"SUMLEV","STATE","COUNTY","STNAME","CTYNAME","YEAR","AGE","TOT_POP","TOT_MALE","TOT_FEMALE"
050,29,001,"Missouri","Adair County",1,0,286,145,141
050,29,001,"Missouri","Adair County",1,1,293,150,143
050,29,001,"Missouri","Adair County",1,2,267,133,134
050,29,001,"Missouri","Adair County",1,3,240,122,118
050,29,001,"Missouri","Adair County",1,4,243,125,118
050,29,001,"Missouri","Adair County",1,5,253,142,111
050,29,001,"Missouri","Adair County",1,6,217,116,101
050,29,001,"Missouri","Adair County",1,7,221,111,110
050,29,001,"Missouri","Adair County",1,8,239,117,122
050,29,001,"Missouri","Adair County",1,9,236,116,120
050,29,001,"Missouri","Adair County",1,10,242,124,118
050,29,001,"Missouri","Adair County",1,11,255,141,114
050,29,001,"Missouri","Adair County",1,12,263,133,130
050,29,001,"Missouri","Adair County",1,13,272,130,142
050,29,001,"Missouri","Adair County",1,14,260,134,126
050,29,001,"Missouri","Adair County",1,15,256,126,130
050,29,001,"Missouri","Adair County",1,16,260,125,135
050,29,001,"Missouri","Adair County",1,17,275,145,130
050,29,001,"Missouri","Adair County",1,18,685,290,395
050,29,001,"Missouri","Adair County",1,19,1318,553,765
050,29,001,"Missouri","Adair County",1,20,1423,579,844
050,29,001,"Missouri","Adair County",1,21,1400,657,743
050,29,001,"Missouri","Adair County",1,22,1078,508,570
050,29,001,"Missouri","Adair County",1,23,568,320,248
050,29,001,"Missouri","Adair County",1,24,440,254,186
050,29,001,"Missouri","Adair County",1,25,380,203,177
050,29,001,"Missouri","Adair County",1,26,340,174,166
050,29,001,"Missouri","Adair County",1,27,287,150,137
050,29,001,"Missouri","Adair County",1,28,276,147,129
050,29,001,"Missouri","Adair County",1,29,279,132,147
050,29,001,"Missouri","Adair County",1,30,231,101,130
050,29,001,"Missouri","Adair County",1,31,222,103,119
050,29,001,"Missouri","Adair County",1,32,226,114,112
050,29,001,"Missouri","Adair County",1,33,236,111,125
050,29,001,"Missouri","Adair County",1,34,255,134,121
050,29,001,"Missouri","Adair County",1,35,232,129,103
050,29,001,"Missouri","Adair County",1,36,227,123,104
050,29,001,"Missouri","Adair County",1,37,224,108,116
050,29,001,"Missouri","Adair County",1,38,243,118,125
050,29,001,"Missouri","Adair County",1,39,211,105,106
050,29,001,"Missouri","Adair County",1,40,228,116,112
050,29,001,"Missouri","Adair County",1,41,232,113,119
050,29,001,"Missouri","Adair County",1,42,212,110,102
050,29,001,"Missouri","Adair County",1,43,211,111,100
050,29,001,"Missouri","Adair County",1,44,181,88,93
050,29,001,"Missouri","Adair County",1,45,190,88,102
050,29,001,"Missouri","Adair County",1,46,215,108,107
050,29,001,"Missouri","Adair County",1,47,225,116,109
050,29,001,"Missouri","Adair County",1,48,252,133,119
050,29,001,"Missouri","Adair County",1,49,268,137,131
050,29,001,"Missouri","Adair County",1,50,258,135,123
050,29,001,"Missouri","Adair County",1,51,256,133,123
050,29,001,"Missouri","Adair County",1,52,237,123,114
050,29,001,"Missouri","Adair County",1,53,227,128,99
050,29,001,"Missouri","Adair County",1,54,241,121,120
050,29,001,"Missouri","Adair County",1,55,276,124,152
050,29,001,"Missouri","Adair County",1,56,272,143,129
050,29,001,"Missouri","Adair County",1,57,274,132,142
050,29,001,"Missouri","Adair County",1,58,283,128,155
050,29,001,"Missouri","Adair County",1,59,282,133,149
050,29,001,"Missouri","Adair County",1,60,272,125,147
050,29,001,"Missouri","Adair County",1,61,273,140,133
050,29,001,"Missouri","Adair County",1,62,259,136,123
050,29,001,"Missouri","Adair County",1,63,250,127,123
050,29,001,"Missouri","Adair County",1,64,254,124,130
050,29,001,"Missouri","Adair County",1,65,256,113,143
050,29,001,"Missouri","Adair County",1,66,251,120,131
050,29,001,"Missouri","Adair County",1,67,226,104,122
050,29,001,"Missouri","Adair County",1,68,214,110,104
050,29,001,"Missouri","Adair County",1,69,229,113,116
050,29,001,"Missouri","Adair County",1,70,212,102,110
050,29,001,"Missouri","Adair County",1,71,202,91,111
050,29,001,"Missouri","Adair County",1,72,204,98,106
050,29,001,"Missouri","Adair County",1,73,207,93,114
050,29,001,"Missouri","Adair County",1,74,149,65,84
050,29,001,"Missouri","Adair County",1,75,154,69,85
050,29,001,"Missouri","Adair County",1,76,172,79,93
050,29,001,"Missouri","Adair County",1,77,153,64,89
050,29,001,"Missouri","Adair County",1,78,131,61,70
050,29,001,"Missouri","Adair County",1,79,119,56,63
050,29,001,"Missouri","Adair County",1,80,107,53,54
050,29,001,"Missouri","Adair County",1,81,110,47,63
050,29,001,"Missouri","Adair County",1,82,89,36,53
050,29,001,"Missouri","Adair County",1,83,77,31,46
050,29,001,"Missouri","Adair County",1,84,75,31,44
050,29,001,"Missouri","Adair County",1,85,488,161,327
050,29,001,"Missouri","Adair County",2,0,281,145,136
050,29,001,"Missouri","Adair County",2,1,292,151,141
050,29,001,"Missouri","Adair County",2,2,270,136,134
050,29,001,"Missouri","Adair County",2,3,240,122,118
050,29,001,"Missouri","Adair County",2,4,241,124,117
050,29,001,"Missouri","Adair County",2,5,250,138,112
050,29,001,"Missouri","Adair County",2,6,226,121,105
050,29,001,"Missouri","Adair County",2,7,217,111,106
050,29,001,"Missouri","Adair County",2,8,235,115,120
050,29,001,"Missouri","Adair County",2,9,234,115,119
050,29,001,"Missouri","Adair County",2,10,239,120,119
050,29,001,"Missouri","Adair County",2,11,250,136,114
050,29,001,"Missouri","Adair County",2,12,261,135,126
050,29,001,"Missouri","Adair County",2,13,268,130,138
050,29,001,"Missouri","Adair County",2,14,262,132,130
050,29,001,"Missouri","Adair County",2,15,257,128,129
050,29,001,"Missouri","Adair County",2,16,259,126,133
050,29,001,"Missouri","Adair County",2,17,272,141,131
050,29,001,"Missouri","Adair County",2,18,675,285,390
050,29,001,"Missouri","Adair County",2,19,1314,550,764
050,29,001,"Missouri","Adair County",2,20,1436,583,853
050,29,001,"Missouri","Adair County",2,21,1388,650,738
050,29,001,"Missouri","Adair County",2,22,1078,506,572
050,29,001,"Missouri","Adair County",2,23,557,315,242
050,29,001,"Missouri","Adair County",2,24,433,247,186
050,29,001,"Missouri","Adair County",2,25,383,204,179
050,29,001,"Missouri","Adair County",2,26,337,176,161
050,29,001,"Missouri","Adair County",2,27,295,153,142
050,29,001,"Missouri","Adair County",2,28,272,144,128
050,29,001,"Missouri","Adair County",2,29,271,132,139
050,29,001,"Missouri","Adair County",2,30,243,111,132
050,29,001,"Missouri","Adair County",2,31,222,102,120
050,29,001,"Missouri","Adair County",2,32,227,113,114
050,29,001,"Missouri","Adair County",2,33,234,113,121
050,29,001,"Missouri","Adair County",2,34,246,127,119
050,29,001,"Missouri","Adair County",2,35,236,129,107
050,29,001,"Missouri","Adair County",2,36,225,121,104
050,29,001,"Missouri","Adair County",2,37,224,112,112
050,29,001,"Missouri","Adair County",2,38,237,115,122
050,29,001,"Missouri","Adair County",2,39,218,108,110
050,29,001,"Missouri","Adair County",2,40,226,115,111
050,29,001,"Missouri","Adair County",2,41,231,114,117
050,29,001,"Missouri","Adair County",2,42,217,111,106
050,29,001,"Missouri","Adair County",2,43,214,111,103
050,29,001,"Missouri","Adair County",2,44,187,93,94
050,29,001,"Missouri","Adair County",2,45,190,87,103
050,29,001,"Missouri","Adair County",2,46,209,103,106
050,29,001,"Missouri","Adair County",2,47,222,114,108
050,29,001,"Missouri","Adair County",2,48,244,128,116
050,29,001,"Missouri","Adair County",2,49,265,136,129
050,29,001,"Missouri","Adair County",2,50,261,135,126
050,29,001,"Missouri","Adair County",2,51,258,134,124
050,29,001,"Missouri","Adair County",2,52,241,125,116
050,29,001,"Missouri","Adair County",2,53,229,127,102
050,29,001,"Missouri","Adair County",2,54,238,123,115
050,29,001,"Missouri","Adair County",2,55,267,122,145
050,29,001,"Missouri","Adair County",2,56,275,140,135
050,29,001,"Missouri","Adair County",2,57,275,136,139
050,29,001,"Missouri","Adair County",2,58,280,129,151
050,29,001,"Missouri","Adair County",2,59,282,131,151
050,29,001,"Missouri","Adair County",2,60,275,128,147
050,29,001,"Missouri","Adair County",2,61,270,135,135
050,29,001,"Missouri","Adair County",2,62,262,137,125
050,29,001,"Missouri","Adair County",2,63,251,129,122
050,29,001,"Missouri","Adair County",2,64,249,122,127
050,29,001,"Missouri","Adair County",2,65,253,114,139
050,29,001,"Missouri","Adair County",2,66,252,117,135
050,29,001,"Missouri","Adair County",2,67,230,106,124
050,29,001,"Missouri","Adair County",2,68,217,109,108
050,29,001,"Missouri","Adair County",2,69,225,114,111
050,29,001,"Missouri","Adair County",2,70,217,105,112
050,29,001,"Missouri","Adair County",2,71,203,93,110
050,29,001,"Missouri","Adair County",2,72,197,93,104
050,29,001,"Missouri","Adair County",2,73,216,98,118
050,29,001,"Missouri","Adair County",2,74,150,66,84
050,29,001,"Missouri","Adair County",2,75,153,69,84
050,29,001,"Missouri","Adair County",2,76,165,73,92
050,29,001,"Missouri","Adair County",2,77,162,69,93
050,29,001,"Missouri","Adair County",2,78,134,61,73
050,29,001,"Missouri","Adair County",2,79,121,57,64
050,29,001,"Missouri","Adair County",2,80,109,54,55
050,29,001,"Missouri","Adair County",2,81,108,47,61
050,29,001,"Missouri","Adair County",2,82,93,38,55
050,29,001,"Missouri","Adair County",2,83,78,31,47
050,29,001,"Missouri","Adair County",2,84,74,32,42
050,29,001,"Missouri","Adair County",2,85,488,161,327
050,29,001,"Missouri","Adair County",3,0,284,161,123
050,29,001,"Missouri","Adair County",3,1,284,155,129
050,29,001,"Missouri","Adair County",3,2,287,146,141
050,29,001,"Missouri","Adair County",3,3,264,134,130
050,29,001,"Missouri","Adair County",3,4,240,123,117
050,29,001,"Missouri","Adair County",3,5,237,121,116
050,29,001,"Missouri","Adair County",3,6,242,137,105
050,29,001,"Missouri","Adair County",3,7,229,126,103
050,29,001,"Missouri","Adair County",3,8,216,108,108
050,29,001,"Missouri","Adair County",3,9,225,117,108
050,29,001,"Missouri","Adair County",3,10,236,119,117
050,29,001,"Missouri","Adair County",3,11,243,120,123
050,29,001,"Missouri","Adair County",3,12,244,135,109
050,29,001,"Missouri","Adair County",3,13,254,136,118
050,29,001,"Missouri","Adair County",3,14,260,125,135
050,29,001,"Missouri","Adair County",3,15,254,130,124
050,29,001,"Missouri","Adair County",3,16,259,132,127
050,29,001,"Missouri","Adair County",3,17,260,124,136
050,29,001,"Missouri","Adair County",3,18,673,278,395
050,29,001,"Missouri","Adair County",3,19,1325,554,771
050,29,001,"Missouri","Adair County",3,20,1455,597,858
050,29,001,"Missouri","Adair County",3,21,1390,657,733
050,29,001,"Missouri","Adair County",3,22,1095,506,589
050,29,001,"Missouri","Adair County",3,23,551,306,245
050,29,001,"Missouri","Adair County",3,24,414,225,189
050,29,001,"Missouri","Adair County",3,25,342,168,174
050,29,001,"Missouri","Adair County",3,26,322,179,143
050,29,001,"Missouri","Adair County",3,27,283,143,140
050,29,001,"Missouri","Adair County",3,28,263,135,128
050,29,001,"Missouri","Adair County",3,29,255,131,124
050,29,001,"Missouri","Adair County",3,30,276,130,146
050,29,001,"Missouri","Adair County",3,31,243,111,132
050,29,001,"Missouri","Adair County",3,32,226,112,114
050,29,001,"Missouri","Adair County",3,33,206,104,102
050,29,001,"Missouri","Adair County",3,34,236,113,123
050,29,001,"Missouri","Adair County",3,35,234,117,117
050,29,001,"Missouri","Adair County",3,36,230,123,107
050,29,001,"Missouri","Adair County",3,37,224,122,102
050,29,001,"Missouri","Adair County",3,38,222,114,108
050,29,001,"Missouri","Adair County",3,39,240,118,122
050,29,001,"Missouri","Adair County",3,40,219,109,110
050,29,001,"Missouri","Adair County",3,41,219,114,105
050,29,001,"Missouri","Adair County",3,42,225,110,115
050,29,001,"Missouri","Adair County",3,43,222,110,112
050,29,001,"Missouri","Adair County",3,44,220,114,106
050,29,001,"Missouri","Adair County",3,45,194,96,98
050,29,001,"Missouri","Adair County",3,46,192,88,104
050,29,001,"Missouri","Adair County",3,47,207,106,101
050,29,001,"Missouri","Adair County",3,48,230,112,118
050,29,001,"Missouri","Adair County",3,49,250,130,120
050,29,001,"Missouri","Adair County",3,50,260,134,126
050,29,001,"Missouri","Adair County",3,51,267,136,131
050,29,001,"Missouri","Adair County",3,52,255,132,123
050,29,001,"Missouri","Adair County",3,53,242,130,112
050,29,001,"Missouri","Adair County",3,54,223,124,99
050,29,001,"Missouri","Adair County",3,55,242,123,119
050,29,001,"Missouri","Adair County",3,56,262,121,141
050,29,001,"Missouri","Adair County",3,57,277,137,140
050,29,001,"Missouri","Adair County",3,58,272,131,141
050,29,001,"Missouri","Adair County",3,59,271,127,144
050,29,001,"Missouri","Adair County",3,60,296,139,157
050,29,001,"Missouri","Adair County",3,61,273,131,142
050,29,001,"Missouri","Adair County",3,62,267,132,135
050,29,001,"Missouri","Adair County",3,63,252,130,122
050,29,001,"Missouri","Adair County",3,64,244,128,116
050,29,001,"Missouri","Adair County",3,65,235,112,123
050,29,001,"Missouri","Adair County",3,66,247,110,137
050,29,001,"Missouri","Adair County",3,67,249,116,133
050,29,001,"Missouri","Adair County",3,68,229,108,121
050,29,001,"Missouri","Adair County",3,69,212,106,106
050,29,001,"Missouri","Adair County",3,70,219,109,110
050,29,001,"Missouri","Adair County",3,71,213,100,113
050,29,001,"Missouri","Adair County",3,72,193,89,104
050,29,001,"Missouri","Adair County",3,73,197,92,105
050,29,001,"Missouri","Adair County",3,74,212,94,118
050,29,001,"Missouri","Adair County",3,75,140,63,77
050,29,001,"Missouri","Adair County",3,76,148,64,84
050,29,001,"Missouri","Adair County",3,77,155,69,86
050,29,001,"Missouri","Adair County",3,78,159,69,90
050,29,001,"Missouri","Adair County",3,79,130,59,71
050,29,001,"Missouri","Adair County",3,80,111,54,57
050,29,001,"Missouri","Adair County",3,81,109,52,57
050,29,001,"Missouri","Adair County",3,82,101,44,57
050,29,001,"Missouri","Adair County",3,83,82,31,51
050,29,001,"Missouri","Adair County",3,84,73,29,44
050,29,001,"Missouri","Adair County",3,85,470,157,313
050,29,001,"Missouri","Adair County",4,0,267,145,122
050,29,001,"Missouri","Adair County",4,1,273,157,116
050,29,001,"Missouri","Adair County",4,2,278,155,123
050,29,001,"Missouri","Adair County",4,3,277,149,128
050,29,001,"Missouri","Adair County",4,4,264,132,132
050,29,001,"Missouri","Adair County",4,5,241,120,121
050,29,001,"Missouri","Adair County",4,6,244,125,119
050,29,001,"Missouri","Adair County",4,7,243,134,109
050,29,001,"Missouri","Adair County",4,8,229,124,105
050,29,001,"Missouri","Adair County",4,9,210,107,103
050,29,001,"Missouri","Adair County",4,10,216,107,109
050,29,001,"Missouri","Adair County",4,11,236,121,115
050,29,001,"Missouri","Adair County",4,12,246,119,127
050,29,001,"Missouri","Adair County",4,13,234,130,104
050,29,001,"Missouri","Adair County",4,14,256,139,117
050,29,001,"Missouri","Adair County",4,15,272,131,141
050,29,001,"Missouri","Adair County",4,16,258,133,125
050,29,001,"Missouri","Adair County",4,17,271,134,137
050,29,001,"Missouri","Adair County",4,18,650,263,387
050,29,001,"Missouri","Adair County",4,19,1300,542,758
050,29,001,"Missouri","Adair County",4,20,1430,579,851
050,29,001,"Missouri","Adair County",4,21,1410,669,741
050,29,001,"Missouri","Adair County",4,22,1100,508,592
050,29,001,"Missouri","Adair County",4,23,578,310,268
050,29,001,"Missouri","Adair County",4,24,397,218,179
050,29,001,"Missouri","Adair County",4,25,340,178,162
050,29,001,"Missouri","Adair County",4,26,298,144,154
050,29,001,"Missouri","Adair County",4,27,286,163,123
050,29,001,"Missouri","Adair County",4,28,273,127,146
050,29,001,"Missouri","Adair County",4,29,266,128,138
050,29,001,"Missouri","Adair County",4,30,241,125,116
050,29,001,"Missouri","Adair County",4,31,267,129,138
050,29,001,"Missouri","Adair County",4,32,257,118,139
050,29,001,"Missouri","Adair County",4,33,218,112,106
050,29,001,"Missouri","Adair County",4,34,204,100,104
050,29,001,"Missouri","Adair County",4,35,235,112,123
050,29,001,"Missouri","Adair County",4,36,240,125,115
050,29,001,"Missouri","Adair County",4,37,233,124,109
050,29,001,"Missouri","Adair County",4,38,234,128,106
050,29,001,"Missouri","Adair County",4,39,223,112,111
050,29,001,"Missouri","Adair County",4,40,243,128,115
050,29,001,"Missouri","Adair County",4,41,220,111,109
050,29,001,"Missouri","Adair County",4,42,230,116,114
050,29,001,"Missouri","Adair County",4,43,231,116,115
050,29,001,"Missouri","Adair County",4,44,210,99,111
050,29,001,"Missouri","Adair County",4,45,220,112,108
050,29,001,"Missouri","Adair County",4,46,191,100,91
050,29,001,"Missouri","Adair County",4,47,191,90,101
050,29,001,"Missouri","Adair County",4,48,211,111,100
050,29,001,"Missouri","Adair County",4,49,230,114,116
050,29,001,"Missouri","Adair County",4,50,244,120,124
050,29,001,"Missouri","Adair County",4,51,258,137,121
050,29,001,"Missouri","Adair County",4,52,266,130,136
050,29,001,"Missouri","Adair County",4,53,252,129,123
050,29,001,"Missouri","Adair County",4,54,239,130,109
050,29,001,"Missouri","Adair County",4,55,231,128,103
050,29,001,"Missouri","Adair County",4,56,240,119,121
050,29,001,"Missouri","Adair County",4,57,254,118,136
050,29,001,"Missouri","Adair County",4,58,272,130,142
050,29,001,"Missouri","Adair County",4,59,267,131,136
050,29,001,"Missouri","Adair County",4,60,275,130,145
050,29,001,"Missouri","Adair County",4,61,290,135,155
050,29,001,"Missouri","Adair County",4,62,267,131,136
050,29,001,"Missouri","Adair County",4,63,258,127,131
050,29,001,"Missouri","Adair County",4,64,259,136,123
050,29,001,"Missouri","Adair County",4,65,235,120,115
050,29,001,"Missouri","Adair County",4,66,236,115,121
050,29,001,"Missouri","Adair County",4,67,241,110,131
050,29,001,"Missouri","Adair County",4,68,243,111,132
050,29,001,"Missouri","Adair County",4,69,229,107,122
050,29,001,"Missouri","Adair County",4,70,207,103,104
050,29,001,"Missouri","Adair County",4,71,218,105,113
050,29,001,"Missouri","Adair County",4,72,205,99,106
050,29,001,"Missouri","Adair County",4,73,185,86,99
050,29,001,"Missouri","Adair County",4,74,191,88,103
050,29,001,"Missouri","Adair County",4,75,198,89,109
050,29,001,"Missouri","Adair County",4,76,139,60,79
050,29,001,"Missouri","Adair County",4,77,140,58,82
050,29,001,"Missouri","Adair County",4,78,149,69,80
050,29,001,"Missouri","Adair County",4,79,148,65,83
050,29,001,"Missouri","Adair County",4,80,120,57,63
050,29,001,"Missouri","Adair County",4,81,103,50,53
050,29,001,"Missouri","Adair County",4,82,96,44,52
050,29,001,"Missouri","Adair County",4,83,93,42,51
050,29,001,"Missouri","Adair County",4,84,83,35,48
050,29,001,"Missouri","Adair County",4,85,448,157,291
050,29,001,"Missouri","Adair County",5,0,271,148,123
050,29,001,"Missouri","Adair County",5,1,251,135,116
050,29,001,"Missouri","Adair County",5,2,270,149,121
050,29,001,"Missouri","Adair County",5,3,280,162,118
050,29,001,"Missouri","Adair County",5,4,271,140,131
050,29,001,"Missouri","Adair County",5,5,258,125,133
050,29,001,"Missouri","Adair County",5,6,238,109,129
050,29,001,"Missouri","Adair County",5,7,247,122,125
050,29,001,"Missouri","Adair County",5,8,238,135,103
050,29,001,"Missouri","Adair County",5,9,242,132,110
050,29,001,"Missouri","Adair County",5,10,229,111,118
050,29,001,"Missouri","Adair County",5,11,231,117,114
050,29,001,"Missouri","Adair County",5,12,237,124,113
050,29,001,"Missouri","Adair County",5,13,255,125,130
050,29,001,"Missouri","Adair County",5,14,238,126,112
050,29,001,"Missouri","Adair County",5,15,258,140,118
050,29,001,"Missouri","Adair County",5,16,292,143,149
050,29,001,"Missouri","Adair County",5,17,271,138,133
050,29,001,"Missouri","Adair County",5,18,657,270,387
050,29,001,"Missouri","Adair County",5,19,1297,534,763
050,29,001,"Missouri","Adair County",5,20,1411,578,833
050,29,001,"Missouri","Adair County",5,21,1380,641,739
050,29,001,"Missouri","Adair County",5,22,1089,509,580
050,29,001,"Missouri","Adair County",5,23,557,306,251
050,29,001,"Missouri","Adair County",5,24,418,221,197
050,29,001,"Missouri","Adair County",5,25,342,177,165
050,29,001,"Missouri","Adair County",5,26,302,158,144
050,29,001,"Missouri","Adair County",5,27,274,128,146
050,29,001,"Missouri","Adair County",5,28,282,142,140
050,29,001,"Missouri","Adair County",5,29,280,124,156
050,29,001,"Missouri","Adair County",5,30,257,112,145
050,29,001,"Missouri","Adair County",5,31,243,132,111
050,29,001,"Missouri","Adair County",5,32,259,133,126
050,29,001,"Missouri","Adair County",5,33,253,115,138
050,29,001,"Missouri","Adair County",5,34,217,113,104
050,29,001,"Missouri","Adair County",5,35,204,100,104
050,29,001,"Missouri","Adair County",5,36,232,112,120
050,29,001,"Missouri","Adair County",5,37,250,133,117
050,29,001,"Missouri","Adair County",5,38,231,125,106
050,29,001,"Missouri","Adair County",5,39,240,130,110
050,29,001,"Missouri","Adair County",5,40,231,114,117
050,29,001,"Missouri","Adair County",5,41,234,117,117
050,29,001,"Missouri","Adair County",5,42,216,114,102
050,29,001,"Missouri","Adair County",5,43,235,123,112
050,29,001,"Missouri","Adair County",5,44,227,113,114
050,29,001,"Missouri","Adair County",5,45,211,102,109
050,29,001,"Missouri","Adair County",5,46,213,108,105
050,29,001,"Missouri","Adair County",5,47,185,94,91
050,29,001,"Missouri","Adair County",5,48,186,89,97
050,29,001,"Missouri","Adair County",5,49,215,109,106
050,29,001,"Missouri","Adair County",5,50,227,113,114
050,29,001,"Missouri","Adair County",5,51,246,122,124
050,29,001,"Missouri","Adair County",5,52,239,124,115
050,29,001,"Missouri","Adair County",5,53,259,130,129
050,29,001,"Missouri","Adair County",5,54,250,124,126
050,29,001,"Missouri","Adair County",5,55,239,128,111
050,29,001,"Missouri","Adair County",5,56,224,122,102
050,29,001,"Missouri","Adair County",5,57,229,114,115
050,29,001,"Missouri","Adair County",5,58,257,119,138
050,29,001,"Missouri","Adair County",5,59,267,125,142
050,29,001,"Missouri","Adair County",5,60,260,130,130
050,29,001,"Missouri","Adair County",5,61,263,124,139
050,29,001,"Missouri","Adair County",5,62,287,133,154
050,29,001,"Missouri","Adair County",5,63,266,129,137
050,29,001,"Missouri","Adair County",5,64,261,131,130
050,29,001,"Missouri","Adair County",5,65,251,129,122
050,29,001,"Missouri","Adair County",5,66,229,116,113
050,29,001,"Missouri","Adair County",5,67,224,108,116
050,29,001,"Missouri","Adair County",5,68,241,107,134
050,29,001,"Missouri","Adair County",5,69,235,110,125
050,29,001,"Missouri","Adair County",5,70,218,102,116
050,29,001,"Missouri","Adair County",5,71,203,101,102
050,29,001,"Missouri","Adair County",5,72,201,98,103
050,29,001,"Missouri","Adair County",5,73,199,94,105
050,29,001,"Missouri","Adair County",5,74,180,82,98
050,29,001,"Missouri","Adair County",5,75,178,85,93
050,29,001,"Missouri","Adair County",5,76,189,82,107
050,29,001,"Missouri","Adair County",5,77,133,56,77
050,29,001,"Missouri","Adair County",5,78,136,59,77
050,29,001,"Missouri","Adair County",5,79,143,63,80
050,29,001,"Missouri","Adair County",5,80,138,62,76
050,29,001,"Missouri","Adair County",5,81,117,55,62
050,29,001,"Missouri","Adair County",5,82,92,42,50
050,29,001,"Missouri","Adair County",5,83,85,39,46
050,29,001,"Missouri","Adair County",5,84,96,46,50
050,29,001,"Missouri","Adair County",5,85,455,168,287
050,29,003,"Missouri","Andrew County",1,0,203,103,100
050,29,003,"Missouri","Andrew County",1,1,197,100,97
050,29,003,"Missouri","Andrew County",1,2,197,110,87
050,29,003,"Missouri","Andrew County",1,3,214,104,110
050,29,003,"Missouri","Andrew County",1,4,216,107,109
050,29,003,"Missouri","Andrew County",1,5,220,123,97
050,29,003,"Missouri","Andrew County",1,6,234,116,118
050,29,003,"Missouri","Andrew County",1,7,246,119,127
050,29,003,"Missouri","Andrew County",1,8,249,122,127
050,29,003,"Missouri","Andrew County",1,9,237,122,115
050,29,003,"Missouri","Andrew County",1,10,248,139,109
050,29,003,"Missouri","Andrew County",1,11,239,121,118
050,29,003,"Missouri","Andrew County",1,12,264,133,131
050,29,003,"Missouri","Andrew County",1,13,252,126,126
050,29,003,"Missouri","Andrew County",1,14,220,108,112
050,29,003,"Missouri","Andrew County",1,15,264,134,130
050,29,003,"Missouri","Andrew County",1,16,275,132,143
050,29,003,"Missouri","Andrew County",1,17,243,126,117
050,29,003,"Missouri","Andrew County",1,18,193,110,83
050,29,003,"Missouri","Andrew County",1,19,165,92,73
050,29,003,"Missouri","Andrew County",1,20,169,92,77
050,29,003,"Missouri","Andrew County",1,21,177,92,85
050,29,003,"Missouri","Andrew County",1,22,173,84,89
050,29,003,"Missouri","Andrew County",1,23,171,93,78
050,29,003,"Missouri","Andrew County",1,24,184,89,95
050,29,003,"Missouri","Andrew County",1,25,196,107,89
050,29,003,"Missouri","Andrew County",1,26,189,92,97
050,29,003,"Missouri","Andrew County",1,27,204,101,103
050,29,003,"Missouri","Andrew County",1,28,206,99,107
050,29,003,"Missouri","Andrew County",1,29,206,102,104
050,29,003,"Missouri","Andrew County",1,30,214,111,103
050,29,003,"Missouri","Andrew County",1,31,230,109,121
050,29,003,"Missouri","Andrew County",1,32,192,101,91
050,29,003,"Missouri","Andrew County",1,33,198,98,100
050,29,003,"Missouri","Andrew County",1,34,207,105,102
050,29,003,"Missouri","Andrew County",1,35,219,104,115
050,29,003,"Missouri","Andrew County",1,36,211,104,107
050,29,003,"Missouri","Andrew County",1,37,236,114,122
050,29,003,"Missouri","Andrew County",1,38,214,105,109
050,29,003,"Missouri","Andrew County",1,39,249,126,123
050,29,003,"Missouri","Andrew County",1,40,232,116,116
050,29,003,"Missouri","Andrew County",1,41,257,120,137
050,29,003,"Missouri","Andrew County",1,42,228,111,117
050,29,003,"Missouri","Andrew County",1,43,220,119,101
050,29,003,"Missouri","Andrew County",1,44,210,100,110
050,29,003,"Missouri","Andrew County",1,45,230,107,123
050,29,003,"Missouri","Andrew County",1,46,192,96,96
050,29,003,"Missouri","Andrew County",1,47,197,112,85
050,29,003,"Missouri","Andrew County",1,48,235,125,110
050,29,003,"Missouri","Andrew County",1,49,261,132,129
050,29,003,"Missouri","Andrew County",1,50,226,114,112
050,29,003,"Missouri","Andrew County",1,51,227,123,104
050,29,003,"Missouri","Andrew County",1,52,228,120,108
050,29,003,"Missouri","Andrew County",1,53,237,119,118
050,29,003,"Missouri","Andrew County",1,54,240,129,111
050,29,003,"Missouri","Andrew County",1,55,257,135,122
050,29,003,"Missouri","Andrew County",1,56,243,122,121
050,29,003,"Missouri","Andrew County",1,57,246,126,120
050,29,003,"Missouri","Andrew County",1,58,248,117,131
050,29,003,"Missouri","Andrew County",1,59,275,142,133
050,29,003,"Missouri","Andrew County",1,60,282,142,140
050,29,003,"Missouri","Andrew County",1,61,284,143,141
050,29,003,"Missouri","Andrew County",1,62,274,132,142
050,29,003,"Missouri","Andrew County",1,63,259,121,138
050,29,003,"Missouri","Andrew County",1,64,258,126,132
050,29,003,"Missouri","Andrew County",1,65,257,117,140
050,29,003,"Missouri","Andrew County",1,66,255,128,127
050,29,003,"Missouri","Andrew County",1,67,218,122,96
050,29,003,"Missouri","Andrew County",1,68,209,109,100
050,29,003,"Missouri","Andrew County",1,69,206,110,96
050,29,003,"Missouri","Andrew County",1,70,196,103,93
050,29,003,"Missouri","Andrew County",1,71,186,93,93
050,29,003,"Missouri","Andrew County",1,72,194,93,101
050,29,003,"Missouri","Andrew County",1,73,187,90,97
050,29,003,"Missouri","Andrew County",1,74,134,55,79
050,29,003,"Missouri","Andrew County",1,75,127,62,65
050,29,003,"Missouri","Andrew County",1,76,150,71,79
050,29,003,"Missouri","Andrew County",1,77,143,73,70
050,29,003,"Missouri","Andrew County",1,78,127,65,62
050,29,003,"Missouri","Andrew County",1,79,111,50,61
050,29,003,"Missouri","Andrew County",1,80,99,37,62
050,29,003,"Missouri","Andrew County",1,81,82,29,53
050,29,003,"Missouri","Andrew County",1,82,71,31,40
050,29,003,"Missouri","Andrew County",1,83,70,31,39
050,29,003,"Missouri","Andrew County",1,84,65,24,41
050,29,003,"Missouri","Andrew County",1,85,378,131,247
050,29,003,"Missouri","Andrew County",2,0,190,93,97
050,29,003,"Missouri","Andrew County",2,1,199,102,97
050,29,003,"Missouri","Andrew County",2,2,194,106,88
050,29,003,"Missouri","Andrew County",2,3,208,103,105
050,29,003,"Missouri","Andrew County",2,4,213,105,108
050,29,003,"Missouri","Andrew County",2,5,220,119,101
050,29,003,"Missouri","Andrew County",2,6,235,120,115
050,29,003,"Missouri","Andrew County",2,7,245,120,125
050,29,003,"Missouri","Andrew County",2,8,246,120,126
050,29,003,"Missouri","Andrew County",2,9,240,122,118
050,29,003,"Missouri","Andrew County",2,10,244,134,110
050,29,003,"Missouri","Andrew County",2,11,239,125,114
050,29,003,"Missouri","Andrew County",2,12,262,133,129
050,29,003,"Missouri","Andrew County",2,13,252,128,124
050,29,003,"Missouri","Andrew County",2,14,229,114,115
050,29,003,"Missouri","Andrew County",2,15,255,129,126
050,29,003,"Missouri","Andrew County",2,16,272,131,141
050,29,003,"Missouri","Andrew County",2,17,248,127,121
050,29,003,"Missouri","Andrew County",2,18,193,107,86
050,29,003,"Missouri","Andrew County",2,19,161,89,72
050,29,003,"Missouri","Andrew County",2,20,172,94,78
050,29,003,"Missouri","Andrew County",2,21,176,94,82
050,29,003,"Missouri","Andrew County",2,22,177,88,89
050,29,003,"Missouri","Andrew County",2,23,176,91,85
050,29,003,"Missouri","Andrew County",2,24,181,90,91
050,29,003,"Missouri","Andrew County",2,25,191,101,90
050,29,003,"Missouri","Andrew County",2,26,190,94,96
050,29,003,"Missouri","Andrew County",2,27,200,97,103
050,29,003,"Missouri","Andrew County",2,28,207,100,107
050,29,003,"Missouri","Andrew County",2,29,203,101,102
050,29,003,"Missouri","Andrew County",2,30,214,110,104
050,29,003,"Missouri","Andrew County",2,31,226,112,114
050,29,003,"Missouri","Andrew County",2,32,200,102,98
050,29,003,"Missouri","Andrew County",2,33,195,98,97
050,29,003,"Missouri","Andrew County",2,34,206,104,102
050,29,003,"Missouri","Andrew County",2,35,216,105,111
050,29,003,"Missouri","Andrew County",2,36,214,104,110
050,29,003,"Missouri","Andrew County",2,37,228,111,117
050,29,003,"Missouri","Andrew County",2,38,222,108,114
050,29,003,"Missouri","Andrew County",2,39,240,120,120
050,29,003,"Missouri","Andrew County",2,40,240,120,120
050,29,003,"Missouri","Andrew County",2,41,251,119,132
050,29,003,"Missouri","Andrew County",2,42,233,113,120
050,29,003,"Missouri","Andrew County",2,43,221,116,105
050,29,003,"Missouri","Andrew County",2,44,209,103,106
050,29,003,"Missouri","Andrew County",2,45,226,106,120
050,29,003,"Missouri","Andrew County",2,46,199,97,102
050,29,003,"Missouri","Andrew County",2,47,195,107,88
050,29,003,"Missouri","Andrew County",2,48,225,121,104
050,29,003,"Missouri","Andrew County",2,49,257,131,126
050,29,003,"Missouri","Andrew County",2,50,236,119,117
050,29,003,"Missouri","Andrew County",2,51,223,118,105
050,29,003,"Missouri","Andrew County",2,52,228,120,108
050,29,003,"Missouri","Andrew County",2,53,236,119,117
050,29,003,"Missouri","Andrew County",2,54,238,125,113
050,29,003,"Missouri","Andrew County",2,55,253,133,120
050,29,003,"Missouri","Andrew County",2,56,247,126,121
050,29,003,"Missouri","Andrew County",2,57,247,125,122
050,29,003,"Missouri","Andrew County",2,58,246,119,127
050,29,003,"Missouri","Andrew County",2,59,269,136,133
050,29,003,"Missouri","Andrew County",2,60,278,141,137
050,29,003,"Missouri","Andrew County",2,61,281,142,139
050,29,003,"Missouri","Andrew County",2,62,275,135,140
050,29,003,"Missouri","Andrew County",2,63,266,125,141
050,29,003,"Missouri","Andrew County",2,64,257,125,132
050,29,003,"Missouri","Andrew County",2,65,258,119,139
050,29,003,"Missouri","Andrew County",2,66,255,126,129
050,29,003,"Missouri","Andrew County",2,67,223,121,102
050,29,003,"Missouri","Andrew County",2,68,206,107,99
050,29,003,"Missouri","Andrew County",2,69,209,111,98
050,29,003,"Missouri","Andrew County",2,70,198,104,94
050,29,003,"Missouri","Andrew County",2,71,186,95,91
050,29,003,"Missouri","Andrew County",2,72,189,93,96
050,29,003,"Missouri","Andrew County",2,73,199,95,104
050,29,003,"Missouri","Andrew County",2,74,137,59,78
050,29,003,"Missouri","Andrew County",2,75,129,61,68
050,29,003,"Missouri","Andrew County",2,76,143,68,75
050,29,003,"Missouri","Andrew County",2,77,147,74,73
050,29,003,"Missouri","Andrew County",2,78,125,63,62
050,29,003,"Missouri","Andrew County",2,79,113,53,60
050,29,003,"Missouri","Andrew County",2,80,100,40,60
050,29,003,"Missouri","Andrew County",2,81,84,31,53
050,29,003,"Missouri","Andrew County",2,82,74,31,43
050,29,003,"Missouri","Andrew County",2,83,69,30,39
050,29,003,"Missouri","Andrew County",2,84,65,26,39
050,29,003,"Missouri","Andrew County",2,85,379,134,245
050,29,003,"Missouri","Andrew County",3,0,160,87,73
050,29,003,"Missouri","Andrew County",3,1,183,89,94
050,29,003,"Missouri","Andrew County",3,2,217,108,109
050,29,003,"Missouri","Andrew County",3,3,192,98,94
050,29,003,"Missouri","Andrew County",3,4,222,106,116
050,29,003,"Missouri","Andrew County",3,5,207,97,110
050,29,003,"Missouri","Andrew County",3,6,226,130,96
050,29,003,"Missouri","Andrew County",3,7,237,121,116
050,29,003,"Missouri","Andrew County",3,8,244,121,123
050,29,003,"Missouri","Andrew County",3,9,245,124,121
050,29,003,"Missouri","Andrew County",3,10,237,116,121
050,29,003,"Missouri","Andrew County",3,11,243,136,107
050,29,003,"Missouri","Andrew County",3,12,240,123,117
050,29,003,"Missouri","Andrew County",3,13,264,134,130
050,29,003,"Missouri","Andrew County",3,14,244,122,122
050,29,003,"Missouri","Andrew County",3,15,229,108,121
050,29,003,"Missouri","Andrew County",3,16,242,122,120
050,29,003,"Missouri","Andrew County",3,17,259,125,134
050,29,003,"Missouri","Andrew County",3,18,197,110,87
050,29,003,"Missouri","Andrew County",3,19,156,87,69
050,29,003,"Missouri","Andrew County",3,20,168,93,75
050,29,003,"Missouri","Andrew County",3,21,187,97,90
050,29,003,"Missouri","Andrew County",3,22,185,94,91
050,29,003,"Missouri","Andrew County",3,23,178,89,89
050,29,003,"Missouri","Andrew County",3,24,176,88,88
050,29,003,"Missouri","Andrew County",3,25,167,82,85
050,29,003,"Missouri","Andrew County",3,26,184,103,81
050,29,003,"Missouri","Andrew County",3,27,182,92,90
050,29,003,"Missouri","Andrew County",3,28,200,97,103
050,29,003,"Missouri","Andrew County",3,29,208,103,105
050,29,003,"Missouri","Andrew County",3,30,200,101,99
050,29,003,"Missouri","Andrew County",3,31,224,116,108
050,29,003,"Missouri","Andrew County",3,32,226,114,112
050,29,003,"Missouri","Andrew County",3,33,205,108,97
050,29,003,"Missouri","Andrew County",3,34,206,104,102
050,29,003,"Missouri","Andrew County",3,35,208,103,105
050,29,003,"Missouri","Andrew County",3,36,217,103,114
050,29,003,"Missouri","Andrew County",3,37,215,104,111
050,29,003,"Missouri","Andrew County",3,38,229,111,118
050,29,003,"Missouri","Andrew County",3,39,220,106,114
050,29,003,"Missouri","Andrew County",3,40,248,124,124
050,29,003,"Missouri","Andrew County",3,41,235,116,119
050,29,003,"Missouri","Andrew County",3,42,242,114,128
050,29,003,"Missouri","Andrew County",3,43,238,113,125
050,29,003,"Missouri","Andrew County",3,44,221,113,108
050,29,003,"Missouri","Andrew County",3,45,211,109,102
050,29,003,"Missouri","Andrew County",3,46,221,105,116
050,29,003,"Missouri","Andrew County",3,47,198,99,99
050,29,003,"Missouri","Andrew County",3,48,203,106,97
050,29,003,"Missouri","Andrew County",3,49,225,121,104
050,29,003,"Missouri","Andrew County",3,50,251,128,123
050,29,003,"Missouri","Andrew County",3,51,242,123,119
050,29,003,"Missouri","Andrew County",3,52,222,119,103
050,29,003,"Missouri","Andrew County",3,53,223,115,108
050,29,003,"Missouri","Andrew County",3,54,230,116,114
050,29,003,"Missouri","Andrew County",3,55,238,127,111
050,29,003,"Missouri","Andrew County",3,56,250,135,115
050,29,003,"Missouri","Andrew County",3,57,250,124,126
050,29,003,"Missouri","Andrew County",3,58,237,120,117
050,29,003,"Missouri","Andrew County",3,59,250,121,129
050,29,003,"Missouri","Andrew County",3,60,274,138,136
050,29,003,"Missouri","Andrew County",3,61,286,144,142
050,29,003,"Missouri","Andrew County",3,62,272,138,134
050,29,003,"Missouri","Andrew County",3,63,268,132,136
050,29,003,"Missouri","Andrew County",3,64,270,129,141
050,29,003,"Missouri","Andrew County",3,65,254,121,133
050,29,003,"Missouri","Andrew County",3,66,261,119,142
050,29,003,"Missouri","Andrew County",3,67,253,127,126
050,29,003,"Missouri","Andrew County",3,68,217,116,101
050,29,003,"Missouri","Andrew County",3,69,211,111,100
050,29,003,"Missouri","Andrew County",3,70,207,104,103
050,29,003,"Missouri","Andrew County",3,71,192,98,94
050,29,003,"Missouri","Andrew County",3,72,172,88,84
050,29,003,"Missouri","Andrew County",3,73,177,87,90
050,29,003,"Missouri","Andrew County",3,74,193,91,102
050,29,003,"Missouri","Andrew County",3,75,129,56,73
050,29,003,"Missouri","Andrew County",3,76,127,61,66
050,29,003,"Missouri","Andrew County",3,77,134,65,69
050,29,003,"Missouri","Andrew County",3,78,148,74,74
050,29,003,"Missouri","Andrew County",3,79,121,60,61
050,29,003,"Missouri","Andrew County",3,80,108,51,57
050,29,003,"Missouri","Andrew County",3,81,89,38,51
050,29,003,"Missouri","Andrew County",3,82,75,30,45
050,29,003,"Missouri","Andrew County",3,83,68,25,43
050,29,003,"Missouri","Andrew County",3,84,68,28,40
050,29,003,"Missouri","Andrew County",3,85,377,138,239
050,29,003,"Missouri","Andrew County",4,0,170,82,88
050,29,003,"Missouri","Andrew County",4,1,175,96,79
050,29,003,"Missouri","Andrew County",4,2,182,90,92
050,29,003,"Missouri","Andrew County",4,3,221,114,107
050,29,003,"Missouri","Andrew County",4,4,210,106,104
050,29,003,"Missouri","Andrew County",4,5,232,117,115
050,29,003,"Missouri","Andrew County",4,6,215,97,118
050,29,003,"Missouri","Andrew County",4,7,229,129,100
050,29,003,"Missouri","Andrew County",4,8,237,121,116
050,29,003,"Missouri","Andrew County",4,9,246,121,125
050,29,003,"Missouri","Andrew County",4,10,249,128,121
050,29,003,"Missouri","Andrew County",4,11,236,120,116
050,29,003,"Missouri","Andrew County",4,12,262,153,109
050,29,003,"Missouri","Andrew County",4,13,240,123,117
050,29,003,"Missouri","Andrew County",4,14,259,129,130
050,29,003,"Missouri","Andrew County",4,15,238,117,121
050,29,003,"Missouri","Andrew County",4,16,224,108,116
050,29,003,"Missouri","Andrew County",4,17,230,116,114
050,29,003,"Missouri","Andrew County",4,18,217,112,105
050,29,003,"Missouri","Andrew County",4,19,152,84,68
050,29,003,"Missouri","Andrew County",4,20,167,95,72
050,29,003,"Missouri","Andrew County",4,21,167,92,75
050,29,003,"Missouri","Andrew County",4,22,194,96,98
050,29,003,"Missouri","Andrew County",4,23,182,96,86
050,29,003,"Missouri","Andrew County",4,24,183,92,91
050,29,003,"Missouri","Andrew County",4,25,193,97,96
050,29,003,"Missouri","Andrew County",4,26,162,82,80
050,29,003,"Missouri","Andrew County",4,27,169,90,79
050,29,003,"Missouri","Andrew County",4,28,186,87,99
050,29,003,"Missouri","Andrew County",4,29,221,114,107
050,29,003,"Missouri","Andrew County",4,30,214,106,108
050,29,003,"Missouri","Andrew County",4,31,209,98,111
050,29,003,"Missouri","Andrew County",4,32,238,120,118
050,29,003,"Missouri","Andrew County",4,33,237,114,123
050,29,003,"Missouri","Andrew County",4,34,208,104,104
050,29,003,"Missouri","Andrew County",4,35,209,110,99
050,29,003,"Missouri","Andrew County",4,36,206,107,99
050,29,003,"Missouri","Andrew County",4,37,215,102,113
050,29,003,"Missouri","Andrew County",4,38,211,99,112
050,29,003,"Missouri","Andrew County",4,39,238,115,123
050,29,003,"Missouri","Andrew County",4,40,224,111,113
050,29,003,"Missouri","Andrew County",4,41,254,130,124
050,29,003,"Missouri","Andrew County",4,42,231,113,118
050,29,003,"Missouri","Andrew County",4,43,243,115,128
050,29,003,"Missouri","Andrew County",4,44,239,116,123
050,29,003,"Missouri","Andrew County",4,45,208,108,100
050,29,003,"Missouri","Andrew County",4,46,211,109,102
050,29,003,"Missouri","Andrew County",4,47,215,104,111
050,29,003,"Missouri","Andrew County",4,48,193,98,95
050,29,003,"Missouri","Andrew County",4,49,208,112,96
050,29,003,"Missouri","Andrew County",4,50,223,122,101
050,29,003,"Missouri","Andrew County",4,51,250,127,123
050,29,003,"Missouri","Andrew County",4,52,236,115,121
050,29,003,"Missouri","Andrew County",4,53,220,121,99
050,29,003,"Missouri","Andrew County",4,54,224,116,108
050,29,003,"Missouri","Andrew County",4,55,223,116,107
050,29,003,"Missouri","Andrew County",4,56,240,124,116
050,29,003,"Missouri","Andrew County",4,57,243,130,113
050,29,003,"Missouri","Andrew County",4,58,250,123,127
050,29,003,"Missouri","Andrew County",4,59,249,129,120
050,29,003,"Missouri","Andrew County",4,60,255,122,133
050,29,003,"Missouri","Andrew County",4,61,275,136,139
050,29,003,"Missouri","Andrew County",4,62,277,141,136
050,29,003,"Missouri","Andrew County",4,63,270,137,133
050,29,003,"Missouri","Andrew County",4,64,258,131,127
050,29,003,"Missouri","Andrew County",4,65,261,125,136
050,29,003,"Missouri","Andrew County",4,66,246,114,132
050,29,003,"Missouri","Andrew County",4,67,243,109,134
050,29,003,"Missouri","Andrew County",4,68,248,124,124
050,29,003,"Missouri","Andrew County",4,69,218,120,98
050,29,003,"Missouri","Andrew County",4,70,201,104,97
050,29,003,"Missouri","Andrew County",4,71,202,102,100
050,29,003,"Missouri","Andrew County",4,72,189,97,92
050,29,003,"Missouri","Andrew County",4,73,161,83,78
050,29,003,"Missouri","Andrew County",4,74,172,80,92
050,29,003,"Missouri","Andrew County",4,75,184,88,96
050,29,003,"Missouri","Andrew County",4,76,132,57,75
050,29,003,"Missouri","Andrew County",4,77,114,52,62
050,29,003,"Missouri","Andrew County",4,78,129,61,68
050,29,003,"Missouri","Andrew County",4,79,140,73,67
050,29,003,"Missouri","Andrew County",4,80,121,59,62
050,29,003,"Missouri","Andrew County",4,81,100,49,51
050,29,003,"Missouri","Andrew County",4,82,84,35,49
050,29,003,"Missouri","Andrew County",4,83,74,29,45
050,29,003,"Missouri","Andrew County",4,84,68,25,43
050,29,003,"Missouri","Andrew County",4,85,377,139,238
050,29,003,"Missouri","Andrew County",5,0,167,81,86
050,29,003,"Missouri","Andrew County",5,1,171,86,85
050,29,003,"Missouri","Andrew County",5,2,187,98,89
050,29,003,"Missouri","Andrew County",5,3,177,86,91
050,29,003,"Missouri","Andrew County",5,4,218,117,101
050,29,003,"Missouri","Andrew County",5,5,215,106,109
050,29,003,"Missouri","Andrew County",5,6,227,120,107
050,29,003,"Missouri","Andrew County",5,7,221,102,119
050,29,003,"Missouri","Andrew County",5,8,240,135,105
050,29,003,"Missouri","Andrew County",5,9,246,125,121
050,29,003,"Missouri","Andrew County",5,10,255,125,130
050,29,003,"Missouri","Andrew County",5,11,269,131,138
050,29,003,"Missouri","Andrew County",5,12,246,124,122
050,29,003,"Missouri","Andrew County",5,13,257,144,113
050,29,003,"Missouri","Andrew County",5,14,247,123,124
050,29,003,"Missouri","Andrew County",5,15,265,135,130
050,29,003,"Missouri","Andrew County",5,16,243,120,123
050,29,003,"Missouri","Andrew County",5,17,224,113,111
050,29,003,"Missouri","Andrew County",5,18,198,101,97
050,29,003,"Missouri","Andrew County",5,19,172,88,84
050,29,003,"Missouri","Andrew County",5,20,171,88,83
050,29,003,"Missouri","Andrew County",5,21,162,89,73
050,29,003,"Missouri","Andrew County",5,22,182,98,84
050,29,003,"Missouri","Andrew County",5,23,198,96,102
050,29,003,"Missouri","Andrew County",5,24,197,100,97
050,29,003,"Missouri","Andrew County",5,25,187,95,92
050,29,003,"Missouri","Andrew County",5,26,179,88,91
050,29,003,"Missouri","Andrew County",5,27,168,91,77
050,29,003,"Missouri","Andrew County",5,28,167,87,80
050,29,003,"Missouri","Andrew County",5,29,196,96,100
050,29,003,"Missouri","Andrew County",5,30,219,116,103
050,29,003,"Missouri","Andrew County",5,31,214,103,111
050,29,003,"Missouri","Andrew County",5,32,210,106,104
050,29,003,"Missouri","Andrew County",5,33,240,124,116
050,29,003,"Missouri","Andrew County",5,34,251,122,129
050,29,003,"Missouri","Andrew County",5,35,216,112,104
050,29,003,"Missouri","Andrew County",5,36,214,112,102
050,29,003,"Missouri","Andrew County",5,37,210,111,99
050,29,003,"Missouri","Andrew County",5,38,218,105,113
050,29,003,"Missouri","Andrew County",5,39,212,97,115
050,29,003,"Missouri","Andrew County",5,40,239,119,120
050,29,003,"Missouri","Andrew County",5,41,239,120,119
050,29,003,"Missouri","Andrew County",5,42,269,133,136
050,29,003,"Missouri","Andrew County",5,43,236,115,121
050,29,003,"Missouri","Andrew County",5,44,237,117,120
050,29,003,"Missouri","Andrew County",5,45,241,118,123
050,29,003,"Missouri","Andrew County",5,46,208,109,99
050,29,003,"Missouri","Andrew County",5,47,197,100,97
050,29,003,"Missouri","Andrew County",5,48,222,106,116
050,29,003,"Missouri","Andrew County",5,49,189,93,96
050,29,003,"Missouri","Andrew County",5,50,205,107,98
050,29,003,"Missouri","Andrew County",5,51,224,122,102
050,29,003,"Missouri","Andrew County",5,52,242,126,116
050,29,003,"Missouri","Andrew County",5,53,233,113,120
050,29,003,"Missouri","Andrew County",5,54,222,122,100
050,29,003,"Missouri","Andrew County",5,55,214,113,101
050,29,003,"Missouri","Andrew County",5,56,228,118,110
050,29,003,"Missouri","Andrew County",5,57,241,126,115
050,29,003,"Missouri","Andrew County",5,58,254,132,122
050,29,003,"Missouri","Andrew County",5,59,248,122,126
050,29,003,"Missouri","Andrew County",5,60,253,135,118
050,29,003,"Missouri","Andrew County",5,61,245,117,128
050,29,003,"Missouri","Andrew County",5,62,273,133,140
050,29,003,"Missouri","Andrew County",5,63,266,133,133
050,29,003,"Missouri","Andrew County",5,64,259,132,127
050,29,003,"Missouri","Andrew County",5,65,251,126,125
050,29,003,"Missouri","Andrew County",5,66,265,126,139
050,29,003,"Missouri","Andrew County",5,67,238,107,131
050,29,003,"Missouri","Andrew County",5,68,236,105,131
050,29,003,"Missouri","Andrew County",5,69,246,125,121
050,29,003,"Missouri","Andrew County",5,70,218,118,100
050,29,003,"Missouri","Andrew County",5,71,201,105,96
050,29,003,"Missouri","Andrew County",5,72,196,100,96
050,29,003,"Missouri","Andrew County",5,73,184,93,91
050,29,003,"Missouri","Andrew County",5,74,151,71,80
050,29,003,"Missouri","Andrew County",5,75,171,79,92
050,29,003,"Missouri","Andrew County",5,76,180,84,96
050,29,003,"Missouri","Andrew County",5,77,122,53,69
050,29,003,"Missouri","Andrew County",5,78,113,52,61
050,29,003,"Missouri","Andrew County",5,79,125,58,67
050,29,003,"Missouri","Andrew County",5,80,136,71,65
050,29,003,"Missouri","Andrew County",5,81,111,55,56
050,29,003,"Missouri","Andrew County",5,82,93,42,51
050,29,003,"Missouri","Andrew County",5,83,81,33,48
050,29,003,"Missouri","Andrew County",5,84,74,28,46
050,29,003,"Missouri","Andrew County",5,85,395,139,256
050,29,005,"Missouri","Atchison County",1,0,47,23,24
050,29,005,"Missouri","Atchison County",1,1,46,20,26
050,29,005,"Missouri","Atchison County",1,2,49,28,21
050,29,005,"Missouri","Atchison County",1,3,53,28,25
050,29,005,"Missouri","Atchison County",1,4,60,29,31
050,29,005,"Missouri","Atchison County",1,5,59,28,31
050,29,005,"Missouri","Atchison County",1,6,54,29,25
050,29,005,"Missouri","Atchison County",1,7,63,32,31
050,29,005,"Missouri","Atchison County",1,8,58,34,24
050,29,005,"Missouri","Atchison County",1,9,67,32,35
050,29,005,"Missouri","Atchison County",1,10,77,43,34
050,29,005,"Missouri","Atchison County",1,11,65,37,28
050,29,005,"Missouri","Atchison County",1,12,61,32,29
050,29,005,"Missouri","Atchison County",1,13,68,34,34
050,29,005,"Missouri","Atchison County",1,14,58,28,30
050,29,005,"Missouri","Atchison County",1,15,63,34,29
050,29,005,"Missouri","Atchison County",1,16,67,33,34
050,29,005,"Missouri","Atchison County",1,17,69,33,36
050,29,005,"Missouri","Atchison County",1,18,59,31,28
050,29,005,"Missouri","Atchison County",1,19,43,25,18
050,29,005,"Missouri","Atchison County",1,20,38,18,20
050,29,005,"Missouri","Atchison County",1,21,42,17,25
050,29,005,"Missouri","Atchison County",1,22,37,13,24
050,29,005,"Missouri","Atchison County",1,23,38,17,21
050,29,005,"Missouri","Atchison County",1,24,52,28,24
050,29,005,"Missouri","Atchison County",1,25,59,32,27
050,29,005,"Missouri","Atchison County",1,26,62,32,30
050,29,005,"Missouri","Atchison County",1,27,48,26,22
050,29,005,"Missouri","Atchison County",1,28,57,24,33
050,29,005,"Missouri","Atchison County",1,29,61,26,35
050,29,005,"Missouri","Atchison County",1,30,67,34,33
050,29,005,"Missouri","Atchison County",1,31,60,32,28
050,29,005,"Missouri","Atchison County",1,32,45,21,24
050,29,005,"Missouri","Atchison County",1,33,57,33,24
050,29,005,"Missouri","Atchison County",1,34,43,22,21
050,29,005,"Missouri","Atchison County",1,35,51,22,29
050,29,005,"Missouri","Atchison County",1,36,54,27,27
050,29,005,"Missouri","Atchison County",1,37,61,34,27
050,29,005,"Missouri","Atchison County",1,38,68,37,31
050,29,005,"Missouri","Atchison County",1,39,64,34,30
050,29,005,"Missouri","Atchison County",1,40,54,30,24
050,29,005,"Missouri","Atchison County",1,41,52,24,28
050,29,005,"Missouri","Atchison County",1,42,58,32,26
050,29,005,"Missouri","Atchison County",1,43,58,35,23
050,29,005,"Missouri","Atchison County",1,44,52,28,24
050,29,005,"Missouri","Atchison County",1,45,59,30,29
050,29,005,"Missouri","Atchison County",1,46,65,29,36
050,29,005,"Missouri","Atchison County",1,47,62,31,31
050,29,005,"Missouri","Atchison County",1,48,59,31,28
050,29,005,"Missouri","Atchison County",1,49,63,35,28
050,29,005,"Missouri","Atchison County",1,50,70,38,32
050,29,005,"Missouri","Atchison County",1,51,75,42,33
050,29,005,"Missouri","Atchison County",1,52,63,36,27
050,29,005,"Missouri","Atchison County",1,53,59,27,32
050,29,005,"Missouri","Atchison County",1,54,75,34,41
050,29,005,"Missouri","Atchison County",1,55,88,40,48
050,29,005,"Missouri","Atchison County",1,56,81,43,38
050,29,005,"Missouri","Atchison County",1,57,75,41,34
050,29,005,"Missouri","Atchison County",1,58,80,45,35
050,29,005,"Missouri","Atchison County",1,59,77,44,33
050,29,005,"Missouri","Atchison County",1,60,84,44,40
050,29,005,"Missouri","Atchison County",1,61,75,33,42
050,29,005,"Missouri","Atchison County",1,62,82,41,41
050,29,005,"Missouri","Atchison County",1,63,81,41,40
050,29,005,"Missouri","Atchison County",1,64,73,37,36
050,29,005,"Missouri","Atchison County",1,65,89,44,45
050,29,005,"Missouri","Atchison County",1,66,80,42,38
050,29,005,"Missouri","Atchison County",1,67,67,36,31
050,29,005,"Missouri","Atchison County",1,68,69,35,34
050,29,005,"Missouri","Atchison County",1,69,66,33,33
050,29,005,"Missouri","Atchison County",1,70,67,35,32
050,29,005,"Missouri","Atchison County",1,71,67,35,32
050,29,005,"Missouri","Atchison County",1,72,71,37,34
050,29,005,"Missouri","Atchison County",1,73,89,39,50
050,29,005,"Missouri","Atchison County",1,74,66,33,33
050,29,005,"Missouri","Atchison County",1,75,68,33,35
050,29,005,"Missouri","Atchison County",1,76,63,36,27
050,29,005,"Missouri","Atchison County",1,77,57,29,28
050,29,005,"Missouri","Atchison County",1,78,47,20,27
050,29,005,"Missouri","Atchison County",1,79,43,17,26
050,29,005,"Missouri","Atchison County",1,80,36,17,19
050,29,005,"Missouri","Atchison County",1,81,32,18,14
050,29,005,"Missouri","Atchison County",1,82,29,17,12
050,29,005,"Missouri","Atchison County",1,83,26,12,14
050,29,005,"Missouri","Atchison County",1,84,25,10,15
050,29,005,"Missouri","Atchison County",1,85,177,44,133
050,29,005,"Missouri","Atchison County",2,0,51,28,23
050,29,005,"Missouri","Atchison County",2,1,46,21,25
050,29,005,"Missouri","Atchison County",2,2,49,26,23
050,29,005,"Missouri","Atchison County",2,3,52,28,24
050,29,005,"Missouri","Atchison County",2,4,59,29,30
050,29,005,"Missouri","Atchison County",2,5,59,28,31
050,29,005,"Missouri","Atchison County",2,6,55,28,27
050,29,005,"Missouri","Atchison County",2,7,60,31,29
050,29,005,"Missouri","Atchison County",2,8,59,33,26
050,29,005,"Missouri","Atchison County",2,9,66,34,32
050,29,005,"Missouri","Atchison County",2,10,75,41,34
050,29,005,"Missouri","Atchison County",2,11,68,39,29
050,29,005,"Missouri","Atchison County",2,12,62,33,29
050,29,005,"Missouri","Atchison County",2,13,65,32,33
050,29,005,"Missouri","Atchison County",2,14,61,30,31
050,29,005,"Missouri","Atchison County",2,15,62,33,29
050,29,005,"Missouri","Atchison County",2,16,67,34,33
050,29,005,"Missouri","Atchison County",2,17,68,32,36
050,29,005,"Missouri","Atchison County",2,18,57,29,28
050,29,005,"Missouri","Atchison County",2,19,44,25,19
050,29,005,"Missouri","Atchison County",2,20,41,20,21
050,29,005,"Missouri","Atchison County",2,21,42,17,25
050,29,005,"Missouri","Atchison County",2,22,38,13,25
050,29,005,"Missouri","Atchison County",2,23,38,17,21
050,29,005,"Missouri","Atchison County",2,24,49,25,24
050,29,005,"Missouri","Atchison County",2,25,58,32,26
050,29,005,"Missouri","Atchison County",2,26,61,32,29
050,29,005,"Missouri","Atchison County",2,27,51,27,24
050,29,005,"Missouri","Atchison County",2,28,55,24,31
050,29,005,"Missouri","Atchison County",2,29,60,26,34
050,29,005,"Missouri","Atchison County",2,30,65,32,33
050,29,005,"Missouri","Atchison County",2,31,63,33,30
050,29,005,"Missouri","Atchison County",2,32,49,24,25
050,29,005,"Missouri","Atchison County",2,33,54,30,24
050,29,005,"Missouri","Atchison County",2,34,46,24,22
050,29,005,"Missouri","Atchison County",2,35,51,23,28
050,29,005,"Missouri","Atchison County",2,36,54,26,28
050,29,005,"Missouri","Atchison County",2,37,59,32,27
050,29,005,"Missouri","Atchison County",2,38,67,36,31
050,29,005,"Missouri","Atchison County",2,39,66,36,30
050,29,005,"Missouri","Atchison County",2,40,56,31,25
050,29,005,"Missouri","Atchison County",2,41,52,25,27
050,29,005,"Missouri","Atchison County",2,42,55,30,25
050,29,005,"Missouri","Atchison County",2,43,59,35,24
050,29,005,"Missouri","Atchison County",2,44,53,30,23
050,29,005,"Missouri","Atchison County",2,45,58,30,28
050,29,005,"Missouri","Atchison County",2,46,63,29,34
050,29,005,"Missouri","Atchison County",2,47,63,30,33
050,29,005,"Missouri","Atchison County",2,48,60,31,29
050,29,005,"Missouri","Atchison County",2,49,63,34,29
050,29,005,"Missouri","Atchison County",2,50,68,38,30
050,29,005,"Missouri","Atchison County",2,51,71,40,31
050,29,005,"Missouri","Atchison County",2,52,67,38,29
050,29,005,"Missouri","Atchison County",2,53,59,29,30
050,29,005,"Missouri","Atchison County",2,54,72,33,39
050,29,005,"Missouri","Atchison County",2,55,84,38,46
050,29,005,"Missouri","Atchison County",2,56,82,41,41
050,29,005,"Missouri","Atchison County",2,57,77,42,35
050,29,005,"Missouri","Atchison County",2,58,79,44,35
050,29,005,"Missouri","Atchison County",2,59,80,45,35
050,29,005,"Missouri","Atchison County",2,60,82,44,38
050,29,005,"Missouri","Atchison County",2,61,77,36,41
050,29,005,"Missouri","Atchison County",2,62,79,39,40
050,29,005,"Missouri","Atchison County",2,63,81,41,40
050,29,005,"Missouri","Atchison County",2,64,74,38,36
050,29,005,"Missouri","Atchison County",2,65,85,42,43
050,29,005,"Missouri","Atchison County",2,66,83,43,40
050,29,005,"Missouri","Atchison County",2,67,68,37,31
050,29,005,"Missouri","Atchison County",2,68,69,36,33
050,29,005,"Missouri","Atchison County",2,69,65,32,33
050,29,005,"Missouri","Atchison County",2,70,67,35,32
050,29,005,"Missouri","Atchison County",2,71,67,35,32
050,29,005,"Missouri","Atchison County",2,72,69,36,33
050,29,005,"Missouri","Atchison County",2,73,88,39,49
050,29,005,"Missouri","Atchison County",2,74,67,32,35
050,29,005,"Missouri","Atchison County",2,75,68,33,35
050,29,005,"Missouri","Atchison County",2,76,62,35,27
050,29,005,"Missouri","Atchison County",2,77,60,31,29
050,29,005,"Missouri","Atchison County",2,78,47,20,27
050,29,005,"Missouri","Atchison County",2,79,44,18,26
050,29,005,"Missouri","Atchison County",2,80,38,17,21
050,29,005,"Missouri","Atchison County",2,81,32,17,15
050,29,005,"Missouri","Atchison County",2,82,29,17,12
050,29,005,"Missouri","Atchison County",2,83,28,14,14
050,29,005,"Missouri","Atchison County",2,84,24,9,15
050,29,005,"Missouri","Atchison County",2,85,180,46,134
050,29,005,"Missouri","Atchison County",3,0,39,21,18
050,29,005,"Missouri","Atchison County",3,1,47,28,19
050,29,005,"Missouri","Atchison County",3,2,50,23,27
050,29,005,"Missouri","Atchison County",3,3,49,27,22
050,29,005,"Missouri","Atchison County",3,4,50,27,23
050,29,005,"Missouri","Atchison County",3,5,58,30,28
050,29,005,"Missouri","Atchison County",3,6,57,26,31
050,29,005,"Missouri","Atchison County",3,7,60,30,30
050,29,005,"Missouri","Atchison County",3,8,60,34,26
050,29,005,"Missouri","Atchison County",3,9,64,36,28
050,29,005,"Missouri","Atchison County",3,10,69,36,33
050,29,005,"Missouri","Atchison County",3,11,72,39,33
050,29,005,"Missouri","Atchison County",3,12,64,36,28
050,29,005,"Missouri","Atchison County",3,13,62,33,29
050,29,005,"Missouri","Atchison County",3,14,67,34,33
050,29,005,"Missouri","Atchison County",3,15,63,32,31
050,29,005,"Missouri","Atchison County",3,16,62,33,29
050,29,005,"Missouri","Atchison County",3,17,66,33,33
050,29,005,"Missouri","Atchison County",3,18,55,27,28
050,29,005,"Missouri","Atchison County",3,19,44,23,21
050,29,005,"Missouri","Atchison County",3,20,42,27,15
050,29,005,"Missouri","Atchison County",3,21,44,21,23
050,29,005,"Missouri","Atchison County",3,22,41,19,22
050,29,005,"Missouri","Atchison County",3,23,38,12,26
050,29,005,"Missouri","Atchison County",3,24,40,20,20
050,29,005,"Missouri","Atchison County",3,25,51,27,24
050,29,005,"Missouri","Atchison County",3,26,61,35,26
050,29,005,"Missouri","Atchison County",3,27,60,34,26
050,29,005,"Missouri","Atchison County",3,28,48,26,22
050,29,005,"Missouri","Atchison County",3,29,59,27,32
050,29,005,"Missouri","Atchison County",3,30,55,26,29
050,29,005,"Missouri","Atchison County",3,31,61,30,31
050,29,005,"Missouri","Atchison County",3,32,59,29,30
050,29,005,"Missouri","Atchison County",3,33,46,24,22
050,29,005,"Missouri","Atchison County",3,34,54,31,23
050,29,005,"Missouri","Atchison County",3,35,44,23,21
050,29,005,"Missouri","Atchison County",3,36,51,22,29
050,29,005,"Missouri","Atchison County",3,37,53,26,27
050,29,005,"Missouri","Atchison County",3,38,58,29,29
050,29,005,"Missouri","Atchison County",3,39,63,32,31
050,29,005,"Missouri","Atchison County",3,40,66,36,30
050,29,005,"Missouri","Atchison County",3,41,56,31,25
050,29,005,"Missouri","Atchison County",3,42,56,26,30
050,29,005,"Missouri","Atchison County",3,43,55,30,25
050,29,005,"Missouri","Atchison County",3,44,58,33,25
050,29,005,"Missouri","Atchison County",3,45,56,31,25
050,29,005,"Missouri","Atchison County",3,46,60,31,29
050,29,005,"Missouri","Atchison County",3,47,66,30,36
050,29,005,"Missouri","Atchison County",3,48,64,30,34
050,29,005,"Missouri","Atchison County",3,49,60,31,29
050,29,005,"Missouri","Atchison County",3,50,64,34,30
050,29,005,"Missouri","Atchison County",3,51,65,36,29
050,29,005,"Missouri","Atchison County",3,52,71,41,30
050,29,005,"Missouri","Atchison County",3,53,71,41,30
050,29,005,"Missouri","Atchison County",3,54,57,28,29
050,29,005,"Missouri","Atchison County",3,55,72,33,39
050,29,005,"Missouri","Atchison County",3,56,86,39,47
050,29,005,"Missouri","Atchison County",3,57,83,41,42
050,29,005,"Missouri","Atchison County",3,58,77,43,34
050,29,005,"Missouri","Atchison County",3,59,76,41,35
050,29,005,"Missouri","Atchison County",3,60,78,44,34
050,29,005,"Missouri","Atchison County",3,61,81,42,39
050,29,005,"Missouri","Atchison County",3,62,73,34,39
050,29,005,"Missouri","Atchison County",3,63,75,38,37
050,29,005,"Missouri","Atchison County",3,64,80,41,39
050,29,005,"Missouri","Atchison County",3,65,70,35,35
050,29,005,"Missouri","Atchison County",3,66,86,43,43
050,29,005,"Missouri","Atchison County",3,67,83,42,41
050,29,005,"Missouri","Atchison County",3,68,70,38,32
050,29,005,"Missouri","Atchison County",3,69,64,33,31
050,29,005,"Missouri","Atchison County",3,70,63,32,31
050,29,005,"Missouri","Atchison County",3,71,61,31,30
050,29,005,"Missouri","Atchison County",3,72,61,31,30
050,29,005,"Missouri","Atchison County",3,73,66,34,32
050,29,005,"Missouri","Atchison County",3,74,81,38,43
050,29,005,"Missouri","Atchison County",3,75,62,29,33
050,29,005,"Missouri","Atchison County",3,76,65,34,31
050,29,005,"Missouri","Atchison County",3,77,61,34,27
050,29,005,"Missouri","Atchison County",3,78,56,27,29
050,29,005,"Missouri","Atchison County",3,79,46,20,26
050,29,005,"Missouri","Atchison County",3,80,36,14,22
050,29,005,"Missouri","Atchison County",3,81,36,16,20
050,29,005,"Missouri","Atchison County",3,82,30,16,14
050,29,005,"Missouri","Atchison County",3,83,28,18,10
050,29,005,"Missouri","Atchison County",3,84,20,7,13
050,29,005,"Missouri","Atchison County",3,85,173,43,130
050,29,005,"Missouri","Atchison County",4,0,42,23,19
050,29,005,"Missouri","Atchison County",4,1,41,21,20
050,29,005,"Missouri","Atchison County",4,2,48,26,22
050,29,005,"Missouri","Atchison County",4,3,50,23,27
050,29,005,"Missouri","Atchison County",4,4,48,26,22
050,29,005,"Missouri","Atchison County",4,5,57,32,25
050,29,005,"Missouri","Atchison County",4,6,58,31,27
050,29,005,"Missouri","Atchison County",4,7,60,27,33
050,29,005,"Missouri","Atchison County",4,8,56,27,29
050,29,005,"Missouri","Atchison County",4,9,62,35,27
050,29,005,"Missouri","Atchison County",4,10,67,37,30
050,29,005,"Missouri","Atchison County",4,11,65,31,34
050,29,005,"Missouri","Atchison County",4,12,71,39,32
050,29,005,"Missouri","Atchison County",4,13,62,35,27
050,29,005,"Missouri","Atchison County",4,14,61,33,28
050,29,005,"Missouri","Atchison County",4,15,68,36,32
050,29,005,"Missouri","Atchison County",4,16,62,32,30
050,29,005,"Missouri","Atchison County",4,17,61,33,28
050,29,005,"Missouri","Atchison County",4,18,57,30,27
050,29,005,"Missouri","Atchison County",4,19,45,21,24
050,29,005,"Missouri","Atchison County",4,20,38,18,20
050,29,005,"Missouri","Atchison County",4,21,40,25,15
050,29,005,"Missouri","Atchison County",4,22,45,20,25
050,29,005,"Missouri","Atchison County",4,23,45,19,26
050,29,005,"Missouri","Atchison County",4,24,32,11,21
050,29,005,"Missouri","Atchison County",4,25,46,23,23
050,29,005,"Missouri","Atchison County",4,26,54,24,30
050,29,005,"Missouri","Atchison County",4,27,60,35,25
050,29,005,"Missouri","Atchison County",4,28,61,33,28
050,29,005,"Missouri","Atchison County",4,29,45,23,22
050,29,005,"Missouri","Atchison County",4,30,60,31,29
050,29,005,"Missouri","Atchison County",4,31,54,22,32
050,29,005,"Missouri","Atchison County",4,32,64,29,35
050,29,005,"Missouri","Atchison County",4,33,61,32,29
050,29,005,"Missouri","Atchison County",4,34,45,24,21
050,29,005,"Missouri","Atchison County",4,35,54,31,23
050,29,005,"Missouri","Atchison County",4,36,45,24,21
050,29,005,"Missouri","Atchison County",4,37,53,23,30
050,29,005,"Missouri","Atchison County",4,38,49,24,25
050,29,005,"Missouri","Atchison County",4,39,56,28,28
050,29,005,"Missouri","Atchison County",4,40,68,35,33
050,29,005,"Missouri","Atchison County",4,41,71,41,30
050,29,005,"Missouri","Atchison County",4,42,62,36,26
050,29,005,"Missouri","Atchison County",4,43,56,25,31
050,29,005,"Missouri","Atchison County",4,44,54,29,25
050,29,005,"Missouri","Atchison County",4,45,64,39,25
050,29,005,"Missouri","Atchison County",4,46,58,32,26
050,29,005,"Missouri","Atchison County",4,47,57,28,29
050,29,005,"Missouri","Atchison County",4,48,69,33,36
050,29,005,"Missouri","Atchison County",4,49,58,29,29
050,29,005,"Missouri","Atchison County",4,50,66,34,32
050,29,005,"Missouri","Atchison County",4,51,64,35,29
050,29,005,"Missouri","Atchison County",4,52,65,36,29
050,29,005,"Missouri","Atchison County",4,53,69,39,30
050,29,005,"Missouri","Atchison County",4,54,68,41,27
050,29,005,"Missouri","Atchison County",4,55,55,28,27
050,29,005,"Missouri","Atchison County",4,56,69,31,38
050,29,005,"Missouri","Atchison County",4,57,87,38,49
050,29,005,"Missouri","Atchison County",4,58,86,42,44
050,29,005,"Missouri","Atchison County",4,59,78,42,36
050,29,005,"Missouri","Atchison County",4,60,76,42,34
050,29,005,"Missouri","Atchison County",4,61,76,43,33
050,29,005,"Missouri","Atchison County",4,62,77,39,38
050,29,005,"Missouri","Atchison County",4,63,70,32,38
050,29,005,"Missouri","Atchison County",4,64,72,38,34
050,29,005,"Missouri","Atchison County",4,65,77,37,40
050,29,005,"Missouri","Atchison County",4,66,66,31,35
050,29,005,"Missouri","Atchison County",4,67,84,38,46
050,29,005,"Missouri","Atchison County",4,68,85,45,40
050,29,005,"Missouri","Atchison County",4,69,69,37,32
050,29,005,"Missouri","Atchison County",4,70,64,34,30
050,29,005,"Missouri","Atchison County",4,71,63,31,32
050,29,005,"Missouri","Atchison County",4,72,60,30,30
050,29,005,"Missouri","Atchison County",4,73,57,27,30
050,29,005,"Missouri","Atchison County",4,74,64,33,31
050,29,005,"Missouri","Atchison County",4,75,74,35,39
050,29,005,"Missouri","Atchison County",4,76,59,28,31
050,29,005,"Missouri","Atchison County",4,77,65,33,32
050,29,005,"Missouri","Atchison County",4,78,56,31,25
050,29,005,"Missouri","Atchison County",4,79,50,25,25
050,29,005,"Missouri","Atchison County",4,80,38,17,21
050,29,005,"Missouri","Atchison County",4,81,35,13,22
050,29,005,"Missouri","Atchison County",4,82,34,14,20
050,29,005,"Missouri","Atchison County",4,83,30,18,12
050,29,005,"Missouri","Atchison County",4,84,25,15,10
050,29,005,"Missouri","Atchison County",4,85,163,40,123
050,29,005,"Missouri","Atchison County",5,0,46,25,21
050,29,005,"Missouri","Atchison County",5,1,41,24,17
050,29,005,"Missouri","Atchison County",5,2,42,21,21
050,29,005,"Missouri","Atchison County",5,3,52,30,22
050,29,005,"Missouri","Atchison County",5,4,49,23,26
050,29,005,"Missouri","Atchison County",5,5,49,25,24
050,29,005,"Missouri","Atchison County",5,6,56,30,26
050,29,005,"Missouri","Atchison County",5,7,59,31,28
050,29,005,"Missouri","Atchison County",5,8,62,27,35
050,29,005,"Missouri","Atchison County",5,9,52,21,31
050,29,005,"Missouri","Atchison County",5,10,66,39,27
050,29,005,"Missouri","Atchison County",5,11,66,34,32
050,29,005,"Missouri","Atchison County",5,12,66,32,34
050,29,005,"Missouri","Atchison County",5,13,67,35,32
050,29,005,"Missouri","Atchison County",5,14,65,35,30
050,29,005,"Missouri","Atchison County",5,15,57,26,31
050,29,005,"Missouri","Atchison County",5,16,69,36,33
050,29,005,"Missouri","Atchison County",5,17,66,38,28
050,29,005,"Missouri","Atchison County",5,18,53,32,21
050,29,005,"Missouri","Atchison County",5,19,38,18,20
050,29,005,"Missouri","Atchison County",5,20,46,22,24
050,29,005,"Missouri","Atchison County",5,21,43,19,24
050,29,005,"Missouri","Atchison County",5,22,40,23,17
050,29,005,"Missouri","Atchison County",5,23,45,22,23
050,29,005,"Missouri","Atchison County",5,24,48,26,22
050,29,005,"Missouri","Atchison County",5,25,36,11,25
050,29,005,"Missouri","Atchison County",5,26,44,22,22
050,29,005,"Missouri","Atchison County",5,27,52,25,27
050,29,005,"Missouri","Atchison County",5,28,59,34,25
050,29,005,"Missouri","Atchison County",5,29,62,32,30
050,29,005,"Missouri","Atchison County",5,30,47,25,22
050,29,005,"Missouri","Atchison County",5,31,60,29,31
050,29,005,"Missouri","Atchison County",5,32,53,21,32
050,29,005,"Missouri","Atchison County",5,33,63,29,34
050,29,005,"Missouri","Atchison County",5,34,57,30,27
050,29,005,"Missouri","Atchison County",5,35,47,24,23
050,29,005,"Missouri","Atchison County",5,36,54,30,24
050,29,005,"Missouri","Atchison County",5,37,45,24,21
050,29,005,"Missouri","Atchison County",5,38,55,23,32
050,29,005,"Missouri","Atchison County",5,39,47,22,25
050,29,005,"Missouri","Atchison County",5,40,61,33,28
050,29,005,"Missouri","Atchison County",5,41,66,35,31
050,29,005,"Missouri","Atchison County",5,42,71,41,30
050,29,005,"Missouri","Atchison County",5,43,62,35,27
050,29,005,"Missouri","Atchison County",5,44,55,25,30
050,29,005,"Missouri","Atchison County",5,45,51,25,26
050,29,005,"Missouri","Atchison County",5,46,62,38,24
050,29,005,"Missouri","Atchison County",5,47,60,34,26
050,29,005,"Missouri","Atchison County",5,48,57,28,29
050,29,005,"Missouri","Atchison County",5,49,65,33,32
050,29,005,"Missouri","Atchison County",5,50,55,29,26
050,29,005,"Missouri","Atchison County",5,51,66,34,32
050,29,005,"Missouri","Atchison County",5,52,63,35,28
050,29,005,"Missouri","Atchison County",5,53,71,39,32
050,29,005,"Missouri","Atchison County",5,54,67,39,28
050,29,005,"Missouri","Atchison County",5,55,69,41,28
050,29,005,"Missouri","Atchison County",5,56,57,28,29
050,29,005,"Missouri","Atchison County",5,57,70,33,37
050,29,005,"Missouri","Atchison County",5,58,89,41,48
050,29,005,"Missouri","Atchison County",5,59,80,38,42
050,29,005,"Missouri","Atchison County",5,60,76,43,33
050,29,005,"Missouri","Atchison County",5,61,76,42,34
050,29,005,"Missouri","Atchison County",5,62,79,45,34
050,29,005,"Missouri","Atchison County",5,63,71,34,37
050,29,005,"Missouri","Atchison County",5,64,72,32,40
050,29,005,"Missouri","Atchison County",5,65,68,37,31
050,29,005,"Missouri","Atchison County",5,66,76,37,39
050,29,005,"Missouri","Atchison County",5,67,62,26,36
050,29,005,"Missouri","Atchison County",5,68,86,40,46
050,29,005,"Missouri","Atchison County",5,69,78,41,37
050,29,005,"Missouri","Atchison County",5,70,66,35,31
050,29,005,"Missouri","Atchison County",5,71,63,32,31
050,29,005,"Missouri","Atchison County",5,72,61,31,30
050,29,005,"Missouri","Atchison County",5,73,58,28,30
050,29,005,"Missouri","Atchison County",5,74,55,27,28
050,29,005,"Missouri","Atchison County",5,75,59,31,28
050,29,005,"Missouri","Atchison County",5,76,72,36,36
050,29,005,"Missouri","Atchison County",5,77,61,29,32
050,29,005,"Missouri","Atchison County",5,78,61,30,31
050,29,005,"Missouri","Atchison County",5,79,54,30,24
050,29,005,"Missouri","Atchison County",5,80,46,23,23
050,29,005,"Missouri","Atchison County",5,81,38,16,22
050,29,005,"Missouri","Atchison County",5,82,30,10,20
050,29,005,"Missouri","Atchison County",5,83,33,16,17
050,29,005,"Missouri","Atchison County",5,84,25,14,11
050,29,005,"Missouri","Atchison County",5,85,160,45,115
050,29,007,"Missouri","Audrain County",1,0,294,151,143
050,29,007,"Missouri","Audrain County",1,1,306,158,148
050,29,007,"Missouri","Audrain County",1,2,315,160,155
050,29,007,"Missouri","Audrain County",1,3,310,158,152
050,29,007,"Missouri","Audrain County",1,4,301,155,146
050,29,007,"Missouri","Audrain County",1,5,319,149,170
050,29,007,"Missouri","Audrain County",1,6,298,156,142
050,29,007,"Missouri","Audrain County",1,7,309,166,143
050,29,007,"Missouri","Audrain County",1,8,285,150,135
050,29,007,"Missouri","Audrain County",1,9,274,139,135
050,29,007,"Missouri","Audrain County",1,10,301,161,140
050,29,007,"Missouri","Audrain County",1,11,312,159,153
050,29,007,"Missouri","Audrain County",1,12,315,164,151
050,29,007,"Missouri","Audrain County",1,13,336,181,155
050,29,007,"Missouri","Audrain County",1,14,357,213,144
050,29,007,"Missouri","Audrain County",1,15,333,190,143
050,29,007,"Missouri","Audrain County",1,16,374,214,160
050,29,007,"Missouri","Audrain County",1,17,386,233,153
050,29,007,"Missouri","Audrain County",1,18,301,168,133
050,29,007,"Missouri","Audrain County",1,19,238,132,106
050,29,007,"Missouri","Audrain County",1,20,225,115,110
050,29,007,"Missouri","Audrain County",1,21,258,109,149
050,29,007,"Missouri","Audrain County",1,22,273,126,147
050,29,007,"Missouri","Audrain County",1,23,280,129,151
050,29,007,"Missouri","Audrain County",1,24,301,124,177
050,29,007,"Missouri","Audrain County",1,25,337,134,203
050,29,007,"Missouri","Audrain County",1,26,331,145,186
050,29,007,"Missouri","Audrain County",1,27,310,137,173
050,29,007,"Missouri","Audrain County",1,28,335,130,205
050,29,007,"Missouri","Audrain County",1,29,340,134,206
050,29,007,"Missouri","Audrain County",1,30,314,120,194
050,29,007,"Missouri","Audrain County",1,31,285,127,158
050,29,007,"Missouri","Audrain County",1,32,307,128,179
050,29,007,"Missouri","Audrain County",1,33,298,112,186
050,29,007,"Missouri","Audrain County",1,34,314,123,191
050,29,007,"Missouri","Audrain County",1,35,316,135,181
050,29,007,"Missouri","Audrain County",1,36,313,142,171
050,29,007,"Missouri","Audrain County",1,37,360,155,205
050,29,007,"Missouri","Audrain County",1,38,321,135,186
050,29,007,"Missouri","Audrain County",1,39,307,137,170
050,29,007,"Missouri","Audrain County",1,40,303,140,163
050,29,007,"Missouri","Audrain County",1,41,308,147,161
050,29,007,"Missouri","Audrain County",1,42,321,144,177
050,29,007,"Missouri","Audrain County",1,43,297,125,172
050,29,007,"Missouri","Audrain County",1,44,291,118,173
050,29,007,"Missouri","Audrain County",1,45,314,135,179
050,29,007,"Missouri","Audrain County",1,46,304,134,170
050,29,007,"Missouri","Audrain County",1,47,298,134,164
050,29,007,"Missouri","Audrain County",1,48,318,162,156
050,29,007,"Missouri","Audrain County",1,49,306,150,156
050,29,007,"Missouri","Audrain County",1,50,291,145,146
050,29,007,"Missouri","Audrain County",1,51,298,144,154
050,29,007,"Missouri","Audrain County",1,52,264,121,143
050,29,007,"Missouri","Audrain County",1,53,294,135,159
050,29,007,"Missouri","Audrain County",1,54,307,156,151
050,29,007,"Missouri","Audrain County",1,55,332,164,168
050,29,007,"Missouri","Audrain County",1,56,348,168,180
050,29,007,"Missouri","Audrain County",1,57,354,169,185
050,29,007,"Missouri","Audrain County",1,58,352,172,180
050,29,007,"Missouri","Audrain County",1,59,346,164,182
050,29,007,"Missouri","Audrain County",1,60,363,176,187
050,29,007,"Missouri","Audrain County",1,61,359,182,177
050,29,007,"Missouri","Audrain County",1,62,368,184,184
050,29,007,"Missouri","Audrain County",1,63,340,165,175
050,29,007,"Missouri","Audrain County",1,64,328,160,168
050,29,007,"Missouri","Audrain County",1,65,306,150,156
050,29,007,"Missouri","Audrain County",1,66,281,144,137
050,29,007,"Missouri","Audrain County",1,67,284,130,154
050,29,007,"Missouri","Audrain County",1,68,290,126,164
050,29,007,"Missouri","Audrain County",1,69,263,123,140
050,29,007,"Missouri","Audrain County",1,70,274,133,141
050,29,007,"Missouri","Audrain County",1,71,262,128,134
050,29,007,"Missouri","Audrain County",1,72,252,127,125
050,29,007,"Missouri","Audrain County",1,73,231,115,116
050,29,007,"Missouri","Audrain County",1,74,160,78,82
050,29,007,"Missouri","Audrain County",1,75,187,95,92
050,29,007,"Missouri","Audrain County",1,76,188,92,96
050,29,007,"Missouri","Audrain County",1,77,170,74,96
050,29,007,"Missouri","Audrain County",1,78,151,69,82
050,29,007,"Missouri","Audrain County",1,79,155,66,89
050,29,007,"Missouri","Audrain County",1,80,144,51,93
050,29,007,"Missouri","Audrain County",1,81,122,45,77
050,29,007,"Missouri","Audrain County",1,82,99,39,60
050,29,007,"Missouri","Audrain County",1,83,97,36,61
050,29,007,"Missouri","Audrain County",1,84,111,40,71
050,29,007,"Missouri","Audrain County",1,85,539,120,419
050,29,007,"Missouri","Audrain County",2,0,281,143,138
050,29,007,"Missouri","Audrain County",2,1,304,156,148
050,29,007,"Missouri","Audrain County",2,2,311,159,152
050,29,007,"Missouri","Audrain County",2,3,309,159,150
050,29,007,"Missouri","Audrain County",2,4,301,154,147
050,29,007,"Missouri","Audrain County",2,5,312,150,162
050,29,007,"Missouri","Audrain County",2,6,305,155,150
050,29,007,"Missouri","Audrain County",2,7,307,163,144
050,29,007,"Missouri","Audrain County",2,8,290,151,139
050,29,007,"Missouri","Audrain County",2,9,278,142,136
050,29,007,"Missouri","Audrain County",2,10,293,154,139
050,29,007,"Missouri","Audrain County",2,11,308,159,149
050,29,007,"Missouri","Audrain County",2,12,316,165,151
050,29,007,"Missouri","Audrain County",2,13,333,179,154
050,29,007,"Missouri","Audrain County",2,14,357,211,146
050,29,007,"Missouri","Audrain County",2,15,337,193,144
050,29,007,"Missouri","Audrain County",2,16,369,214,155
050,29,007,"Missouri","Audrain County",2,17,385,228,157
050,29,007,"Missouri","Audrain County",2,18,300,170,130
050,29,007,"Missouri","Audrain County",2,19,235,127,108
050,29,007,"Missouri","Audrain County",2,20,235,121,114
050,29,007,"Missouri","Audrain County",2,21,254,109,145
050,29,007,"Missouri","Audrain County",2,22,266,122,144
050,29,007,"Missouri","Audrain County",2,23,279,130,149
050,29,007,"Missouri","Audrain County",2,24,292,124,168
050,29,007,"Missouri","Audrain County",2,25,324,130,194
050,29,007,"Missouri","Audrain County",2,26,325,144,181
050,29,007,"Missouri","Audrain County",2,27,312,138,174
050,29,007,"Missouri","Audrain County",2,28,329,133,196
050,29,007,"Missouri","Audrain County",2,29,329,131,198
050,29,007,"Missouri","Audrain County",2,30,318,125,193
050,29,007,"Missouri","Audrain County",2,31,283,125,158
050,29,007,"Missouri","Audrain County",2,32,301,129,172
050,29,007,"Missouri","Audrain County",2,33,297,117,180
050,29,007,"Missouri","Audrain County",2,34,309,121,188
050,29,007,"Missouri","Audrain County",2,35,310,133,177
050,29,007,"Missouri","Audrain County",2,36,308,140,168
050,29,007,"Missouri","Audrain County",2,37,344,149,195
050,29,007,"Missouri","Audrain County",2,38,325,140,185
050,29,007,"Missouri","Audrain County",2,39,304,136,168
050,29,007,"Missouri","Audrain County",2,40,304,142,162
050,29,007,"Missouri","Audrain County",2,41,302,145,157
050,29,007,"Missouri","Audrain County",2,42,314,143,171
050,29,007,"Missouri","Audrain County",2,43,304,131,173
050,29,007,"Missouri","Audrain County",2,44,283,118,165
050,29,007,"Missouri","Audrain County",2,45,310,133,177
050,29,007,"Missouri","Audrain County",2,46,303,133,170
050,29,007,"Missouri","Audrain County",2,47,299,135,164
050,29,007,"Missouri","Audrain County",2,48,309,157,152
050,29,007,"Missouri","Audrain County",2,49,307,152,155
050,29,007,"Missouri","Audrain County",2,50,296,148,148
050,29,007,"Missouri","Audrain County",2,51,291,142,149
050,29,007,"Missouri","Audrain County",2,52,268,127,141
050,29,007,"Missouri","Audrain County",2,53,288,133,155
050,29,007,"Missouri","Audrain County",2,54,306,154,152
050,29,007,"Missouri","Audrain County",2,55,323,162,161
050,29,007,"Missouri","Audrain County",2,56,341,166,175
050,29,007,"Missouri","Audrain County",2,57,353,170,183
050,29,007,"Missouri","Audrain County",2,58,350,169,181
050,29,007,"Missouri","Audrain County",2,59,349,167,182
050,29,007,"Missouri","Audrain County",2,60,359,173,186
050,29,007,"Missouri","Audrain County",2,61,354,177,177
050,29,007,"Missouri","Audrain County",2,62,364,182,182
050,29,007,"Missouri","Audrain County",2,63,350,172,178
050,29,007,"Missouri","Audrain County",2,64,331,161,170
050,29,007,"Missouri","Audrain County",2,65,310,153,157
050,29,007,"Missouri","Audrain County",2,66,286,145,141
050,29,007,"Missouri","Audrain County",2,67,281,132,149
050,29,007,"Missouri","Audrain County",2,68,286,126,160
050,29,007,"Missouri","Audrain County",2,69,270,124,146
050,29,007,"Missouri","Audrain County",2,70,269,129,140
050,29,007,"Missouri","Audrain County",2,71,261,129,132
050,29,007,"Missouri","Audrain County",2,72,247,123,124
050,29,007,"Missouri","Audrain County",2,73,247,124,123
050,29,007,"Missouri","Audrain County",2,74,164,81,83
050,29,007,"Missouri","Audrain County",2,75,176,89,87
050,29,007,"Missouri","Audrain County",2,76,186,92,94
050,29,007,"Missouri","Audrain County",2,77,177,78,99
050,29,007,"Missouri","Audrain County",2,78,151,69,82
050,29,007,"Missouri","Audrain County",2,79,152,65,87
050,29,007,"Missouri","Audrain County",2,80,145,53,92
050,29,007,"Missouri","Audrain County",2,81,124,46,78
050,29,007,"Missouri","Audrain County",2,82,100,40,60
050,29,007,"Missouri","Audrain County",2,83,94,34,60
050,29,007,"Missouri","Audrain County",2,84,104,37,67
050,29,007,"Missouri","Audrain County",2,85,523,116,407
050,29,007,"Missouri","Audrain County",3,0,298,161,137
050,29,007,"Missouri","Audrain County",3,1,279,137,142
050,29,007,"Missouri","Audrain County",3,2,302,149,153
050,29,007,"Missouri","Audrain County",3,3,300,156,144
050,29,007,"Missouri","Audrain County",3,4,323,165,158
050,29,007,"Missouri","Audrain County",3,5,301,153,148
050,29,007,"Missouri","Audrain County",3,6,313,142,171
050,29,007,"Missouri","Audrain County",3,7,308,160,148
050,29,007,"Missouri","Audrain County",3,8,300,159,141
050,29,007,"Missouri","Audrain County",3,9,285,147,138
050,29,007,"Missouri","Audrain County",3,10,276,143,133
050,29,007,"Missouri","Audrain County",3,11,292,150,142
050,29,007,"Missouri","Audrain County",3,12,319,168,151
050,29,007,"Missouri","Audrain County",3,13,329,174,155
050,29,007,"Missouri","Audrain County",3,14,358,201,157
050,29,007,"Missouri","Audrain County",3,15,341,203,138
050,29,007,"Missouri","Audrain County",3,16,360,215,145
050,29,007,"Missouri","Audrain County",3,17,370,221,149
050,29,007,"Missouri","Audrain County",3,18,310,177,133
050,29,007,"Missouri","Audrain County",3,19,223,116,107
050,29,007,"Missouri","Audrain County",3,20,259,131,128
050,29,007,"Missouri","Audrain County",3,21,274,122,152
050,29,007,"Missouri","Audrain County",3,22,250,108,142
050,29,007,"Missouri","Audrain County",3,23,285,131,154
050,29,007,"Missouri","Audrain County",3,24,285,135,150
050,29,007,"Missouri","Audrain County",3,25,323,133,190
050,29,007,"Missouri","Audrain County",3,26,311,135,176
050,29,007,"Missouri","Audrain County",3,27,331,147,184
050,29,007,"Missouri","Audrain County",3,28,330,143,187
050,29,007,"Missouri","Audrain County",3,29,316,132,184
050,29,007,"Missouri","Audrain County",3,30,351,141,210
050,29,007,"Missouri","Audrain County",3,31,310,131,179
050,29,007,"Missouri","Audrain County",3,32,289,123,166
050,29,007,"Missouri","Audrain County",3,33,315,137,178
050,29,007,"Missouri","Audrain County",3,34,316,123,193
050,29,007,"Missouri","Audrain County",3,35,305,126,179
050,29,007,"Missouri","Audrain County",3,36,319,131,188
050,29,007,"Missouri","Audrain County",3,37,332,140,192
050,29,007,"Missouri","Audrain County",3,38,340,146,194
050,29,007,"Missouri","Audrain County",3,39,336,145,191
050,29,007,"Missouri","Audrain County",3,40,298,135,163
050,29,007,"Missouri","Audrain County",3,41,300,140,160
050,29,007,"Missouri","Audrain County",3,42,326,158,168
050,29,007,"Missouri","Audrain County",3,43,314,143,171
050,29,007,"Missouri","Audrain County",3,44,300,135,165
050,29,007,"Missouri","Audrain County",3,45,292,120,172
050,29,007,"Missouri","Audrain County",3,46,304,138,166
050,29,007,"Missouri","Audrain County",3,47,311,132,179
050,29,007,"Missouri","Audrain County",3,48,305,144,161
050,29,007,"Missouri","Audrain County",3,49,295,147,148
050,29,007,"Missouri","Audrain County",3,50,316,160,156
050,29,007,"Missouri","Audrain County",3,51,286,141,145
050,29,007,"Missouri","Audrain County",3,52,288,145,143
050,29,007,"Missouri","Audrain County",3,53,267,121,146
050,29,007,"Missouri","Audrain County",3,54,292,140,152
050,29,007,"Missouri","Audrain County",3,55,305,149,156
050,29,007,"Missouri","Audrain County",3,56,305,151,154
050,29,007,"Missouri","Audrain County",3,57,347,166,181
050,29,007,"Missouri","Audrain County",3,58,347,172,175
050,29,007,"Missouri","Audrain County",3,59,350,166,184
050,29,007,"Missouri","Audrain County",3,60,353,169,184
050,29,007,"Missouri","Audrain County",3,61,351,169,182
050,29,007,"Missouri","Audrain County",3,62,360,181,179
050,29,007,"Missouri","Audrain County",3,63,373,189,184
050,29,007,"Missouri","Audrain County",3,64,346,167,179
050,29,007,"Missouri","Audrain County",3,65,326,159,167
050,29,007,"Missouri","Audrain County",3,66,302,145,157
050,29,007,"Missouri","Audrain County",3,67,286,141,145
050,29,007,"Missouri","Audrain County",3,68,272,130,142
050,29,007,"Missouri","Audrain County",3,69,280,125,155
050,29,007,"Missouri","Audrain County",3,70,259,117,142
050,29,007,"Missouri","Audrain County",3,71,261,127,134
050,29,007,"Missouri","Audrain County",3,72,244,118,126
050,29,007,"Missouri","Audrain County",3,73,237,118,119
050,29,007,"Missouri","Audrain County",3,74,236,119,117
050,29,007,"Missouri","Audrain County",3,75,152,76,76
050,29,007,"Missouri","Audrain County",3,76,168,84,84
050,29,007,"Missouri","Audrain County",3,77,177,88,89
050,29,007,"Missouri","Audrain County",3,78,164,75,89
050,29,007,"Missouri","Audrain County",3,79,145,58,87
050,29,007,"Missouri","Audrain County",3,80,138,56,82
050,29,007,"Missouri","Audrain County",3,81,134,47,87
050,29,007,"Missouri","Audrain County",3,82,113,44,69
050,29,007,"Missouri","Audrain County",3,83,101,39,62
050,29,007,"Missouri","Audrain County",3,84,94,33,61
050,29,007,"Missouri","Audrain County",3,85,477,94,383
050,29,007,"Missouri","Audrain County",4,0,280,141,139
050,29,007,"Missouri","Audrain County",4,1,320,165,155
050,29,007,"Missouri","Audrain County",4,2,262,134,128
050,29,007,"Missouri","Audrain County",4,3,310,148,162
050,29,007,"Missouri","Audrain County",4,4,313,164,149
050,29,007,"Missouri","Audrain County",4,5,321,168,153
050,29,007,"Missouri","Audrain County",4,6,306,157,149
050,29,007,"Missouri","Audrain County",4,7,313,146,167
050,29,007,"Missouri","Audrain County",4,8,312,152,160
050,29,007,"Missouri","Audrain County",4,9,285,146,139
050,29,007,"Missouri","Audrain County",4,10,289,145,144
050,29,007,"Missouri","Audrain County",4,11,271,140,131
050,29,007,"Missouri","Audrain County",4,12,294,158,136
050,29,007,"Missouri","Audrain County",4,13,322,174,148
050,29,007,"Missouri","Audrain County",4,14,360,200,160
050,29,007,"Missouri","Audrain County",4,15,343,188,155
050,29,007,"Missouri","Audrain County",4,16,367,232,135
050,29,007,"Missouri","Audrain County",4,17,358,216,142
050,29,007,"Missouri","Audrain County",4,18,288,163,125
050,29,007,"Missouri","Audrain County",4,19,226,124,102
050,29,007,"Missouri","Audrain County",4,20,236,111,125
050,29,007,"Missouri","Audrain County",4,21,281,130,151
050,29,007,"Missouri","Audrain County",4,22,275,137,138
050,29,007,"Missouri","Audrain County",4,23,256,119,137
050,29,007,"Missouri","Audrain County",4,24,279,129,150
050,29,007,"Missouri","Audrain County",4,25,291,138,153
050,29,007,"Missouri","Audrain County",4,26,288,132,156
050,29,007,"Missouri","Audrain County",4,27,323,147,176
050,29,007,"Missouri","Audrain County",4,28,323,148,175
050,29,007,"Missouri","Audrain County",4,29,333,157,176
050,29,007,"Missouri","Audrain County",4,30,315,138,177
050,29,007,"Missouri","Audrain County",4,31,325,144,181
050,29,007,"Missouri","Audrain County",4,32,297,129,168
050,29,007,"Missouri","Audrain County",4,33,283,135,148
050,29,007,"Missouri","Audrain County",4,34,300,135,165
050,29,007,"Missouri","Audrain County",4,35,296,126,170
050,29,007,"Missouri","Audrain County",4,36,306,136,170
050,29,007,"Missouri","Audrain County",4,37,317,133,184
050,29,007,"Missouri","Audrain County",4,38,315,139,176
050,29,007,"Missouri","Audrain County",4,39,324,151,173
050,29,007,"Missouri","Audrain County",4,40,316,144,172
050,29,007,"Missouri","Audrain County",4,41,277,126,151
050,29,007,"Missouri","Audrain County",4,42,298,142,156
050,29,007,"Missouri","Audrain County",4,43,309,154,155
050,29,007,"Missouri","Audrain County",4,44,287,137,150
050,29,007,"Missouri","Audrain County",4,45,294,136,158
050,29,007,"Missouri","Audrain County",4,46,282,120,162
050,29,007,"Missouri","Audrain County",4,47,295,137,158
050,29,007,"Missouri","Audrain County",4,48,299,139,160
050,29,007,"Missouri","Audrain County",4,49,286,133,153
050,29,007,"Missouri","Audrain County",4,50,294,151,143
050,29,007,"Missouri","Audrain County",4,51,303,154,149
050,29,007,"Missouri","Audrain County",4,52,266,135,131
050,29,007,"Missouri","Audrain County",4,53,287,146,141
050,29,007,"Missouri","Audrain County",4,54,266,122,144
050,29,007,"Missouri","Audrain County",4,55,282,136,146
050,29,007,"Missouri","Audrain County",4,56,295,144,151
050,29,007,"Missouri","Audrain County",4,57,304,146,158
050,29,007,"Missouri","Audrain County",4,58,341,164,177
050,29,007,"Missouri","Audrain County",4,59,351,174,177
050,29,007,"Missouri","Audrain County",4,60,359,171,188
050,29,007,"Missouri","Audrain County",4,61,338,162,176
050,29,007,"Missouri","Audrain County",4,62,341,165,176
050,29,007,"Missouri","Audrain County",4,63,372,187,185
050,29,007,"Missouri","Audrain County",4,64,380,192,188
050,29,007,"Missouri","Audrain County",4,65,347,171,176
050,29,007,"Missouri","Audrain County",4,66,317,158,159
050,29,007,"Missouri","Audrain County",4,67,299,140,159
050,29,007,"Missouri","Audrain County",4,68,280,141,139
050,29,007,"Missouri","Audrain County",4,69,273,127,146
050,29,007,"Missouri","Audrain County",4,70,273,119,154
050,29,007,"Missouri","Audrain County",4,71,243,112,131
050,29,007,"Missouri","Audrain County",4,72,248,117,131
050,29,007,"Missouri","Audrain County",4,73,232,112,120
050,29,007,"Missouri","Audrain County",4,74,229,117,112
050,29,007,"Missouri","Audrain County",4,75,219,109,110
050,29,007,"Missouri","Audrain County",4,76,145,71,74
050,29,007,"Missouri","Audrain County",4,77,161,82,79
050,29,007,"Missouri","Audrain County",4,78,169,88,81
050,29,007,"Missouri","Audrain County",4,79,156,69,87
050,29,007,"Missouri","Audrain County",4,80,136,51,85
050,29,007,"Missouri","Audrain County",4,81,128,52,76
050,29,007,"Missouri","Audrain County",4,82,122,46,76
050,29,007,"Missouri","Audrain County",4,83,108,38,70
050,29,007,"Missouri","Audrain County",4,84,101,38,63
050,29,007,"Missouri","Audrain County",4,85,471,85,386
050,29,007,"Missouri","Audrain County",5,0,281,142,139
050,29,007,"Missouri","Audrain County",5,1,275,137,138
050,29,007,"Missouri","Audrain County",5,2,305,152,153
050,29,007,"Missouri","Audrain County",5,3,264,130,134
050,29,007,"Missouri","Audrain County",5,4,306,144,162
050,29,007,"Missouri","Audrain County",5,5,306,164,142
050,29,007,"Missouri","Audrain County",5,6,316,168,148
050,29,007,"Missouri","Audrain County",5,7,298,152,146
050,29,007,"Missouri","Audrain County",5,8,305,134,171
050,29,007,"Missouri","Audrain County",5,9,313,152,161
050,29,007,"Missouri","Audrain County",5,10,281,147,134
050,29,007,"Missouri","Audrain County",5,11,293,150,143
050,29,007,"Missouri","Audrain County",5,12,290,150,140
050,29,007,"Missouri","Audrain County",5,13,301,168,133
050,29,007,"Missouri","Audrain County",5,14,350,203,147
050,29,007,"Missouri","Audrain County",5,15,350,194,156
050,29,007,"Missouri","Audrain County",5,16,364,220,144
050,29,007,"Missouri","Audrain County",5,17,373,243,130
050,29,007,"Missouri","Audrain County",5,18,278,168,110
050,29,007,"Missouri","Audrain County",5,19,217,114,103
050,29,007,"Missouri","Audrain County",5,20,247,127,120
050,29,007,"Missouri","Audrain County",5,21,249,116,133
050,29,007,"Missouri","Audrain County",5,22,283,132,151
050,29,007,"Missouri","Audrain County",5,23,281,136,145
050,29,007,"Missouri","Audrain County",5,24,260,121,139
050,29,007,"Missouri","Audrain County",5,25,294,138,156
050,29,007,"Missouri","Audrain County",5,26,268,134,134
050,29,007,"Missouri","Audrain County",5,27,275,116,159
050,29,007,"Missouri","Audrain County",5,28,325,150,175
050,29,007,"Missouri","Audrain County",5,29,320,147,173
050,29,007,"Missouri","Audrain County",5,30,341,159,182
050,29,007,"Missouri","Audrain County",5,31,309,138,171
050,29,007,"Missouri","Audrain County",5,32,330,144,186
050,29,007,"Missouri","Audrain County",5,33,300,133,167
050,29,007,"Missouri","Audrain County",5,34,291,136,155
050,29,007,"Missouri","Audrain County",5,35,296,139,157
050,29,007,"Missouri","Audrain County",5,36,293,123,170
050,29,007,"Missouri","Audrain County",5,37,322,142,180
050,29,007,"Missouri","Audrain County",5,38,316,136,180
050,29,007,"Missouri","Audrain County",5,39,323,146,177
050,29,007,"Missouri","Audrain County",5,40,321,154,167
050,29,007,"Missouri","Audrain County",5,41,307,136,171
050,29,007,"Missouri","Audrain County",5,42,288,135,153
050,29,007,"Missouri","Audrain County",5,43,294,137,157
050,29,007,"Missouri","Audrain County",5,44,297,147,150
050,29,007,"Missouri","Audrain County",5,45,288,137,151
050,29,007,"Missouri","Audrain County",5,46,296,142,154
050,29,007,"Missouri","Audrain County",5,47,289,121,168
050,29,007,"Missouri","Audrain County",5,48,291,139,152
050,29,007,"Missouri","Audrain County",5,49,273,124,149
050,29,007,"Missouri","Audrain County",5,50,291,139,152
050,29,007,"Missouri","Audrain County",5,51,283,141,142
050,29,007,"Missouri","Audrain County",5,52,288,161,127
050,29,007,"Missouri","Audrain County",5,53,281,140,141
050,29,007,"Missouri","Audrain County",5,54,286,147,139
050,29,007,"Missouri","Audrain County",5,55,259,115,144
050,29,007,"Missouri","Audrain County",5,56,277,136,141
050,29,007,"Missouri","Audrain County",5,57,295,145,150
050,29,007,"Missouri","Audrain County",5,58,295,143,152
050,29,007,"Missouri","Audrain County",5,59,344,162,182
050,29,007,"Missouri","Audrain County",5,60,358,176,182
050,29,007,"Missouri","Audrain County",5,61,350,165,185
050,29,007,"Missouri","Audrain County",5,62,336,161,175
050,29,007,"Missouri","Audrain County",5,63,344,165,179
050,29,007,"Missouri","Audrain County",5,64,380,190,190
050,29,007,"Missouri","Audrain County",5,65,368,184,184
050,29,007,"Missouri","Audrain County",5,66,333,165,168
050,29,007,"Missouri","Audrain County",5,67,321,160,161
050,29,007,"Missouri","Audrain County",5,68,293,139,154
050,29,007,"Missouri","Audrain County",5,69,274,141,133
050,29,007,"Missouri","Audrain County",5,70,269,123,146
050,29,007,"Missouri","Audrain County",5,71,259,115,144
050,29,007,"Missouri","Audrain County",5,72,239,106,133
050,29,007,"Missouri","Audrain County",5,73,235,111,124
050,29,007,"Missouri","Audrain County",5,74,221,110,111
050,29,007,"Missouri","Audrain County",5,75,207,109,98
050,29,007,"Missouri","Audrain County",5,76,208,99,109
050,29,007,"Missouri","Audrain County",5,77,138,68,70
050,29,007,"Missouri","Audrain County",5,78,157,83,74
050,29,007,"Missouri","Audrain County",5,79,160,79,81
050,29,007,"Missouri","Audrain County",5,80,151,65,86
050,29,007,"Missouri","Audrain County",5,81,126,51,75
050,29,007,"Missouri","Audrain County",5,82,111,50,61
050,29,007,"Missouri","Audrain County",5,83,122,41,81
050,29,007,"Missouri","Audrain County",5,84,106,38,68
050,29,007,"Missouri","Audrain County",5,85,496,95,401
050,29,009,"Missouri","Barry County",1,0,383,194,189
050,29,009,"Missouri","Barry County",1,1,401,189,212
050,29,009,"Missouri","Barry County",1,2,407,202,205
050,29,009,"Missouri","Barry County",1,3,441,238,203
050,29,009,"Missouri","Barry County",1,4,417,217,200
050,29,009,"Missouri","Barry County",1,5,427,216,211
050,29,009,"Missouri","Barry County",1,6,407,202,205
050,29,009,"Missouri","Barry County",1,7,410,211,199
050,29,009,"Missouri","Barry County",1,8,436,233,203
050,29,009,"Missouri","Barry County",1,9,433,233,200
050,29,009,"Missouri","Barry County",1,10,470,247,223
050,29,009,"Missouri","Barry County",1,11,465,256,209
050,29,009,"Missouri","Barry County",1,12,472,235,237
050,29,009,"Missouri","Barry County",1,13,479,248,231
050,29,009,"Missouri","Barry County",1,14,452,241,211
050,29,009,"Missouri","Barry County",1,15,471,245,226
050,29,009,"Missouri","Barry County",1,16,495,267,228
050,29,009,"Missouri","Barry County",1,17,468,250,218
050,29,009,"Missouri","Barry County",1,18,387,209,178
050,29,009,"Missouri","Barry County",1,19,300,161,139
050,29,009,"Missouri","Barry County",1,20,337,183,154
050,29,009,"Missouri","Barry County",1,21,352,181,171
050,29,009,"Missouri","Barry County",1,22,370,204,166
050,29,009,"Missouri","Barry County",1,23,356,184,172
050,29,009,"Missouri","Barry County",1,24,345,179,166
050,29,009,"Missouri","Barry County",1,25,363,180,183
050,29,009,"Missouri","Barry County",1,26,372,183,189
050,29,009,"Missouri","Barry County",1,27,393,187,206
050,29,009,"Missouri","Barry County",1,28,397,209,188
050,29,009,"Missouri","Barry County",1,29,395,214,181
050,29,009,"Missouri","Barry County",1,30,365,200,165
050,29,009,"Missouri","Barry County",1,31,365,187,178
050,29,009,"Missouri","Barry County",1,32,352,183,169
050,29,009,"Missouri","Barry County",1,33,330,170,160
050,29,009,"Missouri","Barry County",1,34,353,182,171
050,29,009,"Missouri","Barry County",1,35,372,186,186
050,29,009,"Missouri","Barry County",1,36,369,190,179
050,29,009,"Missouri","Barry County",1,37,373,185,188
050,29,009,"Missouri","Barry County",1,38,367,181,186
050,29,009,"Missouri","Barry County",1,39,384,207,177
050,29,009,"Missouri","Barry County",1,40,409,211,198
050,29,009,"Missouri","Barry County",1,41,381,187,194
050,29,009,"Missouri","Barry County",1,42,408,214,194
050,29,009,"Missouri","Barry County",1,43,368,182,186
050,29,009,"Missouri","Barry County",1,44,340,168,172
050,29,009,"Missouri","Barry County",1,45,369,196,173
050,29,009,"Missouri","Barry County",1,46,370,185,185
050,29,009,"Missouri","Barry County",1,47,407,201,206
050,29,009,"Missouri","Barry County",1,48,420,203,217
050,29,009,"Missouri","Barry County",1,49,437,211,226
050,29,009,"Missouri","Barry County",1,50,405,196,209
050,29,009,"Missouri","Barry County",1,51,449,222,227
050,29,009,"Missouri","Barry County",1,52,411,204,207
050,29,009,"Missouri","Barry County",1,53,411,217,194
050,29,009,"Missouri","Barry County",1,54,442,221,221
050,29,009,"Missouri","Barry County",1,55,489,250,239
050,29,009,"Missouri","Barry County",1,56,501,256,245
050,29,009,"Missouri","Barry County",1,57,548,288,260
050,29,009,"Missouri","Barry County",1,58,568,281,287
050,29,009,"Missouri","Barry County",1,59,548,305,243
050,29,009,"Missouri","Barry County",1,60,505,266,239
050,29,009,"Missouri","Barry County",1,61,519,258,261
050,29,009,"Missouri","Barry County",1,62,536,255,281
050,29,009,"Missouri","Barry County",1,63,533,257,276
050,29,009,"Missouri","Barry County",1,64,520,246,274
050,29,009,"Missouri","Barry County",1,65,501,241,260
050,29,009,"Missouri","Barry County",1,66,478,246,232
050,29,009,"Missouri","Barry County",1,67,472,245,227
050,29,009,"Missouri","Barry County",1,68,485,240,245
050,29,009,"Missouri","Barry County",1,69,441,217,224
050,29,009,"Missouri","Barry County",1,70,413,215,198
050,29,009,"Missouri","Barry County",1,71,400,206,194
050,29,009,"Missouri","Barry County",1,72,424,216,208
050,29,009,"Missouri","Barry County",1,73,408,206,202
050,29,009,"Missouri","Barry County",1,74,285,132,153
050,29,009,"Missouri","Barry County",1,75,307,148,159
050,29,009,"Missouri","Barry County",1,76,321,151,170
050,29,009,"Missouri","Barry County",1,77,314,152,162
050,29,009,"Missouri","Barry County",1,78,261,120,141
050,29,009,"Missouri","Barry County",1,79,223,103,120
050,29,009,"Missouri","Barry County",1,80,218,99,119
050,29,009,"Missouri","Barry County",1,81,212,102,110
050,29,009,"Missouri","Barry County",1,82,177,73,104
050,29,009,"Missouri","Barry County",1,83,143,59,84
050,29,009,"Missouri","Barry County",1,84,130,53,77
050,29,009,"Missouri","Barry County",1,85,695,287,408
050,29,009,"Missouri","Barry County",2,0,380,185,195
050,29,009,"Missouri","Barry County",2,1,395,188,207
050,29,009,"Missouri","Barry County",2,2,406,198,208
050,29,009,"Missouri","Barry County",2,3,429,226,203
050,29,009,"Missouri","Barry County",2,4,426,222,204
050,29,009,"Missouri","Barry County",2,5,424,215,209
050,29,009,"Missouri","Barry County",2,6,412,206,206
050,29,009,"Missouri","Barry County",2,7,409,208,201
050,29,009,"Missouri","Barry County",2,8,432,229,203
050,29,009,"Missouri","Barry County",2,9,437,234,203
050,29,009,"Missouri","Barry County",2,10,460,243,217
050,29,009,"Missouri","Barry County",2,11,462,250,212
050,29,009,"Missouri","Barry County",2,12,473,242,231
050,29,009,"Missouri","Barry County",2,13,478,245,233
050,29,009,"Missouri","Barry County",2,14,457,241,216
050,29,009,"Missouri","Barry County",2,15,469,246,223
050,29,009,"Missouri","Barry County",2,16,488,260,228
050,29,009,"Missouri","Barry County",2,17,477,255,222
050,29,009,"Missouri","Barry County",2,18,389,211,178
050,29,009,"Missouri","Barry County",2,19,304,164,140
050,29,009,"Missouri","Barry County",2,20,340,184,156
050,29,009,"Missouri","Barry County",2,21,351,184,167
050,29,009,"Missouri","Barry County",2,22,369,199,170
050,29,009,"Missouri","Barry County",2,23,363,190,173
050,29,009,"Missouri","Barry County",2,24,350,183,167
050,29,009,"Missouri","Barry County",2,25,360,181,179
050,29,009,"Missouri","Barry County",2,26,370,181,189
050,29,009,"Missouri","Barry County",2,27,386,187,199
050,29,009,"Missouri","Barry County",2,28,397,206,191
050,29,009,"Missouri","Barry County",2,29,395,213,182
050,29,009,"Missouri","Barry County",2,30,373,203,170
050,29,009,"Missouri","Barry County",2,31,361,188,173
050,29,009,"Missouri","Barry County",2,32,355,182,173
050,29,009,"Missouri","Barry County",2,33,335,173,162
050,29,009,"Missouri","Barry County",2,34,346,180,166
050,29,009,"Missouri","Barry County",2,35,371,189,182
050,29,009,"Missouri","Barry County",2,36,367,188,179
050,29,009,"Missouri","Barry County",2,37,374,188,186
050,29,009,"Missouri","Barry County",2,38,367,183,184
050,29,009,"Missouri","Barry County",2,39,382,200,182
050,29,009,"Missouri","Barry County",2,40,405,209,196
050,29,009,"Missouri","Barry County",2,41,390,195,195
050,29,009,"Missouri","Barry County",2,42,403,209,194
050,29,009,"Missouri","Barry County",2,43,380,191,189
050,29,009,"Missouri","Barry County",2,44,344,170,174
050,29,009,"Missouri","Barry County",2,45,362,189,173
050,29,009,"Missouri","Barry County",2,46,368,189,179
050,29,009,"Missouri","Barry County",2,47,396,196,200
050,29,009,"Missouri","Barry County",2,48,414,201,213
050,29,009,"Missouri","Barry County",2,49,436,209,227
050,29,009,"Missouri","Barry County",2,50,415,200,215
050,29,009,"Missouri","Barry County",2,51,438,215,223
050,29,009,"Missouri","Barry County",2,52,419,208,211
050,29,009,"Missouri","Barry County",2,53,411,214,197
050,29,009,"Missouri","Barry County",2,54,436,221,215
050,29,009,"Missouri","Barry County",2,55,473,241,232
050,29,009,"Missouri","Barry County",2,56,499,256,243
050,29,009,"Missouri","Barry County",2,57,535,278,257
050,29,009,"Missouri","Barry County",2,58,565,285,280
050,29,009,"Missouri","Barry County",2,59,559,301,258
050,29,009,"Missouri","Barry County",2,60,520,278,242
050,29,009,"Missouri","Barry County",2,61,516,260,256
050,29,009,"Missouri","Barry County",2,62,529,252,277
050,29,009,"Missouri","Barry County",2,63,541,261,280
050,29,009,"Missouri","Barry County",2,64,521,247,274
050,29,009,"Missouri","Barry County",2,65,504,242,262
050,29,009,"Missouri","Barry County",2,66,487,247,240
050,29,009,"Missouri","Barry County",2,67,473,246,227
050,29,009,"Missouri","Barry County",2,68,475,240,235
050,29,009,"Missouri","Barry County",2,69,452,223,229
050,29,009,"Missouri","Barry County",2,70,419,216,203
050,29,009,"Missouri","Barry County",2,71,402,208,194
050,29,009,"Missouri","Barry County",2,72,412,210,202
050,29,009,"Missouri","Barry County",2,73,433,217,216
050,29,009,"Missouri","Barry County",2,74,292,139,153
050,29,009,"Missouri","Barry County",2,75,299,144,155
050,29,009,"Missouri","Barry County",2,76,314,148,166
050,29,009,"Missouri","Barry County",2,77,320,153,167
050,29,009,"Missouri","Barry County",2,78,264,124,140
050,29,009,"Missouri","Barry County",2,79,227,104,123
050,29,009,"Missouri","Barry County",2,80,211,95,116
050,29,009,"Missouri","Barry County",2,81,211,100,111
050,29,009,"Missouri","Barry County",2,82,184,80,104
050,29,009,"Missouri","Barry County",2,83,146,61,85
050,29,009,"Missouri","Barry County",2,84,130,53,77
050,29,009,"Missouri","Barry County",2,85,695,286,409
050,29,009,"Missouri","Barry County",3,0,423,221,202
050,29,009,"Missouri","Barry County",3,1,392,181,211
050,29,009,"Missouri","Barry County",3,2,400,193,207
050,29,009,"Missouri","Barry County",3,3,409,196,213
050,29,009,"Missouri","Barry County",3,4,472,257,215
050,29,009,"Missouri","Barry County",3,5,429,228,201
050,29,009,"Missouri","Barry County",3,6,429,218,211
050,29,009,"Missouri","Barry County",3,7,436,223,213
050,29,009,"Missouri","Barry County",3,8,408,207,201
050,29,009,"Missouri","Barry County",3,9,453,238,215
050,29,009,"Missouri","Barry County",3,10,450,243,207
050,29,009,"Missouri","Barry County",3,11,455,248,207
050,29,009,"Missouri","Barry County",3,12,466,254,212
050,29,009,"Missouri","Barry County",3,13,479,251,228
050,29,009,"Missouri","Barry County",3,14,484,250,234
050,29,009,"Missouri","Barry County",3,15,441,230,211
050,29,009,"Missouri","Barry County",3,16,479,244,235
050,29,009,"Missouri","Barry County",3,17,472,255,217
050,29,009,"Missouri","Barry County",3,18,416,229,187
050,29,009,"Missouri","Barry County",3,19,300,167,133
050,29,009,"Missouri","Barry County",3,20,336,179,157
050,29,009,"Missouri","Barry County",3,21,363,191,172
050,29,009,"Missouri","Barry County",3,22,364,196,168
050,29,009,"Missouri","Barry County",3,23,369,203,166
050,29,009,"Missouri","Barry County",3,24,362,185,177
050,29,009,"Missouri","Barry County",3,25,368,198,170
050,29,009,"Missouri","Barry County",3,26,373,184,189
050,29,009,"Missouri","Barry County",3,27,383,201,182
050,29,009,"Missouri","Barry County",3,28,401,195,206
050,29,009,"Missouri","Barry County",3,29,415,196,219
050,29,009,"Missouri","Barry County",3,30,406,216,190
050,29,009,"Missouri","Barry County",3,31,387,206,181
050,29,009,"Missouri","Barry County",3,32,370,200,170
050,29,009,"Missouri","Barry County",3,33,371,184,187
050,29,009,"Missouri","Barry County",3,34,353,190,163
050,29,009,"Missouri","Barry County",3,35,343,186,157
050,29,009,"Missouri","Barry County",3,36,371,187,184
050,29,009,"Missouri","Barry County",3,37,382,184,198
050,29,009,"Missouri","Barry County",3,38,374,189,185
050,29,009,"Missouri","Barry County",3,39,371,182,189
050,29,009,"Missouri","Barry County",3,40,397,211,186
050,29,009,"Missouri","Barry County",3,41,397,206,191
050,29,009,"Missouri","Barry County",3,42,397,196,201
050,29,009,"Missouri","Barry County",3,43,410,208,202
050,29,009,"Missouri","Barry County",3,44,390,196,194
050,29,009,"Missouri","Barry County",3,45,348,172,176
050,29,009,"Missouri","Barry County",3,46,361,188,173
050,29,009,"Missouri","Barry County",3,47,369,189,180
050,29,009,"Missouri","Barry County",3,48,390,187,203
050,29,009,"Missouri","Barry County",3,49,406,196,210
050,29,009,"Missouri","Barry County",3,50,448,223,225
050,29,009,"Missouri","Barry County",3,51,414,195,219
050,29,009,"Missouri","Barry County",3,52,440,213,227
050,29,009,"Missouri","Barry County",3,53,419,208,211
050,29,009,"Missouri","Barry County",3,54,404,212,192
050,29,009,"Missouri","Barry County",3,55,431,218,213
050,29,009,"Missouri","Barry County",3,56,463,236,227
050,29,009,"Missouri","Barry County",3,57,494,251,243
050,29,009,"Missouri","Barry County",3,58,550,288,262
050,29,009,"Missouri","Barry County",3,59,555,280,275
050,29,009,"Missouri","Barry County",3,60,559,298,261
050,29,009,"Missouri","Barry County",3,61,508,271,237
050,29,009,"Missouri","Barry County",3,62,529,260,269
050,29,009,"Missouri","Barry County",3,63,543,258,285
050,29,009,"Missouri","Barry County",3,64,544,265,279
050,29,009,"Missouri","Barry County",3,65,504,239,265
050,29,009,"Missouri","Barry County",3,66,496,238,258
050,29,009,"Missouri","Barry County",3,67,473,245,228
050,29,009,"Missouri","Barry County",3,68,464,242,222
050,29,009,"Missouri","Barry County",3,69,464,232,232
050,29,009,"Missouri","Barry County",3,70,453,222,231
050,29,009,"Missouri","Barry County",3,71,409,211,198
050,29,009,"Missouri","Barry County",3,72,388,197,191
050,29,009,"Missouri","Barry County",3,73,387,198,189
050,29,009,"Missouri","Barry County",3,74,414,205,209
050,29,009,"Missouri","Barry County",3,75,280,133,147
050,29,009,"Missouri","Barry County",3,76,280,133,147
050,29,009,"Missouri","Barry County",3,77,294,135,159
050,29,009,"Missouri","Barry County",3,78,289,132,157
050,29,009,"Missouri","Barry County",3,79,236,112,124
050,29,009,"Missouri","Barry County",3,80,219,99,120
050,29,009,"Missouri","Barry County",3,81,190,85,105
050,29,009,"Missouri","Barry County",3,82,188,88,100
050,29,009,"Missouri","Barry County",3,83,168,72,96
050,29,009,"Missouri","Barry County",3,84,144,55,89
050,29,009,"Missouri","Barry County",3,85,701,282,419
050,29,009,"Missouri","Barry County",4,0,399,201,198
050,29,009,"Missouri","Barry County",4,1,445,246,199
050,29,009,"Missouri","Barry County",4,2,385,177,208
050,29,009,"Missouri","Barry County",4,3,389,193,196
050,29,009,"Missouri","Barry County",4,4,395,189,206
050,29,009,"Missouri","Barry County",4,5,458,254,204
050,29,009,"Missouri","Barry County",4,6,429,224,205
050,29,009,"Missouri","Barry County",4,7,443,225,218
050,29,009,"Missouri","Barry County",4,8,431,220,211
050,29,009,"Missouri","Barry County",4,9,424,212,212
050,29,009,"Missouri","Barry County",4,10,454,245,209
050,29,009,"Missouri","Barry County",4,11,458,251,207
050,29,009,"Missouri","Barry County",4,12,458,245,213
050,29,009,"Missouri","Barry County",4,13,467,258,209
050,29,009,"Missouri","Barry County",4,14,489,254,235
050,29,009,"Missouri","Barry County",4,15,488,258,230
050,29,009,"Missouri","Barry County",4,16,466,243,223
050,29,009,"Missouri","Barry County",4,17,469,237,232
050,29,009,"Missouri","Barry County",4,18,396,224,172
050,29,009,"Missouri","Barry County",4,19,322,174,148
050,29,009,"Missouri","Barry County",4,20,305,170,135
050,29,009,"Missouri","Barry County",4,21,340,177,163
050,29,009,"Missouri","Barry County",4,22,377,199,178
050,29,009,"Missouri","Barry County",4,23,362,193,169
050,29,009,"Missouri","Barry County",4,24,386,217,169
050,29,009,"Missouri","Barry County",4,25,356,186,170
050,29,009,"Missouri","Barry County",4,26,344,188,156
050,29,009,"Missouri","Barry County",4,27,378,182,196
050,29,009,"Missouri","Barry County",4,28,367,195,172
050,29,009,"Missouri","Barry County",4,29,403,191,212
050,29,009,"Missouri","Barry County",4,30,394,188,206
050,29,009,"Missouri","Barry County",4,31,406,212,194
050,29,009,"Missouri","Barry County",4,32,382,204,178
050,29,009,"Missouri","Barry County",4,33,369,196,173
050,29,009,"Missouri","Barry County",4,34,363,176,187
050,29,009,"Missouri","Barry County",4,35,366,192,174
050,29,009,"Missouri","Barry County",4,36,362,191,171
050,29,009,"Missouri","Barry County",4,37,372,190,182
050,29,009,"Missouri","Barry County",4,38,390,190,200
050,29,009,"Missouri","Barry County",4,39,390,197,193
050,29,009,"Missouri","Barry County",4,40,379,187,192
050,29,009,"Missouri","Barry County",4,41,415,224,191
050,29,009,"Missouri","Barry County",4,42,401,207,194
050,29,009,"Missouri","Barry County",4,43,410,205,205
050,29,009,"Missouri","Barry County",4,44,417,212,205
050,29,009,"Missouri","Barry County",4,45,394,199,195
050,29,009,"Missouri","Barry County",4,46,361,174,187
050,29,009,"Missouri","Barry County",4,47,379,199,180
050,29,009,"Missouri","Barry County",4,48,370,185,185
050,29,009,"Missouri","Barry County",4,49,400,185,215
050,29,009,"Missouri","Barry County",4,50,413,198,215
050,29,009,"Missouri","Barry County",4,51,455,229,226
050,29,009,"Missouri","Barry County",4,52,435,206,229
050,29,009,"Missouri","Barry County",4,53,437,214,223
050,29,009,"Missouri","Barry County",4,54,444,222,222
050,29,009,"Missouri","Barry County",4,55,411,215,196
050,29,009,"Missouri","Barry County",4,56,440,220,220
050,29,009,"Missouri","Barry County",4,57,478,238,240
050,29,009,"Missouri","Barry County",4,58,505,267,238
050,29,009,"Missouri","Barry County",4,59,548,288,260
050,29,009,"Missouri","Barry County",4,60,560,286,274
050,29,009,"Missouri","Barry County",4,61,564,295,269
050,29,009,"Missouri","Barry County",4,62,506,260,246
050,29,009,"Missouri","Barry County",4,63,536,276,260
050,29,009,"Missouri","Barry County",4,64,552,266,286
050,29,009,"Missouri","Barry County",4,65,551,270,281
050,29,009,"Missouri","Barry County",4,66,499,233,266
050,29,009,"Missouri","Barry County",4,67,492,236,256
050,29,009,"Missouri","Barry County",4,68,473,245,228
050,29,009,"Missouri","Barry County",4,69,469,243,226
050,29,009,"Missouri","Barry County",4,70,459,230,229
050,29,009,"Missouri","Barry County",4,71,433,213,220
050,29,009,"Missouri","Barry County",4,72,399,205,194
050,29,009,"Missouri","Barry County",4,73,381,192,189
050,29,009,"Missouri","Barry County",4,74,372,188,184
050,29,009,"Missouri","Barry County",4,75,400,198,202
050,29,009,"Missouri","Barry County",4,76,268,120,148
050,29,009,"Missouri","Barry County",4,77,262,124,138
050,29,009,"Missouri","Barry County",4,78,278,124,154
050,29,009,"Missouri","Barry County",4,79,262,123,139
050,29,009,"Missouri","Barry County",4,80,230,100,130
050,29,009,"Missouri","Barry County",4,81,199,87,112
050,29,009,"Missouri","Barry County",4,82,163,69,94
050,29,009,"Missouri","Barry County",4,83,173,85,88
050,29,009,"Missouri","Barry County",4,84,152,65,87
050,29,009,"Missouri","Barry County",4,85,742,279,463
050,29,009,"Missouri","Barry County",5,0,403,205,198
050,29,009,"Missouri","Barry County",5,1,421,201,220
050,29,009,"Missouri","Barry County",5,2,456,254,202
050,29,009,"Missouri","Barry County",5,3,389,185,204
050,29,009,"Missouri","Barry County",5,4,413,204,209
050,29,009,"Missouri","Barry County",5,5,402,189,213
050,29,009,"Missouri","Barry County",5,6,468,255,213
050,29,009,"Missouri","Barry County",5,7,435,232,203
050,29,009,"Missouri","Barry County",5,8,428,221,207
050,29,009,"Missouri","Barry County",5,9,429,222,207
050,29,009,"Missouri","Barry County",5,10,423,205,218
050,29,009,"Missouri","Barry County",5,11,475,253,222
050,29,009,"Missouri","Barry County",5,12,471,257,214
050,29,009,"Missouri","Barry County",5,13,457,247,210
050,29,009,"Missouri","Barry County",5,14,474,256,218
050,29,009,"Missouri","Barry County",5,15,486,257,229
050,29,009,"Missouri","Barry County",5,16,489,268,221
050,29,009,"Missouri","Barry County",5,17,475,238,237
050,29,009,"Missouri","Barry County",5,18,399,211,188
050,29,009,"Missouri","Barry County",5,19,319,184,135
050,29,009,"Missouri","Barry County",5,20,335,173,162
050,29,009,"Missouri","Barry County",5,21,342,176,166
050,29,009,"Missouri","Barry County",5,22,370,196,174
050,29,009,"Missouri","Barry County",5,23,397,204,193
050,29,009,"Missouri","Barry County",5,24,373,202,171
050,29,009,"Missouri","Barry County",5,25,400,216,184
050,29,009,"Missouri","Barry County",5,26,375,189,186
050,29,009,"Missouri","Barry County",5,27,359,199,160
050,29,009,"Missouri","Barry County",5,28,376,182,194
050,29,009,"Missouri","Barry County",5,29,365,198,167
050,29,009,"Missouri","Barry County",5,30,406,190,216
050,29,009,"Missouri","Barry County",5,31,395,191,204
050,29,009,"Missouri","Barry County",5,32,410,208,202
050,29,009,"Missouri","Barry County",5,33,399,208,191
050,29,009,"Missouri","Barry County",5,34,368,193,175
050,29,009,"Missouri","Barry County",5,35,372,186,186
050,29,009,"Missouri","Barry County",5,36,377,200,177
050,29,009,"Missouri","Barry County",5,37,371,194,177
050,29,009,"Missouri","Barry County",5,38,377,187,190
050,29,009,"Missouri","Barry County",5,39,411,201,210
050,29,009,"Missouri","Barry County",5,40,409,213,196
050,29,009,"Missouri","Barry County",5,41,390,190,200
050,29,009,"Missouri","Barry County",5,42,414,221,193
050,29,009,"Missouri","Barry County",5,43,405,209,196
050,29,009,"Missouri","Barry County",5,44,411,203,208
050,29,009,"Missouri","Barry County",5,45,413,209,204
050,29,009,"Missouri","Barry County",5,46,407,202,205
050,29,009,"Missouri","Barry County",5,47,362,172,190
050,29,009,"Missouri","Barry County",5,48,376,196,180
050,29,009,"Missouri","Barry County",5,49,366,185,181
050,29,009,"Missouri","Barry County",5,50,393,189,204
050,29,009,"Missouri","Barry County",5,51,425,201,224
050,29,009,"Missouri","Barry County",5,52,466,238,228
050,29,009,"Missouri","Barry County",5,53,435,207,228
050,29,009,"Missouri","Barry County",5,54,444,220,224
050,29,009,"Missouri","Barry County",5,55,441,216,225
050,29,009,"Missouri","Barry County",5,56,423,220,203
050,29,009,"Missouri","Barry County",5,57,440,223,217
050,29,009,"Missouri","Barry County",5,58,479,244,235
050,29,009,"Missouri","Barry County",5,59,509,275,234
050,29,009,"Missouri","Barry County",5,60,542,288,254
050,29,009,"Missouri","Barry County",5,61,568,286,282
050,29,009,"Missouri","Barry County",5,62,583,306,277
050,29,009,"Missouri","Barry County",5,63,509,262,247
050,29,009,"Missouri","Barry County",5,64,531,271,260
050,29,009,"Missouri","Barry County",5,65,552,260,292
050,29,009,"Missouri","Barry County",5,66,540,258,282
050,29,009,"Missouri","Barry County",5,67,491,234,257
050,29,009,"Missouri","Barry County",5,68,499,244,255
050,29,009,"Missouri","Barry County",5,69,463,236,227
050,29,009,"Missouri","Barry County",5,70,461,243,218
050,29,009,"Missouri","Barry County",5,71,444,219,225
050,29,009,"Missouri","Barry County",5,72,412,202,210
050,29,009,"Missouri","Barry County",5,73,391,198,193
050,29,009,"Missouri","Barry County",5,74,364,182,182
050,29,009,"Missouri","Barry County",5,75,359,181,178
050,29,009,"Missouri","Barry County",5,76,374,177,197
050,29,009,"Missouri","Barry County",5,77,251,113,138
050,29,009,"Missouri","Barry County",5,78,248,115,133
050,29,009,"Missouri","Barry County",5,79,258,118,140
050,29,009,"Missouri","Barry County",5,80,251,109,142
050,29,009,"Missouri","Barry County",5,81,213,91,122
050,29,009,"Missouri","Barry County",5,82,175,75,100
050,29,009,"Missouri","Barry County",5,83,149,63,86
050,29,009,"Missouri","Barry County",5,84,160,74,86
050,29,009,"Missouri","Barry County",5,85,779,296,483
050,29,011,"Missouri","Barton County",1,0,126,66,60
050,29,011,"Missouri","Barton County",1,1,133,73,60
050,29,011,"Missouri","Barton County",1,2,137,65,72
050,29,011,"Missouri","Barton County",1,3,124,70,54
050,29,011,"Missouri","Barton County",1,4,143,80,63
050,29,011,"Missouri","Barton County",1,5,148,75,73
050,29,011,"Missouri","Barton County",1,6,144,72,72
050,29,011,"Missouri","Barton County",1,7,151,80,71
050,29,011,"Missouri","Barton County",1,8,148,79,69
050,29,011,"Missouri","Barton County",1,9,134,69,65
050,29,011,"Missouri","Barton County",1,10,136,69,67
050,29,011,"Missouri","Barton County",1,11,154,77,77
050,29,011,"Missouri","Barton County",1,12,182,93,89
050,29,011,"Missouri","Barton County",1,13,185,101,84
050,29,011,"Missouri","Barton County",1,14,178,94,84
050,29,011,"Missouri","Barton County",1,15,170,91,79
050,29,011,"Missouri","Barton County",1,16,187,101,86
050,29,011,"Missouri","Barton County",1,17,184,102,82
050,29,011,"Missouri","Barton County",1,18,149,89,60
050,29,011,"Missouri","Barton County",1,19,119,69,50
050,29,011,"Missouri","Barton County",1,20,118,60,58
050,29,011,"Missouri","Barton County",1,21,116,60,56
050,29,011,"Missouri","Barton County",1,22,121,57,64
050,29,011,"Missouri","Barton County",1,23,128,66,62
050,29,011,"Missouri","Barton County",1,24,136,70,66
050,29,011,"Missouri","Barton County",1,25,125,61,64
050,29,011,"Missouri","Barton County",1,26,121,62,59
050,29,011,"Missouri","Barton County",1,27,130,71,59
050,29,011,"Missouri","Barton County",1,28,143,67,76
050,29,011,"Missouri","Barton County",1,29,133,67,66
050,29,011,"Missouri","Barton County",1,30,135,73,62
050,29,011,"Missouri","Barton County",1,31,109,52,57
050,29,011,"Missouri","Barton County",1,32,108,50,58
050,29,011,"Missouri","Barton County",1,33,110,51,59
050,29,011,"Missouri","Barton County",1,34,111,52,59
050,29,011,"Missouri","Barton County",1,35,106,57,49
050,29,011,"Missouri","Barton County",1,36,125,63,62
050,29,011,"Missouri","Barton County",1,37,143,62,81
050,29,011,"Missouri","Barton County",1,38,159,73,86
050,29,011,"Missouri","Barton County",1,39,147,76,71
050,29,011,"Missouri","Barton County",1,40,157,80,77
050,29,011,"Missouri","Barton County",1,41,130,67,63
050,29,011,"Missouri","Barton County",1,42,118,58,60
050,29,011,"Missouri","Barton County",1,43,139,72,67
050,29,011,"Missouri","Barton County",1,44,131,66,65
050,29,011,"Missouri","Barton County",1,45,110,58,52
050,29,011,"Missouri","Barton County",1,46,119,62,57
050,29,011,"Missouri","Barton County",1,47,134,75,59
050,29,011,"Missouri","Barton County",1,48,142,72,70
050,29,011,"Missouri","Barton County",1,49,146,72,74
050,29,011,"Missouri","Barton County",1,50,119,57,62
050,29,011,"Missouri","Barton County",1,51,136,66,70
050,29,011,"Missouri","Barton County",1,52,144,71,73
050,29,011,"Missouri","Barton County",1,53,138,68,70
050,29,011,"Missouri","Barton County",1,54,132,66,66
050,29,011,"Missouri","Barton County",1,55,157,78,79
050,29,011,"Missouri","Barton County",1,56,174,88,86
050,29,011,"Missouri","Barton County",1,57,165,77,88
050,29,011,"Missouri","Barton County",1,58,176,89,87
050,29,011,"Missouri","Barton County",1,59,177,88,89
050,29,011,"Missouri","Barton County",1,60,172,82,90
050,29,011,"Missouri","Barton County",1,61,172,91,81
050,29,011,"Missouri","Barton County",1,62,186,96,90
050,29,011,"Missouri","Barton County",1,63,194,91,103
050,29,011,"Missouri","Barton County",1,64,166,89,77
050,29,011,"Missouri","Barton County",1,65,161,83,78
050,29,011,"Missouri","Barton County",1,66,158,80,78
050,29,011,"Missouri","Barton County",1,67,159,74,85
050,29,011,"Missouri","Barton County",1,68,140,68,72
050,29,011,"Missouri","Barton County",1,69,124,57,67
050,29,011,"Missouri","Barton County",1,70,117,56,61
050,29,011,"Missouri","Barton County",1,71,124,53,71
050,29,011,"Missouri","Barton County",1,72,123,63,60
050,29,011,"Missouri","Barton County",1,73,136,62,74
050,29,011,"Missouri","Barton County",1,74,89,37,52
050,29,011,"Missouri","Barton County",1,75,99,47,52
050,29,011,"Missouri","Barton County",1,76,96,46,50
050,29,011,"Missouri","Barton County",1,77,99,47,52
050,29,011,"Missouri","Barton County",1,78,89,40,49
050,29,011,"Missouri","Barton County",1,79,72,36,36
050,29,011,"Missouri","Barton County",1,80,70,34,36
050,29,011,"Missouri","Barton County",1,81,68,33,35
050,29,011,"Missouri","Barton County",1,82,63,28,35
050,29,011,"Missouri","Barton County",1,83,45,21,24
050,29,011,"Missouri","Barton County",1,84,34,14,20
050,29,011,"Missouri","Barton County",1,85,282,96,186
050,29,011,"Missouri","Barton County",2,0,137,74,63
050,29,011,"Missouri","Barton County",2,1,131,71,60
050,29,011,"Missouri","Barton County",2,2,136,68,68
050,29,011,"Missouri","Barton County",2,3,128,71,57
050,29,011,"Missouri","Barton County",2,4,136,77,59
050,29,011,"Missouri","Barton County",2,5,148,76,72
050,29,011,"Missouri","Barton County",2,6,146,73,73
050,29,011,"Missouri","Barton County",2,7,147,77,70
050,29,011,"Missouri","Barton County",2,8,148,79,69
050,29,011,"Missouri","Barton County",2,9,137,72,65
050,29,011,"Missouri","Barton County",2,10,134,69,65
050,29,011,"Missouri","Barton County",2,11,148,76,72
050,29,011,"Missouri","Barton County",2,12,177,90,87
050,29,011,"Missouri","Barton County",2,13,186,99,87
050,29,011,"Missouri","Barton County",2,14,182,97,85
050,29,011,"Missouri","Barton County",2,15,172,92,80
050,29,011,"Missouri","Barton County",2,16,186,100,86
050,29,011,"Missouri","Barton County",2,17,183,101,82
050,29,011,"Missouri","Barton County",2,18,148,87,61
050,29,011,"Missouri","Barton County",2,19,119,69,50
050,29,011,"Missouri","Barton County",2,20,121,64,57
050,29,011,"Missouri","Barton County",2,21,117,60,57
050,29,011,"Missouri","Barton County",2,22,121,57,64
050,29,011,"Missouri","Barton County",2,23,128,64,64
050,29,011,"Missouri","Barton County",2,24,133,68,65
050,29,011,"Missouri","Barton County",2,25,126,62,64
050,29,011,"Missouri","Barton County",2,26,119,62,57
050,29,011,"Missouri","Barton County",2,27,128,69,59
050,29,011,"Missouri","Barton County",2,28,141,69,72
050,29,011,"Missouri","Barton County",2,29,135,67,68
050,29,011,"Missouri","Barton County",2,30,136,72,64
050,29,011,"Missouri","Barton County",2,31,113,55,58
050,29,011,"Missouri","Barton County",2,32,109,51,58
050,29,011,"Missouri","Barton County",2,33,111,51,60
050,29,011,"Missouri","Barton County",2,34,110,51,59
050,29,011,"Missouri","Barton County",2,35,107,56,51
050,29,011,"Missouri","Barton County",2,36,121,62,59
050,29,011,"Missouri","Barton County",2,37,138,62,76
050,29,011,"Missouri","Barton County",2,38,156,72,84
050,29,011,"Missouri","Barton County",2,39,149,74,75
050,29,011,"Missouri","Barton County",2,40,156,81,75
050,29,011,"Missouri","Barton County",2,41,135,69,66
050,29,011,"Missouri","Barton County",2,42,122,61,61
050,29,011,"Missouri","Barton County",2,43,133,68,65
050,29,011,"Missouri","Barton County",2,44,131,67,64
050,29,011,"Missouri","Barton County",2,45,114,59,55
050,29,011,"Missouri","Barton County",2,46,117,62,55
050,29,011,"Missouri","Barton County",2,47,131,71,60
050,29,011,"Missouri","Barton County",2,48,140,73,67
050,29,011,"Missouri","Barton County",2,49,148,73,75
050,29,011,"Missouri","Barton County",2,50,124,60,64
050,29,011,"Missouri","Barton County",2,51,133,64,69
050,29,011,"Missouri","Barton County",2,52,140,68,72
050,29,011,"Missouri","Barton County",2,53,138,68,70
050,29,011,"Missouri","Barton County",2,54,132,66,66
050,29,011,"Missouri","Barton County",2,55,150,74,76
050,29,011,"Missouri","Barton County",2,56,170,86,84
050,29,011,"Missouri","Barton County",2,57,168,81,87
050,29,011,"Missouri","Barton County",2,58,173,86,87
050,29,011,"Missouri","Barton County",2,59,178,88,90
050,29,011,"Missouri","Barton County",2,60,173,83,90
050,29,011,"Missouri","Barton County",2,61,171,89,82
050,29,011,"Missouri","Barton County",2,62,181,94,87
050,29,011,"Missouri","Barton County",2,63,192,93,99
050,29,011,"Missouri","Barton County",2,64,173,89,84
050,29,011,"Missouri","Barton County",2,65,163,84,79
050,29,011,"Missouri","Barton County",2,66,157,79,78
050,29,011,"Missouri","Barton County",2,67,157,74,83
050,29,011,"Missouri","Barton County",2,68,143,68,75
050,29,011,"Missouri","Barton County",2,69,129,60,69
050,29,011,"Missouri","Barton County",2,70,118,55,63
050,29,011,"Missouri","Barton County",2,71,121,52,69
050,29,011,"Missouri","Barton County",2,72,122,60,62
050,29,011,"Missouri","Barton County",2,73,139,65,74
050,29,011,"Missouri","Barton County",2,74,93,40,53
050,29,011,"Missouri","Barton County",2,75,96,43,53
050,29,011,"Missouri","Barton County",2,76,94,45,49
050,29,011,"Missouri","Barton County",2,77,99,46,53
050,29,011,"Missouri","Barton County",2,78,88,40,48
050,29,011,"Missouri","Barton County",2,79,75,36,39
050,29,011,"Missouri","Barton County",2,80,68,34,34
050,29,011,"Missouri","Barton County",2,81,65,32,33
050,29,011,"Missouri","Barton County",2,82,64,29,35
050,29,011,"Missouri","Barton County",2,83,49,22,27
050,29,011,"Missouri","Barton County",2,84,36,15,21
050,29,011,"Missouri","Barton County",2,85,276,93,183
050,29,011,"Missouri","Barton County",3,0,135,74,61
050,29,011,"Missouri","Barton County",3,1,152,84,68
050,29,011,"Missouri","Barton County",3,2,134,70,64
050,29,011,"Missouri","Barton County",3,3,133,65,68
050,29,011,"Missouri","Barton County",3,4,129,76,53
050,29,011,"Missouri","Barton County",3,5,135,75,60
050,29,011,"Missouri","Barton County",3,6,144,74,70
050,29,011,"Missouri","Barton County",3,7,151,76,75
050,29,011,"Missouri","Barton County",3,8,145,72,73
050,29,011,"Missouri","Barton County",3,9,142,76,66
050,29,011,"Missouri","Barton County",3,10,151,82,69
050,29,011,"Missouri","Barton County",3,11,134,69,65
050,29,011,"Missouri","Barton County",3,12,167,82,85
050,29,011,"Missouri","Barton County",3,13,186,92,94
050,29,011,"Missouri","Barton County",3,14,191,102,89
050,29,011,"Missouri","Barton County",3,15,182,97,85
050,29,011,"Missouri","Barton County",3,16,182,96,86
050,29,011,"Missouri","Barton County",3,17,183,99,84
050,29,011,"Missouri","Barton County",3,18,155,83,72
050,29,011,"Missouri","Barton County",3,19,111,66,45
050,29,011,"Missouri","Barton County",3,20,122,67,55
050,29,011,"Missouri","Barton County",3,21,120,60,60
050,29,011,"Missouri","Barton County",3,22,128,63,65
050,29,011,"Missouri","Barton County",3,23,125,59,66
050,29,011,"Missouri","Barton County",3,24,121,63,58
050,29,011,"Missouri","Barton County",3,25,131,69,62
050,29,011,"Missouri","Barton County",3,26,125,59,66
050,29,011,"Missouri","Barton County",3,27,135,71,64
050,29,011,"Missouri","Barton County",3,28,134,74,60
050,29,011,"Missouri","Barton County",3,29,147,77,70
050,29,011,"Missouri","Barton County",3,30,133,68,65
050,29,011,"Missouri","Barton County",3,31,131,73,58
050,29,011,"Missouri","Barton County",3,32,108,51,57
050,29,011,"Missouri","Barton County",3,33,114,53,61
050,29,011,"Missouri","Barton County",3,34,112,53,59
050,29,011,"Missouri","Barton County",3,35,110,51,59
050,29,011,"Missouri","Barton County",3,36,109,57,52
050,29,011,"Missouri","Barton County",3,37,127,67,60
050,29,011,"Missouri","Barton County",3,38,141,57,84
050,29,011,"Missouri","Barton County",3,39,162,78,84
050,29,011,"Missouri","Barton County",3,40,148,66,82
050,29,011,"Missouri","Barton County",3,41,154,81,73
050,29,011,"Missouri","Barton County",3,42,141,71,70
050,29,011,"Missouri","Barton County",3,43,134,72,62
050,29,011,"Missouri","Barton County",3,44,128,66,62
050,29,011,"Missouri","Barton County",3,45,120,59,61
050,29,011,"Missouri","Barton County",3,46,118,62,56
050,29,011,"Missouri","Barton County",3,47,119,64,55
050,29,011,"Missouri","Barton County",3,48,135,74,61
050,29,011,"Missouri","Barton County",3,49,140,72,68
050,29,011,"Missouri","Barton County",3,50,139,68,71
050,29,011,"Missouri","Barton County",3,51,131,64,67
050,29,011,"Missouri","Barton County",3,52,136,63,73
050,29,011,"Missouri","Barton County",3,53,139,67,72
050,29,011,"Missouri","Barton County",3,54,134,67,67
050,29,011,"Missouri","Barton County",3,55,128,64,64
050,29,011,"Missouri","Barton County",3,56,149,76,73
050,29,011,"Missouri","Barton County",3,57,162,80,82
050,29,011,"Missouri","Barton County",3,58,171,84,87
050,29,011,"Missouri","Barton County",3,59,165,82,83
050,29,011,"Missouri","Barton County",3,60,183,91,92
050,29,011,"Missouri","Barton County",3,61,168,79,89
050,29,011,"Missouri","Barton County",3,62,165,88,77
050,29,011,"Missouri","Barton County",3,63,183,95,88
050,29,011,"Missouri","Barton County",3,64,187,91,96
050,29,011,"Missouri","Barton County",3,65,167,86,81
050,29,011,"Missouri","Barton County",3,66,167,85,82
050,29,011,"Missouri","Barton County",3,67,156,77,79
050,29,011,"Missouri","Barton County",3,68,152,71,81
050,29,011,"Missouri","Barton County",3,69,143,68,75
050,29,011,"Missouri","Barton County",3,70,129,61,68
050,29,011,"Missouri","Barton County",3,71,115,54,61
050,29,011,"Missouri","Barton County",3,72,121,54,67
050,29,011,"Missouri","Barton County",3,73,115,58,57
050,29,011,"Missouri","Barton County",3,74,138,64,74
050,29,011,"Missouri","Barton County",3,75,87,37,50
050,29,011,"Missouri","Barton County",3,76,91,41,50
050,29,011,"Missouri","Barton County",3,77,85,39,46
050,29,011,"Missouri","Barton County",3,78,94,45,49
050,29,011,"Missouri","Barton County",3,79,86,38,48
050,29,011,"Missouri","Barton County",3,80,72,34,38
050,29,011,"Missouri","Barton County",3,81,60,27,33
050,29,011,"Missouri","Barton County",3,82,61,29,32
050,29,011,"Missouri","Barton County",3,83,56,24,32
050,29,011,"Missouri","Barton County",3,84,44,18,26
050,29,011,"Missouri","Barton County",3,85,272,92,180
050,29,011,"Missouri","Barton County",4,0,129,65,64
050,29,011,"Missouri","Barton County",4,1,143,77,66
050,29,011,"Missouri","Barton County",4,2,152,81,71
050,29,011,"Missouri","Barton County",4,3,131,67,64
050,29,011,"Missouri","Barton County",4,4,138,70,68
050,29,011,"Missouri","Barton County",4,5,130,77,53
050,29,011,"Missouri","Barton County",4,6,138,75,63
050,29,011,"Missouri","Barton County",4,7,138,72,66
050,29,011,"Missouri","Barton County",4,8,157,81,76
050,29,011,"Missouri","Barton County",4,9,133,70,63
050,29,011,"Missouri","Barton County",4,10,148,76,72
050,29,011,"Missouri","Barton County",4,11,156,83,73
050,29,011,"Missouri","Barton County",4,12,136,70,66
050,29,011,"Missouri","Barton County",4,13,163,80,83
050,29,011,"Missouri","Barton County",4,14,187,96,91
050,29,011,"Missouri","Barton County",4,15,185,101,84
050,29,011,"Missouri","Barton County",4,16,188,100,88
050,29,011,"Missouri","Barton County",4,17,183,102,81
050,29,011,"Missouri","Barton County",4,18,141,77,64
050,29,011,"Missouri","Barton County",4,19,124,67,57
050,29,011,"Missouri","Barton County",4,20,120,68,52
050,29,011,"Missouri","Barton County",4,21,129,71,58
050,29,011,"Missouri","Barton County",4,22,123,64,59
050,29,011,"Missouri","Barton County",4,23,126,64,62
050,29,011,"Missouri","Barton County",4,24,120,54,66
050,29,011,"Missouri","Barton County",4,25,135,69,66
050,29,011,"Missouri","Barton County",4,26,135,71,64
050,29,011,"Missouri","Barton County",4,27,118,56,62
050,29,011,"Missouri","Barton County",4,28,137,73,64
050,29,011,"Missouri","Barton County",4,29,142,75,67
050,29,011,"Missouri","Barton County",4,30,148,78,70
050,29,011,"Missouri","Barton County",4,31,133,65,68
050,29,011,"Missouri","Barton County",4,32,131,69,62
050,29,011,"Missouri","Barton County",4,33,114,58,56
050,29,011,"Missouri","Barton County",4,34,116,54,62
050,29,011,"Missouri","Barton County",4,35,110,54,56
050,29,011,"Missouri","Barton County",4,36,110,48,62
050,29,011,"Missouri","Barton County",4,37,113,59,54
050,29,011,"Missouri","Barton County",4,38,125,67,58
050,29,011,"Missouri","Barton County",4,39,148,59,89
050,29,011,"Missouri","Barton County",4,40,162,78,84
050,29,011,"Missouri","Barton County",4,41,151,68,83
050,29,011,"Missouri","Barton County",4,42,152,78,74
050,29,011,"Missouri","Barton County",4,43,141,71,70
050,29,011,"Missouri","Barton County",4,44,135,71,64
050,29,011,"Missouri","Barton County",4,45,131,67,64
050,29,011,"Missouri","Barton County",4,46,125,59,66
050,29,011,"Missouri","Barton County",4,47,120,62,58
050,29,011,"Missouri","Barton County",4,48,116,59,57
050,29,011,"Missouri","Barton County",4,49,136,75,61
050,29,011,"Missouri","Barton County",4,50,141,75,66
050,29,011,"Missouri","Barton County",4,51,141,71,70
050,29,011,"Missouri","Barton County",4,52,141,67,74
050,29,011,"Missouri","Barton County",4,53,140,65,75
050,29,011,"Missouri","Barton County",4,54,145,69,76
050,29,011,"Missouri","Barton County",4,55,139,68,71
050,29,011,"Missouri","Barton County",4,56,127,64,63
050,29,011,"Missouri","Barton County",4,57,153,80,73
050,29,011,"Missouri","Barton County",4,58,164,80,84
050,29,011,"Missouri","Barton County",4,59,171,87,84
050,29,011,"Missouri","Barton County",4,60,169,84,85
050,29,011,"Missouri","Barton County",4,61,182,87,95
050,29,011,"Missouri","Barton County",4,62,167,80,87
050,29,011,"Missouri","Barton County",4,63,171,88,83
050,29,011,"Missouri","Barton County",4,64,181,92,89
050,29,011,"Missouri","Barton County",4,65,179,88,91
050,29,011,"Missouri","Barton County",4,66,167,87,80
050,29,011,"Missouri","Barton County",4,67,162,79,83
050,29,011,"Missouri","Barton County",4,68,153,75,78
050,29,011,"Missouri","Barton County",4,69,149,69,80
050,29,011,"Missouri","Barton County",4,70,137,66,71
050,29,011,"Missouri","Barton County",4,71,126,60,66
050,29,011,"Missouri","Barton County",4,72,108,49,59
050,29,011,"Missouri","Barton County",4,73,119,56,63
050,29,011,"Missouri","Barton County",4,74,115,60,55
050,29,011,"Missouri","Barton County",4,75,132,61,71
050,29,011,"Missouri","Barton County",4,76,79,34,45
050,29,011,"Missouri","Barton County",4,77,86,38,48
050,29,011,"Missouri","Barton County",4,78,76,37,39
050,29,011,"Missouri","Barton County",4,79,87,42,45
050,29,011,"Missouri","Barton County",4,80,81,36,45
050,29,011,"Missouri","Barton County",4,81,70,31,39
050,29,011,"Missouri","Barton County",4,82,56,24,32
050,29,011,"Missouri","Barton County",4,83,56,27,29
050,29,011,"Missouri","Barton County",4,84,53,22,31
050,29,011,"Missouri","Barton County",4,85,270,93,177
050,29,011,"Missouri","Barton County",5,0,133,68,65
050,29,011,"Missouri","Barton County",5,1,120,63,57
050,29,011,"Missouri","Barton County",5,2,149,82,67
050,29,011,"Missouri","Barton County",5,3,151,79,72
050,29,011,"Missouri","Barton County",5,4,130,66,64
050,29,011,"Missouri","Barton County",5,5,140,69,71
050,29,011,"Missouri","Barton County",5,6,132,82,50
050,29,011,"Missouri","Barton County",5,7,144,77,67
050,29,011,"Missouri","Barton County",5,8,140,75,65
050,29,011,"Missouri","Barton County",5,9,170,83,87
050,29,011,"Missouri","Barton County",5,10,141,70,71
050,29,011,"Missouri","Barton County",5,11,158,80,78
050,29,011,"Missouri","Barton County",5,12,155,84,71
050,29,011,"Missouri","Barton County",5,13,146,72,74
050,29,011,"Missouri","Barton County",5,14,169,88,81
050,29,011,"Missouri","Barton County",5,15,184,97,87
050,29,011,"Missouri","Barton County",5,16,191,103,88
050,29,011,"Missouri","Barton County",5,17,190,102,88
050,29,011,"Missouri","Barton County",5,18,155,87,68
050,29,011,"Missouri","Barton County",5,19,107,57,50
050,29,011,"Missouri","Barton County",5,20,134,72,62
050,29,011,"Missouri","Barton County",5,21,124,66,58
050,29,011,"Missouri","Barton County",5,22,127,69,58
050,29,011,"Missouri","Barton County",5,23,127,67,60
050,29,011,"Missouri","Barton County",5,24,130,69,61
050,29,011,"Missouri","Barton County",5,25,138,66,72
050,29,011,"Missouri","Barton County",5,26,133,70,63
050,29,011,"Missouri","Barton County",5,27,142,75,67
050,29,011,"Missouri","Barton County",5,28,121,59,62
050,29,011,"Missouri","Barton County",5,29,135,72,63
050,29,011,"Missouri","Barton County",5,30,137,73,64
050,29,011,"Missouri","Barton County",5,31,148,79,69
050,29,011,"Missouri","Barton County",5,32,131,63,68
050,29,011,"Missouri","Barton County",5,33,128,69,59
050,29,011,"Missouri","Barton County",5,34,115,55,60
050,29,011,"Missouri","Barton County",5,35,120,60,60
050,29,011,"Missouri","Barton County",5,36,119,58,61
050,29,011,"Missouri","Barton County",5,37,114,52,62
050,29,011,"Missouri","Barton County",5,38,126,65,61
050,29,011,"Missouri","Barton County",5,39,131,69,62
050,29,011,"Missouri","Barton County",5,40,148,59,89
050,29,011,"Missouri","Barton County",5,41,159,78,81
050,29,011,"Missouri","Barton County",5,42,153,68,85
050,29,011,"Missouri","Barton County",5,43,158,83,75
050,29,011,"Missouri","Barton County",5,44,136,67,69
050,29,011,"Missouri","Barton County",5,45,135,72,63
050,29,011,"Missouri","Barton County",5,46,129,64,65
050,29,011,"Missouri","Barton County",5,47,120,59,61
050,29,011,"Missouri","Barton County",5,48,122,64,58
050,29,011,"Missouri","Barton County",5,49,117,59,58
050,29,011,"Missouri","Barton County",5,50,130,72,58
050,29,011,"Missouri","Barton County",5,51,137,75,62
050,29,011,"Missouri","Barton County",5,52,149,79,70
050,29,011,"Missouri","Barton County",5,53,138,64,74
050,29,011,"Missouri","Barton County",5,54,135,66,69
050,29,011,"Missouri","Barton County",5,55,141,71,70
050,29,011,"Missouri","Barton County",5,56,131,62,69
050,29,011,"Missouri","Barton County",5,57,130,63,67
050,29,011,"Missouri","Barton County",5,58,149,81,68
050,29,011,"Missouri","Barton County",5,59,165,81,84
050,29,011,"Missouri","Barton County",5,60,173,87,86
050,29,011,"Missouri","Barton County",5,61,172,84,88
050,29,011,"Missouri","Barton County",5,62,183,85,98
050,29,011,"Missouri","Barton County",5,63,166,78,88
050,29,011,"Missouri","Barton County",5,64,170,87,83
050,29,011,"Missouri","Barton County",5,65,174,90,84
050,29,011,"Missouri","Barton County",5,66,176,87,89
050,29,011,"Missouri","Barton County",5,67,158,82,76
050,29,011,"Missouri","Barton County",5,68,166,80,86
050,29,011,"Missouri","Barton County",5,69,150,73,77
050,29,011,"Missouri","Barton County",5,70,147,70,77
050,29,011,"Missouri","Barton County",5,71,135,64,71
050,29,011,"Missouri","Barton County",5,72,121,55,66
050,29,011,"Missouri","Barton County",5,73,101,47,54
050,29,011,"Missouri","Barton County",5,74,116,53,63
050,29,011,"Missouri","Barton County",5,75,112,59,53
050,29,011,"Missouri","Barton County",5,76,126,61,65
050,29,011,"Missouri","Barton County",5,77,76,31,45
050,29,011,"Missouri","Barton County",5,78,79,37,42
050,29,011,"Missouri","Barton County",5,79,69,32,37
050,29,011,"Missouri","Barton County",5,80,82,40,42
050,29,011,"Missouri","Barton County",5,81,75,30,45
050,29,011,"Missouri","Barton County",5,82,63,28,35
050,29,011,"Missouri","Barton County",5,83,50,22,28
050,29,011,"Missouri","Barton County",5,84,53,24,29
050,29,011,"Missouri","Barton County",5,85,271,92,179
050,29,013,"Missouri","Bates County",1,0,171,88,83
050,29,013,"Missouri","Bates County",1,1,175,93,82
050,29,013,"Missouri","Bates County",1,2,192,96,96
050,29,013,"Missouri","Bates County",1,3,210,111,99
050,29,013,"Missouri","Bates County",1,4,178,83,95
050,29,013,"Missouri","Bates County",1,5,204,109,95
050,29,013,"Missouri","Bates County",1,6,202,109,93
050,29,013,"Missouri","Bates County",1,7,192,101,91
050,29,013,"Missouri","Bates County",1,8,181,94,87
050,29,013,"Missouri","Bates County",1,9,195,99,96
050,29,013,"Missouri","Bates County",1,10,198,98,100
050,29,013,"Missouri","Bates County",1,11,219,107,112
050,29,013,"Missouri","Bates County",1,12,240,110,130
050,29,013,"Missouri","Bates County",1,13,207,97,110
050,29,013,"Missouri","Bates County",1,14,243,109,134
050,29,013,"Missouri","Bates County",1,15,235,119,116
050,29,013,"Missouri","Bates County",1,16,232,136,96
050,29,013,"Missouri","Bates County",1,17,228,134,94
050,29,013,"Missouri","Bates County",1,18,186,108,78
050,29,013,"Missouri","Bates County",1,19,148,82,66
050,29,013,"Missouri","Bates County",1,20,153,76,77
050,29,013,"Missouri","Bates County",1,21,160,85,75
050,29,013,"Missouri","Bates County",1,22,180,102,78
050,29,013,"Missouri","Bates County",1,23,184,100,84
050,29,013,"Missouri","Bates County",1,24,199,107,92
050,29,013,"Missouri","Bates County",1,25,188,95,93
050,29,013,"Missouri","Bates County",1,26,201,107,94
050,29,013,"Missouri","Bates County",1,27,185,99,86
050,29,013,"Missouri","Bates County",1,28,178,91,87
050,29,013,"Missouri","Bates County",1,29,186,100,86
050,29,013,"Missouri","Bates County",1,30,182,92,90
050,29,013,"Missouri","Bates County",1,31,170,90,80
050,29,013,"Missouri","Bates County",1,32,162,84,78
050,29,013,"Missouri","Bates County",1,33,189,105,84
050,29,013,"Missouri","Bates County",1,34,205,109,96
050,29,013,"Missouri","Bates County",1,35,183,96,87
050,29,013,"Missouri","Bates County",1,36,176,92,84
050,29,013,"Missouri","Bates County",1,37,191,92,99
050,29,013,"Missouri","Bates County",1,38,186,87,99
050,29,013,"Missouri","Bates County",1,39,187,82,105
050,29,013,"Missouri","Bates County",1,40,207,98,109
050,29,013,"Missouri","Bates County",1,41,202,93,109
050,29,013,"Missouri","Bates County",1,42,202,104,98
050,29,013,"Missouri","Bates County",1,43,176,85,91
050,29,013,"Missouri","Bates County",1,44,166,85,81
050,29,013,"Missouri","Bates County",1,45,181,96,85
050,29,013,"Missouri","Bates County",1,46,180,104,76
050,29,013,"Missouri","Bates County",1,47,191,99,92
050,29,013,"Missouri","Bates County",1,48,190,99,91
050,29,013,"Missouri","Bates County",1,49,183,96,87
050,29,013,"Missouri","Bates County",1,50,184,105,79
050,29,013,"Missouri","Bates County",1,51,192,98,94
050,29,013,"Missouri","Bates County",1,52,180,86,94
050,29,013,"Missouri","Bates County",1,53,204,105,99
050,29,013,"Missouri","Bates County",1,54,223,112,111
050,29,013,"Missouri","Bates County",1,55,236,121,115
050,29,013,"Missouri","Bates County",1,56,229,117,112
050,29,013,"Missouri","Bates County",1,57,239,110,129
050,29,013,"Missouri","Bates County",1,58,271,138,133
050,29,013,"Missouri","Bates County",1,59,250,133,117
050,29,013,"Missouri","Bates County",1,60,233,110,123
050,29,013,"Missouri","Bates County",1,61,250,126,124
050,29,013,"Missouri","Bates County",1,62,233,114,119
050,29,013,"Missouri","Bates County",1,63,213,113,100
050,29,013,"Missouri","Bates County",1,64,224,124,100
050,29,013,"Missouri","Bates County",1,65,220,115,105
050,29,013,"Missouri","Bates County",1,66,203,105,98
050,29,013,"Missouri","Bates County",1,67,198,92,106
050,29,013,"Missouri","Bates County",1,68,200,97,103
050,29,013,"Missouri","Bates County",1,69,184,92,92
050,29,013,"Missouri","Bates County",1,70,182,84,98
050,29,013,"Missouri","Bates County",1,71,157,81,76
050,29,013,"Missouri","Bates County",1,72,148,80,68
050,29,013,"Missouri","Bates County",1,73,158,83,75
050,29,013,"Missouri","Bates County",1,74,125,56,69
050,29,013,"Missouri","Bates County",1,75,113,53,60
050,29,013,"Missouri","Bates County",1,76,119,54,65
050,29,013,"Missouri","Bates County",1,77,128,56,72
050,29,013,"Missouri","Bates County",1,78,108,43,65
050,29,013,"Missouri","Bates County",1,79,107,43,64
050,29,013,"Missouri","Bates County",1,80,91,40,51
050,29,013,"Missouri","Bates County",1,81,93,41,52
050,29,013,"Missouri","Bates County",1,82,88,40,48
050,29,013,"Missouri","Bates County",1,83,81,35,46
050,29,013,"Missouri","Bates County",1,84,71,26,45
050,29,013,"Missouri","Bates County",1,85,344,125,219
050,29,013,"Missouri","Bates County",2,0,180,98,82
050,29,013,"Missouri","Bates County",2,1,173,91,82
050,29,013,"Missouri","Bates County",2,2,188,96,92
050,29,013,"Missouri","Bates County",2,3,207,108,99
050,29,013,"Missouri","Bates County",2,4,189,93,96
050,29,013,"Missouri","Bates County",2,5,199,104,95
050,29,013,"Missouri","Bates County",2,6,202,108,94
050,29,013,"Missouri","Bates County",2,7,192,100,92
050,29,013,"Missouri","Bates County",2,8,183,94,89
050,29,013,"Missouri","Bates County",2,9,191,98,93
050,29,013,"Missouri","Bates County",2,10,199,99,100
050,29,013,"Missouri","Bates County",2,11,214,103,111
050,29,013,"Missouri","Bates County",2,12,235,108,127
050,29,013,"Missouri","Bates County",2,13,215,100,115
050,29,013,"Missouri","Bates County",2,14,234,107,127
050,29,013,"Missouri","Bates County",2,15,238,117,121
050,29,013,"Missouri","Bates County",2,16,235,133,102
050,29,013,"Missouri","Bates County",2,17,230,134,96
050,29,013,"Missouri","Bates County",2,18,185,109,76
050,29,013,"Missouri","Bates County",2,19,147,82,65
050,29,013,"Missouri","Bates County",2,20,157,78,79
050,29,013,"Missouri","Bates County",2,21,160,83,77
050,29,013,"Missouri","Bates County",2,22,179,98,81
050,29,013,"Missouri","Bates County",2,23,187,102,85
050,29,013,"Missouri","Bates County",2,24,198,106,92
050,29,013,"Missouri","Bates County",2,25,191,97,94
050,29,013,"Missouri","Bates County",2,26,197,104,93
050,29,013,"Missouri","Bates County",2,27,192,103,89
050,29,013,"Missouri","Bates County",2,28,181,93,88
050,29,013,"Missouri","Bates County",2,29,186,99,87
050,29,013,"Missouri","Bates County",2,30,185,95,90
050,29,013,"Missouri","Bates County",2,31,169,89,80
050,29,013,"Missouri","Bates County",2,32,164,86,78
050,29,013,"Missouri","Bates County",2,33,183,101,82
050,29,013,"Missouri","Bates County",2,34,202,109,93
050,29,013,"Missouri","Bates County",2,35,186,97,89
050,29,013,"Missouri","Bates County",2,36,176,93,83
050,29,013,"Missouri","Bates County",2,37,188,93,95
050,29,013,"Missouri","Bates County",2,38,190,89,101
050,29,013,"Missouri","Bates County",2,39,186,82,104
050,29,013,"Missouri","Bates County",2,40,204,95,109
050,29,013,"Missouri","Bates County",2,41,205,97,108
050,29,013,"Missouri","Bates County",2,42,197,98,99
050,29,013,"Missouri","Bates County",2,43,184,90,94
050,29,013,"Missouri","Bates County",2,44,166,84,82
050,29,013,"Missouri","Bates County",2,45,178,93,85
050,29,013,"Missouri","Bates County",2,46,180,102,78
050,29,013,"Missouri","Bates County",2,47,190,102,88
050,29,013,"Missouri","Bates County",2,48,187,97,90
050,29,013,"Missouri","Bates County",2,49,185,97,88
050,29,013,"Missouri","Bates County",2,50,186,105,81
050,29,013,"Missouri","Bates County",2,51,191,99,92
050,29,013,"Missouri","Bates County",2,52,182,88,94
050,29,013,"Missouri","Bates County",2,53,201,103,98
050,29,013,"Missouri","Bates County",2,54,215,106,109
050,29,013,"Missouri","Bates County",2,55,235,120,115
050,29,013,"Missouri","Bates County",2,56,232,119,113
050,29,013,"Missouri","Bates County",2,57,236,112,124
050,29,013,"Missouri","Bates County",2,58,264,133,131
050,29,013,"Missouri","Bates County",2,59,253,133,120
050,29,013,"Missouri","Bates County",2,60,235,113,122
050,29,013,"Missouri","Bates County",2,61,245,122,123
050,29,013,"Missouri","Bates County",2,62,236,118,118
050,29,013,"Missouri","Bates County",2,63,219,113,106
050,29,013,"Missouri","Bates County",2,64,220,119,101
050,29,013,"Missouri","Bates County",2,65,219,116,103
050,29,013,"Missouri","Bates County",2,66,209,108,101
050,29,013,"Missouri","Bates County",2,67,199,94,105
050,29,013,"Missouri","Bates County",2,68,198,96,102
050,29,013,"Missouri","Bates County",2,69,187,91,96
050,29,013,"Missouri","Bates County",2,70,179,83,96
050,29,013,"Missouri","Bates County",2,71,160,80,80
050,29,013,"Missouri","Bates County",2,72,148,80,68
050,29,013,"Missouri","Bates County",2,73,162,85,77
050,29,013,"Missouri","Bates County",2,74,124,58,66
050,29,013,"Missouri","Bates County",2,75,116,53,63
050,29,013,"Missouri","Bates County",2,76,116,53,63
050,29,013,"Missouri","Bates County",2,77,128,56,72
050,29,013,"Missouri","Bates County",2,78,110,45,65
050,29,013,"Missouri","Bates County",2,79,106,43,63
050,29,013,"Missouri","Bates County",2,80,92,39,53
050,29,013,"Missouri","Bates County",2,81,92,40,52
050,29,013,"Missouri","Bates County",2,82,90,39,51
050,29,013,"Missouri","Bates County",2,83,80,36,44
050,29,013,"Missouri","Bates County",2,84,72,28,44
050,29,013,"Missouri","Bates County",2,85,347,123,224
050,29,013,"Missouri","Bates County",3,0,180,92,88
050,29,013,"Missouri","Bates County",3,1,206,108,98
050,29,013,"Missouri","Bates County",3,2,183,96,87
050,29,013,"Missouri","Bates County",3,3,195,104,91
050,29,013,"Missouri","Bates County",3,4,213,113,100
050,29,013,"Missouri","Bates County",3,5,189,92,97
050,29,013,"Missouri","Bates County",3,6,199,107,92
050,29,013,"Missouri","Bates County",3,7,196,105,91
050,29,013,"Missouri","Bates County",3,8,188,103,85
050,29,013,"Missouri","Bates County",3,9,199,107,92
050,29,013,"Missouri","Bates County",3,10,204,110,94
050,29,013,"Missouri","Bates County",3,11,204,99,105
050,29,013,"Missouri","Bates County",3,12,224,110,114
050,29,013,"Missouri","Bates County",3,13,238,114,124
050,29,013,"Missouri","Bates County",3,14,217,104,113
050,29,013,"Missouri","Bates County",3,15,236,103,133
050,29,013,"Missouri","Bates County",3,16,236,119,117
050,29,013,"Missouri","Bates County",3,17,222,122,100
050,29,013,"Missouri","Bates County",3,18,197,116,81
050,29,013,"Missouri","Bates County",3,19,147,82,65
050,29,013,"Missouri","Bates County",3,20,161,86,75
050,29,013,"Missouri","Bates County",3,21,158,82,76
050,29,013,"Missouri","Bates County",3,22,169,85,84
050,29,013,"Missouri","Bates County",3,23,193,108,85
050,29,013,"Missouri","Bates County",3,24,186,106,80
050,29,013,"Missouri","Bates County",3,25,190,105,85
050,29,013,"Missouri","Bates County",3,26,193,105,88
050,29,013,"Missouri","Bates County",3,27,210,109,101
050,29,013,"Missouri","Bates County",3,28,197,98,99
050,29,013,"Missouri","Bates County",3,29,173,88,85
050,29,013,"Missouri","Bates County",3,30,200,102,98
050,29,013,"Missouri","Bates County",3,31,181,95,86
050,29,013,"Missouri","Bates County",3,32,169,81,88
050,29,013,"Missouri","Bates County",3,33,172,91,81
050,29,013,"Missouri","Bates County",3,34,190,107,83
050,29,013,"Missouri","Bates County",3,35,188,100,88
050,29,013,"Missouri","Bates County",3,36,176,93,83
050,29,013,"Missouri","Bates County",3,37,168,89,79
050,29,013,"Missouri","Bates County",3,38,187,91,96
050,29,013,"Missouri","Bates County",3,39,192,92,100
050,29,013,"Missouri","Bates County",3,40,184,83,101
050,29,013,"Missouri","Bates County",3,41,203,96,107
050,29,013,"Missouri","Bates County",3,42,210,95,115
050,29,013,"Missouri","Bates County",3,43,190,98,92
050,29,013,"Missouri","Bates County",3,44,181,87,94
050,29,013,"Missouri","Bates County",3,45,182,92,90
050,29,013,"Missouri","Bates County",3,46,179,97,82
050,29,013,"Missouri","Bates County",3,47,178,100,78
050,29,013,"Missouri","Bates County",3,48,181,98,83
050,29,013,"Missouri","Bates County",3,49,186,96,90
050,29,013,"Missouri","Bates County",3,50,188,99,89
050,29,013,"Missouri","Bates County",3,51,173,94,79
050,29,013,"Missouri","Bates County",3,52,188,96,92
050,29,013,"Missouri","Bates County",3,53,195,93,102
050,29,013,"Missouri","Bates County",3,54,201,103,98
050,29,013,"Missouri","Bates County",3,55,221,106,115
050,29,013,"Missouri","Bates County",3,56,241,124,117
050,29,013,"Missouri","Bates County",3,57,230,118,112
050,29,013,"Missouri","Bates County",3,58,245,120,125
050,29,013,"Missouri","Bates County",3,59,278,141,137
050,29,013,"Missouri","Bates County",3,60,247,126,121
050,29,013,"Missouri","Bates County",3,61,239,114,125
050,29,013,"Missouri","Bates County",3,62,242,119,123
050,29,013,"Missouri","Bates County",3,63,225,113,112
050,29,013,"Missouri","Bates County",3,64,227,115,112
050,29,013,"Missouri","Bates County",3,65,216,115,101
050,29,013,"Missouri","Bates County",3,66,217,118,99
050,29,013,"Missouri","Bates County",3,67,205,109,96
050,29,013,"Missouri","Bates County",3,68,195,92,103
050,29,013,"Missouri","Bates County",3,69,199,96,103
050,29,013,"Missouri","Bates County",3,70,180,86,94
050,29,013,"Missouri","Bates County",3,71,181,83,98
050,29,013,"Missouri","Bates County",3,72,158,81,77
050,29,013,"Missouri","Bates County",3,73,135,70,65
050,29,013,"Missouri","Bates County",3,74,153,81,72
050,29,013,"Missouri","Bates County",3,75,122,56,66
050,29,013,"Missouri","Bates County",3,76,108,49,59
050,29,013,"Missouri","Bates County",3,77,109,47,62
050,29,013,"Missouri","Bates County",3,78,117,54,63
050,29,013,"Missouri","Bates County",3,79,103,38,65
050,29,013,"Missouri","Bates County",3,80,94,40,54
050,29,013,"Missouri","Bates County",3,81,91,37,54
050,29,013,"Missouri","Bates County",3,82,88,34,54
050,29,013,"Missouri","Bates County",3,83,82,37,45
050,29,013,"Missouri","Bates County",3,84,75,35,40
050,29,013,"Missouri","Bates County",3,85,327,120,207
050,29,013,"Missouri","Bates County",4,0,175,93,82
050,29,013,"Missouri","Bates County",4,1,167,85,82
050,29,013,"Missouri","Bates County",4,2,228,124,104
050,29,013,"Missouri","Bates County",4,3,173,94,79
050,29,013,"Missouri","Bates County",4,4,208,115,93
050,29,013,"Missouri","Bates County",4,5,206,108,98
050,29,013,"Missouri","Bates County",4,6,198,96,102
050,29,013,"Missouri","Bates County",4,7,206,112,94
050,29,013,"Missouri","Bates County",4,8,206,107,99
050,29,013,"Missouri","Bates County",4,9,193,100,93
050,29,013,"Missouri","Bates County",4,10,206,110,96
050,29,013,"Missouri","Bates County",4,11,208,106,102
050,29,013,"Missouri","Bates County",4,12,221,109,112
050,29,013,"Missouri","Bates County",4,13,238,120,118
050,29,013,"Missouri","Bates County",4,14,240,114,126
050,29,013,"Missouri","Bates County",4,15,221,103,118
050,29,013,"Missouri","Bates County",4,16,234,104,130
050,29,013,"Missouri","Bates County",4,17,240,120,120
050,29,013,"Missouri","Bates County",4,18,188,108,80
050,29,013,"Missouri","Bates County",4,19,152,90,62
050,29,013,"Missouri","Bates County",4,20,161,84,77
050,29,013,"Missouri","Bates County",4,21,161,82,79
050,29,013,"Missouri","Bates County",4,22,166,81,85
050,29,013,"Missouri","Bates County",4,23,174,90,84
050,29,013,"Missouri","Bates County",4,24,180,97,83
050,29,013,"Missouri","Bates County",4,25,188,109,79
050,29,013,"Missouri","Bates County",4,26,188,96,92
050,29,013,"Missouri","Bates County",4,27,206,108,98
050,29,013,"Missouri","Bates County",4,28,191,91,100
050,29,013,"Missouri","Bates County",4,29,207,105,102
050,29,013,"Missouri","Bates County",4,30,192,94,98
050,29,013,"Missouri","Bates County",4,31,198,106,92
050,29,013,"Missouri","Bates County",4,32,191,98,93
050,29,013,"Missouri","Bates County",4,33,190,94,96
050,29,013,"Missouri","Bates County",4,34,183,97,86
050,29,013,"Missouri","Bates County",4,35,182,96,86
050,29,013,"Missouri","Bates County",4,36,197,102,95
050,29,013,"Missouri","Bates County",4,37,187,99,88
050,29,013,"Missouri","Bates County",4,38,182,95,87
050,29,013,"Missouri","Bates County",4,39,177,90,87
050,29,013,"Missouri","Bates County",4,40,195,98,97
050,29,013,"Missouri","Bates County",4,41,189,85,104
050,29,013,"Missouri","Bates County",4,42,189,92,97
050,29,013,"Missouri","Bates County",4,43,206,90,116
050,29,013,"Missouri","Bates County",4,44,192,100,92
050,29,013,"Missouri","Bates County",4,45,194,92,102
050,29,013,"Missouri","Bates County",4,46,180,87,93
050,29,013,"Missouri","Bates County",4,47,184,98,86
050,29,013,"Missouri","Bates County",4,48,180,101,79
050,29,013,"Missouri","Bates County",4,49,186,102,84
050,29,013,"Missouri","Bates County",4,50,190,96,94
050,29,013,"Missouri","Bates County",4,51,186,95,91
050,29,013,"Missouri","Bates County",4,52,181,100,81
050,29,013,"Missouri","Bates County",4,53,202,103,99
050,29,013,"Missouri","Bates County",4,54,187,88,99
050,29,013,"Missouri","Bates County",4,55,206,106,100
050,29,013,"Missouri","Bates County",4,56,214,99,115
050,29,013,"Missouri","Bates County",4,57,232,125,107
050,29,013,"Missouri","Bates County",4,58,228,116,112
050,29,013,"Missouri","Bates County",4,59,243,124,119
050,29,013,"Missouri","Bates County",4,60,260,130,130
050,29,013,"Missouri","Bates County",4,61,234,121,113
050,29,013,"Missouri","Bates County",4,62,237,109,128
050,29,013,"Missouri","Bates County",4,63,237,114,123
050,29,013,"Missouri","Bates County",4,64,228,113,115
050,29,013,"Missouri","Bates County",4,65,216,112,104
050,29,013,"Missouri","Bates County",4,66,214,112,102
050,29,013,"Missouri","Bates County",4,67,210,112,98
050,29,013,"Missouri","Bates County",4,68,201,105,96
050,29,013,"Missouri","Bates County",4,69,193,92,101
050,29,013,"Missouri","Bates County",4,70,190,92,98
050,29,013,"Missouri","Bates County",4,71,182,86,96
050,29,013,"Missouri","Bates County",4,72,173,84,89
050,29,013,"Missouri","Bates County",4,73,152,76,76
050,29,013,"Missouri","Bates County",4,74,131,72,59
050,29,013,"Missouri","Bates County",4,75,150,79,71
050,29,013,"Missouri","Bates County",4,76,119,53,66
050,29,013,"Missouri","Bates County",4,77,106,44,62
050,29,013,"Missouri","Bates County",4,78,107,49,58
050,29,013,"Missouri","Bates County",4,79,110,51,59
050,29,013,"Missouri","Bates County",4,80,85,35,50
050,29,013,"Missouri","Bates County",4,81,90,37,53
050,29,013,"Missouri","Bates County",4,82,91,32,59
050,29,013,"Missouri","Bates County",4,83,80,31,49
050,29,013,"Missouri","Bates County",4,84,72,31,41
050,29,013,"Missouri","Bates County",4,85,329,133,196
050,29,013,"Missouri","Bates County",5,0,177,96,81
050,29,013,"Missouri","Bates County",5,1,190,109,81
050,29,013,"Missouri","Bates County",5,2,171,89,82
050,29,013,"Missouri","Bates County",5,3,218,116,102
050,29,013,"Missouri","Bates County",5,4,178,99,79
050,29,013,"Missouri","Bates County",5,5,208,116,92
050,29,013,"Missouri","Bates County",5,6,210,111,99
050,29,013,"Missouri","Bates County",5,7,197,98,99
050,29,013,"Missouri","Bates County",5,8,199,111,88
050,29,013,"Missouri","Bates County",5,9,208,110,98
050,29,013,"Missouri","Bates County",5,10,204,99,105
050,29,013,"Missouri","Bates County",5,11,202,108,94
050,29,013,"Missouri","Bates County",5,12,206,109,97
050,29,013,"Missouri","Bates County",5,13,230,115,115
050,29,013,"Missouri","Bates County",5,14,245,126,119
050,29,013,"Missouri","Bates County",5,15,253,123,130
050,29,013,"Missouri","Bates County",5,16,228,108,120
050,29,013,"Missouri","Bates County",5,17,233,108,125
050,29,013,"Missouri","Bates County",5,18,199,103,96
050,29,013,"Missouri","Bates County",5,19,143,81,62
050,29,013,"Missouri","Bates County",5,20,156,92,64
050,29,013,"Missouri","Bates County",5,21,171,90,81
050,29,013,"Missouri","Bates County",5,22,174,91,83
050,29,013,"Missouri","Bates County",5,23,174,95,79
050,29,013,"Missouri","Bates County",5,24,171,92,79
050,29,013,"Missouri","Bates County",5,25,171,86,85
050,29,013,"Missouri","Bates County",5,26,208,118,90
050,29,013,"Missouri","Bates County",5,27,198,103,95
050,29,013,"Missouri","Bates County",5,28,191,93,98
050,29,013,"Missouri","Bates County",5,29,192,93,99
050,29,013,"Missouri","Bates County",5,30,210,105,105
050,29,013,"Missouri","Bates County",5,31,198,98,100
050,29,013,"Missouri","Bates County",5,32,201,107,94
050,29,013,"Missouri","Bates County",5,33,210,112,98
050,29,013,"Missouri","Bates County",5,34,194,101,93
050,29,013,"Missouri","Bates County",5,35,182,90,92
050,29,013,"Missouri","Bates County",5,36,182,97,85
050,29,013,"Missouri","Bates County",5,37,205,104,101
050,29,013,"Missouri","Bates County",5,38,196,100,96
050,29,013,"Missouri","Bates County",5,39,202,100,102
050,29,013,"Missouri","Bates County",5,40,186,95,91
050,29,013,"Missouri","Bates County",5,41,201,106,95
050,29,013,"Missouri","Bates County",5,42,191,85,106
050,29,013,"Missouri","Bates County",5,43,194,93,101
050,29,013,"Missouri","Bates County",5,44,214,95,119
050,29,013,"Missouri","Bates County",5,45,199,100,99
050,29,013,"Missouri","Bates County",5,46,189,92,97
050,29,013,"Missouri","Bates County",5,47,182,89,93
050,29,013,"Missouri","Bates County",5,48,175,93,82
050,29,013,"Missouri","Bates County",5,49,176,99,77
050,29,013,"Missouri","Bates County",5,50,188,101,87
050,29,013,"Missouri","Bates County",5,51,191,92,99
050,29,013,"Missouri","Bates County",5,52,187,93,94
050,29,013,"Missouri","Bates County",5,53,186,108,78
050,29,013,"Missouri","Bates County",5,54,188,91,97
050,29,013,"Missouri","Bates County",5,55,190,94,96
050,29,013,"Missouri","Bates County",5,56,204,108,96
050,29,013,"Missouri","Bates County",5,57,207,95,112
050,29,013,"Missouri","Bates County",5,58,230,124,106
050,29,013,"Missouri","Bates County",5,59,236,121,115
050,29,013,"Missouri","Bates County",5,60,230,112,118
050,29,013,"Missouri","Bates County",5,61,252,124,128
050,29,013,"Missouri","Bates County",5,62,230,124,106
050,29,013,"Missouri","Bates County",5,63,231,105,126
050,29,013,"Missouri","Bates County",5,64,234,114,120
050,29,013,"Missouri","Bates County",5,65,222,110,112
050,29,013,"Missouri","Bates County",5,66,217,116,101
050,29,013,"Missouri","Bates County",5,67,216,114,102
050,29,013,"Missouri","Bates County",5,68,205,105,100
050,29,013,"Missouri","Bates County",5,69,203,106,97
050,29,013,"Missouri","Bates County",5,70,183,86,97
050,29,013,"Missouri","Bates County",5,71,190,88,102
050,29,013,"Missouri","Bates County",5,72,173,83,90
050,29,013,"Missouri","Bates County",5,73,172,80,92
050,29,013,"Missouri","Bates County",5,74,151,79,72
050,29,013,"Missouri","Bates County",5,75,129,68,61
050,29,013,"Missouri","Bates County",5,76,143,72,71
050,29,013,"Missouri","Bates County",5,77,111,46,65
050,29,013,"Missouri","Bates County",5,78,104,45,59
050,29,013,"Missouri","Bates County",5,79,98,42,56
050,29,013,"Missouri","Bates County",5,80,91,45,46
050,29,013,"Missouri","Bates County",5,81,81,30,51
050,29,013,"Missouri","Bates County",5,82,87,30,57
050,29,013,"Missouri","Bates County",5,83,82,28,54
050,29,013,"Missouri","Bates County",5,84,78,33,45
050,29,013,"Missouri","Bates County",5,85,330,141,189
050,29,015,"Missouri","Benton County",1,0,164,83,81
050,29,015,"Missouri","Benton County",1,1,160,86,74
050,29,015,"Missouri","Benton County",1,2,175,99,76
050,29,015,"Missouri","Benton County",1,3,175,91,84
050,29,015,"Missouri","Benton County",1,4,192,99,93
050,29,015,"Missouri","Benton County",1,5,178,87,91
050,29,015,"Missouri","Benton County",1,6,168,88,80
050,29,015,"Missouri","Benton County",1,7,168,87,81
050,29,015,"Missouri","Benton County",1,8,182,100,82
050,29,015,"Missouri","Benton County",1,9,186,101,85
050,29,015,"Missouri","Benton County",1,10,192,93,99
050,29,015,"Missouri","Benton County",1,11,200,106,94
050,29,015,"Missouri","Benton County",1,12,226,116,110
050,29,015,"Missouri","Benton County",1,13,203,101,102
050,29,015,"Missouri","Benton County",1,14,204,98,106
050,29,015,"Missouri","Benton County",1,15,199,111,88
050,29,015,"Missouri","Benton County",1,16,213,112,101
050,29,015,"Missouri","Benton County",1,17,215,109,106
050,29,015,"Missouri","Benton County",1,18,176,97,79
050,29,015,"Missouri","Benton County",1,19,131,72,59
050,29,015,"Missouri","Benton County",1,20,132,72,60
050,29,015,"Missouri","Benton County",1,21,157,88,69
050,29,015,"Missouri","Benton County",1,22,137,80,57
050,29,015,"Missouri","Benton County",1,23,123,61,62
050,29,015,"Missouri","Benton County",1,24,143,73,70
050,29,015,"Missouri","Benton County",1,25,134,67,67
050,29,015,"Missouri","Benton County",1,26,154,81,73
050,29,015,"Missouri","Benton County",1,27,169,79,90
050,29,015,"Missouri","Benton County",1,28,155,78,77
050,29,015,"Missouri","Benton County",1,29,160,89,71
050,29,015,"Missouri","Benton County",1,30,169,95,74
050,29,015,"Missouri","Benton County",1,31,169,93,76
050,29,015,"Missouri","Benton County",1,32,148,78,70
050,29,015,"Missouri","Benton County",1,33,158,84,74
050,29,015,"Missouri","Benton County",1,34,157,81,76
050,29,015,"Missouri","Benton County",1,35,154,82,72
050,29,015,"Missouri","Benton County",1,36,173,83,90
050,29,015,"Missouri","Benton County",1,37,168,75,93
050,29,015,"Missouri","Benton County",1,38,179,84,95
050,29,015,"Missouri","Benton County",1,39,167,89,78
050,29,015,"Missouri","Benton County",1,40,183,96,87
050,29,015,"Missouri","Benton County",1,41,176,89,87
050,29,015,"Missouri","Benton County",1,42,153,75,78
050,29,015,"Missouri","Benton County",1,43,159,85,74
050,29,015,"Missouri","Benton County",1,44,164,86,78
050,29,015,"Missouri","Benton County",1,45,148,64,84
050,29,015,"Missouri","Benton County",1,46,179,89,90
050,29,015,"Missouri","Benton County",1,47,197,106,91
050,29,015,"Missouri","Benton County",1,48,225,117,108
050,29,015,"Missouri","Benton County",1,49,247,120,127
050,29,015,"Missouri","Benton County",1,50,243,117,126
050,29,015,"Missouri","Benton County",1,51,256,134,122
050,29,015,"Missouri","Benton County",1,52,239,128,111
050,29,015,"Missouri","Benton County",1,53,235,115,120
050,29,015,"Missouri","Benton County",1,54,273,139,134
050,29,015,"Missouri","Benton County",1,55,278,149,129
050,29,015,"Missouri","Benton County",1,56,315,155,160
050,29,015,"Missouri","Benton County",1,57,348,175,173
050,29,015,"Missouri","Benton County",1,58,343,169,174
050,29,015,"Missouri","Benton County",1,59,351,173,178
050,29,015,"Missouri","Benton County",1,60,339,176,163
050,29,015,"Missouri","Benton County",1,61,356,181,175
050,29,015,"Missouri","Benton County",1,62,372,189,183
050,29,015,"Missouri","Benton County",1,63,388,189,199
050,29,015,"Missouri","Benton County",1,64,378,199,179
050,29,015,"Missouri","Benton County",1,65,393,190,203
050,29,015,"Missouri","Benton County",1,66,410,197,213
050,29,015,"Missouri","Benton County",1,67,410,196,214
050,29,015,"Missouri","Benton County",1,68,382,195,187
050,29,015,"Missouri","Benton County",1,69,331,177,154
050,29,015,"Missouri","Benton County",1,70,346,174,172
050,29,015,"Missouri","Benton County",1,71,362,174,188
050,29,015,"Missouri","Benton County",1,72,359,181,178
050,29,015,"Missouri","Benton County",1,73,364,195,169
050,29,015,"Missouri","Benton County",1,74,237,130,107
050,29,015,"Missouri","Benton County",1,75,265,131,134
050,29,015,"Missouri","Benton County",1,76,252,121,131
050,29,015,"Missouri","Benton County",1,77,256,139,117
050,29,015,"Missouri","Benton County",1,78,224,113,111
050,29,015,"Missouri","Benton County",1,79,208,108,100
050,29,015,"Missouri","Benton County",1,80,170,89,81
050,29,015,"Missouri","Benton County",1,81,157,76,81
050,29,015,"Missouri","Benton County",1,82,150,76,74
050,29,015,"Missouri","Benton County",1,83,117,53,64
050,29,015,"Missouri","Benton County",1,84,108,51,57
050,29,015,"Missouri","Benton County",1,85,533,221,312
050,29,015,"Missouri","Benton County",2,0,171,86,85
050,29,015,"Missouri","Benton County",2,1,160,86,74
050,29,015,"Missouri","Benton County",2,2,170,95,75
050,29,015,"Missouri","Benton County",2,3,174,91,83
050,29,015,"Missouri","Benton County",2,4,188,95,93
050,29,015,"Missouri","Benton County",2,5,183,91,92
050,29,015,"Missouri","Benton County",2,6,171,88,83
050,29,015,"Missouri","Benton County",2,7,171,89,82
050,29,015,"Missouri","Benton County",2,8,178,98,80
050,29,015,"Missouri","Benton County",2,9,187,102,85
050,29,015,"Missouri","Benton County",2,10,192,96,96
050,29,015,"Missouri","Benton County",2,11,199,105,94
050,29,015,"Missouri","Benton County",2,12,219,114,105
050,29,015,"Missouri","Benton County",2,13,209,105,104
050,29,015,"Missouri","Benton County",2,14,205,99,106
050,29,015,"Missouri","Benton County",2,15,202,108,94
050,29,015,"Missouri","Benton County",2,16,210,112,98
050,29,015,"Missouri","Benton County",2,17,216,110,106
050,29,015,"Missouri","Benton County",2,18,173,94,79
050,29,015,"Missouri","Benton County",2,19,132,72,60
050,29,015,"Missouri","Benton County",2,20,136,76,60
050,29,015,"Missouri","Benton County",2,21,152,84,68
050,29,015,"Missouri","Benton County",2,22,142,84,58
050,29,015,"Missouri","Benton County",2,23,127,67,60
050,29,015,"Missouri","Benton County",2,24,138,70,68
050,29,015,"Missouri","Benton County",2,25,136,68,68
050,29,015,"Missouri","Benton County",2,26,152,79,73
050,29,015,"Missouri","Benton County",2,27,164,79,85
050,29,015,"Missouri","Benton County",2,28,160,80,80
050,29,015,"Missouri","Benton County",2,29,159,88,71
050,29,015,"Missouri","Benton County",2,30,171,96,75
050,29,015,"Missouri","Benton County",2,31,171,95,76
050,29,015,"Missouri","Benton County",2,32,157,83,74
050,29,015,"Missouri","Benton County",2,33,156,83,73
050,29,015,"Missouri","Benton County",2,34,154,80,74
050,29,015,"Missouri","Benton County",2,35,156,81,75
050,29,015,"Missouri","Benton County",2,36,168,82,86
050,29,015,"Missouri","Benton County",2,37,170,78,92
050,29,015,"Missouri","Benton County",2,38,178,82,96
050,29,015,"Missouri","Benton County",2,39,169,87,82
050,29,015,"Missouri","Benton County",2,40,181,96,85
050,29,015,"Missouri","Benton County",2,41,180,93,87
050,29,015,"Missouri","Benton County",2,42,159,78,81
050,29,015,"Missouri","Benton County",2,43,160,84,76
050,29,015,"Missouri","Benton County",2,44,160,83,77
050,29,015,"Missouri","Benton County",2,45,154,71,83
050,29,015,"Missouri","Benton County",2,46,172,83,89
050,29,015,"Missouri","Benton County",2,47,193,101,92
050,29,015,"Missouri","Benton County",2,48,221,116,105
050,29,015,"Missouri","Benton County",2,49,245,121,124
050,29,015,"Missouri","Benton County",2,50,246,120,126
050,29,015,"Missouri","Benton County",2,51,252,130,122
050,29,015,"Missouri","Benton County",2,52,240,129,111
050,29,015,"Missouri","Benton County",2,53,238,119,119
050,29,015,"Missouri","Benton County",2,54,264,133,131
050,29,015,"Missouri","Benton County",2,55,280,147,133
050,29,015,"Missouri","Benton County",2,56,305,152,153
050,29,015,"Missouri","Benton County",2,57,342,172,170
050,29,015,"Missouri","Benton County",2,58,349,173,176
050,29,015,"Missouri","Benton County",2,59,352,175,177
050,29,015,"Missouri","Benton County",2,60,346,178,168
050,29,015,"Missouri","Benton County",2,61,354,181,173
050,29,015,"Missouri","Benton County",2,62,371,188,183
050,29,015,"Missouri","Benton County",2,63,386,189,197
050,29,015,"Missouri","Benton County",2,64,378,195,183
050,29,015,"Missouri","Benton County",2,65,393,194,199
050,29,015,"Missouri","Benton County",2,66,410,199,211
050,29,015,"Missouri","Benton County",2,67,412,197,215
050,29,015,"Missouri","Benton County",2,68,387,196,191
050,29,015,"Missouri","Benton County",2,69,346,182,164
050,29,015,"Missouri","Benton County",2,70,342,175,167
050,29,015,"Missouri","Benton County",2,71,357,172,185
050,29,015,"Missouri","Benton County",2,72,355,177,178
050,29,015,"Missouri","Benton County",2,73,379,203,176
050,29,015,"Missouri","Benton County",2,74,249,135,114
050,29,015,"Missouri","Benton County",2,75,256,130,126
050,29,015,"Missouri","Benton County",2,76,252,121,131
050,29,015,"Missouri","Benton County",2,77,255,135,120
050,29,015,"Missouri","Benton County",2,78,223,116,107
050,29,015,"Missouri","Benton County",2,79,207,106,101
050,29,015,"Missouri","Benton County",2,80,178,93,85
050,29,015,"Missouri","Benton County",2,81,157,78,79
050,29,015,"Missouri","Benton County",2,82,149,74,75
050,29,015,"Missouri","Benton County",2,83,121,56,65
050,29,015,"Missouri","Benton County",2,84,107,50,57
050,29,015,"Missouri","Benton County",2,85,533,220,313
050,29,015,"Missouri","Benton County",3,0,147,70,77
050,29,015,"Missouri","Benton County",3,1,173,79,94
050,29,015,"Missouri","Benton County",3,2,171,86,85
050,29,015,"Missouri","Benton County",3,3,170,90,80
050,29,015,"Missouri","Benton County",3,4,181,94,87
050,29,015,"Missouri","Benton County",3,5,203,103,100
050,29,015,"Missouri","Benton County",3,6,187,96,91
050,29,015,"Missouri","Benton County",3,7,173,88,85
050,29,015,"Missouri","Benton County",3,8,184,99,85
050,29,015,"Missouri","Benton County",3,9,186,100,86
050,29,015,"Missouri","Benton County",3,10,205,115,90
050,29,015,"Missouri","Benton County",3,11,200,100,100
050,29,015,"Missouri","Benton County",3,12,213,112,101
050,29,015,"Missouri","Benton County",3,13,235,117,118
050,29,015,"Missouri","Benton County",3,14,212,107,105
050,29,015,"Missouri","Benton County",3,15,212,104,108
050,29,015,"Missouri","Benton County",3,16,209,110,99
050,29,015,"Missouri","Benton County",3,17,215,119,96
050,29,015,"Missouri","Benton County",3,18,195,106,89
050,29,015,"Missouri","Benton County",3,19,140,77,63
050,29,015,"Missouri","Benton County",3,20,142,80,62
050,29,015,"Missouri","Benton County",3,21,148,72,76
050,29,015,"Missouri","Benton County",3,22,166,93,73
050,29,015,"Missouri","Benton County",3,23,150,79,71
050,29,015,"Missouri","Benton County",3,24,144,77,67
050,29,015,"Missouri","Benton County",3,25,148,79,69
050,29,015,"Missouri","Benton County",3,26,139,73,66
050,29,015,"Missouri","Benton County",3,27,145,82,63
050,29,015,"Missouri","Benton County",3,28,176,83,93
050,29,015,"Missouri","Benton County",3,29,168,79,89
050,29,015,"Missouri","Benton County",3,30,170,94,76
050,29,015,"Missouri","Benton County",3,31,186,104,82
050,29,015,"Missouri","Benton County",3,32,179,95,84
050,29,015,"Missouri","Benton County",3,33,169,82,87
050,29,015,"Missouri","Benton County",3,34,165,85,80
050,29,015,"Missouri","Benton County",3,35,167,86,81
050,29,015,"Missouri","Benton County",3,36,166,84,82
050,29,015,"Missouri","Benton County",3,37,172,84,88
050,29,015,"Missouri","Benton County",3,38,176,81,95
050,29,015,"Missouri","Benton County",3,39,186,90,96
050,29,015,"Missouri","Benton County",3,40,170,86,84
050,29,015,"Missouri","Benton County",3,41,191,99,92
050,29,015,"Missouri","Benton County",3,42,183,94,89
050,29,015,"Missouri","Benton County",3,43,165,84,81
050,29,015,"Missouri","Benton County",3,44,171,86,85
050,29,015,"Missouri","Benton County",3,45,185,97,88
050,29,015,"Missouri","Benton County",3,46,155,72,83
050,29,015,"Missouri","Benton County",3,47,179,85,94
050,29,015,"Missouri","Benton County",3,48,220,110,110
050,29,015,"Missouri","Benton County",3,49,231,120,111
050,29,015,"Missouri","Benton County",3,50,261,127,134
050,29,015,"Missouri","Benton County",3,51,251,118,133
050,29,015,"Missouri","Benton County",3,52,259,134,125
050,29,015,"Missouri","Benton County",3,53,269,140,129
050,29,015,"Missouri","Benton County",3,54,255,131,124
050,29,015,"Missouri","Benton County",3,55,289,148,141
050,29,015,"Missouri","Benton County",3,56,277,142,135
050,29,015,"Missouri","Benton County",3,57,321,162,159
050,29,015,"Missouri","Benton County",3,58,359,173,186
050,29,015,"Missouri","Benton County",3,59,368,184,184
050,29,015,"Missouri","Benton County",3,60,369,182,187
050,29,015,"Missouri","Benton County",3,61,375,194,181
050,29,015,"Missouri","Benton County",3,62,364,186,178
050,29,015,"Missouri","Benton County",3,63,396,195,201
050,29,015,"Missouri","Benton County",3,64,401,197,204
050,29,015,"Missouri","Benton County",3,65,388,196,192
050,29,015,"Missouri","Benton County",3,66,394,203,191
050,29,015,"Missouri","Benton County",3,67,412,202,210
050,29,015,"Missouri","Benton County",3,68,412,201,211
050,29,015,"Missouri","Benton County",3,69,390,197,193
050,29,015,"Missouri","Benton County",3,70,339,179,160
050,29,015,"Missouri","Benton County",3,71,343,177,166
050,29,015,"Missouri","Benton County",3,72,337,161,176
050,29,015,"Missouri","Benton County",3,73,332,166,166
050,29,015,"Missouri","Benton County",3,74,362,193,169
050,29,015,"Missouri","Benton County",3,75,236,130,106
050,29,015,"Missouri","Benton County",3,76,240,124,116
050,29,015,"Missouri","Benton County",3,77,242,116,126
050,29,015,"Missouri","Benton County",3,78,244,125,119
050,29,015,"Missouri","Benton County",3,79,210,110,100
050,29,015,"Missouri","Benton County",3,80,193,96,97
050,29,015,"Missouri","Benton County",3,81,172,89,83
050,29,015,"Missouri","Benton County",3,82,144,72,72
050,29,015,"Missouri","Benton County",3,83,143,73,70
050,29,015,"Missouri","Benton County",3,84,115,54,61
050,29,015,"Missouri","Benton County",3,85,549,238,311
050,29,015,"Missouri","Benton County",4,0,156,76,80
050,29,015,"Missouri","Benton County",4,1,153,70,83
050,29,015,"Missouri","Benton County",4,2,177,81,96
050,29,015,"Missouri","Benton County",4,3,157,83,74
050,29,015,"Missouri","Benton County",4,4,177,96,81
050,29,015,"Missouri","Benton County",4,5,191,96,95
050,29,015,"Missouri","Benton County",4,6,208,109,99
050,29,015,"Missouri","Benton County",4,7,205,105,100
050,29,015,"Missouri","Benton County",4,8,180,95,85
050,29,015,"Missouri","Benton County",4,9,190,106,84
050,29,015,"Missouri","Benton County",4,10,193,101,92
050,29,015,"Missouri","Benton County",4,11,216,118,98
050,29,015,"Missouri","Benton County",4,12,207,108,99
050,29,015,"Missouri","Benton County",4,13,215,117,98
050,29,015,"Missouri","Benton County",4,14,244,121,123
050,29,015,"Missouri","Benton County",4,15,218,107,111
050,29,015,"Missouri","Benton County",4,16,205,98,107
050,29,015,"Missouri","Benton County",4,17,216,114,102
050,29,015,"Missouri","Benton County",4,18,181,100,81
050,29,015,"Missouri","Benton County",4,19,155,85,70
050,29,015,"Missouri","Benton County",4,20,142,77,65
050,29,015,"Missouri","Benton County",4,21,145,76,69
050,29,015,"Missouri","Benton County",4,22,154,83,71
050,29,015,"Missouri","Benton County",4,23,162,91,71
050,29,015,"Missouri","Benton County",4,24,152,82,70
050,29,015,"Missouri","Benton County",4,25,137,69,68
050,29,015,"Missouri","Benton County",4,26,152,80,72
050,29,015,"Missouri","Benton County",4,27,142,76,66
050,29,015,"Missouri","Benton County",4,28,160,93,67
050,29,015,"Missouri","Benton County",4,29,181,85,96
050,29,015,"Missouri","Benton County",4,30,178,87,91
050,29,015,"Missouri","Benton County",4,31,163,84,79
050,29,015,"Missouri","Benton County",4,32,193,105,88
050,29,015,"Missouri","Benton County",4,33,184,98,86
050,29,015,"Missouri","Benton County",4,34,176,81,95
050,29,015,"Missouri","Benton County",4,35,180,86,94
050,29,015,"Missouri","Benton County",4,36,184,90,94
050,29,015,"Missouri","Benton County",4,37,157,84,73
050,29,015,"Missouri","Benton County",4,38,180,92,88
050,29,015,"Missouri","Benton County",4,39,192,90,102
050,29,015,"Missouri","Benton County",4,40,197,90,107
050,29,015,"Missouri","Benton County",4,41,184,92,92
050,29,015,"Missouri","Benton County",4,42,194,99,95
050,29,015,"Missouri","Benton County",4,43,183,87,96
050,29,015,"Missouri","Benton County",4,44,171,88,83
050,29,015,"Missouri","Benton County",4,45,176,85,91
050,29,015,"Missouri","Benton County",4,46,193,97,96
050,29,015,"Missouri","Benton County",4,47,163,78,85
050,29,015,"Missouri","Benton County",4,48,192,93,99
050,29,015,"Missouri","Benton County",4,49,237,114,123
050,29,015,"Missouri","Benton County",4,50,225,122,103
050,29,015,"Missouri","Benton County",4,51,260,120,140
050,29,015,"Missouri","Benton County",4,52,264,120,144
050,29,015,"Missouri","Benton County",4,53,266,139,127
050,29,015,"Missouri","Benton County",4,54,283,151,132
050,29,015,"Missouri","Benton County",4,55,283,148,135
050,29,015,"Missouri","Benton County",4,56,298,144,154
050,29,015,"Missouri","Benton County",4,57,288,148,140
050,29,015,"Missouri","Benton County",4,58,340,169,171
050,29,015,"Missouri","Benton County",4,59,371,178,193
050,29,015,"Missouri","Benton County",4,60,386,191,195
050,29,015,"Missouri","Benton County",4,61,380,190,190
050,29,015,"Missouri","Benton County",4,62,403,212,191
050,29,015,"Missouri","Benton County",4,63,379,195,184
050,29,015,"Missouri","Benton County",4,64,418,214,204
050,29,015,"Missouri","Benton County",4,65,420,213,207
050,29,015,"Missouri","Benton County",4,66,389,194,195
050,29,015,"Missouri","Benton County",4,67,415,210,205
050,29,015,"Missouri","Benton County",4,68,418,208,210
050,29,015,"Missouri","Benton County",4,69,419,210,209
050,29,015,"Missouri","Benton County",4,70,389,195,194
050,29,015,"Missouri","Benton County",4,71,327,180,147
050,29,015,"Missouri","Benton County",4,72,332,168,164
050,29,015,"Missouri","Benton County",4,73,310,149,161
050,29,015,"Missouri","Benton County",4,74,314,158,156
050,29,015,"Missouri","Benton County",4,75,343,179,164
050,29,015,"Missouri","Benton County",4,76,227,125,102
050,29,015,"Missouri","Benton County",4,77,210,113,97
050,29,015,"Missouri","Benton County",4,78,228,112,116
050,29,015,"Missouri","Benton County",4,79,231,119,112
050,29,015,"Missouri","Benton County",4,80,193,100,93
050,29,015,"Missouri","Benton County",4,81,180,87,93
050,29,015,"Missouri","Benton County",4,82,164,80,84
050,29,015,"Missouri","Benton County",4,83,133,66,67
050,29,015,"Missouri","Benton County",4,84,137,69,68
050,29,015,"Missouri","Benton County",4,85,562,248,314
050,29,015,"Missouri","Benton County",5,0,159,78,81
050,29,015,"Missouri","Benton County",5,1,162,73,89
050,29,015,"Missouri","Benton County",5,2,146,71,75
050,29,015,"Missouri","Benton County",5,3,189,86,103
050,29,015,"Missouri","Benton County",5,4,169,84,85
050,29,015,"Missouri","Benton County",5,5,193,107,86
050,29,015,"Missouri","Benton County",5,6,199,100,99
050,29,015,"Missouri","Benton County",5,7,212,111,101
050,29,015,"Missouri","Benton County",5,8,197,102,95
050,29,015,"Missouri","Benton County",5,9,186,97,89
050,29,015,"Missouri","Benton County",5,10,203,115,88
050,29,015,"Missouri","Benton County",5,11,198,97,101
050,29,015,"Missouri","Benton County",5,12,210,121,89
050,29,015,"Missouri","Benton County",5,13,223,114,109
050,29,015,"Missouri","Benton County",5,14,224,118,106
050,29,015,"Missouri","Benton County",5,15,247,125,122
050,29,015,"Missouri","Benton County",5,16,220,113,107
050,29,015,"Missouri","Benton County",5,17,216,103,113
050,29,015,"Missouri","Benton County",5,18,187,100,87
050,29,015,"Missouri","Benton County",5,19,142,84,58
050,29,015,"Missouri","Benton County",5,20,163,86,77
050,29,015,"Missouri","Benton County",5,21,155,80,75
050,29,015,"Missouri","Benton County",5,22,151,87,64
050,29,015,"Missouri","Benton County",5,23,160,85,75
050,29,015,"Missouri","Benton County",5,24,160,86,74
050,29,015,"Missouri","Benton County",5,25,157,84,73
050,29,015,"Missouri","Benton County",5,26,141,74,67
050,29,015,"Missouri","Benton County",5,27,147,77,70
050,29,015,"Missouri","Benton County",5,28,148,73,75
050,29,015,"Missouri","Benton County",5,29,161,87,74
050,29,015,"Missouri","Benton County",5,30,202,93,109
050,29,015,"Missouri","Benton County",5,31,179,94,85
050,29,015,"Missouri","Benton County",5,32,175,91,84
050,29,015,"Missouri","Benton County",5,33,197,109,88
050,29,015,"Missouri","Benton County",5,34,193,103,90
050,29,015,"Missouri","Benton County",5,35,193,94,99
050,29,015,"Missouri","Benton County",5,36,186,87,99
050,29,015,"Missouri","Benton County",5,37,188,94,94
050,29,015,"Missouri","Benton County",5,38,155,82,73
050,29,015,"Missouri","Benton County",5,39,188,97,91
050,29,015,"Missouri","Benton County",5,40,187,82,105
050,29,015,"Missouri","Benton County",5,41,206,96,110
050,29,015,"Missouri","Benton County",5,42,180,88,92
050,29,015,"Missouri","Benton County",5,43,213,107,106
050,29,015,"Missouri","Benton County",5,44,181,89,92
050,29,015,"Missouri","Benton County",5,45,175,91,84
050,29,015,"Missouri","Benton County",5,46,187,94,93
050,29,015,"Missouri","Benton County",5,47,202,100,102
050,29,015,"Missouri","Benton County",5,48,170,83,87
050,29,015,"Missouri","Benton County",5,49,194,90,104
050,29,015,"Missouri","Benton County",5,50,246,121,125
050,29,015,"Missouri","Benton County",5,51,232,132,100
050,29,015,"Missouri","Benton County",5,52,270,126,144
050,29,015,"Missouri","Benton County",5,53,268,120,148
050,29,015,"Missouri","Benton County",5,54,273,147,126
050,29,015,"Missouri","Benton County",5,55,293,154,139
050,29,015,"Missouri","Benton County",5,56,296,145,151
050,29,015,"Missouri","Benton County",5,57,305,150,155
050,29,015,"Missouri","Benton County",5,58,297,154,143
050,29,015,"Missouri","Benton County",5,59,362,187,175
050,29,015,"Missouri","Benton County",5,60,381,183,198
050,29,015,"Missouri","Benton County",5,61,390,190,200
050,29,015,"Missouri","Benton County",5,62,405,209,196
050,29,015,"Missouri","Benton County",5,63,412,221,191
050,29,015,"Missouri","Benton County",5,64,395,203,192
050,29,015,"Missouri","Benton County",5,65,436,223,213
050,29,015,"Missouri","Benton County",5,66,426,217,209
050,29,015,"Missouri","Benton County",5,67,395,194,201
050,29,015,"Missouri","Benton County",5,68,419,214,205
050,29,015,"Missouri","Benton County",5,69,411,206,205
050,29,015,"Missouri","Benton County",5,70,417,209,208
050,29,015,"Missouri","Benton County",5,71,379,193,186
050,29,015,"Missouri","Benton County",5,72,308,170,138
050,29,015,"Missouri","Benton County",5,73,320,168,152
050,29,015,"Missouri","Benton County",5,74,308,146,162
050,29,015,"Missouri","Benton County",5,75,304,149,155
050,29,015,"Missouri","Benton County",5,76,326,172,154
050,29,015,"Missouri","Benton County",5,77,205,116,89
050,29,015,"Missouri","Benton County",5,78,199,108,91
050,29,015,"Missouri","Benton County",5,79,221,110,111
050,29,015,"Missouri","Benton County",5,80,219,115,104
050,29,015,"Missouri","Benton County",5,81,183,94,89
050,29,015,"Missouri","Benton County",5,82,181,86,95
050,29,015,"Missouri","Benton County",5,83,159,76,83
050,29,015,"Missouri","Benton County",5,84,123,60,63
050,29,015,"Missouri","Benton County",5,85,612,278,334
050,29,017,"Missouri","Bollinger County",1,0,121,61,60
050,29,017,"Missouri","Bollinger County",1,1,125,57,68
050,29,017,"Missouri","Bollinger County",1,2,116,54,62
050,29,017,"Missouri","Bollinger County",1,3,112,64,48
050,29,017,"Missouri","Bollinger County",1,4,105,62,43
050,29,017,"Missouri","Bollinger County",1,5,99,51,48
050,29,017,"Missouri","Bollinger County",1,6,116,63,53
050,29,017,"Missouri","Bollinger County",1,7,126,64,62
050,29,017,"Missouri","Bollinger County",1,8,132,60,72
050,29,017,"Missouri","Bollinger County",1,9,132,68,64
050,29,017,"Missouri","Bollinger County",1,10,139,81,58
050,29,017,"Missouri","Bollinger County",1,11,136,72,64
050,29,017,"Missouri","Bollinger County",1,12,142,70,72
050,29,017,"Missouri","Bollinger County",1,13,139,66,73
050,29,017,"Missouri","Bollinger County",1,14,145,75,70
050,29,017,"Missouri","Bollinger County",1,15,128,65,63
050,29,017,"Missouri","Bollinger County",1,16,133,70,63
050,29,017,"Missouri","Bollinger County",1,17,134,74,60
050,29,017,"Missouri","Bollinger County",1,18,111,62,49
050,29,017,"Missouri","Bollinger County",1,19,96,52,44
050,29,017,"Missouri","Bollinger County",1,20,99,54,45
050,29,017,"Missouri","Bollinger County",1,21,98,52,46
050,29,017,"Missouri","Bollinger County",1,22,89,45,44
050,29,017,"Missouri","Bollinger County",1,23,88,44,44
050,29,017,"Missouri","Bollinger County",1,24,113,58,55
050,29,017,"Missouri","Bollinger County",1,25,112,53,59
050,29,017,"Missouri","Bollinger County",1,26,106,60,46
050,29,017,"Missouri","Bollinger County",1,27,110,55,55
050,29,017,"Missouri","Bollinger County",1,28,116,57,59
050,29,017,"Missouri","Bollinger County",1,29,128,61,67
050,29,017,"Missouri","Bollinger County",1,30,130,60,70
050,29,017,"Missouri","Bollinger County",1,31,115,59,56
050,29,017,"Missouri","Bollinger County",1,32,108,61,47
050,29,017,"Missouri","Bollinger County",1,33,111,52,59
050,29,017,"Missouri","Bollinger County",1,34,113,55,58
050,29,017,"Missouri","Bollinger County",1,35,119,57,62
050,29,017,"Missouri","Bollinger County",1,36,114,69,45
050,29,017,"Missouri","Bollinger County",1,37,103,57,46
050,29,017,"Missouri","Bollinger County",1,38,124,63,61
050,29,017,"Missouri","Bollinger County",1,39,129,65,64
050,29,017,"Missouri","Bollinger County",1,40,111,56,55
050,29,017,"Missouri","Bollinger County",1,41,128,64,64
050,29,017,"Missouri","Bollinger County",1,42,128,63,65
050,29,017,"Missouri","Bollinger County",1,43,124,70,54
050,29,017,"Missouri","Bollinger County",1,44,119,64,55
050,29,017,"Missouri","Bollinger County",1,45,106,53,53
050,29,017,"Missouri","Bollinger County",1,46,112,52,60
050,29,017,"Missouri","Bollinger County",1,47,127,62,65
050,29,017,"Missouri","Bollinger County",1,48,156,76,80
050,29,017,"Missouri","Bollinger County",1,49,155,72,83
050,29,017,"Missouri","Bollinger County",1,50,125,66,59
050,29,017,"Missouri","Bollinger County",1,51,140,67,73
050,29,017,"Missouri","Bollinger County",1,52,147,78,69
050,29,017,"Missouri","Bollinger County",1,53,155,78,77
050,29,017,"Missouri","Bollinger County",1,54,142,74,68
050,29,017,"Missouri","Bollinger County",1,55,159,77,82
050,29,017,"Missouri","Bollinger County",1,56,173,83,90
050,29,017,"Missouri","Bollinger County",1,57,174,94,80
050,29,017,"Missouri","Bollinger County",1,58,185,103,82
050,29,017,"Missouri","Bollinger County",1,59,174,92,82
050,29,017,"Missouri","Bollinger County",1,60,174,92,82
050,29,017,"Missouri","Bollinger County",1,61,157,80,77
050,29,017,"Missouri","Bollinger County",1,62,162,83,79
050,29,017,"Missouri","Bollinger County",1,63,172,81,91
050,29,017,"Missouri","Bollinger County",1,64,153,71,82
050,29,017,"Missouri","Bollinger County",1,65,152,71,81
050,29,017,"Missouri","Bollinger County",1,66,141,68,73
050,29,017,"Missouri","Bollinger County",1,67,150,72,78
050,29,017,"Missouri","Bollinger County",1,68,136,55,81
050,29,017,"Missouri","Bollinger County",1,69,120,61,59
050,29,017,"Missouri","Bollinger County",1,70,129,63,66
050,29,017,"Missouri","Bollinger County",1,71,141,68,73
050,29,017,"Missouri","Bollinger County",1,72,113,53,60
050,29,017,"Missouri","Bollinger County",1,73,130,67,63
050,29,017,"Missouri","Bollinger County",1,74,83,44,39
050,29,017,"Missouri","Bollinger County",1,75,83,38,45
050,29,017,"Missouri","Bollinger County",1,76,94,46,48
050,29,017,"Missouri","Bollinger County",1,77,95,52,43
050,29,017,"Missouri","Bollinger County",1,78,83,43,40
050,29,017,"Missouri","Bollinger County",1,79,78,37,41
050,29,017,"Missouri","Bollinger County",1,80,52,24,28
050,29,017,"Missouri","Bollinger County",1,81,57,26,31
050,29,017,"Missouri","Bollinger County",1,82,57,26,31
050,29,017,"Missouri","Bollinger County",1,83,43,19,24
050,29,017,"Missouri","Bollinger County",1,84,38,19,19
050,29,017,"Missouri","Bollinger County",1,85,229,93,136
050,29,017,"Missouri","Bollinger County",2,0,123,61,62
050,29,017,"Missouri","Bollinger County",2,1,124,57,67
050,29,017,"Missouri","Bollinger County",2,2,121,57,64
050,29,017,"Missouri","Bollinger County",2,3,112,61,51
050,29,017,"Missouri","Bollinger County",2,4,105,61,44
050,29,017,"Missouri","Bollinger County",2,5,102,55,47
050,29,017,"Missouri","Bollinger County",2,6,113,61,52
050,29,017,"Missouri","Bollinger County",2,7,124,64,60
050,29,017,"Missouri","Bollinger County",2,8,130,60,70
050,29,017,"Missouri","Bollinger County",2,9,132,67,65
050,29,017,"Missouri","Bollinger County",2,10,136,77,59
050,29,017,"Missouri","Bollinger County",2,11,138,75,63
050,29,017,"Missouri","Bollinger County",2,12,140,70,70
050,29,017,"Missouri","Bollinger County",2,13,140,67,73
050,29,017,"Missouri","Bollinger County",2,14,142,72,70
050,29,017,"Missouri","Bollinger County",2,15,131,67,64
050,29,017,"Missouri","Bollinger County",2,16,131,69,62
050,29,017,"Missouri","Bollinger County",2,17,133,73,60
050,29,017,"Missouri","Bollinger County",2,18,112,63,49
050,29,017,"Missouri","Bollinger County",2,19,93,50,43
050,29,017,"Missouri","Bollinger County",2,20,100,54,46
050,29,017,"Missouri","Bollinger County",2,21,101,53,48
050,29,017,"Missouri","Bollinger County",2,22,92,46,46
050,29,017,"Missouri","Bollinger County",2,23,90,45,45
050,29,017,"Missouri","Bollinger County",2,24,109,56,53
050,29,017,"Missouri","Bollinger County",2,25,112,55,57
050,29,017,"Missouri","Bollinger County",2,26,108,59,49
050,29,017,"Missouri","Bollinger County",2,27,111,58,53
050,29,017,"Missouri","Bollinger County",2,28,115,56,59
050,29,017,"Missouri","Bollinger County",2,29,124,60,64
050,29,017,"Missouri","Bollinger County",2,30,130,61,69
050,29,017,"Missouri","Bollinger County",2,31,118,59,59
050,29,017,"Missouri","Bollinger County",2,32,109,60,49
050,29,017,"Missouri","Bollinger County",2,33,111,55,56
050,29,017,"Missouri","Bollinger County",2,34,113,55,58
050,29,017,"Missouri","Bollinger County",2,35,118,56,62
050,29,017,"Missouri","Bollinger County",2,36,112,63,49
050,29,017,"Missouri","Bollinger County",2,37,105,59,46
050,29,017,"Missouri","Bollinger County",2,38,121,63,58
050,29,017,"Missouri","Bollinger County",2,39,124,63,61
050,29,017,"Missouri","Bollinger County",2,40,115,58,57
050,29,017,"Missouri","Bollinger County",2,41,125,61,64
050,29,017,"Missouri","Bollinger County",2,42,126,63,63
050,29,017,"Missouri","Bollinger County",2,43,127,70,57
050,29,017,"Missouri","Bollinger County",2,44,119,65,54
050,29,017,"Missouri","Bollinger County",2,45,109,55,54
050,29,017,"Missouri","Bollinger County",2,46,113,53,60
050,29,017,"Missouri","Bollinger County",2,47,123,60,63
050,29,017,"Missouri","Bollinger County",2,48,150,73,77
050,29,017,"Missouri","Bollinger County",2,49,156,73,83
050,29,017,"Missouri","Bollinger County",2,50,130,67,63
050,29,017,"Missouri","Bollinger County",2,51,134,67,67
050,29,017,"Missouri","Bollinger County",2,52,146,75,71
050,29,017,"Missouri","Bollinger County",2,53,152,76,76
050,29,017,"Missouri","Bollinger County",2,54,145,75,70
050,29,017,"Missouri","Bollinger County",2,55,157,78,79
050,29,017,"Missouri","Bollinger County",2,56,172,82,90
050,29,017,"Missouri","Bollinger County",2,57,175,91,84
050,29,017,"Missouri","Bollinger County",2,58,181,99,82
050,29,017,"Missouri","Bollinger County",2,59,177,95,82
050,29,017,"Missouri","Bollinger County",2,60,173,91,82
050,29,017,"Missouri","Bollinger County",2,61,158,81,77
050,29,017,"Missouri","Bollinger County",2,62,159,82,77
050,29,017,"Missouri","Bollinger County",2,63,170,82,88
050,29,017,"Missouri","Bollinger County",2,64,158,74,84
050,29,017,"Missouri","Bollinger County",2,65,152,71,81
050,29,017,"Missouri","Bollinger County",2,66,143,68,75
050,29,017,"Missouri","Bollinger County",2,67,146,69,77
050,29,017,"Missouri","Bollinger County",2,68,137,59,78
050,29,017,"Missouri","Bollinger County",2,69,124,60,64
050,29,017,"Missouri","Bollinger County",2,70,124,61,63
050,29,017,"Missouri","Bollinger County",2,71,137,65,72
050,29,017,"Missouri","Bollinger County",2,72,117,56,61
050,29,017,"Missouri","Bollinger County",2,73,132,67,65
050,29,017,"Missouri","Bollinger County",2,74,88,45,43
050,29,017,"Missouri","Bollinger County",2,75,83,40,43
050,29,017,"Missouri","Bollinger County",2,76,90,44,46
050,29,017,"Missouri","Bollinger County",2,77,96,52,44
050,29,017,"Missouri","Bollinger County",2,78,84,44,40
050,29,017,"Missouri","Bollinger County",2,79,79,37,42
050,29,017,"Missouri","Bollinger County",2,80,55,26,29
050,29,017,"Missouri","Bollinger County",2,81,54,24,30
050,29,017,"Missouri","Bollinger County",2,82,57,27,30
050,29,017,"Missouri","Bollinger County",2,83,44,19,25
050,29,017,"Missouri","Bollinger County",2,84,39,19,20
050,29,017,"Missouri","Bollinger County",2,85,226,93,133
050,29,017,"Missouri","Bollinger County",3,0,130,59,71
050,29,017,"Missouri","Bollinger County",3,1,136,71,65
050,29,017,"Missouri","Bollinger County",3,2,129,58,71
050,29,017,"Missouri","Bollinger County",3,3,125,57,68
050,29,017,"Missouri","Bollinger County",3,4,115,60,55
050,29,017,"Missouri","Bollinger County",3,5,102,61,41
050,29,017,"Missouri","Bollinger County",3,6,109,57,52
050,29,017,"Missouri","Bollinger County",3,7,117,59,58
050,29,017,"Missouri","Bollinger County",3,8,115,58,57
050,29,017,"Missouri","Bollinger County",3,9,140,58,82
050,29,017,"Missouri","Bollinger County",3,10,126,62,64
050,29,017,"Missouri","Bollinger County",3,11,139,80,59
050,29,017,"Missouri","Bollinger County",3,12,138,75,63
050,29,017,"Missouri","Bollinger County",3,13,136,70,66
050,29,017,"Missouri","Bollinger County",3,14,144,68,76
050,29,017,"Missouri","Bollinger County",3,15,143,77,66
050,29,017,"Missouri","Bollinger County",3,16,131,65,66
050,29,017,"Missouri","Bollinger County",3,17,127,67,60
050,29,017,"Missouri","Bollinger County",3,18,115,66,49
050,29,017,"Missouri","Bollinger County",3,19,85,47,38
050,29,017,"Missouri","Bollinger County",3,20,105,57,48
050,29,017,"Missouri","Bollinger County",3,21,108,61,47
050,29,017,"Missouri","Bollinger County",3,22,108,51,57
050,29,017,"Missouri","Bollinger County",3,23,86,42,44
050,29,017,"Missouri","Bollinger County",3,24,90,45,45
050,29,017,"Missouri","Bollinger County",3,25,109,58,51
050,29,017,"Missouri","Bollinger County",3,26,122,59,63
050,29,017,"Missouri","Bollinger County",3,27,116,62,54
050,29,017,"Missouri","Bollinger County",3,28,103,52,51
050,29,017,"Missouri","Bollinger County",3,29,127,66,61
050,29,017,"Missouri","Bollinger County",3,30,121,58,63
050,29,017,"Missouri","Bollinger County",3,31,127,67,60
050,29,017,"Missouri","Bollinger County",3,32,110,52,58
050,29,017,"Missouri","Bollinger County",3,33,113,56,57
050,29,017,"Missouri","Bollinger County",3,34,117,63,54
050,29,017,"Missouri","Bollinger County",3,35,110,49,61
050,29,017,"Missouri","Bollinger County",3,36,119,53,66
050,29,017,"Missouri","Bollinger County",3,37,112,65,47
050,29,017,"Missouri","Bollinger County",3,38,120,65,55
050,29,017,"Missouri","Bollinger County",3,39,116,61,55
050,29,017,"Missouri","Bollinger County",3,40,120,60,60
050,29,017,"Missouri","Bollinger County",3,41,131,64,67
050,29,017,"Missouri","Bollinger County",3,42,110,56,54
050,29,017,"Missouri","Bollinger County",3,43,130,67,63
050,29,017,"Missouri","Bollinger County",3,44,128,66,62
050,29,017,"Missouri","Bollinger County",3,45,120,64,56
050,29,017,"Missouri","Bollinger County",3,46,118,57,61
050,29,017,"Missouri","Bollinger County",3,47,106,51,55
050,29,017,"Missouri","Bollinger County",3,48,125,62,63
050,29,017,"Missouri","Bollinger County",3,49,163,78,85
050,29,017,"Missouri","Bollinger County",3,50,148,71,77
050,29,017,"Missouri","Bollinger County",3,51,132,70,62
050,29,017,"Missouri","Bollinger County",3,52,141,72,69
050,29,017,"Missouri","Bollinger County",3,53,136,66,70
050,29,017,"Missouri","Bollinger County",3,54,147,76,71
050,29,017,"Missouri","Bollinger County",3,55,148,80,68
050,29,017,"Missouri","Bollinger County",3,56,157,75,82
050,29,017,"Missouri","Bollinger County",3,57,172,81,91
050,29,017,"Missouri","Bollinger County",3,58,175,92,83
050,29,017,"Missouri","Bollinger County",3,59,183,96,87
050,29,017,"Missouri","Bollinger County",3,60,176,94,82
050,29,017,"Missouri","Bollinger County",3,61,168,86,82
050,29,017,"Missouri","Bollinger County",3,62,159,87,72
050,29,017,"Missouri","Bollinger County",3,63,152,76,76
050,29,017,"Missouri","Bollinger County",3,64,171,83,88
050,29,017,"Missouri","Bollinger County",3,65,152,74,78
050,29,017,"Missouri","Bollinger County",3,66,147,66,81
050,29,017,"Missouri","Bollinger County",3,67,149,73,76
050,29,017,"Missouri","Bollinger County",3,68,140,66,74
050,29,017,"Missouri","Bollinger County",3,69,133,58,75
050,29,017,"Missouri","Bollinger County",3,70,121,60,61
050,29,017,"Missouri","Bollinger County",3,71,124,61,63
050,29,017,"Missouri","Bollinger County",3,72,129,61,68
050,29,017,"Missouri","Bollinger County",3,73,116,56,60
050,29,017,"Missouri","Bollinger County",3,74,126,64,62
050,29,017,"Missouri","Bollinger County",3,75,85,44,41
050,29,017,"Missouri","Bollinger County",3,76,71,34,37
050,29,017,"Missouri","Bollinger County",3,77,84,40,44
050,29,017,"Missouri","Bollinger County",3,78,93,50,43
050,29,017,"Missouri","Bollinger County",3,79,87,44,43
050,29,017,"Missouri","Bollinger County",3,80,66,33,33
050,29,017,"Missouri","Bollinger County",3,81,53,22,31
050,29,017,"Missouri","Bollinger County",3,82,51,22,29
050,29,017,"Missouri","Bollinger County",3,83,46,23,23
050,29,017,"Missouri","Bollinger County",3,84,38,16,22
050,29,017,"Missouri","Bollinger County",3,85,218,90,128
050,29,017,"Missouri","Bollinger County",4,0,126,65,61
050,29,017,"Missouri","Bollinger County",4,1,133,66,67
050,29,017,"Missouri","Bollinger County",4,2,132,70,62
050,29,017,"Missouri","Bollinger County",4,3,124,57,67
050,29,017,"Missouri","Bollinger County",4,4,121,54,67
050,29,017,"Missouri","Bollinger County",4,5,117,64,53
050,29,017,"Missouri","Bollinger County",4,6,106,60,46
050,29,017,"Missouri","Bollinger County",4,7,105,56,49
050,29,017,"Missouri","Bollinger County",4,8,121,60,61
050,29,017,"Missouri","Bollinger County",4,9,115,61,54
050,29,017,"Missouri","Bollinger County",4,10,145,66,79
050,29,017,"Missouri","Bollinger County",4,11,133,64,69
050,29,017,"Missouri","Bollinger County",4,12,136,75,61
050,29,017,"Missouri","Bollinger County",4,13,133,70,63
050,29,017,"Missouri","Bollinger County",4,14,134,70,64
050,29,017,"Missouri","Bollinger County",4,15,143,68,75
050,29,017,"Missouri","Bollinger County",4,16,138,72,66
050,29,017,"Missouri","Bollinger County",4,17,124,64,60
050,29,017,"Missouri","Bollinger County",4,18,103,58,45
050,29,017,"Missouri","Bollinger County",4,19,88,50,38
050,29,017,"Missouri","Bollinger County",4,20,86,49,37
050,29,017,"Missouri","Bollinger County",4,21,107,55,52
050,29,017,"Missouri","Bollinger County",4,22,105,53,52
050,29,017,"Missouri","Bollinger County",4,23,111,56,55
050,29,017,"Missouri","Bollinger County",4,24,92,46,46
050,29,017,"Missouri","Bollinger County",4,25,90,45,45
050,29,017,"Missouri","Bollinger County",4,26,106,56,50
050,29,017,"Missouri","Bollinger County",4,27,124,58,66
050,29,017,"Missouri","Bollinger County",4,28,109,62,47
050,29,017,"Missouri","Bollinger County",4,29,109,55,54
050,29,017,"Missouri","Bollinger County",4,30,126,66,60
050,29,017,"Missouri","Bollinger County",4,31,121,52,69
050,29,017,"Missouri","Bollinger County",4,32,136,67,69
050,29,017,"Missouri","Bollinger County",4,33,114,51,63
050,29,017,"Missouri","Bollinger County",4,34,115,62,53
050,29,017,"Missouri","Bollinger County",4,35,121,67,54
050,29,017,"Missouri","Bollinger County",4,36,118,55,63
050,29,017,"Missouri","Bollinger County",4,37,117,56,61
050,29,017,"Missouri","Bollinger County",4,38,112,62,50
050,29,017,"Missouri","Bollinger County",4,39,115,62,53
050,29,017,"Missouri","Bollinger County",4,40,112,60,52
050,29,017,"Missouri","Bollinger County",4,41,127,64,63
050,29,017,"Missouri","Bollinger County",4,42,128,64,64
050,29,017,"Missouri","Bollinger County",4,43,112,59,53
050,29,017,"Missouri","Bollinger County",4,44,130,66,64
050,29,017,"Missouri","Bollinger County",4,45,120,63,57
050,29,017,"Missouri","Bollinger County",4,46,130,69,61
050,29,017,"Missouri","Bollinger County",4,47,114,58,56
050,29,017,"Missouri","Bollinger County",4,48,113,53,60
050,29,017,"Missouri","Bollinger County",4,49,129,61,68
050,29,017,"Missouri","Bollinger County",4,50,150,77,73
050,29,017,"Missouri","Bollinger County",4,51,153,73,80
050,29,017,"Missouri","Bollinger County",4,52,143,78,65
050,29,017,"Missouri","Bollinger County",4,53,141,74,67
050,29,017,"Missouri","Bollinger County",4,54,130,63,67
050,29,017,"Missouri","Bollinger County",4,55,136,70,66
050,29,017,"Missouri","Bollinger County",4,56,144,74,70
050,29,017,"Missouri","Bollinger County",4,57,156,75,81
050,29,017,"Missouri","Bollinger County",4,58,172,82,90
050,29,017,"Missouri","Bollinger County",4,59,176,91,85
050,29,017,"Missouri","Bollinger County",4,60,185,102,83
050,29,017,"Missouri","Bollinger County",4,61,179,92,87
050,29,017,"Missouri","Bollinger County",4,62,172,88,84
050,29,017,"Missouri","Bollinger County",4,63,155,86,69
050,29,017,"Missouri","Bollinger County",4,64,148,75,73
050,29,017,"Missouri","Bollinger County",4,65,168,83,85
050,29,017,"Missouri","Bollinger County",4,66,146,71,75
050,29,017,"Missouri","Bollinger County",4,67,156,71,85
050,29,017,"Missouri","Bollinger County",4,68,143,70,73
050,29,017,"Missouri","Bollinger County",4,69,130,63,67
050,29,017,"Missouri","Bollinger County",4,70,131,56,75
050,29,017,"Missouri","Bollinger County",4,71,120,57,63
050,29,017,"Missouri","Bollinger County",4,72,122,60,62
050,29,017,"Missouri","Bollinger County",4,73,128,61,67
050,29,017,"Missouri","Bollinger County",4,74,111,54,57
050,29,017,"Missouri","Bollinger County",4,75,121,61,60
050,29,017,"Missouri","Bollinger County",4,76,75,38,37
050,29,017,"Missouri","Bollinger County",4,77,68,33,35
050,29,017,"Missouri","Bollinger County",4,78,72,31,41
050,29,017,"Missouri","Bollinger County",4,79,92,50,42
050,29,017,"Missouri","Bollinger County",4,80,72,38,34
050,29,017,"Missouri","Bollinger County",4,81,62,31,31
050,29,017,"Missouri","Bollinger County",4,82,50,22,28
050,29,017,"Missouri","Bollinger County",4,83,41,21,20
050,29,017,"Missouri","Bollinger County",4,84,45,23,22
050,29,017,"Missouri","Bollinger County",4,85,212,78,134
050,29,017,"Missouri","Bollinger County",5,0,127,66,61
050,29,017,"Missouri","Bollinger County",5,1,143,77,66
050,29,017,"Missouri","Bollinger County",5,2,129,64,65
050,29,017,"Missouri","Bollinger County",5,3,129,73,56
050,29,017,"Missouri","Bollinger County",5,4,124,58,66
050,29,017,"Missouri","Bollinger County",5,5,131,58,73
050,29,017,"Missouri","Bollinger County",5,6,122,64,58
050,29,017,"Missouri","Bollinger County",5,7,109,62,47
050,29,017,"Missouri","Bollinger County",5,8,103,56,47
050,29,017,"Missouri","Bollinger County",5,9,124,60,64
050,29,017,"Missouri","Bollinger County",5,10,121,64,57
050,29,017,"Missouri","Bollinger County",5,11,146,65,81
050,29,017,"Missouri","Bollinger County",5,12,131,68,63
050,29,017,"Missouri","Bollinger County",5,13,138,80,58
050,29,017,"Missouri","Bollinger County",5,14,132,67,65
050,29,017,"Missouri","Bollinger County",5,15,130,69,61
050,29,017,"Missouri","Bollinger County",5,16,143,71,72
050,29,017,"Missouri","Bollinger County",5,17,135,75,60
050,29,017,"Missouri","Bollinger County",5,18,104,57,47
050,29,017,"Missouri","Bollinger County",5,19,72,41,31
050,29,017,"Missouri","Bollinger County",5,20,85,46,39
050,29,017,"Missouri","Bollinger County",5,21,95,51,44
050,29,017,"Missouri","Bollinger County",5,22,108,53,55
050,29,017,"Missouri","Bollinger County",5,23,115,59,56
050,29,017,"Missouri","Bollinger County",5,24,120,59,61
050,29,017,"Missouri","Bollinger County",5,25,90,51,39
050,29,017,"Missouri","Bollinger County",5,26,97,53,44
050,29,017,"Missouri","Bollinger County",5,27,110,56,54
050,29,017,"Missouri","Bollinger County",5,28,116,55,61
050,29,017,"Missouri","Bollinger County",5,29,115,62,53
050,29,017,"Missouri","Bollinger County",5,30,116,53,63
050,29,017,"Missouri","Bollinger County",5,31,135,73,62
050,29,017,"Missouri","Bollinger County",5,32,133,58,75
050,29,017,"Missouri","Bollinger County",5,33,131,68,63
050,29,017,"Missouri","Bollinger County",5,34,124,59,65
050,29,017,"Missouri","Bollinger County",5,35,121,65,56
050,29,017,"Missouri","Bollinger County",5,36,126,69,57
050,29,017,"Missouri","Bollinger County",5,37,120,55,65
050,29,017,"Missouri","Bollinger County",5,38,121,59,62
050,29,017,"Missouri","Bollinger County",5,39,111,62,49
050,29,017,"Missouri","Bollinger County",5,40,111,58,53
050,29,017,"Missouri","Bollinger County",5,41,117,60,57
050,29,017,"Missouri","Bollinger County",5,42,119,63,56
050,29,017,"Missouri","Bollinger County",5,43,130,62,68
050,29,017,"Missouri","Bollinger County",5,44,117,60,57
050,29,017,"Missouri","Bollinger County",5,45,134,68,66
050,29,017,"Missouri","Bollinger County",5,46,120,63,57
050,29,017,"Missouri","Bollinger County",5,47,126,69,57
050,29,017,"Missouri","Bollinger County",5,48,111,56,55
050,29,017,"Missouri","Bollinger County",5,49,118,55,63
050,29,017,"Missouri","Bollinger County",5,50,122,62,60
050,29,017,"Missouri","Bollinger County",5,51,151,79,72
050,29,017,"Missouri","Bollinger County",5,52,157,76,81
050,29,017,"Missouri","Bollinger County",5,53,138,71,67
050,29,017,"Missouri","Bollinger County",5,54,141,73,68
050,29,017,"Missouri","Bollinger County",5,55,129,68,61
050,29,017,"Missouri","Bollinger County",5,56,133,68,65
050,29,017,"Missouri","Bollinger County",5,57,143,74,69
050,29,017,"Missouri","Bollinger County",5,58,153,75,78
050,29,017,"Missouri","Bollinger County",5,59,165,75,90
050,29,017,"Missouri","Bollinger County",5,60,176,91,85
050,29,017,"Missouri","Bollinger County",5,61,177,95,82
050,29,017,"Missouri","Bollinger County",5,62,178,92,86
050,29,017,"Missouri","Bollinger County",5,63,164,84,80
050,29,017,"Missouri","Bollinger County",5,64,151,85,66
050,29,017,"Missouri","Bollinger County",5,65,148,73,75
050,29,017,"Missouri","Bollinger County",5,66,161,79,82
050,29,017,"Missouri","Bollinger County",5,67,151,73,78
050,29,017,"Missouri","Bollinger County",5,68,149,71,78
050,29,017,"Missouri","Bollinger County",5,69,142,69,73
050,29,017,"Missouri","Bollinger County",5,70,127,62,65
050,29,017,"Missouri","Bollinger County",5,71,128,51,77
050,29,017,"Missouri","Bollinger County",5,72,112,53,59
050,29,017,"Missouri","Bollinger County",5,73,120,60,60
050,29,017,"Missouri","Bollinger County",5,74,121,58,63
050,29,017,"Missouri","Bollinger County",5,75,107,51,56
050,29,017,"Missouri","Bollinger County",5,76,109,54,55
050,29,017,"Missouri","Bollinger County",5,77,74,37,37
050,29,017,"Missouri","Bollinger County",5,78,65,30,35
050,29,017,"Missouri","Bollinger County",5,79,72,30,42
050,29,017,"Missouri","Bollinger County",5,80,76,43,33
050,29,017,"Missouri","Bollinger County",5,81,63,32,31
050,29,017,"Missouri","Bollinger County",5,82,62,31,31
050,29,017,"Missouri","Bollinger County",5,83,43,21,22
050,29,017,"Missouri","Bollinger County",5,84,39,22,17
050,29,017,"Missouri","Bollinger County",5,85,212,74,138
050,29,019,"Missouri","Boone County",1,0,2041,1042,999
050,29,019,"Missouri","Boone County",1,1,2042,1044,998
050,29,019,"Missouri","Boone County",1,2,2061,1046,1015
050,29,019,"Missouri","Boone County",1,3,2138,1104,1034
050,29,019,"Missouri","Boone County",1,4,2140,1105,1035
050,29,019,"Missouri","Boone County",1,5,2080,1057,1023
050,29,019,"Missouri","Boone County",1,6,2192,1125,1067
050,29,019,"Missouri","Boone County",1,7,2100,1104,996
050,29,019,"Missouri","Boone County",1,8,2108,1076,1032
050,29,019,"Missouri","Boone County",1,9,2090,1034,1056
050,29,019,"Missouri","Boone County",1,10,2037,1045,992
050,29,019,"Missouri","Boone County",1,11,2075,1085,990
050,29,019,"Missouri","Boone County",1,12,2221,1156,1065
050,29,019,"Missouri","Boone County",1,13,2149,1140,1009
050,29,019,"Missouri","Boone County",1,14,2081,1082,999
050,29,019,"Missouri","Boone County",1,15,2144,1108,1036
050,29,019,"Missouri","Boone County",1,16,2107,1080,1027
050,29,019,"Missouri","Boone County",1,17,1995,1019,976
050,29,019,"Missouri","Boone County",1,18,3387,1446,1941
050,29,019,"Missouri","Boone County",1,19,6442,2893,3549
050,29,019,"Missouri","Boone County",1,20,5940,2640,3300
050,29,019,"Missouri","Boone County",1,21,5741,2740,3001
050,29,019,"Missouri","Boone County",1,22,5205,2567,2638
050,29,019,"Missouri","Boone County",1,23,4374,2098,2276
050,29,019,"Missouri","Boone County",1,24,3637,1716,1921
050,29,019,"Missouri","Boone County",1,25,3203,1601,1602
050,29,019,"Missouri","Boone County",1,26,2870,1390,1480
050,29,019,"Missouri","Boone County",1,27,2712,1360,1352
050,29,019,"Missouri","Boone County",1,28,2704,1335,1369
050,29,019,"Missouri","Boone County",1,29,2772,1364,1408
050,29,019,"Missouri","Boone County",1,30,2780,1356,1424
050,29,019,"Missouri","Boone County",1,31,2659,1277,1382
050,29,019,"Missouri","Boone County",1,32,2533,1209,1324
050,29,019,"Missouri","Boone County",1,33,2414,1218,1196
050,29,019,"Missouri","Boone County",1,34,2388,1215,1173
050,29,019,"Missouri","Boone County",1,35,2338,1170,1168
050,29,019,"Missouri","Boone County",1,36,2447,1235,1212
050,29,019,"Missouri","Boone County",1,37,2449,1224,1225
050,29,019,"Missouri","Boone County",1,38,2373,1196,1177
050,29,019,"Missouri","Boone County",1,39,2358,1157,1201
050,29,019,"Missouri","Boone County",1,40,2261,1120,1141
050,29,019,"Missouri","Boone County",1,41,2163,1076,1087
050,29,019,"Missouri","Boone County",1,42,2146,1055,1091
050,29,019,"Missouri","Boone County",1,43,1989,973,1016
050,29,019,"Missouri","Boone County",1,44,1890,944,946
050,29,019,"Missouri","Boone County",1,45,1896,949,947
050,29,019,"Missouri","Boone County",1,46,1788,885,903
050,29,019,"Missouri","Boone County",1,47,1800,890,910
050,29,019,"Missouri","Boone County",1,48,2048,1018,1030
050,29,019,"Missouri","Boone County",1,49,2099,1038,1061
050,29,019,"Missouri","Boone County",1,50,1880,937,943
050,29,019,"Missouri","Boone County",1,51,1800,892,908
050,29,019,"Missouri","Boone County",1,52,1759,861,898
050,29,019,"Missouri","Boone County",1,53,1798,859,939
050,29,019,"Missouri","Boone County",1,54,1827,919,908
050,29,019,"Missouri","Boone County",1,55,1858,902,956
050,29,019,"Missouri","Boone County",1,56,1986,958,1028
050,29,019,"Missouri","Boone County",1,57,2053,1013,1040
050,29,019,"Missouri","Boone County",1,58,2033,984,1049
050,29,019,"Missouri","Boone County",1,59,2023,973,1050
050,29,019,"Missouri","Boone County",1,60,1954,948,1006
050,29,019,"Missouri","Boone County",1,61,1966,923,1043
050,29,019,"Missouri","Boone County",1,62,1923,901,1022
050,29,019,"Missouri","Boone County",1,63,1916,911,1005
050,29,019,"Missouri","Boone County",1,64,1865,886,979
050,29,019,"Missouri","Boone County",1,65,1741,819,922
050,29,019,"Missouri","Boone County",1,66,1716,778,938
050,29,019,"Missouri","Boone County",1,67,1678,769,909
050,29,019,"Missouri","Boone County",1,68,1612,761,851
050,29,019,"Missouri","Boone County",1,69,1521,707,814
050,29,019,"Missouri","Boone County",1,70,1438,693,745
050,29,019,"Missouri","Boone County",1,71,1396,679,717
050,29,019,"Missouri","Boone County",1,72,1339,657,682
050,29,019,"Missouri","Boone County",1,73,1256,616,640
050,29,019,"Missouri","Boone County",1,74,871,391,480
050,29,019,"Missouri","Boone County",1,75,827,372,455
050,29,019,"Missouri","Boone County",1,76,798,355,443
050,29,019,"Missouri","Boone County",1,77,778,352,426
050,29,019,"Missouri","Boone County",1,78,669,295,374
050,29,019,"Missouri","Boone County",1,79,621,271,350
050,29,019,"Missouri","Boone County",1,80,600,252,348
050,29,019,"Missouri","Boone County",1,81,533,223,310
050,29,019,"Missouri","Boone County",1,82,478,210,268
050,29,019,"Missouri","Boone County",1,83,417,177,240
050,29,019,"Missouri","Boone County",1,84,422,175,247
050,29,019,"Missouri","Boone County",1,85,2645,903,1742
050,29,019,"Missouri","Boone County",2,0,2050,1045,1005
050,29,019,"Missouri","Boone County",2,1,2034,1037,997
050,29,019,"Missouri","Boone County",2,2,2059,1046,1013
050,29,019,"Missouri","Boone County",2,3,2112,1085,1027
050,29,019,"Missouri","Boone County",2,4,2148,1105,1043
050,29,019,"Missouri","Boone County",2,5,2094,1068,1026
050,29,019,"Missouri","Boone County",2,6,2162,1103,1059
050,29,019,"Missouri","Boone County",2,7,2122,1107,1015
050,29,019,"Missouri","Boone County",2,8,2105,1080,1025
050,29,019,"Missouri","Boone County",2,9,2094,1046,1048
050,29,019,"Missouri","Boone County",2,10,2045,1041,1004
050,29,019,"Missouri","Boone County",2,11,2062,1073,989
050,29,019,"Missouri","Boone County",2,12,2199,1145,1054
050,29,019,"Missouri","Boone County",2,13,2172,1145,1027
050,29,019,"Missouri","Boone County",2,14,2111,1101,1010
050,29,019,"Missouri","Boone County",2,15,2142,1107,1035
050,29,019,"Missouri","Boone County",2,16,2121,1090,1031
050,29,019,"Missouri","Boone County",2,17,2037,1038,999
050,29,019,"Missouri","Boone County",2,18,3420,1461,1959
050,29,019,"Missouri","Boone County",2,19,6439,2894,3545
050,29,019,"Missouri","Boone County",2,20,5970,2653,3317
050,29,019,"Missouri","Boone County",2,21,5732,2752,2980
050,29,019,"Missouri","Boone County",2,22,5149,2537,2612
050,29,019,"Missouri","Boone County",2,23,4347,2083,2264
050,29,019,"Missouri","Boone County",2,24,3618,1705,1913
050,29,019,"Missouri","Boone County",2,25,3202,1588,1614
050,29,019,"Missouri","Boone County",2,26,2875,1400,1475
050,29,019,"Missouri","Boone County",2,27,2693,1339,1354
050,29,019,"Missouri","Boone County",2,28,2694,1336,1358
050,29,019,"Missouri","Boone County",2,29,2745,1353,1392
050,29,019,"Missouri","Boone County",2,30,2785,1361,1424
050,29,019,"Missouri","Boone County",2,31,2672,1286,1386
050,29,019,"Missouri","Boone County",2,32,2550,1217,1333
050,29,019,"Missouri","Boone County",2,33,2436,1215,1221
050,29,019,"Missouri","Boone County",2,34,2389,1212,1177
050,29,019,"Missouri","Boone County",2,35,2365,1187,1178
050,29,019,"Missouri","Boone County",2,36,2406,1211,1195
050,29,019,"Missouri","Boone County",2,37,2450,1226,1224
050,29,019,"Missouri","Boone County",2,38,2408,1207,1201
050,29,019,"Missouri","Boone County",2,39,2361,1166,1195
050,29,019,"Missouri","Boone County",2,40,2292,1134,1158
050,29,019,"Missouri","Boone County",2,41,2191,1088,1103
050,29,019,"Missouri","Boone County",2,42,2146,1056,1090
050,29,019,"Missouri","Boone County",2,43,2041,999,1042
050,29,019,"Missouri","Boone County",2,44,1904,943,961
050,29,019,"Missouri","Boone County",2,45,1904,956,948
050,29,019,"Missouri","Boone County",2,46,1808,894,914
050,29,019,"Missouri","Boone County",2,47,1794,890,904
050,29,019,"Missouri","Boone County",2,48,1989,991,998
050,29,019,"Missouri","Boone County",2,49,2091,1040,1051
050,29,019,"Missouri","Boone County",2,50,1935,962,973
050,29,019,"Missouri","Boone County",2,51,1813,899,914
050,29,019,"Missouri","Boone County",2,52,1768,867,901
050,29,019,"Missouri","Boone County",2,53,1795,864,931
050,29,019,"Missouri","Boone County",2,54,1813,899,914
050,29,019,"Missouri","Boone County",2,55,1850,903,947
050,29,019,"Missouri","Boone County",2,56,1956,947,1009
050,29,019,"Missouri","Boone County",2,57,2048,1006,1042
050,29,019,"Missouri","Boone County",2,58,2036,988,1048
050,29,019,"Missouri","Boone County",2,59,2037,981,1056
050,29,019,"Missouri","Boone County",2,60,1966,951,1015
050,29,019,"Missouri","Boone County",2,61,1950,920,1030
050,29,019,"Missouri","Boone County",2,62,1932,906,1026
050,29,019,"Missouri","Boone County",2,63,1922,908,1014
050,29,019,"Missouri","Boone County",2,64,1859,882,977
050,29,019,"Missouri","Boone County",2,65,1765,831,934
050,29,019,"Missouri","Boone County",2,66,1724,788,936
050,29,019,"Missouri","Boone County",2,67,1676,762,914
050,29,019,"Missouri","Boone County",2,68,1615,758,857
050,29,019,"Missouri","Boone County",2,69,1550,720,830
050,29,019,"Missouri","Boone County",2,70,1454,692,762
050,29,019,"Missouri","Boone County",2,71,1409,684,725
050,29,019,"Missouri","Boone County",2,72,1327,649,678
050,29,019,"Missouri","Boone County",2,73,1326,649,677
050,29,019,"Missouri","Boone County",2,74,906,415,491
050,29,019,"Missouri","Boone County",2,75,836,379,457
050,29,019,"Missouri","Boone County",2,76,801,356,445
050,29,019,"Missouri","Boone County",2,77,797,360,437
050,29,019,"Missouri","Boone County",2,78,682,302,380
050,29,019,"Missouri","Boone County",2,79,625,276,349
050,29,019,"Missouri","Boone County",2,80,609,258,351
050,29,019,"Missouri","Boone County",2,81,542,225,317
050,29,019,"Missouri","Boone County",2,82,489,213,276
050,29,019,"Missouri","Boone County",2,83,423,178,245
050,29,019,"Missouri","Boone County",2,84,412,173,239
050,29,019,"Missouri","Boone County",2,85,2664,912,1752
050,29,019,"Missouri","Boone County",3,0,1927,974,953
050,29,019,"Missouri","Boone County",3,1,2016,1011,1005
050,29,019,"Missouri","Boone County",3,2,2038,1029,1009
050,29,019,"Missouri","Boone County",3,3,2058,1034,1024
050,29,019,"Missouri","Boone County",3,4,2146,1110,1036
050,29,019,"Missouri","Boone County",3,5,2162,1113,1049
050,29,019,"Missouri","Boone County",3,6,2123,1086,1037
050,29,019,"Missouri","Boone County",3,7,2147,1107,1040
050,29,019,"Missouri","Boone County",3,8,2143,1120,1023
050,29,019,"Missouri","Boone County",3,9,2082,1086,996
050,29,019,"Missouri","Boone County",3,10,2095,1063,1032
050,29,019,"Missouri","Boone County",3,11,2041,1047,994
050,29,019,"Missouri","Boone County",3,12,2078,1074,1004
050,29,019,"Missouri","Boone County",3,13,2226,1148,1078
050,29,019,"Missouri","Boone County",3,14,2198,1164,1034
050,29,019,"Missouri","Boone County",3,15,2145,1109,1036
050,29,019,"Missouri","Boone County",3,16,2149,1104,1045
050,29,019,"Missouri","Boone County",3,17,2149,1095,1054
050,29,019,"Missouri","Boone County",3,18,3477,1491,1986
050,29,019,"Missouri","Boone County",3,19,6477,2903,3574
050,29,019,"Missouri","Boone County",3,20,6147,2707,3440
050,29,019,"Missouri","Boone County",3,21,5856,2824,3032
050,29,019,"Missouri","Boone County",3,22,5172,2562,2610
050,29,019,"Missouri","Boone County",3,23,4265,2040,2225
050,29,019,"Missouri","Boone County",3,24,3591,1675,1916
050,29,019,"Missouri","Boone County",3,25,3202,1568,1634
050,29,019,"Missouri","Boone County",3,26,2930,1445,1485
050,29,019,"Missouri","Boone County",3,27,2682,1307,1375
050,29,019,"Missouri","Boone County",3,28,2649,1312,1337
050,29,019,"Missouri","Boone County",3,29,2658,1312,1346
050,29,019,"Missouri","Boone County",3,30,2735,1354,1381
050,29,019,"Missouri","Boone County",3,31,2763,1341,1422
050,29,019,"Missouri","Boone County",3,32,2677,1306,1371
050,29,019,"Missouri","Boone County",3,33,2582,1254,1328
050,29,019,"Missouri","Boone County",3,34,2396,1194,1202
050,29,019,"Missouri","Boone County",3,35,2389,1204,1185
050,29,019,"Missouri","Boone County",3,36,2365,1195,1170
050,29,019,"Missouri","Boone County",3,37,2401,1207,1194
050,29,019,"Missouri","Boone County",3,38,2440,1224,1216
050,29,019,"Missouri","Boone County",3,39,2401,1190,1211
050,29,019,"Missouri","Boone County",3,40,2366,1166,1200
050,29,019,"Missouri","Boone County",3,41,2311,1140,1171
050,29,019,"Missouri","Boone County",3,42,2198,1082,1116
050,29,019,"Missouri","Boone County",3,43,2138,1058,1080
050,29,019,"Missouri","Boone County",3,44,2050,986,1064
050,29,019,"Missouri","Boone County",3,45,1924,952,972
050,29,019,"Missouri","Boone County",3,46,1892,950,942
050,29,019,"Missouri","Boone County",3,47,1823,911,912
050,29,019,"Missouri","Boone County",3,48,1811,894,917
050,29,019,"Missouri","Boone County",3,49,1981,988,993
050,29,019,"Missouri","Boone County",3,50,2093,1030,1063
050,29,019,"Missouri","Boone County",3,51,1923,952,971
050,29,019,"Missouri","Boone County",3,52,1837,918,919
050,29,019,"Missouri","Boone County",3,53,1763,857,906
050,29,019,"Missouri","Boone County",3,54,1793,861,932
050,29,019,"Missouri","Boone County",3,55,1797,893,904
050,29,019,"Missouri","Boone County",3,56,1836,894,942
050,29,019,"Missouri","Boone County",3,57,1975,957,1018
050,29,019,"Missouri","Boone County",3,58,2010,974,1036
050,29,019,"Missouri","Boone County",3,59,2036,991,1045
050,29,019,"Missouri","Boone County",3,60,2053,991,1062
050,29,019,"Missouri","Boone County",3,61,1936,943,993
050,29,019,"Missouri","Boone County",3,62,1946,920,1026
050,29,019,"Missouri","Boone County",3,63,1921,899,1022
050,29,019,"Missouri","Boone County",3,64,1904,896,1008
050,29,019,"Missouri","Boone County",3,65,1833,859,974
050,29,019,"Missouri","Boone County",3,66,1743,818,925
050,29,019,"Missouri","Boone County",3,67,1718,780,938
050,29,019,"Missouri","Boone County",3,68,1648,756,892
050,29,019,"Missouri","Boone County",3,69,1587,752,835
050,29,019,"Missouri","Boone County",3,70,1545,713,832
050,29,019,"Missouri","Boone County",3,71,1439,686,753
050,29,019,"Missouri","Boone County",3,72,1395,670,725
050,29,019,"Missouri","Boone County",3,73,1298,638,660
050,29,019,"Missouri","Boone County",3,74,1297,624,673
050,29,019,"Missouri","Boone County",3,75,882,411,471
050,29,019,"Missouri","Boone County",3,76,827,368,459
050,29,019,"Missouri","Boone County",3,77,767,341,426
050,29,019,"Missouri","Boone County",3,78,774,347,427
050,29,019,"Missouri","Boone County",3,79,660,299,361
050,29,019,"Missouri","Boone County",3,80,618,267,351
050,29,019,"Missouri","Boone County",3,81,569,241,328
050,29,019,"Missouri","Boone County",3,82,480,199,281
050,29,019,"Missouri","Boone County",3,83,456,191,265
050,29,019,"Missouri","Boone County",3,84,398,170,228
050,29,019,"Missouri","Boone County",3,85,2686,942,1744
050,29,019,"Missouri","Boone County",4,0,1966,994,972
050,29,019,"Missouri","Boone County",4,1,1847,949,898
050,29,019,"Missouri","Boone County",4,2,2022,995,1027
050,29,019,"Missouri","Boone County",4,3,2064,1052,1012
050,29,019,"Missouri","Boone County",4,4,2078,1056,1022
050,29,019,"Missouri","Boone County",4,5,2170,1122,1048
050,29,019,"Missouri","Boone County",4,6,2180,1109,1071
050,29,019,"Missouri","Boone County",4,7,2104,1075,1029
050,29,019,"Missouri","Boone County",4,8,2133,1102,1031
050,29,019,"Missouri","Boone County",4,9,2177,1140,1037
050,29,019,"Missouri","Boone County",4,10,2074,1069,1005
050,29,019,"Missouri","Boone County",4,11,2100,1055,1045
050,29,019,"Missouri","Boone County",4,12,2056,1056,1000
050,29,019,"Missouri","Boone County",4,13,2114,1080,1034
050,29,019,"Missouri","Boone County",4,14,2258,1173,1085
050,29,019,"Missouri","Boone County",4,15,2195,1167,1028
050,29,019,"Missouri","Boone County",4,16,2173,1117,1056
050,29,019,"Missouri","Boone County",4,17,2155,1095,1060
050,29,019,"Missouri","Boone County",4,18,3562,1567,1995
050,29,019,"Missouri","Boone County",4,19,6470,2917,3553
050,29,019,"Missouri","Boone County",4,20,6037,2646,3391
050,29,019,"Missouri","Boone County",4,21,6051,2871,3180
050,29,019,"Missouri","Boone County",4,22,5316,2706,2610
050,29,019,"Missouri","Boone County",4,23,4306,2085,2221
050,29,019,"Missouri","Boone County",4,24,3586,1660,1926
050,29,019,"Missouri","Boone County",4,25,3223,1590,1633
050,29,019,"Missouri","Boone County",4,26,2902,1418,1484
050,29,019,"Missouri","Boone County",4,27,2635,1299,1336
050,29,019,"Missouri","Boone County",4,28,2624,1271,1353
050,29,019,"Missouri","Boone County",4,29,2616,1283,1333
050,29,019,"Missouri","Boone County",4,30,2662,1319,1343
050,29,019,"Missouri","Boone County",4,31,2680,1313,1367
050,29,019,"Missouri","Boone County",4,32,2701,1309,1392
050,29,019,"Missouri","Boone County",4,33,2603,1288,1315
050,29,019,"Missouri","Boone County",4,34,2550,1233,1317
050,29,019,"Missouri","Boone County",4,35,2392,1173,1219
050,29,019,"Missouri","Boone County",4,36,2391,1211,1180
050,29,019,"Missouri","Boone County",4,37,2331,1160,1171
050,29,019,"Missouri","Boone County",4,38,2412,1196,1216
050,29,019,"Missouri","Boone County",4,39,2425,1209,1216
050,29,019,"Missouri","Boone County",4,40,2392,1208,1184
050,29,019,"Missouri","Boone County",4,41,2317,1141,1176
050,29,019,"Missouri","Boone County",4,42,2306,1130,1176
050,29,019,"Missouri","Boone County",4,43,2226,1096,1130
050,29,019,"Missouri","Boone County",4,44,2172,1059,1113
050,29,019,"Missouri","Boone County",4,45,2062,1005,1057
050,29,019,"Missouri","Boone County",4,46,1892,925,967
050,29,019,"Missouri","Boone County",4,47,1909,966,943
050,29,019,"Missouri","Boone County",4,48,1862,926,936
050,29,019,"Missouri","Boone County",4,49,1809,897,912
050,29,019,"Missouri","Boone County",4,50,2000,990,1010
050,29,019,"Missouri","Boone County",4,51,2080,1038,1042
050,29,019,"Missouri","Boone County",4,52,1944,960,984
050,29,019,"Missouri","Boone County",4,53,1841,922,919
050,29,019,"Missouri","Boone County",4,54,1757,869,888
050,29,019,"Missouri","Boone County",4,55,1764,847,917
050,29,019,"Missouri","Boone County",4,56,1795,896,899
050,29,019,"Missouri","Boone County",4,57,1883,937,946
050,29,019,"Missouri","Boone County",4,58,1965,937,1028
050,29,019,"Missouri","Boone County",4,59,2002,971,1031
050,29,019,"Missouri","Boone County",4,60,1983,970,1013
050,29,019,"Missouri","Boone County",4,61,2018,964,1054
050,29,019,"Missouri","Boone County",4,62,1913,930,983
050,29,019,"Missouri","Boone County",4,63,1922,903,1019
050,29,019,"Missouri","Boone County",4,64,1879,872,1007
050,29,019,"Missouri","Boone County",4,65,1859,863,996
050,29,019,"Missouri","Boone County",4,66,1803,844,959
050,29,019,"Missouri","Boone County",4,67,1721,797,924
050,29,019,"Missouri","Boone County",4,68,1719,778,941
050,29,019,"Missouri","Boone County",4,69,1627,747,880
050,29,019,"Missouri","Boone County",4,70,1580,739,841
050,29,019,"Missouri","Boone County",4,71,1523,696,827
050,29,019,"Missouri","Boone County",4,72,1417,666,751
050,29,019,"Missouri","Boone County",4,73,1368,654,714
050,29,019,"Missouri","Boone County",4,74,1282,623,659
050,29,019,"Missouri","Boone County",4,75,1267,617,650
050,29,019,"Missouri","Boone County",4,76,873,404,469
050,29,019,"Missouri","Boone County",4,77,806,359,447
050,29,019,"Missouri","Boone County",4,78,743,323,420
050,29,019,"Missouri","Boone County",4,79,726,317,409
050,29,019,"Missouri","Boone County",4,80,655,286,369
050,29,019,"Missouri","Boone County",4,81,567,244,323
050,29,019,"Missouri","Boone County",4,82,529,221,308
050,29,019,"Missouri","Boone County",4,83,463,184,279
050,29,019,"Missouri","Boone County",4,84,429,180,249
050,29,019,"Missouri","Boone County",4,85,2730,968,1762
050,29,019,"Missouri","Boone County",5,0,1954,986,968
050,29,019,"Missouri","Boone County",5,1,1932,954,978
050,29,019,"Missouri","Boone County",5,2,1869,961,908
050,29,019,"Missouri","Boone County",5,3,2031,1007,1024
050,29,019,"Missouri","Boone County",5,4,2051,1040,1011
050,29,019,"Missouri","Boone County",5,5,2068,1045,1023
050,29,019,"Missouri","Boone County",5,6,2185,1126,1059
050,29,019,"Missouri","Boone County",5,7,2186,1128,1058
050,29,019,"Missouri","Boone County",5,8,2102,1081,1021
050,29,019,"Missouri","Boone County",5,9,2193,1136,1057
050,29,019,"Missouri","Boone County",5,10,2167,1126,1041
050,29,019,"Missouri","Boone County",5,11,2104,1082,1022
050,29,019,"Missouri","Boone County",5,12,2127,1083,1044
050,29,019,"Missouri","Boone County",5,13,2110,1085,1025
050,29,019,"Missouri","Boone County",5,14,2116,1081,1035
050,29,019,"Missouri","Boone County",5,15,2262,1173,1089
050,29,019,"Missouri","Boone County",5,16,2221,1176,1045
050,29,019,"Missouri","Boone County",5,17,2200,1123,1077
050,29,019,"Missouri","Boone County",5,18,3559,1544,2015
050,29,019,"Missouri","Boone County",5,19,6548,2978,3570
050,29,019,"Missouri","Boone County",5,20,5965,2649,3316
050,29,019,"Missouri","Boone County",5,21,5922,2817,3105
050,29,019,"Missouri","Boone County",5,22,5535,2745,2790
050,29,019,"Missouri","Boone County",5,23,4405,2208,2197
050,29,019,"Missouri","Boone County",5,24,3587,1677,1910
050,29,019,"Missouri","Boone County",5,25,3161,1541,1620
050,29,019,"Missouri","Boone County",5,26,2837,1396,1441
050,29,019,"Missouri","Boone County",5,27,2705,1326,1379
050,29,019,"Missouri","Boone County",5,28,2608,1296,1312
050,29,019,"Missouri","Boone County",5,29,2603,1250,1353
050,29,019,"Missouri","Boone County",5,30,2619,1297,1322
050,29,019,"Missouri","Boone County",5,31,2626,1304,1322
050,29,019,"Missouri","Boone County",5,32,2647,1317,1330
050,29,019,"Missouri","Boone County",5,33,2655,1273,1382
050,29,019,"Missouri","Boone County",5,34,2573,1258,1315
050,29,019,"Missouri","Boone County",5,35,2528,1219,1309
050,29,019,"Missouri","Boone County",5,36,2384,1166,1218
050,29,019,"Missouri","Boone County",5,37,2386,1205,1181
050,29,019,"Missouri","Boone County",5,38,2331,1163,1168
050,29,019,"Missouri","Boone County",5,39,2427,1196,1231
050,29,019,"Missouri","Boone County",5,40,2418,1208,1210
050,29,019,"Missouri","Boone County",5,41,2388,1185,1203
050,29,019,"Missouri","Boone County",5,42,2349,1163,1186
050,29,019,"Missouri","Boone County",5,43,2343,1160,1183
050,29,019,"Missouri","Boone County",5,44,2272,1107,1165
050,29,019,"Missouri","Boone County",5,45,2149,1055,1094
050,29,019,"Missouri","Boone County",5,46,2035,977,1058
050,29,019,"Missouri","Boone County",5,47,1889,921,968
050,29,019,"Missouri","Boone County",5,48,1925,977,948
050,29,019,"Missouri","Boone County",5,49,1847,934,913
050,29,019,"Missouri","Boone County",5,50,1809,900,909
050,29,019,"Missouri","Boone County",5,51,1999,991,1008
050,29,019,"Missouri","Boone County",5,52,2065,1026,1039
050,29,019,"Missouri","Boone County",5,53,1930,956,974
050,29,019,"Missouri","Boone County",5,54,1822,907,915
050,29,019,"Missouri","Boone County",5,55,1741,867,874
050,29,019,"Missouri","Boone County",5,56,1791,852,939
050,29,019,"Missouri","Boone County",5,57,1823,921,902
050,29,019,"Missouri","Boone County",5,58,1858,936,922
050,29,019,"Missouri","Boone County",5,59,1975,931,1044
050,29,019,"Missouri","Boone County",5,60,2012,968,1044
050,29,019,"Missouri","Boone County",5,61,1961,954,1007
050,29,019,"Missouri","Boone County",5,62,1991,963,1028
050,29,019,"Missouri","Boone County",5,63,1904,913,991
050,29,019,"Missouri","Boone County",5,64,1894,873,1021
050,29,019,"Missouri","Boone County",5,65,1862,863,999
050,29,019,"Missouri","Boone County",5,66,1823,848,975
050,29,019,"Missouri","Boone County",5,67,1793,829,964
050,29,019,"Missouri","Boone County",5,68,1697,790,907
050,29,019,"Missouri","Boone County",5,69,1692,760,932
050,29,019,"Missouri","Boone County",5,70,1606,731,875
050,29,019,"Missouri","Boone County",5,71,1572,740,832
050,29,019,"Missouri","Boone County",5,72,1492,681,811
050,29,019,"Missouri","Boone County",5,73,1407,664,743
050,29,019,"Missouri","Boone County",5,74,1363,643,720
050,29,019,"Missouri","Boone County",5,75,1260,615,645
050,29,019,"Missouri","Boone County",5,76,1255,604,651
050,29,019,"Missouri","Boone County",5,77,831,386,445
050,29,019,"Missouri","Boone County",5,78,782,337,445
050,29,019,"Missouri","Boone County",5,79,720,313,407
050,29,019,"Missouri","Boone County",5,80,719,306,413
050,29,019,"Missouri","Boone County",5,81,614,263,351
050,29,019,"Missouri","Boone County",5,82,530,225,305
050,29,019,"Missouri","Boone County",5,83,502,203,299
050,29,019,"Missouri","Boone County",5,84,438,170,268
050,29,019,"Missouri","Boone County",5,85,2826,1021,1805
050,29,021,"Missouri","Buchanan County",1,0,1018,513,505
050,29,021,"Missouri","Buchanan County",1,1,1042,517,525
050,29,021,"Missouri","Buchanan County",1,2,1022,539,483
050,29,021,"Missouri","Buchanan County",1,3,1047,536,511
050,29,021,"Missouri","Buchanan County",1,4,1060,557,503
050,29,021,"Missouri","Buchanan County",1,5,1075,572,503
050,29,021,"Missouri","Buchanan County",1,6,1044,572,472
050,29,021,"Missouri","Buchanan County",1,7,1033,540,493
050,29,021,"Missouri","Buchanan County",1,8,1073,576,497
050,29,021,"Missouri","Buchanan County",1,9,1037,542,495
050,29,021,"Missouri","Buchanan County",1,10,1060,553,507
050,29,021,"Missouri","Buchanan County",1,11,1077,534,543
050,29,021,"Missouri","Buchanan County",1,12,1111,566,545
050,29,021,"Missouri","Buchanan County",1,13,1144,573,571
050,29,021,"Missouri","Buchanan County",1,14,1120,582,538
050,29,021,"Missouri","Buchanan County",1,15,1068,558,510
050,29,021,"Missouri","Buchanan County",1,16,1081,554,527
050,29,021,"Missouri","Buchanan County",1,17,1087,582,505
050,29,021,"Missouri","Buchanan County",1,18,1066,574,492
050,29,021,"Missouri","Buchanan County",1,19,1134,568,566
050,29,021,"Missouri","Buchanan County",1,20,1153,621,532
050,29,021,"Missouri","Buchanan County",1,21,1069,550,519
050,29,021,"Missouri","Buchanan County",1,22,1080,572,508
050,29,021,"Missouri","Buchanan County",1,23,1110,580,530
050,29,021,"Missouri","Buchanan County",1,24,1100,595,505
050,29,021,"Missouri","Buchanan County",1,25,1125,596,529
050,29,021,"Missouri","Buchanan County",1,26,1131,610,521
050,29,021,"Missouri","Buchanan County",1,27,1168,614,554
050,29,021,"Missouri","Buchanan County",1,28,1162,605,557
050,29,021,"Missouri","Buchanan County",1,29,1211,663,548
050,29,021,"Missouri","Buchanan County",1,30,1216,639,577
050,29,021,"Missouri","Buchanan County",1,31,1145,600,545
050,29,021,"Missouri","Buchanan County",1,32,1111,568,543
050,29,021,"Missouri","Buchanan County",1,33,1083,574,509
050,29,021,"Missouri","Buchanan County",1,34,1156,624,532
050,29,021,"Missouri","Buchanan County",1,35,1145,626,519
050,29,021,"Missouri","Buchanan County",1,36,1128,617,511
050,29,021,"Missouri","Buchanan County",1,37,1161,633,528
050,29,021,"Missouri","Buchanan County",1,38,1131,631,500
050,29,021,"Missouri","Buchanan County",1,39,1149,624,525
050,29,021,"Missouri","Buchanan County",1,40,1110,592,518
050,29,021,"Missouri","Buchanan County",1,41,1021,542,479
050,29,021,"Missouri","Buchanan County",1,42,1025,546,479
050,29,021,"Missouri","Buchanan County",1,43,996,523,473
050,29,021,"Missouri","Buchanan County",1,44,996,544,452
050,29,021,"Missouri","Buchanan County",1,45,984,550,434
050,29,021,"Missouri","Buchanan County",1,46,944,491,453
050,29,021,"Missouri","Buchanan County",1,47,947,481,466
050,29,021,"Missouri","Buchanan County",1,48,985,529,456
050,29,021,"Missouri","Buchanan County",1,49,1071,564,507
050,29,021,"Missouri","Buchanan County",1,50,1047,534,513
050,29,021,"Missouri","Buchanan County",1,51,1012,528,484
050,29,021,"Missouri","Buchanan County",1,52,943,482,461
050,29,021,"Missouri","Buchanan County",1,53,980,497,483
050,29,021,"Missouri","Buchanan County",1,54,1070,531,539
050,29,021,"Missouri","Buchanan County",1,55,1153,571,582
050,29,021,"Missouri","Buchanan County",1,56,1135,571,564
050,29,021,"Missouri","Buchanan County",1,57,1203,593,610
050,29,021,"Missouri","Buchanan County",1,58,1241,607,634
050,29,021,"Missouri","Buchanan County",1,59,1212,590,622
050,29,021,"Missouri","Buchanan County",1,60,1156,609,547
050,29,021,"Missouri","Buchanan County",1,61,1110,586,524
050,29,021,"Missouri","Buchanan County",1,62,1139,566,573
050,29,021,"Missouri","Buchanan County",1,63,1102,531,571
050,29,021,"Missouri","Buchanan County",1,64,1071,512,559
050,29,021,"Missouri","Buchanan County",1,65,1002,486,516
050,29,021,"Missouri","Buchanan County",1,66,996,477,519
050,29,021,"Missouri","Buchanan County",1,67,890,435,455
050,29,021,"Missouri","Buchanan County",1,68,885,418,467
050,29,021,"Missouri","Buchanan County",1,69,868,404,464
050,29,021,"Missouri","Buchanan County",1,70,826,383,443
050,29,021,"Missouri","Buchanan County",1,71,795,351,444
050,29,021,"Missouri","Buchanan County",1,72,762,358,404
050,29,021,"Missouri","Buchanan County",1,73,718,339,379
050,29,021,"Missouri","Buchanan County",1,74,497,225,272
050,29,021,"Missouri","Buchanan County",1,75,539,244,295
050,29,021,"Missouri","Buchanan County",1,76,541,240,301
050,29,021,"Missouri","Buchanan County",1,77,511,210,301
050,29,021,"Missouri","Buchanan County",1,78,461,193,268
050,29,021,"Missouri","Buchanan County",1,79,415,168,247
050,29,021,"Missouri","Buchanan County",1,80,364,150,214
050,29,021,"Missouri","Buchanan County",1,81,368,159,209
050,29,021,"Missouri","Buchanan County",1,82,335,143,192
050,29,021,"Missouri","Buchanan County",1,83,291,115,176
050,29,021,"Missouri","Buchanan County",1,84,287,119,168
050,29,021,"Missouri","Buchanan County",1,85,1659,562,1097
050,29,021,"Missouri","Buchanan County",2,0,1044,538,506
050,29,021,"Missouri","Buchanan County",2,1,1029,518,511
050,29,021,"Missouri","Buchanan County",2,2,1026,534,492
050,29,021,"Missouri","Buchanan County",2,3,1034,532,502
050,29,021,"Missouri","Buchanan County",2,4,1061,555,506
050,29,021,"Missouri","Buchanan County",2,5,1068,569,499
050,29,021,"Missouri","Buchanan County",2,6,1049,573,476
050,29,021,"Missouri","Buchanan County",2,7,1030,547,483
050,29,021,"Missouri","Buchanan County",2,8,1056,565,491
050,29,021,"Missouri","Buchanan County",2,9,1042,548,494
050,29,021,"Missouri","Buchanan County",2,10,1052,547,505
050,29,021,"Missouri","Buchanan County",2,11,1066,533,533
050,29,021,"Missouri","Buchanan County",2,12,1104,556,548
050,29,021,"Missouri","Buchanan County",2,13,1136,571,565
050,29,021,"Missouri","Buchanan County",2,14,1123,578,545
050,29,021,"Missouri","Buchanan County",2,15,1080,561,519
050,29,021,"Missouri","Buchanan County",2,16,1084,561,523
050,29,021,"Missouri","Buchanan County",2,17,1087,578,509
050,29,021,"Missouri","Buchanan County",2,18,1061,563,498
050,29,021,"Missouri","Buchanan County",2,19,1131,570,561
050,29,021,"Missouri","Buchanan County",2,20,1139,605,534
050,29,021,"Missouri","Buchanan County",2,21,1067,551,516
050,29,021,"Missouri","Buchanan County",2,22,1080,563,517
050,29,021,"Missouri","Buchanan County",2,23,1088,569,519
050,29,021,"Missouri","Buchanan County",2,24,1089,578,511
050,29,021,"Missouri","Buchanan County",2,25,1103,585,518
050,29,021,"Missouri","Buchanan County",2,26,1115,594,521
050,29,021,"Missouri","Buchanan County",2,27,1153,606,547
050,29,021,"Missouri","Buchanan County",2,28,1148,596,552
050,29,021,"Missouri","Buchanan County",2,29,1182,633,549
050,29,021,"Missouri","Buchanan County",2,30,1204,635,569
050,29,021,"Missouri","Buchanan County",2,31,1148,596,552
050,29,021,"Missouri","Buchanan County",2,32,1107,564,543
050,29,021,"Missouri","Buchanan County",2,33,1078,564,514
050,29,021,"Missouri","Buchanan County",2,34,1127,604,523
050,29,021,"Missouri","Buchanan County",2,35,1139,616,523
050,29,021,"Missouri","Buchanan County",2,36,1111,602,509
050,29,021,"Missouri","Buchanan County",2,37,1145,624,521
050,29,021,"Missouri","Buchanan County",2,38,1132,626,506
050,29,021,"Missouri","Buchanan County",2,39,1132,617,515
050,29,021,"Missouri","Buchanan County",2,40,1110,591,519
050,29,021,"Missouri","Buchanan County",2,41,1032,547,485
050,29,021,"Missouri","Buchanan County",2,42,1012,538,474
050,29,021,"Missouri","Buchanan County",2,43,1004,524,480
050,29,021,"Missouri","Buchanan County",2,44,982,531,451
050,29,021,"Missouri","Buchanan County",2,45,978,538,440
050,29,021,"Missouri","Buchanan County",2,46,945,497,448
050,29,021,"Missouri","Buchanan County",2,47,938,478,460
050,29,021,"Missouri","Buchanan County",2,48,965,509,456
050,29,021,"Missouri","Buchanan County",2,49,1054,556,498
050,29,021,"Missouri","Buchanan County",2,50,1047,535,512
050,29,021,"Missouri","Buchanan County",2,51,1015,526,489
050,29,021,"Missouri","Buchanan County",2,52,945,481,464
050,29,021,"Missouri","Buchanan County",2,53,962,487,475
050,29,021,"Missouri","Buchanan County",2,54,1037,514,523
050,29,021,"Missouri","Buchanan County",2,55,1124,553,571
050,29,021,"Missouri","Buchanan County",2,56,1139,569,570
050,29,021,"Missouri","Buchanan County",2,57,1188,587,601
050,29,021,"Missouri","Buchanan County",2,58,1231,603,628
050,29,021,"Missouri","Buchanan County",2,59,1220,593,627
050,29,021,"Missouri","Buchanan County",2,60,1165,602,563
050,29,021,"Missouri","Buchanan County",2,61,1114,585,529
050,29,021,"Missouri","Buchanan County",2,62,1121,565,556
050,29,021,"Missouri","Buchanan County",2,63,1116,538,578
050,29,021,"Missouri","Buchanan County",2,64,1062,510,552
050,29,021,"Missouri","Buchanan County",2,65,1018,492,526
050,29,021,"Missouri","Buchanan County",2,66,990,476,514
050,29,021,"Missouri","Buchanan County",2,67,911,443,468
050,29,021,"Missouri","Buchanan County",2,68,878,415,463
050,29,021,"Missouri","Buchanan County",2,69,877,411,466
050,29,021,"Missouri","Buchanan County",2,70,822,381,441
050,29,021,"Missouri","Buchanan County",2,71,801,358,443
050,29,021,"Missouri","Buchanan County",2,72,755,350,405
050,29,021,"Missouri","Buchanan County",2,73,763,359,404
050,29,021,"Missouri","Buchanan County",2,74,515,236,279
050,29,021,"Missouri","Buchanan County",2,75,524,237,287
050,29,021,"Missouri","Buchanan County",2,76,530,235,295
050,29,021,"Missouri","Buchanan County",2,77,528,220,308
050,29,021,"Missouri","Buchanan County",2,78,459,193,266
050,29,021,"Missouri","Buchanan County",2,79,417,167,250
050,29,021,"Missouri","Buchanan County",2,80,375,154,221
050,29,021,"Missouri","Buchanan County",2,81,366,156,210
050,29,021,"Missouri","Buchanan County",2,82,339,141,198
050,29,021,"Missouri","Buchanan County",2,83,300,121,179
050,29,021,"Missouri","Buchanan County",2,84,284,117,167
050,29,021,"Missouri","Buchanan County",2,85,1659,563,1096
050,29,021,"Missouri","Buchanan County",3,0,1035,518,517
050,29,021,"Missouri","Buchanan County",3,1,1037,546,491
050,29,021,"Missouri","Buchanan County",3,2,1002,505,497
050,29,021,"Missouri","Buchanan County",3,3,1010,518,492
050,29,021,"Missouri","Buchanan County",3,4,1017,514,503
050,29,021,"Missouri","Buchanan County",3,5,1024,537,487
050,29,021,"Missouri","Buchanan County",3,6,1056,569,487
050,29,021,"Missouri","Buchanan County",3,7,1054,574,480
050,29,021,"Missouri","Buchanan County",3,8,1027,544,483
050,29,021,"Missouri","Buchanan County",3,9,1033,538,495
050,29,021,"Missouri","Buchanan County",3,10,1035,551,484
050,29,021,"Missouri","Buchanan County",3,11,1020,533,487
050,29,021,"Missouri","Buchanan County",3,12,1038,510,528
050,29,021,"Missouri","Buchanan County",3,13,1072,545,527
050,29,021,"Missouri","Buchanan County",3,14,1128,572,556
050,29,021,"Missouri","Buchanan County",3,15,1097,570,527
050,29,021,"Missouri","Buchanan County",3,16,1110,577,533
050,29,021,"Missouri","Buchanan County",3,17,1057,551,506
050,29,021,"Missouri","Buchanan County",3,18,1091,567,524
050,29,021,"Missouri","Buchanan County",3,19,1131,574,557
050,29,021,"Missouri","Buchanan County",3,20,1145,604,541
050,29,021,"Missouri","Buchanan County",3,21,1074,573,501
050,29,021,"Missouri","Buchanan County",3,22,1103,584,519
050,29,021,"Missouri","Buchanan County",3,23,1096,582,514
050,29,021,"Missouri","Buchanan County",3,24,1082,574,508
050,29,021,"Missouri","Buchanan County",3,25,1050,592,458
050,29,021,"Missouri","Buchanan County",3,26,1067,564,503
050,29,021,"Missouri","Buchanan County",3,27,1089,568,521
050,29,021,"Missouri","Buchanan County",3,28,1116,587,529
050,29,021,"Missouri","Buchanan County",3,29,1148,601,547
050,29,021,"Missouri","Buchanan County",3,30,1184,646,538
050,29,021,"Missouri","Buchanan County",3,31,1148,618,530
050,29,021,"Missouri","Buchanan County",3,32,1106,571,535
050,29,021,"Missouri","Buchanan County",3,33,1105,565,540
050,29,021,"Missouri","Buchanan County",3,34,1095,574,521
050,29,021,"Missouri","Buchanan County",3,35,1112,597,515
050,29,021,"Missouri","Buchanan County",3,36,1134,613,521
050,29,021,"Missouri","Buchanan County",3,37,1116,608,508
050,29,021,"Missouri","Buchanan County",3,38,1115,607,508
050,29,021,"Missouri","Buchanan County",3,39,1139,635,504
050,29,021,"Missouri","Buchanan County",3,40,1094,586,508
050,29,021,"Missouri","Buchanan County",3,41,1091,578,513
050,29,021,"Missouri","Buchanan County",3,42,1013,543,470
050,29,021,"Missouri","Buchanan County",3,43,985,524,461
050,29,021,"Missouri","Buchanan County",3,44,1004,528,476
050,29,021,"Missouri","Buchanan County",3,45,949,497,452
050,29,021,"Missouri","Buchanan County",3,46,962,530,432
050,29,021,"Missouri","Buchanan County",3,47,925,481,444
050,29,021,"Missouri","Buchanan County",3,48,926,487,439
050,29,021,"Missouri","Buchanan County",3,49,968,510,458
050,29,021,"Missouri","Buchanan County",3,50,1024,538,486
050,29,021,"Missouri","Buchanan County",3,51,1046,532,514
050,29,021,"Missouri","Buchanan County",3,52,996,493,503
050,29,021,"Missouri","Buchanan County",3,53,923,473,450
050,29,021,"Missouri","Buchanan County",3,54,941,475,466
050,29,021,"Missouri","Buchanan County",3,55,1027,509,518
050,29,021,"Missouri","Buchanan County",3,56,1094,528,566
050,29,021,"Missouri","Buchanan County",3,57,1126,563,563
050,29,021,"Missouri","Buchanan County",3,58,1180,585,595
050,29,021,"Missouri","Buchanan County",3,59,1195,584,611
050,29,021,"Missouri","Buchanan County",3,60,1183,576,607
050,29,021,"Missouri","Buchanan County",3,61,1136,579,557
050,29,021,"Missouri","Buchanan County",3,62,1092,575,517
050,29,021,"Missouri","Buchanan County",3,63,1101,547,554
050,29,021,"Missouri","Buchanan County",3,64,1044,495,549
050,29,021,"Missouri","Buchanan County",3,65,1047,508,539
050,29,021,"Missouri","Buchanan County",3,66,993,473,520
050,29,021,"Missouri","Buchanan County",3,67,968,464,504
050,29,021,"Missouri","Buchanan County",3,68,893,432,461
050,29,021,"Missouri","Buchanan County",3,69,848,397,451
050,29,021,"Missouri","Buchanan County",3,70,836,386,450
050,29,021,"Missouri","Buchanan County",3,71,795,366,429
050,29,021,"Missouri","Buchanan County",3,72,774,348,426
050,29,021,"Missouri","Buchanan County",3,73,727,331,396
050,29,021,"Missouri","Buchanan County",3,74,736,337,399
050,29,021,"Missouri","Buchanan County",3,75,490,225,265
050,29,021,"Missouri","Buchanan County",3,76,495,215,280
050,29,021,"Missouri","Buchanan County",3,77,509,224,285
050,29,021,"Missouri","Buchanan County",3,78,510,211,299
050,29,021,"Missouri","Buchanan County",3,79,427,175,252
050,29,021,"Missouri","Buchanan County",3,80,399,167,232
050,29,021,"Missouri","Buchanan County",3,81,349,140,209
050,29,021,"Missouri","Buchanan County",3,82,332,136,196
050,29,021,"Missouri","Buchanan County",3,83,305,122,183
050,29,021,"Missouri","Buchanan County",3,84,276,111,165
050,29,021,"Missouri","Buchanan County",3,85,1591,558,1033
050,29,021,"Missouri","Buchanan County",4,0,976,473,503
050,29,021,"Missouri","Buchanan County",4,1,1010,522,488
050,29,021,"Missouri","Buchanan County",4,2,1042,553,489
050,29,021,"Missouri","Buchanan County",4,3,1001,498,503
050,29,021,"Missouri","Buchanan County",4,4,1001,513,488
050,29,021,"Missouri","Buchanan County",4,5,998,499,499
050,29,021,"Missouri","Buchanan County",4,6,1006,519,487
050,29,021,"Missouri","Buchanan County",4,7,1030,550,480
050,29,021,"Missouri","Buchanan County",4,8,1053,587,466
050,29,021,"Missouri","Buchanan County",4,9,1002,529,473
050,29,021,"Missouri","Buchanan County",4,10,1023,532,491
050,29,021,"Missouri","Buchanan County",4,11,1026,544,482
050,29,021,"Missouri","Buchanan County",4,12,993,510,483
050,29,021,"Missouri","Buchanan County",4,13,1024,508,516
050,29,021,"Missouri","Buchanan County",4,14,1060,539,521
050,29,021,"Missouri","Buchanan County",4,15,1130,572,558
050,29,021,"Missouri","Buchanan County",4,16,1110,588,522
050,29,021,"Missouri","Buchanan County",4,17,1141,592,549
050,29,021,"Missouri","Buchanan County",4,18,1056,539,517
050,29,021,"Missouri","Buchanan County",4,19,1106,562,544
050,29,021,"Missouri","Buchanan County",4,20,1104,580,524
050,29,021,"Missouri","Buchanan County",4,21,1061,547,514
050,29,021,"Missouri","Buchanan County",4,22,1091,592,499
050,29,021,"Missouri","Buchanan County",4,23,1091,582,509
050,29,021,"Missouri","Buchanan County",4,24,1077,582,495
050,29,021,"Missouri","Buchanan County",4,25,1062,563,499
050,29,021,"Missouri","Buchanan County",4,26,1033,561,472
050,29,021,"Missouri","Buchanan County",4,27,1082,573,509
050,29,021,"Missouri","Buchanan County",4,28,1060,548,512
050,29,021,"Missouri","Buchanan County",4,29,1093,539,554
050,29,021,"Missouri","Buchanan County",4,30,1114,586,528
050,29,021,"Missouri","Buchanan County",4,31,1095,591,504
050,29,021,"Missouri","Buchanan County",4,32,1126,583,543
050,29,021,"Missouri","Buchanan County",4,33,1084,561,523
050,29,021,"Missouri","Buchanan County",4,34,1088,567,521
050,29,021,"Missouri","Buchanan County",4,35,1078,560,518
050,29,021,"Missouri","Buchanan County",4,36,1084,572,512
050,29,021,"Missouri","Buchanan County",4,37,1139,613,526
050,29,021,"Missouri","Buchanan County",4,38,1096,589,507
050,29,021,"Missouri","Buchanan County",4,39,1107,605,502
050,29,021,"Missouri","Buchanan County",4,40,1099,604,495
050,29,021,"Missouri","Buchanan County",4,41,1072,567,505
050,29,021,"Missouri","Buchanan County",4,42,1080,567,513
050,29,021,"Missouri","Buchanan County",4,43,995,519,476
050,29,021,"Missouri","Buchanan County",4,44,985,524,461
050,29,021,"Missouri","Buchanan County",4,45,986,517,469
050,29,021,"Missouri","Buchanan County",4,46,939,492,447
050,29,021,"Missouri","Buchanan County",4,47,971,528,443
050,29,021,"Missouri","Buchanan County",4,48,900,463,437
050,29,021,"Missouri","Buchanan County",4,49,918,483,435
050,29,021,"Missouri","Buchanan County",4,50,961,504,457
050,29,021,"Missouri","Buchanan County",4,51,1038,553,485
050,29,021,"Missouri","Buchanan County",4,52,1027,505,522
050,29,021,"Missouri","Buchanan County",4,53,980,482,498
050,29,021,"Missouri","Buchanan County",4,54,907,458,449
050,29,021,"Missouri","Buchanan County",4,55,944,472,472
050,29,021,"Missouri","Buchanan County",4,56,1011,510,501
050,29,021,"Missouri","Buchanan County",4,57,1093,534,559
050,29,021,"Missouri","Buchanan County",4,58,1119,558,561
050,29,021,"Missouri","Buchanan County",4,59,1127,552,575
050,29,021,"Missouri","Buchanan County",4,60,1155,564,591
050,29,021,"Missouri","Buchanan County",4,61,1165,556,609
050,29,021,"Missouri","Buchanan County",4,62,1115,564,551
050,29,021,"Missouri","Buchanan County",4,63,1077,554,523
050,29,021,"Missouri","Buchanan County",4,64,1056,528,528
050,29,021,"Missouri","Buchanan County",4,65,1041,493,548
050,29,021,"Missouri","Buchanan County",4,66,1028,489,539
050,29,021,"Missouri","Buchanan County",4,67,982,473,509
050,29,021,"Missouri","Buchanan County",4,68,947,448,499
050,29,021,"Missouri","Buchanan County",4,69,873,416,457
050,29,021,"Missouri","Buchanan County",4,70,830,380,450
050,29,021,"Missouri","Buchanan County",4,71,816,371,445
050,29,021,"Missouri","Buchanan County",4,72,769,353,416
050,29,021,"Missouri","Buchanan County",4,73,768,347,421
050,29,021,"Missouri","Buchanan County",4,74,689,302,387
050,29,021,"Missouri","Buchanan County",4,75,730,331,399
050,29,021,"Missouri","Buchanan County",4,76,450,199,251
050,29,021,"Missouri","Buchanan County",4,77,484,217,267
050,29,021,"Missouri","Buchanan County",4,78,488,216,272
050,29,021,"Missouri","Buchanan County",4,79,485,195,290
050,29,021,"Missouri","Buchanan County",4,80,402,170,232
050,29,021,"Missouri","Buchanan County",4,81,368,156,212
050,29,021,"Missouri","Buchanan County",4,82,324,127,197
050,29,021,"Missouri","Buchanan County",4,83,305,112,193
050,29,021,"Missouri","Buchanan County",4,84,281,111,170
050,29,021,"Missouri","Buchanan County",4,85,1558,555,1003
050,29,021,"Missouri","Buchanan County",5,0,976,474,502
050,29,021,"Missouri","Buchanan County",5,1,971,460,511
050,29,021,"Missouri","Buchanan County",5,2,1006,542,464
050,29,021,"Missouri","Buchanan County",5,3,1040,556,484
050,29,021,"Missouri","Buchanan County",5,4,973,482,491
050,29,021,"Missouri","Buchanan County",5,5,997,523,474
050,29,021,"Missouri","Buchanan County",5,6,1006,506,500
050,29,021,"Missouri","Buchanan County",5,7,1006,527,479
050,29,021,"Missouri","Buchanan County",5,8,1021,551,470
050,29,021,"Missouri","Buchanan County",5,9,1033,565,468
050,29,021,"Missouri","Buchanan County",5,10,999,527,472
050,29,021,"Missouri","Buchanan County",5,11,1016,538,478
050,29,021,"Missouri","Buchanan County",5,12,1026,546,480
050,29,021,"Missouri","Buchanan County",5,13,1014,522,492
050,29,021,"Missouri","Buchanan County",5,14,1000,509,491
050,29,021,"Missouri","Buchanan County",5,15,1081,556,525
050,29,021,"Missouri","Buchanan County",5,16,1149,588,561
050,29,021,"Missouri","Buchanan County",5,17,1137,599,538
050,29,021,"Missouri","Buchanan County",5,18,1106,566,540
050,29,021,"Missouri","Buchanan County",5,19,1112,557,555
050,29,021,"Missouri","Buchanan County",5,20,1085,582,503
050,29,021,"Missouri","Buchanan County",5,21,1099,575,524
050,29,021,"Missouri","Buchanan County",5,22,1114,574,540
050,29,021,"Missouri","Buchanan County",5,23,1111,601,510
050,29,021,"Missouri","Buchanan County",5,24,1095,593,502
050,29,021,"Missouri","Buchanan County",5,25,1073,577,496
050,29,021,"Missouri","Buchanan County",5,26,1044,547,497
050,29,021,"Missouri","Buchanan County",5,27,1051,568,483
050,29,021,"Missouri","Buchanan County",5,28,1049,556,493
050,29,021,"Missouri","Buchanan County",5,29,1078,551,527
050,29,021,"Missouri","Buchanan County",5,30,1091,549,542
050,29,021,"Missouri","Buchanan County",5,31,1106,575,531
050,29,021,"Missouri","Buchanan County",5,32,1111,591,520
050,29,021,"Missouri","Buchanan County",5,33,1127,586,541
050,29,021,"Missouri","Buchanan County",5,34,1068,550,518
050,29,021,"Missouri","Buchanan County",5,35,1079,559,520
050,29,021,"Missouri","Buchanan County",5,36,1057,557,500
050,29,021,"Missouri","Buchanan County",5,37,1081,566,515
050,29,021,"Missouri","Buchanan County",5,38,1118,591,527
050,29,021,"Missouri","Buchanan County",5,39,1086,594,492
050,29,021,"Missouri","Buchanan County",5,40,1101,592,509
050,29,021,"Missouri","Buchanan County",5,41,1086,587,499
050,29,021,"Missouri","Buchanan County",5,42,1077,577,500
050,29,021,"Missouri","Buchanan County",5,43,1087,562,525
050,29,021,"Missouri","Buchanan County",5,44,1018,530,488
050,29,021,"Missouri","Buchanan County",5,45,969,519,450
050,29,021,"Missouri","Buchanan County",5,46,976,508,468
050,29,021,"Missouri","Buchanan County",5,47,949,499,450
050,29,021,"Missouri","Buchanan County",5,48,974,528,446
050,29,021,"Missouri","Buchanan County",5,49,906,468,438
050,29,021,"Missouri","Buchanan County",5,50,920,488,432
050,29,021,"Missouri","Buchanan County",5,51,966,507,459
050,29,021,"Missouri","Buchanan County",5,52,1022,535,487
050,29,021,"Missouri","Buchanan County",5,53,1037,527,510
050,29,021,"Missouri","Buchanan County",5,54,956,471,485
050,29,021,"Missouri","Buchanan County",5,55,891,441,450
050,29,021,"Missouri","Buchanan County",5,56,934,461,473
050,29,021,"Missouri","Buchanan County",5,57,1017,507,510
050,29,021,"Missouri","Buchanan County",5,58,1080,540,540
050,29,021,"Missouri","Buchanan County",5,59,1092,544,548
050,29,021,"Missouri","Buchanan County",5,60,1103,539,564
050,29,021,"Missouri","Buchanan County",5,61,1156,559,597
050,29,021,"Missouri","Buchanan County",5,62,1132,543,589
050,29,021,"Missouri","Buchanan County",5,63,1108,558,550
050,29,021,"Missouri","Buchanan County",5,64,1049,542,507
050,29,021,"Missouri","Buchanan County",5,65,1038,523,515
050,29,021,"Missouri","Buchanan County",5,66,1028,485,543
050,29,021,"Missouri","Buchanan County",5,67,1008,478,530
050,29,021,"Missouri","Buchanan County",5,68,975,465,510
050,29,021,"Missouri","Buchanan County",5,69,926,438,488
050,29,021,"Missouri","Buchanan County",5,70,844,397,447
050,29,021,"Missouri","Buchanan County",5,71,809,368,441
050,29,021,"Missouri","Buchanan County",5,72,803,362,441
050,29,021,"Missouri","Buchanan County",5,73,760,350,410
050,29,021,"Missouri","Buchanan County",5,74,752,335,417
050,29,021,"Missouri","Buchanan County",5,75,673,298,375
050,29,021,"Missouri","Buchanan County",5,76,687,312,375
050,29,021,"Missouri","Buchanan County",5,77,440,197,243
050,29,021,"Missouri","Buchanan County",5,78,467,209,258
050,29,021,"Missouri","Buchanan County",5,79,460,202,258
050,29,021,"Missouri","Buchanan County",5,80,457,191,266
050,29,021,"Missouri","Buchanan County",5,81,374,156,218
050,29,021,"Missouri","Buchanan County",5,82,342,145,197
050,29,021,"Missouri","Buchanan County",5,83,298,108,190
050,29,021,"Missouri","Buchanan County",5,84,279,102,177
050,29,021,"Missouri","Buchanan County",5,85,1538,557,981
050,29,023,"Missouri","Butler County",1,0,500,254,246
050,29,023,"Missouri","Butler County",1,1,505,249,256
050,29,023,"Missouri","Butler County",1,2,540,251,289
050,29,023,"Missouri","Butler County",1,3,537,289,248
050,29,023,"Missouri","Butler County",1,4,521,293,228
050,29,023,"Missouri","Butler County",1,5,529,279,250
050,29,023,"Missouri","Butler County",1,6,537,280,257
050,29,023,"Missouri","Butler County",1,7,567,267,300
050,29,023,"Missouri","Butler County",1,8,579,284,295
050,29,023,"Missouri","Butler County",1,9,538,285,253
050,29,023,"Missouri","Butler County",1,10,545,283,262
050,29,023,"Missouri","Butler County",1,11,568,282,286
050,29,023,"Missouri","Butler County",1,12,558,283,275
050,29,023,"Missouri","Butler County",1,13,559,294,265
050,29,023,"Missouri","Butler County",1,14,569,281,288
050,29,023,"Missouri","Butler County",1,15,591,293,298
050,29,023,"Missouri","Butler County",1,16,578,310,268
050,29,023,"Missouri","Butler County",1,17,533,283,250
050,29,023,"Missouri","Butler County",1,18,527,273,254
050,29,023,"Missouri","Butler County",1,19,540,264,276
050,29,023,"Missouri","Butler County",1,20,467,239,228
050,29,023,"Missouri","Butler County",1,21,448,238,210
050,29,023,"Missouri","Butler County",1,22,453,234,219
050,29,023,"Missouri","Butler County",1,23,479,242,237
050,29,023,"Missouri","Butler County",1,24,518,252,266
050,29,023,"Missouri","Butler County",1,25,488,256,232
050,29,023,"Missouri","Butler County",1,26,484,239,245
050,29,023,"Missouri","Butler County",1,27,511,249,262
050,29,023,"Missouri","Butler County",1,28,576,285,291
050,29,023,"Missouri","Butler County",1,29,529,263,266
050,29,023,"Missouri","Butler County",1,30,505,256,249
050,29,023,"Missouri","Butler County",1,31,523,261,262
050,29,023,"Missouri","Butler County",1,32,494,242,252
050,29,023,"Missouri","Butler County",1,33,500,253,247
050,29,023,"Missouri","Butler County",1,34,509,244,265
050,29,023,"Missouri","Butler County",1,35,514,245,269
050,29,023,"Missouri","Butler County",1,36,521,264,257
050,29,023,"Missouri","Butler County",1,37,500,249,251
050,29,023,"Missouri","Butler County",1,38,499,235,264
050,29,023,"Missouri","Butler County",1,39,503,219,284
050,29,023,"Missouri","Butler County",1,40,526,238,288
050,29,023,"Missouri","Butler County",1,41,501,251,250
050,29,023,"Missouri","Butler County",1,42,506,259,247
050,29,023,"Missouri","Butler County",1,43,476,229,247
050,29,023,"Missouri","Butler County",1,44,440,225,215
050,29,023,"Missouri","Butler County",1,45,467,226,241
050,29,023,"Missouri","Butler County",1,46,470,230,240
050,29,023,"Missouri","Butler County",1,47,507,250,257
050,29,023,"Missouri","Butler County",1,48,535,266,269
050,29,023,"Missouri","Butler County",1,49,541,285,256
050,29,023,"Missouri","Butler County",1,50,501,241,260
050,29,023,"Missouri","Butler County",1,51,511,241,270
050,29,023,"Missouri","Butler County",1,52,527,255,272
050,29,023,"Missouri","Butler County",1,53,509,244,265
050,29,023,"Missouri","Butler County",1,54,507,244,263
050,29,023,"Missouri","Butler County",1,55,552,266,286
050,29,023,"Missouri","Butler County",1,56,605,285,320
050,29,023,"Missouri","Butler County",1,57,594,291,303
050,29,023,"Missouri","Butler County",1,58,596,288,308
050,29,023,"Missouri","Butler County",1,59,573,299,274
050,29,023,"Missouri","Butler County",1,60,559,276,283
050,29,023,"Missouri","Butler County",1,61,541,246,295
050,29,023,"Missouri","Butler County",1,62,570,269,301
050,29,023,"Missouri","Butler County",1,63,582,277,305
050,29,023,"Missouri","Butler County",1,64,582,284,298
050,29,023,"Missouri","Butler County",1,65,553,274,279
050,29,023,"Missouri","Butler County",1,66,538,237,301
050,29,023,"Missouri","Butler County",1,67,488,208,280
050,29,023,"Missouri","Butler County",1,68,452,207,245
050,29,023,"Missouri","Butler County",1,69,451,215,236
050,29,023,"Missouri","Butler County",1,70,471,214,257
050,29,023,"Missouri","Butler County",1,71,437,213,224
050,29,023,"Missouri","Butler County",1,72,454,219,235
050,29,023,"Missouri","Butler County",1,73,404,188,216
050,29,023,"Missouri","Butler County",1,74,296,130,166
050,29,023,"Missouri","Butler County",1,75,315,136,179
050,29,023,"Missouri","Butler County",1,76,333,155,178
050,29,023,"Missouri","Butler County",1,77,326,145,181
050,29,023,"Missouri","Butler County",1,78,273,124,149
050,29,023,"Missouri","Butler County",1,79,246,112,134
050,29,023,"Missouri","Butler County",1,80,209,86,123
050,29,023,"Missouri","Butler County",1,81,212,90,122
050,29,023,"Missouri","Butler County",1,82,192,84,108
050,29,023,"Missouri","Butler County",1,83,194,77,117
050,29,023,"Missouri","Butler County",1,84,182,69,113
050,29,023,"Missouri","Butler County",1,85,889,362,527
050,29,023,"Missouri","Butler County",2,0,504,260,244
050,29,023,"Missouri","Butler County",2,1,502,249,253
050,29,023,"Missouri","Butler County",2,2,535,254,281
050,29,023,"Missouri","Butler County",2,3,532,279,253
050,29,023,"Missouri","Butler County",2,4,525,293,232
050,29,023,"Missouri","Butler County",2,5,520,278,242
050,29,023,"Missouri","Butler County",2,6,535,278,257
050,29,023,"Missouri","Butler County",2,7,560,269,291
050,29,023,"Missouri","Butler County",2,8,569,276,293
050,29,023,"Missouri","Butler County",2,9,545,282,263
050,29,023,"Missouri","Butler County",2,10,540,283,257
050,29,023,"Missouri","Butler County",2,11,558,281,277
050,29,023,"Missouri","Butler County",2,12,558,284,274
050,29,023,"Missouri","Butler County",2,13,557,291,266
050,29,023,"Missouri","Butler County",2,14,567,282,285
050,29,023,"Missouri","Butler County",2,15,583,290,293
050,29,023,"Missouri","Butler County",2,16,587,310,277
050,29,023,"Missouri","Butler County",2,17,540,287,253
050,29,023,"Missouri","Butler County",2,18,523,269,254
050,29,023,"Missouri","Butler County",2,19,538,265,273
050,29,023,"Missouri","Butler County",2,20,476,246,230
050,29,023,"Missouri","Butler County",2,21,446,234,212
050,29,023,"Missouri","Butler County",2,22,453,237,216
050,29,023,"Missouri","Butler County",2,23,476,240,236
050,29,023,"Missouri","Butler County",2,24,503,251,252
050,29,023,"Missouri","Butler County",2,25,496,254,242
050,29,023,"Missouri","Butler County",2,26,486,243,243
050,29,023,"Missouri","Butler County",2,27,510,250,260
050,29,023,"Missouri","Butler County",2,28,560,278,282
050,29,023,"Missouri","Butler County",2,29,533,266,267
050,29,023,"Missouri","Butler County",2,30,513,258,255
050,29,023,"Missouri","Butler County",2,31,514,259,255
050,29,023,"Missouri","Butler County",2,32,498,244,254
050,29,023,"Missouri","Butler County",2,33,498,247,251
050,29,023,"Missouri","Butler County",2,34,510,248,262
050,29,023,"Missouri","Butler County",2,35,515,246,269
050,29,023,"Missouri","Butler County",2,36,513,256,257
050,29,023,"Missouri","Butler County",2,37,505,252,253
050,29,023,"Missouri","Butler County",2,38,497,235,262
050,29,023,"Missouri","Butler County",2,39,502,224,278
050,29,023,"Missouri","Butler County",2,40,526,237,289
050,29,023,"Missouri","Butler County",2,41,506,248,258
050,29,023,"Missouri","Butler County",2,42,498,254,244
050,29,023,"Missouri","Butler County",2,43,481,236,245
050,29,023,"Missouri","Butler County",2,44,446,226,220
050,29,023,"Missouri","Butler County",2,45,461,226,235
050,29,023,"Missouri","Butler County",2,46,466,225,241
050,29,023,"Missouri","Butler County",2,47,497,245,252
050,29,023,"Missouri","Butler County",2,48,525,260,265
050,29,023,"Missouri","Butler County",2,49,541,283,258
050,29,023,"Missouri","Butler County",2,50,508,247,261
050,29,023,"Missouri","Butler County",2,51,510,241,269
050,29,023,"Missouri","Butler County",2,52,521,252,269
050,29,023,"Missouri","Butler County",2,53,512,244,268
050,29,023,"Missouri","Butler County",2,54,504,243,261
050,29,023,"Missouri","Butler County",2,55,537,260,277
050,29,023,"Missouri","Butler County",2,56,592,280,312
050,29,023,"Missouri","Butler County",2,57,598,290,308
050,29,023,"Missouri","Butler County",2,58,592,286,306
050,29,023,"Missouri","Butler County",2,59,580,297,283
050,29,023,"Missouri","Butler County",2,60,560,281,279
050,29,023,"Missouri","Butler County",2,61,543,251,292
050,29,023,"Missouri","Butler County",2,62,561,263,298
050,29,023,"Missouri","Butler County",2,63,582,277,305
050,29,023,"Missouri","Butler County",2,64,578,281,297
050,29,023,"Missouri","Butler County",2,65,557,275,282
050,29,023,"Missouri","Butler County",2,66,544,247,297
050,29,023,"Missouri","Butler County",2,67,499,213,286
050,29,023,"Missouri","Butler County",2,68,455,205,250
050,29,023,"Missouri","Butler County",2,69,450,213,237
050,29,023,"Missouri","Butler County",2,70,462,213,249
050,29,023,"Missouri","Butler County",2,71,443,212,231
050,29,023,"Missouri","Butler County",2,72,441,214,227
050,29,023,"Missouri","Butler County",2,73,437,206,231
050,29,023,"Missouri","Butler County",2,74,303,134,169
050,29,023,"Missouri","Butler County",2,75,306,133,173
050,29,023,"Missouri","Butler County",2,76,322,147,175
050,29,023,"Missouri","Butler County",2,77,336,150,186
050,29,023,"Missouri","Butler County",2,78,279,125,154
050,29,023,"Missouri","Butler County",2,79,249,113,136
050,29,023,"Missouri","Butler County",2,80,217,90,127
050,29,023,"Missouri","Butler County",2,81,207,87,120
050,29,023,"Missouri","Butler County",2,82,191,83,108
050,29,023,"Missouri","Butler County",2,83,191,77,114
050,29,023,"Missouri","Butler County",2,84,178,70,108
050,29,023,"Missouri","Butler County",2,85,896,361,535
050,29,023,"Missouri","Butler County",3,0,555,274,281
050,29,023,"Missouri","Butler County",3,1,527,298,229
050,29,023,"Missouri","Butler County",3,2,515,266,249
050,29,023,"Missouri","Butler County",3,3,530,255,275
050,29,023,"Missouri","Butler County",3,4,530,274,256
050,29,023,"Missouri","Butler County",3,5,549,308,241
050,29,023,"Missouri","Butler County",3,6,512,270,242
050,29,023,"Missouri","Butler County",3,7,555,294,261
050,29,023,"Missouri","Butler County",3,8,560,265,295
050,29,023,"Missouri","Butler County",3,9,567,286,281
050,29,023,"Missouri","Butler County",3,10,562,291,271
050,29,023,"Missouri","Butler County",3,11,561,296,265
050,29,023,"Missouri","Butler County",3,12,542,266,276
050,29,023,"Missouri","Butler County",3,13,555,275,280
050,29,023,"Missouri","Butler County",3,14,572,303,269
050,29,023,"Missouri","Butler County",3,15,583,288,295
050,29,023,"Missouri","Butler County",3,16,602,310,292
050,29,023,"Missouri","Butler County",3,17,577,301,276
050,29,023,"Missouri","Butler County",3,18,520,264,256
050,29,023,"Missouri","Butler County",3,19,526,256,270
050,29,023,"Missouri","Butler County",3,20,487,261,226
050,29,023,"Missouri","Butler County",3,21,465,232,233
050,29,023,"Missouri","Butler County",3,22,450,238,212
050,29,023,"Missouri","Butler County",3,23,502,262,240
050,29,023,"Missouri","Butler County",3,24,489,250,239
050,29,023,"Missouri","Butler County",3,25,536,266,270
050,29,023,"Missouri","Butler County",3,26,510,262,248
050,29,023,"Missouri","Butler County",3,27,497,246,251
050,29,023,"Missouri","Butler County",3,28,488,234,254
050,29,023,"Missouri","Butler County",3,29,549,267,282
050,29,023,"Missouri","Butler County",3,30,539,270,269
050,29,023,"Missouri","Butler County",3,31,496,244,252
050,29,023,"Missouri","Butler County",3,32,515,263,252
050,29,023,"Missouri","Butler County",3,33,484,232,252
050,29,023,"Missouri","Butler County",3,34,502,241,261
050,29,023,"Missouri","Butler County",3,35,509,254,255
050,29,023,"Missouri","Butler County",3,36,520,246,274
050,29,023,"Missouri","Butler County",3,37,513,252,261
050,29,023,"Missouri","Butler County",3,38,495,248,247
050,29,023,"Missouri","Butler County",3,39,523,250,273
050,29,023,"Missouri","Butler County",3,40,505,226,279
050,29,023,"Missouri","Butler County",3,41,521,228,293
050,29,023,"Missouri","Butler County",3,42,508,246,262
050,29,023,"Missouri","Butler County",3,43,492,258,234
050,29,023,"Missouri","Butler County",3,44,493,242,251
050,29,023,"Missouri","Butler County",3,45,452,213,239
050,29,023,"Missouri","Butler County",3,46,473,230,243
050,29,023,"Missouri","Butler County",3,47,474,234,240
050,29,023,"Missouri","Butler County",3,48,485,239,246
050,29,023,"Missouri","Butler County",3,49,538,264,274
050,29,023,"Missouri","Butler County",3,50,523,269,254
050,29,023,"Missouri","Butler County",3,51,515,247,268
050,29,023,"Missouri","Butler County",3,52,489,224,265
050,29,023,"Missouri","Butler County",3,53,510,249,261
050,29,023,"Missouri","Butler County",3,54,488,222,266
050,29,023,"Missouri","Butler County",3,55,507,248,259
050,29,023,"Missouri","Butler County",3,56,539,254,285
050,29,023,"Missouri","Butler County",3,57,582,277,305
050,29,023,"Missouri","Butler County",3,58,596,289,307
050,29,023,"Missouri","Butler County",3,59,590,289,301
050,29,023,"Missouri","Butler County",3,60,574,297,277
050,29,023,"Missouri","Butler County",3,61,548,273,275
050,29,023,"Missouri","Butler County",3,62,526,245,281
050,29,023,"Missouri","Butler County",3,63,532,250,282
050,29,023,"Missouri","Butler County",3,64,582,279,303
050,29,023,"Missouri","Butler County",3,65,579,281,298
050,29,023,"Missouri","Butler County",3,66,542,264,278
050,29,023,"Missouri","Butler County",3,67,529,245,284
050,29,023,"Missouri","Butler County",3,68,481,200,281
050,29,023,"Missouri","Butler County",3,69,439,196,243
050,29,023,"Missouri","Butler County",3,70,440,208,232
050,29,023,"Missouri","Butler County",3,71,451,208,243
050,29,023,"Missouri","Butler County",3,72,423,194,229
050,29,023,"Missouri","Butler County",3,73,430,207,223
050,29,023,"Missouri","Butler County",3,74,419,195,224
050,29,023,"Missouri","Butler County",3,75,284,125,159
050,29,023,"Missouri","Butler County",3,76,300,134,166
050,29,023,"Missouri","Butler County",3,77,301,138,163
050,29,023,"Missouri","Butler County",3,78,315,139,176
050,29,023,"Missouri","Butler County",3,79,255,113,142
050,29,023,"Missouri","Butler County",3,80,238,99,139
050,29,023,"Missouri","Butler County",3,81,201,84,117
050,29,023,"Missouri","Butler County",3,82,191,80,111
050,29,023,"Missouri","Butler County",3,83,179,78,101
050,29,023,"Missouri","Butler County",3,84,172,70,102
050,29,023,"Missouri","Butler County",3,85,890,347,543
050,29,023,"Missouri","Butler County",4,0,506,256,250
050,29,023,"Missouri","Butler County",4,1,551,259,292
050,29,023,"Missouri","Butler County",4,2,528,304,224
050,29,023,"Missouri","Butler County",4,3,529,266,263
050,29,023,"Missouri","Butler County",4,4,523,245,278
050,29,023,"Missouri","Butler County",4,5,530,265,265
050,29,023,"Missouri","Butler County",4,6,554,310,244
050,29,023,"Missouri","Butler County",4,7,511,275,236
050,29,023,"Missouri","Butler County",4,8,560,298,262
050,29,023,"Missouri","Butler County",4,9,576,277,299
050,29,023,"Missouri","Butler County",4,10,576,294,282
050,29,023,"Missouri","Butler County",4,11,572,290,282
050,29,023,"Missouri","Butler County",4,12,551,282,269
050,29,023,"Missouri","Butler County",4,13,551,274,277
050,29,023,"Missouri","Butler County",4,14,553,274,279
050,29,023,"Missouri","Butler County",4,15,584,307,277
050,29,023,"Missouri","Butler County",4,16,590,301,289
050,29,023,"Missouri","Butler County",4,17,583,295,288
050,29,023,"Missouri","Butler County",4,18,553,280,273
050,29,023,"Missouri","Butler County",4,19,496,243,253
050,29,023,"Missouri","Butler County",4,20,468,248,220
050,29,023,"Missouri","Butler County",4,21,476,243,233
050,29,023,"Missouri","Butler County",4,22,503,249,254
050,29,023,"Missouri","Butler County",4,23,484,240,244
050,29,023,"Missouri","Butler County",4,24,504,274,230
050,29,023,"Missouri","Butler County",4,25,482,243,239
050,29,023,"Missouri","Butler County",4,26,515,251,264
050,29,023,"Missouri","Butler County",4,27,509,260,249
050,29,023,"Missouri","Butler County",4,28,500,246,254
050,29,023,"Missouri","Butler County",4,29,470,225,245
050,29,023,"Missouri","Butler County",4,30,562,271,291
050,29,023,"Missouri","Butler County",4,31,534,271,263
050,29,023,"Missouri","Butler County",4,32,487,226,261
050,29,023,"Missouri","Butler County",4,33,527,276,251
050,29,023,"Missouri","Butler County",4,34,498,243,255
050,29,023,"Missouri","Butler County",4,35,500,249,251
050,29,023,"Missouri","Butler County",4,36,516,259,257
050,29,023,"Missouri","Butler County",4,37,513,242,271
050,29,023,"Missouri","Butler County",4,38,520,254,266
050,29,023,"Missouri","Butler County",4,39,505,260,245
050,29,023,"Missouri","Butler County",4,40,515,246,269
050,29,023,"Missouri","Butler County",4,41,525,241,284
050,29,023,"Missouri","Butler County",4,42,524,230,294
050,29,023,"Missouri","Butler County",4,43,499,240,259
050,29,023,"Missouri","Butler County",4,44,488,253,235
050,29,023,"Missouri","Butler County",4,45,487,228,259
050,29,023,"Missouri","Butler County",4,46,470,224,246
050,29,023,"Missouri","Butler County",4,47,483,241,242
050,29,023,"Missouri","Butler County",4,48,473,237,236
050,29,023,"Missouri","Butler County",4,49,497,250,247
050,29,023,"Missouri","Butler County",4,50,533,254,279
050,29,023,"Missouri","Butler County",4,51,536,270,266
050,29,023,"Missouri","Butler County",4,52,507,254,253
050,29,023,"Missouri","Butler County",4,53,472,224,248
050,29,023,"Missouri","Butler County",4,54,500,241,259
050,29,023,"Missouri","Butler County",4,55,476,220,256
050,29,023,"Missouri","Butler County",4,56,499,239,260
050,29,023,"Missouri","Butler County",4,57,540,258,282
050,29,023,"Missouri","Butler County",4,58,583,271,312
050,29,023,"Missouri","Butler County",4,59,578,279,299
050,29,023,"Missouri","Butler County",4,60,582,285,297
050,29,023,"Missouri","Butler County",4,61,581,298,283
050,29,023,"Missouri","Butler County",4,62,549,273,276
050,29,023,"Missouri","Butler County",4,63,508,239,269
050,29,023,"Missouri","Butler County",4,64,517,245,272
050,29,023,"Missouri","Butler County",4,65,584,276,308
050,29,023,"Missouri","Butler County",4,66,562,260,302
050,29,023,"Missouri","Butler County",4,67,548,268,280
050,29,023,"Missouri","Butler County",4,68,522,238,284
050,29,023,"Missouri","Butler County",4,69,465,190,275
050,29,023,"Missouri","Butler County",4,70,429,189,240
050,29,023,"Missouri","Butler County",4,71,413,193,220
050,29,023,"Missouri","Butler County",4,72,439,197,242
050,29,023,"Missouri","Butler County",4,73,417,189,228
050,29,023,"Missouri","Butler County",4,74,424,199,225
050,29,023,"Missouri","Butler County",4,75,393,185,208
050,29,023,"Missouri","Butler County",4,76,276,120,156
050,29,023,"Missouri","Butler County",4,77,283,125,158
050,29,023,"Missouri","Butler County",4,78,280,125,155
050,29,023,"Missouri","Butler County",4,79,290,126,164
050,29,023,"Missouri","Butler County",4,80,249,108,141
050,29,023,"Missouri","Butler County",4,81,216,89,127
050,29,023,"Missouri","Butler County",4,82,180,74,106
050,29,023,"Missouri","Butler County",4,83,180,79,101
050,29,023,"Missouri","Butler County",4,84,159,68,91
050,29,023,"Missouri","Butler County",4,85,885,342,543
050,29,023,"Missouri","Butler County",5,0,509,256,253
050,29,023,"Missouri","Butler County",5,1,498,258,240
050,29,023,"Missouri","Butler County",5,2,561,265,296
050,29,023,"Missouri","Butler County",5,3,537,305,232
050,29,023,"Missouri","Butler County",5,4,535,272,263
050,29,023,"Missouri","Butler County",5,5,510,229,281
050,29,023,"Missouri","Butler County",5,6,519,267,252
050,29,023,"Missouri","Butler County",5,7,541,296,245
050,29,023,"Missouri","Butler County",5,8,511,282,229
050,29,023,"Missouri","Butler County",5,9,541,291,250
050,29,023,"Missouri","Butler County",5,10,573,275,298
050,29,023,"Missouri","Butler County",5,11,567,279,288
050,29,023,"Missouri","Butler County",5,12,577,293,284
050,29,023,"Missouri","Butler County",5,13,563,293,270
050,29,023,"Missouri","Butler County",5,14,556,275,281
050,29,023,"Missouri","Butler County",5,15,556,277,279
050,29,023,"Missouri","Butler County",5,16,605,332,273
050,29,023,"Missouri","Butler County",5,17,580,299,281
050,29,023,"Missouri","Butler County",5,18,550,272,278
050,29,023,"Missouri","Butler County",5,19,530,265,265
050,29,023,"Missouri","Butler County",5,20,446,230,216
050,29,023,"Missouri","Butler County",5,21,439,219,220
050,29,023,"Missouri","Butler County",5,22,488,249,239
050,29,023,"Missouri","Butler County",5,23,532,253,279
050,29,023,"Missouri","Butler County",5,24,501,268,233
050,29,023,"Missouri","Butler County",5,25,496,260,236
050,29,023,"Missouri","Butler County",5,26,481,247,234
050,29,023,"Missouri","Butler County",5,27,515,252,263
050,29,023,"Missouri","Butler County",5,28,495,251,244
050,29,023,"Missouri","Butler County",5,29,501,250,251
050,29,023,"Missouri","Butler County",5,30,467,211,256
050,29,023,"Missouri","Butler County",5,31,554,272,282
050,29,023,"Missouri","Butler County",5,32,536,268,268
050,29,023,"Missouri","Butler County",5,33,492,232,260
050,29,023,"Missouri","Butler County",5,34,520,264,256
050,29,023,"Missouri","Butler County",5,35,499,242,257
050,29,023,"Missouri","Butler County",5,36,485,240,245
050,29,023,"Missouri","Butler County",5,37,519,256,263
050,29,023,"Missouri","Butler County",5,38,517,247,270
050,29,023,"Missouri","Butler County",5,39,527,251,276
050,29,023,"Missouri","Butler County",5,40,502,260,242
050,29,023,"Missouri","Butler County",5,41,513,250,263
050,29,023,"Missouri","Butler County",5,42,518,236,282
050,29,023,"Missouri","Butler County",5,43,514,226,288
050,29,023,"Missouri","Butler County",5,44,506,232,274
050,29,023,"Missouri","Butler County",5,45,471,240,231
050,29,023,"Missouri","Butler County",5,46,503,237,266
050,29,023,"Missouri","Butler County",5,47,464,230,234
050,29,023,"Missouri","Butler County",5,48,463,228,235
050,29,023,"Missouri","Butler County",5,49,475,230,245
050,29,023,"Missouri","Butler County",5,50,484,240,244
050,29,023,"Missouri","Butler County",5,51,526,252,274
050,29,023,"Missouri","Butler County",5,52,534,269,265
050,29,023,"Missouri","Butler County",5,53,501,247,254
050,29,023,"Missouri","Butler County",5,54,466,217,249
050,29,023,"Missouri","Butler County",5,55,489,238,251
050,29,023,"Missouri","Butler County",5,56,464,209,255
050,29,023,"Missouri","Butler County",5,57,506,250,256
050,29,023,"Missouri","Butler County",5,58,544,254,290
050,29,023,"Missouri","Butler County",5,59,559,256,303
050,29,023,"Missouri","Butler County",5,60,574,284,290
050,29,023,"Missouri","Butler County",5,61,581,281,300
050,29,023,"Missouri","Butler County",5,62,566,289,277
050,29,023,"Missouri","Butler County",5,63,517,258,259
050,29,023,"Missouri","Butler County",5,64,505,236,269
050,29,023,"Missouri","Butler County",5,65,504,238,266
050,29,023,"Missouri","Butler County",5,66,567,271,296
050,29,023,"Missouri","Butler County",5,67,551,250,301
050,29,023,"Missouri","Butler County",5,68,545,264,281
050,29,023,"Missouri","Butler County",5,69,506,230,276
050,29,023,"Missouri","Butler County",5,70,459,187,272
050,29,023,"Missouri","Butler County",5,71,409,183,226
050,29,023,"Missouri","Butler County",5,72,402,182,220
050,29,023,"Missouri","Butler County",5,73,425,191,234
050,29,023,"Missouri","Butler County",5,74,405,179,226
050,29,023,"Missouri","Butler County",5,75,402,196,206
050,29,023,"Missouri","Butler County",5,76,391,181,210
050,29,023,"Missouri","Butler County",5,77,254,109,145
050,29,023,"Missouri","Butler County",5,78,263,117,146
050,29,023,"Missouri","Butler County",5,79,266,119,147
050,29,023,"Missouri","Butler County",5,80,282,120,162
050,29,023,"Missouri","Butler County",5,81,233,101,132
050,29,023,"Missouri","Butler County",5,82,195,80,115
050,29,023,"Missouri","Butler County",5,83,168,71,97
050,29,023,"Missouri","Butler County",5,84,158,65,93
050,29,023,"Missouri","Butler County",5,85,889,342,547
050,29,025,"Missouri","Caldwell County",1,0,95,51,44
050,29,025,"Missouri","Caldwell County",1,1,105,58,47
050,29,025,"Missouri","Caldwell County",1,2,92,47,45
050,29,025,"Missouri","Caldwell County",1,3,100,53,47
050,29,025,"Missouri","Caldwell County",1,4,113,56,57
050,29,025,"Missouri","Caldwell County",1,5,106,53,53
050,29,025,"Missouri","Caldwell County",1,6,102,52,50
050,29,025,"Missouri","Caldwell County",1,7,106,58,48
050,29,025,"Missouri","Caldwell County",1,8,112,56,56
050,29,025,"Missouri","Caldwell County",1,9,106,64,42
050,29,025,"Missouri","Caldwell County",1,10,127,73,54
050,29,025,"Missouri","Caldwell County",1,11,123,65,58
050,29,025,"Missouri","Caldwell County",1,12,133,78,55
050,29,025,"Missouri","Caldwell County",1,13,138,73,65
050,29,025,"Missouri","Caldwell County",1,14,141,74,67
050,29,025,"Missouri","Caldwell County",1,15,132,64,68
050,29,025,"Missouri","Caldwell County",1,16,122,69,53
050,29,025,"Missouri","Caldwell County",1,17,124,69,55
050,29,025,"Missouri","Caldwell County",1,18,113,66,47
050,29,025,"Missouri","Caldwell County",1,19,92,57,35
050,29,025,"Missouri","Caldwell County",1,20,100,61,39
050,29,025,"Missouri","Caldwell County",1,21,90,46,44
050,29,025,"Missouri","Caldwell County",1,22,96,52,44
050,29,025,"Missouri","Caldwell County",1,23,108,53,55
050,29,025,"Missouri","Caldwell County",1,24,93,50,43
050,29,025,"Missouri","Caldwell County",1,25,95,57,38
050,29,025,"Missouri","Caldwell County",1,26,103,55,48
050,29,025,"Missouri","Caldwell County",1,27,103,56,47
050,29,025,"Missouri","Caldwell County",1,28,95,46,49
050,29,025,"Missouri","Caldwell County",1,29,98,54,44
050,29,025,"Missouri","Caldwell County",1,30,91,45,46
050,29,025,"Missouri","Caldwell County",1,31,87,50,37
050,29,025,"Missouri","Caldwell County",1,32,71,35,36
050,29,025,"Missouri","Caldwell County",1,33,77,45,32
050,29,025,"Missouri","Caldwell County",1,34,83,44,39
050,29,025,"Missouri","Caldwell County",1,35,108,46,62
050,29,025,"Missouri","Caldwell County",1,36,109,46,63
050,29,025,"Missouri","Caldwell County",1,37,88,39,49
050,29,025,"Missouri","Caldwell County",1,38,95,45,50
050,29,025,"Missouri","Caldwell County",1,39,120,59,61
050,29,025,"Missouri","Caldwell County",1,40,100,55,45
050,29,025,"Missouri","Caldwell County",1,41,97,51,46
050,29,025,"Missouri","Caldwell County",1,42,102,54,48
050,29,025,"Missouri","Caldwell County",1,43,102,54,48
050,29,025,"Missouri","Caldwell County",1,44,94,51,43
050,29,025,"Missouri","Caldwell County",1,45,97,43,54
050,29,025,"Missouri","Caldwell County",1,46,95,42,53
050,29,025,"Missouri","Caldwell County",1,47,101,46,55
050,29,025,"Missouri","Caldwell County",1,48,102,60,42
050,29,025,"Missouri","Caldwell County",1,49,110,65,45
050,29,025,"Missouri","Caldwell County",1,50,127,64,63
050,29,025,"Missouri","Caldwell County",1,51,113,59,54
050,29,025,"Missouri","Caldwell County",1,52,111,49,62
050,29,025,"Missouri","Caldwell County",1,53,118,63,55
050,29,025,"Missouri","Caldwell County",1,54,114,58,56
050,29,025,"Missouri","Caldwell County",1,55,115,67,48
050,29,025,"Missouri","Caldwell County",1,56,126,62,64
050,29,025,"Missouri","Caldwell County",1,57,144,77,67
050,29,025,"Missouri","Caldwell County",1,58,140,75,65
050,29,025,"Missouri","Caldwell County",1,59,126,62,64
050,29,025,"Missouri","Caldwell County",1,60,135,69,66
050,29,025,"Missouri","Caldwell County",1,61,122,64,58
050,29,025,"Missouri","Caldwell County",1,62,122,66,56
050,29,025,"Missouri","Caldwell County",1,63,122,57,65
050,29,025,"Missouri","Caldwell County",1,64,140,69,71
050,29,025,"Missouri","Caldwell County",1,65,114,54,60
050,29,025,"Missouri","Caldwell County",1,66,106,47,59
050,29,025,"Missouri","Caldwell County",1,67,112,52,60
050,29,025,"Missouri","Caldwell County",1,68,102,45,57
050,29,025,"Missouri","Caldwell County",1,69,107,61,46
050,29,025,"Missouri","Caldwell County",1,70,111,59,52
050,29,025,"Missouri","Caldwell County",1,71,92,47,45
050,29,025,"Missouri","Caldwell County",1,72,81,44,37
050,29,025,"Missouri","Caldwell County",1,73,90,43,47
050,29,025,"Missouri","Caldwell County",1,74,65,32,33
050,29,025,"Missouri","Caldwell County",1,75,71,40,31
050,29,025,"Missouri","Caldwell County",1,76,76,40,36
050,29,025,"Missouri","Caldwell County",1,77,70,32,38
050,29,025,"Missouri","Caldwell County",1,78,53,25,28
050,29,025,"Missouri","Caldwell County",1,79,58,29,29
050,29,025,"Missouri","Caldwell County",1,80,53,19,34
050,29,025,"Missouri","Caldwell County",1,81,49,22,27
050,29,025,"Missouri","Caldwell County",1,82,45,22,23
050,29,025,"Missouri","Caldwell County",1,83,37,16,21
050,29,025,"Missouri","Caldwell County",1,84,38,14,24
050,29,025,"Missouri","Caldwell County",1,85,215,70,145
050,29,025,"Missouri","Caldwell County",2,0,99,55,44
050,29,025,"Missouri","Caldwell County",2,1,103,56,47
050,29,025,"Missouri","Caldwell County",2,2,95,50,45
050,29,025,"Missouri","Caldwell County",2,3,99,53,46
050,29,025,"Missouri","Caldwell County",2,4,111,56,55
050,29,025,"Missouri","Caldwell County",2,5,110,55,55
050,29,025,"Missouri","Caldwell County",2,6,105,54,51
050,29,025,"Missouri","Caldwell County",2,7,104,55,49
050,29,025,"Missouri","Caldwell County",2,8,111,57,54
050,29,025,"Missouri","Caldwell County",2,9,106,61,45
050,29,025,"Missouri","Caldwell County",2,10,121,70,51
050,29,025,"Missouri","Caldwell County",2,11,123,67,56
050,29,025,"Missouri","Caldwell County",2,12,131,76,55
050,29,025,"Missouri","Caldwell County",2,13,136,74,62
050,29,025,"Missouri","Caldwell County",2,14,140,73,67
050,29,025,"Missouri","Caldwell County",2,15,137,68,69
050,29,025,"Missouri","Caldwell County",2,16,125,68,57
050,29,025,"Missouri","Caldwell County",2,17,124,70,54
050,29,025,"Missouri","Caldwell County",2,18,110,65,45
050,29,025,"Missouri","Caldwell County",2,19,92,57,35
050,29,025,"Missouri","Caldwell County",2,20,98,59,39
050,29,025,"Missouri","Caldwell County",2,21,92,50,42
050,29,025,"Missouri","Caldwell County",2,22,96,51,45
050,29,025,"Missouri","Caldwell County",2,23,105,53,52
050,29,025,"Missouri","Caldwell County",2,24,96,51,45
050,29,025,"Missouri","Caldwell County",2,25,97,57,40
050,29,025,"Missouri","Caldwell County",2,26,100,53,47
050,29,025,"Missouri","Caldwell County",2,27,107,58,49
050,29,025,"Missouri","Caldwell County",2,28,97,48,49
050,29,025,"Missouri","Caldwell County",2,29,97,52,45
050,29,025,"Missouri","Caldwell County",2,30,91,46,45
050,29,025,"Missouri","Caldwell County",2,31,89,50,39
050,29,025,"Missouri","Caldwell County",2,32,77,40,37
050,29,025,"Missouri","Caldwell County",2,33,74,42,32
050,29,025,"Missouri","Caldwell County",2,34,82,44,38
050,29,025,"Missouri","Caldwell County",2,35,103,46,57
050,29,025,"Missouri","Caldwell County",2,36,107,45,62
050,29,025,"Missouri","Caldwell County",2,37,93,41,52
050,29,025,"Missouri","Caldwell County",2,38,93,43,50
050,29,025,"Missouri","Caldwell County",2,39,113,55,58
050,29,025,"Missouri","Caldwell County",2,40,104,55,49
050,29,025,"Missouri","Caldwell County",2,41,97,51,46
050,29,025,"Missouri","Caldwell County",2,42,102,54,48
050,29,025,"Missouri","Caldwell County",2,43,103,54,49
050,29,025,"Missouri","Caldwell County",2,44,95,51,44
050,29,025,"Missouri","Caldwell County",2,45,100,48,52
050,29,025,"Missouri","Caldwell County",2,46,95,42,53
050,29,025,"Missouri","Caldwell County",2,47,99,45,54
050,29,025,"Missouri","Caldwell County",2,48,102,58,44
050,29,025,"Missouri","Caldwell County",2,49,108,63,45
050,29,025,"Missouri","Caldwell County",2,50,125,65,60
050,29,025,"Missouri","Caldwell County",2,51,114,59,55
050,29,025,"Missouri","Caldwell County",2,52,110,52,58
050,29,025,"Missouri","Caldwell County",2,53,117,60,57
050,29,025,"Missouri","Caldwell County",2,54,114,59,55
050,29,025,"Missouri","Caldwell County",2,55,112,64,48
050,29,025,"Missouri","Caldwell County",2,56,125,64,61
050,29,025,"Missouri","Caldwell County",2,57,141,74,67
050,29,025,"Missouri","Caldwell County",2,58,141,76,65
050,29,025,"Missouri","Caldwell County",2,59,130,66,64
050,29,025,"Missouri","Caldwell County",2,60,133,68,65
050,29,025,"Missouri","Caldwell County",2,61,125,65,60
050,29,025,"Missouri","Caldwell County",2,62,121,65,56
050,29,025,"Missouri","Caldwell County",2,63,126,61,65
050,29,025,"Missouri","Caldwell County",2,64,135,66,69
050,29,025,"Missouri","Caldwell County",2,65,119,57,62
050,29,025,"Missouri","Caldwell County",2,66,109,49,60
050,29,025,"Missouri","Caldwell County",2,67,109,49,60
050,29,025,"Missouri","Caldwell County",2,68,103,47,56
050,29,025,"Missouri","Caldwell County",2,69,105,57,48
050,29,025,"Missouri","Caldwell County",2,70,110,60,50
050,29,025,"Missouri","Caldwell County",2,71,97,50,47
050,29,025,"Missouri","Caldwell County",2,72,82,44,38
050,29,025,"Missouri","Caldwell County",2,73,91,45,46
050,29,025,"Missouri","Caldwell County",2,74,66,32,34
050,29,025,"Missouri","Caldwell County",2,75,68,37,31
050,29,025,"Missouri","Caldwell County",2,76,71,39,32
050,29,025,"Missouri","Caldwell County",2,77,74,35,39
050,29,025,"Missouri","Caldwell County",2,78,57,27,30
050,29,025,"Missouri","Caldwell County",2,79,56,27,29
050,29,025,"Missouri","Caldwell County",2,80,53,21,32
050,29,025,"Missouri","Caldwell County",2,81,48,20,28
050,29,025,"Missouri","Caldwell County",2,82,48,23,25
050,29,025,"Missouri","Caldwell County",2,83,37,16,21
050,29,025,"Missouri","Caldwell County",2,84,38,14,24
050,29,025,"Missouri","Caldwell County",2,85,218,71,147
050,29,025,"Missouri","Caldwell County",3,0,96,56,40
050,29,025,"Missouri","Caldwell County",3,1,102,57,45
050,29,025,"Missouri","Caldwell County",3,2,102,56,46
050,29,025,"Missouri","Caldwell County",3,3,98,51,47
050,29,025,"Missouri","Caldwell County",3,4,95,47,48
050,29,025,"Missouri","Caldwell County",3,5,117,56,61
050,29,025,"Missouri","Caldwell County",3,6,116,57,59
050,29,025,"Missouri","Caldwell County",3,7,108,56,52
050,29,025,"Missouri","Caldwell County",3,8,107,59,48
050,29,025,"Missouri","Caldwell County",3,9,112,59,53
050,29,025,"Missouri","Caldwell County",3,10,116,65,51
050,29,025,"Missouri","Caldwell County",3,11,128,74,54
050,29,025,"Missouri","Caldwell County",3,12,127,64,63
050,29,025,"Missouri","Caldwell County",3,13,132,77,55
050,29,025,"Missouri","Caldwell County",3,14,135,73,62
050,29,025,"Missouri","Caldwell County",3,15,144,73,71
050,29,025,"Missouri","Caldwell County",3,16,135,62,73
050,29,025,"Missouri","Caldwell County",3,17,129,70,59
050,29,025,"Missouri","Caldwell County",3,18,105,61,44
050,29,025,"Missouri","Caldwell County",3,19,90,51,39
050,29,025,"Missouri","Caldwell County",3,20,95,59,36
050,29,025,"Missouri","Caldwell County",3,21,99,57,42
050,29,025,"Missouri","Caldwell County",3,22,97,55,42
050,29,025,"Missouri","Caldwell County",3,23,93,51,42
050,29,025,"Missouri","Caldwell County",3,24,109,54,55
050,29,025,"Missouri","Caldwell County",3,25,93,55,38
050,29,025,"Missouri","Caldwell County",3,26,92,54,38
050,29,025,"Missouri","Caldwell County",3,27,110,57,53
050,29,025,"Missouri","Caldwell County",3,28,111,65,46
050,29,025,"Missouri","Caldwell County",3,29,102,56,46
050,29,025,"Missouri","Caldwell County",3,30,103,53,50
050,29,025,"Missouri","Caldwell County",3,31,98,48,50
050,29,025,"Missouri","Caldwell County",3,32,82,46,36
050,29,025,"Missouri","Caldwell County",3,33,81,43,38
050,29,025,"Missouri","Caldwell County",3,34,74,43,31
050,29,025,"Missouri","Caldwell County",3,35,92,49,43
050,29,025,"Missouri","Caldwell County",3,36,104,49,55
050,29,025,"Missouri","Caldwell County",3,37,103,43,60
050,29,025,"Missouri","Caldwell County",3,38,93,39,54
050,29,025,"Missouri","Caldwell County",3,39,98,48,50
050,29,025,"Missouri","Caldwell County",3,40,108,53,55
050,29,025,"Missouri","Caldwell County",3,41,107,56,51
050,29,025,"Missouri","Caldwell County",3,42,95,50,45
050,29,025,"Missouri","Caldwell County",3,43,105,53,52
050,29,025,"Missouri","Caldwell County",3,44,104,51,53
050,29,025,"Missouri","Caldwell County",3,45,100,50,50
050,29,025,"Missouri","Caldwell County",3,46,99,49,50
050,29,025,"Missouri","Caldwell County",3,47,97,42,55
050,29,025,"Missouri","Caldwell County",3,48,105,47,58
050,29,025,"Missouri","Caldwell County",3,49,99,52,47
050,29,025,"Missouri","Caldwell County",3,50,120,67,53
050,29,025,"Missouri","Caldwell County",3,51,122,67,55
050,29,025,"Missouri","Caldwell County",3,52,117,62,55
050,29,025,"Missouri","Caldwell County",3,53,113,51,62
050,29,025,"Missouri","Caldwell County",3,54,112,55,57
050,29,025,"Missouri","Caldwell County",3,55,118,63,55
050,29,025,"Missouri","Caldwell County",3,56,116,64,52
050,29,025,"Missouri","Caldwell County",3,57,127,62,65
050,29,025,"Missouri","Caldwell County",3,58,145,79,66
050,29,025,"Missouri","Caldwell County",3,59,140,75,65
050,29,025,"Missouri","Caldwell County",3,60,133,64,69
050,29,025,"Missouri","Caldwell County",3,61,134,69,65
050,29,025,"Missouri","Caldwell County",3,62,133,70,63
050,29,025,"Missouri","Caldwell County",3,63,122,65,57
050,29,025,"Missouri","Caldwell County",3,64,122,58,64
050,29,025,"Missouri","Caldwell County",3,65,132,64,68
050,29,025,"Missouri","Caldwell County",3,66,117,55,62
050,29,025,"Missouri","Caldwell County",3,67,109,49,60
050,29,025,"Missouri","Caldwell County",3,68,104,45,59
050,29,025,"Missouri","Caldwell County",3,69,101,44,57
050,29,025,"Missouri","Caldwell County",3,70,99,52,47
050,29,025,"Missouri","Caldwell County",3,71,108,60,48
050,29,025,"Missouri","Caldwell County",3,72,95,48,47
050,29,025,"Missouri","Caldwell County",3,73,78,42,36
050,29,025,"Missouri","Caldwell County",3,74,80,41,39
050,29,025,"Missouri","Caldwell County",3,75,67,34,33
050,29,025,"Missouri","Caldwell County",3,76,62,32,30
050,29,025,"Missouri","Caldwell County",3,77,68,32,36
050,29,025,"Missouri","Caldwell County",3,78,71,35,36
050,29,025,"Missouri","Caldwell County",3,79,52,26,26
050,29,025,"Missouri","Caldwell County",3,80,56,27,29
050,29,025,"Missouri","Caldwell County",3,81,48,18,30
050,29,025,"Missouri","Caldwell County",3,82,47,21,26
050,29,025,"Missouri","Caldwell County",3,83,41,21,20
050,29,025,"Missouri","Caldwell County",3,84,33,14,19
050,29,025,"Missouri","Caldwell County",3,85,220,70,150
050,29,025,"Missouri","Caldwell County",4,0,101,56,45
050,29,025,"Missouri","Caldwell County",4,1,82,51,31
050,29,025,"Missouri","Caldwell County",4,2,115,66,49
050,29,025,"Missouri","Caldwell County",4,3,103,52,51
050,29,025,"Missouri","Caldwell County",4,4,107,55,52
050,29,025,"Missouri","Caldwell County",4,5,98,50,48
050,29,025,"Missouri","Caldwell County",4,6,115,56,59
050,29,025,"Missouri","Caldwell County",4,7,122,53,69
050,29,025,"Missouri","Caldwell County",4,8,106,55,51
050,29,025,"Missouri","Caldwell County",4,9,107,58,49
050,29,025,"Missouri","Caldwell County",4,10,113,57,56
050,29,025,"Missouri","Caldwell County",4,11,122,68,54
050,29,025,"Missouri","Caldwell County",4,12,133,78,55
050,29,025,"Missouri","Caldwell County",4,13,128,69,59
050,29,025,"Missouri","Caldwell County",4,14,138,78,60
050,29,025,"Missouri","Caldwell County",4,15,137,77,60
050,29,025,"Missouri","Caldwell County",4,16,148,72,76
050,29,025,"Missouri","Caldwell County",4,17,136,63,73
050,29,025,"Missouri","Caldwell County",4,18,107,61,46
050,29,025,"Missouri","Caldwell County",4,19,86,49,37
050,29,025,"Missouri","Caldwell County",4,20,89,49,40
050,29,025,"Missouri","Caldwell County",4,21,93,60,33
050,29,025,"Missouri","Caldwell County",4,22,107,57,50
050,29,025,"Missouri","Caldwell County",4,23,89,52,37
050,29,025,"Missouri","Caldwell County",4,24,100,50,50
050,29,025,"Missouri","Caldwell County",4,25,110,57,53
050,29,025,"Missouri","Caldwell County",4,26,83,46,37
050,29,025,"Missouri","Caldwell County",4,27,98,60,38
050,29,025,"Missouri","Caldwell County",4,28,103,52,51
050,29,025,"Missouri","Caldwell County",4,29,112,66,46
050,29,025,"Missouri","Caldwell County",4,30,103,48,55
050,29,025,"Missouri","Caldwell County",4,31,115,66,49
050,29,025,"Missouri","Caldwell County",4,32,104,53,51
050,29,025,"Missouri","Caldwell County",4,33,89,47,42
050,29,025,"Missouri","Caldwell County",4,34,83,42,41
050,29,025,"Missouri","Caldwell County",4,35,78,43,35
050,29,025,"Missouri","Caldwell County",4,36,92,52,40
050,29,025,"Missouri","Caldwell County",4,37,95,44,51
050,29,025,"Missouri","Caldwell County",4,38,104,46,58
050,29,025,"Missouri","Caldwell County",4,39,95,46,49
050,29,025,"Missouri","Caldwell County",4,40,99,49,50
050,29,025,"Missouri","Caldwell County",4,41,112,52,60
050,29,025,"Missouri","Caldwell County",4,42,107,56,51
050,29,025,"Missouri","Caldwell County",4,43,101,52,49
050,29,025,"Missouri","Caldwell County",4,44,105,54,51
050,29,025,"Missouri","Caldwell County",4,45,110,54,56
050,29,025,"Missouri","Caldwell County",4,46,102,52,50
050,29,025,"Missouri","Caldwell County",4,47,91,44,47
050,29,025,"Missouri","Caldwell County",4,48,107,48,59
050,29,025,"Missouri","Caldwell County",4,49,100,46,54
050,29,025,"Missouri","Caldwell County",4,50,102,50,52
050,29,025,"Missouri","Caldwell County",4,51,113,66,47
050,29,025,"Missouri","Caldwell County",4,52,137,75,62
050,29,025,"Missouri","Caldwell County",4,53,119,63,56
050,29,025,"Missouri","Caldwell County",4,54,112,50,62
050,29,025,"Missouri","Caldwell County",4,55,113,56,57
050,29,025,"Missouri","Caldwell County",4,56,121,63,58
050,29,025,"Missouri","Caldwell County",4,57,121,68,53
050,29,025,"Missouri","Caldwell County",4,58,126,62,64
050,29,025,"Missouri","Caldwell County",4,59,140,75,65
050,29,025,"Missouri","Caldwell County",4,60,136,71,65
050,29,025,"Missouri","Caldwell County",4,61,129,67,62
050,29,025,"Missouri","Caldwell County",4,62,133,67,66
050,29,025,"Missouri","Caldwell County",4,63,135,71,64
050,29,025,"Missouri","Caldwell County",4,64,121,67,54
050,29,025,"Missouri","Caldwell County",4,65,111,52,59
050,29,025,"Missouri","Caldwell County",4,66,134,64,70
050,29,025,"Missouri","Caldwell County",4,67,111,53,58
050,29,025,"Missouri","Caldwell County",4,68,112,52,60
050,29,025,"Missouri","Caldwell County",4,69,101,43,58
050,29,025,"Missouri","Caldwell County",4,70,102,45,57
050,29,025,"Missouri","Caldwell County",4,71,98,51,47
050,29,025,"Missouri","Caldwell County",4,72,104,58,46
050,29,025,"Missouri","Caldwell County",4,73,89,44,45
050,29,025,"Missouri","Caldwell County",4,74,74,39,35
050,29,025,"Missouri","Caldwell County",4,75,82,45,37
050,29,025,"Missouri","Caldwell County",4,76,62,30,32
050,29,025,"Missouri","Caldwell County",4,77,63,30,33
050,29,025,"Missouri","Caldwell County",4,78,61,30,31
050,29,025,"Missouri","Caldwell County",4,79,59,27,32
050,29,025,"Missouri","Caldwell County",4,80,50,26,24
050,29,025,"Missouri","Caldwell County",4,81,52,24,28
050,29,025,"Missouri","Caldwell County",4,82,47,17,30
050,29,025,"Missouri","Caldwell County",4,83,44,18,26
050,29,025,"Missouri","Caldwell County",4,84,35,17,18
050,29,025,"Missouri","Caldwell County",4,85,210,68,142
050,29,025,"Missouri","Caldwell County",5,0,100,56,44
050,29,025,"Missouri","Caldwell County",5,1,107,56,51
050,29,025,"Missouri","Caldwell County",5,2,91,56,35
050,29,025,"Missouri","Caldwell County",5,3,122,71,51
050,29,025,"Missouri","Caldwell County",5,4,108,58,50
050,29,025,"Missouri","Caldwell County",5,5,111,59,52
050,29,025,"Missouri","Caldwell County",5,6,92,45,47
050,29,025,"Missouri","Caldwell County",5,7,119,61,58
050,29,025,"Missouri","Caldwell County",5,8,122,54,68
050,29,025,"Missouri","Caldwell County",5,9,107,55,52
050,29,025,"Missouri","Caldwell County",5,10,112,61,51
050,29,025,"Missouri","Caldwell County",5,11,115,61,54
050,29,025,"Missouri","Caldwell County",5,12,120,63,57
050,29,025,"Missouri","Caldwell County",5,13,141,81,60
050,29,025,"Missouri","Caldwell County",5,14,127,65,62
050,29,025,"Missouri","Caldwell County",5,15,141,80,61
050,29,025,"Missouri","Caldwell County",5,16,129,72,57
050,29,025,"Missouri","Caldwell County",5,17,142,67,75
050,29,025,"Missouri","Caldwell County",5,18,111,54,57
050,29,025,"Missouri","Caldwell County",5,19,88,53,35
050,29,025,"Missouri","Caldwell County",5,20,92,52,40
050,29,025,"Missouri","Caldwell County",5,21,91,51,40
050,29,025,"Missouri","Caldwell County",5,22,98,59,39
050,29,025,"Missouri","Caldwell County",5,23,103,52,51
050,29,025,"Missouri","Caldwell County",5,24,97,51,46
050,29,025,"Missouri","Caldwell County",5,25,111,65,46
050,29,025,"Missouri","Caldwell County",5,26,102,49,53
050,29,025,"Missouri","Caldwell County",5,27,96,53,43
050,29,025,"Missouri","Caldwell County",5,28,101,60,41
050,29,025,"Missouri","Caldwell County",5,29,105,56,49
050,29,025,"Missouri","Caldwell County",5,30,104,61,43
050,29,025,"Missouri","Caldwell County",5,31,113,55,58
050,29,025,"Missouri","Caldwell County",5,32,113,62,51
050,29,025,"Missouri","Caldwell County",5,33,113,54,59
050,29,025,"Missouri","Caldwell County",5,34,97,50,47
050,29,025,"Missouri","Caldwell County",5,35,86,47,39
050,29,025,"Missouri","Caldwell County",5,36,76,43,33
050,29,025,"Missouri","Caldwell County",5,37,94,52,42
050,29,025,"Missouri","Caldwell County",5,38,89,42,47
050,29,025,"Missouri","Caldwell County",5,39,115,52,63
050,29,025,"Missouri","Caldwell County",5,40,92,42,50
050,29,025,"Missouri","Caldwell County",5,41,94,44,50
050,29,025,"Missouri","Caldwell County",5,42,108,51,57
050,29,025,"Missouri","Caldwell County",5,43,104,54,50
050,29,025,"Missouri","Caldwell County",5,44,96,48,48
050,29,025,"Missouri","Caldwell County",5,45,109,57,52
050,29,025,"Missouri","Caldwell County",5,46,109,56,53
050,29,025,"Missouri","Caldwell County",5,47,97,50,47
050,29,025,"Missouri","Caldwell County",5,48,97,47,50
050,29,025,"Missouri","Caldwell County",5,49,104,47,57
050,29,025,"Missouri","Caldwell County",5,50,104,46,58
050,29,025,"Missouri","Caldwell County",5,51,98,48,50
050,29,025,"Missouri","Caldwell County",5,52,118,70,48
050,29,025,"Missouri","Caldwell County",5,53,141,78,63
050,29,025,"Missouri","Caldwell County",5,54,121,65,56
050,29,025,"Missouri","Caldwell County",5,55,114,53,61
050,29,025,"Missouri","Caldwell County",5,56,110,56,54
050,29,025,"Missouri","Caldwell County",5,57,123,61,62
050,29,025,"Missouri","Caldwell County",5,58,117,68,49
050,29,025,"Missouri","Caldwell County",5,59,120,61,59
050,29,025,"Missouri","Caldwell County",5,60,146,75,71
050,29,025,"Missouri","Caldwell County",5,61,132,70,62
050,29,025,"Missouri","Caldwell County",5,62,131,65,66
050,29,025,"Missouri","Caldwell County",5,63,131,67,64
050,29,025,"Missouri","Caldwell County",5,64,129,71,58
050,29,025,"Missouri","Caldwell County",5,65,114,64,50
050,29,025,"Missouri","Caldwell County",5,66,110,49,61
050,29,025,"Missouri","Caldwell County",5,67,126,58,68
050,29,025,"Missouri","Caldwell County",5,68,112,51,61
050,29,025,"Missouri","Caldwell County",5,69,111,50,61
050,29,025,"Missouri","Caldwell County",5,70,99,41,58
050,29,025,"Missouri","Caldwell County",5,71,96,42,54
050,29,025,"Missouri","Caldwell County",5,72,96,48,48
050,29,025,"Missouri","Caldwell County",5,73,102,56,46
050,29,025,"Missouri","Caldwell County",5,74,86,43,43
050,29,025,"Missouri","Caldwell County",5,75,68,39,29
050,29,025,"Missouri","Caldwell County",5,76,76,40,36
050,29,025,"Missouri","Caldwell County",5,77,61,26,35
050,29,025,"Missouri","Caldwell County",5,78,54,29,25
050,29,025,"Missouri","Caldwell County",5,79,55,27,28
050,29,025,"Missouri","Caldwell County",5,80,53,23,30
050,29,025,"Missouri","Caldwell County",5,81,46,24,22
050,29,025,"Missouri","Caldwell County",5,82,48,24,24
050,29,025,"Missouri","Caldwell County",5,83,42,14,28
050,29,025,"Missouri","Caldwell County",5,84,44,16,28
050,29,025,"Missouri","Caldwell County",5,85,210,72,138
050,29,027,"Missouri","Callaway County",1,0,480,248,232
050,29,027,"Missouri","Callaway County",1,1,486,259,227
050,29,027,"Missouri","Callaway County",1,2,503,258,245
050,29,027,"Missouri","Callaway County",1,3,498,260,238
050,29,027,"Missouri","Callaway County",1,4,475,255,220
050,29,027,"Missouri","Callaway County",1,5,503,271,232
050,29,027,"Missouri","Callaway County",1,6,524,267,257
050,29,027,"Missouri","Callaway County",1,7,508,260,248
050,29,027,"Missouri","Callaway County",1,8,482,249,233
050,29,027,"Missouri","Callaway County",1,9,515,270,245
050,29,027,"Missouri","Callaway County",1,10,510,254,256
050,29,027,"Missouri","Callaway County",1,11,520,272,248
050,29,027,"Missouri","Callaway County",1,12,554,280,274
050,29,027,"Missouri","Callaway County",1,13,540,277,263
050,29,027,"Missouri","Callaway County",1,14,546,296,250
050,29,027,"Missouri","Callaway County",1,15,537,295,242
050,29,027,"Missouri","Callaway County",1,16,538,282,256
050,29,027,"Missouri","Callaway County",1,17,545,275,270
050,29,027,"Missouri","Callaway County",1,18,566,269,297
050,29,027,"Missouri","Callaway County",1,19,700,350,350
050,29,027,"Missouri","Callaway County",1,20,655,339,316
050,29,027,"Missouri","Callaway County",1,21,639,352,287
050,29,027,"Missouri","Callaway County",1,22,622,343,279
050,29,027,"Missouri","Callaway County",1,23,561,297,264
050,29,027,"Missouri","Callaway County",1,24,526,283,243
050,29,027,"Missouri","Callaway County",1,25,523,286,237
050,29,027,"Missouri","Callaway County",1,26,566,308,258
050,29,027,"Missouri","Callaway County",1,27,584,310,274
050,29,027,"Missouri","Callaway County",1,28,593,331,262
050,29,027,"Missouri","Callaway County",1,29,634,333,301
050,29,027,"Missouri","Callaway County",1,30,610,343,267
050,29,027,"Missouri","Callaway County",1,31,623,355,268
050,29,027,"Missouri","Callaway County",1,32,555,299,256
050,29,027,"Missouri","Callaway County",1,33,577,333,244
050,29,027,"Missouri","Callaway County",1,34,562,315,247
050,29,027,"Missouri","Callaway County",1,35,562,306,256
050,29,027,"Missouri","Callaway County",1,36,547,297,250
050,29,027,"Missouri","Callaway County",1,37,589,318,271
050,29,027,"Missouri","Callaway County",1,38,597,308,289
050,29,027,"Missouri","Callaway County",1,39,588,315,273
050,29,027,"Missouri","Callaway County",1,40,567,305,262
050,29,027,"Missouri","Callaway County",1,41,554,301,253
050,29,027,"Missouri","Callaway County",1,42,542,266,276
050,29,027,"Missouri","Callaway County",1,43,527,282,245
050,29,027,"Missouri","Callaway County",1,44,494,262,232
050,29,027,"Missouri","Callaway County",1,45,529,282,247
050,29,027,"Missouri","Callaway County",1,46,512,292,220
050,29,027,"Missouri","Callaway County",1,47,521,278,243
050,29,027,"Missouri","Callaway County",1,48,552,289,263
050,29,027,"Missouri","Callaway County",1,49,590,303,287
050,29,027,"Missouri","Callaway County",1,50,578,306,272
050,29,027,"Missouri","Callaway County",1,51,574,287,287
050,29,027,"Missouri","Callaway County",1,52,559,296,263
050,29,027,"Missouri","Callaway County",1,53,554,280,274
050,29,027,"Missouri","Callaway County",1,54,567,284,283
050,29,027,"Missouri","Callaway County",1,55,610,316,294
050,29,027,"Missouri","Callaway County",1,56,656,349,307
050,29,027,"Missouri","Callaway County",1,57,678,337,341
050,29,027,"Missouri","Callaway County",1,58,672,341,331
050,29,027,"Missouri","Callaway County",1,59,632,310,322
050,29,027,"Missouri","Callaway County",1,60,647,326,321
050,29,027,"Missouri","Callaway County",1,61,633,321,312
050,29,027,"Missouri","Callaway County",1,62,583,296,287
050,29,027,"Missouri","Callaway County",1,63,588,310,278
050,29,027,"Missouri","Callaway County",1,64,576,280,296
050,29,027,"Missouri","Callaway County",1,65,550,252,298
050,29,027,"Missouri","Callaway County",1,66,524,255,269
050,29,027,"Missouri","Callaway County",1,67,527,282,245
050,29,027,"Missouri","Callaway County",1,68,520,278,242
050,29,027,"Missouri","Callaway County",1,69,512,260,252
050,29,027,"Missouri","Callaway County",1,70,451,225,226
050,29,027,"Missouri","Callaway County",1,71,423,209,214
050,29,027,"Missouri","Callaway County",1,72,428,225,203
050,29,027,"Missouri","Callaway County",1,73,418,217,201
050,29,027,"Missouri","Callaway County",1,74,293,146,147
050,29,027,"Missouri","Callaway County",1,75,284,135,149
050,29,027,"Missouri","Callaway County",1,76,277,137,140
050,29,027,"Missouri","Callaway County",1,77,275,134,141
050,29,027,"Missouri","Callaway County",1,78,235,118,117
050,29,027,"Missouri","Callaway County",1,79,216,99,117
050,29,027,"Missouri","Callaway County",1,80,194,80,114
050,29,027,"Missouri","Callaway County",1,81,174,74,100
050,29,027,"Missouri","Callaway County",1,82,180,82,98
050,29,027,"Missouri","Callaway County",1,83,152,78,74
050,29,027,"Missouri","Callaway County",1,84,124,61,63
050,29,027,"Missouri","Callaway County",1,85,792,272,520
050,29,027,"Missouri","Callaway County",2,0,501,254,247
050,29,027,"Missouri","Callaway County",2,1,484,255,229
050,29,027,"Missouri","Callaway County",2,2,503,260,243
050,29,027,"Missouri","Callaway County",2,3,498,260,238
050,29,027,"Missouri","Callaway County",2,4,482,258,224
050,29,027,"Missouri","Callaway County",2,5,499,269,230
050,29,027,"Missouri","Callaway County",2,6,524,270,254
050,29,027,"Missouri","Callaway County",2,7,510,260,250
050,29,027,"Missouri","Callaway County",2,8,489,251,238
050,29,027,"Missouri","Callaway County",2,9,507,265,242
050,29,027,"Missouri","Callaway County",2,10,510,259,251
050,29,027,"Missouri","Callaway County",2,11,515,267,248
050,29,027,"Missouri","Callaway County",2,12,544,276,268
050,29,027,"Missouri","Callaway County",2,13,542,276,266
050,29,027,"Missouri","Callaway County",2,14,546,292,254
050,29,027,"Missouri","Callaway County",2,15,539,294,245
050,29,027,"Missouri","Callaway County",2,16,540,287,253
050,29,027,"Missouri","Callaway County",2,17,544,278,266
050,29,027,"Missouri","Callaway County",2,18,562,270,292
050,29,027,"Missouri","Callaway County",2,19,703,344,359
050,29,027,"Missouri","Callaway County",2,20,661,343,318
050,29,027,"Missouri","Callaway County",2,21,642,350,292
050,29,027,"Missouri","Callaway County",2,22,622,343,279
050,29,027,"Missouri","Callaway County",2,23,551,298,253
050,29,027,"Missouri","Callaway County",2,24,535,286,249
050,29,027,"Missouri","Callaway County",2,25,522,286,236
050,29,027,"Missouri","Callaway County",2,26,563,306,257
050,29,027,"Missouri","Callaway County",2,27,578,310,268
050,29,027,"Missouri","Callaway County",2,28,594,326,268
050,29,027,"Missouri","Callaway County",2,29,616,327,289
050,29,027,"Missouri","Callaway County",2,30,629,352,277
050,29,027,"Missouri","Callaway County",2,31,622,355,267
050,29,027,"Missouri","Callaway County",2,32,561,307,254
050,29,027,"Missouri","Callaway County",2,33,567,322,245
050,29,027,"Missouri","Callaway County",2,34,561,315,246
050,29,027,"Missouri","Callaway County",2,35,570,315,255
050,29,027,"Missouri","Callaway County",2,36,547,296,251
050,29,027,"Missouri","Callaway County",2,37,585,316,269
050,29,027,"Missouri","Callaway County",2,38,595,309,286
050,29,027,"Missouri","Callaway County",2,39,590,315,275
050,29,027,"Missouri","Callaway County",2,40,572,304,268
050,29,027,"Missouri","Callaway County",2,41,562,305,257
050,29,027,"Missouri","Callaway County",2,42,538,271,267
050,29,027,"Missouri","Callaway County",2,43,541,287,254
050,29,027,"Missouri","Callaway County",2,44,491,256,235
050,29,027,"Missouri","Callaway County",2,45,534,287,247
050,29,027,"Missouri","Callaway County",2,46,515,290,225
050,29,027,"Missouri","Callaway County",2,47,514,277,237
050,29,027,"Missouri","Callaway County",2,48,547,287,260
050,29,027,"Missouri","Callaway County",2,49,587,304,283
050,29,027,"Missouri","Callaway County",2,50,584,309,275
050,29,027,"Missouri","Callaway County",2,51,569,287,282
050,29,027,"Missouri","Callaway County",2,52,559,293,266
050,29,027,"Missouri","Callaway County",2,53,553,280,273
050,29,027,"Missouri","Callaway County",2,54,561,282,279
050,29,027,"Missouri","Callaway County",2,55,599,308,291
050,29,027,"Missouri","Callaway County",2,56,646,341,305
050,29,027,"Missouri","Callaway County",2,57,677,343,334
050,29,027,"Missouri","Callaway County",2,58,671,339,332
050,29,027,"Missouri","Callaway County",2,59,644,318,326
050,29,027,"Missouri","Callaway County",2,60,641,320,321
050,29,027,"Missouri","Callaway County",2,61,631,319,312
050,29,027,"Missouri","Callaway County",2,62,592,301,291
050,29,027,"Missouri","Callaway County",2,63,595,311,284
050,29,027,"Missouri","Callaway County",2,64,567,279,288
050,29,027,"Missouri","Callaway County",2,65,554,257,297
050,29,027,"Missouri","Callaway County",2,66,531,255,276
050,29,027,"Missouri","Callaway County",2,67,517,268,249
050,29,027,"Missouri","Callaway County",2,68,513,275,238
050,29,027,"Missouri","Callaway County",2,69,518,266,252
050,29,027,"Missouri","Callaway County",2,70,460,230,230
050,29,027,"Missouri","Callaway County",2,71,428,212,216
050,29,027,"Missouri","Callaway County",2,72,420,219,201
050,29,027,"Missouri","Callaway County",2,73,439,227,212
050,29,027,"Missouri","Callaway County",2,74,302,153,149
050,29,027,"Missouri","Callaway County",2,75,286,138,148
050,29,027,"Missouri","Callaway County",2,76,269,131,138
050,29,027,"Missouri","Callaway County",2,77,282,139,143
050,29,027,"Missouri","Callaway County",2,78,240,119,121
050,29,027,"Missouri","Callaway County",2,79,215,100,115
050,29,027,"Missouri","Callaway County",2,80,198,82,116
050,29,027,"Missouri","Callaway County",2,81,173,73,100
050,29,027,"Missouri","Callaway County",2,82,176,79,97
050,29,027,"Missouri","Callaway County",2,83,154,77,77
050,29,027,"Missouri","Callaway County",2,84,124,61,63
050,29,027,"Missouri","Callaway County",2,85,798,278,520
050,29,027,"Missouri","Callaway County",3,0,440,233,207
050,29,027,"Missouri","Callaway County",3,1,497,263,234
050,29,027,"Missouri","Callaway County",3,2,498,269,229
050,29,027,"Missouri","Callaway County",3,3,516,279,237
050,29,027,"Missouri","Callaway County",3,4,500,264,236
050,29,027,"Missouri","Callaway County",3,5,469,244,225
050,29,027,"Missouri","Callaway County",3,6,504,278,226
050,29,027,"Missouri","Callaway County",3,7,529,272,257
050,29,027,"Missouri","Callaway County",3,8,523,271,252
050,29,027,"Missouri","Callaway County",3,9,499,255,244
050,29,027,"Missouri","Callaway County",3,10,491,256,235
050,29,027,"Missouri","Callaway County",3,11,511,259,252
050,29,027,"Missouri","Callaway County",3,12,523,268,255
050,29,027,"Missouri","Callaway County",3,13,559,285,274
050,29,027,"Missouri","Callaway County",3,14,557,282,275
050,29,027,"Missouri","Callaway County",3,15,550,295,255
050,29,027,"Missouri","Callaway County",3,16,543,301,242
050,29,027,"Missouri","Callaway County",3,17,549,292,257
050,29,027,"Missouri","Callaway County",3,18,575,281,294
050,29,027,"Missouri","Callaway County",3,19,696,338,358
050,29,027,"Missouri","Callaway County",3,20,658,343,315
050,29,027,"Missouri","Callaway County",3,21,634,341,293
050,29,027,"Missouri","Callaway County",3,22,623,331,292
050,29,027,"Missouri","Callaway County",3,23,548,322,226
050,29,027,"Missouri","Callaway County",3,24,562,300,262
050,29,027,"Missouri","Callaway County",3,25,516,277,239
050,29,027,"Missouri","Callaway County",3,26,543,308,235
050,29,027,"Missouri","Callaway County",3,27,576,322,254
050,29,027,"Missouri","Callaway County",3,28,586,317,269
050,29,027,"Missouri","Callaway County",3,29,583,316,267
050,29,027,"Missouri","Callaway County",3,30,647,350,297
050,29,027,"Missouri","Callaway County",3,31,662,372,290
050,29,027,"Missouri","Callaway County",3,32,603,318,285
050,29,027,"Missouri","Callaway County",3,33,549,305,244
050,29,027,"Missouri","Callaway County",3,34,567,321,246
050,29,027,"Missouri","Callaway County",3,35,596,335,261
050,29,027,"Missouri","Callaway County",3,36,573,318,255
050,29,027,"Missouri","Callaway County",3,37,555,312,243
050,29,027,"Missouri","Callaway County",3,38,597,321,276
050,29,027,"Missouri","Callaway County",3,39,617,328,289
050,29,027,"Missouri","Callaway County",3,40,588,309,279
050,29,027,"Missouri","Callaway County",3,41,575,309,266
050,29,027,"Missouri","Callaway County",3,42,553,298,255
050,29,027,"Missouri","Callaway County",3,43,568,305,263
050,29,027,"Missouri","Callaway County",3,44,513,256,257
050,29,027,"Missouri","Callaway County",3,45,520,291,229
050,29,027,"Missouri","Callaway County",3,46,536,289,247
050,29,027,"Missouri","Callaway County",3,47,514,280,234
050,29,027,"Missouri","Callaway County",3,48,505,270,235
050,29,027,"Missouri","Callaway County",3,49,567,299,268
050,29,027,"Missouri","Callaway County",3,50,602,323,279
050,29,027,"Missouri","Callaway County",3,51,588,301,287
050,29,027,"Missouri","Callaway County",3,52,575,293,282
050,29,027,"Missouri","Callaway County",3,53,560,286,274
050,29,027,"Missouri","Callaway County",3,54,574,296,278
050,29,027,"Missouri","Callaway County",3,55,549,267,282
050,29,027,"Missouri","Callaway County",3,56,601,313,288
050,29,027,"Missouri","Callaway County",3,57,657,344,313
050,29,027,"Missouri","Callaway County",3,58,668,338,330
050,29,027,"Missouri","Callaway County",3,59,652,334,318
050,29,027,"Missouri","Callaway County",3,60,646,320,326
050,29,027,"Missouri","Callaway County",3,61,614,309,305
050,29,027,"Missouri","Callaway County",3,62,610,309,301
050,29,027,"Missouri","Callaway County",3,63,587,297,290
050,29,027,"Missouri","Callaway County",3,64,584,302,282
050,29,027,"Missouri","Callaway County",3,65,568,268,300
050,29,027,"Missouri","Callaway County",3,66,546,250,296
050,29,027,"Missouri","Callaway County",3,67,532,254,278
050,29,027,"Missouri","Callaway County",3,68,507,265,242
050,29,027,"Missouri","Callaway County",3,69,507,270,237
050,29,027,"Missouri","Callaway County",3,70,506,257,249
050,29,027,"Missouri","Callaway County",3,71,439,223,216
050,29,027,"Missouri","Callaway County",3,72,420,215,205
050,29,027,"Missouri","Callaway County",3,73,397,202,195
050,29,027,"Missouri","Callaway County",3,74,435,217,218
050,29,027,"Missouri","Callaway County",3,75,290,141,149
050,29,027,"Missouri","Callaway County",3,76,259,124,135
050,29,027,"Missouri","Callaway County",3,77,262,129,133
050,29,027,"Missouri","Callaway County",3,78,274,135,139
050,29,027,"Missouri","Callaway County",3,79,217,103,114
050,29,027,"Missouri","Callaway County",3,80,218,101,117
050,29,027,"Missouri","Callaway County",3,81,172,67,105
050,29,027,"Missouri","Callaway County",3,82,165,71,94
050,29,027,"Missouri","Callaway County",3,83,153,69,84
050,29,027,"Missouri","Callaway County",3,84,141,72,69
050,29,027,"Missouri","Callaway County",3,85,802,282,520
050,29,027,"Missouri","Callaway County",4,0,454,242,212
050,29,027,"Missouri","Callaway County",4,1,464,241,223
050,29,027,"Missouri","Callaway County",4,2,513,270,243
050,29,027,"Missouri","Callaway County",4,3,489,256,233
050,29,027,"Missouri","Callaway County",4,4,507,263,244
050,29,027,"Missouri","Callaway County",4,5,494,263,231
050,29,027,"Missouri","Callaway County",4,6,494,269,225
050,29,027,"Missouri","Callaway County",4,7,518,291,227
050,29,027,"Missouri","Callaway County",4,8,540,276,264
050,29,027,"Missouri","Callaway County",4,9,517,271,246
050,29,027,"Missouri","Callaway County",4,10,485,243,242
050,29,027,"Missouri","Callaway County",4,11,504,253,251
050,29,027,"Missouri","Callaway County",4,12,510,263,247
050,29,027,"Missouri","Callaway County",4,13,509,249,260
050,29,027,"Missouri","Callaway County",4,14,559,287,272
050,29,027,"Missouri","Callaway County",4,15,558,279,279
050,29,027,"Missouri","Callaway County",4,16,553,296,257
050,29,027,"Missouri","Callaway County",4,17,567,314,253
050,29,027,"Missouri","Callaway County",4,18,570,291,279
050,29,027,"Missouri","Callaway County",4,19,693,334,359
050,29,027,"Missouri","Callaway County",4,20,647,340,307
050,29,027,"Missouri","Callaway County",4,21,642,347,295
050,29,027,"Missouri","Callaway County",4,22,622,332,290
050,29,027,"Missouri","Callaway County",4,23,551,308,243
050,29,027,"Missouri","Callaway County",4,24,553,320,233
050,29,027,"Missouri","Callaway County",4,25,546,286,260
050,29,027,"Missouri","Callaway County",4,26,540,286,254
050,29,027,"Missouri","Callaway County",4,27,554,327,227
050,29,027,"Missouri","Callaway County",4,28,570,316,254
050,29,027,"Missouri","Callaway County",4,29,565,300,265
050,29,027,"Missouri","Callaway County",4,30,591,328,263
050,29,027,"Missouri","Callaway County",4,31,658,357,301
050,29,027,"Missouri","Callaway County",4,32,638,351,287
050,29,027,"Missouri","Callaway County",4,33,587,297,290
050,29,027,"Missouri","Callaway County",4,34,534,294,240
050,29,027,"Missouri","Callaway County",4,35,595,344,251
050,29,027,"Missouri","Callaway County",4,36,568,321,247
050,29,027,"Missouri","Callaway County",4,37,601,342,259
050,29,027,"Missouri","Callaway County",4,38,537,290,247
050,29,027,"Missouri","Callaway County",4,39,604,328,276
050,29,027,"Missouri","Callaway County",4,40,594,302,292
050,29,027,"Missouri","Callaway County",4,41,594,313,281
050,29,027,"Missouri","Callaway County",4,42,564,301,263
050,29,027,"Missouri","Callaway County",4,43,577,324,253
050,29,027,"Missouri","Callaway County",4,44,546,281,265
050,29,027,"Missouri","Callaway County",4,45,529,272,257
050,29,027,"Missouri","Callaway County",4,46,529,299,230
050,29,027,"Missouri","Callaway County",4,47,530,280,250
050,29,027,"Missouri","Callaway County",4,48,519,275,244
050,29,027,"Missouri","Callaway County",4,49,514,270,244
050,29,027,"Missouri","Callaway County",4,50,584,313,271
050,29,027,"Missouri","Callaway County",4,51,606,322,284
050,29,027,"Missouri","Callaway County",4,52,607,314,293
050,29,027,"Missouri","Callaway County",4,53,557,280,277
050,29,027,"Missouri","Callaway County",4,54,560,284,276
050,29,027,"Missouri","Callaway County",4,55,566,285,281
050,29,027,"Missouri","Callaway County",4,56,545,271,274
050,29,027,"Missouri","Callaway County",4,57,587,309,278
050,29,027,"Missouri","Callaway County",4,58,620,322,298
050,29,027,"Missouri","Callaway County",4,59,672,336,336
050,29,027,"Missouri","Callaway County",4,60,655,341,314
050,29,027,"Missouri","Callaway County",4,61,635,320,315
050,29,027,"Missouri","Callaway County",4,62,589,293,296
050,29,027,"Missouri","Callaway County",4,63,605,305,300
050,29,027,"Missouri","Callaway County",4,64,585,294,291
050,29,027,"Missouri","Callaway County",4,65,572,294,278
050,29,027,"Missouri","Callaway County",4,66,553,262,291
050,29,027,"Missouri","Callaway County",4,67,536,251,285
050,29,027,"Missouri","Callaway County",4,68,522,248,274
050,29,027,"Missouri","Callaway County",4,69,496,259,237
050,29,027,"Missouri","Callaway County",4,70,485,254,231
050,29,027,"Missouri","Callaway County",4,71,501,259,242
050,29,027,"Missouri","Callaway County",4,72,437,221,216
050,29,027,"Missouri","Callaway County",4,73,400,200,200
050,29,027,"Missouri","Callaway County",4,74,403,199,204
050,29,027,"Missouri","Callaway County",4,75,426,212,214
050,29,027,"Missouri","Callaway County",4,76,266,129,137
050,29,027,"Missouri","Callaway County",4,77,263,126,137
050,29,027,"Missouri","Callaway County",4,78,254,125,129
050,29,027,"Missouri","Callaway County",4,79,254,120,134
050,29,027,"Missouri","Callaway County",4,80,224,108,116
050,29,027,"Missouri","Callaway County",4,81,198,92,106
050,29,027,"Missouri","Callaway County",4,82,166,68,98
050,29,027,"Missouri","Callaway County",4,83,158,67,91
050,29,027,"Missouri","Callaway County",4,84,139,63,76
050,29,027,"Missouri","Callaway County",4,85,800,294,506
050,29,027,"Missouri","Callaway County",5,0,456,243,213
050,29,027,"Missouri","Callaway County",5,1,472,240,232
050,29,027,"Missouri","Callaway County",5,2,473,244,229
050,29,027,"Missouri","Callaway County",5,3,511,264,247
050,29,027,"Missouri","Callaway County",5,4,482,242,240
050,29,027,"Missouri","Callaway County",5,5,526,272,254
050,29,027,"Missouri","Callaway County",5,6,509,266,243
050,29,027,"Missouri","Callaway County",5,7,497,269,228
050,29,027,"Missouri","Callaway County",5,8,523,297,226
050,29,027,"Missouri","Callaway County",5,9,539,278,261
050,29,027,"Missouri","Callaway County",5,10,524,271,253
050,29,027,"Missouri","Callaway County",5,11,504,258,246
050,29,027,"Missouri","Callaway County",5,12,509,262,247
050,29,027,"Missouri","Callaway County",5,13,508,255,253
050,29,027,"Missouri","Callaway County",5,14,523,261,262
050,29,027,"Missouri","Callaway County",5,15,558,297,261
050,29,027,"Missouri","Callaway County",5,16,544,265,279
050,29,027,"Missouri","Callaway County",5,17,558,297,261
050,29,027,"Missouri","Callaway County",5,18,580,304,276
050,29,027,"Missouri","Callaway County",5,19,689,341,348
050,29,027,"Missouri","Callaway County",5,20,651,335,316
050,29,027,"Missouri","Callaway County",5,21,639,336,303
050,29,027,"Missouri","Callaway County",5,22,624,324,300
050,29,027,"Missouri","Callaway County",5,23,578,330,248
050,29,027,"Missouri","Callaway County",5,24,543,297,246
050,29,027,"Missouri","Callaway County",5,25,534,305,229
050,29,027,"Missouri","Callaway County",5,26,559,296,263
050,29,027,"Missouri","Callaway County",5,27,529,280,249
050,29,027,"Missouri","Callaway County",5,28,549,304,245
050,29,027,"Missouri","Callaway County",5,29,544,289,255
050,29,027,"Missouri","Callaway County",5,30,587,310,277
050,29,027,"Missouri","Callaway County",5,31,600,325,275
050,29,027,"Missouri","Callaway County",5,32,636,333,303
050,29,027,"Missouri","Callaway County",5,33,626,342,284
050,29,027,"Missouri","Callaway County",5,34,570,280,290
050,29,027,"Missouri","Callaway County",5,35,540,294,246
050,29,027,"Missouri","Callaway County",5,36,588,330,258
050,29,027,"Missouri","Callaway County",5,37,587,329,258
050,29,027,"Missouri","Callaway County",5,38,592,325,267
050,29,027,"Missouri","Callaway County",5,39,523,282,241
050,29,027,"Missouri","Callaway County",5,40,580,300,280
050,29,027,"Missouri","Callaway County",5,41,605,314,291
050,29,027,"Missouri","Callaway County",5,42,580,301,279
050,29,027,"Missouri","Callaway County",5,43,583,313,270
050,29,027,"Missouri","Callaway County",5,44,563,301,262
050,29,027,"Missouri","Callaway County",5,45,567,299,268
050,29,027,"Missouri","Callaway County",5,46,510,263,247
050,29,027,"Missouri","Callaway County",5,47,521,286,235
050,29,027,"Missouri","Callaway County",5,48,515,264,251
050,29,027,"Missouri","Callaway County",5,49,508,271,237
050,29,027,"Missouri","Callaway County",5,50,519,271,248
050,29,027,"Missouri","Callaway County",5,51,566,295,271
050,29,027,"Missouri","Callaway County",5,52,604,315,289
050,29,027,"Missouri","Callaway County",5,53,600,305,295
050,29,027,"Missouri","Callaway County",5,54,568,286,282
050,29,027,"Missouri","Callaway County",5,55,563,281,282
050,29,027,"Missouri","Callaway County",5,56,565,290,275
050,29,027,"Missouri","Callaway County",5,57,553,272,281
050,29,027,"Missouri","Callaway County",5,58,570,291,279
050,29,027,"Missouri","Callaway County",5,59,602,313,289
050,29,027,"Missouri","Callaway County",5,60,661,332,329
050,29,027,"Missouri","Callaway County",5,61,661,347,314
050,29,027,"Missouri","Callaway County",5,62,622,313,309
050,29,027,"Missouri","Callaway County",5,63,596,293,303
050,29,027,"Missouri","Callaway County",5,64,592,289,303
050,29,027,"Missouri","Callaway County",5,65,589,287,302
050,29,027,"Missouri","Callaway County",5,66,557,289,268
050,29,027,"Missouri","Callaway County",5,67,548,265,283
050,29,027,"Missouri","Callaway County",5,68,520,241,279
050,29,027,"Missouri","Callaway County",5,69,515,241,274
050,29,027,"Missouri","Callaway County",5,70,476,247,229
050,29,027,"Missouri","Callaway County",5,71,475,253,222
050,29,027,"Missouri","Callaway County",5,72,495,257,238
050,29,027,"Missouri","Callaway County",5,73,404,203,201
050,29,027,"Missouri","Callaway County",5,74,388,188,200
050,29,027,"Missouri","Callaway County",5,75,388,184,204
050,29,027,"Missouri","Callaway County",5,76,407,201,206
050,29,027,"Missouri","Callaway County",5,77,265,131,134
050,29,027,"Missouri","Callaway County",5,78,252,123,129
050,29,027,"Missouri","Callaway County",5,79,234,113,121
050,29,027,"Missouri","Callaway County",5,80,246,121,125
050,29,027,"Missouri","Callaway County",5,81,206,99,107
050,29,027,"Missouri","Callaway County",5,82,188,89,99
050,29,027,"Missouri","Callaway County",5,83,154,65,89
050,29,027,"Missouri","Callaway County",5,84,145,62,83
050,29,027,"Missouri","Callaway County",5,85,821,303,518
050,29,029,"Missouri","Camden County",1,0,357,180,177
050,29,029,"Missouri","Camden County",1,1,361,190,171
050,29,029,"Missouri","Camden County",1,2,369,196,173
050,29,029,"Missouri","Camden County",1,3,351,176,175
050,29,029,"Missouri","Camden County",1,4,395,203,192
050,29,029,"Missouri","Camden County",1,5,392,201,191
050,29,029,"Missouri","Camden County",1,6,387,194,193
050,29,029,"Missouri","Camden County",1,7,377,199,178
050,29,029,"Missouri","Camden County",1,8,388,199,189
050,29,029,"Missouri","Camden County",1,9,405,204,201
050,29,029,"Missouri","Camden County",1,10,423,227,196
050,29,029,"Missouri","Camden County",1,11,439,223,216
050,29,029,"Missouri","Camden County",1,12,491,226,265
050,29,029,"Missouri","Camden County",1,13,468,227,241
050,29,029,"Missouri","Camden County",1,14,460,237,223
050,29,029,"Missouri","Camden County",1,15,482,240,242
050,29,029,"Missouri","Camden County",1,16,509,269,240
050,29,029,"Missouri","Camden County",1,17,507,259,248
050,29,029,"Missouri","Camden County",1,18,431,231,200
050,29,029,"Missouri","Camden County",1,19,314,164,150
050,29,029,"Missouri","Camden County",1,20,332,180,152
050,29,029,"Missouri","Camden County",1,21,332,180,152
050,29,029,"Missouri","Camden County",1,22,328,165,163
050,29,029,"Missouri","Camden County",1,23,341,165,176
050,29,029,"Missouri","Camden County",1,24,355,175,180
050,29,029,"Missouri","Camden County",1,25,357,196,161
050,29,029,"Missouri","Camden County",1,26,338,170,168
050,29,029,"Missouri","Camden County",1,27,362,184,178
050,29,029,"Missouri","Camden County",1,28,364,188,176
050,29,029,"Missouri","Camden County",1,29,374,188,186
050,29,029,"Missouri","Camden County",1,30,363,183,180
050,29,029,"Missouri","Camden County",1,31,379,185,194
050,29,029,"Missouri","Camden County",1,32,381,190,191
050,29,029,"Missouri","Camden County",1,33,365,190,175
050,29,029,"Missouri","Camden County",1,34,402,202,200
050,29,029,"Missouri","Camden County",1,35,421,201,220
050,29,029,"Missouri","Camden County",1,36,409,195,214
050,29,029,"Missouri","Camden County",1,37,427,206,221
050,29,029,"Missouri","Camden County",1,38,404,197,207
050,29,029,"Missouri","Camden County",1,39,400,192,208
050,29,029,"Missouri","Camden County",1,40,426,203,223
050,29,029,"Missouri","Camden County",1,41,433,215,218
050,29,029,"Missouri","Camden County",1,42,429,213,216
050,29,029,"Missouri","Camden County",1,43,395,193,202
050,29,029,"Missouri","Camden County",1,44,396,206,190
050,29,029,"Missouri","Camden County",1,45,395,202,193
050,29,029,"Missouri","Camden County",1,46,412,195,217
050,29,029,"Missouri","Camden County",1,47,426,217,209
050,29,029,"Missouri","Camden County",1,48,477,229,248
050,29,029,"Missouri","Camden County",1,49,491,241,250
050,29,029,"Missouri","Camden County",1,50,496,230,266
050,29,029,"Missouri","Camden County",1,51,535,260,275
050,29,029,"Missouri","Camden County",1,52,504,254,250
050,29,029,"Missouri","Camden County",1,53,536,265,271
050,29,029,"Missouri","Camden County",1,54,588,283,305
050,29,029,"Missouri","Camden County",1,55,616,290,326
050,29,029,"Missouri","Camden County",1,56,719,349,370
050,29,029,"Missouri","Camden County",1,57,700,336,364
050,29,029,"Missouri","Camden County",1,58,762,374,388
050,29,029,"Missouri","Camden County",1,59,798,376,422
050,29,029,"Missouri","Camden County",1,60,802,402,400
050,29,029,"Missouri","Camden County",1,61,823,397,426
050,29,029,"Missouri","Camden County",1,62,845,393,452
050,29,029,"Missouri","Camden County",1,63,885,439,446
050,29,029,"Missouri","Camden County",1,64,892,463,429
050,29,029,"Missouri","Camden County",1,65,839,416,423
050,29,029,"Missouri","Camden County",1,66,815,409,406
050,29,029,"Missouri","Camden County",1,67,831,417,414
050,29,029,"Missouri","Camden County",1,68,819,399,420
050,29,029,"Missouri","Camden County",1,69,761,378,383
050,29,029,"Missouri","Camden County",1,70,733,366,367
050,29,029,"Missouri","Camden County",1,71,768,379,389
050,29,029,"Missouri","Camden County",1,72,795,411,384
050,29,029,"Missouri","Camden County",1,73,773,398,375
050,29,029,"Missouri","Camden County",1,74,535,270,265
050,29,029,"Missouri","Camden County",1,75,524,287,237
050,29,029,"Missouri","Camden County",1,76,526,276,250
050,29,029,"Missouri","Camden County",1,77,523,266,257
050,29,029,"Missouri","Camden County",1,78,402,216,186
050,29,029,"Missouri","Camden County",1,79,334,185,149
050,29,029,"Missouri","Camden County",1,80,328,163,165
050,29,029,"Missouri","Camden County",1,81,280,143,137
050,29,029,"Missouri","Camden County",1,82,253,132,121
050,29,029,"Missouri","Camden County",1,83,231,116,115
050,29,029,"Missouri","Camden County",1,84,206,106,100
050,29,029,"Missouri","Camden County",1,85,948,397,551
050,29,029,"Missouri","Camden County",2,0,365,181,184
050,29,029,"Missouri","Camden County",2,1,359,187,172
050,29,029,"Missouri","Camden County",2,2,364,192,172
050,29,029,"Missouri","Camden County",2,3,351,179,172
050,29,029,"Missouri","Camden County",2,4,383,193,190
050,29,029,"Missouri","Camden County",2,5,390,202,188
050,29,029,"Missouri","Camden County",2,6,389,198,191
050,29,029,"Missouri","Camden County",2,7,377,195,182
050,29,029,"Missouri","Camden County",2,8,386,198,188
050,29,029,"Missouri","Camden County",2,9,398,204,194
050,29,029,"Missouri","Camden County",2,10,421,224,197
050,29,029,"Missouri","Camden County",2,11,433,222,211
050,29,029,"Missouri","Camden County",2,12,483,228,255
050,29,029,"Missouri","Camden County",2,13,471,227,244
050,29,029,"Missouri","Camden County",2,14,464,238,226
050,29,029,"Missouri","Camden County",2,15,483,240,243
050,29,029,"Missouri","Camden County",2,16,500,264,236
050,29,029,"Missouri","Camden County",2,17,502,258,244
050,29,029,"Missouri","Camden County",2,18,427,226,201
050,29,029,"Missouri","Camden County",2,19,322,167,155
050,29,029,"Missouri","Camden County",2,20,341,186,155
050,29,029,"Missouri","Camden County",2,21,338,182,156
050,29,029,"Missouri","Camden County",2,22,334,169,165
050,29,029,"Missouri","Camden County",2,23,346,169,177
050,29,029,"Missouri","Camden County",2,24,357,176,181
050,29,029,"Missouri","Camden County",2,25,356,193,163
050,29,029,"Missouri","Camden County",2,26,343,177,166
050,29,029,"Missouri","Camden County",2,27,352,181,171
050,29,029,"Missouri","Camden County",2,28,364,189,175
050,29,029,"Missouri","Camden County",2,29,374,189,185
050,29,029,"Missouri","Camden County",2,30,362,182,180
050,29,029,"Missouri","Camden County",2,31,369,182,187
050,29,029,"Missouri","Camden County",2,32,377,188,189
050,29,029,"Missouri","Camden County",2,33,368,189,179
050,29,029,"Missouri","Camden County",2,34,391,197,194
050,29,029,"Missouri","Camden County",2,35,420,201,219
050,29,029,"Missouri","Camden County",2,36,409,195,214
050,29,029,"Missouri","Camden County",2,37,425,205,220
050,29,029,"Missouri","Camden County",2,38,410,200,210
050,29,029,"Missouri","Camden County",2,39,401,193,208
050,29,029,"Missouri","Camden County",2,40,427,204,223
050,29,029,"Missouri","Camden County",2,41,436,214,222
050,29,029,"Missouri","Camden County",2,42,429,214,215
050,29,029,"Missouri","Camden County",2,43,406,200,206
050,29,029,"Missouri","Camden County",2,44,393,200,193
050,29,029,"Missouri","Camden County",2,45,404,207,197
050,29,029,"Missouri","Camden County",2,46,408,196,212
050,29,029,"Missouri","Camden County",2,47,423,212,211
050,29,029,"Missouri","Camden County",2,48,468,226,242
050,29,029,"Missouri","Camden County",2,49,491,241,250
050,29,029,"Missouri","Camden County",2,50,498,236,262
050,29,029,"Missouri","Camden County",2,51,531,255,276
050,29,029,"Missouri","Camden County",2,52,511,256,255
050,29,029,"Missouri","Camden County",2,53,534,266,268
050,29,029,"Missouri","Camden County",2,54,575,277,298
050,29,029,"Missouri","Camden County",2,55,618,293,325
050,29,029,"Missouri","Camden County",2,56,699,339,360
050,29,029,"Missouri","Camden County",2,57,712,344,368
050,29,029,"Missouri","Camden County",2,58,755,369,386
050,29,029,"Missouri","Camden County",2,59,802,381,421
050,29,029,"Missouri","Camden County",2,60,806,398,408
050,29,029,"Missouri","Camden County",2,61,827,402,425
050,29,029,"Missouri","Camden County",2,62,853,401,452
050,29,029,"Missouri","Camden County",2,63,886,433,453
050,29,029,"Missouri","Camden County",2,64,885,452,433
050,29,029,"Missouri","Camden County",2,65,864,435,429
050,29,029,"Missouri","Camden County",2,66,828,416,412
050,29,029,"Missouri","Camden County",2,67,827,417,410
050,29,029,"Missouri","Camden County",2,68,818,403,415
050,29,029,"Missouri","Camden County",2,69,779,387,392
050,29,029,"Missouri","Camden County",2,70,738,370,368
050,29,029,"Missouri","Camden County",2,71,763,379,384
050,29,029,"Missouri","Camden County",2,72,771,394,377
050,29,029,"Missouri","Camden County",2,73,809,413,396
050,29,029,"Missouri","Camden County",2,74,547,277,270
050,29,029,"Missouri","Camden County",2,75,521,281,240
050,29,029,"Missouri","Camden County",2,76,516,273,243
050,29,029,"Missouri","Camden County",2,77,527,269,258
050,29,029,"Missouri","Camden County",2,78,419,222,197
050,29,029,"Missouri","Camden County",2,79,339,185,154
050,29,029,"Missouri","Camden County",2,80,324,165,159
050,29,029,"Missouri","Camden County",2,81,285,147,138
050,29,029,"Missouri","Camden County",2,82,255,131,124
050,29,029,"Missouri","Camden County",2,83,229,114,115
050,29,029,"Missouri","Camden County",2,84,203,103,100
050,29,029,"Missouri","Camden County",2,85,962,406,556
050,29,029,"Missouri","Camden County",3,0,381,202,179
050,29,029,"Missouri","Camden County",3,1,350,173,177
050,29,029,"Missouri","Camden County",3,2,371,194,177
050,29,029,"Missouri","Camden County",3,3,346,181,165
050,29,029,"Missouri","Camden County",3,4,350,172,178
050,29,029,"Missouri","Camden County",3,5,377,194,183
050,29,029,"Missouri","Camden County",3,6,380,202,178
050,29,029,"Missouri","Camden County",3,7,399,195,204
050,29,029,"Missouri","Camden County",3,8,367,183,184
050,29,029,"Missouri","Camden County",3,9,416,215,201
050,29,029,"Missouri","Camden County",3,10,415,211,204
050,29,029,"Missouri","Camden County",3,11,429,232,197
050,29,029,"Missouri","Camden County",3,12,456,231,225
050,29,029,"Missouri","Camden County",3,13,492,229,263
050,29,029,"Missouri","Camden County",3,14,473,241,232
050,29,029,"Missouri","Camden County",3,15,512,249,263
050,29,029,"Missouri","Camden County",3,16,502,263,239
050,29,029,"Missouri","Camden County",3,17,514,274,240
050,29,029,"Missouri","Camden County",3,18,447,229,218
050,29,029,"Missouri","Camden County",3,19,342,180,162
050,29,029,"Missouri","Camden County",3,20,332,172,160
050,29,029,"Missouri","Camden County",3,21,361,196,165
050,29,029,"Missouri","Camden County",3,22,370,189,181
050,29,029,"Missouri","Camden County",3,23,348,172,176
050,29,029,"Missouri","Camden County",3,24,369,170,199
050,29,029,"Missouri","Camden County",3,25,365,198,167
050,29,029,"Missouri","Camden County",3,26,353,196,157
050,29,029,"Missouri","Camden County",3,27,333,168,165
050,29,029,"Missouri","Camden County",3,28,357,182,175
050,29,029,"Missouri","Camden County",3,29,376,186,190
050,29,029,"Missouri","Camden County",3,30,393,198,195
050,29,029,"Missouri","Camden County",3,31,376,193,183
050,29,029,"Missouri","Camden County",3,32,390,191,199
050,29,029,"Missouri","Camden County",3,33,395,194,201
050,29,029,"Missouri","Camden County",3,34,371,188,183
050,29,029,"Missouri","Camden County",3,35,398,196,202
050,29,029,"Missouri","Camden County",3,36,424,203,221
050,29,029,"Missouri","Camden County",3,37,427,210,217
050,29,029,"Missouri","Camden County",3,38,432,213,219
050,29,029,"Missouri","Camden County",3,39,427,204,223
050,29,029,"Missouri","Camden County",3,40,404,200,204
050,29,029,"Missouri","Camden County",3,41,462,217,245
050,29,029,"Missouri","Camden County",3,42,446,223,223
050,29,029,"Missouri","Camden County",3,43,441,224,217
050,29,029,"Missouri","Camden County",3,44,422,211,211
050,29,029,"Missouri","Camden County",3,45,432,212,220
050,29,029,"Missouri","Camden County",3,46,406,208,198
050,29,029,"Missouri","Camden County",3,47,412,196,216
050,29,029,"Missouri","Camden County",3,48,439,208,231
050,29,029,"Missouri","Camden County",3,49,466,226,240
050,29,029,"Missouri","Camden County",3,50,527,273,254
050,29,029,"Missouri","Camden County",3,51,533,256,277
050,29,029,"Missouri","Camden County",3,52,541,251,290
050,29,029,"Missouri","Camden County",3,53,536,266,270
050,29,029,"Missouri","Camden County",3,54,555,291,264
050,29,029,"Missouri","Camden County",3,55,607,298,309
050,29,029,"Missouri","Camden County",3,56,675,323,352
050,29,029,"Missouri","Camden County",3,57,740,351,389
050,29,029,"Missouri","Camden County",3,58,741,354,387
050,29,029,"Missouri","Camden County",3,59,785,378,407
050,29,029,"Missouri","Camden County",3,60,842,412,430
050,29,029,"Missouri","Camden County",3,61,833,413,420
050,29,029,"Missouri","Camden County",3,62,859,410,449
050,29,029,"Missouri","Camden County",3,63,895,431,464
050,29,029,"Missouri","Camden County",3,64,932,456,476
050,29,029,"Missouri","Camden County",3,65,916,459,457
050,29,029,"Missouri","Camden County",3,66,866,448,418
050,29,029,"Missouri","Camden County",3,67,823,402,421
050,29,029,"Missouri","Camden County",3,68,829,424,405
050,29,029,"Missouri","Camden County",3,69,815,402,413
050,29,029,"Missouri","Camden County",3,70,761,382,379
050,29,029,"Missouri","Camden County",3,71,708,353,355
050,29,029,"Missouri","Camden County",3,72,766,391,375
050,29,029,"Missouri","Camden County",3,73,747,374,373
050,29,029,"Missouri","Camden County",3,74,756,381,375
050,29,029,"Missouri","Camden County",3,75,510,263,247
050,29,029,"Missouri","Camden County",3,76,486,259,227
050,29,029,"Missouri","Camden County",3,77,490,255,235
050,29,029,"Missouri","Camden County",3,78,493,249,244
050,29,029,"Missouri","Camden County",3,79,388,199,189
050,29,029,"Missouri","Camden County",3,80,314,166,148
050,29,029,"Missouri","Camden County",3,81,303,148,155
050,29,029,"Missouri","Camden County",3,82,265,135,130
050,29,029,"Missouri","Camden County",3,83,228,120,108
050,29,029,"Missouri","Camden County",3,84,204,101,103
050,29,029,"Missouri","Camden County",3,85,992,439,553
050,29,029,"Missouri","Camden County",4,0,380,202,178
050,29,029,"Missouri","Camden County",4,1,383,201,182
050,29,029,"Missouri","Camden County",4,2,346,172,174
050,29,029,"Missouri","Camden County",4,3,363,191,172
050,29,029,"Missouri","Camden County",4,4,347,173,174
050,29,029,"Missouri","Camden County",4,5,346,166,180
050,29,029,"Missouri","Camden County",4,6,371,191,180
050,29,029,"Missouri","Camden County",4,7,394,210,184
050,29,029,"Missouri","Camden County",4,8,414,201,213
050,29,029,"Missouri","Camden County",4,9,376,190,186
050,29,029,"Missouri","Camden County",4,10,428,220,208
050,29,029,"Missouri","Camden County",4,11,419,220,199
050,29,029,"Missouri","Camden County",4,12,452,234,218
050,29,029,"Missouri","Camden County",4,13,467,244,223
050,29,029,"Missouri","Camden County",4,14,510,253,257
050,29,029,"Missouri","Camden County",4,15,505,245,260
050,29,029,"Missouri","Camden County",4,16,508,268,240
050,29,029,"Missouri","Camden County",4,17,480,247,233
050,29,029,"Missouri","Camden County",4,18,439,241,198
050,29,029,"Missouri","Camden County",4,19,334,177,157
050,29,029,"Missouri","Camden County",4,20,357,184,173
050,29,029,"Missouri","Camden County",4,21,350,175,175
050,29,029,"Missouri","Camden County",4,22,365,188,177
050,29,029,"Missouri","Camden County",4,23,361,180,181
050,29,029,"Missouri","Camden County",4,24,339,167,172
050,29,029,"Missouri","Camden County",4,25,335,162,173
050,29,029,"Missouri","Camden County",4,26,369,198,171
050,29,029,"Missouri","Camden County",4,27,362,184,178
050,29,029,"Missouri","Camden County",4,28,341,167,174
050,29,029,"Missouri","Camden County",4,29,371,196,175
050,29,029,"Missouri","Camden County",4,30,370,183,187
050,29,029,"Missouri","Camden County",4,31,393,192,201
050,29,029,"Missouri","Camden County",4,32,409,212,197
050,29,029,"Missouri","Camden County",4,33,386,190,196
050,29,029,"Missouri","Camden County",4,34,414,202,212
050,29,029,"Missouri","Camden County",4,35,375,189,186
050,29,029,"Missouri","Camden County",4,36,422,212,210
050,29,029,"Missouri","Camden County",4,37,429,207,222
050,29,029,"Missouri","Camden County",4,38,414,204,210
050,29,029,"Missouri","Camden County",4,39,433,205,228
050,29,029,"Missouri","Camden County",4,40,431,204,227
050,29,029,"Missouri","Camden County",4,41,415,207,208
050,29,029,"Missouri","Camden County",4,42,464,215,249
050,29,029,"Missouri","Camden County",4,43,454,231,223
050,29,029,"Missouri","Camden County",4,44,438,219,219
050,29,029,"Missouri","Camden County",4,45,450,213,237
050,29,029,"Missouri","Camden County",4,46,445,210,235
050,29,029,"Missouri","Camden County",4,47,423,221,202
050,29,029,"Missouri","Camden County",4,48,436,206,230
050,29,029,"Missouri","Camden County",4,49,451,226,225
050,29,029,"Missouri","Camden County",4,50,481,234,247
050,29,029,"Missouri","Camden County",4,51,543,281,262
050,29,029,"Missouri","Camden County",4,52,552,272,280
050,29,029,"Missouri","Camden County",4,53,568,256,312
050,29,029,"Missouri","Camden County",4,54,546,267,279
050,29,029,"Missouri","Camden County",4,55,586,289,297
050,29,029,"Missouri","Camden County",4,56,645,316,329
050,29,029,"Missouri","Camden County",4,57,682,323,359
050,29,029,"Missouri","Camden County",4,58,793,368,425
050,29,029,"Missouri","Camden County",4,59,761,369,392
050,29,029,"Missouri","Camden County",4,60,787,382,405
050,29,029,"Missouri","Camden County",4,61,876,426,450
050,29,029,"Missouri","Camden County",4,62,867,443,424
050,29,029,"Missouri","Camden County",4,63,877,419,458
050,29,029,"Missouri","Camden County",4,64,912,442,470
050,29,029,"Missouri","Camden County",4,65,934,465,469
050,29,029,"Missouri","Camden County",4,66,932,480,452
050,29,029,"Missouri","Camden County",4,67,864,444,420
050,29,029,"Missouri","Camden County",4,68,813,400,413
050,29,029,"Missouri","Camden County",4,69,816,423,393
050,29,029,"Missouri","Camden County",4,70,782,395,387
050,29,029,"Missouri","Camden County",4,71,748,373,375
050,29,029,"Missouri","Camden County",4,72,699,353,346
050,29,029,"Missouri","Camden County",4,73,743,376,367
050,29,029,"Missouri","Camden County",4,74,697,355,342
050,29,029,"Missouri","Camden County",4,75,716,365,351
050,29,029,"Missouri","Camden County",4,76,474,240,234
050,29,029,"Missouri","Camden County",4,77,457,241,216
050,29,029,"Missouri","Camden County",4,78,464,242,222
050,29,029,"Missouri","Camden County",4,79,460,238,222
050,29,029,"Missouri","Camden County",4,80,363,182,181
050,29,029,"Missouri","Camden County",4,81,289,152,137
050,29,029,"Missouri","Camden County",4,82,274,136,138
050,29,029,"Missouri","Camden County",4,83,247,128,119
050,29,029,"Missouri","Camden County",4,84,207,111,96
050,29,029,"Missouri","Camden County",4,85,1041,476,565
050,29,029,"Missouri","Camden County",5,0,384,203,181
050,29,029,"Missouri","Camden County",5,1,406,206,200
050,29,029,"Missouri","Camden County",5,2,369,191,178
050,29,029,"Missouri","Camden County",5,3,337,165,172
050,29,029,"Missouri","Camden County",5,4,370,186,184
050,29,029,"Missouri","Camden County",5,5,343,178,165
050,29,029,"Missouri","Camden County",5,6,339,167,172
050,29,029,"Missouri","Camden County",5,7,383,200,183
050,29,029,"Missouri","Camden County",5,8,405,221,184
050,29,029,"Missouri","Camden County",5,9,405,198,207
050,29,029,"Missouri","Camden County",5,10,377,188,189
050,29,029,"Missouri","Camden County",5,11,424,211,213
050,29,029,"Missouri","Camden County",5,12,439,222,217
050,29,029,"Missouri","Camden County",5,13,449,233,216
050,29,029,"Missouri","Camden County",5,14,482,258,224
050,29,029,"Missouri","Camden County",5,15,527,253,274
050,29,029,"Missouri","Camden County",5,16,517,260,257
050,29,029,"Missouri","Camden County",5,17,490,262,228
050,29,029,"Missouri","Camden County",5,18,426,226,200
050,29,029,"Missouri","Camden County",5,19,336,187,149
050,29,029,"Missouri","Camden County",5,20,374,188,186
050,29,029,"Missouri","Camden County",5,21,382,189,193
050,29,029,"Missouri","Camden County",5,22,388,184,204
050,29,029,"Missouri","Camden County",5,23,372,193,179
050,29,029,"Missouri","Camden County",5,24,369,192,177
050,29,029,"Missouri","Camden County",5,25,344,171,173
050,29,029,"Missouri","Camden County",5,26,331,162,169
050,29,029,"Missouri","Camden County",5,27,366,191,175
050,29,029,"Missouri","Camden County",5,28,371,184,187
050,29,029,"Missouri","Camden County",5,29,329,164,165
050,29,029,"Missouri","Camden County",5,30,346,186,160
050,29,029,"Missouri","Camden County",5,31,381,196,185
050,29,029,"Missouri","Camden County",5,32,413,203,210
050,29,029,"Missouri","Camden County",5,33,411,216,195
050,29,029,"Missouri","Camden County",5,34,394,191,203
050,29,029,"Missouri","Camden County",5,35,420,211,209
050,29,029,"Missouri","Camden County",5,36,386,193,193
050,29,029,"Missouri","Camden County",5,37,417,206,211
050,29,029,"Missouri","Camden County",5,38,424,197,227
050,29,029,"Missouri","Camden County",5,39,411,200,211
050,29,029,"Missouri","Camden County",5,40,412,195,217
050,29,029,"Missouri","Camden County",5,41,425,213,212
050,29,029,"Missouri","Camden County",5,42,413,203,210
050,29,029,"Missouri","Camden County",5,43,465,217,248
050,29,029,"Missouri","Camden County",5,44,458,240,218
050,29,029,"Missouri","Camden County",5,45,454,233,221
050,29,029,"Missouri","Camden County",5,46,463,217,246
050,29,029,"Missouri","Camden County",5,47,473,222,251
050,29,029,"Missouri","Camden County",5,48,440,219,221
050,29,029,"Missouri","Camden County",5,49,457,218,239
050,29,029,"Missouri","Camden County",5,50,470,237,233
050,29,029,"Missouri","Camden County",5,51,500,242,258
050,29,029,"Missouri","Camden County",5,52,561,289,272
050,29,029,"Missouri","Camden County",5,53,596,298,298
050,29,029,"Missouri","Camden County",5,54,592,266,326
050,29,029,"Missouri","Camden County",5,55,582,283,299
050,29,029,"Missouri","Camden County",5,56,584,294,290
050,29,029,"Missouri","Camden County",5,57,660,318,342
050,29,029,"Missouri","Camden County",5,58,697,337,360
050,29,029,"Missouri","Camden County",5,59,804,380,424
050,29,029,"Missouri","Camden County",5,60,800,390,410
050,29,029,"Missouri","Camden County",5,61,805,378,427
050,29,029,"Missouri","Camden County",5,62,886,434,452
050,29,029,"Missouri","Camden County",5,63,894,469,425
050,29,029,"Missouri","Camden County",5,64,886,422,464
050,29,029,"Missouri","Camden County",5,65,925,445,480
050,29,029,"Missouri","Camden County",5,66,945,469,476
050,29,029,"Missouri","Camden County",5,67,940,479,461
050,29,029,"Missouri","Camden County",5,68,854,445,409
050,29,029,"Missouri","Camden County",5,69,796,394,402
050,29,029,"Missouri","Camden County",5,70,781,408,373
050,29,029,"Missouri","Camden County",5,71,763,373,390
050,29,029,"Missouri","Camden County",5,72,726,365,361
050,29,029,"Missouri","Camden County",5,73,679,342,337
050,29,029,"Missouri","Camden County",5,74,714,364,350
050,29,029,"Missouri","Camden County",5,75,666,338,328
050,29,029,"Missouri","Camden County",5,76,686,357,329
050,29,029,"Missouri","Camden County",5,77,461,233,228
050,29,029,"Missouri","Camden County",5,78,431,227,204
050,29,029,"Missouri","Camden County",5,79,419,214,205
050,29,029,"Missouri","Camden County",5,80,437,222,215
050,29,029,"Missouri","Camden County",5,81,340,172,168
050,29,029,"Missouri","Camden County",5,82,266,141,125
050,29,029,"Missouri","Camden County",5,83,249,122,127
050,29,029,"Missouri","Camden County",5,84,226,121,105
050,29,029,"Missouri","Camden County",5,85,1126,536,590
050,29,031,"Missouri","Cape Girardeau County",1,0,886,455,431
050,29,031,"Missouri","Cape Girardeau County",1,1,928,464,464
050,29,031,"Missouri","Cape Girardeau County",1,2,968,508,460
050,29,031,"Missouri","Cape Girardeau County",1,3,978,494,484
050,29,031,"Missouri","Cape Girardeau County",1,4,965,493,472
050,29,031,"Missouri","Cape Girardeau County",1,5,956,503,453
050,29,031,"Missouri","Cape Girardeau County",1,6,935,458,477
050,29,031,"Missouri","Cape Girardeau County",1,7,936,487,449
050,29,031,"Missouri","Cape Girardeau County",1,8,926,489,437
050,29,031,"Missouri","Cape Girardeau County",1,9,964,516,448
050,29,031,"Missouri","Cape Girardeau County",1,10,996,525,471
050,29,031,"Missouri","Cape Girardeau County",1,11,1023,530,493
050,29,031,"Missouri","Cape Girardeau County",1,12,1059,548,511
050,29,031,"Missouri","Cape Girardeau County",1,13,1080,556,524
050,29,031,"Missouri","Cape Girardeau County",1,14,1019,512,507
050,29,031,"Missouri","Cape Girardeau County",1,15,980,502,478
050,29,031,"Missouri","Cape Girardeau County",1,16,1025,501,524
050,29,031,"Missouri","Cape Girardeau County",1,17,983,479,504
050,29,031,"Missouri","Cape Girardeau County",1,18,1167,551,616
050,29,031,"Missouri","Cape Girardeau County",1,19,1896,828,1068
050,29,031,"Missouri","Cape Girardeau County",1,20,1911,827,1084
050,29,031,"Missouri","Cape Girardeau County",1,21,1799,822,977
050,29,031,"Missouri","Cape Girardeau County",1,22,1709,820,889
050,29,031,"Missouri","Cape Girardeau County",1,23,1482,801,681
050,29,031,"Missouri","Cape Girardeau County",1,24,1187,585,602
050,29,031,"Missouri","Cape Girardeau County",1,25,1117,566,551
050,29,031,"Missouri","Cape Girardeau County",1,26,1055,545,510
050,29,031,"Missouri","Cape Girardeau County",1,27,1026,511,515
050,29,031,"Missouri","Cape Girardeau County",1,28,1067,542,525
050,29,031,"Missouri","Cape Girardeau County",1,29,1080,557,523
050,29,031,"Missouri","Cape Girardeau County",1,30,981,505,476
050,29,031,"Missouri","Cape Girardeau County",1,31,981,463,518
050,29,031,"Missouri","Cape Girardeau County",1,32,983,482,501
050,29,031,"Missouri","Cape Girardeau County",1,33,980,486,494
050,29,031,"Missouri","Cape Girardeau County",1,34,1045,528,517
050,29,031,"Missouri","Cape Girardeau County",1,35,1005,488,517
050,29,031,"Missouri","Cape Girardeau County",1,36,1007,515,492
050,29,031,"Missouri","Cape Girardeau County",1,37,1004,511,493
050,29,031,"Missouri","Cape Girardeau County",1,38,991,492,499
050,29,031,"Missouri","Cape Girardeau County",1,39,1000,483,517
050,29,031,"Missouri","Cape Girardeau County",1,40,979,488,491
050,29,031,"Missouri","Cape Girardeau County",1,41,925,459,466
050,29,031,"Missouri","Cape Girardeau County",1,42,912,484,428
050,29,031,"Missouri","Cape Girardeau County",1,43,880,461,419
050,29,031,"Missouri","Cape Girardeau County",1,44,829,406,423
050,29,031,"Missouri","Cape Girardeau County",1,45,844,416,428
050,29,031,"Missouri","Cape Girardeau County",1,46,872,436,436
050,29,031,"Missouri","Cape Girardeau County",1,47,880,450,430
050,29,031,"Missouri","Cape Girardeau County",1,48,945,483,462
050,29,031,"Missouri","Cape Girardeau County",1,49,971,482,489
050,29,031,"Missouri","Cape Girardeau County",1,50,908,450,458
050,29,031,"Missouri","Cape Girardeau County",1,51,856,425,431
050,29,031,"Missouri","Cape Girardeau County",1,52,852,420,432
050,29,031,"Missouri","Cape Girardeau County",1,53,914,446,468
050,29,031,"Missouri","Cape Girardeau County",1,54,922,442,480
050,29,031,"Missouri","Cape Girardeau County",1,55,968,471,497
050,29,031,"Missouri","Cape Girardeau County",1,56,1008,531,477
050,29,031,"Missouri","Cape Girardeau County",1,57,1007,521,486
050,29,031,"Missouri","Cape Girardeau County",1,58,1017,506,511
050,29,031,"Missouri","Cape Girardeau County",1,59,1060,508,552
050,29,031,"Missouri","Cape Girardeau County",1,60,1025,502,523
050,29,031,"Missouri","Cape Girardeau County",1,61,1053,531,522
050,29,031,"Missouri","Cape Girardeau County",1,62,1034,508,526
050,29,031,"Missouri","Cape Girardeau County",1,63,988,491,497
050,29,031,"Missouri","Cape Girardeau County",1,64,975,451,524
050,29,031,"Missouri","Cape Girardeau County",1,65,919,437,482
050,29,031,"Missouri","Cape Girardeau County",1,66,882,411,471
050,29,031,"Missouri","Cape Girardeau County",1,67,926,430,496
050,29,031,"Missouri","Cape Girardeau County",1,68,948,451,497
050,29,031,"Missouri","Cape Girardeau County",1,69,819,389,430
050,29,031,"Missouri","Cape Girardeau County",1,70,774,379,395
050,29,031,"Missouri","Cape Girardeau County",1,71,747,362,385
050,29,031,"Missouri","Cape Girardeau County",1,72,715,337,378
050,29,031,"Missouri","Cape Girardeau County",1,73,724,327,397
050,29,031,"Missouri","Cape Girardeau County",1,74,515,241,274
050,29,031,"Missouri","Cape Girardeau County",1,75,532,253,279
050,29,031,"Missouri","Cape Girardeau County",1,76,560,242,318
050,29,031,"Missouri","Cape Girardeau County",1,77,523,229,294
050,29,031,"Missouri","Cape Girardeau County",1,78,412,161,251
050,29,031,"Missouri","Cape Girardeau County",1,79,410,165,245
050,29,031,"Missouri","Cape Girardeau County",1,80,385,164,221
050,29,031,"Missouri","Cape Girardeau County",1,81,368,146,222
050,29,031,"Missouri","Cape Girardeau County",1,82,356,156,200
050,29,031,"Missouri","Cape Girardeau County",1,83,298,124,174
050,29,031,"Missouri","Cape Girardeau County",1,84,325,133,192
050,29,031,"Missouri","Cape Girardeau County",1,85,1868,623,1245
050,29,031,"Missouri","Cape Girardeau County",2,0,905,464,441
050,29,031,"Missouri","Cape Girardeau County",2,1,920,464,456
050,29,031,"Missouri","Cape Girardeau County",2,2,966,501,465
050,29,031,"Missouri","Cape Girardeau County",2,3,977,498,479
050,29,031,"Missouri","Cape Girardeau County",2,4,971,494,477
050,29,031,"Missouri","Cape Girardeau County",2,5,960,498,462
050,29,031,"Missouri","Cape Girardeau County",2,6,944,469,475
050,29,031,"Missouri","Cape Girardeau County",2,7,936,480,456
050,29,031,"Missouri","Cape Girardeau County",2,8,927,485,442
050,29,031,"Missouri","Cape Girardeau County",2,9,951,505,446
050,29,031,"Missouri","Cape Girardeau County",2,10,986,522,464
050,29,031,"Missouri","Cape Girardeau County",2,11,1012,526,486
050,29,031,"Missouri","Cape Girardeau County",2,12,1054,545,509
050,29,031,"Missouri","Cape Girardeau County",2,13,1072,553,519
050,29,031,"Missouri","Cape Girardeau County",2,14,1031,522,509
050,29,031,"Missouri","Cape Girardeau County",2,15,993,507,486
050,29,031,"Missouri","Cape Girardeau County",2,16,1013,500,513
050,29,031,"Missouri","Cape Girardeau County",2,17,1002,488,514
050,29,031,"Missouri","Cape Girardeau County",2,18,1164,549,615
050,29,031,"Missouri","Cape Girardeau County",2,19,1892,821,1071
050,29,031,"Missouri","Cape Girardeau County",2,20,1927,832,1095
050,29,031,"Missouri","Cape Girardeau County",2,21,1802,828,974
050,29,031,"Missouri","Cape Girardeau County",2,22,1698,809,889
050,29,031,"Missouri","Cape Girardeau County",2,23,1484,798,686
050,29,031,"Missouri","Cape Girardeau County",2,24,1188,586,602
050,29,031,"Missouri","Cape Girardeau County",2,25,1118,564,554
050,29,031,"Missouri","Cape Girardeau County",2,26,1062,545,517
050,29,031,"Missouri","Cape Girardeau County",2,27,1016,508,508
050,29,031,"Missouri","Cape Girardeau County",2,28,1064,539,525
050,29,031,"Missouri","Cape Girardeau County",2,29,1080,553,527
050,29,031,"Missouri","Cape Girardeau County",2,30,1014,522,492
050,29,031,"Missouri","Cape Girardeau County",2,31,983,473,510
050,29,031,"Missouri","Cape Girardeau County",2,32,989,483,506
050,29,031,"Missouri","Cape Girardeau County",2,33,981,485,496
050,29,031,"Missouri","Cape Girardeau County",2,34,1032,522,510
050,29,031,"Missouri","Cape Girardeau County",2,35,1019,501,518
050,29,031,"Missouri","Cape Girardeau County",2,36,1003,511,492
050,29,031,"Missouri","Cape Girardeau County",2,37,1004,511,493
050,29,031,"Missouri","Cape Girardeau County",2,38,1000,499,501
050,29,031,"Missouri","Cape Girardeau County",2,39,994,486,508
050,29,031,"Missouri","Cape Girardeau County",2,40,990,490,500
050,29,031,"Missouri","Cape Girardeau County",2,41,933,462,471
050,29,031,"Missouri","Cape Girardeau County",2,42,914,480,434
050,29,031,"Missouri","Cape Girardeau County",2,43,891,468,423
050,29,031,"Missouri","Cape Girardeau County",2,44,834,413,421
050,29,031,"Missouri","Cape Girardeau County",2,45,849,418,431
050,29,031,"Missouri","Cape Girardeau County",2,46,870,434,436
050,29,031,"Missouri","Cape Girardeau County",2,47,869,441,428
050,29,031,"Missouri","Cape Girardeau County",2,48,930,476,454
050,29,031,"Missouri","Cape Girardeau County",2,49,964,480,484
050,29,031,"Missouri","Cape Girardeau County",2,50,931,462,469
050,29,031,"Missouri","Cape Girardeau County",2,51,864,426,438
050,29,031,"Missouri","Cape Girardeau County",2,52,847,417,430
050,29,031,"Missouri","Cape Girardeau County",2,53,905,443,462
050,29,031,"Missouri","Cape Girardeau County",2,54,913,440,473
050,29,031,"Missouri","Cape Girardeau County",2,55,956,464,492
050,29,031,"Missouri","Cape Girardeau County",2,56,996,515,481
050,29,031,"Missouri","Cape Girardeau County",2,57,1001,517,484
050,29,031,"Missouri","Cape Girardeau County",2,58,1019,513,506
050,29,031,"Missouri","Cape Girardeau County",2,59,1057,511,546
050,29,031,"Missouri","Cape Girardeau County",2,60,1022,500,522
050,29,031,"Missouri","Cape Girardeau County",2,61,1039,517,522
050,29,031,"Missouri","Cape Girardeau County",2,62,1037,514,523
050,29,031,"Missouri","Cape Girardeau County",2,63,1010,501,509
050,29,031,"Missouri","Cape Girardeau County",2,64,966,455,511
050,29,031,"Missouri","Cape Girardeau County",2,65,926,435,491
050,29,031,"Missouri","Cape Girardeau County",2,66,889,419,470
050,29,031,"Missouri","Cape Girardeau County",2,67,909,421,488
050,29,031,"Missouri","Cape Girardeau County",2,68,933,440,493
050,29,031,"Missouri","Cape Girardeau County",2,69,848,404,444
050,29,031,"Missouri","Cape Girardeau County",2,70,784,380,404
050,29,031,"Missouri","Cape Girardeau County",2,71,756,367,389
050,29,031,"Missouri","Cape Girardeau County",2,72,710,336,374
050,29,031,"Missouri","Cape Girardeau County",2,73,757,344,413
050,29,031,"Missouri","Cape Girardeau County",2,74,529,245,284
050,29,031,"Missouri","Cape Girardeau County",2,75,526,252,274
050,29,031,"Missouri","Cape Girardeau County",2,76,541,237,304
050,29,031,"Missouri","Cape Girardeau County",2,77,541,239,302
050,29,031,"Missouri","Cape Girardeau County",2,78,424,171,253
050,29,031,"Missouri","Cape Girardeau County",2,79,405,165,240
050,29,031,"Missouri","Cape Girardeau County",2,80,386,162,224
050,29,031,"Missouri","Cape Girardeau County",2,81,371,148,223
050,29,031,"Missouri","Cape Girardeau County",2,82,347,149,198
050,29,031,"Missouri","Cape Girardeau County",2,83,306,128,178
050,29,031,"Missouri","Cape Girardeau County",2,84,313,129,184
050,29,031,"Missouri","Cape Girardeau County",2,85,1879,628,1251
050,29,031,"Missouri","Cape Girardeau County",3,0,865,449,416
050,29,031,"Missouri","Cape Girardeau County",3,1,911,459,452
050,29,031,"Missouri","Cape Girardeau County",3,2,922,478,444
050,29,031,"Missouri","Cape Girardeau County",3,3,956,496,460
050,29,031,"Missouri","Cape Girardeau County",3,4,963,494,469
050,29,031,"Missouri","Cape Girardeau County",3,5,981,496,485
050,29,031,"Missouri","Cape Girardeau County",3,6,988,520,468
050,29,031,"Missouri","Cape Girardeau County",3,7,942,483,459
050,29,031,"Missouri","Cape Girardeau County",3,8,959,489,470
050,29,031,"Missouri","Cape Girardeau County",3,9,955,504,451
050,29,031,"Missouri","Cape Girardeau County",3,10,967,513,454
050,29,031,"Missouri","Cape Girardeau County",3,11,981,526,455
050,29,031,"Missouri","Cape Girardeau County",3,12,1002,526,476
050,29,031,"Missouri","Cape Girardeau County",3,13,1046,543,503
050,29,031,"Missouri","Cape Girardeau County",3,14,1075,546,529
050,29,031,"Missouri","Cape Girardeau County",3,15,1034,528,506
050,29,031,"Missouri","Cape Girardeau County",3,16,994,503,491
050,29,031,"Missouri","Cape Girardeau County",3,17,1031,514,517
050,29,031,"Missouri","Cape Girardeau County",3,18,1190,558,632
050,29,031,"Missouri","Cape Girardeau County",3,19,1869,802,1067
050,29,031,"Missouri","Cape Girardeau County",3,20,1903,811,1092
050,29,031,"Missouri","Cape Girardeau County",3,21,1828,852,976
050,29,031,"Missouri","Cape Girardeau County",3,22,1687,795,892
050,29,031,"Missouri","Cape Girardeau County",3,23,1491,793,698
050,29,031,"Missouri","Cape Girardeau County",3,24,1181,591,590
050,29,031,"Missouri","Cape Girardeau County",3,25,1101,563,538
050,29,031,"Missouri","Cape Girardeau County",3,26,1062,537,525
050,29,031,"Missouri","Cape Girardeau County",3,27,1024,510,514
050,29,031,"Missouri","Cape Girardeau County",3,28,1038,532,506
050,29,031,"Missouri","Cape Girardeau County",3,29,1067,526,541
050,29,031,"Missouri","Cape Girardeau County",3,30,1064,565,499
050,29,031,"Missouri","Cape Girardeau County",3,31,1030,509,521
050,29,031,"Missouri","Cape Girardeau County",3,32,998,487,511
050,29,031,"Missouri","Cape Girardeau County",3,33,1003,492,511
050,29,031,"Missouri","Cape Girardeau County",3,34,1029,516,513
050,29,031,"Missouri","Cape Girardeau County",3,35,1049,526,523
050,29,031,"Missouri","Cape Girardeau County",3,36,1026,511,515
050,29,031,"Missouri","Cape Girardeau County",3,37,983,495,488
050,29,031,"Missouri","Cape Girardeau County",3,38,1014,516,498
050,29,031,"Missouri","Cape Girardeau County",3,39,973,475,498
050,29,031,"Missouri","Cape Girardeau County",3,40,1003,503,500
050,29,031,"Missouri","Cape Girardeau County",3,41,994,501,493
050,29,031,"Missouri","Cape Girardeau County",3,42,953,480,473
050,29,031,"Missouri","Cape Girardeau County",3,43,927,481,446
050,29,031,"Missouri","Cape Girardeau County",3,44,884,466,418
050,29,031,"Missouri","Cape Girardeau County",3,45,825,397,428
050,29,031,"Missouri","Cape Girardeau County",3,46,873,431,442
050,29,031,"Missouri","Cape Girardeau County",3,47,855,432,423
050,29,031,"Missouri","Cape Girardeau County",3,48,901,461,440
050,29,031,"Missouri","Cape Girardeau County",3,49,913,455,458
050,29,031,"Missouri","Cape Girardeau County",3,50,989,504,485
050,29,031,"Missouri","Cape Girardeau County",3,51,919,455,464
050,29,031,"Missouri","Cape Girardeau County",3,52,858,425,433
050,29,031,"Missouri","Cape Girardeau County",3,53,879,429,450
050,29,031,"Missouri","Cape Girardeau County",3,54,901,439,462
050,29,031,"Missouri","Cape Girardeau County",3,55,908,431,477
050,29,031,"Missouri","Cape Girardeau County",3,56,951,468,483
050,29,031,"Missouri","Cape Girardeau County",3,57,980,505,475
050,29,031,"Missouri","Cape Girardeau County",3,58,999,512,487
050,29,031,"Missouri","Cape Girardeau County",3,59,1025,521,504
050,29,031,"Missouri","Cape Girardeau County",3,60,1042,511,531
050,29,031,"Missouri","Cape Girardeau County",3,61,1022,493,529
050,29,031,"Missouri","Cape Girardeau County",3,62,1022,515,507
050,29,031,"Missouri","Cape Girardeau County",3,63,1056,525,531
050,29,031,"Missouri","Cape Girardeau County",3,64,1000,488,512
050,29,031,"Missouri","Cape Girardeau County",3,65,936,436,500
050,29,031,"Missouri","Cape Girardeau County",3,66,914,436,478
050,29,031,"Missouri","Cape Girardeau County",3,67,885,413,472
050,29,031,"Missouri","Cape Girardeau County",3,68,892,408,484
050,29,031,"Missouri","Cape Girardeau County",3,69,893,419,474
050,29,031,"Missouri","Cape Girardeau County",3,70,826,391,435
050,29,031,"Missouri","Cape Girardeau County",3,71,761,363,398
050,29,031,"Missouri","Cape Girardeau County",3,72,737,361,376
050,29,031,"Missouri","Cape Girardeau County",3,73,693,318,375
050,29,031,"Missouri","Cape Girardeau County",3,74,743,331,412
050,29,031,"Missouri","Cape Girardeau County",3,75,505,237,268
050,29,031,"Missouri","Cape Girardeau County",3,76,517,236,281
050,29,031,"Missouri","Cape Girardeau County",3,77,529,230,299
050,29,031,"Missouri","Cape Girardeau County",3,78,495,212,283
050,29,031,"Missouri","Cape Girardeau County",3,79,400,159,241
050,29,031,"Missouri","Cape Girardeau County",3,80,379,158,221
050,29,031,"Missouri","Cape Girardeau County",3,81,386,147,239
050,29,031,"Missouri","Cape Girardeau County",3,82,343,143,200
050,29,031,"Missouri","Cape Girardeau County",3,83,307,125,182
050,29,031,"Missouri","Cape Girardeau County",3,84,297,128,169
050,29,031,"Missouri","Cape Girardeau County",3,85,1833,618,1215
050,29,031,"Missouri","Cape Girardeau County",4,0,895,481,414
050,29,031,"Missouri","Cape Girardeau County",4,1,889,461,428
050,29,031,"Missouri","Cape Girardeau County",4,2,928,462,466
050,29,031,"Missouri","Cape Girardeau County",4,3,953,490,463
050,29,031,"Missouri","Cape Girardeau County",4,4,968,503,465
050,29,031,"Missouri","Cape Girardeau County",4,5,963,479,484
050,29,031,"Missouri","Cape Girardeau County",4,6,986,503,483
050,29,031,"Missouri","Cape Girardeau County",4,7,1009,513,496
050,29,031,"Missouri","Cape Girardeau County",4,8,965,502,463
050,29,031,"Missouri","Cape Girardeau County",4,9,972,504,468
050,29,031,"Missouri","Cape Girardeau County",4,10,954,499,455
050,29,031,"Missouri","Cape Girardeau County",4,11,983,520,463
050,29,031,"Missouri","Cape Girardeau County",4,12,1001,542,459
050,29,031,"Missouri","Cape Girardeau County",4,13,1016,540,476
050,29,031,"Missouri","Cape Girardeau County",4,14,1058,544,514
050,29,031,"Missouri","Cape Girardeau County",4,15,1104,563,541
050,29,031,"Missouri","Cape Girardeau County",4,16,1045,527,518
050,29,031,"Missouri","Cape Girardeau County",4,17,1026,512,514
050,29,031,"Missouri","Cape Girardeau County",4,18,1221,573,648
050,29,031,"Missouri","Cape Girardeau County",4,19,1880,812,1068
050,29,031,"Missouri","Cape Girardeau County",4,20,1881,792,1089
050,29,031,"Missouri","Cape Girardeau County",4,21,1840,845,995
050,29,031,"Missouri","Cape Girardeau County",4,22,1712,823,889
050,29,031,"Missouri","Cape Girardeau County",4,23,1495,791,704
050,29,031,"Missouri","Cape Girardeau County",4,24,1216,597,619
050,29,031,"Missouri","Cape Girardeau County",4,25,1100,564,536
050,29,031,"Missouri","Cape Girardeau County",4,26,1040,534,506
050,29,031,"Missouri","Cape Girardeau County",4,27,1021,505,516
050,29,031,"Missouri","Cape Girardeau County",4,28,1026,521,505
050,29,031,"Missouri","Cape Girardeau County",4,29,1037,535,502
050,29,031,"Missouri","Cape Girardeau County",4,30,1079,526,553
050,29,031,"Missouri","Cape Girardeau County",4,31,1084,576,508
050,29,031,"Missouri","Cape Girardeau County",4,32,1053,516,537
050,29,031,"Missouri","Cape Girardeau County",4,33,992,477,515
050,29,031,"Missouri","Cape Girardeau County",4,34,1011,494,517
050,29,031,"Missouri","Cape Girardeau County",4,35,1050,521,529
050,29,031,"Missouri","Cape Girardeau County",4,36,1062,537,525
050,29,031,"Missouri","Cape Girardeau County",4,37,1031,508,523
050,29,031,"Missouri","Cape Girardeau County",4,38,994,510,484
050,29,031,"Missouri","Cape Girardeau County",4,39,997,504,493
050,29,031,"Missouri","Cape Girardeau County",4,40,983,485,498
050,29,031,"Missouri","Cape Girardeau County",4,41,1021,510,511
050,29,031,"Missouri","Cape Girardeau County",4,42,1044,519,525
050,29,031,"Missouri","Cape Girardeau County",4,43,963,483,480
050,29,031,"Missouri","Cape Girardeau County",4,44,926,471,455
050,29,031,"Missouri","Cape Girardeau County",4,45,890,464,426
050,29,031,"Missouri","Cape Girardeau County",4,46,852,409,443
050,29,031,"Missouri","Cape Girardeau County",4,47,852,420,432
050,29,031,"Missouri","Cape Girardeau County",4,48,869,447,422
050,29,031,"Missouri","Cape Girardeau County",4,49,880,438,442
050,29,031,"Missouri","Cape Girardeau County",4,50,929,466,463
050,29,031,"Missouri","Cape Girardeau County",4,51,981,490,491
050,29,031,"Missouri","Cape Girardeau County",4,52,906,445,461
050,29,031,"Missouri","Cape Girardeau County",4,53,881,432,449
050,29,031,"Missouri","Cape Girardeau County",4,54,864,422,442
050,29,031,"Missouri","Cape Girardeau County",4,55,901,435,466
050,29,031,"Missouri","Cape Girardeau County",4,56,922,451,471
050,29,031,"Missouri","Cape Girardeau County",4,57,937,454,483
050,29,031,"Missouri","Cape Girardeau County",4,58,992,505,487
050,29,031,"Missouri","Cape Girardeau County",4,59,994,515,479
050,29,031,"Missouri","Cape Girardeau County",4,60,1018,531,487
050,29,031,"Missouri","Cape Girardeau County",4,61,1037,502,535
050,29,031,"Missouri","Cape Girardeau County",4,62,1016,495,521
050,29,031,"Missouri","Cape Girardeau County",4,63,1032,523,509
050,29,031,"Missouri","Cape Girardeau County",4,64,1035,511,524
050,29,031,"Missouri","Cape Girardeau County",4,65,979,471,508
050,29,031,"Missouri","Cape Girardeau County",4,66,946,438,508
050,29,031,"Missouri","Cape Girardeau County",4,67,901,425,476
050,29,031,"Missouri","Cape Girardeau County",4,68,865,408,457
050,29,031,"Missouri","Cape Girardeau County",4,69,844,384,460
050,29,031,"Missouri","Cape Girardeau County",4,70,887,412,475
050,29,031,"Missouri","Cape Girardeau County",4,71,813,384,429
050,29,031,"Missouri","Cape Girardeau County",4,72,753,361,392
050,29,031,"Missouri","Cape Girardeau County",4,73,728,352,376
050,29,031,"Missouri","Cape Girardeau County",4,74,686,314,372
050,29,031,"Missouri","Cape Girardeau County",4,75,725,326,399
050,29,031,"Missouri","Cape Girardeau County",4,76,498,224,274
050,29,031,"Missouri","Cape Girardeau County",4,77,504,239,265
050,29,031,"Missouri","Cape Girardeau County",4,78,484,200,284
050,29,031,"Missouri","Cape Girardeau County",4,79,475,204,271
050,29,031,"Missouri","Cape Girardeau County",4,80,375,155,220
050,29,031,"Missouri","Cape Girardeau County",4,81,374,139,235
050,29,031,"Missouri","Cape Girardeau County",4,82,358,142,216
050,29,031,"Missouri","Cape Girardeau County",4,83,307,116,191
050,29,031,"Missouri","Cape Girardeau County",4,84,305,125,180
050,29,031,"Missouri","Cape Girardeau County",4,85,1862,657,1205
050,29,031,"Missouri","Cape Girardeau County",5,0,894,482,412
050,29,031,"Missouri","Cape Girardeau County",5,1,885,483,402
050,29,031,"Missouri","Cape Girardeau County",5,2,887,452,435
050,29,031,"Missouri","Cape Girardeau County",5,3,925,460,465
050,29,031,"Missouri","Cape Girardeau County",5,4,956,494,462
050,29,031,"Missouri","Cape Girardeau County",5,5,967,505,462
050,29,031,"Missouri","Cape Girardeau County",5,6,952,470,482
050,29,031,"Missouri","Cape Girardeau County",5,7,987,504,483
050,29,031,"Missouri","Cape Girardeau County",5,8,1017,510,507
050,29,031,"Missouri","Cape Girardeau County",5,9,981,505,476
050,29,031,"Missouri","Cape Girardeau County",5,10,974,501,473
050,29,031,"Missouri","Cape Girardeau County",5,11,958,496,462
050,29,031,"Missouri","Cape Girardeau County",5,12,978,530,448
050,29,031,"Missouri","Cape Girardeau County",5,13,1006,551,455
050,29,031,"Missouri","Cape Girardeau County",5,14,1011,546,465
050,29,031,"Missouri","Cape Girardeau County",5,15,1067,539,528
050,29,031,"Missouri","Cape Girardeau County",5,16,1095,555,540
050,29,031,"Missouri","Cape Girardeau County",5,17,1056,532,524
050,29,031,"Missouri","Cape Girardeau County",5,18,1197,572,625
050,29,031,"Missouri","Cape Girardeau County",5,19,1879,801,1078
050,29,031,"Missouri","Cape Girardeau County",5,20,1896,811,1085
050,29,031,"Missouri","Cape Girardeau County",5,21,1768,807,961
050,29,031,"Missouri","Cape Girardeau County",5,22,1720,792,928
050,29,031,"Missouri","Cape Girardeau County",5,23,1489,788,701
050,29,031,"Missouri","Cape Girardeau County",5,24,1195,589,606
050,29,031,"Missouri","Cape Girardeau County",5,25,1151,560,591
050,29,031,"Missouri","Cape Girardeau County",5,26,1037,532,505
050,29,031,"Missouri","Cape Girardeau County",5,27,946,472,474
050,29,031,"Missouri","Cape Girardeau County",5,28,997,499,498
050,29,031,"Missouri","Cape Girardeau County",5,29,1007,520,487
050,29,031,"Missouri","Cape Girardeau County",5,30,1009,536,473
050,29,031,"Missouri","Cape Girardeau County",5,31,1062,504,558
050,29,031,"Missouri","Cape Girardeau County",5,32,1086,583,503
050,29,031,"Missouri","Cape Girardeau County",5,33,1040,509,531
050,29,031,"Missouri","Cape Girardeau County",5,34,1008,469,539
050,29,031,"Missouri","Cape Girardeau County",5,35,996,474,522
050,29,031,"Missouri","Cape Girardeau County",5,36,1063,546,517
050,29,031,"Missouri","Cape Girardeau County",5,37,1068,530,538
050,29,031,"Missouri","Cape Girardeau County",5,38,1035,514,521
050,29,031,"Missouri","Cape Girardeau County",5,39,956,489,467
050,29,031,"Missouri","Cape Girardeau County",5,40,1000,510,490
050,29,031,"Missouri","Cape Girardeau County",5,41,1003,498,505
050,29,031,"Missouri","Cape Girardeau County",5,42,1050,521,529
050,29,031,"Missouri","Cape Girardeau County",5,43,1007,491,516
050,29,031,"Missouri","Cape Girardeau County",5,44,955,476,479
050,29,031,"Missouri","Cape Girardeau County",5,45,929,475,454
050,29,031,"Missouri","Cape Girardeau County",5,46,936,487,449
050,29,031,"Missouri","Cape Girardeau County",5,47,815,391,424
050,29,031,"Missouri","Cape Girardeau County",5,48,859,434,425
050,29,031,"Missouri","Cape Girardeau County",5,49,835,423,412
050,29,031,"Missouri","Cape Girardeau County",5,50,885,446,439
050,29,031,"Missouri","Cape Girardeau County",5,51,938,460,478
050,29,031,"Missouri","Cape Girardeau County",5,52,969,485,484
050,29,031,"Missouri","Cape Girardeau County",5,53,940,462,478
050,29,031,"Missouri","Cape Girardeau County",5,54,861,414,447
050,29,031,"Missouri","Cape Girardeau County",5,55,860,406,454
050,29,031,"Missouri","Cape Girardeau County",5,56,917,451,466
050,29,031,"Missouri","Cape Girardeau County",5,57,892,429,463
050,29,031,"Missouri","Cape Girardeau County",5,58,935,444,491
050,29,031,"Missouri","Cape Girardeau County",5,59,978,496,482
050,29,031,"Missouri","Cape Girardeau County",5,60,985,525,460
050,29,031,"Missouri","Cape Girardeau County",5,61,1014,516,498
050,29,031,"Missouri","Cape Girardeau County",5,62,1032,497,535
050,29,031,"Missouri","Cape Girardeau County",5,63,1024,498,526
050,29,031,"Missouri","Cape Girardeau County",5,64,994,497,497
050,29,031,"Missouri","Cape Girardeau County",5,65,1023,504,519
050,29,031,"Missouri","Cape Girardeau County",5,66,971,466,505
050,29,031,"Missouri","Cape Girardeau County",5,67,938,434,504
050,29,031,"Missouri","Cape Girardeau County",5,68,894,425,469
050,29,031,"Missouri","Cape Girardeau County",5,69,821,389,432
050,29,031,"Missouri","Cape Girardeau County",5,70,842,381,461
050,29,031,"Missouri","Cape Girardeau County",5,71,865,396,469
050,29,031,"Missouri","Cape Girardeau County",5,72,788,374,414
050,29,031,"Missouri","Cape Girardeau County",5,73,744,349,395
050,29,031,"Missouri","Cape Girardeau County",5,74,724,353,371
050,29,031,"Missouri","Cape Girardeau County",5,75,669,312,357
050,29,031,"Missouri","Cape Girardeau County",5,76,719,315,404
050,29,031,"Missouri","Cape Girardeau County",5,77,503,234,269
050,29,031,"Missouri","Cape Girardeau County",5,78,462,213,249
050,29,031,"Missouri","Cape Girardeau County",5,79,469,199,270
050,29,031,"Missouri","Cape Girardeau County",5,80,453,202,251
050,29,031,"Missouri","Cape Girardeau County",5,81,384,142,242
050,29,031,"Missouri","Cape Girardeau County",5,82,342,131,211
050,29,031,"Missouri","Cape Girardeau County",5,83,320,117,203
050,29,031,"Missouri","Cape Girardeau County",5,84,303,115,188
050,29,031,"Missouri","Cape Girardeau County",5,85,1936,700,1236
050,29,033,"Missouri","Carroll County",1,0,84,44,40
050,29,033,"Missouri","Carroll County",1,1,86,49,37
050,29,033,"Missouri","Carroll County",1,2,86,45,41
050,29,033,"Missouri","Carroll County",1,3,85,42,43
050,29,033,"Missouri","Carroll County",1,4,86,37,49
050,29,033,"Missouri","Carroll County",1,5,97,55,42
050,29,033,"Missouri","Carroll County",1,6,122,73,49
050,29,033,"Missouri","Carroll County",1,7,117,52,65
050,29,033,"Missouri","Carroll County",1,8,112,53,59
050,29,033,"Missouri","Carroll County",1,9,106,62,44
050,29,033,"Missouri","Carroll County",1,10,112,60,52
050,29,033,"Missouri","Carroll County",1,11,102,52,50
050,29,033,"Missouri","Carroll County",1,12,122,59,63
050,29,033,"Missouri","Carroll County",1,13,125,67,58
050,29,033,"Missouri","Carroll County",1,14,113,58,55
050,29,033,"Missouri","Carroll County",1,15,105,54,51
050,29,033,"Missouri","Carroll County",1,16,108,49,59
050,29,033,"Missouri","Carroll County",1,17,125,56,69
050,29,033,"Missouri","Carroll County",1,18,113,58,55
050,29,033,"Missouri","Carroll County",1,19,80,43,37
050,29,033,"Missouri","Carroll County",1,20,83,46,37
050,29,033,"Missouri","Carroll County",1,21,94,49,45
050,29,033,"Missouri","Carroll County",1,22,87,44,43
050,29,033,"Missouri","Carroll County",1,23,105,50,55
050,29,033,"Missouri","Carroll County",1,24,100,49,51
050,29,033,"Missouri","Carroll County",1,25,93,44,49
050,29,033,"Missouri","Carroll County",1,26,96,45,51
050,29,033,"Missouri","Carroll County",1,27,95,57,38
050,29,033,"Missouri","Carroll County",1,28,93,45,48
050,29,033,"Missouri","Carroll County",1,29,90,47,43
050,29,033,"Missouri","Carroll County",1,30,96,55,41
050,29,033,"Missouri","Carroll County",1,31,87,44,43
050,29,033,"Missouri","Carroll County",1,32,69,33,36
050,29,033,"Missouri","Carroll County",1,33,75,33,42
050,29,033,"Missouri","Carroll County",1,34,80,41,39
050,29,033,"Missouri","Carroll County",1,35,84,40,44
050,29,033,"Missouri","Carroll County",1,36,83,42,41
050,29,033,"Missouri","Carroll County",1,37,93,44,49
050,29,033,"Missouri","Carroll County",1,38,99,46,53
050,29,033,"Missouri","Carroll County",1,39,104,48,56
050,29,033,"Missouri","Carroll County",1,40,92,44,48
050,29,033,"Missouri","Carroll County",1,41,105,49,56
050,29,033,"Missouri","Carroll County",1,42,101,52,49
050,29,033,"Missouri","Carroll County",1,43,112,58,54
050,29,033,"Missouri","Carroll County",1,44,97,47,50
050,29,033,"Missouri","Carroll County",1,45,88,38,50
050,29,033,"Missouri","Carroll County",1,46,104,51,53
050,29,033,"Missouri","Carroll County",1,47,98,53,45
050,29,033,"Missouri","Carroll County",1,48,100,54,46
050,29,033,"Missouri","Carroll County",1,49,106,60,46
050,29,033,"Missouri","Carroll County",1,50,110,56,54
050,29,033,"Missouri","Carroll County",1,51,105,57,48
050,29,033,"Missouri","Carroll County",1,52,105,59,46
050,29,033,"Missouri","Carroll County",1,53,114,52,62
050,29,033,"Missouri","Carroll County",1,54,102,50,52
050,29,033,"Missouri","Carroll County",1,55,106,53,53
050,29,033,"Missouri","Carroll County",1,56,121,58,63
050,29,033,"Missouri","Carroll County",1,57,122,64,58
050,29,033,"Missouri","Carroll County",1,58,124,67,57
050,29,033,"Missouri","Carroll County",1,59,135,69,66
050,29,033,"Missouri","Carroll County",1,60,128,66,62
050,29,033,"Missouri","Carroll County",1,61,127,64,63
050,29,033,"Missouri","Carroll County",1,62,104,49,55
050,29,033,"Missouri","Carroll County",1,63,113,53,60
050,29,033,"Missouri","Carroll County",1,64,121,55,66
050,29,033,"Missouri","Carroll County",1,65,118,56,62
050,29,033,"Missouri","Carroll County",1,66,103,56,47
050,29,033,"Missouri","Carroll County",1,67,112,62,50
050,29,033,"Missouri","Carroll County",1,68,110,59,51
050,29,033,"Missouri","Carroll County",1,69,101,52,49
050,29,033,"Missouri","Carroll County",1,70,106,52,54
050,29,033,"Missouri","Carroll County",1,71,93,43,50
050,29,033,"Missouri","Carroll County",1,72,107,42,65
050,29,033,"Missouri","Carroll County",1,73,114,49,65
050,29,033,"Missouri","Carroll County",1,74,77,38,39
050,29,033,"Missouri","Carroll County",1,75,91,38,53
050,29,033,"Missouri","Carroll County",1,76,78,34,44
050,29,033,"Missouri","Carroll County",1,77,71,34,37
050,29,033,"Missouri","Carroll County",1,78,56,26,30
050,29,033,"Missouri","Carroll County",1,79,56,27,29
050,29,033,"Missouri","Carroll County",1,80,66,36,30
050,29,033,"Missouri","Carroll County",1,81,48,26,22
050,29,033,"Missouri","Carroll County",1,82,49,22,27
050,29,033,"Missouri","Carroll County",1,83,39,22,17
050,29,033,"Missouri","Carroll County",1,84,36,15,21
050,29,033,"Missouri","Carroll County",1,85,232,87,145
050,29,033,"Missouri","Carroll County",2,0,81,44,37
050,29,033,"Missouri","Carroll County",2,1,84,48,36
050,29,033,"Missouri","Carroll County",2,2,87,47,40
050,29,033,"Missouri","Carroll County",2,3,84,41,43
050,29,033,"Missouri","Carroll County",2,4,86,38,48
050,29,033,"Missouri","Carroll County",2,5,95,52,43
050,29,033,"Missouri","Carroll County",2,6,116,68,48
050,29,033,"Missouri","Carroll County",2,7,118,57,61
050,29,033,"Missouri","Carroll County",2,8,110,53,57
050,29,033,"Missouri","Carroll County",2,9,107,60,47
050,29,033,"Missouri","Carroll County",2,10,108,60,48
050,29,033,"Missouri","Carroll County",2,11,103,54,49
050,29,033,"Missouri","Carroll County",2,12,118,58,60
050,29,033,"Missouri","Carroll County",2,13,125,66,59
050,29,033,"Missouri","Carroll County",2,14,115,60,55
050,29,033,"Missouri","Carroll County",2,15,107,55,52
050,29,033,"Missouri","Carroll County",2,16,109,51,58
050,29,033,"Missouri","Carroll County",2,17,120,54,66
050,29,033,"Missouri","Carroll County",2,18,110,56,54
050,29,033,"Missouri","Carroll County",2,19,83,44,39
050,29,033,"Missouri","Carroll County",2,20,85,46,39
050,29,033,"Missouri","Carroll County",2,21,91,48,43
050,29,033,"Missouri","Carroll County",2,22,88,44,44
050,29,033,"Missouri","Carroll County",2,23,103,50,53
050,29,033,"Missouri","Carroll County",2,24,100,49,51
050,29,033,"Missouri","Carroll County",2,25,93,44,49
050,29,033,"Missouri","Carroll County",2,26,97,46,51
050,29,033,"Missouri","Carroll County",2,27,95,54,41
050,29,033,"Missouri","Carroll County",2,28,93,47,46
050,29,033,"Missouri","Carroll County",2,29,90,46,44
050,29,033,"Missouri","Carroll County",2,30,94,53,41
050,29,033,"Missouri","Carroll County",2,31,87,46,41
050,29,033,"Missouri","Carroll County",2,32,73,36,37
050,29,033,"Missouri","Carroll County",2,33,73,33,40
050,29,033,"Missouri","Carroll County",2,34,78,38,40
050,29,033,"Missouri","Carroll County",2,35,84,41,43
050,29,033,"Missouri","Carroll County",2,36,83,41,42
050,29,033,"Missouri","Carroll County",2,37,91,43,48
050,29,033,"Missouri","Carroll County",2,38,99,46,53
050,29,033,"Missouri","Carroll County",2,39,103,48,55
050,29,033,"Missouri","Carroll County",2,40,93,44,49
050,29,033,"Missouri","Carroll County",2,41,103,48,55
050,29,033,"Missouri","Carroll County",2,42,103,52,51
050,29,033,"Missouri","Carroll County",2,43,109,57,52
050,29,033,"Missouri","Carroll County",2,44,99,49,50
050,29,033,"Missouri","Carroll County",2,45,92,41,51
050,29,033,"Missouri","Carroll County",2,46,99,48,51
050,29,033,"Missouri","Carroll County",2,47,101,53,48
050,29,033,"Missouri","Carroll County",2,48,100,54,46
050,29,033,"Missouri","Carroll County",2,49,104,59,45
050,29,033,"Missouri","Carroll County",2,50,108,57,51
050,29,033,"Missouri","Carroll County",2,51,106,57,49
050,29,033,"Missouri","Carroll County",2,52,104,57,47
050,29,033,"Missouri","Carroll County",2,53,113,53,60
050,29,033,"Missouri","Carroll County",2,54,104,51,53
050,29,033,"Missouri","Carroll County",2,55,105,52,53
050,29,033,"Missouri","Carroll County",2,56,117,57,60
050,29,033,"Missouri","Carroll County",2,57,122,63,59
050,29,033,"Missouri","Carroll County",2,58,123,66,57
050,29,033,"Missouri","Carroll County",2,59,134,70,64
050,29,033,"Missouri","Carroll County",2,60,130,66,64
050,29,033,"Missouri","Carroll County",2,61,128,65,63
050,29,033,"Missouri","Carroll County",2,62,110,53,57
050,29,033,"Missouri","Carroll County",2,63,112,53,59
050,29,033,"Missouri","Carroll County",2,64,117,54,63
050,29,033,"Missouri","Carroll County",2,65,119,56,63
050,29,033,"Missouri","Carroll County",2,66,109,57,52
050,29,033,"Missouri","Carroll County",2,67,106,59,47
050,29,033,"Missouri","Carroll County",2,68,108,58,50
050,29,033,"Missouri","Carroll County",2,69,103,53,50
050,29,033,"Missouri","Carroll County",2,70,102,51,51
050,29,033,"Missouri","Carroll County",2,71,95,44,51
050,29,033,"Missouri","Carroll County",2,72,101,42,59
050,29,033,"Missouri","Carroll County",2,73,118,50,68
050,29,033,"Missouri","Carroll County",2,74,79,38,41
050,29,033,"Missouri","Carroll County",2,75,88,38,50
050,29,033,"Missouri","Carroll County",2,76,78,34,44
050,29,033,"Missouri","Carroll County",2,77,74,35,39
050,29,033,"Missouri","Carroll County",2,78,59,28,31
050,29,033,"Missouri","Carroll County",2,79,54,26,28
050,29,033,"Missouri","Carroll County",2,80,64,35,29
050,29,033,"Missouri","Carroll County",2,81,50,26,24
050,29,033,"Missouri","Carroll County",2,82,49,23,26
050,29,033,"Missouri","Carroll County",2,83,40,22,18
050,29,033,"Missouri","Carroll County",2,84,37,16,21
050,29,033,"Missouri","Carroll County",2,85,231,87,144
050,29,033,"Missouri","Carroll County",3,0,93,39,54
050,29,033,"Missouri","Carroll County",3,1,74,40,34
050,29,033,"Missouri","Carroll County",3,2,85,50,35
050,29,033,"Missouri","Carroll County",3,3,85,45,40
050,29,033,"Missouri","Carroll County",3,4,86,43,43
050,29,033,"Missouri","Carroll County",3,5,91,42,49
050,29,033,"Missouri","Carroll County",3,6,94,48,46
050,29,033,"Missouri","Carroll County",3,7,112,63,49
050,29,033,"Missouri","Carroll County",3,8,118,58,60
050,29,033,"Missouri","Carroll County",3,9,106,51,55
050,29,033,"Missouri","Carroll County",3,10,115,67,48
050,29,033,"Missouri","Carroll County",3,11,110,60,50
050,29,033,"Missouri","Carroll County",3,12,100,53,47
050,29,033,"Missouri","Carroll County",3,13,114,57,57
050,29,033,"Missouri","Carroll County",3,14,122,64,58
050,29,033,"Missouri","Carroll County",3,15,111,59,52
050,29,033,"Missouri","Carroll County",3,16,103,51,52
050,29,033,"Missouri","Carroll County",3,17,109,51,58
050,29,033,"Missouri","Carroll County",3,18,105,50,55
050,29,033,"Missouri","Carroll County",3,19,83,45,38
050,29,033,"Missouri","Carroll County",3,20,89,46,43
050,29,033,"Missouri","Carroll County",3,21,90,48,42
050,29,033,"Missouri","Carroll County",3,22,96,49,47
050,29,033,"Missouri","Carroll County",3,23,86,44,42
050,29,033,"Missouri","Carroll County",3,24,92,47,45
050,29,033,"Missouri","Carroll County",3,25,92,49,43
050,29,033,"Missouri","Carroll County",3,26,96,45,51
050,29,033,"Missouri","Carroll County",3,27,102,52,50
050,29,033,"Missouri","Carroll County",3,28,101,56,45
050,29,033,"Missouri","Carroll County",3,29,101,49,52
050,29,033,"Missouri","Carroll County",3,30,87,43,44
050,29,033,"Missouri","Carroll County",3,31,97,55,42
050,29,033,"Missouri","Carroll County",3,32,86,51,35
050,29,033,"Missouri","Carroll County",3,33,70,36,34
050,29,033,"Missouri","Carroll County",3,34,77,36,41
050,29,033,"Missouri","Carroll County",3,35,86,41,45
050,29,033,"Missouri","Carroll County",3,36,88,46,42
050,29,033,"Missouri","Carroll County",3,37,82,41,41
050,29,033,"Missouri","Carroll County",3,38,88,41,47
050,29,033,"Missouri","Carroll County",3,39,100,48,52
050,29,033,"Missouri","Carroll County",3,40,105,50,55
050,29,033,"Missouri","Carroll County",3,41,99,46,53
050,29,033,"Missouri","Carroll County",3,42,103,47,56
050,29,033,"Missouri","Carroll County",3,43,95,49,46
050,29,033,"Missouri","Carroll County",3,44,110,55,55
050,29,033,"Missouri","Carroll County",3,45,95,48,47
050,29,033,"Missouri","Carroll County",3,46,90,42,48
050,29,033,"Missouri","Carroll County",3,47,104,51,53
050,29,033,"Missouri","Carroll County",3,48,100,50,50
050,29,033,"Missouri","Carroll County",3,49,103,53,50
050,29,033,"Missouri","Carroll County",3,50,106,59,47
050,29,033,"Missouri","Carroll County",3,51,108,58,50
050,29,033,"Missouri","Carroll County",3,52,102,55,47
050,29,033,"Missouri","Carroll County",3,53,103,54,49
050,29,033,"Missouri","Carroll County",3,54,107,54,53
050,29,033,"Missouri","Carroll County",3,55,102,50,52
050,29,033,"Missouri","Carroll County",3,56,108,52,56
050,29,033,"Missouri","Carroll County",3,57,110,55,55
050,29,033,"Missouri","Carroll County",3,58,122,62,60
050,29,033,"Missouri","Carroll County",3,59,120,67,53
050,29,033,"Missouri","Carroll County",3,60,128,67,61
050,29,033,"Missouri","Carroll County",3,61,131,67,64
050,29,033,"Missouri","Carroll County",3,62,132,67,65
050,29,033,"Missouri","Carroll County",3,63,108,53,55
050,29,033,"Missouri","Carroll County",3,64,111,54,57
050,29,033,"Missouri","Carroll County",3,65,112,48,64
050,29,033,"Missouri","Carroll County",3,66,124,60,64
050,29,033,"Missouri","Carroll County",3,67,102,55,47
050,29,033,"Missouri","Carroll County",3,68,106,58,48
050,29,033,"Missouri","Carroll County",3,69,105,56,49
050,29,033,"Missouri","Carroll County",3,70,100,52,48
050,29,033,"Missouri","Carroll County",3,71,100,48,52
050,29,033,"Missouri","Carroll County",3,72,96,43,53
050,29,033,"Missouri","Carroll County",3,73,101,43,58
050,29,033,"Missouri","Carroll County",3,74,111,48,63
050,29,033,"Missouri","Carroll County",3,75,86,38,48
050,29,033,"Missouri","Carroll County",3,76,80,38,42
050,29,033,"Missouri","Carroll County",3,77,75,34,41
050,29,033,"Missouri","Carroll County",3,78,71,32,39
050,29,033,"Missouri","Carroll County",3,79,50,25,25
050,29,033,"Missouri","Carroll County",3,80,54,25,29
050,29,033,"Missouri","Carroll County",3,81,60,28,32
050,29,033,"Missouri","Carroll County",3,82,45,22,23
050,29,033,"Missouri","Carroll County",3,83,41,20,21
050,29,033,"Missouri","Carroll County",3,84,42,20,22
050,29,033,"Missouri","Carroll County",3,85,213,82,131
050,29,033,"Missouri","Carroll County",4,0,87,49,38
050,29,033,"Missouri","Carroll County",4,1,97,42,55
050,29,033,"Missouri","Carroll County",4,2,73,37,36
050,29,033,"Missouri","Carroll County",4,3,87,49,38
050,29,033,"Missouri","Carroll County",4,4,87,43,44
050,29,033,"Missouri","Carroll County",4,5,87,46,41
050,29,033,"Missouri","Carroll County",4,6,92,42,50
050,29,033,"Missouri","Carroll County",4,7,108,58,50
050,29,033,"Missouri","Carroll County",4,8,119,64,55
050,29,033,"Missouri","Carroll County",4,9,116,58,58
050,29,033,"Missouri","Carroll County",4,10,110,56,54
050,29,033,"Missouri","Carroll County",4,11,114,68,46
050,29,033,"Missouri","Carroll County",4,12,116,63,53
050,29,033,"Missouri","Carroll County",4,13,103,53,50
050,29,033,"Missouri","Carroll County",4,14,122,61,61
050,29,033,"Missouri","Carroll County",4,15,119,60,59
050,29,033,"Missouri","Carroll County",4,16,111,57,54
050,29,033,"Missouri","Carroll County",4,17,102,53,49
050,29,033,"Missouri","Carroll County",4,18,96,44,52
050,29,033,"Missouri","Carroll County",4,19,77,36,41
050,29,033,"Missouri","Carroll County",4,20,82,43,39
050,29,033,"Missouri","Carroll County",4,21,94,49,45
050,29,033,"Missouri","Carroll County",4,22,97,51,46
050,29,033,"Missouri","Carroll County",4,23,96,47,49
050,29,033,"Missouri","Carroll County",4,24,82,44,38
050,29,033,"Missouri","Carroll County",4,25,85,42,43
050,29,033,"Missouri","Carroll County",4,26,91,47,44
050,29,033,"Missouri","Carroll County",4,27,92,40,52
050,29,033,"Missouri","Carroll County",4,28,94,48,46
050,29,033,"Missouri","Carroll County",4,29,103,56,47
050,29,033,"Missouri","Carroll County",4,30,99,51,48
050,29,033,"Missouri","Carroll County",4,31,90,45,45
050,29,033,"Missouri","Carroll County",4,32,101,57,44
050,29,033,"Missouri","Carroll County",4,33,93,54,39
050,29,033,"Missouri","Carroll County",4,34,74,37,37
050,29,033,"Missouri","Carroll County",4,35,81,44,37
050,29,033,"Missouri","Carroll County",4,36,85,38,47
050,29,033,"Missouri","Carroll County",4,37,93,46,47
050,29,033,"Missouri","Carroll County",4,38,83,42,41
050,29,033,"Missouri","Carroll County",4,39,94,46,48
050,29,033,"Missouri","Carroll County",4,40,103,51,52
050,29,033,"Missouri","Carroll County",4,41,103,50,53
050,29,033,"Missouri","Carroll County",4,42,102,50,52
050,29,033,"Missouri","Carroll County",4,43,106,49,57
050,29,033,"Missouri","Carroll County",4,44,95,49,46
050,29,033,"Missouri","Carroll County",4,45,107,53,54
050,29,033,"Missouri","Carroll County",4,46,91,47,44
050,29,033,"Missouri","Carroll County",4,47,88,41,47
050,29,033,"Missouri","Carroll County",4,48,100,48,52
050,29,033,"Missouri","Carroll County",4,49,91,51,40
050,29,033,"Missouri","Carroll County",4,50,100,51,49
050,29,033,"Missouri","Carroll County",4,51,107,60,47
050,29,033,"Missouri","Carroll County",4,52,110,59,51
050,29,033,"Missouri","Carroll County",4,53,103,55,48
050,29,033,"Missouri","Carroll County",4,54,103,56,47
050,29,033,"Missouri","Carroll County",4,55,112,56,56
050,29,033,"Missouri","Carroll County",4,56,108,53,55
050,29,033,"Missouri","Carroll County",4,57,111,53,58
050,29,033,"Missouri","Carroll County",4,58,109,56,53
050,29,033,"Missouri","Carroll County",4,59,118,58,60
050,29,033,"Missouri","Carroll County",4,60,114,64,50
050,29,033,"Missouri","Carroll County",4,61,128,65,63
050,29,033,"Missouri","Carroll County",4,62,130,65,65
050,29,033,"Missouri","Carroll County",4,63,131,66,65
050,29,033,"Missouri","Carroll County",4,64,110,56,54
050,29,033,"Missouri","Carroll County",4,65,109,51,58
050,29,033,"Missouri","Carroll County",4,66,111,45,66
050,29,033,"Missouri","Carroll County",4,67,117,54,63
050,29,033,"Missouri","Carroll County",4,68,101,56,45
050,29,033,"Missouri","Carroll County",4,69,105,57,48
050,29,033,"Missouri","Carroll County",4,70,107,55,52
050,29,033,"Missouri","Carroll County",4,71,100,53,47
050,29,033,"Missouri","Carroll County",4,72,98,47,51
050,29,033,"Missouri","Carroll County",4,73,95,41,54
050,29,033,"Missouri","Carroll County",4,74,97,41,56
050,29,033,"Missouri","Carroll County",4,75,115,48,67
050,29,033,"Missouri","Carroll County",4,76,81,37,44
050,29,033,"Missouri","Carroll County",4,77,83,40,43
050,29,033,"Missouri","Carroll County",4,78,74,31,43
050,29,033,"Missouri","Carroll County",4,79,66,31,35
050,29,033,"Missouri","Carroll County",4,80,52,25,27
050,29,033,"Missouri","Carroll County",4,81,48,21,27
050,29,033,"Missouri","Carroll County",4,82,57,26,31
050,29,033,"Missouri","Carroll County",4,83,37,21,16
050,29,033,"Missouri","Carroll County",4,84,43,17,26
050,29,033,"Missouri","Carroll County",4,85,212,86,126
050,29,033,"Missouri","Carroll County",5,0,88,48,40
050,29,033,"Missouri","Carroll County",5,1,78,48,30
050,29,033,"Missouri","Carroll County",5,2,107,46,61
050,29,033,"Missouri","Carroll County",5,3,79,41,38
050,29,033,"Missouri","Carroll County",5,4,95,53,42
050,29,033,"Missouri","Carroll County",5,5,88,44,44
050,29,033,"Missouri","Carroll County",5,6,90,46,44
050,29,033,"Missouri","Carroll County",5,7,90,41,49
050,29,033,"Missouri","Carroll County",5,8,113,57,56
050,29,033,"Missouri","Carroll County",5,9,116,65,51
050,29,033,"Missouri","Carroll County",5,10,113,58,55
050,29,033,"Missouri","Carroll County",5,11,115,57,58
050,29,033,"Missouri","Carroll County",5,12,113,68,45
050,29,033,"Missouri","Carroll County",5,13,113,60,53
050,29,033,"Missouri","Carroll County",5,14,105,54,51
050,29,033,"Missouri","Carroll County",5,15,116,56,60
050,29,033,"Missouri","Carroll County",5,16,116,61,55
050,29,033,"Missouri","Carroll County",5,17,114,61,53
050,29,033,"Missouri","Carroll County",5,18,85,43,42
050,29,033,"Missouri","Carroll County",5,19,69,32,37
050,29,033,"Missouri","Carroll County",5,20,85,42,43
050,29,033,"Missouri","Carroll County",5,21,87,43,44
050,29,033,"Missouri","Carroll County",5,22,94,47,47
050,29,033,"Missouri","Carroll County",5,23,90,50,40
050,29,033,"Missouri","Carroll County",5,24,105,56,49
050,29,033,"Missouri","Carroll County",5,25,83,42,41
050,29,033,"Missouri","Carroll County",5,26,84,44,40
050,29,033,"Missouri","Carroll County",5,27,91,40,51
050,29,033,"Missouri","Carroll County",5,28,90,38,52
050,29,033,"Missouri","Carroll County",5,29,91,42,49
050,29,033,"Missouri","Carroll County",5,30,102,53,49
050,29,033,"Missouri","Carroll County",5,31,102,57,45
050,29,033,"Missouri","Carroll County",5,32,92,46,46
050,29,033,"Missouri","Carroll County",5,33,102,56,46
050,29,033,"Missouri","Carroll County",5,34,96,56,40
050,29,033,"Missouri","Carroll County",5,35,74,40,34
050,29,033,"Missouri","Carroll County",5,36,79,41,38
050,29,033,"Missouri","Carroll County",5,37,82,35,47
050,29,033,"Missouri","Carroll County",5,38,94,48,46
050,29,033,"Missouri","Carroll County",5,39,87,43,44
050,29,033,"Missouri","Carroll County",5,40,90,42,48
050,29,033,"Missouri","Carroll County",5,41,108,51,57
050,29,033,"Missouri","Carroll County",5,42,100,49,51
050,29,033,"Missouri","Carroll County",5,43,101,50,51
050,29,033,"Missouri","Carroll County",5,44,112,51,61
050,29,033,"Missouri","Carroll County",5,45,102,54,48
050,29,033,"Missouri","Carroll County",5,46,108,54,54
050,29,033,"Missouri","Carroll County",5,47,85,44,41
050,29,033,"Missouri","Carroll County",5,48,85,38,47
050,29,033,"Missouri","Carroll County",5,49,98,50,48
050,29,033,"Missouri","Carroll County",5,50,89,48,41
050,29,033,"Missouri","Carroll County",5,51,98,48,50
050,29,033,"Missouri","Carroll County",5,52,105,58,47
050,29,033,"Missouri","Carroll County",5,53,114,58,56
050,29,033,"Missouri","Carroll County",5,54,103,57,46
050,29,033,"Missouri","Carroll County",5,55,101,53,48
050,29,033,"Missouri","Carroll County",5,56,109,53,56
050,29,033,"Missouri","Carroll County",5,57,107,54,53
050,29,033,"Missouri","Carroll County",5,58,112,52,60
050,29,033,"Missouri","Carroll County",5,59,109,57,52
050,29,033,"Missouri","Carroll County",5,60,116,60,56
050,29,033,"Missouri","Carroll County",5,61,116,63,53
050,29,033,"Missouri","Carroll County",5,62,126,64,62
050,29,033,"Missouri","Carroll County",5,63,128,64,64
050,29,033,"Missouri","Carroll County",5,64,129,69,60
050,29,033,"Missouri","Carroll County",5,65,109,54,55
050,29,033,"Missouri","Carroll County",5,66,111,51,60
050,29,033,"Missouri","Carroll County",5,67,103,42,61
050,29,033,"Missouri","Carroll County",5,68,117,54,63
050,29,033,"Missouri","Carroll County",5,69,98,55,43
050,29,033,"Missouri","Carroll County",5,70,100,56,44
050,29,033,"Missouri","Carroll County",5,71,107,55,52
050,29,033,"Missouri","Carroll County",5,72,100,52,48
050,29,033,"Missouri","Carroll County",5,73,96,46,50
050,29,033,"Missouri","Carroll County",5,74,88,38,50
050,29,033,"Missouri","Carroll County",5,75,98,39,59
050,29,033,"Missouri","Carroll County",5,76,107,45,62
050,29,033,"Missouri","Carroll County",5,77,81,37,44
050,29,033,"Missouri","Carroll County",5,78,77,34,43
050,29,033,"Missouri","Carroll County",5,79,67,28,39
050,29,033,"Missouri","Carroll County",5,80,66,31,35
050,29,033,"Missouri","Carroll County",5,81,49,21,28
050,29,033,"Missouri","Carroll County",5,82,45,19,26
050,29,033,"Missouri","Carroll County",5,83,53,27,26
050,29,033,"Missouri","Carroll County",5,84,40,19,21
050,29,033,"Missouri","Carroll County",5,85,215,87,128
050,29,035,"Missouri","Carter County",1,0,62,32,30
050,29,035,"Missouri","Carter County",1,1,62,30,32
050,29,035,"Missouri","Carter County",1,2,61,31,30
050,29,035,"Missouri","Carter County",1,3,59,37,22
050,29,035,"Missouri","Carter County",1,4,64,28,36
050,29,035,"Missouri","Carter County",1,5,67,32,35
050,29,035,"Missouri","Carter County",1,6,66,28,38
050,29,035,"Missouri","Carter County",1,7,66,33,33
050,29,035,"Missouri","Carter County",1,8,55,29,26
050,29,035,"Missouri","Carter County",1,9,66,32,34
050,29,035,"Missouri","Carter County",1,10,69,36,33
050,29,035,"Missouri","Carter County",1,11,67,36,31
050,29,035,"Missouri","Carter County",1,12,75,33,42
050,29,035,"Missouri","Carter County",1,13,82,35,47
050,29,035,"Missouri","Carter County",1,14,69,37,32
050,29,035,"Missouri","Carter County",1,15,70,37,33
050,29,035,"Missouri","Carter County",1,16,78,39,39
050,29,035,"Missouri","Carter County",1,17,75,36,39
050,29,035,"Missouri","Carter County",1,18,64,35,29
050,29,035,"Missouri","Carter County",1,19,49,28,21
050,29,035,"Missouri","Carter County",1,20,56,31,25
050,29,035,"Missouri","Carter County",1,21,47,24,23
050,29,035,"Missouri","Carter County",1,22,56,28,28
050,29,035,"Missouri","Carter County",1,23,48,24,24
050,29,035,"Missouri","Carter County",1,24,47,22,25
050,29,035,"Missouri","Carter County",1,25,45,20,25
050,29,035,"Missouri","Carter County",1,26,55,26,29
050,29,035,"Missouri","Carter County",1,27,49,25,24
050,29,035,"Missouri","Carter County",1,28,55,30,25
050,29,035,"Missouri","Carter County",1,29,56,27,29
050,29,035,"Missouri","Carter County",1,30,51,23,28
050,29,035,"Missouri","Carter County",1,31,63,28,35
050,29,035,"Missouri","Carter County",1,32,44,22,22
050,29,035,"Missouri","Carter County",1,33,44,23,21
050,29,035,"Missouri","Carter County",1,34,61,24,37
050,29,035,"Missouri","Carter County",1,35,53,28,25
050,29,035,"Missouri","Carter County",1,36,46,23,23
050,29,035,"Missouri","Carter County",1,37,57,33,24
050,29,035,"Missouri","Carter County",1,38,62,28,34
050,29,035,"Missouri","Carter County",1,39,68,35,33
050,29,035,"Missouri","Carter County",1,40,68,35,33
050,29,035,"Missouri","Carter County",1,41,61,29,32
050,29,035,"Missouri","Carter County",1,42,59,30,29
050,29,035,"Missouri","Carter County",1,43,62,21,41
050,29,035,"Missouri","Carter County",1,44,50,22,28
050,29,035,"Missouri","Carter County",1,45,55,27,28
050,29,035,"Missouri","Carter County",1,46,66,37,29
050,29,035,"Missouri","Carter County",1,47,65,34,31
050,29,035,"Missouri","Carter County",1,48,67,32,35
050,29,035,"Missouri","Carter County",1,49,70,34,36
050,29,035,"Missouri","Carter County",1,50,64,30,34
050,29,035,"Missouri","Carter County",1,51,63,32,31
050,29,035,"Missouri","Carter County",1,52,67,35,32
050,29,035,"Missouri","Carter County",1,53,67,32,35
050,29,035,"Missouri","Carter County",1,54,74,34,40
050,29,035,"Missouri","Carter County",1,55,74,41,33
050,29,035,"Missouri","Carter County",1,56,75,43,32
050,29,035,"Missouri","Carter County",1,57,75,43,32
050,29,035,"Missouri","Carter County",1,58,83,41,42
050,29,035,"Missouri","Carter County",1,59,85,37,48
050,29,035,"Missouri","Carter County",1,60,88,49,39
050,29,035,"Missouri","Carter County",1,61,78,39,39
050,29,035,"Missouri","Carter County",1,62,76,41,35
050,29,035,"Missouri","Carter County",1,63,77,39,38
050,29,035,"Missouri","Carter County",1,64,73,36,37
050,29,035,"Missouri","Carter County",1,65,78,37,41
050,29,035,"Missouri","Carter County",1,66,77,36,41
050,29,035,"Missouri","Carter County",1,67,70,33,37
050,29,035,"Missouri","Carter County",1,68,65,29,36
050,29,035,"Missouri","Carter County",1,69,70,35,35
050,29,035,"Missouri","Carter County",1,70,72,36,36
050,29,035,"Missouri","Carter County",1,71,60,28,32
050,29,035,"Missouri","Carter County",1,72,54,23,31
050,29,035,"Missouri","Carter County",1,73,55,26,29
050,29,035,"Missouri","Carter County",1,74,38,20,18
050,29,035,"Missouri","Carter County",1,75,46,22,24
050,29,035,"Missouri","Carter County",1,76,44,18,26
050,29,035,"Missouri","Carter County",1,77,33,15,18
050,29,035,"Missouri","Carter County",1,78,39,19,20
050,29,035,"Missouri","Carter County",1,79,33,17,16
050,29,035,"Missouri","Carter County",1,80,30,14,16
050,29,035,"Missouri","Carter County",1,81,27,10,17
050,29,035,"Missouri","Carter County",1,82,30,13,17
050,29,035,"Missouri","Carter County",1,83,20,9,11
050,29,035,"Missouri","Carter County",1,84,25,10,15
050,29,035,"Missouri","Carter County",1,85,103,40,63
050,29,035,"Missouri","Carter County",2,0,62,30,32
050,29,035,"Missouri","Carter County",2,1,60,29,31
050,29,035,"Missouri","Carter County",2,2,59,30,29
050,29,035,"Missouri","Carter County",2,3,58,34,24
050,29,035,"Missouri","Carter County",2,4,63,30,33
050,29,035,"Missouri","Carter County",2,5,66,31,35
050,29,035,"Missouri","Carter County",2,6,66,29,37
050,29,035,"Missouri","Carter County",2,7,66,32,34
050,29,035,"Missouri","Carter County",2,8,58,30,28
050,29,035,"Missouri","Carter County",2,9,63,32,31
050,29,035,"Missouri","Carter County",2,10,68,35,33
050,29,035,"Missouri","Carter County",2,11,67,35,32
050,29,035,"Missouri","Carter County",2,12,74,34,40
050,29,035,"Missouri","Carter County",2,13,81,35,46
050,29,035,"Missouri","Carter County",2,14,72,37,35
050,29,035,"Missouri","Carter County",2,15,72,38,34
050,29,035,"Missouri","Carter County",2,16,77,39,38
050,29,035,"Missouri","Carter County",2,17,78,38,40
050,29,035,"Missouri","Carter County",2,18,64,35,29
050,29,035,"Missouri","Carter County",2,19,51,28,23
050,29,035,"Missouri","Carter County",2,20,56,31,25
050,29,035,"Missouri","Carter County",2,21,49,26,23
050,29,035,"Missouri","Carter County",2,22,54,27,27
050,29,035,"Missouri","Carter County",2,23,49,25,24
050,29,035,"Missouri","Carter County",2,24,47,23,24
050,29,035,"Missouri","Carter County",2,25,45,20,25
050,29,035,"Missouri","Carter County",2,26,53,25,28
050,29,035,"Missouri","Carter County",2,27,51,25,26
050,29,035,"Missouri","Carter County",2,28,53,29,24
050,29,035,"Missouri","Carter County",2,29,56,28,28
050,29,035,"Missouri","Carter County",2,30,53,25,28
050,29,035,"Missouri","Carter County",2,31,60,28,32
050,29,035,"Missouri","Carter County",2,32,48,23,25
050,29,035,"Missouri","Carter County",2,33,46,24,22
050,29,035,"Missouri","Carter County",2,34,58,24,34
050,29,035,"Missouri","Carter County",2,35,55,27,28
050,29,035,"Missouri","Carter County",2,36,48,24,24
050,29,035,"Missouri","Carter County",2,37,55,31,24
050,29,035,"Missouri","Carter County",2,38,61,29,32
050,29,035,"Missouri","Carter County",2,39,67,33,34
050,29,035,"Missouri","Carter County",2,40,70,36,34
050,29,035,"Missouri","Carter County",2,41,62,30,32
050,29,035,"Missouri","Carter County",2,42,59,29,30
050,29,035,"Missouri","Carter County",2,43,61,23,38
050,29,035,"Missouri","Carter County",2,44,52,22,30
050,29,035,"Missouri","Carter County",2,45,56,27,29
050,29,035,"Missouri","Carter County",2,46,62,34,28
050,29,035,"Missouri","Carter County",2,47,66,34,32
050,29,035,"Missouri","Carter County",2,48,67,32,35
050,29,035,"Missouri","Carter County",2,49,69,34,35
050,29,035,"Missouri","Carter County",2,50,64,30,34
050,29,035,"Missouri","Carter County",2,51,63,31,32
050,29,035,"Missouri","Carter County",2,52,66,35,31
050,29,035,"Missouri","Carter County",2,53,67,33,34
050,29,035,"Missouri","Carter County",2,54,73,34,39
050,29,035,"Missouri","Carter County",2,55,75,40,35
050,29,035,"Missouri","Carter County",2,56,76,43,33
050,29,035,"Missouri","Carter County",2,57,75,43,32
050,29,035,"Missouri","Carter County",2,58,82,42,40
050,29,035,"Missouri","Carter County",2,59,84,37,47
050,29,035,"Missouri","Carter County",2,60,88,46,42
050,29,035,"Missouri","Carter County",2,61,80,41,39
050,29,035,"Missouri","Carter County",2,62,76,40,36
050,29,035,"Missouri","Carter County",2,63,77,39,38
050,29,035,"Missouri","Carter County",2,64,73,37,36
050,29,035,"Missouri","Carter County",2,65,76,37,39
050,29,035,"Missouri","Carter County",2,66,76,36,40
050,29,035,"Missouri","Carter County",2,67,73,35,38
050,29,035,"Missouri","Carter County",2,68,64,28,36
050,29,035,"Missouri","Carter County",2,69,70,34,36
050,29,035,"Missouri","Carter County",2,70,71,36,35
050,29,035,"Missouri","Carter County",2,71,63,30,33
050,29,035,"Missouri","Carter County",2,72,54,24,30
050,29,035,"Missouri","Carter County",2,73,55,25,30
050,29,035,"Missouri","Carter County",2,74,39,20,19
050,29,035,"Missouri","Carter County",2,75,44,21,23
050,29,035,"Missouri","Carter County",2,76,44,19,25
050,29,035,"Missouri","Carter County",2,77,37,16,21
050,29,035,"Missouri","Carter County",2,78,35,17,18
050,29,035,"Missouri","Carter County",2,79,35,18,17
050,29,035,"Missouri","Carter County",2,80,29,14,15
050,29,035,"Missouri","Carter County",2,81,27,11,16
050,29,035,"Missouri","Carter County",2,82,28,11,17
050,29,035,"Missouri","Carter County",2,83,22,10,12
050,29,035,"Missouri","Carter County",2,84,23,10,13
050,29,035,"Missouri","Carter County",2,85,105,39,66
050,29,035,"Missouri","Carter County",3,0,73,38,35
050,29,035,"Missouri","Carter County",3,1,62,33,29
050,29,035,"Missouri","Carter County",3,2,71,36,35
050,29,035,"Missouri","Carter County",3,3,57,29,28
050,29,035,"Missouri","Carter County",3,4,64,37,27
050,29,035,"Missouri","Carter County",3,5,75,33,42
050,29,035,"Missouri","Carter County",3,6,71,37,34
050,29,035,"Missouri","Carter County",3,7,77,35,42
050,29,035,"Missouri","Carter County",3,8,69,31,38
050,29,035,"Missouri","Carter County",3,9,62,28,34
050,29,035,"Missouri","Carter County",3,10,70,39,31
050,29,035,"Missouri","Carter County",3,11,70,36,34
050,29,035,"Missouri","Carter County",3,12,63,32,31
050,29,035,"Missouri","Carter County",3,13,72,36,36
050,29,035,"Missouri","Carter County",3,14,81,37,44
050,29,035,"Missouri","Carter County",3,15,71,38,33
050,29,035,"Missouri","Carter County",3,16,76,38,38
050,29,035,"Missouri","Carter County",3,17,81,42,39
050,29,035,"Missouri","Carter County",3,18,73,38,35
050,29,035,"Missouri","Carter County",3,19,50,26,24
050,29,035,"Missouri","Carter County",3,20,59,30,29
050,29,035,"Missouri","Carter County",3,21,61,34,27
050,29,035,"Missouri","Carter County",3,22,52,23,29
050,29,035,"Missouri","Carter County",3,23,64,35,29
050,29,035,"Missouri","Carter County",3,24,53,28,25
050,29,035,"Missouri","Carter County",3,25,51,24,27
050,29,035,"Missouri","Carter County",3,26,47,22,25
050,29,035,"Missouri","Carter County",3,27,57,27,30
050,29,035,"Missouri","Carter County",3,28,50,26,24
050,29,035,"Missouri","Carter County",3,29,62,33,29
050,29,035,"Missouri","Carter County",3,30,59,28,31
050,29,035,"Missouri","Carter County",3,31,59,30,29
050,29,035,"Missouri","Carter County",3,32,60,27,33
050,29,035,"Missouri","Carter County",3,33,51,24,27
050,29,035,"Missouri","Carter County",3,34,47,25,22
050,29,035,"Missouri","Carter County",3,35,59,24,35
050,29,035,"Missouri","Carter County",3,36,53,25,28
050,29,035,"Missouri","Carter County",3,37,51,26,25
050,29,035,"Missouri","Carter County",3,38,57,33,24
050,29,035,"Missouri","Carter County",3,39,61,28,33
050,29,035,"Missouri","Carter County",3,40,66,32,34
050,29,035,"Missouri","Carter County",3,41,68,35,33
050,29,035,"Missouri","Carter County",3,42,67,31,36
050,29,035,"Missouri","Carter County",3,43,59,29,30
050,29,035,"Missouri","Carter County",3,44,61,24,37
050,29,035,"Missouri","Carter County",3,45,52,23,29
050,29,035,"Missouri","Carter County",3,46,59,29,30
050,29,035,"Missouri","Carter County",3,47,64,36,28
050,29,035,"Missouri","Carter County",3,48,67,37,30
050,29,035,"Missouri","Carter County",3,49,63,30,33
050,29,035,"Missouri","Carter County",3,50,67,35,32
050,29,035,"Missouri","Carter County",3,51,64,30,34
050,29,035,"Missouri","Carter County",3,52,64,32,32
050,29,035,"Missouri","Carter County",3,53,61,32,29
050,29,035,"Missouri","Carter County",3,54,68,34,34
050,29,035,"Missouri","Carter County",3,55,70,31,39
050,29,035,"Missouri","Carter County",3,56,73,38,35
050,29,035,"Missouri","Carter County",3,57,78,44,34
050,29,035,"Missouri","Carter County",3,58,74,41,33
050,29,035,"Missouri","Carter County",3,59,74,34,40
050,29,035,"Missouri","Carter County",3,60,89,40,49
050,29,035,"Missouri","Carter County",3,61,87,47,40
050,29,035,"Missouri","Carter County",3,62,88,42,46
050,29,035,"Missouri","Carter County",3,63,77,41,36
050,29,035,"Missouri","Carter County",3,64,76,38,38
050,29,035,"Missouri","Carter County",3,65,69,37,32
050,29,035,"Missouri","Carter County",3,66,73,35,38
050,29,035,"Missouri","Carter County",3,67,78,39,39
050,29,035,"Missouri","Carter County",3,68,76,34,42
050,29,035,"Missouri","Carter County",3,69,60,26,34
050,29,035,"Missouri","Carter County",3,70,70,34,36
050,29,035,"Missouri","Carter County",3,71,72,34,38
050,29,035,"Missouri","Carter County",3,72,60,29,31
050,29,035,"Missouri","Carter County",3,73,50,25,25
050,29,035,"Missouri","Carter County",3,74,53,25,28
050,29,035,"Missouri","Carter County",3,75,38,19,19
050,29,035,"Missouri","Carter County",3,76,39,19,20
050,29,035,"Missouri","Carter County",3,77,45,19,26
050,29,035,"Missouri","Carter County",3,78,33,13,20
050,29,035,"Missouri","Carter County",3,79,32,15,17
050,29,035,"Missouri","Carter County",3,80,34,17,17
050,29,035,"Missouri","Carter County",3,81,28,14,14
050,29,035,"Missouri","Carter County",3,82,26,11,15
050,29,035,"Missouri","Carter County",3,83,22,11,11
050,29,035,"Missouri","Carter County",3,84,24,13,11
050,29,035,"Missouri","Carter County",3,85,102,35,67
050,29,035,"Missouri","Carter County",4,0,85,41,44
050,29,035,"Missouri","Carter County",4,1,65,33,32
050,29,035,"Missouri","Carter County",4,2,63,30,33
050,29,035,"Missouri","Carter County",4,3,67,32,35
050,29,035,"Missouri","Carter County",4,4,54,24,30
050,29,035,"Missouri","Carter County",4,5,68,39,29
050,29,035,"Missouri","Carter County",4,6,70,31,39
050,29,035,"Missouri","Carter County",4,7,67,35,32
050,29,035,"Missouri","Carter County",4,8,80,35,45
050,29,035,"Missouri","Carter County",4,9,74,33,41
050,29,035,"Missouri","Carter County",4,10,62,27,35
050,29,035,"Missouri","Carter County",4,11,74,40,34
050,29,035,"Missouri","Carter County",4,12,71,35,36
050,29,035,"Missouri","Carter County",4,13,62,33,29
050,29,035,"Missouri","Carter County",4,14,78,39,39
050,29,035,"Missouri","Carter County",4,15,71,32,39
050,29,035,"Missouri","Carter County",4,16,71,40,31
050,29,035,"Missouri","Carter County",4,17,71,37,34
050,29,035,"Missouri","Carter County",4,18,63,34,29
050,29,035,"Missouri","Carter County",4,19,49,25,24
050,29,035,"Missouri","Carter County",4,20,51,25,26
050,29,035,"Missouri","Carter County",4,21,62,30,32
050,29,035,"Missouri","Carter County",4,22,54,30,24
050,29,035,"Missouri","Carter County",4,23,48,26,22
050,29,035,"Missouri","Carter County",4,24,61,34,27
050,29,035,"Missouri","Carter County",4,25,53,28,25
050,29,035,"Missouri","Carter County",4,26,55,26,29
050,29,035,"Missouri","Carter County",4,27,53,26,27
050,29,035,"Missouri","Carter County",4,28,52,24,28
050,29,035,"Missouri","Carter County",4,29,50,25,25
050,29,035,"Missouri","Carter County",4,30,63,35,28
050,29,035,"Missouri","Carter County",4,31,61,25,36
050,29,035,"Missouri","Carter County",4,32,56,27,29
050,29,035,"Missouri","Carter County",4,33,59,28,31
050,29,035,"Missouri","Carter County",4,34,57,28,29
050,29,035,"Missouri","Carter County",4,35,46,22,24
050,29,035,"Missouri","Carter County",4,36,56,24,32
050,29,035,"Missouri","Carter County",4,37,49,22,27
050,29,035,"Missouri","Carter County",4,38,45,24,21
050,29,035,"Missouri","Carter County",4,39,57,34,23
050,29,035,"Missouri","Carter County",4,40,61,31,30
050,29,035,"Missouri","Carter County",4,41,66,32,34
050,29,035,"Missouri","Carter County",4,42,65,31,34
050,29,035,"Missouri","Carter County",4,43,62,28,34
050,29,035,"Missouri","Carter County",4,44,62,31,31
050,29,035,"Missouri","Carter County",4,45,63,28,35
050,29,035,"Missouri","Carter County",4,46,50,23,27
050,29,035,"Missouri","Carter County",4,47,60,30,30
050,29,035,"Missouri","Carter County",4,48,65,36,29
050,29,035,"Missouri","Carter County",4,49,66,38,28
050,29,035,"Missouri","Carter County",4,50,63,30,33
050,29,035,"Missouri","Carter County",4,51,72,35,37
050,29,035,"Missouri","Carter County",4,52,64,31,33
050,29,035,"Missouri","Carter County",4,53,59,30,29
050,29,035,"Missouri","Carter County",4,54,61,32,29
050,29,035,"Missouri","Carter County",4,55,66,32,34
050,29,035,"Missouri","Carter County",4,56,67,28,39
050,29,035,"Missouri","Carter County",4,57,69,36,33
050,29,035,"Missouri","Carter County",4,58,78,44,34
050,29,035,"Missouri","Carter County",4,59,75,41,34
050,29,035,"Missouri","Carter County",4,60,70,30,40
050,29,035,"Missouri","Carter County",4,61,89,38,51
050,29,035,"Missouri","Carter County",4,62,87,48,39
050,29,035,"Missouri","Carter County",4,63,88,40,48
050,29,035,"Missouri","Carter County",4,64,78,40,38
050,29,035,"Missouri","Carter County",4,65,74,40,34
050,29,035,"Missouri","Carter County",4,66,65,35,30
050,29,035,"Missouri","Carter County",4,67,74,37,37
050,29,035,"Missouri","Carter County",4,68,78,38,40
050,29,035,"Missouri","Carter County",4,69,74,35,39
050,29,035,"Missouri","Carter County",4,70,55,24,31
050,29,035,"Missouri","Carter County",4,71,71,33,38
050,29,035,"Missouri","Carter County",4,72,65,31,34
050,29,035,"Missouri","Carter County",4,73,56,26,30
050,29,035,"Missouri","Carter County",4,74,49,24,25
050,29,035,"Missouri","Carter County",4,75,49,22,27
050,29,035,"Missouri","Carter County",4,76,37,20,17
050,29,035,"Missouri","Carter County",4,77,35,18,17
050,29,035,"Missouri","Carter County",4,78,40,17,23
050,29,035,"Missouri","Carter County",4,79,33,13,20
050,29,035,"Missouri","Carter County",4,80,26,10,16
050,29,035,"Missouri","Carter County",4,81,34,18,16
050,29,035,"Missouri","Carter County",4,82,27,14,13
050,29,035,"Missouri","Carter County",4,83,21,10,11
050,29,035,"Missouri","Carter County",4,84,24,14,10
050,29,035,"Missouri","Carter County",4,85,108,36,72
050,29,035,"Missouri","Carter County",5,0,81,39,42
050,29,035,"Missouri","Carter County",5,1,80,41,39
050,29,035,"Missouri","Carter County",5,2,74,38,36
050,29,035,"Missouri","Carter County",5,3,62,31,31
050,29,035,"Missouri","Carter County",5,4,67,29,38
050,29,035,"Missouri","Carter County",5,5,60,28,32
050,29,035,"Missouri","Carter County",5,6,68,39,29
050,29,035,"Missouri","Carter County",5,7,77,37,40
050,29,035,"Missouri","Carter County",5,8,70,35,35
050,29,035,"Missouri","Carter County",5,9,81,34,47
050,29,035,"Missouri","Carter County",5,10,73,34,39
050,29,035,"Missouri","Carter County",5,11,60,27,33
050,29,035,"Missouri","Carter County",5,12,68,35,33
050,29,035,"Missouri","Carter County",5,13,73,35,38
050,29,035,"Missouri","Carter County",5,14,61,32,29
050,29,035,"Missouri","Carter County",5,15,80,41,39
050,29,035,"Missouri","Carter County",5,16,73,31,42
050,29,035,"Missouri","Carter County",5,17,69,39,30
050,29,035,"Missouri","Carter County",5,18,57,27,30
050,29,035,"Missouri","Carter County",5,19,47,26,21
050,29,035,"Missouri","Carter County",5,20,50,25,25
050,29,035,"Missouri","Carter County",5,21,57,26,31
050,29,035,"Missouri","Carter County",5,22,59,29,30
050,29,035,"Missouri","Carter County",5,23,65,37,28
050,29,035,"Missouri","Carter County",5,24,50,27,23
050,29,035,"Missouri","Carter County",5,25,64,38,26
050,29,035,"Missouri","Carter County",5,26,55,24,31
050,29,035,"Missouri","Carter County",5,27,53,27,26
050,29,035,"Missouri","Carter County",5,28,56,26,30
050,29,035,"Missouri","Carter County",5,29,55,29,26
050,29,035,"Missouri","Carter County",5,30,61,29,32
050,29,035,"Missouri","Carter County",5,31,61,35,26
050,29,035,"Missouri","Carter County",5,32,59,22,37
050,29,035,"Missouri","Carter County",5,33,58,26,32
050,29,035,"Missouri","Carter County",5,34,57,28,29
050,29,035,"Missouri","Carter County",5,35,56,28,28
050,29,035,"Missouri","Carter County",5,36,53,26,27
050,29,035,"Missouri","Carter County",5,37,57,24,33
050,29,035,"Missouri","Carter County",5,38,50,23,27
050,29,035,"Missouri","Carter County",5,39,47,25,22
050,29,035,"Missouri","Carter County",5,40,52,29,23
050,29,035,"Missouri","Carter County",5,41,61,32,29
050,29,035,"Missouri","Carter County",5,42,65,32,33
050,29,035,"Missouri","Carter County",5,43,69,34,35
050,29,035,"Missouri","Carter County",5,44,61,29,32
050,29,035,"Missouri","Carter County",5,45,63,31,32
050,29,035,"Missouri","Carter County",5,46,61,24,37
050,29,035,"Missouri","Carter County",5,47,52,23,29
050,29,035,"Missouri","Carter County",5,48,60,30,30
050,29,035,"Missouri","Carter County",5,49,65,35,30
050,29,035,"Missouri","Carter County",5,50,71,42,29
050,29,035,"Missouri","Carter County",5,51,63,30,33
050,29,035,"Missouri","Carter County",5,52,73,34,39
050,29,035,"Missouri","Carter County",5,53,63,29,34
050,29,035,"Missouri","Carter County",5,54,59,30,29
050,29,035,"Missouri","Carter County",5,55,61,30,31
050,29,035,"Missouri","Carter County",5,56,68,35,33
050,29,035,"Missouri","Carter County",5,57,66,31,35
050,29,035,"Missouri","Carter County",5,58,66,35,31
050,29,035,"Missouri","Carter County",5,59,77,42,35
050,29,035,"Missouri","Carter County",5,60,77,41,36
050,29,035,"Missouri","Carter County",5,61,69,31,38
050,29,035,"Missouri","Carter County",5,62,87,38,49
050,29,035,"Missouri","Carter County",5,63,89,49,40
050,29,035,"Missouri","Carter County",5,64,87,39,48
050,29,035,"Missouri","Carter County",5,65,78,38,40
050,29,035,"Missouri","Carter County",5,66,75,40,35
050,29,035,"Missouri","Carter County",5,67,65,36,29
050,29,035,"Missouri","Carter County",5,68,70,34,36
050,29,035,"Missouri","Carter County",5,69,78,39,39
050,29,035,"Missouri","Carter County",5,70,72,33,39
050,29,035,"Missouri","Carter County",5,71,56,23,33
050,29,035,"Missouri","Carter County",5,72,65,32,33
050,29,035,"Missouri","Carter County",5,73,64,31,33
050,29,035,"Missouri","Carter County",5,74,55,25,30
050,29,035,"Missouri","Carter County",5,75,46,22,24
050,29,035,"Missouri","Carter County",5,76,46,22,24
050,29,035,"Missouri","Carter County",5,77,37,20,17
050,29,035,"Missouri","Carter County",5,78,33,17,16
050,29,035,"Missouri","Carter County",5,79,38,16,22
050,29,035,"Missouri","Carter County",5,80,28,10,18
050,29,035,"Missouri","Carter County",5,81,24,9,15
050,29,035,"Missouri","Carter County",5,82,32,17,15
050,29,035,"Missouri","Carter County",5,83,21,14,7
050,29,035,"Missouri","Carter County",5,84,22,13,9
050,29,035,"Missouri","Carter County",5,85,109,38,71
050,29,037,"Missouri","Cass County",1,0,1152,585,567
050,29,037,"Missouri","Cass County",1,1,1195,601,594
050,29,037,"Missouri","Cass County",1,2,1287,664,623
050,29,037,"Missouri","Cass County",1,3,1329,682,647
050,29,037,"Missouri","Cass County",1,4,1325,677,648
050,29,037,"Missouri","Cass County",1,5,1351,676,675
050,29,037,"Missouri","Cass County",1,6,1374,702,672
050,29,037,"Missouri","Cass County",1,7,1386,736,650
050,29,037,"Missouri","Cass County",1,8,1449,771,678
050,29,037,"Missouri","Cass County",1,9,1488,758,730
050,29,037,"Missouri","Cass County",1,10,1537,770,767
050,29,037,"Missouri","Cass County",1,11,1546,772,774
050,29,037,"Missouri","Cass County",1,12,1577,793,784
050,29,037,"Missouri","Cass County",1,13,1634,857,777
050,29,037,"Missouri","Cass County",1,14,1580,818,762
050,29,037,"Missouri","Cass County",1,15,1581,792,789
050,29,037,"Missouri","Cass County",1,16,1601,820,781
050,29,037,"Missouri","Cass County",1,17,1583,800,783
050,29,037,"Missouri","Cass County",1,18,1290,670,620
050,29,037,"Missouri","Cass County",1,19,1039,547,492
050,29,037,"Missouri","Cass County",1,20,1111,580,531
050,29,037,"Missouri","Cass County",1,21,1133,581,552
050,29,037,"Missouri","Cass County",1,22,1149,568,581
050,29,037,"Missouri","Cass County",1,23,1120,582,538
050,29,037,"Missouri","Cass County",1,24,1122,573,549
050,29,037,"Missouri","Cass County",1,25,1210,610,600
050,29,037,"Missouri","Cass County",1,26,1270,613,657
050,29,037,"Missouri","Cass County",1,27,1239,623,616
050,29,037,"Missouri","Cass County",1,28,1270,643,627
050,29,037,"Missouri","Cass County",1,29,1345,660,685
050,29,037,"Missouri","Cass County",1,30,1337,667,670
050,29,037,"Missouri","Cass County",1,31,1251,587,664
050,29,037,"Missouri","Cass County",1,32,1271,599,672
050,29,037,"Missouri","Cass County",1,33,1367,672,695
050,29,037,"Missouri","Cass County",1,34,1344,699,645
050,29,037,"Missouri","Cass County",1,35,1305,662,643
050,29,037,"Missouri","Cass County",1,36,1400,699,701
050,29,037,"Missouri","Cass County",1,37,1367,659,708
050,29,037,"Missouri","Cass County",1,38,1388,680,708
050,29,037,"Missouri","Cass County",1,39,1424,690,734
050,29,037,"Missouri","Cass County",1,40,1411,698,713
050,29,037,"Missouri","Cass County",1,41,1373,670,703
050,29,037,"Missouri","Cass County",1,42,1357,660,697
050,29,037,"Missouri","Cass County",1,43,1353,688,665
050,29,037,"Missouri","Cass County",1,44,1315,639,676
050,29,037,"Missouri","Cass County",1,45,1339,674,665
050,29,037,"Missouri","Cass County",1,46,1329,665,664
050,29,037,"Missouri","Cass County",1,47,1334,659,675
050,29,037,"Missouri","Cass County",1,48,1345,667,678
050,29,037,"Missouri","Cass County",1,49,1492,746,746
050,29,037,"Missouri","Cass County",1,50,1396,692,704
050,29,037,"Missouri","Cass County",1,51,1353,684,669
050,29,037,"Missouri","Cass County",1,52,1338,676,662
050,29,037,"Missouri","Cass County",1,53,1340,673,667
050,29,037,"Missouri","Cass County",1,54,1362,686,676
050,29,037,"Missouri","Cass County",1,55,1503,742,761
050,29,037,"Missouri","Cass County",1,56,1554,773,781
050,29,037,"Missouri","Cass County",1,57,1649,832,817
050,29,037,"Missouri","Cass County",1,58,1644,817,827
050,29,037,"Missouri","Cass County",1,59,1601,768,833
050,29,037,"Missouri","Cass County",1,60,1521,747,774
050,29,037,"Missouri","Cass County",1,61,1533,765,768
050,29,037,"Missouri","Cass County",1,62,1472,725,747
050,29,037,"Missouri","Cass County",1,63,1465,722,743
050,29,037,"Missouri","Cass County",1,64,1362,667,695
050,29,037,"Missouri","Cass County",1,65,1299,619,680
050,29,037,"Missouri","Cass County",1,66,1234,579,655
050,29,037,"Missouri","Cass County",1,67,1175,560,615
050,29,037,"Missouri","Cass County",1,68,1112,521,591
050,29,037,"Missouri","Cass County",1,69,1037,474,563
050,29,037,"Missouri","Cass County",1,70,1009,459,550
050,29,037,"Missouri","Cass County",1,71,993,433,560
050,29,037,"Missouri","Cass County",1,72,1006,439,567
050,29,037,"Missouri","Cass County",1,73,1024,467,557
050,29,037,"Missouri","Cass County",1,74,718,325,393
050,29,037,"Missouri","Cass County",1,75,712,334,378
050,29,037,"Missouri","Cass County",1,76,761,335,426
050,29,037,"Missouri","Cass County",1,77,748,319,429
050,29,037,"Missouri","Cass County",1,78,639,271,368
050,29,037,"Missouri","Cass County",1,79,574,246,328
050,29,037,"Missouri","Cass County",1,80,519,237,282
050,29,037,"Missouri","Cass County",1,81,500,218,282
050,29,037,"Missouri","Cass County",1,82,411,172,239
050,29,037,"Missouri","Cass County",1,83,400,176,224
050,29,037,"Missouri","Cass County",1,84,377,156,221
050,29,037,"Missouri","Cass County",1,85,2107,769,1338
050,29,037,"Missouri","Cass County",2,0,1165,600,565
050,29,037,"Missouri","Cass County",2,1,1191,599,592
050,29,037,"Missouri","Cass County",2,2,1273,650,623
050,29,037,"Missouri","Cass County",2,3,1317,678,639
050,29,037,"Missouri","Cass County",2,4,1332,678,654
050,29,037,"Missouri","Cass County",2,5,1350,677,673
050,29,037,"Missouri","Cass County",2,6,1376,700,676
050,29,037,"Missouri","Cass County",2,7,1387,730,657
050,29,037,"Missouri","Cass County",2,8,1431,761,670
050,29,037,"Missouri","Cass County",2,9,1473,759,714
050,29,037,"Missouri","Cass County",2,10,1527,771,756
050,29,037,"Missouri","Cass County",2,11,1538,769,769
050,29,037,"Missouri","Cass County",2,12,1578,792,786
050,29,037,"Missouri","Cass County",2,13,1622,843,779
050,29,037,"Missouri","Cass County",2,14,1606,837,769
050,29,037,"Missouri","Cass County",2,15,1596,809,787
050,29,037,"Missouri","Cass County",2,16,1604,816,788
050,29,037,"Missouri","Cass County",2,17,1588,803,785
050,29,037,"Missouri","Cass County",2,18,1294,675,619
050,29,037,"Missouri","Cass County",2,19,1047,548,499
050,29,037,"Missouri","Cass County",2,20,1125,588,537
050,29,037,"Missouri","Cass County",2,21,1136,580,556
050,29,037,"Missouri","Cass County",2,22,1162,581,581
050,29,037,"Missouri","Cass County",2,23,1142,590,552
050,29,037,"Missouri","Cass County",2,24,1129,577,552
050,29,037,"Missouri","Cass County",2,25,1203,606,597
050,29,037,"Missouri","Cass County",2,26,1268,622,646
050,29,037,"Missouri","Cass County",2,27,1249,622,627
050,29,037,"Missouri","Cass County",2,28,1270,640,630
050,29,037,"Missouri","Cass County",2,29,1339,660,679
050,29,037,"Missouri","Cass County",2,30,1351,668,683
050,29,037,"Missouri","Cass County",2,31,1278,609,669
050,29,037,"Missouri","Cass County",2,32,1274,599,675
050,29,037,"Missouri","Cass County",2,33,1352,659,693
050,29,037,"Missouri","Cass County",2,34,1355,693,662
050,29,037,"Missouri","Cass County",2,35,1336,682,654
050,29,037,"Missouri","Cass County",2,36,1378,690,688
050,29,037,"Missouri","Cass County",2,37,1380,671,709
050,29,037,"Missouri","Cass County",2,38,1394,681,713
050,29,037,"Missouri","Cass County",2,39,1419,693,726
050,29,037,"Missouri","Cass County",2,40,1420,698,722
050,29,037,"Missouri","Cass County",2,41,1380,675,705
050,29,037,"Missouri","Cass County",2,42,1359,666,693
050,29,037,"Missouri","Cass County",2,43,1368,692,676
050,29,037,"Missouri","Cass County",2,44,1315,648,667
050,29,037,"Missouri","Cass County",2,45,1342,668,674
050,29,037,"Missouri","Cass County",2,46,1327,666,661
050,29,037,"Missouri","Cass County",2,47,1328,656,672
050,29,037,"Missouri","Cass County",2,48,1348,666,682
050,29,037,"Missouri","Cass County",2,49,1464,732,732
050,29,037,"Missouri","Cass County",2,50,1427,709,718
050,29,037,"Missouri","Cass County",2,51,1360,688,672
050,29,037,"Missouri","Cass County",2,52,1341,677,664
050,29,037,"Missouri","Cass County",2,53,1349,678,671
050,29,037,"Missouri","Cass County",2,54,1355,682,673
050,29,037,"Missouri","Cass County",2,55,1467,728,739
050,29,037,"Missouri","Cass County",2,56,1547,767,780
050,29,037,"Missouri","Cass County",2,57,1635,820,815
050,29,037,"Missouri","Cass County",2,58,1647,820,827
050,29,037,"Missouri","Cass County",2,59,1623,787,836
050,29,037,"Missouri","Cass County",2,60,1535,750,785
050,29,037,"Missouri","Cass County",2,61,1528,760,768
050,29,037,"Missouri","Cass County",2,62,1487,735,752
050,29,037,"Missouri","Cass County",2,63,1478,728,750
050,29,037,"Missouri","Cass County",2,64,1376,674,702
050,29,037,"Missouri","Cass County",2,65,1308,624,684
050,29,037,"Missouri","Cass County",2,66,1253,589,664
050,29,037,"Missouri","Cass County",2,67,1186,565,621
050,29,037,"Missouri","Cass County",2,68,1122,530,592
050,29,037,"Missouri","Cass County",2,69,1060,491,569
050,29,037,"Missouri","Cass County",2,70,1011,459,552
050,29,037,"Missouri","Cass County",2,71,999,440,559
050,29,037,"Missouri","Cass County",2,72,979,424,555
050,29,037,"Missouri","Cass County",2,73,1071,480,591
050,29,037,"Missouri","Cass County",2,74,742,337,405
050,29,037,"Missouri","Cass County",2,75,710,328,382
050,29,037,"Missouri","Cass County",2,76,737,328,409
050,29,037,"Missouri","Cass County",2,77,762,328,434
050,29,037,"Missouri","Cass County",2,78,649,274,375
050,29,037,"Missouri","Cass County",2,79,576,244,332
050,29,037,"Missouri","Cass County",2,80,533,238,295
050,29,037,"Missouri","Cass County",2,81,495,219,276
050,29,037,"Missouri","Cass County",2,82,430,181,249
050,29,037,"Missouri","Cass County",2,83,394,173,221
050,29,037,"Missouri","Cass County",2,84,379,158,221
050,29,037,"Missouri","Cass County",2,85,2124,774,1350
050,29,037,"Missouri","Cass County",3,0,1113,579,534
050,29,037,"Missouri","Cass County",3,1,1202,612,590
050,29,037,"Missouri","Cass County",3,2,1242,625,617
050,29,037,"Missouri","Cass County",3,3,1347,671,676
050,29,037,"Missouri","Cass County",3,4,1368,693,675
050,29,037,"Missouri","Cass County",3,5,1364,714,650
050,29,037,"Missouri","Cass County",3,6,1444,730,714
050,29,037,"Missouri","Cass County",3,7,1440,736,704
050,29,037,"Missouri","Cass County",3,8,1423,743,680
050,29,037,"Missouri","Cass County",3,9,1450,773,677
050,29,037,"Missouri","Cass County",3,10,1494,777,717
050,29,037,"Missouri","Cass County",3,11,1593,813,780
050,29,037,"Missouri","Cass County",3,12,1547,756,791
050,29,037,"Missouri","Cass County",3,13,1623,807,816
050,29,037,"Missouri","Cass County",3,14,1633,842,791
050,29,037,"Missouri","Cass County",3,15,1634,850,784
050,29,037,"Missouri","Cass County",3,16,1608,798,810
050,29,037,"Missouri","Cass County",3,17,1624,834,790
050,29,037,"Missouri","Cass County",3,18,1335,693,642
050,29,037,"Missouri","Cass County",3,19,1007,512,495
050,29,037,"Missouri","Cass County",3,20,1118,586,532
050,29,037,"Missouri","Cass County",3,21,1152,590,562
050,29,037,"Missouri","Cass County",3,22,1240,633,607
050,29,037,"Missouri","Cass County",3,23,1185,589,596
050,29,037,"Missouri","Cass County",3,24,1180,618,562
050,29,037,"Missouri","Cass County",3,25,1181,604,577
050,29,037,"Missouri","Cass County",3,26,1253,626,627
050,29,037,"Missouri","Cass County",3,27,1328,669,659
050,29,037,"Missouri","Cass County",3,28,1267,636,631
050,29,037,"Missouri","Cass County",3,29,1338,661,677
050,29,037,"Missouri","Cass County",3,30,1396,664,732
050,29,037,"Missouri","Cass County",3,31,1438,702,736
050,29,037,"Missouri","Cass County",3,32,1356,653,703
050,29,037,"Missouri","Cass County",3,33,1340,644,696
050,29,037,"Missouri","Cass County",3,34,1394,689,705
050,29,037,"Missouri","Cass County",3,35,1415,709,706
050,29,037,"Missouri","Cass County",3,36,1372,704,668
050,29,037,"Missouri","Cass County",3,37,1426,716,710
050,29,037,"Missouri","Cass County",3,38,1408,685,723
050,29,037,"Missouri","Cass County",3,39,1418,690,728
050,29,037,"Missouri","Cass County",3,40,1463,725,738
050,29,037,"Missouri","Cass County",3,41,1475,722,753
050,29,037,"Missouri","Cass County",3,42,1392,689,703
050,29,037,"Missouri","Cass County",3,43,1377,681,696
050,29,037,"Missouri","Cass County",3,44,1356,680,676
050,29,037,"Missouri","Cass County",3,45,1321,655,666
050,29,037,"Missouri","Cass County",3,46,1323,664,659
050,29,037,"Missouri","Cass County",3,47,1324,656,668
050,29,037,"Missouri","Cass County",3,48,1330,656,674
050,29,037,"Missouri","Cass County",3,49,1351,678,673
050,29,037,"Missouri","Cass County",3,50,1475,732,743
050,29,037,"Missouri","Cass County",3,51,1462,728,734
050,29,037,"Missouri","Cass County",3,52,1371,695,676
050,29,037,"Missouri","Cass County",3,53,1327,669,658
050,29,037,"Missouri","Cass County",3,54,1385,689,696
050,29,037,"Missouri","Cass County",3,55,1377,703,674
050,29,037,"Missouri","Cass County",3,56,1499,743,756
050,29,037,"Missouri","Cass County",3,57,1537,761,776
050,29,037,"Missouri","Cass County",3,58,1637,816,821
050,29,037,"Missouri","Cass County",3,59,1634,805,829
050,29,037,"Missouri","Cass County",3,60,1608,773,835
050,29,037,"Missouri","Cass County",3,61,1521,740,781
050,29,037,"Missouri","Cass County",3,62,1529,746,783
050,29,037,"Missouri","Cass County",3,63,1454,712,742
050,29,037,"Missouri","Cass County",3,64,1490,737,753
050,29,037,"Missouri","Cass County",3,65,1372,672,700
050,29,037,"Missouri","Cass County",3,66,1283,601,682
050,29,037,"Missouri","Cass County",3,67,1228,572,656
050,29,037,"Missouri","Cass County",3,68,1164,558,606
050,29,037,"Missouri","Cass County",3,69,1105,517,588
050,29,037,"Missouri","Cass County",3,70,1038,476,562
050,29,037,"Missouri","Cass County",3,71,1002,460,542
050,29,037,"Missouri","Cass County",3,72,974,433,541
050,29,037,"Missouri","Cass County",3,73,948,403,545
050,29,037,"Missouri","Cass County",3,74,1034,460,574
050,29,037,"Missouri","Cass County",3,75,729,328,401
050,29,037,"Missouri","Cass County",3,76,693,314,379
050,29,037,"Missouri","Cass County",3,77,705,309,396
050,29,037,"Missouri","Cass County",3,78,742,315,427
050,29,037,"Missouri","Cass County",3,79,620,256,364
050,29,037,"Missouri","Cass County",3,80,567,237,330
050,29,037,"Missouri","Cass County",3,81,511,230,281
050,29,037,"Missouri","Cass County",3,82,453,198,255
050,29,037,"Missouri","Cass County",3,83,405,175,230
050,29,037,"Missouri","Cass County",3,84,371,161,210
050,29,037,"Missouri","Cass County",3,85,2122,779,1343
050,29,037,"Missouri","Cass County",4,0,1144,604,540
050,29,037,"Missouri","Cass County",4,1,1194,612,582
050,29,037,"Missouri","Cass County",4,2,1233,624,609
050,29,037,"Missouri","Cass County",4,3,1264,641,623
050,29,037,"Missouri","Cass County",4,4,1329,669,660
050,29,037,"Missouri","Cass County",4,5,1422,717,705
050,29,037,"Missouri","Cass County",4,6,1374,705,669
050,29,037,"Missouri","Cass County",4,7,1428,730,698
050,29,037,"Missouri","Cass County",4,8,1432,740,692
050,29,037,"Missouri","Cass County",4,9,1434,754,680
050,29,037,"Missouri","Cass County",4,10,1450,780,670
050,29,037,"Missouri","Cass County",4,11,1515,808,707
050,29,037,"Missouri","Cass County",4,12,1622,832,790
050,29,037,"Missouri","Cass County",4,13,1550,762,788
050,29,037,"Missouri","Cass County",4,14,1628,809,819
050,29,037,"Missouri","Cass County",4,15,1647,853,794
050,29,037,"Missouri","Cass County",4,16,1625,837,788
050,29,037,"Missouri","Cass County",4,17,1585,788,797
050,29,037,"Missouri","Cass County",4,18,1366,725,641
050,29,037,"Missouri","Cass County",4,19,1045,538,507
050,29,037,"Missouri","Cass County",4,20,1081,566,515
050,29,037,"Missouri","Cass County",4,21,1118,585,533
050,29,037,"Missouri","Cass County",4,22,1202,620,582
050,29,037,"Missouri","Cass County",4,23,1252,633,619
050,29,037,"Missouri","Cass County",4,24,1244,613,631
050,29,037,"Missouri","Cass County",4,25,1206,628,578
050,29,037,"Missouri","Cass County",4,26,1218,628,590
050,29,037,"Missouri","Cass County",4,27,1290,634,656
050,29,037,"Missouri","Cass County",4,28,1322,660,662
050,29,037,"Missouri","Cass County",4,29,1260,640,620
050,29,037,"Missouri","Cass County",4,30,1343,675,668
050,29,037,"Missouri","Cass County",4,31,1435,696,739
050,29,037,"Missouri","Cass County",4,32,1439,694,745
050,29,037,"Missouri","Cass County",4,33,1371,652,719
050,29,037,"Missouri","Cass County",4,34,1341,648,693
050,29,037,"Missouri","Cass County",4,35,1444,714,730
050,29,037,"Missouri","Cass County",4,36,1444,709,735
050,29,037,"Missouri","Cass County",4,37,1428,742,686
050,29,037,"Missouri","Cass County",4,38,1403,684,719
050,29,037,"Missouri","Cass County",4,39,1433,696,737
050,29,037,"Missouri","Cass County",4,40,1458,716,742
050,29,037,"Missouri","Cass County",4,41,1484,736,748
050,29,037,"Missouri","Cass County",4,42,1480,730,750
050,29,037,"Missouri","Cass County",4,43,1405,697,708
050,29,037,"Missouri","Cass County",4,44,1374,681,693
050,29,037,"Missouri","Cass County",4,45,1369,694,675
050,29,037,"Missouri","Cass County",4,46,1310,664,646
050,29,037,"Missouri","Cass County",4,47,1331,667,664
050,29,037,"Missouri","Cass County",4,48,1350,669,681
050,29,037,"Missouri","Cass County",4,49,1337,661,676
050,29,037,"Missouri","Cass County",4,50,1355,668,687
050,29,037,"Missouri","Cass County",4,51,1473,741,732
050,29,037,"Missouri","Cass County",4,52,1452,718,734
050,29,037,"Missouri","Cass County",4,53,1351,691,660
050,29,037,"Missouri","Cass County",4,54,1325,669,656
050,29,037,"Missouri","Cass County",4,55,1394,690,704
050,29,037,"Missouri","Cass County",4,56,1367,693,674
050,29,037,"Missouri","Cass County",4,57,1514,733,781
050,29,037,"Missouri","Cass County",4,58,1519,754,765
050,29,037,"Missouri","Cass County",4,59,1616,803,813
050,29,037,"Missouri","Cass County",4,60,1631,806,825
050,29,037,"Missouri","Cass County",4,61,1594,762,832
050,29,037,"Missouri","Cass County",4,62,1527,742,785
050,29,037,"Missouri","Cass County",4,63,1518,735,783
050,29,037,"Missouri","Cass County",4,64,1428,698,730
050,29,037,"Missouri","Cass County",4,65,1463,718,745
050,29,037,"Missouri","Cass County",4,66,1366,667,699
050,29,037,"Missouri","Cass County",4,67,1279,584,695
050,29,037,"Missouri","Cass County",4,68,1226,570,656
050,29,037,"Missouri","Cass County",4,69,1152,548,604
050,29,037,"Missouri","Cass County",4,70,1091,496,595
050,29,037,"Missouri","Cass County",4,71,1036,486,550
050,29,037,"Missouri","Cass County",4,72,990,448,542
050,29,037,"Missouri","Cass County",4,73,951,417,534
050,29,037,"Missouri","Cass County",4,74,926,394,532
050,29,037,"Missouri","Cass County",4,75,1016,436,580
050,29,037,"Missouri","Cass County",4,76,716,319,397
050,29,037,"Missouri","Cass County",4,77,695,312,383
050,29,037,"Missouri","Cass County",4,78,671,286,385
050,29,037,"Missouri","Cass County",4,79,703,294,409
050,29,037,"Missouri","Cass County",4,80,603,242,361
050,29,037,"Missouri","Cass County",4,81,533,228,305
050,29,037,"Missouri","Cass County",4,82,473,208,265
050,29,037,"Missouri","Cass County",4,83,428,190,238
050,29,037,"Missouri","Cass County",4,84,381,164,217
050,29,037,"Missouri","Cass County",4,85,2135,818,1317
050,29,037,"Missouri","Cass County",5,0,1191,629,562
050,29,037,"Missouri","Cass County",5,1,1173,600,573
050,29,037,"Missouri","Cass County",5,2,1235,644,591
050,29,037,"Missouri","Cass County",5,3,1287,650,637
050,29,037,"Missouri","Cass County",5,4,1295,657,638
050,29,037,"Missouri","Cass County",5,5,1368,689,679
050,29,037,"Missouri","Cass County",5,6,1467,728,739
050,29,037,"Missouri","Cass County",5,7,1397,729,668
050,29,037,"Missouri","Cass County",5,8,1460,750,710
050,29,037,"Missouri","Cass County",5,9,1441,749,692
050,29,037,"Missouri","Cass County",5,10,1444,755,689
050,29,037,"Missouri","Cass County",5,11,1496,792,704
050,29,037,"Missouri","Cass County",5,12,1522,807,715
050,29,037,"Missouri","Cass County",5,13,1601,821,780
050,29,037,"Missouri","Cass County",5,14,1571,769,802
050,29,037,"Missouri","Cass County",5,15,1635,822,813
050,29,037,"Missouri","Cass County",5,16,1648,856,792
050,29,037,"Missouri","Cass County",5,17,1621,819,802
050,29,037,"Missouri","Cass County",5,18,1315,674,641
050,29,037,"Missouri","Cass County",5,19,1092,578,514
050,29,037,"Missouri","Cass County",5,20,1139,594,545
050,29,037,"Missouri","Cass County",5,21,1137,572,565
050,29,037,"Missouri","Cass County",5,22,1238,648,590
050,29,037,"Missouri","Cass County",5,23,1270,658,612
050,29,037,"Missouri","Cass County",5,24,1323,654,669
050,29,037,"Missouri","Cass County",5,25,1283,628,655
050,29,037,"Missouri","Cass County",5,26,1292,667,625
050,29,037,"Missouri","Cass County",5,27,1253,632,621
050,29,037,"Missouri","Cass County",5,28,1331,667,664
050,29,037,"Missouri","Cass County",5,29,1363,693,670
050,29,037,"Missouri","Cass County",5,30,1300,658,642
050,29,037,"Missouri","Cass County",5,31,1409,704,705
050,29,037,"Missouri","Cass County",5,32,1479,737,742
050,29,037,"Missouri","Cass County",5,33,1481,723,758
050,29,037,"Missouri","Cass County",5,34,1380,658,722
050,29,037,"Missouri","Cass County",5,35,1392,675,717
050,29,037,"Missouri","Cass County",5,36,1444,724,720
050,29,037,"Missouri","Cass County",5,37,1469,724,745
050,29,037,"Missouri","Cass County",5,38,1453,747,706
050,29,037,"Missouri","Cass County",5,39,1405,696,709
050,29,037,"Missouri","Cass County",5,40,1439,708,731
050,29,037,"Missouri","Cass County",5,41,1476,719,757
050,29,037,"Missouri","Cass County",5,42,1475,735,740
050,29,037,"Missouri","Cass County",5,43,1479,727,752
050,29,037,"Missouri","Cass County",5,44,1418,701,717
050,29,037,"Missouri","Cass County",5,45,1397,698,699
050,29,037,"Missouri","Cass County",5,46,1389,711,678
050,29,037,"Missouri","Cass County",5,47,1332,668,664
050,29,037,"Missouri","Cass County",5,48,1331,675,656
050,29,037,"Missouri","Cass County",5,49,1348,665,683
050,29,037,"Missouri","Cass County",5,50,1360,668,692
050,29,037,"Missouri","Cass County",5,51,1374,692,682
050,29,037,"Missouri","Cass County",5,52,1474,742,732
050,29,037,"Missouri","Cass County",5,53,1476,720,756
050,29,037,"Missouri","Cass County",5,54,1346,681,665
050,29,037,"Missouri","Cass County",5,55,1348,682,666
050,29,037,"Missouri","Cass County",5,56,1400,692,708
050,29,037,"Missouri","Cass County",5,57,1387,697,690
050,29,037,"Missouri","Cass County",5,58,1491,730,761
050,29,037,"Missouri","Cass County",5,59,1507,731,776
050,29,037,"Missouri","Cass County",5,60,1625,811,814
050,29,037,"Missouri","Cass County",5,61,1639,815,824
050,29,037,"Missouri","Cass County",5,62,1578,750,828
050,29,037,"Missouri","Cass County",5,63,1526,733,793
050,29,037,"Missouri","Cass County",5,64,1496,720,776
050,29,037,"Missouri","Cass County",5,65,1412,694,718
050,29,037,"Missouri","Cass County",5,66,1444,700,744
050,29,037,"Missouri","Cass County",5,67,1357,660,697
050,29,037,"Missouri","Cass County",5,68,1282,584,698
050,29,037,"Missouri","Cass County",5,69,1206,552,654
050,29,037,"Missouri","Cass County",5,70,1142,529,613
050,29,037,"Missouri","Cass County",5,71,1085,510,575
050,29,037,"Missouri","Cass County",5,72,1030,486,544
050,29,037,"Missouri","Cass County",5,73,962,426,536
050,29,037,"Missouri","Cass County",5,74,924,405,519
050,29,037,"Missouri","Cass County",5,75,901,379,522
050,29,037,"Missouri","Cass County",5,76,1008,428,580
050,29,037,"Missouri","Cass County",5,77,693,306,387
050,29,037,"Missouri","Cass County",5,78,663,301,362
050,29,037,"Missouri","Cass County",5,79,645,269,376
050,29,037,"Missouri","Cass County",5,80,681,278,403
050,29,037,"Missouri","Cass County",5,81,573,233,340
050,29,037,"Missouri","Cass County",5,82,488,201,287
050,29,037,"Missouri","Cass County",5,83,442,193,249
050,29,037,"Missouri","Cass County",5,84,408,181,227
050,29,037,"Missouri","Cass County",5,85,2175,871,1304
050,29,039,"Missouri","Cedar County",1,0,188,96,92
050,29,039,"Missouri","Cedar County",1,1,185,99,86
050,29,039,"Missouri","Cedar County",1,2,162,80,82
050,29,039,"Missouri","Cedar County",1,3,204,104,100
050,29,039,"Missouri","Cedar County",1,4,191,95,96
050,29,039,"Missouri","Cedar County",1,5,198,104,94
050,29,039,"Missouri","Cedar County",1,6,190,102,88
050,29,039,"Missouri","Cedar County",1,7,187,98,89
050,29,039,"Missouri","Cedar County",1,8,173,92,81
050,29,039,"Missouri","Cedar County",1,9,173,97,76
050,29,039,"Missouri","Cedar County",1,10,175,92,83
050,29,039,"Missouri","Cedar County",1,11,182,95,87
050,29,039,"Missouri","Cedar County",1,12,185,84,101
050,29,039,"Missouri","Cedar County",1,13,212,109,103
050,29,039,"Missouri","Cedar County",1,14,206,109,97
050,29,039,"Missouri","Cedar County",1,15,196,115,81
050,29,039,"Missouri","Cedar County",1,16,205,119,86
050,29,039,"Missouri","Cedar County",1,17,202,111,91
050,29,039,"Missouri","Cedar County",1,18,165,96,69
050,29,039,"Missouri","Cedar County",1,19,141,79,62
050,29,039,"Missouri","Cedar County",1,20,133,72,61
050,29,039,"Missouri","Cedar County",1,21,136,70,66
050,29,039,"Missouri","Cedar County",1,22,138,73,65
050,29,039,"Missouri","Cedar County",1,23,132,64,68
050,29,039,"Missouri","Cedar County",1,24,139,63,76
050,29,039,"Missouri","Cedar County",1,25,131,75,56
050,29,039,"Missouri","Cedar County",1,26,136,76,60
050,29,039,"Missouri","Cedar County",1,27,149,72,77
050,29,039,"Missouri","Cedar County",1,28,149,69,80
050,29,039,"Missouri","Cedar County",1,29,153,79,74
050,29,039,"Missouri","Cedar County",1,30,148,83,65
050,29,039,"Missouri","Cedar County",1,31,135,77,58
050,29,039,"Missouri","Cedar County",1,32,133,63,70
050,29,039,"Missouri","Cedar County",1,33,128,53,75
050,29,039,"Missouri","Cedar County",1,34,139,59,80
050,29,039,"Missouri","Cedar County",1,35,142,69,73
050,29,039,"Missouri","Cedar County",1,36,148,75,73
050,29,039,"Missouri","Cedar County",1,37,155,77,78
050,29,039,"Missouri","Cedar County",1,38,151,80,71
050,29,039,"Missouri","Cedar County",1,39,160,87,73
050,29,039,"Missouri","Cedar County",1,40,139,67,72
050,29,039,"Missouri","Cedar County",1,41,136,67,69
050,29,039,"Missouri","Cedar County",1,42,132,69,63
050,29,039,"Missouri","Cedar County",1,43,148,71,77
050,29,039,"Missouri","Cedar County",1,44,144,71,73
050,29,039,"Missouri","Cedar County",1,45,152,80,72
050,29,039,"Missouri","Cedar County",1,46,138,81,57
050,29,039,"Missouri","Cedar County",1,47,148,82,66
050,29,039,"Missouri","Cedar County",1,48,157,78,79
050,29,039,"Missouri","Cedar County",1,49,171,88,83
050,29,039,"Missouri","Cedar County",1,50,167,92,75
050,29,039,"Missouri","Cedar County",1,51,192,101,91
050,29,039,"Missouri","Cedar County",1,52,184,86,98
050,29,039,"Missouri","Cedar County",1,53,180,88,92
050,29,039,"Missouri","Cedar County",1,54,174,84,90
050,29,039,"Missouri","Cedar County",1,55,179,86,93
050,29,039,"Missouri","Cedar County",1,56,192,102,90
050,29,039,"Missouri","Cedar County",1,57,205,106,99
050,29,039,"Missouri","Cedar County",1,58,212,108,104
050,29,039,"Missouri","Cedar County",1,59,209,105,104
050,29,039,"Missouri","Cedar County",1,60,202,99,103
050,29,039,"Missouri","Cedar County",1,61,201,100,101
050,29,039,"Missouri","Cedar County",1,62,227,109,118
050,29,039,"Missouri","Cedar County",1,63,198,102,96
050,29,039,"Missouri","Cedar County",1,64,192,99,93
050,29,039,"Missouri","Cedar County",1,65,205,104,101
050,29,039,"Missouri","Cedar County",1,66,203,111,92
050,29,039,"Missouri","Cedar County",1,67,161,71,90
050,29,039,"Missouri","Cedar County",1,68,187,89,98
050,29,039,"Missouri","Cedar County",1,69,195,92,103
050,29,039,"Missouri","Cedar County",1,70,185,90,95
050,29,039,"Missouri","Cedar County",1,71,208,101,107
050,29,039,"Missouri","Cedar County",1,72,177,99,78
050,29,039,"Missouri","Cedar County",1,73,175,84,91
050,29,039,"Missouri","Cedar County",1,74,122,51,71
050,29,039,"Missouri","Cedar County",1,75,134,59,75
050,29,039,"Missouri","Cedar County",1,76,123,57,66
050,29,039,"Missouri","Cedar County",1,77,130,64,66
050,29,039,"Missouri","Cedar County",1,78,110,55,55
050,29,039,"Missouri","Cedar County",1,79,116,54,62
050,29,039,"Missouri","Cedar County",1,80,98,47,51
050,29,039,"Missouri","Cedar County",1,81,84,39,45
050,29,039,"Missouri","Cedar County",1,82,81,33,48
050,29,039,"Missouri","Cedar County",1,83,73,36,37
050,29,039,"Missouri","Cedar County",1,84,91,44,47
050,29,039,"Missouri","Cedar County",1,85,395,138,257
050,29,039,"Missouri","Cedar County",2,0,196,99,97
050,29,039,"Missouri","Cedar County",2,1,182,97,85
050,29,039,"Missouri","Cedar County",2,2,169,86,83
050,29,039,"Missouri","Cedar County",2,3,192,97,95
050,29,039,"Missouri","Cedar County",2,4,195,98,97
050,29,039,"Missouri","Cedar County",2,5,196,103,93
050,29,039,"Missouri","Cedar County",2,6,195,105,90
050,29,039,"Missouri","Cedar County",2,7,187,99,88
050,29,039,"Missouri","Cedar County",2,8,177,94,83
050,29,039,"Missouri","Cedar County",2,9,172,96,76
050,29,039,"Missouri","Cedar County",2,10,175,94,81
050,29,039,"Missouri","Cedar County",2,11,179,94,85
050,29,039,"Missouri","Cedar County",2,12,186,88,98
050,29,039,"Missouri","Cedar County",2,13,207,105,102
050,29,039,"Missouri","Cedar County",2,14,206,109,97
050,29,039,"Missouri","Cedar County",2,15,196,111,85
050,29,039,"Missouri","Cedar County",2,16,204,118,86
050,29,039,"Missouri","Cedar County",2,17,200,111,89
050,29,039,"Missouri","Cedar County",2,18,165,94,71
050,29,039,"Missouri","Cedar County",2,19,140,79,61
050,29,039,"Missouri","Cedar County",2,20,140,76,64
050,29,039,"Missouri","Cedar County",2,21,135,71,64
050,29,039,"Missouri","Cedar County",2,22,137,72,65
050,29,039,"Missouri","Cedar County",2,23,133,65,68
050,29,039,"Missouri","Cedar County",2,24,137,65,72
050,29,039,"Missouri","Cedar County",2,25,134,73,61
050,29,039,"Missouri","Cedar County",2,26,136,77,59
050,29,039,"Missouri","Cedar County",2,27,145,73,72
050,29,039,"Missouri","Cedar County",2,28,149,70,79
050,29,039,"Missouri","Cedar County",2,29,153,77,76
050,29,039,"Missouri","Cedar County",2,30,152,84,68
050,29,039,"Missouri","Cedar County",2,31,141,80,61
050,29,039,"Missouri","Cedar County",2,32,133,65,68
050,29,039,"Missouri","Cedar County",2,33,129,56,73
050,29,039,"Missouri","Cedar County",2,34,137,57,80
050,29,039,"Missouri","Cedar County",2,35,143,69,74
050,29,039,"Missouri","Cedar County",2,36,148,74,74
050,29,039,"Missouri","Cedar County",2,37,154,78,76
050,29,039,"Missouri","Cedar County",2,38,155,81,74
050,29,039,"Missouri","Cedar County",2,39,156,84,72
050,29,039,"Missouri","Cedar County",2,40,144,72,72
050,29,039,"Missouri","Cedar County",2,41,135,67,68
050,29,039,"Missouri","Cedar County",2,42,135,70,65
050,29,039,"Missouri","Cedar County",2,43,145,71,74
050,29,039,"Missouri","Cedar County",2,44,142,70,72
050,29,039,"Missouri","Cedar County",2,45,153,79,74
050,29,039,"Missouri","Cedar County",2,46,141,81,60
050,29,039,"Missouri","Cedar County",2,47,147,82,65
050,29,039,"Missouri","Cedar County",2,48,153,78,75
050,29,039,"Missouri","Cedar County",2,49,168,87,81
050,29,039,"Missouri","Cedar County",2,50,171,93,78
050,29,039,"Missouri","Cedar County",2,51,188,100,88
050,29,039,"Missouri","Cedar County",2,52,184,89,95
050,29,039,"Missouri","Cedar County",2,53,182,87,95
050,29,039,"Missouri","Cedar County",2,54,175,84,91
050,29,039,"Missouri","Cedar County",2,55,177,86,91
050,29,039,"Missouri","Cedar County",2,56,191,99,92
050,29,039,"Missouri","Cedar County",2,57,202,104,98
050,29,039,"Missouri","Cedar County",2,58,211,108,103
050,29,039,"Missouri","Cedar County",2,59,210,107,103
050,29,039,"Missouri","Cedar County",2,60,204,101,103
050,29,039,"Missouri","Cedar County",2,61,201,98,103
050,29,039,"Missouri","Cedar County",2,62,223,107,116
050,29,039,"Missouri","Cedar County",2,63,205,105,100
050,29,039,"Missouri","Cedar County",2,64,194,99,95
050,29,039,"Missouri","Cedar County",2,65,204,104,100
050,29,039,"Missouri","Cedar County",2,66,202,108,94
050,29,039,"Missouri","Cedar County",2,67,172,81,91
050,29,039,"Missouri","Cedar County",2,68,177,83,94
050,29,039,"Missouri","Cedar County",2,69,193,91,102
050,29,039,"Missouri","Cedar County",2,70,186,89,97
050,29,039,"Missouri","Cedar County",2,71,203,98,105
050,29,039,"Missouri","Cedar County",2,72,180,98,82
050,29,039,"Missouri","Cedar County",2,73,185,92,93
050,29,039,"Missouri","Cedar County",2,74,125,55,70
050,29,039,"Missouri","Cedar County",2,75,130,55,75
050,29,039,"Missouri","Cedar County",2,76,124,57,67
050,29,039,"Missouri","Cedar County",2,77,128,64,64
050,29,039,"Missouri","Cedar County",2,78,112,55,57
050,29,039,"Missouri","Cedar County",2,79,114,53,61
050,29,039,"Missouri","Cedar County",2,80,101,48,53
050,29,039,"Missouri","Cedar County",2,81,85,40,45
050,29,039,"Missouri","Cedar County",2,82,81,33,48
050,29,039,"Missouri","Cedar County",2,83,73,34,39
050,29,039,"Missouri","Cedar County",2,84,84,40,44
050,29,039,"Missouri","Cedar County",2,85,406,145,261
050,29,039,"Missouri","Cedar County",3,0,193,84,109
050,29,039,"Missouri","Cedar County",3,1,204,104,100
050,29,039,"Missouri","Cedar County",3,2,183,92,91
050,29,039,"Missouri","Cedar County",3,3,178,90,88
050,29,039,"Missouri","Cedar County",3,4,201,98,103
050,29,039,"Missouri","Cedar County",3,5,204,108,96
050,29,039,"Missouri","Cedar County",3,6,204,105,99
050,29,039,"Missouri","Cedar County",3,7,207,117,90
050,29,039,"Missouri","Cedar County",3,8,189,105,84
050,29,039,"Missouri","Cedar County",3,9,184,95,89
050,29,039,"Missouri","Cedar County",3,10,179,98,81
050,29,039,"Missouri","Cedar County",3,11,183,95,88
050,29,039,"Missouri","Cedar County",3,12,183,96,87
050,29,039,"Missouri","Cedar County",3,13,188,91,97
050,29,039,"Missouri","Cedar County",3,14,218,111,107
050,29,039,"Missouri","Cedar County",3,15,212,120,92
050,29,039,"Missouri","Cedar County",3,16,210,117,93
050,29,039,"Missouri","Cedar County",3,17,206,123,83
050,29,039,"Missouri","Cedar County",3,18,181,102,79
050,29,039,"Missouri","Cedar County",3,19,139,77,62
050,29,039,"Missouri","Cedar County",3,20,153,87,66
050,29,039,"Missouri","Cedar County",3,21,148,78,70
050,29,039,"Missouri","Cedar County",3,22,142,76,66
050,29,039,"Missouri","Cedar County",3,23,150,74,76
050,29,039,"Missouri","Cedar County",3,24,133,62,71
050,29,039,"Missouri","Cedar County",3,25,143,72,71
050,29,039,"Missouri","Cedar County",3,26,135,75,60
050,29,039,"Missouri","Cedar County",3,27,136,77,59
050,29,039,"Missouri","Cedar County",3,28,142,72,70
050,29,039,"Missouri","Cedar County",3,29,159,71,88
050,29,039,"Missouri","Cedar County",3,30,160,82,78
050,29,039,"Missouri","Cedar County",3,31,159,87,72
050,29,039,"Missouri","Cedar County",3,32,149,82,67
050,29,039,"Missouri","Cedar County",3,33,143,67,76
050,29,039,"Missouri","Cedar County",3,34,134,57,77
050,29,039,"Missouri","Cedar County",3,35,146,67,79
050,29,039,"Missouri","Cedar County",3,36,148,74,74
050,29,039,"Missouri","Cedar County",3,37,147,78,69
050,29,039,"Missouri","Cedar County",3,38,157,77,80
050,29,039,"Missouri","Cedar County",3,39,158,85,73
050,29,039,"Missouri","Cedar County",3,40,163,88,75
050,29,039,"Missouri","Cedar County",3,41,147,72,75
050,29,039,"Missouri","Cedar County",3,42,137,71,66
050,29,039,"Missouri","Cedar County",3,43,147,79,68
050,29,039,"Missouri","Cedar County",3,44,149,69,80
050,29,039,"Missouri","Cedar County",3,45,142,70,72
050,29,039,"Missouri","Cedar County",3,46,151,79,72
050,29,039,"Missouri","Cedar County",3,47,156,87,69
050,29,039,"Missouri","Cedar County",3,48,144,86,58
050,29,039,"Missouri","Cedar County",3,49,162,82,80
050,29,039,"Missouri","Cedar County",3,50,169,87,82
050,29,039,"Missouri","Cedar County",3,51,178,96,82
050,29,039,"Missouri","Cedar County",3,52,187,97,90
050,29,039,"Missouri","Cedar County",3,53,190,94,96
050,29,039,"Missouri","Cedar County",3,54,181,89,92
050,29,039,"Missouri","Cedar County",3,55,177,88,89
050,29,039,"Missouri","Cedar County",3,56,169,81,88
050,29,039,"Missouri","Cedar County",3,57,207,105,102
050,29,039,"Missouri","Cedar County",3,58,196,97,99
050,29,039,"Missouri","Cedar County",3,59,205,103,102
050,29,039,"Missouri","Cedar County",3,60,211,102,109
050,29,039,"Missouri","Cedar County",3,61,207,100,107
050,29,039,"Missouri","Cedar County",3,62,205,101,104
050,29,039,"Missouri","Cedar County",3,63,217,107,110
050,29,039,"Missouri","Cedar County",3,64,203,105,98
050,29,039,"Missouri","Cedar County",3,65,202,102,100
050,29,039,"Missouri","Cedar County",3,66,190,97,93
050,29,039,"Missouri","Cedar County",3,67,203,105,98
050,29,039,"Missouri","Cedar County",3,68,176,86,90
050,29,039,"Missouri","Cedar County",3,69,181,87,94
050,29,039,"Missouri","Cedar County",3,70,191,89,102
050,29,039,"Missouri","Cedar County",3,71,182,87,95
050,29,039,"Missouri","Cedar County",3,72,188,90,98
050,29,039,"Missouri","Cedar County",3,73,178,96,82
050,29,039,"Missouri","Cedar County",3,74,175,87,88
050,29,039,"Missouri","Cedar County",3,75,125,54,71
050,29,039,"Missouri","Cedar County",3,76,130,56,74
050,29,039,"Missouri","Cedar County",3,77,111,53,58
050,29,039,"Missouri","Cedar County",3,78,127,61,66
050,29,039,"Missouri","Cedar County",3,79,113,53,60
050,29,039,"Missouri","Cedar County",3,80,99,49,50
050,29,039,"Missouri","Cedar County",3,81,87,40,47
050,29,039,"Missouri","Cedar County",3,82,90,40,50
050,29,039,"Missouri","Cedar County",3,83,73,29,44
050,29,039,"Missouri","Cedar County",3,84,74,36,38
050,29,039,"Missouri","Cedar County",3,85,432,162,270
050,29,039,"Missouri","Cedar County",4,0,213,99,114
050,29,039,"Missouri","Cedar County",4,1,195,85,110
050,29,039,"Missouri","Cedar County",4,2,201,102,99
050,29,039,"Missouri","Cedar County",4,3,189,95,94
050,29,039,"Missouri","Cedar County",4,4,177,88,89
050,29,039,"Missouri","Cedar County",4,5,208,95,113
050,29,039,"Missouri","Cedar County",4,6,202,108,94
050,29,039,"Missouri","Cedar County",4,7,202,103,99
050,29,039,"Missouri","Cedar County",4,8,220,122,98
050,29,039,"Missouri","Cedar County",4,9,190,98,92
050,29,039,"Missouri","Cedar County",4,10,186,98,88
050,29,039,"Missouri","Cedar County",4,11,175,87,88
050,29,039,"Missouri","Cedar County",4,12,192,105,87
050,29,039,"Missouri","Cedar County",4,13,180,94,86
050,29,039,"Missouri","Cedar County",4,14,193,91,102
050,29,039,"Missouri","Cedar County",4,15,216,111,105
050,29,039,"Missouri","Cedar County",4,16,212,116,96
050,29,039,"Missouri","Cedar County",4,17,209,116,93
050,29,039,"Missouri","Cedar County",4,18,176,104,72
050,29,039,"Missouri","Cedar County",4,19,130,74,56
050,29,039,"Missouri","Cedar County",4,20,145,81,64
050,29,039,"Missouri","Cedar County",4,21,154,84,70
050,29,039,"Missouri","Cedar County",4,22,155,81,74
050,29,039,"Missouri","Cedar County",4,23,138,76,62
050,29,039,"Missouri","Cedar County",4,24,141,69,72
050,29,039,"Missouri","Cedar County",4,25,136,61,75
050,29,039,"Missouri","Cedar County",4,26,143,75,68
050,29,039,"Missouri","Cedar County",4,27,129,66,63
050,29,039,"Missouri","Cedar County",4,28,144,80,64
050,29,039,"Missouri","Cedar County",4,29,141,69,72
050,29,039,"Missouri","Cedar County",4,30,165,75,90
050,29,039,"Missouri","Cedar County",4,31,174,92,82
050,29,039,"Missouri","Cedar County",4,32,156,80,76
050,29,039,"Missouri","Cedar County",4,33,142,77,65
050,29,039,"Missouri","Cedar County",4,34,143,67,76
050,29,039,"Missouri","Cedar County",4,35,137,59,78
050,29,039,"Missouri","Cedar County",4,36,146,65,81
050,29,039,"Missouri","Cedar County",4,37,147,72,75
050,29,039,"Missouri","Cedar County",4,38,148,81,67
050,29,039,"Missouri","Cedar County",4,39,159,79,80
050,29,039,"Missouri","Cedar County",4,40,160,85,75
050,29,039,"Missouri","Cedar County",4,41,161,88,73
050,29,039,"Missouri","Cedar County",4,42,151,75,76
050,29,039,"Missouri","Cedar County",4,43,132,70,62
050,29,039,"Missouri","Cedar County",4,44,150,81,69
050,29,039,"Missouri","Cedar County",4,45,149,72,77
050,29,039,"Missouri","Cedar County",4,46,140,67,73
050,29,039,"Missouri","Cedar County",4,47,154,79,75
050,29,039,"Missouri","Cedar County",4,48,145,82,63
050,29,039,"Missouri","Cedar County",4,49,146,86,60
050,29,039,"Missouri","Cedar County",4,50,164,83,81
050,29,039,"Missouri","Cedar County",4,51,181,95,86
050,29,039,"Missouri","Cedar County",4,52,181,101,80
050,29,039,"Missouri","Cedar County",4,53,190,94,96
050,29,039,"Missouri","Cedar County",4,54,186,95,91
050,29,039,"Missouri","Cedar County",4,55,180,89,91
050,29,039,"Missouri","Cedar County",4,56,180,86,94
050,29,039,"Missouri","Cedar County",4,57,178,86,92
050,29,039,"Missouri","Cedar County",4,58,213,107,106
050,29,039,"Missouri","Cedar County",4,59,196,101,95
050,29,039,"Missouri","Cedar County",4,60,202,101,101
050,29,039,"Missouri","Cedar County",4,61,221,108,113
050,29,039,"Missouri","Cedar County",4,62,211,103,108
050,29,039,"Missouri","Cedar County",4,63,212,103,109
050,29,039,"Missouri","Cedar County",4,64,215,110,105
050,29,039,"Missouri","Cedar County",4,65,198,101,97
050,29,039,"Missouri","Cedar County",4,66,198,92,106
050,29,039,"Missouri","Cedar County",4,67,196,100,96
050,29,039,"Missouri","Cedar County",4,68,204,105,99
050,29,039,"Missouri","Cedar County",4,69,177,91,86
050,29,039,"Missouri","Cedar County",4,70,184,89,95
050,29,039,"Missouri","Cedar County",4,71,200,93,107
050,29,039,"Missouri","Cedar County",4,72,177,84,93
050,29,039,"Missouri","Cedar County",4,73,183,84,99
050,29,039,"Missouri","Cedar County",4,74,171,92,79
050,29,039,"Missouri","Cedar County",4,75,171,82,89
050,29,039,"Missouri","Cedar County",4,76,127,57,70
050,29,039,"Missouri","Cedar County",4,77,120,49,71
050,29,039,"Missouri","Cedar County",4,78,104,50,54
050,29,039,"Missouri","Cedar County",4,79,119,56,63
050,29,039,"Missouri","Cedar County",4,80,105,51,54
050,29,039,"Missouri","Cedar County",4,81,83,39,44
050,29,039,"Missouri","Cedar County",4,82,90,39,51
050,29,039,"Missouri","Cedar County",4,83,86,39,47
050,29,039,"Missouri","Cedar County",4,84,73,30,43
050,29,039,"Missouri","Cedar County",4,85,428,162,266
050,29,039,"Missouri","Cedar County",5,0,214,99,115
050,29,039,"Missouri","Cedar County",5,1,210,108,102
050,29,039,"Missouri","Cedar County",5,2,195,81,114
050,29,039,"Missouri","Cedar County",5,3,193,100,93
050,29,039,"Missouri","Cedar County",5,4,192,94,98
050,29,039,"Missouri","Cedar County",5,5,189,93,96
050,29,039,"Missouri","Cedar County",5,6,204,94,110
050,29,039,"Missouri","Cedar County",5,7,209,112,97
050,29,039,"Missouri","Cedar County",5,8,205,104,101
050,29,039,"Missouri","Cedar County",5,9,219,120,99
050,29,039,"Missouri","Cedar County",5,10,194,96,98
050,29,039,"Missouri","Cedar County",5,11,199,100,99
050,29,039,"Missouri","Cedar County",5,12,176,86,90
050,29,039,"Missouri","Cedar County",5,13,187,100,87
050,29,039,"Missouri","Cedar County",5,14,184,92,92
050,29,039,"Missouri","Cedar County",5,15,179,84,95
050,29,039,"Missouri","Cedar County",5,16,219,112,107
050,29,039,"Missouri","Cedar County",5,17,206,116,90
050,29,039,"Missouri","Cedar County",5,18,176,99,77
050,29,039,"Missouri","Cedar County",5,19,129,75,54
050,29,039,"Missouri","Cedar County",5,20,140,76,64
050,29,039,"Missouri","Cedar County",5,21,149,77,72
050,29,039,"Missouri","Cedar County",5,22,165,88,77
050,29,039,"Missouri","Cedar County",5,23,152,79,73
050,29,039,"Missouri","Cedar County",5,24,135,76,59
050,29,039,"Missouri","Cedar County",5,25,139,70,69
050,29,039,"Missouri","Cedar County",5,26,142,68,74
050,29,039,"Missouri","Cedar County",5,27,148,74,74
050,29,039,"Missouri","Cedar County",5,28,138,75,63
050,29,039,"Missouri","Cedar County",5,29,144,79,65
050,29,039,"Missouri","Cedar County",5,30,143,73,70
050,29,039,"Missouri","Cedar County",5,31,177,79,98
050,29,039,"Missouri","Cedar County",5,32,176,90,86
050,29,039,"Missouri","Cedar County",5,33,155,83,72
050,29,039,"Missouri","Cedar County",5,34,138,75,63
050,29,039,"Missouri","Cedar County",5,35,149,77,72
050,29,039,"Missouri","Cedar County",5,36,132,59,73
050,29,039,"Missouri","Cedar County",5,37,151,66,85
050,29,039,"Missouri","Cedar County",5,38,151,71,80
050,29,039,"Missouri","Cedar County",5,39,157,90,67
050,29,039,"Missouri","Cedar County",5,40,168,77,91
050,29,039,"Missouri","Cedar County",5,41,159,82,77
050,29,039,"Missouri","Cedar County",5,42,162,88,74
050,29,039,"Missouri","Cedar County",5,43,145,73,72
050,29,039,"Missouri","Cedar County",5,44,136,74,62
050,29,039,"Missouri","Cedar County",5,45,152,82,70
050,29,039,"Missouri","Cedar County",5,46,142,72,70
050,29,039,"Missouri","Cedar County",5,47,138,67,71
050,29,039,"Missouri","Cedar County",5,48,157,78,79
050,29,039,"Missouri","Cedar County",5,49,150,83,67
050,29,039,"Missouri","Cedar County",5,50,152,89,63
050,29,039,"Missouri","Cedar County",5,51,162,81,81
050,29,039,"Missouri","Cedar County",5,52,178,93,85
050,29,039,"Missouri","Cedar County",5,53,185,101,84
050,29,039,"Missouri","Cedar County",5,54,189,94,95
050,29,039,"Missouri","Cedar County",5,55,190,94,96
050,29,039,"Missouri","Cedar County",5,56,181,86,95
050,29,039,"Missouri","Cedar County",5,57,185,91,94
050,29,039,"Missouri","Cedar County",5,58,180,88,92
050,29,039,"Missouri","Cedar County",5,59,210,104,106
050,29,039,"Missouri","Cedar County",5,60,197,104,93
050,29,039,"Missouri","Cedar County",5,61,201,101,100
050,29,039,"Missouri","Cedar County",5,62,221,104,117
050,29,039,"Missouri","Cedar County",5,63,213,104,109
050,29,039,"Missouri","Cedar County",5,64,220,107,113
050,29,039,"Missouri","Cedar County",5,65,225,111,114
050,29,039,"Missouri","Cedar County",5,66,190,95,95
050,29,039,"Missouri","Cedar County",5,67,199,92,107
050,29,039,"Missouri","Cedar County",5,68,200,103,97
050,29,039,"Missouri","Cedar County",5,69,198,103,95
050,29,039,"Missouri","Cedar County",5,70,175,91,84
050,29,039,"Missouri","Cedar County",5,71,177,86,91
050,29,039,"Missouri","Cedar County",5,72,191,90,101
050,29,039,"Missouri","Cedar County",5,73,172,80,92
050,29,039,"Missouri","Cedar County",5,74,174,81,93
050,29,039,"Missouri","Cedar County",5,75,166,87,79
050,29,039,"Missouri","Cedar County",5,76,167,81,86
050,29,039,"Missouri","Cedar County",5,77,110,51,59
050,29,039,"Missouri","Cedar County",5,78,113,46,67
050,29,039,"Missouri","Cedar County",5,79,104,50,54
050,29,039,"Missouri","Cedar County",5,80,111,52,59
050,29,039,"Missouri","Cedar County",5,81,80,36,44
050,29,039,"Missouri","Cedar County",5,82,87,38,49
050,29,039,"Missouri","Cedar County",5,83,88,40,48
050,29,039,"Missouri","Cedar County",5,84,86,42,44
050,29,039,"Missouri","Cedar County",5,85,426,156,270
050,29,041,"Missouri","Chariton County",1,0,91,47,44
050,29,041,"Missouri","Chariton County",1,1,91,52,39
050,29,041,"Missouri","Chariton County",1,2,86,45,41
050,29,041,"Missouri","Chariton County",1,3,88,41,47
050,29,041,"Missouri","Chariton County",1,4,90,42,48
050,29,041,"Missouri","Chariton County",1,5,93,52,41
050,29,041,"Missouri","Chariton County",1,6,110,55,55
050,29,041,"Missouri","Chariton County",1,7,99,53,46
050,29,041,"Missouri","Chariton County",1,8,88,46,42
050,29,041,"Missouri","Chariton County",1,9,92,54,38
050,29,041,"Missouri","Chariton County",1,10,98,51,47
050,29,041,"Missouri","Chariton County",1,11,103,57,46
050,29,041,"Missouri","Chariton County",1,12,111,60,51
050,29,041,"Missouri","Chariton County",1,13,99,54,45
050,29,041,"Missouri","Chariton County",1,14,100,55,45
050,29,041,"Missouri","Chariton County",1,15,91,46,45
050,29,041,"Missouri","Chariton County",1,16,98,48,50
050,29,041,"Missouri","Chariton County",1,17,88,46,42
050,29,041,"Missouri","Chariton County",1,18,82,47,35
050,29,041,"Missouri","Chariton County",1,19,66,40,26
050,29,041,"Missouri","Chariton County",1,20,67,42,25
050,29,041,"Missouri","Chariton County",1,21,67,32,35
050,29,041,"Missouri","Chariton County",1,22,61,33,28
050,29,041,"Missouri","Chariton County",1,23,61,35,26
050,29,041,"Missouri","Chariton County",1,24,67,31,36
050,29,041,"Missouri","Chariton County",1,25,67,32,35
050,29,041,"Missouri","Chariton County",1,26,64,35,29
050,29,041,"Missouri","Chariton County",1,27,76,45,31
050,29,041,"Missouri","Chariton County",1,28,80,41,39
050,29,041,"Missouri","Chariton County",1,29,85,44,41
050,29,041,"Missouri","Chariton County",1,30,87,46,41
050,29,041,"Missouri","Chariton County",1,31,68,41,27
050,29,041,"Missouri","Chariton County",1,32,71,36,35
050,29,041,"Missouri","Chariton County",1,33,70,36,34
050,29,041,"Missouri","Chariton County",1,34,68,36,32
050,29,041,"Missouri","Chariton County",1,35,67,30,37
050,29,041,"Missouri","Chariton County",1,36,73,34,39
050,29,041,"Missouri","Chariton County",1,37,81,44,37
050,29,041,"Missouri","Chariton County",1,38,85,47,38
050,29,041,"Missouri","Chariton County",1,39,74,39,35
050,29,041,"Missouri","Chariton County",1,40,80,40,40
050,29,041,"Missouri","Chariton County",1,41,85,40,45
050,29,041,"Missouri","Chariton County",1,42,86,43,43
050,29,041,"Missouri","Chariton County",1,43,68,34,34
050,29,041,"Missouri","Chariton County",1,44,71,33,38
050,29,041,"Missouri","Chariton County",1,45,75,36,39
050,29,041,"Missouri","Chariton County",1,46,71,38,33
050,29,041,"Missouri","Chariton County",1,47,68,37,31
050,29,041,"Missouri","Chariton County",1,48,73,36,37
050,29,041,"Missouri","Chariton County",1,49,80,36,44
050,29,041,"Missouri","Chariton County",1,50,80,40,40
050,29,041,"Missouri","Chariton County",1,51,94,49,45
050,29,041,"Missouri","Chariton County",1,52,87,45,42
050,29,041,"Missouri","Chariton County",1,53,80,40,40
050,29,041,"Missouri","Chariton County",1,54,85,47,38
050,29,041,"Missouri","Chariton County",1,55,96,51,45
050,29,041,"Missouri","Chariton County",1,56,107,58,49
050,29,041,"Missouri","Chariton County",1,57,103,56,47
050,29,041,"Missouri","Chariton County",1,58,115,61,54
050,29,041,"Missouri","Chariton County",1,59,125,62,63
050,29,041,"Missouri","Chariton County",1,60,119,61,58
050,29,041,"Missouri","Chariton County",1,61,128,61,67
050,29,041,"Missouri","Chariton County",1,62,127,59,68
050,29,041,"Missouri","Chariton County",1,63,115,56,59
050,29,041,"Missouri","Chariton County",1,64,120,58,62
050,29,041,"Missouri","Chariton County",1,65,120,60,60
050,29,041,"Missouri","Chariton County",1,66,111,55,56
050,29,041,"Missouri","Chariton County",1,67,98,51,47
050,29,041,"Missouri","Chariton County",1,68,90,54,36
050,29,041,"Missouri","Chariton County",1,69,92,54,38
050,29,041,"Missouri","Chariton County",1,70,89,44,45
050,29,041,"Missouri","Chariton County",1,71,83,46,37
050,29,041,"Missouri","Chariton County",1,72,92,49,43
050,29,041,"Missouri","Chariton County",1,73,90,35,55
050,29,041,"Missouri","Chariton County",1,74,66,31,35
050,29,041,"Missouri","Chariton County",1,75,59,30,29
050,29,041,"Missouri","Chariton County",1,76,67,34,33
050,29,041,"Missouri","Chariton County",1,77,71,34,37
050,29,041,"Missouri","Chariton County",1,78,55,24,31
050,29,041,"Missouri","Chariton County",1,79,60,27,33
050,29,041,"Missouri","Chariton County",1,80,57,23,34
050,29,041,"Missouri","Chariton County",1,81,64,22,42
050,29,041,"Missouri","Chariton County",1,82,45,16,29
050,29,041,"Missouri","Chariton County",1,83,42,19,23
050,29,041,"Missouri","Chariton County",1,84,31,12,19
050,29,041,"Missouri","Chariton County",1,85,288,105,183
050,29,041,"Missouri","Chariton County",2,0,91,46,45
050,29,041,"Missouri","Chariton County",2,1,91,52,39
050,29,041,"Missouri","Chariton County",2,2,87,47,40
050,29,041,"Missouri","Chariton County",2,3,87,42,45
050,29,041,"Missouri","Chariton County",2,4,90,42,48
050,29,041,"Missouri","Chariton County",2,5,92,50,42
050,29,041,"Missouri","Chariton County",2,6,105,53,52
050,29,041,"Missouri","Chariton County",2,7,100,52,48
050,29,041,"Missouri","Chariton County",2,8,90,48,42
050,29,041,"Missouri","Chariton County",2,9,90,52,38
050,29,041,"Missouri","Chariton County",2,10,96,52,44
050,29,041,"Missouri","Chariton County",2,11,102,56,46
050,29,041,"Missouri","Chariton County",2,12,110,60,50
050,29,041,"Missouri","Chariton County",2,13,102,56,46
050,29,041,"Missouri","Chariton County",2,14,101,56,45
050,29,041,"Missouri","Chariton County",2,15,92,48,44
050,29,041,"Missouri","Chariton County",2,16,94,46,48
050,29,041,"Missouri","Chariton County",2,17,87,44,43
050,29,041,"Missouri","Chariton County",2,18,76,42,34
050,29,041,"Missouri","Chariton County",2,19,62,37,25
050,29,041,"Missouri","Chariton County",2,20,71,43,28
050,29,041,"Missouri","Chariton County",2,21,66,35,31
050,29,041,"Missouri","Chariton County",2,22,63,34,29
050,29,041,"Missouri","Chariton County",2,23,63,35,28
050,29,041,"Missouri","Chariton County",2,24,65,32,33
050,29,041,"Missouri","Chariton County",2,25,67,32,35
050,29,041,"Missouri","Chariton County",2,26,65,34,31
050,29,041,"Missouri","Chariton County",2,27,73,42,31
050,29,041,"Missouri","Chariton County",2,28,80,42,38
050,29,041,"Missouri","Chariton County",2,29,84,43,41
050,29,041,"Missouri","Chariton County",2,30,87,46,41
050,29,041,"Missouri","Chariton County",2,31,73,42,31
050,29,041,"Missouri","Chariton County",2,32,73,39,34
050,29,041,"Missouri","Chariton County",2,33,70,36,34
050,29,041,"Missouri","Chariton County",2,34,69,37,32
050,29,041,"Missouri","Chariton County",2,35,67,31,36
050,29,041,"Missouri","Chariton County",2,36,70,32,38
050,29,041,"Missouri","Chariton County",2,37,79,42,37
050,29,041,"Missouri","Chariton County",2,38,84,46,38
050,29,041,"Missouri","Chariton County",2,39,76,41,35
050,29,041,"Missouri","Chariton County",2,40,78,40,38
050,29,041,"Missouri","Chariton County",2,41,81,39,42
050,29,041,"Missouri","Chariton County",2,42,83,41,42
050,29,041,"Missouri","Chariton County",2,43,74,37,37
050,29,041,"Missouri","Chariton County",2,44,70,33,37
050,29,041,"Missouri","Chariton County",2,45,74,35,39
050,29,041,"Missouri","Chariton County",2,46,73,38,35
050,29,041,"Missouri","Chariton County",2,47,70,38,32
050,29,041,"Missouri","Chariton County",2,48,71,35,36
050,29,041,"Missouri","Chariton County",2,49,80,36,44
050,29,041,"Missouri","Chariton County",2,50,79,39,40
050,29,041,"Missouri","Chariton County",2,51,89,47,42
050,29,041,"Missouri","Chariton County",2,52,87,44,43
050,29,041,"Missouri","Chariton County",2,53,83,42,41
050,29,041,"Missouri","Chariton County",2,54,84,47,37
050,29,041,"Missouri","Chariton County",2,55,92,49,43
050,29,041,"Missouri","Chariton County",2,56,105,57,48
050,29,041,"Missouri","Chariton County",2,57,103,56,47
050,29,041,"Missouri","Chariton County",2,58,112,60,52
050,29,041,"Missouri","Chariton County",2,59,123,62,61
050,29,041,"Missouri","Chariton County",2,60,120,61,59
050,29,041,"Missouri","Chariton County",2,61,127,61,66
050,29,041,"Missouri","Chariton County",2,62,126,59,67
050,29,041,"Missouri","Chariton County",2,63,118,57,61
050,29,041,"Missouri","Chariton County",2,64,118,57,61
050,29,041,"Missouri","Chariton County",2,65,119,60,59
050,29,041,"Missouri","Chariton County",2,66,112,55,57
050,29,041,"Missouri","Chariton County",2,67,101,53,48
050,29,041,"Missouri","Chariton County",2,68,91,53,38
050,29,041,"Missouri","Chariton County",2,69,93,55,38
050,29,041,"Missouri","Chariton County",2,70,89,45,44
050,29,041,"Missouri","Chariton County",2,71,84,46,38
050,29,041,"Missouri","Chariton County",2,72,86,46,40
050,29,041,"Missouri","Chariton County",2,73,94,39,55
050,29,041,"Missouri","Chariton County",2,74,67,30,37
050,29,041,"Missouri","Chariton County",2,75,60,30,30
050,29,041,"Missouri","Chariton County",2,76,65,33,32
050,29,041,"Missouri","Chariton County",2,77,72,35,37
050,29,041,"Missouri","Chariton County",2,78,58,26,32
050,29,041,"Missouri","Chariton County",2,79,58,26,32
050,29,041,"Missouri","Chariton County",2,80,59,24,35
050,29,041,"Missouri","Chariton County",2,81,64,23,41
050,29,041,"Missouri","Chariton County",2,82,48,17,31
050,29,041,"Missouri","Chariton County",2,83,40,17,23
050,29,041,"Missouri","Chariton County",2,84,32,12,20
050,29,041,"Missouri","Chariton County",2,85,284,104,180
050,29,041,"Missouri","Chariton County",3,0,74,37,37
050,29,041,"Missouri","Chariton County",3,1,88,51,37
050,29,041,"Missouri","Chariton County",3,2,87,49,38
050,29,041,"Missouri","Chariton County",3,3,87,50,37
050,29,041,"Missouri","Chariton County",3,4,88,40,48
050,29,041,"Missouri","Chariton County",3,5,91,43,48
050,29,041,"Missouri","Chariton County",3,6,92,53,39
050,29,041,"Missouri","Chariton County",3,7,104,51,53
050,29,041,"Missouri","Chariton County",3,8,96,50,46
050,29,041,"Missouri","Chariton County",3,9,83,46,37
050,29,041,"Missouri","Chariton County",3,10,90,52,38
050,29,041,"Missouri","Chariton County",3,11,97,51,46
050,29,041,"Missouri","Chariton County",3,12,109,58,51
050,29,041,"Missouri","Chariton County",3,13,115,62,53
050,29,041,"Missouri","Chariton County",3,14,101,56,45
050,29,041,"Missouri","Chariton County",3,15,99,55,44
050,29,041,"Missouri","Chariton County",3,16,94,50,44
050,29,041,"Missouri","Chariton County",3,17,93,43,50
050,29,041,"Missouri","Chariton County",3,18,71,38,33
050,29,041,"Missouri","Chariton County",3,19,64,35,29
050,29,041,"Missouri","Chariton County",3,20,76,43,33
050,29,041,"Missouri","Chariton County",3,21,69,43,26
050,29,041,"Missouri","Chariton County",3,22,67,39,28
050,29,041,"Missouri","Chariton County",3,23,62,36,26
050,29,041,"Missouri","Chariton County",3,24,65,34,31
050,29,041,"Missouri","Chariton County",3,25,68,34,34
050,29,041,"Missouri","Chariton County",3,26,65,30,35
050,29,041,"Missouri","Chariton County",3,27,65,32,33
050,29,041,"Missouri","Chariton County",3,28,75,43,32
050,29,041,"Missouri","Chariton County",3,29,83,43,40
050,29,041,"Missouri","Chariton County",3,30,85,44,41
050,29,041,"Missouri","Chariton County",3,31,84,44,40
050,29,041,"Missouri","Chariton County",3,32,73,42,31
050,29,041,"Missouri","Chariton County",3,33,74,39,35
050,29,041,"Missouri","Chariton County",3,34,68,36,32
050,29,041,"Missouri","Chariton County",3,35,64,32,32
050,29,041,"Missouri","Chariton County",3,36,66,31,35
050,29,041,"Missouri","Chariton County",3,37,74,35,39
050,29,041,"Missouri","Chariton County",3,38,78,39,39
050,29,041,"Missouri","Chariton County",3,39,87,47,40
050,29,041,"Missouri","Chariton County",3,40,84,46,38
050,29,041,"Missouri","Chariton County",3,41,81,46,35
050,29,041,"Missouri","Chariton County",3,42,76,36,40
050,29,041,"Missouri","Chariton County",3,43,84,41,43
050,29,041,"Missouri","Chariton County",3,44,70,34,36
050,29,041,"Missouri","Chariton County",3,45,72,35,37
050,29,041,"Missouri","Chariton County",3,46,74,34,40
050,29,041,"Missouri","Chariton County",3,47,72,37,35
050,29,041,"Missouri","Chariton County",3,48,69,36,33
050,29,041,"Missouri","Chariton County",3,49,73,35,38
050,29,041,"Missouri","Chariton County",3,50,71,33,38
050,29,041,"Missouri","Chariton County",3,51,81,42,39
050,29,041,"Missouri","Chariton County",3,52,91,48,43
050,29,041,"Missouri","Chariton County",3,53,92,43,49
050,29,041,"Missouri","Chariton County",3,54,81,46,35
050,29,041,"Missouri","Chariton County",3,55,84,41,43
050,29,041,"Missouri","Chariton County",3,56,94,53,41
050,29,041,"Missouri","Chariton County",3,57,109,58,51
050,29,041,"Missouri","Chariton County",3,58,104,53,51
050,29,041,"Missouri","Chariton County",3,59,107,58,49
050,29,041,"Missouri","Chariton County",3,60,122,58,64
050,29,041,"Missouri","Chariton County",3,61,123,63,60
050,29,041,"Missouri","Chariton County",3,62,120,58,62
050,29,041,"Missouri","Chariton County",3,63,124,58,66
050,29,041,"Missouri","Chariton County",3,64,119,56,63
050,29,041,"Missouri","Chariton County",3,65,120,56,64
050,29,041,"Missouri","Chariton County",3,66,115,59,56
050,29,041,"Missouri","Chariton County",3,67,114,58,56
050,29,041,"Missouri","Chariton County",3,68,99,51,48
050,29,041,"Missouri","Chariton County",3,69,94,57,37
050,29,041,"Missouri","Chariton County",3,70,84,46,38
050,29,041,"Missouri","Chariton County",3,71,89,48,41
050,29,041,"Missouri","Chariton County",3,72,86,46,40
050,29,041,"Missouri","Chariton County",3,73,83,44,39
050,29,041,"Missouri","Chariton County",3,74,87,36,51
050,29,041,"Missouri","Chariton County",3,75,63,31,32
050,29,041,"Missouri","Chariton County",3,76,60,32,28
050,29,041,"Missouri","Chariton County",3,77,64,32,32
050,29,041,"Missouri","Chariton County",3,78,69,32,37
050,29,041,"Missouri","Chariton County",3,79,55,24,31
050,29,041,"Missouri","Chariton County",3,80,59,24,35
050,29,041,"Missouri","Chariton County",3,81,67,29,38
050,29,041,"Missouri","Chariton County",3,82,53,19,34
050,29,041,"Missouri","Chariton County",3,83,42,14,28
050,29,041,"Missouri","Chariton County",3,84,38,13,25
050,29,041,"Missouri","Chariton County",3,85,272,98,174
050,29,041,"Missouri","Chariton County",4,0,76,40,36
050,29,041,"Missouri","Chariton County",4,1,72,37,35
050,29,041,"Missouri","Chariton County",4,2,93,49,44
050,29,041,"Missouri","Chariton County",4,3,88,49,39
050,29,041,"Missouri","Chariton County",4,4,85,51,34
050,29,041,"Missouri","Chariton County",4,5,90,39,51
050,29,041,"Missouri","Chariton County",4,6,96,44,52
050,29,041,"Missouri","Chariton County",4,7,94,54,40
050,29,041,"Missouri","Chariton County",4,8,112,57,55
050,29,041,"Missouri","Chariton County",4,9,96,51,45
050,29,041,"Missouri","Chariton County",4,10,86,46,40
050,29,041,"Missouri","Chariton County",4,11,87,49,38
050,29,041,"Missouri","Chariton County",4,12,100,55,45
050,29,041,"Missouri","Chariton County",4,13,113,62,51
050,29,041,"Missouri","Chariton County",4,14,123,71,52
050,29,041,"Missouri","Chariton County",4,15,104,58,46
050,29,041,"Missouri","Chariton County",4,16,108,60,48
050,29,041,"Missouri","Chariton County",4,17,93,50,43
050,29,041,"Missouri","Chariton County",4,18,78,39,39
050,29,041,"Missouri","Chariton County",4,19,56,29,27
050,29,041,"Missouri","Chariton County",4,20,64,35,29
050,29,041,"Missouri","Chariton County",4,21,77,44,33
050,29,041,"Missouri","Chariton County",4,22,71,43,28
050,29,041,"Missouri","Chariton County",4,23,65,40,25
050,29,041,"Missouri","Chariton County",4,24,58,32,26
050,29,041,"Missouri","Chariton County",4,25,73,40,33
050,29,041,"Missouri","Chariton County",4,26,65,31,34
050,29,041,"Missouri","Chariton County",4,27,61,28,33
050,29,041,"Missouri","Chariton County",4,28,72,34,38
050,29,041,"Missouri","Chariton County",4,29,75,44,31
050,29,041,"Missouri","Chariton County",4,30,90,48,42
050,29,041,"Missouri","Chariton County",4,31,80,38,42
050,29,041,"Missouri","Chariton County",4,32,92,44,48
050,29,041,"Missouri","Chariton County",4,33,69,38,31
050,29,041,"Missouri","Chariton County",4,34,76,42,34
050,29,041,"Missouri","Chariton County",4,35,68,32,36
050,29,041,"Missouri","Chariton County",4,36,68,35,33
050,29,041,"Missouri","Chariton County",4,37,69,33,36
050,29,041,"Missouri","Chariton County",4,38,76,37,39
050,29,041,"Missouri","Chariton County",4,39,74,38,36
050,29,041,"Missouri","Chariton County",4,40,90,47,43
050,29,041,"Missouri","Chariton County",4,41,88,48,40
050,29,041,"Missouri","Chariton County",4,42,91,51,40
050,29,041,"Missouri","Chariton County",4,43,76,35,41
050,29,041,"Missouri","Chariton County",4,44,84,40,44
050,29,041,"Missouri","Chariton County",4,45,69,33,36
050,29,041,"Missouri","Chariton County",4,46,76,36,40
050,29,041,"Missouri","Chariton County",4,47,75,36,39
050,29,041,"Missouri","Chariton County",4,48,70,37,33
050,29,041,"Missouri","Chariton County",4,49,77,40,37
050,29,041,"Missouri","Chariton County",4,50,68,35,33
050,29,041,"Missouri","Chariton County",4,51,71,33,38
050,29,041,"Missouri","Chariton County",4,52,77,39,38
050,29,041,"Missouri","Chariton County",4,53,94,48,46
050,29,041,"Missouri","Chariton County",4,54,91,48,43
050,29,041,"Missouri","Chariton County",4,55,77,39,38
050,29,041,"Missouri","Chariton County",4,56,85,43,42
050,29,041,"Missouri","Chariton County",4,57,92,49,43
050,29,041,"Missouri","Chariton County",4,58,108,55,53
050,29,041,"Missouri","Chariton County",4,59,105,56,49
050,29,041,"Missouri","Chariton County",4,60,108,56,52
050,29,041,"Missouri","Chariton County",4,61,129,63,66
050,29,041,"Missouri","Chariton County",4,62,118,61,57
050,29,041,"Missouri","Chariton County",4,63,118,56,62
050,29,041,"Missouri","Chariton County",4,64,127,60,67
050,29,041,"Missouri","Chariton County",4,65,119,56,63
050,29,041,"Missouri","Chariton County",4,66,122,55,67
050,29,041,"Missouri","Chariton County",4,67,115,61,54
050,29,041,"Missouri","Chariton County",4,68,111,56,55
050,29,041,"Missouri","Chariton County",4,69,101,54,47
050,29,041,"Missouri","Chariton County",4,70,87,49,38
050,29,041,"Missouri","Chariton County",4,71,81,46,35
050,29,041,"Missouri","Chariton County",4,72,83,44,39
050,29,041,"Missouri","Chariton County",4,73,81,42,39
050,29,041,"Missouri","Chariton County",4,74,78,42,36
050,29,041,"Missouri","Chariton County",4,75,82,32,50
050,29,041,"Missouri","Chariton County",4,76,63,33,30
050,29,041,"Missouri","Chariton County",4,77,57,30,27
050,29,041,"Missouri","Chariton County",4,78,57,24,33
050,29,041,"Missouri","Chariton County",4,79,68,33,35
050,29,041,"Missouri","Chariton County",4,80,56,24,32
050,29,041,"Missouri","Chariton County",4,81,62,25,37
050,29,041,"Missouri","Chariton County",4,82,58,26,32
050,29,041,"Missouri","Chariton County",4,83,47,14,33
050,29,041,"Missouri","Chariton County",4,84,44,12,32
050,29,041,"Missouri","Chariton County",4,85,266,97,169
050,29,041,"Missouri","Chariton County",5,0,76,40,36
050,29,041,"Missouri","Chariton County",5,1,86,44,42
050,29,041,"Missouri","Chariton County",5,2,76,38,38
050,29,041,"Missouri","Chariton County",5,3,96,52,44
050,29,041,"Missouri","Chariton County",5,4,88,47,41
050,29,041,"Missouri","Chariton County",5,5,86,47,39
050,29,041,"Missouri","Chariton County",5,6,90,37,53
050,29,041,"Missouri","Chariton County",5,7,102,48,54
050,29,041,"Missouri","Chariton County",5,8,100,58,42
050,29,041,"Missouri","Chariton County",5,9,111,53,58
050,29,041,"Missouri","Chariton County",5,10,92,49,43
050,29,041,"Missouri","Chariton County",5,11,88,46,42
050,29,041,"Missouri","Chariton County",5,12,89,49,40
050,29,041,"Missouri","Chariton County",5,13,98,53,45
050,29,041,"Missouri","Chariton County",5,14,113,60,53
050,29,041,"Missouri","Chariton County",5,15,117,64,53
050,29,041,"Missouri","Chariton County",5,16,102,55,47
050,29,041,"Missouri","Chariton County",5,17,113,59,54
050,29,041,"Missouri","Chariton County",5,18,78,44,34
050,29,041,"Missouri","Chariton County",5,19,63,28,35
050,29,041,"Missouri","Chariton County",5,20,66,31,35
050,29,041,"Missouri","Chariton County",5,21,69,40,29
050,29,041,"Missouri","Chariton County",5,22,82,47,35
050,29,041,"Missouri","Chariton County",5,23,84,48,36
050,29,041,"Missouri","Chariton County",5,24,77,47,30
050,29,041,"Missouri","Chariton County",5,25,60,32,28
050,29,041,"Missouri","Chariton County",5,26,74,37,37
050,29,041,"Missouri","Chariton County",5,27,64,31,33
050,29,041,"Missouri","Chariton County",5,28,65,31,34
050,29,041,"Missouri","Chariton County",5,29,75,33,42
050,29,041,"Missouri","Chariton County",5,30,85,48,37
050,29,041,"Missouri","Chariton County",5,31,87,44,43
050,29,041,"Missouri","Chariton County",5,32,83,39,44
050,29,041,"Missouri","Chariton County",5,33,86,41,45
050,29,041,"Missouri","Chariton County",5,34,72,45,27
050,29,041,"Missouri","Chariton County",5,35,74,39,35
050,29,041,"Missouri","Chariton County",5,36,70,32,38
050,29,041,"Missouri","Chariton County",5,37,77,43,34
050,29,041,"Missouri","Chariton County",5,38,73,39,34
050,29,041,"Missouri","Chariton County",5,39,78,38,40
050,29,041,"Missouri","Chariton County",5,40,74,36,38
050,29,041,"Missouri","Chariton County",5,41,91,47,44
050,29,041,"Missouri","Chariton County",5,42,78,41,37
050,29,041,"Missouri","Chariton County",5,43,82,45,37
050,29,041,"Missouri","Chariton County",5,44,78,35,43
050,29,041,"Missouri","Chariton County",5,45,79,39,40
050,29,041,"Missouri","Chariton County",5,46,71,33,38
050,29,041,"Missouri","Chariton County",5,47,77,37,40
050,29,041,"Missouri","Chariton County",5,48,75,35,40
050,29,041,"Missouri","Chariton County",5,49,75,38,37
050,29,041,"Missouri","Chariton County",5,50,66,36,30
050,29,041,"Missouri","Chariton County",5,51,67,35,32
050,29,041,"Missouri","Chariton County",5,52,71,30,41
050,29,041,"Missouri","Chariton County",5,53,82,42,40
050,29,041,"Missouri","Chariton County",5,54,95,53,42
050,29,041,"Missouri","Chariton County",5,55,87,41,46
050,29,041,"Missouri","Chariton County",5,56,77,42,35
050,29,041,"Missouri","Chariton County",5,57,84,42,42
050,29,041,"Missouri","Chariton County",5,58,91,47,44
050,29,041,"Missouri","Chariton County",5,59,102,53,49
050,29,041,"Missouri","Chariton County",5,60,109,57,52
050,29,041,"Missouri","Chariton County",5,61,110,58,52
050,29,041,"Missouri","Chariton County",5,62,124,61,63
050,29,041,"Missouri","Chariton County",5,63,115,60,55
050,29,041,"Missouri","Chariton County",5,64,121,58,63
050,29,041,"Missouri","Chariton County",5,65,120,58,62
050,29,041,"Missouri","Chariton County",5,66,118,54,64
050,29,041,"Missouri","Chariton County",5,67,117,55,62
050,29,041,"Missouri","Chariton County",5,68,112,58,54
050,29,041,"Missouri","Chariton County",5,69,114,59,55
050,29,041,"Missouri","Chariton County",5,70,93,46,47
050,29,041,"Missouri","Chariton County",5,71,84,50,34
050,29,041,"Missouri","Chariton County",5,72,79,43,36
050,29,041,"Missouri","Chariton County",5,73,80,40,40
050,29,041,"Missouri","Chariton County",5,74,76,40,36
050,29,041,"Missouri","Chariton County",5,75,71,39,32
050,29,041,"Missouri","Chariton County",5,76,77,33,44
050,29,041,"Missouri","Chariton County",5,77,60,30,30
050,29,041,"Missouri","Chariton County",5,78,53,24,29
050,29,041,"Missouri","Chariton County",5,79,53,24,29
050,29,041,"Missouri","Chariton County",5,80,67,29,38
050,29,041,"Missouri","Chariton County",5,81,60,25,35
050,29,041,"Missouri","Chariton County",5,82,53,22,31
050,29,041,"Missouri","Chariton County",5,83,50,21,29
050,29,041,"Missouri","Chariton County",5,84,45,11,34
050,29,041,"Missouri","Chariton County",5,85,271,97,174
050,29,043,"Missouri","Christian County",1,0,1032,527,505
050,29,043,"Missouri","Christian County",1,1,1077,545,532
050,29,043,"Missouri","Christian County",1,2,1048,536,512
050,29,043,"Missouri","Christian County",1,3,1146,588,558
050,29,043,"Missouri","Christian County",1,4,1189,620,569
050,29,043,"Missouri","Christian County",1,5,1221,623,598
050,29,043,"Missouri","Christian County",1,6,1254,615,639
050,29,043,"Missouri","Christian County",1,7,1245,641,604
050,29,043,"Missouri","Christian County",1,8,1275,651,624
050,29,043,"Missouri","Christian County",1,9,1307,694,613
050,29,043,"Missouri","Christian County",1,10,1343,676,667
050,29,043,"Missouri","Christian County",1,11,1374,679,695
050,29,043,"Missouri","Christian County",1,12,1351,681,670
050,29,043,"Missouri","Christian County",1,13,1417,728,689
050,29,043,"Missouri","Christian County",1,14,1389,709,680
050,29,043,"Missouri","Christian County",1,15,1338,685,653
050,29,043,"Missouri","Christian County",1,16,1312,695,617
050,29,043,"Missouri","Christian County",1,17,1243,653,590
050,29,043,"Missouri","Christian County",1,18,1087,556,531
050,29,043,"Missouri","Christian County",1,19,834,431,403
050,29,043,"Missouri","Christian County",1,20,852,443,409
050,29,043,"Missouri","Christian County",1,21,891,452,439
050,29,043,"Missouri","Christian County",1,22,867,426,441
050,29,043,"Missouri","Christian County",1,23,921,451,470
050,29,043,"Missouri","Christian County",1,24,936,441,495
050,29,043,"Missouri","Christian County",1,25,957,466,491
050,29,043,"Missouri","Christian County",1,26,949,459,490
050,29,043,"Missouri","Christian County",1,27,996,505,491
050,29,043,"Missouri","Christian County",1,28,1092,548,544
050,29,043,"Missouri","Christian County",1,29,1124,523,601
050,29,043,"Missouri","Christian County",1,30,1136,543,593
050,29,043,"Missouri","Christian County",1,31,1142,541,601
050,29,043,"Missouri","Christian County",1,32,1154,559,595
050,29,043,"Missouri","Christian County",1,33,1159,554,605
050,29,043,"Missouri","Christian County",1,34,1243,596,647
050,29,043,"Missouri","Christian County",1,35,1245,591,654
050,29,043,"Missouri","Christian County",1,36,1293,642,651
050,29,043,"Missouri","Christian County",1,37,1327,667,660
050,29,043,"Missouri","Christian County",1,38,1241,604,637
050,29,043,"Missouri","Christian County",1,39,1310,648,662
050,29,043,"Missouri","Christian County",1,40,1295,632,663
050,29,043,"Missouri","Christian County",1,41,1246,623,623
050,29,043,"Missouri","Christian County",1,42,1197,627,570
050,29,043,"Missouri","Christian County",1,43,1121,569,552
050,29,043,"Missouri","Christian County",1,44,1068,543,525
050,29,043,"Missouri","Christian County",1,45,1100,544,556
050,29,043,"Missouri","Christian County",1,46,1097,550,547
050,29,043,"Missouri","Christian County",1,47,1133,559,574
050,29,043,"Missouri","Christian County",1,48,1207,607,600
050,29,043,"Missouri","Christian County",1,49,1233,644,589
050,29,043,"Missouri","Christian County",1,50,1131,591,540
050,29,043,"Missouri","Christian County",1,51,1077,561,516
050,29,043,"Missouri","Christian County",1,52,985,489,496
050,29,043,"Missouri","Christian County",1,53,1052,518,534
050,29,043,"Missouri","Christian County",1,54,1059,533,526
050,29,043,"Missouri","Christian County",1,55,1094,532,562
050,29,043,"Missouri","Christian County",1,56,1139,558,581
050,29,043,"Missouri","Christian County",1,57,1133,561,572
050,29,043,"Missouri","Christian County",1,58,1178,538,640
050,29,043,"Missouri","Christian County",1,59,1195,571,624
050,29,043,"Missouri","Christian County",1,60,1168,572,596
050,29,043,"Missouri","Christian County",1,61,1115,551,564
050,29,043,"Missouri","Christian County",1,62,1125,539,586
050,29,043,"Missouri","Christian County",1,63,1109,513,596
050,29,043,"Missouri","Christian County",1,64,1016,463,553
050,29,043,"Missouri","Christian County",1,65,975,482,493
050,29,043,"Missouri","Christian County",1,66,943,463,480
050,29,043,"Missouri","Christian County",1,67,934,425,509
050,29,043,"Missouri","Christian County",1,68,964,443,521
050,29,043,"Missouri","Christian County",1,69,890,420,470
050,29,043,"Missouri","Christian County",1,70,834,388,446
050,29,043,"Missouri","Christian County",1,71,840,393,447
050,29,043,"Missouri","Christian County",1,72,872,423,449
050,29,043,"Missouri","Christian County",1,73,815,394,421
050,29,043,"Missouri","Christian County",1,74,553,268,285
050,29,043,"Missouri","Christian County",1,75,580,274,306
050,29,043,"Missouri","Christian County",1,76,590,266,324
050,29,043,"Missouri","Christian County",1,77,565,268,297
050,29,043,"Missouri","Christian County",1,78,477,220,257
050,29,043,"Missouri","Christian County",1,79,437,183,254
050,29,043,"Missouri","Christian County",1,80,355,155,200
050,29,043,"Missouri","Christian County",1,81,356,168,188
050,29,043,"Missouri","Christian County",1,82,323,147,176
050,29,043,"Missouri","Christian County",1,83,273,118,155
050,29,043,"Missouri","Christian County",1,84,279,123,156
050,29,043,"Missouri","Christian County",1,85,1396,519,877
050,29,043,"Missouri","Christian County",2,0,1010,509,501
050,29,043,"Missouri","Christian County",2,1,1062,539,523
050,29,043,"Missouri","Christian County",2,2,1066,542,524
050,29,043,"Missouri","Christian County",2,3,1130,576,554
050,29,043,"Missouri","Christian County",2,4,1197,621,576
050,29,043,"Missouri","Christian County",2,5,1230,630,600
050,29,043,"Missouri","Christian County",2,6,1258,624,634
050,29,043,"Missouri","Christian County",2,7,1256,639,617
050,29,043,"Missouri","Christian County",2,8,1272,652,620
050,29,043,"Missouri","Christian County",2,9,1303,684,619
050,29,043,"Missouri","Christian County",2,10,1345,684,661
050,29,043,"Missouri","Christian County",2,11,1365,680,685
050,29,043,"Missouri","Christian County",2,12,1372,691,681
050,29,043,"Missouri","Christian County",2,13,1409,722,687
050,29,043,"Missouri","Christian County",2,14,1401,715,686
050,29,043,"Missouri","Christian County",2,15,1355,694,661
050,29,043,"Missouri","Christian County",2,16,1325,698,627
050,29,043,"Missouri","Christian County",2,17,1263,665,598
050,29,043,"Missouri","Christian County",2,18,1070,557,513
050,29,043,"Missouri","Christian County",2,19,852,437,415
050,29,043,"Missouri","Christian County",2,20,867,447,420
050,29,043,"Missouri","Christian County",2,21,884,449,435
050,29,043,"Missouri","Christian County",2,22,884,437,447
050,29,043,"Missouri","Christian County",2,23,922,449,473
050,29,043,"Missouri","Christian County",2,24,934,445,489
050,29,043,"Missouri","Christian County",2,25,950,458,492
050,29,043,"Missouri","Christian County",2,26,957,464,493
050,29,043,"Missouri","Christian County",2,27,995,500,495
050,29,043,"Missouri","Christian County",2,28,1082,541,541
050,29,043,"Missouri","Christian County",2,29,1126,532,594
050,29,043,"Missouri","Christian County",2,30,1151,545,606
050,29,043,"Missouri","Christian County",2,31,1151,546,605
050,29,043,"Missouri","Christian County",2,32,1153,554,599
050,29,043,"Missouri","Christian County",2,33,1165,559,606
050,29,043,"Missouri","Christian County",2,34,1229,588,641
050,29,043,"Missouri","Christian County",2,35,1269,608,661
050,29,043,"Missouri","Christian County",2,36,1287,636,651
050,29,043,"Missouri","Christian County",2,37,1323,661,662
050,29,043,"Missouri","Christian County",2,38,1276,629,647
050,29,043,"Missouri","Christian County",2,39,1296,640,656
050,29,043,"Missouri","Christian County",2,40,1308,641,667
050,29,043,"Missouri","Christian County",2,41,1259,626,633
050,29,043,"Missouri","Christian County",2,42,1200,623,577
050,29,043,"Missouri","Christian County",2,43,1141,585,556
050,29,043,"Missouri","Christian County",2,44,1071,545,526
050,29,043,"Missouri","Christian County",2,45,1095,546,549
050,29,043,"Missouri","Christian County",2,46,1092,547,545
050,29,043,"Missouri","Christian County",2,47,1127,558,569
050,29,043,"Missouri","Christian County",2,48,1192,598,594
050,29,043,"Missouri","Christian County",2,49,1237,640,597
050,29,043,"Missouri","Christian County",2,50,1162,608,554
050,29,043,"Missouri","Christian County",2,51,1095,569,526
050,29,043,"Missouri","Christian County",2,52,1008,505,503
050,29,043,"Missouri","Christian County",2,53,1042,515,527
050,29,043,"Missouri","Christian County",2,54,1056,529,527
050,29,043,"Missouri","Christian County",2,55,1089,533,556
050,29,043,"Missouri","Christian County",2,56,1130,552,578
050,29,043,"Missouri","Christian County",2,57,1141,562,579
050,29,043,"Missouri","Christian County",2,58,1168,544,624
050,29,043,"Missouri","Christian County",2,59,1202,569,633
050,29,043,"Missouri","Christian County",2,60,1178,574,604
050,29,043,"Missouri","Christian County",2,61,1130,556,574
050,29,043,"Missouri","Christian County",2,62,1130,545,585
050,29,043,"Missouri","Christian County",2,63,1117,520,597
050,29,043,"Missouri","Christian County",2,64,1033,476,557
050,29,043,"Missouri","Christian County",2,65,995,484,511
050,29,043,"Missouri","Christian County",2,66,953,469,484
050,29,043,"Missouri","Christian County",2,67,939,436,503
050,29,043,"Missouri","Christian County",2,68,952,438,514
050,29,043,"Missouri","Christian County",2,69,917,429,488
050,29,043,"Missouri","Christian County",2,70,844,395,449
050,29,043,"Missouri","Christian County",2,71,842,393,449
050,29,043,"Missouri","Christian County",2,72,848,408,440
050,29,043,"Missouri","Christian County",2,73,873,425,448
050,29,043,"Missouri","Christian County",2,74,579,279,300
050,29,043,"Missouri","Christian County",2,75,578,272,306
050,29,043,"Missouri","Christian County",2,76,583,267,316
050,29,043,"Missouri","Christian County",2,77,582,271,311
050,29,043,"Missouri","Christian County",2,78,485,227,258
050,29,043,"Missouri","Christian County",2,79,442,186,256
050,29,043,"Missouri","Christian County",2,80,373,162,211
050,29,043,"Missouri","Christian County",2,81,354,166,188
050,29,043,"Missouri","Christian County",2,82,328,149,179
050,29,043,"Missouri","Christian County",2,83,279,124,155
050,29,043,"Missouri","Christian County",2,84,270,119,151
050,29,043,"Missouri","Christian County",2,85,1424,529,895
050,29,043,"Missouri","Christian County",3,0,1029,519,510
050,29,043,"Missouri","Christian County",3,1,1116,565,551
050,29,043,"Missouri","Christian County",3,2,1125,560,565
050,29,043,"Missouri","Christian County",3,3,1142,576,566
050,29,043,"Missouri","Christian County",3,4,1218,618,600
050,29,043,"Missouri","Christian County",3,5,1286,695,591
050,29,043,"Missouri","Christian County",3,6,1284,653,631
050,29,043,"Missouri","Christian County",3,7,1312,653,659
050,29,043,"Missouri","Christian County",3,8,1263,662,601
050,29,043,"Missouri","Christian County",3,9,1327,678,649
050,29,043,"Missouri","Christian County",3,10,1328,686,642
050,29,043,"Missouri","Christian County",3,11,1378,696,682
050,29,043,"Missouri","Christian County",3,12,1411,712,699
050,29,043,"Missouri","Christian County",3,13,1409,697,712
050,29,043,"Missouri","Christian County",3,14,1449,739,710
050,29,043,"Missouri","Christian County",3,15,1419,731,688
050,29,043,"Missouri","Christian County",3,16,1379,717,662
050,29,043,"Missouri","Christian County",3,17,1316,681,635
050,29,043,"Missouri","Christian County",3,18,1067,575,492
050,29,043,"Missouri","Christian County",3,19,843,439,404
050,29,043,"Missouri","Christian County",3,20,916,468,448
050,29,043,"Missouri","Christian County",3,21,903,451,452
050,29,043,"Missouri","Christian County",3,22,924,464,460
050,29,043,"Missouri","Christian County",3,23,947,447,500
050,29,043,"Missouri","Christian County",3,24,947,459,488
050,29,043,"Missouri","Christian County",3,25,971,461,510
050,29,043,"Missouri","Christian County",3,26,986,461,525
050,29,043,"Missouri","Christian County",3,27,1026,508,518
050,29,043,"Missouri","Christian County",3,28,1069,552,517
050,29,043,"Missouri","Christian County",3,29,1160,589,571
050,29,043,"Missouri","Christian County",3,30,1175,554,621
050,29,043,"Missouri","Christian County",3,31,1218,581,637
050,29,043,"Missouri","Christian County",3,32,1186,566,620
050,29,043,"Missouri","Christian County",3,33,1198,572,626
050,29,043,"Missouri","Christian County",3,34,1212,596,616
050,29,043,"Missouri","Christian County",3,35,1274,606,668
050,29,043,"Missouri","Christian County",3,36,1335,638,697
050,29,043,"Missouri","Christian County",3,37,1328,667,661
050,29,043,"Missouri","Christian County",3,38,1349,680,669
050,29,043,"Missouri","Christian County",3,39,1332,639,693
050,29,043,"Missouri","Christian County",3,40,1312,660,652
050,29,043,"Missouri","Christian County",3,41,1329,653,676
050,29,043,"Missouri","Christian County",3,42,1278,643,635
050,29,043,"Missouri","Christian County",3,43,1244,639,605
050,29,043,"Missouri","Christian County",3,44,1158,593,565
050,29,043,"Missouri","Christian County",3,45,1092,557,535
050,29,043,"Missouri","Christian County",3,46,1090,554,536
050,29,043,"Missouri","Christian County",3,47,1091,534,557
050,29,043,"Missouri","Christian County",3,48,1139,565,574
050,29,043,"Missouri","Christian County",3,49,1185,604,581
050,29,043,"Missouri","Christian County",3,50,1271,653,618
050,29,043,"Missouri","Christian County",3,51,1205,629,576
050,29,043,"Missouri","Christian County",3,52,1092,560,532
050,29,043,"Missouri","Christian County",3,53,1047,530,517
050,29,043,"Missouri","Christian County",3,54,1047,519,528
050,29,043,"Missouri","Christian County",3,55,1063,537,526
050,29,043,"Missouri","Christian County",3,56,1098,522,576
050,29,043,"Missouri","Christian County",3,57,1135,553,582
050,29,043,"Missouri","Christian County",3,58,1156,578,578
050,29,043,"Missouri","Christian County",3,59,1200,569,631
050,29,043,"Missouri","Christian County",3,60,1230,580,650
050,29,043,"Missouri","Christian County",3,61,1199,584,615
050,29,043,"Missouri","Christian County",3,62,1137,553,584
050,29,043,"Missouri","Christian County",3,63,1141,535,606
050,29,043,"Missouri","Christian County",3,64,1110,508,602
050,29,043,"Missouri","Christian County",3,65,1058,486,572
050,29,043,"Missouri","Christian County",3,66,980,471,509
050,29,043,"Missouri","Christian County",3,67,974,474,500
050,29,043,"Missouri","Christian County",3,68,927,426,501
050,29,043,"Missouri","Christian County",3,69,947,434,513
050,29,043,"Missouri","Christian County",3,70,917,428,489
050,29,043,"Missouri","Christian County",3,71,838,392,446
050,29,043,"Missouri","Christian County",3,72,814,371,443
050,29,043,"Missouri","Christian County",3,73,821,396,425
050,29,043,"Missouri","Christian County",3,74,853,405,448
050,29,043,"Missouri","Christian County",3,75,569,272,297
050,29,043,"Missouri","Christian County",3,76,575,258,317
050,29,043,"Missouri","Christian County",3,77,566,261,305
050,29,043,"Missouri","Christian County",3,78,553,256,297
050,29,043,"Missouri","Christian County",3,79,472,217,255
050,29,043,"Missouri","Christian County",3,80,425,178,247
050,29,043,"Missouri","Christian County",3,81,364,159,205
050,29,043,"Missouri","Christian County",3,82,328,156,172
050,29,043,"Missouri","Christian County",3,83,299,130,169
050,29,043,"Missouri","Christian County",3,84,270,114,156
050,29,043,"Missouri","Christian County",3,85,1460,536,924
050,29,043,"Missouri","Christian County",4,0,1052,535,517
050,29,043,"Missouri","Christian County",4,1,1075,551,524
050,29,043,"Missouri","Christian County",4,2,1174,600,574
050,29,043,"Missouri","Christian County",4,3,1177,583,594
050,29,043,"Missouri","Christian County",4,4,1165,596,569
050,29,043,"Missouri","Christian County",4,5,1261,655,606
050,29,043,"Missouri","Christian County",4,6,1370,746,624
050,29,043,"Missouri","Christian County",4,7,1343,672,671
050,29,043,"Missouri","Christian County",4,8,1334,667,667
050,29,043,"Missouri","Christian County",4,9,1310,686,624
050,29,043,"Missouri","Christian County",4,10,1354,701,653
050,29,043,"Missouri","Christian County",4,11,1375,714,661
050,29,043,"Missouri","Christian County",4,12,1413,722,691
050,29,043,"Missouri","Christian County",4,13,1440,736,704
050,29,043,"Missouri","Christian County",4,14,1417,702,715
050,29,043,"Missouri","Christian County",4,15,1474,745,729
050,29,043,"Missouri","Christian County",4,16,1415,722,693
050,29,043,"Missouri","Christian County",4,17,1422,736,686
050,29,043,"Missouri","Christian County",4,18,1123,591,532
050,29,043,"Missouri","Christian County",4,19,840,464,376
050,29,043,"Missouri","Christian County",4,20,863,456,407
050,29,043,"Missouri","Christian County",4,21,920,471,449
050,29,043,"Missouri","Christian County",4,22,919,464,455
050,29,043,"Missouri","Christian County",4,23,935,446,489
050,29,043,"Missouri","Christian County",4,24,979,464,515
050,29,043,"Missouri","Christian County",4,25,1003,486,517
050,29,043,"Missouri","Christian County",4,26,998,475,523
050,29,043,"Missouri","Christian County",4,27,1003,475,528
050,29,043,"Missouri","Christian County",4,28,1058,517,541
050,29,043,"Missouri","Christian County",4,29,1072,555,517
050,29,043,"Missouri","Christian County",4,30,1219,611,608
050,29,043,"Missouri","Christian County",4,31,1223,591,632
050,29,043,"Missouri","Christian County",4,32,1261,616,645
050,29,043,"Missouri","Christian County",4,33,1230,573,657
050,29,043,"Missouri","Christian County",4,34,1231,598,633
050,29,043,"Missouri","Christian County",4,35,1262,612,650
050,29,043,"Missouri","Christian County",4,36,1288,615,673
050,29,043,"Missouri","Christian County",4,37,1363,650,713
050,29,043,"Missouri","Christian County",4,38,1337,675,662
050,29,043,"Missouri","Christian County",4,39,1395,698,697
050,29,043,"Missouri","Christian County",4,40,1333,639,694
050,29,043,"Missouri","Christian County",4,41,1327,672,655
050,29,043,"Missouri","Christian County",4,42,1342,660,682
050,29,043,"Missouri","Christian County",4,43,1288,645,643
050,29,043,"Missouri","Christian County",4,44,1260,653,607
050,29,043,"Missouri","Christian County",4,45,1185,596,589
050,29,043,"Missouri","Christian County",4,46,1114,568,546
050,29,043,"Missouri","Christian County",4,47,1093,564,529
050,29,043,"Missouri","Christian County",4,48,1076,523,553
050,29,043,"Missouri","Christian County",4,49,1151,573,578
050,29,043,"Missouri","Christian County",4,50,1194,610,584
050,29,043,"Missouri","Christian County",4,51,1263,666,597
050,29,043,"Missouri","Christian County",4,52,1198,612,586
050,29,043,"Missouri","Christian County",4,53,1105,574,531
050,29,043,"Missouri","Christian County",4,54,1050,536,514
050,29,043,"Missouri","Christian County",4,55,1044,506,538
050,29,043,"Missouri","Christian County",4,56,1066,532,534
050,29,043,"Missouri","Christian County",4,57,1119,535,584
050,29,043,"Missouri","Christian County",4,58,1153,565,588
050,29,043,"Missouri","Christian County",4,59,1183,594,589
050,29,043,"Missouri","Christian County",4,60,1180,560,620
050,29,043,"Missouri","Christian County",4,61,1238,575,663
050,29,043,"Missouri","Christian County",4,62,1191,575,616
050,29,043,"Missouri","Christian County",4,63,1133,552,581
050,29,043,"Missouri","Christian County",4,64,1117,525,592
050,29,043,"Missouri","Christian County",4,65,1085,496,589
050,29,043,"Missouri","Christian County",4,66,1061,479,582
050,29,043,"Missouri","Christian County",4,67,966,460,506
050,29,043,"Missouri","Christian County",4,68,971,475,496
050,29,043,"Missouri","Christian County",4,69,939,424,515
050,29,043,"Missouri","Christian County",4,70,952,437,515
050,29,043,"Missouri","Christian County",4,71,905,415,490
050,29,043,"Missouri","Christian County",4,72,835,383,452
050,29,043,"Missouri","Christian County",4,73,795,360,435
050,29,043,"Missouri","Christian County",4,74,802,386,416
050,29,043,"Missouri","Christian County",4,75,841,399,442
050,29,043,"Missouri","Christian County",4,76,561,265,296
050,29,043,"Missouri","Christian County",4,77,551,234,317
050,29,043,"Missouri","Christian County",4,78,543,247,296
050,29,043,"Missouri","Christian County",4,79,530,243,287
050,29,043,"Missouri","Christian County",4,80,433,198,235
050,29,043,"Missouri","Christian County",4,81,395,166,229
050,29,043,"Missouri","Christian County",4,82,334,143,191
050,29,043,"Missouri","Christian County",4,83,309,145,164
050,29,043,"Missouri","Christian County",4,84,297,125,172
050,29,043,"Missouri","Christian County",4,85,1521,564,957
050,29,043,"Missouri","Christian County",5,0,1044,532,512
050,29,043,"Missouri","Christian County",5,1,1091,567,524
050,29,043,"Missouri","Christian County",5,2,1119,565,554
050,29,043,"Missouri","Christian County",5,3,1196,606,590
050,29,043,"Missouri","Christian County",5,4,1238,621,617
050,29,043,"Missouri","Christian County",5,5,1184,592,592
050,29,043,"Missouri","Christian County",5,6,1322,676,646
050,29,043,"Missouri","Christian County",5,7,1375,750,625
050,29,043,"Missouri","Christian County",5,8,1381,689,692
050,29,043,"Missouri","Christian County",5,9,1363,678,685
050,29,043,"Missouri","Christian County",5,10,1316,676,640
050,29,043,"Missouri","Christian County",5,11,1376,694,682
050,29,043,"Missouri","Christian County",5,12,1401,729,672
050,29,043,"Missouri","Christian County",5,13,1449,741,708
050,29,043,"Missouri","Christian County",5,14,1442,746,696
050,29,043,"Missouri","Christian County",5,15,1431,717,714
050,29,043,"Missouri","Christian County",5,16,1450,737,713
050,29,043,"Missouri","Christian County",5,17,1442,730,712
050,29,043,"Missouri","Christian County",5,18,1184,638,546
050,29,043,"Missouri","Christian County",5,19,861,461,400
050,29,043,"Missouri","Christian County",5,20,878,479,399
050,29,043,"Missouri","Christian County",5,21,877,465,412
050,29,043,"Missouri","Christian County",5,22,933,458,475
050,29,043,"Missouri","Christian County",5,23,965,505,460
050,29,043,"Missouri","Christian County",5,24,985,485,500
050,29,043,"Missouri","Christian County",5,25,1007,477,530
050,29,043,"Missouri","Christian County",5,26,1046,501,545
050,29,043,"Missouri","Christian County",5,27,1040,498,542
050,29,043,"Missouri","Christian County",5,28,1051,495,556
050,29,043,"Missouri","Christian County",5,29,1090,543,547
050,29,043,"Missouri","Christian County",5,30,1092,545,547
050,29,043,"Missouri","Christian County",5,31,1273,648,625
050,29,043,"Missouri","Christian County",5,32,1257,603,654
050,29,043,"Missouri","Christian County",5,33,1319,651,668
050,29,043,"Missouri","Christian County",5,34,1262,592,670
050,29,043,"Missouri","Christian County",5,35,1245,608,637
050,29,043,"Missouri","Christian County",5,36,1291,622,669
050,29,043,"Missouri","Christian County",5,37,1317,625,692
050,29,043,"Missouri","Christian County",5,38,1369,664,705
050,29,043,"Missouri","Christian County",5,39,1360,666,694
050,29,043,"Missouri","Christian County",5,40,1406,699,707
050,29,043,"Missouri","Christian County",5,41,1351,661,690
050,29,043,"Missouri","Christian County",5,42,1355,684,671
050,29,043,"Missouri","Christian County",5,43,1355,657,698
050,29,043,"Missouri","Christian County",5,44,1307,671,636
050,29,043,"Missouri","Christian County",5,45,1266,652,614
050,29,043,"Missouri","Christian County",5,46,1207,610,597
050,29,043,"Missouri","Christian County",5,47,1123,574,549
050,29,043,"Missouri","Christian County",5,48,1092,571,521
050,29,043,"Missouri","Christian County",5,49,1067,527,540
050,29,043,"Missouri","Christian County",5,50,1162,569,593
050,29,043,"Missouri","Christian County",5,51,1192,598,594
050,29,043,"Missouri","Christian County",5,52,1236,652,584
050,29,043,"Missouri","Christian County",5,53,1216,641,575
050,29,043,"Missouri","Christian County",5,54,1111,574,537
050,29,043,"Missouri","Christian County",5,55,1052,529,523
050,29,043,"Missouri","Christian County",5,56,1036,502,534
050,29,043,"Missouri","Christian County",5,57,1069,536,533
050,29,043,"Missouri","Christian County",5,58,1118,536,582
050,29,043,"Missouri","Christian County",5,59,1176,570,606
050,29,043,"Missouri","Christian County",5,60,1204,591,613
050,29,043,"Missouri","Christian County",5,61,1200,570,630
050,29,043,"Missouri","Christian County",5,62,1225,571,654
050,29,043,"Missouri","Christian County",5,63,1195,578,617
050,29,043,"Missouri","Christian County",5,64,1126,554,572
050,29,043,"Missouri","Christian County",5,65,1131,523,608
050,29,043,"Missouri","Christian County",5,66,1078,495,583
050,29,043,"Missouri","Christian County",5,67,1063,481,582
050,29,043,"Missouri","Christian County",5,68,950,446,504
050,29,043,"Missouri","Christian County",5,69,962,463,499
050,29,043,"Missouri","Christian County",5,70,937,429,508
050,29,043,"Missouri","Christian County",5,71,943,432,511
050,29,043,"Missouri","Christian County",5,72,877,394,483
050,29,043,"Missouri","Christian County",5,73,821,384,437
050,29,043,"Missouri","Christian County",5,74,784,347,437
050,29,043,"Missouri","Christian County",5,75,774,376,398
050,29,043,"Missouri","Christian County",5,76,827,396,431
050,29,043,"Missouri","Christian County",5,77,542,254,288
050,29,043,"Missouri","Christian County",5,78,542,228,314
050,29,043,"Missouri","Christian County",5,79,531,231,300
050,29,043,"Missouri","Christian County",5,80,492,227,265
050,29,043,"Missouri","Christian County",5,81,416,191,225
050,29,043,"Missouri","Christian County",5,82,352,144,208
050,29,043,"Missouri","Christian County",5,83,303,127,176
050,29,043,"Missouri","Christian County",5,84,308,140,168
050,29,043,"Missouri","Christian County",5,85,1620,614,1006
050,29,045,"Missouri","Clark County",1,0,70,35,35
050,29,045,"Missouri","Clark County",1,1,71,38,33
050,29,045,"Missouri","Clark County",1,2,75,43,32
050,29,045,"Missouri","Clark County",1,3,81,46,35
050,29,045,"Missouri","Clark County",1,4,77,39,38
050,29,045,"Missouri","Clark County",1,5,85,45,40
050,29,045,"Missouri","Clark County",1,6,83,45,38
050,29,045,"Missouri","Clark County",1,7,76,38,38
050,29,045,"Missouri","Clark County",1,8,76,37,39
050,29,045,"Missouri","Clark County",1,9,82,42,40
050,29,045,"Missouri","Clark County",1,10,88,46,42
050,29,045,"Missouri","Clark County",1,11,98,53,45
050,29,045,"Missouri","Clark County",1,12,102,58,44
050,29,045,"Missouri","Clark County",1,13,100,60,40
050,29,045,"Missouri","Clark County",1,14,105,55,50
050,29,045,"Missouri","Clark County",1,15,92,48,44
050,29,045,"Missouri","Clark County",1,16,84,49,35
050,29,045,"Missouri","Clark County",1,17,81,41,40
050,29,045,"Missouri","Clark County",1,18,69,39,30
050,29,045,"Missouri","Clark County",1,19,60,32,28
050,29,045,"Missouri","Clark County",1,20,60,32,28
050,29,045,"Missouri","Clark County",1,21,56,29,27
050,29,045,"Missouri","Clark County",1,22,69,36,33
050,29,045,"Missouri","Clark County",1,23,69,40,29
050,29,045,"Missouri","Clark County",1,24,62,32,30
050,29,045,"Missouri","Clark County",1,25,70,40,30
050,29,045,"Missouri","Clark County",1,26,68,33,35
050,29,045,"Missouri","Clark County",1,27,72,36,36
050,29,045,"Missouri","Clark County",1,28,69,33,36
050,29,045,"Missouri","Clark County",1,29,75,37,38
050,29,045,"Missouri","Clark County",1,30,68,31,37
050,29,045,"Missouri","Clark County",1,31,66,33,33
050,29,045,"Missouri","Clark County",1,32,71,42,29
050,29,045,"Missouri","Clark County",1,33,69,42,27
050,29,045,"Missouri","Clark County",1,34,65,33,32
050,29,045,"Missouri","Clark County",1,35,62,31,31
050,29,045,"Missouri","Clark County",1,36,75,39,36
050,29,045,"Missouri","Clark County",1,37,69,34,35
050,29,045,"Missouri","Clark County",1,38,80,40,40
050,29,045,"Missouri","Clark County",1,39,72,34,38
050,29,045,"Missouri","Clark County",1,40,75,35,40
050,29,045,"Missouri","Clark County",1,41,73,43,30
050,29,045,"Missouri","Clark County",1,42,80,45,35
050,29,045,"Missouri","Clark County",1,43,83,44,39
050,29,045,"Missouri","Clark County",1,44,85,43,42
050,29,045,"Missouri","Clark County",1,45,80,44,36
050,29,045,"Missouri","Clark County",1,46,67,37,30
050,29,045,"Missouri","Clark County",1,47,72,39,33
050,29,045,"Missouri","Clark County",1,48,79,42,37
050,29,045,"Missouri","Clark County",1,49,77,42,35
050,29,045,"Missouri","Clark County",1,50,67,32,35
050,29,045,"Missouri","Clark County",1,51,79,39,40
050,29,045,"Missouri","Clark County",1,52,98,47,51
050,29,045,"Missouri","Clark County",1,53,86,48,38
050,29,045,"Missouri","Clark County",1,54,86,49,37
050,29,045,"Missouri","Clark County",1,55,104,59,45
050,29,045,"Missouri","Clark County",1,56,113,60,53
050,29,045,"Missouri","Clark County",1,57,106,51,55
050,29,045,"Missouri","Clark County",1,58,103,52,51
050,29,045,"Missouri","Clark County",1,59,122,61,61
050,29,045,"Missouri","Clark County",1,60,99,53,46
050,29,045,"Missouri","Clark County",1,61,99,50,49
050,29,045,"Missouri","Clark County",1,62,97,52,45
050,29,045,"Missouri","Clark County",1,63,98,49,49
050,29,045,"Missouri","Clark County",1,64,94,48,46
050,29,045,"Missouri","Clark County",1,65,96,56,40
050,29,045,"Missouri","Clark County",1,66,95,56,39
050,29,045,"Missouri","Clark County",1,67,84,44,40
050,29,045,"Missouri","Clark County",1,68,93,45,48
050,29,045,"Missouri","Clark County",1,69,76,37,39
050,29,045,"Missouri","Clark County",1,70,78,35,43
050,29,045,"Missouri","Clark County",1,71,80,39,41
050,29,045,"Missouri","Clark County",1,72,66,30,36
050,29,045,"Missouri","Clark County",1,73,81,40,41
050,29,045,"Missouri","Clark County",1,74,56,27,29
050,29,045,"Missouri","Clark County",1,75,56,26,30
050,29,045,"Missouri","Clark County",1,76,50,25,25
050,29,045,"Missouri","Clark County",1,77,49,21,28
050,29,045,"Missouri","Clark County",1,78,46,18,28
050,29,045,"Missouri","Clark County",1,79,49,21,28
050,29,045,"Missouri","Clark County",1,80,36,19,17
050,29,045,"Missouri","Clark County",1,81,36,18,18
050,29,045,"Missouri","Clark County",1,82,35,19,16
050,29,045,"Missouri","Clark County",1,83,28,13,15
050,29,045,"Missouri","Clark County",1,84,35,15,20
050,29,045,"Missouri","Clark County",1,85,169,71,98
050,29,045,"Missouri","Clark County",2,0,80,45,35
050,29,045,"Missouri","Clark County",2,1,70,37,33
050,29,045,"Missouri","Clark County",2,2,74,42,32
050,29,045,"Missouri","Clark County",2,3,79,45,34
050,29,045,"Missouri","Clark County",2,4,78,41,37
050,29,045,"Missouri","Clark County",2,5,84,44,40
050,29,045,"Missouri","Clark County",2,6,83,45,38
050,29,045,"Missouri","Clark County",2,7,77,39,38
050,29,045,"Missouri","Clark County",2,8,76,38,38
050,29,045,"Missouri","Clark County",2,9,81,40,41
050,29,045,"Missouri","Clark County",2,10,87,45,42
050,29,045,"Missouri","Clark County",2,11,96,51,45
050,29,045,"Missouri","Clark County",2,12,102,57,45
050,29,045,"Missouri","Clark County",2,13,101,60,41
050,29,045,"Missouri","Clark County",2,14,105,56,49
050,29,045,"Missouri","Clark County",2,15,95,50,45
050,29,045,"Missouri","Clark County",2,16,85,48,37
050,29,045,"Missouri","Clark County",2,17,80,41,39
050,29,045,"Missouri","Clark County",2,18,68,38,30
050,29,045,"Missouri","Clark County",2,19,59,32,27
050,29,045,"Missouri","Clark County",2,20,63,33,30
050,29,045,"Missouri","Clark County",2,21,58,30,28
050,29,045,"Missouri","Clark County",2,22,67,35,32
050,29,045,"Missouri","Clark County",2,23,69,39,30
050,29,045,"Missouri","Clark County",2,24,63,34,29
050,29,045,"Missouri","Clark County",2,25,68,38,30
050,29,045,"Missouri","Clark County",2,26,70,35,35
050,29,045,"Missouri","Clark County",2,27,71,36,35
050,29,045,"Missouri","Clark County",2,28,70,35,35
050,29,045,"Missouri","Clark County",2,29,73,36,37
050,29,045,"Missouri","Clark County",2,30,70,33,37
050,29,045,"Missouri","Clark County",2,31,67,32,35
050,29,045,"Missouri","Clark County",2,32,69,39,30
050,29,045,"Missouri","Clark County",2,33,70,43,27
050,29,045,"Missouri","Clark County",2,34,66,35,31
050,29,045,"Missouri","Clark County",2,35,61,31,30
050,29,045,"Missouri","Clark County",2,36,72,37,35
050,29,045,"Missouri","Clark County",2,37,70,35,35
050,29,045,"Missouri","Clark County",2,38,78,39,39
050,29,045,"Missouri","Clark County",2,39,75,35,40
050,29,045,"Missouri","Clark County",2,40,75,35,40
050,29,045,"Missouri","Clark County",2,41,75,42,33
050,29,045,"Missouri","Clark County",2,42,79,44,35
050,29,045,"Missouri","Clark County",2,43,84,45,39
050,29,045,"Missouri","Clark County",2,44,84,43,41
050,29,045,"Missouri","Clark County",2,45,82,44,38
050,29,045,"Missouri","Clark County",2,46,70,39,31
050,29,045,"Missouri","Clark County",2,47,70,38,32
050,29,045,"Missouri","Clark County",2,48,77,41,36
050,29,045,"Missouri","Clark County",2,49,78,42,36
050,29,045,"Missouri","Clark County",2,50,69,34,35
050,29,045,"Missouri","Clark County",2,51,76,37,39
050,29,045,"Missouri","Clark County",2,52,93,45,48
050,29,045,"Missouri","Clark County",2,53,89,48,41
050,29,045,"Missouri","Clark County",2,54,84,48,36
050,29,045,"Missouri","Clark County",2,55,100,57,43
050,29,045,"Missouri","Clark County",2,56,111,60,51
050,29,045,"Missouri","Clark County",2,57,109,54,55
050,29,045,"Missouri","Clark County",2,58,104,52,52
050,29,045,"Missouri","Clark County",2,59,119,60,59
050,29,045,"Missouri","Clark County",2,60,104,55,49
050,29,045,"Missouri","Clark County",2,61,98,51,47
050,29,045,"Missouri","Clark County",2,62,98,52,46
050,29,045,"Missouri","Clark County",2,63,98,50,48
050,29,045,"Missouri","Clark County",2,64,96,49,47
050,29,045,"Missouri","Clark County",2,65,95,54,41
050,29,045,"Missouri","Clark County",2,66,95,57,38
050,29,045,"Missouri","Clark County",2,67,87,47,40
050,29,045,"Missouri","Clark County",2,68,91,45,46
050,29,045,"Missouri","Clark County",2,69,82,40,42
050,29,045,"Missouri","Clark County",2,70,77,35,42
050,29,045,"Missouri","Clark County",2,71,80,38,42
050,29,045,"Missouri","Clark County",2,72,67,31,36
050,29,045,"Missouri","Clark County",2,73,82,40,42
050,29,045,"Missouri","Clark County",2,74,57,28,29
050,29,045,"Missouri","Clark County",2,75,57,27,30
050,29,045,"Missouri","Clark County",2,76,51,25,26
050,29,045,"Missouri","Clark County",2,77,50,22,28
050,29,045,"Missouri","Clark County",2,78,47,19,28
050,29,045,"Missouri","Clark County",2,79,47,20,27
050,29,045,"Missouri","Clark County",2,80,40,20,20
050,29,045,"Missouri","Clark County",2,81,36,19,17
050,29,045,"Missouri","Clark County",2,82,35,19,16
050,29,045,"Missouri","Clark County",2,83,29,14,15
050,29,045,"Missouri","Clark County",2,84,33,14,19
050,29,045,"Missouri","Clark County",2,85,170,72,98
050,29,045,"Missouri","Clark County",3,0,79,42,37
050,29,045,"Missouri","Clark County",3,1,81,45,36
050,29,045,"Missouri","Clark County",3,2,68,37,31
050,29,045,"Missouri","Clark County",3,3,82,47,35
050,29,045,"Missouri","Clark County",3,4,88,44,44
050,29,045,"Missouri","Clark County",3,5,82,40,42
050,29,045,"Missouri","Clark County",3,6,89,48,41
050,29,045,"Missouri","Clark County",3,7,79,39,40
050,29,045,"Missouri","Clark County",3,8,89,46,43
050,29,045,"Missouri","Clark County",3,9,77,40,37
050,29,045,"Missouri","Clark County",3,10,83,42,41
050,29,045,"Missouri","Clark County",3,11,87,47,40
050,29,045,"Missouri","Clark County",3,12,99,55,44
050,29,045,"Missouri","Clark County",3,13,103,58,45
050,29,045,"Missouri","Clark County",3,14,101,58,43
050,29,045,"Missouri","Clark County",3,15,99,53,46
050,29,045,"Missouri","Clark County",3,16,92,48,44
050,29,045,"Missouri","Clark County",3,17,84,48,36
050,29,045,"Missouri","Clark County",3,18,71,38,33
050,29,045,"Missouri","Clark County",3,19,50,25,25
050,29,045,"Missouri","Clark County",3,20,60,30,30
050,29,045,"Missouri","Clark County",3,21,70,33,37
050,29,045,"Missouri","Clark County",3,22,66,35,31
050,29,045,"Missouri","Clark County",3,23,66,35,31
050,29,045,"Missouri","Clark County",3,24,74,42,32
050,29,045,"Missouri","Clark County",3,25,67,38,29
050,29,045,"Missouri","Clark County",3,26,74,39,35
050,29,045,"Missouri","Clark County",3,27,72,33,39
050,29,045,"Missouri","Clark County",3,28,79,40,39
050,29,045,"Missouri","Clark County",3,29,75,37,38
050,29,045,"Missouri","Clark County",3,30,71,35,36
050,29,045,"Missouri","Clark County",3,31,70,34,36
050,29,045,"Missouri","Clark County",3,32,71,35,36
050,29,045,"Missouri","Clark County",3,33,72,39,33
050,29,045,"Missouri","Clark County",3,34,70,42,28
050,29,045,"Missouri","Clark County",3,35,72,39,33
050,29,045,"Missouri","Clark County",3,36,67,34,33
050,29,045,"Missouri","Clark County",3,37,74,37,37
050,29,045,"Missouri","Clark County",3,38,71,36,35
050,29,045,"Missouri","Clark County",3,39,75,39,36
050,29,045,"Missouri","Clark County",3,40,76,35,41
050,29,045,"Missouri","Clark County",3,41,78,38,40
050,29,045,"Missouri","Clark County",3,42,74,42,32
050,29,045,"Missouri","Clark County",3,43,79,45,34
050,29,045,"Missouri","Clark County",3,44,81,42,39
050,29,045,"Missouri","Clark County",3,45,81,43,38
050,29,045,"Missouri","Clark County",3,46,83,44,39
050,29,045,"Missouri","Clark County",3,47,69,39,30
050,29,045,"Missouri","Clark County",3,48,73,38,35
050,29,045,"Missouri","Clark County",3,49,80,41,39
050,29,045,"Missouri","Clark County",3,50,83,46,37
050,29,045,"Missouri","Clark County",3,51,69,35,34
050,29,045,"Missouri","Clark County",3,52,75,37,38
050,29,045,"Missouri","Clark County",3,53,98,47,51
050,29,045,"Missouri","Clark County",3,54,86,48,38
050,29,045,"Missouri","Clark County",3,55,91,52,39
050,29,045,"Missouri","Clark County",3,56,102,56,46
050,29,045,"Missouri","Clark County",3,57,111,60,51
050,29,045,"Missouri","Clark County",3,58,105,52,53
050,29,045,"Missouri","Clark County",3,59,104,52,52
050,29,045,"Missouri","Clark County",3,60,121,60,61
050,29,045,"Missouri","Clark County",3,61,105,57,48
050,29,045,"Missouri","Clark County",3,62,99,54,45
050,29,045,"Missouri","Clark County",3,63,98,51,47
050,29,045,"Missouri","Clark County",3,64,97,49,48
050,29,045,"Missouri","Clark County",3,65,96,50,46
050,29,045,"Missouri","Clark County",3,66,92,52,40
050,29,045,"Missouri","Clark County",3,67,93,54,39
050,29,045,"Missouri","Clark County",3,68,89,49,40
050,29,045,"Missouri","Clark County",3,69,88,44,44
050,29,045,"Missouri","Clark County",3,70,77,35,42
050,29,045,"Missouri","Clark County",3,71,76,34,42
050,29,045,"Missouri","Clark County",3,72,76,36,40
050,29,045,"Missouri","Clark County",3,73,70,32,38
050,29,045,"Missouri","Clark County",3,74,75,37,38
050,29,045,"Missouri","Clark County",3,75,55,28,27
050,29,045,"Missouri","Clark County",3,76,57,28,29
050,29,045,"Missouri","Clark County",3,77,49,23,26
050,29,045,"Missouri","Clark County",3,78,46,20,26
050,29,045,"Missouri","Clark County",3,79,44,17,27
050,29,045,"Missouri","Clark County",3,80,44,18,26
050,29,045,"Missouri","Clark County",3,81,36,20,16
050,29,045,"Missouri","Clark County",3,82,29,17,12
050,29,045,"Missouri","Clark County",3,83,29,14,15
050,29,045,"Missouri","Clark County",3,84,36,16,20
050,29,045,"Missouri","Clark County",3,85,161,64,97
050,29,045,"Missouri","Clark County",4,0,73,36,37
050,29,045,"Missouri","Clark County",4,1,73,40,33
050,29,045,"Missouri","Clark County",4,2,82,46,36
050,29,045,"Missouri","Clark County",4,3,71,39,32
050,29,045,"Missouri","Clark County",4,4,80,46,34
050,29,045,"Missouri","Clark County",4,5,96,47,49
050,29,045,"Missouri","Clark County",4,6,86,45,41
050,29,045,"Missouri","Clark County",4,7,92,48,44
050,29,045,"Missouri","Clark County",4,8,81,43,38
050,29,045,"Missouri","Clark County",4,9,88,46,42
050,29,045,"Missouri","Clark County",4,10,77,40,37
050,29,045,"Missouri","Clark County",4,11,86,43,43
050,29,045,"Missouri","Clark County",4,12,87,47,40
050,29,045,"Missouri","Clark County",4,13,104,59,45
050,29,045,"Missouri","Clark County",4,14,100,55,45
050,29,045,"Missouri","Clark County",4,15,101,58,43
050,29,045,"Missouri","Clark County",4,16,104,57,47
050,29,045,"Missouri","Clark County",4,17,90,45,45
050,29,045,"Missouri","Clark County",4,18,69,40,29
050,29,045,"Missouri","Clark County",4,19,52,28,24
050,29,045,"Missouri","Clark County",4,20,51,27,24
050,29,045,"Missouri","Clark County",4,21,58,30,28
050,29,045,"Missouri","Clark County",4,22,68,32,36
050,29,045,"Missouri","Clark County",4,23,58,32,26
050,29,045,"Missouri","Clark County",4,24,67,38,29
050,29,045,"Missouri","Clark County",4,25,78,42,36
050,29,045,"Missouri","Clark County",4,26,66,37,29
050,29,045,"Missouri","Clark County",4,27,75,40,35
050,29,045,"Missouri","Clark County",4,28,77,36,41
050,29,045,"Missouri","Clark County",4,29,80,41,39
050,29,045,"Missouri","Clark County",4,30,76,37,39
050,29,045,"Missouri","Clark County",4,31,73,37,36
050,29,045,"Missouri","Clark County",4,32,72,36,36
050,29,045,"Missouri","Clark County",4,33,73,36,37
050,29,045,"Missouri","Clark County",4,34,75,40,35
050,29,045,"Missouri","Clark County",4,35,72,43,29
050,29,045,"Missouri","Clark County",4,36,74,41,33
050,29,045,"Missouri","Clark County",4,37,68,34,34
050,29,045,"Missouri","Clark County",4,38,76,39,37
050,29,045,"Missouri","Clark County",4,39,65,32,33
050,29,045,"Missouri","Clark County",4,40,76,39,37
050,29,045,"Missouri","Clark County",4,41,73,34,39
050,29,045,"Missouri","Clark County",4,42,79,40,39
050,29,045,"Missouri","Clark County",4,43,79,45,34
050,29,045,"Missouri","Clark County",4,44,81,46,35
050,29,045,"Missouri","Clark County",4,45,80,42,38
050,29,045,"Missouri","Clark County",4,46,84,46,38
050,29,045,"Missouri","Clark County",4,47,82,43,39
050,29,045,"Missouri","Clark County",4,48,67,38,29
050,29,045,"Missouri","Clark County",4,49,70,36,34
050,29,045,"Missouri","Clark County",4,50,80,42,38
050,29,045,"Missouri","Clark County",4,51,80,44,36
050,29,045,"Missouri","Clark County",4,52,69,35,34
050,29,045,"Missouri","Clark County",4,53,77,38,39
050,29,045,"Missouri","Clark County",4,54,96,45,51
050,29,045,"Missouri","Clark County",4,55,89,50,39
050,29,045,"Missouri","Clark County",4,56,96,54,42
050,29,045,"Missouri","Clark County",4,57,103,60,43
050,29,045,"Missouri","Clark County",4,58,106,57,49
050,29,045,"Missouri","Clark County",4,59,103,51,52
050,29,045,"Missouri","Clark County",4,60,105,52,53
050,29,045,"Missouri","Clark County",4,61,119,58,61
050,29,045,"Missouri","Clark County",4,62,102,57,45
050,29,045,"Missouri","Clark County",4,63,96,51,45
050,29,045,"Missouri","Clark County",4,64,100,52,48
050,29,045,"Missouri","Clark County",4,65,97,50,47
050,29,045,"Missouri","Clark County",4,66,95,52,43
050,29,045,"Missouri","Clark County",4,67,92,52,40
050,29,045,"Missouri","Clark County",4,68,89,50,39
050,29,045,"Missouri","Clark County",4,69,86,48,38
050,29,045,"Missouri","Clark County",4,70,82,40,42
050,29,045,"Missouri","Clark County",4,71,78,35,43
050,29,045,"Missouri","Clark County",4,72,71,33,38
050,29,045,"Missouri","Clark County",4,73,72,32,40
050,29,045,"Missouri","Clark County",4,74,66,32,34
050,29,045,"Missouri","Clark County",4,75,69,35,34
050,29,045,"Missouri","Clark County",4,76,54,28,26
050,29,045,"Missouri","Clark County",4,77,51,23,28
050,29,045,"Missouri","Clark County",4,78,46,21,25
050,29,045,"Missouri","Clark County",4,79,44,19,25
050,29,045,"Missouri","Clark County",4,80,42,14,28
050,29,045,"Missouri","Clark County",4,81,38,17,21
050,29,045,"Missouri","Clark County",4,82,29,17,12
050,29,045,"Missouri","Clark County",4,83,26,15,11
050,29,045,"Missouri","Clark County",4,84,35,16,19
050,29,045,"Missouri","Clark County",4,85,167,64,103
050,29,045,"Missouri","Clark County",5,0,81,41,40
050,29,045,"Missouri","Clark County",5,1,65,32,33
050,29,045,"Missouri","Clark County",5,2,68,37,31
050,29,045,"Missouri","Clark County",5,3,85,44,41
050,29,045,"Missouri","Clark County",5,4,73,39,34
050,29,045,"Missouri","Clark County",5,5,86,52,34
050,29,045,"Missouri","Clark County",5,6,93,47,46
050,29,045,"Missouri","Clark County",5,7,84,43,41
050,29,045,"Missouri","Clark County",5,8,95,46,49
050,29,045,"Missouri","Clark County",5,9,81,43,38
050,29,045,"Missouri","Clark County",5,10,90,46,44
050,29,045,"Missouri","Clark County",5,11,75,37,38
050,29,045,"Missouri","Clark County",5,12,82,43,39
050,29,045,"Missouri","Clark County",5,13,86,46,40
050,29,045,"Missouri","Clark County",5,14,103,58,45
050,29,045,"Missouri","Clark County",5,15,96,55,41
050,29,045,"Missouri","Clark County",5,16,103,59,44
050,29,045,"Missouri","Clark County",5,17,99,52,47
050,29,045,"Missouri","Clark County",5,18,71,36,35
050,29,045,"Missouri","Clark County",5,19,49,30,19
050,29,045,"Missouri","Clark County",5,20,60,30,30
050,29,045,"Missouri","Clark County",5,21,51,28,23
050,29,045,"Missouri","Clark County",5,22,64,33,31
050,29,045,"Missouri","Clark County",5,23,65,25,40
050,29,045,"Missouri","Clark County",5,24,58,36,22
050,29,045,"Missouri","Clark County",5,25,62,37,25
050,29,045,"Missouri","Clark County",5,26,82,45,37
050,29,045,"Missouri","Clark County",5,27,70,36,34
050,29,045,"Missouri","Clark County",5,28,71,38,33
050,29,045,"Missouri","Clark County",5,29,73,35,38
050,29,045,"Missouri","Clark County",5,30,82,44,38
050,29,045,"Missouri","Clark County",5,31,74,37,37
050,29,045,"Missouri","Clark County",5,32,69,35,34
050,29,045,"Missouri","Clark County",5,33,72,35,37
050,29,045,"Missouri","Clark County",5,34,72,35,37
050,29,045,"Missouri","Clark County",5,35,72,38,34
050,29,045,"Missouri","Clark County",5,36,66,42,24
050,29,045,"Missouri","Clark County",5,37,77,43,34
050,29,045,"Missouri","Clark County",5,38,68,34,34
050,29,045,"Missouri","Clark County",5,39,72,37,35
050,29,045,"Missouri","Clark County",5,40,67,31,36
050,29,045,"Missouri","Clark County",5,41,75,40,35
050,29,045,"Missouri","Clark County",5,42,70,32,38
050,29,045,"Missouri","Clark County",5,43,81,40,41
050,29,045,"Missouri","Clark County",5,44,80,48,32
050,29,045,"Missouri","Clark County",5,45,81,46,35
050,29,045,"Missouri","Clark County",5,46,81,42,39
050,29,045,"Missouri","Clark County",5,47,83,42,41
050,29,045,"Missouri","Clark County",5,48,80,43,37
050,29,045,"Missouri","Clark County",5,49,66,38,28
050,29,045,"Missouri","Clark County",5,50,67,35,32
050,29,045,"Missouri","Clark County",5,51,83,44,39
050,29,045,"Missouri","Clark County",5,52,88,52,36
050,29,045,"Missouri","Clark County",5,53,65,33,32
050,29,045,"Missouri","Clark County",5,54,72,35,37
050,29,045,"Missouri","Clark County",5,55,98,47,51
050,29,045,"Missouri","Clark County",5,56,91,52,39
050,29,045,"Missouri","Clark County",5,57,96,54,42
050,29,045,"Missouri","Clark County",5,58,97,58,39
050,29,045,"Missouri","Clark County",5,59,110,60,50
050,29,045,"Missouri","Clark County",5,60,104,51,53
050,29,045,"Missouri","Clark County",5,61,103,50,53
050,29,045,"Missouri","Clark County",5,62,113,57,56
050,29,045,"Missouri","Clark County",5,63,103,57,46
050,29,045,"Missouri","Clark County",5,64,99,53,46
050,29,045,"Missouri","Clark County",5,65,98,52,46
050,29,045,"Missouri","Clark County",5,66,94,48,46
050,29,045,"Missouri","Clark County",5,67,93,51,42
050,29,045,"Missouri","Clark County",5,68,89,48,41
050,29,045,"Missouri","Clark County",5,69,84,47,37
050,29,045,"Missouri","Clark County",5,70,77,43,34
050,29,045,"Missouri","Clark County",5,71,85,40,45
050,29,045,"Missouri","Clark County",5,72,72,33,39
050,29,045,"Missouri","Clark County",5,73,67,30,37
050,29,045,"Missouri","Clark County",5,74,68,32,36
050,29,045,"Missouri","Clark County",5,75,63,32,31
050,29,045,"Missouri","Clark County",5,76,67,34,33
050,29,045,"Missouri","Clark County",5,77,52,25,27
050,29,045,"Missouri","Clark County",5,78,49,22,27
050,29,045,"Missouri","Clark County",5,79,44,20,24
050,29,045,"Missouri","Clark County",5,80,43,18,25
050,29,045,"Missouri","Clark County",5,81,36,13,23
050,29,045,"Missouri","Clark County",5,82,31,14,17
050,29,045,"Missouri","Clark County",5,83,25,15,10
050,29,045,"Missouri","Clark County",5,84,31,18,13
050,29,045,"Missouri","Clark County",5,85,175,67,108
050,29,047,"Missouri","Clay County",1,0,3054,1568,1486
050,29,047,"Missouri","Clay County",1,1,3120,1615,1505
050,29,047,"Missouri","Clay County",1,2,3162,1611,1551
050,29,047,"Missouri","Clay County",1,3,3127,1600,1527
050,29,047,"Missouri","Clay County",1,4,3309,1676,1633
050,29,047,"Missouri","Clay County",1,5,3377,1749,1628
050,29,047,"Missouri","Clay County",1,6,3367,1735,1632
050,29,047,"Missouri","Clay County",1,7,3328,1697,1631
050,29,047,"Missouri","Clay County",1,8,3346,1688,1658
050,29,047,"Missouri","Clay County",1,9,3367,1697,1670
050,29,047,"Missouri","Clay County",1,10,3473,1771,1702
050,29,047,"Missouri","Clay County",1,11,3610,1846,1764
050,29,047,"Missouri","Clay County",1,12,3724,1901,1823
050,29,047,"Missouri","Clay County",1,13,3629,1831,1798
050,29,047,"Missouri","Clay County",1,14,3609,1875,1734
050,29,047,"Missouri","Clay County",1,15,3516,1798,1718
050,29,047,"Missouri","Clay County",1,16,3554,1830,1724
050,29,047,"Missouri","Clay County",1,17,3501,1848,1653
050,29,047,"Missouri","Clay County",1,18,2983,1565,1418
050,29,047,"Missouri","Clay County",1,19,2582,1316,1266
050,29,047,"Missouri","Clay County",1,20,2590,1344,1246
050,29,047,"Missouri","Clay County",1,21,2636,1323,1313
050,29,047,"Missouri","Clay County",1,22,2773,1379,1394
050,29,047,"Missouri","Clay County",1,23,2995,1488,1507
050,29,047,"Missouri","Clay County",1,24,3169,1580,1589
050,29,047,"Missouri","Clay County",1,25,3304,1590,1714
050,29,047,"Missouri","Clay County",1,26,3433,1675,1758
050,29,047,"Missouri","Clay County",1,27,3638,1770,1868
050,29,047,"Missouri","Clay County",1,28,3749,1843,1906
050,29,047,"Missouri","Clay County",1,29,3771,1854,1917
050,29,047,"Missouri","Clay County",1,30,3765,1850,1915
050,29,047,"Missouri","Clay County",1,31,3632,1804,1828
050,29,047,"Missouri","Clay County",1,32,3695,1878,1817
050,29,047,"Missouri","Clay County",1,33,3701,1861,1840
050,29,047,"Missouri","Clay County",1,34,3783,1886,1897
050,29,047,"Missouri","Clay County",1,35,3813,1944,1869
050,29,047,"Missouri","Clay County",1,36,3759,1883,1876
050,29,047,"Missouri","Clay County",1,37,3799,1953,1846
050,29,047,"Missouri","Clay County",1,38,3640,1852,1788
050,29,047,"Missouri","Clay County",1,39,3637,1840,1797
050,29,047,"Missouri","Clay County",1,40,3657,1812,1845
050,29,047,"Missouri","Clay County",1,41,3525,1741,1784
050,29,047,"Missouri","Clay County",1,42,3503,1712,1791
050,29,047,"Missouri","Clay County",1,43,3304,1642,1662
050,29,047,"Missouri","Clay County",1,44,3169,1568,1601
050,29,047,"Missouri","Clay County",1,45,3196,1607,1589
050,29,047,"Missouri","Clay County",1,46,3152,1561,1591
050,29,047,"Missouri","Clay County",1,47,3203,1592,1611
050,29,047,"Missouri","Clay County",1,48,3366,1699,1667
050,29,047,"Missouri","Clay County",1,49,3661,1841,1820
050,29,047,"Missouri","Clay County",1,50,3412,1726,1686
050,29,047,"Missouri","Clay County",1,51,3185,1612,1573
050,29,047,"Missouri","Clay County",1,52,3045,1531,1514
050,29,047,"Missouri","Clay County",1,53,3059,1482,1577
050,29,047,"Missouri","Clay County",1,54,3050,1496,1554
050,29,047,"Missouri","Clay County",1,55,3152,1565,1587
050,29,047,"Missouri","Clay County",1,56,3267,1640,1627
050,29,047,"Missouri","Clay County",1,57,3238,1615,1623
050,29,047,"Missouri","Clay County",1,58,3328,1608,1720
050,29,047,"Missouri","Clay County",1,59,3323,1613,1710
050,29,047,"Missouri","Clay County",1,60,3180,1574,1606
050,29,047,"Missouri","Clay County",1,61,3078,1528,1550
050,29,047,"Missouri","Clay County",1,62,3025,1484,1541
050,29,047,"Missouri","Clay County",1,63,2951,1418,1533
050,29,047,"Missouri","Clay County",1,64,2841,1358,1483
050,29,047,"Missouri","Clay County",1,65,2689,1252,1437
050,29,047,"Missouri","Clay County",1,66,2556,1219,1337
050,29,047,"Missouri","Clay County",1,67,2436,1128,1308
050,29,047,"Missouri","Clay County",1,68,2348,1059,1289
050,29,047,"Missouri","Clay County",1,69,2187,1025,1162
050,29,047,"Missouri","Clay County",1,70,2224,1007,1217
050,29,047,"Missouri","Clay County",1,71,2156,1012,1144
050,29,047,"Missouri","Clay County",1,72,2180,1024,1156
050,29,047,"Missouri","Clay County",1,73,2147,997,1150
050,29,047,"Missouri","Clay County",1,74,1421,640,781
050,29,047,"Missouri","Clay County",1,75,1395,637,758
050,29,047,"Missouri","Clay County",1,76,1430,663,767
050,29,047,"Missouri","Clay County",1,77,1390,651,739
050,29,047,"Missouri","Clay County",1,78,1165,517,648
050,29,047,"Missouri","Clay County",1,79,1035,436,599
050,29,047,"Missouri","Clay County",1,80,936,401,535
050,29,047,"Missouri","Clay County",1,81,887,367,520
050,29,047,"Missouri","Clay County",1,82,793,326,467
050,29,047,"Missouri","Clay County",1,83,707,274,433
050,29,047,"Missouri","Clay County",1,84,636,252,384
050,29,047,"Missouri","Clay County",1,85,3721,1312,2409
050,29,047,"Missouri","Clay County",2,0,3042,1530,1512
050,29,047,"Missouri","Clay County",2,1,3112,1603,1509
050,29,047,"Missouri","Clay County",2,2,3165,1616,1549
050,29,047,"Missouri","Clay County",2,3,3136,1607,1529
050,29,047,"Missouri","Clay County",2,4,3283,1665,1618
050,29,047,"Missouri","Clay County",2,5,3364,1730,1634
050,29,047,"Missouri","Clay County",2,6,3373,1741,1632
050,29,047,"Missouri","Clay County",2,7,3345,1712,1633
050,29,047,"Missouri","Clay County",2,8,3341,1688,1653
050,29,047,"Missouri","Clay County",2,9,3358,1697,1661
050,29,047,"Missouri","Clay County",2,10,3457,1760,1697
050,29,047,"Missouri","Clay County",2,11,3572,1831,1741
050,29,047,"Missouri","Clay County",2,12,3716,1900,1816
050,29,047,"Missouri","Clay County",2,13,3650,1850,1800
050,29,047,"Missouri","Clay County",2,14,3617,1864,1753
050,29,047,"Missouri","Clay County",2,15,3544,1823,1721
050,29,047,"Missouri","Clay County",2,16,3559,1833,1726
050,29,047,"Missouri","Clay County",2,17,3524,1852,1672
050,29,047,"Missouri","Clay County",2,18,3003,1587,1416
050,29,047,"Missouri","Clay County",2,19,2610,1336,1274
050,29,047,"Missouri","Clay County",2,20,2653,1368,1285
050,29,047,"Missouri","Clay County",2,21,2649,1332,1317
050,29,047,"Missouri","Clay County",2,22,2804,1389,1415
050,29,047,"Missouri","Clay County",2,23,3001,1494,1507
050,29,047,"Missouri","Clay County",2,24,3168,1578,1590
050,29,047,"Missouri","Clay County",2,25,3305,1605,1700
050,29,047,"Missouri","Clay County",2,26,3440,1675,1765
050,29,047,"Missouri","Clay County",2,27,3607,1764,1843
050,29,047,"Missouri","Clay County",2,28,3746,1841,1905
050,29,047,"Missouri","Clay County",2,29,3787,1856,1931
050,29,047,"Missouri","Clay County",2,30,3801,1868,1933
050,29,047,"Missouri","Clay County",2,31,3681,1829,1852
050,29,047,"Missouri","Clay County",2,32,3688,1869,1819
050,29,047,"Missouri","Clay County",2,33,3705,1873,1832
050,29,047,"Missouri","Clay County",2,34,3771,1886,1885
050,29,047,"Missouri","Clay County",2,35,3834,1939,1895
050,29,047,"Missouri","Clay County",2,36,3755,1886,1869
050,29,047,"Missouri","Clay County",2,37,3801,1941,1860
050,29,047,"Missouri","Clay County",2,38,3702,1887,1815
050,29,047,"Missouri","Clay County",2,39,3640,1845,1795
050,29,047,"Missouri","Clay County",2,40,3677,1830,1847
050,29,047,"Missouri","Clay County",2,41,3556,1757,1799
050,29,047,"Missouri","Clay County",2,42,3487,1709,1778
050,29,047,"Missouri","Clay County",2,43,3370,1669,1701
050,29,047,"Missouri","Clay County",2,44,3177,1575,1602
050,29,047,"Missouri","Clay County",2,45,3210,1607,1603
050,29,047,"Missouri","Clay County",2,46,3160,1571,1589
050,29,047,"Missouri","Clay County",2,47,3183,1583,1600
050,29,047,"Missouri","Clay County",2,48,3314,1669,1645
050,29,047,"Missouri","Clay County",2,49,3603,1812,1791
050,29,047,"Missouri","Clay County",2,50,3476,1754,1722
050,29,047,"Missouri","Clay County",2,51,3229,1632,1597
050,29,047,"Missouri","Clay County",2,52,3074,1546,1528
050,29,047,"Missouri","Clay County",2,53,3052,1492,1560
050,29,047,"Missouri","Clay County",2,54,3039,1486,1553
050,29,047,"Missouri","Clay County",2,55,3137,1553,1584
050,29,047,"Missouri","Clay County",2,56,3245,1629,1616
050,29,047,"Missouri","Clay County",2,57,3249,1621,1628
050,29,047,"Missouri","Clay County",2,58,3302,1607,1695
050,29,047,"Missouri","Clay County",2,59,3331,1613,1718
050,29,047,"Missouri","Clay County",2,60,3206,1579,1627
050,29,047,"Missouri","Clay County",2,61,3095,1536,1559
050,29,047,"Missouri","Clay County",2,62,3027,1488,1539
050,29,047,"Missouri","Clay County",2,63,2989,1445,1544
050,29,047,"Missouri","Clay County",2,64,2844,1357,1487
050,29,047,"Missouri","Clay County",2,65,2717,1277,1440
050,29,047,"Missouri","Clay County",2,66,2595,1230,1365
050,29,047,"Missouri","Clay County",2,67,2461,1146,1315
050,29,047,"Missouri","Clay County",2,68,2346,1066,1280
050,29,047,"Missouri","Clay County",2,69,2237,1038,1199
050,29,047,"Missouri","Clay County",2,70,2195,1003,1192
050,29,047,"Missouri","Clay County",2,71,2157,1005,1152
050,29,047,"Missouri","Clay County",2,72,2137,1007,1130
050,29,047,"Missouri","Clay County",2,73,2252,1049,1203
050,29,047,"Missouri","Clay County",2,74,1489,676,813
050,29,047,"Missouri","Clay County",2,75,1396,632,764
050,29,047,"Missouri","Clay County",2,76,1402,646,756
050,29,047,"Missouri","Clay County",2,77,1420,662,758
050,29,047,"Missouri","Clay County",2,78,1187,535,652
050,29,047,"Missouri","Clay County",2,79,1055,449,606
050,29,047,"Missouri","Clay County",2,80,954,401,553
050,29,047,"Missouri","Clay County",2,81,891,375,516
050,29,047,"Missouri","Clay County",2,82,818,333,485
050,29,047,"Missouri","Clay County",2,83,713,279,434
050,29,047,"Missouri","Clay County",2,84,640,253,387
050,29,047,"Missouri","Clay County",2,85,3734,1323,2411
050,29,047,"Missouri","Clay County",3,0,2954,1526,1428
050,29,047,"Missouri","Clay County",3,1,3059,1565,1494
050,29,047,"Missouri","Clay County",3,2,3136,1627,1509
050,29,047,"Missouri","Clay County",3,3,3211,1649,1562
050,29,047,"Missouri","Clay County",3,4,3134,1581,1553
050,29,047,"Missouri","Clay County",3,5,3290,1643,1647
050,29,047,"Missouri","Clay County",3,6,3390,1774,1616
050,29,047,"Missouri","Clay County",3,7,3388,1741,1647
050,29,047,"Missouri","Clay County",3,8,3364,1715,1649
050,29,047,"Missouri","Clay County",3,9,3343,1723,1620
050,29,047,"Missouri","Clay County",3,10,3388,1722,1666
050,29,047,"Missouri","Clay County",3,11,3488,1778,1710
050,29,047,"Missouri","Clay County",3,12,3606,1846,1760
050,29,047,"Missouri","Clay County",3,13,3725,1899,1826
050,29,047,"Missouri","Clay County",3,14,3687,1871,1816
050,29,047,"Missouri","Clay County",3,15,3711,1927,1784
050,29,047,"Missouri","Clay County",3,16,3550,1841,1709
050,29,047,"Missouri","Clay County",3,17,3570,1844,1726
050,29,047,"Missouri","Clay County",3,18,3079,1668,1411
050,29,047,"Missouri","Clay County",3,19,2610,1375,1235
050,29,047,"Missouri","Clay County",3,20,2743,1399,1344
050,29,047,"Missouri","Clay County",3,21,2665,1341,1324
050,29,047,"Missouri","Clay County",3,22,2813,1369,1444
050,29,047,"Missouri","Clay County",3,23,2952,1454,1498
050,29,047,"Missouri","Clay County",3,24,3127,1554,1573
050,29,047,"Missouri","Clay County",3,25,3326,1645,1681
050,29,047,"Missouri","Clay County",3,26,3464,1701,1763
050,29,047,"Missouri","Clay County",3,27,3548,1715,1833
050,29,047,"Missouri","Clay County",3,28,3649,1793,1856
050,29,047,"Missouri","Clay County",3,29,3872,1903,1969
050,29,047,"Missouri","Clay County",3,30,3854,1924,1930
050,29,047,"Missouri","Clay County",3,31,3872,1916,1956
050,29,047,"Missouri","Clay County",3,32,3783,1903,1880
050,29,047,"Missouri","Clay County",3,33,3701,1890,1811
050,29,047,"Missouri","Clay County",3,34,3720,1872,1848
050,29,047,"Missouri","Clay County",3,35,3778,1889,1889
050,29,047,"Missouri","Clay County",3,36,3867,1942,1925
050,29,047,"Missouri","Clay County",3,37,3764,1901,1863
050,29,047,"Missouri","Clay County",3,38,3878,1974,1904
050,29,047,"Missouri","Clay County",3,39,3726,1918,1808
050,29,047,"Missouri","Clay County",3,40,3657,1838,1819
050,29,047,"Missouri","Clay County",3,41,3645,1805,1840
050,29,047,"Missouri","Clay County",3,42,3537,1762,1775
050,29,047,"Missouri","Clay County",3,43,3512,1706,1806
050,29,047,"Missouri","Clay County",3,44,3359,1664,1695
050,29,047,"Missouri","Clay County",3,45,3159,1575,1584
050,29,047,"Missouri","Clay County",3,46,3213,1602,1611
050,29,047,"Missouri","Clay County",3,47,3154,1563,1591
050,29,047,"Missouri","Clay County",3,48,3151,1566,1585
050,29,047,"Missouri","Clay County",3,49,3319,1645,1674
050,29,047,"Missouri","Clay County",3,50,3579,1817,1762
050,29,047,"Missouri","Clay County",3,51,3462,1742,1720
050,29,047,"Missouri","Clay County",3,52,3216,1659,1557
050,29,047,"Missouri","Clay County",3,53,3065,1541,1524
050,29,047,"Missouri","Clay County",3,54,3035,1491,1544
050,29,047,"Missouri","Clay County",3,55,3053,1488,1565
050,29,047,"Missouri","Clay County",3,56,3073,1523,1550
050,29,047,"Missouri","Clay County",3,57,3202,1608,1594
050,29,047,"Missouri","Clay County",3,58,3164,1565,1599
050,29,047,"Missouri","Clay County",3,59,3269,1582,1687
050,29,047,"Missouri","Clay County",3,60,3300,1595,1705
050,29,047,"Missouri","Clay County",3,61,3130,1534,1596
050,29,047,"Missouri","Clay County",3,62,3032,1509,1523
050,29,047,"Missouri","Clay County",3,63,2960,1453,1507
050,29,047,"Missouri","Clay County",3,64,2935,1403,1532
050,29,047,"Missouri","Clay County",3,65,2812,1338,1474
050,29,047,"Missouri","Clay County",3,66,2673,1251,1422
050,29,047,"Missouri","Clay County",3,67,2543,1203,1340
050,29,047,"Missouri","Clay County",3,68,2383,1109,1274
050,29,047,"Missouri","Clay County",3,69,2317,1051,1266
050,29,047,"Missouri","Clay County",3,70,2184,1001,1183
050,29,047,"Missouri","Clay County",3,71,2157,982,1175
050,29,047,"Missouri","Clay County",3,72,2102,966,1136
050,29,047,"Missouri","Clay County",3,73,2082,981,1101
050,29,047,"Missouri","Clay County",3,74,2184,1009,1175
050,29,047,"Missouri","Clay County",3,75,1455,658,797
050,29,047,"Missouri","Clay County",3,76,1356,602,754
050,29,047,"Missouri","Clay County",3,77,1351,618,733
050,29,047,"Missouri","Clay County",3,78,1349,620,729
050,29,047,"Missouri","Clay County",3,79,1148,518,630
050,29,047,"Missouri","Clay County",3,80,985,401,584
050,29,047,"Missouri","Clay County",3,81,883,382,501
050,29,047,"Missouri","Clay County",3,82,849,354,495
050,29,047,"Missouri","Clay County",3,83,736,306,430
050,29,047,"Missouri","Clay County",3,84,624,232,392
050,29,047,"Missouri","Clay County",3,85,3732,1323,2409
050,29,047,"Missouri","Clay County",4,0,2932,1491,1441
050,29,047,"Missouri","Clay County",4,1,2892,1505,1387
050,29,047,"Missouri","Clay County",4,2,3100,1598,1502
050,29,047,"Missouri","Clay County",4,3,3203,1681,1522
050,29,047,"Missouri","Clay County",4,4,3203,1657,1546
050,29,047,"Missouri","Clay County",4,5,3139,1578,1561
050,29,047,"Missouri","Clay County",4,6,3286,1641,1645
050,29,047,"Missouri","Clay County",4,7,3393,1756,1637
050,29,047,"Missouri","Clay County",4,8,3444,1766,1678
050,29,047,"Missouri","Clay County",4,9,3381,1732,1649
050,29,047,"Missouri","Clay County",4,10,3380,1735,1645
050,29,047,"Missouri","Clay County",4,11,3417,1737,1680
050,29,047,"Missouri","Clay County",4,12,3472,1795,1677
050,29,047,"Missouri","Clay County",4,13,3599,1853,1746
050,29,047,"Missouri","Clay County",4,14,3756,1913,1843
050,29,047,"Missouri","Clay County",4,15,3688,1864,1824
050,29,047,"Missouri","Clay County",4,16,3748,1924,1824
050,29,047,"Missouri","Clay County",4,17,3596,1861,1735
050,29,047,"Missouri","Clay County",4,18,3070,1617,1453
050,29,047,"Missouri","Clay County",4,19,2575,1375,1200
050,29,047,"Missouri","Clay County",4,20,2709,1437,1272
050,29,047,"Missouri","Clay County",4,21,2789,1395,1394
050,29,047,"Missouri","Clay County",4,22,2811,1408,1403
050,29,047,"Missouri","Clay County",4,23,2945,1437,1508
050,29,047,"Missouri","Clay County",4,24,3145,1601,1544
050,29,047,"Missouri","Clay County",4,25,3242,1609,1633
050,29,047,"Missouri","Clay County",4,26,3383,1700,1683
050,29,047,"Missouri","Clay County",4,27,3413,1687,1726
050,29,047,"Missouri","Clay County",4,28,3532,1701,1831
050,29,047,"Missouri","Clay County",4,29,3700,1798,1902
050,29,047,"Missouri","Clay County",4,30,3909,1957,1952
050,29,047,"Missouri","Clay County",4,31,3920,1948,1972
050,29,047,"Missouri","Clay County",4,32,3906,1945,1961
050,29,047,"Missouri","Clay County",4,33,3783,1924,1859
050,29,047,"Missouri","Clay County",4,34,3740,1888,1852
050,29,047,"Missouri","Clay County",4,35,3723,1872,1851
050,29,047,"Missouri","Clay County",4,36,3742,1890,1852
050,29,047,"Missouri","Clay County",4,37,3863,1930,1933
050,29,047,"Missouri","Clay County",4,38,3787,1908,1879
050,29,047,"Missouri","Clay County",4,39,3841,1937,1904
050,29,047,"Missouri","Clay County",4,40,3722,1907,1815
050,29,047,"Missouri","Clay County",4,41,3698,1866,1832
050,29,047,"Missouri","Clay County",4,42,3665,1808,1857
050,29,047,"Missouri","Clay County",4,43,3558,1761,1797
050,29,047,"Missouri","Clay County",4,44,3565,1735,1830
050,29,047,"Missouri","Clay County",4,45,3389,1689,1700
050,29,047,"Missouri","Clay County",4,46,3141,1554,1587
050,29,047,"Missouri","Clay County",4,47,3189,1607,1582
050,29,047,"Missouri","Clay County",4,48,3154,1582,1572
050,29,047,"Missouri","Clay County",4,49,3127,1558,1569
050,29,047,"Missouri","Clay County",4,50,3325,1648,1677
050,29,047,"Missouri","Clay County",4,51,3576,1803,1773
050,29,047,"Missouri","Clay County",4,52,3474,1758,1716
050,29,047,"Missouri","Clay County",4,53,3195,1634,1561
050,29,047,"Missouri","Clay County",4,54,3002,1502,1500
050,29,047,"Missouri","Clay County",4,55,2970,1451,1519
050,29,047,"Missouri","Clay County",4,56,2992,1465,1527
050,29,047,"Missouri","Clay County",4,57,3039,1518,1521
050,29,047,"Missouri","Clay County",4,58,3131,1587,1544
050,29,047,"Missouri","Clay County",4,59,3118,1535,1583
050,29,047,"Missouri","Clay County",4,60,3231,1559,1672
050,29,047,"Missouri","Clay County",4,61,3234,1555,1679
050,29,047,"Missouri","Clay County",4,62,3070,1504,1566
050,29,047,"Missouri","Clay County",4,63,3032,1509,1523
050,29,047,"Missouri","Clay County",4,64,2882,1413,1469
050,29,047,"Missouri","Clay County",4,65,2873,1355,1518
050,29,047,"Missouri","Clay County",4,66,2742,1294,1448
050,29,047,"Missouri","Clay County",4,67,2640,1220,1420
050,29,047,"Missouri","Clay County",4,68,2505,1182,1323
050,29,047,"Missouri","Clay County",4,69,2342,1091,1251
050,29,047,"Missouri","Clay County",4,70,2266,1004,1262
050,29,047,"Missouri","Clay County",4,71,2120,972,1148
050,29,047,"Missouri","Clay County",4,72,2132,956,1176
050,29,047,"Missouri","Clay County",4,73,2038,926,1112
050,29,047,"Missouri","Clay County",4,74,2018,938,1080
050,29,047,"Missouri","Clay County",4,75,2139,996,1143
050,29,047,"Missouri","Clay County",4,76,1421,629,792
050,29,047,"Missouri","Clay County",4,77,1295,565,730
050,29,047,"Missouri","Clay County",4,78,1314,598,716
050,29,047,"Missouri","Clay County",4,79,1294,597,697
050,29,047,"Missouri","Clay County",4,80,1106,480,626
050,29,047,"Missouri","Clay County",4,81,948,377,571
050,29,047,"Missouri","Clay County",4,82,849,363,486
050,29,047,"Missouri","Clay County",4,83,790,331,459
050,29,047,"Missouri","Clay County",4,84,656,268,388
050,29,047,"Missouri","Clay County",4,85,3806,1358,2448
050,29,047,"Missouri","Clay County",5,0,2952,1505,1447
050,29,047,"Missouri","Clay County",5,1,2930,1533,1397
050,29,047,"Missouri","Clay County",5,2,2962,1545,1417
050,29,047,"Missouri","Clay County",5,3,3145,1625,1520
050,29,047,"Missouri","Clay County",5,4,3261,1697,1564
050,29,047,"Missouri","Clay County",5,5,3211,1671,1540
050,29,047,"Missouri","Clay County",5,6,3158,1586,1572
050,29,047,"Missouri","Clay County",5,7,3323,1661,1662
050,29,047,"Missouri","Clay County",5,8,3411,1797,1614
050,29,047,"Missouri","Clay County",5,9,3455,1776,1679
050,29,047,"Missouri","Clay County",5,10,3436,1752,1684
050,29,047,"Missouri","Clay County",5,11,3395,1735,1660
050,29,047,"Missouri","Clay County",5,12,3462,1750,1712
050,29,047,"Missouri","Clay County",5,13,3502,1814,1688
050,29,047,"Missouri","Clay County",5,14,3609,1850,1759
050,29,047,"Missouri","Clay County",5,15,3808,1944,1864
050,29,047,"Missouri","Clay County",5,16,3737,1884,1853
050,29,047,"Missouri","Clay County",5,17,3781,1933,1848
050,29,047,"Missouri","Clay County",5,18,3113,1649,1464
050,29,047,"Missouri","Clay County",5,19,2653,1369,1284
050,29,047,"Missouri","Clay County",5,20,2777,1476,1301
050,29,047,"Missouri","Clay County",5,21,2844,1472,1372
050,29,047,"Missouri","Clay County",5,22,2961,1463,1498
050,29,047,"Missouri","Clay County",5,23,2984,1508,1476
050,29,047,"Missouri","Clay County",5,24,3124,1542,1582
050,29,047,"Missouri","Clay County",5,25,3242,1671,1571
050,29,047,"Missouri","Clay County",5,26,3350,1649,1701
050,29,047,"Missouri","Clay County",5,27,3408,1738,1670
050,29,047,"Missouri","Clay County",5,28,3451,1659,1792
050,29,047,"Missouri","Clay County",5,29,3600,1746,1854
050,29,047,"Missouri","Clay County",5,30,3800,1852,1948
050,29,047,"Missouri","Clay County",5,31,3992,2010,1982
050,29,047,"Missouri","Clay County",5,32,4018,2022,1996
050,29,047,"Missouri","Clay County",5,33,3986,1970,2016
050,29,047,"Missouri","Clay County",5,34,3827,1947,1880
050,29,047,"Missouri","Clay County",5,35,3765,1887,1878
050,29,047,"Missouri","Clay County",5,36,3736,1865,1871
050,29,047,"Missouri","Clay County",5,37,3780,1903,1877
050,29,047,"Missouri","Clay County",5,38,3888,1957,1931
050,29,047,"Missouri","Clay County",5,39,3835,1922,1913
050,29,047,"Missouri","Clay County",5,40,3907,1943,1964
050,29,047,"Missouri","Clay County",5,41,3709,1902,1807
050,29,047,"Missouri","Clay County",5,42,3710,1876,1834
050,29,047,"Missouri","Clay County",5,43,3617,1772,1845
050,29,047,"Missouri","Clay County",5,44,3511,1760,1751
050,29,047,"Missouri","Clay County",5,45,3586,1758,1828
050,29,047,"Missouri","Clay County",5,46,3410,1705,1705
050,29,047,"Missouri","Clay County",5,47,3154,1562,1592
050,29,047,"Missouri","Clay County",5,48,3196,1608,1588
050,29,047,"Missouri","Clay County",5,49,3148,1568,1580
050,29,047,"Missouri","Clay County",5,50,3116,1565,1551
050,29,047,"Missouri","Clay County",5,51,3336,1633,1703
050,29,047,"Missouri","Clay County",5,52,3592,1815,1777
050,29,047,"Missouri","Clay County",5,53,3492,1756,1736
050,29,047,"Missouri","Clay County",5,54,3157,1621,1536
050,29,047,"Missouri","Clay County",5,55,2989,1503,1486
050,29,047,"Missouri","Clay County",5,56,2940,1440,1500
050,29,047,"Missouri","Clay County",5,57,2963,1450,1513
050,29,047,"Missouri","Clay County",5,58,3039,1516,1523
050,29,047,"Missouri","Clay County",5,59,3138,1588,1550
050,29,047,"Missouri","Clay County",5,60,3107,1532,1575
050,29,047,"Missouri","Clay County",5,61,3224,1548,1676
050,29,047,"Missouri","Clay County",5,62,3209,1540,1669
050,29,047,"Missouri","Clay County",5,63,3075,1497,1578
050,29,047,"Missouri","Clay County",5,64,2997,1480,1517
050,29,047,"Missouri","Clay County",5,65,2867,1404,1463
050,29,047,"Missouri","Clay County",5,66,2819,1346,1473
050,29,047,"Missouri","Clay County",5,67,2705,1269,1436
050,29,047,"Missouri","Clay County",5,68,2585,1195,1390
050,29,047,"Missouri","Clay County",5,69,2473,1157,1316
050,29,047,"Missouri","Clay County",5,70,2298,1064,1234
050,29,047,"Missouri","Clay County",5,71,2217,966,1251
050,29,047,"Missouri","Clay County",5,72,2108,962,1146
050,29,047,"Missouri","Clay County",5,73,2086,932,1154
050,29,047,"Missouri","Clay County",5,74,1981,892,1089
050,29,047,"Missouri","Clay County",5,75,1983,926,1057
050,29,047,"Missouri","Clay County",5,76,2080,953,1127
050,29,047,"Missouri","Clay County",5,77,1380,615,765
050,29,047,"Missouri","Clay County",5,78,1274,550,724
050,29,047,"Missouri","Clay County",5,79,1283,582,701
050,29,047,"Missouri","Clay County",5,80,1251,563,688
050,29,047,"Missouri","Clay County",5,81,1067,453,614
050,29,047,"Missouri","Clay County",5,82,914,355,559
050,29,047,"Missouri","Clay County",5,83,787,334,453
050,29,047,"Missouri","Clay County",5,84,719,288,431
050,29,047,"Missouri","Clay County",5,85,3901,1427,2474
050,29,049,"Missouri","Clinton County",1,0,228,114,114
050,29,049,"Missouri","Clinton County",1,1,230,107,123
050,29,049,"Missouri","Clinton County",1,2,246,124,122
050,29,049,"Missouri","Clinton County",1,3,237,112,125
050,29,049,"Missouri","Clinton County",1,4,266,142,124
050,29,049,"Missouri","Clinton County",1,5,258,130,128
050,29,049,"Missouri","Clinton County",1,6,261,131,130
050,29,049,"Missouri","Clinton County",1,7,277,157,120
050,29,049,"Missouri","Clinton County",1,8,246,117,129
050,29,049,"Missouri","Clinton County",1,9,271,137,134
050,29,049,"Missouri","Clinton County",1,10,282,146,136
050,29,049,"Missouri","Clinton County",1,11,284,141,143
050,29,049,"Missouri","Clinton County",1,12,278,133,145
050,29,049,"Missouri","Clinton County",1,13,332,156,176
050,29,049,"Missouri","Clinton County",1,14,331,181,150
050,29,049,"Missouri","Clinton County",1,15,291,158,133
050,29,049,"Missouri","Clinton County",1,16,308,150,158
050,29,049,"Missouri","Clinton County",1,17,304,154,150
050,29,049,"Missouri","Clinton County",1,18,273,156,117
050,29,049,"Missouri","Clinton County",1,19,197,109,88
050,29,049,"Missouri","Clinton County",1,20,208,108,100
050,29,049,"Missouri","Clinton County",1,21,225,118,107
050,29,049,"Missouri","Clinton County",1,22,222,119,103
050,29,049,"Missouri","Clinton County",1,23,208,115,93
050,29,049,"Missouri","Clinton County",1,24,199,101,98
050,29,049,"Missouri","Clinton County",1,25,220,97,123
050,29,049,"Missouri","Clinton County",1,26,220,106,114
050,29,049,"Missouri","Clinton County",1,27,246,123,123
050,29,049,"Missouri","Clinton County",1,28,267,148,119
050,29,049,"Missouri","Clinton County",1,29,250,128,122
050,29,049,"Missouri","Clinton County",1,30,277,147,130
050,29,049,"Missouri","Clinton County",1,31,243,127,116
050,29,049,"Missouri","Clinton County",1,32,247,128,119
050,29,049,"Missouri","Clinton County",1,33,230,128,102
050,29,049,"Missouri","Clinton County",1,34,225,113,112
050,29,049,"Missouri","Clinton County",1,35,256,115,141
050,29,049,"Missouri","Clinton County",1,36,239,112,127
050,29,049,"Missouri","Clinton County",1,37,279,126,153
050,29,049,"Missouri","Clinton County",1,38,260,134,126
050,29,049,"Missouri","Clinton County",1,39,253,120,133
050,29,049,"Missouri","Clinton County",1,40,256,124,132
050,29,049,"Missouri","Clinton County",1,41,252,130,122
050,29,049,"Missouri","Clinton County",1,42,262,143,119
050,29,049,"Missouri","Clinton County",1,43,262,144,118
050,29,049,"Missouri","Clinton County",1,44,240,126,114
050,29,049,"Missouri","Clinton County",1,45,224,118,106
050,29,049,"Missouri","Clinton County",1,46,228,104,124
050,29,049,"Missouri","Clinton County",1,47,244,123,121
050,29,049,"Missouri","Clinton County",1,48,307,153,154
050,29,049,"Missouri","Clinton County",1,49,287,147,140
050,29,049,"Missouri","Clinton County",1,50,272,139,133
050,29,049,"Missouri","Clinton County",1,51,277,142,135
050,29,049,"Missouri","Clinton County",1,52,269,145,124
050,29,049,"Missouri","Clinton County",1,53,266,140,126
050,29,049,"Missouri","Clinton County",1,54,293,154,139
050,29,049,"Missouri","Clinton County",1,55,343,164,179
050,29,049,"Missouri","Clinton County",1,56,305,157,148
050,29,049,"Missouri","Clinton County",1,57,315,154,161
050,29,049,"Missouri","Clinton County",1,58,324,166,158
050,29,049,"Missouri","Clinton County",1,59,344,161,183
050,29,049,"Missouri","Clinton County",1,60,324,161,163
050,29,049,"Missouri","Clinton County",1,61,337,172,165
050,29,049,"Missouri","Clinton County",1,62,330,171,159
050,29,049,"Missouri","Clinton County",1,63,294,169,125
050,29,049,"Missouri","Clinton County",1,64,291,157,134
050,29,049,"Missouri","Clinton County",1,65,281,130,151
050,29,049,"Missouri","Clinton County",1,66,258,124,134
050,29,049,"Missouri","Clinton County",1,67,245,113,132
050,29,049,"Missouri","Clinton County",1,68,218,106,112
050,29,049,"Missouri","Clinton County",1,69,221,110,111
050,29,049,"Missouri","Clinton County",1,70,201,92,109
050,29,049,"Missouri","Clinton County",1,71,210,114,96
050,29,049,"Missouri","Clinton County",1,72,218,118,100
050,29,049,"Missouri","Clinton County",1,73,215,104,111
050,29,049,"Missouri","Clinton County",1,74,149,66,83
050,29,049,"Missouri","Clinton County",1,75,153,69,84
050,29,049,"Missouri","Clinton County",1,76,158,82,76
050,29,049,"Missouri","Clinton County",1,77,135,66,69
050,29,049,"Missouri","Clinton County",1,78,124,60,64
050,29,049,"Missouri","Clinton County",1,79,116,62,54
050,29,049,"Missouri","Clinton County",1,80,104,54,50
050,29,049,"Missouri","Clinton County",1,81,101,48,53
050,29,049,"Missouri","Clinton County",1,82,95,44,51
050,29,049,"Missouri","Clinton County",1,83,88,42,46
050,29,049,"Missouri","Clinton County",1,84,71,30,41
050,29,049,"Missouri","Clinton County",1,85,495,208,287
050,29,049,"Missouri","Clinton County",2,0,239,114,125
050,29,049,"Missouri","Clinton County",2,1,233,110,123
050,29,049,"Missouri","Clinton County",2,2,241,120,121
050,29,049,"Missouri","Clinton County",2,3,244,119,125
050,29,049,"Missouri","Clinton County",2,4,262,137,125
050,29,049,"Missouri","Clinton County",2,5,264,136,128
050,29,049,"Missouri","Clinton County",2,6,266,136,130
050,29,049,"Missouri","Clinton County",2,7,273,149,124
050,29,049,"Missouri","Clinton County",2,8,255,127,128
050,29,049,"Missouri","Clinton County",2,9,266,132,134
050,29,049,"Missouri","Clinton County",2,10,280,144,136
050,29,049,"Missouri","Clinton County",2,11,283,142,141
050,29,049,"Missouri","Clinton County",2,12,279,134,145
050,29,049,"Missouri","Clinton County",2,13,321,153,168
050,29,049,"Missouri","Clinton County",2,14,329,176,153
050,29,049,"Missouri","Clinton County",2,15,300,162,138
050,29,049,"Missouri","Clinton County",2,16,301,150,151
050,29,049,"Missouri","Clinton County",2,17,303,153,150
050,29,049,"Missouri","Clinton County",2,18,264,148,116
050,29,049,"Missouri","Clinton County",2,19,203,112,91
050,29,049,"Missouri","Clinton County",2,20,213,112,101
050,29,049,"Missouri","Clinton County",2,21,225,117,108
050,29,049,"Missouri","Clinton County",2,22,225,121,104
050,29,049,"Missouri","Clinton County",2,23,213,117,96
050,29,049,"Missouri","Clinton County",2,24,204,106,98
050,29,049,"Missouri","Clinton County",2,25,218,100,118
050,29,049,"Missouri","Clinton County",2,26,225,106,119
050,29,049,"Missouri","Clinton County",2,27,241,121,120
050,29,049,"Missouri","Clinton County",2,28,267,144,123
050,29,049,"Missouri","Clinton County",2,29,261,137,124
050,29,049,"Missouri","Clinton County",2,30,276,145,131
050,29,049,"Missouri","Clinton County",2,31,251,132,119
050,29,049,"Missouri","Clinton County",2,32,244,127,117
050,29,049,"Missouri","Clinton County",2,33,236,129,107
050,29,049,"Missouri","Clinton County",2,34,227,117,110
050,29,049,"Missouri","Clinton County",2,35,248,114,134
050,29,049,"Missouri","Clinton County",2,36,242,111,131
050,29,049,"Missouri","Clinton County",2,37,269,124,145
050,29,049,"Missouri","Clinton County",2,38,264,131,133
050,29,049,"Missouri","Clinton County",2,39,254,121,133
050,29,049,"Missouri","Clinton County",2,40,255,124,131
050,29,049,"Missouri","Clinton County",2,41,251,128,123
050,29,049,"Missouri","Clinton County",2,42,255,139,116
050,29,049,"Missouri","Clinton County",2,43,264,146,118
050,29,049,"Missouri","Clinton County",2,44,240,127,113
050,29,049,"Missouri","Clinton County",2,45,231,121,110
050,29,049,"Missouri","Clinton County",2,46,227,109,118
050,29,049,"Missouri","Clinton County",2,47,240,118,122
050,29,049,"Missouri","Clinton County",2,48,290,144,146
050,29,049,"Missouri","Clinton County",2,49,294,150,144
050,29,049,"Missouri","Clinton County",2,50,276,141,135
050,29,049,"Missouri","Clinton County",2,51,277,143,134
050,29,049,"Missouri","Clinton County",2,52,269,143,126
050,29,049,"Missouri","Clinton County",2,53,270,143,127
050,29,049,"Missouri","Clinton County",2,54,289,153,136
050,29,049,"Missouri","Clinton County",2,55,331,162,169
050,29,049,"Missouri","Clinton County",2,56,313,157,156
050,29,049,"Missouri","Clinton County",2,57,310,154,156
050,29,049,"Missouri","Clinton County",2,58,321,162,159
050,29,049,"Missouri","Clinton County",2,59,343,163,180
050,29,049,"Missouri","Clinton County",2,60,326,158,168
050,29,049,"Missouri","Clinton County",2,61,333,169,164
050,29,049,"Missouri","Clinton County",2,62,331,172,159
050,29,049,"Missouri","Clinton County",2,63,306,172,134
050,29,049,"Missouri","Clinton County",2,64,293,161,132
050,29,049,"Missouri","Clinton County",2,65,284,136,148
050,29,049,"Missouri","Clinton County",2,66,266,127,139
050,29,049,"Missouri","Clinton County",2,67,244,113,131
050,29,049,"Missouri","Clinton County",2,68,223,107,116
050,29,049,"Missouri","Clinton County",2,69,223,111,112
050,29,049,"Missouri","Clinton County",2,70,202,94,108
050,29,049,"Missouri","Clinton County",2,71,208,109,99
050,29,049,"Missouri","Clinton County",2,72,207,112,95
050,29,049,"Missouri","Clinton County",2,73,223,113,110
050,29,049,"Missouri","Clinton County",2,74,153,70,83
050,29,049,"Missouri","Clinton County",2,75,150,65,85
050,29,049,"Missouri","Clinton County",2,76,154,77,77
050,29,049,"Missouri","Clinton County",2,77,142,70,72
050,29,049,"Missouri","Clinton County",2,78,125,60,65
050,29,049,"Missouri","Clinton County",2,79,116,61,55
050,29,049,"Missouri","Clinton County",2,80,101,54,47
050,29,049,"Missouri","Clinton County",2,81,100,49,51
050,29,049,"Missouri","Clinton County",2,82,94,43,51
050,29,049,"Missouri","Clinton County",2,83,87,41,46
050,29,049,"Missouri","Clinton County",2,84,74,32,42
050,29,049,"Missouri","Clinton County",2,85,489,206,283
050,29,049,"Missouri","Clinton County",3,0,207,107,100
050,29,049,"Missouri","Clinton County",3,1,236,104,132
050,29,049,"Missouri","Clinton County",3,2,255,130,125
050,29,049,"Missouri","Clinton County",3,3,241,118,123
050,29,049,"Missouri","Clinton County",3,4,262,132,130
050,29,049,"Missouri","Clinton County",3,5,258,137,121
050,29,049,"Missouri","Clinton County",3,6,263,142,121
050,29,049,"Missouri","Clinton County",3,7,266,136,130
050,29,049,"Missouri","Clinton County",3,8,278,148,130
050,29,049,"Missouri","Clinton County",3,9,255,128,127
050,29,049,"Missouri","Clinton County",3,10,265,135,130
050,29,049,"Missouri","Clinton County",3,11,275,139,136
050,29,049,"Missouri","Clinton County",3,12,279,143,136
050,29,049,"Missouri","Clinton County",3,13,276,127,149
050,29,049,"Missouri","Clinton County",3,14,321,154,167
050,29,049,"Missouri","Clinton County",3,15,321,165,156
050,29,049,"Missouri","Clinton County",3,16,308,167,141
050,29,049,"Missouri","Clinton County",3,17,301,151,150
050,29,049,"Missouri","Clinton County",3,18,261,135,126
050,29,049,"Missouri","Clinton County",3,19,186,104,82
050,29,049,"Missouri","Clinton County",3,20,209,113,96
050,29,049,"Missouri","Clinton County",3,21,232,126,106
050,29,049,"Missouri","Clinton County",3,22,239,126,113
050,29,049,"Missouri","Clinton County",3,23,253,127,126
050,29,049,"Missouri","Clinton County",3,24,225,116,109
050,29,049,"Missouri","Clinton County",3,25,222,115,107
050,29,049,"Missouri","Clinton County",3,26,204,92,112
050,29,049,"Missouri","Clinton County",3,27,237,111,126
050,29,049,"Missouri","Clinton County",3,28,248,127,121
050,29,049,"Missouri","Clinton County",3,29,265,146,119
050,29,049,"Missouri","Clinton County",3,30,271,148,123
050,29,049,"Missouri","Clinton County",3,31,289,155,134
050,29,049,"Missouri","Clinton County",3,32,244,132,112
050,29,049,"Missouri","Clinton County",3,33,243,126,117
050,29,049,"Missouri","Clinton County",3,34,243,129,114
050,29,049,"Missouri","Clinton County",3,35,233,118,115
050,29,049,"Missouri","Clinton County",3,36,247,114,133
050,29,049,"Missouri","Clinton County",3,37,252,117,135
050,29,049,"Missouri","Clinton County",3,38,277,133,144
050,29,049,"Missouri","Clinton County",3,39,265,127,138
050,29,049,"Missouri","Clinton County",3,40,249,119,130
050,29,049,"Missouri","Clinton County",3,41,266,132,134
050,29,049,"Missouri","Clinton County",3,42,252,128,124
050,29,049,"Missouri","Clinton County",3,43,260,143,117
050,29,049,"Missouri","Clinton County",3,44,255,137,118
050,29,049,"Missouri","Clinton County",3,45,239,131,108
050,29,049,"Missouri","Clinton County",3,46,226,120,106
050,29,049,"Missouri","Clinton County",3,47,220,106,114
050,29,049,"Missouri","Clinton County",3,48,251,128,123
050,29,049,"Missouri","Clinton County",3,49,279,139,140
050,29,049,"Missouri","Clinton County",3,50,298,147,151
050,29,049,"Missouri","Clinton County",3,51,289,148,141
050,29,049,"Missouri","Clinton County",3,52,283,146,137
050,29,049,"Missouri","Clinton County",3,53,264,138,126
050,29,049,"Missouri","Clinton County",3,54,277,148,129
050,29,049,"Missouri","Clinton County",3,55,293,152,141
050,29,049,"Missouri","Clinton County",3,56,338,172,166
050,29,049,"Missouri","Clinton County",3,57,318,151,167
050,29,049,"Missouri","Clinton County",3,58,307,158,149
050,29,049,"Missouri","Clinton County",3,59,329,165,164
050,29,049,"Missouri","Clinton County",3,60,336,165,171
050,29,049,"Missouri","Clinton County",3,61,331,163,168
050,29,049,"Missouri","Clinton County",3,62,334,173,161
050,29,049,"Missouri","Clinton County",3,63,319,166,153
050,29,049,"Missouri","Clinton County",3,64,307,171,136
050,29,049,"Missouri","Clinton County",3,65,283,154,129
050,29,049,"Missouri","Clinton County",3,66,281,139,142
050,29,049,"Missouri","Clinton County",3,67,251,117,134
050,29,049,"Missouri","Clinton County",3,68,241,114,127
050,29,049,"Missouri","Clinton County",3,69,219,107,112
050,29,049,"Missouri","Clinton County",3,70,206,98,108
050,29,049,"Missouri","Clinton County",3,71,202,97,105
050,29,049,"Missouri","Clinton County",3,72,198,105,93
050,29,049,"Missouri","Clinton County",3,73,194,102,92
050,29,049,"Missouri","Clinton County",3,74,220,112,108
050,29,049,"Missouri","Clinton County",3,75,144,60,84
050,29,049,"Missouri","Clinton County",3,76,140,63,77
050,29,049,"Missouri","Clinton County",3,77,141,74,67
050,29,049,"Missouri","Clinton County",3,78,133,63,70
050,29,049,"Missouri","Clinton County",3,79,116,58,58
050,29,049,"Missouri","Clinton County",3,80,100,51,49
050,29,049,"Missouri","Clinton County",3,81,101,55,46
050,29,049,"Missouri","Clinton County",3,82,97,48,49
050,29,049,"Missouri","Clinton County",3,83,82,34,48
050,29,049,"Missouri","Clinton County",3,84,80,37,43
050,29,049,"Missouri","Clinton County",3,85,452,186,266
050,29,049,"Missouri","Clinton County",4,0,229,114,115
050,29,049,"Missouri","Clinton County",4,1,202,109,93
050,29,049,"Missouri","Clinton County",4,2,247,115,132
050,29,049,"Missouri","Clinton County",4,3,253,122,131
050,29,049,"Missouri","Clinton County",4,4,237,114,123
050,29,049,"Missouri","Clinton County",4,5,278,144,134
050,29,049,"Missouri","Clinton County",4,6,256,135,121
050,29,049,"Missouri","Clinton County",4,7,279,158,121
050,29,049,"Missouri","Clinton County",4,8,274,134,140
050,29,049,"Missouri","Clinton County",4,9,281,151,130
050,29,049,"Missouri","Clinton County",4,10,263,133,130
050,29,049,"Missouri","Clinton County",4,11,273,141,132
050,29,049,"Missouri","Clinton County",4,12,279,141,138
050,29,049,"Missouri","Clinton County",4,13,278,145,133
050,29,049,"Missouri","Clinton County",4,14,288,132,156
050,29,049,"Missouri","Clinton County",4,15,316,148,168
050,29,049,"Missouri","Clinton County",4,16,321,166,155
050,29,049,"Missouri","Clinton County",4,17,303,164,139
050,29,049,"Missouri","Clinton County",4,18,250,126,124
050,29,049,"Missouri","Clinton County",4,19,189,99,90
050,29,049,"Missouri","Clinton County",4,20,190,106,84
050,29,049,"Missouri","Clinton County",4,21,201,111,90
050,29,049,"Missouri","Clinton County",4,22,233,131,102
050,29,049,"Missouri","Clinton County",4,23,245,129,116
050,29,049,"Missouri","Clinton County",4,24,258,130,128
050,29,049,"Missouri","Clinton County",4,25,236,125,111
050,29,049,"Missouri","Clinton County",4,26,230,116,114
050,29,049,"Missouri","Clinton County",4,27,217,102,115
050,29,049,"Missouri","Clinton County",4,28,232,105,127
050,29,049,"Missouri","Clinton County",4,29,245,124,121
050,29,049,"Missouri","Clinton County",4,30,258,144,114
050,29,049,"Missouri","Clinton County",4,31,273,144,129
050,29,049,"Missouri","Clinton County",4,32,296,149,147
050,29,049,"Missouri","Clinton County",4,33,238,123,115
050,29,049,"Missouri","Clinton County",4,34,248,130,118
050,29,049,"Missouri","Clinton County",4,35,254,138,116
050,29,049,"Missouri","Clinton County",4,36,236,124,112
050,29,049,"Missouri","Clinton County",4,37,255,120,135
050,29,049,"Missouri","Clinton County",4,38,247,116,131
050,29,049,"Missouri","Clinton County",4,39,279,134,145
050,29,049,"Missouri","Clinton County",4,40,278,127,151
050,29,049,"Missouri","Clinton County",4,41,252,124,128
050,29,049,"Missouri","Clinton County",4,42,276,136,140
050,29,049,"Missouri","Clinton County",4,43,255,122,133
050,29,049,"Missouri","Clinton County",4,44,262,139,123
050,29,049,"Missouri","Clinton County",4,45,263,141,122
050,29,049,"Missouri","Clinton County",4,46,237,130,107
050,29,049,"Missouri","Clinton County",4,47,229,119,110
050,29,049,"Missouri","Clinton County",4,48,234,116,118
050,29,049,"Missouri","Clinton County",4,49,264,137,127
050,29,049,"Missouri","Clinton County",4,50,282,140,142
050,29,049,"Missouri","Clinton County",4,51,297,148,149
050,29,049,"Missouri","Clinton County",4,52,294,151,143
050,29,049,"Missouri","Clinton County",4,53,289,152,137
050,29,049,"Missouri","Clinton County",4,54,268,142,126
050,29,049,"Missouri","Clinton County",4,55,280,145,135
050,29,049,"Missouri","Clinton County",4,56,288,151,137
050,29,049,"Missouri","Clinton County",4,57,338,171,167
050,29,049,"Missouri","Clinton County",4,58,323,156,167
050,29,049,"Missouri","Clinton County",4,59,318,164,154
050,29,049,"Missouri","Clinton County",4,60,328,169,159
050,29,049,"Missouri","Clinton County",4,61,341,168,173
050,29,049,"Missouri","Clinton County",4,62,322,160,162
050,29,049,"Missouri","Clinton County",4,63,322,167,155
050,29,049,"Missouri","Clinton County",4,64,317,164,153
050,29,049,"Missouri","Clinton County",4,65,307,171,136
050,29,049,"Missouri","Clinton County",4,66,276,151,125
050,29,049,"Missouri","Clinton County",4,67,272,131,141
050,29,049,"Missouri","Clinton County",4,68,240,113,127
050,29,049,"Missouri","Clinton County",4,69,241,115,126
050,29,049,"Missouri","Clinton County",4,70,200,94,106
050,29,049,"Missouri","Clinton County",4,71,201,95,106
050,29,049,"Missouri","Clinton County",4,72,197,96,101
050,29,049,"Missouri","Clinton County",4,73,193,102,91
050,29,049,"Missouri","Clinton County",4,74,190,99,91
050,29,049,"Missouri","Clinton County",4,75,205,102,103
050,29,049,"Missouri","Clinton County",4,76,136,62,74
050,29,049,"Missouri","Clinton County",4,77,130,61,69
050,29,049,"Missouri","Clinton County",4,78,135,68,67
050,29,049,"Missouri","Clinton County",4,79,132,67,65
050,29,049,"Missouri","Clinton County",4,80,99,50,49
050,29,049,"Missouri","Clinton County",4,81,93,49,44
050,29,049,"Missouri","Clinton County",4,82,99,53,46
050,29,049,"Missouri","Clinton County",4,83,88,44,44
050,29,049,"Missouri","Clinton County",4,84,67,25,42
050,29,049,"Missouri","Clinton County",4,85,478,197,281
050,29,049,"Missouri","Clinton County",5,0,230,114,116
050,29,049,"Missouri","Clinton County",5,1,257,131,126
050,29,049,"Missouri","Clinton County",5,2,205,110,95
050,29,049,"Missouri","Clinton County",5,3,249,119,130
050,29,049,"Missouri","Clinton County",5,4,270,131,139
050,29,049,"Missouri","Clinton County",5,5,245,124,121
050,29,049,"Missouri","Clinton County",5,6,271,134,137
050,29,049,"Missouri","Clinton County",5,7,269,139,130
050,29,049,"Missouri","Clinton County",5,8,274,150,124
050,29,049,"Missouri","Clinton County",5,9,283,145,138
050,29,049,"Missouri","Clinton County",5,10,284,156,128
050,29,049,"Missouri","Clinton County",5,11,272,140,132
050,29,049,"Missouri","Clinton County",5,12,277,146,131
050,29,049,"Missouri","Clinton County",5,13,271,139,132
050,29,049,"Missouri","Clinton County",5,14,296,156,140
050,29,049,"Missouri","Clinton County",5,15,286,131,155
050,29,049,"Missouri","Clinton County",5,16,342,159,183
050,29,049,"Missouri","Clinton County",5,17,324,167,157
050,29,049,"Missouri","Clinton County",5,18,262,140,122
050,29,049,"Missouri","Clinton County",5,19,197,95,102
050,29,049,"Missouri","Clinton County",5,20,202,103,99
050,29,049,"Missouri","Clinton County",5,21,189,109,80
050,29,049,"Missouri","Clinton County",5,22,218,121,97
050,29,049,"Missouri","Clinton County",5,23,234,130,104
050,29,049,"Missouri","Clinton County",5,24,238,116,122
050,29,049,"Missouri","Clinton County",5,25,260,122,138
050,29,049,"Missouri","Clinton County",5,26,244,128,116
050,29,049,"Missouri","Clinton County",5,27,226,118,108
050,29,049,"Missouri","Clinton County",5,28,234,106,128
050,29,049,"Missouri","Clinton County",5,29,241,111,130
050,29,049,"Missouri","Clinton County",5,30,240,124,116
050,29,049,"Missouri","Clinton County",5,31,271,155,116
050,29,049,"Missouri","Clinton County",5,32,284,150,134
050,29,049,"Missouri","Clinton County",5,33,292,151,141
050,29,049,"Missouri","Clinton County",5,34,238,120,118
050,29,049,"Missouri","Clinton County",5,35,271,141,130
050,29,049,"Missouri","Clinton County",5,36,259,143,116
050,29,049,"Missouri","Clinton County",5,37,235,125,110
050,29,049,"Missouri","Clinton County",5,38,262,125,137
050,29,049,"Missouri","Clinton County",5,39,257,123,134
050,29,049,"Missouri","Clinton County",5,40,287,138,149
050,29,049,"Missouri","Clinton County",5,41,276,128,148
050,29,049,"Missouri","Clinton County",5,42,255,126,129
050,29,049,"Missouri","Clinton County",5,43,274,140,134
050,29,049,"Missouri","Clinton County",5,44,254,119,135
050,29,049,"Missouri","Clinton County",5,45,263,136,127
050,29,049,"Missouri","Clinton County",5,46,271,144,127
050,29,049,"Missouri","Clinton County",5,47,246,136,110
050,29,049,"Missouri","Clinton County",5,48,223,116,107
050,29,049,"Missouri","Clinton County",5,49,245,122,123
050,29,049,"Missouri","Clinton County",5,50,255,135,120
050,29,049,"Missouri","Clinton County",5,51,281,143,138
050,29,049,"Missouri","Clinton County",5,52,296,146,150
050,29,049,"Missouri","Clinton County",5,53,293,148,145
050,29,049,"Missouri","Clinton County",5,54,298,153,145
050,29,049,"Missouri","Clinton County",5,55,260,133,127
050,29,049,"Missouri","Clinton County",5,56,280,149,131
050,29,049,"Missouri","Clinton County",5,57,288,147,141
050,29,049,"Missouri","Clinton County",5,58,341,179,162
050,29,049,"Missouri","Clinton County",5,59,324,158,166
050,29,049,"Missouri","Clinton County",5,60,309,157,152
050,29,049,"Missouri","Clinton County",5,61,333,173,160
050,29,049,"Missouri","Clinton County",5,62,329,164,165
050,29,049,"Missouri","Clinton County",5,63,311,151,160
050,29,049,"Missouri","Clinton County",5,64,335,179,156
050,29,049,"Missouri","Clinton County",5,65,314,155,159
050,29,049,"Missouri","Clinton County",5,66,312,174,138
050,29,049,"Missouri","Clinton County",5,67,274,148,126
050,29,049,"Missouri","Clinton County",5,68,262,127,135
050,29,049,"Missouri","Clinton County",5,69,238,112,126
050,29,049,"Missouri","Clinton County",5,70,232,108,124
050,29,049,"Missouri","Clinton County",5,71,195,92,103
050,29,049,"Missouri","Clinton County",5,72,189,86,103
050,29,049,"Missouri","Clinton County",5,73,201,97,104
050,29,049,"Missouri","Clinton County",5,74,196,104,92
050,29,049,"Missouri","Clinton County",5,75,183,90,93
050,29,049,"Missouri","Clinton County",5,76,194,102,92
050,29,049,"Missouri","Clinton County",5,77,134,64,70
050,29,049,"Missouri","Clinton County",5,78,125,53,72
050,29,049,"Missouri","Clinton County",5,79,128,69,59
050,29,049,"Missouri","Clinton County",5,80,116,59,57
050,29,049,"Missouri","Clinton County",5,81,96,51,45
050,29,049,"Missouri","Clinton County",5,82,95,49,46
050,29,049,"Missouri","Clinton County",5,83,94,48,46
050,29,049,"Missouri","Clinton County",5,84,79,38,41
050,29,049,"Missouri","Clinton County",5,85,505,205,300
050,29,051,"Missouri","Cole County",1,0,856,440,416
050,29,051,"Missouri","Cole County",1,1,887,460,427
050,29,051,"Missouri","Cole County",1,2,859,454,405
050,29,051,"Missouri","Cole County",1,3,890,481,409
050,29,051,"Missouri","Cole County",1,4,942,493,449
050,29,051,"Missouri","Cole County",1,5,975,523,452
050,29,051,"Missouri","Cole County",1,6,933,455,478
050,29,051,"Missouri","Cole County",1,7,956,479,477
050,29,051,"Missouri","Cole County",1,8,937,471,466
050,29,051,"Missouri","Cole County",1,9,938,474,464
050,29,051,"Missouri","Cole County",1,10,982,488,494
050,29,051,"Missouri","Cole County",1,11,1018,510,508
050,29,051,"Missouri","Cole County",1,12,1053,540,513
050,29,051,"Missouri","Cole County",1,13,1069,543,526
050,29,051,"Missouri","Cole County",1,14,1041,534,507
050,29,051,"Missouri","Cole County",1,15,1035,517,518
050,29,051,"Missouri","Cole County",1,16,1050,531,519
050,29,051,"Missouri","Cole County",1,17,995,514,481
050,29,051,"Missouri","Cole County",1,18,984,514,470
050,29,051,"Missouri","Cole County",1,19,939,496,443
050,29,051,"Missouri","Cole County",1,20,897,475,422
050,29,051,"Missouri","Cole County",1,21,871,437,434
050,29,051,"Missouri","Cole County",1,22,909,452,457
050,29,051,"Missouri","Cole County",1,23,951,493,458
050,29,051,"Missouri","Cole County",1,24,965,513,452
050,29,051,"Missouri","Cole County",1,25,975,533,442
050,29,051,"Missouri","Cole County",1,26,958,504,454
050,29,051,"Missouri","Cole County",1,27,974,523,451
050,29,051,"Missouri","Cole County",1,28,1069,587,482
050,29,051,"Missouri","Cole County",1,29,1069,575,494
050,29,051,"Missouri","Cole County",1,30,1059,574,485
050,29,051,"Missouri","Cole County",1,31,994,526,468
050,29,051,"Missouri","Cole County",1,32,1014,542,472
050,29,051,"Missouri","Cole County",1,33,1038,573,465
050,29,051,"Missouri","Cole County",1,34,1077,582,495
050,29,051,"Missouri","Cole County",1,35,1065,573,492
050,29,051,"Missouri","Cole County",1,36,1045,572,473
050,29,051,"Missouri","Cole County",1,37,1045,568,477
050,29,051,"Missouri","Cole County",1,38,1050,586,464
050,29,051,"Missouri","Cole County",1,39,1054,581,473
050,29,051,"Missouri","Cole County",1,40,1042,546,496
050,29,051,"Missouri","Cole County",1,41,1013,576,437
050,29,051,"Missouri","Cole County",1,42,974,543,431
050,29,051,"Missouri","Cole County",1,43,914,490,424
050,29,051,"Missouri","Cole County",1,44,912,493,419
050,29,051,"Missouri","Cole County",1,45,920,512,408
050,29,051,"Missouri","Cole County",1,46,902,494,408
050,29,051,"Missouri","Cole County",1,47,938,492,446
050,29,051,"Missouri","Cole County",1,48,992,538,454
050,29,051,"Missouri","Cole County",1,49,1045,556,489
050,29,051,"Missouri","Cole County",1,50,995,525,470
050,29,051,"Missouri","Cole County",1,51,985,513,472
050,29,051,"Missouri","Cole County",1,52,995,541,454
050,29,051,"Missouri","Cole County",1,53,993,512,481
050,29,051,"Missouri","Cole County",1,54,964,488,476
050,29,051,"Missouri","Cole County",1,55,1021,536,485
050,29,051,"Missouri","Cole County",1,56,1043,529,514
050,29,051,"Missouri","Cole County",1,57,1042,517,525
050,29,051,"Missouri","Cole County",1,58,1076,525,551
050,29,051,"Missouri","Cole County",1,59,1029,513,516
050,29,051,"Missouri","Cole County",1,60,987,471,516
050,29,051,"Missouri","Cole County",1,61,997,472,525
050,29,051,"Missouri","Cole County",1,62,987,458,529
050,29,051,"Missouri","Cole County",1,63,982,466,516
050,29,051,"Missouri","Cole County",1,64,949,465,484
050,29,051,"Missouri","Cole County",1,65,901,453,448
050,29,051,"Missouri","Cole County",1,66,952,493,459
050,29,051,"Missouri","Cole County",1,67,904,438,466
050,29,051,"Missouri","Cole County",1,68,895,424,471
050,29,051,"Missouri","Cole County",1,69,782,341,441
050,29,051,"Missouri","Cole County",1,70,767,351,416
050,29,051,"Missouri","Cole County",1,71,727,346,381
050,29,051,"Missouri","Cole County",1,72,783,355,428
050,29,051,"Missouri","Cole County",1,73,769,369,400
050,29,051,"Missouri","Cole County",1,74,500,256,244
050,29,051,"Missouri","Cole County",1,75,482,227,255
050,29,051,"Missouri","Cole County",1,76,504,236,268
050,29,051,"Missouri","Cole County",1,77,474,206,268
050,29,051,"Missouri","Cole County",1,78,408,166,242
050,29,051,"Missouri","Cole County",1,79,365,165,200
050,29,051,"Missouri","Cole County",1,80,339,161,178
050,29,051,"Missouri","Cole County",1,81,325,137,188
050,29,051,"Missouri","Cole County",1,82,283,107,176
050,29,051,"Missouri","Cole County",1,83,253,98,155
050,29,051,"Missouri","Cole County",1,84,215,79,136
050,29,051,"Missouri","Cole County",1,85,1537,494,1043
050,29,051,"Missouri","Cole County",2,0,840,431,409
050,29,051,"Missouri","Cole County",2,1,880,457,423
050,29,051,"Missouri","Cole County",2,2,873,460,413
050,29,051,"Missouri","Cole County",2,3,880,471,409
050,29,051,"Missouri","Cole County",2,4,934,495,439
050,29,051,"Missouri","Cole County",2,5,965,515,450
050,29,051,"Missouri","Cole County",2,6,948,475,473
050,29,051,"Missouri","Cole County",2,7,952,474,478
050,29,051,"Missouri","Cole County",2,8,945,475,470
050,29,051,"Missouri","Cole County",2,9,940,473,467
050,29,051,"Missouri","Cole County",2,10,970,484,486
050,29,051,"Missouri","Cole County",2,11,1011,506,505
050,29,051,"Missouri","Cole County",2,12,1054,538,516
050,29,051,"Missouri","Cole County",2,13,1066,547,519
050,29,051,"Missouri","Cole County",2,14,1042,533,509
050,29,051,"Missouri","Cole County",2,15,1034,520,514
050,29,051,"Missouri","Cole County",2,16,1049,527,522
050,29,051,"Missouri","Cole County",2,17,1010,517,493
050,29,051,"Missouri","Cole County",2,18,985,514,471
050,29,051,"Missouri","Cole County",2,19,942,499,443
050,29,051,"Missouri","Cole County",2,20,899,470,429
050,29,051,"Missouri","Cole County",2,21,864,435,429
050,29,051,"Missouri","Cole County",2,22,900,443,457
050,29,051,"Missouri","Cole County",2,23,931,474,457
050,29,051,"Missouri","Cole County",2,24,942,494,448
050,29,051,"Missouri","Cole County",2,25,959,516,443
050,29,051,"Missouri","Cole County",2,26,937,487,450
050,29,051,"Missouri","Cole County",2,27,953,500,453
050,29,051,"Missouri","Cole County",2,28,1026,551,475
050,29,051,"Missouri","Cole County",2,29,1050,558,492
050,29,051,"Missouri","Cole County",2,30,1044,552,492
050,29,051,"Missouri","Cole County",2,31,983,510,473
050,29,051,"Missouri","Cole County",2,32,983,514,469
050,29,051,"Missouri","Cole County",2,33,1006,541,465
050,29,051,"Missouri","Cole County",2,34,1047,555,492
050,29,051,"Missouri","Cole County",2,35,1049,554,495
050,29,051,"Missouri","Cole County",2,36,1021,548,473
050,29,051,"Missouri","Cole County",2,37,1024,546,478
050,29,051,"Missouri","Cole County",2,38,1030,562,468
050,29,051,"Missouri","Cole County",2,39,1023,554,469
050,29,051,"Missouri","Cole County",2,40,1023,533,490
050,29,051,"Missouri","Cole County",2,41,992,545,447
050,29,051,"Missouri","Cole County",2,42,956,528,428
050,29,051,"Missouri","Cole County",2,43,913,485,428
050,29,051,"Missouri","Cole County",2,44,893,476,417
050,29,051,"Missouri","Cole County",2,45,901,487,414
050,29,051,"Missouri","Cole County",2,46,886,477,409
050,29,051,"Missouri","Cole County",2,47,906,472,434
050,29,051,"Missouri","Cole County",2,48,965,509,456
050,29,051,"Missouri","Cole County",2,49,1021,535,486
050,29,051,"Missouri","Cole County",2,50,995,518,477
050,29,051,"Missouri","Cole County",2,51,965,494,471
050,29,051,"Missouri","Cole County",2,52,976,517,459
050,29,051,"Missouri","Cole County",2,53,976,503,473
050,29,051,"Missouri","Cole County",2,54,954,480,474
050,29,051,"Missouri","Cole County",2,55,993,511,482
050,29,051,"Missouri","Cole County",2,56,1031,522,509
050,29,051,"Missouri","Cole County",2,57,1040,517,523
050,29,051,"Missouri","Cole County",2,58,1053,512,541
050,29,051,"Missouri","Cole County",2,59,1034,508,526
050,29,051,"Missouri","Cole County",2,60,985,474,511
050,29,051,"Missouri","Cole County",2,61,986,464,522
050,29,051,"Missouri","Cole County",2,62,986,461,525
050,29,051,"Missouri","Cole County",2,63,985,463,522
050,29,051,"Missouri","Cole County",2,64,944,458,486
050,29,051,"Missouri","Cole County",2,65,906,452,454
050,29,051,"Missouri","Cole County",2,66,932,477,455
050,29,051,"Missouri","Cole County",2,67,907,446,461
050,29,051,"Missouri","Cole County",2,68,890,421,469
050,29,051,"Missouri","Cole County",2,69,809,360,449
050,29,051,"Missouri","Cole County",2,70,766,347,419
050,29,051,"Missouri","Cole County",2,71,732,343,389
050,29,051,"Missouri","Cole County",2,72,756,345,411
050,29,051,"Missouri","Cole County",2,73,807,385,422
050,29,051,"Missouri","Cole County",2,74,529,264,265
050,29,051,"Missouri","Cole County",2,75,488,234,254
050,29,051,"Missouri","Cole County",2,76,489,228,261
050,29,051,"Missouri","Cole County",2,77,490,215,275
050,29,051,"Missouri","Cole County",2,78,413,169,244
050,29,051,"Missouri","Cole County",2,79,373,166,207
050,29,051,"Missouri","Cole County",2,80,345,162,183
050,29,051,"Missouri","Cole County",2,81,325,142,183
050,29,051,"Missouri","Cole County",2,82,296,112,184
050,29,051,"Missouri","Cole County",2,83,255,99,156
050,29,051,"Missouri","Cole County",2,84,221,80,141
050,29,051,"Missouri","Cole County",2,85,1542,495,1047
050,29,051,"Missouri","Cole County",3,0,813,449,364
050,29,051,"Missouri","Cole County",3,1,822,410,412
050,29,051,"Missouri","Cole County",3,2,869,444,425
050,29,051,"Missouri","Cole County",3,3,869,466,403
050,29,051,"Missouri","Cole County",3,4,875,453,422
050,29,051,"Missouri","Cole County",3,5,929,500,429
050,29,051,"Missouri","Cole County",3,6,963,509,454
050,29,051,"Missouri","Cole County",3,7,931,466,465
050,29,051,"Missouri","Cole County",3,8,943,468,475
050,29,051,"Missouri","Cole County",3,9,943,470,473
050,29,051,"Missouri","Cole County",3,10,950,470,480
050,29,051,"Missouri","Cole County",3,11,949,473,476
050,29,051,"Missouri","Cole County",3,12,996,499,497
050,29,051,"Missouri","Cole County",3,13,1046,534,512
050,29,051,"Missouri","Cole County",3,14,1051,543,508
050,29,051,"Missouri","Cole County",3,15,1042,529,513
050,29,051,"Missouri","Cole County",3,16,1044,522,522
050,29,051,"Missouri","Cole County",3,17,1059,537,522
050,29,051,"Missouri","Cole County",3,18,1009,525,484
050,29,051,"Missouri","Cole County",3,19,948,498,450
050,29,051,"Missouri","Cole County",3,20,889,473,416
050,29,051,"Missouri","Cole County",3,21,883,459,424
050,29,051,"Missouri","Cole County",3,22,892,462,430
050,29,051,"Missouri","Cole County",3,23,951,478,473
050,29,051,"Missouri","Cole County",3,24,945,502,443
050,29,051,"Missouri","Cole County",3,25,978,517,461
050,29,051,"Missouri","Cole County",3,26,981,543,438
050,29,051,"Missouri","Cole County",3,27,961,514,447
050,29,051,"Missouri","Cole County",3,28,985,529,456
050,29,051,"Missouri","Cole County",3,29,1006,544,462
050,29,051,"Missouri","Cole County",3,30,1063,585,478
050,29,051,"Missouri","Cole County",3,31,1023,555,468
050,29,051,"Missouri","Cole County",3,32,987,528,459
050,29,051,"Missouri","Cole County",3,33,979,506,473
050,29,051,"Missouri","Cole County",3,34,1000,528,472
050,29,051,"Missouri","Cole County",3,35,1046,563,483
050,29,051,"Missouri","Cole County",3,36,1048,554,494
050,29,051,"Missouri","Cole County",3,37,1008,544,464
050,29,051,"Missouri","Cole County",3,38,1042,569,473
050,29,051,"Missouri","Cole County",3,39,1013,544,469
050,29,051,"Missouri","Cole County",3,40,1030,546,484
050,29,051,"Missouri","Cole County",3,41,1028,545,483
050,29,051,"Missouri","Cole County",3,42,989,549,440
050,29,051,"Missouri","Cole County",3,43,944,530,414
050,29,051,"Missouri","Cole County",3,44,943,514,429
050,29,051,"Missouri","Cole County",3,45,896,470,426
050,29,051,"Missouri","Cole County",3,46,906,492,414
050,29,051,"Missouri","Cole County",3,47,906,493,413
050,29,051,"Missouri","Cole County",3,48,906,478,428
050,29,051,"Missouri","Cole County",3,49,939,488,451
050,29,051,"Missouri","Cole County",3,50,1038,545,493
050,29,051,"Missouri","Cole County",3,51,971,507,464
050,29,051,"Missouri","Cole County",3,52,968,502,466
050,29,051,"Missouri","Cole County",3,53,952,497,455
050,29,051,"Missouri","Cole County",3,54,964,495,469
050,29,051,"Missouri","Cole County",3,55,933,469,464
050,29,051,"Missouri","Cole County",3,56,973,496,477
050,29,051,"Missouri","Cole County",3,57,1030,525,505
050,29,051,"Missouri","Cole County",3,58,1018,492,526
050,29,051,"Missouri","Cole County",3,59,1032,502,530
050,29,051,"Missouri","Cole County",3,60,1005,484,521
050,29,051,"Missouri","Cole County",3,61,974,467,507
050,29,051,"Missouri","Cole County",3,62,976,464,512
050,29,051,"Missouri","Cole County",3,63,975,455,520
050,29,051,"Missouri","Cole County",3,64,975,463,512
050,29,051,"Missouri","Cole County",3,65,911,437,474
050,29,051,"Missouri","Cole County",3,66,895,440,455
050,29,051,"Missouri","Cole County",3,67,908,459,449
050,29,051,"Missouri","Cole County",3,68,908,442,466
050,29,051,"Missouri","Cole County",3,69,870,409,461
050,29,051,"Missouri","Cole County",3,70,790,353,437
050,29,051,"Missouri","Cole County",3,71,750,329,421
050,29,051,"Missouri","Cole County",3,72,724,333,391
050,29,051,"Missouri","Cole County",3,73,740,329,411
050,29,051,"Missouri","Cole County",3,74,789,373,416
050,29,051,"Missouri","Cole County",3,75,513,256,257
050,29,051,"Missouri","Cole County",3,76,481,229,252
050,29,051,"Missouri","Cole County",3,77,459,218,241
050,29,051,"Missouri","Cole County",3,78,465,194,271
050,29,051,"Missouri","Cole County",3,79,401,165,236
050,29,051,"Missouri","Cole County",3,80,344,146,198
050,29,051,"Missouri","Cole County",3,81,328,152,176
050,29,051,"Missouri","Cole County",3,82,308,127,181
050,29,051,"Missouri","Cole County",3,83,274,113,161
050,29,051,"Missouri","Cole County",3,84,239,86,153
050,29,051,"Missouri","Cole County",3,85,1504,477,1027
050,29,051,"Missouri","Cole County",4,0,807,429,378
050,29,051,"Missouri","Cole County",4,1,839,455,384
050,29,051,"Missouri","Cole County",4,2,849,421,428
050,29,051,"Missouri","Cole County",4,3,886,445,441
050,29,051,"Missouri","Cole County",4,4,884,463,421
050,29,051,"Missouri","Cole County",4,5,891,463,428
050,29,051,"Missouri","Cole County",4,6,924,496,428
050,29,051,"Missouri","Cole County",4,7,960,511,449
050,29,051,"Missouri","Cole County",4,8,943,474,469
050,29,051,"Missouri","Cole County",4,9,953,470,483
050,29,051,"Missouri","Cole County",4,10,948,483,465
050,29,051,"Missouri","Cole County",4,11,945,477,468
050,29,051,"Missouri","Cole County",4,12,924,466,458
050,29,051,"Missouri","Cole County",4,13,1012,514,498
050,29,051,"Missouri","Cole County",4,14,1045,527,518
050,29,051,"Missouri","Cole County",4,15,1068,561,507
050,29,051,"Missouri","Cole County",4,16,1036,529,507
050,29,051,"Missouri","Cole County",4,17,1059,533,526
050,29,051,"Missouri","Cole County",4,18,1044,540,504
050,29,051,"Missouri","Cole County",4,19,940,503,437
050,29,051,"Missouri","Cole County",4,20,918,490,428
050,29,051,"Missouri","Cole County",4,21,858,456,402
050,29,051,"Missouri","Cole County",4,22,928,477,451
050,29,051,"Missouri","Cole County",4,23,950,498,452
050,29,051,"Missouri","Cole County",4,24,972,492,480
050,29,051,"Missouri","Cole County",4,25,973,507,466
050,29,051,"Missouri","Cole County",4,26,1009,536,473
050,29,051,"Missouri","Cole County",4,27,996,556,440
050,29,051,"Missouri","Cole County",4,28,975,527,448
050,29,051,"Missouri","Cole County",4,29,952,508,444
050,29,051,"Missouri","Cole County",4,30,1021,564,457
050,29,051,"Missouri","Cole County",4,31,1044,564,480
050,29,051,"Missouri","Cole County",4,32,1010,545,465
050,29,051,"Missouri","Cole County",4,33,1006,538,468
050,29,051,"Missouri","Cole County",4,34,961,499,462
050,29,051,"Missouri","Cole County",4,35,1023,538,485
050,29,051,"Missouri","Cole County",4,36,1038,561,477
050,29,051,"Missouri","Cole County",4,37,1052,556,496
050,29,051,"Missouri","Cole County",4,38,1032,560,472
050,29,051,"Missouri","Cole County",4,39,1044,557,487
050,29,051,"Missouri","Cole County",4,40,1006,533,473
050,29,051,"Missouri","Cole County",4,41,1039,561,478
050,29,051,"Missouri","Cole County",4,42,1036,550,486
050,29,051,"Missouri","Cole County",4,43,994,546,448
050,29,051,"Missouri","Cole County",4,44,959,548,411
050,29,051,"Missouri","Cole County",4,45,933,500,433
050,29,051,"Missouri","Cole County",4,46,918,482,436
050,29,051,"Missouri","Cole County",4,47,905,490,415
050,29,051,"Missouri","Cole County",4,48,927,516,411
050,29,051,"Missouri","Cole County",4,49,881,455,426
050,29,051,"Missouri","Cole County",4,50,944,499,445
050,29,051,"Missouri","Cole County",4,51,999,506,493
050,29,051,"Missouri","Cole County",4,52,963,498,465
050,29,051,"Missouri","Cole County",4,53,980,498,482
050,29,051,"Missouri","Cole County",4,54,947,495,452
050,29,051,"Missouri","Cole County",4,55,936,479,457
050,29,051,"Missouri","Cole County",4,56,916,452,464
050,29,051,"Missouri","Cole County",4,57,977,506,471
050,29,051,"Missouri","Cole County",4,58,1033,525,508
050,29,051,"Missouri","Cole County",4,59,1007,491,516
050,29,051,"Missouri","Cole County",4,60,1007,484,523
050,29,051,"Missouri","Cole County",4,61,1002,480,522
050,29,051,"Missouri","Cole County",4,62,954,456,498
050,29,051,"Missouri","Cole County",4,63,973,468,505
050,29,051,"Missouri","Cole County",4,64,978,464,514
050,29,051,"Missouri","Cole County",4,65,948,440,508
050,29,051,"Missouri","Cole County",4,66,890,428,462
050,29,051,"Missouri","Cole County",4,67,886,428,458
050,29,051,"Missouri","Cole County",4,68,906,456,450
050,29,051,"Missouri","Cole County",4,69,894,434,460
050,29,051,"Missouri","Cole County",4,70,857,399,458
050,29,051,"Missouri","Cole County",4,71,788,348,440
050,29,051,"Missouri","Cole County",4,72,745,323,422
050,29,051,"Missouri","Cole County",4,73,716,335,381
050,29,051,"Missouri","Cole County",4,74,725,320,405
050,29,051,"Missouri","Cole County",4,75,764,353,411
050,29,051,"Missouri","Cole County",4,76,498,248,250
050,29,051,"Missouri","Cole County",4,77,465,223,242
050,29,051,"Missouri","Cole County",4,78,437,204,233
050,29,051,"Missouri","Cole County",4,79,443,191,252
050,29,051,"Missouri","Cole County",4,80,367,144,223
050,29,051,"Missouri","Cole County",4,81,325,131,194
050,29,051,"Missouri","Cole County",4,82,321,142,179
050,29,051,"Missouri","Cole County",4,83,287,124,163
050,29,051,"Missouri","Cole County",4,84,253,94,159
050,29,051,"Missouri","Cole County",4,85,1508,465,1043
050,29,051,"Missouri","Cole County",5,0,805,430,375
050,29,051,"Missouri","Cole County",5,1,828,437,391
050,29,051,"Missouri","Cole County",5,2,847,463,384
050,29,051,"Missouri","Cole County",5,3,854,440,414
050,29,051,"Missouri","Cole County",5,4,882,450,432
050,29,051,"Missouri","Cole County",5,5,878,463,415
050,29,051,"Missouri","Cole County",5,6,862,451,411
050,29,051,"Missouri","Cole County",5,7,929,488,441
050,29,051,"Missouri","Cole County",5,8,986,519,467
050,29,051,"Missouri","Cole County",5,9,944,470,474
050,29,051,"Missouri","Cole County",5,10,972,471,501
050,29,051,"Missouri","Cole County",5,11,952,486,466
050,29,051,"Missouri","Cole County",5,12,964,485,479
050,29,051,"Missouri","Cole County",5,13,957,485,472
050,29,051,"Missouri","Cole County",5,14,1024,518,506
050,29,051,"Missouri","Cole County",5,15,1067,535,532
050,29,051,"Missouri","Cole County",5,16,1068,555,513
050,29,051,"Missouri","Cole County",5,17,1053,532,521
050,29,051,"Missouri","Cole County",5,18,1053,536,517
050,29,051,"Missouri","Cole County",5,19,994,527,467
050,29,051,"Missouri","Cole County",5,20,886,472,414
050,29,051,"Missouri","Cole County",5,21,907,477,430
050,29,051,"Missouri","Cole County",5,22,940,492,448
050,29,051,"Missouri","Cole County",5,23,950,495,455
050,29,051,"Missouri","Cole County",5,24,973,522,451
050,29,051,"Missouri","Cole County",5,25,980,521,459
050,29,051,"Missouri","Cole County",5,26,976,524,452
050,29,051,"Missouri","Cole County",5,27,1005,535,470
050,29,051,"Missouri","Cole County",5,28,988,553,435
050,29,051,"Missouri","Cole County",5,29,990,530,460
050,29,051,"Missouri","Cole County",5,30,945,508,437
050,29,051,"Missouri","Cole County",5,31,1021,555,466
050,29,051,"Missouri","Cole County",5,32,1047,557,490
050,29,051,"Missouri","Cole County",5,33,1000,543,457
050,29,051,"Missouri","Cole County",5,34,974,522,452
050,29,051,"Missouri","Cole County",5,35,989,503,486
050,29,051,"Missouri","Cole County",5,36,1028,547,481
050,29,051,"Missouri","Cole County",5,37,1025,558,467
050,29,051,"Missouri","Cole County",5,38,1062,579,483
050,29,051,"Missouri","Cole County",5,39,1019,544,475
050,29,051,"Missouri","Cole County",5,40,1018,537,481
050,29,051,"Missouri","Cole County",5,41,1011,536,475
050,29,051,"Missouri","Cole County",5,42,1040,550,490
050,29,051,"Missouri","Cole County",5,43,1036,547,489
050,29,051,"Missouri","Cole County",5,44,1011,566,445
050,29,051,"Missouri","Cole County",5,45,929,520,409
050,29,051,"Missouri","Cole County",5,46,938,508,430
050,29,051,"Missouri","Cole County",5,47,936,497,439
050,29,051,"Missouri","Cole County",5,48,939,506,433
050,29,051,"Missouri","Cole County",5,49,909,500,409
050,29,051,"Missouri","Cole County",5,50,884,452,432
050,29,051,"Missouri","Cole County",5,51,937,490,447
050,29,051,"Missouri","Cole County",5,52,1010,518,492
050,29,051,"Missouri","Cole County",5,53,969,497,472
050,29,051,"Missouri","Cole County",5,54,973,500,473
050,29,051,"Missouri","Cole County",5,55,926,481,445
050,29,051,"Missouri","Cole County",5,56,912,459,453
050,29,051,"Missouri","Cole County",5,57,920,456,464
050,29,051,"Missouri","Cole County",5,58,953,488,465
050,29,051,"Missouri","Cole County",5,59,1040,534,506
050,29,051,"Missouri","Cole County",5,60,975,473,502
050,29,051,"Missouri","Cole County",5,61,994,479,515
050,29,051,"Missouri","Cole County",5,62,995,483,512
050,29,051,"Missouri","Cole County",5,63,957,456,501
050,29,051,"Missouri","Cole County",5,64,973,471,502
050,29,051,"Missouri","Cole County",5,65,967,455,512
050,29,051,"Missouri","Cole County",5,66,929,434,495
050,29,051,"Missouri","Cole County",5,67,864,407,457
050,29,051,"Missouri","Cole County",5,68,884,426,458
050,29,051,"Missouri","Cole County",5,69,886,443,443
050,29,051,"Missouri","Cole County",5,70,881,429,452
050,29,051,"Missouri","Cole County",5,71,846,395,451
050,29,051,"Missouri","Cole County",5,72,766,329,437
050,29,051,"Missouri","Cole County",5,73,742,323,419
050,29,051,"Missouri","Cole County",5,74,712,334,378
050,29,051,"Missouri","Cole County",5,75,705,301,404
050,29,051,"Missouri","Cole County",5,76,743,345,398
050,29,051,"Missouri","Cole County",5,77,479,237,242
050,29,051,"Missouri","Cole County",5,78,448,208,240
050,29,051,"Missouri","Cole County",5,79,424,201,223
050,29,051,"Missouri","Cole County",5,80,415,173,242
050,29,051,"Missouri","Cole County",5,81,355,129,226
050,29,051,"Missouri","Cole County",5,82,320,125,195
050,29,051,"Missouri","Cole County",5,83,296,138,158
050,29,051,"Missouri","Cole County",5,84,262,105,157
050,29,051,"Missouri","Cole County",5,85,1545,469,1076
050,29,053,"Missouri","Cooper County",1,0,197,100,97
050,29,053,"Missouri","Cooper County",1,1,200,89,111
050,29,053,"Missouri","Cooper County",1,2,209,95,114
050,29,053,"Missouri","Cooper County",1,3,188,102,86
050,29,053,"Missouri","Cooper County",1,4,191,97,94
050,29,053,"Missouri","Cooper County",1,5,205,106,99
050,29,053,"Missouri","Cooper County",1,6,206,113,93
050,29,053,"Missouri","Cooper County",1,7,174,86,88
050,29,053,"Missouri","Cooper County",1,8,201,107,94
050,29,053,"Missouri","Cooper County",1,9,212,109,103
050,29,053,"Missouri","Cooper County",1,10,204,108,96
050,29,053,"Missouri","Cooper County",1,11,229,111,118
050,29,053,"Missouri","Cooper County",1,12,227,108,119
050,29,053,"Missouri","Cooper County",1,13,223,104,119
050,29,053,"Missouri","Cooper County",1,14,226,118,108
050,29,053,"Missouri","Cooper County",1,15,206,101,105
050,29,053,"Missouri","Cooper County",1,16,224,110,114
050,29,053,"Missouri","Cooper County",1,17,223,127,96
050,29,053,"Missouri","Cooper County",1,18,209,126,83
050,29,053,"Missouri","Cooper County",1,19,198,121,77
050,29,053,"Missouri","Cooper County",1,20,227,136,91
050,29,053,"Missouri","Cooper County",1,21,214,133,81
050,29,053,"Missouri","Cooper County",1,22,260,163,97
050,29,053,"Missouri","Cooper County",1,23,259,161,98
050,29,053,"Missouri","Cooper County",1,24,225,147,78
050,29,053,"Missouri","Cooper County",1,25,232,139,93
050,29,053,"Missouri","Cooper County",1,26,237,143,94
050,29,053,"Missouri","Cooper County",1,27,226,132,94
050,29,053,"Missouri","Cooper County",1,28,240,149,91
050,29,053,"Missouri","Cooper County",1,29,236,149,87
050,29,053,"Missouri","Cooper County",1,30,227,127,100
050,29,053,"Missouri","Cooper County",1,31,194,108,86
050,29,053,"Missouri","Cooper County",1,32,204,123,81
050,29,053,"Missouri","Cooper County",1,33,190,102,88
050,29,053,"Missouri","Cooper County",1,34,201,106,95
050,29,053,"Missouri","Cooper County",1,35,198,104,94
050,29,053,"Missouri","Cooper County",1,36,206,101,105
050,29,053,"Missouri","Cooper County",1,37,208,95,113
050,29,053,"Missouri","Cooper County",1,38,215,108,107
050,29,053,"Missouri","Cooper County",1,39,224,117,107
050,29,053,"Missouri","Cooper County",1,40,225,125,100
050,29,053,"Missouri","Cooper County",1,41,207,114,93
050,29,053,"Missouri","Cooper County",1,42,197,111,86
050,29,053,"Missouri","Cooper County",1,43,195,98,97
050,29,053,"Missouri","Cooper County",1,44,185,97,88
050,29,053,"Missouri","Cooper County",1,45,185,99,86
050,29,053,"Missouri","Cooper County",1,46,200,100,100
050,29,053,"Missouri","Cooper County",1,47,186,96,90
050,29,053,"Missouri","Cooper County",1,48,186,99,87
050,29,053,"Missouri","Cooper County",1,49,202,108,94
050,29,053,"Missouri","Cooper County",1,50,201,102,99
050,29,053,"Missouri","Cooper County",1,51,200,95,105
050,29,053,"Missouri","Cooper County",1,52,211,109,102
050,29,053,"Missouri","Cooper County",1,53,199,92,107
050,29,053,"Missouri","Cooper County",1,54,197,106,91
050,29,053,"Missouri","Cooper County",1,55,228,118,110
050,29,053,"Missouri","Cooper County",1,56,236,125,111
050,29,053,"Missouri","Cooper County",1,57,235,111,124
050,29,053,"Missouri","Cooper County",1,58,232,107,125
050,29,053,"Missouri","Cooper County",1,59,253,114,139
050,29,053,"Missouri","Cooper County",1,60,258,124,134
050,29,053,"Missouri","Cooper County",1,61,247,128,119
050,29,053,"Missouri","Cooper County",1,62,238,121,117
050,29,053,"Missouri","Cooper County",1,63,221,108,113
050,29,053,"Missouri","Cooper County",1,64,219,113,106
050,29,053,"Missouri","Cooper County",1,65,219,105,114
050,29,053,"Missouri","Cooper County",1,66,212,103,109
050,29,053,"Missouri","Cooper County",1,67,200,96,104
050,29,053,"Missouri","Cooper County",1,68,200,96,104
050,29,053,"Missouri","Cooper County",1,69,186,86,100
050,29,053,"Missouri","Cooper County",1,70,181,83,98
050,29,053,"Missouri","Cooper County",1,71,163,85,78
050,29,053,"Missouri","Cooper County",1,72,175,90,85
050,29,053,"Missouri","Cooper County",1,73,172,76,96
050,29,053,"Missouri","Cooper County",1,74,102,47,55
050,29,053,"Missouri","Cooper County",1,75,122,50,72
050,29,053,"Missouri","Cooper County",1,76,135,55,80
050,29,053,"Missouri","Cooper County",1,77,115,54,61
050,29,053,"Missouri","Cooper County",1,78,100,40,60
050,29,053,"Missouri","Cooper County",1,79,110,47,63
050,29,053,"Missouri","Cooper County",1,80,86,38,48
050,29,053,"Missouri","Cooper County",1,81,87,44,43
050,29,053,"Missouri","Cooper County",1,82,66,28,38
050,29,053,"Missouri","Cooper County",1,83,64,27,37
050,29,053,"Missouri","Cooper County",1,84,64,26,38
050,29,053,"Missouri","Cooper County",1,85,426,138,288
050,29,053,"Missouri","Cooper County",2,0,196,103,93
050,29,053,"Missouri","Cooper County",2,1,197,90,107
050,29,053,"Missouri","Cooper County",2,2,205,95,110
050,29,053,"Missouri","Cooper County",2,3,192,100,92
050,29,053,"Missouri","Cooper County",2,4,191,98,93
050,29,053,"Missouri","Cooper County",2,5,203,105,98
050,29,053,"Missouri","Cooper County",2,6,207,112,95
050,29,053,"Missouri","Cooper County",2,7,182,93,89
050,29,053,"Missouri","Cooper County",2,8,195,101,94
050,29,053,"Missouri","Cooper County",2,9,209,108,101
050,29,053,"Missouri","Cooper County",2,10,207,108,99
050,29,053,"Missouri","Cooper County",2,11,220,110,110
050,29,053,"Missouri","Cooper County",2,12,228,110,118
050,29,053,"Missouri","Cooper County",2,13,224,106,118
050,29,053,"Missouri","Cooper County",2,14,225,113,112
050,29,053,"Missouri","Cooper County",2,15,209,103,106
050,29,053,"Missouri","Cooper County",2,16,218,107,111
050,29,053,"Missouri","Cooper County",2,17,223,122,101
050,29,053,"Missouri","Cooper County",2,18,198,116,82
050,29,053,"Missouri","Cooper County",2,19,175,101,74
050,29,053,"Missouri","Cooper County",2,20,201,111,90
050,29,053,"Missouri","Cooper County",2,21,191,106,85
050,29,053,"Missouri","Cooper County",2,22,222,128,94
050,29,053,"Missouri","Cooper County",2,23,228,131,97
050,29,053,"Missouri","Cooper County",2,24,204,121,83
050,29,053,"Missouri","Cooper County",2,25,207,115,92
050,29,053,"Missouri","Cooper County",2,26,213,117,96
050,29,053,"Missouri","Cooper County",2,27,202,109,93
050,29,053,"Missouri","Cooper County",2,28,213,122,91
050,29,053,"Missouri","Cooper County",2,29,215,127,88
050,29,053,"Missouri","Cooper County",2,30,213,114,99
050,29,053,"Missouri","Cooper County",2,31,192,102,90
050,29,053,"Missouri","Cooper County",2,32,189,107,82
050,29,053,"Missouri","Cooper County",2,33,180,95,85
050,29,053,"Missouri","Cooper County",2,34,186,94,92
050,29,053,"Missouri","Cooper County",2,35,190,96,94
050,29,053,"Missouri","Cooper County",2,36,197,94,103
050,29,053,"Missouri","Cooper County",2,37,203,91,112
050,29,053,"Missouri","Cooper County",2,38,208,101,107
050,29,053,"Missouri","Cooper County",2,39,214,108,106
050,29,053,"Missouri","Cooper County",2,40,218,116,102
050,29,053,"Missouri","Cooper County",2,41,203,109,94
050,29,053,"Missouri","Cooper County",2,42,194,106,88
050,29,053,"Missouri","Cooper County",2,43,190,96,94
050,29,053,"Missouri","Cooper County",2,44,181,91,90
050,29,053,"Missouri","Cooper County",2,45,182,94,88
050,29,053,"Missouri","Cooper County",2,46,189,94,95
050,29,053,"Missouri","Cooper County",2,47,186,95,91
050,29,053,"Missouri","Cooper County",2,48,181,93,88
050,29,053,"Missouri","Cooper County",2,49,194,102,92
050,29,053,"Missouri","Cooper County",2,50,200,101,99
050,29,053,"Missouri","Cooper County",2,51,198,95,103
050,29,053,"Missouri","Cooper County",2,52,205,103,102
050,29,053,"Missouri","Cooper County",2,53,202,96,106
050,29,053,"Missouri","Cooper County",2,54,194,100,94
050,29,053,"Missouri","Cooper County",2,55,219,113,106
050,29,053,"Missouri","Cooper County",2,56,232,121,111
050,29,053,"Missouri","Cooper County",2,57,237,114,123
050,29,053,"Missouri","Cooper County",2,58,230,105,125
050,29,053,"Missouri","Cooper County",2,59,247,111,136
050,29,053,"Missouri","Cooper County",2,60,254,121,133
050,29,053,"Missouri","Cooper County",2,61,246,124,122
050,29,053,"Missouri","Cooper County",2,62,239,122,117
050,29,053,"Missouri","Cooper County",2,63,229,112,117
050,29,053,"Missouri","Cooper County",2,64,219,110,109
050,29,053,"Missouri","Cooper County",2,65,219,107,112
050,29,053,"Missouri","Cooper County",2,66,214,103,111
050,29,053,"Missouri","Cooper County",2,67,202,96,106
050,29,053,"Missouri","Cooper County",2,68,198,96,102
050,29,053,"Missouri","Cooper County",2,69,191,89,102
050,29,053,"Missouri","Cooper County",2,70,181,82,99
050,29,053,"Missouri","Cooper County",2,71,166,84,82
050,29,053,"Missouri","Cooper County",2,72,168,85,83
050,29,053,"Missouri","Cooper County",2,73,179,82,97
050,29,053,"Missouri","Cooper County",2,74,110,50,60
050,29,053,"Missouri","Cooper County",2,75,115,48,67
050,29,053,"Missouri","Cooper County",2,76,132,54,78
050,29,053,"Missouri","Cooper County",2,77,121,54,67
050,29,053,"Missouri","Cooper County",2,78,101,42,59
050,29,053,"Missouri","Cooper County",2,79,108,44,64
050,29,053,"Missouri","Cooper County",2,80,90,40,50
050,29,053,"Missouri","Cooper County",2,81,83,41,42
050,29,053,"Missouri","Cooper County",2,82,70,31,39
050,29,053,"Missouri","Cooper County",2,83,63,26,37
050,29,053,"Missouri","Cooper County",2,84,63,27,36
050,29,053,"Missouri","Cooper County",2,85,431,140,291
050,29,053,"Missouri","Cooper County",3,0,192,99,93
050,29,053,"Missouri","Cooper County",3,1,199,95,104
050,29,053,"Missouri","Cooper County",3,2,198,93,105
050,29,053,"Missouri","Cooper County",3,3,220,107,113
050,29,053,"Missouri","Cooper County",3,4,197,100,97
050,29,053,"Missouri","Cooper County",3,5,175,91,84
050,29,053,"Missouri","Cooper County",3,6,200,105,95
050,29,053,"Missouri","Cooper County",3,7,203,111,92
050,29,053,"Missouri","Cooper County",3,8,187,91,96
050,29,053,"Missouri","Cooper County",3,9,194,96,98
050,29,053,"Missouri","Cooper County",3,10,206,106,100
050,29,053,"Missouri","Cooper County",3,11,201,103,98
050,29,053,"Missouri","Cooper County",3,12,224,116,108
050,29,053,"Missouri","Cooper County",3,13,227,109,118
050,29,053,"Missouri","Cooper County",3,14,225,111,114
050,29,053,"Missouri","Cooper County",3,15,227,118,109
050,29,053,"Missouri","Cooper County",3,16,207,105,102
050,29,053,"Missouri","Cooper County",3,17,226,112,114
050,29,053,"Missouri","Cooper County",3,18,192,109,83
050,29,053,"Missouri","Cooper County",3,19,165,103,62
050,29,053,"Missouri","Cooper County",3,20,190,115,75
050,29,053,"Missouri","Cooper County",3,21,197,114,83
050,29,053,"Missouri","Cooper County",3,22,206,120,86
050,29,053,"Missouri","Cooper County",3,23,228,132,96
050,29,053,"Missouri","Cooper County",3,24,221,126,95
050,29,053,"Missouri","Cooper County",3,25,197,110,87
050,29,053,"Missouri","Cooper County",3,26,231,125,106
050,29,053,"Missouri","Cooper County",3,27,224,119,105
050,29,053,"Missouri","Cooper County",3,28,211,116,95
050,29,053,"Missouri","Cooper County",3,29,196,105,91
050,29,053,"Missouri","Cooper County",3,30,209,119,90
050,29,053,"Missouri","Cooper County",3,31,208,109,99
050,29,053,"Missouri","Cooper County",3,32,196,106,90
050,29,053,"Missouri","Cooper County",3,33,191,102,89
050,29,053,"Missouri","Cooper County",3,34,184,98,86
050,29,053,"Missouri","Cooper County",3,35,190,101,89
050,29,053,"Missouri","Cooper County",3,36,187,96,91
050,29,053,"Missouri","Cooper County",3,37,189,92,97
050,29,053,"Missouri","Cooper County",3,38,212,95,117
050,29,053,"Missouri","Cooper County",3,39,216,109,107
050,29,053,"Missouri","Cooper County",3,40,213,106,107
050,29,053,"Missouri","Cooper County",3,41,223,116,107
050,29,053,"Missouri","Cooper County",3,42,212,119,93
050,29,053,"Missouri","Cooper County",3,43,189,102,87
050,29,053,"Missouri","Cooper County",3,44,193,100,93
050,29,053,"Missouri","Cooper County",3,45,186,97,89
050,29,053,"Missouri","Cooper County",3,46,168,86,82
050,29,053,"Missouri","Cooper County",3,47,189,98,91
050,29,053,"Missouri","Cooper County",3,48,179,83,96
050,29,053,"Missouri","Cooper County",3,49,179,95,84
050,29,053,"Missouri","Cooper County",3,50,202,102,100
050,29,053,"Missouri","Cooper County",3,51,205,106,99
050,29,053,"Missouri","Cooper County",3,52,202,97,105
050,29,053,"Missouri","Cooper County",3,53,197,102,95
050,29,053,"Missouri","Cooper County",3,54,203,102,101
050,29,053,"Missouri","Cooper County",3,55,197,104,93
050,29,053,"Missouri","Cooper County",3,56,226,121,105
050,29,053,"Missouri","Cooper County",3,57,234,119,115
050,29,053,"Missouri","Cooper County",3,58,235,113,122
050,29,053,"Missouri","Cooper County",3,59,232,107,125
050,29,053,"Missouri","Cooper County",3,60,248,112,136
050,29,053,"Missouri","Cooper County",3,61,253,118,135
050,29,053,"Missouri","Cooper County",3,62,238,120,118
050,29,053,"Missouri","Cooper County",3,63,237,123,114
050,29,053,"Missouri","Cooper County",3,64,233,116,117
050,29,053,"Missouri","Cooper County",3,65,221,110,111
050,29,053,"Missouri","Cooper County",3,66,209,102,107
050,29,053,"Missouri","Cooper County",3,67,216,103,113
050,29,053,"Missouri","Cooper County",3,68,196,91,105
050,29,053,"Missouri","Cooper County",3,69,189,90,99
050,29,053,"Missouri","Cooper County",3,70,187,83,104
050,29,053,"Missouri","Cooper County",3,71,186,90,96
050,29,053,"Missouri","Cooper County",3,72,158,75,83
050,29,053,"Missouri","Cooper County",3,73,151,80,71
050,29,053,"Missouri","Cooper County",3,74,182,87,95
050,29,053,"Missouri","Cooper County",3,75,101,45,56
050,29,053,"Missouri","Cooper County",3,76,117,51,66
050,29,053,"Missouri","Cooper County",3,77,123,47,76
050,29,053,"Missouri","Cooper County",3,78,112,50,62
050,29,053,"Missouri","Cooper County",3,79,103,40,63
050,29,053,"Missouri","Cooper County",3,80,98,44,54
050,29,053,"Missouri","Cooper County",3,81,83,36,47
050,29,053,"Missouri","Cooper County",3,82,72,34,38
050,29,053,"Missouri","Cooper County",3,83,68,27,41
050,29,053,"Missouri","Cooper County",3,84,48,21,27
050,29,053,"Missouri","Cooper County",3,85,435,138,297
050,29,053,"Missouri","Cooper County",4,0,182,98,84
050,29,053,"Missouri","Cooper County",4,1,194,93,101
050,29,053,"Missouri","Cooper County",4,2,208,106,102
050,29,053,"Missouri","Cooper County",4,3,199,91,108
050,29,053,"Missouri","Cooper County",4,4,225,112,113
050,29,053,"Missouri","Cooper County",4,5,194,95,99
050,29,053,"Missouri","Cooper County",4,6,186,100,86
050,29,053,"Missouri","Cooper County",4,7,209,110,99
050,29,053,"Missouri","Cooper County",4,8,208,111,97
050,29,053,"Missouri","Cooper County",4,9,193,91,102
050,29,053,"Missouri","Cooper County",4,10,198,102,96
050,29,053,"Missouri","Cooper County",4,11,205,105,100
050,29,053,"Missouri","Cooper County",4,12,205,106,99
050,29,053,"Missouri","Cooper County",4,13,231,118,113
050,29,053,"Missouri","Cooper County",4,14,236,115,121
050,29,053,"Missouri","Cooper County",4,15,224,107,117
050,29,053,"Missouri","Cooper County",4,16,235,119,116
050,29,053,"Missouri","Cooper County",4,17,210,102,108
050,29,053,"Missouri","Cooper County",4,18,197,102,95
050,29,053,"Missouri","Cooper County",4,19,164,98,66
050,29,053,"Missouri","Cooper County",4,20,179,119,60
050,29,053,"Missouri","Cooper County",4,21,182,108,74
050,29,053,"Missouri","Cooper County",4,22,211,122,89
050,29,053,"Missouri","Cooper County",4,23,203,115,88
050,29,053,"Missouri","Cooper County",4,24,217,128,89
050,29,053,"Missouri","Cooper County",4,25,206,118,88
050,29,053,"Missouri","Cooper County",4,26,208,119,89
050,29,053,"Missouri","Cooper County",4,27,241,129,112
050,29,053,"Missouri","Cooper County",4,28,232,120,112
050,29,053,"Missouri","Cooper County",4,29,218,118,100
050,29,053,"Missouri","Cooper County",4,30,192,105,87
050,29,053,"Missouri","Cooper County",4,31,197,104,93
050,29,053,"Missouri","Cooper County",4,32,221,115,106
050,29,053,"Missouri","Cooper County",4,33,190,102,88
050,29,053,"Missouri","Cooper County",4,34,208,111,97
050,29,053,"Missouri","Cooper County",4,35,181,98,83
050,29,053,"Missouri","Cooper County",4,36,194,101,93
050,29,053,"Missouri","Cooper County",4,37,195,95,100
050,29,053,"Missouri","Cooper County",4,38,192,90,102
050,29,053,"Missouri","Cooper County",4,39,218,100,118
050,29,053,"Missouri","Cooper County",4,40,213,111,102
050,29,053,"Missouri","Cooper County",4,41,209,105,104
050,29,053,"Missouri","Cooper County",4,42,233,120,113
050,29,053,"Missouri","Cooper County",4,43,206,115,91
050,29,053,"Missouri","Cooper County",4,44,200,109,91
050,29,053,"Missouri","Cooper County",4,45,200,104,96
050,29,053,"Missouri","Cooper County",4,46,181,91,90
050,29,053,"Missouri","Cooper County",4,47,178,93,85
050,29,053,"Missouri","Cooper County",4,48,182,89,93
050,29,053,"Missouri","Cooper County",4,49,191,90,101
050,29,053,"Missouri","Cooper County",4,50,185,97,88
050,29,053,"Missouri","Cooper County",4,51,206,105,101
050,29,053,"Missouri","Cooper County",4,52,199,101,98
050,29,053,"Missouri","Cooper County",4,53,200,98,102
050,29,053,"Missouri","Cooper County",4,54,201,107,94
050,29,053,"Missouri","Cooper County",4,55,196,97,99
050,29,053,"Missouri","Cooper County",4,56,194,103,91
050,29,053,"Missouri","Cooper County",4,57,225,119,106
050,29,053,"Missouri","Cooper County",4,58,231,117,114
050,29,053,"Missouri","Cooper County",4,59,238,117,121
050,29,053,"Missouri","Cooper County",4,60,234,110,124
050,29,053,"Missouri","Cooper County",4,61,242,111,131
050,29,053,"Missouri","Cooper County",4,62,257,116,141
050,29,053,"Missouri","Cooper County",4,63,238,124,114
050,29,053,"Missouri","Cooper County",4,64,232,118,114
050,29,053,"Missouri","Cooper County",4,65,232,114,118
050,29,053,"Missouri","Cooper County",4,66,214,109,105
050,29,053,"Missouri","Cooper County",4,67,208,101,107
050,29,053,"Missouri","Cooper County",4,68,204,99,105
050,29,053,"Missouri","Cooper County",4,69,189,86,103
050,29,053,"Missouri","Cooper County",4,70,181,84,97
050,29,053,"Missouri","Cooper County",4,71,192,86,106
050,29,053,"Missouri","Cooper County",4,72,170,80,90
050,29,053,"Missouri","Cooper County",4,73,146,72,74
050,29,053,"Missouri","Cooper County",4,74,152,79,73
050,29,053,"Missouri","Cooper County",4,75,171,77,94
050,29,053,"Missouri","Cooper County",4,76,106,49,57
050,29,053,"Missouri","Cooper County",4,77,111,46,65
050,29,053,"Missouri","Cooper County",4,78,117,48,69
050,29,053,"Missouri","Cooper County",4,79,112,51,61
050,29,053,"Missouri","Cooper County",4,80,92,38,54
050,29,053,"Missouri","Cooper County",4,81,95,41,54
050,29,053,"Missouri","Cooper County",4,82,70,27,43
050,29,053,"Missouri","Cooper County",4,83,70,32,38
050,29,053,"Missouri","Cooper County",4,84,60,27,33
050,29,053,"Missouri","Cooper County",4,85,412,133,279
050,29,053,"Missouri","Cooper County",5,0,184,97,87
050,29,053,"Missouri","Cooper County",5,1,201,100,101
050,29,053,"Missouri","Cooper County",5,2,204,97,107
050,29,053,"Missouri","Cooper County",5,3,210,116,94
050,29,053,"Missouri","Cooper County",5,4,217,100,117
050,29,053,"Missouri","Cooper County",5,5,231,114,117
050,29,053,"Missouri","Cooper County",5,6,192,94,98
050,29,053,"Missouri","Cooper County",5,7,186,98,88
050,29,053,"Missouri","Cooper County",5,8,208,111,97
050,29,053,"Missouri","Cooper County",5,9,217,116,101
050,29,053,"Missouri","Cooper County",5,10,204,97,107
050,29,053,"Missouri","Cooper County",5,11,185,91,94
050,29,053,"Missouri","Cooper County",5,12,207,109,98
050,29,053,"Missouri","Cooper County",5,13,206,108,98
050,29,053,"Missouri","Cooper County",5,14,232,120,112
050,29,053,"Missouri","Cooper County",5,15,231,111,120
050,29,053,"Missouri","Cooper County",5,16,226,109,117
050,29,053,"Missouri","Cooper County",5,17,241,127,114
050,29,053,"Missouri","Cooper County",5,18,183,97,86
050,29,053,"Missouri","Cooper County",5,19,165,96,69
050,29,053,"Missouri","Cooper County",5,20,190,119,71
050,29,053,"Missouri","Cooper County",5,21,188,122,66
050,29,053,"Missouri","Cooper County",5,22,211,123,88
050,29,053,"Missouri","Cooper County",5,23,230,131,99
050,29,053,"Missouri","Cooper County",5,24,211,120,91
050,29,053,"Missouri","Cooper County",5,25,239,136,103
050,29,053,"Missouri","Cooper County",5,26,217,127,90
050,29,053,"Missouri","Cooper County",5,27,208,120,88
050,29,053,"Missouri","Cooper County",5,28,253,135,118
050,29,053,"Missouri","Cooper County",5,29,243,129,114
050,29,053,"Missouri","Cooper County",5,30,219,113,106
050,29,053,"Missouri","Cooper County",5,31,188,102,86
050,29,053,"Missouri","Cooper County",5,32,209,114,95
050,29,053,"Missouri","Cooper County",5,33,213,107,106
050,29,053,"Missouri","Cooper County",5,34,193,106,87
050,29,053,"Missouri","Cooper County",5,35,192,100,92
050,29,053,"Missouri","Cooper County",5,36,174,93,81
050,29,053,"Missouri","Cooper County",5,37,185,95,90
050,29,053,"Missouri","Cooper County",5,38,198,96,102
050,29,053,"Missouri","Cooper County",5,39,205,99,106
050,29,053,"Missouri","Cooper County",5,40,216,99,117
050,29,053,"Missouri","Cooper County",5,41,221,115,106
050,29,053,"Missouri","Cooper County",5,42,205,99,106
050,29,053,"Missouri","Cooper County",5,43,236,119,117
050,29,053,"Missouri","Cooper County",5,44,218,119,99
050,29,053,"Missouri","Cooper County",5,45,196,104,92
050,29,053,"Missouri","Cooper County",5,46,203,107,96
050,29,053,"Missouri","Cooper County",5,47,199,107,92
050,29,053,"Missouri","Cooper County",5,48,170,84,86
050,29,053,"Missouri","Cooper County",5,49,178,91,87
050,29,053,"Missouri","Cooper County",5,50,194,93,101
050,29,053,"Missouri","Cooper County",5,51,187,96,91
050,29,053,"Missouri","Cooper County",5,52,199,99,100
050,29,053,"Missouri","Cooper County",5,53,199,103,96
050,29,053,"Missouri","Cooper County",5,54,204,100,104
050,29,053,"Missouri","Cooper County",5,55,192,99,93
050,29,053,"Missouri","Cooper County",5,56,194,92,102
050,29,053,"Missouri","Cooper County",5,57,197,104,93
050,29,053,"Missouri","Cooper County",5,58,223,120,103
050,29,053,"Missouri","Cooper County",5,59,228,116,112
050,29,053,"Missouri","Cooper County",5,60,238,116,122
050,29,053,"Missouri","Cooper County",5,61,237,108,129
050,29,053,"Missouri","Cooper County",5,62,240,110,130
050,29,053,"Missouri","Cooper County",5,63,255,119,136
050,29,053,"Missouri","Cooper County",5,64,232,118,114
050,29,053,"Missouri","Cooper County",5,65,223,115,108
050,29,053,"Missouri","Cooper County",5,66,228,112,116
050,29,053,"Missouri","Cooper County",5,67,220,110,110
050,29,053,"Missouri","Cooper County",5,68,208,101,107
050,29,053,"Missouri","Cooper County",5,69,200,95,105
050,29,053,"Missouri","Cooper County",5,70,181,79,102
050,29,053,"Missouri","Cooper County",5,71,180,86,94
050,29,053,"Missouri","Cooper County",5,72,180,75,105
050,29,053,"Missouri","Cooper County",5,73,160,77,83
050,29,053,"Missouri","Cooper County",5,74,145,73,72
050,29,053,"Missouri","Cooper County",5,75,145,72,73
050,29,053,"Missouri","Cooper County",5,76,173,83,90
050,29,053,"Missouri","Cooper County",5,77,98,43,55
050,29,053,"Missouri","Cooper County",5,78,106,43,63
050,29,053,"Missouri","Cooper County",5,79,117,46,71
050,29,053,"Missouri","Cooper County",5,80,103,50,53
050,29,053,"Missouri","Cooper County",5,81,90,35,55
050,29,053,"Missouri","Cooper County",5,82,88,36,52
050,29,053,"Missouri","Cooper County",5,83,71,25,46
050,29,053,"Missouri","Cooper County",5,84,62,31,31
050,29,053,"Missouri","Cooper County",5,85,412,135,277
050,29,055,"Missouri","Crawford County",1,0,242,125,117
050,29,055,"Missouri","Crawford County",1,1,240,126,114
050,29,055,"Missouri","Crawford County",1,2,271,150,121
050,29,055,"Missouri","Crawford County",1,3,251,133,118
050,29,055,"Missouri","Crawford County",1,4,264,135,129
050,29,055,"Missouri","Crawford County",1,5,296,156,140
050,29,055,"Missouri","Crawford County",1,6,281,147,134
050,29,055,"Missouri","Crawford County",1,7,287,144,143
050,29,055,"Missouri","Crawford County",1,8,241,118,123
050,29,055,"Missouri","Crawford County",1,9,283,138,145
050,29,055,"Missouri","Crawford County",1,10,283,133,150
050,29,055,"Missouri","Crawford County",1,11,322,157,165
050,29,055,"Missouri","Crawford County",1,12,351,171,180
050,29,055,"Missouri","Crawford County",1,13,358,170,188
050,29,055,"Missouri","Crawford County",1,14,333,153,180
050,29,055,"Missouri","Crawford County",1,15,326,170,156
050,29,055,"Missouri","Crawford County",1,16,328,171,157
050,29,055,"Missouri","Crawford County",1,17,302,157,145
050,29,055,"Missouri","Crawford County",1,18,266,153,113
050,29,055,"Missouri","Crawford County",1,19,199,104,95
050,29,055,"Missouri","Crawford County",1,20,219,116,103
050,29,055,"Missouri","Crawford County",1,21,215,116,99
050,29,055,"Missouri","Crawford County",1,22,240,119,121
050,29,055,"Missouri","Crawford County",1,23,244,131,113
050,29,055,"Missouri","Crawford County",1,24,260,147,113
050,29,055,"Missouri","Crawford County",1,25,252,130,122
050,29,055,"Missouri","Crawford County",1,26,270,141,129
050,29,055,"Missouri","Crawford County",1,27,271,133,138
050,29,055,"Missouri","Crawford County",1,28,258,129,129
050,29,055,"Missouri","Crawford County",1,29,278,135,143
050,29,055,"Missouri","Crawford County",1,30,271,145,126
050,29,055,"Missouri","Crawford County",1,31,262,129,133
050,29,055,"Missouri","Crawford County",1,32,249,138,111
050,29,055,"Missouri","Crawford County",1,33,239,124,115
050,29,055,"Missouri","Crawford County",1,34,247,117,130
050,29,055,"Missouri","Crawford County",1,35,254,116,138
050,29,055,"Missouri","Crawford County",1,36,267,137,130
050,29,055,"Missouri","Crawford County",1,37,298,149,149
050,29,055,"Missouri","Crawford County",1,38,286,153,133
050,29,055,"Missouri","Crawford County",1,39,266,141,125
050,29,055,"Missouri","Crawford County",1,40,273,139,134
050,29,055,"Missouri","Crawford County",1,41,272,144,128
050,29,055,"Missouri","Crawford County",1,42,285,147,138
050,29,055,"Missouri","Crawford County",1,43,259,133,126
050,29,055,"Missouri","Crawford County",1,44,218,105,113
050,29,055,"Missouri","Crawford County",1,45,262,125,137
050,29,055,"Missouri","Crawford County",1,46,243,122,121
050,29,055,"Missouri","Crawford County",1,47,249,130,119
050,29,055,"Missouri","Crawford County",1,48,275,148,127
050,29,055,"Missouri","Crawford County",1,49,284,144,140
050,29,055,"Missouri","Crawford County",1,50,291,150,141
050,29,055,"Missouri","Crawford County",1,51,295,158,137
050,29,055,"Missouri","Crawford County",1,52,294,153,141
050,29,055,"Missouri","Crawford County",1,53,288,154,134
050,29,055,"Missouri","Crawford County",1,54,294,149,145
050,29,055,"Missouri","Crawford County",1,55,322,153,169
050,29,055,"Missouri","Crawford County",1,56,350,158,192
050,29,055,"Missouri","Crawford County",1,57,370,174,196
050,29,055,"Missouri","Crawford County",1,58,377,195,182
050,29,055,"Missouri","Crawford County",1,59,345,186,159
050,29,055,"Missouri","Crawford County",1,60,375,198,177
050,29,055,"Missouri","Crawford County",1,61,383,199,184
050,29,055,"Missouri","Crawford County",1,62,366,184,182
050,29,055,"Missouri","Crawford County",1,63,338,174,164
050,29,055,"Missouri","Crawford County",1,64,339,172,167
050,29,055,"Missouri","Crawford County",1,65,320,144,176
050,29,055,"Missouri","Crawford County",1,66,298,145,153
050,29,055,"Missouri","Crawford County",1,67,293,144,149
050,29,055,"Missouri","Crawford County",1,68,272,144,128
050,29,055,"Missouri","Crawford County",1,69,267,137,130
050,29,055,"Missouri","Crawford County",1,70,256,127,129
050,29,055,"Missouri","Crawford County",1,71,264,126,138
050,29,055,"Missouri","Crawford County",1,72,270,128,142
050,29,055,"Missouri","Crawford County",1,73,260,125,135
050,29,055,"Missouri","Crawford County",1,74,180,90,90
050,29,055,"Missouri","Crawford County",1,75,198,104,94
050,29,055,"Missouri","Crawford County",1,76,180,87,93
050,29,055,"Missouri","Crawford County",1,77,190,85,105
050,29,055,"Missouri","Crawford County",1,78,149,68,81
050,29,055,"Missouri","Crawford County",1,79,133,64,69
050,29,055,"Missouri","Crawford County",1,80,114,46,68
050,29,055,"Missouri","Crawford County",1,81,117,48,69
050,29,055,"Missouri","Crawford County",1,82,107,53,54
050,29,055,"Missouri","Crawford County",1,83,92,45,47
050,29,055,"Missouri","Crawford County",1,84,92,43,49
050,29,055,"Missouri","Crawford County",1,85,485,167,318
050,29,055,"Missouri","Crawford County",2,0,237,124,113
050,29,055,"Missouri","Crawford County",2,1,241,127,114
050,29,055,"Missouri","Crawford County",2,2,263,144,119
050,29,055,"Missouri","Crawford County",2,3,253,135,118
050,29,055,"Missouri","Crawford County",2,4,266,137,129
050,29,055,"Missouri","Crawford County",2,5,289,152,137
050,29,055,"Missouri","Crawford County",2,6,284,149,135
050,29,055,"Missouri","Crawford County",2,7,283,142,141
050,29,055,"Missouri","Crawford County",2,8,254,123,131
050,29,055,"Missouri","Crawford County",2,9,272,133,139
050,29,055,"Missouri","Crawford County",2,10,284,136,148
050,29,055,"Missouri","Crawford County",2,11,316,155,161
050,29,055,"Missouri","Crawford County",2,12,348,169,179
050,29,055,"Missouri","Crawford County",2,13,357,170,187
050,29,055,"Missouri","Crawford County",2,14,343,158,185
050,29,055,"Missouri","Crawford County",2,15,331,169,162
050,29,055,"Missouri","Crawford County",2,16,326,169,157
050,29,055,"Missouri","Crawford County",2,17,307,161,146
050,29,055,"Missouri","Crawford County",2,18,260,148,112
050,29,055,"Missouri","Crawford County",2,19,201,108,93
050,29,055,"Missouri","Crawford County",2,20,219,116,103
050,29,055,"Missouri","Crawford County",2,21,220,117,103
050,29,055,"Missouri","Crawford County",2,22,236,118,118
050,29,055,"Missouri","Crawford County",2,23,245,130,115
050,29,055,"Missouri","Crawford County",2,24,260,146,114
050,29,055,"Missouri","Crawford County",2,25,257,134,123
050,29,055,"Missouri","Crawford County",2,26,266,139,127
050,29,055,"Missouri","Crawford County",2,27,270,136,134
050,29,055,"Missouri","Crawford County",2,28,262,130,132
050,29,055,"Missouri","Crawford County",2,29,274,136,138
050,29,055,"Missouri","Crawford County",2,30,273,142,131
050,29,055,"Missouri","Crawford County",2,31,262,132,130
050,29,055,"Missouri","Crawford County",2,32,252,136,116
050,29,055,"Missouri","Crawford County",2,33,239,124,115
050,29,055,"Missouri","Crawford County",2,34,247,121,126
050,29,055,"Missouri","Crawford County",2,35,251,116,135
050,29,055,"Missouri","Crawford County",2,36,265,132,133
050,29,055,"Missouri","Crawford County",2,37,294,148,146
050,29,055,"Missouri","Crawford County",2,38,290,155,135
050,29,055,"Missouri","Crawford County",2,39,266,140,126
050,29,055,"Missouri","Crawford County",2,40,270,139,131
050,29,055,"Missouri","Crawford County",2,41,274,144,130
050,29,055,"Missouri","Crawford County",2,42,278,142,136
050,29,055,"Missouri","Crawford County",2,43,270,139,131
050,29,055,"Missouri","Crawford County",2,44,223,109,114
050,29,055,"Missouri","Crawford County",2,45,255,123,132
050,29,055,"Missouri","Crawford County",2,46,242,119,123
050,29,055,"Missouri","Crawford County",2,47,247,129,118
050,29,055,"Missouri","Crawford County",2,48,267,142,125
050,29,055,"Missouri","Crawford County",2,49,283,146,137
050,29,055,"Missouri","Crawford County",2,50,290,149,141
050,29,055,"Missouri","Crawford County",2,51,293,156,137
050,29,055,"Missouri","Crawford County",2,52,291,151,140
050,29,055,"Missouri","Crawford County",2,53,289,153,136
050,29,055,"Missouri","Crawford County",2,54,292,149,143
050,29,055,"Missouri","Crawford County",2,55,310,148,162
050,29,055,"Missouri","Crawford County",2,56,345,158,187
050,29,055,"Missouri","Crawford County",2,57,365,171,194
050,29,055,"Missouri","Crawford County",2,58,371,188,183
050,29,055,"Missouri","Crawford County",2,59,351,189,162
050,29,055,"Missouri","Crawford County",2,60,366,194,172
050,29,055,"Missouri","Crawford County",2,61,381,198,183
050,29,055,"Missouri","Crawford County",2,62,369,187,182
050,29,055,"Missouri","Crawford County",2,63,349,178,171
050,29,055,"Missouri","Crawford County",2,64,339,174,165
050,29,055,"Missouri","Crawford County",2,65,322,149,173
050,29,055,"Missouri","Crawford County",2,66,300,144,156
050,29,055,"Missouri","Crawford County",2,67,293,143,150
050,29,055,"Missouri","Crawford County",2,68,273,142,131
050,29,055,"Missouri","Crawford County",2,69,270,140,130
050,29,055,"Missouri","Crawford County",2,70,257,130,127
050,29,055,"Missouri","Crawford County",2,71,261,125,136
050,29,055,"Missouri","Crawford County",2,72,265,126,139
050,29,055,"Missouri","Crawford County",2,73,274,133,141
050,29,055,"Missouri","Crawford County",2,74,188,92,96
050,29,055,"Missouri","Crawford County",2,75,191,99,92
050,29,055,"Missouri","Crawford County",2,76,182,89,93
050,29,055,"Missouri","Crawford County",2,77,191,88,103
050,29,055,"Missouri","Crawford County",2,78,153,70,83
050,29,055,"Missouri","Crawford County",2,79,133,64,69
050,29,055,"Missouri","Crawford County",2,80,115,46,69
050,29,055,"Missouri","Crawford County",2,81,116,47,69
050,29,055,"Missouri","Crawford County",2,82,106,50,56
050,29,055,"Missouri","Crawford County",2,83,95,47,48
050,29,055,"Missouri","Crawford County",2,84,91,42,49
050,29,055,"Missouri","Crawford County",2,85,486,170,316
050,29,055,"Missouri","Crawford County",3,0,244,121,123
050,29,055,"Missouri","Crawford County",3,1,241,126,115
050,29,055,"Missouri","Crawford County",3,2,252,137,115
050,29,055,"Missouri","Crawford County",3,3,261,147,114
050,29,055,"Missouri","Crawford County",3,4,238,130,108
050,29,055,"Missouri","Crawford County",3,5,262,130,132
050,29,055,"Missouri","Crawford County",3,6,274,144,130
050,29,055,"Missouri","Crawford County",3,7,278,140,138
050,29,055,"Missouri","Crawford County",3,8,281,145,136
050,29,055,"Missouri","Crawford County",3,9,255,125,130
050,29,055,"Missouri","Crawford County",3,10,262,128,134
050,29,055,"Missouri","Crawford County",3,11,279,135,144
050,29,055,"Missouri","Crawford County",3,12,308,145,163
050,29,055,"Missouri","Crawford County",3,13,338,170,168
050,29,055,"Missouri","Crawford County",3,14,354,173,181
050,29,055,"Missouri","Crawford County",3,15,357,162,195
050,29,055,"Missouri","Crawford County",3,16,326,164,162
050,29,055,"Missouri","Crawford County",3,17,317,158,159
050,29,055,"Missouri","Crawford County",3,18,255,145,110
050,29,055,"Missouri","Crawford County",3,19,199,113,86
050,29,055,"Missouri","Crawford County",3,20,227,114,113
050,29,055,"Missouri","Crawford County",3,21,234,129,105
050,29,055,"Missouri","Crawford County",3,22,228,116,112
050,29,055,"Missouri","Crawford County",3,23,238,114,124
050,29,055,"Missouri","Crawford County",3,24,264,143,121
050,29,055,"Missouri","Crawford County",3,25,261,146,115
050,29,055,"Missouri","Crawford County",3,26,245,131,114
050,29,055,"Missouri","Crawford County",3,27,271,137,134
050,29,055,"Missouri","Crawford County",3,28,264,132,132
050,29,055,"Missouri","Crawford County",3,29,271,139,132
050,29,055,"Missouri","Crawford County",3,30,257,121,136
050,29,055,"Missouri","Crawford County",3,31,264,137,127
050,29,055,"Missouri","Crawford County",3,32,266,134,132
050,29,055,"Missouri","Crawford County",3,33,245,133,112
050,29,055,"Missouri","Crawford County",3,34,231,121,110
050,29,055,"Missouri","Crawford County",3,35,248,123,125
050,29,055,"Missouri","Crawford County",3,36,251,118,133
050,29,055,"Missouri","Crawford County",3,37,264,128,136
050,29,055,"Missouri","Crawford County",3,38,294,149,145
050,29,055,"Missouri","Crawford County",3,39,274,140,134
050,29,055,"Missouri","Crawford County",3,40,273,144,129
050,29,055,"Missouri","Crawford County",3,41,263,137,126
050,29,055,"Missouri","Crawford County",3,42,259,131,128
050,29,055,"Missouri","Crawford County",3,43,285,150,135
050,29,055,"Missouri","Crawford County",3,44,265,136,129
050,29,055,"Missouri","Crawford County",3,45,236,122,114
050,29,055,"Missouri","Crawford County",3,46,237,109,128
050,29,055,"Missouri","Crawford County",3,47,247,116,131
050,29,055,"Missouri","Crawford County",3,48,245,126,119
050,29,055,"Missouri","Crawford County",3,49,269,148,121
050,29,055,"Missouri","Crawford County",3,50,282,145,137
050,29,055,"Missouri","Crawford County",3,51,291,152,139
050,29,055,"Missouri","Crawford County",3,52,286,152,134
050,29,055,"Missouri","Crawford County",3,53,295,155,140
050,29,055,"Missouri","Crawford County",3,54,294,153,141
050,29,055,"Missouri","Crawford County",3,55,281,140,141
050,29,055,"Missouri","Crawford County",3,56,315,144,171
050,29,055,"Missouri","Crawford County",3,57,348,151,197
050,29,055,"Missouri","Crawford County",3,58,367,177,190
050,29,055,"Missouri","Crawford County",3,59,361,188,173
050,29,055,"Missouri","Crawford County",3,60,344,181,163
050,29,055,"Missouri","Crawford County",3,61,362,188,174
050,29,055,"Missouri","Crawford County",3,62,379,197,182
050,29,055,"Missouri","Crawford County",3,63,372,185,187
050,29,055,"Missouri","Crawford County",3,64,348,184,164
050,29,055,"Missouri","Crawford County",3,65,340,167,173
050,29,055,"Missouri","Crawford County",3,66,326,150,176
050,29,055,"Missouri","Crawford County",3,67,291,137,154
050,29,055,"Missouri","Crawford County",3,68,284,144,140
050,29,055,"Missouri","Crawford County",3,69,268,137,131
050,29,055,"Missouri","Crawford County",3,70,268,145,123
050,29,055,"Missouri","Crawford County",3,71,242,123,119
050,29,055,"Missouri","Crawford County",3,72,255,119,136
050,29,055,"Missouri","Crawford County",3,73,253,122,131
050,29,055,"Missouri","Crawford County",3,74,267,127,140
050,29,055,"Missouri","Crawford County",3,75,182,88,94
050,29,055,"Missouri","Crawford County",3,76,181,89,92
050,29,055,"Missouri","Crawford County",3,77,176,88,88
050,29,055,"Missouri","Crawford County",3,78,175,80,95
050,29,055,"Missouri","Crawford County",3,79,144,67,77
050,29,055,"Missouri","Crawford County",3,80,117,54,63
050,29,055,"Missouri","Crawford County",3,81,100,37,63
050,29,055,"Missouri","Crawford County",3,82,100,43,57
050,29,055,"Missouri","Crawford County",3,83,94,44,50
050,29,055,"Missouri","Crawford County",3,84,80,36,44
050,29,055,"Missouri","Crawford County",3,85,495,180,315
050,29,055,"Missouri","Crawford County",4,0,239,115,124
050,29,055,"Missouri","Crawford County",4,1,245,122,123
050,29,055,"Missouri","Crawford County",4,2,233,116,117
050,29,055,"Missouri","Crawford County",4,3,252,133,119
050,29,055,"Missouri","Crawford County",4,4,260,144,116
050,29,055,"Missouri","Crawford County",4,5,243,128,115
050,29,055,"Missouri","Crawford County",4,6,255,129,126
050,29,055,"Missouri","Crawford County",4,7,285,148,137
050,29,055,"Missouri","Crawford County",4,8,272,143,129
050,29,055,"Missouri","Crawford County",4,9,298,154,144
050,29,055,"Missouri","Crawford County",4,10,235,121,114
050,29,055,"Missouri","Crawford County",4,11,266,136,130
050,29,055,"Missouri","Crawford County",4,12,275,136,139
050,29,055,"Missouri","Crawford County",4,13,311,150,161
050,29,055,"Missouri","Crawford County",4,14,337,162,175
050,29,055,"Missouri","Crawford County",4,15,347,169,178
050,29,055,"Missouri","Crawford County",4,16,360,172,188
050,29,055,"Missouri","Crawford County",4,17,318,163,155
050,29,055,"Missouri","Crawford County",4,18,259,130,129
050,29,055,"Missouri","Crawford County",4,19,188,105,83
050,29,055,"Missouri","Crawford County",4,20,211,118,93
050,29,055,"Missouri","Crawford County",4,21,234,124,110
050,29,055,"Missouri","Crawford County",4,22,232,117,115
050,29,055,"Missouri","Crawford County",4,23,242,119,123
050,29,055,"Missouri","Crawford County",4,24,251,129,122
050,29,055,"Missouri","Crawford County",4,25,256,140,116
050,29,055,"Missouri","Crawford County",4,26,254,143,111
050,29,055,"Missouri","Crawford County",4,27,256,136,120
050,29,055,"Missouri","Crawford County",4,28,274,140,134
050,29,055,"Missouri","Crawford County",4,29,263,126,137
050,29,055,"Missouri","Crawford County",4,30,262,132,130
050,29,055,"Missouri","Crawford County",4,31,261,127,134
050,29,055,"Missouri","Crawford County",4,32,275,148,127
050,29,055,"Missouri","Crawford County",4,33,252,123,129
050,29,055,"Missouri","Crawford County",4,34,249,137,112
050,29,055,"Missouri","Crawford County",4,35,238,123,115
050,29,055,"Missouri","Crawford County",4,36,250,131,119
050,29,055,"Missouri","Crawford County",4,37,258,124,134
050,29,055,"Missouri","Crawford County",4,38,272,133,139
050,29,055,"Missouri","Crawford County",4,39,262,122,140
050,29,055,"Missouri","Crawford County",4,40,269,137,132
050,29,055,"Missouri","Crawford County",4,41,278,145,133
050,29,055,"Missouri","Crawford County",4,42,251,128,123
050,29,055,"Missouri","Crawford County",4,43,270,145,125
050,29,055,"Missouri","Crawford County",4,44,272,144,128
050,29,055,"Missouri","Crawford County",4,45,266,140,126
050,29,055,"Missouri","Crawford County",4,46,224,110,114
050,29,055,"Missouri","Crawford County",4,47,251,113,138
050,29,055,"Missouri","Crawford County",4,48,238,112,126
050,29,055,"Missouri","Crawford County",4,49,243,130,113
050,29,055,"Missouri","Crawford County",4,50,269,143,126
050,29,055,"Missouri","Crawford County",4,51,290,150,140
050,29,055,"Missouri","Crawford County",4,52,290,148,142
050,29,055,"Missouri","Crawford County",4,53,281,144,137
050,29,055,"Missouri","Crawford County",4,54,297,155,142
050,29,055,"Missouri","Crawford County",4,55,290,148,142
050,29,055,"Missouri","Crawford County",4,56,284,141,143
050,29,055,"Missouri","Crawford County",4,57,316,136,180
050,29,055,"Missouri","Crawford County",4,58,343,152,191
050,29,055,"Missouri","Crawford County",4,59,366,180,186
050,29,055,"Missouri","Crawford County",4,60,361,185,176
050,29,055,"Missouri","Crawford County",4,61,346,174,172
050,29,055,"Missouri","Crawford County",4,62,361,187,174
050,29,055,"Missouri","Crawford County",4,63,384,201,183
050,29,055,"Missouri","Crawford County",4,64,375,191,184
050,29,055,"Missouri","Crawford County",4,65,334,173,161
050,29,055,"Missouri","Crawford County",4,66,345,172,173
050,29,055,"Missouri","Crawford County",4,67,326,144,182
050,29,055,"Missouri","Crawford County",4,68,294,142,152
050,29,055,"Missouri","Crawford County",4,69,269,136,133
050,29,055,"Missouri","Crawford County",4,70,254,134,120
050,29,055,"Missouri","Crawford County",4,71,254,135,119
050,29,055,"Missouri","Crawford County",4,72,231,115,116
050,29,055,"Missouri","Crawford County",4,73,238,117,121
050,29,055,"Missouri","Crawford County",4,74,247,120,127
050,29,055,"Missouri","Crawford County",4,75,253,120,133
050,29,055,"Missouri","Crawford County",4,76,169,77,92
050,29,055,"Missouri","Crawford County",4,77,180,91,89
050,29,055,"Missouri","Crawford County",4,78,164,81,83
050,29,055,"Missouri","Crawford County",4,79,159,74,85
050,29,055,"Missouri","Crawford County",4,80,127,57,70
050,29,055,"Missouri","Crawford County",4,81,103,45,58
050,29,055,"Missouri","Crawford County",4,82,83,29,54
050,29,055,"Missouri","Crawford County",4,83,91,38,53
050,29,055,"Missouri","Crawford County",4,84,83,34,49
050,29,055,"Missouri","Crawford County",4,85,510,183,327
050,29,055,"Missouri","Crawford County",5,0,237,114,123
050,29,055,"Missouri","Crawford County",5,1,239,121,118
050,29,055,"Missouri","Crawford County",5,2,254,131,123
050,29,055,"Missouri","Crawford County",5,3,229,110,119
050,29,055,"Missouri","Crawford County",5,4,265,137,128
050,29,055,"Missouri","Crawford County",5,5,272,152,120
050,29,055,"Missouri","Crawford County",5,6,256,133,123
050,29,055,"Missouri","Crawford County",5,7,238,126,112
050,29,055,"Missouri","Crawford County",5,8,283,147,136
050,29,055,"Missouri","Crawford County",5,9,288,145,143
050,29,055,"Missouri","Crawford County",5,10,298,150,148
050,29,055,"Missouri","Crawford County",5,11,241,115,126
050,29,055,"Missouri","Crawford County",5,12,272,135,137
050,29,055,"Missouri","Crawford County",5,13,277,134,143
050,29,055,"Missouri","Crawford County",5,14,314,152,162
050,29,055,"Missouri","Crawford County",5,15,336,166,170
050,29,055,"Missouri","Crawford County",5,16,360,176,184
050,29,055,"Missouri","Crawford County",5,17,345,154,191
050,29,055,"Missouri","Crawford County",5,18,270,148,122
050,29,055,"Missouri","Crawford County",5,19,200,104,96
050,29,055,"Missouri","Crawford County",5,20,215,115,100
050,29,055,"Missouri","Crawford County",5,21,229,130,99
050,29,055,"Missouri","Crawford County",5,22,236,113,123
050,29,055,"Missouri","Crawford County",5,23,253,130,123
050,29,055,"Missouri","Crawford County",5,24,243,123,120
050,29,055,"Missouri","Crawford County",5,25,247,126,121
050,29,055,"Missouri","Crawford County",5,26,251,135,116
050,29,055,"Missouri","Crawford County",5,27,259,141,118
050,29,055,"Missouri","Crawford County",5,28,265,141,124
050,29,055,"Missouri","Crawford County",5,29,270,148,122
050,29,055,"Missouri","Crawford County",5,30,261,124,137
050,29,055,"Missouri","Crawford County",5,31,263,128,135
050,29,055,"Missouri","Crawford County",5,32,273,139,134
050,29,055,"Missouri","Crawford County",5,33,275,146,129
050,29,055,"Missouri","Crawford County",5,34,261,133,128
050,29,055,"Missouri","Crawford County",5,35,252,131,121
050,29,055,"Missouri","Crawford County",5,36,251,128,123
050,29,055,"Missouri","Crawford County",5,37,258,138,120
050,29,055,"Missouri","Crawford County",5,38,257,123,134
050,29,055,"Missouri","Crawford County",5,39,252,113,139
050,29,055,"Missouri","Crawford County",5,40,269,124,145
050,29,055,"Missouri","Crawford County",5,41,272,141,131
050,29,055,"Missouri","Crawford County",5,42,272,141,131
050,29,055,"Missouri","Crawford County",5,43,258,141,117
050,29,055,"Missouri","Crawford County",5,44,272,145,127
050,29,055,"Missouri","Crawford County",5,45,283,150,133
050,29,055,"Missouri","Crawford County",5,46,257,130,127
050,29,055,"Missouri","Crawford County",5,47,232,110,122
050,29,055,"Missouri","Crawford County",5,48,247,112,135
050,29,055,"Missouri","Crawford County",5,49,229,111,118
050,29,055,"Missouri","Crawford County",5,50,240,132,108
050,29,055,"Missouri","Crawford County",5,51,269,141,128
050,29,055,"Missouri","Crawford County",5,52,291,146,145
050,29,055,"Missouri","Crawford County",5,53,299,148,151
050,29,055,"Missouri","Crawford County",5,54,279,137,142
050,29,055,"Missouri","Crawford County",5,55,279,147,132
050,29,055,"Missouri","Crawford County",5,56,292,148,144
050,29,055,"Missouri","Crawford County",5,57,288,143,145
050,29,055,"Missouri","Crawford County",5,58,320,141,179
050,29,055,"Missouri","Crawford County",5,59,349,159,190
050,29,055,"Missouri","Crawford County",5,60,364,172,192
050,29,055,"Missouri","Crawford County",5,61,366,185,181
050,29,055,"Missouri","Crawford County",5,62,341,173,168
050,29,055,"Missouri","Crawford County",5,63,359,187,172
050,29,055,"Missouri","Crawford County",5,64,384,201,183
050,29,055,"Missouri","Crawford County",5,65,363,185,178
050,29,055,"Missouri","Crawford County",5,66,333,175,158
050,29,055,"Missouri","Crawford County",5,67,343,166,177
050,29,055,"Missouri","Crawford County",5,68,317,143,174
050,29,055,"Missouri","Crawford County",5,69,298,145,153
050,29,055,"Missouri","Crawford County",5,70,268,136,132
050,29,055,"Missouri","Crawford County",5,71,245,128,117
050,29,055,"Missouri","Crawford County",5,72,249,128,121
050,29,055,"Missouri","Crawford County",5,73,210,110,100
050,29,055,"Missouri","Crawford County",5,74,239,114,125
050,29,055,"Missouri","Crawford County",5,75,234,113,121
050,29,055,"Missouri","Crawford County",5,76,235,106,129
050,29,055,"Missouri","Crawford County",5,77,168,77,91
050,29,055,"Missouri","Crawford County",5,78,172,86,86
050,29,055,"Missouri","Crawford County",5,79,149,75,74
050,29,055,"Missouri","Crawford County",5,80,147,66,81
050,29,055,"Missouri","Crawford County",5,81,116,48,68
050,29,055,"Missouri","Crawford County",5,82,92,39,53
050,29,055,"Missouri","Crawford County",5,83,77,26,51
050,29,055,"Missouri","Crawford County",5,84,77,28,49
050,29,055,"Missouri","Crawford County",5,85,531,192,339
050,29,057,"Missouri","Dade County",1,0,72,37,35
050,29,057,"Missouri","Dade County",1,1,75,40,35
050,29,057,"Missouri","Dade County",1,2,72,44,28
050,29,057,"Missouri","Dade County",1,3,77,48,29
050,29,057,"Missouri","Dade County",1,4,72,40,32
050,29,057,"Missouri","Dade County",1,5,82,44,38
050,29,057,"Missouri","Dade County",1,6,70,37,33
050,29,057,"Missouri","Dade County",1,7,85,47,38
050,29,057,"Missouri","Dade County",1,8,101,50,51
050,29,057,"Missouri","Dade County",1,9,96,49,47
050,29,057,"Missouri","Dade County",1,10,90,51,39
050,29,057,"Missouri","Dade County",1,11,93,54,39
050,29,057,"Missouri","Dade County",1,12,100,57,43
050,29,057,"Missouri","Dade County",1,13,107,60,47
050,29,057,"Missouri","Dade County",1,14,113,60,53
050,29,057,"Missouri","Dade County",1,15,104,63,41
050,29,057,"Missouri","Dade County",1,16,96,65,31
050,29,057,"Missouri","Dade County",1,17,105,56,49
050,29,057,"Missouri","Dade County",1,18,83,44,39
050,29,057,"Missouri","Dade County",1,19,63,34,29
050,29,057,"Missouri","Dade County",1,20,68,38,30
050,29,057,"Missouri","Dade County",1,21,68,36,32
050,29,057,"Missouri","Dade County",1,22,72,44,28
050,29,057,"Missouri","Dade County",1,23,73,35,38
050,29,057,"Missouri","Dade County",1,24,67,36,31
050,29,057,"Missouri","Dade County",1,25,65,34,31
050,29,057,"Missouri","Dade County",1,26,73,36,37
050,29,057,"Missouri","Dade County",1,27,73,45,28
050,29,057,"Missouri","Dade County",1,28,77,46,31
050,29,057,"Missouri","Dade County",1,29,63,30,33
050,29,057,"Missouri","Dade County",1,30,66,30,36
050,29,057,"Missouri","Dade County",1,31,70,35,35
050,29,057,"Missouri","Dade County",1,32,60,30,30
050,29,057,"Missouri","Dade County",1,33,66,36,30
050,29,057,"Missouri","Dade County",1,34,70,35,35
050,29,057,"Missouri","Dade County",1,35,88,44,44
050,29,057,"Missouri","Dade County",1,36,75,37,38
050,29,057,"Missouri","Dade County",1,37,91,42,49
050,29,057,"Missouri","Dade County",1,38,88,44,44
050,29,057,"Missouri","Dade County",1,39,90,39,51
050,29,057,"Missouri","Dade County",1,40,94,45,49
050,29,057,"Missouri","Dade County",1,41,96,50,46
050,29,057,"Missouri","Dade County",1,42,88,50,38
050,29,057,"Missouri","Dade County",1,43,77,48,29
050,29,057,"Missouri","Dade County",1,44,82,46,36
050,29,057,"Missouri","Dade County",1,45,89,48,41
050,29,057,"Missouri","Dade County",1,46,81,41,40
050,29,057,"Missouri","Dade County",1,47,79,45,34
050,29,057,"Missouri","Dade County",1,48,96,56,40
050,29,057,"Missouri","Dade County",1,49,102,58,44
050,29,057,"Missouri","Dade County",1,50,79,37,42
050,29,057,"Missouri","Dade County",1,51,89,43,46
050,29,057,"Missouri","Dade County",1,52,89,47,42
050,29,057,"Missouri","Dade County",1,53,99,56,43
050,29,057,"Missouri","Dade County",1,54,95,45,50
050,29,057,"Missouri","Dade County",1,55,105,45,60
050,29,057,"Missouri","Dade County",1,56,131,66,65
050,29,057,"Missouri","Dade County",1,57,125,70,55
050,29,057,"Missouri","Dade County",1,58,127,61,66
050,29,057,"Missouri","Dade County",1,59,121,63,58
050,29,057,"Missouri","Dade County",1,60,113,61,52
050,29,057,"Missouri","Dade County",1,61,107,47,60
050,29,057,"Missouri","Dade County",1,62,125,53,72
050,29,057,"Missouri","Dade County",1,63,134,62,72
050,29,057,"Missouri","Dade County",1,64,128,61,67
050,29,057,"Missouri","Dade County",1,65,130,64,66
050,29,057,"Missouri","Dade County",1,66,118,60,58
050,29,057,"Missouri","Dade County",1,67,120,64,56
050,29,057,"Missouri","Dade County",1,68,119,57,62
050,29,057,"Missouri","Dade County",1,69,119,63,56
050,29,057,"Missouri","Dade County",1,70,96,58,38
050,29,057,"Missouri","Dade County",1,71,89,53,36
050,29,057,"Missouri","Dade County",1,72,89,45,44
050,29,057,"Missouri","Dade County",1,73,84,43,41
050,29,057,"Missouri","Dade County",1,74,66,36,30
050,29,057,"Missouri","Dade County",1,75,70,30,40
050,29,057,"Missouri","Dade County",1,76,69,26,43
050,29,057,"Missouri","Dade County",1,77,76,32,44
050,29,057,"Missouri","Dade County",1,78,59,31,28
050,29,057,"Missouri","Dade County",1,79,55,26,29
050,29,057,"Missouri","Dade County",1,80,47,19,28
050,29,057,"Missouri","Dade County",1,81,50,22,28
050,29,057,"Missouri","Dade County",1,82,46,23,23
050,29,057,"Missouri","Dade County",1,83,33,15,18
050,29,057,"Missouri","Dade County",1,84,33,11,22
050,29,057,"Missouri","Dade County",1,85,230,79,151
050,29,057,"Missouri","Dade County",2,0,70,37,33
050,29,057,"Missouri","Dade County",2,1,75,39,36
050,29,057,"Missouri","Dade County",2,2,74,44,30
050,29,057,"Missouri","Dade County",2,3,76,47,29
050,29,057,"Missouri","Dade County",2,4,75,43,32
050,29,057,"Missouri","Dade County",2,5,80,44,36
050,29,057,"Missouri","Dade County",2,6,75,40,35
050,29,057,"Missouri","Dade County",2,7,83,45,38
050,29,057,"Missouri","Dade County",2,8,97,49,48
050,29,057,"Missouri","Dade County",2,9,96,49,47
050,29,057,"Missouri","Dade County",2,10,92,52,40
050,29,057,"Missouri","Dade County",2,11,92,53,39
050,29,057,"Missouri","Dade County",2,12,101,57,44
050,29,057,"Missouri","Dade County",2,13,107,61,46
050,29,057,"Missouri","Dade County",2,14,114,62,52
050,29,057,"Missouri","Dade County",2,15,105,62,43
050,29,057,"Missouri","Dade County",2,16,99,64,35
050,29,057,"Missouri","Dade County",2,17,103,59,44
050,29,057,"Missouri","Dade County",2,18,83,45,38
050,29,057,"Missouri","Dade County",2,19,63,34,29
050,29,057,"Missouri","Dade County",2,20,68,37,31
050,29,057,"Missouri","Dade County",2,21,68,37,31
050,29,057,"Missouri","Dade County",2,22,69,42,27
050,29,057,"Missouri","Dade County",2,23,75,38,37
050,29,057,"Missouri","Dade County",2,24,70,37,33
050,29,057,"Missouri","Dade County",2,25,67,35,32
050,29,057,"Missouri","Dade County",2,26,72,36,36
050,29,057,"Missouri","Dade County",2,27,72,43,29
050,29,057,"Missouri","Dade County",2,28,75,45,30
050,29,057,"Missouri","Dade County",2,29,67,34,33
050,29,057,"Missouri","Dade County",2,30,66,31,35
050,29,057,"Missouri","Dade County",2,31,70,34,36
050,29,057,"Missouri","Dade County",2,32,64,32,32
050,29,057,"Missouri","Dade County",2,33,65,35,30
050,29,057,"Missouri","Dade County",2,34,70,36,34
050,29,057,"Missouri","Dade County",2,35,84,41,43
050,29,057,"Missouri","Dade County",2,36,78,38,40
050,29,057,"Missouri","Dade County",2,37,88,41,47
050,29,057,"Missouri","Dade County",2,38,90,44,46
050,29,057,"Missouri","Dade County",2,39,91,41,50
050,29,057,"Missouri","Dade County",2,40,93,44,49
050,29,057,"Missouri","Dade County",2,41,96,49,47
050,29,057,"Missouri","Dade County",2,42,88,49,39
050,29,057,"Missouri","Dade County",2,43,82,49,33
050,29,057,"Missouri","Dade County",2,44,80,46,34
050,29,057,"Missouri","Dade County",2,45,88,48,40
050,29,057,"Missouri","Dade County",2,46,82,43,39
050,29,057,"Missouri","Dade County",2,47,80,44,36
050,29,057,"Missouri","Dade County",2,48,91,53,38
050,29,057,"Missouri","Dade County",2,49,102,58,44
050,29,057,"Missouri","Dade County",2,50,86,42,44
050,29,057,"Missouri","Dade County",2,51,85,41,44
050,29,057,"Missouri","Dade County",2,52,88,46,42
050,29,057,"Missouri","Dade County",2,53,97,55,42
050,29,057,"Missouri","Dade County",2,54,98,49,49
050,29,057,"Missouri","Dade County",2,55,104,46,58
050,29,057,"Missouri","Dade County",2,56,126,62,64
050,29,057,"Missouri","Dade County",2,57,126,68,58
050,29,057,"Missouri","Dade County",2,58,127,63,64
050,29,057,"Missouri","Dade County",2,59,122,62,60
050,29,057,"Missouri","Dade County",2,60,115,62,53
050,29,057,"Missouri","Dade County",2,61,107,49,58
050,29,057,"Missouri","Dade County",2,62,121,52,69
050,29,057,"Missouri","Dade County",2,63,133,60,73
050,29,057,"Missouri","Dade County",2,64,128,61,67
050,29,057,"Missouri","Dade County",2,65,131,64,67
050,29,057,"Missouri","Dade County",2,66,122,61,61
050,29,057,"Missouri","Dade County",2,67,120,64,56
050,29,057,"Missouri","Dade County",2,68,116,57,59
050,29,057,"Missouri","Dade County",2,69,120,63,57
050,29,057,"Missouri","Dade County",2,70,101,59,42
050,29,057,"Missouri","Dade County",2,71,87,52,35
050,29,057,"Missouri","Dade County",2,72,87,45,42
050,29,057,"Missouri","Dade County",2,73,89,46,43
050,29,057,"Missouri","Dade County",2,74,64,33,31
050,29,057,"Missouri","Dade County",2,75,70,32,38
050,29,057,"Missouri","Dade County",2,76,66,25,41
050,29,057,"Missouri","Dade County",2,77,77,31,46
050,29,057,"Missouri","Dade County",2,78,60,30,30
050,29,057,"Missouri","Dade County",2,79,54,26,28
050,29,057,"Missouri","Dade County",2,80,49,21,28
050,29,057,"Missouri","Dade County",2,81,49,21,28
050,29,057,"Missouri","Dade County",2,82,46,23,23
050,29,057,"Missouri","Dade County",2,83,35,17,18
050,29,057,"Missouri","Dade County",2,84,35,12,23
050,29,057,"Missouri","Dade County",2,85,232,80,152
050,29,057,"Missouri","Dade County",3,0,68,35,33
050,29,057,"Missouri","Dade County",3,1,78,41,37
050,29,057,"Missouri","Dade County",3,2,77,42,35
050,29,057,"Missouri","Dade County",3,3,80,49,31
050,29,057,"Missouri","Dade County",3,4,72,42,30
050,29,057,"Missouri","Dade County",3,5,77,38,39
050,29,057,"Missouri","Dade County",3,6,74,43,31
050,29,057,"Missouri","Dade County",3,7,76,39,37
050,29,057,"Missouri","Dade County",3,8,80,45,35
050,29,057,"Missouri","Dade County",3,9,94,46,48
050,29,057,"Missouri","Dade County",3,10,94,43,51
050,29,057,"Missouri","Dade County",3,11,95,52,43
050,29,057,"Missouri","Dade County",3,12,92,48,44
050,29,057,"Missouri","Dade County",3,13,105,58,47
050,29,057,"Missouri","Dade County",3,14,104,57,47
050,29,057,"Missouri","Dade County",3,15,111,60,51
050,29,057,"Missouri","Dade County",3,16,109,63,46
050,29,057,"Missouri","Dade County",3,17,102,68,34
050,29,057,"Missouri","Dade County",3,18,85,50,35
050,29,057,"Missouri","Dade County",3,19,61,34,27
050,29,057,"Missouri","Dade County",3,20,62,34,28
050,29,057,"Missouri","Dade County",3,21,72,38,34
050,29,057,"Missouri","Dade County",3,22,71,35,36
050,29,057,"Missouri","Dade County",3,23,73,45,28
050,29,057,"Missouri","Dade County",3,24,82,39,43
050,29,057,"Missouri","Dade County",3,25,64,29,35
050,29,057,"Missouri","Dade County",3,26,63,34,29
050,29,057,"Missouri","Dade County",3,27,64,31,33
050,29,057,"Missouri","Dade County",3,28,79,45,34
050,29,057,"Missouri","Dade County",3,29,74,45,29
050,29,057,"Missouri","Dade County",3,30,64,32,32
050,29,057,"Missouri","Dade County",3,31,75,38,37
050,29,057,"Missouri","Dade County",3,32,70,33,37
050,29,057,"Missouri","Dade County",3,33,66,34,32
050,29,057,"Missouri","Dade County",3,34,65,33,32
050,29,057,"Missouri","Dade County",3,35,75,39,36
050,29,057,"Missouri","Dade County",3,36,77,36,41
050,29,057,"Missouri","Dade County",3,37,82,39,43
050,29,057,"Missouri","Dade County",3,38,90,45,45
050,29,057,"Missouri","Dade County",3,39,91,43,48
050,29,057,"Missouri","Dade County",3,40,86,40,46
050,29,057,"Missouri","Dade County",3,41,94,44,50
050,29,057,"Missouri","Dade County",3,42,99,51,48
050,29,057,"Missouri","Dade County",3,43,95,54,41
050,29,057,"Missouri","Dade County",3,44,85,50,35
050,29,057,"Missouri","Dade County",3,45,86,50,36
050,29,057,"Missouri","Dade County",3,46,88,45,43
050,29,057,"Missouri","Dade County",3,47,84,43,41
050,29,057,"Missouri","Dade County",3,48,80,44,36
050,29,057,"Missouri","Dade County",3,49,89,53,36
050,29,057,"Missouri","Dade County",3,50,101,56,45
050,29,057,"Missouri","Dade County",3,51,85,42,43
050,29,057,"Missouri","Dade County",3,52,87,42,45
050,29,057,"Missouri","Dade County",3,53,83,43,40
050,29,057,"Missouri","Dade County",3,54,107,57,50
050,29,057,"Missouri","Dade County",3,55,97,47,50
050,29,057,"Missouri","Dade County",3,56,113,51,62
050,29,057,"Missouri","Dade County",3,57,127,64,63
050,29,057,"Missouri","Dade County",3,58,138,75,63
050,29,057,"Missouri","Dade County",3,59,126,63,63
050,29,057,"Missouri","Dade County",3,60,124,66,58
050,29,057,"Missouri","Dade County",3,61,117,61,56
050,29,057,"Missouri","Dade County",3,62,110,49,61
050,29,057,"Missouri","Dade County",3,63,130,58,72
050,29,057,"Missouri","Dade County",3,64,132,56,76
050,29,057,"Missouri","Dade County",3,65,129,63,66
050,29,057,"Missouri","Dade County",3,66,130,64,66
050,29,057,"Missouri","Dade County",3,67,115,59,56
050,29,057,"Missouri","Dade County",3,68,115,57,58
050,29,057,"Missouri","Dade County",3,69,118,62,56
050,29,057,"Missouri","Dade County",3,70,115,59,56
050,29,057,"Missouri","Dade County",3,71,98,58,40
050,29,057,"Missouri","Dade County",3,72,83,47,36
050,29,057,"Missouri","Dade County",3,73,85,43,42
050,29,057,"Missouri","Dade County",3,74,80,43,37
050,29,057,"Missouri","Dade County",3,75,67,34,33
050,29,057,"Missouri","Dade County",3,76,64,29,35
050,29,057,"Missouri","Dade County",3,77,67,26,41
050,29,057,"Missouri","Dade County",3,78,73,28,45
050,29,057,"Missouri","Dade County",3,79,58,28,30
050,29,057,"Missouri","Dade County",3,80,57,30,27
050,29,057,"Missouri","Dade County",3,81,46,17,29
050,29,057,"Missouri","Dade County",3,82,43,20,23
050,29,057,"Missouri","Dade County",3,83,39,19,20
050,29,057,"Missouri","Dade County",3,84,37,16,21
050,29,057,"Missouri","Dade County",3,85,221,71,150
050,29,057,"Missouri","Dade County",4,0,59,31,28
050,29,057,"Missouri","Dade County",4,1,73,35,38
050,29,057,"Missouri","Dade County",4,2,66,33,33
050,29,057,"Missouri","Dade County",4,3,80,43,37
050,29,057,"Missouri","Dade County",4,4,85,52,33
050,29,057,"Missouri","Dade County",4,5,77,46,31
050,29,057,"Missouri","Dade County",4,6,82,44,38
050,29,057,"Missouri","Dade County",4,7,85,50,35
050,29,057,"Missouri","Dade County",4,8,90,44,46
050,29,057,"Missouri","Dade County",4,9,84,49,35
050,29,057,"Missouri","Dade County",4,10,98,46,52
050,29,057,"Missouri","Dade County",4,11,100,51,49
050,29,057,"Missouri","Dade County",4,12,100,56,44
050,29,057,"Missouri","Dade County",4,13,93,49,44
050,29,057,"Missouri","Dade County",4,14,103,56,47
050,29,057,"Missouri","Dade County",4,15,107,56,51
050,29,057,"Missouri","Dade County",4,16,108,58,50
050,29,057,"Missouri","Dade County",4,17,111,63,48
050,29,057,"Missouri","Dade County",4,18,80,53,27
050,29,057,"Missouri","Dade County",4,19,64,35,29
050,29,057,"Missouri","Dade County",4,20,54,29,25
050,29,057,"Missouri","Dade County",4,21,61,30,31
050,29,057,"Missouri","Dade County",4,22,78,39,39
050,29,057,"Missouri","Dade County",4,23,78,38,40
050,29,057,"Missouri","Dade County",4,24,65,41,24
050,29,057,"Missouri","Dade County",4,25,76,37,39
050,29,057,"Missouri","Dade County",4,26,68,29,39
050,29,057,"Missouri","Dade County",4,27,59,33,26
050,29,057,"Missouri","Dade County",4,28,61,30,31
050,29,057,"Missouri","Dade County",4,29,84,49,35
050,29,057,"Missouri","Dade County",4,30,79,49,30
050,29,057,"Missouri","Dade County",4,31,69,36,33
050,29,057,"Missouri","Dade County",4,32,76,34,42
050,29,057,"Missouri","Dade County",4,33,81,41,40
050,29,057,"Missouri","Dade County",4,34,74,41,33
050,29,057,"Missouri","Dade County",4,35,67,33,34
050,29,057,"Missouri","Dade County",4,36,79,38,41
050,29,057,"Missouri","Dade County",4,37,85,39,46
050,29,057,"Missouri","Dade County",4,38,83,40,43
050,29,057,"Missouri","Dade County",4,39,97,48,49
050,29,057,"Missouri","Dade County",4,40,90,46,44
050,29,057,"Missouri","Dade County",4,41,88,40,48
050,29,057,"Missouri","Dade County",4,42,94,45,49
050,29,057,"Missouri","Dade County",4,43,104,54,50
050,29,057,"Missouri","Dade County",4,44,100,54,46
050,29,057,"Missouri","Dade County",4,45,86,50,36
050,29,057,"Missouri","Dade County",4,46,87,51,36
050,29,057,"Missouri","Dade County",4,47,93,49,44
050,29,057,"Missouri","Dade County",4,48,86,47,39
050,29,057,"Missouri","Dade County",4,49,89,49,40
050,29,057,"Missouri","Dade County",4,50,95,57,38
050,29,057,"Missouri","Dade County",4,51,106,58,48
050,29,057,"Missouri","Dade County",4,52,83,37,46
050,29,057,"Missouri","Dade County",4,53,90,44,46
050,29,057,"Missouri","Dade County",4,54,89,47,42
050,29,057,"Missouri","Dade County",4,55,106,55,51
050,29,057,"Missouri","Dade County",4,56,101,49,52
050,29,057,"Missouri","Dade County",4,57,106,51,55
050,29,057,"Missouri","Dade County",4,58,129,65,64
050,29,057,"Missouri","Dade County",4,59,137,72,65
050,29,057,"Missouri","Dade County",4,60,123,62,61
050,29,057,"Missouri","Dade County",4,61,122,64,58
050,29,057,"Missouri","Dade County",4,62,125,68,57
050,29,057,"Missouri","Dade County",4,63,114,47,67
050,29,057,"Missouri","Dade County",4,64,129,60,69
050,29,057,"Missouri","Dade County",4,65,126,54,72
050,29,057,"Missouri","Dade County",4,66,124,61,63
050,29,057,"Missouri","Dade County",4,67,130,64,66
050,29,057,"Missouri","Dade County",4,68,112,58,54
050,29,057,"Missouri","Dade County",4,69,121,63,58
050,29,057,"Missouri","Dade County",4,70,105,55,50
050,29,057,"Missouri","Dade County",4,71,108,56,52
050,29,057,"Missouri","Dade County",4,72,93,53,40
050,29,057,"Missouri","Dade County",4,73,85,44,41
050,29,057,"Missouri","Dade County",4,74,76,40,36
050,29,057,"Missouri","Dade County",4,75,83,43,40
050,29,057,"Missouri","Dade County",4,76,57,31,26
050,29,057,"Missouri","Dade County",4,77,65,28,37
050,29,057,"Missouri","Dade County",4,78,63,24,39
050,29,057,"Missouri","Dade County",4,79,71,25,46
050,29,057,"Missouri","Dade County",4,80,59,29,30
050,29,057,"Missouri","Dade County",4,81,56,29,27
050,29,057,"Missouri","Dade County",4,82,37,14,23
050,29,057,"Missouri","Dade County",4,83,40,16,24
050,29,057,"Missouri","Dade County",4,84,45,20,25
050,29,057,"Missouri","Dade County",4,85,218,68,150
050,29,057,"Missouri","Dade County",5,0,60,31,29
050,29,057,"Missouri","Dade County",5,1,61,29,32
050,29,057,"Missouri","Dade County",5,2,73,38,35
050,29,057,"Missouri","Dade County",5,3,74,43,31
050,29,057,"Missouri","Dade County",5,4,84,44,40
050,29,057,"Missouri","Dade County",5,5,88,50,38
050,29,057,"Missouri","Dade County",5,6,83,48,35
050,29,057,"Missouri","Dade County",5,7,79,45,34
050,29,057,"Missouri","Dade County",5,8,80,47,33
050,29,057,"Missouri","Dade County",5,9,83,41,42
050,29,057,"Missouri","Dade County",5,10,85,50,35
050,29,057,"Missouri","Dade County",5,11,105,57,48
050,29,057,"Missouri","Dade County",5,12,104,51,53
050,29,057,"Missouri","Dade County",5,13,104,55,49
050,29,057,"Missouri","Dade County",5,14,99,54,45
050,29,057,"Missouri","Dade County",5,15,100,55,45
050,29,057,"Missouri","Dade County",5,16,112,60,52
050,29,057,"Missouri","Dade County",5,17,109,59,50
050,29,057,"Missouri","Dade County",5,18,85,51,34
050,29,057,"Missouri","Dade County",5,19,67,45,22
050,29,057,"Missouri","Dade County",5,20,71,39,32
050,29,057,"Missouri","Dade County",5,21,51,23,28
050,29,057,"Missouri","Dade County",5,22,69,32,37
050,29,057,"Missouri","Dade County",5,23,79,43,36
050,29,057,"Missouri","Dade County",5,24,81,39,42
050,29,057,"Missouri","Dade County",5,25,66,40,26
050,29,057,"Missouri","Dade County",5,26,78,38,40
050,29,057,"Missouri","Dade County",5,27,67,28,39
050,29,057,"Missouri","Dade County",5,28,63,33,30
050,29,057,"Missouri","Dade County",5,29,65,32,33
050,29,057,"Missouri","Dade County",5,30,93,56,37
050,29,057,"Missouri","Dade County",5,31,74,46,28
050,29,057,"Missouri","Dade County",5,32,77,40,37
050,29,057,"Missouri","Dade County",5,33,67,28,39
050,29,057,"Missouri","Dade County",5,34,87,47,40
050,29,057,"Missouri","Dade County",5,35,76,41,35
050,29,057,"Missouri","Dade County",5,36,65,33,32
050,29,057,"Missouri","Dade County",5,37,77,36,41
050,29,057,"Missouri","Dade County",5,38,90,41,49
050,29,057,"Missouri","Dade County",5,39,85,37,48
050,29,057,"Missouri","Dade County",5,40,96,49,47
050,29,057,"Missouri","Dade County",5,41,91,46,45
050,29,057,"Missouri","Dade County",5,42,91,43,48
050,29,057,"Missouri","Dade County",5,43,95,46,49
050,29,057,"Missouri","Dade County",5,44,110,56,54
050,29,057,"Missouri","Dade County",5,45,100,51,49
050,29,057,"Missouri","Dade County",5,46,86,51,35
050,29,057,"Missouri","Dade County",5,47,92,54,38
050,29,057,"Missouri","Dade County",5,48,103,54,49
050,29,057,"Missouri","Dade County",5,49,87,45,42
050,29,057,"Missouri","Dade County",5,50,92,53,39
050,29,057,"Missouri","Dade County",5,51,98,59,39
050,29,057,"Missouri","Dade County",5,52,107,58,49
050,29,057,"Missouri","Dade County",5,53,91,39,52
050,29,057,"Missouri","Dade County",5,54,97,49,48
050,29,057,"Missouri","Dade County",5,55,92,48,44
050,29,057,"Missouri","Dade County",5,56,105,54,51
050,29,057,"Missouri","Dade County",5,57,102,54,48
050,29,057,"Missouri","Dade County",5,58,117,55,62
050,29,057,"Missouri","Dade County",5,59,131,65,66
050,29,057,"Missouri","Dade County",5,60,137,70,67
050,29,057,"Missouri","Dade County",5,61,129,62,67
050,29,057,"Missouri","Dade County",5,62,130,68,62
050,29,057,"Missouri","Dade County",5,63,127,66,61
050,29,057,"Missouri","Dade County",5,64,108,45,63
050,29,057,"Missouri","Dade County",5,65,125,55,70
050,29,057,"Missouri","Dade County",5,66,128,55,73
050,29,057,"Missouri","Dade County",5,67,119,59,60
050,29,057,"Missouri","Dade County",5,68,127,62,65
050,29,057,"Missouri","Dade County",5,69,113,60,53
050,29,057,"Missouri","Dade County",5,70,109,56,53
050,29,057,"Missouri","Dade County",5,71,100,53,47
050,29,057,"Missouri","Dade County",5,72,101,51,50
050,29,057,"Missouri","Dade County",5,73,91,52,39
050,29,057,"Missouri","Dade County",5,74,79,40,39
050,29,057,"Missouri","Dade County",5,75,79,40,39
050,29,057,"Missouri","Dade County",5,76,74,39,35
050,29,057,"Missouri","Dade County",5,77,59,32,27
050,29,057,"Missouri","Dade County",5,78,61,26,35
050,29,057,"Missouri","Dade County",5,79,57,23,34
050,29,057,"Missouri","Dade County",5,80,68,24,44
050,29,057,"Missouri","Dade County",5,81,54,27,27
050,29,057,"Missouri","Dade County",5,82,46,25,21
050,29,057,"Missouri","Dade County",5,83,31,10,21
050,29,057,"Missouri","Dade County",5,84,40,15,25
050,29,057,"Missouri","Dade County",5,85,225,71,154
050,29,059,"Missouri","Dallas County",1,0,231,118,113
050,29,059,"Missouri","Dallas County",1,1,232,123,109
050,29,059,"Missouri","Dallas County",1,2,219,114,105
050,29,059,"Missouri","Dallas County",1,3,220,123,97
050,29,059,"Missouri","Dallas County",1,4,218,115,103
050,29,059,"Missouri","Dallas County",1,5,220,116,104
050,29,059,"Missouri","Dallas County",1,6,210,111,99
050,29,059,"Missouri","Dallas County",1,7,213,85,128
050,29,059,"Missouri","Dallas County",1,8,208,101,107
050,29,059,"Missouri","Dallas County",1,9,209,101,108
050,29,059,"Missouri","Dallas County",1,10,220,115,105
050,29,059,"Missouri","Dallas County",1,11,248,130,118
050,29,059,"Missouri","Dallas County",1,12,265,138,127
050,29,059,"Missouri","Dallas County",1,13,241,131,110
050,29,059,"Missouri","Dallas County",1,14,236,130,106
050,29,059,"Missouri","Dallas County",1,15,255,128,127
050,29,059,"Missouri","Dallas County",1,16,236,113,123
050,29,059,"Missouri","Dallas County",1,17,223,99,124
050,29,059,"Missouri","Dallas County",1,18,198,100,98
050,29,059,"Missouri","Dallas County",1,19,136,81,55
050,29,059,"Missouri","Dallas County",1,20,150,79,71
050,29,059,"Missouri","Dallas County",1,21,143,75,68
050,29,059,"Missouri","Dallas County",1,22,155,83,72
050,29,059,"Missouri","Dallas County",1,23,163,80,83
050,29,059,"Missouri","Dallas County",1,24,157,81,76
050,29,059,"Missouri","Dallas County",1,25,182,94,88
050,29,059,"Missouri","Dallas County",1,26,188,94,94
050,29,059,"Missouri","Dallas County",1,27,174,86,88
050,29,059,"Missouri","Dallas County",1,28,210,95,115
050,29,059,"Missouri","Dallas County",1,29,221,98,123
050,29,059,"Missouri","Dallas County",1,30,209,91,118
050,29,059,"Missouri","Dallas County",1,31,207,103,104
050,29,059,"Missouri","Dallas County",1,32,184,86,98
050,29,059,"Missouri","Dallas County",1,33,171,81,90
050,29,059,"Missouri","Dallas County",1,34,188,99,89
050,29,059,"Missouri","Dallas County",1,35,172,85,87
050,29,059,"Missouri","Dallas County",1,36,201,107,94
050,29,059,"Missouri","Dallas County",1,37,185,94,91
050,29,059,"Missouri","Dallas County",1,38,188,98,90
050,29,059,"Missouri","Dallas County",1,39,203,103,100
050,29,059,"Missouri","Dallas County",1,40,182,95,87
050,29,059,"Missouri","Dallas County",1,41,198,98,100
050,29,059,"Missouri","Dallas County",1,42,187,100,87
050,29,059,"Missouri","Dallas County",1,43,172,90,82
050,29,059,"Missouri","Dallas County",1,44,169,83,86
050,29,059,"Missouri","Dallas County",1,45,191,92,99
050,29,059,"Missouri","Dallas County",1,46,188,91,97
050,29,059,"Missouri","Dallas County",1,47,188,93,95
050,29,059,"Missouri","Dallas County",1,48,188,105,83
050,29,059,"Missouri","Dallas County",1,49,203,105,98
050,29,059,"Missouri","Dallas County",1,50,188,89,99
050,29,059,"Missouri","Dallas County",1,51,223,108,115
050,29,059,"Missouri","Dallas County",1,52,206,104,102
050,29,059,"Missouri","Dallas County",1,53,209,106,103
050,29,059,"Missouri","Dallas County",1,54,208,108,100
050,29,059,"Missouri","Dallas County",1,55,237,118,119
050,29,059,"Missouri","Dallas County",1,56,260,131,129
050,29,059,"Missouri","Dallas County",1,57,248,120,128
050,29,059,"Missouri","Dallas County",1,58,259,132,127
050,29,059,"Missouri","Dallas County",1,59,258,128,130
050,29,059,"Missouri","Dallas County",1,60,292,157,135
050,29,059,"Missouri","Dallas County",1,61,269,129,140
050,29,059,"Missouri","Dallas County",1,62,270,126,144
050,29,059,"Missouri","Dallas County",1,63,255,128,127
050,29,059,"Missouri","Dallas County",1,64,255,131,124
050,29,059,"Missouri","Dallas County",1,65,259,130,129
050,29,059,"Missouri","Dallas County",1,66,241,121,120
050,29,059,"Missouri","Dallas County",1,67,229,121,108
050,29,059,"Missouri","Dallas County",1,68,212,105,107
050,29,059,"Missouri","Dallas County",1,69,197,93,104
050,29,059,"Missouri","Dallas County",1,70,218,111,107
050,29,059,"Missouri","Dallas County",1,71,193,102,91
050,29,059,"Missouri","Dallas County",1,72,179,92,87
050,29,059,"Missouri","Dallas County",1,73,174,85,89
050,29,059,"Missouri","Dallas County",1,74,131,60,71
050,29,059,"Missouri","Dallas County",1,75,141,72,69
050,29,059,"Missouri","Dallas County",1,76,139,64,75
050,29,059,"Missouri","Dallas County",1,77,137,66,71
050,29,059,"Missouri","Dallas County",1,78,132,67,65
050,29,059,"Missouri","Dallas County",1,79,106,48,58
050,29,059,"Missouri","Dallas County",1,80,90,40,50
050,29,059,"Missouri","Dallas County",1,81,90,41,49
050,29,059,"Missouri","Dallas County",1,82,77,33,44
050,29,059,"Missouri","Dallas County",1,83,74,37,37
050,29,059,"Missouri","Dallas County",1,84,65,29,36
050,29,059,"Missouri","Dallas County",1,85,390,136,254
050,29,059,"Missouri","Dallas County",2,0,242,130,112
050,29,059,"Missouri","Dallas County",2,1,232,122,110
050,29,059,"Missouri","Dallas County",2,2,223,118,105
050,29,059,"Missouri","Dallas County",2,3,219,121,98
050,29,059,"Missouri","Dallas County",2,4,219,117,102
050,29,059,"Missouri","Dallas County",2,5,220,116,104
050,29,059,"Missouri","Dallas County",2,6,214,112,102
050,29,059,"Missouri","Dallas County",2,7,211,90,121
050,29,059,"Missouri","Dallas County",2,8,208,97,111
050,29,059,"Missouri","Dallas County",2,9,208,100,108
050,29,059,"Missouri","Dallas County",2,10,219,113,106
050,29,059,"Missouri","Dallas County",2,11,245,129,116
050,29,059,"Missouri","Dallas County",2,12,262,136,126
050,29,059,"Missouri","Dallas County",2,13,249,134,115
050,29,059,"Missouri","Dallas County",2,14,238,130,108
050,29,059,"Missouri","Dallas County",2,15,253,130,123
050,29,059,"Missouri","Dallas County",2,16,241,116,125
050,29,059,"Missouri","Dallas County",2,17,225,101,124
050,29,059,"Missouri","Dallas County",2,18,192,96,96
050,29,059,"Missouri","Dallas County",2,19,142,80,62
050,29,059,"Missouri","Dallas County",2,20,152,82,70
050,29,059,"Missouri","Dallas County",2,21,147,77,70
050,29,059,"Missouri","Dallas County",2,22,157,84,73
050,29,059,"Missouri","Dallas County",2,23,162,82,80
050,29,059,"Missouri","Dallas County",2,24,160,81,79
050,29,059,"Missouri","Dallas County",2,25,176,90,86
050,29,059,"Missouri","Dallas County",2,26,188,95,93
050,29,059,"Missouri","Dallas County",2,27,181,89,92
050,29,059,"Missouri","Dallas County",2,28,201,94,107
050,29,059,"Missouri","Dallas County",2,29,218,96,122
050,29,059,"Missouri","Dallas County",2,30,214,95,119
050,29,059,"Missouri","Dallas County",2,31,205,99,106
050,29,059,"Missouri","Dallas County",2,32,192,92,100
050,29,059,"Missouri","Dallas County",2,33,175,83,92
050,29,059,"Missouri","Dallas County",2,34,185,96,89
050,29,059,"Missouri","Dallas County",2,35,180,92,88
050,29,059,"Missouri","Dallas County",2,36,196,103,93
050,29,059,"Missouri","Dallas County",2,37,191,98,93
050,29,059,"Missouri","Dallas County",2,38,187,96,91
050,29,059,"Missouri","Dallas County",2,39,199,101,98
050,29,059,"Missouri","Dallas County",2,40,190,99,91
050,29,059,"Missouri","Dallas County",2,41,195,97,98
050,29,059,"Missouri","Dallas County",2,42,191,102,89
050,29,059,"Missouri","Dallas County",2,43,178,94,84
050,29,059,"Missouri","Dallas County",2,44,170,85,85
050,29,059,"Missouri","Dallas County",2,45,186,89,97
050,29,059,"Missouri","Dallas County",2,46,190,92,98
050,29,059,"Missouri","Dallas County",2,47,190,94,96
050,29,059,"Missouri","Dallas County",2,48,191,104,87
050,29,059,"Missouri","Dallas County",2,49,202,106,96
050,29,059,"Missouri","Dallas County",2,50,192,93,99
050,29,059,"Missouri","Dallas County",2,51,217,104,113
050,29,059,"Missouri","Dallas County",2,52,208,104,104
050,29,059,"Missouri","Dallas County",2,53,207,105,102
050,29,059,"Missouri","Dallas County",2,54,206,106,100
050,29,059,"Missouri","Dallas County",2,55,231,117,114
050,29,059,"Missouri","Dallas County",2,56,255,128,127
050,29,059,"Missouri","Dallas County",2,57,253,124,129
050,29,059,"Missouri","Dallas County",2,58,253,127,126
050,29,059,"Missouri","Dallas County",2,59,262,131,131
050,29,059,"Missouri","Dallas County",2,60,283,150,133
050,29,059,"Missouri","Dallas County",2,61,270,135,135
050,29,059,"Missouri","Dallas County",2,62,269,126,143
050,29,059,"Missouri","Dallas County",2,63,264,130,134
050,29,059,"Missouri","Dallas County",2,64,250,128,122
050,29,059,"Missouri","Dallas County",2,65,258,130,128
050,29,059,"Missouri","Dallas County",2,66,243,121,122
050,29,059,"Missouri","Dallas County",2,67,232,120,112
050,29,059,"Missouri","Dallas County",2,68,213,106,107
050,29,059,"Missouri","Dallas County",2,69,202,97,105
050,29,059,"Missouri","Dallas County",2,70,211,107,104
050,29,059,"Missouri","Dallas County",2,71,200,105,95
050,29,059,"Missouri","Dallas County",2,72,180,93,87
050,29,059,"Missouri","Dallas County",2,73,184,91,93
050,29,059,"Missouri","Dallas County",2,74,130,60,70
050,29,059,"Missouri","Dallas County",2,75,141,70,71
050,29,059,"Missouri","Dallas County",2,76,137,64,73
050,29,059,"Missouri","Dallas County",2,77,141,67,74
050,29,059,"Missouri","Dallas County",2,78,126,63,63
050,29,059,"Missouri","Dallas County",2,79,109,52,57
050,29,059,"Missouri","Dallas County",2,80,95,42,53
050,29,059,"Missouri","Dallas County",2,81,88,39,49
050,29,059,"Missouri","Dallas County",2,82,81,35,46
050,29,059,"Missouri","Dallas County",2,83,72,35,37
050,29,059,"Missouri","Dallas County",2,84,67,30,37
050,29,059,"Missouri","Dallas County",2,85,387,134,253
050,29,059,"Missouri","Dallas County",3,0,204,104,100
050,29,059,"Missouri","Dallas County",3,1,251,137,114
050,29,059,"Missouri","Dallas County",3,2,227,128,99
050,29,059,"Missouri","Dallas County",3,3,235,124,111
050,29,059,"Missouri","Dallas County",3,4,215,117,98
050,29,059,"Missouri","Dallas County",3,5,220,116,104
050,29,059,"Missouri","Dallas County",3,6,236,119,117
050,29,059,"Missouri","Dallas County",3,7,221,116,105
050,29,059,"Missouri","Dallas County",3,8,220,98,122
050,29,059,"Missouri","Dallas County",3,9,204,93,111
050,29,059,"Missouri","Dallas County",3,10,219,110,109
050,29,059,"Missouri","Dallas County",3,11,223,123,100
050,29,059,"Missouri","Dallas County",3,12,253,130,123
050,29,059,"Missouri","Dallas County",3,13,264,131,133
050,29,059,"Missouri","Dallas County",3,14,257,135,122
050,29,059,"Missouri","Dallas County",3,15,236,125,111
050,29,059,"Missouri","Dallas County",3,16,254,131,123
050,29,059,"Missouri","Dallas County",3,17,247,119,128
050,29,059,"Missouri","Dallas County",3,18,200,99,101
050,29,059,"Missouri","Dallas County",3,19,153,83,70
050,29,059,"Missouri","Dallas County",3,20,156,89,67
050,29,059,"Missouri","Dallas County",3,21,168,87,81
050,29,059,"Missouri","Dallas County",3,22,151,78,73
050,29,059,"Missouri","Dallas County",3,23,169,89,80
050,29,059,"Missouri","Dallas County",3,24,171,87,84
050,29,059,"Missouri","Dallas County",3,25,162,85,77
050,29,059,"Missouri","Dallas County",3,26,179,98,81
050,29,059,"Missouri","Dallas County",3,27,187,92,95
050,29,059,"Missouri","Dallas County",3,28,184,88,96
050,29,059,"Missouri","Dallas County",3,29,213,102,111
050,29,059,"Missouri","Dallas County",3,30,231,103,128
050,29,059,"Missouri","Dallas County",3,31,221,97,124
050,29,059,"Missouri","Dallas County",3,32,198,99,99
050,29,059,"Missouri","Dallas County",3,33,189,88,101
050,29,059,"Missouri","Dallas County",3,34,163,72,91
050,29,059,"Missouri","Dallas County",3,35,185,96,89
050,29,059,"Missouri","Dallas County",3,36,177,93,84
050,29,059,"Missouri","Dallas County",3,37,202,102,100
050,29,059,"Missouri","Dallas County",3,38,208,109,99
050,29,059,"Missouri","Dallas County",3,39,204,108,96
050,29,059,"Missouri","Dallas County",3,40,201,103,98
050,29,059,"Missouri","Dallas County",3,41,188,97,91
050,29,059,"Missouri","Dallas County",3,42,206,100,106
050,29,059,"Missouri","Dallas County",3,43,192,103,89
050,29,059,"Missouri","Dallas County",3,44,184,96,88
050,29,059,"Missouri","Dallas County",3,45,182,90,92
050,29,059,"Missouri","Dallas County",3,46,192,93,99
050,29,059,"Missouri","Dallas County",3,47,194,92,102
050,29,059,"Missouri","Dallas County",3,48,208,111,97
050,29,059,"Missouri","Dallas County",3,49,204,112,92
050,29,059,"Missouri","Dallas County",3,50,206,110,96
050,29,059,"Missouri","Dallas County",3,51,194,90,104
050,29,059,"Missouri","Dallas County",3,52,218,105,113
050,29,059,"Missouri","Dallas County",3,53,208,105,103
050,29,059,"Missouri","Dallas County",3,54,217,108,109
050,29,059,"Missouri","Dallas County",3,55,205,108,97
050,29,059,"Missouri","Dallas County",3,56,224,115,109
050,29,059,"Missouri","Dallas County",3,57,264,134,130
050,29,059,"Missouri","Dallas County",3,58,251,123,128
050,29,059,"Missouri","Dallas County",3,59,255,127,128
050,29,059,"Missouri","Dallas County",3,60,269,139,130
050,29,059,"Missouri","Dallas County",3,61,287,153,134
050,29,059,"Missouri","Dallas County",3,62,269,135,134
050,29,059,"Missouri","Dallas County",3,63,271,129,142
050,29,059,"Missouri","Dallas County",3,64,270,134,136
050,29,059,"Missouri","Dallas County",3,65,251,125,126
050,29,059,"Missouri","Dallas County",3,66,248,127,121
050,29,059,"Missouri","Dallas County",3,67,257,131,126
050,29,059,"Missouri","Dallas County",3,68,227,118,109
050,29,059,"Missouri","Dallas County",3,69,206,102,104
050,29,059,"Missouri","Dallas County",3,70,197,96,101
050,29,059,"Missouri","Dallas County",3,71,205,107,98
050,29,059,"Missouri","Dallas County",3,72,187,98,89
050,29,059,"Missouri","Dallas County",3,73,179,88,91
050,29,059,"Missouri","Dallas County",3,74,169,85,84
050,29,059,"Missouri","Dallas County",3,75,129,58,71
050,29,059,"Missouri","Dallas County",3,76,127,62,65
050,29,059,"Missouri","Dallas County",3,77,135,65,70
050,29,059,"Missouri","Dallas County",3,78,132,64,68
050,29,059,"Missouri","Dallas County",3,79,110,52,58
050,29,059,"Missouri","Dallas County",3,80,99,46,53
050,29,059,"Missouri","Dallas County",3,81,88,42,46
050,29,059,"Missouri","Dallas County",3,82,81,30,51
050,29,059,"Missouri","Dallas County",3,83,67,30,37
050,29,059,"Missouri","Dallas County",3,84,62,27,35
050,29,059,"Missouri","Dallas County",3,85,364,128,236
050,29,059,"Missouri","Dallas County",4,0,211,115,96
050,29,059,"Missouri","Dallas County",4,1,218,102,116
050,29,059,"Missouri","Dallas County",4,2,256,131,125
050,29,059,"Missouri","Dallas County",4,3,236,132,104
050,29,059,"Missouri","Dallas County",4,4,228,115,113
050,29,059,"Missouri","Dallas County",4,5,230,123,107
050,29,059,"Missouri","Dallas County",4,6,221,119,102
050,29,059,"Missouri","Dallas County",4,7,238,121,117
050,29,059,"Missouri","Dallas County",4,8,228,111,117
050,29,059,"Missouri","Dallas County",4,9,221,97,124
050,29,059,"Missouri","Dallas County",4,10,213,100,113
050,29,059,"Missouri","Dallas County",4,11,222,112,110
050,29,059,"Missouri","Dallas County",4,12,230,123,107
050,29,059,"Missouri","Dallas County",4,13,264,134,130
050,29,059,"Missouri","Dallas County",4,14,260,133,127
050,29,059,"Missouri","Dallas County",4,15,254,131,123
050,29,059,"Missouri","Dallas County",4,16,236,128,108
050,29,059,"Missouri","Dallas County",4,17,268,139,129
050,29,059,"Missouri","Dallas County",4,18,199,101,98
050,29,059,"Missouri","Dallas County",4,19,148,75,73
050,29,059,"Missouri","Dallas County",4,20,177,95,82
050,29,059,"Missouri","Dallas County",4,21,174,97,77
050,29,059,"Missouri","Dallas County",4,22,173,91,82
050,29,059,"Missouri","Dallas County",4,23,166,82,84
050,29,059,"Missouri","Dallas County",4,24,195,98,97
050,29,059,"Missouri","Dallas County",4,25,167,87,80
050,29,059,"Missouri","Dallas County",4,26,176,98,78
050,29,059,"Missouri","Dallas County",4,27,187,97,90
050,29,059,"Missouri","Dallas County",4,28,193,93,100
050,29,059,"Missouri","Dallas County",4,29,195,90,105
050,29,059,"Missouri","Dallas County",4,30,203,95,108
050,29,059,"Missouri","Dallas County",4,31,224,102,122
050,29,059,"Missouri","Dallas County",4,32,225,108,117
050,29,059,"Missouri","Dallas County",4,33,198,93,105
050,29,059,"Missouri","Dallas County",4,34,198,96,102
050,29,059,"Missouri","Dallas County",4,35,170,80,90
050,29,059,"Missouri","Dallas County",4,36,200,105,95
050,29,059,"Missouri","Dallas County",4,37,183,97,86
050,29,059,"Missouri","Dallas County",4,38,200,99,101
050,29,059,"Missouri","Dallas County",4,39,216,110,106
050,29,059,"Missouri","Dallas County",4,40,207,107,100
050,29,059,"Missouri","Dallas County",4,41,194,92,102
050,29,059,"Missouri","Dallas County",4,42,204,110,94
050,29,059,"Missouri","Dallas County",4,43,215,100,115
050,29,059,"Missouri","Dallas County",4,44,192,100,92
050,29,059,"Missouri","Dallas County",4,45,190,102,88
050,29,059,"Missouri","Dallas County",4,46,173,86,87
050,29,059,"Missouri","Dallas County",4,47,194,98,96
050,29,059,"Missouri","Dallas County",4,48,200,96,104
050,29,059,"Missouri","Dallas County",4,49,216,115,101
050,29,059,"Missouri","Dallas County",4,50,212,116,96
050,29,059,"Missouri","Dallas County",4,51,205,106,99
050,29,059,"Missouri","Dallas County",4,52,195,95,100
050,29,059,"Missouri","Dallas County",4,53,223,104,119
050,29,059,"Missouri","Dallas County",4,54,223,110,113
050,29,059,"Missouri","Dallas County",4,55,224,112,112
050,29,059,"Missouri","Dallas County",4,56,201,107,94
050,29,059,"Missouri","Dallas County",4,57,233,119,114
050,29,059,"Missouri","Dallas County",4,58,267,134,133
050,29,059,"Missouri","Dallas County",4,59,251,125,126
050,29,059,"Missouri","Dallas County",4,60,261,130,131
050,29,059,"Missouri","Dallas County",4,61,270,142,128
050,29,059,"Missouri","Dallas County",4,62,291,151,140
050,29,059,"Missouri","Dallas County",4,63,270,137,133
050,29,059,"Missouri","Dallas County",4,64,276,129,147
050,29,059,"Missouri","Dallas County",4,65,276,139,137
050,29,059,"Missouri","Dallas County",4,66,243,125,118
050,29,059,"Missouri","Dallas County",4,67,246,126,120
050,29,059,"Missouri","Dallas County",4,68,247,123,124
050,29,059,"Missouri","Dallas County",4,69,219,107,112
050,29,059,"Missouri","Dallas County",4,70,199,93,106
050,29,059,"Missouri","Dallas County",4,71,185,92,93
050,29,059,"Missouri","Dallas County",4,72,196,101,95
050,29,059,"Missouri","Dallas County",4,73,180,96,84
050,29,059,"Missouri","Dallas County",4,74,165,78,87
050,29,059,"Missouri","Dallas County",4,75,165,83,82
050,29,059,"Missouri","Dallas County",4,76,124,51,73
050,29,059,"Missouri","Dallas County",4,77,121,61,60
050,29,059,"Missouri","Dallas County",4,78,136,62,74
050,29,059,"Missouri","Dallas County",4,79,129,61,68
050,29,059,"Missouri","Dallas County",4,80,97,50,47
050,29,059,"Missouri","Dallas County",4,81,95,44,51
050,29,059,"Missouri","Dallas County",4,82,83,34,49
050,29,059,"Missouri","Dallas County",4,83,66,27,39
050,29,059,"Missouri","Dallas County",4,84,65,25,40
050,29,059,"Missouri","Dallas County",4,85,362,123,239
050,29,059,"Missouri","Dallas County",5,0,211,115,96
050,29,059,"Missouri","Dallas County",5,1,234,123,111
050,29,059,"Missouri","Dallas County",5,2,206,92,114
050,29,059,"Missouri","Dallas County",5,3,258,136,122
050,29,059,"Missouri","Dallas County",5,4,226,126,100
050,29,059,"Missouri","Dallas County",5,5,232,123,109
050,29,059,"Missouri","Dallas County",5,6,226,116,110
050,29,059,"Missouri","Dallas County",5,7,222,118,104
050,29,059,"Missouri","Dallas County",5,8,244,132,112
050,29,059,"Missouri","Dallas County",5,9,228,117,111
050,29,059,"Missouri","Dallas County",5,10,228,99,129
050,29,059,"Missouri","Dallas County",5,11,213,105,108
050,29,059,"Missouri","Dallas County",5,12,220,109,111
050,29,059,"Missouri","Dallas County",5,13,235,126,109
050,29,059,"Missouri","Dallas County",5,14,269,137,132
050,29,059,"Missouri","Dallas County",5,15,271,142,129
050,29,059,"Missouri","Dallas County",5,16,258,137,121
050,29,059,"Missouri","Dallas County",5,17,247,138,109
050,29,059,"Missouri","Dallas County",5,18,224,120,104
050,29,059,"Missouri","Dallas County",5,19,153,79,74
050,29,059,"Missouri","Dallas County",5,20,164,79,85
050,29,059,"Missouri","Dallas County",5,21,188,94,94
050,29,059,"Missouri","Dallas County",5,22,189,102,87
050,29,059,"Missouri","Dallas County",5,23,182,102,80
050,29,059,"Missouri","Dallas County",5,24,161,84,77
050,29,059,"Missouri","Dallas County",5,25,183,97,86
050,29,059,"Missouri","Dallas County",5,26,167,89,78
050,29,059,"Missouri","Dallas County",5,27,172,97,75
050,29,059,"Missouri","Dallas County",5,28,191,92,99
050,29,059,"Missouri","Dallas County",5,29,201,95,106
050,29,059,"Missouri","Dallas County",5,30,209,99,110
050,29,059,"Missouri","Dallas County",5,31,200,88,112
050,29,059,"Missouri","Dallas County",5,32,238,109,129
050,29,059,"Missouri","Dallas County",5,33,233,112,121
050,29,059,"Missouri","Dallas County",5,34,207,94,113
050,29,059,"Missouri","Dallas County",5,35,196,93,103
050,29,059,"Missouri","Dallas County",5,36,161,76,85
050,29,059,"Missouri","Dallas County",5,37,209,112,97
050,29,059,"Missouri","Dallas County",5,38,197,108,89
050,29,059,"Missouri","Dallas County",5,39,203,100,103
050,29,059,"Missouri","Dallas County",5,40,217,106,111
050,29,059,"Missouri","Dallas County",5,41,217,116,101
050,29,059,"Missouri","Dallas County",5,42,196,93,103
050,29,059,"Missouri","Dallas County",5,43,209,109,100
050,29,059,"Missouri","Dallas County",5,44,220,107,113
050,29,059,"Missouri","Dallas County",5,45,193,101,92
050,29,059,"Missouri","Dallas County",5,46,185,97,88
050,29,059,"Missouri","Dallas County",5,47,182,87,95
050,29,059,"Missouri","Dallas County",5,48,198,100,98
050,29,059,"Missouri","Dallas County",5,49,206,97,109
050,29,059,"Missouri","Dallas County",5,50,225,119,106
050,29,059,"Missouri","Dallas County",5,51,214,116,98
050,29,059,"Missouri","Dallas County",5,52,201,104,97
050,29,059,"Missouri","Dallas County",5,53,208,103,105
050,29,059,"Missouri","Dallas County",5,54,224,109,115
050,29,059,"Missouri","Dallas County",5,55,221,111,110
050,29,059,"Missouri","Dallas County",5,56,222,110,112
050,29,059,"Missouri","Dallas County",5,57,210,112,98
050,29,059,"Missouri","Dallas County",5,58,235,118,117
050,29,059,"Missouri","Dallas County",5,59,261,130,131
050,29,059,"Missouri","Dallas County",5,60,255,127,128
050,29,059,"Missouri","Dallas County",5,61,259,132,127
050,29,059,"Missouri","Dallas County",5,62,278,145,133
050,29,059,"Missouri","Dallas County",5,63,300,157,143
050,29,059,"Missouri","Dallas County",5,64,267,135,132
050,29,059,"Missouri","Dallas County",5,65,265,122,143
050,29,059,"Missouri","Dallas County",5,66,263,138,125
050,29,059,"Missouri","Dallas County",5,67,251,128,123
050,29,059,"Missouri","Dallas County",5,68,246,126,120
050,29,059,"Missouri","Dallas County",5,69,238,114,124
050,29,059,"Missouri","Dallas County",5,70,218,105,113
050,29,059,"Missouri","Dallas County",5,71,199,94,105
050,29,059,"Missouri","Dallas County",5,72,178,87,91
050,29,059,"Missouri","Dallas County",5,73,194,96,98
050,29,059,"Missouri","Dallas County",5,74,171,88,83
050,29,059,"Missouri","Dallas County",5,75,163,74,89
050,29,059,"Missouri","Dallas County",5,76,157,75,82
050,29,059,"Missouri","Dallas County",5,77,116,49,67
050,29,059,"Missouri","Dallas County",5,78,120,58,62
050,29,059,"Missouri","Dallas County",5,79,131,60,71
050,29,059,"Missouri","Dallas County",5,80,118,57,61
050,29,059,"Missouri","Dallas County",5,81,88,44,44
050,29,059,"Missouri","Dallas County",5,82,88,38,50
050,29,059,"Missouri","Dallas County",5,83,66,29,37
050,29,059,"Missouri","Dallas County",5,84,65,22,43
050,29,059,"Missouri","Dallas County",5,85,374,127,247
050,29,061,"Missouri","Daviess County",1,0,126,63,63
050,29,061,"Missouri","Daviess County",1,1,125,54,71
050,29,061,"Missouri","Daviess County",1,2,124,52,72
050,29,061,"Missouri","Daviess County",1,3,110,51,59
050,29,061,"Missouri","Daviess County",1,4,120,66,54
050,29,061,"Missouri","Daviess County",1,5,116,63,53
050,29,061,"Missouri","Daviess County",1,6,104,59,45
050,29,061,"Missouri","Daviess County",1,7,94,49,45
050,29,061,"Missouri","Daviess County",1,8,94,42,52
050,29,061,"Missouri","Daviess County",1,9,102,49,53
050,29,061,"Missouri","Daviess County",1,10,118,62,56
050,29,061,"Missouri","Daviess County",1,11,121,64,57
050,29,061,"Missouri","Daviess County",1,12,129,64,65
050,29,061,"Missouri","Daviess County",1,13,132,63,69
050,29,061,"Missouri","Daviess County",1,14,125,68,57
050,29,061,"Missouri","Daviess County",1,15,136,68,68
050,29,061,"Missouri","Daviess County",1,16,134,70,64
050,29,061,"Missouri","Daviess County",1,17,151,78,73
050,29,061,"Missouri","Daviess County",1,18,110,57,53
050,29,061,"Missouri","Daviess County",1,19,82,38,44
050,29,061,"Missouri","Daviess County",1,20,97,47,50
050,29,061,"Missouri","Daviess County",1,21,93,42,51
050,29,061,"Missouri","Daviess County",1,22,102,45,57
050,29,061,"Missouri","Daviess County",1,23,101,54,47
050,29,061,"Missouri","Daviess County",1,24,73,42,31
050,29,061,"Missouri","Daviess County",1,25,86,43,43
050,29,061,"Missouri","Daviess County",1,26,94,49,45
050,29,061,"Missouri","Daviess County",1,27,95,55,40
050,29,061,"Missouri","Daviess County",1,28,91,41,50
050,29,061,"Missouri","Daviess County",1,29,93,44,49
050,29,061,"Missouri","Daviess County",1,30,91,41,50
050,29,061,"Missouri","Daviess County",1,31,78,36,42
050,29,061,"Missouri","Daviess County",1,32,81,39,42
050,29,061,"Missouri","Daviess County",1,33,76,38,38
050,29,061,"Missouri","Daviess County",1,34,70,31,39
050,29,061,"Missouri","Daviess County",1,35,72,37,35
050,29,061,"Missouri","Daviess County",1,36,88,43,45
050,29,061,"Missouri","Daviess County",1,37,93,50,43
050,29,061,"Missouri","Daviess County",1,38,92,48,44
050,29,061,"Missouri","Daviess County",1,39,82,42,40
050,29,061,"Missouri","Daviess County",1,40,84,48,36
050,29,061,"Missouri","Daviess County",1,41,92,49,43
050,29,061,"Missouri","Daviess County",1,42,94,47,47
050,29,061,"Missouri","Daviess County",1,43,87,44,43
050,29,061,"Missouri","Daviess County",1,44,103,57,46
050,29,061,"Missouri","Daviess County",1,45,92,47,45
050,29,061,"Missouri","Daviess County",1,46,84,46,38
050,29,061,"Missouri","Daviess County",1,47,82,39,43
050,29,061,"Missouri","Daviess County",1,48,106,47,59
050,29,061,"Missouri","Daviess County",1,49,108,53,55
050,29,061,"Missouri","Daviess County",1,50,92,51,41
050,29,061,"Missouri","Daviess County",1,51,96,49,47
050,29,061,"Missouri","Daviess County",1,52,89,49,40
050,29,061,"Missouri","Daviess County",1,53,88,45,43
050,29,061,"Missouri","Daviess County",1,54,101,51,50
050,29,061,"Missouri","Daviess County",1,55,97,45,52
050,29,061,"Missouri","Daviess County",1,56,113,55,58
050,29,061,"Missouri","Daviess County",1,57,110,58,52
050,29,061,"Missouri","Daviess County",1,58,131,57,74
050,29,061,"Missouri","Daviess County",1,59,141,72,69
050,29,061,"Missouri","Daviess County",1,60,112,61,51
050,29,061,"Missouri","Daviess County",1,61,124,64,60
050,29,061,"Missouri","Daviess County",1,62,127,64,63
050,29,061,"Missouri","Daviess County",1,63,119,57,62
050,29,061,"Missouri","Daviess County",1,64,117,56,61
050,29,061,"Missouri","Daviess County",1,65,125,70,55
050,29,061,"Missouri","Daviess County",1,66,116,50,66
050,29,061,"Missouri","Daviess County",1,67,109,48,61
050,29,061,"Missouri","Daviess County",1,68,106,60,46
050,29,061,"Missouri","Daviess County",1,69,96,55,41
050,29,061,"Missouri","Daviess County",1,70,109,59,50
050,29,061,"Missouri","Daviess County",1,71,94,49,45
050,29,061,"Missouri","Daviess County",1,72,101,50,51
050,29,061,"Missouri","Daviess County",1,73,104,47,57
050,29,061,"Missouri","Daviess County",1,74,77,35,42
050,29,061,"Missouri","Daviess County",1,75,81,41,40
050,29,061,"Missouri","Daviess County",1,76,79,44,35
050,29,061,"Missouri","Daviess County",1,77,61,34,27
050,29,061,"Missouri","Daviess County",1,78,57,28,29
050,29,061,"Missouri","Daviess County",1,79,52,26,26
050,29,061,"Missouri","Daviess County",1,80,41,19,22
050,29,061,"Missouri","Daviess County",1,81,38,21,17
050,29,061,"Missouri","Daviess County",1,82,37,11,26
050,29,061,"Missouri","Daviess County",1,83,37,19,18
050,29,061,"Missouri","Daviess County",1,84,38,19,19
050,29,061,"Missouri","Daviess County",1,85,184,71,113
050,29,061,"Missouri","Daviess County",2,0,120,58,62
050,29,061,"Missouri","Daviess County",2,1,124,55,69
050,29,061,"Missouri","Daviess County",2,2,123,50,73
050,29,061,"Missouri","Daviess County",2,3,114,51,63
050,29,061,"Missouri","Daviess County",2,4,118,63,55
050,29,061,"Missouri","Daviess County",2,5,115,63,52
050,29,061,"Missouri","Daviess County",2,6,104,58,46
050,29,061,"Missouri","Daviess County",2,7,96,50,46
050,29,061,"Missouri","Daviess County",2,8,95,44,51
050,29,061,"Missouri","Daviess County",2,9,99,47,52
050,29,061,"Missouri","Daviess County",2,10,114,58,56
050,29,061,"Missouri","Daviess County",2,11,120,64,56
050,29,061,"Missouri","Daviess County",2,12,128,65,63
050,29,061,"Missouri","Daviess County",2,13,131,64,67
050,29,061,"Missouri","Daviess County",2,14,126,67,59
050,29,061,"Missouri","Daviess County",2,15,132,67,65
050,29,061,"Missouri","Daviess County",2,16,136,71,65
050,29,061,"Missouri","Daviess County",2,17,148,76,72
050,29,061,"Missouri","Daviess County",2,18,113,58,55
050,29,061,"Missouri","Daviess County",2,19,84,41,43
050,29,061,"Missouri","Daviess County",2,20,95,44,51
050,29,061,"Missouri","Daviess County",2,21,97,44,53
050,29,061,"Missouri","Daviess County",2,22,101,45,56
050,29,061,"Missouri","Daviess County",2,23,100,51,49
050,29,061,"Missouri","Daviess County",2,24,78,44,34
050,29,061,"Missouri","Daviess County",2,25,85,44,41
050,29,061,"Missouri","Daviess County",2,26,92,49,43
050,29,061,"Missouri","Daviess County",2,27,94,52,42
050,29,061,"Missouri","Daviess County",2,28,92,44,48
050,29,061,"Missouri","Daviess County",2,29,92,43,49
050,29,061,"Missouri","Daviess County",2,30,91,42,49
050,29,061,"Missouri","Daviess County",2,31,80,36,44
050,29,061,"Missouri","Daviess County",2,32,82,39,43
050,29,061,"Missouri","Daviess County",2,33,78,38,40
050,29,061,"Missouri","Daviess County",2,34,72,33,39
050,29,061,"Missouri","Daviess County",2,35,72,36,36
050,29,061,"Missouri","Daviess County",2,36,85,42,43
050,29,061,"Missouri","Daviess County",2,37,93,48,45
050,29,061,"Missouri","Daviess County",2,38,93,48,45
050,29,061,"Missouri","Daviess County",2,39,83,43,40
050,29,061,"Missouri","Daviess County",2,40,83,47,36
050,29,061,"Missouri","Daviess County",2,41,90,48,42
050,29,061,"Missouri","Daviess County",2,42,94,47,47
050,29,061,"Missouri","Daviess County",2,43,91,46,45
050,29,061,"Missouri","Daviess County",2,44,97,53,44
050,29,061,"Missouri","Daviess County",2,45,96,50,46
050,29,061,"Missouri","Daviess County",2,46,85,46,39
050,29,061,"Missouri","Daviess County",2,47,82,40,42
050,29,061,"Missouri","Daviess County",2,48,101,45,56
050,29,061,"Missouri","Daviess County",2,49,110,54,56
050,29,061,"Missouri","Daviess County",2,50,95,51,44
050,29,061,"Missouri","Daviess County",2,51,97,51,46
050,29,061,"Missouri","Daviess County",2,52,91,50,41
050,29,061,"Missouri","Daviess County",2,53,89,46,43
050,29,061,"Missouri","Daviess County",2,54,98,49,49
050,29,061,"Missouri","Daviess County",2,55,98,46,52
050,29,061,"Missouri","Daviess County",2,56,109,53,56
050,29,061,"Missouri","Daviess County",2,57,111,57,54
050,29,061,"Missouri","Daviess County",2,58,128,58,70
050,29,061,"Missouri","Daviess County",2,59,139,68,71
050,29,061,"Missouri","Daviess County",2,60,120,64,56
050,29,061,"Missouri","Daviess County",2,61,121,62,59
050,29,061,"Missouri","Daviess County",2,62,125,65,60
050,29,061,"Missouri","Daviess County",2,63,123,59,64
050,29,061,"Missouri","Daviess County",2,64,119,58,61
050,29,061,"Missouri","Daviess County",2,65,122,65,57
050,29,061,"Missouri","Daviess County",2,66,118,55,63
050,29,061,"Missouri","Daviess County",2,67,110,49,61
050,29,061,"Missouri","Daviess County",2,68,106,57,49
050,29,061,"Missouri","Daviess County",2,69,100,57,43
050,29,061,"Missouri","Daviess County",2,70,105,58,47
050,29,061,"Missouri","Daviess County",2,71,97,51,46
050,29,061,"Missouri","Daviess County",2,72,98,49,49
050,29,061,"Missouri","Daviess County",2,73,109,50,59
050,29,061,"Missouri","Daviess County",2,74,77,35,42
050,29,061,"Missouri","Daviess County",2,75,78,39,39
050,29,061,"Missouri","Daviess County",2,76,79,43,36
050,29,061,"Missouri","Daviess County",2,77,63,35,28
050,29,061,"Missouri","Daviess County",2,78,56,28,28
050,29,061,"Missouri","Daviess County",2,79,52,26,26
050,29,061,"Missouri","Daviess County",2,80,43,21,22
050,29,061,"Missouri","Daviess County",2,81,37,20,17
050,29,061,"Missouri","Daviess County",2,82,35,13,22
050,29,061,"Missouri","Daviess County",2,83,35,16,19
050,29,061,"Missouri","Daviess County",2,84,36,18,18
050,29,061,"Missouri","Daviess County",2,85,187,73,114
050,29,061,"Missouri","Daviess County",3,0,110,58,52
050,29,061,"Missouri","Daviess County",3,1,110,49,61
050,29,061,"Missouri","Daviess County",3,2,122,50,72
050,29,061,"Missouri","Daviess County",3,3,116,53,63
050,29,061,"Missouri","Daviess County",3,4,115,56,59
050,29,061,"Missouri","Daviess County",3,5,113,61,52
050,29,061,"Missouri","Daviess County",3,6,114,64,50
050,29,061,"Missouri","Daviess County",3,7,104,57,47
050,29,061,"Missouri","Daviess County",3,8,95,46,49
050,29,061,"Missouri","Daviess County",3,9,92,42,50
050,29,061,"Missouri","Daviess County",3,10,107,51,56
050,29,061,"Missouri","Daviess County",3,11,112,60,52
050,29,061,"Missouri","Daviess County",3,12,124,67,57
050,29,061,"Missouri","Daviess County",3,13,123,66,57
050,29,061,"Missouri","Daviess County",3,14,130,61,69
050,29,061,"Missouri","Daviess County",3,15,133,68,65
050,29,061,"Missouri","Daviess County",3,16,147,82,65
050,29,061,"Missouri","Daviess County",3,17,136,70,66
050,29,061,"Missouri","Daviess County",3,18,127,68,59
050,29,061,"Missouri","Daviess County",3,19,87,47,40
050,29,061,"Missouri","Daviess County",3,20,85,43,42
050,29,061,"Missouri","Daviess County",3,21,96,44,52
050,29,061,"Missouri","Daviess County",3,22,105,52,53
050,29,061,"Missouri","Daviess County",3,23,89,44,45
050,29,061,"Missouri","Daviess County",3,24,89,44,45
050,29,061,"Missouri","Daviess County",3,25,75,40,35
050,29,061,"Missouri","Daviess County",3,26,86,46,40
050,29,061,"Missouri","Daviess County",3,27,90,42,48
050,29,061,"Missouri","Daviess County",3,28,92,50,42
050,29,061,"Missouri","Daviess County",3,29,85,39,46
050,29,061,"Missouri","Daviess County",3,30,99,48,51
050,29,061,"Missouri","Daviess County",3,31,95,46,49
050,29,061,"Missouri","Daviess County",3,32,88,40,48
050,29,061,"Missouri","Daviess County",3,33,86,42,44
050,29,061,"Missouri","Daviess County",3,34,76,40,36
050,29,061,"Missouri","Daviess County",3,35,68,32,36
050,29,061,"Missouri","Daviess County",3,36,79,39,40
050,29,061,"Missouri","Daviess County",3,37,76,33,43
050,29,061,"Missouri","Daviess County",3,38,91,47,44
050,29,061,"Missouri","Daviess County",3,39,92,47,45
050,29,061,"Missouri","Daviess County",3,40,78,43,35
050,29,061,"Missouri","Daviess County",3,41,79,44,35
050,29,061,"Missouri","Daviess County",3,42,101,54,47
050,29,061,"Missouri","Daviess County",3,43,92,48,44
050,29,061,"Missouri","Daviess County",3,44,90,44,46
050,29,061,"Missouri","Daviess County",3,45,104,55,49
050,29,061,"Missouri","Daviess County",3,46,96,51,45
050,29,061,"Missouri","Daviess County",3,47,85,45,40
050,29,061,"Missouri","Daviess County",3,48,82,41,41
050,29,061,"Missouri","Daviess County",3,49,107,49,58
050,29,061,"Missouri","Daviess County",3,50,105,51,54
050,29,061,"Missouri","Daviess County",3,51,96,51,45
050,29,061,"Missouri","Daviess County",3,52,96,52,44
050,29,061,"Missouri","Daviess County",3,53,94,51,43
050,29,061,"Missouri","Daviess County",3,54,89,47,42
050,29,061,"Missouri","Daviess County",3,55,92,47,45
050,29,061,"Missouri","Daviess County",3,56,99,47,52
050,29,061,"Missouri","Daviess County",3,57,105,48,57
050,29,061,"Missouri","Daviess County",3,58,111,53,58
050,29,061,"Missouri","Daviess County",3,59,128,56,72
050,29,061,"Missouri","Daviess County",3,60,135,67,68
050,29,061,"Missouri","Daviess County",3,61,119,63,56
050,29,061,"Missouri","Daviess County",3,62,117,63,54
050,29,061,"Missouri","Daviess County",3,63,125,62,63
050,29,061,"Missouri","Daviess County",3,64,125,62,63
050,29,061,"Missouri","Daviess County",3,65,119,57,62
050,29,061,"Missouri","Daviess County",3,66,126,69,57
050,29,061,"Missouri","Daviess County",3,67,116,52,64
050,29,061,"Missouri","Daviess County",3,68,113,52,61
050,29,061,"Missouri","Daviess County",3,69,113,60,53
050,29,061,"Missouri","Daviess County",3,70,96,56,40
050,29,061,"Missouri","Daviess County",3,71,102,58,44
050,29,061,"Missouri","Daviess County",3,72,94,50,44
050,29,061,"Missouri","Daviess County",3,73,99,48,51
050,29,061,"Missouri","Daviess County",3,74,110,49,61
050,29,061,"Missouri","Daviess County",3,75,73,35,38
050,29,061,"Missouri","Daviess County",3,76,72,32,40
050,29,061,"Missouri","Daviess County",3,77,72,39,33
050,29,061,"Missouri","Daviess County",3,78,62,34,28
050,29,061,"Missouri","Daviess County",3,79,52,26,26
050,29,061,"Missouri","Daviess County",3,80,48,26,22
050,29,061,"Missouri","Daviess County",3,81,40,18,22
050,29,061,"Missouri","Daviess County",3,82,35,18,17
050,29,061,"Missouri","Daviess County",3,83,27,12,15
050,29,061,"Missouri","Daviess County",3,84,36,15,21
050,29,061,"Missouri","Daviess County",3,85,186,72,114
050,29,061,"Missouri","Daviess County",4,0,112,60,52
050,29,061,"Missouri","Daviess County",4,1,109,59,50
050,29,061,"Missouri","Daviess County",4,2,108,48,60
050,29,061,"Missouri","Daviess County",4,3,125,56,69
050,29,061,"Missouri","Daviess County",4,4,114,55,59
050,29,061,"Missouri","Daviess County",4,5,124,57,67
050,29,061,"Missouri","Daviess County",4,6,114,59,55
050,29,061,"Missouri","Daviess County",4,7,124,69,55
050,29,061,"Missouri","Daviess County",4,8,105,58,47
050,29,061,"Missouri","Daviess County",4,9,103,51,52
050,29,061,"Missouri","Daviess County",4,10,98,44,54
050,29,061,"Missouri","Daviess County",4,11,105,51,54
050,29,061,"Missouri","Daviess County",4,12,115,60,55
050,29,061,"Missouri","Daviess County",4,13,124,68,56
050,29,061,"Missouri","Daviess County",4,14,128,67,61
050,29,061,"Missouri","Daviess County",4,15,129,61,68
050,29,061,"Missouri","Daviess County",4,16,134,69,65
050,29,061,"Missouri","Daviess County",4,17,149,81,68
050,29,061,"Missouri","Daviess County",4,18,122,62,60
050,29,061,"Missouri","Daviess County",4,19,88,47,41
050,29,061,"Missouri","Daviess County",4,20,79,42,37
050,29,061,"Missouri","Daviess County",4,21,87,44,43
050,29,061,"Missouri","Daviess County",4,22,97,45,52
050,29,061,"Missouri","Daviess County",4,23,108,54,54
050,29,061,"Missouri","Daviess County",4,24,92,43,49
050,29,061,"Missouri","Daviess County",4,25,89,43,46
050,29,061,"Missouri","Daviess County",4,26,73,39,34
050,29,061,"Missouri","Daviess County",4,27,91,49,42
050,29,061,"Missouri","Daviess County",4,28,90,41,49
050,29,061,"Missouri","Daviess County",4,29,88,43,45
050,29,061,"Missouri","Daviess County",4,30,80,38,42
050,29,061,"Missouri","Daviess County",4,31,97,46,51
050,29,061,"Missouri","Daviess County",4,32,95,48,47
050,29,061,"Missouri","Daviess County",4,33,91,40,51
050,29,061,"Missouri","Daviess County",4,34,83,43,40
050,29,061,"Missouri","Daviess County",4,35,79,41,38
050,29,061,"Missouri","Daviess County",4,36,74,36,38
050,29,061,"Missouri","Daviess County",4,37,80,40,40
050,29,061,"Missouri","Daviess County",4,38,80,38,42
050,29,061,"Missouri","Daviess County",4,39,90,44,46
050,29,061,"Missouri","Daviess County",4,40,93,47,46
050,29,061,"Missouri","Daviess County",4,41,84,43,41
050,29,061,"Missouri","Daviess County",4,42,82,45,37
050,29,061,"Missouri","Daviess County",4,43,100,52,48
050,29,061,"Missouri","Daviess County",4,44,92,48,44
050,29,061,"Missouri","Daviess County",4,45,100,52,48
050,29,061,"Missouri","Daviess County",4,46,99,54,45
050,29,061,"Missouri","Daviess County",4,47,91,50,41
050,29,061,"Missouri","Daviess County",4,48,84,44,40
050,29,061,"Missouri","Daviess County",4,49,86,46,40
050,29,061,"Missouri","Daviess County",4,50,104,46,58
050,29,061,"Missouri","Daviess County",4,51,103,52,51
050,29,061,"Missouri","Daviess County",4,52,88,48,40
050,29,061,"Missouri","Daviess County",4,53,92,47,45
050,29,061,"Missouri","Daviess County",4,54,104,56,48
050,29,061,"Missouri","Daviess County",4,55,93,50,43
050,29,061,"Missouri","Daviess County",4,56,94,45,49
050,29,061,"Missouri","Daviess County",4,57,103,48,55
050,29,061,"Missouri","Daviess County",4,58,107,50,57
050,29,061,"Missouri","Daviess County",4,59,114,57,57
050,29,061,"Missouri","Daviess County",4,60,124,55,69
050,29,061,"Missouri","Daviess County",4,61,131,64,67
050,29,061,"Missouri","Daviess County",4,62,121,67,54
050,29,061,"Missouri","Daviess County",4,63,112,59,53
050,29,061,"Missouri","Daviess County",4,64,125,59,66
050,29,061,"Missouri","Daviess County",4,65,128,63,65
050,29,061,"Missouri","Daviess County",4,66,120,58,62
050,29,061,"Missouri","Daviess County",4,67,128,68,60
050,29,061,"Missouri","Daviess County",4,68,110,51,59
050,29,061,"Missouri","Daviess County",4,69,110,54,56
050,29,061,"Missouri","Daviess County",4,70,108,58,50
050,29,061,"Missouri","Daviess County",4,71,97,55,42
050,29,061,"Missouri","Daviess County",4,72,100,55,45
050,29,061,"Missouri","Daviess County",4,73,97,49,48
050,29,061,"Missouri","Daviess County",4,74,95,46,49
050,29,061,"Missouri","Daviess County",4,75,107,48,59
050,29,061,"Missouri","Daviess County",4,76,70,31,39
050,29,061,"Missouri","Daviess County",4,77,68,32,36
050,29,061,"Missouri","Daviess County",4,78,72,40,32
050,29,061,"Missouri","Daviess County",4,79,61,33,28
050,29,061,"Missouri","Daviess County",4,80,49,25,24
050,29,061,"Missouri","Daviess County",4,81,45,24,21
050,29,061,"Missouri","Daviess County",4,82,41,18,23
050,29,061,"Missouri","Daviess County",4,83,29,15,14
050,29,061,"Missouri","Daviess County",4,84,27,13,14
050,29,061,"Missouri","Daviess County",4,85,196,77,119
050,29,061,"Missouri","Daviess County",5,0,113,59,54
050,29,061,"Missouri","Daviess County",5,1,114,60,54
050,29,061,"Missouri","Daviess County",5,2,120,62,58
050,29,061,"Missouri","Daviess County",5,3,109,52,57
050,29,061,"Missouri","Daviess County",5,4,130,61,69
050,29,061,"Missouri","Daviess County",5,5,113,51,62
050,29,061,"Missouri","Daviess County",5,6,116,51,65
050,29,061,"Missouri","Daviess County",5,7,117,61,56
050,29,061,"Missouri","Daviess County",5,8,122,69,53
050,29,061,"Missouri","Daviess County",5,9,107,56,51
050,29,061,"Missouri","Daviess County",5,10,106,53,53
050,29,061,"Missouri","Daviess County",5,11,109,48,61
050,29,061,"Missouri","Daviess County",5,12,106,52,54
050,29,061,"Missouri","Daviess County",5,13,115,60,55
050,29,061,"Missouri","Daviess County",5,14,127,70,57
050,29,061,"Missouri","Daviess County",5,15,133,70,63
050,29,061,"Missouri","Daviess County",5,16,126,63,63
050,29,061,"Missouri","Daviess County",5,17,134,66,68
050,29,061,"Missouri","Daviess County",5,18,121,70,51
050,29,061,"Missouri","Daviess County",5,19,91,47,44
050,29,061,"Missouri","Daviess County",5,20,95,51,44
050,29,061,"Missouri","Daviess County",5,21,84,42,42
050,29,061,"Missouri","Daviess County",5,22,94,48,46
050,29,061,"Missouri","Daviess County",5,23,112,53,59
050,29,061,"Missouri","Daviess County",5,24,118,61,57
050,29,061,"Missouri","Daviess County",5,25,93,44,49
050,29,061,"Missouri","Daviess County",5,26,97,46,51
050,29,061,"Missouri","Daviess County",5,27,74,39,35
050,29,061,"Missouri","Daviess County",5,28,86,49,37
050,29,061,"Missouri","Daviess County",5,29,80,37,43
050,29,061,"Missouri","Daviess County",5,30,96,51,45
050,29,061,"Missouri","Daviess County",5,31,80,37,43
050,29,061,"Missouri","Daviess County",5,32,96,45,51
050,29,061,"Missouri","Daviess County",5,33,100,48,52
050,29,061,"Missouri","Daviess County",5,34,100,50,50
050,29,061,"Missouri","Daviess County",5,35,80,43,37
050,29,061,"Missouri","Daviess County",5,36,83,44,39
050,29,061,"Missouri","Daviess County",5,37,73,37,36
050,29,061,"Missouri","Daviess County",5,38,84,42,42
050,29,061,"Missouri","Daviess County",5,39,83,38,45
050,29,061,"Missouri","Daviess County",5,40,90,48,42
050,29,061,"Missouri","Daviess County",5,41,87,48,39
050,29,061,"Missouri","Daviess County",5,42,89,46,43
050,29,061,"Missouri","Daviess County",5,43,85,47,38
050,29,061,"Missouri","Daviess County",5,44,100,54,46
050,29,061,"Missouri","Daviess County",5,45,89,47,42
050,29,061,"Missouri","Daviess County",5,46,104,54,50
050,29,061,"Missouri","Daviess County",5,47,97,49,48
050,29,061,"Missouri","Daviess County",5,48,90,49,41
050,29,061,"Missouri","Daviess County",5,49,87,46,41
050,29,061,"Missouri","Daviess County",5,50,77,42,35
050,29,061,"Missouri","Daviess County",5,51,104,48,56
050,29,061,"Missouri","Daviess County",5,52,103,55,48
050,29,061,"Missouri","Daviess County",5,53,86,43,43
050,29,061,"Missouri","Daviess County",5,54,97,49,48
050,29,061,"Missouri","Daviess County",5,55,101,53,48
050,29,061,"Missouri","Daviess County",5,56,98,51,47
050,29,061,"Missouri","Daviess County",5,57,92,43,49
050,29,061,"Missouri","Daviess County",5,58,109,50,59
050,29,061,"Missouri","Daviess County",5,59,117,59,58
050,29,061,"Missouri","Daviess County",5,60,116,58,58
050,29,061,"Missouri","Daviess County",5,61,125,55,70
050,29,061,"Missouri","Daviess County",5,62,130,63,67
050,29,061,"Missouri","Daviess County",5,63,120,65,55
050,29,061,"Missouri","Daviess County",5,64,117,59,58
050,29,061,"Missouri","Daviess County",5,65,125,58,67
050,29,061,"Missouri","Daviess County",5,66,127,60,67
050,29,061,"Missouri","Daviess County",5,67,114,53,61
050,29,061,"Missouri","Daviess County",5,68,127,70,57
050,29,061,"Missouri","Daviess County",5,69,108,52,56
050,29,061,"Missouri","Daviess County",5,70,107,53,54
050,29,061,"Missouri","Daviess County",5,71,102,56,46
050,29,061,"Missouri","Daviess County",5,72,96,56,40
050,29,061,"Missouri","Daviess County",5,73,107,61,46
050,29,061,"Missouri","Daviess County",5,74,95,48,47
050,29,061,"Missouri","Daviess County",5,75,86,41,45
050,29,061,"Missouri","Daviess County",5,76,103,46,57
050,29,061,"Missouri","Daviess County",5,77,65,30,35
050,29,061,"Missouri","Daviess County",5,78,70,34,36
050,29,061,"Missouri","Daviess County",5,79,65,34,31
050,29,061,"Missouri","Daviess County",5,80,59,33,26
050,29,061,"Missouri","Daviess County",5,81,47,24,23
050,29,061,"Missouri","Daviess County",5,82,43,21,22
050,29,061,"Missouri","Daviess County",5,83,40,17,23
050,29,061,"Missouri","Daviess County",5,84,28,14,14
050,29,061,"Missouri","Daviess County",5,85,190,75,115
050,29,063,"Missouri","DeKalb County",1,0,92,47,45
050,29,063,"Missouri","DeKalb County",1,1,99,46,53
050,29,063,"Missouri","DeKalb County",1,2,94,46,48
050,29,063,"Missouri","DeKalb County",1,3,114,63,51
050,29,063,"Missouri","DeKalb County",1,4,137,63,74
050,29,063,"Missouri","DeKalb County",1,5,118,56,62
050,29,063,"Missouri","DeKalb County",1,6,121,59,62
050,29,063,"Missouri","DeKalb County",1,7,124,68,56
050,29,063,"Missouri","DeKalb County",1,8,126,61,65
050,29,063,"Missouri","DeKalb County",1,9,133,69,64
050,29,063,"Missouri","DeKalb County",1,10,132,73,59
050,29,063,"Missouri","DeKalb County",1,11,108,62,46
050,29,063,"Missouri","DeKalb County",1,12,135,66,69
050,29,063,"Missouri","DeKalb County",1,13,121,62,59
050,29,063,"Missouri","DeKalb County",1,14,129,70,59
050,29,063,"Missouri","DeKalb County",1,15,137,70,67
050,29,063,"Missouri","DeKalb County",1,16,131,67,64
050,29,063,"Missouri","DeKalb County",1,17,117,60,57
050,29,063,"Missouri","DeKalb County",1,18,112,64,48
050,29,063,"Missouri","DeKalb County",1,19,98,61,37
050,29,063,"Missouri","DeKalb County",1,20,103,63,40
050,29,063,"Missouri","DeKalb County",1,21,115,79,36
050,29,063,"Missouri","DeKalb County",1,22,127,76,51
050,29,063,"Missouri","DeKalb County",1,23,144,93,51
050,29,063,"Missouri","DeKalb County",1,24,138,98,40
050,29,063,"Missouri","DeKalb County",1,25,139,92,47
050,29,063,"Missouri","DeKalb County",1,26,145,93,52
050,29,063,"Missouri","DeKalb County",1,27,145,96,49
050,29,063,"Missouri","DeKalb County",1,28,157,100,57
050,29,063,"Missouri","DeKalb County",1,29,151,104,47
050,29,063,"Missouri","DeKalb County",1,30,159,104,55
050,29,063,"Missouri","DeKalb County",1,31,166,111,55
050,29,063,"Missouri","DeKalb County",1,32,162,108,54
050,29,063,"Missouri","DeKalb County",1,33,145,100,45
050,29,063,"Missouri","DeKalb County",1,34,149,102,47
050,29,063,"Missouri","DeKalb County",1,35,139,99,40
050,29,063,"Missouri","DeKalb County",1,36,145,97,48
050,29,063,"Missouri","DeKalb County",1,37,154,99,55
050,29,063,"Missouri","DeKalb County",1,38,150,102,48
050,29,063,"Missouri","DeKalb County",1,39,156,98,58
050,29,063,"Missouri","DeKalb County",1,40,161,98,63
050,29,063,"Missouri","DeKalb County",1,41,126,81,45
050,29,063,"Missouri","DeKalb County",1,42,139,95,44
050,29,063,"Missouri","DeKalb County",1,43,154,101,53
050,29,063,"Missouri","DeKalb County",1,44,171,109,62
050,29,063,"Missouri","DeKalb County",1,45,140,87,53
050,29,063,"Missouri","DeKalb County",1,46,140,92,48
050,29,063,"Missouri","DeKalb County",1,47,143,88,55
050,29,063,"Missouri","DeKalb County",1,48,148,95,53
050,29,063,"Missouri","DeKalb County",1,49,172,111,61
050,29,063,"Missouri","DeKalb County",1,50,159,99,60
050,29,063,"Missouri","DeKalb County",1,51,160,104,56
050,29,063,"Missouri","DeKalb County",1,52,154,97,57
050,29,063,"Missouri","DeKalb County",1,53,132,77,55
050,29,063,"Missouri","DeKalb County",1,54,146,85,61
050,29,063,"Missouri","DeKalb County",1,55,143,79,64
050,29,063,"Missouri","DeKalb County",1,56,152,87,65
050,29,063,"Missouri","DeKalb County",1,57,157,83,74
050,29,063,"Missouri","DeKalb County",1,58,159,85,74
050,29,063,"Missouri","DeKalb County",1,59,155,82,73
050,29,063,"Missouri","DeKalb County",1,60,142,76,66
050,29,063,"Missouri","DeKalb County",1,61,140,80,60
050,29,063,"Missouri","DeKalb County",1,62,148,79,69
050,29,063,"Missouri","DeKalb County",1,63,145,69,76
050,29,063,"Missouri","DeKalb County",1,64,131,62,69
050,29,063,"Missouri","DeKalb County",1,65,119,63,56
050,29,063,"Missouri","DeKalb County",1,66,124,66,58
050,29,063,"Missouri","DeKalb County",1,67,118,59,59
050,29,063,"Missouri","DeKalb County",1,68,134,74,60
050,29,063,"Missouri","DeKalb County",1,69,128,66,62
050,29,063,"Missouri","DeKalb County",1,70,97,50,47
050,29,063,"Missouri","DeKalb County",1,71,94,53,41
050,29,063,"Missouri","DeKalb County",1,72,93,46,47
050,29,063,"Missouri","DeKalb County",1,73,94,43,51
050,29,063,"Missouri","DeKalb County",1,74,75,26,49
050,29,063,"Missouri","DeKalb County",1,75,64,32,32
050,29,063,"Missouri","DeKalb County",1,76,68,39,29
050,29,063,"Missouri","DeKalb County",1,77,80,39,41
050,29,063,"Missouri","DeKalb County",1,78,80,37,43
050,29,063,"Missouri","DeKalb County",1,79,69,31,38
050,29,063,"Missouri","DeKalb County",1,80,67,34,33
050,29,063,"Missouri","DeKalb County",1,81,59,25,34
050,29,063,"Missouri","DeKalb County",1,82,52,22,30
050,29,063,"Missouri","DeKalb County",1,83,55,19,36
050,29,063,"Missouri","DeKalb County",1,84,55,19,36
050,29,063,"Missouri","DeKalb County",1,85,325,106,219
050,29,063,"Missouri","DeKalb County",2,0,95,49,46
050,29,063,"Missouri","DeKalb County",2,1,95,45,50
050,29,063,"Missouri","DeKalb County",2,2,94,46,48
050,29,063,"Missouri","DeKalb County",2,3,108,58,50
050,29,063,"Missouri","DeKalb County",2,4,132,63,69
050,29,063,"Missouri","DeKalb County",2,5,123,58,65
050,29,063,"Missouri","DeKalb County",2,6,121,58,63
050,29,063,"Missouri","DeKalb County",2,7,122,65,57
050,29,063,"Missouri","DeKalb County",2,8,126,63,63
050,29,063,"Missouri","DeKalb County",2,9,129,67,62
050,29,063,"Missouri","DeKalb County",2,10,132,72,60
050,29,063,"Missouri","DeKalb County",2,11,113,64,49
050,29,063,"Missouri","DeKalb County",2,12,129,65,64
050,29,063,"Missouri","DeKalb County",2,13,126,64,62
050,29,063,"Missouri","DeKalb County",2,14,129,69,60
050,29,063,"Missouri","DeKalb County",2,15,136,71,65
050,29,063,"Missouri","DeKalb County",2,16,133,67,66
050,29,063,"Missouri","DeKalb County",2,17,121,62,59
050,29,063,"Missouri","DeKalb County",2,18,107,60,47
050,29,063,"Missouri","DeKalb County",2,19,101,64,37
050,29,063,"Missouri","DeKalb County",2,20,114,73,41
050,29,063,"Missouri","DeKalb County",2,21,123,85,38
050,29,063,"Missouri","DeKalb County",2,22,136,89,47
050,29,063,"Missouri","DeKalb County",2,23,159,110,49
050,29,063,"Missouri","DeKalb County",2,24,155,114,41
050,29,063,"Missouri","DeKalb County",2,25,156,110,46
050,29,063,"Missouri","DeKalb County",2,26,160,111,49
050,29,063,"Missouri","DeKalb County",2,27,161,112,49
050,29,063,"Missouri","DeKalb County",2,28,168,114,54
050,29,063,"Missouri","DeKalb County",2,29,171,121,50
050,29,063,"Missouri","DeKalb County",2,30,174,122,52
050,29,063,"Missouri","DeKalb County",2,31,188,133,55
050,29,063,"Missouri","DeKalb County",2,32,180,125,55
050,29,063,"Missouri","DeKalb County",2,33,166,118,48
050,29,063,"Missouri","DeKalb County",2,34,162,116,46
050,29,063,"Missouri","DeKalb County",2,35,160,118,42
050,29,063,"Missouri","DeKalb County",2,36,158,112,46
050,29,063,"Missouri","DeKalb County",2,37,167,114,53
050,29,063,"Missouri","DeKalb County",2,38,171,122,49
050,29,063,"Missouri","DeKalb County",2,39,168,112,56
050,29,063,"Missouri","DeKalb County",2,40,179,115,64
050,29,063,"Missouri","DeKalb County",2,41,143,94,49
050,29,063,"Missouri","DeKalb County",2,42,154,110,44
050,29,063,"Missouri","DeKalb County",2,43,169,118,51
050,29,063,"Missouri","DeKalb County",2,44,187,128,59
050,29,063,"Missouri","DeKalb County",2,45,156,100,56
050,29,063,"Missouri","DeKalb County",2,46,155,105,50
050,29,063,"Missouri","DeKalb County",2,47,154,102,52
050,29,063,"Missouri","DeKalb County",2,48,157,104,53
050,29,063,"Missouri","DeKalb County",2,49,186,127,59
050,29,063,"Missouri","DeKalb County",2,50,173,113,60
050,29,063,"Missouri","DeKalb County",2,51,177,120,57
050,29,063,"Missouri","DeKalb County",2,52,166,109,57
050,29,063,"Missouri","DeKalb County",2,53,150,93,57
050,29,063,"Missouri","DeKalb County",2,54,152,92,60
050,29,063,"Missouri","DeKalb County",2,55,148,84,64
050,29,063,"Missouri","DeKalb County",2,56,159,94,65
050,29,063,"Missouri","DeKalb County",2,57,160,88,72
050,29,063,"Missouri","DeKalb County",2,58,162,87,75
050,29,063,"Missouri","DeKalb County",2,59,163,89,74
050,29,063,"Missouri","DeKalb County",2,60,145,78,67
050,29,063,"Missouri","DeKalb County",2,61,141,81,60
050,29,063,"Missouri","DeKalb County",2,62,150,83,67
050,29,063,"Missouri","DeKalb County",2,63,147,73,74
050,29,063,"Missouri","DeKalb County",2,64,134,64,70
050,29,063,"Missouri","DeKalb County",2,65,124,65,59
050,29,063,"Missouri","DeKalb County",2,66,126,67,59
050,29,063,"Missouri","DeKalb County",2,67,117,59,58
050,29,063,"Missouri","DeKalb County",2,68,130,71,59
050,29,063,"Missouri","DeKalb County",2,69,131,68,63
050,29,063,"Missouri","DeKalb County",2,70,102,51,51
050,29,063,"Missouri","DeKalb County",2,71,98,54,44
050,29,063,"Missouri","DeKalb County",2,72,90,46,44
050,29,063,"Missouri","DeKalb County",2,73,97,45,52
050,29,063,"Missouri","DeKalb County",2,74,75,29,46
050,29,063,"Missouri","DeKalb County",2,75,64,29,35
050,29,063,"Missouri","DeKalb County",2,76,64,34,30
050,29,063,"Missouri","DeKalb County",2,77,78,40,38
050,29,063,"Missouri","DeKalb County",2,78,81,38,43
050,29,063,"Missouri","DeKalb County",2,79,69,31,38
050,29,063,"Missouri","DeKalb County",2,80,69,34,35
050,29,063,"Missouri","DeKalb County",2,81,58,25,33
050,29,063,"Missouri","DeKalb County",2,82,54,23,31
050,29,063,"Missouri","DeKalb County",2,83,56,20,36
050,29,063,"Missouri","DeKalb County",2,84,55,18,37
050,29,063,"Missouri","DeKalb County",2,85,325,106,219
050,29,063,"Missouri","DeKalb County",3,0,91,42,49
050,29,063,"Missouri","DeKalb County",3,1,104,56,48
050,29,063,"Missouri","DeKalb County",3,2,102,52,50
050,29,063,"Missouri","DeKalb County",3,3,107,54,53
050,29,063,"Missouri","DeKalb County",3,4,107,56,51
050,29,063,"Missouri","DeKalb County",3,5,137,65,72
050,29,063,"Missouri","DeKalb County",3,6,126,59,67
050,29,063,"Missouri","DeKalb County",3,7,118,59,59
050,29,063,"Missouri","DeKalb County",3,8,122,67,55
050,29,063,"Missouri","DeKalb County",3,9,135,68,67
050,29,063,"Missouri","DeKalb County",3,10,138,71,67
050,29,063,"Missouri","DeKalb County",3,11,133,71,62
050,29,063,"Missouri","DeKalb County",3,12,116,67,49
050,29,063,"Missouri","DeKalb County",3,13,130,62,68
050,29,063,"Missouri","DeKalb County",3,14,127,62,65
050,29,063,"Missouri","DeKalb County",3,15,125,67,58
050,29,063,"Missouri","DeKalb County",3,16,131,66,65
050,29,063,"Missouri","DeKalb County",3,17,122,62,60
050,29,063,"Missouri","DeKalb County",3,18,108,59,49
050,29,063,"Missouri","DeKalb County",3,19,90,54,36
050,29,063,"Missouri","DeKalb County",3,20,116,76,40
050,29,063,"Missouri","DeKalb County",3,21,128,82,46
050,29,063,"Missouri","DeKalb County",3,22,143,97,46
050,29,063,"Missouri","DeKalb County",3,23,161,116,45
050,29,063,"Missouri","DeKalb County",3,24,160,115,45
050,29,063,"Missouri","DeKalb County",3,25,161,113,48
050,29,063,"Missouri","DeKalb County",3,26,156,112,44
050,29,063,"Missouri","DeKalb County",3,27,173,130,43
050,29,063,"Missouri","DeKalb County",3,28,168,118,50
050,29,063,"Missouri","DeKalb County",3,29,177,117,60
050,29,063,"Missouri","DeKalb County",3,30,177,123,54
050,29,063,"Missouri","DeKalb County",3,31,184,134,50
050,29,063,"Missouri","DeKalb County",3,32,178,125,53
050,29,063,"Missouri","DeKalb County",3,33,183,125,58
050,29,063,"Missouri","DeKalb County",3,34,166,119,47
050,29,063,"Missouri","DeKalb County",3,35,168,120,48
050,29,063,"Missouri","DeKalb County",3,36,154,112,42
050,29,063,"Missouri","DeKalb County",3,37,156,115,41
050,29,063,"Missouri","DeKalb County",3,38,185,131,54
050,29,063,"Missouri","DeKalb County",3,39,161,111,50
050,29,063,"Missouri","DeKalb County",3,40,177,119,58
050,29,063,"Missouri","DeKalb County",3,41,169,104,65
050,29,063,"Missouri","DeKalb County",3,42,165,109,56
050,29,063,"Missouri","DeKalb County",3,43,156,112,44
050,29,063,"Missouri","DeKalb County",3,44,191,136,55
050,29,063,"Missouri","DeKalb County",3,45,160,101,59
050,29,063,"Missouri","DeKalb County",3,46,172,110,62
050,29,063,"Missouri","DeKalb County",3,47,161,108,53
050,29,063,"Missouri","DeKalb County",3,48,141,91,50
050,29,063,"Missouri","DeKalb County",3,49,178,123,55
050,29,063,"Missouri","DeKalb County",3,50,185,123,62
050,29,063,"Missouri","DeKalb County",3,51,176,122,54
050,29,063,"Missouri","DeKalb County",3,52,167,113,54
050,29,063,"Missouri","DeKalb County",3,53,164,104,60
050,29,063,"Missouri","DeKalb County",3,54,138,83,55
050,29,063,"Missouri","DeKalb County",3,55,141,79,62
050,29,063,"Missouri","DeKalb County",3,56,158,90,68
050,29,063,"Missouri","DeKalb County",3,57,149,87,62
050,29,063,"Missouri","DeKalb County",3,58,157,85,72
050,29,063,"Missouri","DeKalb County",3,59,163,92,71
050,29,063,"Missouri","DeKalb County",3,60,147,76,71
050,29,063,"Missouri","DeKalb County",3,61,155,87,68
050,29,063,"Missouri","DeKalb County",3,62,139,80,59
050,29,063,"Missouri","DeKalb County",3,63,141,74,67
050,29,063,"Missouri","DeKalb County",3,64,148,75,73
050,29,063,"Missouri","DeKalb County",3,65,134,60,74
050,29,063,"Missouri","DeKalb County",3,66,113,54,59
050,29,063,"Missouri","DeKalb County",3,67,119,61,58
050,29,063,"Missouri","DeKalb County",3,68,115,59,56
050,29,063,"Missouri","DeKalb County",3,69,126,65,61
050,29,063,"Missouri","DeKalb County",3,70,128,68,60
050,29,063,"Missouri","DeKalb County",3,71,101,53,48
050,29,063,"Missouri","DeKalb County",3,72,89,48,41
050,29,063,"Missouri","DeKalb County",3,73,80,37,43
050,29,063,"Missouri","DeKalb County",3,74,99,46,53
050,29,063,"Missouri","DeKalb County",3,75,65,26,39
050,29,063,"Missouri","DeKalb County",3,76,62,28,34
050,29,063,"Missouri","DeKalb County",3,77,62,32,30
050,29,063,"Missouri","DeKalb County",3,78,80,40,40
050,29,063,"Missouri","DeKalb County",3,79,72,32,40
050,29,063,"Missouri","DeKalb County",3,80,73,34,39
050,29,063,"Missouri","DeKalb County",3,81,55,22,33
050,29,063,"Missouri","DeKalb County",3,82,55,25,30
050,29,063,"Missouri","DeKalb County",3,83,53,19,34
050,29,063,"Missouri","DeKalb County",3,84,56,18,38
050,29,063,"Missouri","DeKalb County",3,85,331,107,224
050,29,063,"Missouri","DeKalb County",4,0,93,43,50
050,29,063,"Missouri","DeKalb County",4,1,101,46,55
050,29,063,"Missouri","DeKalb County",4,2,102,59,43
050,29,063,"Missouri","DeKalb County",4,3,108,53,55
050,29,063,"Missouri","DeKalb County",4,4,104,53,51
050,29,063,"Missouri","DeKalb County",4,5,109,56,53
050,29,063,"Missouri","DeKalb County",4,6,141,69,72
050,29,063,"Missouri","DeKalb County",4,7,124,60,64
050,29,063,"Missouri","DeKalb County",4,8,127,63,64
050,29,063,"Missouri","DeKalb County",4,9,121,65,56
050,29,063,"Missouri","DeKalb County",4,10,136,65,71
050,29,063,"Missouri","DeKalb County",4,11,131,69,62
050,29,063,"Missouri","DeKalb County",4,12,143,73,70
050,29,063,"Missouri","DeKalb County",4,13,121,71,50
050,29,063,"Missouri","DeKalb County",4,14,127,65,62
050,29,063,"Missouri","DeKalb County",4,15,133,64,69
050,29,063,"Missouri","DeKalb County",4,16,124,65,59
050,29,063,"Missouri","DeKalb County",4,17,132,69,63
050,29,063,"Missouri","DeKalb County",4,18,108,59,49
050,29,063,"Missouri","DeKalb County",4,19,92,57,35
050,29,063,"Missouri","DeKalb County",4,20,102,65,37
050,29,063,"Missouri","DeKalb County",4,21,123,81,42
050,29,063,"Missouri","DeKalb County",4,22,137,90,47
050,29,063,"Missouri","DeKalb County",4,23,157,108,49
050,29,063,"Missouri","DeKalb County",4,24,144,106,38
050,29,063,"Missouri","DeKalb County",4,25,147,102,45
050,29,063,"Missouri","DeKalb County",4,26,163,111,52
050,29,063,"Missouri","DeKalb County",4,27,155,108,47
050,29,063,"Missouri","DeKalb County",4,28,154,114,40
050,29,063,"Missouri","DeKalb County",4,29,159,106,53
050,29,063,"Missouri","DeKalb County",4,30,168,110,58
050,29,063,"Missouri","DeKalb County",4,31,168,116,52
050,29,063,"Missouri","DeKalb County",4,32,164,111,53
050,29,063,"Missouri","DeKalb County",4,33,161,111,50
050,29,063,"Missouri","DeKalb County",4,34,158,104,54
050,29,063,"Missouri","DeKalb County",4,35,148,103,45
050,29,063,"Missouri","DeKalb County",4,36,160,106,54
050,29,063,"Missouri","DeKalb County",4,37,152,105,47
050,29,063,"Missouri","DeKalb County",4,38,159,116,43
050,29,063,"Missouri","DeKalb County",4,39,163,109,54
050,29,063,"Missouri","DeKalb County",4,40,161,109,52
050,29,063,"Missouri","DeKalb County",4,41,158,98,60
050,29,063,"Missouri","DeKalb County",4,42,173,107,66
050,29,063,"Missouri","DeKalb County",4,43,159,104,55
050,29,063,"Missouri","DeKalb County",4,44,152,110,42
050,29,063,"Missouri","DeKalb County",4,45,159,102,57
050,29,063,"Missouri","DeKalb County",4,46,163,104,59
050,29,063,"Missouri","DeKalb County",4,47,167,105,62
050,29,063,"Missouri","DeKalb County",4,48,146,91,55
050,29,063,"Missouri","DeKalb County",4,49,146,97,49
050,29,063,"Missouri","DeKalb County",4,50,161,100,61
050,29,063,"Missouri","DeKalb County",4,51,174,119,55
050,29,063,"Missouri","DeKalb County",4,52,157,107,50
050,29,063,"Missouri","DeKalb County",4,53,166,111,55
050,29,063,"Missouri","DeKalb County",4,54,151,88,63
050,29,063,"Missouri","DeKalb County",4,55,118,66,52
050,29,063,"Missouri","DeKalb County",4,56,141,79,62
050,29,063,"Missouri","DeKalb County",4,57,147,81,66
050,29,063,"Missouri","DeKalb County",4,58,138,77,61
050,29,063,"Missouri","DeKalb County",4,59,157,87,70
050,29,063,"Missouri","DeKalb County",4,60,146,77,69
050,29,063,"Missouri","DeKalb County",4,61,145,75,70
050,29,063,"Missouri","DeKalb County",4,62,137,74,63
050,29,063,"Missouri","DeKalb County",4,63,135,75,60
050,29,063,"Missouri","DeKalb County",4,64,135,73,62
050,29,063,"Missouri","DeKalb County",4,65,146,70,76
050,29,063,"Missouri","DeKalb County",4,66,129,56,73
050,29,063,"Missouri","DeKalb County",4,67,101,48,53
050,29,063,"Missouri","DeKalb County",4,68,121,63,58
050,29,063,"Missouri","DeKalb County",4,69,107,53,54
050,29,063,"Missouri","DeKalb County",4,70,123,64,59
050,29,063,"Missouri","DeKalb County",4,71,129,70,59
050,29,063,"Missouri","DeKalb County",4,72,93,50,43
050,29,063,"Missouri","DeKalb County",4,73,81,41,40
050,29,063,"Missouri","DeKalb County",4,74,84,37,47
050,29,063,"Missouri","DeKalb County",4,75,90,43,47
050,29,063,"Missouri","DeKalb County",4,76,65,25,40
050,29,063,"Missouri","DeKalb County",4,77,61,27,34
050,29,063,"Missouri","DeKalb County",4,78,62,30,32
050,29,063,"Missouri","DeKalb County",4,79,73,35,38
050,29,063,"Missouri","DeKalb County",4,80,77,37,40
050,29,063,"Missouri","DeKalb County",4,81,61,25,36
050,29,063,"Missouri","DeKalb County",4,82,52,24,28
050,29,063,"Missouri","DeKalb County",4,83,62,25,37
050,29,063,"Missouri","DeKalb County",4,84,52,16,36
050,29,063,"Missouri","DeKalb County",4,85,330,106,224
050,29,063,"Missouri","DeKalb County",5,0,97,43,54
050,29,063,"Missouri","DeKalb County",5,1,114,54,60
050,29,063,"Missouri","DeKalb County",5,2,104,47,57
050,29,063,"Missouri","DeKalb County",5,3,104,60,44
050,29,063,"Missouri","DeKalb County",5,4,113,54,59
050,29,063,"Missouri","DeKalb County",5,5,110,52,58
050,29,063,"Missouri","DeKalb County",5,6,111,54,57
050,29,063,"Missouri","DeKalb County",5,7,140,71,69
050,29,063,"Missouri","DeKalb County",5,8,124,57,67
050,29,063,"Missouri","DeKalb County",5,9,127,63,64
050,29,063,"Missouri","DeKalb County",5,10,114,63,51
050,29,063,"Missouri","DeKalb County",5,11,128,64,64
050,29,063,"Missouri","DeKalb County",5,12,131,69,62
050,29,063,"Missouri","DeKalb County",5,13,139,71,68
050,29,063,"Missouri","DeKalb County",5,14,117,66,51
050,29,063,"Missouri","DeKalb County",5,15,127,67,60
050,29,063,"Missouri","DeKalb County",5,16,132,63,69
050,29,063,"Missouri","DeKalb County",5,17,126,67,59
050,29,063,"Missouri","DeKalb County",5,18,110,64,46
050,29,063,"Missouri","DeKalb County",5,19,82,45,37
050,29,063,"Missouri","DeKalb County",5,20,86,52,34
050,29,063,"Missouri","DeKalb County",5,21,93,52,41
050,29,063,"Missouri","DeKalb County",5,22,113,61,52
050,29,063,"Missouri","DeKalb County",5,23,123,70,53
050,29,063,"Missouri","DeKalb County",5,24,122,73,49
050,29,063,"Missouri","DeKalb County",5,25,93,63,30
050,29,063,"Missouri","DeKalb County",5,26,115,67,48
050,29,063,"Missouri","DeKalb County",5,27,120,68,52
050,29,063,"Missouri","DeKalb County",5,28,117,69,48
050,29,063,"Missouri","DeKalb County",5,29,117,76,41
050,29,063,"Missouri","DeKalb County",5,30,119,67,52
050,29,063,"Missouri","DeKalb County",5,31,138,78,60
050,29,063,"Missouri","DeKalb County",5,32,119,68,51
050,29,063,"Missouri","DeKalb County",5,33,115,70,45
050,29,063,"Missouri","DeKalb County",5,34,116,68,48
050,29,063,"Missouri","DeKalb County",5,35,128,71,57
050,29,063,"Missouri","DeKalb County",5,36,110,63,47
050,29,063,"Missouri","DeKalb County",5,37,125,75,50
050,29,063,"Missouri","DeKalb County",5,38,118,72,46
050,29,063,"Missouri","DeKalb County",5,39,109,67,42
050,29,063,"Missouri","DeKalb County",5,40,127,76,51
050,29,063,"Missouri","DeKalb County",5,41,115,65,50
050,29,063,"Missouri","DeKalb County",5,42,132,73,59
050,29,063,"Missouri","DeKalb County",5,43,132,67,65
050,29,063,"Missouri","DeKalb County",5,44,123,71,52
050,29,063,"Missouri","DeKalb County",5,45,100,60,40
050,29,063,"Missouri","DeKalb County",5,46,130,74,56
050,29,063,"Missouri","DeKalb County",5,47,124,65,59
050,29,063,"Missouri","DeKalb County",5,48,129,73,56
050,29,063,"Missouri","DeKalb County",5,49,121,68,53
050,29,063,"Missouri","DeKalb County",5,50,111,58,53
050,29,063,"Missouri","DeKalb County",5,51,132,74,58
050,29,063,"Missouri","DeKalb County",5,52,135,80,55
050,29,063,"Missouri","DeKalb County",5,53,122,72,50
050,29,063,"Missouri","DeKalb County",5,54,132,81,51
050,29,063,"Missouri","DeKalb County",5,55,125,61,64
050,29,063,"Missouri","DeKalb County",5,56,106,51,55
050,29,063,"Missouri","DeKalb County",5,57,120,59,61
050,29,063,"Missouri","DeKalb County",5,58,132,64,68
050,29,063,"Missouri","DeKalb County",5,59,120,62,58
050,29,063,"Missouri","DeKalb County",5,60,139,69,70
050,29,063,"Missouri","DeKalb County",5,61,142,72,70
050,29,063,"Missouri","DeKalb County",5,62,137,65,72
050,29,063,"Missouri","DeKalb County",5,63,131,66,65
050,29,063,"Missouri","DeKalb County",5,64,125,66,59
050,29,063,"Missouri","DeKalb County",5,65,131,68,63
050,29,063,"Missouri","DeKalb County",5,66,145,65,80
050,29,063,"Missouri","DeKalb County",5,67,124,54,70
050,29,063,"Missouri","DeKalb County",5,68,102,50,52
050,29,063,"Missouri","DeKalb County",5,69,114,57,57
050,29,063,"Missouri","DeKalb County",5,70,102,47,55
050,29,063,"Missouri","DeKalb County",5,71,121,63,58
050,29,063,"Missouri","DeKalb County",5,72,122,65,57
050,29,063,"Missouri","DeKalb County",5,73,82,41,41
050,29,063,"Missouri","DeKalb County",5,74,79,40,39
050,29,063,"Missouri","DeKalb County",5,75,71,32,39
050,29,063,"Missouri","DeKalb County",5,76,88,40,48
050,29,063,"Missouri","DeKalb County",5,77,67,25,42
050,29,063,"Missouri","DeKalb County",5,78,57,22,35
050,29,063,"Missouri","DeKalb County",5,79,56,25,31
050,29,063,"Missouri","DeKalb County",5,80,77,36,41
050,29,063,"Missouri","DeKalb County",5,81,70,31,39
050,29,063,"Missouri","DeKalb County",5,82,61,25,36
050,29,063,"Missouri","DeKalb County",5,83,53,21,32
050,29,063,"Missouri","DeKalb County",5,84,59,21,38
050,29,063,"Missouri","DeKalb County",5,85,330,99,231
050,29,065,"Missouri","Dent County",1,0,147,74,73
050,29,065,"Missouri","Dent County",1,1,141,69,72
050,29,065,"Missouri","Dent County",1,2,188,97,91
050,29,065,"Missouri","Dent County",1,3,175,91,84
050,29,065,"Missouri","Dent County",1,4,188,89,99
050,29,065,"Missouri","Dent County",1,5,180,86,94
050,29,065,"Missouri","Dent County",1,6,180,92,88
050,29,065,"Missouri","Dent County",1,7,181,96,85
050,29,065,"Missouri","Dent County",1,8,175,90,85
050,29,065,"Missouri","Dent County",1,9,171,82,89
050,29,065,"Missouri","Dent County",1,10,193,91,102
050,29,065,"Missouri","Dent County",1,11,189,95,94
050,29,065,"Missouri","Dent County",1,12,199,113,86
050,29,065,"Missouri","Dent County",1,13,193,103,90
050,29,065,"Missouri","Dent County",1,14,175,100,75
050,29,065,"Missouri","Dent County",1,15,183,97,86
050,29,065,"Missouri","Dent County",1,16,190,92,98
050,29,065,"Missouri","Dent County",1,17,201,98,103
050,29,065,"Missouri","Dent County",1,18,164,85,79
050,29,065,"Missouri","Dent County",1,19,130,70,60
050,29,065,"Missouri","Dent County",1,20,138,79,59
050,29,065,"Missouri","Dent County",1,21,135,77,58
050,29,065,"Missouri","Dent County",1,22,135,73,62
050,29,065,"Missouri","Dent County",1,23,133,72,61
050,29,065,"Missouri","Dent County",1,24,136,72,64
050,29,065,"Missouri","Dent County",1,25,136,73,63
050,29,065,"Missouri","Dent County",1,26,141,78,63
050,29,065,"Missouri","Dent County",1,27,145,74,71
050,29,065,"Missouri","Dent County",1,28,154,74,80
050,29,065,"Missouri","Dent County",1,29,158,72,86
050,29,065,"Missouri","Dent County",1,30,145,76,69
050,29,065,"Missouri","Dent County",1,31,143,75,68
050,29,065,"Missouri","Dent County",1,32,161,74,87
050,29,065,"Missouri","Dent County",1,33,150,72,78
050,29,065,"Missouri","Dent County",1,34,152,79,73
050,29,065,"Missouri","Dent County",1,35,160,80,80
050,29,065,"Missouri","Dent County",1,36,161,82,79
050,29,065,"Missouri","Dent County",1,37,156,89,67
050,29,065,"Missouri","Dent County",1,38,155,84,71
050,29,065,"Missouri","Dent County",1,39,189,96,93
050,29,065,"Missouri","Dent County",1,40,178,88,90
050,29,065,"Missouri","Dent County",1,41,178,95,83
050,29,065,"Missouri","Dent County",1,42,158,75,83
050,29,065,"Missouri","Dent County",1,43,159,76,83
050,29,065,"Missouri","Dent County",1,44,146,63,83
050,29,065,"Missouri","Dent County",1,45,155,79,76
050,29,065,"Missouri","Dent County",1,46,148,86,62
050,29,065,"Missouri","Dent County",1,47,161,82,79
050,29,065,"Missouri","Dent County",1,48,158,78,80
050,29,065,"Missouri","Dent County",1,49,180,91,89
050,29,065,"Missouri","Dent County",1,50,176,89,87
050,29,065,"Missouri","Dent County",1,51,162,84,78
050,29,065,"Missouri","Dent County",1,52,155,78,77
050,29,065,"Missouri","Dent County",1,53,183,94,89
050,29,065,"Missouri","Dent County",1,54,202,100,102
050,29,065,"Missouri","Dent County",1,55,203,104,99
050,29,065,"Missouri","Dent County",1,56,214,102,112
050,29,065,"Missouri","Dent County",1,57,236,113,123
050,29,065,"Missouri","Dent County",1,58,243,120,123
050,29,065,"Missouri","Dent County",1,59,221,125,96
050,29,065,"Missouri","Dent County",1,60,227,125,102
050,29,065,"Missouri","Dent County",1,61,251,127,124
050,29,065,"Missouri","Dent County",1,62,223,110,113
050,29,065,"Missouri","Dent County",1,63,229,112,117
050,29,065,"Missouri","Dent County",1,64,204,111,93
050,29,065,"Missouri","Dent County",1,65,202,102,100
050,29,065,"Missouri","Dent County",1,66,200,102,98
050,29,065,"Missouri","Dent County",1,67,195,100,95
050,29,065,"Missouri","Dent County",1,68,176,83,93
050,29,065,"Missouri","Dent County",1,69,174,73,101
050,29,065,"Missouri","Dent County",1,70,176,80,96
050,29,065,"Missouri","Dent County",1,71,162,87,75
050,29,065,"Missouri","Dent County",1,72,169,83,86
050,29,065,"Missouri","Dent County",1,73,179,80,99
050,29,065,"Missouri","Dent County",1,74,116,57,59
050,29,065,"Missouri","Dent County",1,75,137,64,73
050,29,065,"Missouri","Dent County",1,76,132,60,72
050,29,065,"Missouri","Dent County",1,77,120,59,61
050,29,065,"Missouri","Dent County",1,78,118,54,64
050,29,065,"Missouri","Dent County",1,79,109,58,51
050,29,065,"Missouri","Dent County",1,80,96,37,59
050,29,065,"Missouri","Dent County",1,81,80,31,49
050,29,065,"Missouri","Dent County",1,82,80,38,42
050,29,065,"Missouri","Dent County",1,83,77,40,37
050,29,065,"Missouri","Dent County",1,84,68,28,40
050,29,065,"Missouri","Dent County",1,85,374,145,229
050,29,065,"Missouri","Dent County",2,0,143,68,75
050,29,065,"Missouri","Dent County",2,1,141,70,71
050,29,065,"Missouri","Dent County",2,2,181,93,88
050,29,065,"Missouri","Dent County",2,3,180,94,86
050,29,065,"Missouri","Dent County",2,4,186,90,96
050,29,065,"Missouri","Dent County",2,5,183,87,96
050,29,065,"Missouri","Dent County",2,6,180,91,89
050,29,065,"Missouri","Dent County",2,7,180,96,84
050,29,065,"Missouri","Dent County",2,8,177,90,87
050,29,065,"Missouri","Dent County",2,9,170,84,86
050,29,065,"Missouri","Dent County",2,10,188,88,100
050,29,065,"Missouri","Dent County",2,11,188,92,96
050,29,065,"Missouri","Dent County",2,12,198,109,89
050,29,065,"Missouri","Dent County",2,13,193,105,88
050,29,065,"Missouri","Dent County",2,14,180,102,78
050,29,065,"Missouri","Dent County",2,15,181,97,84
050,29,065,"Missouri","Dent County",2,16,192,95,97
050,29,065,"Missouri","Dent County",2,17,198,97,101
050,29,065,"Missouri","Dent County",2,18,165,85,80
050,29,065,"Missouri","Dent County",2,19,130,69,61
050,29,065,"Missouri","Dent County",2,20,139,77,62
050,29,065,"Missouri","Dent County",2,21,137,78,59
050,29,065,"Missouri","Dent County",2,22,137,75,62
050,29,065,"Missouri","Dent County",2,23,136,74,62
050,29,065,"Missouri","Dent County",2,24,134,71,63
050,29,065,"Missouri","Dent County",2,25,135,71,64
050,29,065,"Missouri","Dent County",2,26,140,78,62
050,29,065,"Missouri","Dent County",2,27,143,73,70
050,29,065,"Missouri","Dent County",2,28,153,74,79
050,29,065,"Missouri","Dent County",2,29,158,73,85
050,29,065,"Missouri","Dent County",2,30,149,76,73
050,29,065,"Missouri","Dent County",2,31,142,76,66
050,29,065,"Missouri","Dent County",2,32,155,73,82
050,29,065,"Missouri","Dent County",2,33,155,74,81
050,29,065,"Missouri","Dent County",2,34,151,76,75
050,29,065,"Missouri","Dent County",2,35,160,80,80
050,29,065,"Missouri","Dent County",2,36,155,79,76
050,29,065,"Missouri","Dent County",2,37,157,87,70
050,29,065,"Missouri","Dent County",2,38,158,87,71
050,29,065,"Missouri","Dent County",2,39,180,92,88
050,29,065,"Missouri","Dent County",2,40,184,92,92
050,29,065,"Missouri","Dent County",2,41,178,93,85
050,29,065,"Missouri","Dent County",2,42,159,77,82
050,29,065,"Missouri","Dent County",2,43,157,75,82
050,29,065,"Missouri","Dent County",2,44,145,64,81
050,29,065,"Missouri","Dent County",2,45,154,75,79
050,29,065,"Missouri","Dent County",2,46,150,85,65
050,29,065,"Missouri","Dent County",2,47,157,83,74
050,29,065,"Missouri","Dent County",2,48,159,80,79
050,29,065,"Missouri","Dent County",2,49,175,88,87
050,29,065,"Missouri","Dent County",2,50,176,87,89
050,29,065,"Missouri","Dent County",2,51,164,85,79
050,29,065,"Missouri","Dent County",2,52,156,78,78
050,29,065,"Missouri","Dent County",2,53,175,89,86
050,29,065,"Missouri","Dent County",2,54,197,99,98
050,29,065,"Missouri","Dent County",2,55,206,105,101
050,29,065,"Missouri","Dent County",2,56,213,104,109
050,29,065,"Missouri","Dent County",2,57,229,109,120
050,29,065,"Missouri","Dent County",2,58,239,118,121
050,29,065,"Missouri","Dent County",2,59,224,122,102
050,29,065,"Missouri","Dent County",2,60,226,125,101
050,29,065,"Missouri","Dent County",2,61,245,126,119
050,29,065,"Missouri","Dent County",2,62,231,115,116
050,29,065,"Missouri","Dent County",2,63,231,113,118
050,29,065,"Missouri","Dent County",2,64,207,109,98
050,29,065,"Missouri","Dent County",2,65,202,104,98
050,29,065,"Missouri","Dent County",2,66,203,103,100
050,29,065,"Missouri","Dent County",2,67,197,101,96
050,29,065,"Missouri","Dent County",2,68,178,86,92
050,29,065,"Missouri","Dent County",2,69,175,75,100
050,29,065,"Missouri","Dent County",2,70,175,78,97
050,29,065,"Missouri","Dent County",2,71,165,85,80
050,29,065,"Missouri","Dent County",2,72,164,82,82
050,29,065,"Missouri","Dent County",2,73,186,87,99
050,29,065,"Missouri","Dent County",2,74,125,60,65
050,29,065,"Missouri","Dent County",2,75,129,61,68
050,29,065,"Missouri","Dent County",2,76,127,55,72
050,29,065,"Missouri","Dent County",2,77,122,59,63
050,29,065,"Missouri","Dent County",2,78,112,50,62
050,29,065,"Missouri","Dent County",2,79,110,57,53
050,29,065,"Missouri","Dent County",2,80,93,37,56
050,29,065,"Missouri","Dent County",2,81,82,31,51
050,29,065,"Missouri","Dent County",2,82,79,36,43
050,29,065,"Missouri","Dent County",2,83,77,40,37
050,29,065,"Missouri","Dent County",2,84,65,28,37
050,29,065,"Missouri","Dent County",2,85,376,145,231
050,29,065,"Missouri","Dent County",3,0,158,79,79
050,29,065,"Missouri","Dent County",3,1,157,76,81
050,29,065,"Missouri","Dent County",3,2,139,71,68
050,29,065,"Missouri","Dent County",3,3,185,94,91
050,29,065,"Missouri","Dent County",3,4,172,92,80
050,29,065,"Missouri","Dent County",3,5,180,84,96
050,29,065,"Missouri","Dent County",3,6,182,85,97
050,29,065,"Missouri","Dent County",3,7,181,92,89
050,29,065,"Missouri","Dent County",3,8,192,102,90
050,29,065,"Missouri","Dent County",3,9,188,94,94
050,29,065,"Missouri","Dent County",3,10,170,85,85
050,29,065,"Missouri","Dent County",3,11,187,88,99
050,29,065,"Missouri","Dent County",3,12,196,100,96
050,29,065,"Missouri","Dent County",3,13,207,118,89
050,29,065,"Missouri","Dent County",3,14,190,104,86
050,29,065,"Missouri","Dent County",3,15,181,101,80
050,29,065,"Missouri","Dent County",3,16,179,100,79
050,29,065,"Missouri","Dent County",3,17,184,91,93
050,29,065,"Missouri","Dent County",3,18,165,84,81
050,29,065,"Missouri","Dent County",3,19,124,59,65
050,29,065,"Missouri","Dent County",3,20,132,63,69
050,29,065,"Missouri","Dent County",3,21,152,88,64
050,29,065,"Missouri","Dent County",3,22,138,80,58
050,29,065,"Missouri","Dent County",3,23,130,77,53
050,29,065,"Missouri","Dent County",3,24,134,67,67
050,29,065,"Missouri","Dent County",3,25,142,80,62
050,29,065,"Missouri","Dent County",3,26,134,71,63
050,29,065,"Missouri","Dent County",3,27,131,72,59
050,29,065,"Missouri","Dent County",3,28,132,66,66
050,29,065,"Missouri","Dent County",3,29,166,84,82
050,29,065,"Missouri","Dent County",3,30,170,76,94
050,29,065,"Missouri","Dent County",3,31,147,80,67
050,29,065,"Missouri","Dent County",3,32,152,76,76
050,29,065,"Missouri","Dent County",3,33,158,75,83
050,29,065,"Missouri","Dent County",3,34,159,72,87
050,29,065,"Missouri","Dent County",3,35,151,76,75
050,29,065,"Missouri","Dent County",3,36,165,82,83
050,29,065,"Missouri","Dent County",3,37,152,76,76
050,29,065,"Missouri","Dent County",3,38,157,89,68
050,29,065,"Missouri","Dent County",3,39,163,93,70
050,29,065,"Missouri","Dent County",3,40,183,93,90
050,29,065,"Missouri","Dent County",3,41,189,97,92
050,29,065,"Missouri","Dent County",3,42,170,87,83
050,29,065,"Missouri","Dent County",3,43,172,84,88
050,29,065,"Missouri","Dent County",3,44,155,80,75
050,29,065,"Missouri","Dent County",3,45,155,72,83
050,29,065,"Missouri","Dent County",3,46,162,79,83
050,29,065,"Missouri","Dent County",3,47,163,89,74
050,29,065,"Missouri","Dent County",3,48,164,85,79
050,29,065,"Missouri","Dent County",3,49,163,77,86
050,29,065,"Missouri","Dent County",3,50,175,88,87
050,29,065,"Missouri","Dent County",3,51,178,89,89
050,29,065,"Missouri","Dent County",3,52,173,94,79
050,29,065,"Missouri","Dent County",3,53,157,78,79
050,29,065,"Missouri","Dent County",3,54,183,93,90
050,29,065,"Missouri","Dent County",3,55,196,104,92
050,29,065,"Missouri","Dent County",3,56,216,106,110
050,29,065,"Missouri","Dent County",3,57,199,98,101
050,29,065,"Missouri","Dent County",3,58,235,112,123
050,29,065,"Missouri","Dent County",3,59,238,121,117
050,29,065,"Missouri","Dent County",3,60,235,126,109
050,29,065,"Missouri","Dent County",3,61,222,119,103
050,29,065,"Missouri","Dent County",3,62,251,130,121
050,29,065,"Missouri","Dent County",3,63,235,119,116
050,29,065,"Missouri","Dent County",3,64,234,114,120
050,29,065,"Missouri","Dent County",3,65,208,110,98
050,29,065,"Missouri","Dent County",3,66,190,96,94
050,29,065,"Missouri","Dent County",3,67,204,101,103
050,29,065,"Missouri","Dent County",3,68,198,101,97
050,29,065,"Missouri","Dent County",3,69,184,90,94
050,29,065,"Missouri","Dent County",3,70,167,71,96
050,29,065,"Missouri","Dent County",3,71,167,76,91
050,29,065,"Missouri","Dent County",3,72,162,85,77
050,29,065,"Missouri","Dent County",3,73,158,81,77
050,29,065,"Missouri","Dent County",3,74,181,88,93
050,29,065,"Missouri","Dent County",3,75,120,59,61
050,29,065,"Missouri","Dent County",3,76,119,56,63
050,29,065,"Missouri","Dent County",3,77,123,54,69
050,29,065,"Missouri","Dent County",3,78,118,55,63
050,29,065,"Missouri","Dent County",3,79,102,48,54
050,29,065,"Missouri","Dent County",3,80,96,47,49
050,29,065,"Missouri","Dent County",3,81,88,35,53
050,29,065,"Missouri","Dent County",3,82,70,22,48
050,29,065,"Missouri","Dent County",3,83,76,34,42
050,29,065,"Missouri","Dent County",3,84,64,28,36
050,29,065,"Missouri","Dent County",3,85,374,146,228
050,29,065,"Missouri","Dent County",4,0,149,75,74
050,29,065,"Missouri","Dent County",4,1,173,82,91
050,29,065,"Missouri","Dent County",4,2,151,81,70
050,29,065,"Missouri","Dent County",4,3,133,67,66
050,29,065,"Missouri","Dent County",4,4,206,104,102
050,29,065,"Missouri","Dent County",4,5,178,91,87
050,29,065,"Missouri","Dent County",4,6,187,84,103
050,29,065,"Missouri","Dent County",4,7,172,84,88
050,29,065,"Missouri","Dent County",4,8,179,92,87
050,29,065,"Missouri","Dent County",4,9,200,110,90
050,29,065,"Missouri","Dent County",4,10,188,92,96
050,29,065,"Missouri","Dent County",4,11,172,87,85
050,29,065,"Missouri","Dent County",4,12,200,96,104
050,29,065,"Missouri","Dent County",4,13,202,99,103
050,29,065,"Missouri","Dent County",4,14,197,112,85
050,29,065,"Missouri","Dent County",4,15,182,99,83
050,29,065,"Missouri","Dent County",4,16,188,99,89
050,29,065,"Missouri","Dent County",4,17,191,108,83
050,29,065,"Missouri","Dent County",4,18,154,82,72
050,29,065,"Missouri","Dent County",4,19,120,67,53
050,29,065,"Missouri","Dent County",4,20,132,64,68
050,29,065,"Missouri","Dent County",4,21,137,66,71
050,29,065,"Missouri","Dent County",4,22,160,94,66
050,29,065,"Missouri","Dent County",4,23,132,76,56
050,29,065,"Missouri","Dent County",4,24,130,71,59
050,29,065,"Missouri","Dent County",4,25,149,75,74
050,29,065,"Missouri","Dent County",4,26,141,82,59
050,29,065,"Missouri","Dent County",4,27,129,67,62
050,29,065,"Missouri","Dent County",4,28,134,72,62
050,29,065,"Missouri","Dent County",4,29,140,73,67
050,29,065,"Missouri","Dent County",4,30,170,85,85
050,29,065,"Missouri","Dent County",4,31,179,74,105
050,29,065,"Missouri","Dent County",4,32,153,81,72
050,29,065,"Missouri","Dent County",4,33,152,78,74
050,29,065,"Missouri","Dent County",4,34,165,76,89
050,29,065,"Missouri","Dent County",4,35,167,76,91
050,29,065,"Missouri","Dent County",4,36,149,76,73
050,29,065,"Missouri","Dent County",4,37,158,79,79
050,29,065,"Missouri","Dent County",4,38,158,81,77
050,29,065,"Missouri","Dent County",4,39,172,95,77
050,29,065,"Missouri","Dent County",4,40,162,94,68
050,29,065,"Missouri","Dent County",4,41,186,92,94
050,29,065,"Missouri","Dent County",4,42,192,98,94
050,29,065,"Missouri","Dent County",4,43,178,93,85
050,29,065,"Missouri","Dent County",4,44,172,83,89
050,29,065,"Missouri","Dent County",4,45,159,79,80
050,29,065,"Missouri","Dent County",4,46,156,75,81
050,29,065,"Missouri","Dent County",4,47,166,82,84
050,29,065,"Missouri","Dent County",4,48,161,90,71
050,29,065,"Missouri","Dent County",4,49,158,80,78
050,29,065,"Missouri","Dent County",4,50,159,75,84
050,29,065,"Missouri","Dent County",4,51,179,83,96
050,29,065,"Missouri","Dent County",4,52,187,90,97
050,29,065,"Missouri","Dent County",4,53,169,94,75
050,29,065,"Missouri","Dent County",4,54,158,77,81
050,29,065,"Missouri","Dent County",4,55,178,92,86
050,29,065,"Missouri","Dent County",4,56,199,110,89
050,29,065,"Missouri","Dent County",4,57,209,107,102
050,29,065,"Missouri","Dent County",4,58,198,98,100
050,29,065,"Missouri","Dent County",4,59,234,111,123
050,29,065,"Missouri","Dent County",4,60,239,121,118
050,29,065,"Missouri","Dent County",4,61,234,123,111
050,29,065,"Missouri","Dent County",4,62,220,119,101
050,29,065,"Missouri","Dent County",4,63,240,125,115
050,29,065,"Missouri","Dent County",4,64,234,123,111
050,29,065,"Missouri","Dent County",4,65,233,112,121
050,29,065,"Missouri","Dent County",4,66,206,111,95
050,29,065,"Missouri","Dent County",4,67,190,96,94
050,29,065,"Missouri","Dent County",4,68,198,98,100
050,29,065,"Missouri","Dent County",4,69,204,101,103
050,29,065,"Missouri","Dent County",4,70,182,89,93
050,29,065,"Missouri","Dent County",4,71,158,66,92
050,29,065,"Missouri","Dent County",4,72,159,73,86
050,29,065,"Missouri","Dent County",4,73,158,83,75
050,29,065,"Missouri","Dent County",4,74,149,80,69
050,29,065,"Missouri","Dent County",4,75,174,83,91
050,29,065,"Missouri","Dent County",4,76,110,50,60
050,29,065,"Missouri","Dent County",4,77,115,53,62
050,29,065,"Missouri","Dent County",4,78,114,49,65
050,29,065,"Missouri","Dent County",4,79,116,58,58
050,29,065,"Missouri","Dent County",4,80,87,38,49
050,29,065,"Missouri","Dent County",4,81,93,45,48
050,29,065,"Missouri","Dent County",4,82,79,30,49
050,29,065,"Missouri","Dent County",4,83,68,23,45
050,29,065,"Missouri","Dent County",4,84,56,20,36
050,29,065,"Missouri","Dent County",4,85,383,152,231
050,29,065,"Missouri","Dent County",5,0,148,74,74
050,29,065,"Missouri","Dent County",5,1,153,77,76
050,29,065,"Missouri","Dent County",5,2,166,76,90
050,29,065,"Missouri","Dent County",5,3,155,86,69
050,29,065,"Missouri","Dent County",5,4,145,73,72
050,29,065,"Missouri","Dent County",5,5,200,104,96
050,29,065,"Missouri","Dent County",5,6,177,89,88
050,29,065,"Missouri","Dent County",5,7,190,86,104
050,29,065,"Missouri","Dent County",5,8,183,92,91
050,29,065,"Missouri","Dent County",5,9,182,92,90
050,29,065,"Missouri","Dent County",5,10,209,117,92
050,29,065,"Missouri","Dent County",5,11,194,95,99
050,29,065,"Missouri","Dent County",5,12,174,93,81
050,29,065,"Missouri","Dent County",5,13,207,97,110
050,29,065,"Missouri","Dent County",5,14,209,104,105
050,29,065,"Missouri","Dent County",5,15,212,122,90
050,29,065,"Missouri","Dent County",5,16,191,101,90
050,29,065,"Missouri","Dent County",5,17,201,109,92
050,29,065,"Missouri","Dent County",5,18,159,91,68
050,29,065,"Missouri","Dent County",5,19,112,61,51
050,29,065,"Missouri","Dent County",5,20,123,66,57
050,29,065,"Missouri","Dent County",5,21,144,68,76
050,29,065,"Missouri","Dent County",5,22,142,71,71
050,29,065,"Missouri","Dent County",5,23,157,95,62
050,29,065,"Missouri","Dent County",5,24,136,75,61
050,29,065,"Missouri","Dent County",5,25,135,74,61
050,29,065,"Missouri","Dent County",5,26,149,80,69
050,29,065,"Missouri","Dent County",5,27,140,73,67
050,29,065,"Missouri","Dent County",5,28,135,70,65
050,29,065,"Missouri","Dent County",5,29,138,76,62
050,29,065,"Missouri","Dent County",5,30,140,72,68
050,29,065,"Missouri","Dent County",5,31,172,86,86
050,29,065,"Missouri","Dent County",5,32,175,74,101
050,29,065,"Missouri","Dent County",5,33,162,87,75
050,29,065,"Missouri","Dent County",5,34,150,74,76
050,29,065,"Missouri","Dent County",5,35,165,80,85
050,29,065,"Missouri","Dent County",5,36,175,79,96
050,29,065,"Missouri","Dent County",5,37,153,79,74
050,29,065,"Missouri","Dent County",5,38,169,88,81
050,29,065,"Missouri","Dent County",5,39,169,87,82
050,29,065,"Missouri","Dent County",5,40,173,95,78
050,29,065,"Missouri","Dent County",5,41,181,101,80
050,29,065,"Missouri","Dent County",5,42,186,93,93
050,29,065,"Missouri","Dent County",5,43,204,105,99
050,29,065,"Missouri","Dent County",5,44,184,97,87
050,29,065,"Missouri","Dent County",5,45,177,86,91
050,29,065,"Missouri","Dent County",5,46,161,79,82
050,29,065,"Missouri","Dent County",5,47,160,82,78
050,29,065,"Missouri","Dent County",5,48,168,84,84
050,29,065,"Missouri","Dent County",5,49,165,92,73
050,29,065,"Missouri","Dent County",5,50,167,81,86
050,29,065,"Missouri","Dent County",5,51,158,73,85
050,29,065,"Missouri","Dent County",5,52,184,87,97
050,29,065,"Missouri","Dent County",5,53,188,90,98
050,29,065,"Missouri","Dent County",5,54,169,92,77
050,29,065,"Missouri","Dent County",5,55,164,82,82
050,29,065,"Missouri","Dent County",5,56,177,93,84
050,29,065,"Missouri","Dent County",5,57,200,107,93
050,29,065,"Missouri","Dent County",5,58,214,107,107
050,29,065,"Missouri","Dent County",5,59,200,101,99
050,29,065,"Missouri","Dent County",5,60,237,114,123
050,29,065,"Missouri","Dent County",5,61,243,123,120
050,29,065,"Missouri","Dent County",5,62,236,123,113
050,29,065,"Missouri","Dent County",5,63,220,118,102
050,29,065,"Missouri","Dent County",5,64,242,126,116
050,29,065,"Missouri","Dent County",5,65,230,119,111
050,29,065,"Missouri","Dent County",5,66,228,111,117
050,29,065,"Missouri","Dent County",5,67,207,111,96
050,29,065,"Missouri","Dent County",5,68,189,97,92
050,29,065,"Missouri","Dent County",5,69,198,100,98
050,29,065,"Missouri","Dent County",5,70,204,104,100
050,29,065,"Missouri","Dent County",5,71,166,84,82
050,29,065,"Missouri","Dent County",5,72,149,61,88
050,29,065,"Missouri","Dent County",5,73,157,70,87
050,29,065,"Missouri","Dent County",5,74,150,79,71
050,29,065,"Missouri","Dent County",5,75,147,78,69
050,29,065,"Missouri","Dent County",5,76,158,75,83
050,29,065,"Missouri","Dent County",5,77,103,48,55
050,29,065,"Missouri","Dent County",5,78,109,49,60
050,29,065,"Missouri","Dent County",5,79,111,49,62
050,29,065,"Missouri","Dent County",5,80,102,48,54
050,29,065,"Missouri","Dent County",5,81,85,37,48
050,29,065,"Missouri","Dent County",5,82,86,42,44
050,29,065,"Missouri","Dent County",5,83,76,30,46
050,29,065,"Missouri","Dent County",5,84,52,9,43
050,29,065,"Missouri","Dent County",5,85,386,150,236
050,29,067,"Missouri","Douglas County",1,0,118,62,56
050,29,067,"Missouri","Douglas County",1,1,133,70,63
050,29,067,"Missouri","Douglas County",1,2,129,71,58
050,29,067,"Missouri","Douglas County",1,3,127,75,52
050,29,067,"Missouri","Douglas County",1,4,127,64,63
050,29,067,"Missouri","Douglas County",1,5,153,78,75
050,29,067,"Missouri","Douglas County",1,6,129,68,61
050,29,067,"Missouri","Douglas County",1,7,134,64,70
050,29,067,"Missouri","Douglas County",1,8,141,76,65
050,29,067,"Missouri","Douglas County",1,9,133,68,65
050,29,067,"Missouri","Douglas County",1,10,146,77,69
050,29,067,"Missouri","Douglas County",1,11,154,79,75
050,29,067,"Missouri","Douglas County",1,12,158,76,82
050,29,067,"Missouri","Douglas County",1,13,161,81,80
050,29,067,"Missouri","Douglas County",1,14,163,78,85
050,29,067,"Missouri","Douglas County",1,15,170,82,88
050,29,067,"Missouri","Douglas County",1,16,163,86,77
050,29,067,"Missouri","Douglas County",1,17,146,76,70
050,29,067,"Missouri","Douglas County",1,18,110,58,52
050,29,067,"Missouri","Douglas County",1,19,82,43,39
050,29,067,"Missouri","Douglas County",1,20,86,49,37
050,29,067,"Missouri","Douglas County",1,21,90,52,38
050,29,067,"Missouri","Douglas County",1,22,99,53,46
050,29,067,"Missouri","Douglas County",1,23,98,55,43
050,29,067,"Missouri","Douglas County",1,24,95,48,47
050,29,067,"Missouri","Douglas County",1,25,89,44,45
050,29,067,"Missouri","Douglas County",1,26,100,43,57
050,29,067,"Missouri","Douglas County",1,27,99,58,41
050,29,067,"Missouri","Douglas County",1,28,110,61,49
050,29,067,"Missouri","Douglas County",1,29,122,64,58
050,29,067,"Missouri","Douglas County",1,30,118,64,54
050,29,067,"Missouri","Douglas County",1,31,112,50,62
050,29,067,"Missouri","Douglas County",1,32,115,56,59
050,29,067,"Missouri","Douglas County",1,33,120,56,64
050,29,067,"Missouri","Douglas County",1,34,122,59,63
050,29,067,"Missouri","Douglas County",1,35,133,77,56
050,29,067,"Missouri","Douglas County",1,36,124,68,56
050,29,067,"Missouri","Douglas County",1,37,122,62,60
050,29,067,"Missouri","Douglas County",1,38,133,70,63
050,29,067,"Missouri","Douglas County",1,39,140,77,63
050,29,067,"Missouri","Douglas County",1,40,121,60,61
050,29,067,"Missouri","Douglas County",1,41,104,56,48
050,29,067,"Missouri","Douglas County",1,42,113,64,49
050,29,067,"Missouri","Douglas County",1,43,117,59,58
050,29,067,"Missouri","Douglas County",1,44,117,60,57
050,29,067,"Missouri","Douglas County",1,45,119,58,61
050,29,067,"Missouri","Douglas County",1,46,116,60,56
050,29,067,"Missouri","Douglas County",1,47,115,55,60
050,29,067,"Missouri","Douglas County",1,48,130,62,68
050,29,067,"Missouri","Douglas County",1,49,144,73,71
050,29,067,"Missouri","Douglas County",1,50,133,68,65
050,29,067,"Missouri","Douglas County",1,51,134,64,70
050,29,067,"Missouri","Douglas County",1,52,138,69,69
050,29,067,"Missouri","Douglas County",1,53,134,68,66
050,29,067,"Missouri","Douglas County",1,54,146,74,72
050,29,067,"Missouri","Douglas County",1,55,167,80,87
050,29,067,"Missouri","Douglas County",1,56,170,98,72
050,29,067,"Missouri","Douglas County",1,57,189,97,92
050,29,067,"Missouri","Douglas County",1,58,175,89,86
050,29,067,"Missouri","Douglas County",1,59,173,92,81
050,29,067,"Missouri","Douglas County",1,60,180,89,91
050,29,067,"Missouri","Douglas County",1,61,204,104,100
050,29,067,"Missouri","Douglas County",1,62,193,90,103
050,29,067,"Missouri","Douglas County",1,63,206,105,101
050,29,067,"Missouri","Douglas County",1,64,191,91,100
050,29,067,"Missouri","Douglas County",1,65,177,81,96
050,29,067,"Missouri","Douglas County",1,66,199,100,99
050,29,067,"Missouri","Douglas County",1,67,193,96,97
050,29,067,"Missouri","Douglas County",1,68,168,75,93
050,29,067,"Missouri","Douglas County",1,69,174,85,89
050,29,067,"Missouri","Douglas County",1,70,167,87,80
050,29,067,"Missouri","Douglas County",1,71,171,93,78
050,29,067,"Missouri","Douglas County",1,72,161,84,77
050,29,067,"Missouri","Douglas County",1,73,154,75,79
050,29,067,"Missouri","Douglas County",1,74,114,51,63
050,29,067,"Missouri","Douglas County",1,75,123,54,69
050,29,067,"Missouri","Douglas County",1,76,119,55,64
050,29,067,"Missouri","Douglas County",1,77,112,55,57
050,29,067,"Missouri","Douglas County",1,78,91,45,46
050,29,067,"Missouri","Douglas County",1,79,86,47,39
050,29,067,"Missouri","Douglas County",1,80,80,37,43
050,29,067,"Missouri","Douglas County",1,81,64,30,34
050,29,067,"Missouri","Douglas County",1,82,65,28,37
050,29,067,"Missouri","Douglas County",1,83,68,33,35
050,29,067,"Missouri","Douglas County",1,84,52,18,34
050,29,067,"Missouri","Douglas County",1,85,305,125,180
050,29,067,"Missouri","Douglas County",2,0,127,69,58
050,29,067,"Missouri","Douglas County",2,1,133,69,64
050,29,067,"Missouri","Douglas County",2,2,131,70,61
050,29,067,"Missouri","Douglas County",2,3,128,74,54
050,29,067,"Missouri","Douglas County",2,4,131,70,61
050,29,067,"Missouri","Douglas County",2,5,148,75,73
050,29,067,"Missouri","Douglas County",2,6,135,70,65
050,29,067,"Missouri","Douglas County",2,7,133,65,68
050,29,067,"Missouri","Douglas County",2,8,138,72,66
050,29,067,"Missouri","Douglas County",2,9,133,69,64
050,29,067,"Missouri","Douglas County",2,10,142,74,68
050,29,067,"Missouri","Douglas County",2,11,151,77,74
050,29,067,"Missouri","Douglas County",2,12,157,77,80
050,29,067,"Missouri","Douglas County",2,13,161,80,81
050,29,067,"Missouri","Douglas County",2,14,163,80,83
050,29,067,"Missouri","Douglas County",2,15,171,82,89
050,29,067,"Missouri","Douglas County",2,16,164,85,79
050,29,067,"Missouri","Douglas County",2,17,150,79,71
050,29,067,"Missouri","Douglas County",2,18,111,59,52
050,29,067,"Missouri","Douglas County",2,19,84,43,41
050,29,067,"Missouri","Douglas County",2,20,89,50,39
050,29,067,"Missouri","Douglas County",2,21,91,52,39
050,29,067,"Missouri","Douglas County",2,22,99,55,44
050,29,067,"Missouri","Douglas County",2,23,100,55,45
050,29,067,"Missouri","Douglas County",2,24,96,50,46
050,29,067,"Missouri","Douglas County",2,25,91,45,46
050,29,067,"Missouri","Douglas County",2,26,99,45,54
050,29,067,"Missouri","Douglas County",2,27,101,56,45
050,29,067,"Missouri","Douglas County",2,28,107,61,46
050,29,067,"Missouri","Douglas County",2,29,120,64,56
050,29,067,"Missouri","Douglas County",2,30,121,66,55
050,29,067,"Missouri","Douglas County",2,31,113,54,59
050,29,067,"Missouri","Douglas County",2,32,112,53,59
050,29,067,"Missouri","Douglas County",2,33,120,56,64
050,29,067,"Missouri","Douglas County",2,34,123,60,63
050,29,067,"Missouri","Douglas County",2,35,132,74,58
050,29,067,"Missouri","Douglas County",2,36,127,71,56
050,29,067,"Missouri","Douglas County",2,37,123,64,59
050,29,067,"Missouri","Douglas County",2,38,131,68,63
050,29,067,"Missouri","Douglas County",2,39,139,76,63
050,29,067,"Missouri","Douglas County",2,40,127,65,62
050,29,067,"Missouri","Douglas County",2,41,106,55,51
050,29,067,"Missouri","Douglas County",2,42,112,62,50
050,29,067,"Missouri","Douglas County",2,43,118,61,57
050,29,067,"Missouri","Douglas County",2,44,119,61,58
050,29,067,"Missouri","Douglas County",2,45,118,58,60
050,29,067,"Missouri","Douglas County",2,46,118,60,58
050,29,067,"Missouri","Douglas County",2,47,115,56,59
050,29,067,"Missouri","Douglas County",2,48,126,60,66
050,29,067,"Missouri","Douglas County",2,49,141,73,68
050,29,067,"Missouri","Douglas County",2,50,138,71,67
050,29,067,"Missouri","Douglas County",2,51,134,65,69
050,29,067,"Missouri","Douglas County",2,52,137,68,69
050,29,067,"Missouri","Douglas County",2,53,136,68,68
050,29,067,"Missouri","Douglas County",2,54,145,73,72
050,29,067,"Missouri","Douglas County",2,55,161,78,83
050,29,067,"Missouri","Douglas County",2,56,171,94,77
050,29,067,"Missouri","Douglas County",2,57,184,97,87
050,29,067,"Missouri","Douglas County",2,58,176,90,86
050,29,067,"Missouri","Douglas County",2,59,175,92,83
050,29,067,"Missouri","Douglas County",2,60,179,89,90
050,29,067,"Missouri","Douglas County",2,61,197,99,98
050,29,067,"Missouri","Douglas County",2,62,197,94,103
050,29,067,"Missouri","Douglas County",2,63,205,102,103
050,29,067,"Missouri","Douglas County",2,64,194,94,100
050,29,067,"Missouri","Douglas County",2,65,176,82,94
050,29,067,"Missouri","Douglas County",2,66,193,96,97
050,29,067,"Missouri","Douglas County",2,67,194,97,97
050,29,067,"Missouri","Douglas County",2,68,174,79,95
050,29,067,"Missouri","Douglas County",2,69,174,83,91
050,29,067,"Missouri","Douglas County",2,70,167,85,82
050,29,067,"Missouri","Douglas County",2,71,171,92,79
050,29,067,"Missouri","Douglas County",2,72,159,85,74
050,29,067,"Missouri","Douglas County",2,73,163,80,83
050,29,067,"Missouri","Douglas County",2,74,115,53,62
050,29,067,"Missouri","Douglas County",2,75,121,54,67
050,29,067,"Missouri","Douglas County",2,76,116,53,63
050,29,067,"Missouri","Douglas County",2,77,116,56,60
050,29,067,"Missouri","Douglas County",2,78,92,44,48
050,29,067,"Missouri","Douglas County",2,79,84,45,39
050,29,067,"Missouri","Douglas County",2,80,79,39,40
050,29,067,"Missouri","Douglas County",2,81,66,31,35
050,29,067,"Missouri","Douglas County",2,82,65,29,36
050,29,067,"Missouri","Douglas County",2,83,65,32,33
050,29,067,"Missouri","Douglas County",2,84,55,21,34
050,29,067,"Missouri","Douglas County",2,85,307,125,182
050,29,067,"Missouri","Douglas County",3,0,137,84,53
050,29,067,"Missouri","Douglas County",3,1,119,67,52
050,29,067,"Missouri","Douglas County",3,2,140,75,65
050,29,067,"Missouri","Douglas County",3,3,135,68,67
050,29,067,"Missouri","Douglas County",3,4,134,78,56
050,29,067,"Missouri","Douglas County",3,5,142,77,65
050,29,067,"Missouri","Douglas County",3,6,144,72,72
050,29,067,"Missouri","Douglas County",3,7,139,73,66
050,29,067,"Missouri","Douglas County",3,8,139,67,72
050,29,067,"Missouri","Douglas County",3,9,143,72,71
050,29,067,"Missouri","Douglas County",3,10,136,70,66
050,29,067,"Missouri","Douglas County",3,11,143,69,74
050,29,067,"Missouri","Douglas County",3,12,157,78,79
050,29,067,"Missouri","Douglas County",3,13,165,83,82
050,29,067,"Missouri","Douglas County",3,14,167,80,87
050,29,067,"Missouri","Douglas County",3,15,176,87,89
050,29,067,"Missouri","Douglas County",3,16,176,83,93
050,29,067,"Missouri","Douglas County",3,17,169,91,78
050,29,067,"Missouri","Douglas County",3,18,134,74,60
050,29,067,"Missouri","Douglas County",3,19,85,44,41
050,29,067,"Missouri","Douglas County",3,20,85,41,44
050,29,067,"Missouri","Douglas County",3,21,96,58,38
050,29,067,"Missouri","Douglas County",3,22,97,46,51
050,29,067,"Missouri","Douglas County",3,23,104,52,52
050,29,067,"Missouri","Douglas County",3,24,101,57,44
050,29,067,"Missouri","Douglas County",3,25,97,54,43
050,29,067,"Missouri","Douglas County",3,26,95,52,43
050,29,067,"Missouri","Douglas County",3,27,100,48,52
050,29,067,"Missouri","Douglas County",3,28,101,52,49
050,29,067,"Missouri","Douglas County",3,29,108,59,49
050,29,067,"Missouri","Douglas County",3,30,129,68,61
050,29,067,"Missouri","Douglas County",3,31,122,69,53
050,29,067,"Missouri","Douglas County",3,32,113,52,61
050,29,067,"Missouri","Douglas County",3,33,121,56,65
050,29,067,"Missouri","Douglas County",3,34,120,57,63
050,29,067,"Missouri","Douglas County",3,35,131,63,68
050,29,067,"Missouri","Douglas County",3,36,136,73,63
050,29,067,"Missouri","Douglas County",3,37,131,75,56
050,29,067,"Missouri","Douglas County",3,38,127,68,59
050,29,067,"Missouri","Douglas County",3,39,139,71,68
050,29,067,"Missouri","Douglas County",3,40,147,80,67
050,29,067,"Missouri","Douglas County",3,41,132,68,64
050,29,067,"Missouri","Douglas County",3,42,111,59,52
050,29,067,"Missouri","Douglas County",3,43,124,69,55
050,29,067,"Missouri","Douglas County",3,44,127,66,61
050,29,067,"Missouri","Douglas County",3,45,117,60,57
050,29,067,"Missouri","Douglas County",3,46,125,66,59
050,29,067,"Missouri","Douglas County",3,47,122,59,63
050,29,067,"Missouri","Douglas County",3,48,123,63,60
050,29,067,"Missouri","Douglas County",3,49,127,61,66
050,29,067,"Missouri","Douglas County",3,50,132,71,61
050,29,067,"Missouri","Douglas County",3,51,143,71,72
050,29,067,"Missouri","Douglas County",3,52,133,65,68
050,29,067,"Missouri","Douglas County",3,53,139,66,73
050,29,067,"Missouri","Douglas County",3,54,136,65,71
050,29,067,"Missouri","Douglas County",3,55,137,69,68
050,29,067,"Missouri","Douglas County",3,56,160,76,84
050,29,067,"Missouri","Douglas County",3,57,169,92,77
050,29,067,"Missouri","Douglas County",3,58,182,95,87
050,29,067,"Missouri","Douglas County",3,59,177,89,88
050,29,067,"Missouri","Douglas County",3,60,175,91,84
050,29,067,"Missouri","Douglas County",3,61,184,93,91
050,29,067,"Missouri","Douglas County",3,62,190,92,98
050,29,067,"Missouri","Douglas County",3,63,196,96,100
050,29,067,"Missouri","Douglas County",3,64,205,102,103
050,29,067,"Missouri","Douglas County",3,65,191,93,98
050,29,067,"Missouri","Douglas County",3,66,176,82,94
050,29,067,"Missouri","Douglas County",3,67,191,95,96
050,29,067,"Missouri","Douglas County",3,68,191,95,96
050,29,067,"Missouri","Douglas County",3,69,169,76,93
050,29,067,"Missouri","Douglas County",3,70,169,80,89
050,29,067,"Missouri","Douglas County",3,71,163,84,79
050,29,067,"Missouri","Douglas County",3,72,168,91,77
050,29,067,"Missouri","Douglas County",3,73,156,84,72
050,29,067,"Missouri","Douglas County",3,74,161,79,82
050,29,067,"Missouri","Douglas County",3,75,109,49,60
050,29,067,"Missouri","Douglas County",3,76,120,53,67
050,29,067,"Missouri","Douglas County",3,77,111,50,61
050,29,067,"Missouri","Douglas County",3,78,104,46,58
050,29,067,"Missouri","Douglas County",3,79,88,40,48
050,29,067,"Missouri","Douglas County",3,80,85,43,42
050,29,067,"Missouri","Douglas County",3,81,78,36,42
050,29,067,"Missouri","Douglas County",3,82,60,28,32
050,29,067,"Missouri","Douglas County",3,83,61,24,37
050,29,067,"Missouri","Douglas County",3,84,58,27,31
050,29,067,"Missouri","Douglas County",3,85,294,119,175
050,29,067,"Missouri","Douglas County",4,0,144,82,62
050,29,067,"Missouri","Douglas County",4,1,133,88,45
050,29,067,"Missouri","Douglas County",4,2,128,73,55
050,29,067,"Missouri","Douglas County",4,3,145,71,74
050,29,067,"Missouri","Douglas County",4,4,154,82,72
050,29,067,"Missouri","Douglas County",4,5,135,77,58
050,29,067,"Missouri","Douglas County",4,6,157,87,70
050,29,067,"Missouri","Douglas County",4,7,153,78,75
050,29,067,"Missouri","Douglas County",4,8,148,76,72
050,29,067,"Missouri","Douglas County",4,9,143,71,72
050,29,067,"Missouri","Douglas County",4,10,152,77,75
050,29,067,"Missouri","Douglas County",4,11,147,77,70
050,29,067,"Missouri","Douglas County",4,12,155,74,81
050,29,067,"Missouri","Douglas County",4,13,152,75,77
050,29,067,"Missouri","Douglas County",4,14,178,89,89
050,29,067,"Missouri","Douglas County",4,15,172,83,89
050,29,067,"Missouri","Douglas County",4,16,193,94,99
050,29,067,"Missouri","Douglas County",4,17,189,94,95
050,29,067,"Missouri","Douglas County",4,18,144,81,63
050,29,067,"Missouri","Douglas County",4,19,99,55,44
050,29,067,"Missouri","Douglas County",4,20,91,42,49
050,29,067,"Missouri","Douglas County",4,21,86,44,42
050,29,067,"Missouri","Douglas County",4,22,106,59,47
050,29,067,"Missouri","Douglas County",4,23,95,47,48
050,29,067,"Missouri","Douglas County",4,24,111,58,53
050,29,067,"Missouri","Douglas County",4,25,100,54,46
050,29,067,"Missouri","Douglas County",4,26,108,57,51
050,29,067,"Missouri","Douglas County",4,27,95,54,41
050,29,067,"Missouri","Douglas County",4,28,101,49,52
050,29,067,"Missouri","Douglas County",4,29,101,52,49
050,29,067,"Missouri","Douglas County",4,30,119,65,54
050,29,067,"Missouri","Douglas County",4,31,132,68,64
050,29,067,"Missouri","Douglas County",4,32,116,62,54
050,29,067,"Missouri","Douglas County",4,33,124,57,67
050,29,067,"Missouri","Douglas County",4,34,134,60,74
050,29,067,"Missouri","Douglas County",4,35,125,64,61
050,29,067,"Missouri","Douglas County",4,36,129,60,69
050,29,067,"Missouri","Douglas County",4,37,140,70,70
050,29,067,"Missouri","Douglas County",4,38,143,79,64
050,29,067,"Missouri","Douglas County",4,39,145,74,71
050,29,067,"Missouri","Douglas County",4,40,144,76,68
050,29,067,"Missouri","Douglas County",4,41,146,83,63
050,29,067,"Missouri","Douglas County",4,42,142,72,70
050,29,067,"Missouri","Douglas County",4,43,111,58,53
050,29,067,"Missouri","Douglas County",4,44,130,72,58
050,29,067,"Missouri","Douglas County",4,45,131,68,63
050,29,067,"Missouri","Douglas County",4,46,124,66,58
050,29,067,"Missouri","Douglas County",4,47,124,66,58
050,29,067,"Missouri","Douglas County",4,48,116,54,62
050,29,067,"Missouri","Douglas County",4,49,121,65,56
050,29,067,"Missouri","Douglas County",4,50,131,65,66
050,29,067,"Missouri","Douglas County",4,51,126,68,58
050,29,067,"Missouri","Douglas County",4,52,153,73,80
050,29,067,"Missouri","Douglas County",4,53,126,60,66
050,29,067,"Missouri","Douglas County",4,54,144,69,75
050,29,067,"Missouri","Douglas County",4,55,137,64,73
050,29,067,"Missouri","Douglas County",4,56,148,72,76
050,29,067,"Missouri","Douglas County",4,57,167,82,85
050,29,067,"Missouri","Douglas County",4,58,180,100,80
050,29,067,"Missouri","Douglas County",4,59,192,106,86
050,29,067,"Missouri","Douglas County",4,60,167,83,84
050,29,067,"Missouri","Douglas County",4,61,178,90,88
050,29,067,"Missouri","Douglas County",4,62,178,86,92
050,29,067,"Missouri","Douglas County",4,63,188,94,94
050,29,067,"Missouri","Douglas County",4,64,198,97,101
050,29,067,"Missouri","Douglas County",4,65,204,98,106
050,29,067,"Missouri","Douglas County",4,66,194,97,97
050,29,067,"Missouri","Douglas County",4,67,173,82,91
050,29,067,"Missouri","Douglas County",4,68,193,95,98
050,29,067,"Missouri","Douglas County",4,69,192,94,98
050,29,067,"Missouri","Douglas County",4,70,164,74,90
050,29,067,"Missouri","Douglas County",4,71,165,80,85
050,29,067,"Missouri","Douglas County",4,72,158,81,77
050,29,067,"Missouri","Douglas County",4,73,169,87,82
050,29,067,"Missouri","Douglas County",4,74,151,85,66
050,29,067,"Missouri","Douglas County",4,75,154,79,75
050,29,067,"Missouri","Douglas County",4,76,99,45,54
050,29,067,"Missouri","Douglas County",4,77,114,48,66
050,29,067,"Missouri","Douglas County",4,78,102,43,59
050,29,067,"Missouri","Douglas County",4,79,96,40,56
050,29,067,"Missouri","Douglas County",4,80,91,41,50
050,29,067,"Missouri","Douglas County",4,81,82,44,38
050,29,067,"Missouri","Douglas County",4,82,73,33,40
050,29,067,"Missouri","Douglas County",4,83,50,21,29
050,29,067,"Missouri","Douglas County",4,84,56,21,35
050,29,067,"Missouri","Douglas County",4,85,277,116,161
050,29,067,"Missouri","Douglas County",5,0,144,83,61
050,29,067,"Missouri","Douglas County",5,1,150,90,60
050,29,067,"Missouri","Douglas County",5,2,134,88,46
050,29,067,"Missouri","Douglas County",5,3,152,89,63
050,29,067,"Missouri","Douglas County",5,4,155,78,77
050,29,067,"Missouri","Douglas County",5,5,162,88,74
050,29,067,"Missouri","Douglas County",5,6,147,84,63
050,29,067,"Missouri","Douglas County",5,7,164,94,70
050,29,067,"Missouri","Douglas County",5,8,158,79,79
050,29,067,"Missouri","Douglas County",5,9,155,75,80
050,29,067,"Missouri","Douglas County",5,10,158,69,89
050,29,067,"Missouri","Douglas County",5,11,159,79,80
050,29,067,"Missouri","Douglas County",5,12,161,87,74
050,29,067,"Missouri","Douglas County",5,13,168,80,88
050,29,067,"Missouri","Douglas County",5,14,159,83,76
050,29,067,"Missouri","Douglas County",5,15,183,94,89
050,29,067,"Missouri","Douglas County",5,16,183,88,95
050,29,067,"Missouri","Douglas County",5,17,203,100,103
050,29,067,"Missouri","Douglas County",5,18,153,80,73
050,29,067,"Missouri","Douglas County",5,19,106,62,44
050,29,067,"Missouri","Douglas County",5,20,96,51,45
050,29,067,"Missouri","Douglas County",5,21,91,40,51
050,29,067,"Missouri","Douglas County",5,22,99,51,48
050,29,067,"Missouri","Douglas County",5,23,119,66,53
050,29,067,"Missouri","Douglas County",5,24,98,47,51
050,29,067,"Missouri","Douglas County",5,25,120,62,58
050,29,067,"Missouri","Douglas County",5,26,99,50,49
050,29,067,"Missouri","Douglas County",5,27,113,58,55
050,29,067,"Missouri","Douglas County",5,28,103,54,49
050,29,067,"Missouri","Douglas County",5,29,112,57,55
050,29,067,"Missouri","Douglas County",5,30,112,59,53
050,29,067,"Missouri","Douglas County",5,31,122,67,55
050,29,067,"Missouri","Douglas County",5,32,140,69,71
050,29,067,"Missouri","Douglas County",5,33,132,73,59
050,29,067,"Missouri","Douglas County",5,34,123,55,68
050,29,067,"Missouri","Douglas County",5,35,134,62,72
050,29,067,"Missouri","Douglas County",5,36,133,67,66
050,29,067,"Missouri","Douglas County",5,37,142,67,75
050,29,067,"Missouri","Douglas County",5,38,147,73,74
050,29,067,"Missouri","Douglas County",5,39,152,85,67
050,29,067,"Missouri","Douglas County",5,40,144,72,72
050,29,067,"Missouri","Douglas County",5,41,140,73,67
050,29,067,"Missouri","Douglas County",5,42,153,89,64
050,29,067,"Missouri","Douglas County",5,43,157,75,82
050,29,067,"Missouri","Douglas County",5,44,118,59,59
050,29,067,"Missouri","Douglas County",5,45,134,75,59
050,29,067,"Missouri","Douglas County",5,46,131,67,64
050,29,067,"Missouri","Douglas County",5,47,127,70,57
050,29,067,"Missouri","Douglas County",5,48,126,66,60
050,29,067,"Missouri","Douglas County",5,49,123,59,64
050,29,067,"Missouri","Douglas County",5,50,126,67,59
050,29,067,"Missouri","Douglas County",5,51,133,65,68
050,29,067,"Missouri","Douglas County",5,52,134,69,65
050,29,067,"Missouri","Douglas County",5,53,141,70,71
050,29,067,"Missouri","Douglas County",5,54,132,63,69
050,29,067,"Missouri","Douglas County",5,55,142,65,77
050,29,067,"Missouri","Douglas County",5,56,138,64,74
050,29,067,"Missouri","Douglas County",5,57,146,69,77
050,29,067,"Missouri","Douglas County",5,58,162,83,79
050,29,067,"Missouri","Douglas County",5,59,187,105,82
050,29,067,"Missouri","Douglas County",5,60,187,103,84
050,29,067,"Missouri","Douglas County",5,61,181,91,90
050,29,067,"Missouri","Douglas County",5,62,178,89,89
050,29,067,"Missouri","Douglas County",5,63,183,89,94
050,29,067,"Missouri","Douglas County",5,64,191,96,95
050,29,067,"Missouri","Douglas County",5,65,203,95,108
050,29,067,"Missouri","Douglas County",5,66,200,98,102
050,29,067,"Missouri","Douglas County",5,67,193,93,100
050,29,067,"Missouri","Douglas County",5,68,174,81,93
050,29,067,"Missouri","Douglas County",5,69,188,95,93
050,29,067,"Missouri","Douglas County",5,70,183,92,91
050,29,067,"Missouri","Douglas County",5,71,152,70,82
050,29,067,"Missouri","Douglas County",5,72,157,78,79
050,29,067,"Missouri","Douglas County",5,73,152,75,77
050,29,067,"Missouri","Douglas County",5,74,155,84,71
050,29,067,"Missouri","Douglas County",5,75,150,85,65
050,29,067,"Missouri","Douglas County",5,76,145,75,70
050,29,067,"Missouri","Douglas County",5,77,93,40,53
050,29,067,"Missouri","Douglas County",5,78,104,44,60
050,29,067,"Missouri","Douglas County",5,79,90,36,54
050,29,067,"Missouri","Douglas County",5,80,96,39,57
050,29,067,"Missouri","Douglas County",5,81,86,40,46
050,29,067,"Missouri","Douglas County",5,82,72,39,33
050,29,067,"Missouri","Douglas County",5,83,66,28,38
050,29,067,"Missouri","Douglas County",5,84,42,16,26
050,29,067,"Missouri","Douglas County",5,85,272,107,165
050,29,069,"Missouri","Dunklin County",1,0,352,179,173
050,29,069,"Missouri","Dunklin County",1,1,370,192,178
050,29,069,"Missouri","Dunklin County",1,2,377,208,169
050,29,069,"Missouri","Dunklin County",1,3,353,195,158
050,29,069,"Missouri","Dunklin County",1,4,454,238,216
050,29,069,"Missouri","Dunklin County",1,5,426,214,212
050,29,069,"Missouri","Dunklin County",1,6,409,217,192
050,29,069,"Missouri","Dunklin County",1,7,430,227,203
050,29,069,"Missouri","Dunklin County",1,8,421,226,195
050,29,069,"Missouri","Dunklin County",1,9,442,239,203
050,29,069,"Missouri","Dunklin County",1,10,420,224,196
050,29,069,"Missouri","Dunklin County",1,11,411,204,207
050,29,069,"Missouri","Dunklin County",1,12,436,204,232
050,29,069,"Missouri","Dunklin County",1,13,413,204,209
050,29,069,"Missouri","Dunklin County",1,14,403,205,198
050,29,069,"Missouri","Dunklin County",1,15,418,206,212
050,29,069,"Missouri","Dunklin County",1,16,400,193,207
050,29,069,"Missouri","Dunklin County",1,17,391,195,196
050,29,069,"Missouri","Dunklin County",1,18,344,167,177
050,29,069,"Missouri","Dunklin County",1,19,314,167,147
050,29,069,"Missouri","Dunklin County",1,20,300,147,153
050,29,069,"Missouri","Dunklin County",1,21,305,157,148
050,29,069,"Missouri","Dunklin County",1,22,317,159,158
050,29,069,"Missouri","Dunklin County",1,23,309,149,160
050,29,069,"Missouri","Dunklin County",1,24,325,151,174
050,29,069,"Missouri","Dunklin County",1,25,322,164,158
050,29,069,"Missouri","Dunklin County",1,26,281,131,150
050,29,069,"Missouri","Dunklin County",1,27,318,171,147
050,29,069,"Missouri","Dunklin County",1,28,331,158,173
050,29,069,"Missouri","Dunklin County",1,29,351,169,182
050,29,069,"Missouri","Dunklin County",1,30,320,136,184
050,29,069,"Missouri","Dunklin County",1,31,320,142,178
050,29,069,"Missouri","Dunklin County",1,32,274,133,141
050,29,069,"Missouri","Dunklin County",1,33,273,138,135
050,29,069,"Missouri","Dunklin County",1,34,325,167,158
050,29,069,"Missouri","Dunklin County",1,35,314,146,168
050,29,069,"Missouri","Dunklin County",1,36,295,141,154
050,29,069,"Missouri","Dunklin County",1,37,317,164,153
050,29,069,"Missouri","Dunklin County",1,38,305,141,164
050,29,069,"Missouri","Dunklin County",1,39,323,138,185
050,29,069,"Missouri","Dunklin County",1,40,343,168,175
050,29,069,"Missouri","Dunklin County",1,41,340,162,178
050,29,069,"Missouri","Dunklin County",1,42,349,159,190
050,29,069,"Missouri","Dunklin County",1,43,324,164,160
050,29,069,"Missouri","Dunklin County",1,44,334,170,164
050,29,069,"Missouri","Dunklin County",1,45,324,163,161
050,29,069,"Missouri","Dunklin County",1,46,320,147,173
050,29,069,"Missouri","Dunklin County",1,47,337,157,180
050,29,069,"Missouri","Dunklin County",1,48,339,150,189
050,29,069,"Missouri","Dunklin County",1,49,338,170,168
050,29,069,"Missouri","Dunklin County",1,50,321,164,157
050,29,069,"Missouri","Dunklin County",1,51,339,181,158
050,29,069,"Missouri","Dunklin County",1,52,341,173,168
050,29,069,"Missouri","Dunklin County",1,53,351,167,184
050,29,069,"Missouri","Dunklin County",1,54,340,165,175
050,29,069,"Missouri","Dunklin County",1,55,363,169,194
050,29,069,"Missouri","Dunklin County",1,56,363,173,190
050,29,069,"Missouri","Dunklin County",1,57,376,184,192
050,29,069,"Missouri","Dunklin County",1,58,418,208,210
050,29,069,"Missouri","Dunklin County",1,59,399,192,207
050,29,069,"Missouri","Dunklin County",1,60,397,200,197
050,29,069,"Missouri","Dunklin County",1,61,363,184,179
050,29,069,"Missouri","Dunklin County",1,62,384,191,193
050,29,069,"Missouri","Dunklin County",1,63,363,175,188
050,29,069,"Missouri","Dunklin County",1,64,373,171,202
050,29,069,"Missouri","Dunklin County",1,65,360,168,192
050,29,069,"Missouri","Dunklin County",1,66,346,164,182
050,29,069,"Missouri","Dunklin County",1,67,347,161,186
050,29,069,"Missouri","Dunklin County",1,68,329,163,166
050,29,069,"Missouri","Dunklin County",1,69,303,154,149
050,29,069,"Missouri","Dunklin County",1,70,253,119,134
050,29,069,"Missouri","Dunklin County",1,71,257,113,144
050,29,069,"Missouri","Dunklin County",1,72,271,114,157
050,29,069,"Missouri","Dunklin County",1,73,271,101,170
050,29,069,"Missouri","Dunklin County",1,74,202,80,122
050,29,069,"Missouri","Dunklin County",1,75,221,86,135
050,29,069,"Missouri","Dunklin County",1,76,214,92,122
050,29,069,"Missouri","Dunklin County",1,77,203,91,112
050,29,069,"Missouri","Dunklin County",1,78,174,75,99
050,29,069,"Missouri","Dunklin County",1,79,175,76,99
050,29,069,"Missouri","Dunklin County",1,80,163,76,87
050,29,069,"Missouri","Dunklin County",1,81,147,53,94
050,29,069,"Missouri","Dunklin County",1,82,128,42,86
050,29,069,"Missouri","Dunklin County",1,83,125,44,81
050,29,069,"Missouri","Dunklin County",1,84,118,40,78
050,29,069,"Missouri","Dunklin County",1,85,630,217,413
050,29,069,"Missouri","Dunklin County",2,0,358,191,167
050,29,069,"Missouri","Dunklin County",2,1,368,193,175
050,29,069,"Missouri","Dunklin County",2,2,375,204,171
050,29,069,"Missouri","Dunklin County",2,3,359,198,161
050,29,069,"Missouri","Dunklin County",2,4,427,226,201
050,29,069,"Missouri","Dunklin County",2,5,433,221,212
050,29,069,"Missouri","Dunklin County",2,6,414,217,197
050,29,069,"Missouri","Dunklin County",2,7,423,223,200
050,29,069,"Missouri","Dunklin County",2,8,423,226,197
050,29,069,"Missouri","Dunklin County",2,9,433,233,200
050,29,069,"Missouri","Dunklin County",2,10,423,225,198
050,29,069,"Missouri","Dunklin County",2,11,413,207,206
050,29,069,"Missouri","Dunklin County",2,12,432,205,227
050,29,069,"Missouri","Dunklin County",2,13,419,204,215
050,29,069,"Missouri","Dunklin County",2,14,403,204,199
050,29,069,"Missouri","Dunklin County",2,15,414,206,208
050,29,069,"Missouri","Dunklin County",2,16,406,197,209
050,29,069,"Missouri","Dunklin County",2,17,392,195,197
050,29,069,"Missouri","Dunklin County",2,18,341,168,173
050,29,069,"Missouri","Dunklin County",2,19,309,160,149
050,29,069,"Missouri","Dunklin County",2,20,310,156,154
050,29,069,"Missouri","Dunklin County",2,21,304,154,150
050,29,069,"Missouri","Dunklin County",2,22,313,157,156
050,29,069,"Missouri","Dunklin County",2,23,315,154,161
050,29,069,"Missouri","Dunklin County",2,24,325,153,172
050,29,069,"Missouri","Dunklin County",2,25,318,154,164
050,29,069,"Missouri","Dunklin County",2,26,291,140,151
050,29,069,"Missouri","Dunklin County",2,27,309,162,147
050,29,069,"Missouri","Dunklin County",2,28,326,160,166
050,29,069,"Missouri","Dunklin County",2,29,342,164,178
050,29,069,"Missouri","Dunklin County",2,30,331,145,186
050,29,069,"Missouri","Dunklin County",2,31,313,138,175
050,29,069,"Missouri","Dunklin County",2,32,283,134,149
050,29,069,"Missouri","Dunklin County",2,33,275,139,136
050,29,069,"Missouri","Dunklin County",2,34,310,156,154
050,29,069,"Missouri","Dunklin County",2,35,317,151,166
050,29,069,"Missouri","Dunklin County",2,36,298,141,157
050,29,069,"Missouri","Dunklin County",2,37,313,157,156
050,29,069,"Missouri","Dunklin County",2,38,307,145,162
050,29,069,"Missouri","Dunklin County",2,39,318,137,181
050,29,069,"Missouri","Dunklin County",2,40,342,163,179
050,29,069,"Missouri","Dunklin County",2,41,344,166,178
050,29,069,"Missouri","Dunklin County",2,42,343,157,186
050,29,069,"Missouri","Dunklin County",2,43,333,165,168
050,29,069,"Missouri","Dunklin County",2,44,330,167,163
050,29,069,"Missouri","Dunklin County",2,45,328,165,163
050,29,069,"Missouri","Dunklin County",2,46,316,149,167
050,29,069,"Missouri","Dunklin County",2,47,331,154,177
050,29,069,"Missouri","Dunklin County",2,48,340,151,189
050,29,069,"Missouri","Dunklin County",2,49,338,166,172
050,29,069,"Missouri","Dunklin County",2,50,325,165,160
050,29,069,"Missouri","Dunklin County",2,51,333,176,157
050,29,069,"Missouri","Dunklin County",2,52,339,175,164
050,29,069,"Missouri","Dunklin County",2,53,346,167,179
050,29,069,"Missouri","Dunklin County",2,54,339,164,175
050,29,069,"Missouri","Dunklin County",2,55,355,165,190
050,29,069,"Missouri","Dunklin County",2,56,364,173,191
050,29,069,"Missouri","Dunklin County",2,57,369,180,189
050,29,069,"Missouri","Dunklin County",2,58,407,201,206
050,29,069,"Missouri","Dunklin County",2,59,404,197,207
050,29,069,"Missouri","Dunklin County",2,60,397,196,201
050,29,069,"Missouri","Dunklin County",2,61,369,187,182
050,29,069,"Missouri","Dunklin County",2,62,377,188,189
050,29,069,"Missouri","Dunklin County",2,63,366,180,186
050,29,069,"Missouri","Dunklin County",2,64,368,171,197
050,29,069,"Missouri","Dunklin County",2,65,363,168,195
050,29,069,"Missouri","Dunklin County",2,66,347,164,183
050,29,069,"Missouri","Dunklin County",2,67,342,159,183
050,29,069,"Missouri","Dunklin County",2,68,326,159,167
050,29,069,"Missouri","Dunklin County",2,69,307,154,153
050,29,069,"Missouri","Dunklin County",2,70,263,126,137
050,29,069,"Missouri","Dunklin County",2,71,254,113,141
050,29,069,"Missouri","Dunklin County",2,72,258,108,150
050,29,069,"Missouri","Dunklin County",2,73,284,110,174
050,29,069,"Missouri","Dunklin County",2,74,203,79,124
050,29,069,"Missouri","Dunklin County",2,75,214,83,131
050,29,069,"Missouri","Dunklin County",2,76,207,88,119
050,29,069,"Missouri","Dunklin County",2,77,210,93,117
050,29,069,"Missouri","Dunklin County",2,78,171,75,96
050,29,069,"Missouri","Dunklin County",2,79,171,72,99
050,29,069,"Missouri","Dunklin County",2,80,160,76,84
050,29,069,"Missouri","Dunklin County",2,81,146,55,91
050,29,069,"Missouri","Dunklin County",2,82,128,43,85
050,29,069,"Missouri","Dunklin County",2,83,124,43,81
050,29,069,"Missouri","Dunklin County",2,84,120,40,80
050,29,069,"Missouri","Dunklin County",2,85,633,219,414
050,29,069,"Missouri","Dunklin County",3,0,361,193,168
050,29,069,"Missouri","Dunklin County",3,1,398,208,190
050,29,069,"Missouri","Dunklin County",3,2,371,186,185
050,29,069,"Missouri","Dunklin County",3,3,376,207,169
050,29,069,"Missouri","Dunklin County",3,4,361,202,159
050,29,069,"Missouri","Dunklin County",3,5,414,220,194
050,29,069,"Missouri","Dunklin County",3,6,432,218,214
050,29,069,"Missouri","Dunklin County",3,7,394,204,190
050,29,069,"Missouri","Dunklin County",3,8,427,227,200
050,29,069,"Missouri","Dunklin County",3,9,397,217,180
050,29,069,"Missouri","Dunklin County",3,10,427,236,191
050,29,069,"Missouri","Dunklin County",3,11,406,210,196
050,29,069,"Missouri","Dunklin County",3,12,394,196,198
050,29,069,"Missouri","Dunklin County",3,13,436,206,230
050,29,069,"Missouri","Dunklin County",3,14,419,206,213
050,29,069,"Missouri","Dunklin County",3,15,400,201,199
050,29,069,"Missouri","Dunklin County",3,16,408,201,207
050,29,069,"Missouri","Dunklin County",3,17,399,192,207
050,29,069,"Missouri","Dunklin County",3,18,319,165,154
050,29,069,"Missouri","Dunklin County",3,19,284,142,142
050,29,069,"Missouri","Dunklin County",3,20,311,149,162
050,29,069,"Missouri","Dunklin County",3,21,320,155,165
050,29,069,"Missouri","Dunklin County",3,22,297,149,148
050,29,069,"Missouri","Dunklin County",3,23,314,163,151
050,29,069,"Missouri","Dunklin County",3,24,315,153,162
050,29,069,"Missouri","Dunklin County",3,25,314,138,176
050,29,069,"Missouri","Dunklin County",3,26,302,147,155
050,29,069,"Missouri","Dunklin County",3,27,306,147,159
050,29,069,"Missouri","Dunklin County",3,28,307,159,148
050,29,069,"Missouri","Dunklin County",3,29,312,156,156
050,29,069,"Missouri","Dunklin County",3,30,351,166,185
050,29,069,"Missouri","Dunklin County",3,31,322,143,179
050,29,069,"Missouri","Dunklin County",3,32,301,123,178
050,29,069,"Missouri","Dunklin County",3,33,288,149,139
050,29,069,"Missouri","Dunklin County",3,34,272,131,141
050,29,069,"Missouri","Dunklin County",3,35,308,160,148
050,29,069,"Missouri","Dunklin County",3,36,327,161,166
050,29,069,"Missouri","Dunklin County",3,37,297,140,157
050,29,069,"Missouri","Dunklin County",3,38,320,162,158
050,29,069,"Missouri","Dunklin County",3,39,307,144,163
050,29,069,"Missouri","Dunklin County",3,40,328,139,189
050,29,069,"Missouri","Dunklin County",3,41,344,170,174
050,29,069,"Missouri","Dunklin County",3,42,318,149,169
050,29,069,"Missouri","Dunklin County",3,43,339,157,182
050,29,069,"Missouri","Dunklin County",3,44,341,168,173
050,29,069,"Missouri","Dunklin County",3,45,318,170,148
050,29,069,"Missouri","Dunklin County",3,46,314,156,158
050,29,069,"Missouri","Dunklin County",3,47,309,149,160
050,29,069,"Missouri","Dunklin County",3,48,323,137,186
050,29,069,"Missouri","Dunklin County",3,49,315,135,180
050,29,069,"Missouri","Dunklin County",3,50,335,160,175
050,29,069,"Missouri","Dunklin County",3,51,325,164,161
050,29,069,"Missouri","Dunklin County",3,52,337,182,155
050,29,069,"Missouri","Dunklin County",3,53,338,169,169
050,29,069,"Missouri","Dunklin County",3,54,352,173,179
050,29,069,"Missouri","Dunklin County",3,55,329,154,175
050,29,069,"Missouri","Dunklin County",3,56,350,161,189
050,29,069,"Missouri","Dunklin County",3,57,350,171,179
050,29,069,"Missouri","Dunklin County",3,58,374,181,193
050,29,069,"Missouri","Dunklin County",3,59,377,180,197
050,29,069,"Missouri","Dunklin County",3,60,406,198,208
050,29,069,"Missouri","Dunklin County",3,61,370,180,190
050,29,069,"Missouri","Dunklin County",3,62,357,182,175
050,29,069,"Missouri","Dunklin County",3,63,371,182,189
050,29,069,"Missouri","Dunklin County",3,64,350,178,172
050,29,069,"Missouri","Dunklin County",3,65,350,155,195
050,29,069,"Missouri","Dunklin County",3,66,344,155,189
050,29,069,"Missouri","Dunklin County",3,67,330,153,177
050,29,069,"Missouri","Dunklin County",3,68,318,150,168
050,29,069,"Missouri","Dunklin County",3,69,310,148,162
050,29,069,"Missouri","Dunklin County",3,70,296,144,152
050,29,069,"Missouri","Dunklin County",3,71,253,121,132
050,29,069,"Missouri","Dunklin County",3,72,237,105,132
050,29,069,"Missouri","Dunklin County",3,73,241,101,140
050,29,069,"Missouri","Dunklin County",3,74,268,108,160
050,29,069,"Missouri","Dunklin County",3,75,199,73,126
050,29,069,"Missouri","Dunklin County",3,76,183,73,110
050,29,069,"Missouri","Dunklin County",3,77,193,74,119
050,29,069,"Missouri","Dunklin County",3,78,191,82,109
050,29,069,"Missouri","Dunklin County",3,79,153,61,92
050,29,069,"Missouri","Dunklin County",3,80,158,67,91
050,29,069,"Missouri","Dunklin County",3,81,144,61,83
050,29,069,"Missouri","Dunklin County",3,82,127,43,84
050,29,069,"Missouri","Dunklin County",3,83,121,43,78
050,29,069,"Missouri","Dunklin County",3,84,111,29,82
050,29,069,"Missouri","Dunklin County",3,85,632,216,416
050,29,069,"Missouri","Dunklin County",4,0,345,183,162
050,29,069,"Missouri","Dunklin County",4,1,372,196,176
050,29,069,"Missouri","Dunklin County",4,2,381,200,181
050,29,069,"Missouri","Dunklin County",4,3,368,192,176
050,29,069,"Missouri","Dunklin County",4,4,370,202,168
050,29,069,"Missouri","Dunklin County",4,5,356,198,158
050,29,069,"Missouri","Dunklin County",4,6,410,224,186
050,29,069,"Missouri","Dunklin County",4,7,432,215,217
050,29,069,"Missouri","Dunklin County",4,8,378,196,182
050,29,069,"Missouri","Dunklin County",4,9,409,221,188
050,29,069,"Missouri","Dunklin County",4,10,395,214,181
050,29,069,"Missouri","Dunklin County",4,11,445,241,204
050,29,069,"Missouri","Dunklin County",4,12,419,218,201
050,29,069,"Missouri","Dunklin County",4,13,389,200,189
050,29,069,"Missouri","Dunklin County",4,14,438,209,229
050,29,069,"Missouri","Dunklin County",4,15,416,203,213
050,29,069,"Missouri","Dunklin County",4,16,404,197,207
050,29,069,"Missouri","Dunklin County",4,17,415,206,209
050,29,069,"Missouri","Dunklin County",4,18,345,169,176
050,29,069,"Missouri","Dunklin County",4,19,258,137,121
050,29,069,"Missouri","Dunklin County",4,20,291,143,148
050,29,069,"Missouri","Dunklin County",4,21,308,147,161
050,29,069,"Missouri","Dunklin County",4,22,321,151,170
050,29,069,"Missouri","Dunklin County",4,23,302,157,145
050,29,069,"Missouri","Dunklin County",4,24,303,152,151
050,29,069,"Missouri","Dunklin County",4,25,325,151,174
050,29,069,"Missouri","Dunklin County",4,26,313,132,181
050,29,069,"Missouri","Dunklin County",4,27,306,164,142
050,29,069,"Missouri","Dunklin County",4,28,293,135,158
050,29,069,"Missouri","Dunklin County",4,29,313,160,153
050,29,069,"Missouri","Dunklin County",4,30,308,152,156
050,29,069,"Missouri","Dunklin County",4,31,341,162,179
050,29,069,"Missouri","Dunklin County",4,32,311,136,175
050,29,069,"Missouri","Dunklin County",4,33,302,131,171
050,29,069,"Missouri","Dunklin County",4,34,278,134,144
050,29,069,"Missouri","Dunklin County",4,35,268,133,135
050,29,069,"Missouri","Dunklin County",4,36,312,162,150
050,29,069,"Missouri","Dunklin County",4,37,328,153,175
050,29,069,"Missouri","Dunklin County",4,38,305,155,150
050,29,069,"Missouri","Dunklin County",4,39,304,154,150
050,29,069,"Missouri","Dunklin County",4,40,303,141,162
050,29,069,"Missouri","Dunklin County",4,41,330,143,187
050,29,069,"Missouri","Dunklin County",4,42,335,160,175
050,29,069,"Missouri","Dunklin County",4,43,311,136,175
050,29,069,"Missouri","Dunklin County",4,44,347,157,190
050,29,069,"Missouri","Dunklin County",4,45,336,172,164
050,29,069,"Missouri","Dunklin County",4,46,321,176,145
050,29,069,"Missouri","Dunklin County",4,47,313,161,152
050,29,069,"Missouri","Dunklin County",4,48,295,139,156
050,29,069,"Missouri","Dunklin County",4,49,302,130,172
050,29,069,"Missouri","Dunklin County",4,50,313,130,183
050,29,069,"Missouri","Dunklin County",4,51,334,159,175
050,29,069,"Missouri","Dunklin County",4,52,319,161,158
050,29,069,"Missouri","Dunklin County",4,53,331,177,154
050,29,069,"Missouri","Dunklin County",4,54,336,172,164
050,29,069,"Missouri","Dunklin County",4,55,347,169,178
050,29,069,"Missouri","Dunklin County",4,56,322,150,172
050,29,069,"Missouri","Dunklin County",4,57,336,156,180
050,29,069,"Missouri","Dunklin County",4,58,353,172,181
050,29,069,"Missouri","Dunklin County",4,59,365,175,190
050,29,069,"Missouri","Dunklin County",4,60,367,174,193
050,29,069,"Missouri","Dunklin County",4,61,387,193,194
050,29,069,"Missouri","Dunklin County",4,62,364,174,190
050,29,069,"Missouri","Dunklin County",4,63,344,171,173
050,29,069,"Missouri","Dunklin County",4,64,360,176,184
050,29,069,"Missouri","Dunklin County",4,65,341,169,172
050,29,069,"Missouri","Dunklin County",4,66,341,145,196
050,29,069,"Missouri","Dunklin County",4,67,339,147,192
050,29,069,"Missouri","Dunklin County",4,68,320,150,170
050,29,069,"Missouri","Dunklin County",4,69,306,141,165
050,29,069,"Missouri","Dunklin County",4,70,294,137,157
050,29,069,"Missouri","Dunklin County",4,71,291,146,145
050,29,069,"Missouri","Dunklin County",4,72,236,113,123
050,29,069,"Missouri","Dunklin County",4,73,228,97,131
050,29,069,"Missouri","Dunklin County",4,74,236,104,132
050,29,069,"Missouri","Dunklin County",4,75,261,102,159
050,29,069,"Missouri","Dunklin County",4,76,183,68,115
050,29,069,"Missouri","Dunklin County",4,77,173,66,107
050,29,069,"Missouri","Dunklin County",4,78,172,69,103
050,29,069,"Missouri","Dunklin County",4,79,184,75,109
050,29,069,"Missouri","Dunklin County",4,80,148,64,84
050,29,069,"Missouri","Dunklin County",4,81,138,50,88
050,29,069,"Missouri","Dunklin County",4,82,123,50,73
050,29,069,"Missouri","Dunklin County",4,83,117,38,79
050,29,069,"Missouri","Dunklin County",4,84,113,37,76
050,29,069,"Missouri","Dunklin County",4,85,619,198,421
050,29,069,"Missouri","Dunklin County",5,0,349,182,167
050,29,069,"Missouri","Dunklin County",5,1,352,184,168
050,29,069,"Missouri","Dunklin County",5,2,380,208,172
050,29,069,"Missouri","Dunklin County",5,3,385,204,181
050,29,069,"Missouri","Dunklin County",5,4,371,194,177
050,29,069,"Missouri","Dunklin County",5,5,377,199,178
050,29,069,"Missouri","Dunklin County",5,6,364,205,159
050,29,069,"Missouri","Dunklin County",5,7,415,222,193
050,29,069,"Missouri","Dunklin County",5,8,437,215,222
050,29,069,"Missouri","Dunklin County",5,9,372,190,182
050,29,069,"Missouri","Dunklin County",5,10,419,224,195
050,29,069,"Missouri","Dunklin County",5,11,391,214,177
050,29,069,"Missouri","Dunklin County",5,12,418,221,197
050,29,069,"Missouri","Dunklin County",5,13,401,211,190
050,29,069,"Missouri","Dunklin County",5,14,373,185,188
050,29,069,"Missouri","Dunklin County",5,15,444,216,228
050,29,069,"Missouri","Dunklin County",5,16,394,190,204
050,29,069,"Missouri","Dunklin County",5,17,386,190,196
050,29,069,"Missouri","Dunklin County",5,18,342,176,166
050,29,069,"Missouri","Dunklin County",5,19,265,132,133
050,29,069,"Missouri","Dunklin County",5,20,282,144,138
050,29,069,"Missouri","Dunklin County",5,21,286,130,156
050,29,069,"Missouri","Dunklin County",5,22,312,153,159
050,29,069,"Missouri","Dunklin County",5,23,329,157,172
050,29,069,"Missouri","Dunklin County",5,24,310,167,143
050,29,069,"Missouri","Dunklin County",5,25,292,143,149
050,29,069,"Missouri","Dunklin County",5,26,319,143,176
050,29,069,"Missouri","Dunklin County",5,27,323,136,187
050,29,069,"Missouri","Dunklin County",5,28,296,151,145
050,29,069,"Missouri","Dunklin County",5,29,293,131,162
050,29,069,"Missouri","Dunklin County",5,30,307,156,151
050,29,069,"Missouri","Dunklin County",5,31,303,151,152
050,29,069,"Missouri","Dunklin County",5,32,323,149,174
050,29,069,"Missouri","Dunklin County",5,33,314,144,170
050,29,069,"Missouri","Dunklin County",5,34,295,115,180
050,29,069,"Missouri","Dunklin County",5,35,257,125,132
050,29,069,"Missouri","Dunklin County",5,36,268,140,128
050,29,069,"Missouri","Dunklin County",5,37,298,155,143
050,29,069,"Missouri","Dunklin County",5,38,330,158,172
050,29,069,"Missouri","Dunklin County",5,39,300,150,150
050,29,069,"Missouri","Dunklin County",5,40,302,155,147
050,29,069,"Missouri","Dunklin County",5,41,311,148,163
050,29,069,"Missouri","Dunklin County",5,42,314,128,186
050,29,069,"Missouri","Dunklin County",5,43,321,155,166
050,29,069,"Missouri","Dunklin County",5,44,310,133,177
050,29,069,"Missouri","Dunklin County",5,45,344,158,186
050,29,069,"Missouri","Dunklin County",5,46,328,166,162
050,29,069,"Missouri","Dunklin County",5,47,320,177,143
050,29,069,"Missouri","Dunklin County",5,48,316,155,161
050,29,069,"Missouri","Dunklin County",5,49,290,138,152
050,29,069,"Missouri","Dunklin County",5,50,300,136,164
050,29,069,"Missouri","Dunklin County",5,51,305,123,182
050,29,069,"Missouri","Dunklin County",5,52,330,155,175
050,29,069,"Missouri","Dunklin County",5,53,307,151,156
050,29,069,"Missouri","Dunklin County",5,54,332,182,150
050,29,069,"Missouri","Dunklin County",5,55,333,170,163
050,29,069,"Missouri","Dunklin County",5,56,337,165,172
050,29,069,"Missouri","Dunklin County",5,57,318,153,165
050,29,069,"Missouri","Dunklin County",5,58,337,153,184
050,29,069,"Missouri","Dunklin County",5,59,344,169,175
050,29,069,"Missouri","Dunklin County",5,60,359,165,194
050,29,069,"Missouri","Dunklin County",5,61,354,172,182
050,29,069,"Missouri","Dunklin County",5,62,370,184,186
050,29,069,"Missouri","Dunklin County",5,63,351,163,188
050,29,069,"Missouri","Dunklin County",5,64,342,175,167
050,29,069,"Missouri","Dunklin County",5,65,345,165,180
050,29,069,"Missouri","Dunklin County",5,66,336,164,172
050,29,069,"Missouri","Dunklin County",5,67,331,141,190
050,29,069,"Missouri","Dunklin County",5,68,327,141,186
050,29,069,"Missouri","Dunklin County",5,69,307,143,164
050,29,069,"Missouri","Dunklin County",5,70,295,131,164
050,29,069,"Missouri","Dunklin County",5,71,293,141,152
050,29,069,"Missouri","Dunklin County",5,72,278,141,137
050,29,069,"Missouri","Dunklin County",5,73,226,105,121
050,29,069,"Missouri","Dunklin County",5,74,218,95,123
050,29,069,"Missouri","Dunklin County",5,75,239,100,139
050,29,069,"Missouri","Dunklin County",5,76,234,92,142
050,29,069,"Missouri","Dunklin County",5,77,176,59,117
050,29,069,"Missouri","Dunklin County",5,78,151,56,95
050,29,069,"Missouri","Dunklin County",5,79,164,62,102
050,29,069,"Missouri","Dunklin County",5,80,177,76,101
050,29,069,"Missouri","Dunklin County",5,81,128,49,79
050,29,069,"Missouri","Dunklin County",5,82,119,39,80
050,29,069,"Missouri","Dunklin County",5,83,112,45,67
050,29,069,"Missouri","Dunklin County",5,84,108,30,78
050,29,069,"Missouri","Dunklin County",5,85,621,195,426
050,29,071,"Missouri","Franklin County",1,0,1173,598,575
050,29,071,"Missouri","Franklin County",1,1,1191,610,581
050,29,071,"Missouri","Franklin County",1,2,1230,624,606
050,29,071,"Missouri","Franklin County",1,3,1284,672,612
050,29,071,"Missouri","Franklin County",1,4,1270,651,619
050,29,071,"Missouri","Franklin County",1,5,1273,642,631
050,29,071,"Missouri","Franklin County",1,6,1273,669,604
050,29,071,"Missouri","Franklin County",1,7,1305,676,629
050,29,071,"Missouri","Franklin County",1,8,1332,698,634
050,29,071,"Missouri","Franklin County",1,9,1311,670,641
050,29,071,"Missouri","Franklin County",1,10,1362,709,653
050,29,071,"Missouri","Franklin County",1,11,1428,741,687
050,29,071,"Missouri","Franklin County",1,12,1443,774,669
050,29,071,"Missouri","Franklin County",1,13,1455,756,699
050,29,071,"Missouri","Franklin County",1,14,1409,722,687
050,29,071,"Missouri","Franklin County",1,15,1376,722,654
050,29,071,"Missouri","Franklin County",1,16,1409,721,688
050,29,071,"Missouri","Franklin County",1,17,1434,725,709
050,29,071,"Missouri","Franklin County",1,18,1176,615,561
050,29,071,"Missouri","Franklin County",1,19,934,499,435
050,29,071,"Missouri","Franklin County",1,20,1018,536,482
050,29,071,"Missouri","Franklin County",1,21,1065,574,491
050,29,071,"Missouri","Franklin County",1,22,1145,576,569
050,29,071,"Missouri","Franklin County",1,23,1188,596,592
050,29,071,"Missouri","Franklin County",1,24,1201,632,569
050,29,071,"Missouri","Franklin County",1,25,1195,625,570
050,29,071,"Missouri","Franklin County",1,26,1228,628,600
050,29,071,"Missouri","Franklin County",1,27,1251,652,599
050,29,071,"Missouri","Franklin County",1,28,1339,671,668
050,29,071,"Missouri","Franklin County",1,29,1354,689,665
050,29,071,"Missouri","Franklin County",1,30,1289,654,635
050,29,071,"Missouri","Franklin County",1,31,1262,629,633
050,29,071,"Missouri","Franklin County",1,32,1195,580,615
050,29,071,"Missouri","Franklin County",1,33,1253,648,605
050,29,071,"Missouri","Franklin County",1,34,1296,653,643
050,29,071,"Missouri","Franklin County",1,35,1290,663,627
050,29,071,"Missouri","Franklin County",1,36,1281,662,619
050,29,071,"Missouri","Franklin County",1,37,1263,648,615
050,29,071,"Missouri","Franklin County",1,38,1289,648,641
050,29,071,"Missouri","Franklin County",1,39,1317,659,658
050,29,071,"Missouri","Franklin County",1,40,1233,628,605
050,29,071,"Missouri","Franklin County",1,41,1137,597,540
050,29,071,"Missouri","Franklin County",1,42,1148,584,564
050,29,071,"Missouri","Franklin County",1,43,1132,579,553
050,29,071,"Missouri","Franklin County",1,44,1109,575,534
050,29,071,"Missouri","Franklin County",1,45,1143,565,578
050,29,071,"Missouri","Franklin County",1,46,1155,577,578
050,29,071,"Missouri","Franklin County",1,47,1200,600,600
050,29,071,"Missouri","Franklin County",1,48,1272,652,620
050,29,071,"Missouri","Franklin County",1,49,1380,698,682
050,29,071,"Missouri","Franklin County",1,50,1315,639,676
050,29,071,"Missouri","Franklin County",1,51,1350,668,682
050,29,071,"Missouri","Franklin County",1,52,1386,692,694
050,29,071,"Missouri","Franklin County",1,53,1445,712,733
050,29,071,"Missouri","Franklin County",1,54,1474,735,739
050,29,071,"Missouri","Franklin County",1,55,1544,783,761
050,29,071,"Missouri","Franklin County",1,56,1641,841,800
050,29,071,"Missouri","Franklin County",1,57,1645,824,821
050,29,071,"Missouri","Franklin County",1,58,1759,870,889
050,29,071,"Missouri","Franklin County",1,59,1785,919,866
050,29,071,"Missouri","Franklin County",1,60,1693,854,839
050,29,071,"Missouri","Franklin County",1,61,1650,842,808
050,29,071,"Missouri","Franklin County",1,62,1616,814,802
050,29,071,"Missouri","Franklin County",1,63,1533,739,794
050,29,071,"Missouri","Franklin County",1,64,1449,693,756
050,29,071,"Missouri","Franklin County",1,65,1357,677,680
050,29,071,"Missouri","Franklin County",1,66,1332,675,657
050,29,071,"Missouri","Franklin County",1,67,1282,655,627
050,29,071,"Missouri","Franklin County",1,68,1167,579,588
050,29,071,"Missouri","Franklin County",1,69,1057,509,548
050,29,071,"Missouri","Franklin County",1,70,1060,510,550
050,29,071,"Missouri","Franklin County",1,71,1067,511,556
050,29,071,"Missouri","Franklin County",1,72,1057,485,572
050,29,071,"Missouri","Franklin County",1,73,1019,475,544
050,29,071,"Missouri","Franklin County",1,74,733,341,392
050,29,071,"Missouri","Franklin County",1,75,748,352,396
050,29,071,"Missouri","Franklin County",1,76,740,340,400
050,29,071,"Missouri","Franklin County",1,77,747,330,417
050,29,071,"Missouri","Franklin County",1,78,663,306,357
050,29,071,"Missouri","Franklin County",1,79,552,241,311
050,29,071,"Missouri","Franklin County",1,80,507,222,285
050,29,071,"Missouri","Franklin County",1,81,460,197,263
050,29,071,"Missouri","Franklin County",1,82,447,198,249
050,29,071,"Missouri","Franklin County",1,83,402,158,244
050,29,071,"Missouri","Franklin County",1,84,342,135,207
050,29,071,"Missouri","Franklin County",1,85,1969,715,1254
050,29,071,"Missouri","Franklin County",2,0,1146,579,567
050,29,071,"Missouri","Franklin County",2,1,1185,607,578
050,29,071,"Missouri","Franklin County",2,2,1226,624,602
050,29,071,"Missouri","Franklin County",2,3,1264,657,607
050,29,071,"Missouri","Franklin County",2,4,1282,659,623
050,29,071,"Missouri","Franklin County",2,5,1279,648,631
050,29,071,"Missouri","Franklin County",2,6,1279,666,613
050,29,071,"Missouri","Franklin County",2,7,1301,677,624
050,29,071,"Missouri","Franklin County",2,8,1326,693,633
050,29,071,"Missouri","Franklin County",2,9,1321,681,640
050,29,071,"Missouri","Franklin County",2,10,1354,702,652
050,29,071,"Missouri","Franklin County",2,11,1406,733,673
050,29,071,"Missouri","Franklin County",2,12,1444,770,674
050,29,071,"Missouri","Franklin County",2,13,1451,760,691
050,29,071,"Missouri","Franklin County",2,14,1421,729,692
050,29,071,"Missouri","Franklin County",2,15,1389,723,666
050,29,071,"Missouri","Franklin County",2,16,1408,726,682
050,29,071,"Missouri","Franklin County",2,17,1428,723,705
050,29,071,"Missouri","Franklin County",2,18,1183,619,564
050,29,071,"Missouri","Franklin County",2,19,942,500,442
050,29,071,"Missouri","Franklin County",2,20,1024,541,483
050,29,071,"Missouri","Franklin County",2,21,1069,571,498
050,29,071,"Missouri","Franklin County",2,22,1145,581,564
050,29,071,"Missouri","Franklin County",2,23,1195,602,593
050,29,071,"Missouri","Franklin County",2,24,1205,626,579
050,29,071,"Missouri","Franklin County",2,25,1201,629,572
050,29,071,"Missouri","Franklin County",2,26,1220,632,588
050,29,071,"Missouri","Franklin County",2,27,1241,645,596
050,29,071,"Missouri","Franklin County",2,28,1322,673,649
050,29,071,"Missouri","Franklin County",2,29,1359,689,670
050,29,071,"Missouri","Franklin County",2,30,1317,669,648
050,29,071,"Missouri","Franklin County",2,31,1267,634,633
050,29,071,"Missouri","Franklin County",2,32,1210,590,620
050,29,071,"Missouri","Franklin County",2,33,1243,633,610
050,29,071,"Missouri","Franklin County",2,34,1287,650,637
050,29,071,"Missouri","Franklin County",2,35,1299,664,635
050,29,071,"Missouri","Franklin County",2,36,1278,662,616
050,29,071,"Missouri","Franklin County",2,37,1268,653,615
050,29,071,"Missouri","Franklin County",2,38,1286,649,637
050,29,071,"Missouri","Franklin County",2,39,1308,656,652
050,29,071,"Missouri","Franklin County",2,40,1261,639,622
050,29,071,"Missouri","Franklin County",2,41,1159,604,555
050,29,071,"Missouri","Franklin County",2,42,1142,586,556
050,29,071,"Missouri","Franklin County",2,43,1151,589,562
050,29,071,"Missouri","Franklin County",2,44,1108,573,535
050,29,071,"Missouri","Franklin County",2,45,1141,571,570
050,29,071,"Missouri","Franklin County",2,46,1151,575,576
050,29,071,"Missouri","Franklin County",2,47,1185,592,593
050,29,071,"Missouri","Franklin County",2,48,1251,636,615
050,29,071,"Missouri","Franklin County",2,49,1359,690,669
050,29,071,"Missouri","Franklin County",2,50,1333,653,680
050,29,071,"Missouri","Franklin County",2,51,1340,662,678
050,29,071,"Missouri","Franklin County",2,52,1376,686,690
050,29,071,"Missouri","Franklin County",2,53,1433,711,722
050,29,071,"Missouri","Franklin County",2,54,1463,728,735
050,29,071,"Missouri","Franklin County",2,55,1527,770,757
050,29,071,"Missouri","Franklin County",2,56,1626,832,794
050,29,071,"Missouri","Franklin County",2,57,1651,830,821
050,29,071,"Missouri","Franklin County",2,58,1732,859,873
050,29,071,"Missouri","Franklin County",2,59,1785,911,874
050,29,071,"Missouri","Franklin County",2,60,1712,866,846
050,29,071,"Missouri","Franklin County",2,61,1654,841,813
050,29,071,"Missouri","Franklin County",2,62,1625,822,803
050,29,071,"Missouri","Franklin County",2,63,1563,761,802
050,29,071,"Missouri","Franklin County",2,64,1461,700,761
050,29,071,"Missouri","Franklin County",2,65,1379,680,699
050,29,071,"Missouri","Franklin County",2,66,1333,674,659
050,29,071,"Missouri","Franklin County",2,67,1289,655,634
050,29,071,"Missouri","Franklin County",2,68,1189,592,597
050,29,071,"Missouri","Franklin County",2,69,1092,531,561
050,29,071,"Missouri","Franklin County",2,70,1054,506,548
050,29,071,"Missouri","Franklin County",2,71,1066,513,553
050,29,071,"Missouri","Franklin County",2,72,1040,481,559
050,29,071,"Missouri","Franklin County",2,73,1074,498,576
050,29,071,"Missouri","Franklin County",2,74,751,348,403
050,29,071,"Missouri","Franklin County",2,75,739,344,395
050,29,071,"Missouri","Franklin County",2,76,729,337,392
050,29,071,"Missouri","Franklin County",2,77,758,336,422
050,29,071,"Missouri","Franklin County",2,78,669,306,363
050,29,071,"Missouri","Franklin County",2,79,568,250,318
050,29,071,"Missouri","Franklin County",2,80,509,221,288
050,29,071,"Missouri","Franklin County",2,81,469,202,267
050,29,071,"Missouri","Franklin County",2,82,449,196,253
050,29,071,"Missouri","Franklin County",2,83,405,165,240
050,29,071,"Missouri","Franklin County",2,84,352,137,215
050,29,071,"Missouri","Franklin County",2,85,1982,720,1262
050,29,071,"Missouri","Franklin County",3,0,1088,554,534
050,29,071,"Missouri","Franklin County",3,1,1166,605,561
050,29,071,"Missouri","Franklin County",3,2,1217,599,618
050,29,071,"Missouri","Franklin County",3,3,1244,632,612
050,29,071,"Missouri","Franklin County",3,4,1273,662,611
050,29,071,"Missouri","Franklin County",3,5,1281,673,608
050,29,071,"Missouri","Franklin County",3,6,1297,659,638
050,29,071,"Missouri","Franklin County",3,7,1285,697,588
050,29,071,"Missouri","Franklin County",3,8,1326,688,638
050,29,071,"Missouri","Franklin County",3,9,1336,698,638
050,29,071,"Missouri","Franklin County",3,10,1330,688,642
050,29,071,"Missouri","Franklin County",3,11,1359,707,652
050,29,071,"Missouri","Franklin County",3,12,1424,739,685
050,29,071,"Missouri","Franklin County",3,13,1459,775,684
050,29,071,"Missouri","Franklin County",3,14,1440,755,685
050,29,071,"Missouri","Franklin County",3,15,1426,729,697
050,29,071,"Missouri","Franklin County",3,16,1396,726,670
050,29,071,"Missouri","Franklin County",3,17,1412,718,694
050,29,071,"Missouri","Franklin County",3,18,1210,627,583
050,29,071,"Missouri","Franklin County",3,19,936,492,444
050,29,071,"Missouri","Franklin County",3,20,1031,542,489
050,29,071,"Missouri","Franklin County",3,21,1073,558,515
050,29,071,"Missouri","Franklin County",3,22,1126,598,528
050,29,071,"Missouri","Franklin County",3,23,1202,621,581
050,29,071,"Missouri","Franklin County",3,24,1198,610,588
050,29,071,"Missouri","Franklin County",3,25,1198,614,584
050,29,071,"Missouri","Franklin County",3,26,1185,631,554
050,29,071,"Missouri","Franklin County",3,27,1220,633,587
050,29,071,"Missouri","Franklin County",3,28,1273,663,610
050,29,071,"Missouri","Franklin County",3,29,1337,672,665
050,29,071,"Missouri","Franklin County",3,30,1386,698,688
050,29,071,"Missouri","Franklin County",3,31,1327,679,648
050,29,071,"Missouri","Franklin County",3,32,1301,651,650
050,29,071,"Missouri","Franklin County",3,33,1223,608,615
050,29,071,"Missouri","Franklin County",3,34,1272,643,629
050,29,071,"Missouri","Franklin County",3,35,1290,647,643
050,29,071,"Missouri","Franklin County",3,36,1307,668,639
050,29,071,"Missouri","Franklin County",3,37,1269,665,604
050,29,071,"Missouri","Franklin County",3,38,1293,673,620
050,29,071,"Missouri","Franklin County",3,39,1319,669,650
050,29,071,"Missouri","Franklin County",3,40,1316,656,660
050,29,071,"Missouri","Franklin County",3,41,1257,641,616
050,29,071,"Missouri","Franklin County",3,42,1178,615,563
050,29,071,"Missouri","Franklin County",3,43,1151,577,574
050,29,071,"Missouri","Franklin County",3,44,1153,588,565
050,29,071,"Missouri","Franklin County",3,45,1108,579,529
050,29,071,"Missouri","Franklin County",3,46,1156,587,569
050,29,071,"Missouri","Franklin County",3,47,1142,570,572
050,29,071,"Missouri","Franklin County",3,48,1172,577,595
050,29,071,"Missouri","Franklin County",3,49,1246,632,614
050,29,071,"Missouri","Franklin County",3,50,1381,698,683
050,29,071,"Missouri","Franklin County",3,51,1350,660,690
050,29,071,"Missouri","Franklin County",3,52,1351,674,677
050,29,071,"Missouri","Franklin County",3,53,1390,704,686
050,29,071,"Missouri","Franklin County",3,54,1425,703,722
050,29,071,"Missouri","Franklin County",3,55,1480,735,745
050,29,071,"Missouri","Franklin County",3,56,1564,777,787
050,29,071,"Missouri","Franklin County",3,57,1618,818,800
050,29,071,"Missouri","Franklin County",3,58,1644,825,819
050,29,071,"Missouri","Franklin County",3,59,1746,879,867
050,29,071,"Missouri","Franklin County",3,60,1767,916,851
050,29,071,"Missouri","Franklin County",3,61,1721,868,853
050,29,071,"Missouri","Franklin County",3,62,1669,854,815
050,29,071,"Missouri","Franklin County",3,63,1634,825,809
050,29,071,"Missouri","Franklin County",3,64,1536,754,782
050,29,071,"Missouri","Franklin County",3,65,1435,689,746
050,29,071,"Missouri","Franklin County",3,66,1358,666,692
050,29,071,"Missouri","Franklin County",3,67,1294,656,638
050,29,071,"Missouri","Franklin County",3,68,1290,649,641
050,29,071,"Missouri","Franklin County",3,69,1169,582,587
050,29,071,"Missouri","Franklin County",3,70,1073,517,556
050,29,071,"Missouri","Franklin County",3,71,1030,494,536
050,29,071,"Missouri","Franklin County",3,72,1049,501,548
050,29,071,"Missouri","Franklin County",3,73,1009,461,548
050,29,071,"Missouri","Franklin County",3,74,1036,469,567
050,29,071,"Missouri","Franklin County",3,75,725,333,392
050,29,071,"Missouri","Franklin County",3,76,712,334,378
050,29,071,"Missouri","Franklin County",3,77,683,307,376
050,29,071,"Missouri","Franklin County",3,78,728,324,404
050,29,071,"Missouri","Franklin County",3,79,625,283,342
050,29,071,"Missouri","Franklin County",3,80,529,228,301
050,29,071,"Missouri","Franklin County",3,81,474,203,271
050,29,071,"Missouri","Franklin County",3,82,441,176,265
050,29,071,"Missouri","Franklin County",3,83,412,175,237
050,29,071,"Missouri","Franklin County",3,84,350,134,216
050,29,071,"Missouri","Franklin County",3,85,1995,721,1274
050,29,071,"Missouri","Franklin County",4,0,1118,590,528
050,29,071,"Missouri","Franklin County",4,1,1089,566,523
050,29,071,"Missouri","Franklin County",4,2,1182,607,575
050,29,071,"Missouri","Franklin County",4,3,1242,613,629
050,29,071,"Missouri","Franklin County",4,4,1241,628,613
050,29,071,"Missouri","Franklin County",4,5,1289,678,611
050,29,071,"Missouri","Franklin County",4,6,1324,697,627
050,29,071,"Missouri","Franklin County",4,7,1298,647,651
050,29,071,"Missouri","Franklin County",4,8,1311,700,611
050,29,071,"Missouri","Franklin County",4,9,1334,686,648
050,29,071,"Missouri","Franklin County",4,10,1349,707,642
050,29,071,"Missouri","Franklin County",4,11,1320,672,648
050,29,071,"Missouri","Franklin County",4,12,1364,723,641
050,29,071,"Missouri","Franklin County",4,13,1409,725,684
050,29,071,"Missouri","Franklin County",4,14,1478,783,695
050,29,071,"Missouri","Franklin County",4,15,1454,765,689
050,29,071,"Missouri","Franklin County",4,16,1440,730,710
050,29,071,"Missouri","Franklin County",4,17,1415,739,676
050,29,071,"Missouri","Franklin County",4,18,1176,621,555
050,29,071,"Missouri","Franklin County",4,19,930,485,445
050,29,071,"Missouri","Franklin County",4,20,1002,519,483
050,29,071,"Missouri","Franklin County",4,21,1060,551,509
050,29,071,"Missouri","Franklin County",4,22,1167,591,576
050,29,071,"Missouri","Franklin County",4,23,1197,659,538
050,29,071,"Missouri","Franklin County",4,24,1208,634,574
050,29,071,"Missouri","Franklin County",4,25,1211,625,586
050,29,071,"Missouri","Franklin County",4,26,1226,629,597
050,29,071,"Missouri","Franklin County",4,27,1196,626,570
050,29,071,"Missouri","Franklin County",4,28,1213,641,572
050,29,071,"Missouri","Franklin County",4,29,1275,660,615
050,29,071,"Missouri","Franklin County",4,30,1371,676,695
050,29,071,"Missouri","Franklin County",4,31,1401,717,684
050,29,071,"Missouri","Franklin County",4,32,1328,690,638
050,29,071,"Missouri","Franklin County",4,33,1313,661,652
050,29,071,"Missouri","Franklin County",4,34,1233,612,621
050,29,071,"Missouri","Franklin County",4,35,1280,645,635
050,29,071,"Missouri","Franklin County",4,36,1303,654,649
050,29,071,"Missouri","Franklin County",4,37,1322,668,654
050,29,071,"Missouri","Franklin County",4,38,1299,685,614
050,29,071,"Missouri","Franklin County",4,39,1320,690,630
050,29,071,"Missouri","Franklin County",4,40,1335,672,663
050,29,071,"Missouri","Franklin County",4,41,1334,673,661
050,29,071,"Missouri","Franklin County",4,42,1266,649,617
050,29,071,"Missouri","Franklin County",4,43,1174,613,561
050,29,071,"Missouri","Franklin County",4,44,1156,585,571
050,29,071,"Missouri","Franklin County",4,45,1123,577,546
050,29,071,"Missouri","Franklin County",4,46,1113,583,530
050,29,071,"Missouri","Franklin County",4,47,1148,574,574
050,29,071,"Missouri","Franklin County",4,48,1139,566,573
050,29,071,"Missouri","Franklin County",4,49,1192,585,607
050,29,071,"Missouri","Franklin County",4,50,1243,638,605
050,29,071,"Missouri","Franklin County",4,51,1394,716,678
050,29,071,"Missouri","Franklin County",4,52,1347,651,696
050,29,071,"Missouri","Franklin County",4,53,1369,692,677
050,29,071,"Missouri","Franklin County",4,54,1392,707,685
050,29,071,"Missouri","Franklin County",4,55,1439,703,736
050,29,071,"Missouri","Franklin County",4,56,1505,739,766
050,29,071,"Missouri","Franklin County",4,57,1555,752,803
050,29,071,"Missouri","Franklin County",4,58,1625,834,791
050,29,071,"Missouri","Franklin County",4,59,1637,818,819
050,29,071,"Missouri","Franklin County",4,60,1734,872,862
050,29,071,"Missouri","Franklin County",4,61,1784,937,847
050,29,071,"Missouri","Franklin County",4,62,1736,876,860
050,29,071,"Missouri","Franklin County",4,63,1662,832,830
050,29,071,"Missouri","Franklin County",4,64,1593,805,788
050,29,071,"Missouri","Franklin County",4,65,1534,751,783
050,29,071,"Missouri","Franklin County",4,66,1422,680,742
050,29,071,"Missouri","Franklin County",4,67,1330,658,672
050,29,071,"Missouri","Franklin County",4,68,1301,657,644
050,29,071,"Missouri","Franklin County",4,69,1257,628,629
050,29,071,"Missouri","Franklin County",4,70,1155,571,584
050,29,071,"Missouri","Franklin County",4,71,1049,502,547
050,29,071,"Missouri","Franklin County",4,72,1030,490,540
050,29,071,"Missouri","Franklin County",4,73,1031,487,544
050,29,071,"Missouri","Franklin County",4,74,986,451,535
050,29,071,"Missouri","Franklin County",4,75,1005,451,554
050,29,071,"Missouri","Franklin County",4,76,708,322,386
050,29,071,"Missouri","Franklin County",4,77,665,298,367
050,29,071,"Missouri","Franklin County",4,78,666,304,362
050,29,071,"Missouri","Franklin County",4,79,671,294,377
050,29,071,"Missouri","Franklin County",4,80,595,263,332
050,29,071,"Missouri","Franklin County",4,81,499,217,282
050,29,071,"Missouri","Franklin County",4,82,440,183,257
050,29,071,"Missouri","Franklin County",4,83,404,160,244
050,29,071,"Missouri","Franklin County",4,84,358,143,215
050,29,071,"Missouri","Franklin County",4,85,2004,726,1278
050,29,071,"Missouri","Franklin County",5,0,1088,570,518
050,29,071,"Missouri","Franklin County",5,1,1157,614,543
050,29,071,"Missouri","Franklin County",5,2,1129,571,558
050,29,071,"Missouri","Franklin County",5,3,1205,622,583
050,29,071,"Missouri","Franklin County",5,4,1244,625,619
050,29,071,"Missouri","Franklin County",5,5,1262,641,621
050,29,071,"Missouri","Franklin County",5,6,1326,701,625
050,29,071,"Missouri","Franklin County",5,7,1339,703,636
050,29,071,"Missouri","Franklin County",5,8,1326,654,672
050,29,071,"Missouri","Franklin County",5,9,1314,693,621
050,29,071,"Missouri","Franklin County",5,10,1337,697,640
050,29,071,"Missouri","Franklin County",5,11,1340,697,643
050,29,071,"Missouri","Franklin County",5,12,1334,687,647
050,29,071,"Missouri","Franklin County",5,13,1355,702,653
050,29,071,"Missouri","Franklin County",5,14,1423,734,689
050,29,071,"Missouri","Franklin County",5,15,1475,785,690
050,29,071,"Missouri","Franklin County",5,16,1447,756,691
050,29,071,"Missouri","Franklin County",5,17,1458,740,718
050,29,071,"Missouri","Franklin County",5,18,1149,629,520
050,29,071,"Missouri","Franklin County",5,19,907,479,428
050,29,071,"Missouri","Franklin County",5,20,1038,539,499
050,29,071,"Missouri","Franklin County",5,21,1048,549,499
050,29,071,"Missouri","Franklin County",5,22,1136,583,553
050,29,071,"Missouri","Franklin County",5,23,1210,628,582
050,29,071,"Missouri","Franklin County",5,24,1223,689,534
050,29,071,"Missouri","Franklin County",5,25,1223,630,593
050,29,071,"Missouri","Franklin County",5,26,1211,614,597
050,29,071,"Missouri","Franklin County",5,27,1241,642,599
050,29,071,"Missouri","Franklin County",5,28,1210,622,588
050,29,071,"Missouri","Franklin County",5,29,1250,665,585
050,29,071,"Missouri","Franklin County",5,30,1276,638,638
050,29,071,"Missouri","Franklin County",5,31,1381,698,683
050,29,071,"Missouri","Franklin County",5,32,1411,725,686
050,29,071,"Missouri","Franklin County",5,33,1339,700,639
050,29,071,"Missouri","Franklin County",5,34,1328,679,649
050,29,071,"Missouri","Franklin County",5,35,1250,619,631
050,29,071,"Missouri","Franklin County",5,36,1267,642,625
050,29,071,"Missouri","Franklin County",5,37,1328,660,668
050,29,071,"Missouri","Franklin County",5,38,1340,668,672
050,29,071,"Missouri","Franklin County",5,39,1321,698,623
050,29,071,"Missouri","Franklin County",5,40,1302,679,623
050,29,071,"Missouri","Franklin County",5,41,1350,685,665
050,29,071,"Missouri","Franklin County",5,42,1341,681,660
050,29,071,"Missouri","Franklin County",5,43,1291,656,635
050,29,071,"Missouri","Franklin County",5,44,1193,625,568
050,29,071,"Missouri","Franklin County",5,45,1156,585,571
050,29,071,"Missouri","Franklin County",5,46,1147,593,554
050,29,071,"Missouri","Franklin County",5,47,1122,586,536
050,29,071,"Missouri","Franklin County",5,48,1137,569,568
050,29,071,"Missouri","Franklin County",5,49,1144,565,579
050,29,071,"Missouri","Franklin County",5,50,1203,590,613
050,29,071,"Missouri","Franklin County",5,51,1247,633,614
050,29,071,"Missouri","Franklin County",5,52,1402,716,686
050,29,071,"Missouri","Franklin County",5,53,1368,664,704
050,29,071,"Missouri","Franklin County",5,54,1372,688,684
050,29,071,"Missouri","Franklin County",5,55,1386,706,680
050,29,071,"Missouri","Franklin County",5,56,1433,690,743
050,29,071,"Missouri","Franklin County",5,57,1500,732,768
050,29,071,"Missouri","Franklin County",5,58,1549,752,797
050,29,071,"Missouri","Franklin County",5,59,1635,849,786
050,29,071,"Missouri","Franklin County",5,60,1652,827,825
050,29,071,"Missouri","Franklin County",5,61,1713,858,855
050,29,071,"Missouri","Franklin County",5,62,1791,939,852
050,29,071,"Missouri","Franklin County",5,63,1718,861,857
050,29,071,"Missouri","Franklin County",5,64,1651,826,825
050,29,071,"Missouri","Franklin County",5,65,1588,804,784
050,29,071,"Missouri","Franklin County",5,66,1534,755,779
050,29,071,"Missouri","Franklin County",5,67,1397,663,734
050,29,071,"Missouri","Franklin County",5,68,1345,670,675
050,29,071,"Missouri","Franklin County",5,69,1284,645,639
050,29,071,"Missouri","Franklin County",5,70,1232,611,621
050,29,071,"Missouri","Franklin County",5,71,1147,565,582
050,29,071,"Missouri","Franklin County",5,72,1054,503,551
050,29,071,"Missouri","Franklin County",5,73,994,472,522
050,29,071,"Missouri","Franklin County",5,74,1000,476,524
050,29,071,"Missouri","Franklin County",5,75,974,447,527
050,29,071,"Missouri","Franklin County",5,76,981,438,543
050,29,071,"Missouri","Franklin County",5,77,666,291,375
050,29,071,"Missouri","Franklin County",5,78,643,291,352
050,29,071,"Missouri","Franklin County",5,79,625,283,342
050,29,071,"Missouri","Franklin County",5,80,643,276,367
050,29,071,"Missouri","Franklin County",5,81,568,251,317
050,29,071,"Missouri","Franklin County",5,82,466,195,271
050,29,071,"Missouri","Franklin County",5,83,417,176,241
050,29,071,"Missouri","Franklin County",5,84,355,131,224
050,29,071,"Missouri","Franklin County",5,85,2042,753,1289
050,29,073,"Missouri","Gasconade County",1,0,150,78,72
050,29,073,"Missouri","Gasconade County",1,1,160,80,80
050,29,073,"Missouri","Gasconade County",1,2,162,80,82
050,29,073,"Missouri","Gasconade County",1,3,168,98,70
050,29,073,"Missouri","Gasconade County",1,4,155,89,66
050,29,073,"Missouri","Gasconade County",1,5,155,91,64
050,29,073,"Missouri","Gasconade County",1,6,161,88,73
050,29,073,"Missouri","Gasconade County",1,7,151,78,73
050,29,073,"Missouri","Gasconade County",1,8,173,91,82
050,29,073,"Missouri","Gasconade County",1,9,170,92,78
050,29,073,"Missouri","Gasconade County",1,10,152,78,74
050,29,073,"Missouri","Gasconade County",1,11,177,88,89
050,29,073,"Missouri","Gasconade County",1,12,181,83,98
050,29,073,"Missouri","Gasconade County",1,13,201,102,99
050,29,073,"Missouri","Gasconade County",1,14,186,92,94
050,29,073,"Missouri","Gasconade County",1,15,176,94,82
050,29,073,"Missouri","Gasconade County",1,16,202,112,90
050,29,073,"Missouri","Gasconade County",1,17,191,105,86
050,29,073,"Missouri","Gasconade County",1,18,165,86,79
050,29,073,"Missouri","Gasconade County",1,19,136,67,69
050,29,073,"Missouri","Gasconade County",1,20,130,71,59
050,29,073,"Missouri","Gasconade County",1,21,149,78,71
050,29,073,"Missouri","Gasconade County",1,22,146,76,70
050,29,073,"Missouri","Gasconade County",1,23,155,80,75
050,29,073,"Missouri","Gasconade County",1,24,128,60,68
050,29,073,"Missouri","Gasconade County",1,25,142,72,70
050,29,073,"Missouri","Gasconade County",1,26,156,73,83
050,29,073,"Missouri","Gasconade County",1,27,154,70,84
050,29,073,"Missouri","Gasconade County",1,28,157,80,77
050,29,073,"Missouri","Gasconade County",1,29,177,92,85
050,29,073,"Missouri","Gasconade County",1,30,154,78,76
050,29,073,"Missouri","Gasconade County",1,31,169,91,78
050,29,073,"Missouri","Gasconade County",1,32,157,82,75
050,29,073,"Missouri","Gasconade County",1,33,144,64,80
050,29,073,"Missouri","Gasconade County",1,34,167,82,85
050,29,073,"Missouri","Gasconade County",1,35,152,79,73
050,29,073,"Missouri","Gasconade County",1,36,158,83,75
050,29,073,"Missouri","Gasconade County",1,37,172,85,87
050,29,073,"Missouri","Gasconade County",1,38,176,90,86
050,29,073,"Missouri","Gasconade County",1,39,158,87,71
050,29,073,"Missouri","Gasconade County",1,40,152,71,81
050,29,073,"Missouri","Gasconade County",1,41,148,73,75
050,29,073,"Missouri","Gasconade County",1,42,150,74,76
050,29,073,"Missouri","Gasconade County",1,43,142,82,60
050,29,073,"Missouri","Gasconade County",1,44,166,86,80
050,29,073,"Missouri","Gasconade County",1,45,148,72,76
050,29,073,"Missouri","Gasconade County",1,46,168,86,82
050,29,073,"Missouri","Gasconade County",1,47,165,86,79
050,29,073,"Missouri","Gasconade County",1,48,174,91,83
050,29,073,"Missouri","Gasconade County",1,49,175,93,82
050,29,073,"Missouri","Gasconade County",1,50,189,103,86
050,29,073,"Missouri","Gasconade County",1,51,192,98,94
050,29,073,"Missouri","Gasconade County",1,52,178,83,95
050,29,073,"Missouri","Gasconade County",1,53,198,96,102
050,29,073,"Missouri","Gasconade County",1,54,192,90,102
050,29,073,"Missouri","Gasconade County",1,55,234,112,122
050,29,073,"Missouri","Gasconade County",1,56,248,131,117
050,29,073,"Missouri","Gasconade County",1,57,227,123,104
050,29,073,"Missouri","Gasconade County",1,58,257,144,113
050,29,073,"Missouri","Gasconade County",1,59,246,133,113
050,29,073,"Missouri","Gasconade County",1,60,244,125,119
050,29,073,"Missouri","Gasconade County",1,61,247,119,128
050,29,073,"Missouri","Gasconade County",1,62,253,129,124
050,29,073,"Missouri","Gasconade County",1,63,251,130,121
050,29,073,"Missouri","Gasconade County",1,64,236,133,103
050,29,073,"Missouri","Gasconade County",1,65,247,134,113
050,29,073,"Missouri","Gasconade County",1,66,226,117,109
050,29,073,"Missouri","Gasconade County",1,67,211,106,105
050,29,073,"Missouri","Gasconade County",1,68,211,108,103
050,29,073,"Missouri","Gasconade County",1,69,178,82,96
050,29,073,"Missouri","Gasconade County",1,70,163,77,86
050,29,073,"Missouri","Gasconade County",1,71,177,82,95
050,29,073,"Missouri","Gasconade County",1,72,195,91,104
050,29,073,"Missouri","Gasconade County",1,73,186,82,104
050,29,073,"Missouri","Gasconade County",1,74,122,57,65
050,29,073,"Missouri","Gasconade County",1,75,142,67,75
050,29,073,"Missouri","Gasconade County",1,76,130,56,74
050,29,073,"Missouri","Gasconade County",1,77,108,49,59
050,29,073,"Missouri","Gasconade County",1,78,104,49,55
050,29,073,"Missouri","Gasconade County",1,79,105,54,51
050,29,073,"Missouri","Gasconade County",1,80,92,43,49
050,29,073,"Missouri","Gasconade County",1,81,94,37,57
050,29,073,"Missouri","Gasconade County",1,82,76,33,43
050,29,073,"Missouri","Gasconade County",1,83,79,34,45
050,29,073,"Missouri","Gasconade County",1,84,73,36,37
050,29,073,"Missouri","Gasconade County",1,85,422,146,276
050,29,073,"Missouri","Gasconade County",2,0,142,76,66
050,29,073,"Missouri","Gasconade County",2,1,154,77,77
050,29,073,"Missouri","Gasconade County",2,2,161,80,81
050,29,073,"Missouri","Gasconade County",2,3,166,94,72
050,29,073,"Missouri","Gasconade County",2,4,157,91,66
050,29,073,"Missouri","Gasconade County",2,5,155,91,64
050,29,073,"Missouri","Gasconade County",2,6,161,89,72
050,29,073,"Missouri","Gasconade County",2,7,154,81,73
050,29,073,"Missouri","Gasconade County",2,8,167,87,80
050,29,073,"Missouri","Gasconade County",2,9,168,89,79
050,29,073,"Missouri","Gasconade County",2,10,155,80,75
050,29,073,"Missouri","Gasconade County",2,11,168,83,85
050,29,073,"Missouri","Gasconade County",2,12,183,86,97
050,29,073,"Missouri","Gasconade County",2,13,198,100,98
050,29,073,"Missouri","Gasconade County",2,14,189,95,94
050,29,073,"Missouri","Gasconade County",2,15,179,93,86
050,29,073,"Missouri","Gasconade County",2,16,198,109,89
050,29,073,"Missouri","Gasconade County",2,17,193,106,87
050,29,073,"Missouri","Gasconade County",2,18,161,86,75
050,29,073,"Missouri","Gasconade County",2,19,134,67,67
050,29,073,"Missouri","Gasconade County",2,20,135,72,63
050,29,073,"Missouri","Gasconade County",2,21,144,76,68
050,29,073,"Missouri","Gasconade County",2,22,149,78,71
050,29,073,"Missouri","Gasconade County",2,23,151,76,75
050,29,073,"Missouri","Gasconade County",2,24,134,64,70
050,29,073,"Missouri","Gasconade County",2,25,138,69,69
050,29,073,"Missouri","Gasconade County",2,26,152,72,80
050,29,073,"Missouri","Gasconade County",2,27,154,71,83
050,29,073,"Missouri","Gasconade County",2,28,155,77,78
050,29,073,"Missouri","Gasconade County",2,29,167,86,81
050,29,073,"Missouri","Gasconade County",2,30,161,82,79
050,29,073,"Missouri","Gasconade County",2,31,165,89,76
050,29,073,"Missouri","Gasconade County",2,32,159,83,76
050,29,073,"Missouri","Gasconade County",2,33,148,69,79
050,29,073,"Missouri","Gasconade County",2,34,159,77,82
050,29,073,"Missouri","Gasconade County",2,35,154,79,75
050,29,073,"Missouri","Gasconade County",2,36,156,80,76
050,29,073,"Missouri","Gasconade County",2,37,170,84,86
050,29,073,"Missouri","Gasconade County",2,38,172,88,84
050,29,073,"Missouri","Gasconade County",2,39,162,87,75
050,29,073,"Missouri","Gasconade County",2,40,155,77,78
050,29,073,"Missouri","Gasconade County",2,41,151,75,76
050,29,073,"Missouri","Gasconade County",2,42,151,75,76
050,29,073,"Missouri","Gasconade County",2,43,146,81,65
050,29,073,"Missouri","Gasconade County",2,44,158,83,75
050,29,073,"Missouri","Gasconade County",2,45,155,75,80
050,29,073,"Missouri","Gasconade County",2,46,163,82,81
050,29,073,"Missouri","Gasconade County",2,47,167,87,80
050,29,073,"Missouri","Gasconade County",2,48,171,89,82
050,29,073,"Missouri","Gasconade County",2,49,177,94,83
050,29,073,"Missouri","Gasconade County",2,50,187,101,86
050,29,073,"Missouri","Gasconade County",2,51,191,99,92
050,29,073,"Missouri","Gasconade County",2,52,182,87,95
050,29,073,"Missouri","Gasconade County",2,53,194,93,101
050,29,073,"Missouri","Gasconade County",2,54,192,91,101
050,29,073,"Missouri","Gasconade County",2,55,225,107,118
050,29,073,"Missouri","Gasconade County",2,56,245,127,118
050,29,073,"Missouri","Gasconade County",2,57,233,126,107
050,29,073,"Missouri","Gasconade County",2,58,250,139,111
050,29,073,"Missouri","Gasconade County",2,59,250,137,113
050,29,073,"Missouri","Gasconade County",2,60,242,125,117
050,29,073,"Missouri","Gasconade County",2,61,246,120,126
050,29,073,"Missouri","Gasconade County",2,62,254,128,126
050,29,073,"Missouri","Gasconade County",2,63,254,131,123
050,29,073,"Missouri","Gasconade County",2,64,239,131,108
050,29,073,"Missouri","Gasconade County",2,65,245,134,111
050,29,073,"Missouri","Gasconade County",2,66,232,122,110
050,29,073,"Missouri","Gasconade County",2,67,215,109,106
050,29,073,"Missouri","Gasconade County",2,68,209,107,102
050,29,073,"Missouri","Gasconade County",2,69,184,86,98
050,29,073,"Missouri","Gasconade County",2,70,167,79,88
050,29,073,"Missouri","Gasconade County",2,71,172,80,92
050,29,073,"Missouri","Gasconade County",2,72,186,86,100
050,29,073,"Missouri","Gasconade County",2,73,196,89,107
050,29,073,"Missouri","Gasconade County",2,74,129,59,70
050,29,073,"Missouri","Gasconade County",2,75,136,63,73
050,29,073,"Missouri","Gasconade County",2,76,133,59,74
050,29,073,"Missouri","Gasconade County",2,77,114,51,63
050,29,073,"Missouri","Gasconade County",2,78,103,48,55
050,29,073,"Missouri","Gasconade County",2,79,101,50,51
050,29,073,"Missouri","Gasconade County",2,80,93,45,48
050,29,073,"Missouri","Gasconade County",2,81,93,37,56
050,29,073,"Missouri","Gasconade County",2,82,79,34,45
050,29,073,"Missouri","Gasconade County",2,83,77,33,44
050,29,073,"Missouri","Gasconade County",2,84,72,36,36
050,29,073,"Missouri","Gasconade County",2,85,421,145,276
050,29,073,"Missouri","Gasconade County",3,0,146,78,68
050,29,073,"Missouri","Gasconade County",3,1,145,83,62
050,29,073,"Missouri","Gasconade County",3,2,158,79,79
050,29,073,"Missouri","Gasconade County",3,3,162,86,76
050,29,073,"Missouri","Gasconade County",3,4,179,103,76
050,29,073,"Missouri","Gasconade County",3,5,148,86,62
050,29,073,"Missouri","Gasconade County",3,6,168,93,75
050,29,073,"Missouri","Gasconade County",3,7,164,87,77
050,29,073,"Missouri","Gasconade County",3,8,164,91,73
050,29,073,"Missouri","Gasconade County",3,9,166,88,78
050,29,073,"Missouri","Gasconade County",3,10,169,96,73
050,29,073,"Missouri","Gasconade County",3,11,159,85,74
050,29,073,"Missouri","Gasconade County",3,12,169,86,83
050,29,073,"Missouri","Gasconade County",3,13,194,95,99
050,29,073,"Missouri","Gasconade County",3,14,199,102,97
050,29,073,"Missouri","Gasconade County",3,15,190,92,98
050,29,073,"Missouri","Gasconade County",3,16,182,96,86
050,29,073,"Missouri","Gasconade County",3,17,204,116,88
050,29,073,"Missouri","Gasconade County",3,18,163,94,69
050,29,073,"Missouri","Gasconade County",3,19,124,69,55
050,29,073,"Missouri","Gasconade County",3,20,136,67,69
050,29,073,"Missouri","Gasconade County",3,21,141,72,69
050,29,073,"Missouri","Gasconade County",3,22,147,81,66
050,29,073,"Missouri","Gasconade County",3,23,156,82,74
050,29,073,"Missouri","Gasconade County",3,24,145,80,65
050,29,073,"Missouri","Gasconade County",3,25,118,58,60
050,29,073,"Missouri","Gasconade County",3,26,130,67,63
050,29,073,"Missouri","Gasconade County",3,27,151,73,78
050,29,073,"Missouri","Gasconade County",3,28,160,73,87
050,29,073,"Missouri","Gasconade County",3,29,155,75,80
050,29,073,"Missouri","Gasconade County",3,30,181,95,86
050,29,073,"Missouri","Gasconade County",3,31,176,91,85
050,29,073,"Missouri","Gasconade County",3,32,171,89,82
050,29,073,"Missouri","Gasconade County",3,33,164,85,79
050,29,073,"Missouri","Gasconade County",3,34,143,70,73
050,29,073,"Missouri","Gasconade County",3,35,161,84,77
050,29,073,"Missouri","Gasconade County",3,36,154,78,76
050,29,073,"Missouri","Gasconade County",3,37,153,80,73
050,29,073,"Missouri","Gasconade County",3,38,170,82,88
050,29,073,"Missouri","Gasconade County",3,39,178,90,88
050,29,073,"Missouri","Gasconade County",3,40,166,88,78
050,29,073,"Missouri","Gasconade County",3,41,162,80,82
050,29,073,"Missouri","Gasconade County",3,42,150,73,77
050,29,073,"Missouri","Gasconade County",3,43,149,75,74
050,29,073,"Missouri","Gasconade County",3,44,142,81,61
050,29,073,"Missouri","Gasconade County",3,45,156,82,74
050,29,073,"Missouri","Gasconade County",3,46,161,78,83
050,29,073,"Missouri","Gasconade County",3,47,169,85,84
050,29,073,"Missouri","Gasconade County",3,48,175,86,89
050,29,073,"Missouri","Gasconade County",3,49,167,85,82
050,29,073,"Missouri","Gasconade County",3,50,182,97,85
050,29,073,"Missouri","Gasconade County",3,51,181,94,87
050,29,073,"Missouri","Gasconade County",3,52,191,100,91
050,29,073,"Missouri","Gasconade County",3,53,183,90,93
050,29,073,"Missouri","Gasconade County",3,54,197,93,104
050,29,073,"Missouri","Gasconade County",3,55,201,92,109
050,29,073,"Missouri","Gasconade County",3,56,219,107,112
050,29,073,"Missouri","Gasconade County",3,57,256,132,124
050,29,073,"Missouri","Gasconade County",3,58,237,126,111
050,29,073,"Missouri","Gasconade County",3,59,248,138,110
050,29,073,"Missouri","Gasconade County",3,60,250,137,113
050,29,073,"Missouri","Gasconade County",3,61,255,127,128
050,29,073,"Missouri","Gasconade County",3,62,253,129,124
050,29,073,"Missouri","Gasconade County",3,63,247,124,123
050,29,073,"Missouri","Gasconade County",3,64,258,132,126
050,29,073,"Missouri","Gasconade County",3,65,241,132,109
050,29,073,"Missouri","Gasconade County",3,66,239,131,108
050,29,073,"Missouri","Gasconade County",3,67,231,120,111
050,29,073,"Missouri","Gasconade County",3,68,199,98,101
050,29,073,"Missouri","Gasconade County",3,69,195,101,94
050,29,073,"Missouri","Gasconade County",3,70,182,86,96
050,29,073,"Missouri","Gasconade County",3,71,164,74,90
050,29,073,"Missouri","Gasconade County",3,72,163,75,88
050,29,073,"Missouri","Gasconade County",3,73,177,80,97
050,29,073,"Missouri","Gasconade County",3,74,190,88,102
050,29,073,"Missouri","Gasconade County",3,75,118,51,67
050,29,073,"Missouri","Gasconade County",3,76,132,63,69
050,29,073,"Missouri","Gasconade County",3,77,122,54,68
050,29,073,"Missouri","Gasconade County",3,78,109,48,61
050,29,073,"Missouri","Gasconade County",3,79,98,45,53
050,29,073,"Missouri","Gasconade County",3,80,91,44,47
050,29,073,"Missouri","Gasconade County",3,81,98,44,54
050,29,073,"Missouri","Gasconade County",3,82,86,38,48
050,29,073,"Missouri","Gasconade County",3,83,72,31,41
050,29,073,"Missouri","Gasconade County",3,84,65,28,37
050,29,073,"Missouri","Gasconade County",3,85,410,154,256
050,29,073,"Missouri","Gasconade County",4,0,147,78,69
050,29,073,"Missouri","Gasconade County",4,1,146,71,75
050,29,073,"Missouri","Gasconade County",4,2,155,89,66
050,29,073,"Missouri","Gasconade County",4,3,153,71,82
050,29,073,"Missouri","Gasconade County",4,4,168,86,82
050,29,073,"Missouri","Gasconade County",4,5,185,105,80
050,29,073,"Missouri","Gasconade County",4,6,152,84,68
050,29,073,"Missouri","Gasconade County",4,7,168,95,73
050,29,073,"Missouri","Gasconade County",4,8,169,88,81
050,29,073,"Missouri","Gasconade County",4,9,166,91,75
050,29,073,"Missouri","Gasconade County",4,10,159,85,74
050,29,073,"Missouri","Gasconade County",4,11,177,101,76
050,29,073,"Missouri","Gasconade County",4,12,155,86,69
050,29,073,"Missouri","Gasconade County",4,13,177,87,90
050,29,073,"Missouri","Gasconade County",4,14,200,96,104
050,29,073,"Missouri","Gasconade County",4,15,196,102,94
050,29,073,"Missouri","Gasconade County",4,16,190,94,96
050,29,073,"Missouri","Gasconade County",4,17,180,96,84
050,29,073,"Missouri","Gasconade County",4,18,173,103,70
050,29,073,"Missouri","Gasconade County",4,19,120,68,52
050,29,073,"Missouri","Gasconade County",4,20,136,73,63
050,29,073,"Missouri","Gasconade County",4,21,139,64,75
050,29,073,"Missouri","Gasconade County",4,22,160,78,82
050,29,073,"Missouri","Gasconade County",4,23,167,88,79
050,29,073,"Missouri","Gasconade County",4,24,151,81,70
050,29,073,"Missouri","Gasconade County",4,25,138,76,62
050,29,073,"Missouri","Gasconade County",4,26,111,58,53
050,29,073,"Missouri","Gasconade County",4,27,135,70,65
050,29,073,"Missouri","Gasconade County",4,28,146,72,74
050,29,073,"Missouri","Gasconade County",4,29,159,71,88
050,29,073,"Missouri","Gasconade County",4,30,154,73,81
050,29,073,"Missouri","Gasconade County",4,31,176,86,90
050,29,073,"Missouri","Gasconade County",4,32,168,87,81
050,29,073,"Missouri","Gasconade County",4,33,175,89,86
050,29,073,"Missouri","Gasconade County",4,34,169,93,76
050,29,073,"Missouri","Gasconade County",4,35,145,67,78
050,29,073,"Missouri","Gasconade County",4,36,165,88,77
050,29,073,"Missouri","Gasconade County",4,37,159,81,78
050,29,073,"Missouri","Gasconade County",4,38,152,80,72
050,29,073,"Missouri","Gasconade County",4,39,170,81,89
050,29,073,"Missouri","Gasconade County",4,40,180,91,89
050,29,073,"Missouri","Gasconade County",4,41,163,88,75
050,29,073,"Missouri","Gasconade County",4,42,161,82,79
050,29,073,"Missouri","Gasconade County",4,43,158,80,78
050,29,073,"Missouri","Gasconade County",4,44,148,77,71
050,29,073,"Missouri","Gasconade County",4,45,149,84,65
050,29,073,"Missouri","Gasconade County",4,46,165,82,83
050,29,073,"Missouri","Gasconade County",4,47,159,78,81
050,29,073,"Missouri","Gasconade County",4,48,168,86,82
050,29,073,"Missouri","Gasconade County",4,49,170,84,86
050,29,073,"Missouri","Gasconade County",4,50,169,87,82
050,29,073,"Missouri","Gasconade County",4,51,181,94,87
050,29,073,"Missouri","Gasconade County",4,52,180,91,89
050,29,073,"Missouri","Gasconade County",4,53,196,104,92
050,29,073,"Missouri","Gasconade County",4,54,184,90,94
050,29,073,"Missouri","Gasconade County",4,55,190,89,101
050,29,073,"Missouri","Gasconade County",4,56,192,88,104
050,29,073,"Missouri","Gasconade County",4,57,223,110,113
050,29,073,"Missouri","Gasconade County",4,58,267,138,129
050,29,073,"Missouri","Gasconade County",4,59,241,127,114
050,29,073,"Missouri","Gasconade County",4,60,250,138,112
050,29,073,"Missouri","Gasconade County",4,61,248,135,113
050,29,073,"Missouri","Gasconade County",4,62,250,128,122
050,29,073,"Missouri","Gasconade County",4,63,269,141,128
050,29,073,"Missouri","Gasconade County",4,64,246,122,124
050,29,073,"Missouri","Gasconade County",4,65,254,131,123
050,29,073,"Missouri","Gasconade County",4,66,239,131,108
050,29,073,"Missouri","Gasconade County",4,67,247,131,116
050,29,073,"Missouri","Gasconade County",4,68,220,113,107
050,29,073,"Missouri","Gasconade County",4,69,186,89,97
050,29,073,"Missouri","Gasconade County",4,70,194,100,94
050,29,073,"Missouri","Gasconade County",4,71,181,87,94
050,29,073,"Missouri","Gasconade County",4,72,160,74,86
050,29,073,"Missouri","Gasconade County",4,73,150,70,80
050,29,073,"Missouri","Gasconade County",4,74,164,76,88
050,29,073,"Missouri","Gasconade County",4,75,185,84,101
050,29,073,"Missouri","Gasconade County",4,76,117,53,64
050,29,073,"Missouri","Gasconade County",4,77,122,58,64
050,29,073,"Missouri","Gasconade County",4,78,115,49,66
050,29,073,"Missouri","Gasconade County",4,79,104,45,59
050,29,073,"Missouri","Gasconade County",4,80,90,42,48
050,29,073,"Missouri","Gasconade County",4,81,90,38,52
050,29,073,"Missouri","Gasconade County",4,82,90,41,49
050,29,073,"Missouri","Gasconade County",4,83,79,35,44
050,29,073,"Missouri","Gasconade County",4,84,63,30,33
050,29,073,"Missouri","Gasconade County",4,85,404,154,250
050,29,073,"Missouri","Gasconade County",5,0,144,76,68
050,29,073,"Missouri","Gasconade County",5,1,146,79,67
050,29,073,"Missouri","Gasconade County",5,2,147,71,76
050,29,073,"Missouri","Gasconade County",5,3,153,85,68
050,29,073,"Missouri","Gasconade County",5,4,157,81,76
050,29,073,"Missouri","Gasconade County",5,5,160,79,81
050,29,073,"Missouri","Gasconade County",5,6,187,107,80
050,29,073,"Missouri","Gasconade County",5,7,152,76,76
050,29,073,"Missouri","Gasconade County",5,8,162,93,69
050,29,073,"Missouri","Gasconade County",5,9,165,90,75
050,29,073,"Missouri","Gasconade County",5,10,165,93,72
050,29,073,"Missouri","Gasconade County",5,11,169,86,83
050,29,073,"Missouri","Gasconade County",5,12,178,100,78
050,29,073,"Missouri","Gasconade County",5,13,155,88,67
050,29,073,"Missouri","Gasconade County",5,14,178,90,88
050,29,073,"Missouri","Gasconade County",5,15,198,95,103
050,29,073,"Missouri","Gasconade County",5,16,193,102,91
050,29,073,"Missouri","Gasconade County",5,17,187,88,99
050,29,073,"Missouri","Gasconade County",5,18,160,83,77
050,29,073,"Missouri","Gasconade County",5,19,128,75,53
050,29,073,"Missouri","Gasconade County",5,20,133,72,61
050,29,073,"Missouri","Gasconade County",5,21,135,69,66
050,29,073,"Missouri","Gasconade County",5,22,151,74,77
050,29,073,"Missouri","Gasconade County",5,23,163,78,85
050,29,073,"Missouri","Gasconade County",5,24,166,87,79
050,29,073,"Missouri","Gasconade County",5,25,146,76,70
050,29,073,"Missouri","Gasconade County",5,26,119,64,55
050,29,073,"Missouri","Gasconade County",5,27,102,50,52
050,29,073,"Missouri","Gasconade County",5,28,135,71,64
050,29,073,"Missouri","Gasconade County",5,29,142,64,78
050,29,073,"Missouri","Gasconade County",5,30,147,64,83
050,29,073,"Missouri","Gasconade County",5,31,154,72,82
050,29,073,"Missouri","Gasconade County",5,32,181,92,89
050,29,073,"Missouri","Gasconade County",5,33,181,98,83
050,29,073,"Missouri","Gasconade County",5,34,181,94,87
050,29,073,"Missouri","Gasconade County",5,35,166,94,72
050,29,073,"Missouri","Gasconade County",5,36,141,65,76
050,29,073,"Missouri","Gasconade County",5,37,161,86,75
050,29,073,"Missouri","Gasconade County",5,38,153,76,77
050,29,073,"Missouri","Gasconade County",5,39,158,86,72
050,29,073,"Missouri","Gasconade County",5,40,173,85,88
050,29,073,"Missouri","Gasconade County",5,41,186,98,88
050,29,073,"Missouri","Gasconade County",5,42,165,88,77
050,29,073,"Missouri","Gasconade County",5,43,166,87,79
050,29,073,"Missouri","Gasconade County",5,44,161,78,83
050,29,073,"Missouri","Gasconade County",5,45,148,77,71
050,29,073,"Missouri","Gasconade County",5,46,151,84,67
050,29,073,"Missouri","Gasconade County",5,47,166,82,84
050,29,073,"Missouri","Gasconade County",5,48,159,78,81
050,29,073,"Missouri","Gasconade County",5,49,167,86,81
050,29,073,"Missouri","Gasconade County",5,50,174,87,87
050,29,073,"Missouri","Gasconade County",5,51,177,90,87
050,29,073,"Missouri","Gasconade County",5,52,175,90,85
050,29,073,"Missouri","Gasconade County",5,53,181,91,90
050,29,073,"Missouri","Gasconade County",5,54,198,107,91
050,29,073,"Missouri","Gasconade County",5,55,181,87,94
050,29,073,"Missouri","Gasconade County",5,56,192,91,101
050,29,073,"Missouri","Gasconade County",5,57,188,87,101
050,29,073,"Missouri","Gasconade County",5,58,224,113,111
050,29,073,"Missouri","Gasconade County",5,59,263,136,127
050,29,073,"Missouri","Gasconade County",5,60,243,126,117
050,29,073,"Missouri","Gasconade County",5,61,248,134,114
050,29,073,"Missouri","Gasconade County",5,62,248,138,110
050,29,073,"Missouri","Gasconade County",5,63,256,135,121
050,29,073,"Missouri","Gasconade County",5,64,264,137,127
050,29,073,"Missouri","Gasconade County",5,65,245,124,121
050,29,073,"Missouri","Gasconade County",5,66,247,126,121
050,29,073,"Missouri","Gasconade County",5,67,243,135,108
050,29,073,"Missouri","Gasconade County",5,68,237,124,113
050,29,073,"Missouri","Gasconade County",5,69,208,105,103
050,29,073,"Missouri","Gasconade County",5,70,185,87,98
050,29,073,"Missouri","Gasconade County",5,71,186,97,89
050,29,073,"Missouri","Gasconade County",5,72,181,86,95
050,29,073,"Missouri","Gasconade County",5,73,155,71,84
050,29,073,"Missouri","Gasconade County",5,74,146,69,77
050,29,073,"Missouri","Gasconade County",5,75,161,72,89
050,29,073,"Missouri","Gasconade County",5,76,176,83,93
050,29,073,"Missouri","Gasconade County",5,77,110,48,62
050,29,073,"Missouri","Gasconade County",5,78,118,56,62
050,29,073,"Missouri","Gasconade County",5,79,112,47,65
050,29,073,"Missouri","Gasconade County",5,80,96,42,54
050,29,073,"Missouri","Gasconade County",5,81,92,37,55
050,29,073,"Missouri","Gasconade County",5,82,85,39,46
050,29,073,"Missouri","Gasconade County",5,83,82,36,46
050,29,073,"Missouri","Gasconade County",5,84,72,34,38
050,29,073,"Missouri","Gasconade County",5,85,415,159,256
050,29,075,"Missouri","Gentry County",1,0,84,43,41
050,29,075,"Missouri","Gentry County",1,1,85,40,45
050,29,075,"Missouri","Gentry County",1,2,87,37,50
050,29,075,"Missouri","Gentry County",1,3,95,46,49
050,29,075,"Missouri","Gentry County",1,4,96,37,59
050,29,075,"Missouri","Gentry County",1,5,101,46,55
050,29,075,"Missouri","Gentry County",1,6,91,53,38
050,29,075,"Missouri","Gentry County",1,7,85,53,32
050,29,075,"Missouri","Gentry County",1,8,86,43,43
050,29,075,"Missouri","Gentry County",1,9,93,40,53
050,29,075,"Missouri","Gentry County",1,10,104,43,61
050,29,075,"Missouri","Gentry County",1,11,86,41,45
050,29,075,"Missouri","Gentry County",1,12,71,32,39
050,29,075,"Missouri","Gentry County",1,13,87,43,44
050,29,075,"Missouri","Gentry County",1,14,81,36,45
050,29,075,"Missouri","Gentry County",1,15,82,44,38
050,29,075,"Missouri","Gentry County",1,16,90,48,42
050,29,075,"Missouri","Gentry County",1,17,74,34,40
050,29,075,"Missouri","Gentry County",1,18,66,33,33
050,29,075,"Missouri","Gentry County",1,19,62,30,32
050,29,075,"Missouri","Gentry County",1,20,58,31,27
050,29,075,"Missouri","Gentry County",1,21,48,23,25
050,29,075,"Missouri","Gentry County",1,22,58,30,28
050,29,075,"Missouri","Gentry County",1,23,62,29,33
050,29,075,"Missouri","Gentry County",1,24,62,34,28
050,29,075,"Missouri","Gentry County",1,25,63,33,30
050,29,075,"Missouri","Gentry County",1,26,69,32,37
050,29,075,"Missouri","Gentry County",1,27,68,34,34
050,29,075,"Missouri","Gentry County",1,28,84,46,38
050,29,075,"Missouri","Gentry County",1,29,86,42,44
050,29,075,"Missouri","Gentry County",1,30,68,30,38
050,29,075,"Missouri","Gentry County",1,31,54,24,30
050,29,075,"Missouri","Gentry County",1,32,73,31,42
050,29,075,"Missouri","Gentry County",1,33,80,41,39
050,29,075,"Missouri","Gentry County",1,34,67,36,31
050,29,075,"Missouri","Gentry County",1,35,73,34,39
050,29,075,"Missouri","Gentry County",1,36,77,36,41
050,29,075,"Missouri","Gentry County",1,37,83,38,45
050,29,075,"Missouri","Gentry County",1,38,85,49,36
050,29,075,"Missouri","Gentry County",1,39,67,34,33
050,29,075,"Missouri","Gentry County",1,40,66,32,34
050,29,075,"Missouri","Gentry County",1,41,62,31,31
050,29,075,"Missouri","Gentry County",1,42,64,34,30
050,29,075,"Missouri","Gentry County",1,43,70,33,37
050,29,075,"Missouri","Gentry County",1,44,62,39,23
050,29,075,"Missouri","Gentry County",1,45,60,30,30
050,29,075,"Missouri","Gentry County",1,46,72,33,39
050,29,075,"Missouri","Gentry County",1,47,60,29,31
050,29,075,"Missouri","Gentry County",1,48,69,33,36
050,29,075,"Missouri","Gentry County",1,49,76,42,34
050,29,075,"Missouri","Gentry County",1,50,85,45,40
050,29,075,"Missouri","Gentry County",1,51,67,36,31
050,29,075,"Missouri","Gentry County",1,52,74,37,37
050,29,075,"Missouri","Gentry County",1,53,76,43,33
050,29,075,"Missouri","Gentry County",1,54,65,34,31
050,29,075,"Missouri","Gentry County",1,55,84,42,42
050,29,075,"Missouri","Gentry County",1,56,96,52,44
050,29,075,"Missouri","Gentry County",1,57,86,47,39
050,29,075,"Missouri","Gentry County",1,58,95,49,46
050,29,075,"Missouri","Gentry County",1,59,92,45,47
050,29,075,"Missouri","Gentry County",1,60,86,45,41
050,29,075,"Missouri","Gentry County",1,61,86,47,39
050,29,075,"Missouri","Gentry County",1,62,92,48,44
050,29,075,"Missouri","Gentry County",1,63,81,34,47
050,29,075,"Missouri","Gentry County",1,64,83,37,46
050,29,075,"Missouri","Gentry County",1,65,88,46,42
050,29,075,"Missouri","Gentry County",1,66,78,37,41
050,29,075,"Missouri","Gentry County",1,67,72,32,40
050,29,075,"Missouri","Gentry County",1,68,70,33,37
050,29,075,"Missouri","Gentry County",1,69,62,32,30
050,29,075,"Missouri","Gentry County",1,70,58,30,28
050,29,075,"Missouri","Gentry County",1,71,45,19,26
050,29,075,"Missouri","Gentry County",1,72,53,26,27
050,29,075,"Missouri","Gentry County",1,73,57,29,28
050,29,075,"Missouri","Gentry County",1,74,37,17,20
050,29,075,"Missouri","Gentry County",1,75,45,21,24
050,29,075,"Missouri","Gentry County",1,76,43,16,27
050,29,075,"Missouri","Gentry County",1,77,44,23,21
050,29,075,"Missouri","Gentry County",1,78,34,17,17
050,29,075,"Missouri","Gentry County",1,79,44,20,24
050,29,075,"Missouri","Gentry County",1,80,41,16,25
050,29,075,"Missouri","Gentry County",1,81,33,13,20
050,29,075,"Missouri","Gentry County",1,82,28,13,15
050,29,075,"Missouri","Gentry County",1,83,28,14,14
050,29,075,"Missouri","Gentry County",1,84,26,9,17
050,29,075,"Missouri","Gentry County",1,85,176,62,114
050,29,075,"Missouri","Gentry County",2,0,83,37,46
050,29,075,"Missouri","Gentry County",2,1,84,40,44
050,29,075,"Missouri","Gentry County",2,2,88,40,48
050,29,075,"Missouri","Gentry County",2,3,92,43,49
050,29,075,"Missouri","Gentry County",2,4,96,39,57
050,29,075,"Missouri","Gentry County",2,5,99,43,56
050,29,075,"Missouri","Gentry County",2,6,93,51,42
050,29,075,"Missouri","Gentry County",2,7,86,53,33
050,29,075,"Missouri","Gentry County",2,8,86,44,42
050,29,075,"Missouri","Gentry County",2,9,91,41,50
050,29,075,"Missouri","Gentry County",2,10,101,43,58
050,29,075,"Missouri","Gentry County",2,11,89,42,47
050,29,075,"Missouri","Gentry County",2,12,75,34,41
050,29,075,"Missouri","Gentry County",2,13,83,40,43
050,29,075,"Missouri","Gentry County",2,14,82,38,44
050,29,075,"Missouri","Gentry County",2,15,83,44,39
050,29,075,"Missouri","Gentry County",2,16,85,45,40
050,29,075,"Missouri","Gentry County",2,17,79,38,41
050,29,075,"Missouri","Gentry County",2,18,64,31,33
050,29,075,"Missouri","Gentry County",2,19,60,29,31
050,29,075,"Missouri","Gentry County",2,20,58,31,27
050,29,075,"Missouri","Gentry County",2,21,51,25,26
050,29,075,"Missouri","Gentry County",2,22,58,30,28
050,29,075,"Missouri","Gentry County",2,23,62,30,32
050,29,075,"Missouri","Gentry County",2,24,61,33,28
050,29,075,"Missouri","Gentry County",2,25,61,33,28
050,29,075,"Missouri","Gentry County",2,26,67,32,35
050,29,075,"Missouri","Gentry County",2,27,67,33,34
050,29,075,"Missouri","Gentry County",2,28,80,43,37
050,29,075,"Missouri","Gentry County",2,29,86,42,44
050,29,075,"Missouri","Gentry County",2,30,73,33,40
050,29,075,"Missouri","Gentry County",2,31,56,25,31
050,29,075,"Missouri","Gentry County",2,32,68,30,38
050,29,075,"Missouri","Gentry County",2,33,78,39,39
050,29,075,"Missouri","Gentry County",2,34,71,38,33
050,29,075,"Missouri","Gentry County",2,35,72,35,37
050,29,075,"Missouri","Gentry County",2,36,75,35,40
050,29,075,"Missouri","Gentry County",2,37,77,35,42
050,29,075,"Missouri","Gentry County",2,38,85,47,38
050,29,075,"Missouri","Gentry County",2,39,69,36,33
050,29,075,"Missouri","Gentry County",2,40,66,32,34
050,29,075,"Missouri","Gentry County",2,41,62,31,31
050,29,075,"Missouri","Gentry County",2,42,65,34,31
050,29,075,"Missouri","Gentry County",2,43,69,33,36
050,29,075,"Missouri","Gentry County",2,44,63,37,26
050,29,075,"Missouri","Gentry County",2,45,61,32,29
050,29,075,"Missouri","Gentry County",2,46,69,33,36
050,29,075,"Missouri","Gentry County",2,47,63,29,34
050,29,075,"Missouri","Gentry County",2,48,67,33,34
050,29,075,"Missouri","Gentry County",2,49,74,40,34
050,29,075,"Missouri","Gentry County",2,50,84,45,39
050,29,075,"Missouri","Gentry County",2,51,72,38,34
050,29,075,"Missouri","Gentry County",2,52,72,37,35
050,29,075,"Missouri","Gentry County",2,53,76,41,35
050,29,075,"Missouri","Gentry County",2,54,67,37,30
050,29,075,"Missouri","Gentry County",2,55,79,40,39
050,29,075,"Missouri","Gentry County",2,56,94,50,44
050,29,075,"Missouri","Gentry County",2,57,87,47,40
050,29,075,"Missouri","Gentry County",2,58,94,49,45
050,29,075,"Missouri","Gentry County",2,59,93,46,47
050,29,075,"Missouri","Gentry County",2,60,85,44,41
050,29,075,"Missouri","Gentry County",2,61,87,47,40
050,29,075,"Missouri","Gentry County",2,62,90,47,43
050,29,075,"Missouri","Gentry County",2,63,85,38,47
050,29,075,"Missouri","Gentry County",2,64,82,36,46
050,29,075,"Missouri","Gentry County",2,65,87,44,43
050,29,075,"Missouri","Gentry County",2,66,81,39,42
050,29,075,"Missouri","Gentry County",2,67,73,33,40
050,29,075,"Missouri","Gentry County",2,68,68,30,38
050,29,075,"Missouri","Gentry County",2,69,64,32,32
050,29,075,"Missouri","Gentry County",2,70,58,30,28
050,29,075,"Missouri","Gentry County",2,71,46,21,25
050,29,075,"Missouri","Gentry County",2,72,49,23,26
050,29,075,"Missouri","Gentry County",2,73,59,30,29
050,29,075,"Missouri","Gentry County",2,74,38,19,19
050,29,075,"Missouri","Gentry County",2,75,41,18,23
050,29,075,"Missouri","Gentry County",2,76,44,17,27
050,29,075,"Missouri","Gentry County",2,77,43,21,22
050,29,075,"Missouri","Gentry County",2,78,35,18,17
050,29,075,"Missouri","Gentry County",2,79,42,19,23
050,29,075,"Missouri","Gentry County",2,80,41,17,24
050,29,075,"Missouri","Gentry County",2,81,34,14,20
050,29,075,"Missouri","Gentry County",2,82,28,13,15
050,29,075,"Missouri","Gentry County",2,83,27,13,14
050,29,075,"Missouri","Gentry County",2,84,26,10,16
050,29,075,"Missouri","Gentry County",2,85,168,58,110
050,29,075,"Missouri","Gentry County",3,0,76,45,31
050,29,075,"Missouri","Gentry County",3,1,77,33,44
050,29,075,"Missouri","Gentry County",3,2,86,41,45
050,29,075,"Missouri","Gentry County",3,3,94,43,51
050,29,075,"Missouri","Gentry County",3,4,98,47,51
050,29,075,"Missouri","Gentry County",3,5,101,43,58
050,29,075,"Missouri","Gentry County",3,6,99,46,53
050,29,075,"Missouri","Gentry County",3,7,98,56,42
050,29,075,"Missouri","Gentry County",3,8,87,54,33
050,29,075,"Missouri","Gentry County",3,9,86,43,43
050,29,075,"Missouri","Gentry County",3,10,96,42,54
050,29,075,"Missouri","Gentry County",3,11,106,43,63
050,29,075,"Missouri","Gentry County",3,12,91,43,48
050,29,075,"Missouri","Gentry County",3,13,76,34,42
050,29,075,"Missouri","Gentry County",3,14,89,38,51
050,29,075,"Missouri","Gentry County",3,15,84,38,46
050,29,075,"Missouri","Gentry County",3,16,86,48,38
050,29,075,"Missouri","Gentry County",3,17,85,45,40
050,29,075,"Missouri","Gentry County",3,18,65,32,33
050,29,075,"Missouri","Gentry County",3,19,44,21,23
050,29,075,"Missouri","Gentry County",3,20,61,32,29
050,29,075,"Missouri","Gentry County",3,21,57,30,27
050,29,075,"Missouri","Gentry County",3,22,56,27,29
050,29,075,"Missouri","Gentry County",3,23,70,36,34
050,29,075,"Missouri","Gentry County",3,24,68,38,30
050,29,075,"Missouri","Gentry County",3,25,56,30,26
050,29,075,"Missouri","Gentry County",3,26,61,32,29
050,29,075,"Missouri","Gentry County",3,27,69,30,39
050,29,075,"Missouri","Gentry County",3,28,64,31,33
050,29,075,"Missouri","Gentry County",3,29,80,39,41
050,29,075,"Missouri","Gentry County",3,30,84,43,41
050,29,075,"Missouri","Gentry County",3,31,69,32,37
050,29,075,"Missouri","Gentry County",3,32,63,25,38
050,29,075,"Missouri","Gentry County",3,33,67,29,38
050,29,075,"Missouri","Gentry County",3,34,79,38,41
050,29,075,"Missouri","Gentry County",3,35,80,41,39
050,29,075,"Missouri","Gentry County",3,36,72,34,38
050,29,075,"Missouri","Gentry County",3,37,74,34,40
050,29,075,"Missouri","Gentry County",3,38,78,36,42
050,29,075,"Missouri","Gentry County",3,39,86,46,40
050,29,075,"Missouri","Gentry County",3,40,70,39,31
050,29,075,"Missouri","Gentry County",3,41,66,31,35
050,29,075,"Missouri","Gentry County",3,42,65,35,30
050,29,075,"Missouri","Gentry County",3,43,62,31,31
050,29,075,"Missouri","Gentry County",3,44,67,31,36
050,29,075,"Missouri","Gentry County",3,45,65,37,28
050,29,075,"Missouri","Gentry County",3,46,62,34,28
050,29,075,"Missouri","Gentry County",3,47,65,31,34
050,29,075,"Missouri","Gentry County",3,48,66,31,35
050,29,075,"Missouri","Gentry County",3,49,70,37,33
050,29,075,"Missouri","Gentry County",3,50,80,43,37
050,29,075,"Missouri","Gentry County",3,51,82,45,37
050,29,075,"Missouri","Gentry County",3,52,77,38,39
050,29,075,"Missouri","Gentry County",3,53,70,31,39
050,29,075,"Missouri","Gentry County",3,54,71,40,31
050,29,075,"Missouri","Gentry County",3,55,67,38,29
050,29,075,"Missouri","Gentry County",3,56,83,40,43
050,29,075,"Missouri","Gentry County",3,57,89,47,42
050,29,075,"Missouri","Gentry County",3,58,96,50,46
050,29,075,"Missouri","Gentry County",3,59,100,51,49
050,29,075,"Missouri","Gentry County",3,60,89,45,44
050,29,075,"Missouri","Gentry County",3,61,89,47,42
050,29,075,"Missouri","Gentry County",3,62,87,47,40
050,29,075,"Missouri","Gentry County",3,63,91,47,44
050,29,075,"Missouri","Gentry County",3,64,76,35,41
050,29,075,"Missouri","Gentry County",3,65,82,37,45
050,29,075,"Missouri","Gentry County",3,66,86,44,42
050,29,075,"Missouri","Gentry County",3,67,78,39,39
050,29,075,"Missouri","Gentry County",3,68,68,28,40
050,29,075,"Missouri","Gentry County",3,69,67,30,37
050,29,075,"Missouri","Gentry County",3,70,64,30,34
050,29,075,"Missouri","Gentry County",3,71,55,29,26
050,29,075,"Missouri","Gentry County",3,72,45,21,24
050,29,075,"Missouri","Gentry County",3,73,47,20,27
050,29,075,"Missouri","Gentry County",3,74,56,26,30
050,29,075,"Missouri","Gentry County",3,75,40,19,21
050,29,075,"Missouri","Gentry County",3,76,43,18,25
050,29,075,"Missouri","Gentry County",3,77,42,18,24
050,29,075,"Missouri","Gentry County",3,78,41,18,23
050,29,075,"Missouri","Gentry County",3,79,37,19,18
050,29,075,"Missouri","Gentry County",3,80,36,19,17
050,29,075,"Missouri","Gentry County",3,81,39,16,23
050,29,075,"Missouri","Gentry County",3,82,27,9,18
050,29,075,"Missouri","Gentry County",3,83,24,11,13
050,29,075,"Missouri","Gentry County",3,84,23,10,13
050,29,075,"Missouri","Gentry County",3,85,161,53,108
050,29,075,"Missouri","Gentry County",4,0,77,37,40
050,29,075,"Missouri","Gentry County",4,1,83,47,36
050,29,075,"Missouri","Gentry County",4,2,88,41,47
050,29,075,"Missouri","Gentry County",4,3,89,41,48
050,29,075,"Missouri","Gentry County",4,4,89,41,48
050,29,075,"Missouri","Gentry County",4,5,98,49,49
050,29,075,"Missouri","Gentry County",4,6,99,41,58
050,29,075,"Missouri","Gentry County",4,7,109,53,56
050,29,075,"Missouri","Gentry County",4,8,101,54,47
050,29,075,"Missouri","Gentry County",4,9,87,54,33
050,29,075,"Missouri","Gentry County",4,10,91,44,47
050,29,075,"Missouri","Gentry County",4,11,93,40,53
050,29,075,"Missouri","Gentry County",4,12,105,43,62
050,29,075,"Missouri","Gentry County",4,13,94,44,50
050,29,075,"Missouri","Gentry County",4,14,78,37,41
050,29,075,"Missouri","Gentry County",4,15,97,42,55
050,29,075,"Missouri","Gentry County",4,16,92,42,50
050,29,075,"Missouri","Gentry County",4,17,92,52,40
050,29,075,"Missouri","Gentry County",4,18,73,39,34
050,29,075,"Missouri","Gentry County",4,19,53,28,25
050,29,075,"Missouri","Gentry County",4,20,47,24,23
050,29,075,"Missouri","Gentry County",4,21,59,31,28
050,29,075,"Missouri","Gentry County",4,22,63,30,33
050,29,075,"Missouri","Gentry County",4,23,51,25,26
050,29,075,"Missouri","Gentry County",4,24,68,36,32
050,29,075,"Missouri","Gentry County",4,25,70,42,28
050,29,075,"Missouri","Gentry County",4,26,59,28,31
050,29,075,"Missouri","Gentry County",4,27,66,32,34
050,29,075,"Missouri","Gentry County",4,28,79,38,41
050,29,075,"Missouri","Gentry County",4,29,62,28,34
050,29,075,"Missouri","Gentry County",4,30,85,41,44
050,29,075,"Missouri","Gentry County",4,31,88,46,42
050,29,075,"Missouri","Gentry County",4,32,71,36,35
050,29,075,"Missouri","Gentry County",4,33,66,27,39
050,29,075,"Missouri","Gentry County",4,34,74,34,40
050,29,075,"Missouri","Gentry County",4,35,80,39,41
050,29,075,"Missouri","Gentry County",4,36,76,40,36
050,29,075,"Missouri","Gentry County",4,37,74,38,36
050,29,075,"Missouri","Gentry County",4,38,78,37,41
050,29,075,"Missouri","Gentry County",4,39,83,35,48
050,29,075,"Missouri","Gentry County",4,40,87,45,42
050,29,075,"Missouri","Gentry County",4,41,69,38,31
050,29,075,"Missouri","Gentry County",4,42,78,38,40
050,29,075,"Missouri","Gentry County",4,43,67,37,30
050,29,075,"Missouri","Gentry County",4,44,62,30,32
050,29,075,"Missouri","Gentry County",4,45,67,31,36
050,29,075,"Missouri","Gentry County",4,46,71,41,30
050,29,075,"Missouri","Gentry County",4,47,64,34,30
050,29,075,"Missouri","Gentry County",4,48,68,34,34
050,29,075,"Missouri","Gentry County",4,49,62,27,35
050,29,075,"Missouri","Gentry County",4,50,71,37,34
050,29,075,"Missouri","Gentry County",4,51,82,44,38
050,29,075,"Missouri","Gentry County",4,52,86,45,41
050,29,075,"Missouri","Gentry County",4,53,76,33,43
050,29,075,"Missouri","Gentry County",4,54,62,31,31
050,29,075,"Missouri","Gentry County",4,55,68,40,28
050,29,075,"Missouri","Gentry County",4,56,72,42,30
050,29,075,"Missouri","Gentry County",4,57,79,37,42
050,29,075,"Missouri","Gentry County",4,58,92,48,44
050,29,075,"Missouri","Gentry County",4,59,95,49,46
050,29,075,"Missouri","Gentry County",4,60,94,46,48
050,29,075,"Missouri","Gentry County",4,61,91,47,44
050,29,075,"Missouri","Gentry County",4,62,89,43,46
050,29,075,"Missouri","Gentry County",4,63,88,47,41
050,29,075,"Missouri","Gentry County",4,64,88,48,40
050,29,075,"Missouri","Gentry County",4,65,73,34,39
050,29,075,"Missouri","Gentry County",4,66,87,42,45
050,29,075,"Missouri","Gentry County",4,67,84,43,41
050,29,075,"Missouri","Gentry County",4,68,78,39,39
050,29,075,"Missouri","Gentry County",4,69,65,27,38
050,29,075,"Missouri","Gentry County",4,70,65,29,36
050,29,075,"Missouri","Gentry County",4,71,62,29,33
050,29,075,"Missouri","Gentry County",4,72,55,28,27
050,29,075,"Missouri","Gentry County",4,73,46,22,24
050,29,075,"Missouri","Gentry County",4,74,47,21,26
050,29,075,"Missouri","Gentry County",4,75,52,23,29
050,29,075,"Missouri","Gentry County",4,76,40,18,22
050,29,075,"Missouri","Gentry County",4,77,39,18,21
050,29,075,"Missouri","Gentry County",4,78,41,16,25
050,29,075,"Missouri","Gentry County",4,79,43,18,25
050,29,075,"Missouri","Gentry County",4,80,28,18,10
050,29,075,"Missouri","Gentry County",4,81,34,18,16
050,29,075,"Missouri","Gentry County",4,82,33,14,19
050,29,075,"Missouri","Gentry County",4,83,24,7,17
050,29,075,"Missouri","Gentry County",4,84,18,6,12
050,29,075,"Missouri","Gentry County",4,85,145,46,99
050,29,075,"Missouri","Gentry County",5,0,77,36,41
050,29,075,"Missouri","Gentry County",5,1,79,39,40
050,29,075,"Missouri","Gentry County",5,2,84,46,38
050,29,075,"Missouri","Gentry County",5,3,86,41,45
050,29,075,"Missouri","Gentry County",5,4,92,44,48
050,29,075,"Missouri","Gentry County",5,5,87,40,47
050,29,075,"Missouri","Gentry County",5,6,98,48,50
050,29,075,"Missouri","Gentry County",5,7,98,45,53
050,29,075,"Missouri","Gentry County",5,8,108,54,54
050,29,075,"Missouri","Gentry County",5,9,106,57,49
050,29,075,"Missouri","Gentry County",5,10,86,52,34
050,29,075,"Missouri","Gentry County",5,11,97,47,50
050,29,075,"Missouri","Gentry County",5,12,93,41,52
050,29,075,"Missouri","Gentry County",5,13,112,47,65
050,29,075,"Missouri","Gentry County",5,14,87,42,45
050,29,075,"Missouri","Gentry County",5,15,76,34,42
050,29,075,"Missouri","Gentry County",5,16,95,42,53
050,29,075,"Missouri","Gentry County",5,17,91,41,50
050,29,075,"Missouri","Gentry County",5,18,79,46,33
050,29,075,"Missouri","Gentry County",5,19,54,29,25
050,29,075,"Missouri","Gentry County",5,20,55,31,24
050,29,075,"Missouri","Gentry County",5,21,47,23,24
050,29,075,"Missouri","Gentry County",5,22,61,32,29
050,29,075,"Missouri","Gentry County",5,23,64,30,34
050,29,075,"Missouri","Gentry County",5,24,53,25,28
050,29,075,"Missouri","Gentry County",5,25,72,40,32
050,29,075,"Missouri","Gentry County",5,26,62,39,23
050,29,075,"Missouri","Gentry County",5,27,65,32,33
050,29,075,"Missouri","Gentry County",5,28,65,31,34
050,29,075,"Missouri","Gentry County",5,29,73,30,43
050,29,075,"Missouri","Gentry County",5,30,62,28,34
050,29,075,"Missouri","Gentry County",5,31,83,41,42
050,29,075,"Missouri","Gentry County",5,32,90,43,47
050,29,075,"Missouri","Gentry County",5,33,81,42,39
050,29,075,"Missouri","Gentry County",5,34,68,31,37
050,29,075,"Missouri","Gentry County",5,35,72,33,39
050,29,075,"Missouri","Gentry County",5,36,80,38,42
050,29,075,"Missouri","Gentry County",5,37,80,44,36
050,29,075,"Missouri","Gentry County",5,38,77,41,36
050,29,075,"Missouri","Gentry County",5,39,76,34,42
050,29,075,"Missouri","Gentry County",5,40,82,33,49
050,29,075,"Missouri","Gentry County",5,41,87,48,39
050,29,075,"Missouri","Gentry County",5,42,72,42,30
050,29,075,"Missouri","Gentry County",5,43,76,36,40
050,29,075,"Missouri","Gentry County",5,44,68,37,31
050,29,075,"Missouri","Gentry County",5,45,64,30,34
050,29,075,"Missouri","Gentry County",5,46,69,33,36
050,29,075,"Missouri","Gentry County",5,47,72,42,30
050,29,075,"Missouri","Gentry County",5,48,63,36,27
050,29,075,"Missouri","Gentry County",5,49,67,33,34
050,29,075,"Missouri","Gentry County",5,50,62,28,34
050,29,075,"Missouri","Gentry County",5,51,72,38,34
050,29,075,"Missouri","Gentry County",5,52,80,41,39
050,29,075,"Missouri","Gentry County",5,53,87,42,45
050,29,075,"Missouri","Gentry County",5,54,71,34,37
050,29,075,"Missouri","Gentry County",5,55,63,32,31
050,29,075,"Missouri","Gentry County",5,56,72,42,30
050,29,075,"Missouri","Gentry County",5,57,68,39,29
050,29,075,"Missouri","Gentry County",5,58,88,40,48
050,29,075,"Missouri","Gentry County",5,59,97,50,47
050,29,075,"Missouri","Gentry County",5,60,93,48,45
050,29,075,"Missouri","Gentry County",5,61,98,47,51
050,29,075,"Missouri","Gentry County",5,62,90,43,47
050,29,075,"Missouri","Gentry County",5,63,93,45,48
050,29,075,"Missouri","Gentry County",5,64,89,48,41
050,29,075,"Missouri","Gentry County",5,65,86,46,40
050,29,075,"Missouri","Gentry County",5,66,72,34,38
050,29,075,"Missouri","Gentry County",5,67,84,41,43
050,29,075,"Missouri","Gentry County",5,68,84,44,40
050,29,075,"Missouri","Gentry County",5,69,79,40,39
050,29,075,"Missouri","Gentry County",5,70,63,23,40
050,29,075,"Missouri","Gentry County",5,71,61,28,33
050,29,075,"Missouri","Gentry County",5,72,58,28,30
050,29,075,"Missouri","Gentry County",5,73,57,28,29
050,29,075,"Missouri","Gentry County",5,74,41,18,23
050,29,075,"Missouri","Gentry County",5,75,43,18,25
050,29,075,"Missouri","Gentry County",5,76,51,21,30
050,29,075,"Missouri","Gentry County",5,77,35,16,19
050,29,075,"Missouri","Gentry County",5,78,35,15,20
050,29,075,"Missouri","Gentry County",5,79,45,17,28
050,29,075,"Missouri","Gentry County",5,80,37,17,20
050,29,075,"Missouri","Gentry County",5,81,27,18,9
050,29,075,"Missouri","Gentry County",5,82,26,15,11
050,29,075,"Missouri","Gentry County",5,83,32,14,18
050,29,075,"Missouri","Gentry County",5,84,21,4,17
050,29,075,"Missouri","Gentry County",5,85,136,41,95
050,29,077,"Missouri","Greene County",1,0,3410,1752,1658
050,29,077,"Missouri","Greene County",1,1,3350,1718,1632
050,29,077,"Missouri","Greene County",1,2,3404,1770,1634
050,29,077,"Missouri","Greene County",1,3,3594,1882,1712
050,29,077,"Missouri","Greene County",1,4,3704,1940,1764
050,29,077,"Missouri","Greene County",1,5,3547,1843,1704
050,29,077,"Missouri","Greene County",1,6,3442,1747,1695
050,29,077,"Missouri","Greene County",1,7,3484,1744,1740
050,29,077,"Missouri","Greene County",1,8,3413,1743,1670
050,29,077,"Missouri","Greene County",1,9,3413,1792,1621
050,29,077,"Missouri","Greene County",1,10,3496,1812,1684
050,29,077,"Missouri","Greene County",1,11,3635,1844,1791
050,29,077,"Missouri","Greene County",1,12,3753,1931,1822
050,29,077,"Missouri","Greene County",1,13,3608,1857,1751
050,29,077,"Missouri","Greene County",1,14,3580,1844,1736
050,29,077,"Missouri","Greene County",1,15,3540,1829,1711
050,29,077,"Missouri","Greene County",1,16,3523,1796,1727
050,29,077,"Missouri","Greene County",1,17,3404,1763,1641
050,29,077,"Missouri","Greene County",1,18,3666,1822,1844
050,29,077,"Missouri","Greene County",1,19,5185,2407,2778
050,29,077,"Missouri","Greene County",1,20,6033,2846,3187
050,29,077,"Missouri","Greene County",1,21,6613,3285,3328
050,29,077,"Missouri","Greene County",1,22,6378,3089,3289
050,29,077,"Missouri","Greene County",1,23,5818,2898,2920
050,29,077,"Missouri","Greene County",1,24,5388,2660,2728
050,29,077,"Missouri","Greene County",1,25,4899,2441,2458
050,29,077,"Missouri","Greene County",1,26,4471,2245,2226
050,29,077,"Missouri","Greene County",1,27,4359,2231,2128
050,29,077,"Missouri","Greene County",1,28,4495,2268,2227
050,29,077,"Missouri","Greene County",1,29,4291,2131,2160
050,29,077,"Missouri","Greene County",1,30,3999,2026,1973
050,29,077,"Missouri","Greene County",1,31,3834,1923,1911
050,29,077,"Missouri","Greene County",1,32,3760,1899,1861
050,29,077,"Missouri","Greene County",1,33,3855,1931,1924
050,29,077,"Missouri","Greene County",1,34,3926,1958,1968
050,29,077,"Missouri","Greene County",1,35,3857,1973,1884
050,29,077,"Missouri","Greene County",1,36,3752,1925,1827
050,29,077,"Missouri","Greene County",1,37,3777,1930,1847
050,29,077,"Missouri","Greene County",1,38,3926,2018,1908
050,29,077,"Missouri","Greene County",1,39,3914,2019,1895
050,29,077,"Missouri","Greene County",1,40,3751,1925,1826
050,29,077,"Missouri","Greene County",1,41,3487,1770,1717
050,29,077,"Missouri","Greene County",1,42,3496,1779,1717
050,29,077,"Missouri","Greene County",1,43,3321,1682,1639
050,29,077,"Missouri","Greene County",1,44,3199,1621,1578
050,29,077,"Missouri","Greene County",1,45,3194,1579,1615
050,29,077,"Missouri","Greene County",1,46,3114,1570,1544
050,29,077,"Missouri","Greene County",1,47,3219,1605,1614
050,29,077,"Missouri","Greene County",1,48,3494,1792,1702
050,29,077,"Missouri","Greene County",1,49,3630,1838,1792
050,29,077,"Missouri","Greene County",1,50,3407,1692,1715
050,29,077,"Missouri","Greene County",1,51,3272,1637,1635
050,29,077,"Missouri","Greene County",1,52,3283,1646,1637
050,29,077,"Missouri","Greene County",1,53,3308,1626,1682
050,29,077,"Missouri","Greene County",1,54,3264,1612,1652
050,29,077,"Missouri","Greene County",1,55,3424,1648,1776
050,29,077,"Missouri","Greene County",1,56,3593,1722,1871
050,29,077,"Missouri","Greene County",1,57,3721,1801,1920
050,29,077,"Missouri","Greene County",1,58,3746,1831,1915
050,29,077,"Missouri","Greene County",1,59,3666,1764,1902
050,29,077,"Missouri","Greene County",1,60,3628,1709,1919
050,29,077,"Missouri","Greene County",1,61,3526,1686,1840
050,29,077,"Missouri","Greene County",1,62,3539,1729,1810
050,29,077,"Missouri","Greene County",1,63,3423,1649,1774
050,29,077,"Missouri","Greene County",1,64,3335,1556,1779
050,29,077,"Missouri","Greene County",1,65,3262,1529,1733
050,29,077,"Missouri","Greene County",1,66,3223,1533,1690
050,29,077,"Missouri","Greene County",1,67,3110,1416,1694
050,29,077,"Missouri","Greene County",1,68,3085,1355,1730
050,29,077,"Missouri","Greene County",1,69,2823,1210,1613
050,29,077,"Missouri","Greene County",1,70,2756,1268,1488
050,29,077,"Missouri","Greene County",1,71,2697,1253,1444
050,29,077,"Missouri","Greene County",1,72,2705,1222,1483
050,29,077,"Missouri","Greene County",1,73,2738,1265,1473
050,29,077,"Missouri","Greene County",1,74,1935,853,1082
050,29,077,"Missouri","Greene County",1,75,1965,879,1086
050,29,077,"Missouri","Greene County",1,76,2017,905,1112
050,29,077,"Missouri","Greene County",1,77,1925,824,1101
050,29,077,"Missouri","Greene County",1,78,1649,691,958
050,29,077,"Missouri","Greene County",1,79,1458,609,849
050,29,077,"Missouri","Greene County",1,80,1353,545,808
050,29,077,"Missouri","Greene County",1,81,1282,517,765
050,29,077,"Missouri","Greene County",1,82,1210,483,727
050,29,077,"Missouri","Greene County",1,83,1044,429,615
050,29,077,"Missouri","Greene County",1,84,990,396,594
050,29,077,"Missouri","Greene County",1,85,6150,2098,4052
050,29,077,"Missouri","Greene County",2,0,3335,1723,1612
050,29,077,"Missouri","Greene County",2,1,3350,1719,1631
050,29,077,"Missouri","Greene County",2,2,3390,1757,1633
050,29,077,"Missouri","Greene County",2,3,3541,1855,1686
050,29,077,"Missouri","Greene County",2,4,3676,1930,1746
050,29,077,"Missouri","Greene County",2,5,3573,1867,1706
050,29,077,"Missouri","Greene County",2,6,3472,1776,1696
050,29,077,"Missouri","Greene County",2,7,3462,1737,1725
050,29,077,"Missouri","Greene County",2,8,3420,1741,1679
050,29,077,"Missouri","Greene County",2,9,3405,1775,1630
050,29,077,"Missouri","Greene County",2,10,3469,1804,1665
050,29,077,"Missouri","Greene County",2,11,3580,1825,1755
050,29,077,"Missouri","Greene County",2,12,3742,1918,1824
050,29,077,"Missouri","Greene County",2,13,3639,1875,1764
050,29,077,"Missouri","Greene County",2,14,3587,1849,1738
050,29,077,"Missouri","Greene County",2,15,3553,1833,1720
050,29,077,"Missouri","Greene County",2,16,3539,1811,1728
050,29,077,"Missouri","Greene County",2,17,3443,1775,1668
050,29,077,"Missouri","Greene County",2,18,3701,1827,1874
050,29,077,"Missouri","Greene County",2,19,5159,2419,2740
050,29,077,"Missouri","Greene County",2,20,6084,2871,3213
050,29,077,"Missouri","Greene County",2,21,6599,3261,3338
050,29,077,"Missouri","Greene County",2,22,6381,3103,3278
050,29,077,"Missouri","Greene County",2,23,5813,2893,2920
050,29,077,"Missouri","Greene County",2,24,5348,2631,2717
050,29,077,"Missouri","Greene County",2,25,4933,2459,2474
050,29,077,"Missouri","Greene County",2,26,4499,2262,2237
050,29,077,"Missouri","Greene County",2,27,4326,2204,2122
050,29,077,"Missouri","Greene County",2,28,4437,2245,2192
050,29,077,"Missouri","Greene County",2,29,4308,2149,2159
050,29,077,"Missouri","Greene County",2,30,4084,2055,2029
050,29,077,"Missouri","Greene County",2,31,3851,1944,1907
050,29,077,"Missouri","Greene County",2,32,3775,1904,1871
050,29,077,"Missouri","Greene County",2,33,3827,1919,1908
050,29,077,"Missouri","Greene County",2,34,3905,1949,1956
050,29,077,"Missouri","Greene County",2,35,3882,1973,1909
050,29,077,"Missouri","Greene County",2,36,3746,1922,1824
050,29,077,"Missouri","Greene County",2,37,3781,1935,1846
050,29,077,"Missouri","Greene County",2,38,3900,1999,1901
050,29,077,"Missouri","Greene County",2,39,3907,2013,1894
050,29,077,"Missouri","Greene County",2,40,3812,1960,1852
050,29,077,"Missouri","Greene County",2,41,3551,1808,1743
050,29,077,"Missouri","Greene County",2,42,3483,1776,1707
050,29,077,"Missouri","Greene County",2,43,3381,1711,1670
050,29,077,"Missouri","Greene County",2,44,3195,1616,1579
050,29,077,"Missouri","Greene County",2,45,3212,1595,1617
050,29,077,"Missouri","Greene County",2,46,3126,1564,1562
050,29,077,"Missouri","Greene County",2,47,3180,1587,1593
050,29,077,"Missouri","Greene County",2,48,3428,1747,1681
050,29,077,"Missouri","Greene County",2,49,3617,1842,1775
050,29,077,"Missouri","Greene County",2,50,3468,1727,1741
050,29,077,"Missouri","Greene County",2,51,3301,1649,1652
050,29,077,"Missouri","Greene County",2,52,3264,1635,1629
050,29,077,"Missouri","Greene County",2,53,3287,1621,1666
050,29,077,"Missouri","Greene County",2,54,3266,1616,1650
050,29,077,"Missouri","Greene County",2,55,3375,1628,1747
050,29,077,"Missouri","Greene County",2,56,3563,1705,1858
050,29,077,"Missouri","Greene County",2,57,3700,1794,1906
050,29,077,"Missouri","Greene County",2,58,3737,1817,1920
050,29,077,"Missouri","Greene County",2,59,3702,1791,1911
050,29,077,"Missouri","Greene County",2,60,3622,1715,1907
050,29,077,"Missouri","Greene County",2,61,3536,1681,1855
050,29,077,"Missouri","Greene County",2,62,3540,1719,1821
050,29,077,"Missouri","Greene County",2,63,3477,1678,1799
050,29,077,"Missouri","Greene County",2,64,3333,1569,1764
050,29,077,"Missouri","Greene County",2,65,3274,1526,1748
050,29,077,"Missouri","Greene County",2,66,3243,1531,1712
050,29,077,"Missouri","Greene County",2,67,3135,1443,1692
050,29,077,"Missouri","Greene County",2,68,3062,1360,1702
050,29,077,"Missouri","Greene County",2,69,2896,1247,1649
050,29,077,"Missouri","Greene County",2,70,2756,1247,1509
050,29,077,"Missouri","Greene County",2,71,2711,1253,1458
050,29,077,"Missouri","Greene County",2,72,2647,1204,1443
050,29,077,"Missouri","Greene County",2,73,2858,1307,1551
050,29,077,"Missouri","Greene County",2,74,1983,878,1105
050,29,077,"Missouri","Greene County",2,75,1963,877,1086
050,29,077,"Missouri","Greene County",2,76,1982,894,1088
050,29,077,"Missouri","Greene County",2,77,1977,857,1120
050,29,077,"Missouri","Greene County",2,78,1671,702,969
050,29,077,"Missouri","Greene County",2,79,1481,615,866
050,29,077,"Missouri","Greene County",2,80,1363,553,810
050,29,077,"Missouri","Greene County",2,81,1284,520,764
050,29,077,"Missouri","Greene County",2,82,1219,482,737
050,29,077,"Missouri","Greene County",2,83,1071,438,633
050,29,077,"Missouri","Greene County",2,84,983,388,595
050,29,077,"Missouri","Greene County",2,85,6191,2129,4062
050,29,077,"Missouri","Greene County",3,0,3206,1690,1516
050,29,077,"Missouri","Greene County",3,1,3267,1742,1525
050,29,077,"Missouri","Greene County",3,2,3335,1685,1650
050,29,077,"Missouri","Greene County",3,3,3368,1748,1620
050,29,077,"Missouri","Greene County",3,4,3528,1832,1696
050,29,077,"Missouri","Greene County",3,5,3678,1910,1768
050,29,077,"Missouri","Greene County",3,6,3569,1830,1739
050,29,077,"Missouri","Greene County",3,7,3481,1770,1711
050,29,077,"Missouri","Greene County",3,8,3455,1749,1706
050,29,077,"Missouri","Greene County",3,9,3472,1787,1685
050,29,077,"Missouri","Greene County",3,10,3446,1803,1643
050,29,077,"Missouri","Greene County",3,11,3501,1822,1679
050,29,077,"Missouri","Greene County",3,12,3622,1858,1764
050,29,077,"Missouri","Greene County",3,13,3794,1947,1847
050,29,077,"Missouri","Greene County",3,14,3641,1890,1751
050,29,077,"Missouri","Greene County",3,15,3604,1857,1747
050,29,077,"Missouri","Greene County",3,16,3618,1863,1755
050,29,077,"Missouri","Greene County",3,17,3548,1805,1743
050,29,077,"Missouri","Greene County",3,18,3802,1861,1941
050,29,077,"Missouri","Greene County",3,19,5150,2462,2688
050,29,077,"Missouri","Greene County",3,20,6029,2854,3175
050,29,077,"Missouri","Greene County",3,21,6672,3272,3400
050,29,077,"Missouri","Greene County",3,22,6440,3181,3259
050,29,077,"Missouri","Greene County",3,23,5890,2931,2959
050,29,077,"Missouri","Greene County",3,24,5434,2639,2795
050,29,077,"Missouri","Greene County",3,25,4958,2457,2501
050,29,077,"Missouri","Greene County",3,26,4603,2345,2258
050,29,077,"Missouri","Greene County",3,27,4292,2170,2122
050,29,077,"Missouri","Greene County",3,28,4244,2145,2099
050,29,077,"Missouri","Greene County",3,29,4320,2186,2134
050,29,077,"Missouri","Greene County",3,30,4266,2127,2139
050,29,077,"Missouri","Greene County",3,31,4071,2083,1988
050,29,077,"Missouri","Greene County",3,32,3836,1964,1872
050,29,077,"Missouri","Greene County",3,33,3758,1908,1850
050,29,077,"Missouri","Greene County",3,34,3809,1899,1910
050,29,077,"Missouri","Greene County",3,35,3922,1958,1964
050,29,077,"Missouri","Greene County",3,36,3874,1984,1890
050,29,077,"Missouri","Greene County",3,37,3757,1927,1830
050,29,077,"Missouri","Greene County",3,38,3785,1917,1868
050,29,077,"Missouri","Greene County",3,39,3891,1991,1900
050,29,077,"Missouri","Greene County",3,40,3874,2010,1864
050,29,077,"Missouri","Greene County",3,41,3837,1965,1872
050,29,077,"Missouri","Greene County",3,42,3518,1796,1722
050,29,077,"Missouri","Greene County",3,43,3505,1765,1740
050,29,077,"Missouri","Greene County",3,44,3403,1726,1677
050,29,077,"Missouri","Greene County",3,45,3225,1625,1600
050,29,077,"Missouri","Greene County",3,46,3220,1586,1634
050,29,077,"Missouri","Greene County",3,47,3143,1563,1580
050,29,077,"Missouri","Greene County",3,48,3203,1606,1597
050,29,077,"Missouri","Greene County",3,49,3419,1723,1696
050,29,077,"Missouri","Greene County",3,50,3597,1810,1787
050,29,077,"Missouri","Greene County",3,51,3445,1731,1714
050,29,077,"Missouri","Greene County",3,52,3323,1665,1658
050,29,077,"Missouri","Greene County",3,53,3233,1603,1630
050,29,077,"Missouri","Greene County",3,54,3247,1593,1654
050,29,077,"Missouri","Greene County",3,55,3204,1574,1630
050,29,077,"Missouri","Greene County",3,56,3363,1619,1744
050,29,077,"Missouri","Greene County",3,57,3589,1731,1858
050,29,077,"Missouri","Greene County",3,58,3701,1779,1922
050,29,077,"Missouri","Greene County",3,59,3683,1783,1900
050,29,077,"Missouri","Greene County",3,60,3633,1742,1891
050,29,077,"Missouri","Greene County",3,61,3609,1693,1916
050,29,077,"Missouri","Greene County",3,62,3536,1675,1861
050,29,077,"Missouri","Greene County",3,63,3528,1690,1838
050,29,077,"Missouri","Greene County",3,64,3449,1658,1791
050,29,077,"Missouri","Greene County",3,65,3301,1552,1749
050,29,077,"Missouri","Greene County",3,66,3234,1504,1730
050,29,077,"Missouri","Greene County",3,67,3167,1497,1670
050,29,077,"Missouri","Greene County",3,68,3059,1397,1662
050,29,077,"Missouri","Greene County",3,69,3026,1328,1698
050,29,077,"Missouri","Greene County",3,70,2856,1227,1629
050,29,077,"Missouri","Greene County",3,71,2680,1195,1485
050,29,077,"Missouri","Greene County",3,72,2655,1224,1431
050,29,077,"Missouri","Greene County",3,73,2583,1169,1414
050,29,077,"Missouri","Greene County",3,74,2778,1267,1511
050,29,077,"Missouri","Greene County",3,75,1947,857,1090
050,29,077,"Missouri","Greene County",3,76,1912,859,1053
050,29,077,"Missouri","Greene County",3,77,1889,830,1059
050,29,077,"Missouri","Greene County",3,78,1880,801,1079
050,29,077,"Missouri","Greene County",3,79,1608,683,925
050,29,077,"Missouri","Greene County",3,80,1404,573,831
050,29,077,"Missouri","Greene County",3,81,1291,514,777
050,29,077,"Missouri","Greene County",3,82,1195,480,715
050,29,077,"Missouri","Greene County",3,83,1121,444,677
050,29,077,"Missouri","Greene County",3,84,992,380,612
050,29,077,"Missouri","Greene County",3,85,6097,2085,4012
050,29,077,"Missouri","Greene County",4,0,3267,1702,1565
050,29,077,"Missouri","Greene County",4,1,3149,1673,1476
050,29,077,"Missouri","Greene County",4,2,3277,1750,1527
050,29,077,"Missouri","Greene County",4,3,3346,1702,1644
050,29,077,"Missouri","Greene County",4,4,3367,1724,1643
050,29,077,"Missouri","Greene County",4,5,3562,1853,1709
050,29,077,"Missouri","Greene County",4,6,3614,1877,1737
050,29,077,"Missouri","Greene County",4,7,3552,1801,1751
050,29,077,"Missouri","Greene County",4,8,3491,1788,1703
050,29,077,"Missouri","Greene County",4,9,3502,1783,1719
050,29,077,"Missouri","Greene County",4,10,3488,1795,1693
050,29,077,"Missouri","Greene County",4,11,3497,1830,1667
050,29,077,"Missouri","Greene County",4,12,3528,1839,1689
050,29,077,"Missouri","Greene County",4,13,3672,1860,1812
050,29,077,"Missouri","Greene County",4,14,3804,1940,1864
050,29,077,"Missouri","Greene County",4,15,3679,1906,1773
050,29,077,"Missouri","Greene County",4,16,3694,1919,1775
050,29,077,"Missouri","Greene County",4,17,3649,1881,1768
050,29,077,"Missouri","Greene County",4,18,3848,1894,1954
050,29,077,"Missouri","Greene County",4,19,5117,2436,2681
050,29,077,"Missouri","Greene County",4,20,5978,2837,3141
050,29,077,"Missouri","Greene County",4,21,6647,3264,3383
050,29,077,"Missouri","Greene County",4,22,6502,3170,3332
050,29,077,"Missouri","Greene County",4,23,5945,3031,2914
050,29,077,"Missouri","Greene County",4,24,5338,2642,2696
050,29,077,"Missouri","Greene County",4,25,4956,2389,2567
050,29,077,"Missouri","Greene County",4,26,4668,2373,2295
050,29,077,"Missouri","Greene County",4,27,4461,2288,2173
050,29,077,"Missouri","Greene County",4,28,4243,2137,2106
050,29,077,"Missouri","Greene County",4,29,4232,2145,2087
050,29,077,"Missouri","Greene County",4,30,4328,2207,2121
050,29,077,"Missouri","Greene County",4,31,4248,2110,2138
050,29,077,"Missouri","Greene County",4,32,4098,2103,1995
050,29,077,"Missouri","Greene County",4,33,3790,1941,1849
050,29,077,"Missouri","Greene County",4,34,3763,1869,1894
050,29,077,"Missouri","Greene County",4,35,3792,1888,1904
050,29,077,"Missouri","Greene County",4,36,3878,1925,1953
050,29,077,"Missouri","Greene County",4,37,3892,1969,1923
050,29,077,"Missouri","Greene County",4,38,3805,1944,1861
050,29,077,"Missouri","Greene County",4,39,3772,1914,1858
050,29,077,"Missouri","Greene County",4,40,3896,2009,1887
050,29,077,"Missouri","Greene County",4,41,3896,2006,1890
050,29,077,"Missouri","Greene County",4,42,3871,1971,1900
050,29,077,"Missouri","Greene County",4,43,3519,1769,1750
050,29,077,"Missouri","Greene County",4,44,3505,1758,1747
050,29,077,"Missouri","Greene County",4,45,3405,1738,1667
050,29,077,"Missouri","Greene County",4,46,3238,1621,1617
050,29,077,"Missouri","Greene County",4,47,3239,1588,1651
050,29,077,"Missouri","Greene County",4,48,3194,1599,1595
050,29,077,"Missouri","Greene County",4,49,3162,1579,1583
050,29,077,"Missouri","Greene County",4,50,3429,1708,1721
050,29,077,"Missouri","Greene County",4,51,3617,1818,1799
050,29,077,"Missouri","Greene County",4,52,3501,1765,1736
050,29,077,"Missouri","Greene County",4,53,3315,1644,1671
050,29,077,"Missouri","Greene County",4,54,3244,1603,1641
050,29,077,"Missouri","Greene County",4,55,3193,1566,1627
050,29,077,"Missouri","Greene County",4,56,3199,1565,1634
050,29,077,"Missouri","Greene County",4,57,3383,1644,1739
050,29,077,"Missouri","Greene County",4,58,3572,1709,1863
050,29,077,"Missouri","Greene County",4,59,3643,1742,1901
050,29,077,"Missouri","Greene County",4,60,3716,1806,1910
050,29,077,"Missouri","Greene County",4,61,3651,1743,1908
050,29,077,"Missouri","Greene County",4,62,3582,1662,1920
050,29,077,"Missouri","Greene County",4,63,3490,1632,1858
050,29,077,"Missouri","Greene County",4,64,3468,1642,1826
050,29,077,"Missouri","Greene County",4,65,3382,1613,1769
050,29,077,"Missouri","Greene County",4,66,3311,1561,1750
050,29,077,"Missouri","Greene County",4,67,3196,1470,1726
050,29,077,"Missouri","Greene County",4,68,3111,1466,1645
050,29,077,"Missouri","Greene County",4,69,2988,1352,1636
050,29,077,"Missouri","Greene County",4,70,2966,1296,1670
050,29,077,"Missouri","Greene County",4,71,2805,1205,1600
050,29,077,"Missouri","Greene County",4,72,2625,1163,1462
050,29,077,"Missouri","Greene County",4,73,2622,1204,1418
050,29,077,"Missouri","Greene County",4,74,2495,1110,1385
050,29,077,"Missouri","Greene County",4,75,2713,1231,1482
050,29,077,"Missouri","Greene County",4,76,1903,826,1077
050,29,077,"Missouri","Greene County",4,77,1845,816,1029
050,29,077,"Missouri","Greene County",4,78,1799,782,1017
050,29,077,"Missouri","Greene County",4,79,1819,781,1038
050,29,077,"Missouri","Greene County",4,80,1533,649,884
050,29,077,"Missouri","Greene County",4,81,1349,536,813
050,29,077,"Missouri","Greene County",4,82,1223,491,732
050,29,077,"Missouri","Greene County",4,83,1094,433,661
050,29,077,"Missouri","Greene County",4,84,1040,393,647
050,29,077,"Missouri","Greene County",4,85,6011,2038,3973
050,29,077,"Missouri","Greene County",5,0,3265,1705,1560
050,29,077,"Missouri","Greene County",5,1,3209,1671,1538
050,29,077,"Missouri","Greene County",5,2,3182,1701,1481
050,29,077,"Missouri","Greene County",5,3,3261,1700,1561
050,29,077,"Missouri","Greene County",5,4,3381,1717,1664
050,29,077,"Missouri","Greene County",5,5,3371,1745,1626
050,29,077,"Missouri","Greene County",5,6,3515,1847,1668
050,29,077,"Missouri","Greene County",5,7,3648,1901,1747
050,29,077,"Missouri","Greene County",5,8,3542,1817,1725
050,29,077,"Missouri","Greene County",5,9,3524,1828,1696
050,29,077,"Missouri","Greene County",5,10,3539,1805,1734
050,29,077,"Missouri","Greene County",5,11,3504,1822,1682
050,29,077,"Missouri","Greene County",5,12,3500,1826,1674
050,29,077,"Missouri","Greene County",5,13,3545,1854,1691
050,29,077,"Missouri","Greene County",5,14,3723,1898,1825
050,29,077,"Missouri","Greene County",5,15,3814,1947,1867
050,29,077,"Missouri","Greene County",5,16,3734,1919,1815
050,29,077,"Missouri","Greene County",5,17,3695,1938,1757
050,29,077,"Missouri","Greene County",5,18,3903,1935,1968
050,29,077,"Missouri","Greene County",5,19,5173,2480,2693
050,29,077,"Missouri","Greene County",5,20,5996,2890,3106
050,29,077,"Missouri","Greene County",5,21,6549,3224,3325
050,29,077,"Missouri","Greene County",5,22,6435,3162,3273
050,29,077,"Missouri","Greene County",5,23,5919,2966,2953
050,29,077,"Missouri","Greene County",5,24,5410,2713,2697
050,29,077,"Missouri","Greene County",5,25,4997,2486,2511
050,29,077,"Missouri","Greene County",5,26,4580,2229,2351
050,29,077,"Missouri","Greene County",5,27,4430,2274,2156
050,29,077,"Missouri","Greene County",5,28,4411,2269,2142
050,29,077,"Missouri","Greene County",5,29,4137,2089,2048
050,29,077,"Missouri","Greene County",5,30,4140,2117,2023
050,29,077,"Missouri","Greene County",5,31,4323,2213,2110
050,29,077,"Missouri","Greene County",5,32,4259,2138,2121
050,29,077,"Missouri","Greene County",5,33,4122,2116,2006
050,29,077,"Missouri","Greene County",5,34,3801,1923,1878
050,29,077,"Missouri","Greene County",5,35,3773,1862,1911
050,29,077,"Missouri","Greene County",5,36,3783,1881,1902
050,29,077,"Missouri","Greene County",5,37,3831,1907,1924
050,29,077,"Missouri","Greene County",5,38,3866,1942,1924
050,29,077,"Missouri","Greene County",5,39,3775,1918,1857
050,29,077,"Missouri","Greene County",5,40,3764,1910,1854
050,29,077,"Missouri","Greene County",5,41,3869,1990,1879
050,29,077,"Missouri","Greene County",5,42,3840,1975,1865
050,29,077,"Missouri","Greene County",5,43,3881,1955,1926
050,29,077,"Missouri","Greene County",5,44,3506,1757,1749
050,29,077,"Missouri","Greene County",5,45,3521,1755,1766
050,29,077,"Missouri","Greene County",5,46,3464,1754,1710
050,29,077,"Missouri","Greene County",5,47,3186,1601,1585
050,29,077,"Missouri","Greene County",5,48,3245,1611,1634
050,29,077,"Missouri","Greene County",5,49,3192,1600,1592
050,29,077,"Missouri","Greene County",5,50,3147,1565,1582
050,29,077,"Missouri","Greene County",5,51,3424,1706,1718
050,29,077,"Missouri","Greene County",5,52,3638,1839,1799
050,29,077,"Missouri","Greene County",5,53,3510,1728,1782
050,29,077,"Missouri","Greene County",5,54,3303,1650,1653
050,29,077,"Missouri","Greene County",5,55,3204,1575,1629
050,29,077,"Missouri","Greene County",5,56,3182,1558,1624
050,29,077,"Missouri","Greene County",5,57,3233,1586,1647
050,29,077,"Missouri","Greene County",5,58,3397,1635,1762
050,29,077,"Missouri","Greene County",5,59,3510,1665,1845
050,29,077,"Missouri","Greene County",5,60,3614,1730,1884
050,29,077,"Missouri","Greene County",5,61,3638,1764,1874
050,29,077,"Missouri","Greene County",5,62,3644,1732,1912
050,29,077,"Missouri","Greene County",5,63,3534,1630,1904
050,29,077,"Missouri","Greene County",5,64,3493,1603,1890
050,29,077,"Missouri","Greene County",5,65,3409,1607,1802
050,29,077,"Missouri","Greene County",5,66,3363,1597,1766
050,29,077,"Missouri","Greene County",5,67,3264,1540,1724
050,29,077,"Missouri","Greene County",5,68,3160,1452,1708
050,29,077,"Missouri","Greene County",5,69,3073,1434,1639
050,29,077,"Missouri","Greene County",5,70,2959,1331,1628
050,29,077,"Missouri","Greene County",5,71,2922,1269,1653
050,29,077,"Missouri","Greene County",5,72,2751,1172,1579
050,29,077,"Missouri","Greene County",5,73,2558,1125,1433
050,29,077,"Missouri","Greene County",5,74,2537,1167,1370
050,29,077,"Missouri","Greene County",5,75,2429,1077,1352
050,29,077,"Missouri","Greene County",5,76,2643,1197,1446
050,29,077,"Missouri","Greene County",5,77,1824,774,1050
050,29,077,"Missouri","Greene County",5,78,1780,776,1004
050,29,077,"Missouri","Greene County",5,79,1737,767,970
050,29,077,"Missouri","Greene County",5,80,1748,744,1004
050,29,077,"Missouri","Greene County",5,81,1479,623,856
050,29,077,"Missouri","Greene County",5,82,1272,503,769
050,29,077,"Missouri","Greene County",5,83,1151,459,692
050,29,077,"Missouri","Greene County",5,84,1024,385,639
050,29,077,"Missouri","Greene County",5,85,6024,2041,3983
050,29,079,"Missouri","Grundy County",1,0,133,68,65
050,29,079,"Missouri","Grundy County",1,1,129,62,67
050,29,079,"Missouri","Grundy County",1,2,151,79,72
050,29,079,"Missouri","Grundy County",1,3,135,77,58
050,29,079,"Missouri","Grundy County",1,4,138,78,60
050,29,079,"Missouri","Grundy County",1,5,142,71,71
050,29,079,"Missouri","Grundy County",1,6,146,76,70
050,29,079,"Missouri","Grundy County",1,7,127,64,63
050,29,079,"Missouri","Grundy County",1,8,136,74,62
050,29,079,"Missouri","Grundy County",1,9,123,65,58
050,29,079,"Missouri","Grundy County",1,10,143,73,70
050,29,079,"Missouri","Grundy County",1,11,134,67,67
050,29,079,"Missouri","Grundy County",1,12,147,86,61
050,29,079,"Missouri","Grundy County",1,13,149,84,65
050,29,079,"Missouri","Grundy County",1,14,128,63,65
050,29,079,"Missouri","Grundy County",1,15,120,56,64
050,29,079,"Missouri","Grundy County",1,16,129,56,73
050,29,079,"Missouri","Grundy County",1,17,136,58,78
050,29,079,"Missouri","Grundy County",1,18,108,51,57
050,29,079,"Missouri","Grundy County",1,19,114,57,57
050,29,079,"Missouri","Grundy County",1,20,97,50,47
050,29,079,"Missouri","Grundy County",1,21,78,39,39
050,29,079,"Missouri","Grundy County",1,22,69,34,35
050,29,079,"Missouri","Grundy County",1,23,85,39,46
050,29,079,"Missouri","Grundy County",1,24,117,61,56
050,29,079,"Missouri","Grundy County",1,25,102,53,49
050,29,079,"Missouri","Grundy County",1,26,102,45,57
050,29,079,"Missouri","Grundy County",1,27,111,46,65
050,29,079,"Missouri","Grundy County",1,28,110,56,54
050,29,079,"Missouri","Grundy County",1,29,136,74,62
050,29,079,"Missouri","Grundy County",1,30,138,69,69
050,29,079,"Missouri","Grundy County",1,31,130,60,70
050,29,079,"Missouri","Grundy County",1,32,116,55,61
050,29,079,"Missouri","Grundy County",1,33,116,66,50
050,29,079,"Missouri","Grundy County",1,34,113,65,48
050,29,079,"Missouri","Grundy County",1,35,102,50,52
050,29,079,"Missouri","Grundy County",1,36,109,54,55
050,29,079,"Missouri","Grundy County",1,37,112,63,49
050,29,079,"Missouri","Grundy County",1,38,111,62,49
050,29,079,"Missouri","Grundy County",1,39,104,58,46
050,29,079,"Missouri","Grundy County",1,40,102,57,45
050,29,079,"Missouri","Grundy County",1,41,84,48,36
050,29,079,"Missouri","Grundy County",1,42,82,42,40
050,29,079,"Missouri","Grundy County",1,43,87,38,49
050,29,079,"Missouri","Grundy County",1,44,91,45,46
050,29,079,"Missouri","Grundy County",1,45,100,51,49
050,29,079,"Missouri","Grundy County",1,46,86,44,42
050,29,079,"Missouri","Grundy County",1,47,81,36,45
050,29,079,"Missouri","Grundy County",1,48,96,49,47
050,29,079,"Missouri","Grundy County",1,49,111,49,62
050,29,079,"Missouri","Grundy County",1,50,102,48,54
050,29,079,"Missouri","Grundy County",1,51,116,57,59
050,29,079,"Missouri","Grundy County",1,52,102,56,46
050,29,079,"Missouri","Grundy County",1,53,105,50,55
050,29,079,"Missouri","Grundy County",1,54,107,49,58
050,29,079,"Missouri","Grundy County",1,55,136,64,72
050,29,079,"Missouri","Grundy County",1,56,130,68,62
050,29,079,"Missouri","Grundy County",1,57,128,64,64
050,29,079,"Missouri","Grundy County",1,58,142,61,81
050,29,079,"Missouri","Grundy County",1,59,151,75,76
050,29,079,"Missouri","Grundy County",1,60,141,71,70
050,29,079,"Missouri","Grundy County",1,61,142,82,60
050,29,079,"Missouri","Grundy County",1,62,152,79,73
050,29,079,"Missouri","Grundy County",1,63,133,58,75
050,29,079,"Missouri","Grundy County",1,64,136,77,59
050,29,079,"Missouri","Grundy County",1,65,118,67,51
050,29,079,"Missouri","Grundy County",1,66,119,64,55
050,29,079,"Missouri","Grundy County",1,67,109,48,61
050,29,079,"Missouri","Grundy County",1,68,113,53,60
050,29,079,"Missouri","Grundy County",1,69,111,53,58
050,29,079,"Missouri","Grundy County",1,70,109,53,56
050,29,079,"Missouri","Grundy County",1,71,110,59,51
050,29,079,"Missouri","Grundy County",1,72,101,50,51
050,29,079,"Missouri","Grundy County",1,73,103,49,54
050,29,079,"Missouri","Grundy County",1,74,83,38,45
050,29,079,"Missouri","Grundy County",1,75,82,39,43
050,29,079,"Missouri","Grundy County",1,76,83,34,49
050,29,079,"Missouri","Grundy County",1,77,88,39,49
050,29,079,"Missouri","Grundy County",1,78,83,34,49
050,29,079,"Missouri","Grundy County",1,79,75,33,42
050,29,079,"Missouri","Grundy County",1,80,65,33,32
050,29,079,"Missouri","Grundy County",1,81,64,30,34
050,29,079,"Missouri","Grundy County",1,82,53,19,34
050,29,079,"Missouri","Grundy County",1,83,62,24,38
050,29,079,"Missouri","Grundy County",1,84,63,26,37
050,29,079,"Missouri","Grundy County",1,85,343,112,231
050,29,079,"Missouri","Grundy County",2,0,129,67,62
050,29,079,"Missouri","Grundy County",2,1,128,62,66
050,29,079,"Missouri","Grundy County",2,2,144,74,70
050,29,079,"Missouri","Grundy County",2,3,139,77,62
050,29,079,"Missouri","Grundy County",2,4,138,78,60
050,29,079,"Missouri","Grundy County",2,5,141,73,68
050,29,079,"Missouri","Grundy County",2,6,143,73,70
050,29,079,"Missouri","Grundy County",2,7,131,67,64
050,29,079,"Missouri","Grundy County",2,8,133,72,61
050,29,079,"Missouri","Grundy County",2,9,127,68,59
050,29,079,"Missouri","Grundy County",2,10,138,71,67
050,29,079,"Missouri","Grundy County",2,11,134,68,66
050,29,079,"Missouri","Grundy County",2,12,146,83,63
050,29,079,"Missouri","Grundy County",2,13,149,84,65
050,29,079,"Missouri","Grundy County",2,14,130,67,63
050,29,079,"Missouri","Grundy County",2,15,120,57,63
050,29,079,"Missouri","Grundy County",2,16,129,57,72
050,29,079,"Missouri","Grundy County",2,17,134,57,77
050,29,079,"Missouri","Grundy County",2,18,109,52,57
050,29,079,"Missouri","Grundy County",2,19,113,56,57
050,29,079,"Missouri","Grundy County",2,20,95,49,46
050,29,079,"Missouri","Grundy County",2,21,79,41,38
050,29,079,"Missouri","Grundy County",2,22,70,34,36
050,29,079,"Missouri","Grundy County",2,23,83,39,44
050,29,079,"Missouri","Grundy County",2,24,110,58,52
050,29,079,"Missouri","Grundy County",2,25,106,56,50
050,29,079,"Missouri","Grundy County",2,26,103,47,56
050,29,079,"Missouri","Grundy County",2,27,110,46,64
050,29,079,"Missouri","Grundy County",2,28,113,56,57
050,29,079,"Missouri","Grundy County",2,29,128,68,60
050,29,079,"Missouri","Grundy County",2,30,138,71,67
050,29,079,"Missouri","Grundy County",2,31,130,61,69
050,29,079,"Missouri","Grundy County",2,32,119,56,63
050,29,079,"Missouri","Grundy County",2,33,114,63,51
050,29,079,"Missouri","Grundy County",2,34,111,64,47
050,29,079,"Missouri","Grundy County",2,35,106,55,51
050,29,079,"Missouri","Grundy County",2,36,107,54,53
050,29,079,"Missouri","Grundy County",2,37,112,61,51
050,29,079,"Missouri","Grundy County",2,38,111,62,49
050,29,079,"Missouri","Grundy County",2,39,107,60,47
050,29,079,"Missouri","Grundy County",2,40,101,57,44
050,29,079,"Missouri","Grundy County",2,41,85,48,37
050,29,079,"Missouri","Grundy County",2,42,82,43,39
050,29,079,"Missouri","Grundy County",2,43,87,39,48
050,29,079,"Missouri","Grundy County",2,44,88,42,46
050,29,079,"Missouri","Grundy County",2,45,99,50,49
050,29,079,"Missouri","Grundy County",2,46,87,44,43
050,29,079,"Missouri","Grundy County",2,47,82,38,44
050,29,079,"Missouri","Grundy County",2,48,91,46,45
050,29,079,"Missouri","Grundy County",2,49,107,49,58
050,29,079,"Missouri","Grundy County",2,50,101,46,55
050,29,079,"Missouri","Grundy County",2,51,111,53,58
050,29,079,"Missouri","Grundy County",2,52,103,56,47
050,29,079,"Missouri","Grundy County",2,53,104,51,53
050,29,079,"Missouri","Grundy County",2,54,106,49,57
050,29,079,"Missouri","Grundy County",2,55,128,60,68
050,29,079,"Missouri","Grundy County",2,56,129,66,63
050,29,079,"Missouri","Grundy County",2,57,129,65,64
050,29,079,"Missouri","Grundy County",2,58,140,62,78
050,29,079,"Missouri","Grundy County",2,59,149,73,76
050,29,079,"Missouri","Grundy County",2,60,142,72,70
050,29,079,"Missouri","Grundy County",2,61,140,78,62
050,29,079,"Missouri","Grundy County",2,62,148,79,69
050,29,079,"Missouri","Grundy County",2,63,139,64,75
050,29,079,"Missouri","Grundy County",2,64,136,73,63
050,29,079,"Missouri","Grundy County",2,65,122,69,53
050,29,079,"Missouri","Grundy County",2,66,121,65,56
050,29,079,"Missouri","Grundy County",2,67,108,51,57
050,29,079,"Missouri","Grundy County",2,68,111,51,60
050,29,079,"Missouri","Grundy County",2,69,112,53,59
050,29,079,"Missouri","Grundy County",2,70,107,52,55
050,29,079,"Missouri","Grundy County",2,71,107,57,50
050,29,079,"Missouri","Grundy County",2,72,101,51,50
050,29,079,"Missouri","Grundy County",2,73,105,50,55
050,29,079,"Missouri","Grundy County",2,74,81,36,45
050,29,079,"Missouri","Grundy County",2,75,81,39,42
050,29,079,"Missouri","Grundy County",2,76,83,35,48
050,29,079,"Missouri","Grundy County",2,77,86,38,48
050,29,079,"Missouri","Grundy County",2,78,84,35,49
050,29,079,"Missouri","Grundy County",2,79,72,31,41
050,29,079,"Missouri","Grundy County",2,80,65,32,33
050,29,079,"Missouri","Grundy County",2,81,65,31,34
050,29,079,"Missouri","Grundy County",2,82,53,19,34
050,29,079,"Missouri","Grundy County",2,83,59,22,37
050,29,079,"Missouri","Grundy County",2,84,61,25,36
050,29,079,"Missouri","Grundy County",2,85,349,116,233
050,29,079,"Missouri","Grundy County",3,0,124,68,56
050,29,079,"Missouri","Grundy County",3,1,131,64,67
050,29,079,"Missouri","Grundy County",3,2,129,66,63
050,29,079,"Missouri","Grundy County",3,3,135,70,65
050,29,079,"Missouri","Grundy County",3,4,144,74,70
050,29,079,"Missouri","Grundy County",3,5,147,80,67
050,29,079,"Missouri","Grundy County",3,6,144,72,72
050,29,079,"Missouri","Grundy County",3,7,133,70,63
050,29,079,"Missouri","Grundy County",3,8,136,71,65
050,29,079,"Missouri","Grundy County",3,9,136,74,62
050,29,079,"Missouri","Grundy County",3,10,136,72,64
050,29,079,"Missouri","Grundy County",3,11,133,68,65
050,29,079,"Missouri","Grundy County",3,12,137,68,69
050,29,079,"Missouri","Grundy County",3,13,144,78,66
050,29,079,"Missouri","Grundy County",3,14,148,87,61
050,29,079,"Missouri","Grundy County",3,15,129,62,67
050,29,079,"Missouri","Grundy County",3,16,135,63,72
050,29,079,"Missouri","Grundy County",3,17,124,58,66
050,29,079,"Missouri","Grundy County",3,18,113,53,60
050,29,079,"Missouri","Grundy County",3,19,116,52,64
050,29,079,"Missouri","Grundy County",3,20,102,49,53
050,29,079,"Missouri","Grundy County",3,21,95,47,48
050,29,079,"Missouri","Grundy County",3,22,80,42,38
050,29,079,"Missouri","Grundy County",3,23,79,35,44
050,29,079,"Missouri","Grundy County",3,24,80,35,45
050,29,079,"Missouri","Grundy County",3,25,115,56,59
050,29,079,"Missouri","Grundy County",3,26,103,55,48
050,29,079,"Missouri","Grundy County",3,27,98,45,53
050,29,079,"Missouri","Grundy County",3,28,105,46,59
050,29,079,"Missouri","Grundy County",3,29,119,62,57
050,29,079,"Missouri","Grundy County",3,30,117,62,55
050,29,079,"Missouri","Grundy County",3,31,136,72,64
050,29,079,"Missouri","Grundy County",3,32,127,62,65
050,29,079,"Missouri","Grundy County",3,33,124,58,66
050,29,079,"Missouri","Grundy County",3,34,124,69,55
050,29,079,"Missouri","Grundy County",3,35,116,67,49
050,29,079,"Missouri","Grundy County",3,36,104,54,50
050,29,079,"Missouri","Grundy County",3,37,110,57,53
050,29,079,"Missouri","Grundy County",3,38,102,53,49
050,29,079,"Missouri","Grundy County",3,39,111,62,49
050,29,079,"Missouri","Grundy County",3,40,102,56,46
050,29,079,"Missouri","Grundy County",3,41,102,57,45
050,29,079,"Missouri","Grundy County",3,42,84,44,40
050,29,079,"Missouri","Grundy County",3,43,82,45,37
050,29,079,"Missouri","Grundy County",3,44,90,39,51
050,29,079,"Missouri","Grundy County",3,45,93,46,47
050,29,079,"Missouri","Grundy County",3,46,97,47,50
050,29,079,"Missouri","Grundy County",3,47,90,48,42
050,29,079,"Missouri","Grundy County",3,48,81,37,44
050,29,079,"Missouri","Grundy County",3,49,93,45,48
050,29,079,"Missouri","Grundy County",3,50,102,46,56
050,29,079,"Missouri","Grundy County",3,51,100,42,58
050,29,079,"Missouri","Grundy County",3,52,111,57,54
050,29,079,"Missouri","Grundy County",3,53,101,54,47
050,29,079,"Missouri","Grundy County",3,54,112,59,53
050,29,079,"Missouri","Grundy County",3,55,109,50,59
050,29,079,"Missouri","Grundy County",3,56,127,59,68
050,29,079,"Missouri","Grundy County",3,57,135,73,62
050,29,079,"Missouri","Grundy County",3,58,129,66,63
050,29,079,"Missouri","Grundy County",3,59,134,58,76
050,29,079,"Missouri","Grundy County",3,60,151,70,81
050,29,079,"Missouri","Grundy County",3,61,144,73,71
050,29,079,"Missouri","Grundy County",3,62,141,76,65
050,29,079,"Missouri","Grundy County",3,63,144,78,66
050,29,079,"Missouri","Grundy County",3,64,139,62,77
050,29,079,"Missouri","Grundy County",3,65,132,70,62
050,29,079,"Missouri","Grundy County",3,66,126,68,58
050,29,079,"Missouri","Grundy County",3,67,112,61,51
050,29,079,"Missouri","Grundy County",3,68,106,49,57
050,29,079,"Missouri","Grundy County",3,69,114,53,61
050,29,079,"Missouri","Grundy County",3,70,111,54,57
050,29,079,"Missouri","Grundy County",3,71,103,48,55
050,29,079,"Missouri","Grundy County",3,72,105,58,47
050,29,079,"Missouri","Grundy County",3,73,92,43,49
050,29,079,"Missouri","Grundy County",3,74,103,46,57
050,29,079,"Missouri","Grundy County",3,75,71,35,36
050,29,079,"Missouri","Grundy County",3,76,83,40,43
050,29,079,"Missouri","Grundy County",3,77,82,36,46
050,29,079,"Missouri","Grundy County",3,78,92,38,54
050,29,079,"Missouri","Grundy County",3,79,66,27,39
050,29,079,"Missouri","Grundy County",3,80,63,30,33
050,29,079,"Missouri","Grundy County",3,81,61,29,32
050,29,079,"Missouri","Grundy County",3,82,63,27,36
050,29,079,"Missouri","Grundy County",3,83,48,17,31
050,29,079,"Missouri","Grundy County",3,84,53,20,33
050,29,079,"Missouri","Grundy County",3,85,357,118,239
050,29,079,"Missouri","Grundy County",4,0,139,76,63
050,29,079,"Missouri","Grundy County",4,1,133,68,65
050,29,079,"Missouri","Grundy County",4,2,139,67,72
050,29,079,"Missouri","Grundy County",4,3,130,64,66
050,29,079,"Missouri","Grundy County",4,4,141,70,71
050,29,079,"Missouri","Grundy County",4,5,154,78,76
050,29,079,"Missouri","Grundy County",4,6,146,79,67
050,29,079,"Missouri","Grundy County",4,7,143,71,72
050,29,079,"Missouri","Grundy County",4,8,135,67,68
050,29,079,"Missouri","Grundy County",4,9,143,74,69
050,29,079,"Missouri","Grundy County",4,10,131,71,60
050,29,079,"Missouri","Grundy County",4,11,131,73,58
050,29,079,"Missouri","Grundy County",4,12,139,75,64
050,29,079,"Missouri","Grundy County",4,13,141,68,73
050,29,079,"Missouri","Grundy County",4,14,142,79,63
050,29,079,"Missouri","Grundy County",4,15,150,90,60
050,29,079,"Missouri","Grundy County",4,16,131,63,68
050,29,079,"Missouri","Grundy County",4,17,131,60,71
050,29,079,"Missouri","Grundy County",4,18,105,52,53
050,29,079,"Missouri","Grundy County",4,19,122,58,64
050,29,079,"Missouri","Grundy County",4,20,106,51,55
050,29,079,"Missouri","Grundy County",4,21,85,42,43
050,29,079,"Missouri","Grundy County",4,22,99,46,53
050,29,079,"Missouri","Grundy County",4,23,85,41,44
050,29,079,"Missouri","Grundy County",4,24,84,39,45
050,29,079,"Missouri","Grundy County",4,25,91,43,48
050,29,079,"Missouri","Grundy County",4,26,117,53,64
050,29,079,"Missouri","Grundy County",4,27,109,57,52
050,29,079,"Missouri","Grundy County",4,28,108,53,55
050,29,079,"Missouri","Grundy County",4,29,108,50,58
050,29,079,"Missouri","Grundy County",4,30,120,67,53
050,29,079,"Missouri","Grundy County",4,31,125,69,56
050,29,079,"Missouri","Grundy County",4,32,139,76,63
050,29,079,"Missouri","Grundy County",4,33,121,58,63
050,29,079,"Missouri","Grundy County",4,34,124,57,67
050,29,079,"Missouri","Grundy County",4,35,119,64,55
050,29,079,"Missouri","Grundy County",4,36,121,70,51
050,29,079,"Missouri","Grundy County",4,37,105,52,53
050,29,079,"Missouri","Grundy County",4,38,110,57,53
050,29,079,"Missouri","Grundy County",4,39,103,52,51
050,29,079,"Missouri","Grundy County",4,40,110,60,50
050,29,079,"Missouri","Grundy County",4,41,106,56,50
050,29,079,"Missouri","Grundy County",4,42,102,58,44
050,29,079,"Missouri","Grundy County",4,43,83,44,39
050,29,079,"Missouri","Grundy County",4,44,80,44,36
050,29,079,"Missouri","Grundy County",4,45,88,39,49
050,29,079,"Missouri","Grundy County",4,46,94,47,47
050,29,079,"Missouri","Grundy County",4,47,100,51,49
050,29,079,"Missouri","Grundy County",4,48,93,45,48
050,29,079,"Missouri","Grundy County",4,49,91,41,50
050,29,079,"Missouri","Grundy County",4,50,93,46,47
050,29,079,"Missouri","Grundy County",4,51,99,45,54
050,29,079,"Missouri","Grundy County",4,52,100,44,56
050,29,079,"Missouri","Grundy County",4,53,116,61,55
050,29,079,"Missouri","Grundy County",4,54,101,55,46
050,29,079,"Missouri","Grundy County",4,55,114,58,56
050,29,079,"Missouri","Grundy County",4,56,107,46,61
050,29,079,"Missouri","Grundy County",4,57,126,58,68
050,29,079,"Missouri","Grundy County",4,58,130,71,59
050,29,079,"Missouri","Grundy County",4,59,129,68,61
050,29,079,"Missouri","Grundy County",4,60,136,55,81
050,29,079,"Missouri","Grundy County",4,61,151,72,79
050,29,079,"Missouri","Grundy County",4,62,140,70,70
050,29,079,"Missouri","Grundy County",4,63,142,80,62
050,29,079,"Missouri","Grundy County",4,64,143,77,66
050,29,079,"Missouri","Grundy County",4,65,133,60,73
050,29,079,"Missouri","Grundy County",4,66,137,70,67
050,29,079,"Missouri","Grundy County",4,67,121,67,54
050,29,079,"Missouri","Grundy County",4,68,114,62,52
050,29,079,"Missouri","Grundy County",4,69,107,48,59
050,29,079,"Missouri","Grundy County",4,70,116,55,61
050,29,079,"Missouri","Grundy County",4,71,107,49,58
050,29,079,"Missouri","Grundy County",4,72,103,50,53
050,29,079,"Missouri","Grundy County",4,73,99,51,48
050,29,079,"Missouri","Grundy County",4,74,91,41,50
050,29,079,"Missouri","Grundy County",4,75,94,47,47
050,29,079,"Missouri","Grundy County",4,76,69,33,36
050,29,079,"Missouri","Grundy County",4,77,73,38,35
050,29,079,"Missouri","Grundy County",4,78,81,31,50
050,29,079,"Missouri","Grundy County",4,79,75,30,45
050,29,079,"Missouri","Grundy County",4,80,62,27,35
050,29,079,"Missouri","Grundy County",4,81,58,25,33
050,29,079,"Missouri","Grundy County",4,82,61,29,32
050,29,079,"Missouri","Grundy County",4,83,60,22,38
050,29,079,"Missouri","Grundy County",4,84,41,14,27
050,29,079,"Missouri","Grundy County",4,85,363,119,244
050,29,079,"Missouri","Grundy County",5,0,143,79,64
050,29,079,"Missouri","Grundy County",5,1,127,74,53
050,29,079,"Missouri","Grundy County",5,2,124,60,64
050,29,079,"Missouri","Grundy County",5,3,128,57,71
050,29,079,"Missouri","Grundy County",5,4,120,56,64
050,29,079,"Missouri","Grundy County",5,5,144,69,75
050,29,079,"Missouri","Grundy County",5,6,156,82,74
050,29,079,"Missouri","Grundy County",5,7,148,75,73
050,29,079,"Missouri","Grundy County",5,8,138,66,72
050,29,079,"Missouri","Grundy County",5,9,139,67,72
050,29,079,"Missouri","Grundy County",5,10,144,71,73
050,29,079,"Missouri","Grundy County",5,11,128,63,65
050,29,079,"Missouri","Grundy County",5,12,126,66,60
050,29,079,"Missouri","Grundy County",5,13,136,71,65
050,29,079,"Missouri","Grundy County",5,14,145,76,69
050,29,079,"Missouri","Grundy County",5,15,149,86,63
050,29,079,"Missouri","Grundy County",5,16,162,99,63
050,29,079,"Missouri","Grundy County",5,17,137,65,72
050,29,079,"Missouri","Grundy County",5,18,117,57,60
050,29,079,"Missouri","Grundy County",5,19,114,51,63
050,29,079,"Missouri","Grundy County",5,20,102,49,53
050,29,079,"Missouri","Grundy County",5,21,92,46,46
050,29,079,"Missouri","Grundy County",5,22,79,38,41
050,29,079,"Missouri","Grundy County",5,23,105,51,54
050,29,079,"Missouri","Grundy County",5,24,90,48,42
050,29,079,"Missouri","Grundy County",5,25,91,42,49
050,29,079,"Missouri","Grundy County",5,26,89,47,42
050,29,079,"Missouri","Grundy County",5,27,114,54,60
050,29,079,"Missouri","Grundy County",5,28,103,54,49
050,29,079,"Missouri","Grundy County",5,29,113,50,63
050,29,079,"Missouri","Grundy County",5,30,114,48,66
050,29,079,"Missouri","Grundy County",5,31,116,65,51
050,29,079,"Missouri","Grundy County",5,32,122,68,54
050,29,079,"Missouri","Grundy County",5,33,129,70,59
050,29,079,"Missouri","Grundy County",5,34,125,60,65
050,29,079,"Missouri","Grundy County",5,35,118,54,64
050,29,079,"Missouri","Grundy County",5,36,123,69,54
050,29,079,"Missouri","Grundy County",5,37,124,70,54
050,29,079,"Missouri","Grundy County",5,38,104,51,53
050,29,079,"Missouri","Grundy County",5,39,118,62,56
050,29,079,"Missouri","Grundy County",5,40,105,55,50
050,29,079,"Missouri","Grundy County",5,41,120,64,56
050,29,079,"Missouri","Grundy County",5,42,99,54,45
050,29,079,"Missouri","Grundy County",5,43,103,61,42
050,29,079,"Missouri","Grundy County",5,44,81,42,39
050,29,079,"Missouri","Grundy County",5,45,87,50,37
050,29,079,"Missouri","Grundy County",5,46,87,37,50
050,29,079,"Missouri","Grundy County",5,47,93,49,44
050,29,079,"Missouri","Grundy County",5,48,96,47,49
050,29,079,"Missouri","Grundy County",5,49,98,49,49
050,29,079,"Missouri","Grundy County",5,50,85,40,45
050,29,079,"Missouri","Grundy County",5,51,92,45,47
050,29,079,"Missouri","Grundy County",5,52,95,42,53
050,29,079,"Missouri","Grundy County",5,53,97,42,55
050,29,079,"Missouri","Grundy County",5,54,112,56,56
050,29,079,"Missouri","Grundy County",5,55,99,53,46
050,29,079,"Missouri","Grundy County",5,56,107,55,52
050,29,079,"Missouri","Grundy County",5,57,108,47,61
050,29,079,"Missouri","Grundy County",5,58,123,57,66
050,29,079,"Missouri","Grundy County",5,59,130,69,61
050,29,079,"Missouri","Grundy County",5,60,126,67,59
050,29,079,"Missouri","Grundy County",5,61,137,55,82
050,29,079,"Missouri","Grundy County",5,62,146,71,75
050,29,079,"Missouri","Grundy County",5,63,147,78,69
050,29,079,"Missouri","Grundy County",5,64,146,82,64
050,29,079,"Missouri","Grundy County",5,65,142,76,66
050,29,079,"Missouri","Grundy County",5,66,135,57,78
050,29,079,"Missouri","Grundy County",5,67,132,68,64
050,29,079,"Missouri","Grundy County",5,68,124,67,57
050,29,079,"Missouri","Grundy County",5,69,112,58,54
050,29,079,"Missouri","Grundy County",5,70,109,51,58
050,29,079,"Missouri","Grundy County",5,71,109,51,58
050,29,079,"Missouri","Grundy County",5,72,110,52,58
050,29,079,"Missouri","Grundy County",5,73,97,42,55
050,29,079,"Missouri","Grundy County",5,74,101,50,51
050,29,079,"Missouri","Grundy County",5,75,78,41,37
050,29,079,"Missouri","Grundy County",5,76,94,44,50
050,29,079,"Missouri","Grundy County",5,77,62,31,31
050,29,079,"Missouri","Grundy County",5,78,74,37,37
050,29,079,"Missouri","Grundy County",5,79,63,23,40
050,29,079,"Missouri","Grundy County",5,80,69,30,39
050,29,079,"Missouri","Grundy County",5,81,58,24,34
050,29,079,"Missouri","Grundy County",5,82,57,24,33
050,29,079,"Missouri","Grundy County",5,83,57,24,33
050,29,079,"Missouri","Grundy County",5,84,56,21,35
050,29,079,"Missouri","Grundy County",5,85,361,117,244
050,29,081,"Missouri","Harrison County",1,0,89,45,44
050,29,081,"Missouri","Harrison County",1,1,92,45,47
050,29,081,"Missouri","Harrison County",1,2,90,53,37
050,29,081,"Missouri","Harrison County",1,3,98,48,50
050,29,081,"Missouri","Harrison County",1,4,108,56,52
050,29,081,"Missouri","Harrison County",1,5,105,67,38
050,29,081,"Missouri","Harrison County",1,6,113,56,57
050,29,081,"Missouri","Harrison County",1,7,108,49,59
050,29,081,"Missouri","Harrison County",1,8,107,50,57
050,29,081,"Missouri","Harrison County",1,9,98,49,49
050,29,081,"Missouri","Harrison County",1,10,106,53,53
050,29,081,"Missouri","Harrison County",1,11,125,71,54
050,29,081,"Missouri","Harrison County",1,12,131,63,68
050,29,081,"Missouri","Harrison County",1,13,140,72,68
050,29,081,"Missouri","Harrison County",1,14,134,73,61
050,29,081,"Missouri","Harrison County",1,15,122,64,58
050,29,081,"Missouri","Harrison County",1,16,122,69,53
050,29,081,"Missouri","Harrison County",1,17,118,66,52
050,29,081,"Missouri","Harrison County",1,18,97,52,45
050,29,081,"Missouri","Harrison County",1,19,75,43,32
050,29,081,"Missouri","Harrison County",1,20,77,40,37
050,29,081,"Missouri","Harrison County",1,21,73,39,34
050,29,081,"Missouri","Harrison County",1,22,72,40,32
050,29,081,"Missouri","Harrison County",1,23,84,47,37
050,29,081,"Missouri","Harrison County",1,24,81,43,38
050,29,081,"Missouri","Harrison County",1,25,77,41,36
050,29,081,"Missouri","Harrison County",1,26,74,39,35
050,29,081,"Missouri","Harrison County",1,27,81,43,38
050,29,081,"Missouri","Harrison County",1,28,83,48,35
050,29,081,"Missouri","Harrison County",1,29,85,45,40
050,29,081,"Missouri","Harrison County",1,30,86,46,40
050,29,081,"Missouri","Harrison County",1,31,93,44,49
050,29,081,"Missouri","Harrison County",1,32,83,38,45
050,29,081,"Missouri","Harrison County",1,33,85,41,44
050,29,081,"Missouri","Harrison County",1,34,93,44,49
050,29,081,"Missouri","Harrison County",1,35,83,44,39
050,29,081,"Missouri","Harrison County",1,36,102,52,50
050,29,081,"Missouri","Harrison County",1,37,92,44,48
050,29,081,"Missouri","Harrison County",1,38,96,49,47
050,29,081,"Missouri","Harrison County",1,39,87,45,42
050,29,081,"Missouri","Harrison County",1,40,97,50,47
050,29,081,"Missouri","Harrison County",1,41,82,41,41
050,29,081,"Missouri","Harrison County",1,42,83,42,41
050,29,081,"Missouri","Harrison County",1,43,84,42,42
050,29,081,"Missouri","Harrison County",1,44,80,40,40
050,29,081,"Missouri","Harrison County",1,45,79,39,40
050,29,081,"Missouri","Harrison County",1,46,87,44,43
050,29,081,"Missouri","Harrison County",1,47,90,50,40
050,29,081,"Missouri","Harrison County",1,48,90,46,44
050,29,081,"Missouri","Harrison County",1,49,101,50,51
050,29,081,"Missouri","Harrison County",1,50,83,42,41
050,29,081,"Missouri","Harrison County",1,51,70,40,30
050,29,081,"Missouri","Harrison County",1,52,87,48,39
050,29,081,"Missouri","Harrison County",1,53,93,42,51
050,29,081,"Missouri","Harrison County",1,54,111,51,60
050,29,081,"Missouri","Harrison County",1,55,111,56,55
050,29,081,"Missouri","Harrison County",1,56,101,54,47
050,29,081,"Missouri","Harrison County",1,57,120,62,58
050,29,081,"Missouri","Harrison County",1,58,118,57,61
050,29,081,"Missouri","Harrison County",1,59,117,64,53
050,29,081,"Missouri","Harrison County",1,60,123,57,66
050,29,081,"Missouri","Harrison County",1,61,123,59,64
050,29,081,"Missouri","Harrison County",1,62,125,57,68
050,29,081,"Missouri","Harrison County",1,63,129,61,68
050,29,081,"Missouri","Harrison County",1,64,123,59,64
050,29,081,"Missouri","Harrison County",1,65,111,48,63
050,29,081,"Missouri","Harrison County",1,66,102,50,52
050,29,081,"Missouri","Harrison County",1,67,99,50,49
050,29,081,"Missouri","Harrison County",1,68,107,58,49
050,29,081,"Missouri","Harrison County",1,69,104,48,56
050,29,081,"Missouri","Harrison County",1,70,94,44,50
050,29,081,"Missouri","Harrison County",1,71,90,46,44
050,29,081,"Missouri","Harrison County",1,72,88,47,41
050,29,081,"Missouri","Harrison County",1,73,88,44,44
050,29,081,"Missouri","Harrison County",1,74,64,33,31
050,29,081,"Missouri","Harrison County",1,75,73,34,39
050,29,081,"Missouri","Harrison County",1,76,70,37,33
050,29,081,"Missouri","Harrison County",1,77,85,45,40
050,29,081,"Missouri","Harrison County",1,78,68,32,36
050,29,081,"Missouri","Harrison County",1,79,54,24,30
050,29,081,"Missouri","Harrison County",1,80,44,19,25
050,29,081,"Missouri","Harrison County",1,81,52,20,32
050,29,081,"Missouri","Harrison County",1,82,49,20,29
050,29,081,"Missouri","Harrison County",1,83,40,15,25
050,29,081,"Missouri","Harrison County",1,84,35,11,24
050,29,081,"Missouri","Harrison County",1,85,274,87,187
050,29,081,"Missouri","Harrison County",2,0,90,44,46
050,29,081,"Missouri","Harrison County",2,1,90,45,45
050,29,081,"Missouri","Harrison County",2,2,91,51,40
050,29,081,"Missouri","Harrison County",2,3,94,48,46
050,29,081,"Missouri","Harrison County",2,4,105,54,51
050,29,081,"Missouri","Harrison County",2,5,106,64,42
050,29,081,"Missouri","Harrison County",2,6,111,59,52
050,29,081,"Missouri","Harrison County",2,7,109,51,58
050,29,081,"Missouri","Harrison County",2,8,107,50,57
050,29,081,"Missouri","Harrison County",2,9,101,50,51
050,29,081,"Missouri","Harrison County",2,10,104,52,52
050,29,081,"Missouri","Harrison County",2,11,121,66,55
050,29,081,"Missouri","Harrison County",2,12,133,67,66
050,29,081,"Missouri","Harrison County",2,13,137,70,67
050,29,081,"Missouri","Harrison County",2,14,135,72,63
050,29,081,"Missouri","Harrison County",2,15,124,66,58
050,29,081,"Missouri","Harrison County",2,16,124,69,55
050,29,081,"Missouri","Harrison County",2,17,119,67,52
050,29,081,"Missouri","Harrison County",2,18,98,54,44
050,29,081,"Missouri","Harrison County",2,19,75,42,33
050,29,081,"Missouri","Harrison County",2,20,77,41,36
050,29,081,"Missouri","Harrison County",2,21,75,40,35
050,29,081,"Missouri","Harrison County",2,22,73,40,33
050,29,081,"Missouri","Harrison County",2,23,82,45,37
050,29,081,"Missouri","Harrison County",2,24,85,46,39
050,29,081,"Missouri","Harrison County",2,25,77,41,36
050,29,081,"Missouri","Harrison County",2,26,74,39,35
050,29,081,"Missouri","Harrison County",2,27,76,40,36
050,29,081,"Missouri","Harrison County",2,28,81,46,35
050,29,081,"Missouri","Harrison County",2,29,85,47,38
050,29,081,"Missouri","Harrison County",2,30,88,46,42
050,29,081,"Missouri","Harrison County",2,31,90,44,46
050,29,081,"Missouri","Harrison County",2,32,85,39,46
050,29,081,"Missouri","Harrison County",2,33,84,40,44
050,29,081,"Missouri","Harrison County",2,34,90,42,48
050,29,081,"Missouri","Harrison County",2,35,85,43,42
050,29,081,"Missouri","Harrison County",2,36,97,50,47
050,29,081,"Missouri","Harrison County",2,37,95,46,49
050,29,081,"Missouri","Harrison County",2,38,95,47,48
050,29,081,"Missouri","Harrison County",2,39,92,48,44
050,29,081,"Missouri","Harrison County",2,40,96,50,46
050,29,081,"Missouri","Harrison County",2,41,84,42,42
050,29,081,"Missouri","Harrison County",2,42,83,42,41
050,29,081,"Missouri","Harrison County",2,43,88,44,44
050,29,081,"Missouri","Harrison County",2,44,79,40,39
050,29,081,"Missouri","Harrison County",2,45,80,40,40
050,29,081,"Missouri","Harrison County",2,46,85,42,43
050,29,081,"Missouri","Harrison County",2,47,88,47,41
050,29,081,"Missouri","Harrison County",2,48,91,48,43
050,29,081,"Missouri","Harrison County",2,49,101,51,50
050,29,081,"Missouri","Harrison County",2,50,88,43,45
050,29,081,"Missouri","Harrison County",2,51,73,40,33
050,29,081,"Missouri","Harrison County",2,52,82,46,36
050,29,081,"Missouri","Harrison County",2,53,92,44,48
050,29,081,"Missouri","Harrison County",2,54,107,49,58
050,29,081,"Missouri","Harrison County",2,55,111,55,56
050,29,081,"Missouri","Harrison County",2,56,105,55,50
050,29,081,"Missouri","Harrison County",2,57,116,61,55
050,29,081,"Missouri","Harrison County",2,58,117,57,60
050,29,081,"Missouri","Harrison County",2,59,119,63,56
050,29,081,"Missouri","Harrison County",2,60,121,58,63
050,29,081,"Missouri","Harrison County",2,61,122,58,64
050,29,081,"Missouri","Harrison County",2,62,123,56,67
050,29,081,"Missouri","Harrison County",2,63,129,61,68
050,29,081,"Missouri","Harrison County",2,64,122,58,64
050,29,081,"Missouri","Harrison County",2,65,114,50,64
050,29,081,"Missouri","Harrison County",2,66,105,51,54
050,29,081,"Missouri","Harrison County",2,67,99,50,49
050,29,081,"Missouri","Harrison County",2,68,105,56,49
050,29,081,"Missouri","Harrison County",2,69,104,49,55
050,29,081,"Missouri","Harrison County",2,70,96,45,51
050,29,081,"Missouri","Harrison County",2,71,90,44,46
050,29,081,"Missouri","Harrison County",2,72,86,46,40
050,29,081,"Missouri","Harrison County",2,73,92,47,45
050,29,081,"Missouri","Harrison County",2,74,65,33,32
050,29,081,"Missouri","Harrison County",2,75,70,34,36
050,29,081,"Missouri","Harrison County",2,76,70,36,34
050,29,081,"Missouri","Harrison County",2,77,83,43,40
050,29,081,"Missouri","Harrison County",2,78,71,35,36
050,29,081,"Missouri","Harrison County",2,79,56,25,31
050,29,081,"Missouri","Harrison County",2,80,48,21,27
050,29,081,"Missouri","Harrison County",2,81,47,18,29
050,29,081,"Missouri","Harrison County",2,82,50,20,30
050,29,081,"Missouri","Harrison County",2,83,41,15,26
050,29,081,"Missouri","Harrison County",2,84,37,12,25
050,29,081,"Missouri","Harrison County",2,85,272,86,186
050,29,081,"Missouri","Harrison County",3,0,98,41,57
050,29,081,"Missouri","Harrison County",3,1,92,50,42
050,29,081,"Missouri","Harrison County",3,2,87,45,42
050,29,081,"Missouri","Harrison County",3,3,85,46,39
050,29,081,"Missouri","Harrison County",3,4,100,56,44
050,29,081,"Missouri","Harrison County",3,5,112,56,56
050,29,081,"Missouri","Harrison County",3,6,111,68,43
050,29,081,"Missouri","Harrison County",3,7,110,57,53
050,29,081,"Missouri","Harrison County",3,8,113,56,57
050,29,081,"Missouri","Harrison County",3,9,111,51,60
050,29,081,"Missouri","Harrison County",3,10,103,53,50
050,29,081,"Missouri","Harrison County",3,11,105,53,52
050,29,081,"Missouri","Harrison County",3,12,122,67,55
050,29,081,"Missouri","Harrison County",3,13,142,75,67
050,29,081,"Missouri","Harrison County",3,14,140,70,70
050,29,081,"Missouri","Harrison County",3,15,137,71,66
050,29,081,"Missouri","Harrison County",3,16,120,62,58
050,29,081,"Missouri","Harrison County",3,17,124,70,54
050,29,081,"Missouri","Harrison County",3,18,95,55,40
050,29,081,"Missouri","Harrison County",3,19,79,42,37
050,29,081,"Missouri","Harrison County",3,20,83,41,42
050,29,081,"Missouri","Harrison County",3,21,89,47,42
050,29,081,"Missouri","Harrison County",3,22,79,44,35
050,29,081,"Missouri","Harrison County",3,23,77,43,34
050,29,081,"Missouri","Harrison County",3,24,77,40,37
050,29,081,"Missouri","Harrison County",3,25,79,44,35
050,29,081,"Missouri","Harrison County",3,26,81,45,36
050,29,081,"Missouri","Harrison County",3,27,68,37,31
050,29,081,"Missouri","Harrison County",3,28,79,41,38
050,29,081,"Missouri","Harrison County",3,29,86,51,35
050,29,081,"Missouri","Harrison County",3,30,82,45,37
050,29,081,"Missouri","Harrison County",3,31,92,45,47
050,29,081,"Missouri","Harrison County",3,32,98,47,51
050,29,081,"Missouri","Harrison County",3,33,86,41,45
050,29,081,"Missouri","Harrison County",3,34,78,36,42
050,29,081,"Missouri","Harrison County",3,35,92,43,49
050,29,081,"Missouri","Harrison County",3,36,90,49,41
050,29,081,"Missouri","Harrison County",3,37,92,47,45
050,29,081,"Missouri","Harrison County",3,38,101,52,49
050,29,081,"Missouri","Harrison County",3,39,95,49,46
050,29,081,"Missouri","Harrison County",3,40,90,45,45
050,29,081,"Missouri","Harrison County",3,41,100,50,50
050,29,081,"Missouri","Harrison County",3,42,79,41,38
050,29,081,"Missouri","Harrison County",3,43,85,41,44
050,29,081,"Missouri","Harrison County",3,44,86,43,43
050,29,081,"Missouri","Harrison County",3,45,78,40,38
050,29,081,"Missouri","Harrison County",3,46,78,39,39
050,29,081,"Missouri","Harrison County",3,47,86,41,45
050,29,081,"Missouri","Harrison County",3,48,85,47,38
050,29,081,"Missouri","Harrison County",3,49,97,54,43
050,29,081,"Missouri","Harrison County",3,50,99,47,52
050,29,081,"Missouri","Harrison County",3,51,88,43,45
050,29,081,"Missouri","Harrison County",3,52,79,42,37
050,29,081,"Missouri","Harrison County",3,53,79,46,33
050,29,081,"Missouri","Harrison County",3,54,93,43,50
050,29,081,"Missouri","Harrison County",3,55,103,47,56
050,29,081,"Missouri","Harrison County",3,56,109,56,53
050,29,081,"Missouri","Harrison County",3,57,110,59,51
050,29,081,"Missouri","Harrison County",3,58,113,59,54
050,29,081,"Missouri","Harrison County",3,59,126,62,64
050,29,081,"Missouri","Harrison County",3,60,117,63,54
050,29,081,"Missouri","Harrison County",3,61,117,55,62
050,29,081,"Missouri","Harrison County",3,62,122,55,67
050,29,081,"Missouri","Harrison County",3,63,120,55,65
050,29,081,"Missouri","Harrison County",3,64,134,65,69
050,29,081,"Missouri","Harrison County",3,65,115,54,61
050,29,081,"Missouri","Harrison County",3,66,118,52,66
050,29,081,"Missouri","Harrison County",3,67,106,51,55
050,29,081,"Missouri","Harrison County",3,68,100,53,47
050,29,081,"Missouri","Harrison County",3,69,94,48,46
050,29,081,"Missouri","Harrison County",3,70,101,48,53
050,29,081,"Missouri","Harrison County",3,71,96,43,53
050,29,081,"Missouri","Harrison County",3,72,83,42,41
050,29,081,"Missouri","Harrison County",3,73,88,48,40
050,29,081,"Missouri","Harrison County",3,74,88,44,44
050,29,081,"Missouri","Harrison County",3,75,64,33,31
050,29,081,"Missouri","Harrison County",3,76,63,29,34
050,29,081,"Missouri","Harrison County",3,77,68,34,34
050,29,081,"Missouri","Harrison County",3,78,80,40,40
050,29,081,"Missouri","Harrison County",3,79,66,31,35
050,29,081,"Missouri","Harrison County",3,80,53,23,30
050,29,081,"Missouri","Harrison County",3,81,41,17,24
050,29,081,"Missouri","Harrison County",3,82,48,18,30
050,29,081,"Missouri","Harrison County",3,83,44,17,27
050,29,081,"Missouri","Harrison County",3,84,40,13,27
050,29,081,"Missouri","Harrison County",3,85,265,83,182
050,29,081,"Missouri","Harrison County",4,0,83,40,43
050,29,081,"Missouri","Harrison County",4,1,102,46,56
050,29,081,"Missouri","Harrison County",4,2,86,47,39
050,29,081,"Missouri","Harrison County",4,3,90,48,42
050,29,081,"Missouri","Harrison County",4,4,94,51,43
050,29,081,"Missouri","Harrison County",4,5,97,57,40
050,29,081,"Missouri","Harrison County",4,6,117,63,54
050,29,081,"Missouri","Harrison County",4,7,114,72,42
050,29,081,"Missouri","Harrison County",4,8,112,61,51
050,29,081,"Missouri","Harrison County",4,9,121,56,65
050,29,081,"Missouri","Harrison County",4,10,105,51,54
050,29,081,"Missouri","Harrison County",4,11,110,59,51
050,29,081,"Missouri","Harrison County",4,12,109,55,54
050,29,081,"Missouri","Harrison County",4,13,126,71,55
050,29,081,"Missouri","Harrison County",4,14,147,81,66
050,29,081,"Missouri","Harrison County",4,15,143,74,69
050,29,081,"Missouri","Harrison County",4,16,141,73,68
050,29,081,"Missouri","Harrison County",4,17,124,66,58
050,29,081,"Missouri","Harrison County",4,18,111,65,46
050,29,081,"Missouri","Harrison County",4,19,70,40,30
050,29,081,"Missouri","Harrison County",4,20,81,45,36
050,29,081,"Missouri","Harrison County",4,21,84,40,44
050,29,081,"Missouri","Harrison County",4,22,88,48,40
050,29,081,"Missouri","Harrison County",4,23,76,42,34
050,29,081,"Missouri","Harrison County",4,24,81,44,37
050,29,081,"Missouri","Harrison County",4,25,77,41,36
050,29,081,"Missouri","Harrison County",4,26,85,46,39
050,29,081,"Missouri","Harrison County",4,27,80,44,36
050,29,081,"Missouri","Harrison County",4,28,70,38,32
050,29,081,"Missouri","Harrison County",4,29,81,41,40
050,29,081,"Missouri","Harrison County",4,30,87,47,40
050,29,081,"Missouri","Harrison County",4,31,73,41,32
050,29,081,"Missouri","Harrison County",4,32,85,41,44
050,29,081,"Missouri","Harrison County",4,33,100,47,53
050,29,081,"Missouri","Harrison County",4,34,82,40,42
050,29,081,"Missouri","Harrison County",4,35,88,42,46
050,29,081,"Missouri","Harrison County",4,36,101,49,52
050,29,081,"Missouri","Harrison County",4,37,89,44,45
050,29,081,"Missouri","Harrison County",4,38,102,53,49
050,29,081,"Missouri","Harrison County",4,39,103,54,49
050,29,081,"Missouri","Harrison County",4,40,94,49,45
050,29,081,"Missouri","Harrison County",4,41,88,44,44
050,29,081,"Missouri","Harrison County",4,42,102,51,51
050,29,081,"Missouri","Harrison County",4,43,82,42,40
050,29,081,"Missouri","Harrison County",4,44,87,39,48
050,29,081,"Missouri","Harrison County",4,45,91,47,44
050,29,081,"Missouri","Harrison County",4,46,78,36,42
050,29,081,"Missouri","Harrison County",4,47,79,39,40
050,29,081,"Missouri","Harrison County",4,48,83,45,38
050,29,081,"Missouri","Harrison County",4,49,92,52,40
050,29,081,"Missouri","Harrison County",4,50,96,46,50
050,29,081,"Missouri","Harrison County",4,51,101,51,50
050,29,081,"Missouri","Harrison County",4,52,92,44,48
050,29,081,"Missouri","Harrison County",4,53,74,40,34
050,29,081,"Missouri","Harrison County",4,54,81,48,33
050,29,081,"Missouri","Harrison County",4,55,91,42,49
050,29,081,"Missouri","Harrison County",4,56,106,51,55
050,29,081,"Missouri","Harrison County",4,57,104,57,47
050,29,081,"Missouri","Harrison County",4,58,110,59,51
050,29,081,"Missouri","Harrison County",4,59,119,64,55
050,29,081,"Missouri","Harrison County",4,60,120,59,61
050,29,081,"Missouri","Harrison County",4,61,117,63,54
050,29,081,"Missouri","Harrison County",4,62,110,51,59
050,29,081,"Missouri","Harrison County",4,63,123,55,68
050,29,081,"Missouri","Harrison County",4,64,120,60,60
050,29,081,"Missouri","Harrison County",4,65,132,63,69
050,29,081,"Missouri","Harrison County",4,66,113,54,59
050,29,081,"Missouri","Harrison County",4,67,114,50,64
050,29,081,"Missouri","Harrison County",4,68,110,53,57
050,29,081,"Missouri","Harrison County",4,69,93,48,45
050,29,081,"Missouri","Harrison County",4,70,93,46,47
050,29,081,"Missouri","Harrison County",4,71,102,49,53
050,29,081,"Missouri","Harrison County",4,72,89,41,48
050,29,081,"Missouri","Harrison County",4,73,78,38,40
050,29,081,"Missouri","Harrison County",4,74,84,47,37
050,29,081,"Missouri","Harrison County",4,75,91,47,44
050,29,081,"Missouri","Harrison County",4,76,64,32,32
050,29,081,"Missouri","Harrison County",4,77,58,26,32
050,29,081,"Missouri","Harrison County",4,78,60,26,34
050,29,081,"Missouri","Harrison County",4,79,75,34,41
050,29,081,"Missouri","Harrison County",4,80,64,30,34
050,29,081,"Missouri","Harrison County",4,81,48,20,28
050,29,081,"Missouri","Harrison County",4,82,45,20,25
050,29,081,"Missouri","Harrison County",4,83,44,16,28
050,29,081,"Missouri","Harrison County",4,84,40,11,29
050,29,081,"Missouri","Harrison County",4,85,265,84,181
050,29,081,"Missouri","Harrison County",5,0,84,40,44
050,29,081,"Missouri","Harrison County",5,1,86,38,48
050,29,081,"Missouri","Harrison County",5,2,106,45,61
050,29,081,"Missouri","Harrison County",5,3,93,52,41
050,29,081,"Missouri","Harrison County",5,4,91,49,42
050,29,081,"Missouri","Harrison County",5,5,93,49,44
050,29,081,"Missouri","Harrison County",5,6,102,57,45
050,29,081,"Missouri","Harrison County",5,7,121,62,59
050,29,081,"Missouri","Harrison County",5,8,117,73,44
050,29,081,"Missouri","Harrison County",5,9,113,60,53
050,29,081,"Missouri","Harrison County",5,10,119,56,63
050,29,081,"Missouri","Harrison County",5,11,103,53,50
050,29,081,"Missouri","Harrison County",5,12,120,65,55
050,29,081,"Missouri","Harrison County",5,13,107,53,54
050,29,081,"Missouri","Harrison County",5,14,124,71,53
050,29,081,"Missouri","Harrison County",5,15,145,76,69
050,29,081,"Missouri","Harrison County",5,16,139,68,71
050,29,081,"Missouri","Harrison County",5,17,139,72,67
050,29,081,"Missouri","Harrison County",5,18,105,58,47
050,29,081,"Missouri","Harrison County",5,19,83,47,36
050,29,081,"Missouri","Harrison County",5,20,77,44,33
050,29,081,"Missouri","Harrison County",5,21,89,48,41
050,29,081,"Missouri","Harrison County",5,22,91,40,51
050,29,081,"Missouri","Harrison County",5,23,88,47,41
050,29,081,"Missouri","Harrison County",5,24,79,43,36
050,29,081,"Missouri","Harrison County",5,25,91,52,39
050,29,081,"Missouri","Harrison County",5,26,77,43,34
050,29,081,"Missouri","Harrison County",5,27,86,46,40
050,29,081,"Missouri","Harrison County",5,28,80,42,38
050,29,081,"Missouri","Harrison County",5,29,76,43,33
050,29,081,"Missouri","Harrison County",5,30,79,40,39
050,29,081,"Missouri","Harrison County",5,31,89,49,40
050,29,081,"Missouri","Harrison County",5,32,70,38,32
050,29,081,"Missouri","Harrison County",5,33,85,40,45
050,29,081,"Missouri","Harrison County",5,34,97,45,52
050,29,081,"Missouri","Harrison County",5,35,85,41,44
050,29,081,"Missouri","Harrison County",5,36,91,47,44
050,29,081,"Missouri","Harrison County",5,37,100,48,52
050,29,081,"Missouri","Harrison County",5,38,89,47,42
050,29,081,"Missouri","Harrison County",5,39,104,55,49
050,29,081,"Missouri","Harrison County",5,40,103,52,51
050,29,081,"Missouri","Harrison County",5,41,90,45,45
050,29,081,"Missouri","Harrison County",5,42,87,45,42
050,29,081,"Missouri","Harrison County",5,43,105,51,54
050,29,081,"Missouri","Harrison County",5,44,81,44,37
050,29,081,"Missouri","Harrison County",5,45,94,47,47
050,29,081,"Missouri","Harrison County",5,46,92,49,43
050,29,081,"Missouri","Harrison County",5,47,82,39,43
050,29,081,"Missouri","Harrison County",5,48,76,39,37
050,29,081,"Missouri","Harrison County",5,49,87,49,38
050,29,081,"Missouri","Harrison County",5,50,90,45,45
050,29,081,"Missouri","Harrison County",5,51,95,47,48
050,29,081,"Missouri","Harrison County",5,52,106,53,53
050,29,081,"Missouri","Harrison County",5,53,88,42,46
050,29,081,"Missouri","Harrison County",5,54,76,41,35
050,29,081,"Missouri","Harrison County",5,55,79,44,35
050,29,081,"Missouri","Harrison County",5,56,90,40,50
050,29,081,"Missouri","Harrison County",5,57,106,54,52
050,29,081,"Missouri","Harrison County",5,58,100,53,47
050,29,081,"Missouri","Harrison County",5,59,112,61,51
050,29,081,"Missouri","Harrison County",5,60,120,66,54
050,29,081,"Missouri","Harrison County",5,61,119,58,61
050,29,081,"Missouri","Harrison County",5,62,115,60,55
050,29,081,"Missouri","Harrison County",5,63,106,49,57
050,29,081,"Missouri","Harrison County",5,64,115,56,59
050,29,081,"Missouri","Harrison County",5,65,114,52,62
050,29,081,"Missouri","Harrison County",5,66,139,67,72
050,29,081,"Missouri","Harrison County",5,67,112,50,62
050,29,081,"Missouri","Harrison County",5,68,117,54,63
050,29,081,"Missouri","Harrison County",5,69,102,48,54
050,29,081,"Missouri","Harrison County",5,70,88,46,42
050,29,081,"Missouri","Harrison County",5,71,100,49,51
050,29,081,"Missouri","Harrison County",5,72,96,47,49
050,29,081,"Missouri","Harrison County",5,73,87,39,48
050,29,081,"Missouri","Harrison County",5,74,74,37,37
050,29,081,"Missouri","Harrison County",5,75,86,48,38
050,29,081,"Missouri","Harrison County",5,76,85,44,41
050,29,081,"Missouri","Harrison County",5,77,58,28,30
050,29,081,"Missouri","Harrison County",5,78,51,20,31
050,29,081,"Missouri","Harrison County",5,79,59,25,34
050,29,081,"Missouri","Harrison County",5,80,73,34,39
050,29,081,"Missouri","Harrison County",5,81,61,29,32
050,29,081,"Missouri","Harrison County",5,82,48,22,26
050,29,081,"Missouri","Harrison County",5,83,42,19,23
050,29,081,"Missouri","Harrison County",5,84,38,7,31
050,29,081,"Missouri","Harrison County",5,85,263,85,178
050,29,083,"Missouri","Henry County",1,0,267,137,130
050,29,083,"Missouri","Henry County",1,1,279,141,138
050,29,083,"Missouri","Henry County",1,2,247,135,112
050,29,083,"Missouri","Henry County",1,3,252,119,133
050,29,083,"Missouri","Henry County",1,4,265,141,124
050,29,083,"Missouri","Henry County",1,5,273,137,136
050,29,083,"Missouri","Henry County",1,6,287,149,138
050,29,083,"Missouri","Henry County",1,7,287,150,137
050,29,083,"Missouri","Henry County",1,8,266,144,122
050,29,083,"Missouri","Henry County",1,9,273,133,140
050,29,083,"Missouri","Henry County",1,10,267,140,127
050,29,083,"Missouri","Henry County",1,11,274,145,129
050,29,083,"Missouri","Henry County",1,12,284,147,137
050,29,083,"Missouri","Henry County",1,13,297,147,150
050,29,083,"Missouri","Henry County",1,14,269,134,135
050,29,083,"Missouri","Henry County",1,15,256,124,132
050,29,083,"Missouri","Henry County",1,16,267,142,125
050,29,083,"Missouri","Henry County",1,17,283,131,152
050,29,083,"Missouri","Henry County",1,18,231,126,105
050,29,083,"Missouri","Henry County",1,19,194,105,89
050,29,083,"Missouri","Henry County",1,20,229,117,112
050,29,083,"Missouri","Henry County",1,21,215,108,107
050,29,083,"Missouri","Henry County",1,22,214,109,105
050,29,083,"Missouri","Henry County",1,23,227,118,109
050,29,083,"Missouri","Henry County",1,24,221,101,120
050,29,083,"Missouri","Henry County",1,25,211,110,101
050,29,083,"Missouri","Henry County",1,26,223,120,103
050,29,083,"Missouri","Henry County",1,27,240,121,119
050,29,083,"Missouri","Henry County",1,28,237,114,123
050,29,083,"Missouri","Henry County",1,29,228,113,115
050,29,083,"Missouri","Henry County",1,30,237,114,123
050,29,083,"Missouri","Henry County",1,31,264,128,136
050,29,083,"Missouri","Henry County",1,32,246,120,126
050,29,083,"Missouri","Henry County",1,33,246,122,124
050,29,083,"Missouri","Henry County",1,34,259,130,129
050,29,083,"Missouri","Henry County",1,35,254,122,132
050,29,083,"Missouri","Henry County",1,36,235,113,122
050,29,083,"Missouri","Henry County",1,37,236,121,115
050,29,083,"Missouri","Henry County",1,38,240,119,121
050,29,083,"Missouri","Henry County",1,39,250,118,132
050,29,083,"Missouri","Henry County",1,40,269,134,135
050,29,083,"Missouri","Henry County",1,41,263,134,129
050,29,083,"Missouri","Henry County",1,42,241,121,120
050,29,083,"Missouri","Henry County",1,43,241,124,117
050,29,083,"Missouri","Henry County",1,44,225,111,114
050,29,083,"Missouri","Henry County",1,45,222,123,99
050,29,083,"Missouri","Henry County",1,46,220,110,110
050,29,083,"Missouri","Henry County",1,47,254,128,126
050,29,083,"Missouri","Henry County",1,48,255,132,123
050,29,083,"Missouri","Henry County",1,49,274,130,144
050,29,083,"Missouri","Henry County",1,50,253,134,119
050,29,083,"Missouri","Henry County",1,51,236,115,121
050,29,083,"Missouri","Henry County",1,52,255,127,128
050,29,083,"Missouri","Henry County",1,53,279,141,138
050,29,083,"Missouri","Henry County",1,54,283,154,129
050,29,083,"Missouri","Henry County",1,55,297,162,135
050,29,083,"Missouri","Henry County",1,56,325,169,156
050,29,083,"Missouri","Henry County",1,57,305,155,150
050,29,083,"Missouri","Henry County",1,58,347,165,182
050,29,083,"Missouri","Henry County",1,59,361,183,178
050,29,083,"Missouri","Henry County",1,60,340,176,164
050,29,083,"Missouri","Henry County",1,61,335,170,165
050,29,083,"Missouri","Henry County",1,62,328,163,165
050,29,083,"Missouri","Henry County",1,63,307,139,168
050,29,083,"Missouri","Henry County",1,64,319,155,164
050,29,083,"Missouri","Henry County",1,65,340,165,175
050,29,083,"Missouri","Henry County",1,66,310,143,167
050,29,083,"Missouri","Henry County",1,67,291,143,148
050,29,083,"Missouri","Henry County",1,68,296,134,162
050,29,083,"Missouri","Henry County",1,69,264,126,138
050,29,083,"Missouri","Henry County",1,70,262,129,133
050,29,083,"Missouri","Henry County",1,71,262,135,127
050,29,083,"Missouri","Henry County",1,72,266,134,132
050,29,083,"Missouri","Henry County",1,73,317,154,163
050,29,083,"Missouri","Henry County",1,74,209,100,109
050,29,083,"Missouri","Henry County",1,75,206,94,112
050,29,083,"Missouri","Henry County",1,76,189,90,99
050,29,083,"Missouri","Henry County",1,77,198,93,105
050,29,083,"Missouri","Henry County",1,78,167,81,86
050,29,083,"Missouri","Henry County",1,79,167,74,93
050,29,083,"Missouri","Henry County",1,80,149,66,83
050,29,083,"Missouri","Henry County",1,81,123,58,65
050,29,083,"Missouri","Henry County",1,82,125,58,67
050,29,083,"Missouri","Henry County",1,83,91,35,56
050,29,083,"Missouri","Henry County",1,84,107,42,65
050,29,083,"Missouri","Henry County",1,85,542,195,347
050,29,083,"Missouri","Henry County",2,0,264,134,130
050,29,083,"Missouri","Henry County",2,1,273,139,134
050,29,083,"Missouri","Henry County",2,2,257,138,119
050,29,083,"Missouri","Henry County",2,3,251,123,128
050,29,083,"Missouri","Henry County",2,4,266,137,129
050,29,083,"Missouri","Henry County",2,5,271,137,134
050,29,083,"Missouri","Henry County",2,6,286,148,138
050,29,083,"Missouri","Henry County",2,7,288,151,137
050,29,083,"Missouri","Henry County",2,8,269,145,124
050,29,083,"Missouri","Henry County",2,9,270,136,134
050,29,083,"Missouri","Henry County",2,10,269,139,130
050,29,083,"Missouri","Henry County",2,11,272,144,128
050,29,083,"Missouri","Henry County",2,12,287,150,137
050,29,083,"Missouri","Henry County",2,13,294,146,148
050,29,083,"Missouri","Henry County",2,14,276,137,139
050,29,083,"Missouri","Henry County",2,15,258,127,131
050,29,083,"Missouri","Henry County",2,16,266,139,127
050,29,083,"Missouri","Henry County",2,17,277,132,145
050,29,083,"Missouri","Henry County",2,18,234,123,111
050,29,083,"Missouri","Henry County",2,19,194,105,89
050,29,083,"Missouri","Henry County",2,20,228,117,111
050,29,083,"Missouri","Henry County",2,21,223,112,111
050,29,083,"Missouri","Henry County",2,22,216,109,107
050,29,083,"Missouri","Henry County",2,23,229,117,112
050,29,083,"Missouri","Henry County",2,24,224,106,118
050,29,083,"Missouri","Henry County",2,25,214,110,104
050,29,083,"Missouri","Henry County",2,26,218,117,101
050,29,083,"Missouri","Henry County",2,27,236,122,114
050,29,083,"Missouri","Henry County",2,28,236,114,122
050,29,083,"Missouri","Henry County",2,29,236,116,120
050,29,083,"Missouri","Henry County",2,30,241,116,125
050,29,083,"Missouri","Henry County",2,31,258,124,134
050,29,083,"Missouri","Henry County",2,32,250,122,128
050,29,083,"Missouri","Henry County",2,33,249,122,127
050,29,083,"Missouri","Henry County",2,34,256,127,129
050,29,083,"Missouri","Henry County",2,35,257,124,133
050,29,083,"Missouri","Henry County",2,36,235,113,122
050,29,083,"Missouri","Henry County",2,37,237,119,118
050,29,083,"Missouri","Henry County",2,38,241,120,121
050,29,083,"Missouri","Henry County",2,39,247,119,128
050,29,083,"Missouri","Henry County",2,40,268,132,136
050,29,083,"Missouri","Henry County",2,41,262,133,129
050,29,083,"Missouri","Henry County",2,42,247,124,123
050,29,083,"Missouri","Henry County",2,43,245,125,120
050,29,083,"Missouri","Henry County",2,44,228,113,115
050,29,083,"Missouri","Henry County",2,45,225,122,103
050,29,083,"Missouri","Henry County",2,46,220,113,107
050,29,083,"Missouri","Henry County",2,47,244,124,120
050,29,083,"Missouri","Henry County",2,48,256,131,125
050,29,083,"Missouri","Henry County",2,49,271,132,139
050,29,083,"Missouri","Henry County",2,50,257,133,124
050,29,083,"Missouri","Henry County",2,51,239,119,120
050,29,083,"Missouri","Henry County",2,52,250,124,126
050,29,083,"Missouri","Henry County",2,53,275,138,137
050,29,083,"Missouri","Henry County",2,54,282,152,130
050,29,083,"Missouri","Henry County",2,55,291,159,132
050,29,083,"Missouri","Henry County",2,56,320,169,151
050,29,083,"Missouri","Henry County",2,57,310,159,151
050,29,083,"Missouri","Henry County",2,58,334,161,173
050,29,083,"Missouri","Henry County",2,59,360,181,179
050,29,083,"Missouri","Henry County",2,60,344,178,166
050,29,083,"Missouri","Henry County",2,61,334,171,163
050,29,083,"Missouri","Henry County",2,62,328,162,166
050,29,083,"Missouri","Henry County",2,63,317,147,170
050,29,083,"Missouri","Henry County",2,64,313,149,164
050,29,083,"Missouri","Henry County",2,65,335,162,173
050,29,083,"Missouri","Henry County",2,66,314,147,167
050,29,083,"Missouri","Henry County",2,67,295,143,152
050,29,083,"Missouri","Henry County",2,68,293,137,156
050,29,083,"Missouri","Henry County",2,69,272,127,145
050,29,083,"Missouri","Henry County",2,70,262,130,132
050,29,083,"Missouri","Henry County",2,71,263,134,129
050,29,083,"Missouri","Henry County",2,72,257,130,127
050,29,083,"Missouri","Henry County",2,73,318,156,162
050,29,083,"Missouri","Henry County",2,74,217,104,113
050,29,083,"Missouri","Henry County",2,75,207,94,113
050,29,083,"Missouri","Henry County",2,76,188,87,101
050,29,083,"Missouri","Henry County",2,77,202,95,107
050,29,083,"Missouri","Henry County",2,78,170,83,87
050,29,083,"Missouri","Henry County",2,79,167,75,92
050,29,083,"Missouri","Henry County",2,80,150,67,83
050,29,083,"Missouri","Henry County",2,81,127,58,69
050,29,083,"Missouri","Henry County",2,82,125,58,67
050,29,083,"Missouri","Henry County",2,83,93,38,55
050,29,083,"Missouri","Henry County",2,84,101,38,63
050,29,083,"Missouri","Henry County",2,85,547,196,351
050,29,083,"Missouri","Henry County",3,0,233,129,104
050,29,083,"Missouri","Henry County",3,1,282,152,130
050,29,083,"Missouri","Henry County",3,2,277,142,135
050,29,083,"Missouri","Henry County",3,3,264,140,124
050,29,083,"Missouri","Henry County",3,4,253,127,126
050,29,083,"Missouri","Henry County",3,5,268,138,130
050,29,083,"Missouri","Henry County",3,6,280,140,140
050,29,083,"Missouri","Henry County",3,7,292,145,147
050,29,083,"Missouri","Henry County",3,8,282,142,140
050,29,083,"Missouri","Henry County",3,9,266,141,125
050,29,083,"Missouri","Henry County",3,10,272,135,137
050,29,083,"Missouri","Henry County",3,11,272,139,133
050,29,083,"Missouri","Henry County",3,12,280,148,132
050,29,083,"Missouri","Henry County",3,13,297,145,152
050,29,083,"Missouri","Henry County",3,14,294,148,146
050,29,083,"Missouri","Henry County",3,15,277,140,137
050,29,083,"Missouri","Henry County",3,16,271,136,135
050,29,083,"Missouri","Henry County",3,17,269,142,127
050,29,083,"Missouri","Henry County",3,18,242,124,118
050,29,083,"Missouri","Henry County",3,19,194,100,94
050,29,083,"Missouri","Henry County",3,20,216,109,107
050,29,083,"Missouri","Henry County",3,21,247,132,115
050,29,083,"Missouri","Henry County",3,22,236,120,116
050,29,083,"Missouri","Henry County",3,23,250,127,123
050,29,083,"Missouri","Henry County",3,24,235,126,109
050,29,083,"Missouri","Henry County",3,25,234,113,121
050,29,083,"Missouri","Henry County",3,26,225,112,113
050,29,083,"Missouri","Henry County",3,27,235,125,110
050,29,083,"Missouri","Henry County",3,28,233,124,109
050,29,083,"Missouri","Henry County",3,29,241,115,126
050,29,083,"Missouri","Henry County",3,30,233,113,120
050,29,083,"Missouri","Henry County",3,31,258,126,132
050,29,083,"Missouri","Henry County",3,32,260,126,134
050,29,083,"Missouri","Henry County",3,33,246,124,122
050,29,083,"Missouri","Henry County",3,34,243,114,129
050,29,083,"Missouri","Henry County",3,35,258,130,128
050,29,083,"Missouri","Henry County",3,36,254,126,128
050,29,083,"Missouri","Henry County",3,37,238,114,124
050,29,083,"Missouri","Henry County",3,38,249,122,127
050,29,083,"Missouri","Henry County",3,39,241,123,118
050,29,083,"Missouri","Henry County",3,40,264,132,132
050,29,083,"Missouri","Henry County",3,41,273,134,139
050,29,083,"Missouri","Henry County",3,42,260,134,126
050,29,083,"Missouri","Henry County",3,43,253,130,123
050,29,083,"Missouri","Henry County",3,44,234,117,117
050,29,083,"Missouri","Henry County",3,45,232,117,115
050,29,083,"Missouri","Henry County",3,46,224,112,112
050,29,083,"Missouri","Henry County",3,47,226,116,110
050,29,083,"Missouri","Henry County",3,48,246,128,118
050,29,083,"Missouri","Henry County",3,49,275,141,134
050,29,083,"Missouri","Henry County",3,50,276,134,142
050,29,083,"Missouri","Henry County",3,51,258,128,130
050,29,083,"Missouri","Henry County",3,52,236,117,119
050,29,083,"Missouri","Henry County",3,53,254,128,126
050,29,083,"Missouri","Henry County",3,54,280,148,132
050,29,083,"Missouri","Henry County",3,55,269,139,130
050,29,083,"Missouri","Henry County",3,56,286,160,126
050,29,083,"Missouri","Henry County",3,57,336,172,164
050,29,083,"Missouri","Henry County",3,58,312,158,154
050,29,083,"Missouri","Henry County",3,59,330,157,173
050,29,083,"Missouri","Henry County",3,60,369,189,180
050,29,083,"Missouri","Henry County",3,61,347,177,170
050,29,083,"Missouri","Henry County",3,62,342,177,165
050,29,083,"Missouri","Henry County",3,63,342,173,169
050,29,083,"Missouri","Henry County",3,64,323,141,182
050,29,083,"Missouri","Henry County",3,65,315,151,164
050,29,083,"Missouri","Henry County",3,66,328,158,170
050,29,083,"Missouri","Henry County",3,67,311,150,161
050,29,083,"Missouri","Henry County",3,68,299,145,154
050,29,083,"Missouri","Henry County",3,69,285,131,154
050,29,083,"Missouri","Henry County",3,70,271,126,145
050,29,083,"Missouri","Henry County",3,71,262,130,132
050,29,083,"Missouri","Henry County",3,72,246,125,121
050,29,083,"Missouri","Henry County",3,73,265,135,130
050,29,083,"Missouri","Henry County",3,74,302,143,159
050,29,083,"Missouri","Henry County",3,75,207,104,103
050,29,083,"Missouri","Henry County",3,76,190,87,103
050,29,083,"Missouri","Henry County",3,77,186,78,108
050,29,083,"Missouri","Henry County",3,78,181,86,95
050,29,083,"Missouri","Henry County",3,79,164,74,90
050,29,083,"Missouri","Henry County",3,80,141,70,71
050,29,083,"Missouri","Henry County",3,81,142,58,84
050,29,083,"Missouri","Henry County",3,82,119,53,66
050,29,083,"Missouri","Henry County",3,83,109,55,54
050,29,083,"Missouri","Henry County",3,84,84,28,56
050,29,083,"Missouri","Henry County",3,85,557,205,352
050,29,083,"Missouri","Henry County",4,0,251,139,112
050,29,083,"Missouri","Henry County",4,1,253,134,119
050,29,083,"Missouri","Henry County",4,2,293,159,134
050,29,083,"Missouri","Henry County",4,3,291,150,141
050,29,083,"Missouri","Henry County",4,4,271,157,114
050,29,083,"Missouri","Henry County",4,5,253,130,123
050,29,083,"Missouri","Henry County",4,6,281,143,138
050,29,083,"Missouri","Henry County",4,7,290,144,146
050,29,083,"Missouri","Henry County",4,8,298,151,147
050,29,083,"Missouri","Henry County",4,9,276,142,134
050,29,083,"Missouri","Henry County",4,10,277,147,130
050,29,083,"Missouri","Henry County",4,11,266,135,131
050,29,083,"Missouri","Henry County",4,12,290,143,147
050,29,083,"Missouri","Henry County",4,13,281,142,139
050,29,083,"Missouri","Henry County",4,14,291,144,147
050,29,083,"Missouri","Henry County",4,15,311,162,149
050,29,083,"Missouri","Henry County",4,16,290,144,146
050,29,083,"Missouri","Henry County",4,17,264,129,135
050,29,083,"Missouri","Henry County",4,18,225,119,106
050,29,083,"Missouri","Henry County",4,19,183,94,89
050,29,083,"Missouri","Henry County",4,20,210,106,104
050,29,083,"Missouri","Henry County",4,21,227,116,111
050,29,083,"Missouri","Henry County",4,22,240,126,114
050,29,083,"Missouri","Henry County",4,23,264,132,132
050,29,083,"Missouri","Henry County",4,24,248,118,130
050,29,083,"Missouri","Henry County",4,25,235,124,111
050,29,083,"Missouri","Henry County",4,26,240,116,124
050,29,083,"Missouri","Henry County",4,27,239,124,115
050,29,083,"Missouri","Henry County",4,28,236,127,109
050,29,083,"Missouri","Henry County",4,29,241,133,108
050,29,083,"Missouri","Henry County",4,30,236,113,123
050,29,083,"Missouri","Henry County",4,31,242,119,123
050,29,083,"Missouri","Henry County",4,32,246,120,126
050,29,083,"Missouri","Henry County",4,33,270,136,134
050,29,083,"Missouri","Henry County",4,34,260,124,136
050,29,083,"Missouri","Henry County",4,35,234,105,129
050,29,083,"Missouri","Henry County",4,36,279,139,140
050,29,083,"Missouri","Henry County",4,37,257,127,130
050,29,083,"Missouri","Henry County",4,38,240,119,121
050,29,083,"Missouri","Henry County",4,39,253,125,128
050,29,083,"Missouri","Henry County",4,40,250,127,123
050,29,083,"Missouri","Henry County",4,41,266,139,127
050,29,083,"Missouri","Henry County",4,42,287,147,140
050,29,083,"Missouri","Henry County",4,43,277,143,134
050,29,083,"Missouri","Henry County",4,44,249,126,123
050,29,083,"Missouri","Henry County",4,45,239,122,117
050,29,083,"Missouri","Henry County",4,46,235,115,120
050,29,083,"Missouri","Henry County",4,47,228,117,111
050,29,083,"Missouri","Henry County",4,48,224,113,111
050,29,083,"Missouri","Henry County",4,49,248,134,114
050,29,083,"Missouri","Henry County",4,50,277,149,128
050,29,083,"Missouri","Henry County",4,51,271,126,145
050,29,083,"Missouri","Henry County",4,52,250,123,127
050,29,083,"Missouri","Henry County",4,53,240,123,117
050,29,083,"Missouri","Henry County",4,54,277,137,140
050,29,083,"Missouri","Henry County",4,55,284,149,135
050,29,083,"Missouri","Henry County",4,56,282,142,140
050,29,083,"Missouri","Henry County",4,57,280,154,126
050,29,083,"Missouri","Henry County",4,58,328,172,156
050,29,083,"Missouri","Henry County",4,59,311,154,157
050,29,083,"Missouri","Henry County",4,60,332,156,176
050,29,083,"Missouri","Henry County",4,61,366,188,178
050,29,083,"Missouri","Henry County",4,62,346,176,170
050,29,083,"Missouri","Henry County",4,63,353,179,174
050,29,083,"Missouri","Henry County",4,64,333,174,159
050,29,083,"Missouri","Henry County",4,65,314,139,175
050,29,083,"Missouri","Henry County",4,66,303,142,161
050,29,083,"Missouri","Henry County",4,67,324,153,171
050,29,083,"Missouri","Henry County",4,68,313,153,160
050,29,083,"Missouri","Henry County",4,69,289,138,151
050,29,083,"Missouri","Henry County",4,70,290,135,155
050,29,083,"Missouri","Henry County",4,71,269,123,146
050,29,083,"Missouri","Henry County",4,72,261,131,130
050,29,083,"Missouri","Henry County",4,73,248,126,122
050,29,083,"Missouri","Henry County",4,74,261,125,136
050,29,083,"Missouri","Henry County",4,75,289,140,149
050,29,083,"Missouri","Henry County",4,76,193,98,95
050,29,083,"Missouri","Henry County",4,77,189,83,106
050,29,083,"Missouri","Henry County",4,78,166,69,97
050,29,083,"Missouri","Henry County",4,79,187,85,102
050,29,083,"Missouri","Henry County",4,80,143,69,74
050,29,083,"Missouri","Henry County",4,81,137,63,74
050,29,083,"Missouri","Henry County",4,82,136,56,80
050,29,083,"Missouri","Henry County",4,83,94,44,50
050,29,083,"Missouri","Henry County",4,84,102,48,54
050,29,083,"Missouri","Henry County",4,85,548,189,359
050,29,083,"Missouri","Henry County",5,0,248,137,111
050,29,083,"Missouri","Henry County",5,1,267,143,124
050,29,083,"Missouri","Henry County",5,2,250,134,116
050,29,083,"Missouri","Henry County",5,3,298,159,139
050,29,083,"Missouri","Henry County",5,4,284,143,141
050,29,083,"Missouri","Henry County",5,5,270,145,125
050,29,083,"Missouri","Henry County",5,6,258,133,125
050,29,083,"Missouri","Henry County",5,7,290,146,144
050,29,083,"Missouri","Henry County",5,8,284,131,153
050,29,083,"Missouri","Henry County",5,9,304,158,146
050,29,083,"Missouri","Henry County",5,10,275,146,129
050,29,083,"Missouri","Henry County",5,11,268,145,123
050,29,083,"Missouri","Henry County",5,12,275,143,132
050,29,083,"Missouri","Henry County",5,13,283,135,148
050,29,083,"Missouri","Henry County",5,14,284,146,138
050,29,083,"Missouri","Henry County",5,15,297,147,150
050,29,083,"Missouri","Henry County",5,16,326,163,163
050,29,083,"Missouri","Henry County",5,17,286,142,144
050,29,083,"Missouri","Henry County",5,18,228,119,109
050,29,083,"Missouri","Henry County",5,19,180,99,81
050,29,083,"Missouri","Henry County",5,20,197,94,103
050,29,083,"Missouri","Henry County",5,21,229,115,114
050,29,083,"Missouri","Henry County",5,22,228,110,118
050,29,083,"Missouri","Henry County",5,23,254,135,119
050,29,083,"Missouri","Henry County",5,24,263,133,130
050,29,083,"Missouri","Henry County",5,25,240,116,124
050,29,083,"Missouri","Henry County",5,26,248,129,119
050,29,083,"Missouri","Henry County",5,27,236,110,126
050,29,083,"Missouri","Henry County",5,28,232,117,115
050,29,083,"Missouri","Henry County",5,29,239,133,106
050,29,083,"Missouri","Henry County",5,30,230,124,106
050,29,083,"Missouri","Henry County",5,31,239,107,132
050,29,083,"Missouri","Henry County",5,32,258,131,127
050,29,083,"Missouri","Henry County",5,33,248,124,124
050,29,083,"Missouri","Henry County",5,34,267,134,133
050,29,083,"Missouri","Henry County",5,35,264,122,142
050,29,083,"Missouri","Henry County",5,36,238,103,135
050,29,083,"Missouri","Henry County",5,37,283,139,144
050,29,083,"Missouri","Henry County",5,38,267,137,130
050,29,083,"Missouri","Henry County",5,39,249,120,129
050,29,083,"Missouri","Henry County",5,40,245,119,126
050,29,083,"Missouri","Henry County",5,41,240,123,117
050,29,083,"Missouri","Henry County",5,42,270,139,131
050,29,083,"Missouri","Henry County",5,43,300,155,145
050,29,083,"Missouri","Henry County",5,44,282,148,134
050,29,083,"Missouri","Henry County",5,45,252,130,122
050,29,083,"Missouri","Henry County",5,46,226,114,112
050,29,083,"Missouri","Henry County",5,47,233,114,119
050,29,083,"Missouri","Henry County",5,48,227,114,113
050,29,083,"Missouri","Henry County",5,49,228,114,114
050,29,083,"Missouri","Henry County",5,50,251,135,116
050,29,083,"Missouri","Henry County",5,51,294,159,135
050,29,083,"Missouri","Henry County",5,52,272,129,143
050,29,083,"Missouri","Henry County",5,53,251,123,128
050,29,083,"Missouri","Henry County",5,54,262,132,130
050,29,083,"Missouri","Henry County",5,55,266,128,138
050,29,083,"Missouri","Henry County",5,56,292,154,138
050,29,083,"Missouri","Henry County",5,57,281,135,146
050,29,083,"Missouri","Henry County",5,58,291,159,132
050,29,083,"Missouri","Henry County",5,59,332,172,160
050,29,083,"Missouri","Henry County",5,60,314,151,163
050,29,083,"Missouri","Henry County",5,61,344,167,177
050,29,083,"Missouri","Henry County",5,62,359,188,171
050,29,083,"Missouri","Henry County",5,63,349,171,178
050,29,083,"Missouri","Henry County",5,64,349,178,171
050,29,083,"Missouri","Henry County",5,65,336,178,158
050,29,083,"Missouri","Henry County",5,66,314,140,174
050,29,083,"Missouri","Henry County",5,67,300,140,160
050,29,083,"Missouri","Henry County",5,68,311,150,161
050,29,083,"Missouri","Henry County",5,69,305,144,161
050,29,083,"Missouri","Henry County",5,70,284,136,148
050,29,083,"Missouri","Henry County",5,71,274,123,151
050,29,083,"Missouri","Henry County",5,72,258,119,139
050,29,083,"Missouri","Henry County",5,73,256,128,128
050,29,083,"Missouri","Henry County",5,74,244,120,124
050,29,083,"Missouri","Henry County",5,75,243,121,122
050,29,083,"Missouri","Henry County",5,76,267,133,134
050,29,083,"Missouri","Henry County",5,77,192,90,102
050,29,083,"Missouri","Henry County",5,78,173,77,96
050,29,083,"Missouri","Henry County",5,79,165,69,96
050,29,083,"Missouri","Henry County",5,80,164,80,84
050,29,083,"Missouri","Henry County",5,81,134,61,73
050,29,083,"Missouri","Henry County",5,82,136,61,75
050,29,083,"Missouri","Henry County",5,83,109,49,60
050,29,083,"Missouri","Henry County",5,84,86,39,47
050,29,083,"Missouri","Henry County",5,85,560,194,366
050,29,085,"Missouri","Hickory County",1,0,68,35,33
050,29,085,"Missouri","Hickory County",1,1,58,29,29
050,29,085,"Missouri","Hickory County",1,2,69,33,36
050,29,085,"Missouri","Hickory County",1,3,69,37,32
050,29,085,"Missouri","Hickory County",1,4,72,41,31
050,29,085,"Missouri","Hickory County",1,5,68,36,32
050,29,085,"Missouri","Hickory County",1,6,70,37,33
050,29,085,"Missouri","Hickory County",1,7,68,37,31
050,29,085,"Missouri","Hickory County",1,8,70,30,40
050,29,085,"Missouri","Hickory County",1,9,74,40,34
050,29,085,"Missouri","Hickory County",1,10,80,42,38
050,29,085,"Missouri","Hickory County",1,11,68,36,32
050,29,085,"Missouri","Hickory County",1,12,83,42,41
050,29,085,"Missouri","Hickory County",1,13,96,40,56
050,29,085,"Missouri","Hickory County",1,14,89,41,48
050,29,085,"Missouri","Hickory County",1,15,90,44,46
050,29,085,"Missouri","Hickory County",1,16,93,46,47
050,29,085,"Missouri","Hickory County",1,17,79,43,36
050,29,085,"Missouri","Hickory County",1,18,73,36,37
050,29,085,"Missouri","Hickory County",1,19,55,26,29
050,29,085,"Missouri","Hickory County",1,20,64,32,32
050,29,085,"Missouri","Hickory County",1,21,52,26,26
050,29,085,"Missouri","Hickory County",1,22,46,21,25
050,29,085,"Missouri","Hickory County",1,23,62,31,31
050,29,085,"Missouri","Hickory County",1,24,58,28,30
050,29,085,"Missouri","Hickory County",1,25,49,24,25
050,29,085,"Missouri","Hickory County",1,26,65,33,32
050,29,085,"Missouri","Hickory County",1,27,59,28,31
050,29,085,"Missouri","Hickory County",1,28,63,32,31
050,29,085,"Missouri","Hickory County",1,29,56,30,26
050,29,085,"Missouri","Hickory County",1,30,65,35,30
050,29,085,"Missouri","Hickory County",1,31,62,27,35
050,29,085,"Missouri","Hickory County",1,32,59,29,30
050,29,085,"Missouri","Hickory County",1,33,64,31,33
050,29,085,"Missouri","Hickory County",1,34,74,44,30
050,29,085,"Missouri","Hickory County",1,35,76,43,33
050,29,085,"Missouri","Hickory County",1,36,59,29,30
050,29,085,"Missouri","Hickory County",1,37,70,27,43
050,29,085,"Missouri","Hickory County",1,38,60,30,30
050,29,085,"Missouri","Hickory County",1,39,64,31,33
050,29,085,"Missouri","Hickory County",1,40,82,40,42
050,29,085,"Missouri","Hickory County",1,41,86,43,43
050,29,085,"Missouri","Hickory County",1,42,80,40,40
050,29,085,"Missouri","Hickory County",1,43,61,27,34
050,29,085,"Missouri","Hickory County",1,44,51,25,26
050,29,085,"Missouri","Hickory County",1,45,62,31,31
050,29,085,"Missouri","Hickory County",1,46,77,31,46
050,29,085,"Missouri","Hickory County",1,47,90,46,44
050,29,085,"Missouri","Hickory County",1,48,96,48,48
050,29,085,"Missouri","Hickory County",1,49,93,46,47
050,29,085,"Missouri","Hickory County",1,50,96,51,45
050,29,085,"Missouri","Hickory County",1,51,92,48,44
050,29,085,"Missouri","Hickory County",1,52,101,53,48
050,29,085,"Missouri","Hickory County",1,53,126,66,60
050,29,085,"Missouri","Hickory County",1,54,104,57,47
050,29,085,"Missouri","Hickory County",1,55,108,50,58
050,29,085,"Missouri","Hickory County",1,56,131,60,71
050,29,085,"Missouri","Hickory County",1,57,141,63,78
050,29,085,"Missouri","Hickory County",1,58,151,79,72
050,29,085,"Missouri","Hickory County",1,59,162,79,83
050,29,085,"Missouri","Hickory County",1,60,154,65,89
050,29,085,"Missouri","Hickory County",1,61,157,78,79
050,29,085,"Missouri","Hickory County",1,62,161,80,81
050,29,085,"Missouri","Hickory County",1,63,165,83,82
050,29,085,"Missouri","Hickory County",1,64,162,74,88
050,29,085,"Missouri","Hickory County",1,65,145,68,77
050,29,085,"Missouri","Hickory County",1,66,176,86,90
050,29,085,"Missouri","Hickory County",1,67,143,74,69
050,29,085,"Missouri","Hickory County",1,68,147,69,78
050,29,085,"Missouri","Hickory County",1,69,158,70,88
050,29,085,"Missouri","Hickory County",1,70,173,91,82
050,29,085,"Missouri","Hickory County",1,71,146,71,75
050,29,085,"Missouri","Hickory County",1,72,158,79,79
050,29,085,"Missouri","Hickory County",1,73,167,91,76
050,29,085,"Missouri","Hickory County",1,74,115,56,59
050,29,085,"Missouri","Hickory County",1,75,135,71,64
050,29,085,"Missouri","Hickory County",1,76,127,65,62
050,29,085,"Missouri","Hickory County",1,77,119,66,53
050,29,085,"Missouri","Hickory County",1,78,105,53,52
050,29,085,"Missouri","Hickory County",1,79,96,49,47
050,29,085,"Missouri","Hickory County",1,80,89,44,45
050,29,085,"Missouri","Hickory County",1,81,70,32,38
050,29,085,"Missouri","Hickory County",1,82,61,30,31
050,29,085,"Missouri","Hickory County",1,83,60,29,31
050,29,085,"Missouri","Hickory County",1,84,55,24,31
050,29,085,"Missouri","Hickory County",1,85,321,131,190
050,29,085,"Missouri","Hickory County",2,0,70,34,36
050,29,085,"Missouri","Hickory County",2,1,60,30,30
050,29,085,"Missouri","Hickory County",2,2,67,32,35
050,29,085,"Missouri","Hickory County",2,3,68,35,33
050,29,085,"Missouri","Hickory County",2,4,72,42,30
050,29,085,"Missouri","Hickory County",2,5,69,37,32
050,29,085,"Missouri","Hickory County",2,6,72,38,34
050,29,085,"Missouri","Hickory County",2,7,67,36,31
050,29,085,"Missouri","Hickory County",2,8,69,31,38
050,29,085,"Missouri","Hickory County",2,9,73,37,36
050,29,085,"Missouri","Hickory County",2,10,79,42,37
050,29,085,"Missouri","Hickory County",2,11,72,38,34
050,29,085,"Missouri","Hickory County",2,12,81,41,40
050,29,085,"Missouri","Hickory County",2,13,94,41,53
050,29,085,"Missouri","Hickory County",2,14,92,42,50
050,29,085,"Missouri","Hickory County",2,15,90,43,47
050,29,085,"Missouri","Hickory County",2,16,93,46,47
050,29,085,"Missouri","Hickory County",2,17,81,42,39
050,29,085,"Missouri","Hickory County",2,18,70,36,34
050,29,085,"Missouri","Hickory County",2,19,57,27,30
050,29,085,"Missouri","Hickory County",2,20,63,31,32
050,29,085,"Missouri","Hickory County",2,21,54,27,27
050,29,085,"Missouri","Hickory County",2,22,49,22,27
050,29,085,"Missouri","Hickory County",2,23,59,29,30
050,29,085,"Missouri","Hickory County",2,24,57,29,28
050,29,085,"Missouri","Hickory County",2,25,52,26,26
050,29,085,"Missouri","Hickory County",2,26,62,31,31
050,29,085,"Missouri","Hickory County",2,27,60,29,31
050,29,085,"Missouri","Hickory County",2,28,63,32,31
050,29,085,"Missouri","Hickory County",2,29,60,32,28
050,29,085,"Missouri","Hickory County",2,30,64,34,30
050,29,085,"Missouri","Hickory County",2,31,62,28,34
050,29,085,"Missouri","Hickory County",2,32,60,29,31
050,29,085,"Missouri","Hickory County",2,33,64,32,32
050,29,085,"Missouri","Hickory County",2,34,72,41,31
050,29,085,"Missouri","Hickory County",2,35,76,44,32
050,29,085,"Missouri","Hickory County",2,36,64,33,31
050,29,085,"Missouri","Hickory County",2,37,70,28,42
050,29,085,"Missouri","Hickory County",2,38,61,29,32
050,29,085,"Missouri","Hickory County",2,39,64,31,33
050,29,085,"Missouri","Hickory County",2,40,79,38,41
050,29,085,"Missouri","Hickory County",2,41,86,43,43
050,29,085,"Missouri","Hickory County",2,42,79,40,39
050,29,085,"Missouri","Hickory County",2,43,66,30,36
050,29,085,"Missouri","Hickory County",2,44,54,26,28
050,29,085,"Missouri","Hickory County",2,45,60,30,30
050,29,085,"Missouri","Hickory County",2,46,72,30,42
050,29,085,"Missouri","Hickory County",2,47,87,42,45
050,29,085,"Missouri","Hickory County",2,48,94,47,47
050,29,085,"Missouri","Hickory County",2,49,96,48,48
050,29,085,"Missouri","Hickory County",2,50,95,49,46
050,29,085,"Missouri","Hickory County",2,51,94,49,45
050,29,085,"Missouri","Hickory County",2,52,101,53,48
050,29,085,"Missouri","Hickory County",2,53,120,63,57
050,29,085,"Missouri","Hickory County",2,54,106,57,49
050,29,085,"Missouri","Hickory County",2,55,109,53,56
050,29,085,"Missouri","Hickory County",2,56,130,61,69
050,29,085,"Missouri","Hickory County",2,57,140,63,77
050,29,085,"Missouri","Hickory County",2,58,151,77,74
050,29,085,"Missouri","Hickory County",2,59,163,81,82
050,29,085,"Missouri","Hickory County",2,60,153,69,84
050,29,085,"Missouri","Hickory County",2,61,159,76,83
050,29,085,"Missouri","Hickory County",2,62,159,80,79
050,29,085,"Missouri","Hickory County",2,63,166,83,83
050,29,085,"Missouri","Hickory County",2,64,164,77,87
050,29,085,"Missouri","Hickory County",2,65,152,71,81
050,29,085,"Missouri","Hickory County",2,66,169,81,88
050,29,085,"Missouri","Hickory County",2,67,150,76,74
050,29,085,"Missouri","Hickory County",2,68,144,69,75
050,29,085,"Missouri","Hickory County",2,69,155,70,85
050,29,085,"Missouri","Hickory County",2,70,168,85,83
050,29,085,"Missouri","Hickory County",2,71,153,77,76
050,29,085,"Missouri","Hickory County",2,72,154,76,78
050,29,085,"Missouri","Hickory County",2,73,170,92,78
050,29,085,"Missouri","Hickory County",2,74,120,61,59
050,29,085,"Missouri","Hickory County",2,75,129,66,63
050,29,085,"Missouri","Hickory County",2,76,127,67,60
050,29,085,"Missouri","Hickory County",2,77,124,67,57
050,29,085,"Missouri","Hickory County",2,78,105,55,50
050,29,085,"Missouri","Hickory County",2,79,100,50,50
050,29,085,"Missouri","Hickory County",2,80,88,42,46
050,29,085,"Missouri","Hickory County",2,81,72,34,38
050,29,085,"Missouri","Hickory County",2,82,62,29,33
050,29,085,"Missouri","Hickory County",2,83,61,30,31
050,29,085,"Missouri","Hickory County",2,84,56,25,31
050,29,085,"Missouri","Hickory County",2,85,325,133,192
050,29,085,"Missouri","Hickory County",3,0,89,47,42
050,29,085,"Missouri","Hickory County",3,1,74,29,45
050,29,085,"Missouri","Hickory County",3,2,65,29,36
050,29,085,"Missouri","Hickory County",3,3,76,39,37
050,29,085,"Missouri","Hickory County",3,4,79,38,41
050,29,085,"Missouri","Hickory County",3,5,84,45,39
050,29,085,"Missouri","Hickory County",3,6,77,40,37
050,29,085,"Missouri","Hickory County",3,7,83,51,32
050,29,085,"Missouri","Hickory County",3,8,69,32,37
050,29,085,"Missouri","Hickory County",3,9,73,30,43
050,29,085,"Missouri","Hickory County",3,10,71,35,36
050,29,085,"Missouri","Hickory County",3,11,93,48,45
050,29,085,"Missouri","Hickory County",3,12,81,45,36
050,29,085,"Missouri","Hickory County",3,13,93,48,45
050,29,085,"Missouri","Hickory County",3,14,108,44,64
050,29,085,"Missouri","Hickory County",3,15,92,40,52
050,29,085,"Missouri","Hickory County",3,16,92,46,46
050,29,085,"Missouri","Hickory County",3,17,98,48,50
050,29,085,"Missouri","Hickory County",3,18,68,35,33
050,29,085,"Missouri","Hickory County",3,19,55,31,24
050,29,085,"Missouri","Hickory County",3,20,60,26,34
050,29,085,"Missouri","Hickory County",3,21,58,29,29
050,29,085,"Missouri","Hickory County",3,22,63,31,32
050,29,085,"Missouri","Hickory County",3,23,46,22,24
050,29,085,"Missouri","Hickory County",3,24,61,29,32
050,29,085,"Missouri","Hickory County",3,25,56,32,24
050,29,085,"Missouri","Hickory County",3,26,59,27,32
050,29,085,"Missouri","Hickory County",3,27,59,29,30
050,29,085,"Missouri","Hickory County",3,28,69,29,40
050,29,085,"Missouri","Hickory County",3,29,77,41,36
050,29,085,"Missouri","Hickory County",3,30,65,33,32
050,29,085,"Missouri","Hickory County",3,31,66,31,35
050,29,085,"Missouri","Hickory County",3,32,68,35,33
050,29,085,"Missouri","Hickory County",3,33,67,28,39
050,29,085,"Missouri","Hickory County",3,34,71,38,33
050,29,085,"Missouri","Hickory County",3,35,89,53,36
050,29,085,"Missouri","Hickory County",3,36,90,55,35
050,29,085,"Missouri","Hickory County",3,37,73,34,39
050,29,085,"Missouri","Hickory County",3,38,68,32,36
050,29,085,"Missouri","Hickory County",3,39,64,26,38
050,29,085,"Missouri","Hickory County",3,40,73,32,41
050,29,085,"Missouri","Hickory County",3,41,82,40,42
050,29,085,"Missouri","Hickory County",3,42,94,46,48
050,29,085,"Missouri","Hickory County",3,43,79,40,39
050,29,085,"Missouri","Hickory County",3,44,67,31,36
050,29,085,"Missouri","Hickory County",3,45,62,29,33
050,29,085,"Missouri","Hickory County",3,46,64,31,33
050,29,085,"Missouri","Hickory County",3,47,71,30,41
050,29,085,"Missouri","Hickory County",3,48,92,45,47
050,29,085,"Missouri","Hickory County",3,49,100,49,51
050,29,085,"Missouri","Hickory County",3,50,109,53,56
050,29,085,"Missouri","Hickory County",3,51,97,51,46
050,29,085,"Missouri","Hickory County",3,52,97,50,47
050,29,085,"Missouri","Hickory County",3,53,117,63,54
050,29,085,"Missouri","Hickory County",3,54,120,62,58
050,29,085,"Missouri","Hickory County",3,55,110,57,53
050,29,085,"Missouri","Hickory County",3,56,119,61,58
050,29,085,"Missouri","Hickory County",3,57,132,57,75
050,29,085,"Missouri","Hickory County",3,58,143,64,79
050,29,085,"Missouri","Hickory County",3,59,168,82,86
050,29,085,"Missouri","Hickory County",3,60,155,84,71
050,29,085,"Missouri","Hickory County",3,61,162,75,87
050,29,085,"Missouri","Hickory County",3,62,169,82,87
050,29,085,"Missouri","Hickory County",3,63,164,85,79
050,29,085,"Missouri","Hickory County",3,64,162,81,81
050,29,085,"Missouri","Hickory County",3,65,174,79,95
050,29,085,"Missouri","Hickory County",3,66,153,75,78
050,29,085,"Missouri","Hickory County",3,67,172,84,88
050,29,085,"Missouri","Hickory County",3,68,156,81,75
050,29,085,"Missouri","Hickory County",3,69,139,68,71
050,29,085,"Missouri","Hickory County",3,70,149,69,80
050,29,085,"Missouri","Hickory County",3,71,163,78,85
050,29,085,"Missouri","Hickory County",3,72,160,74,86
050,29,085,"Missouri","Hickory County",3,73,130,71,59
050,29,085,"Missouri","Hickory County",3,74,163,84,79
050,29,085,"Missouri","Hickory County",3,75,112,57,55
050,29,085,"Missouri","Hickory County",3,76,115,60,55
050,29,085,"Missouri","Hickory County",3,77,122,66,56
050,29,085,"Missouri","Hickory County",3,78,109,59,50
050,29,085,"Missouri","Hickory County",3,79,105,53,52
050,29,085,"Missouri","Hickory County",3,80,97,44,53
050,29,085,"Missouri","Hickory County",3,81,80,40,40
050,29,085,"Missouri","Hickory County",3,82,68,32,36
050,29,085,"Missouri","Hickory County",3,83,62,31,31
050,29,085,"Missouri","Hickory County",3,84,53,22,31
050,29,085,"Missouri","Hickory County",3,85,333,136,197
050,29,085,"Missouri","Hickory County",4,0,78,41,37
050,29,085,"Missouri","Hickory County",4,1,88,46,42
050,29,085,"Missouri","Hickory County",4,2,76,30,46
050,29,085,"Missouri","Hickory County",4,3,74,39,35
050,29,085,"Missouri","Hickory County",4,4,75,40,35
050,29,085,"Missouri","Hickory County",4,5,87,44,43
050,29,085,"Missouri","Hickory County",4,6,89,47,42
050,29,085,"Missouri","Hickory County",4,7,81,43,38
050,29,085,"Missouri","Hickory County",4,8,82,51,31
050,29,085,"Missouri","Hickory County",4,9,75,36,39
050,29,085,"Missouri","Hickory County",4,10,79,32,47
050,29,085,"Missouri","Hickory County",4,11,71,34,37
050,29,085,"Missouri","Hickory County",4,12,92,49,43
050,29,085,"Missouri","Hickory County",4,13,80,40,40
050,29,085,"Missouri","Hickory County",4,14,95,49,46
050,29,085,"Missouri","Hickory County",4,15,109,51,58
050,29,085,"Missouri","Hickory County",4,16,94,44,50
050,29,085,"Missouri","Hickory County",4,17,89,44,45
050,29,085,"Missouri","Hickory County",4,18,80,38,42
050,29,085,"Missouri","Hickory County",4,19,43,20,23
050,29,085,"Missouri","Hickory County",4,20,58,34,24
050,29,085,"Missouri","Hickory County",4,21,55,23,32
050,29,085,"Missouri","Hickory County",4,22,55,29,26
050,29,085,"Missouri","Hickory County",4,23,64,29,35
050,29,085,"Missouri","Hickory County",4,24,53,22,31
050,29,085,"Missouri","Hickory County",4,25,67,33,34
050,29,085,"Missouri","Hickory County",4,26,73,38,35
050,29,085,"Missouri","Hickory County",4,27,55,27,28
050,29,085,"Missouri","Hickory County",4,28,65,29,36
050,29,085,"Missouri","Hickory County",4,29,73,32,41
050,29,085,"Missouri","Hickory County",4,30,82,45,37
050,29,085,"Missouri","Hickory County",4,31,71,38,33
050,29,085,"Missouri","Hickory County",4,32,70,33,37
050,29,085,"Missouri","Hickory County",4,33,65,36,29
050,29,085,"Missouri","Hickory County",4,34,68,27,41
050,29,085,"Missouri","Hickory County",4,35,80,39,41
050,29,085,"Missouri","Hickory County",4,36,87,52,35
050,29,085,"Missouri","Hickory County",4,37,94,53,41
050,29,085,"Missouri","Hickory County",4,38,71,38,33
050,29,085,"Missouri","Hickory County",4,39,66,34,32
050,29,085,"Missouri","Hickory County",4,40,54,21,33
050,29,085,"Missouri","Hickory County",4,41,70,30,40
050,29,085,"Missouri","Hickory County",4,42,78,37,41
050,29,085,"Missouri","Hickory County",4,43,98,48,50
050,29,085,"Missouri","Hickory County",4,44,86,42,44
050,29,085,"Missouri","Hickory County",4,45,68,29,39
050,29,085,"Missouri","Hickory County",4,46,60,25,35
050,29,085,"Missouri","Hickory County",4,47,68,31,37
050,29,085,"Missouri","Hickory County",4,48,76,31,45
050,29,085,"Missouri","Hickory County",4,49,97,47,50
050,29,085,"Missouri","Hickory County",4,50,111,55,56
050,29,085,"Missouri","Hickory County",4,51,112,53,59
050,29,085,"Missouri","Hickory County",4,52,103,54,49
050,29,085,"Missouri","Hickory County",4,53,98,49,49
050,29,085,"Missouri","Hickory County",4,54,120,65,55
050,29,085,"Missouri","Hickory County",4,55,124,66,58
050,29,085,"Missouri","Hickory County",4,56,115,62,53
050,29,085,"Missouri","Hickory County",4,57,130,64,66
050,29,085,"Missouri","Hickory County",4,58,147,67,80
050,29,085,"Missouri","Hickory County",4,59,156,67,89
050,29,085,"Missouri","Hickory County",4,60,161,85,76
050,29,085,"Missouri","Hickory County",4,61,167,90,77
050,29,085,"Missouri","Hickory County",4,62,166,77,89
050,29,085,"Missouri","Hickory County",4,63,171,84,87
050,29,085,"Missouri","Hickory County",4,64,163,83,80
050,29,085,"Missouri","Hickory County",4,65,162,79,83
050,29,085,"Missouri","Hickory County",4,66,163,80,83
050,29,085,"Missouri","Hickory County",4,67,154,74,80
050,29,085,"Missouri","Hickory County",4,68,166,81,85
050,29,085,"Missouri","Hickory County",4,69,150,77,73
050,29,085,"Missouri","Hickory County",4,70,141,71,70
050,29,085,"Missouri","Hickory County",4,71,150,69,81
050,29,085,"Missouri","Hickory County",4,72,164,73,91
050,29,085,"Missouri","Hickory County",4,73,132,66,66
050,29,085,"Missouri","Hickory County",4,74,126,66,60
050,29,085,"Missouri","Hickory County",4,75,154,74,80
050,29,085,"Missouri","Hickory County",4,76,99,54,45
050,29,085,"Missouri","Hickory County",4,77,103,55,48
050,29,085,"Missouri","Hickory County",4,78,109,61,48
050,29,085,"Missouri","Hickory County",4,79,103,54,49
050,29,085,"Missouri","Hickory County",4,80,95,44,51
050,29,085,"Missouri","Hickory County",4,81,81,38,43
050,29,085,"Missouri","Hickory County",4,82,67,33,34
050,29,085,"Missouri","Hickory County",4,83,66,32,34
050,29,085,"Missouri","Hickory County",4,84,58,28,30
050,29,085,"Missouri","Hickory County",4,85,324,127,197
050,29,085,"Missouri","Hickory County",5,0,90,48,42
050,29,085,"Missouri","Hickory County",5,1,75,40,35
050,29,085,"Missouri","Hickory County",5,2,92,49,43
050,29,085,"Missouri","Hickory County",5,3,79,33,46
050,29,085,"Missouri","Hickory County",5,4,80,44,36
050,29,085,"Missouri","Hickory County",5,5,75,39,36
050,29,085,"Missouri","Hickory County",5,6,96,50,46
050,29,085,"Missouri","Hickory County",5,7,84,42,42
050,29,085,"Missouri","Hickory County",5,8,85,41,44
050,29,085,"Missouri","Hickory County",5,9,82,50,32
050,29,085,"Missouri","Hickory County",5,10,77,37,40
050,29,085,"Missouri","Hickory County",5,11,86,39,47
050,29,085,"Missouri","Hickory County",5,12,74,37,37
050,29,085,"Missouri","Hickory County",5,13,98,54,44
050,29,085,"Missouri","Hickory County",5,14,87,46,41
050,29,085,"Missouri","Hickory County",5,15,92,47,45
050,29,085,"Missouri","Hickory County",5,16,109,54,55
050,29,085,"Missouri","Hickory County",5,17,94,40,54
050,29,085,"Missouri","Hickory County",5,18,76,38,38
050,29,085,"Missouri","Hickory County",5,19,57,26,31
050,29,085,"Missouri","Hickory County",5,20,52,23,29
050,29,085,"Missouri","Hickory County",5,21,58,32,26
050,29,085,"Missouri","Hickory County",5,22,59,29,30
050,29,085,"Missouri","Hickory County",5,23,57,27,30
050,29,085,"Missouri","Hickory County",5,24,59,26,33
050,29,085,"Missouri","Hickory County",5,25,55,19,36
050,29,085,"Missouri","Hickory County",5,26,72,37,35
050,29,085,"Missouri","Hickory County",5,27,69,37,32
050,29,085,"Missouri","Hickory County",5,28,61,30,31
050,29,085,"Missouri","Hickory County",5,29,71,33,38
050,29,085,"Missouri","Hickory County",5,30,75,37,38
050,29,085,"Missouri","Hickory County",5,31,85,41,44
050,29,085,"Missouri","Hickory County",5,32,74,44,30
050,29,085,"Missouri","Hickory County",5,33,76,37,39
050,29,085,"Missouri","Hickory County",5,34,67,38,29
050,29,085,"Missouri","Hickory County",5,35,71,29,42
050,29,085,"Missouri","Hickory County",5,36,88,46,42
050,29,085,"Missouri","Hickory County",5,37,94,51,43
050,29,085,"Missouri","Hickory County",5,38,88,48,40
050,29,085,"Missouri","Hickory County",5,39,72,38,34
050,29,085,"Missouri","Hickory County",5,40,68,37,31
050,29,085,"Missouri","Hickory County",5,41,60,27,33
050,29,085,"Missouri","Hickory County",5,42,81,34,47
050,29,085,"Missouri","Hickory County",5,43,76,35,41
050,29,085,"Missouri","Hickory County",5,44,96,50,46
050,29,085,"Missouri","Hickory County",5,45,91,46,45
050,29,085,"Missouri","Hickory County",5,46,76,32,44
050,29,085,"Missouri","Hickory County",5,47,60,24,36
050,29,085,"Missouri","Hickory County",5,48,75,34,41
050,29,085,"Missouri","Hickory County",5,49,78,31,47
050,29,085,"Missouri","Hickory County",5,50,111,61,50
050,29,085,"Missouri","Hickory County",5,51,110,55,55
050,29,085,"Missouri","Hickory County",5,52,123,58,65
050,29,085,"Missouri","Hickory County",5,53,103,52,51
050,29,085,"Missouri","Hickory County",5,54,94,44,50
050,29,085,"Missouri","Hickory County",5,55,125,69,56
050,29,085,"Missouri","Hickory County",5,56,139,73,66
050,29,085,"Missouri","Hickory County",5,57,126,62,64
050,29,085,"Missouri","Hickory County",5,58,135,68,67
050,29,085,"Missouri","Hickory County",5,59,159,67,92
050,29,085,"Missouri","Hickory County",5,60,162,72,90
050,29,085,"Missouri","Hickory County",5,61,168,89,79
050,29,085,"Missouri","Hickory County",5,62,179,98,81
050,29,085,"Missouri","Hickory County",5,63,162,78,84
050,29,085,"Missouri","Hickory County",5,64,172,86,86
050,29,085,"Missouri","Hickory County",5,65,169,89,80
050,29,085,"Missouri","Hickory County",5,66,160,79,81
050,29,085,"Missouri","Hickory County",5,67,162,79,83
050,29,085,"Missouri","Hickory County",5,68,152,74,78
050,29,085,"Missouri","Hickory County",5,69,168,86,82
050,29,085,"Missouri","Hickory County",5,70,144,79,65
050,29,085,"Missouri","Hickory County",5,71,137,71,66
050,29,085,"Missouri","Hickory County",5,72,151,64,87
050,29,085,"Missouri","Hickory County",5,73,148,72,76
050,29,085,"Missouri","Hickory County",5,74,127,61,66
050,29,085,"Missouri","Hickory County",5,75,119,61,58
050,29,085,"Missouri","Hickory County",5,76,141,72,69
050,29,085,"Missouri","Hickory County",5,77,95,51,44
050,29,085,"Missouri","Hickory County",5,78,94,50,44
050,29,085,"Missouri","Hickory County",5,79,113,60,53
050,29,085,"Missouri","Hickory County",5,80,94,47,47
050,29,085,"Missouri","Hickory County",5,81,85,43,42
050,29,085,"Missouri","Hickory County",5,82,79,35,44
050,29,085,"Missouri","Hickory County",5,83,67,34,33
050,29,085,"Missouri","Hickory County",5,84,58,25,33
050,29,085,"Missouri","Hickory County",5,85,335,131,204
050,29,087,"Missouri","Holt County",1,0,48,24,24
050,29,087,"Missouri","Holt County",1,1,55,29,26
050,29,087,"Missouri","Holt County",1,2,44,22,22
050,29,087,"Missouri","Holt County",1,3,42,22,20
050,29,087,"Missouri","Holt County",1,4,42,20,22
050,29,087,"Missouri","Holt County",1,5,40,17,23
050,29,087,"Missouri","Holt County",1,6,49,23,26
050,29,087,"Missouri","Holt County",1,7,46,24,22
050,29,087,"Missouri","Holt County",1,8,45,22,23
050,29,087,"Missouri","Holt County",1,9,57,26,31
050,29,087,"Missouri","Holt County",1,10,47,23,24
050,29,087,"Missouri","Holt County",1,11,48,24,24
050,29,087,"Missouri","Holt County",1,12,46,24,22
050,29,087,"Missouri","Holt County",1,13,49,26,23
050,29,087,"Missouri","Holt County",1,14,45,23,22
050,29,087,"Missouri","Holt County",1,15,59,28,31
050,29,087,"Missouri","Holt County",1,16,54,28,26
050,29,087,"Missouri","Holt County",1,17,53,29,24
050,29,087,"Missouri","Holt County",1,18,43,22,21
050,29,087,"Missouri","Holt County",1,19,35,18,17
050,29,087,"Missouri","Holt County",1,20,26,14,12
050,29,087,"Missouri","Holt County",1,21,34,17,17
050,29,087,"Missouri","Holt County",1,22,35,20,15
050,29,087,"Missouri","Holt County",1,23,35,21,14
050,29,087,"Missouri","Holt County",1,24,38,19,19
050,29,087,"Missouri","Holt County",1,25,33,12,21
050,29,087,"Missouri","Holt County",1,26,38,20,18
050,29,087,"Missouri","Holt County",1,27,35,19,16
050,29,087,"Missouri","Holt County",1,28,40,19,21
050,29,087,"Missouri","Holt County",1,29,52,27,25
050,29,087,"Missouri","Holt County",1,30,45,21,24
050,29,087,"Missouri","Holt County",1,31,48,21,27
050,29,087,"Missouri","Holt County",1,32,46,25,21
050,29,087,"Missouri","Holt County",1,33,36,21,15
050,29,087,"Missouri","Holt County",1,34,45,23,22
050,29,087,"Missouri","Holt County",1,35,43,27,16
050,29,087,"Missouri","Holt County",1,36,32,13,19
050,29,087,"Missouri","Holt County",1,37,37,19,18
050,29,087,"Missouri","Holt County",1,38,40,19,21
050,29,087,"Missouri","Holt County",1,39,43,27,16
050,29,087,"Missouri","Holt County",1,40,46,27,19
050,29,087,"Missouri","Holt County",1,41,44,24,20
050,29,087,"Missouri","Holt County",1,42,43,20,23
050,29,087,"Missouri","Holt County",1,43,40,24,16
050,29,087,"Missouri","Holt County",1,44,40,22,18
050,29,087,"Missouri","Holt County",1,45,44,19,25
050,29,087,"Missouri","Holt County",1,46,46,17,29
050,29,087,"Missouri","Holt County",1,47,52,27,25
050,29,087,"Missouri","Holt County",1,48,55,33,22
050,29,087,"Missouri","Holt County",1,49,64,30,34
050,29,087,"Missouri","Holt County",1,50,54,23,31
050,29,087,"Missouri","Holt County",1,51,51,26,25
050,29,087,"Missouri","Holt County",1,52,53,24,29
050,29,087,"Missouri","Holt County",1,53,47,23,24
050,29,087,"Missouri","Holt County",1,54,59,29,30
050,29,087,"Missouri","Holt County",1,55,69,33,36
050,29,087,"Missouri","Holt County",1,56,79,38,41
050,29,087,"Missouri","Holt County",1,57,70,35,35
050,29,087,"Missouri","Holt County",1,58,74,39,35
050,29,087,"Missouri","Holt County",1,59,67,33,34
050,29,087,"Missouri","Holt County",1,60,66,35,31
050,29,087,"Missouri","Holt County",1,61,62,28,34
050,29,087,"Missouri","Holt County",1,62,69,32,37
050,29,087,"Missouri","Holt County",1,63,64,31,33
050,29,087,"Missouri","Holt County",1,64,58,23,35
050,29,087,"Missouri","Holt County",1,65,72,36,36
050,29,087,"Missouri","Holt County",1,66,64,33,31
050,29,087,"Missouri","Holt County",1,67,64,33,31
050,29,087,"Missouri","Holt County",1,68,68,36,32
050,29,087,"Missouri","Holt County",1,69,65,39,26
050,29,087,"Missouri","Holt County",1,70,53,32,21
050,29,087,"Missouri","Holt County",1,71,55,27,28
050,29,087,"Missouri","Holt County",1,72,55,24,31
050,29,087,"Missouri","Holt County",1,73,51,27,24
050,29,087,"Missouri","Holt County",1,74,44,24,20
050,29,087,"Missouri","Holt County",1,75,42,17,25
050,29,087,"Missouri","Holt County",1,76,35,16,19
050,29,087,"Missouri","Holt County",1,77,37,18,19
050,29,087,"Missouri","Holt County",1,78,33,19,14
050,29,087,"Missouri","Holt County",1,79,34,20,14
050,29,087,"Missouri","Holt County",1,80,26,12,14
050,29,087,"Missouri","Holt County",1,81,28,14,14
050,29,087,"Missouri","Holt County",1,82,21,9,12
050,29,087,"Missouri","Holt County",1,83,28,14,14
050,29,087,"Missouri","Holt County",1,84,22,6,16
050,29,087,"Missouri","Holt County",1,85,190,55,135
050,29,087,"Missouri","Holt County",2,0,41,22,19
050,29,087,"Missouri","Holt County",2,1,53,28,25
050,29,087,"Missouri","Holt County",2,2,46,24,22
050,29,087,"Missouri","Holt County",2,3,41,21,20
050,29,087,"Missouri","Holt County",2,4,41,19,22
050,29,087,"Missouri","Holt County",2,5,40,17,23
050,29,087,"Missouri","Holt County",2,6,47,21,26
050,29,087,"Missouri","Holt County",2,7,46,23,23
050,29,087,"Missouri","Holt County",2,8,44,21,23
050,29,087,"Missouri","Holt County",2,9,52,24,28
050,29,087,"Missouri","Holt County",2,10,49,24,25
050,29,087,"Missouri","Holt County",2,11,47,24,23
050,29,087,"Missouri","Holt County",2,12,45,24,21
050,29,087,"Missouri","Holt County",2,13,46,24,22
050,29,087,"Missouri","Holt County",2,14,46,24,22
050,29,087,"Missouri","Holt County",2,15,56,27,29
050,29,087,"Missouri","Holt County",2,16,54,28,26
050,29,087,"Missouri","Holt County",2,17,54,29,25
050,29,087,"Missouri","Holt County",2,18,44,23,21
050,29,087,"Missouri","Holt County",2,19,34,18,16
050,29,087,"Missouri","Holt County",2,20,28,15,13
050,29,087,"Missouri","Holt County",2,21,33,17,16
050,29,087,"Missouri","Holt County",2,22,34,19,15
050,29,087,"Missouri","Holt County",2,23,37,22,15
050,29,087,"Missouri","Holt County",2,24,38,19,19
050,29,087,"Missouri","Holt County",2,25,36,14,22
050,29,087,"Missouri","Holt County",2,26,37,19,18
050,29,087,"Missouri","Holt County",2,27,34,18,16
050,29,087,"Missouri","Holt County",2,28,39,19,20
050,29,087,"Missouri","Holt County",2,29,49,25,24
050,29,087,"Missouri","Holt County",2,30,46,22,24
050,29,087,"Missouri","Holt County",2,31,47,21,26
050,29,087,"Missouri","Holt County",2,32,45,24,21
050,29,087,"Missouri","Holt County",2,33,39,22,17
050,29,087,"Missouri","Holt County",2,34,42,22,20
050,29,087,"Missouri","Holt County",2,35,43,26,17
050,29,087,"Missouri","Holt County",2,36,33,15,18
050,29,087,"Missouri","Holt County",2,37,35,17,18
050,29,087,"Missouri","Holt County",2,38,39,19,20
050,29,087,"Missouri","Holt County",2,39,42,25,17
050,29,087,"Missouri","Holt County",2,40,46,28,18
050,29,087,"Missouri","Holt County",2,41,43,24,19
050,29,087,"Missouri","Holt County",2,42,43,21,22
050,29,087,"Missouri","Holt County",2,43,40,23,17
050,29,087,"Missouri","Holt County",2,44,40,22,18
050,29,087,"Missouri","Holt County",2,45,43,19,24
050,29,087,"Missouri","Holt County",2,46,46,18,28
050,29,087,"Missouri","Holt County",2,47,50,25,25
050,29,087,"Missouri","Holt County",2,48,53,30,23
050,29,087,"Missouri","Holt County",2,49,62,31,31
050,29,087,"Missouri","Holt County",2,50,57,24,33
050,29,087,"Missouri","Holt County",2,51,52,26,26
050,29,087,"Missouri","Holt County",2,52,51,24,27
050,29,087,"Missouri","Holt County",2,53,49,23,26
050,29,087,"Missouri","Holt County",2,54,55,27,28
050,29,087,"Missouri","Holt County",2,55,66,32,34
050,29,087,"Missouri","Holt County",2,56,77,37,40
050,29,087,"Missouri","Holt County",2,57,70,35,35
050,29,087,"Missouri","Holt County",2,58,72,37,35
050,29,087,"Missouri","Holt County",2,59,68,34,34
050,29,087,"Missouri","Holt County",2,60,67,35,32
050,29,087,"Missouri","Holt County",2,61,62,29,33
050,29,087,"Missouri","Holt County",2,62,67,31,36
050,29,087,"Missouri","Holt County",2,63,66,32,34
050,29,087,"Missouri","Holt County",2,64,58,24,34
050,29,087,"Missouri","Holt County",2,65,68,32,36
050,29,087,"Missouri","Holt County",2,66,65,33,32
050,29,087,"Missouri","Holt County",2,67,65,33,32
050,29,087,"Missouri","Holt County",2,68,65,35,30
050,29,087,"Missouri","Holt County",2,69,67,39,28
050,29,087,"Missouri","Holt County",2,70,55,33,22
050,29,087,"Missouri","Holt County",2,71,55,28,27
050,29,087,"Missouri","Holt County",2,72,53,24,29
050,29,087,"Missouri","Holt County",2,73,54,27,27
050,29,087,"Missouri","Holt County",2,74,41,21,20
050,29,087,"Missouri","Holt County",2,75,43,19,24
050,29,087,"Missouri","Holt County",2,76,35,16,19
050,29,087,"Missouri","Holt County",2,77,37,18,19
050,29,087,"Missouri","Holt County",2,78,33,19,14
050,29,087,"Missouri","Holt County",2,79,33,19,14
050,29,087,"Missouri","Holt County",2,80,27,14,13
050,29,087,"Missouri","Holt County",2,81,28,14,14
050,29,087,"Missouri","Holt County",2,82,22,10,12
050,29,087,"Missouri","Holt County",2,83,26,13,13
050,29,087,"Missouri","Holt County",2,84,21,7,14
050,29,087,"Missouri","Holt County",2,85,191,55,136
050,29,087,"Missouri","Holt County",3,0,41,19,22
050,29,087,"Missouri","Holt County",3,1,42,21,21
050,29,087,"Missouri","Holt County",3,2,60,31,29
050,29,087,"Missouri","Holt County",3,3,45,22,23
050,29,087,"Missouri","Holt County",3,4,47,22,25
050,29,087,"Missouri","Holt County",3,5,43,18,25
050,29,087,"Missouri","Holt County",3,6,45,21,24
050,29,087,"Missouri","Holt County",3,7,48,22,26
050,29,087,"Missouri","Holt County",3,8,45,22,23
050,29,087,"Missouri","Holt County",3,9,45,23,22
050,29,087,"Missouri","Holt County",3,10,52,25,27
050,29,087,"Missouri","Holt County",3,11,50,24,26
050,29,087,"Missouri","Holt County",3,12,51,26,25
050,29,087,"Missouri","Holt County",3,13,48,23,25
050,29,087,"Missouri","Holt County",3,14,49,22,27
050,29,087,"Missouri","Holt County",3,15,55,29,26
050,29,087,"Missouri","Holt County",3,16,56,26,30
050,29,087,"Missouri","Holt County",3,17,56,32,24
050,29,087,"Missouri","Holt County",3,18,53,28,25
050,29,087,"Missouri","Holt County",3,19,34,19,15
050,29,087,"Missouri","Holt County",3,20,34,17,17
050,29,087,"Missouri","Holt County",3,21,33,18,15
050,29,087,"Missouri","Holt County",3,22,36,16,20
050,29,087,"Missouri","Holt County",3,23,40,26,14
050,29,087,"Missouri","Holt County",3,24,38,22,16
050,29,087,"Missouri","Holt County",3,25,44,19,25
050,29,087,"Missouri","Holt County",3,26,35,13,22
050,29,087,"Missouri","Holt County",3,27,42,22,20
050,29,087,"Missouri","Holt County",3,28,36,17,19
050,29,087,"Missouri","Holt County",3,29,47,23,24
050,29,087,"Missouri","Holt County",3,30,46,23,23
050,29,087,"Missouri","Holt County",3,31,49,23,26
050,29,087,"Missouri","Holt County",3,32,48,22,26
050,29,087,"Missouri","Holt County",3,33,44,25,19
050,29,087,"Missouri","Holt County",3,34,40,22,18
050,29,087,"Missouri","Holt County",3,35,43,24,19
050,29,087,"Missouri","Holt County",3,36,44,26,18
050,29,087,"Missouri","Holt County",3,37,35,13,22
050,29,087,"Missouri","Holt County",3,38,36,19,17
050,29,087,"Missouri","Holt County",3,39,36,18,18
050,29,087,"Missouri","Holt County",3,40,41,25,16
050,29,087,"Missouri","Holt County",3,41,49,29,20
050,29,087,"Missouri","Holt County",3,42,46,24,22
050,29,087,"Missouri","Holt County",3,43,40,19,21
050,29,087,"Missouri","Holt County",3,44,44,27,17
050,29,087,"Missouri","Holt County",3,45,44,22,22
050,29,087,"Missouri","Holt County",3,46,44,19,25
050,29,087,"Missouri","Holt County",3,47,45,19,26
050,29,087,"Missouri","Holt County",3,48,50,24,26
050,29,087,"Missouri","Holt County",3,49,55,31,24
050,29,087,"Missouri","Holt County",3,50,62,31,31
050,29,087,"Missouri","Holt County",3,51,60,26,34
050,29,087,"Missouri","Holt County",3,52,55,29,26
050,29,087,"Missouri","Holt County",3,53,54,26,28
050,29,087,"Missouri","Holt County",3,54,47,23,24
050,29,087,"Missouri","Holt County",3,55,55,27,28
050,29,087,"Missouri","Holt County",3,56,67,32,35
050,29,087,"Missouri","Holt County",3,57,71,35,36
050,29,087,"Missouri","Holt County",3,58,68,33,35
050,29,087,"Missouri","Holt County",3,59,70,36,34
050,29,087,"Missouri","Holt County",3,60,70,35,35
050,29,087,"Missouri","Holt County",3,61,63,33,30
050,29,087,"Missouri","Holt County",3,62,60,29,31
050,29,087,"Missouri","Holt County",3,63,64,28,36
050,29,087,"Missouri","Holt County",3,64,68,32,36
050,29,087,"Missouri","Holt County",3,65,60,23,37
050,29,087,"Missouri","Holt County",3,66,65,32,33
050,29,087,"Missouri","Holt County",3,67,61,31,30
050,29,087,"Missouri","Holt County",3,68,58,29,29
050,29,087,"Missouri","Holt County",3,69,65,35,30
050,29,087,"Missouri","Holt County",3,70,60,36,24
050,29,087,"Missouri","Holt County",3,71,51,29,22
050,29,087,"Missouri","Holt County",3,72,53,27,26
050,29,087,"Missouri","Holt County",3,73,51,24,27
050,29,087,"Missouri","Holt County",3,74,53,27,26
050,29,087,"Missouri","Holt County",3,75,42,21,21
050,29,087,"Missouri","Holt County",3,76,38,19,19
050,29,087,"Missouri","Holt County",3,77,29,10,19
050,29,087,"Missouri","Holt County",3,78,36,18,18
050,29,087,"Missouri","Holt County",3,79,32,19,13
050,29,087,"Missouri","Holt County",3,80,29,19,10
050,29,087,"Missouri","Holt County",3,81,30,15,15
050,29,087,"Missouri","Holt County",3,82,27,11,16
050,29,087,"Missouri","Holt County",3,83,20,8,12
050,29,087,"Missouri","Holt County",3,84,20,9,11
050,29,087,"Missouri","Holt County",3,85,189,55,134
050,29,087,"Missouri","Holt County",4,0,46,19,27
050,29,087,"Missouri","Holt County",4,1,32,16,16
050,29,087,"Missouri","Holt County",4,2,45,22,23
050,29,087,"Missouri","Holt County",4,3,62,33,29
050,29,087,"Missouri","Holt County",4,4,46,23,23
050,29,087,"Missouri","Holt County",4,5,46,23,23
050,29,087,"Missouri","Holt County",4,6,45,20,25
050,29,087,"Missouri","Holt County",4,7,48,23,25
050,29,087,"Missouri","Holt County",4,8,50,23,27
050,29,087,"Missouri","Holt County",4,9,48,25,23
050,29,087,"Missouri","Holt County",4,10,47,24,23
050,29,087,"Missouri","Holt County",4,11,57,29,28
050,29,087,"Missouri","Holt County",4,12,53,26,27
050,29,087,"Missouri","Holt County",4,13,50,25,25
050,29,087,"Missouri","Holt County",4,14,53,28,25
050,29,087,"Missouri","Holt County",4,15,52,24,28
050,29,087,"Missouri","Holt County",4,16,56,31,25
050,29,087,"Missouri","Holt County",4,17,60,28,32
050,29,087,"Missouri","Holt County",4,18,49,28,21
050,29,087,"Missouri","Holt County",4,19,49,27,22
050,29,087,"Missouri","Holt County",4,20,38,22,16
050,29,087,"Missouri","Holt County",4,21,40,18,22
050,29,087,"Missouri","Holt County",4,22,34,19,15
050,29,087,"Missouri","Holt County",4,23,37,15,22
050,29,087,"Missouri","Holt County",4,24,40,28,12
050,29,087,"Missouri","Holt County",4,25,40,24,16
050,29,087,"Missouri","Holt County",4,26,44,22,22
050,29,087,"Missouri","Holt County",4,27,35,14,21
050,29,087,"Missouri","Holt County",4,28,41,20,21
050,29,087,"Missouri","Holt County",4,29,40,23,17
050,29,087,"Missouri","Holt County",4,30,50,23,27
050,29,087,"Missouri","Holt County",4,31,48,26,22
050,29,087,"Missouri","Holt County",4,32,49,24,25
050,29,087,"Missouri","Holt County",4,33,48,22,26
050,29,087,"Missouri","Holt County",4,34,46,24,22
050,29,087,"Missouri","Holt County",4,35,43,23,20
050,29,087,"Missouri","Holt County",4,36,39,20,19
050,29,087,"Missouri","Holt County",4,37,47,29,18
050,29,087,"Missouri","Holt County",4,38,35,14,21
050,29,087,"Missouri","Holt County",4,39,38,19,19
050,29,087,"Missouri","Holt County",4,40,36,18,18
050,29,087,"Missouri","Holt County",4,41,36,21,15
050,29,087,"Missouri","Holt County",4,42,51,31,20
050,29,087,"Missouri","Holt County",4,43,50,25,25
050,29,087,"Missouri","Holt County",4,44,38,18,20
050,29,087,"Missouri","Holt County",4,45,43,26,17
050,29,087,"Missouri","Holt County",4,46,47,25,22
050,29,087,"Missouri","Holt County",4,47,42,19,23
050,29,087,"Missouri","Holt County",4,48,45,20,25
050,29,087,"Missouri","Holt County",4,49,51,25,26
050,29,087,"Missouri","Holt County",4,50,56,31,25
050,29,087,"Missouri","Holt County",4,51,60,29,31
050,29,087,"Missouri","Holt County",4,52,62,26,36
050,29,087,"Missouri","Holt County",4,53,59,29,30
050,29,087,"Missouri","Holt County",4,54,55,28,27
050,29,087,"Missouri","Holt County",4,55,47,23,24
050,29,087,"Missouri","Holt County",4,56,57,27,30
050,29,087,"Missouri","Holt County",4,57,63,31,32
050,29,087,"Missouri","Holt County",4,58,75,36,39
050,29,087,"Missouri","Holt County",4,59,63,32,31
050,29,087,"Missouri","Holt County",4,60,70,38,32
050,29,087,"Missouri","Holt County",4,61,71,38,33
050,29,087,"Missouri","Holt County",4,62,64,33,31
050,29,087,"Missouri","Holt County",4,63,55,25,30
050,29,087,"Missouri","Holt County",4,64,61,29,32
050,29,087,"Missouri","Holt County",4,65,65,30,35
050,29,087,"Missouri","Holt County",4,66,61,22,39
050,29,087,"Missouri","Holt County",4,67,65,32,33
050,29,087,"Missouri","Holt County",4,68,59,30,29
050,29,087,"Missouri","Holt County",4,69,59,31,28
050,29,087,"Missouri","Holt County",4,70,62,34,28
050,29,087,"Missouri","Holt County",4,71,55,30,25
050,29,087,"Missouri","Holt County",4,72,52,29,23
050,29,087,"Missouri","Holt County",4,73,46,24,22
050,29,087,"Missouri","Holt County",4,74,50,23,27
050,29,087,"Missouri","Holt County",4,75,54,28,26
050,29,087,"Missouri","Holt County",4,76,40,22,18
050,29,087,"Missouri","Holt County",4,77,36,17,19
050,29,087,"Missouri","Holt County",4,78,26,7,19
050,29,087,"Missouri","Holt County",4,79,36,18,18
050,29,087,"Missouri","Holt County",4,80,29,17,12
050,29,087,"Missouri","Holt County",4,81,28,17,11
050,29,087,"Missouri","Holt County",4,82,26,13,13
050,29,087,"Missouri","Holt County",4,83,27,12,15
050,29,087,"Missouri","Holt County",4,84,15,4,11
050,29,087,"Missouri","Holt County",4,85,180,56,124
050,29,087,"Missouri","Holt County",5,0,45,20,25
050,29,087,"Missouri","Holt County",5,1,59,27,32
050,29,087,"Missouri","Holt County",5,2,32,15,17
050,29,087,"Missouri","Holt County",5,3,45,25,20
050,29,087,"Missouri","Holt County",5,4,58,32,26
050,29,087,"Missouri","Holt County",5,5,51,27,24
050,29,087,"Missouri","Holt County",5,6,42,22,20
050,29,087,"Missouri","Holt County",5,7,49,22,27
050,29,087,"Missouri","Holt County",5,8,49,22,27
050,29,087,"Missouri","Holt County",5,9,49,23,26
050,29,087,"Missouri","Holt County",5,10,49,25,24
050,29,087,"Missouri","Holt County",5,11,49,26,23
050,29,087,"Missouri","Holt County",5,12,58,28,30
050,29,087,"Missouri","Holt County",5,13,52,27,25
050,29,087,"Missouri","Holt County",5,14,54,28,26
050,29,087,"Missouri","Holt County",5,15,56,28,28
050,29,087,"Missouri","Holt County",5,16,52,23,29
050,29,087,"Missouri","Holt County",5,17,57,30,27
050,29,087,"Missouri","Holt County",5,18,53,25,28
050,29,087,"Missouri","Holt County",5,19,40,26,14
050,29,087,"Missouri","Holt County",5,20,52,28,24
050,29,087,"Missouri","Holt County",5,21,41,25,16
050,29,087,"Missouri","Holt County",5,22,41,18,23
050,29,087,"Missouri","Holt County",5,23,39,22,17
050,29,087,"Missouri","Holt County",5,24,32,12,20
050,29,087,"Missouri","Holt County",5,25,36,25,11
050,29,087,"Missouri","Holt County",5,26,37,24,13
050,29,087,"Missouri","Holt County",5,27,41,19,22
050,29,087,"Missouri","Holt County",5,28,38,16,22
050,29,087,"Missouri","Holt County",5,29,41,19,22
050,29,087,"Missouri","Holt County",5,30,41,24,17
050,29,087,"Missouri","Holt County",5,31,50,22,28
050,29,087,"Missouri","Holt County",5,32,49,26,23
050,29,087,"Missouri","Holt County",5,33,45,25,20
050,29,087,"Missouri","Holt County",5,34,46,19,27
050,29,087,"Missouri","Holt County",5,35,44,23,21
050,29,087,"Missouri","Holt County",5,36,44,23,21
050,29,087,"Missouri","Holt County",5,37,35,18,17
050,29,087,"Missouri","Holt County",5,38,46,29,17
050,29,087,"Missouri","Holt County",5,39,38,15,23
050,29,087,"Missouri","Holt County",5,40,39,19,20
050,29,087,"Missouri","Holt County",5,41,36,18,18
050,29,087,"Missouri","Holt County",5,42,37,21,16
050,29,087,"Missouri","Holt County",5,43,55,34,21
050,29,087,"Missouri","Holt County",5,44,49,24,25
050,29,087,"Missouri","Holt County",5,45,45,22,23
050,29,087,"Missouri","Holt County",5,46,46,26,20
050,29,087,"Missouri","Holt County",5,47,47,24,23
050,29,087,"Missouri","Holt County",5,48,39,19,20
050,29,087,"Missouri","Holt County",5,49,47,20,27
050,29,087,"Missouri","Holt County",5,50,49,24,25
050,29,087,"Missouri","Holt County",5,51,52,29,23
050,29,087,"Missouri","Holt County",5,52,65,33,32
050,29,087,"Missouri","Holt County",5,53,62,27,35
050,29,087,"Missouri","Holt County",5,54,55,28,27
050,29,087,"Missouri","Holt County",5,55,57,27,30
050,29,087,"Missouri","Holt County",5,56,51,26,25
050,29,087,"Missouri","Holt County",5,57,55,27,28
050,29,087,"Missouri","Holt County",5,58,60,29,31
050,29,087,"Missouri","Holt County",5,59,75,36,39
050,29,087,"Missouri","Holt County",5,60,62,32,30
050,29,087,"Missouri","Holt County",5,61,69,37,32
050,29,087,"Missouri","Holt County",5,62,69,37,32
050,29,087,"Missouri","Holt County",5,63,62,31,31
050,29,087,"Missouri","Holt County",5,64,51,25,26
050,29,087,"Missouri","Holt County",5,65,61,28,33
050,29,087,"Missouri","Holt County",5,66,62,29,33
050,29,087,"Missouri","Holt County",5,67,61,22,39
050,29,087,"Missouri","Holt County",5,68,61,30,31
050,29,087,"Missouri","Holt County",5,69,57,28,29
050,29,087,"Missouri","Holt County",5,70,57,33,24
050,29,087,"Missouri","Holt County",5,71,62,32,30
050,29,087,"Missouri","Holt County",5,72,54,29,25
050,29,087,"Missouri","Holt County",5,73,48,27,21
050,29,087,"Missouri","Holt County",5,74,47,24,23
050,29,087,"Missouri","Holt County",5,75,49,23,26
050,29,087,"Missouri","Holt County",5,76,49,27,22
050,29,087,"Missouri","Holt County",5,77,35,18,17
050,29,087,"Missouri","Holt County",5,78,31,14,17
050,29,087,"Missouri","Holt County",5,79,27,7,20
050,29,087,"Missouri","Holt County",5,80,35,19,16
050,29,087,"Missouri","Holt County",5,81,31,18,13
050,29,087,"Missouri","Holt County",5,82,27,16,11
050,29,087,"Missouri","Holt County",5,83,29,14,15
050,29,087,"Missouri","Holt County",5,84,22,8,14
050,29,087,"Missouri","Holt County",5,85,174,52,122
050,29,089,"Missouri","Howard County",1,0,108,55,53
050,29,089,"Missouri","Howard County",1,1,113,59,54
050,29,089,"Missouri","Howard County",1,2,101,57,44
050,29,089,"Missouri","Howard County",1,3,105,57,48
050,29,089,"Missouri","Howard County",1,4,121,63,58
050,29,089,"Missouri","Howard County",1,5,123,60,63
050,29,089,"Missouri","Howard County",1,6,123,63,60
050,29,089,"Missouri","Howard County",1,7,117,59,58
050,29,089,"Missouri","Howard County",1,8,130,70,60
050,29,089,"Missouri","Howard County",1,9,139,79,60
050,29,089,"Missouri","Howard County",1,10,122,75,47
050,29,089,"Missouri","Howard County",1,11,144,75,69
050,29,089,"Missouri","Howard County",1,12,132,66,66
050,29,089,"Missouri","Howard County",1,13,131,68,63
050,29,089,"Missouri","Howard County",1,14,139,69,70
050,29,089,"Missouri","Howard County",1,15,142,70,72
050,29,089,"Missouri","Howard County",1,16,131,70,61
050,29,089,"Missouri","Howard County",1,17,128,65,63
050,29,089,"Missouri","Howard County",1,18,158,86,72
050,29,089,"Missouri","Howard County",1,19,348,189,159
050,29,089,"Missouri","Howard County",1,20,288,164,124
050,29,089,"Missouri","Howard County",1,21,198,90,108
050,29,089,"Missouri","Howard County",1,22,134,68,66
050,29,089,"Missouri","Howard County",1,23,106,62,44
050,29,089,"Missouri","Howard County",1,24,106,48,58
050,29,089,"Missouri","Howard County",1,25,115,57,58
050,29,089,"Missouri","Howard County",1,26,100,56,44
050,29,089,"Missouri","Howard County",1,27,94,46,48
050,29,089,"Missouri","Howard County",1,28,115,51,64
050,29,089,"Missouri","Howard County",1,29,92,45,47
050,29,089,"Missouri","Howard County",1,30,99,47,52
050,29,089,"Missouri","Howard County",1,31,116,52,64
050,29,089,"Missouri","Howard County",1,32,106,55,51
050,29,089,"Missouri","Howard County",1,33,112,57,55
050,29,089,"Missouri","Howard County",1,34,110,57,53
050,29,089,"Missouri","Howard County",1,35,112,47,65
050,29,089,"Missouri","Howard County",1,36,125,57,68
050,29,089,"Missouri","Howard County",1,37,130,59,71
050,29,089,"Missouri","Howard County",1,38,123,66,57
050,29,089,"Missouri","Howard County",1,39,106,55,51
050,29,089,"Missouri","Howard County",1,40,118,58,60
050,29,089,"Missouri","Howard County",1,41,109,55,54
050,29,089,"Missouri","Howard County",1,42,91,49,42
050,29,089,"Missouri","Howard County",1,43,85,49,36
050,29,089,"Missouri","Howard County",1,44,88,45,43
050,29,089,"Missouri","Howard County",1,45,108,53,55
050,29,089,"Missouri","Howard County",1,46,101,51,50
050,29,089,"Missouri","Howard County",1,47,108,51,57
050,29,089,"Missouri","Howard County",1,48,116,61,55
050,29,089,"Missouri","Howard County",1,49,112,56,56
050,29,089,"Missouri","Howard County",1,50,94,50,44
050,29,089,"Missouri","Howard County",1,51,102,55,47
050,29,089,"Missouri","Howard County",1,52,103,56,47
050,29,089,"Missouri","Howard County",1,53,121,71,50
050,29,089,"Missouri","Howard County",1,54,121,58,63
050,29,089,"Missouri","Howard County",1,55,129,68,61
050,29,089,"Missouri","Howard County",1,56,129,69,60
050,29,089,"Missouri","Howard County",1,57,125,65,60
050,29,089,"Missouri","Howard County",1,58,165,87,78
050,29,089,"Missouri","Howard County",1,59,151,72,79
050,29,089,"Missouri","Howard County",1,60,137,64,73
050,29,089,"Missouri","Howard County",1,61,149,73,76
050,29,089,"Missouri","Howard County",1,62,141,77,64
050,29,089,"Missouri","Howard County",1,63,148,76,72
050,29,089,"Missouri","Howard County",1,64,139,66,73
050,29,089,"Missouri","Howard County",1,65,136,67,69
050,29,089,"Missouri","Howard County",1,66,133,63,70
050,29,089,"Missouri","Howard County",1,67,146,73,73
050,29,089,"Missouri","Howard County",1,68,123,60,63
050,29,089,"Missouri","Howard County",1,69,112,51,61
050,29,089,"Missouri","Howard County",1,70,116,52,64
050,29,089,"Missouri","Howard County",1,71,109,50,59
050,29,089,"Missouri","Howard County",1,72,101,49,52
050,29,089,"Missouri","Howard County",1,73,90,46,44
050,29,089,"Missouri","Howard County",1,74,71,38,33
050,29,089,"Missouri","Howard County",1,75,71,37,34
050,29,089,"Missouri","Howard County",1,76,69,31,38
050,29,089,"Missouri","Howard County",1,77,69,34,35
050,29,089,"Missouri","Howard County",1,78,68,30,38
050,29,089,"Missouri","Howard County",1,79,64,30,34
050,29,089,"Missouri","Howard County",1,80,50,22,28
050,29,089,"Missouri","Howard County",1,81,51,19,32
050,29,089,"Missouri","Howard County",1,82,51,21,30
050,29,089,"Missouri","Howard County",1,83,37,13,24
050,29,089,"Missouri","Howard County",1,84,28,13,15
050,29,089,"Missouri","Howard County",1,85,228,94,134
050,29,089,"Missouri","Howard County",2,0,113,55,58
050,29,089,"Missouri","Howard County",2,1,110,56,54
050,29,089,"Missouri","Howard County",2,2,104,57,47
050,29,089,"Missouri","Howard County",2,3,104,57,47
050,29,089,"Missouri","Howard County",2,4,115,60,55
050,29,089,"Missouri","Howard County",2,5,122,60,62
050,29,089,"Missouri","Howard County",2,6,123,63,60
050,29,089,"Missouri","Howard County",2,7,120,62,58
050,29,089,"Missouri","Howard County",2,8,128,69,59
050,29,089,"Missouri","Howard County",2,9,136,77,59
050,29,089,"Missouri","Howard County",2,10,126,76,50
050,29,089,"Missouri","Howard County",2,11,139,75,64
050,29,089,"Missouri","Howard County",2,12,137,69,68
050,29,089,"Missouri","Howard County",2,13,132,68,64
050,29,089,"Missouri","Howard County",2,14,138,69,69
050,29,089,"Missouri","Howard County",2,15,141,70,71
050,29,089,"Missouri","Howard County",2,16,136,72,64
050,29,089,"Missouri","Howard County",2,17,129,67,62
050,29,089,"Missouri","Howard County",2,18,157,84,73
050,29,089,"Missouri","Howard County",2,19,349,190,159
050,29,089,"Missouri","Howard County",2,20,289,164,125
050,29,089,"Missouri","Howard County",2,21,196,90,106
050,29,089,"Missouri","Howard County",2,22,131,68,63
050,29,089,"Missouri","Howard County",2,23,110,62,48
050,29,089,"Missouri","Howard County",2,24,105,49,56
050,29,089,"Missouri","Howard County",2,25,115,58,57
050,29,089,"Missouri","Howard County",2,26,101,57,44
050,29,089,"Missouri","Howard County",2,27,96,48,48
050,29,089,"Missouri","Howard County",2,28,107,48,59
050,29,089,"Missouri","Howard County",2,29,97,46,51
050,29,089,"Missouri","Howard County",2,30,98,45,53
050,29,089,"Missouri","Howard County",2,31,109,50,59
050,29,089,"Missouri","Howard County",2,32,108,54,54
050,29,089,"Missouri","Howard County",2,33,112,56,56
050,29,089,"Missouri","Howard County",2,34,111,58,53
050,29,089,"Missouri","Howard County",2,35,114,51,63
050,29,089,"Missouri","Howard County",2,36,120,54,66
050,29,089,"Missouri","Howard County",2,37,129,59,70
050,29,089,"Missouri","Howard County",2,38,126,65,61
050,29,089,"Missouri","Howard County",2,39,109,57,52
050,29,089,"Missouri","Howard County",2,40,116,57,59
050,29,089,"Missouri","Howard County",2,41,109,53,56
050,29,089,"Missouri","Howard County",2,42,95,50,45
050,29,089,"Missouri","Howard County",2,43,87,50,37
050,29,089,"Missouri","Howard County",2,44,87,46,41
050,29,089,"Missouri","Howard County",2,45,103,51,52
050,29,089,"Missouri","Howard County",2,46,100,49,51
050,29,089,"Missouri","Howard County",2,47,109,51,58
050,29,089,"Missouri","Howard County",2,48,115,60,55
050,29,089,"Missouri","Howard County",2,49,113,57,56
050,29,089,"Missouri","Howard County",2,50,97,51,46
050,29,089,"Missouri","Howard County",2,51,99,53,46
050,29,089,"Missouri","Howard County",2,52,104,57,47
050,29,089,"Missouri","Howard County",2,53,116,67,49
050,29,089,"Missouri","Howard County",2,54,120,62,58
050,29,089,"Missouri","Howard County",2,55,126,65,61
050,29,089,"Missouri","Howard County",2,56,130,70,60
050,29,089,"Missouri","Howard County",2,57,127,65,62
050,29,089,"Missouri","Howard County",2,58,154,83,71
050,29,089,"Missouri","Howard County",2,59,153,74,79
050,29,089,"Missouri","Howard County",2,60,141,66,75
050,29,089,"Missouri","Howard County",2,61,146,71,75
050,29,089,"Missouri","Howard County",2,62,143,76,67
050,29,089,"Missouri","Howard County",2,63,147,77,70
050,29,089,"Missouri","Howard County",2,64,142,69,73
050,29,089,"Missouri","Howard County",2,65,137,67,70
050,29,089,"Missouri","Howard County",2,66,133,63,70
050,29,089,"Missouri","Howard County",2,67,143,70,73
050,29,089,"Missouri","Howard County",2,68,128,64,64
050,29,089,"Missouri","Howard County",2,69,116,54,62
050,29,089,"Missouri","Howard County",2,70,115,51,64
050,29,089,"Missouri","Howard County",2,71,107,48,59
050,29,089,"Missouri","Howard County",2,72,100,47,53
050,29,089,"Missouri","Howard County",2,73,97,49,48
050,29,089,"Missouri","Howard County",2,74,69,37,32
050,29,089,"Missouri","Howard County",2,75,71,37,34
050,29,089,"Missouri","Howard County",2,76,68,32,36
050,29,089,"Missouri","Howard County",2,77,71,34,37
050,29,089,"Missouri","Howard County",2,78,67,31,36
050,29,089,"Missouri","Howard County",2,79,62,29,33
050,29,089,"Missouri","Howard County",2,80,54,25,29
050,29,089,"Missouri","Howard County",2,81,51,20,31
050,29,089,"Missouri","Howard County",2,82,51,21,30
050,29,089,"Missouri","Howard County",2,83,41,15,26
050,29,089,"Missouri","Howard County",2,84,30,13,17
050,29,089,"Missouri","Howard County",2,85,225,96,129
050,29,089,"Missouri","Howard County",3,0,94,55,39
050,29,089,"Missouri","Howard County",3,1,116,57,59
050,29,089,"Missouri","Howard County",3,2,110,59,51
050,29,089,"Missouri","Howard County",3,3,102,56,46
050,29,089,"Missouri","Howard County",3,4,109,60,49
050,29,089,"Missouri","Howard County",3,5,112,55,57
050,29,089,"Missouri","Howard County",3,6,120,59,61
050,29,089,"Missouri","Howard County",3,7,132,66,66
050,29,089,"Missouri","Howard County",3,8,117,57,60
050,29,089,"Missouri","Howard County",3,9,128,68,60
050,29,089,"Missouri","Howard County",3,10,133,79,54
050,29,089,"Missouri","Howard County",3,11,127,80,47
050,29,089,"Missouri","Howard County",3,12,136,73,63
050,29,089,"Missouri","Howard County",3,13,137,65,72
050,29,089,"Missouri","Howard County",3,14,133,70,63
050,29,089,"Missouri","Howard County",3,15,133,63,70
050,29,089,"Missouri","Howard County",3,16,143,67,76
050,29,089,"Missouri","Howard County",3,17,136,75,61
050,29,089,"Missouri","Howard County",3,18,159,82,77
050,29,089,"Missouri","Howard County",3,19,353,193,160
050,29,089,"Missouri","Howard County",3,20,289,162,127
050,29,089,"Missouri","Howard County",3,21,201,92,109
050,29,089,"Missouri","Howard County",3,22,136,71,65
050,29,089,"Missouri","Howard County",3,23,114,62,52
050,29,089,"Missouri","Howard County",3,24,90,51,39
050,29,089,"Missouri","Howard County",3,25,99,50,49
050,29,089,"Missouri","Howard County",3,26,110,54,56
050,29,089,"Missouri","Howard County",3,27,88,47,41
050,29,089,"Missouri","Howard County",3,28,91,42,49
050,29,089,"Missouri","Howard County",3,29,106,47,59
050,29,089,"Missouri","Howard County",3,30,104,51,53
050,29,089,"Missouri","Howard County",3,31,98,44,54
050,29,089,"Missouri","Howard County",3,32,117,56,61
050,29,089,"Missouri","Howard County",3,33,97,46,51
050,29,089,"Missouri","Howard County",3,34,108,56,52
050,29,089,"Missouri","Howard County",3,35,116,63,53
050,29,089,"Missouri","Howard County",3,36,115,52,63
050,29,089,"Missouri","Howard County",3,37,123,53,70
050,29,089,"Missouri","Howard County",3,38,135,66,69
050,29,089,"Missouri","Howard County",3,39,121,61,60
050,29,089,"Missouri","Howard County",3,40,109,55,54
050,29,089,"Missouri","Howard County",3,41,119,61,58
050,29,089,"Missouri","Howard County",3,42,108,53,55
050,29,089,"Missouri","Howard County",3,43,89,46,43
050,29,089,"Missouri","Howard County",3,44,91,51,40
050,29,089,"Missouri","Howard County",3,45,88,44,44
050,29,089,"Missouri","Howard County",3,46,100,50,50
050,29,089,"Missouri","Howard County",3,47,104,51,53
050,29,089,"Missouri","Howard County",3,48,105,54,51
050,29,089,"Missouri","Howard County",3,49,111,57,54
050,29,089,"Missouri","Howard County",3,50,116,60,56
050,29,089,"Missouri","Howard County",3,51,101,51,50
050,29,089,"Missouri","Howard County",3,52,98,53,45
050,29,089,"Missouri","Howard County",3,53,108,61,47
050,29,089,"Missouri","Howard County",3,54,114,64,50
050,29,089,"Missouri","Howard County",3,55,121,62,59
050,29,089,"Missouri","Howard County",3,56,130,67,63
050,29,089,"Missouri","Howard County",3,57,127,71,56
050,29,089,"Missouri","Howard County",3,58,133,71,62
050,29,089,"Missouri","Howard County",3,59,150,79,71
050,29,089,"Missouri","Howard County",3,60,151,76,75
050,29,089,"Missouri","Howard County",3,61,143,65,78
050,29,089,"Missouri","Howard County",3,62,156,71,85
050,29,089,"Missouri","Howard County",3,63,143,75,68
050,29,089,"Missouri","Howard County",3,64,148,78,70
050,29,089,"Missouri","Howard County",3,65,140,66,74
050,29,089,"Missouri","Howard County",3,66,135,66,69
050,29,089,"Missouri","Howard County",3,67,128,64,64
050,29,089,"Missouri","Howard County",3,68,140,69,71
050,29,089,"Missouri","Howard County",3,69,130,65,65
050,29,089,"Missouri","Howard County",3,70,109,49,60
050,29,089,"Missouri","Howard County",3,71,116,51,65
050,29,089,"Missouri","Howard County",3,72,101,43,58
050,29,089,"Missouri","Howard County",3,73,99,50,49
050,29,089,"Missouri","Howard County",3,74,93,48,45
050,29,089,"Missouri","Howard County",3,75,68,37,31
050,29,089,"Missouri","Howard County",3,76,68,36,32
050,29,089,"Missouri","Howard County",3,77,64,29,35
050,29,089,"Missouri","Howard County",3,78,71,33,38
050,29,089,"Missouri","Howard County",3,79,67,29,38
050,29,089,"Missouri","Howard County",3,80,59,27,32
050,29,089,"Missouri","Howard County",3,81,55,25,30
050,29,089,"Missouri","Howard County",3,82,53,20,33
050,29,089,"Missouri","Howard County",3,83,48,21,27
050,29,089,"Missouri","Howard County",3,84,34,12,22
050,29,089,"Missouri","Howard County",3,85,216,89,127
050,29,089,"Missouri","Howard County",4,0,100,48,52
050,29,089,"Missouri","Howard County",4,1,114,66,48
050,29,089,"Missouri","Howard County",4,2,119,58,61
050,29,089,"Missouri","Howard County",4,3,121,62,59
050,29,089,"Missouri","Howard County",4,4,97,54,43
050,29,089,"Missouri","Howard County",4,5,112,64,48
050,29,089,"Missouri","Howard County",4,6,114,59,55
050,29,089,"Missouri","Howard County",4,7,122,60,62
050,29,089,"Missouri","Howard County",4,8,129,64,65
050,29,089,"Missouri","Howard County",4,9,112,56,56
050,29,089,"Missouri","Howard County",4,10,136,72,64
050,29,089,"Missouri","Howard County",4,11,142,81,61
050,29,089,"Missouri","Howard County",4,12,134,84,50
050,29,089,"Missouri","Howard County",4,13,133,72,61
050,29,089,"Missouri","Howard County",4,14,135,62,73
050,29,089,"Missouri","Howard County",4,15,128,64,64
050,29,089,"Missouri","Howard County",4,16,129,61,68
050,29,089,"Missouri","Howard County",4,17,135,63,72
050,29,089,"Missouri","Howard County",4,18,168,88,80
050,29,089,"Missouri","Howard County",4,19,358,194,164
050,29,089,"Missouri","Howard County",4,20,293,166,127
050,29,089,"Missouri","Howard County",4,21,206,95,111
050,29,089,"Missouri","Howard County",4,22,138,69,69
050,29,089,"Missouri","Howard County",4,23,123,73,50
050,29,089,"Missouri","Howard County",4,24,104,51,53
050,29,089,"Missouri","Howard County",4,25,100,59,41
050,29,089,"Missouri","Howard County",4,26,95,42,53
050,29,089,"Missouri","Howard County",4,27,105,50,55
050,29,089,"Missouri","Howard County",4,28,84,49,35
050,29,089,"Missouri","Howard County",4,29,89,40,49
050,29,089,"Missouri","Howard County",4,30,113,58,55
050,29,089,"Missouri","Howard County",4,31,110,51,59
050,29,089,"Missouri","Howard County",4,32,107,51,56
050,29,089,"Missouri","Howard County",4,33,120,57,63
050,29,089,"Missouri","Howard County",4,34,99,48,51
050,29,089,"Missouri","Howard County",4,35,101,55,46
050,29,089,"Missouri","Howard County",4,36,108,55,53
050,29,089,"Missouri","Howard County",4,37,113,48,65
050,29,089,"Missouri","Howard County",4,38,124,58,66
050,29,089,"Missouri","Howard County",4,39,136,65,71
050,29,089,"Missouri","Howard County",4,40,126,63,63
050,29,089,"Missouri","Howard County",4,41,108,55,53
050,29,089,"Missouri","Howard County",4,42,119,60,59
050,29,089,"Missouri","Howard County",4,43,105,52,53
050,29,089,"Missouri","Howard County",4,44,95,51,44
050,29,089,"Missouri","Howard County",4,45,87,51,36
050,29,089,"Missouri","Howard County",4,46,88,44,44
050,29,089,"Missouri","Howard County",4,47,102,49,53
050,29,089,"Missouri","Howard County",4,48,98,52,46
050,29,089,"Missouri","Howard County",4,49,107,56,51
050,29,089,"Missouri","Howard County",4,50,103,52,51
050,29,089,"Missouri","Howard County",4,51,126,61,65
050,29,089,"Missouri","Howard County",4,52,109,57,52
050,29,089,"Missouri","Howard County",4,53,99,51,48
050,29,089,"Missouri","Howard County",4,54,101,56,45
050,29,089,"Missouri","Howard County",4,55,117,63,54
050,29,089,"Missouri","Howard County",4,56,124,64,60
050,29,089,"Missouri","Howard County",4,57,138,70,68
050,29,089,"Missouri","Howard County",4,58,128,72,56
050,29,089,"Missouri","Howard County",4,59,130,70,60
050,29,089,"Missouri","Howard County",4,60,148,79,69
050,29,089,"Missouri","Howard County",4,61,150,75,75
050,29,089,"Missouri","Howard County",4,62,144,66,78
050,29,089,"Missouri","Howard County",4,63,155,73,82
050,29,089,"Missouri","Howard County",4,64,139,67,72
050,29,089,"Missouri","Howard County",4,65,148,78,70
050,29,089,"Missouri","Howard County",4,66,143,65,78
050,29,089,"Missouri","Howard County",4,67,133,68,65
050,29,089,"Missouri","Howard County",4,68,129,63,66
050,29,089,"Missouri","Howard County",4,69,136,70,66
050,29,089,"Missouri","Howard County",4,70,122,60,62
050,29,089,"Missouri","Howard County",4,71,110,50,60
050,29,089,"Missouri","Howard County",4,72,114,49,65
050,29,089,"Missouri","Howard County",4,73,97,42,55
050,29,089,"Missouri","Howard County",4,74,96,48,48
050,29,089,"Missouri","Howard County",4,75,91,48,43
050,29,089,"Missouri","Howard County",4,76,65,35,30
050,29,089,"Missouri","Howard County",4,77,66,34,32
050,29,089,"Missouri","Howard County",4,78,63,27,36
050,29,089,"Missouri","Howard County",4,79,63,27,36
050,29,089,"Missouri","Howard County",4,80,62,27,35
050,29,089,"Missouri","Howard County",4,81,55,24,31
050,29,089,"Missouri","Howard County",4,82,53,25,28
050,29,089,"Missouri","Howard County",4,83,50,19,31
050,29,089,"Missouri","Howard County",4,84,40,19,21
050,29,089,"Missouri","Howard County",4,85,191,80,111
050,29,089,"Missouri","Howard County",5,0,99,45,54
050,29,089,"Missouri","Howard County",5,1,101,48,53
050,29,089,"Missouri","Howard County",5,2,103,64,39
050,29,089,"Missouri","Howard County",5,3,119,54,65
050,29,089,"Missouri","Howard County",5,4,119,62,57
050,29,089,"Missouri","Howard County",5,5,96,54,42
050,29,089,"Missouri","Howard County",5,6,103,61,42
050,29,089,"Missouri","Howard County",5,7,116,59,57
050,29,089,"Missouri","Howard County",5,8,122,63,59
050,29,089,"Missouri","Howard County",5,9,123,61,62
050,29,089,"Missouri","Howard County",5,10,110,54,56
050,29,089,"Missouri","Howard County",5,11,141,74,67
050,29,089,"Missouri","Howard County",5,12,142,81,61
050,29,089,"Missouri","Howard County",5,13,130,82,48
050,29,089,"Missouri","Howard County",5,14,137,73,64
050,29,089,"Missouri","Howard County",5,15,134,66,68
050,29,089,"Missouri","Howard County",5,16,136,69,67
050,29,089,"Missouri","Howard County",5,17,127,63,64
050,29,089,"Missouri","Howard County",5,18,171,84,87
050,29,089,"Missouri","Howard County",5,19,360,194,166
050,29,089,"Missouri","Howard County",5,20,297,166,131
050,29,089,"Missouri","Howard County",5,21,202,94,108
050,29,089,"Missouri","Howard County",5,22,137,70,67
050,29,089,"Missouri","Howard County",5,23,119,66,53
050,29,089,"Missouri","Howard County",5,24,100,66,34
050,29,089,"Missouri","Howard County",5,25,101,51,50
050,29,089,"Missouri","Howard County",5,26,99,56,43
050,29,089,"Missouri","Howard County",5,27,89,42,47
050,29,089,"Missouri","Howard County",5,28,96,46,50
050,29,089,"Missouri","Howard County",5,29,74,45,29
050,29,089,"Missouri","Howard County",5,30,92,42,50
050,29,089,"Missouri","Howard County",5,31,109,53,56
050,29,089,"Missouri","Howard County",5,32,114,56,58
050,29,089,"Missouri","Howard County",5,33,110,53,57
050,29,089,"Missouri","Howard County",5,34,121,63,58
050,29,089,"Missouri","Howard County",5,35,100,47,53
050,29,089,"Missouri","Howard County",5,36,103,57,46
050,29,089,"Missouri","Howard County",5,37,111,53,58
050,29,089,"Missouri","Howard County",5,38,119,54,65
050,29,089,"Missouri","Howard County",5,39,124,57,67
050,29,089,"Missouri","Howard County",5,40,134,60,74
050,29,089,"Missouri","Howard County",5,41,124,61,63
050,29,089,"Missouri","Howard County",5,42,112,56,56
050,29,089,"Missouri","Howard County",5,43,113,57,56
050,29,089,"Missouri","Howard County",5,44,110,55,55
050,29,089,"Missouri","Howard County",5,45,98,53,45
050,29,089,"Missouri","Howard County",5,46,87,48,39
050,29,089,"Missouri","Howard County",5,47,91,44,47
050,29,089,"Missouri","Howard County",5,48,94,49,45
050,29,089,"Missouri","Howard County",5,49,101,55,46
050,29,089,"Missouri","Howard County",5,50,101,53,48
050,29,089,"Missouri","Howard County",5,51,108,57,51
050,29,089,"Missouri","Howard County",5,52,120,60,60
050,29,089,"Missouri","Howard County",5,53,108,55,53
050,29,089,"Missouri","Howard County",5,54,97,51,46
050,29,089,"Missouri","Howard County",5,55,95,52,43
050,29,089,"Missouri","Howard County",5,56,108,60,48
050,29,089,"Missouri","Howard County",5,57,128,65,63
050,29,089,"Missouri","Howard County",5,58,142,74,68
050,29,089,"Missouri","Howard County",5,59,125,69,56
050,29,089,"Missouri","Howard County",5,60,128,70,58
050,29,089,"Missouri","Howard County",5,61,148,77,71
050,29,089,"Missouri","Howard County",5,62,151,74,77
050,29,089,"Missouri","Howard County",5,63,145,66,79
050,29,089,"Missouri","Howard County",5,64,156,74,82
050,29,089,"Missouri","Howard County",5,65,139,65,74
050,29,089,"Missouri","Howard County",5,66,147,74,73
050,29,089,"Missouri","Howard County",5,67,144,66,78
050,29,089,"Missouri","Howard County",5,68,127,66,61
050,29,089,"Missouri","Howard County",5,69,131,64,67
050,29,089,"Missouri","Howard County",5,70,135,70,65
050,29,089,"Missouri","Howard County",5,71,117,59,58
050,29,089,"Missouri","Howard County",5,72,105,46,59
050,29,089,"Missouri","Howard County",5,73,114,50,64
050,29,089,"Missouri","Howard County",5,74,93,39,54
050,29,089,"Missouri","Howard County",5,75,91,47,44
050,29,089,"Missouri","Howard County",5,76,90,46,44
050,29,089,"Missouri","Howard County",5,77,63,34,29
050,29,089,"Missouri","Howard County",5,78,63,32,31
050,29,089,"Missouri","Howard County",5,79,61,25,36
050,29,089,"Missouri","Howard County",5,80,58,25,33
050,29,089,"Missouri","Howard County",5,81,57,25,32
050,29,089,"Missouri","Howard County",5,82,56,23,33
050,29,089,"Missouri","Howard County",5,83,51,24,27
050,29,089,"Missouri","Howard County",5,84,43,18,25
050,29,089,"Missouri","Howard County",5,85,186,80,106
050,29,091,"Missouri","Howell County",1,0,481,245,236
050,29,091,"Missouri","Howell County",1,1,489,249,240
050,29,091,"Missouri","Howell County",1,2,513,263,250
050,29,091,"Missouri","Howell County",1,3,512,258,254
050,29,091,"Missouri","Howell County",1,4,504,264,240
050,29,091,"Missouri","Howell County",1,5,526,261,265
050,29,091,"Missouri","Howell County",1,6,533,261,272
050,29,091,"Missouri","Howell County",1,7,511,273,238
050,29,091,"Missouri","Howell County",1,8,522,270,252
050,29,091,"Missouri","Howell County",1,9,554,287,267
050,29,091,"Missouri","Howell County",1,10,580,309,271
050,29,091,"Missouri","Howell County",1,11,583,308,275
050,29,091,"Missouri","Howell County",1,12,573,305,268
050,29,091,"Missouri","Howell County",1,13,568,289,279
050,29,091,"Missouri","Howell County",1,14,598,296,302
050,29,091,"Missouri","Howell County",1,15,516,260,256
050,29,091,"Missouri","Howell County",1,16,560,270,290
050,29,091,"Missouri","Howell County",1,17,560,279,281
050,29,091,"Missouri","Howell County",1,18,470,249,221
050,29,091,"Missouri","Howell County",1,19,384,210,174
050,29,091,"Missouri","Howell County",1,20,428,223,205
050,29,091,"Missouri","Howell County",1,21,396,201,195
050,29,091,"Missouri","Howell County",1,22,421,216,205
050,29,091,"Missouri","Howell County",1,23,442,229,213
050,29,091,"Missouri","Howell County",1,24,456,225,231
050,29,091,"Missouri","Howell County",1,25,444,228,216
050,29,091,"Missouri","Howell County",1,26,443,230,213
050,29,091,"Missouri","Howell County",1,27,455,230,225
050,29,091,"Missouri","Howell County",1,28,466,227,239
050,29,091,"Missouri","Howell County",1,29,505,244,261
050,29,091,"Missouri","Howell County",1,30,502,251,251
050,29,091,"Missouri","Howell County",1,31,462,225,237
050,29,091,"Missouri","Howell County",1,32,443,213,230
050,29,091,"Missouri","Howell County",1,33,473,228,245
050,29,091,"Missouri","Howell County",1,34,472,224,248
050,29,091,"Missouri","Howell County",1,35,451,222,229
050,29,091,"Missouri","Howell County",1,36,456,215,241
050,29,091,"Missouri","Howell County",1,37,459,235,224
050,29,091,"Missouri","Howell County",1,38,470,235,235
050,29,091,"Missouri","Howell County",1,39,466,231,235
050,29,091,"Missouri","Howell County",1,40,444,231,213
050,29,091,"Missouri","Howell County",1,41,433,227,206
050,29,091,"Missouri","Howell County",1,42,455,231,224
050,29,091,"Missouri","Howell County",1,43,447,233,214
050,29,091,"Missouri","Howell County",1,44,454,225,229
050,29,091,"Missouri","Howell County",1,45,465,220,245
050,29,091,"Missouri","Howell County",1,46,431,203,228
050,29,091,"Missouri","Howell County",1,47,458,225,233
050,29,091,"Missouri","Howell County",1,48,503,244,259
050,29,091,"Missouri","Howell County",1,49,511,250,261
050,29,091,"Missouri","Howell County",1,50,492,239,253
050,29,091,"Missouri","Howell County",1,51,484,241,243
050,29,091,"Missouri","Howell County",1,52,448,222,226
050,29,091,"Missouri","Howell County",1,53,434,216,218
050,29,091,"Missouri","Howell County",1,54,450,222,228
050,29,091,"Missouri","Howell County",1,55,510,253,257
050,29,091,"Missouri","Howell County",1,56,540,274,266
050,29,091,"Missouri","Howell County",1,57,541,257,284
050,29,091,"Missouri","Howell County",1,58,553,272,281
050,29,091,"Missouri","Howell County",1,59,572,281,291
050,29,091,"Missouri","Howell County",1,60,568,273,295
050,29,091,"Missouri","Howell County",1,61,528,247,281
050,29,091,"Missouri","Howell County",1,62,502,237,265
050,29,091,"Missouri","Howell County",1,63,508,239,269
050,29,091,"Missouri","Howell County",1,64,524,257,267
050,29,091,"Missouri","Howell County",1,65,497,237,260
050,29,091,"Missouri","Howell County",1,66,499,241,258
050,29,091,"Missouri","Howell County",1,67,496,231,265
050,29,091,"Missouri","Howell County",1,68,458,212,246
050,29,091,"Missouri","Howell County",1,69,471,234,237
050,29,091,"Missouri","Howell County",1,70,438,216,222
050,29,091,"Missouri","Howell County",1,71,439,212,227
050,29,091,"Missouri","Howell County",1,72,464,214,250
050,29,091,"Missouri","Howell County",1,73,447,207,240
050,29,091,"Missouri","Howell County",1,74,329,161,168
050,29,091,"Missouri","Howell County",1,75,301,139,162
050,29,091,"Missouri","Howell County",1,76,304,135,169
050,29,091,"Missouri","Howell County",1,77,299,136,163
050,29,091,"Missouri","Howell County",1,78,249,109,140
050,29,091,"Missouri","Howell County",1,79,247,101,146
050,29,091,"Missouri","Howell County",1,80,224,85,139
050,29,091,"Missouri","Howell County",1,81,207,86,121
050,29,091,"Missouri","Howell County",1,82,204,84,120
050,29,091,"Missouri","Howell County",1,83,183,82,101
050,29,091,"Missouri","Howell County",1,84,158,63,95
050,29,091,"Missouri","Howell County",1,85,933,320,613
050,29,091,"Missouri","Howell County",2,0,474,249,225
050,29,091,"Missouri","Howell County",2,1,488,248,240
050,29,091,"Missouri","Howell County",2,2,508,261,247
050,29,091,"Missouri","Howell County",2,3,511,260,251
050,29,091,"Missouri","Howell County",2,4,510,266,244
050,29,091,"Missouri","Howell County",2,5,528,265,263
050,29,091,"Missouri","Howell County",2,6,538,266,272
050,29,091,"Missouri","Howell County",2,7,518,271,247
050,29,091,"Missouri","Howell County",2,8,522,272,250
050,29,091,"Missouri","Howell County",2,9,545,283,262
050,29,091,"Missouri","Howell County",2,10,576,304,272
050,29,091,"Missouri","Howell County",2,11,581,307,274
050,29,091,"Missouri","Howell County",2,12,579,308,271
050,29,091,"Missouri","Howell County",2,13,570,293,277
050,29,091,"Missouri","Howell County",2,14,591,294,297
050,29,091,"Missouri","Howell County",2,15,541,271,270
050,29,091,"Missouri","Howell County",2,16,555,271,284
050,29,091,"Missouri","Howell County",2,17,564,279,285
050,29,091,"Missouri","Howell County",2,18,468,247,221
050,29,091,"Missouri","Howell County",2,19,390,210,180
050,29,091,"Missouri","Howell County",2,20,427,226,201
050,29,091,"Missouri","Howell County",2,21,405,207,198
050,29,091,"Missouri","Howell County",2,22,419,214,205
050,29,091,"Missouri","Howell County",2,23,441,227,214
050,29,091,"Missouri","Howell County",2,24,457,228,229
050,29,091,"Missouri","Howell County",2,25,446,226,220
050,29,091,"Missouri","Howell County",2,26,444,231,213
050,29,091,"Missouri","Howell County",2,27,453,231,222
050,29,091,"Missouri","Howell County",2,28,465,228,237
050,29,091,"Missouri","Howell County",2,29,497,239,258
050,29,091,"Missouri","Howell County",2,30,507,250,257
050,29,091,"Missouri","Howell County",2,31,472,231,241
050,29,091,"Missouri","Howell County",2,32,450,215,235
050,29,091,"Missouri","Howell County",2,33,464,223,241
050,29,091,"Missouri","Howell County",2,34,472,226,246
050,29,091,"Missouri","Howell County",2,35,462,225,237
050,29,091,"Missouri","Howell County",2,36,455,217,238
050,29,091,"Missouri","Howell County",2,37,461,231,230
050,29,091,"Missouri","Howell County",2,38,475,238,237
050,29,091,"Missouri","Howell County",2,39,464,231,233
050,29,091,"Missouri","Howell County",2,40,450,230,220
050,29,091,"Missouri","Howell County",2,41,435,228,207
050,29,091,"Missouri","Howell County",2,42,445,230,215
050,29,091,"Missouri","Howell County",2,43,449,232,217
050,29,091,"Missouri","Howell County",2,44,446,225,221
050,29,091,"Missouri","Howell County",2,45,464,221,243
050,29,091,"Missouri","Howell County",2,46,437,209,228
050,29,091,"Missouri","Howell County",2,47,449,219,230
050,29,091,"Missouri","Howell County",2,48,495,241,254
050,29,091,"Missouri","Howell County",2,49,515,252,263
050,29,091,"Missouri","Howell County",2,50,497,240,257
050,29,091,"Missouri","Howell County",2,51,483,238,245
050,29,091,"Missouri","Howell County",2,52,455,227,228
050,29,091,"Missouri","Howell County",2,53,438,217,221
050,29,091,"Missouri","Howell County",2,54,443,220,223
050,29,091,"Missouri","Howell County",2,55,496,246,250
050,29,091,"Missouri","Howell County",2,56,537,273,264
050,29,091,"Missouri","Howell County",2,57,542,262,280
050,29,091,"Missouri","Howell County",2,58,549,268,281
050,29,091,"Missouri","Howell County",2,59,569,279,290
050,29,091,"Missouri","Howell County",2,60,567,273,294
050,29,091,"Missouri","Howell County",2,61,539,255,284
050,29,091,"Missouri","Howell County",2,62,506,240,266
050,29,091,"Missouri","Howell County",2,63,511,241,270
050,29,091,"Missouri","Howell County",2,64,515,250,265
050,29,091,"Missouri","Howell County",2,65,503,242,261
050,29,091,"Missouri","Howell County",2,66,497,237,260
050,29,091,"Missouri","Howell County",2,67,489,227,262
050,29,091,"Missouri","Howell County",2,68,460,214,246
050,29,091,"Missouri","Howell County",2,69,472,232,240
050,29,091,"Missouri","Howell County",2,70,444,217,227
050,29,091,"Missouri","Howell County",2,71,438,214,224
050,29,091,"Missouri","Howell County",2,72,449,209,240
050,29,091,"Missouri","Howell County",2,73,476,218,258
050,29,091,"Missouri","Howell County",2,74,330,160,170
050,29,091,"Missouri","Howell County",2,75,305,144,161
050,29,091,"Missouri","Howell County",2,76,300,135,165
050,29,091,"Missouri","Howell County",2,77,302,135,167
050,29,091,"Missouri","Howell County",2,78,251,110,141
050,29,091,"Missouri","Howell County",2,79,246,103,143
050,29,091,"Missouri","Howell County",2,80,227,88,139
050,29,091,"Missouri","Howell County",2,81,202,81,121
050,29,091,"Missouri","Howell County",2,82,205,82,123
050,29,091,"Missouri","Howell County",2,83,183,80,103
050,29,091,"Missouri","Howell County",2,84,160,66,94
050,29,091,"Missouri","Howell County",2,85,935,319,616
050,29,091,"Missouri","Howell County",3,0,477,233,244
050,29,091,"Missouri","Howell County",3,1,470,247,223
050,29,091,"Missouri","Howell County",3,2,500,264,236
050,29,091,"Missouri","Howell County",3,3,497,257,240
050,29,091,"Missouri","Howell County",3,4,506,252,254
050,29,091,"Missouri","Howell County",3,5,512,273,239
050,29,091,"Missouri","Howell County",3,6,534,269,265
050,29,091,"Missouri","Howell County",3,7,531,262,269
050,29,091,"Missouri","Howell County",3,8,521,276,245
050,29,091,"Missouri","Howell County",3,9,537,278,259
050,29,091,"Missouri","Howell County",3,10,564,301,263
050,29,091,"Missouri","Howell County",3,11,596,316,280
050,29,091,"Missouri","Howell County",3,12,579,309,270
050,29,091,"Missouri","Howell County",3,13,601,321,280
050,29,091,"Missouri","Howell County",3,14,575,301,274
050,29,091,"Missouri","Howell County",3,15,609,305,304
050,29,091,"Missouri","Howell County",3,16,541,270,271
050,29,091,"Missouri","Howell County",3,17,565,275,290
050,29,091,"Missouri","Howell County",3,18,463,247,216
050,29,091,"Missouri","Howell County",3,19,394,205,189
050,29,091,"Missouri","Howell County",3,20,427,231,196
050,29,091,"Missouri","Howell County",3,21,431,225,206
050,29,091,"Missouri","Howell County",3,22,413,211,202
050,29,091,"Missouri","Howell County",3,23,445,222,223
050,29,091,"Missouri","Howell County",3,24,434,219,215
050,29,091,"Missouri","Howell County",3,25,460,236,224
050,29,091,"Missouri","Howell County",3,26,455,233,222
050,29,091,"Missouri","Howell County",3,27,453,231,222
050,29,091,"Missouri","Howell County",3,28,460,235,225
050,29,091,"Missouri","Howell County",3,29,459,226,233
050,29,091,"Missouri","Howell County",3,30,484,231,253
050,29,091,"Missouri","Howell County",3,31,523,265,258
050,29,091,"Missouri","Howell County",3,32,471,225,246
050,29,091,"Missouri","Howell County",3,33,457,216,241
050,29,091,"Missouri","Howell County",3,34,473,231,242
050,29,091,"Missouri","Howell County",3,35,469,222,247
050,29,091,"Missouri","Howell County",3,36,462,224,238
050,29,091,"Missouri","Howell County",3,37,474,236,238
050,29,091,"Missouri","Howell County",3,38,475,231,244
050,29,091,"Missouri","Howell County",3,39,490,248,242
050,29,091,"Missouri","Howell County",3,40,473,235,238
050,29,091,"Missouri","Howell County",3,41,453,227,226
050,29,091,"Missouri","Howell County",3,42,431,219,212
050,29,091,"Missouri","Howell County",3,43,461,237,224
050,29,091,"Missouri","Howell County",3,44,446,234,212
050,29,091,"Missouri","Howell County",3,45,453,223,230
050,29,091,"Missouri","Howell County",3,46,467,222,245
050,29,091,"Missouri","Howell County",3,47,457,219,238
050,29,091,"Missouri","Howell County",3,48,447,222,225
050,29,091,"Missouri","Howell County",3,49,491,239,252
050,29,091,"Missouri","Howell County",3,50,527,253,274
050,29,091,"Missouri","Howell County",3,51,485,243,242
050,29,091,"Missouri","Howell County",3,52,494,240,254
050,29,091,"Missouri","Howell County",3,53,470,229,241
050,29,091,"Missouri","Howell County",3,54,431,215,216
050,29,091,"Missouri","Howell County",3,55,442,224,218
050,29,091,"Missouri","Howell County",3,56,497,239,258
050,29,091,"Missouri","Howell County",3,57,550,284,266
050,29,091,"Missouri","Howell County",3,58,556,274,282
050,29,091,"Missouri","Howell County",3,59,561,266,295
050,29,091,"Missouri","Howell County",3,60,563,262,301
050,29,091,"Missouri","Howell County",3,61,571,274,297
050,29,091,"Missouri","Howell County",3,62,537,259,278
050,29,091,"Missouri","Howell County",3,63,514,244,270
050,29,091,"Missouri","Howell County",3,64,506,243,263
050,29,091,"Missouri","Howell County",3,65,496,234,262
050,29,091,"Missouri","Howell County",3,66,508,247,261
050,29,091,"Missouri","Howell County",3,67,491,232,259
050,29,091,"Missouri","Howell County",3,68,475,217,258
050,29,091,"Missouri","Howell County",3,69,458,216,242
050,29,091,"Missouri","Howell County",3,70,462,220,242
050,29,091,"Missouri","Howell County",3,71,436,216,220
050,29,091,"Missouri","Howell County",3,72,430,211,219
050,29,091,"Missouri","Howell County",3,73,431,191,240
050,29,091,"Missouri","Howell County",3,74,447,208,239
050,29,091,"Missouri","Howell County",3,75,311,153,158
050,29,091,"Missouri","Howell County",3,76,288,132,156
050,29,091,"Missouri","Howell County",3,77,284,118,166
050,29,091,"Missouri","Howell County",3,78,291,129,162
050,29,091,"Missouri","Howell County",3,79,242,109,133
050,29,091,"Missouri","Howell County",3,80,233,98,135
050,29,091,"Missouri","Howell County",3,81,210,88,122
050,29,091,"Missouri","Howell County",3,82,186,72,114
050,29,091,"Missouri","Howell County",3,83,179,64,115
050,29,091,"Missouri","Howell County",3,84,166,68,98
050,29,091,"Missouri","Howell County",3,85,922,313,609
050,29,091,"Missouri","Howell County",4,0,443,207,236
050,29,091,"Missouri","Howell County",4,1,477,239,238
050,29,091,"Missouri","Howell County",4,2,473,245,228
050,29,091,"Missouri","Howell County",4,3,509,264,245
050,29,091,"Missouri","Howell County",4,4,529,270,259
050,29,091,"Missouri","Howell County",4,5,523,262,261
050,29,091,"Missouri","Howell County",4,6,521,279,242
050,29,091,"Missouri","Howell County",4,7,558,284,274
050,29,091,"Missouri","Howell County",4,8,543,261,282
050,29,091,"Missouri","Howell County",4,9,548,288,260
050,29,091,"Missouri","Howell County",4,10,555,285,270
050,29,091,"Missouri","Howell County",4,11,584,314,270
050,29,091,"Missouri","Howell County",4,12,620,328,292
050,29,091,"Missouri","Howell County",4,13,607,333,274
050,29,091,"Missouri","Howell County",4,14,629,337,292
050,29,091,"Missouri","Howell County",4,15,581,306,275
050,29,091,"Missouri","Howell County",4,16,611,318,293
050,29,091,"Missouri","Howell County",4,17,554,283,271
050,29,091,"Missouri","Howell County",4,18,468,239,229
050,29,091,"Missouri","Howell County",4,19,395,206,189
050,29,091,"Missouri","Howell County",4,20,413,222,191
050,29,091,"Missouri","Howell County",4,21,435,230,205
050,29,091,"Missouri","Howell County",4,22,462,239,223
050,29,091,"Missouri","Howell County",4,23,436,217,219
050,29,091,"Missouri","Howell County",4,24,451,232,219
050,29,091,"Missouri","Howell County",4,25,433,211,222
050,29,091,"Missouri","Howell County",4,26,460,231,229
050,29,091,"Missouri","Howell County",4,27,456,227,229
050,29,091,"Missouri","Howell County",4,28,464,232,232
050,29,091,"Missouri","Howell County",4,29,456,235,221
050,29,091,"Missouri","Howell County",4,30,483,239,244
050,29,091,"Missouri","Howell County",4,31,510,237,273
050,29,091,"Missouri","Howell County",4,32,526,264,262
050,29,091,"Missouri","Howell County",4,33,509,241,268
050,29,091,"Missouri","Howell County",4,34,464,224,240
050,29,091,"Missouri","Howell County",4,35,485,242,243
050,29,091,"Missouri","Howell County",4,36,487,231,256
050,29,091,"Missouri","Howell County",4,37,477,227,250
050,29,091,"Missouri","Howell County",4,38,486,239,247
050,29,091,"Missouri","Howell County",4,39,475,236,239
050,29,091,"Missouri","Howell County",4,40,509,255,254
050,29,091,"Missouri","Howell County",4,41,484,243,241
050,29,091,"Missouri","Howell County",4,42,469,236,233
050,29,091,"Missouri","Howell County",4,43,438,217,221
050,29,091,"Missouri","Howell County",4,44,458,235,223
050,29,091,"Missouri","Howell County",4,45,451,236,215
050,29,091,"Missouri","Howell County",4,46,459,237,222
050,29,091,"Missouri","Howell County",4,47,477,219,258
050,29,091,"Missouri","Howell County",4,48,471,233,238
050,29,091,"Missouri","Howell County",4,49,474,235,239
050,29,091,"Missouri","Howell County",4,50,498,244,254
050,29,091,"Missouri","Howell County",4,51,531,262,269
050,29,091,"Missouri","Howell County",4,52,511,255,256
050,29,091,"Missouri","Howell County",4,53,498,238,260
050,29,091,"Missouri","Howell County",4,54,481,236,245
050,29,091,"Missouri","Howell County",4,55,440,221,219
050,29,091,"Missouri","Howell County",4,56,444,221,223
050,29,091,"Missouri","Howell County",4,57,494,242,252
050,29,091,"Missouri","Howell County",4,58,557,286,271
050,29,091,"Missouri","Howell County",4,59,570,275,295
050,29,091,"Missouri","Howell County",4,60,568,263,305
050,29,091,"Missouri","Howell County",4,61,575,271,304
050,29,091,"Missouri","Howell County",4,62,559,269,290
050,29,091,"Missouri","Howell County",4,63,552,263,289
050,29,091,"Missouri","Howell County",4,64,510,246,264
050,29,091,"Missouri","Howell County",4,65,502,247,255
050,29,091,"Missouri","Howell County",4,66,504,243,261
050,29,091,"Missouri","Howell County",4,67,502,237,265
050,29,091,"Missouri","Howell County",4,68,472,226,246
050,29,091,"Missouri","Howell County",4,69,469,217,252
050,29,091,"Missouri","Howell County",4,70,460,210,250
050,29,091,"Missouri","Howell County",4,71,459,224,235
050,29,091,"Missouri","Howell County",4,72,431,216,215
050,29,091,"Missouri","Howell County",4,73,429,207,222
050,29,091,"Missouri","Howell County",4,74,400,180,220
050,29,091,"Missouri","Howell County",4,75,428,197,231
050,29,091,"Missouri","Howell County",4,76,297,146,151
050,29,091,"Missouri","Howell County",4,77,276,120,156
050,29,091,"Missouri","Howell County",4,78,278,114,164
050,29,091,"Missouri","Howell County",4,79,275,119,156
050,29,091,"Missouri","Howell County",4,80,227,101,126
050,29,091,"Missouri","Howell County",4,81,205,88,117
050,29,091,"Missouri","Howell County",4,82,196,78,118
050,29,091,"Missouri","Howell County",4,83,164,55,109
050,29,091,"Missouri","Howell County",4,84,167,57,110
050,29,091,"Missouri","Howell County",4,85,908,306,602
050,29,091,"Missouri","Howell County",5,0,444,208,236
050,29,091,"Missouri","Howell County",5,1,448,199,249
050,29,091,"Missouri","Howell County",5,2,482,234,248
050,29,091,"Missouri","Howell County",5,3,471,247,224
050,29,091,"Missouri","Howell County",5,4,512,281,231
050,29,091,"Missouri","Howell County",5,5,522,269,253
050,29,091,"Missouri","Howell County",5,6,529,272,257
050,29,091,"Missouri","Howell County",5,7,542,285,257
050,29,091,"Missouri","Howell County",5,8,572,298,274
050,29,091,"Missouri","Howell County",5,9,558,274,284
050,29,091,"Missouri","Howell County",5,10,557,294,263
050,29,091,"Missouri","Howell County",5,11,545,274,271
050,29,091,"Missouri","Howell County",5,12,593,320,273
050,29,091,"Missouri","Howell County",5,13,619,328,291
050,29,091,"Missouri","Howell County",5,14,612,324,288
050,29,091,"Missouri","Howell County",5,15,625,338,287
050,29,091,"Missouri","Howell County",5,16,594,311,283
050,29,091,"Missouri","Howell County",5,17,612,315,297
050,29,091,"Missouri","Howell County",5,18,465,247,218
050,29,091,"Missouri","Howell County",5,19,395,193,202
050,29,091,"Missouri","Howell County",5,20,421,223,198
050,29,091,"Missouri","Howell County",5,21,429,211,218
050,29,091,"Missouri","Howell County",5,22,478,256,222
050,29,091,"Missouri","Howell County",5,23,463,244,219
050,29,091,"Missouri","Howell County",5,24,438,219,219
050,29,091,"Missouri","Howell County",5,25,451,239,212
050,29,091,"Missouri","Howell County",5,26,431,205,226
050,29,091,"Missouri","Howell County",5,27,457,222,235
050,29,091,"Missouri","Howell County",5,28,436,222,214
050,29,091,"Missouri","Howell County",5,29,478,241,237
050,29,091,"Missouri","Howell County",5,30,439,225,214
050,29,091,"Missouri","Howell County",5,31,478,238,240
050,29,091,"Missouri","Howell County",5,32,503,230,273
050,29,091,"Missouri","Howell County",5,33,539,271,268
050,29,091,"Missouri","Howell County",5,34,511,251,260
050,29,091,"Missouri","Howell County",5,35,482,234,248
050,29,091,"Missouri","Howell County",5,36,483,235,248
050,29,091,"Missouri","Howell County",5,37,481,235,246
050,29,091,"Missouri","Howell County",5,38,490,230,260
050,29,091,"Missouri","Howell County",5,39,478,235,243
050,29,091,"Missouri","Howell County",5,40,488,238,250
050,29,091,"Missouri","Howell County",5,41,520,265,255
050,29,091,"Missouri","Howell County",5,42,485,242,243
050,29,091,"Missouri","Howell County",5,43,479,241,238
050,29,091,"Missouri","Howell County",5,44,438,218,220
050,29,091,"Missouri","Howell County",5,45,467,238,229
050,29,091,"Missouri","Howell County",5,46,453,240,213
050,29,091,"Missouri","Howell County",5,47,466,234,232
050,29,091,"Missouri","Howell County",5,48,479,219,260
050,29,091,"Missouri","Howell County",5,49,474,238,236
050,29,091,"Missouri","Howell County",5,50,472,234,238
050,29,091,"Missouri","Howell County",5,51,497,243,254
050,29,091,"Missouri","Howell County",5,52,534,265,269
050,29,091,"Missouri","Howell County",5,53,520,255,265
050,29,091,"Missouri","Howell County",5,54,494,237,257
050,29,091,"Missouri","Howell County",5,55,484,236,248
050,29,091,"Missouri","Howell County",5,56,440,227,213
050,29,091,"Missouri","Howell County",5,57,443,220,223
050,29,091,"Missouri","Howell County",5,58,493,243,250
050,29,091,"Missouri","Howell County",5,59,552,284,268
050,29,091,"Missouri","Howell County",5,60,563,262,301
050,29,091,"Missouri","Howell County",5,61,569,274,295
050,29,091,"Missouri","Howell County",5,62,583,274,309
050,29,091,"Missouri","Howell County",5,63,564,267,297
050,29,091,"Missouri","Howell County",5,64,544,255,289
050,29,091,"Missouri","Howell County",5,65,503,243,260
050,29,091,"Missouri","Howell County",5,66,523,263,260
050,29,091,"Missouri","Howell County",5,67,498,239,259
050,29,091,"Missouri","Howell County",5,68,493,235,258
050,29,091,"Missouri","Howell County",5,69,470,228,242
050,29,091,"Missouri","Howell County",5,70,455,201,254
050,29,091,"Missouri","Howell County",5,71,449,213,236
050,29,091,"Missouri","Howell County",5,72,455,222,233
050,29,091,"Missouri","Howell County",5,73,427,207,220
050,29,091,"Missouri","Howell County",5,74,398,199,199
050,29,091,"Missouri","Howell County",5,75,376,169,207
050,29,091,"Missouri","Howell County",5,76,426,196,230
050,29,091,"Missouri","Howell County",5,77,281,130,151
050,29,091,"Missouri","Howell County",5,78,269,121,148
050,29,091,"Missouri","Howell County",5,79,262,100,162
050,29,091,"Missouri","Howell County",5,80,262,115,147
050,29,091,"Missouri","Howell County",5,81,201,93,108
050,29,091,"Missouri","Howell County",5,82,191,78,113
050,29,091,"Missouri","Howell County",5,83,169,59,110
050,29,091,"Missouri","Howell County",5,84,150,49,101
050,29,091,"Missouri","Howell County",5,85,913,305,608
050,29,093,"Missouri","Iron County",1,0,98,51,47
050,29,093,"Missouri","Iron County",1,1,96,57,39
050,29,093,"Missouri","Iron County",1,2,90,51,39
050,29,093,"Missouri","Iron County",1,3,104,55,49
050,29,093,"Missouri","Iron County",1,4,116,54,62
050,29,093,"Missouri","Iron County",1,5,101,48,53
050,29,093,"Missouri","Iron County",1,6,95,54,41
050,29,093,"Missouri","Iron County",1,7,96,46,50
050,29,093,"Missouri","Iron County",1,8,108,62,46
050,29,093,"Missouri","Iron County",1,9,103,56,47
050,29,093,"Missouri","Iron County",1,10,108,58,50
050,29,093,"Missouri","Iron County",1,11,118,68,50
050,29,093,"Missouri","Iron County",1,12,124,61,63
050,29,093,"Missouri","Iron County",1,13,124,58,66
050,29,093,"Missouri","Iron County",1,14,131,62,69
050,29,093,"Missouri","Iron County",1,15,118,66,52
050,29,093,"Missouri","Iron County",1,16,125,68,57
050,29,093,"Missouri","Iron County",1,17,118,62,56
050,29,093,"Missouri","Iron County",1,18,114,62,52
050,29,093,"Missouri","Iron County",1,19,82,45,37
050,29,093,"Missouri","Iron County",1,20,86,44,42
050,29,093,"Missouri","Iron County",1,21,85,45,40
050,29,093,"Missouri","Iron County",1,22,92,47,45
050,29,093,"Missouri","Iron County",1,23,87,46,41
050,29,093,"Missouri","Iron County",1,24,89,46,43
050,29,093,"Missouri","Iron County",1,25,90,48,42
050,29,093,"Missouri","Iron County",1,26,95,46,49
050,29,093,"Missouri","Iron County",1,27,98,49,49
050,29,093,"Missouri","Iron County",1,28,109,49,60
050,29,093,"Missouri","Iron County",1,29,96,53,43
050,29,093,"Missouri","Iron County",1,30,96,59,37
050,29,093,"Missouri","Iron County",1,31,93,51,42
050,29,093,"Missouri","Iron County",1,32,96,50,46
050,29,093,"Missouri","Iron County",1,33,89,45,44
050,29,093,"Missouri","Iron County",1,34,102,55,47
050,29,093,"Missouri","Iron County",1,35,91,46,45
050,29,093,"Missouri","Iron County",1,36,103,54,49
050,29,093,"Missouri","Iron County",1,37,105,49,56
050,29,093,"Missouri","Iron County",1,38,109,47,62
050,29,093,"Missouri","Iron County",1,39,136,56,80
050,29,093,"Missouri","Iron County",1,40,122,56,66
050,29,093,"Missouri","Iron County",1,41,117,55,62
050,29,093,"Missouri","Iron County",1,42,116,64,52
050,29,093,"Missouri","Iron County",1,43,120,57,63
050,29,093,"Missouri","Iron County",1,44,120,54,66
050,29,093,"Missouri","Iron County",1,45,115,57,58
050,29,093,"Missouri","Iron County",1,46,111,60,51
050,29,093,"Missouri","Iron County",1,47,121,65,56
050,29,093,"Missouri","Iron County",1,48,135,72,63
050,29,093,"Missouri","Iron County",1,49,133,67,66
050,29,093,"Missouri","Iron County",1,50,124,63,61
050,29,093,"Missouri","Iron County",1,51,117,65,52
050,29,093,"Missouri","Iron County",1,52,118,62,56
050,29,093,"Missouri","Iron County",1,53,120,56,64
050,29,093,"Missouri","Iron County",1,54,150,81,69
050,29,093,"Missouri","Iron County",1,55,141,70,71
050,29,093,"Missouri","Iron County",1,56,139,71,68
050,29,093,"Missouri","Iron County",1,57,156,77,79
050,29,093,"Missouri","Iron County",1,58,157,80,77
050,29,093,"Missouri","Iron County",1,59,140,82,58
050,29,093,"Missouri","Iron County",1,60,150,76,74
050,29,093,"Missouri","Iron County",1,61,154,76,78
050,29,093,"Missouri","Iron County",1,62,161,83,78
050,29,093,"Missouri","Iron County",1,63,158,90,68
050,29,093,"Missouri","Iron County",1,64,142,62,80
050,29,093,"Missouri","Iron County",1,65,143,63,80
050,29,093,"Missouri","Iron County",1,66,151,74,77
050,29,093,"Missouri","Iron County",1,67,147,72,75
050,29,093,"Missouri","Iron County",1,68,120,56,64
050,29,093,"Missouri","Iron County",1,69,119,55,64
050,29,093,"Missouri","Iron County",1,70,132,65,67
050,29,093,"Missouri","Iron County",1,71,103,55,48
050,29,093,"Missouri","Iron County",1,72,106,58,48
050,29,093,"Missouri","Iron County",1,73,105,51,54
050,29,093,"Missouri","Iron County",1,74,72,33,39
050,29,093,"Missouri","Iron County",1,75,86,42,44
050,29,093,"Missouri","Iron County",1,76,93,40,53
050,29,093,"Missouri","Iron County",1,77,75,33,42
050,29,093,"Missouri","Iron County",1,78,64,31,33
050,29,093,"Missouri","Iron County",1,79,67,29,38
050,29,093,"Missouri","Iron County",1,80,56,27,29
050,29,093,"Missouri","Iron County",1,81,56,25,31
050,29,093,"Missouri","Iron County",1,82,52,18,34
050,29,093,"Missouri","Iron County",1,83,49,23,26
050,29,093,"Missouri","Iron County",1,84,41,21,20
050,29,093,"Missouri","Iron County",1,85,244,86,158
050,29,093,"Missouri","Iron County",2,0,93,53,40
050,29,093,"Missouri","Iron County",2,1,95,55,40
050,29,093,"Missouri","Iron County",2,2,91,52,39
050,29,093,"Missouri","Iron County",2,3,100,53,47
050,29,093,"Missouri","Iron County",2,4,115,54,61
050,29,093,"Missouri","Iron County",2,5,104,50,54
050,29,093,"Missouri","Iron County",2,6,96,52,44
050,29,093,"Missouri","Iron County",2,7,98,49,49
050,29,093,"Missouri","Iron County",2,8,105,58,47
050,29,093,"Missouri","Iron County",2,9,105,58,47
050,29,093,"Missouri","Iron County",2,10,107,58,49
050,29,093,"Missouri","Iron County",2,11,116,65,51
050,29,093,"Missouri","Iron County",2,12,123,62,61
050,29,093,"Missouri","Iron County",2,13,125,59,66
050,29,093,"Missouri","Iron County",2,14,130,62,68
050,29,093,"Missouri","Iron County",2,15,121,65,56
050,29,093,"Missouri","Iron County",2,16,123,67,56
050,29,093,"Missouri","Iron County",2,17,119,63,56
050,29,093,"Missouri","Iron County",2,18,107,59,48
050,29,093,"Missouri","Iron County",2,19,83,45,38
050,29,093,"Missouri","Iron County",2,20,88,46,42
050,29,093,"Missouri","Iron County",2,21,84,45,39
050,29,093,"Missouri","Iron County",2,22,91,47,44
050,29,093,"Missouri","Iron County",2,23,89,47,42
050,29,093,"Missouri","Iron County",2,24,89,47,42
050,29,093,"Missouri","Iron County",2,25,90,47,43
050,29,093,"Missouri","Iron County",2,26,94,47,47
050,29,093,"Missouri","Iron County",2,27,99,50,49
050,29,093,"Missouri","Iron County",2,28,109,50,59
050,29,093,"Missouri","Iron County",2,29,99,53,46
050,29,093,"Missouri","Iron County",2,30,98,59,39
050,29,093,"Missouri","Iron County",2,31,91,52,39
050,29,093,"Missouri","Iron County",2,32,95,50,45
050,29,093,"Missouri","Iron County",2,33,87,44,43
050,29,093,"Missouri","Iron County",2,34,99,51,48
050,29,093,"Missouri","Iron County",2,35,95,49,46
050,29,093,"Missouri","Iron County",2,36,101,52,49
050,29,093,"Missouri","Iron County",2,37,106,51,55
050,29,093,"Missouri","Iron County",2,38,110,49,61
050,29,093,"Missouri","Iron County",2,39,129,54,75
050,29,093,"Missouri","Iron County",2,40,126,56,70
050,29,093,"Missouri","Iron County",2,41,118,56,62
050,29,093,"Missouri","Iron County",2,42,117,62,55
050,29,093,"Missouri","Iron County",2,43,119,59,60
050,29,093,"Missouri","Iron County",2,44,117,52,65
050,29,093,"Missouri","Iron County",2,45,115,56,59
050,29,093,"Missouri","Iron County",2,46,111,59,52
050,29,093,"Missouri","Iron County",2,47,122,66,56
050,29,093,"Missouri","Iron County",2,48,127,68,59
050,29,093,"Missouri","Iron County",2,49,134,69,65
050,29,093,"Missouri","Iron County",2,50,126,64,62
050,29,093,"Missouri","Iron County",2,51,119,66,53
050,29,093,"Missouri","Iron County",2,52,115,61,54
050,29,093,"Missouri","Iron County",2,53,122,58,64
050,29,093,"Missouri","Iron County",2,54,143,75,68
050,29,093,"Missouri","Iron County",2,55,140,70,70
050,29,093,"Missouri","Iron County",2,56,140,71,69
050,29,093,"Missouri","Iron County",2,57,151,76,75
050,29,093,"Missouri","Iron County",2,58,156,79,77
050,29,093,"Missouri","Iron County",2,59,144,81,63
050,29,093,"Missouri","Iron County",2,60,147,77,70
050,29,093,"Missouri","Iron County",2,61,153,77,76
050,29,093,"Missouri","Iron County",2,62,160,82,78
050,29,093,"Missouri","Iron County",2,63,163,91,72
050,29,093,"Missouri","Iron County",2,64,143,65,78
050,29,093,"Missouri","Iron County",2,65,144,64,80
050,29,093,"Missouri","Iron County",2,66,145,68,77
050,29,093,"Missouri","Iron County",2,67,148,72,76
050,29,093,"Missouri","Iron County",2,68,124,59,65
050,29,093,"Missouri","Iron County",2,69,121,57,64
050,29,093,"Missouri","Iron County",2,70,127,62,65
050,29,093,"Missouri","Iron County",2,71,109,57,52
050,29,093,"Missouri","Iron County",2,72,103,56,47
050,29,093,"Missouri","Iron County",2,73,109,56,53
050,29,093,"Missouri","Iron County",2,74,75,35,40
050,29,093,"Missouri","Iron County",2,75,84,41,43
050,29,093,"Missouri","Iron County",2,76,88,38,50
050,29,093,"Missouri","Iron County",2,77,80,35,45
050,29,093,"Missouri","Iron County",2,78,67,31,36
050,29,093,"Missouri","Iron County",2,79,68,30,38
050,29,093,"Missouri","Iron County",2,80,56,26,30
050,29,093,"Missouri","Iron County",2,81,55,25,30
050,29,093,"Missouri","Iron County",2,82,54,20,34
050,29,093,"Missouri","Iron County",2,83,45,21,24
050,29,093,"Missouri","Iron County",2,84,41,20,21
050,29,093,"Missouri","Iron County",2,85,241,86,155
050,29,093,"Missouri","Iron County",3,0,92,44,48
050,29,093,"Missouri","Iron County",3,1,102,53,49
050,29,093,"Missouri","Iron County",3,2,91,50,41
050,29,093,"Missouri","Iron County",3,3,93,50,43
050,29,093,"Missouri","Iron County",3,4,93,49,44
050,29,093,"Missouri","Iron County",3,5,115,57,58
050,29,093,"Missouri","Iron County",3,6,105,49,56
050,29,093,"Missouri","Iron County",3,7,101,49,52
050,29,093,"Missouri","Iron County",3,8,98,48,50
050,29,093,"Missouri","Iron County",3,9,111,56,55
050,29,093,"Missouri","Iron County",3,10,103,59,44
050,29,093,"Missouri","Iron County",3,11,113,59,54
050,29,093,"Missouri","Iron County",3,12,112,63,49
050,29,093,"Missouri","Iron County",3,13,114,58,56
050,29,093,"Missouri","Iron County",3,14,132,59,73
050,29,093,"Missouri","Iron County",3,15,125,56,69
050,29,093,"Missouri","Iron County",3,16,126,70,56
050,29,093,"Missouri","Iron County",3,17,125,70,55
050,29,093,"Missouri","Iron County",3,18,104,57,47
050,29,093,"Missouri","Iron County",3,19,78,39,39
050,29,093,"Missouri","Iron County",3,20,86,46,40
050,29,093,"Missouri","Iron County",3,21,82,43,39
050,29,093,"Missouri","Iron County",3,22,96,47,49
050,29,093,"Missouri","Iron County",3,23,99,52,47
050,29,093,"Missouri","Iron County",3,24,93,54,39
050,29,093,"Missouri","Iron County",3,25,91,48,43
050,29,093,"Missouri","Iron County",3,26,90,50,40
050,29,093,"Missouri","Iron County",3,27,91,50,41
050,29,093,"Missouri","Iron County",3,28,101,47,54
050,29,093,"Missouri","Iron County",3,29,101,43,58
050,29,093,"Missouri","Iron County",3,30,101,54,47
050,29,093,"Missouri","Iron County",3,31,99,64,35
050,29,093,"Missouri","Iron County",3,32,104,57,47
050,29,093,"Missouri","Iron County",3,33,90,45,45
050,29,093,"Missouri","Iron County",3,34,95,46,49
050,29,093,"Missouri","Iron County",3,35,95,47,48
050,29,093,"Missouri","Iron County",3,36,96,53,43
050,29,093,"Missouri","Iron County",3,37,112,57,55
050,29,093,"Missouri","Iron County",3,38,100,46,54
050,29,093,"Missouri","Iron County",3,39,110,50,60
050,29,093,"Missouri","Iron County",3,40,129,53,76
050,29,093,"Missouri","Iron County",3,41,124,54,70
050,29,093,"Missouri","Iron County",3,42,124,59,65
050,29,093,"Missouri","Iron County",3,43,115,61,54
050,29,093,"Missouri","Iron County",3,44,115,56,59
050,29,093,"Missouri","Iron County",3,45,110,52,58
050,29,093,"Missouri","Iron County",3,46,118,58,60
050,29,093,"Missouri","Iron County",3,47,111,61,50
050,29,093,"Missouri","Iron County",3,48,119,62,57
050,29,093,"Missouri","Iron County",3,49,131,70,61
050,29,093,"Missouri","Iron County",3,50,128,64,64
050,29,093,"Missouri","Iron County",3,51,129,70,59
050,29,093,"Missouri","Iron County",3,52,114,59,55
050,29,093,"Missouri","Iron County",3,53,116,59,57
050,29,093,"Missouri","Iron County",3,54,121,59,62
050,29,093,"Missouri","Iron County",3,55,128,64,64
050,29,093,"Missouri","Iron County",3,56,137,68,69
050,29,093,"Missouri","Iron County",3,57,136,70,66
050,29,093,"Missouri","Iron County",3,58,151,74,77
050,29,093,"Missouri","Iron County",3,59,162,80,82
050,29,093,"Missouri","Iron County",3,60,143,82,61
050,29,093,"Missouri","Iron County",3,61,146,79,67
050,29,093,"Missouri","Iron County",3,62,148,75,73
050,29,093,"Missouri","Iron County",3,63,163,86,77
050,29,093,"Missouri","Iron County",3,64,149,76,73
050,29,093,"Missouri","Iron County",3,65,133,58,75
050,29,093,"Missouri","Iron County",3,66,134,61,73
050,29,093,"Missouri","Iron County",3,67,141,69,72
050,29,093,"Missouri","Iron County",3,68,141,69,72
050,29,093,"Missouri","Iron County",3,69,127,60,67
050,29,093,"Missouri","Iron County",3,70,113,52,61
050,29,093,"Missouri","Iron County",3,71,118,58,60
050,29,093,"Missouri","Iron County",3,72,108,56,52
050,29,093,"Missouri","Iron County",3,73,103,55,48
050,29,093,"Missouri","Iron County",3,74,105,55,50
050,29,093,"Missouri","Iron County",3,75,70,34,36
050,29,093,"Missouri","Iron County",3,76,82,39,43
050,29,093,"Missouri","Iron County",3,77,73,32,41
050,29,093,"Missouri","Iron County",3,78,80,34,46
050,29,093,"Missouri","Iron County",3,79,64,28,36
050,29,093,"Missouri","Iron County",3,80,63,28,35
050,29,093,"Missouri","Iron County",3,81,57,24,33
050,29,093,"Missouri","Iron County",3,82,51,23,28
050,29,093,"Missouri","Iron County",3,83,48,18,30
050,29,093,"Missouri","Iron County",3,84,42,16,26
050,29,093,"Missouri","Iron County",3,85,244,92,152
050,29,093,"Missouri","Iron County",4,0,86,43,43
050,29,093,"Missouri","Iron County",4,1,94,38,56
050,29,093,"Missouri","Iron County",4,2,94,52,42
050,29,093,"Missouri","Iron County",4,3,100,58,42
050,29,093,"Missouri","Iron County",4,4,105,56,49
050,29,093,"Missouri","Iron County",4,5,99,54,45
050,29,093,"Missouri","Iron County",4,6,123,60,63
050,29,093,"Missouri","Iron County",4,7,110,50,60
050,29,093,"Missouri","Iron County",4,8,102,52,50
050,29,093,"Missouri","Iron County",4,9,104,51,53
050,29,093,"Missouri","Iron County",4,10,122,65,57
050,29,093,"Missouri","Iron County",4,11,104,60,44
050,29,093,"Missouri","Iron County",4,12,112,60,52
050,29,093,"Missouri","Iron County",4,13,123,75,48
050,29,093,"Missouri","Iron County",4,14,115,60,55
050,29,093,"Missouri","Iron County",4,15,134,63,71
050,29,093,"Missouri","Iron County",4,16,130,57,73
050,29,093,"Missouri","Iron County",4,17,128,76,52
050,29,093,"Missouri","Iron County",4,18,109,62,47
050,29,093,"Missouri","Iron County",4,19,72,42,30
050,29,093,"Missouri","Iron County",4,20,83,44,39
050,29,093,"Missouri","Iron County",4,21,88,49,39
050,29,093,"Missouri","Iron County",4,22,90,42,48
050,29,093,"Missouri","Iron County",4,23,92,46,46
050,29,093,"Missouri","Iron County",4,24,116,58,58
050,29,093,"Missouri","Iron County",4,25,86,47,39
050,29,093,"Missouri","Iron County",4,26,84,45,39
050,29,093,"Missouri","Iron County",4,27,89,53,36
050,29,093,"Missouri","Iron County",4,28,90,46,44
050,29,093,"Missouri","Iron County",4,29,104,50,54
050,29,093,"Missouri","Iron County",4,30,114,51,63
050,29,093,"Missouri","Iron County",4,31,107,58,49
050,29,093,"Missouri","Iron County",4,32,103,69,34
050,29,093,"Missouri","Iron County",4,33,101,54,47
050,29,093,"Missouri","Iron County",4,34,88,44,44
050,29,093,"Missouri","Iron County",4,35,100,51,49
050,29,093,"Missouri","Iron County",4,36,98,52,46
050,29,093,"Missouri","Iron County",4,37,98,54,44
050,29,093,"Missouri","Iron County",4,38,116,55,61
050,29,093,"Missouri","Iron County",4,39,95,44,51
050,29,093,"Missouri","Iron County",4,40,124,59,65
050,29,093,"Missouri","Iron County",4,41,123,53,70
050,29,093,"Missouri","Iron County",4,42,130,58,72
050,29,093,"Missouri","Iron County",4,43,120,60,60
050,29,093,"Missouri","Iron County",4,44,112,54,58
050,29,093,"Missouri","Iron County",4,45,103,52,51
050,29,093,"Missouri","Iron County",4,46,109,53,56
050,29,093,"Missouri","Iron County",4,47,126,71,55
050,29,093,"Missouri","Iron County",4,48,106,59,47
050,29,093,"Missouri","Iron County",4,49,119,64,55
050,29,093,"Missouri","Iron County",4,50,133,71,62
050,29,093,"Missouri","Iron County",4,51,138,73,65
050,29,093,"Missouri","Iron County",4,52,124,65,59
050,29,093,"Missouri","Iron County",4,53,116,56,60
050,29,093,"Missouri","Iron County",4,54,118,65,53
050,29,093,"Missouri","Iron County",4,55,107,52,55
050,29,093,"Missouri","Iron County",4,56,129,65,64
050,29,093,"Missouri","Iron County",4,57,135,67,68
050,29,093,"Missouri","Iron County",4,58,142,70,72
050,29,093,"Missouri","Iron County",4,59,151,72,79
050,29,093,"Missouri","Iron County",4,60,160,80,80
050,29,093,"Missouri","Iron County",4,61,138,81,57
050,29,093,"Missouri","Iron County",4,62,139,75,64
050,29,093,"Missouri","Iron County",4,63,162,89,73
050,29,093,"Missouri","Iron County",4,64,157,78,79
050,29,093,"Missouri","Iron County",4,65,135,72,63
050,29,093,"Missouri","Iron County",4,66,127,56,71
050,29,093,"Missouri","Iron County",4,67,132,62,70
050,29,093,"Missouri","Iron County",4,68,136,69,67
050,29,093,"Missouri","Iron County",4,69,141,63,78
050,29,093,"Missouri","Iron County",4,70,124,60,64
050,29,093,"Missouri","Iron County",4,71,99,49,50
050,29,093,"Missouri","Iron County",4,72,111,54,57
050,29,093,"Missouri","Iron County",4,73,106,54,52
050,29,093,"Missouri","Iron County",4,74,98,52,46
050,29,093,"Missouri","Iron County",4,75,101,56,45
050,29,093,"Missouri","Iron County",4,76,66,29,37
050,29,093,"Missouri","Iron County",4,77,63,32,31
050,29,093,"Missouri","Iron County",4,78,70,28,42
050,29,093,"Missouri","Iron County",4,79,77,34,43
050,29,093,"Missouri","Iron County",4,80,52,23,29
050,29,093,"Missouri","Iron County",4,81,61,29,32
050,29,093,"Missouri","Iron County",4,82,54,24,30
050,29,093,"Missouri","Iron County",4,83,43,20,23
050,29,093,"Missouri","Iron County",4,84,47,16,31
050,29,093,"Missouri","Iron County",4,85,241,86,155
050,29,093,"Missouri","Iron County",5,0,84,41,43
050,29,093,"Missouri","Iron County",5,1,98,52,46
050,29,093,"Missouri","Iron County",5,2,99,44,55
050,29,093,"Missouri","Iron County",5,3,102,54,48
050,29,093,"Missouri","Iron County",5,4,95,54,41
050,29,093,"Missouri","Iron County",5,5,108,58,50
050,29,093,"Missouri","Iron County",5,6,102,59,43
050,29,093,"Missouri","Iron County",5,7,139,70,69
050,29,093,"Missouri","Iron County",5,8,108,48,60
050,29,093,"Missouri","Iron County",5,9,106,57,49
050,29,093,"Missouri","Iron County",5,10,114,49,65
050,29,093,"Missouri","Iron County",5,11,115,61,54
050,29,093,"Missouri","Iron County",5,12,109,59,50
050,29,093,"Missouri","Iron County",5,13,113,61,52
050,29,093,"Missouri","Iron County",5,14,131,71,60
050,29,093,"Missouri","Iron County",5,15,125,64,61
050,29,093,"Missouri","Iron County",5,16,143,69,74
050,29,093,"Missouri","Iron County",5,17,129,57,72
050,29,093,"Missouri","Iron County",5,18,109,70,39
050,29,093,"Missouri","Iron County",5,19,81,45,36
050,29,093,"Missouri","Iron County",5,20,87,49,38
050,29,093,"Missouri","Iron County",5,21,83,49,34
050,29,093,"Missouri","Iron County",5,22,91,50,41
050,29,093,"Missouri","Iron County",5,23,91,42,49
050,29,093,"Missouri","Iron County",5,24,94,50,44
050,29,093,"Missouri","Iron County",5,25,115,59,56
050,29,093,"Missouri","Iron County",5,26,90,49,41
050,29,093,"Missouri","Iron County",5,27,82,48,34
050,29,093,"Missouri","Iron County",5,28,87,49,38
050,29,093,"Missouri","Iron County",5,29,89,47,42
050,29,093,"Missouri","Iron County",5,30,114,55,59
050,29,093,"Missouri","Iron County",5,31,124,55,69
050,29,093,"Missouri","Iron County",5,32,117,63,54
050,29,093,"Missouri","Iron County",5,33,99,63,36
050,29,093,"Missouri","Iron County",5,34,110,60,50
050,29,093,"Missouri","Iron County",5,35,84,43,41
050,29,093,"Missouri","Iron County",5,36,106,54,52
050,29,093,"Missouri","Iron County",5,37,105,57,48
050,29,093,"Missouri","Iron County",5,38,101,54,47
050,29,093,"Missouri","Iron County",5,39,109,50,59
050,29,093,"Missouri","Iron County",5,40,93,46,47
050,29,093,"Missouri","Iron County",5,41,123,56,67
050,29,093,"Missouri","Iron County",5,42,128,57,71
050,29,093,"Missouri","Iron County",5,43,129,55,74
050,29,093,"Missouri","Iron County",5,44,119,54,65
050,29,093,"Missouri","Iron County",5,45,102,53,49
050,29,093,"Missouri","Iron County",5,46,105,53,52
050,29,093,"Missouri","Iron County",5,47,117,60,57
050,29,093,"Missouri","Iron County",5,48,117,68,49
050,29,093,"Missouri","Iron County",5,49,110,63,47
050,29,093,"Missouri","Iron County",5,50,121,63,58
050,29,093,"Missouri","Iron County",5,51,136,76,60
050,29,093,"Missouri","Iron County",5,52,142,74,68
050,29,093,"Missouri","Iron County",5,53,122,61,61
050,29,093,"Missouri","Iron County",5,54,126,62,64
050,29,093,"Missouri","Iron County",5,55,107,57,50
050,29,093,"Missouri","Iron County",5,56,114,58,56
050,29,093,"Missouri","Iron County",5,57,124,68,56
050,29,093,"Missouri","Iron County",5,58,134,63,71
050,29,093,"Missouri","Iron County",5,59,148,72,76
050,29,093,"Missouri","Iron County",5,60,155,74,81
050,29,093,"Missouri","Iron County",5,61,157,79,78
050,29,093,"Missouri","Iron County",5,62,137,82,55
050,29,093,"Missouri","Iron County",5,63,150,85,65
050,29,093,"Missouri","Iron County",5,64,149,75,74
050,29,093,"Missouri","Iron County",5,65,151,78,73
050,29,093,"Missouri","Iron County",5,66,133,70,63
050,29,093,"Missouri","Iron County",5,67,125,55,70
050,29,093,"Missouri","Iron County",5,68,127,57,70
050,29,093,"Missouri","Iron County",5,69,140,70,70
050,29,093,"Missouri","Iron County",5,70,137,59,78
050,29,093,"Missouri","Iron County",5,71,107,55,52
050,29,093,"Missouri","Iron County",5,72,95,46,49
050,29,093,"Missouri","Iron County",5,73,108,55,53
050,29,093,"Missouri","Iron County",5,74,95,47,48
050,29,093,"Missouri","Iron County",5,75,89,48,41
050,29,093,"Missouri","Iron County",5,76,94,51,43
050,29,093,"Missouri","Iron County",5,77,49,23,26
050,29,093,"Missouri","Iron County",5,78,61,30,31
050,29,093,"Missouri","Iron County",5,79,67,30,37
050,29,093,"Missouri","Iron County",5,80,62,27,35
050,29,093,"Missouri","Iron County",5,81,54,22,32
050,29,093,"Missouri","Iron County",5,82,57,28,29
050,29,093,"Missouri","Iron County",5,83,46,23,23
050,29,093,"Missouri","Iron County",5,84,45,19,26
050,29,093,"Missouri","Iron County",5,85,245,86,159
050,29,095,"Missouri","Jackson County",1,0,9021,4601,4420
050,29,095,"Missouri","Jackson County",1,1,9020,4601,4419
050,29,095,"Missouri","Jackson County",1,2,9301,4721,4580
050,29,095,"Missouri","Jackson County",1,3,9386,4775,4611
050,29,095,"Missouri","Jackson County",1,4,9236,4732,4504
050,29,095,"Missouri","Jackson County",1,5,9539,4841,4698
050,29,095,"Missouri","Jackson County",1,6,9477,4866,4611
050,29,095,"Missouri","Jackson County",1,7,9456,4789,4667
050,29,095,"Missouri","Jackson County",1,8,9313,4669,4644
050,29,095,"Missouri","Jackson County",1,9,9370,4749,4621
050,29,095,"Missouri","Jackson County",1,10,9662,4969,4693
050,29,095,"Missouri","Jackson County",1,11,9853,5053,4800
050,29,095,"Missouri","Jackson County",1,12,10103,5215,4888
050,29,095,"Missouri","Jackson County",1,13,9965,5000,4965
050,29,095,"Missouri","Jackson County",1,14,9789,4907,4882
050,29,095,"Missouri","Jackson County",1,15,9533,4820,4713
050,29,095,"Missouri","Jackson County",1,16,9488,4815,4673
050,29,095,"Missouri","Jackson County",1,17,9307,4651,4656
050,29,095,"Missouri","Jackson County",1,18,8268,4222,4046
050,29,095,"Missouri","Jackson County",1,19,7644,3812,3832
050,29,095,"Missouri","Jackson County",1,20,7796,3878,3918
050,29,095,"Missouri","Jackson County",1,21,7986,3881,4105
050,29,095,"Missouri","Jackson County",1,22,8314,4063,4251
050,29,095,"Missouri","Jackson County",1,23,9206,4448,4758
050,29,095,"Missouri","Jackson County",1,24,9946,4889,5057
050,29,095,"Missouri","Jackson County",1,25,10359,5091,5268
050,29,095,"Missouri","Jackson County",1,26,11067,5483,5584
050,29,095,"Missouri","Jackson County",1,27,11356,5597,5759
050,29,095,"Missouri","Jackson County",1,28,11709,5720,5989
050,29,095,"Missouri","Jackson County",1,29,11730,5759,5971
050,29,095,"Missouri","Jackson County",1,30,11437,5539,5898
050,29,095,"Missouri","Jackson County",1,31,11016,5423,5593
050,29,095,"Missouri","Jackson County",1,32,10661,5312,5349
050,29,095,"Missouri","Jackson County",1,33,10533,5188,5345
050,29,095,"Missouri","Jackson County",1,34,10625,5325,5300
050,29,095,"Missouri","Jackson County",1,35,10389,5102,5287
050,29,095,"Missouri","Jackson County",1,36,9948,4839,5109
050,29,095,"Missouri","Jackson County",1,37,10095,4968,5127
050,29,095,"Missouri","Jackson County",1,38,9897,4837,5060
050,29,095,"Missouri","Jackson County",1,39,9791,4821,4970
050,29,095,"Missouri","Jackson County",1,40,9416,4668,4748
050,29,095,"Missouri","Jackson County",1,41,8953,4443,4510
050,29,095,"Missouri","Jackson County",1,42,8608,4231,4377
050,29,095,"Missouri","Jackson County",1,43,8196,4024,4172
050,29,095,"Missouri","Jackson County",1,44,7889,3864,4025
050,29,095,"Missouri","Jackson County",1,45,8057,3956,4101
050,29,095,"Missouri","Jackson County",1,46,7879,3853,4026
050,29,095,"Missouri","Jackson County",1,47,7994,3953,4041
050,29,095,"Missouri","Jackson County",1,48,8652,4262,4390
050,29,095,"Missouri","Jackson County",1,49,9155,4580,4575
050,29,095,"Missouri","Jackson County",1,50,8749,4381,4368
050,29,095,"Missouri","Jackson County",1,51,8378,4225,4153
050,29,095,"Missouri","Jackson County",1,52,7994,3971,4023
050,29,095,"Missouri","Jackson County",1,53,8295,4122,4173
050,29,095,"Missouri","Jackson County",1,54,8455,4148,4307
050,29,095,"Missouri","Jackson County",1,55,8977,4370,4607
050,29,095,"Missouri","Jackson County",1,56,9337,4596,4741
050,29,095,"Missouri","Jackson County",1,57,9540,4644,4896
050,29,095,"Missouri","Jackson County",1,58,9655,4672,4983
050,29,095,"Missouri","Jackson County",1,59,9680,4632,5048
050,29,095,"Missouri","Jackson County",1,60,9699,4652,5047
050,29,095,"Missouri","Jackson County",1,61,9252,4454,4798
050,29,095,"Missouri","Jackson County",1,62,9094,4342,4752
050,29,095,"Missouri","Jackson County",1,63,8727,4211,4516
050,29,095,"Missouri","Jackson County",1,64,8244,3901,4343
050,29,095,"Missouri","Jackson County",1,65,7915,3709,4206
050,29,095,"Missouri","Jackson County",1,66,7690,3573,4117
050,29,095,"Missouri","Jackson County",1,67,7415,3480,3935
050,29,095,"Missouri","Jackson County",1,68,7057,3240,3817
050,29,095,"Missouri","Jackson County",1,69,6576,2998,3578
050,29,095,"Missouri","Jackson County",1,70,6228,2817,3411
050,29,095,"Missouri","Jackson County",1,71,6013,2685,3328
050,29,095,"Missouri","Jackson County",1,72,5906,2661,3245
050,29,095,"Missouri","Jackson County",1,73,5911,2678,3233
050,29,095,"Missouri","Jackson County",1,74,4135,1845,2290
050,29,095,"Missouri","Jackson County",1,75,4107,1800,2307
050,29,095,"Missouri","Jackson County",1,76,3989,1725,2264
050,29,095,"Missouri","Jackson County",1,77,3908,1704,2204
050,29,095,"Missouri","Jackson County",1,78,3448,1490,1958
050,29,095,"Missouri","Jackson County",1,79,3070,1307,1763
050,29,095,"Missouri","Jackson County",1,80,2748,1123,1625
050,29,095,"Missouri","Jackson County",1,81,2564,1068,1496
050,29,095,"Missouri","Jackson County",1,82,2328,958,1370
050,29,095,"Missouri","Jackson County",1,83,2133,848,1285
050,29,095,"Missouri","Jackson County",1,84,2029,809,1220
050,29,095,"Missouri","Jackson County",1,85,12579,4275,8304
050,29,095,"Missouri","Jackson County",2,0,8980,4592,4388
050,29,095,"Missouri","Jackson County",2,1,9007,4594,4413
050,29,095,"Missouri","Jackson County",2,2,9246,4691,4555
050,29,095,"Missouri","Jackson County",2,3,9325,4736,4589
050,29,095,"Missouri","Jackson County",2,4,9277,4741,4536
050,29,095,"Missouri","Jackson County",2,5,9458,4815,4643
050,29,095,"Missouri","Jackson County",2,6,9495,4862,4633
050,29,095,"Missouri","Jackson County",2,7,9449,4798,4651
050,29,095,"Missouri","Jackson County",2,8,9321,4687,4634
050,29,095,"Missouri","Jackson County",2,9,9339,4722,4617
050,29,095,"Missouri","Jackson County",2,10,9551,4894,4657
050,29,095,"Missouri","Jackson County",2,11,9758,5005,4753
050,29,095,"Missouri","Jackson County",2,12,10048,5175,4873
050,29,095,"Missouri","Jackson County",2,13,9968,5037,4931
050,29,095,"Missouri","Jackson County",2,14,9815,4917,4898
050,29,095,"Missouri","Jackson County",2,15,9576,4831,4745
050,29,095,"Missouri","Jackson County",2,16,9500,4814,4686
050,29,095,"Missouri","Jackson County",2,17,9325,4673,4652
050,29,095,"Missouri","Jackson County",2,18,8277,4207,4070
050,29,095,"Missouri","Jackson County",2,19,7700,3832,3868
050,29,095,"Missouri","Jackson County",2,20,7879,3920,3959
050,29,095,"Missouri","Jackson County",2,21,8016,3912,4104
050,29,095,"Missouri","Jackson County",2,22,8470,4123,4347
050,29,095,"Missouri","Jackson County",2,23,9257,4495,4762
050,29,095,"Missouri","Jackson County",2,24,9864,4831,5033
050,29,095,"Missouri","Jackson County",2,25,10354,5093,5261
050,29,095,"Missouri","Jackson County",2,26,10948,5422,5526
050,29,095,"Missouri","Jackson County",2,27,11286,5572,5714
050,29,095,"Missouri","Jackson County",2,28,11611,5692,5919
050,29,095,"Missouri","Jackson County",2,29,11704,5741,5963
050,29,095,"Missouri","Jackson County",2,30,11553,5610,5943
050,29,095,"Missouri","Jackson County",2,31,11074,5429,5645
050,29,095,"Missouri","Jackson County",2,32,10687,5301,5386
050,29,095,"Missouri","Jackson County",2,33,10519,5197,5322
050,29,095,"Missouri","Jackson County",2,34,10575,5282,5293
050,29,095,"Missouri","Jackson County",2,35,10490,5187,5303
050,29,095,"Missouri","Jackson County",2,36,9965,4858,5107
050,29,095,"Missouri","Jackson County",2,37,10053,4938,5115
050,29,095,"Missouri","Jackson County",2,38,9957,4868,5089
050,29,095,"Missouri","Jackson County",2,39,9755,4789,4966
050,29,095,"Missouri","Jackson County",2,40,9566,4731,4835
050,29,095,"Missouri","Jackson County",2,41,9043,4484,4559
050,29,095,"Missouri","Jackson County",2,42,8644,4254,4390
050,29,095,"Missouri","Jackson County",2,43,8337,4093,4244
050,29,095,"Missouri","Jackson County",2,44,7879,3862,4017
050,29,095,"Missouri","Jackson County",2,45,8049,3953,4096
050,29,095,"Missouri","Jackson County",2,46,7880,3849,4031
050,29,095,"Missouri","Jackson County",2,47,7936,3909,4027
050,29,095,"Missouri","Jackson County",2,48,8481,4179,4302
050,29,095,"Missouri","Jackson County",2,49,9053,4521,4532
050,29,095,"Missouri","Jackson County",2,50,8855,4430,4425
050,29,095,"Missouri","Jackson County",2,51,8408,4231,4177
050,29,095,"Missouri","Jackson County",2,52,8064,4021,4043
050,29,095,"Missouri","Jackson County",2,53,8193,4067,4126
050,29,095,"Missouri","Jackson County",2,54,8380,4123,4257
050,29,095,"Missouri","Jackson County",2,55,8822,4299,4523
050,29,095,"Missouri","Jackson County",2,56,9264,4547,4717
050,29,095,"Missouri","Jackson County",2,57,9478,4624,4854
050,29,095,"Missouri","Jackson County",2,58,9600,4651,4949
050,29,095,"Missouri","Jackson County",2,59,9675,4636,5039
050,29,095,"Missouri","Jackson County",2,60,9655,4623,5032
050,29,095,"Missouri","Jackson County",2,61,9318,4471,4847
050,29,095,"Missouri","Jackson County",2,62,9076,4335,4741
050,29,095,"Missouri","Jackson County",2,63,8835,4240,4595
050,29,095,"Missouri","Jackson County",2,64,8274,3933,4341
050,29,095,"Missouri","Jackson County",2,65,7931,3712,4219
050,29,095,"Missouri","Jackson County",2,66,7738,3599,4139
050,29,095,"Missouri","Jackson County",2,67,7417,3460,3957
050,29,095,"Missouri","Jackson County",2,68,7057,3249,3808
050,29,095,"Missouri","Jackson County",2,69,6696,3049,3647
050,29,095,"Missouri","Jackson County",2,70,6263,2838,3425
050,29,095,"Missouri","Jackson County",2,71,6039,2701,3338
050,29,095,"Missouri","Jackson County",2,72,5805,2602,3203
050,29,095,"Missouri","Jackson County",2,73,6141,2771,3370
050,29,095,"Missouri","Jackson County",2,74,4273,1906,2367
050,29,095,"Missouri","Jackson County",2,75,4100,1795,2305
050,29,095,"Missouri","Jackson County",2,76,3953,1714,2239
050,29,095,"Missouri","Jackson County",2,77,3982,1730,2252
050,29,095,"Missouri","Jackson County",2,78,3459,1492,1967
050,29,095,"Missouri","Jackson County",2,79,3108,1323,1785
050,29,095,"Missouri","Jackson County",2,80,2794,1149,1645
050,29,095,"Missouri","Jackson County",2,81,2556,1056,1500
050,29,095,"Missouri","Jackson County",2,82,2355,972,1383
050,29,095,"Missouri","Jackson County",2,83,2149,853,1296
050,29,095,"Missouri","Jackson County",2,84,2018,806,1212
050,29,095,"Missouri","Jackson County",2,85,12584,4268,8316
050,29,095,"Missouri","Jackson County",3,0,8411,4311,4100
050,29,095,"Missouri","Jackson County",3,1,8915,4567,4348
050,29,095,"Missouri","Jackson County",3,2,8971,4543,4428
050,29,095,"Missouri","Jackson County",3,3,9217,4683,4534
050,29,095,"Missouri","Jackson County",3,4,9240,4707,4533
050,29,095,"Missouri","Jackson County",3,5,9303,4782,4521
050,29,095,"Missouri","Jackson County",3,6,9394,4761,4633
050,29,095,"Missouri","Jackson County",3,7,9451,4876,4575
050,29,095,"Missouri","Jackson County",3,8,9366,4766,4600
050,29,095,"Missouri","Jackson County",3,9,9277,4671,4606
050,29,095,"Missouri","Jackson County",3,10,9261,4699,4562
050,29,095,"Missouri","Jackson County",3,11,9520,4892,4628
050,29,095,"Missouri","Jackson County",3,12,9695,4965,4730
050,29,095,"Missouri","Jackson County",3,13,10024,5191,4833
050,29,095,"Missouri","Jackson County",3,14,9988,5044,4944
050,29,095,"Missouri","Jackson County",3,15,9774,4875,4899
050,29,095,"Missouri","Jackson County",3,16,9596,4837,4759
050,29,095,"Missouri","Jackson County",3,17,9401,4767,4634
050,29,095,"Missouri","Jackson County",3,18,8430,4249,4181
050,29,095,"Missouri","Jackson County",3,19,7694,3819,3875
050,29,095,"Missouri","Jackson County",3,20,7892,3928,3964
050,29,095,"Missouri","Jackson County",3,21,8123,3999,4124
050,29,095,"Missouri","Jackson County",3,22,8495,4091,4404
050,29,095,"Missouri","Jackson County",3,23,9573,4593,4980
050,29,095,"Missouri","Jackson County",3,24,10058,4890,5168
050,29,095,"Missouri","Jackson County",3,25,10286,5046,5240
050,29,095,"Missouri","Jackson County",3,26,10622,5282,5340
050,29,095,"Missouri","Jackson County",3,27,11092,5565,5527
050,29,095,"Missouri","Jackson County",3,28,11266,5567,5699
050,29,095,"Missouri","Jackson County",3,29,11494,5678,5816
050,29,095,"Missouri","Jackson County",3,30,11582,5734,5848
050,29,095,"Missouri","Jackson County",3,31,11456,5520,5936
050,29,095,"Missouri","Jackson County",3,32,10879,5310,5569
050,29,095,"Missouri","Jackson County",3,33,10549,5179,5370
050,29,095,"Missouri","Jackson County",3,34,10397,5137,5260
050,29,095,"Missouri","Jackson County",3,35,10448,5223,5225
050,29,095,"Missouri","Jackson County",3,36,10251,5048,5203
050,29,095,"Missouri","Jackson County",3,37,9845,4795,5050
050,29,095,"Missouri","Jackson County",3,38,9908,4821,5087
050,29,095,"Missouri","Jackson County",3,39,9823,4782,5041
050,29,095,"Missouri","Jackson County",3,40,9754,4820,4934
050,29,095,"Missouri","Jackson County",3,41,9482,4683,4799
050,29,095,"Missouri","Jackson County",3,42,9012,4469,4543
050,29,095,"Missouri","Jackson County",3,43,8639,4261,4378
050,29,095,"Missouri","Jackson County",3,44,8265,4067,4198
050,29,095,"Missouri","Jackson County",3,45,7805,3794,4011
050,29,095,"Missouri","Jackson County",3,46,7974,3875,4099
050,29,095,"Missouri","Jackson County",3,47,7841,3839,4002
050,29,095,"Missouri","Jackson County",3,48,7891,3859,4032
050,29,095,"Missouri","Jackson County",3,49,8417,4151,4266
050,29,095,"Missouri","Jackson County",3,50,9005,4477,4528
050,29,095,"Missouri","Jackson County",3,51,8841,4403,4438
050,29,095,"Missouri","Jackson County",3,52,8337,4189,4148
050,29,095,"Missouri","Jackson County",3,53,8010,3995,4015
050,29,095,"Missouri","Jackson County",3,54,8053,3996,4057
050,29,095,"Missouri","Jackson County",3,55,8282,4042,4240
050,29,095,"Missouri","Jackson County",3,56,8769,4262,4507
050,29,095,"Missouri","Jackson County",3,57,9039,4388,4651
050,29,095,"Missouri","Jackson County",3,58,9340,4549,4791
050,29,095,"Missouri","Jackson County",3,59,9401,4525,4876
050,29,095,"Missouri","Jackson County",3,60,9542,4563,4979
050,29,095,"Missouri","Jackson County",3,61,9465,4494,4971
050,29,095,"Missouri","Jackson County",3,62,9142,4353,4789
050,29,095,"Missouri","Jackson County",3,63,8885,4232,4653
050,29,095,"Missouri","Jackson County",3,64,8640,4137,4503
050,29,095,"Missouri","Jackson County",3,65,8063,3806,4257
050,29,095,"Missouri","Jackson County",3,66,7729,3616,4113
050,29,095,"Missouri","Jackson County",3,67,7581,3481,4100
050,29,095,"Missouri","Jackson County",3,68,7209,3345,3864
050,29,095,"Missouri","Jackson County",3,69,6851,3140,3711
050,29,095,"Missouri","Jackson County",3,70,6519,2953,3566
050,29,095,"Missouri","Jackson County",3,71,6129,2741,3388
050,29,095,"Missouri","Jackson County",3,72,5848,2614,3234
050,29,095,"Missouri","Jackson County",3,73,5635,2499,3136
050,29,095,"Missouri","Jackson County",3,74,5936,2692,3244
050,29,095,"Missouri","Jackson County",3,75,4124,1817,2307
050,29,095,"Missouri","Jackson County",3,76,3944,1712,2232
050,29,095,"Missouri","Jackson County",3,77,3785,1646,2139
050,29,095,"Missouri","Jackson County",3,78,3837,1642,2195
050,29,095,"Missouri","Jackson County",3,79,3296,1412,1884
050,29,095,"Missouri","Jackson County",3,80,2910,1208,1702
050,29,095,"Missouri","Jackson County",3,81,2630,1062,1568
050,29,095,"Missouri","Jackson County",3,82,2395,975,1420
050,29,095,"Missouri","Jackson County",3,83,2203,878,1325
050,29,095,"Missouri","Jackson County",3,84,1955,773,1182
050,29,095,"Missouri","Jackson County",3,85,12498,4233,8265
050,29,095,"Missouri","Jackson County",4,0,8381,4290,4091
050,29,095,"Missouri","Jackson County",4,1,8348,4322,4026
050,29,095,"Missouri","Jackson County",4,2,8813,4521,4292
050,29,095,"Missouri","Jackson County",4,3,8891,4499,4392
050,29,095,"Missouri","Jackson County",4,4,9171,4644,4527
050,29,095,"Missouri","Jackson County",4,5,9152,4723,4429
050,29,095,"Missouri","Jackson County",4,6,9279,4741,4538
050,29,095,"Missouri","Jackson County",4,7,9358,4736,4622
050,29,095,"Missouri","Jackson County",4,8,9369,4855,4514
050,29,095,"Missouri","Jackson County",4,9,9314,4761,4553
050,29,095,"Missouri","Jackson County",4,10,9199,4622,4577
050,29,095,"Missouri","Jackson County",4,11,9232,4672,4560
050,29,095,"Missouri","Jackson County",4,12,9454,4838,4616
050,29,095,"Missouri","Jackson County",4,13,9703,4946,4757
050,29,095,"Missouri","Jackson County",4,14,9932,5132,4800
050,29,095,"Missouri","Jackson County",4,15,9897,5017,4880
050,29,095,"Missouri","Jackson County",4,16,9713,4850,4863
050,29,095,"Missouri","Jackson County",4,17,9443,4727,4716
050,29,095,"Missouri","Jackson County",4,18,8409,4282,4127
050,29,095,"Missouri","Jackson County",4,19,7652,3763,3889
050,29,095,"Missouri","Jackson County",4,20,7723,3846,3877
050,29,095,"Missouri","Jackson County",4,21,8017,3978,4039
050,29,095,"Missouri","Jackson County",4,22,8596,4143,4453
050,29,095,"Missouri","Jackson County",4,23,9601,4549,5052
050,29,095,"Missouri","Jackson County",4,24,10325,4973,5352
050,29,095,"Missouri","Jackson County",4,25,10457,5098,5359
050,29,095,"Missouri","Jackson County",4,26,10520,5195,5325
050,29,095,"Missouri","Jackson County",4,27,10792,5306,5486
050,29,095,"Missouri","Jackson County",4,28,11148,5613,5535
050,29,095,"Missouri","Jackson County",4,29,11150,5555,5595
050,29,095,"Missouri","Jackson County",4,30,11382,5668,5714
050,29,095,"Missouri","Jackson County",4,31,11477,5675,5802
050,29,095,"Missouri","Jackson County",4,32,11326,5438,5888
050,29,095,"Missouri","Jackson County",4,33,10707,5232,5475
050,29,095,"Missouri","Jackson County",4,34,10377,5127,5250
050,29,095,"Missouri","Jackson County",4,35,10280,5078,5202
050,29,095,"Missouri","Jackson County",4,36,10306,5138,5168
050,29,095,"Missouri","Jackson County",4,37,10160,4994,5166
050,29,095,"Missouri","Jackson County",4,38,9738,4731,5007
050,29,095,"Missouri","Jackson County",4,39,9787,4763,5024
050,29,095,"Missouri","Jackson County",4,40,9760,4753,5007
050,29,095,"Missouri","Jackson County",4,41,9611,4743,4868
050,29,095,"Missouri","Jackson County",4,42,9427,4633,4794
050,29,095,"Missouri","Jackson County",4,43,8868,4394,4474
050,29,095,"Missouri","Jackson County",4,44,8624,4204,4420
050,29,095,"Missouri","Jackson County",4,45,8190,4014,4176
050,29,095,"Missouri","Jackson County",4,46,7717,3752,3965
050,29,095,"Missouri","Jackson County",4,47,7965,3850,4115
050,29,095,"Missouri","Jackson County",4,48,7812,3794,4018
050,29,095,"Missouri","Jackson County",4,49,7835,3862,3973
050,29,095,"Missouri","Jackson County",4,50,8282,4088,4194
050,29,095,"Missouri","Jackson County",4,51,8879,4421,4458
050,29,095,"Missouri","Jackson County",4,52,8657,4288,4369
050,29,095,"Missouri","Jackson County",4,53,8226,4132,4094
050,29,095,"Missouri","Jackson County",4,54,7937,3950,3987
050,29,095,"Missouri","Jackson County",4,55,7887,3903,3984
050,29,095,"Missouri","Jackson County",4,56,8204,3980,4224
050,29,095,"Missouri","Jackson County",4,57,8568,4142,4426
050,29,095,"Missouri","Jackson County",4,58,8900,4304,4596
050,29,095,"Missouri","Jackson County",4,59,9166,4441,4725
050,29,095,"Missouri","Jackson County",4,60,9209,4417,4792
050,29,095,"Missouri","Jackson County",4,61,9367,4458,4909
050,29,095,"Missouri","Jackson County",4,62,9241,4359,4882
050,29,095,"Missouri","Jackson County",4,63,8907,4227,4680
050,29,095,"Missouri","Jackson County",4,64,8673,4115,4558
050,29,095,"Missouri","Jackson County",4,65,8355,3975,4380
050,29,095,"Missouri","Jackson County",4,66,7849,3690,4159
050,29,095,"Missouri","Jackson County",4,67,7535,3499,4036
050,29,095,"Missouri","Jackson County",4,68,7357,3360,3997
050,29,095,"Missouri","Jackson County",4,69,7041,3258,3783
050,29,095,"Missouri","Jackson County",4,70,6663,3035,3628
050,29,095,"Missouri","Jackson County",4,71,6326,2857,3469
050,29,095,"Missouri","Jackson County",4,72,5897,2641,3256
050,29,095,"Missouri","Jackson County",4,73,5706,2516,3190
050,29,095,"Missouri","Jackson County",4,74,5453,2429,3024
050,29,095,"Missouri","Jackson County",4,75,5701,2577,3124
050,29,095,"Missouri","Jackson County",4,76,3971,1725,2246
050,29,095,"Missouri","Jackson County",4,77,3755,1637,2118
050,29,095,"Missouri","Jackson County",4,78,3650,1570,2080
050,29,095,"Missouri","Jackson County",4,79,3670,1530,2140
050,29,095,"Missouri","Jackson County",4,80,3092,1299,1793
050,29,095,"Missouri","Jackson County",4,81,2739,1130,1609
050,29,095,"Missouri","Jackson County",4,82,2424,954,1470
050,29,095,"Missouri","Jackson County",4,83,2229,885,1344
050,29,095,"Missouri","Jackson County",4,84,2023,793,1230
050,29,095,"Missouri","Jackson County",4,85,12291,4155,8136
050,29,095,"Missouri","Jackson County",5,0,8494,4357,4137
050,29,095,"Missouri","Jackson County",5,1,8427,4337,4090
050,29,095,"Missouri","Jackson County",5,2,8380,4313,4067
050,29,095,"Missouri","Jackson County",5,3,8802,4479,4323
050,29,095,"Missouri","Jackson County",5,4,8792,4472,4320
050,29,095,"Missouri","Jackson County",5,5,9215,4683,4532
050,29,095,"Missouri","Jackson County",5,6,9072,4644,4428
050,29,095,"Missouri","Jackson County",5,7,9256,4741,4515
050,29,095,"Missouri","Jackson County",5,8,9306,4697,4609
050,29,095,"Missouri","Jackson County",5,9,9340,4813,4527
050,29,095,"Missouri","Jackson County",5,10,9220,4724,4496
050,29,095,"Missouri","Jackson County",5,11,9201,4628,4573
050,29,095,"Missouri","Jackson County",5,12,9245,4692,4553
050,29,095,"Missouri","Jackson County",5,13,9443,4820,4623
050,29,095,"Missouri","Jackson County",5,14,9739,4973,4766
050,29,095,"Missouri","Jackson County",5,15,9823,5049,4774
050,29,095,"Missouri","Jackson County",5,16,9961,5024,4937
050,29,095,"Missouri","Jackson County",5,17,9642,4818,4824
050,29,095,"Missouri","Jackson County",5,18,8422,4268,4154
050,29,095,"Missouri","Jackson County",5,19,7698,3826,3872
050,29,095,"Missouri","Jackson County",5,20,7858,3887,3971
050,29,095,"Missouri","Jackson County",5,21,7974,3929,4045
050,29,095,"Missouri","Jackson County",5,22,8528,4132,4396
050,29,095,"Missouri","Jackson County",5,23,9726,4627,5099
050,29,095,"Missouri","Jackson County",5,24,10308,4948,5360
050,29,095,"Missouri","Jackson County",5,25,10862,5201,5661
050,29,095,"Missouri","Jackson County",5,26,10847,5353,5494
050,29,095,"Missouri","Jackson County",5,27,10782,5305,5477
050,29,095,"Missouri","Jackson County",5,28,10801,5331,5470
050,29,095,"Missouri","Jackson County",5,29,11066,5556,5510
050,29,095,"Missouri","Jackson County",5,30,11080,5513,5567
050,29,095,"Missouri","Jackson County",5,31,11322,5601,5721
050,29,095,"Missouri","Jackson County",5,32,11309,5545,5764
050,29,095,"Missouri","Jackson County",5,33,11187,5395,5792
050,29,095,"Missouri","Jackson County",5,34,10533,5151,5382
050,29,095,"Missouri","Jackson County",5,35,10308,5108,5200
050,29,095,"Missouri","Jackson County",5,36,10187,5030,5157
050,29,095,"Missouri","Jackson County",5,37,10198,5080,5118
050,29,095,"Missouri","Jackson County",5,38,10084,4934,5150
050,29,095,"Missouri","Jackson County",5,39,9606,4642,4964
050,29,095,"Missouri","Jackson County",5,40,9675,4686,4989
050,29,095,"Missouri","Jackson County",5,41,9682,4690,4992
050,29,095,"Missouri","Jackson County",5,42,9647,4776,4871
050,29,095,"Missouri","Jackson County",5,43,9437,4655,4782
050,29,095,"Missouri","Jackson County",5,44,8885,4389,4496
050,29,095,"Missouri","Jackson County",5,45,8562,4170,4392
050,29,095,"Missouri","Jackson County",5,46,8138,3969,4169
050,29,095,"Missouri","Jackson County",5,47,7672,3717,3955
050,29,095,"Missouri","Jackson County",5,48,7979,3827,4152
050,29,095,"Missouri","Jackson County",5,49,7789,3774,4015
050,29,095,"Missouri","Jackson County",5,50,7808,3840,3968
050,29,095,"Missouri","Jackson County",5,51,8182,4045,4137
050,29,095,"Missouri","Jackson County",5,52,8766,4328,4438
050,29,095,"Missouri","Jackson County",5,53,8616,4292,4324
050,29,095,"Missouri","Jackson County",5,54,8186,4123,4063
050,29,095,"Missouri","Jackson County",5,55,7826,3875,3951
050,29,095,"Missouri","Jackson County",5,56,7827,3860,3967
050,29,095,"Missouri","Jackson County",5,57,8061,3895,4166
050,29,095,"Missouri","Jackson County",5,58,8481,4056,4425
050,29,095,"Missouri","Jackson County",5,59,8791,4230,4561
050,29,095,"Missouri","Jackson County",5,60,9049,4374,4675
050,29,095,"Missouri","Jackson County",5,61,9086,4338,4748
050,29,095,"Missouri","Jackson County",5,62,9233,4368,4865
050,29,095,"Missouri","Jackson County",5,63,9077,4242,4835
050,29,095,"Missouri","Jackson County",5,64,8733,4135,4598
050,29,095,"Missouri","Jackson County",5,65,8476,3993,4483
050,29,095,"Missouri","Jackson County",5,66,8237,3898,4339
050,29,095,"Missouri","Jackson County",5,67,7735,3612,4123
050,29,095,"Missouri","Jackson County",5,68,7385,3412,3973
050,29,095,"Missouri","Jackson County",5,69,7196,3279,3917
050,29,095,"Missouri","Jackson County",5,70,6883,3180,3703
050,29,095,"Missouri","Jackson County",5,71,6563,2962,3601
050,29,095,"Missouri","Jackson County",5,72,6093,2738,3355
050,29,095,"Missouri","Jackson County",5,73,5764,2565,3199
050,29,095,"Missouri","Jackson County",5,74,5556,2452,3104
050,29,095,"Missouri","Jackson County",5,75,5290,2334,2956
050,29,095,"Missouri","Jackson County",5,76,5545,2489,3056
050,29,095,"Missouri","Jackson County",5,77,3814,1664,2150
050,29,095,"Missouri","Jackson County",5,78,3620,1576,2044
050,29,095,"Missouri","Jackson County",5,79,3506,1486,2020
050,29,095,"Missouri","Jackson County",5,80,3478,1439,2039
050,29,095,"Missouri","Jackson County",5,81,2922,1221,1701
050,29,095,"Missouri","Jackson County",5,82,2569,1050,1519
050,29,095,"Missouri","Jackson County",5,83,2292,883,1409
050,29,095,"Missouri","Jackson County",5,84,2047,813,1234
050,29,095,"Missouri","Jackson County",5,85,12357,4195,8162
050,29,097,"Missouri","Jasper County",1,0,1560,790,770
050,29,097,"Missouri","Jasper County",1,1,1608,797,811
050,29,097,"Missouri","Jasper County",1,2,1596,792,804
050,29,097,"Missouri","Jasper County",1,3,1621,816,805
050,29,097,"Missouri","Jasper County",1,4,1637,852,785
050,29,097,"Missouri","Jasper County",1,5,1668,833,835
050,29,097,"Missouri","Jasper County",1,6,1755,854,901
050,29,097,"Missouri","Jasper County",1,7,1671,848,823
050,29,097,"Missouri","Jasper County",1,8,1725,896,829
050,29,097,"Missouri","Jasper County",1,9,1699,875,824
050,29,097,"Missouri","Jasper County",1,10,1745,874,871
050,29,097,"Missouri","Jasper County",1,11,1841,913,928
050,29,097,"Missouri","Jasper County",1,12,1886,976,910
050,29,097,"Missouri","Jasper County",1,13,1794,901,893
050,29,097,"Missouri","Jasper County",1,14,1761,896,865
050,29,097,"Missouri","Jasper County",1,15,1735,872,863
050,29,097,"Missouri","Jasper County",1,16,1744,861,883
050,29,097,"Missouri","Jasper County",1,17,1705,889,816
050,29,097,"Missouri","Jasper County",1,18,1665,883,782
050,29,097,"Missouri","Jasper County",1,19,1619,821,798
050,29,097,"Missouri","Jasper County",1,20,1554,789,765
050,29,097,"Missouri","Jasper County",1,21,1575,776,799
050,29,097,"Missouri","Jasper County",1,22,1651,808,843
050,29,097,"Missouri","Jasper County",1,23,1569,806,763
050,29,097,"Missouri","Jasper County",1,24,1623,863,760
050,29,097,"Missouri","Jasper County",1,25,1612,810,802
050,29,097,"Missouri","Jasper County",1,26,1632,821,811
050,29,097,"Missouri","Jasper County",1,27,1705,884,821
050,29,097,"Missouri","Jasper County",1,28,1854,916,938
050,29,097,"Missouri","Jasper County",1,29,1788,873,915
050,29,097,"Missouri","Jasper County",1,30,1724,844,880
050,29,097,"Missouri","Jasper County",1,31,1709,858,851
050,29,097,"Missouri","Jasper County",1,32,1611,815,796
050,29,097,"Missouri","Jasper County",1,33,1636,811,825
050,29,097,"Missouri","Jasper County",1,34,1629,791,838
050,29,097,"Missouri","Jasper County",1,35,1647,828,819
050,29,097,"Missouri","Jasper County",1,36,1626,813,813
050,29,097,"Missouri","Jasper County",1,37,1671,834,837
050,29,097,"Missouri","Jasper County",1,38,1645,842,803
050,29,097,"Missouri","Jasper County",1,39,1610,799,811
050,29,097,"Missouri","Jasper County",1,40,1553,800,753
050,29,097,"Missouri","Jasper County",1,41,1504,762,742
050,29,097,"Missouri","Jasper County",1,42,1485,744,741
050,29,097,"Missouri","Jasper County",1,43,1504,762,742
050,29,097,"Missouri","Jasper County",1,44,1453,760,693
050,29,097,"Missouri","Jasper County",1,45,1436,701,735
050,29,097,"Missouri","Jasper County",1,46,1384,685,699
050,29,097,"Missouri","Jasper County",1,47,1471,723,748
050,29,097,"Missouri","Jasper County",1,48,1534,742,792
050,29,097,"Missouri","Jasper County",1,49,1514,742,772
050,29,097,"Missouri","Jasper County",1,50,1418,682,736
050,29,097,"Missouri","Jasper County",1,51,1376,677,699
050,29,097,"Missouri","Jasper County",1,52,1326,657,669
050,29,097,"Missouri","Jasper County",1,53,1379,694,685
050,29,097,"Missouri","Jasper County",1,54,1383,688,695
050,29,097,"Missouri","Jasper County",1,55,1426,717,709
050,29,097,"Missouri","Jasper County",1,56,1499,741,758
050,29,097,"Missouri","Jasper County",1,57,1545,791,754
050,29,097,"Missouri","Jasper County",1,58,1534,765,769
050,29,097,"Missouri","Jasper County",1,59,1487,729,758
050,29,097,"Missouri","Jasper County",1,60,1503,723,780
050,29,097,"Missouri","Jasper County",1,61,1535,729,806
050,29,097,"Missouri","Jasper County",1,62,1533,713,820
050,29,097,"Missouri","Jasper County",1,63,1433,682,751
050,29,097,"Missouri","Jasper County",1,64,1377,653,724
050,29,097,"Missouri","Jasper County",1,65,1275,606,669
050,29,097,"Missouri","Jasper County",1,66,1252,561,691
050,29,097,"Missouri","Jasper County",1,67,1286,600,686
050,29,097,"Missouri","Jasper County",1,68,1276,596,680
050,29,097,"Missouri","Jasper County",1,69,1129,522,607
050,29,097,"Missouri","Jasper County",1,70,1089,483,606
050,29,097,"Missouri","Jasper County",1,71,1047,478,569
050,29,097,"Missouri","Jasper County",1,72,1053,490,563
050,29,097,"Missouri","Jasper County",1,73,1081,512,569
050,29,097,"Missouri","Jasper County",1,74,710,326,384
050,29,097,"Missouri","Jasper County",1,75,717,321,396
050,29,097,"Missouri","Jasper County",1,76,755,349,406
050,29,097,"Missouri","Jasper County",1,77,725,329,396
050,29,097,"Missouri","Jasper County",1,78,631,271,360
050,29,097,"Missouri","Jasper County",1,79,582,258,324
050,29,097,"Missouri","Jasper County",1,80,535,227,308
050,29,097,"Missouri","Jasper County",1,81,529,226,303
050,29,097,"Missouri","Jasper County",1,82,444,190,254
050,29,097,"Missouri","Jasper County",1,83,399,166,233
050,29,097,"Missouri","Jasper County",1,84,376,156,220
050,29,097,"Missouri","Jasper County",1,85,2181,710,1471
050,29,097,"Missouri","Jasper County",2,0,1557,803,754
050,29,097,"Missouri","Jasper County",2,1,1598,795,803
050,29,097,"Missouri","Jasper County",2,2,1596,789,807
050,29,097,"Missouri","Jasper County",2,3,1604,803,801
050,29,097,"Missouri","Jasper County",2,4,1637,846,791
050,29,097,"Missouri","Jasper County",2,5,1664,839,825
050,29,097,"Missouri","Jasper County",2,6,1734,848,886
050,29,097,"Missouri","Jasper County",2,7,1691,848,843
050,29,097,"Missouri","Jasper County",2,8,1705,878,827
050,29,097,"Missouri","Jasper County",2,9,1707,878,829
050,29,097,"Missouri","Jasper County",2,10,1731,867,864
050,29,097,"Missouri","Jasper County",2,11,1816,904,912
050,29,097,"Missouri","Jasper County",2,12,1882,964,918
050,29,097,"Missouri","Jasper County",2,13,1810,916,894
050,29,097,"Missouri","Jasper County",2,14,1763,894,869
050,29,097,"Missouri","Jasper County",2,15,1749,880,869
050,29,097,"Missouri","Jasper County",2,16,1745,865,880
050,29,097,"Missouri","Jasper County",2,17,1720,886,834
050,29,097,"Missouri","Jasper County",2,18,1645,871,774
050,29,097,"Missouri","Jasper County",2,19,1633,832,801
050,29,097,"Missouri","Jasper County",2,20,1584,798,786
050,29,097,"Missouri","Jasper County",2,21,1590,787,803
050,29,097,"Missouri","Jasper County",2,22,1632,802,830
050,29,097,"Missouri","Jasper County",2,23,1601,817,784
050,29,097,"Missouri","Jasper County",2,24,1606,848,758
050,29,097,"Missouri","Jasper County",2,25,1610,819,791
050,29,097,"Missouri","Jasper County",2,26,1625,820,805
050,29,097,"Missouri","Jasper County",2,27,1684,861,823
050,29,097,"Missouri","Jasper County",2,28,1815,907,908
050,29,097,"Missouri","Jasper County",2,29,1797,878,919
050,29,097,"Missouri","Jasper County",2,30,1742,847,895
050,29,097,"Missouri","Jasper County",2,31,1701,846,855
050,29,097,"Missouri","Jasper County",2,32,1625,817,808
050,29,097,"Missouri","Jasper County",2,33,1623,806,817
050,29,097,"Missouri","Jasper County",2,34,1630,794,836
050,29,097,"Missouri","Jasper County",2,35,1655,823,832
050,29,097,"Missouri","Jasper County",2,36,1620,811,809
050,29,097,"Missouri","Jasper County",2,37,1665,832,833
050,29,097,"Missouri","Jasper County",2,38,1652,839,813
050,29,097,"Missouri","Jasper County",2,39,1607,808,799
050,29,097,"Missouri","Jasper County",2,40,1572,804,768
050,29,097,"Missouri","Jasper County",2,41,1510,767,743
050,29,097,"Missouri","Jasper County",2,42,1484,744,740
050,29,097,"Missouri","Jasper County",2,43,1514,768,746
050,29,097,"Missouri","Jasper County",2,44,1451,753,698
050,29,097,"Missouri","Jasper County",2,45,1444,719,725
050,29,097,"Missouri","Jasper County",2,46,1388,684,704
050,29,097,"Missouri","Jasper County",2,47,1448,711,737
050,29,097,"Missouri","Jasper County",2,48,1512,736,776
050,29,097,"Missouri","Jasper County",2,49,1523,743,780
050,29,097,"Missouri","Jasper County",2,50,1445,698,747
050,29,097,"Missouri","Jasper County",2,51,1383,676,707
050,29,097,"Missouri","Jasper County",2,52,1339,662,677
050,29,097,"Missouri","Jasper County",2,53,1372,688,684
050,29,097,"Missouri","Jasper County",2,54,1373,688,685
050,29,097,"Missouri","Jasper County",2,55,1414,705,709
050,29,097,"Missouri","Jasper County",2,56,1483,735,748
050,29,097,"Missouri","Jasper County",2,57,1539,781,758
050,29,097,"Missouri","Jasper County",2,58,1539,772,767
050,29,097,"Missouri","Jasper County",2,59,1503,739,764
050,29,097,"Missouri","Jasper County",2,60,1495,717,778
050,29,097,"Missouri","Jasper County",2,61,1522,722,800
050,29,097,"Missouri","Jasper County",2,62,1531,716,815
050,29,097,"Missouri","Jasper County",2,63,1465,692,773
050,29,097,"Missouri","Jasper County",2,64,1382,657,725
050,29,097,"Missouri","Jasper County",2,65,1299,613,686
050,29,097,"Missouri","Jasper County",2,66,1256,572,684
050,29,097,"Missouri","Jasper County",2,67,1270,592,678
050,29,097,"Missouri","Jasper County",2,68,1270,591,679
050,29,097,"Missouri","Jasper County",2,69,1175,544,631
050,29,097,"Missouri","Jasper County",2,70,1092,489,603
050,29,097,"Missouri","Jasper County",2,71,1054,476,578
050,29,097,"Missouri","Jasper County",2,72,1032,479,553
050,29,097,"Missouri","Jasper County",2,73,1124,531,593
050,29,097,"Missouri","Jasper County",2,74,749,348,401
050,29,097,"Missouri","Jasper County",2,75,717,322,395
050,29,097,"Missouri","Jasper County",2,76,733,336,397
050,29,097,"Missouri","Jasper County",2,77,750,343,407
050,29,097,"Missouri","Jasper County",2,78,634,275,359
050,29,097,"Missouri","Jasper County",2,79,588,257,331
050,29,097,"Missouri","Jasper County",2,80,540,231,309
050,29,097,"Missouri","Jasper County",2,81,516,222,294
050,29,097,"Missouri","Jasper County",2,82,457,193,264
050,29,097,"Missouri","Jasper County",2,83,401,166,235
050,29,097,"Missouri","Jasper County",2,84,374,155,219
050,29,097,"Missouri","Jasper County",2,85,2194,712,1482
050,29,097,"Missouri","Jasper County",3,0,1507,773,734
050,29,097,"Missouri","Jasper County",3,1,1548,792,756
050,29,097,"Missouri","Jasper County",3,2,1618,825,793
050,29,097,"Missouri","Jasper County",3,3,1665,826,839
050,29,097,"Missouri","Jasper County",3,4,1606,814,792
050,29,097,"Missouri","Jasper County",3,5,1636,855,781
050,29,097,"Missouri","Jasper County",3,6,1631,820,811
050,29,097,"Missouri","Jasper County",3,7,1747,862,885
050,29,097,"Missouri","Jasper County",3,8,1698,862,836
050,29,097,"Missouri","Jasper County",3,9,1713,898,815
050,29,097,"Missouri","Jasper County",3,10,1712,879,833
050,29,097,"Missouri","Jasper County",3,11,1768,886,882
050,29,097,"Missouri","Jasper County",3,12,1827,923,904
050,29,097,"Missouri","Jasper County",3,13,1862,955,907
050,29,097,"Missouri","Jasper County",3,14,1786,911,875
050,29,097,"Missouri","Jasper County",3,15,1806,920,886
050,29,097,"Missouri","Jasper County",3,16,1732,875,857
050,29,097,"Missouri","Jasper County",3,17,1734,863,871
050,29,097,"Missouri","Jasper County",3,18,1609,832,777
050,29,097,"Missouri","Jasper County",3,19,1625,845,780
050,29,097,"Missouri","Jasper County",3,20,1667,850,817
050,29,097,"Missouri","Jasper County",3,21,1670,838,832
050,29,097,"Missouri","Jasper County",3,22,1639,797,842
050,29,097,"Missouri","Jasper County",3,23,1659,813,846
050,29,097,"Missouri","Jasper County",3,24,1633,857,776
050,29,097,"Missouri","Jasper County",3,25,1667,862,805
050,29,097,"Missouri","Jasper County",3,26,1579,800,779
050,29,097,"Missouri","Jasper County",3,27,1690,866,824
050,29,097,"Missouri","Jasper County",3,28,1694,859,835
050,29,097,"Missouri","Jasper County",3,29,1806,904,902
050,29,097,"Missouri","Jasper County",3,30,1755,856,899
050,29,097,"Missouri","Jasper County",3,31,1740,842,898
050,29,097,"Missouri","Jasper County",3,32,1671,825,846
050,29,097,"Missouri","Jasper County",3,33,1619,826,793
050,29,097,"Missouri","Jasper County",3,34,1598,799,799
050,29,097,"Missouri","Jasper County",3,35,1636,805,831
050,29,097,"Missouri","Jasper County",3,36,1643,821,822
050,29,097,"Missouri","Jasper County",3,37,1624,813,811
050,29,097,"Missouri","Jasper County",3,38,1647,822,825
050,29,097,"Missouri","Jasper County",3,39,1662,839,823
050,29,097,"Missouri","Jasper County",3,40,1622,828,794
050,29,097,"Missouri","Jasper County",3,41,1579,810,769
050,29,097,"Missouri","Jasper County",3,42,1500,759,741
050,29,097,"Missouri","Jasper County",3,43,1480,727,753
050,29,097,"Missouri","Jasper County",3,44,1510,773,737
050,29,097,"Missouri","Jasper County",3,45,1449,747,702
050,29,097,"Missouri","Jasper County",3,46,1443,727,716
050,29,097,"Missouri","Jasper County",3,47,1402,682,720
050,29,097,"Missouri","Jasper County",3,48,1432,718,714
050,29,097,"Missouri","Jasper County",3,49,1484,712,772
050,29,097,"Missouri","Jasper County",3,50,1541,753,788
050,29,097,"Missouri","Jasper County",3,51,1452,702,750
050,29,097,"Missouri","Jasper County",3,52,1383,679,704
050,29,097,"Missouri","Jasper County",3,53,1326,666,660
050,29,097,"Missouri","Jasper County",3,54,1363,688,675
050,29,097,"Missouri","Jasper County",3,55,1332,657,675
050,29,097,"Missouri","Jasper County",3,56,1396,691,705
050,29,097,"Missouri","Jasper County",3,57,1482,748,734
050,29,097,"Missouri","Jasper County",3,58,1515,764,751
050,29,097,"Missouri","Jasper County",3,59,1518,763,755
050,29,097,"Missouri","Jasper County",3,60,1487,734,753
050,29,097,"Missouri","Jasper County",3,61,1452,693,759
050,29,097,"Missouri","Jasper County",3,62,1525,723,802
050,29,097,"Missouri","Jasper County",3,63,1506,703,803
050,29,097,"Missouri","Jasper County",3,64,1447,680,767
050,29,097,"Missouri","Jasper County",3,65,1359,645,714
050,29,097,"Missouri","Jasper County",3,66,1282,594,688
050,29,097,"Missouri","Jasper County",3,67,1240,572,668
050,29,097,"Missouri","Jasper County",3,68,1251,563,688
050,29,097,"Missouri","Jasper County",3,69,1254,578,676
050,29,097,"Missouri","Jasper County",3,70,1141,544,597
050,29,097,"Missouri","Jasper County",3,71,1053,470,583
050,29,097,"Missouri","Jasper County",3,72,1016,461,555
050,29,097,"Missouri","Jasper County",3,73,1003,458,545
050,29,097,"Missouri","Jasper County",3,74,1089,508,581
050,29,097,"Missouri","Jasper County",3,75,738,339,399
050,29,097,"Missouri","Jasper County",3,76,681,302,379
050,29,097,"Missouri","Jasper County",3,77,710,316,394
050,29,097,"Missouri","Jasper County",3,78,708,326,382
050,29,097,"Missouri","Jasper County",3,79,597,242,355
050,29,097,"Missouri","Jasper County",3,80,553,244,309
050,29,097,"Missouri","Jasper County",3,81,509,217,292
050,29,097,"Missouri","Jasper County",3,82,463,193,270
050,29,097,"Missouri","Jasper County",3,83,410,171,239
050,29,097,"Missouri","Jasper County",3,84,364,147,217
050,29,097,"Missouri","Jasper County",3,85,2148,691,1457
050,29,097,"Missouri","Jasper County",4,0,1577,785,792
050,29,097,"Missouri","Jasper County",4,1,1466,739,727
050,29,097,"Missouri","Jasper County",4,2,1571,804,767
050,29,097,"Missouri","Jasper County",4,3,1643,836,807
050,29,097,"Missouri","Jasper County",4,4,1649,823,826
050,29,097,"Missouri","Jasper County",4,5,1630,828,802
050,29,097,"Missouri","Jasper County",4,6,1661,879,782
050,29,097,"Missouri","Jasper County",4,7,1686,855,831
050,29,097,"Missouri","Jasper County",4,8,1746,864,882
050,29,097,"Missouri","Jasper County",4,9,1720,852,868
050,29,097,"Missouri","Jasper County",4,10,1714,898,816
050,29,097,"Missouri","Jasper County",4,11,1699,885,814
050,29,097,"Missouri","Jasper County",4,12,1767,890,877
050,29,097,"Missouri","Jasper County",4,13,1840,930,910
050,29,097,"Missouri","Jasper County",4,14,1874,972,902
050,29,097,"Missouri","Jasper County",4,15,1798,917,881
050,29,097,"Missouri","Jasper County",4,16,1820,905,915
050,29,097,"Missouri","Jasper County",4,17,1751,900,851
050,29,097,"Missouri","Jasper County",4,18,1616,831,785
050,29,097,"Missouri","Jasper County",4,19,1558,792,766
050,29,097,"Missouri","Jasper County",4,20,1619,822,797
050,29,097,"Missouri","Jasper County",4,21,1745,879,866
050,29,097,"Missouri","Jasper County",4,22,1718,862,856
050,29,097,"Missouri","Jasper County",4,23,1662,793,869
050,29,097,"Missouri","Jasper County",4,24,1685,864,821
050,29,097,"Missouri","Jasper County",4,25,1655,840,815
050,29,097,"Missouri","Jasper County",4,26,1696,877,819
050,29,097,"Missouri","Jasper County",4,27,1631,837,794
050,29,097,"Missouri","Jasper County",4,28,1698,886,812
050,29,097,"Missouri","Jasper County",4,29,1700,870,830
050,29,097,"Missouri","Jasper County",4,30,1794,901,893
050,29,097,"Missouri","Jasper County",4,31,1756,843,913
050,29,097,"Missouri","Jasper County",4,32,1725,860,865
050,29,097,"Missouri","Jasper County",4,33,1686,819,867
050,29,097,"Missouri","Jasper County",4,34,1611,823,788
050,29,097,"Missouri","Jasper County",4,35,1579,772,807
050,29,097,"Missouri","Jasper County",4,36,1615,794,821
050,29,097,"Missouri","Jasper County",4,37,1656,830,826
050,29,097,"Missouri","Jasper County",4,38,1629,816,813
050,29,097,"Missouri","Jasper County",4,39,1634,829,805
050,29,097,"Missouri","Jasper County",4,40,1671,843,828
050,29,097,"Missouri","Jasper County",4,41,1597,808,789
050,29,097,"Missouri","Jasper County",4,42,1581,808,773
050,29,097,"Missouri","Jasper County",4,43,1516,766,750
050,29,097,"Missouri","Jasper County",4,44,1490,736,754
050,29,097,"Missouri","Jasper County",4,45,1519,769,750
050,29,097,"Missouri","Jasper County",4,46,1416,740,676
050,29,097,"Missouri","Jasper County",4,47,1451,730,721
050,29,097,"Missouri","Jasper County",4,48,1395,683,712
050,29,097,"Missouri","Jasper County",4,49,1405,693,712
050,29,097,"Missouri","Jasper County",4,50,1479,722,757
050,29,097,"Missouri","Jasper County",4,51,1510,731,779
050,29,097,"Missouri","Jasper County",4,52,1481,712,769
050,29,097,"Missouri","Jasper County",4,53,1400,688,712
050,29,097,"Missouri","Jasper County",4,54,1326,672,654
050,29,097,"Missouri","Jasper County",4,55,1351,687,664
050,29,097,"Missouri","Jasper County",4,56,1323,641,682
050,29,097,"Missouri","Jasper County",4,57,1396,688,708
050,29,097,"Missouri","Jasper County",4,58,1457,732,725
050,29,097,"Missouri","Jasper County",4,59,1501,747,754
050,29,097,"Missouri","Jasper County",4,60,1515,756,759
050,29,097,"Missouri","Jasper County",4,61,1452,700,752
050,29,097,"Missouri","Jasper County",4,62,1459,701,758
050,29,097,"Missouri","Jasper County",4,63,1496,708,788
050,29,097,"Missouri","Jasper County",4,64,1495,684,811
050,29,097,"Missouri","Jasper County",4,65,1414,658,756
050,29,097,"Missouri","Jasper County",4,66,1332,630,702
050,29,097,"Missouri","Jasper County",4,67,1264,589,675
050,29,097,"Missouri","Jasper County",4,68,1244,550,694
050,29,097,"Missouri","Jasper County",4,69,1243,548,695
050,29,097,"Missouri","Jasper County",4,70,1225,562,663
050,29,097,"Missouri","Jasper County",4,71,1121,530,591
050,29,097,"Missouri","Jasper County",4,72,1010,460,550
050,29,097,"Missouri","Jasper County",4,73,975,435,540
050,29,097,"Missouri","Jasper County",4,74,982,441,541
050,29,097,"Missouri","Jasper County",4,75,1067,485,582
050,29,097,"Missouri","Jasper County",4,76,691,308,383
050,29,097,"Missouri","Jasper County",4,77,658,291,367
050,29,097,"Missouri","Jasper County",4,78,681,299,382
050,29,097,"Missouri","Jasper County",4,79,672,301,371
050,29,097,"Missouri","Jasper County",4,80,568,230,338
050,29,097,"Missouri","Jasper County",4,81,523,231,292
050,29,097,"Missouri","Jasper County",4,82,456,188,268
050,29,097,"Missouri","Jasper County",4,83,409,158,251
050,29,097,"Missouri","Jasper County",4,84,364,148,216
050,29,097,"Missouri","Jasper County",4,85,2155,715,1440
050,29,097,"Missouri","Jasper County",5,0,1573,783,790
050,29,097,"Missouri","Jasper County",5,1,1575,791,784
050,29,097,"Missouri","Jasper County",5,2,1489,756,733
050,29,097,"Missouri","Jasper County",5,3,1613,833,780
050,29,097,"Missouri","Jasper County",5,4,1614,823,791
050,29,097,"Missouri","Jasper County",5,5,1646,816,830
050,29,097,"Missouri","Jasper County",5,6,1609,819,790
050,29,097,"Missouri","Jasper County",5,7,1641,863,778
050,29,097,"Missouri","Jasper County",5,8,1694,854,840
050,29,097,"Missouri","Jasper County",5,9,1779,886,893
050,29,097,"Missouri","Jasper County",5,10,1725,841,884
050,29,097,"Missouri","Jasper County",5,11,1728,922,806
050,29,097,"Missouri","Jasper County",5,12,1717,899,818
050,29,097,"Missouri","Jasper County",5,13,1767,883,884
050,29,097,"Missouri","Jasper County",5,14,1825,929,896
050,29,097,"Missouri","Jasper County",5,15,1875,957,918
050,29,097,"Missouri","Jasper County",5,16,1842,920,922
050,29,097,"Missouri","Jasper County",5,17,1829,909,920
050,29,097,"Missouri","Jasper County",5,18,1607,822,785
050,29,097,"Missouri","Jasper County",5,19,1590,791,799
050,29,097,"Missouri","Jasper County",5,20,1578,784,794
050,29,097,"Missouri","Jasper County",5,21,1715,874,841
050,29,097,"Missouri","Jasper County",5,22,1788,923,865
050,29,097,"Missouri","Jasper County",5,23,1816,898,918
050,29,097,"Missouri","Jasper County",5,24,1691,815,876
050,29,097,"Missouri","Jasper County",5,25,1717,885,832
050,29,097,"Missouri","Jasper County",5,26,1639,845,794
050,29,097,"Missouri","Jasper County",5,27,1694,864,830
050,29,097,"Missouri","Jasper County",5,28,1645,850,795
050,29,097,"Missouri","Jasper County",5,29,1681,882,799
050,29,097,"Missouri","Jasper County",5,30,1724,876,848
050,29,097,"Missouri","Jasper County",5,31,1804,904,900
050,29,097,"Missouri","Jasper County",5,32,1754,841,913
050,29,097,"Missouri","Jasper County",5,33,1707,861,846
050,29,097,"Missouri","Jasper County",5,34,1678,826,852
050,29,097,"Missouri","Jasper County",5,35,1605,821,784
050,29,097,"Missouri","Jasper County",5,36,1590,790,800
050,29,097,"Missouri","Jasper County",5,37,1606,807,799
050,29,097,"Missouri","Jasper County",5,38,1669,836,833
050,29,097,"Missouri","Jasper County",5,39,1636,818,818
050,29,097,"Missouri","Jasper County",5,40,1633,833,800
050,29,097,"Missouri","Jasper County",5,41,1670,838,832
050,29,097,"Missouri","Jasper County",5,42,1612,813,799
050,29,097,"Missouri","Jasper County",5,43,1611,833,778
050,29,097,"Missouri","Jasper County",5,44,1515,770,745
050,29,097,"Missouri","Jasper County",5,45,1494,723,771
050,29,097,"Missouri","Jasper County",5,46,1518,775,743
050,29,097,"Missouri","Jasper County",5,47,1426,753,673
050,29,097,"Missouri","Jasper County",5,48,1449,729,720
050,29,097,"Missouri","Jasper County",5,49,1410,678,732
050,29,097,"Missouri","Jasper County",5,50,1406,702,704
050,29,097,"Missouri","Jasper County",5,51,1495,745,750
050,29,097,"Missouri","Jasper County",5,52,1534,732,802
050,29,097,"Missouri","Jasper County",5,53,1501,720,781
050,29,097,"Missouri","Jasper County",5,54,1383,687,696
050,29,097,"Missouri","Jasper County",5,55,1310,655,655
050,29,097,"Missouri","Jasper County",5,56,1351,687,664
050,29,097,"Missouri","Jasper County",5,57,1349,655,694
050,29,097,"Missouri","Jasper County",5,58,1400,690,710
050,29,097,"Missouri","Jasper County",5,59,1445,728,717
050,29,097,"Missouri","Jasper County",5,60,1488,736,752
050,29,097,"Missouri","Jasper County",5,61,1484,734,750
050,29,097,"Missouri","Jasper County",5,62,1454,703,751
050,29,097,"Missouri","Jasper County",5,63,1448,683,765
050,29,097,"Missouri","Jasper County",5,64,1471,678,793
050,29,097,"Missouri","Jasper County",5,65,1465,670,795
050,29,097,"Missouri","Jasper County",5,66,1399,642,757
050,29,097,"Missouri","Jasper County",5,67,1332,630,702
050,29,097,"Missouri","Jasper County",5,68,1286,576,710
050,29,097,"Missouri","Jasper County",5,69,1230,544,686
050,29,097,"Missouri","Jasper County",5,70,1229,548,681
050,29,097,"Missouri","Jasper County",5,71,1182,539,643
050,29,097,"Missouri","Jasper County",5,72,1086,516,570
050,29,097,"Missouri","Jasper County",5,73,996,446,550
050,29,097,"Missouri","Jasper County",5,74,954,424,530
050,29,097,"Missouri","Jasper County",5,75,965,424,541
050,29,097,"Missouri","Jasper County",5,76,1028,462,566
050,29,097,"Missouri","Jasper County",5,77,674,297,377
050,29,097,"Missouri","Jasper County",5,78,623,270,353
050,29,097,"Missouri","Jasper County",5,79,658,282,376
050,29,097,"Missouri","Jasper County",5,80,642,280,362
050,29,097,"Missouri","Jasper County",5,81,531,225,306
050,29,097,"Missouri","Jasper County",5,82,463,201,262
050,29,097,"Missouri","Jasper County",5,83,413,158,255
050,29,097,"Missouri","Jasper County",5,84,368,143,225
050,29,097,"Missouri","Jasper County",5,85,2200,750,1450
050,29,099,"Missouri","Jefferson County",1,0,2451,1265,1186
050,29,099,"Missouri","Jefferson County",1,1,2532,1309,1223
050,29,099,"Missouri","Jefferson County",1,2,2686,1349,1337
050,29,099,"Missouri","Jefferson County",1,3,2703,1366,1337
050,29,099,"Missouri","Jefferson County",1,4,2713,1371,1342
050,29,099,"Missouri","Jefferson County",1,5,2687,1353,1334
050,29,099,"Missouri","Jefferson County",1,6,2781,1435,1346
050,29,099,"Missouri","Jefferson County",1,7,2863,1473,1390
050,29,099,"Missouri","Jefferson County",1,8,2802,1445,1357
050,29,099,"Missouri","Jefferson County",1,9,2924,1531,1393
050,29,099,"Missouri","Jefferson County",1,10,3047,1575,1472
050,29,099,"Missouri","Jefferson County",1,11,3205,1652,1553
050,29,099,"Missouri","Jefferson County",1,12,3262,1693,1569
050,29,099,"Missouri","Jefferson County",1,13,3267,1700,1567
050,29,099,"Missouri","Jefferson County",1,14,3187,1661,1526
050,29,099,"Missouri","Jefferson County",1,15,3146,1639,1507
050,29,099,"Missouri","Jefferson County",1,16,3069,1562,1507
050,29,099,"Missouri","Jefferson County",1,17,3015,1573,1442
050,29,099,"Missouri","Jefferson County",1,18,2628,1371,1257
050,29,099,"Missouri","Jefferson County",1,19,2082,1067,1015
050,29,099,"Missouri","Jefferson County",1,20,2251,1154,1097
050,29,099,"Missouri","Jefferson County",1,21,2306,1190,1116
050,29,099,"Missouri","Jefferson County",1,22,2360,1198,1162
050,29,099,"Missouri","Jefferson County",1,23,2440,1264,1176
050,29,099,"Missouri","Jefferson County",1,24,2470,1279,1191
050,29,099,"Missouri","Jefferson County",1,25,2548,1297,1251
050,29,099,"Missouri","Jefferson County",1,26,2558,1318,1240
050,29,099,"Missouri","Jefferson County",1,27,2670,1361,1309
050,29,099,"Missouri","Jefferson County",1,28,2823,1419,1404
050,29,099,"Missouri","Jefferson County",1,29,2978,1489,1489
050,29,099,"Missouri","Jefferson County",1,30,3040,1500,1540
050,29,099,"Missouri","Jefferson County",1,31,2910,1451,1459
050,29,099,"Missouri","Jefferson County",1,32,2954,1455,1499
050,29,099,"Missouri","Jefferson County",1,33,2996,1473,1523
050,29,099,"Missouri","Jefferson County",1,34,3066,1538,1528
050,29,099,"Missouri","Jefferson County",1,35,3076,1580,1496
050,29,099,"Missouri","Jefferson County",1,36,3084,1593,1491
050,29,099,"Missouri","Jefferson County",1,37,3220,1620,1600
050,29,099,"Missouri","Jefferson County",1,38,3182,1622,1560
050,29,099,"Missouri","Jefferson County",1,39,3173,1600,1573
050,29,099,"Missouri","Jefferson County",1,40,3090,1582,1508
050,29,099,"Missouri","Jefferson County",1,41,3068,1593,1475
050,29,099,"Missouri","Jefferson County",1,42,2992,1518,1474
050,29,099,"Missouri","Jefferson County",1,43,2889,1472,1417
050,29,099,"Missouri","Jefferson County",1,44,2821,1459,1362
050,29,099,"Missouri","Jefferson County",1,45,2724,1363,1361
050,29,099,"Missouri","Jefferson County",1,46,2672,1352,1320
050,29,099,"Missouri","Jefferson County",1,47,2801,1387,1414
050,29,099,"Missouri","Jefferson County",1,48,3016,1504,1512
050,29,099,"Missouri","Jefferson County",1,49,3264,1622,1642
050,29,099,"Missouri","Jefferson County",1,50,3076,1576,1500
050,29,099,"Missouri","Jefferson County",1,51,2952,1483,1469
050,29,099,"Missouri","Jefferson County",1,52,2858,1426,1432
050,29,099,"Missouri","Jefferson County",1,53,3014,1492,1522
050,29,099,"Missouri","Jefferson County",1,54,3111,1569,1542
050,29,099,"Missouri","Jefferson County",1,55,3356,1693,1663
050,29,099,"Missouri","Jefferson County",1,56,3440,1733,1707
050,29,099,"Missouri","Jefferson County",1,57,3572,1775,1797
050,29,099,"Missouri","Jefferson County",1,58,3686,1832,1854
050,29,099,"Missouri","Jefferson County",1,59,3614,1829,1785
050,29,099,"Missouri","Jefferson County",1,60,3445,1786,1659
050,29,099,"Missouri","Jefferson County",1,61,3410,1748,1662
050,29,099,"Missouri","Jefferson County",1,62,3264,1597,1667
050,29,099,"Missouri","Jefferson County",1,63,3115,1540,1575
050,29,099,"Missouri","Jefferson County",1,64,2977,1463,1514
050,29,099,"Missouri","Jefferson County",1,65,2840,1402,1438
050,29,099,"Missouri","Jefferson County",1,66,2715,1300,1415
050,29,099,"Missouri","Jefferson County",1,67,2541,1233,1308
050,29,099,"Missouri","Jefferson County",1,68,2439,1131,1308
050,29,099,"Missouri","Jefferson County",1,69,2256,1050,1206
050,29,099,"Missouri","Jefferson County",1,70,2180,1050,1130
050,29,099,"Missouri","Jefferson County",1,71,2045,975,1070
050,29,099,"Missouri","Jefferson County",1,72,2033,971,1062
050,29,099,"Missouri","Jefferson County",1,73,2067,982,1085
050,29,099,"Missouri","Jefferson County",1,74,1409,647,762
050,29,099,"Missouri","Jefferson County",1,75,1358,638,720
050,29,099,"Missouri","Jefferson County",1,76,1336,626,710
050,29,099,"Missouri","Jefferson County",1,77,1403,625,778
050,29,099,"Missouri","Jefferson County",1,78,1164,506,658
050,29,099,"Missouri","Jefferson County",1,79,1026,463,563
050,29,099,"Missouri","Jefferson County",1,80,893,383,510
050,29,099,"Missouri","Jefferson County",1,81,801,352,449
050,29,099,"Missouri","Jefferson County",1,82,715,304,411
050,29,099,"Missouri","Jefferson County",1,83,588,257,331
050,29,099,"Missouri","Jefferson County",1,84,556,243,313
050,29,099,"Missouri","Jefferson County",1,85,2822,1051,1771
050,29,099,"Missouri","Jefferson County",2,0,2475,1279,1196
050,29,099,"Missouri","Jefferson County",2,1,2520,1301,1219
050,29,099,"Missouri","Jefferson County",2,2,2659,1344,1315
050,29,099,"Missouri","Jefferson County",2,3,2694,1360,1334
050,29,099,"Missouri","Jefferson County",2,4,2730,1377,1353
050,29,099,"Missouri","Jefferson County",2,5,2700,1363,1337
050,29,099,"Missouri","Jefferson County",2,6,2770,1422,1348
050,29,099,"Missouri","Jefferson County",2,7,2843,1464,1379
050,29,099,"Missouri","Jefferson County",2,8,2815,1453,1362
050,29,099,"Missouri","Jefferson County",2,9,2895,1511,1384
050,29,099,"Missouri","Jefferson County",2,10,3031,1572,1459
050,29,099,"Missouri","Jefferson County",2,11,3162,1632,1530
050,29,099,"Missouri","Jefferson County",2,12,3266,1692,1574
050,29,099,"Missouri","Jefferson County",2,13,3266,1696,1570
050,29,099,"Missouri","Jefferson County",2,14,3210,1674,1536
050,29,099,"Missouri","Jefferson County",2,15,3162,1647,1515
050,29,099,"Missouri","Jefferson County",2,16,3091,1585,1506
050,29,099,"Missouri","Jefferson County",2,17,3033,1570,1463
050,29,099,"Missouri","Jefferson County",2,18,2592,1363,1229
050,29,099,"Missouri","Jefferson County",2,19,2105,1079,1026
050,29,099,"Missouri","Jefferson County",2,20,2274,1167,1107
050,29,099,"Missouri","Jefferson County",2,21,2321,1190,1131
050,29,099,"Missouri","Jefferson County",2,22,2391,1215,1176
050,29,099,"Missouri","Jefferson County",2,23,2450,1260,1190
050,29,099,"Missouri","Jefferson County",2,24,2483,1288,1195
050,29,099,"Missouri","Jefferson County",2,25,2536,1298,1238
050,29,099,"Missouri","Jefferson County",2,26,2569,1322,1247
050,29,099,"Missouri","Jefferson County",2,27,2651,1358,1293
050,29,099,"Missouri","Jefferson County",2,28,2808,1420,1388
050,29,099,"Missouri","Jefferson County",2,29,2957,1480,1477
050,29,099,"Missouri","Jefferson County",2,30,3045,1507,1538
050,29,099,"Missouri","Jefferson County",2,31,2950,1468,1482
050,29,099,"Missouri","Jefferson County",2,32,2951,1455,1496
050,29,099,"Missouri","Jefferson County",2,33,2993,1476,1517
050,29,099,"Missouri","Jefferson County",2,34,3061,1530,1531
050,29,099,"Missouri","Jefferson County",2,35,3094,1588,1506
050,29,099,"Missouri","Jefferson County",2,36,3072,1585,1487
050,29,099,"Missouri","Jefferson County",2,37,3205,1622,1583
050,29,099,"Missouri","Jefferson County",2,38,3202,1629,1573
050,29,099,"Missouri","Jefferson County",2,39,3174,1605,1569
050,29,099,"Missouri","Jefferson County",2,40,3132,1598,1534
050,29,099,"Missouri","Jefferson County",2,41,3071,1589,1482
050,29,099,"Missouri","Jefferson County",2,42,2995,1531,1464
050,29,099,"Missouri","Jefferson County",2,43,2934,1495,1439
050,29,099,"Missouri","Jefferson County",2,44,2809,1447,1362
050,29,099,"Missouri","Jefferson County",2,45,2760,1392,1368
050,29,099,"Missouri","Jefferson County",2,46,2677,1347,1330
050,29,099,"Missouri","Jefferson County",2,47,2766,1377,1389
050,29,099,"Missouri","Jefferson County",2,48,2966,1472,1494
050,29,099,"Missouri","Jefferson County",2,49,3223,1604,1619
050,29,099,"Missouri","Jefferson County",2,50,3131,1593,1538
050,29,099,"Missouri","Jefferson County",2,51,2970,1500,1470
050,29,099,"Missouri","Jefferson County",2,52,2865,1427,1438
050,29,099,"Missouri","Jefferson County",2,53,2982,1477,1505
050,29,099,"Missouri","Jefferson County",2,54,3072,1539,1533
050,29,099,"Missouri","Jefferson County",2,55,3296,1663,1633
050,29,099,"Missouri","Jefferson County",2,56,3423,1724,1699
050,29,099,"Missouri","Jefferson County",2,57,3540,1763,1777
050,29,099,"Missouri","Jefferson County",2,58,3645,1812,1833
050,29,099,"Missouri","Jefferson County",2,59,3650,1839,1811
050,29,099,"Missouri","Jefferson County",2,60,3468,1788,1680
050,29,099,"Missouri","Jefferson County",2,61,3398,1745,1653
050,29,099,"Missouri","Jefferson County",2,62,3280,1626,1654
050,29,099,"Missouri","Jefferson County",2,63,3168,1556,1612
050,29,099,"Missouri","Jefferson County",2,64,2986,1471,1515
050,29,099,"Missouri","Jefferson County",2,65,2857,1410,1447
050,29,099,"Missouri","Jefferson County",2,66,2742,1323,1419
050,29,099,"Missouri","Jefferson County",2,67,2558,1239,1319
050,29,099,"Missouri","Jefferson County",2,68,2430,1136,1294
050,29,099,"Missouri","Jefferson County",2,69,2301,1068,1233
050,29,099,"Missouri","Jefferson County",2,70,2190,1042,1148
050,29,099,"Missouri","Jefferson County",2,71,2075,990,1085
050,29,099,"Missouri","Jefferson County",2,72,1993,946,1047
050,29,099,"Missouri","Jefferson County",2,73,2148,1023,1125
050,29,099,"Missouri","Jefferson County",2,74,1460,678,782
050,29,099,"Missouri","Jefferson County",2,75,1369,637,732
050,29,099,"Missouri","Jefferson County",2,76,1322,616,706
050,29,099,"Missouri","Jefferson County",2,77,1413,630,783
050,29,099,"Missouri","Jefferson County",2,78,1188,522,666
050,29,099,"Missouri","Jefferson County",2,79,1040,466,574
050,29,099,"Missouri","Jefferson County",2,80,908,394,514
050,29,099,"Missouri","Jefferson County",2,81,809,352,457
050,29,099,"Missouri","Jefferson County",2,82,716,304,412
050,29,099,"Missouri","Jefferson County",2,83,604,262,342
050,29,099,"Missouri","Jefferson County",2,84,554,242,312
050,29,099,"Missouri","Jefferson County",2,85,2847,1072,1775
050,29,099,"Missouri","Jefferson County",3,0,2341,1189,1152
050,29,099,"Missouri","Jefferson County",3,1,2544,1309,1235
050,29,099,"Missouri","Jefferson County",3,2,2590,1350,1240
050,29,099,"Missouri","Jefferson County",3,3,2675,1334,1341
050,29,099,"Missouri","Jefferson County",3,4,2735,1372,1363
050,29,099,"Missouri","Jefferson County",3,5,2768,1405,1363
050,29,099,"Missouri","Jefferson County",3,6,2701,1379,1322
050,29,099,"Missouri","Jefferson County",3,7,2771,1413,1358
050,29,099,"Missouri","Jefferson County",3,8,2872,1492,1380
050,29,099,"Missouri","Jefferson County",3,9,2838,1456,1382
050,29,099,"Missouri","Jefferson County",3,10,2917,1501,1416
050,29,099,"Missouri","Jefferson County",3,11,3017,1563,1454
050,29,099,"Missouri","Jefferson County",3,12,3139,1634,1505
050,29,099,"Missouri","Jefferson County",3,13,3247,1666,1581
050,29,099,"Missouri","Jefferson County",3,14,3253,1700,1553
050,29,099,"Missouri","Jefferson County",3,15,3213,1686,1527
050,29,099,"Missouri","Jefferson County",3,16,3152,1624,1528
050,29,099,"Missouri","Jefferson County",3,17,3088,1564,1524
050,29,099,"Missouri","Jefferson County",3,18,2591,1383,1208
050,29,099,"Missouri","Jefferson County",3,19,2083,1092,991
050,29,099,"Missouri","Jefferson County",3,20,2280,1159,1121
050,29,099,"Missouri","Jefferson County",3,21,2359,1208,1151
050,29,099,"Missouri","Jefferson County",3,22,2482,1261,1221
050,29,099,"Missouri","Jefferson County",3,23,2512,1279,1233
050,29,099,"Missouri","Jefferson County",3,24,2459,1287,1172
050,29,099,"Missouri","Jefferson County",3,25,2524,1299,1225
050,29,099,"Missouri","Jefferson County",3,26,2633,1347,1286
050,29,099,"Missouri","Jefferson County",3,27,2684,1386,1298
050,29,099,"Missouri","Jefferson County",3,28,2726,1406,1320
050,29,099,"Missouri","Jefferson County",3,29,2874,1446,1428
050,29,099,"Missouri","Jefferson County",3,30,3015,1485,1530
050,29,099,"Missouri","Jefferson County",3,31,3180,1577,1603
050,29,099,"Missouri","Jefferson County",3,32,3039,1536,1503
050,29,099,"Missouri","Jefferson County",3,33,2993,1456,1537
050,29,099,"Missouri","Jefferson County",3,34,3047,1494,1553
050,29,099,"Missouri","Jefferson County",3,35,3109,1564,1545
050,29,099,"Missouri","Jefferson County",3,36,3111,1592,1519
050,29,099,"Missouri","Jefferson County",3,37,3084,1595,1489
050,29,099,"Missouri","Jefferson County",3,38,3222,1658,1564
050,29,099,"Missouri","Jefferson County",3,39,3184,1610,1574
050,29,099,"Missouri","Jefferson County",3,40,3197,1617,1580
050,29,099,"Missouri","Jefferson County",3,41,3142,1605,1537
050,29,099,"Missouri","Jefferson County",3,42,3065,1571,1494
050,29,099,"Missouri","Jefferson County",3,43,2974,1525,1449
050,29,099,"Missouri","Jefferson County",3,44,2966,1514,1452
050,29,099,"Missouri","Jefferson County",3,45,2802,1446,1356
050,29,099,"Missouri","Jefferson County",3,46,2756,1389,1367
050,29,099,"Missouri","Jefferson County",3,47,2686,1347,1339
050,29,099,"Missouri","Jefferson County",3,48,2756,1377,1379
050,29,099,"Missouri","Jefferson County",3,49,2975,1482,1493
050,29,099,"Missouri","Jefferson County",3,50,3211,1605,1606
050,29,099,"Missouri","Jefferson County",3,51,3114,1583,1531
050,29,099,"Missouri","Jefferson County",3,52,2927,1475,1452
050,29,099,"Missouri","Jefferson County",3,53,2890,1427,1463
050,29,099,"Missouri","Jefferson County",3,54,2993,1480,1513
050,29,099,"Missouri","Jefferson County",3,55,3065,1535,1530
050,29,099,"Missouri","Jefferson County",3,56,3298,1658,1640
050,29,099,"Missouri","Jefferson County",3,57,3423,1729,1694
050,29,099,"Missouri","Jefferson County",3,58,3507,1734,1773
050,29,099,"Missouri","Jefferson County",3,59,3605,1797,1808
050,29,099,"Missouri","Jefferson County",3,60,3621,1807,1814
050,29,099,"Missouri","Jefferson County",3,61,3457,1771,1686
050,29,099,"Missouri","Jefferson County",3,62,3357,1717,1640
050,29,099,"Missouri","Jefferson County",3,63,3240,1595,1645
050,29,099,"Missouri","Jefferson County",3,64,3124,1532,1592
050,29,099,"Missouri","Jefferson County",3,65,2960,1460,1500
050,29,099,"Missouri","Jefferson County",3,66,2817,1371,1446
050,29,099,"Missouri","Jefferson County",3,67,2700,1307,1393
050,29,099,"Missouri","Jefferson County",3,68,2498,1205,1293
050,29,099,"Missouri","Jefferson County",3,69,2357,1088,1269
050,29,099,"Missouri","Jefferson County",3,70,2252,1036,1216
050,29,099,"Missouri","Jefferson County",3,71,2144,1008,1136
050,29,099,"Missouri","Jefferson County",3,72,1997,950,1047
050,29,099,"Missouri","Jefferson County",3,73,1922,900,1022
050,29,099,"Missouri","Jefferson County",3,74,2060,977,1083
050,29,099,"Missouri","Jefferson County",3,75,1435,660,775
050,29,099,"Missouri","Jefferson County",3,76,1313,609,704
050,29,099,"Missouri","Jefferson County",3,77,1283,585,698
050,29,099,"Missouri","Jefferson County",3,78,1323,593,730
050,29,099,"Missouri","Jefferson County",3,79,1115,483,632
050,29,099,"Missouri","Jefferson County",3,80,990,438,552
050,29,099,"Missouri","Jefferson County",3,81,857,369,488
050,29,099,"Missouri","Jefferson County",3,82,745,305,440
050,29,099,"Missouri","Jefferson County",3,83,622,267,355
050,29,099,"Missouri","Jefferson County",3,84,530,221,309
050,29,099,"Missouri","Jefferson County",3,85,2870,1095,1775
050,29,099,"Missouri","Jefferson County",4,0,2353,1161,1192
050,29,099,"Missouri","Jefferson County",4,1,2421,1242,1179
050,29,099,"Missouri","Jefferson County",4,2,2616,1355,1261
050,29,099,"Missouri","Jefferson County",4,3,2622,1345,1277
050,29,099,"Missouri","Jefferson County",4,4,2725,1358,1367
050,29,099,"Missouri","Jefferson County",4,5,2789,1397,1392
050,29,099,"Missouri","Jefferson County",4,6,2829,1440,1389
050,29,099,"Missouri","Jefferson County",4,7,2731,1384,1347
050,29,099,"Missouri","Jefferson County",4,8,2817,1440,1377
050,29,099,"Missouri","Jefferson County",4,9,2922,1529,1393
050,29,099,"Missouri","Jefferson County",4,10,2843,1454,1389
050,29,099,"Missouri","Jefferson County",4,11,2944,1522,1422
050,29,099,"Missouri","Jefferson County",4,12,3064,1598,1466
050,29,099,"Missouri","Jefferson County",4,13,3181,1642,1539
050,29,099,"Missouri","Jefferson County",4,14,3286,1687,1599
050,29,099,"Missouri","Jefferson County",4,15,3272,1711,1561
050,29,099,"Missouri","Jefferson County",4,16,3224,1698,1526
050,29,099,"Missouri","Jefferson County",4,17,3176,1643,1533
050,29,099,"Missouri","Jefferson County",4,18,2628,1396,1232
050,29,099,"Missouri","Jefferson County",4,19,2040,1082,958
050,29,099,"Missouri","Jefferson County",4,20,2188,1138,1050
050,29,099,"Missouri","Jefferson County",4,21,2301,1171,1130
050,29,099,"Missouri","Jefferson County",4,22,2487,1254,1233
050,29,099,"Missouri","Jefferson County",4,23,2599,1300,1299
050,29,099,"Missouri","Jefferson County",4,24,2546,1314,1232
050,29,099,"Missouri","Jefferson County",4,25,2533,1323,1210
050,29,099,"Missouri","Jefferson County",4,26,2605,1351,1254
050,29,099,"Missouri","Jefferson County",4,27,2684,1377,1307
050,29,099,"Missouri","Jefferson County",4,28,2757,1425,1332
050,29,099,"Missouri","Jefferson County",4,29,2773,1422,1351
050,29,099,"Missouri","Jefferson County",4,30,2959,1491,1468
050,29,099,"Missouri","Jefferson County",4,31,3058,1484,1574
050,29,099,"Missouri","Jefferson County",4,32,3204,1578,1626
050,29,099,"Missouri","Jefferson County",4,33,3069,1544,1525
050,29,099,"Missouri","Jefferson County",4,34,3016,1475,1541
050,29,099,"Missouri","Jefferson County",4,35,3084,1498,1586
050,29,099,"Missouri","Jefferson County",4,36,3162,1590,1572
050,29,099,"Missouri","Jefferson County",4,37,3155,1618,1537
050,29,099,"Missouri","Jefferson County",4,38,3115,1615,1500
050,29,099,"Missouri","Jefferson County",4,39,3244,1670,1574
050,29,099,"Missouri","Jefferson County",4,40,3207,1637,1570
050,29,099,"Missouri","Jefferson County",4,41,3228,1632,1596
050,29,099,"Missouri","Jefferson County",4,42,3137,1593,1544
050,29,099,"Missouri","Jefferson County",4,43,3053,1568,1485
050,29,099,"Missouri","Jefferson County",4,44,2984,1547,1437
050,29,099,"Missouri","Jefferson County",4,45,2970,1516,1454
050,29,099,"Missouri","Jefferson County",4,46,2833,1430,1403
050,29,099,"Missouri","Jefferson County",4,47,2793,1424,1369
050,29,099,"Missouri","Jefferson County",4,48,2689,1357,1332
050,29,099,"Missouri","Jefferson County",4,49,2730,1370,1360
050,29,099,"Missouri","Jefferson County",4,50,3010,1495,1515
050,29,099,"Missouri","Jefferson County",4,51,3204,1581,1623
050,29,099,"Missouri","Jefferson County",4,52,3114,1591,1523
050,29,099,"Missouri","Jefferson County",4,53,2908,1461,1447
050,29,099,"Missouri","Jefferson County",4,54,2891,1430,1461
050,29,099,"Missouri","Jefferson County",4,55,2970,1465,1505
050,29,099,"Missouri","Jefferson County",4,56,3023,1499,1524
050,29,099,"Missouri","Jefferson County",4,57,3309,1668,1641
050,29,099,"Missouri","Jefferson County",4,58,3432,1738,1694
050,29,099,"Missouri","Jefferson County",4,59,3490,1722,1768
050,29,099,"Missouri","Jefferson County",4,60,3565,1777,1788
050,29,099,"Missouri","Jefferson County",4,61,3589,1786,1803
050,29,099,"Missouri","Jefferson County",4,62,3395,1728,1667
050,29,099,"Missouri","Jefferson County",4,63,3287,1681,1606
050,29,099,"Missouri","Jefferson County",4,64,3215,1573,1642
050,29,099,"Missouri","Jefferson County",4,65,3078,1510,1568
050,29,099,"Missouri","Jefferson County",4,66,2925,1429,1496
050,29,099,"Missouri","Jefferson County",4,67,2770,1350,1420
050,29,099,"Missouri","Jefferson County",4,68,2625,1268,1357
050,29,099,"Missouri","Jefferson County",4,69,2453,1168,1285
050,29,099,"Missouri","Jefferson County",4,70,2314,1075,1239
050,29,099,"Missouri","Jefferson County",4,71,2200,991,1209
050,29,099,"Missouri","Jefferson County",4,72,2083,977,1106
050,29,099,"Missouri","Jefferson County",4,73,1941,916,1025
050,29,099,"Missouri","Jefferson County",4,74,1846,866,980
050,29,099,"Missouri","Jefferson County",4,75,2006,955,1051
050,29,099,"Missouri","Jefferson County",4,76,1378,636,742
050,29,099,"Missouri","Jefferson County",4,77,1277,580,697
050,29,099,"Missouri","Jefferson County",4,78,1209,554,655
050,29,099,"Missouri","Jefferson County",4,79,1241,549,692
050,29,099,"Missouri","Jefferson County",4,80,1049,443,606
050,29,099,"Missouri","Jefferson County",4,81,922,400,522
050,29,099,"Missouri","Jefferson County",4,82,784,327,457
050,29,099,"Missouri","Jefferson County",4,83,666,282,384
050,29,099,"Missouri","Jefferson County",4,84,533,218,315
050,29,099,"Missouri","Jefferson County",4,85,2872,1108,1764
050,29,099,"Missouri","Jefferson County",5,0,2266,1122,1144
050,29,099,"Missouri","Jefferson County",5,1,2405,1197,1208
050,29,099,"Missouri","Jefferson County",5,2,2507,1301,1206
050,29,099,"Missouri","Jefferson County",5,3,2664,1365,1299
050,29,099,"Missouri","Jefferson County",5,4,2665,1367,1298
050,29,099,"Missouri","Jefferson County",5,5,2796,1407,1389
050,29,099,"Missouri","Jefferson County",5,6,2842,1421,1421
050,29,099,"Missouri","Jefferson County",5,7,2888,1460,1428
050,29,099,"Missouri","Jefferson County",5,8,2787,1410,1377
050,29,099,"Missouri","Jefferson County",5,9,2885,1486,1399
050,29,099,"Missouri","Jefferson County",5,10,2954,1550,1404
050,29,099,"Missouri","Jefferson County",5,11,2881,1473,1408
050,29,099,"Missouri","Jefferson County",5,12,2970,1531,1439
050,29,099,"Missouri","Jefferson County",5,13,3107,1630,1477
050,29,099,"Missouri","Jefferson County",5,14,3200,1666,1534
050,29,099,"Missouri","Jefferson County",5,15,3297,1685,1612
050,29,099,"Missouri","Jefferson County",5,16,3292,1706,1586
050,29,099,"Missouri","Jefferson County",5,17,3205,1672,1533
050,29,099,"Missouri","Jefferson County",5,18,2668,1422,1246
050,29,099,"Missouri","Jefferson County",5,19,2049,1077,972
050,29,099,"Missouri","Jefferson County",5,20,2226,1183,1043
050,29,099,"Missouri","Jefferson County",5,21,2325,1197,1128
050,29,099,"Missouri","Jefferson County",5,22,2477,1251,1226
050,29,099,"Missouri","Jefferson County",5,23,2643,1325,1318
050,29,099,"Missouri","Jefferson County",5,24,2694,1346,1348
050,29,099,"Missouri","Jefferson County",5,25,2594,1331,1263
050,29,099,"Missouri","Jefferson County",5,26,2609,1385,1224
050,29,099,"Missouri","Jefferson County",5,27,2716,1401,1315
050,29,099,"Missouri","Jefferson County",5,28,2724,1364,1360
050,29,099,"Missouri","Jefferson County",5,29,2857,1485,1372
050,29,099,"Missouri","Jefferson County",5,30,2885,1482,1403
050,29,099,"Missouri","Jefferson County",5,31,3055,1546,1509
050,29,099,"Missouri","Jefferson County",5,32,3126,1510,1616
050,29,099,"Missouri","Jefferson County",5,33,3226,1584,1642
050,29,099,"Missouri","Jefferson County",5,34,3081,1573,1508
050,29,099,"Missouri","Jefferson County",5,35,3072,1525,1547
050,29,099,"Missouri","Jefferson County",5,36,3143,1544,1599
050,29,099,"Missouri","Jefferson County",5,37,3175,1588,1587
050,29,099,"Missouri","Jefferson County",5,38,3204,1627,1577
050,29,099,"Missouri","Jefferson County",5,39,3156,1629,1527
050,29,099,"Missouri","Jefferson County",5,40,3244,1672,1572
050,29,099,"Missouri","Jefferson County",5,41,3220,1633,1587
050,29,099,"Missouri","Jefferson County",5,42,3269,1658,1611
050,29,099,"Missouri","Jefferson County",5,43,3162,1613,1549
050,29,099,"Missouri","Jefferson County",5,44,3077,1591,1486
050,29,099,"Missouri","Jefferson County",5,45,3007,1539,1468
050,29,099,"Missouri","Jefferson County",5,46,2953,1504,1449
050,29,099,"Missouri","Jefferson County",5,47,2828,1438,1390
050,29,099,"Missouri","Jefferson County",5,48,2822,1432,1390
050,29,099,"Missouri","Jefferson County",5,49,2711,1363,1348
050,29,099,"Missouri","Jefferson County",5,50,2742,1388,1354
050,29,099,"Missouri","Jefferson County",5,51,3014,1485,1529
050,29,099,"Missouri","Jefferson County",5,52,3200,1571,1629
050,29,099,"Missouri","Jefferson County",5,53,3090,1588,1502
050,29,099,"Missouri","Jefferson County",5,54,2899,1443,1456
050,29,099,"Missouri","Jefferson County",5,55,2886,1433,1453
050,29,099,"Missouri","Jefferson County",5,56,2957,1441,1516
050,29,099,"Missouri","Jefferson County",5,57,3026,1492,1534
050,29,099,"Missouri","Jefferson County",5,58,3294,1671,1623
050,29,099,"Missouri","Jefferson County",5,59,3441,1722,1719
050,29,099,"Missouri","Jefferson County",5,60,3447,1700,1747
050,29,099,"Missouri","Jefferson County",5,61,3566,1773,1793
050,29,099,"Missouri","Jefferson County",5,62,3545,1753,1792
050,29,099,"Missouri","Jefferson County",5,63,3363,1700,1663
050,29,099,"Missouri","Jefferson County",5,64,3249,1662,1587
050,29,099,"Missouri","Jefferson County",5,65,3195,1570,1625
050,29,099,"Missouri","Jefferson County",5,66,3055,1477,1578
050,29,099,"Missouri","Jefferson County",5,67,2900,1410,1490
050,29,099,"Missouri","Jefferson County",5,68,2733,1314,1419
050,29,099,"Missouri","Jefferson County",5,69,2579,1246,1333
050,29,099,"Missouri","Jefferson County",5,70,2412,1139,1273
050,29,099,"Missouri","Jefferson County",5,71,2277,1043,1234
050,29,099,"Missouri","Jefferson County",5,72,2146,973,1173
050,29,099,"Missouri","Jefferson County",5,73,2013,946,1067
050,29,099,"Missouri","Jefferson County",5,74,1878,892,986
050,29,099,"Missouri","Jefferson County",5,75,1790,843,947
050,29,099,"Missouri","Jefferson County",5,76,1960,942,1018
050,29,099,"Missouri","Jefferson County",5,77,1345,611,734
050,29,099,"Missouri","Jefferson County",5,78,1205,544,661
050,29,099,"Missouri","Jefferson County",5,79,1143,515,628
050,29,099,"Missouri","Jefferson County",5,80,1183,521,662
050,29,099,"Missouri","Jefferson County",5,81,996,414,582
050,29,099,"Missouri","Jefferson County",5,82,858,368,490
050,29,099,"Missouri","Jefferson County",5,83,715,301,414
050,29,099,"Missouri","Jefferson County",5,84,594,243,351
050,29,099,"Missouri","Jefferson County",5,85,2925,1139,1786
050,29,101,"Missouri","Johnson County",1,0,682,347,335
050,29,101,"Missouri","Johnson County",1,1,664,340,324
050,29,101,"Missouri","Johnson County",1,2,695,329,366
050,29,101,"Missouri","Johnson County",1,3,652,328,324
050,29,101,"Missouri","Johnson County",1,4,678,337,341
050,29,101,"Missouri","Johnson County",1,5,702,355,347
050,29,101,"Missouri","Johnson County",1,6,658,338,320
050,29,101,"Missouri","Johnson County",1,7,636,331,305
050,29,101,"Missouri","Johnson County",1,8,651,342,309
050,29,101,"Missouri","Johnson County",1,9,664,337,327
050,29,101,"Missouri","Johnson County",1,10,638,328,310
050,29,101,"Missouri","Johnson County",1,11,657,339,318
050,29,101,"Missouri","Johnson County",1,12,684,350,334
050,29,101,"Missouri","Johnson County",1,13,687,360,327
050,29,101,"Missouri","Johnson County",1,14,646,335,311
050,29,101,"Missouri","Johnson County",1,15,585,307,278
050,29,101,"Missouri","Johnson County",1,16,638,333,305
050,29,101,"Missouri","Johnson County",1,17,612,293,319
050,29,101,"Missouri","Johnson County",1,18,851,412,439
050,29,101,"Missouri","Johnson County",1,19,1640,773,867
050,29,101,"Missouri","Johnson County",1,20,1773,917,856
050,29,101,"Missouri","Johnson County",1,21,1981,1058,923
050,29,101,"Missouri","Johnson County",1,22,1644,869,775
050,29,101,"Missouri","Johnson County",1,23,1323,779,544
050,29,101,"Missouri","Johnson County",1,24,1051,575,476
050,29,101,"Missouri","Johnson County",1,25,947,561,386
050,29,101,"Missouri","Johnson County",1,26,899,494,405
050,29,101,"Missouri","Johnson County",1,27,789,419,370
050,29,101,"Missouri","Johnson County",1,28,814,439,375
050,29,101,"Missouri","Johnson County",1,29,778,433,345
050,29,101,"Missouri","Johnson County",1,30,754,389,365
050,29,101,"Missouri","Johnson County",1,31,713,374,339
050,29,101,"Missouri","Johnson County",1,32,683,360,323
050,29,101,"Missouri","Johnson County",1,33,695,364,331
050,29,101,"Missouri","Johnson County",1,34,694,366,328
050,29,101,"Missouri","Johnson County",1,35,674,361,313
050,29,101,"Missouri","Johnson County",1,36,665,350,315
050,29,101,"Missouri","Johnson County",1,37,695,356,339
050,29,101,"Missouri","Johnson County",1,38,648,337,311
050,29,101,"Missouri","Johnson County",1,39,599,292,307
050,29,101,"Missouri","Johnson County",1,40,587,303,284
050,29,101,"Missouri","Johnson County",1,41,554,305,249
050,29,101,"Missouri","Johnson County",1,42,548,286,262
050,29,101,"Missouri","Johnson County",1,43,533,277,256
050,29,101,"Missouri","Johnson County",1,44,493,260,233
050,29,101,"Missouri","Johnson County",1,45,478,244,234
050,29,101,"Missouri","Johnson County",1,46,469,246,223
050,29,101,"Missouri","Johnson County",1,47,497,257,240
050,29,101,"Missouri","Johnson County",1,48,517,249,268
050,29,101,"Missouri","Johnson County",1,49,588,277,311
050,29,101,"Missouri","Johnson County",1,50,528,252,276
050,29,101,"Missouri","Johnson County",1,51,512,248,264
050,29,101,"Missouri","Johnson County",1,52,497,238,259
050,29,101,"Missouri","Johnson County",1,53,517,257,260
050,29,101,"Missouri","Johnson County",1,54,511,266,245
050,29,101,"Missouri","Johnson County",1,55,573,305,268
050,29,101,"Missouri","Johnson County",1,56,630,321,309
050,29,101,"Missouri","Johnson County",1,57,641,330,311
050,29,101,"Missouri","Johnson County",1,58,634,323,311
050,29,101,"Missouri","Johnson County",1,59,640,299,341
050,29,101,"Missouri","Johnson County",1,60,653,305,348
050,29,101,"Missouri","Johnson County",1,61,633,300,333
050,29,101,"Missouri","Johnson County",1,62,589,286,303
050,29,101,"Missouri","Johnson County",1,63,586,311,275
050,29,101,"Missouri","Johnson County",1,64,520,256,264
050,29,101,"Missouri","Johnson County",1,65,517,263,254
050,29,101,"Missouri","Johnson County",1,66,490,241,249
050,29,101,"Missouri","Johnson County",1,67,461,231,230
050,29,101,"Missouri","Johnson County",1,68,442,213,229
050,29,101,"Missouri","Johnson County",1,69,423,210,213
050,29,101,"Missouri","Johnson County",1,70,381,205,176
050,29,101,"Missouri","Johnson County",1,71,358,181,177
050,29,101,"Missouri","Johnson County",1,72,385,179,206
050,29,101,"Missouri","Johnson County",1,73,385,184,201
050,29,101,"Missouri","Johnson County",1,74,265,129,136
050,29,101,"Missouri","Johnson County",1,75,306,152,154
050,29,101,"Missouri","Johnson County",1,76,270,126,144
050,29,101,"Missouri","Johnson County",1,77,267,128,139
050,29,101,"Missouri","Johnson County",1,78,237,111,126
050,29,101,"Missouri","Johnson County",1,79,201,95,106
050,29,101,"Missouri","Johnson County",1,80,186,91,95
050,29,101,"Missouri","Johnson County",1,81,174,76,98
050,29,101,"Missouri","Johnson County",1,82,156,73,83
050,29,101,"Missouri","Johnson County",1,83,136,65,71
050,29,101,"Missouri","Johnson County",1,84,117,56,61
050,29,101,"Missouri","Johnson County",1,85,786,325,461
050,29,101,"Missouri","Johnson County",2,0,698,371,327
050,29,101,"Missouri","Johnson County",2,1,664,341,323
050,29,101,"Missouri","Johnson County",2,2,688,332,356
050,29,101,"Missouri","Johnson County",2,3,659,326,333
050,29,101,"Missouri","Johnson County",2,4,675,336,339
050,29,101,"Missouri","Johnson County",2,5,693,349,344
050,29,101,"Missouri","Johnson County",2,6,668,344,324
050,29,101,"Missouri","Johnson County",2,7,638,333,305
050,29,101,"Missouri","Johnson County",2,8,637,332,305
050,29,101,"Missouri","Johnson County",2,9,655,336,319
050,29,101,"Missouri","Johnson County",2,10,640,328,312
050,29,101,"Missouri","Johnson County",2,11,642,331,311
050,29,101,"Missouri","Johnson County",2,12,674,347,327
050,29,101,"Missouri","Johnson County",2,13,688,360,328
050,29,101,"Missouri","Johnson County",2,14,653,340,313
050,29,101,"Missouri","Johnson County",2,15,600,315,285
050,29,101,"Missouri","Johnson County",2,16,625,325,300
050,29,101,"Missouri","Johnson County",2,17,622,306,316
050,29,101,"Missouri","Johnson County",2,18,871,417,454
050,29,101,"Missouri","Johnson County",2,19,1644,779,865
050,29,101,"Missouri","Johnson County",2,20,1785,919,866
050,29,101,"Missouri","Johnson County",2,21,1961,1044,917
050,29,101,"Missouri","Johnson County",2,22,1650,870,780
050,29,101,"Missouri","Johnson County",2,23,1329,779,550
050,29,101,"Missouri","Johnson County",2,24,1045,576,469
050,29,101,"Missouri","Johnson County",2,25,946,552,394
050,29,101,"Missouri","Johnson County",2,26,882,483,399
050,29,101,"Missouri","Johnson County",2,27,793,423,370
050,29,101,"Missouri","Johnson County",2,28,809,436,373
050,29,101,"Missouri","Johnson County",2,29,784,432,352
050,29,101,"Missouri","Johnson County",2,30,759,400,359
050,29,101,"Missouri","Johnson County",2,31,711,371,340
050,29,101,"Missouri","Johnson County",2,32,687,361,326
050,29,101,"Missouri","Johnson County",2,33,692,363,329
050,29,101,"Missouri","Johnson County",2,34,697,366,331
050,29,101,"Missouri","Johnson County",2,35,684,366,318
050,29,101,"Missouri","Johnson County",2,36,658,347,311
050,29,101,"Missouri","Johnson County",2,37,690,355,335
050,29,101,"Missouri","Johnson County",2,38,655,340,315
050,29,101,"Missouri","Johnson County",2,39,608,305,303
050,29,101,"Missouri","Johnson County",2,40,589,302,287
050,29,101,"Missouri","Johnson County",2,41,558,303,255
050,29,101,"Missouri","Johnson County",2,42,544,285,259
050,29,101,"Missouri","Johnson County",2,43,537,278,259
050,29,101,"Missouri","Johnson County",2,44,497,261,236
050,29,101,"Missouri","Johnson County",2,45,485,250,235
050,29,101,"Missouri","Johnson County",2,46,469,243,226
050,29,101,"Missouri","Johnson County",2,47,491,255,236
050,29,101,"Missouri","Johnson County",2,48,514,252,262
050,29,101,"Missouri","Johnson County",2,49,573,271,302
050,29,101,"Missouri","Johnson County",2,50,541,256,285
050,29,101,"Missouri","Johnson County",2,51,515,250,265
050,29,101,"Missouri","Johnson County",2,52,502,241,261
050,29,101,"Missouri","Johnson County",2,53,512,254,258
050,29,101,"Missouri","Johnson County",2,54,514,265,249
050,29,101,"Missouri","Johnson County",2,55,553,291,262
050,29,101,"Missouri","Johnson County",2,56,616,317,299
050,29,101,"Missouri","Johnson County",2,57,635,326,309
050,29,101,"Missouri","Johnson County",2,58,634,324,310
050,29,101,"Missouri","Johnson County",2,59,642,308,334
050,29,101,"Missouri","Johnson County",2,60,645,300,345
050,29,101,"Missouri","Johnson County",2,61,634,299,335
050,29,101,"Missouri","Johnson County",2,62,599,291,308
050,29,101,"Missouri","Johnson County",2,63,589,308,281
050,29,101,"Missouri","Johnson County",2,64,528,267,261
050,29,101,"Missouri","Johnson County",2,65,515,259,256
050,29,101,"Missouri","Johnson County",2,66,496,246,250
050,29,101,"Missouri","Johnson County",2,67,464,232,232
050,29,101,"Missouri","Johnson County",2,68,439,215,224
050,29,101,"Missouri","Johnson County",2,69,429,211,218
050,29,101,"Missouri","Johnson County",2,70,385,206,179
050,29,101,"Missouri","Johnson County",2,71,362,187,175
050,29,101,"Missouri","Johnson County",2,72,371,175,196
050,29,101,"Missouri","Johnson County",2,73,396,190,206
050,29,101,"Missouri","Johnson County",2,74,276,134,142
050,29,101,"Missouri","Johnson County",2,75,295,145,150
050,29,101,"Missouri","Johnson County",2,76,269,127,142
050,29,101,"Missouri","Johnson County",2,77,271,127,144
050,29,101,"Missouri","Johnson County",2,78,233,109,124
050,29,101,"Missouri","Johnson County",2,79,205,97,108
050,29,101,"Missouri","Johnson County",2,80,190,91,99
050,29,101,"Missouri","Johnson County",2,81,173,77,96
050,29,101,"Missouri","Johnson County",2,82,155,72,83
050,29,101,"Missouri","Johnson County",2,83,134,66,68
050,29,101,"Missouri","Johnson County",2,84,121,57,64
050,29,101,"Missouri","Johnson County",2,85,777,321,456
050,29,101,"Missouri","Johnson County",3,0,686,342,344
050,29,101,"Missouri","Johnson County",3,1,680,370,310
050,29,101,"Missouri","Johnson County",3,2,681,353,328
050,29,101,"Missouri","Johnson County",3,3,701,347,354
050,29,101,"Missouri","Johnson County",3,4,662,345,317
050,29,101,"Missouri","Johnson County",3,5,651,329,322
050,29,101,"Missouri","Johnson County",3,6,693,363,330
050,29,101,"Missouri","Johnson County",3,7,680,339,341
050,29,101,"Missouri","Johnson County",3,8,642,334,308
050,29,101,"Missouri","Johnson County",3,9,653,337,316
050,29,101,"Missouri","Johnson County",3,10,659,336,323
050,29,101,"Missouri","Johnson County",3,11,646,340,306
050,29,101,"Missouri","Johnson County",3,12,635,332,303
050,29,101,"Missouri","Johnson County",3,13,686,361,325
050,29,101,"Missouri","Johnson County",3,14,695,360,335
050,29,101,"Missouri","Johnson County",3,15,642,334,308
050,29,101,"Missouri","Johnson County",3,16,584,308,276
050,29,101,"Missouri","Johnson County",3,17,640,335,305
050,29,101,"Missouri","Johnson County",3,18,880,416,464
050,29,101,"Missouri","Johnson County",3,19,1652,804,848
050,29,101,"Missouri","Johnson County",3,20,1762,912,850
050,29,101,"Missouri","Johnson County",3,21,1913,1012,901
050,29,101,"Missouri","Johnson County",3,22,1651,879,772
050,29,101,"Missouri","Johnson County",3,23,1360,795,565
050,29,101,"Missouri","Johnson County",3,24,1063,599,464
050,29,101,"Missouri","Johnson County",3,25,916,543,373
050,29,101,"Missouri","Johnson County",3,26,869,482,387
050,29,101,"Missouri","Johnson County",3,27,771,425,346
050,29,101,"Missouri","Johnson County",3,28,781,422,359
050,29,101,"Missouri","Johnson County",3,29,795,420,375
050,29,101,"Missouri","Johnson County",3,30,781,421,360
050,29,101,"Missouri","Johnson County",3,31,719,385,334
050,29,101,"Missouri","Johnson County",3,32,714,374,340
050,29,101,"Missouri","Johnson County",3,33,687,344,343
050,29,101,"Missouri","Johnson County",3,34,693,356,337
050,29,101,"Missouri","Johnson County",3,35,694,374,320
050,29,101,"Missouri","Johnson County",3,36,683,368,315
050,29,101,"Missouri","Johnson County",3,37,672,352,320
050,29,101,"Missouri","Johnson County",3,38,676,358,318
050,29,101,"Missouri","Johnson County",3,39,663,342,321
050,29,101,"Missouri","Johnson County",3,40,598,301,297
050,29,101,"Missouri","Johnson County",3,41,596,304,292
050,29,101,"Missouri","Johnson County",3,42,552,295,257
050,29,101,"Missouri","Johnson County",3,43,543,289,254
050,29,101,"Missouri","Johnson County",3,44,537,277,260
050,29,101,"Missouri","Johnson County",3,45,491,258,233
050,29,101,"Missouri","Johnson County",3,46,492,254,238
050,29,101,"Missouri","Johnson County",3,47,476,245,231
050,29,101,"Missouri","Johnson County",3,48,484,240,244
050,29,101,"Missouri","Johnson County",3,49,511,256,255
050,29,101,"Missouri","Johnson County",3,50,578,272,306
050,29,101,"Missouri","Johnson County",3,51,539,259,280
050,29,101,"Missouri","Johnson County",3,52,517,242,275
050,29,101,"Missouri","Johnson County",3,53,505,242,263
050,29,101,"Missouri","Johnson County",3,54,535,267,268
050,29,101,"Missouri","Johnson County",3,55,506,259,247
050,29,101,"Missouri","Johnson County",3,56,568,300,268
050,29,101,"Missouri","Johnson County",3,57,608,308,300
050,29,101,"Missouri","Johnson County",3,58,622,320,302
050,29,101,"Missouri","Johnson County",3,59,624,320,304
050,29,101,"Missouri","Johnson County",3,60,618,302,316
050,29,101,"Missouri","Johnson County",3,61,641,294,347
050,29,101,"Missouri","Johnson County",3,62,622,298,324
050,29,101,"Missouri","Johnson County",3,63,581,277,304
050,29,101,"Missouri","Johnson County",3,64,571,298,273
050,29,101,"Missouri","Johnson County",3,65,516,261,255
050,29,101,"Missouri","Johnson County",3,66,521,256,265
050,29,101,"Missouri","Johnson County",3,67,472,233,239
050,29,101,"Missouri","Johnson County",3,68,433,214,219
050,29,101,"Missouri","Johnson County",3,69,411,199,212
050,29,101,"Missouri","Johnson County",3,70,410,202,208
050,29,101,"Missouri","Johnson County",3,71,377,202,175
050,29,101,"Missouri","Johnson County",3,72,351,180,171
050,29,101,"Missouri","Johnson County",3,73,343,162,181
050,29,101,"Missouri","Johnson County",3,74,376,173,203
050,29,101,"Missouri","Johnson County",3,75,258,123,135
050,29,101,"Missouri","Johnson County",3,76,278,138,140
050,29,101,"Missouri","Johnson County",3,77,255,121,134
050,29,101,"Missouri","Johnson County",3,78,262,117,145
050,29,101,"Missouri","Johnson County",3,79,215,101,114
050,29,101,"Missouri","Johnson County",3,80,193,91,102
050,29,101,"Missouri","Johnson County",3,81,175,78,97
050,29,101,"Missouri","Johnson County",3,82,148,68,80
050,29,101,"Missouri","Johnson County",3,83,144,71,73
050,29,101,"Missouri","Johnson County",3,84,115,56,59
050,29,101,"Missouri","Johnson County",3,85,715,287,428
050,29,101,"Missouri","Johnson County",4,0,705,369,336
050,29,101,"Missouri","Johnson County",4,1,699,332,367
050,29,101,"Missouri","Johnson County",4,2,662,358,304
050,29,101,"Missouri","Johnson County",4,3,658,344,314
050,29,101,"Missouri","Johnson County",4,4,712,360,352
050,29,101,"Missouri","Johnson County",4,5,691,351,340
050,29,101,"Missouri","Johnson County",4,6,669,349,320
050,29,101,"Missouri","Johnson County",4,7,716,362,354
050,29,101,"Missouri","Johnson County",4,8,693,341,352
050,29,101,"Missouri","Johnson County",4,9,659,333,326
050,29,101,"Missouri","Johnson County",4,10,643,327,316
050,29,101,"Missouri","Johnson County",4,11,678,336,342
050,29,101,"Missouri","Johnson County",4,12,657,337,320
050,29,101,"Missouri","Johnson County",4,13,636,334,302
050,29,101,"Missouri","Johnson County",4,14,682,351,331
050,29,101,"Missouri","Johnson County",4,15,704,364,340
050,29,101,"Missouri","Johnson County",4,16,649,341,308
050,29,101,"Missouri","Johnson County",4,17,574,302,272
050,29,101,"Missouri","Johnson County",4,18,892,429,463
050,29,101,"Missouri","Johnson County",4,19,1619,769,850
050,29,101,"Missouri","Johnson County",4,20,1736,904,832
050,29,101,"Missouri","Johnson County",4,21,1897,991,906
050,29,101,"Missouri","Johnson County",4,22,1594,815,779
050,29,101,"Missouri","Johnson County",4,23,1367,831,536
050,29,101,"Missouri","Johnson County",4,24,1066,587,479
050,29,101,"Missouri","Johnson County",4,25,942,556,386
050,29,101,"Missouri","Johnson County",4,26,803,444,359
050,29,101,"Missouri","Johnson County",4,27,759,422,337
050,29,101,"Missouri","Johnson County",4,28,758,398,360
050,29,101,"Missouri","Johnson County",4,29,781,422,359
050,29,101,"Missouri","Johnson County",4,30,778,421,357
050,29,101,"Missouri","Johnson County",4,31,775,412,363
050,29,101,"Missouri","Johnson County",4,32,700,365,335
050,29,101,"Missouri","Johnson County",4,33,719,376,343
050,29,101,"Missouri","Johnson County",4,34,691,353,338
050,29,101,"Missouri","Johnson County",4,35,726,371,355
050,29,101,"Missouri","Johnson County",4,36,692,362,330
050,29,101,"Missouri","Johnson County",4,37,682,357,325
050,29,101,"Missouri","Johnson County",4,38,656,350,306
050,29,101,"Missouri","Johnson County",4,39,674,369,305
050,29,101,"Missouri","Johnson County",4,40,663,353,310
050,29,101,"Missouri","Johnson County",4,41,603,307,296
050,29,101,"Missouri","Johnson County",4,42,600,304,296
050,29,101,"Missouri","Johnson County",4,43,544,291,253
050,29,101,"Missouri","Johnson County",4,44,536,278,258
050,29,101,"Missouri","Johnson County",4,45,559,301,258
050,29,101,"Missouri","Johnson County",4,46,496,257,239
050,29,101,"Missouri","Johnson County",4,47,500,257,243
050,29,101,"Missouri","Johnson County",4,48,461,238,223
050,29,101,"Missouri","Johnson County",4,49,473,244,229
050,29,101,"Missouri","Johnson County",4,50,519,262,257
050,29,101,"Missouri","Johnson County",4,51,575,281,294
050,29,101,"Missouri","Johnson County",4,52,546,268,278
050,29,101,"Missouri","Johnson County",4,53,516,245,271
050,29,101,"Missouri","Johnson County",4,54,499,238,261
050,29,101,"Missouri","Johnson County",4,55,531,266,265
050,29,101,"Missouri","Johnson County",4,56,500,263,237
050,29,101,"Missouri","Johnson County",4,57,568,300,268
050,29,101,"Missouri","Johnson County",4,58,590,294,296
050,29,101,"Missouri","Johnson County",4,59,613,326,287
050,29,101,"Missouri","Johnson County",4,60,621,310,311
050,29,101,"Missouri","Johnson County",4,61,586,282,304
050,29,101,"Missouri","Johnson County",4,62,627,294,333
050,29,101,"Missouri","Johnson County",4,63,616,292,324
050,29,101,"Missouri","Johnson County",4,64,584,292,292
050,29,101,"Missouri","Johnson County",4,65,558,290,268
050,29,101,"Missouri","Johnson County",4,66,509,254,255
050,29,101,"Missouri","Johnson County",4,67,497,242,255
050,29,101,"Missouri","Johnson County",4,68,453,225,228
050,29,101,"Missouri","Johnson County",4,69,422,205,217
050,29,101,"Missouri","Johnson County",4,70,401,195,206
050,29,101,"Missouri","Johnson County",4,71,396,197,199
050,29,101,"Missouri","Johnson County",4,72,369,193,176
050,29,101,"Missouri","Johnson County",4,73,336,170,166
050,29,101,"Missouri","Johnson County",4,74,332,154,178
050,29,101,"Missouri","Johnson County",4,75,358,164,194
050,29,101,"Missouri","Johnson County",4,76,252,118,134
050,29,101,"Missouri","Johnson County",4,77,273,135,138
050,29,101,"Missouri","Johnson County",4,78,244,115,129
050,29,101,"Missouri","Johnson County",4,79,238,107,131
050,29,101,"Missouri","Johnson County",4,80,203,92,111
050,29,101,"Missouri","Johnson County",4,81,184,82,102
050,29,101,"Missouri","Johnson County",4,82,154,68,86
050,29,101,"Missouri","Johnson County",4,83,135,64,71
050,29,101,"Missouri","Johnson County",4,84,131,66,65
050,29,101,"Missouri","Johnson County",4,85,684,281,403
050,29,101,"Missouri","Johnson County",5,0,709,372,337
050,29,101,"Missouri","Johnson County",5,1,733,368,365
050,29,101,"Missouri","Johnson County",5,2,699,352,347
050,29,101,"Missouri","Johnson County",5,3,673,361,312
050,29,101,"Missouri","Johnson County",5,4,653,352,301
050,29,101,"Missouri","Johnson County",5,5,716,364,352
050,29,101,"Missouri","Johnson County",5,6,698,344,354
050,29,101,"Missouri","Johnson County",5,7,691,360,331
050,29,101,"Missouri","Johnson County",5,8,718,351,367
050,29,101,"Missouri","Johnson County",5,9,718,359,359
050,29,101,"Missouri","Johnson County",5,10,667,325,342
050,29,101,"Missouri","Johnson County",5,11,670,339,331
050,29,101,"Missouri","Johnson County",5,12,655,332,323
050,29,101,"Missouri","Johnson County",5,13,674,355,319
050,29,101,"Missouri","Johnson County",5,14,626,319,307
050,29,101,"Missouri","Johnson County",5,15,675,343,332
050,29,101,"Missouri","Johnson County",5,16,701,359,342
050,29,101,"Missouri","Johnson County",5,17,632,328,304
050,29,101,"Missouri","Johnson County",5,18,836,410,426
050,29,101,"Missouri","Johnson County",5,19,1622,776,846
050,29,101,"Missouri","Johnson County",5,20,1720,894,826
050,29,101,"Missouri","Johnson County",5,21,1839,964,875
050,29,101,"Missouri","Johnson County",5,22,1604,813,791
050,29,101,"Missouri","Johnson County",5,23,1319,750,569
050,29,101,"Missouri","Johnson County",5,24,1111,650,461
050,29,101,"Missouri","Johnson County",5,25,959,552,407
050,29,101,"Missouri","Johnson County",5,26,828,459,369
050,29,101,"Missouri","Johnson County",5,27,741,413,328
050,29,101,"Missouri","Johnson County",5,28,757,408,349
050,29,101,"Missouri","Johnson County",5,29,755,397,358
050,29,101,"Missouri","Johnson County",5,30,767,419,348
050,29,101,"Missouri","Johnson County",5,31,756,400,356
050,29,101,"Missouri","Johnson County",5,32,792,426,366
050,29,101,"Missouri","Johnson County",5,33,724,372,352
050,29,101,"Missouri","Johnson County",5,34,734,377,357
050,29,101,"Missouri","Johnson County",5,35,702,353,349
050,29,101,"Missouri","Johnson County",5,36,716,372,344
050,29,101,"Missouri","Johnson County",5,37,694,357,337
050,29,101,"Missouri","Johnson County",5,38,670,352,318
050,29,101,"Missouri","Johnson County",5,39,625,340,285
050,29,101,"Missouri","Johnson County",5,40,676,361,315
050,29,101,"Missouri","Johnson County",5,41,670,359,311
050,29,101,"Missouri","Johnson County",5,42,572,284,288
050,29,101,"Missouri","Johnson County",5,43,595,309,286
050,29,101,"Missouri","Johnson County",5,44,550,285,265
050,29,101,"Missouri","Johnson County",5,45,523,280,243
050,29,101,"Missouri","Johnson County",5,46,563,300,263
050,29,101,"Missouri","Johnson County",5,47,497,260,237
050,29,101,"Missouri","Johnson County",5,48,506,260,246
050,29,101,"Missouri","Johnson County",5,49,467,239,228
050,29,101,"Missouri","Johnson County",5,50,470,238,232
050,29,101,"Missouri","Johnson County",5,51,526,270,256
050,29,101,"Missouri","Johnson County",5,52,579,276,303
050,29,101,"Missouri","Johnson County",5,53,536,259,277
050,29,101,"Missouri","Johnson County",5,54,513,247,266
050,29,101,"Missouri","Johnson County",5,55,514,243,271
050,29,101,"Missouri","Johnson County",5,56,523,269,254
050,29,101,"Missouri","Johnson County",5,57,493,253,240
050,29,101,"Missouri","Johnson County",5,58,562,298,264
050,29,101,"Missouri","Johnson County",5,59,587,292,295
050,29,101,"Missouri","Johnson County",5,60,611,320,291
050,29,101,"Missouri","Johnson County",5,61,616,305,311
050,29,101,"Missouri","Johnson County",5,62,580,274,306
050,29,101,"Missouri","Johnson County",5,63,640,300,340
050,29,101,"Missouri","Johnson County",5,64,618,302,316
050,29,101,"Missouri","Johnson County",5,65,581,287,294
050,29,101,"Missouri","Johnson County",5,66,544,283,261
050,29,101,"Missouri","Johnson County",5,67,488,247,241
050,29,101,"Missouri","Johnson County",5,68,482,234,248
050,29,101,"Missouri","Johnson County",5,69,441,214,227
050,29,101,"Missouri","Johnson County",5,70,413,202,211
050,29,101,"Missouri","Johnson County",5,71,411,200,211
050,29,101,"Missouri","Johnson County",5,72,388,189,199
050,29,101,"Missouri","Johnson County",5,73,355,183,172
050,29,101,"Missouri","Johnson County",5,74,335,166,169
050,29,101,"Missouri","Johnson County",5,75,326,152,174
050,29,101,"Missouri","Johnson County",5,76,343,151,192
050,29,101,"Missouri","Johnson County",5,77,244,119,125
050,29,101,"Missouri","Johnson County",5,78,262,129,133
050,29,101,"Missouri","Johnson County",5,79,230,112,118
050,29,101,"Missouri","Johnson County",5,80,228,99,129
050,29,101,"Missouri","Johnson County",5,81,195,81,114
050,29,101,"Missouri","Johnson County",5,82,165,78,87
050,29,101,"Missouri","Johnson County",5,83,140,66,74
050,29,101,"Missouri","Johnson County",5,84,124,58,66
050,29,101,"Missouri","Johnson County",5,85,701,297,404
050,29,103,"Missouri","Knox County",1,0,59,30,29
050,29,103,"Missouri","Knox County",1,1,52,25,27
050,29,103,"Missouri","Knox County",1,2,51,28,23
050,29,103,"Missouri","Knox County",1,3,47,20,27
050,29,103,"Missouri","Knox County",1,4,41,19,22
050,29,103,"Missouri","Knox County",1,5,46,22,24
050,29,103,"Missouri","Knox County",1,6,40,22,18
050,29,103,"Missouri","Knox County",1,7,51,30,21
050,29,103,"Missouri","Knox County",1,8,39,21,18
050,29,103,"Missouri","Knox County",1,9,37,17,20
050,29,103,"Missouri","Knox County",1,10,49,28,21
050,29,103,"Missouri","Knox County",1,11,53,25,28
050,29,103,"Missouri","Knox County",1,12,62,29,33
050,29,103,"Missouri","Knox County",1,13,46,22,24
050,29,103,"Missouri","Knox County",1,14,61,30,31
050,29,103,"Missouri","Knox County",1,15,51,32,19
050,29,103,"Missouri","Knox County",1,16,47,29,18
050,29,103,"Missouri","Knox County",1,17,58,37,21
050,29,103,"Missouri","Knox County",1,18,50,27,23
050,29,103,"Missouri","Knox County",1,19,42,23,19
050,29,103,"Missouri","Knox County",1,20,49,22,27
050,29,103,"Missouri","Knox County",1,21,47,28,19
050,29,103,"Missouri","Knox County",1,22,44,25,19
050,29,103,"Missouri","Knox County",1,23,46,24,22
050,29,103,"Missouri","Knox County",1,24,43,23,20
050,29,103,"Missouri","Knox County",1,25,39,21,18
050,29,103,"Missouri","Knox County",1,26,36,20,16
050,29,103,"Missouri","Knox County",1,27,47,23,24
050,29,103,"Missouri","Knox County",1,28,39,22,17
050,29,103,"Missouri","Knox County",1,29,43,21,22
050,29,103,"Missouri","Knox County",1,30,27,15,12
050,29,103,"Missouri","Knox County",1,31,35,15,20
050,29,103,"Missouri","Knox County",1,32,39,17,22
050,29,103,"Missouri","Knox County",1,33,33,19,14
050,29,103,"Missouri","Knox County",1,34,26,14,12
050,29,103,"Missouri","Knox County",1,35,31,15,16
050,29,103,"Missouri","Knox County",1,36,36,19,17
050,29,103,"Missouri","Knox County",1,37,45,24,21
050,29,103,"Missouri","Knox County",1,38,40,21,19
050,29,103,"Missouri","Knox County",1,39,36,22,14
050,29,103,"Missouri","Knox County",1,40,32,15,17
050,29,103,"Missouri","Knox County",1,41,33,18,15
050,29,103,"Missouri","Knox County",1,42,31,13,18
050,29,103,"Missouri","Knox County",1,43,36,14,22
050,29,103,"Missouri","Knox County",1,44,37,18,19
050,29,103,"Missouri","Knox County",1,45,38,15,23
050,29,103,"Missouri","Knox County",1,46,43,19,24
050,29,103,"Missouri","Knox County",1,47,35,19,16
050,29,103,"Missouri","Knox County",1,48,43,26,17
050,29,103,"Missouri","Knox County",1,49,52,24,28
050,29,103,"Missouri","Knox County",1,50,48,25,23
050,29,103,"Missouri","Knox County",1,51,44,22,22
050,29,103,"Missouri","Knox County",1,52,40,19,21
050,29,103,"Missouri","Knox County",1,53,45,24,21
050,29,103,"Missouri","Knox County",1,54,41,20,21
050,29,103,"Missouri","Knox County",1,55,57,31,26
050,29,103,"Missouri","Knox County",1,56,53,26,27
050,29,103,"Missouri","Knox County",1,57,53,24,29
050,29,103,"Missouri","Knox County",1,58,63,34,29
050,29,103,"Missouri","Knox County",1,59,64,37,27
050,29,103,"Missouri","Knox County",1,60,56,35,21
050,29,103,"Missouri","Knox County",1,61,65,37,28
050,29,103,"Missouri","Knox County",1,62,65,38,27
050,29,103,"Missouri","Knox County",1,63,60,32,28
050,29,103,"Missouri","Knox County",1,64,55,26,29
050,29,103,"Missouri","Knox County",1,65,49,25,24
050,29,103,"Missouri","Knox County",1,66,44,19,25
050,29,103,"Missouri","Knox County",1,67,44,22,22
050,29,103,"Missouri","Knox County",1,68,41,21,20
050,29,103,"Missouri","Knox County",1,69,41,19,22
050,29,103,"Missouri","Knox County",1,70,46,26,20
050,29,103,"Missouri","Knox County",1,71,43,19,24
050,29,103,"Missouri","Knox County",1,72,46,22,24
050,29,103,"Missouri","Knox County",1,73,43,17,26
050,29,103,"Missouri","Knox County",1,74,32,16,16
050,29,103,"Missouri","Knox County",1,75,37,18,19
050,29,103,"Missouri","Knox County",1,76,29,10,19
050,29,103,"Missouri","Knox County",1,77,37,16,21
050,29,103,"Missouri","Knox County",1,78,35,18,17
050,29,103,"Missouri","Knox County",1,79,28,16,12
050,29,103,"Missouri","Knox County",1,80,24,12,12
050,29,103,"Missouri","Knox County",1,81,21,11,10
050,29,103,"Missouri","Knox County",1,82,18,7,11
050,29,103,"Missouri","Knox County",1,83,18,6,12
050,29,103,"Missouri","Knox County",1,84,16,4,12
050,29,103,"Missouri","Knox County",1,85,99,35,64
050,29,103,"Missouri","Knox County",2,0,58,31,27
050,29,103,"Missouri","Knox County",2,1,53,26,27
050,29,103,"Missouri","Knox County",2,2,52,27,25
050,29,103,"Missouri","Knox County",2,3,48,22,26
050,29,103,"Missouri","Knox County",2,4,43,19,24
050,29,103,"Missouri","Knox County",2,5,44,20,24
050,29,103,"Missouri","Knox County",2,6,42,22,20
050,29,103,"Missouri","Knox County",2,7,47,28,19
050,29,103,"Missouri","Knox County",2,8,41,23,18
050,29,103,"Missouri","Knox County",2,9,37,18,19
050,29,103,"Missouri","Knox County",2,10,47,25,22
050,29,103,"Missouri","Knox County",2,11,53,26,27
050,29,103,"Missouri","Knox County",2,12,60,28,32
050,29,103,"Missouri","Knox County",2,13,50,24,26
050,29,103,"Missouri","Knox County",2,14,58,29,29
050,29,103,"Missouri","Knox County",2,15,52,31,21
050,29,103,"Missouri","Knox County",2,16,47,29,18
050,29,103,"Missouri","Knox County",2,17,56,35,21
050,29,103,"Missouri","Knox County",2,18,50,29,21
050,29,103,"Missouri","Knox County",2,19,42,23,19
050,29,103,"Missouri","Knox County",2,20,48,22,26
050,29,103,"Missouri","Knox County",2,21,47,27,20
050,29,103,"Missouri","Knox County",2,22,47,27,20
050,29,103,"Missouri","Knox County",2,23,44,23,21
050,29,103,"Missouri","Knox County",2,24,45,24,21
050,29,103,"Missouri","Knox County",2,25,40,22,18
050,29,103,"Missouri","Knox County",2,26,37,20,17
050,29,103,"Missouri","Knox County",2,27,44,22,22
050,29,103,"Missouri","Knox County",2,28,41,22,19
050,29,103,"Missouri","Knox County",2,29,44,22,22
050,29,103,"Missouri","Knox County",2,30,30,16,14
050,29,103,"Missouri","Knox County",2,31,33,15,18
050,29,103,"Missouri","Knox County",2,32,38,17,21
050,29,103,"Missouri","Knox County",2,33,33,18,15
050,29,103,"Missouri","Knox County",2,34,27,15,12
050,29,103,"Missouri","Knox County",2,35,29,14,15
050,29,103,"Missouri","Knox County",2,36,35,18,17
050,29,103,"Missouri","Knox County",2,37,44,23,21
050,29,103,"Missouri","Knox County",2,38,42,22,20
050,29,103,"Missouri","Knox County",2,39,37,22,15
050,29,103,"Missouri","Knox County",2,40,32,16,16
050,29,103,"Missouri","Knox County",2,41,33,18,15
050,29,103,"Missouri","Knox County",2,42,31,13,18
050,29,103,"Missouri","Knox County",2,43,35,14,21
050,29,103,"Missouri","Knox County",2,44,36,16,20
050,29,103,"Missouri","Knox County",2,45,38,16,22
050,29,103,"Missouri","Knox County",2,46,43,19,24
050,29,103,"Missouri","Knox County",2,47,36,18,18
050,29,103,"Missouri","Knox County",2,48,40,24,16
050,29,103,"Missouri","Knox County",2,49,50,25,25
050,29,103,"Missouri","Knox County",2,50,48,24,24
050,29,103,"Missouri","Knox County",2,51,46,23,23
050,29,103,"Missouri","Knox County",2,52,41,20,21
050,29,103,"Missouri","Knox County",2,53,45,24,21
050,29,103,"Missouri","Knox County",2,54,41,21,20
050,29,103,"Missouri","Knox County",2,55,53,28,25
050,29,103,"Missouri","Knox County",2,56,54,27,27
050,29,103,"Missouri","Knox County",2,57,53,25,28
050,29,103,"Missouri","Knox County",2,58,60,31,29
050,29,103,"Missouri","Knox County",2,59,64,36,28
050,29,103,"Missouri","Knox County",2,60,57,35,22
050,29,103,"Missouri","Knox County",2,61,62,36,26
050,29,103,"Missouri","Knox County",2,62,65,38,27
050,29,103,"Missouri","Knox County",2,63,60,32,28
050,29,103,"Missouri","Knox County",2,64,57,28,29
050,29,103,"Missouri","Knox County",2,65,50,25,25
050,29,103,"Missouri","Knox County",2,66,46,21,25
050,29,103,"Missouri","Knox County",2,67,44,21,23
050,29,103,"Missouri","Knox County",2,68,40,20,20
050,29,103,"Missouri","Knox County",2,69,42,20,22
050,29,103,"Missouri","Knox County",2,70,45,24,21
050,29,103,"Missouri","Knox County",2,71,43,20,23
050,29,103,"Missouri","Knox County",2,72,45,21,24
050,29,103,"Missouri","Knox County",2,73,46,19,27
050,29,103,"Missouri","Knox County",2,74,32,15,17
050,29,103,"Missouri","Knox County",2,75,36,18,18
050,29,103,"Missouri","Knox County",2,76,30,11,19
050,29,103,"Missouri","Knox County",2,77,36,15,21
050,29,103,"Missouri","Knox County",2,78,35,17,18
050,29,103,"Missouri","Knox County",2,79,29,16,13
050,29,103,"Missouri","Knox County",2,80,25,13,12
050,29,103,"Missouri","Knox County",2,81,22,11,11
050,29,103,"Missouri","Knox County",2,82,18,8,10
050,29,103,"Missouri","Knox County",2,83,18,6,12
050,29,103,"Missouri","Knox County",2,84,17,5,12
050,29,103,"Missouri","Knox County",2,85,95,32,63
050,29,103,"Missouri","Knox County",3,0,40,23,17
050,29,103,"Missouri","Knox County",3,1,58,29,29
050,29,103,"Missouri","Knox County",3,2,55,25,30
050,29,103,"Missouri","Knox County",3,3,55,27,28
050,29,103,"Missouri","Knox County",3,4,47,19,28
050,29,103,"Missouri","Knox County",3,5,41,17,24
050,29,103,"Missouri","Knox County",3,6,44,20,24
050,29,103,"Missouri","Knox County",3,7,46,25,21
050,29,103,"Missouri","Knox County",3,8,47,29,18
050,29,103,"Missouri","Knox County",3,9,41,24,17
050,29,103,"Missouri","Knox County",3,10,36,19,17
050,29,103,"Missouri","Knox County",3,11,50,27,23
050,29,103,"Missouri","Knox County",3,12,59,31,28
050,29,103,"Missouri","Knox County",3,13,59,28,31
050,29,103,"Missouri","Knox County",3,14,50,22,28
050,29,103,"Missouri","Knox County",3,15,57,27,30
050,29,103,"Missouri","Knox County",3,16,55,29,26
050,29,103,"Missouri","Knox County",3,17,48,29,19
050,29,103,"Missouri","Knox County",3,18,46,31,15
050,29,103,"Missouri","Knox County",3,19,44,25,19
050,29,103,"Missouri","Knox County",3,20,38,21,17
050,29,103,"Missouri","Knox County",3,21,49,22,27
050,29,103,"Missouri","Knox County",3,22,52,31,21
050,29,103,"Missouri","Knox County",3,23,46,23,23
050,29,103,"Missouri","Knox County",3,24,43,23,20
050,29,103,"Missouri","Knox County",3,25,49,30,19
050,29,103,"Missouri","Knox County",3,26,43,23,20
050,29,103,"Missouri","Knox County",3,27,37,19,18
050,29,103,"Missouri","Knox County",3,28,40,19,21
050,29,103,"Missouri","Knox County",3,29,38,22,16
050,29,103,"Missouri","Knox County",3,30,42,23,19
050,29,103,"Missouri","Knox County",3,31,33,18,15
050,29,103,"Missouri","Knox County",3,32,37,16,21
050,29,103,"Missouri","Knox County",3,33,40,18,22
050,29,103,"Missouri","Knox County",3,34,34,20,14
050,29,103,"Missouri","Knox County",3,35,32,16,16
050,29,103,"Missouri","Knox County",3,36,36,20,16
050,29,103,"Missouri","Knox County",3,37,43,24,19
050,29,103,"Missouri","Knox County",3,38,47,24,23
050,29,103,"Missouri","Knox County",3,39,45,24,21
050,29,103,"Missouri","Knox County",3,40,35,20,15
050,29,103,"Missouri","Knox County",3,41,39,22,17
050,29,103,"Missouri","Knox County",3,42,28,14,14
050,29,103,"Missouri","Knox County",3,43,31,14,17
050,29,103,"Missouri","Knox County",3,44,35,14,21
050,29,103,"Missouri","Knox County",3,45,36,16,20
050,29,103,"Missouri","Knox County",3,46,39,18,21
050,29,103,"Missouri","Knox County",3,47,39,16,23
050,29,103,"Missouri","Knox County",3,48,40,21,19
050,29,103,"Missouri","Knox County",3,49,41,22,19
050,29,103,"Missouri","Knox County",3,50,49,23,26
050,29,103,"Missouri","Knox County",3,51,51,25,26
050,29,103,"Missouri","Knox County",3,52,42,21,21
050,29,103,"Missouri","Knox County",3,53,45,21,24
050,29,103,"Missouri","Knox County",3,54,45,22,23
050,29,103,"Missouri","Knox County",3,55,45,25,20
050,29,103,"Missouri","Knox County",3,56,51,27,24
050,29,103,"Missouri","Knox County",3,57,55,27,28
050,29,103,"Missouri","Knox County",3,58,54,26,28
050,29,103,"Missouri","Knox County",3,59,60,30,30
050,29,103,"Missouri","Knox County",3,60,63,37,26
050,29,103,"Missouri","Knox County",3,61,61,35,26
050,29,103,"Missouri","Knox County",3,62,62,36,26
050,29,103,"Missouri","Knox County",3,63,68,38,30
050,29,103,"Missouri","Knox County",3,64,61,34,27
050,29,103,"Missouri","Knox County",3,65,58,29,29
050,29,103,"Missouri","Knox County",3,66,53,27,26
050,29,103,"Missouri","Knox County",3,67,46,21,25
050,29,103,"Missouri","Knox County",3,68,44,20,24
050,29,103,"Missouri","Knox County",3,69,38,18,20
050,29,103,"Missouri","Knox County",3,70,44,20,24
050,29,103,"Missouri","Knox County",3,71,43,23,20
050,29,103,"Missouri","Knox County",3,72,41,19,22
050,29,103,"Missouri","Knox County",3,73,45,21,24
050,29,103,"Missouri","Knox County",3,74,44,18,26
050,29,103,"Missouri","Knox County",3,75,31,14,17
050,29,103,"Missouri","Knox County",3,76,35,18,17
050,29,103,"Missouri","Knox County",3,77,26,9,17
050,29,103,"Missouri","Knox County",3,78,34,14,20
050,29,103,"Missouri","Knox County",3,79,33,15,18
050,29,103,"Missouri","Knox County",3,80,25,14,11
050,29,103,"Missouri","Knox County",3,81,21,10,11
050,29,103,"Missouri","Knox County",3,82,18,10,8
050,29,103,"Missouri","Knox County",3,83,19,8,11
050,29,103,"Missouri","Knox County",3,84,16,6,10
050,29,103,"Missouri","Knox County",3,85,94,28,66
050,29,103,"Missouri","Knox County",4,0,46,27,19
050,29,103,"Missouri","Knox County",4,1,44,23,21
050,29,103,"Missouri","Knox County",4,2,62,30,32
050,29,103,"Missouri","Knox County",4,3,52,25,27
050,29,103,"Missouri","Knox County",4,4,52,26,26
050,29,103,"Missouri","Knox County",4,5,51,25,26
050,29,103,"Missouri","Knox County",4,6,40,16,24
050,29,103,"Missouri","Knox County",4,7,51,25,26
050,29,103,"Missouri","Knox County",4,8,44,25,19
050,29,103,"Missouri","Knox County",4,9,43,26,17
050,29,103,"Missouri","Knox County",4,10,41,25,16
050,29,103,"Missouri","Knox County",4,11,34,18,16
050,29,103,"Missouri","Knox County",4,12,50,27,23
050,29,103,"Missouri","Knox County",4,13,58,30,28
050,29,103,"Missouri","Knox County",4,14,58,27,31
050,29,103,"Missouri","Knox County",4,15,53,23,30
050,29,103,"Missouri","Knox County",4,16,58,28,30
050,29,103,"Missouri","Knox County",4,17,54,27,27
050,29,103,"Missouri","Knox County",4,18,43,27,16
050,29,103,"Missouri","Knox County",4,19,41,25,16
050,29,103,"Missouri","Knox County",4,20,49,28,21
050,29,103,"Missouri","Knox County",4,21,38,21,17
050,29,103,"Missouri","Knox County",4,22,47,20,27
050,29,103,"Missouri","Knox County",4,23,48,23,25
050,29,103,"Missouri","Knox County",4,24,49,28,21
050,29,103,"Missouri","Knox County",4,25,46,25,21
050,29,103,"Missouri","Knox County",4,26,46,27,19
050,29,103,"Missouri","Knox County",4,27,47,24,23
050,29,103,"Missouri","Knox County",4,28,40,19,21
050,29,103,"Missouri","Knox County",4,29,38,19,19
050,29,103,"Missouri","Knox County",4,30,39,22,17
050,29,103,"Missouri","Knox County",4,31,37,20,17
050,29,103,"Missouri","Knox County",4,32,39,23,16
050,29,103,"Missouri","Knox County",4,33,32,15,17
050,29,103,"Missouri","Knox County",4,34,40,19,21
050,29,103,"Missouri","Knox County",4,35,30,18,12
050,29,103,"Missouri","Knox County",4,36,34,16,18
050,29,103,"Missouri","Knox County",4,37,36,20,16
050,29,103,"Missouri","Knox County",4,38,42,23,19
050,29,103,"Missouri","Knox County",4,39,47,24,23
050,29,103,"Missouri","Knox County",4,40,47,28,19
050,29,103,"Missouri","Knox County",4,41,38,22,16
050,29,103,"Missouri","Knox County",4,42,38,21,17
050,29,103,"Missouri","Knox County",4,43,27,14,13
050,29,103,"Missouri","Knox County",4,44,29,12,17
050,29,103,"Missouri","Knox County",4,45,37,16,21
050,29,103,"Missouri","Knox County",4,46,35,16,19
050,29,103,"Missouri","Knox County",4,47,42,19,23
050,29,103,"Missouri","Knox County",4,48,40,17,23
050,29,103,"Missouri","Knox County",4,49,41,22,19
050,29,103,"Missouri","Knox County",4,50,43,24,19
050,29,103,"Missouri","Knox County",4,51,49,23,26
050,29,103,"Missouri","Knox County",4,52,48,23,25
050,29,103,"Missouri","Knox County",4,53,44,22,22
050,29,103,"Missouri","Knox County",4,54,48,24,24
050,29,103,"Missouri","Knox County",4,55,46,23,23
050,29,103,"Missouri","Knox County",4,56,43,24,19
050,29,103,"Missouri","Knox County",4,57,50,26,24
050,29,103,"Missouri","Knox County",4,58,60,31,29
050,29,103,"Missouri","Knox County",4,59,55,26,29
050,29,103,"Missouri","Knox County",4,60,57,28,29
050,29,103,"Missouri","Knox County",4,61,61,35,26
050,29,103,"Missouri","Knox County",4,62,63,36,27
050,29,103,"Missouri","Knox County",4,63,62,35,27
050,29,103,"Missouri","Knox County",4,64,69,38,31
050,29,103,"Missouri","Knox County",4,65,57,33,24
050,29,103,"Missouri","Knox County",4,66,59,30,29
050,29,103,"Missouri","Knox County",4,67,55,26,29
050,29,103,"Missouri","Knox County",4,68,45,19,26
050,29,103,"Missouri","Knox County",4,69,42,19,23
050,29,103,"Missouri","Knox County",4,70,36,18,18
050,29,103,"Missouri","Knox County",4,71,41,19,22
050,29,103,"Missouri","Knox County",4,72,38,21,17
050,29,103,"Missouri","Knox County",4,73,40,17,23
050,29,103,"Missouri","Knox County",4,74,43,20,23
050,29,103,"Missouri","Knox County",4,75,43,17,26
050,29,103,"Missouri","Knox County",4,76,30,14,16
050,29,103,"Missouri","Knox County",4,77,34,18,16
050,29,103,"Missouri","Knox County",4,78,26,9,17
050,29,103,"Missouri","Knox County",4,79,32,12,20
050,29,103,"Missouri","Knox County",4,80,24,10,14
050,29,103,"Missouri","Knox County",4,81,20,11,9
050,29,103,"Missouri","Knox County",4,82,20,10,10
050,29,103,"Missouri","Knox County",4,83,16,9,7
050,29,103,"Missouri","Knox County",4,84,18,8,10
050,29,103,"Missouri","Knox County",4,85,87,27,60
050,29,103,"Missouri","Knox County",5,0,47,27,20
050,29,103,"Missouri","Knox County",5,1,43,26,17
050,29,103,"Missouri","Knox County",5,2,45,23,22
050,29,103,"Missouri","Knox County",5,3,62,33,29
050,29,103,"Missouri","Knox County",5,4,59,31,28
050,29,103,"Missouri","Knox County",5,5,45,24,21
050,29,103,"Missouri","Knox County",5,6,49,25,24
050,29,103,"Missouri","Knox County",5,7,39,16,23
050,29,103,"Missouri","Knox County",5,8,53,29,24
050,29,103,"Missouri","Knox County",5,9,44,26,18
050,29,103,"Missouri","Knox County",5,10,41,25,16
050,29,103,"Missouri","Knox County",5,11,41,25,16
050,29,103,"Missouri","Knox County",5,12,34,18,16
050,29,103,"Missouri","Knox County",5,13,51,27,24
050,29,103,"Missouri","Knox County",5,14,55,28,27
050,29,103,"Missouri","Knox County",5,15,58,28,30
050,29,103,"Missouri","Knox County",5,16,46,18,28
050,29,103,"Missouri","Knox County",5,17,57,28,29
050,29,103,"Missouri","Knox County",5,18,49,26,23
050,29,103,"Missouri","Knox County",5,19,34,20,14
050,29,103,"Missouri","Knox County",5,20,39,23,16
050,29,103,"Missouri","Knox County",5,21,47,28,19
050,29,103,"Missouri","Knox County",5,22,38,18,20
050,29,103,"Missouri","Knox County",5,23,48,22,26
050,29,103,"Missouri","Knox County",5,24,48,24,24
050,29,103,"Missouri","Knox County",5,25,49,29,20
050,29,103,"Missouri","Knox County",5,26,41,21,20
050,29,103,"Missouri","Knox County",5,27,42,26,16
050,29,103,"Missouri","Knox County",5,28,48,25,23
050,29,103,"Missouri","Knox County",5,29,36,17,19
050,29,103,"Missouri","Knox County",5,30,38,21,17
050,29,103,"Missouri","Knox County",5,31,37,20,17
050,29,103,"Missouri","Knox County",5,32,45,25,20
050,29,103,"Missouri","Knox County",5,33,40,24,16
050,29,103,"Missouri","Knox County",5,34,32,15,17
050,29,103,"Missouri","Knox County",5,35,37,19,18
050,29,103,"Missouri","Knox County",5,36,35,19,16
050,29,103,"Missouri","Knox County",5,37,32,16,16
050,29,103,"Missouri","Knox County",5,38,38,23,15
050,29,103,"Missouri","Knox County",5,39,38,19,19
050,29,103,"Missouri","Knox County",5,40,47,23,24
050,29,103,"Missouri","Knox County",5,41,47,29,18
050,29,103,"Missouri","Knox County",5,42,36,19,17
050,29,103,"Missouri","Knox County",5,43,38,21,17
050,29,103,"Missouri","Knox County",5,44,28,14,14
050,29,103,"Missouri","Knox County",5,45,31,12,19
050,29,103,"Missouri","Knox County",5,46,37,15,22
050,29,103,"Missouri","Knox County",5,47,29,14,15
050,29,103,"Missouri","Knox County",5,48,42,20,22
050,29,103,"Missouri","Knox County",5,49,39,18,21
050,29,103,"Missouri","Knox County",5,50,37,21,16
050,29,103,"Missouri","Knox County",5,51,44,26,18
050,29,103,"Missouri","Knox County",5,52,48,23,25
050,29,103,"Missouri","Knox County",5,53,49,24,25
050,29,103,"Missouri","Knox County",5,54,42,21,21
050,29,103,"Missouri","Knox County",5,55,46,22,24
050,29,103,"Missouri","Knox County",5,56,47,25,22
050,29,103,"Missouri","Knox County",5,57,44,24,20
050,29,103,"Missouri","Knox County",5,58,51,27,24
050,29,103,"Missouri","Knox County",5,59,60,30,30
050,29,103,"Missouri","Knox County",5,60,53,25,28
050,29,103,"Missouri","Knox County",5,61,55,25,30
050,29,103,"Missouri","Knox County",5,62,60,35,25
050,29,103,"Missouri","Knox County",5,63,66,38,28
050,29,103,"Missouri","Knox County",5,64,62,35,27
050,29,103,"Missouri","Knox County",5,65,66,37,29
050,29,103,"Missouri","Knox County",5,66,55,31,24
050,29,103,"Missouri","Knox County",5,67,62,32,30
050,29,103,"Missouri","Knox County",5,68,54,25,29
050,29,103,"Missouri","Knox County",5,69,42,18,24
050,29,103,"Missouri","Knox County",5,70,43,21,22
050,29,103,"Missouri","Knox County",5,71,33,16,17
050,29,103,"Missouri","Knox County",5,72,40,18,22
050,29,103,"Missouri","Knox County",5,73,40,21,19
050,29,103,"Missouri","Knox County",5,74,37,16,21
050,29,103,"Missouri","Knox County",5,75,41,19,22
050,29,103,"Missouri","Knox County",5,76,42,17,25
050,29,103,"Missouri","Knox County",5,77,27,13,14
050,29,103,"Missouri","Knox County",5,78,34,17,17
050,29,103,"Missouri","Knox County",5,79,26,8,18
050,29,103,"Missouri","Knox County",5,80,26,8,18
050,29,103,"Missouri","Knox County",5,81,21,7,14
050,29,103,"Missouri","Knox County",5,82,18,9,9
050,29,103,"Missouri","Knox County",5,83,20,10,10
050,29,103,"Missouri","Knox County",5,84,15,9,6
050,29,103,"Missouri","Knox County",5,85,83,28,55
050,29,105,"Missouri","Laclede County",1,0,476,243,233
050,29,105,"Missouri","Laclede County",1,1,481,247,234
050,29,105,"Missouri","Laclede County",1,2,494,262,232
050,29,105,"Missouri","Laclede County",1,3,525,290,235
050,29,105,"Missouri","Laclede County",1,4,503,252,251
050,29,105,"Missouri","Laclede County",1,5,511,258,253
050,29,105,"Missouri","Laclede County",1,6,479,244,235
050,29,105,"Missouri","Laclede County",1,7,466,245,221
050,29,105,"Missouri","Laclede County",1,8,472,226,246
050,29,105,"Missouri","Laclede County",1,9,469,229,240
050,29,105,"Missouri","Laclede County",1,10,499,240,259
050,29,105,"Missouri","Laclede County",1,11,500,256,244
050,29,105,"Missouri","Laclede County",1,12,504,275,229
050,29,105,"Missouri","Laclede County",1,13,541,302,239
050,29,105,"Missouri","Laclede County",1,14,554,279,275
050,29,105,"Missouri","Laclede County",1,15,546,277,269
050,29,105,"Missouri","Laclede County",1,16,521,270,251
050,29,105,"Missouri","Laclede County",1,17,485,234,251
050,29,105,"Missouri","Laclede County",1,18,413,216,197
050,29,105,"Missouri","Laclede County",1,19,347,192,155
050,29,105,"Missouri","Laclede County",1,20,362,198,164
050,29,105,"Missouri","Laclede County",1,21,358,189,169
050,29,105,"Missouri","Laclede County",1,22,372,193,179
050,29,105,"Missouri","Laclede County",1,23,399,205,194
050,29,105,"Missouri","Laclede County",1,24,425,218,207
050,29,105,"Missouri","Laclede County",1,25,410,208,202
050,29,105,"Missouri","Laclede County",1,26,420,205,215
050,29,105,"Missouri","Laclede County",1,27,411,221,190
050,29,105,"Missouri","Laclede County",1,28,428,232,196
050,29,105,"Missouri","Laclede County",1,29,420,207,213
050,29,105,"Missouri","Laclede County",1,30,429,207,222
050,29,105,"Missouri","Laclede County",1,31,416,201,215
050,29,105,"Missouri","Laclede County",1,32,401,199,202
050,29,105,"Missouri","Laclede County",1,33,398,212,186
050,29,105,"Missouri","Laclede County",1,34,396,209,187
050,29,105,"Missouri","Laclede County",1,35,432,209,223
050,29,105,"Missouri","Laclede County",1,36,446,209,237
050,29,105,"Missouri","Laclede County",1,37,451,226,225
050,29,105,"Missouri","Laclede County",1,38,455,230,225
050,29,105,"Missouri","Laclede County",1,39,428,218,210
050,29,105,"Missouri","Laclede County",1,40,444,223,221
050,29,105,"Missouri","Laclede County",1,41,440,212,228
050,29,105,"Missouri","Laclede County",1,42,432,208,224
050,29,105,"Missouri","Laclede County",1,43,405,209,196
050,29,105,"Missouri","Laclede County",1,44,384,186,198
050,29,105,"Missouri","Laclede County",1,45,359,166,193
050,29,105,"Missouri","Laclede County",1,46,396,195,201
050,29,105,"Missouri","Laclede County",1,47,427,211,216
050,29,105,"Missouri","Laclede County",1,48,458,224,234
050,29,105,"Missouri","Laclede County",1,49,504,263,241
050,29,105,"Missouri","Laclede County",1,50,486,249,237
050,29,105,"Missouri","Laclede County",1,51,446,231,215
050,29,105,"Missouri","Laclede County",1,52,442,215,227
050,29,105,"Missouri","Laclede County",1,53,457,238,219
050,29,105,"Missouri","Laclede County",1,54,457,233,224
050,29,105,"Missouri","Laclede County",1,55,521,275,246
050,29,105,"Missouri","Laclede County",1,56,582,299,283
050,29,105,"Missouri","Laclede County",1,57,558,285,273
050,29,105,"Missouri","Laclede County",1,58,518,274,244
050,29,105,"Missouri","Laclede County",1,59,508,265,243
050,29,105,"Missouri","Laclede County",1,60,495,255,240
050,29,105,"Missouri","Laclede County",1,61,464,226,238
050,29,105,"Missouri","Laclede County",1,62,469,225,244
050,29,105,"Missouri","Laclede County",1,63,471,228,243
050,29,105,"Missouri","Laclede County",1,64,469,235,234
050,29,105,"Missouri","Laclede County",1,65,435,205,230
050,29,105,"Missouri","Laclede County",1,66,402,199,203
050,29,105,"Missouri","Laclede County",1,67,407,192,215
050,29,105,"Missouri","Laclede County",1,68,404,191,213
050,29,105,"Missouri","Laclede County",1,69,370,181,189
050,29,105,"Missouri","Laclede County",1,70,349,167,182
050,29,105,"Missouri","Laclede County",1,71,365,172,193
050,29,105,"Missouri","Laclede County",1,72,384,177,207
050,29,105,"Missouri","Laclede County",1,73,377,170,207
050,29,105,"Missouri","Laclede County",1,74,277,122,155
050,29,105,"Missouri","Laclede County",1,75,277,130,147
050,29,105,"Missouri","Laclede County",1,76,280,138,142
050,29,105,"Missouri","Laclede County",1,77,273,138,135
050,29,105,"Missouri","Laclede County",1,78,228,105,123
050,29,105,"Missouri","Laclede County",1,79,197,83,114
050,29,105,"Missouri","Laclede County",1,80,180,76,104
050,29,105,"Missouri","Laclede County",1,81,179,70,109
050,29,105,"Missouri","Laclede County",1,82,152,67,85
050,29,105,"Missouri","Laclede County",1,83,135,56,79
050,29,105,"Missouri","Laclede County",1,84,126,55,71
050,29,105,"Missouri","Laclede County",1,85,605,212,393
050,29,105,"Missouri","Laclede County",2,0,464,242,222
050,29,105,"Missouri","Laclede County",2,1,477,246,231
050,29,105,"Missouri","Laclede County",2,2,494,261,233
050,29,105,"Missouri","Laclede County",2,3,514,283,231
050,29,105,"Missouri","Laclede County",2,4,511,263,248
050,29,105,"Missouri","Laclede County",2,5,513,258,255
050,29,105,"Missouri","Laclede County",2,6,488,248,240
050,29,105,"Missouri","Laclede County",2,7,465,244,221
050,29,105,"Missouri","Laclede County",2,8,469,232,237
050,29,105,"Missouri","Laclede County",2,9,473,230,243
050,29,105,"Missouri","Laclede County",2,10,492,238,254
050,29,105,"Missouri","Laclede County",2,11,499,253,246
050,29,105,"Missouri","Laclede County",2,12,508,273,235
050,29,105,"Missouri","Laclede County",2,13,532,295,237
050,29,105,"Missouri","Laclede County",2,14,553,286,267
050,29,105,"Missouri","Laclede County",2,15,547,277,270
050,29,105,"Missouri","Laclede County",2,16,528,272,256
050,29,105,"Missouri","Laclede County",2,17,492,243,249
050,29,105,"Missouri","Laclede County",2,18,408,212,196
050,29,105,"Missouri","Laclede County",2,19,344,189,155
050,29,105,"Missouri","Laclede County",2,20,367,202,165
050,29,105,"Missouri","Laclede County",2,21,359,191,168
050,29,105,"Missouri","Laclede County",2,22,375,198,177
050,29,105,"Missouri","Laclede County",2,23,396,204,192
050,29,105,"Missouri","Laclede County",2,24,415,212,203
050,29,105,"Missouri","Laclede County",2,25,408,208,200
050,29,105,"Missouri","Laclede County",2,26,417,205,212
050,29,105,"Missouri","Laclede County",2,27,411,215,196
050,29,105,"Missouri","Laclede County",2,28,422,226,196
050,29,105,"Missouri","Laclede County",2,29,424,213,211
050,29,105,"Missouri","Laclede County",2,30,435,213,222
050,29,105,"Missouri","Laclede County",2,31,418,202,216
050,29,105,"Missouri","Laclede County",2,32,405,200,205
050,29,105,"Missouri","Laclede County",2,33,404,211,193
050,29,105,"Missouri","Laclede County",2,34,401,212,189
050,29,105,"Missouri","Laclede County",2,35,425,210,215
050,29,105,"Missouri","Laclede County",2,36,437,206,231
050,29,105,"Missouri","Laclede County",2,37,452,223,229
050,29,105,"Missouri","Laclede County",2,38,456,231,225
050,29,105,"Missouri","Laclede County",2,39,438,223,215
050,29,105,"Missouri","Laclede County",2,40,443,224,219
050,29,105,"Missouri","Laclede County",2,41,439,214,225
050,29,105,"Missouri","Laclede County",2,42,427,207,220
050,29,105,"Missouri","Laclede County",2,43,414,211,203
050,29,105,"Missouri","Laclede County",2,44,382,187,195
050,29,105,"Missouri","Laclede County",2,45,366,171,195
050,29,105,"Missouri","Laclede County",2,46,385,188,197
050,29,105,"Missouri","Laclede County",2,47,418,207,211
050,29,105,"Missouri","Laclede County",2,48,450,221,229
050,29,105,"Missouri","Laclede County",2,49,495,255,240
050,29,105,"Missouri","Laclede County",2,50,487,252,235
050,29,105,"Missouri","Laclede County",2,51,454,235,219
050,29,105,"Missouri","Laclede County",2,52,445,222,223
050,29,105,"Missouri","Laclede County",2,53,453,231,222
050,29,105,"Missouri","Laclede County",2,54,457,235,222
050,29,105,"Missouri","Laclede County",2,55,508,267,241
050,29,105,"Missouri","Laclede County",2,56,570,295,275
050,29,105,"Missouri","Laclede County",2,57,559,287,272
050,29,105,"Missouri","Laclede County",2,58,531,279,252
050,29,105,"Missouri","Laclede County",2,59,510,267,243
050,29,105,"Missouri","Laclede County",2,60,493,254,239
050,29,105,"Missouri","Laclede County",2,61,469,231,238
050,29,105,"Missouri","Laclede County",2,62,464,223,241
050,29,105,"Missouri","Laclede County",2,63,475,229,246
050,29,105,"Missouri","Laclede County",2,64,464,231,233
050,29,105,"Missouri","Laclede County",2,65,441,212,229
050,29,105,"Missouri","Laclede County",2,66,410,201,209
050,29,105,"Missouri","Laclede County",2,67,404,193,211
050,29,105,"Missouri","Laclede County",2,68,403,191,212
050,29,105,"Missouri","Laclede County",2,69,383,185,198
050,29,105,"Missouri","Laclede County",2,70,354,171,183
050,29,105,"Missouri","Laclede County",2,71,363,169,194
050,29,105,"Missouri","Laclede County",2,72,376,173,203
050,29,105,"Missouri","Laclede County",2,73,396,180,216
050,29,105,"Missouri","Laclede County",2,74,282,125,157
050,29,105,"Missouri","Laclede County",2,75,274,125,149
050,29,105,"Missouri","Laclede County",2,76,274,134,140
050,29,105,"Missouri","Laclede County",2,77,280,140,140
050,29,105,"Missouri","Laclede County",2,78,228,107,121
050,29,105,"Missouri","Laclede County",2,79,201,85,116
050,29,105,"Missouri","Laclede County",2,80,177,73,104
050,29,105,"Missouri","Laclede County",2,81,176,71,105
050,29,105,"Missouri","Laclede County",2,82,156,66,90
050,29,105,"Missouri","Laclede County",2,83,135,57,78
050,29,105,"Missouri","Laclede County",2,84,124,53,71
050,29,105,"Missouri","Laclede County",2,85,612,216,396
050,29,105,"Missouri","Laclede County",3,0,471,235,236
050,29,105,"Missouri","Laclede County",3,1,458,239,219
050,29,105,"Missouri","Laclede County",3,2,481,254,227
050,29,105,"Missouri","Laclede County",3,3,497,267,230
050,29,105,"Missouri","Laclede County",3,4,519,285,234
050,29,105,"Missouri","Laclede County",3,5,488,256,232
050,29,105,"Missouri","Laclede County",3,6,495,253,242
050,29,105,"Missouri","Laclede County",3,7,497,253,244
050,29,105,"Missouri","Laclede County",3,8,459,242,217
050,29,105,"Missouri","Laclede County",3,9,480,237,243
050,29,105,"Missouri","Laclede County",3,10,480,234,246
050,29,105,"Missouri","Laclede County",3,11,509,243,266
050,29,105,"Missouri","Laclede County",3,12,511,255,256
050,29,105,"Missouri","Laclede County",3,13,524,286,238
050,29,105,"Missouri","Laclede County",3,14,549,305,244
050,29,105,"Missouri","Laclede County",3,15,570,307,263
050,29,105,"Missouri","Laclede County",3,16,547,275,272
050,29,105,"Missouri","Laclede County",3,17,540,277,263
050,29,105,"Missouri","Laclede County",3,18,425,214,211
050,29,105,"Missouri","Laclede County",3,19,328,160,168
050,29,105,"Missouri","Laclede County",3,20,365,202,163
050,29,105,"Missouri","Laclede County",3,21,388,205,183
050,29,105,"Missouri","Laclede County",3,22,371,199,172
050,29,105,"Missouri","Laclede County",3,23,384,197,187
050,29,105,"Missouri","Laclede County",3,24,398,196,202
050,29,105,"Missouri","Laclede County",3,25,428,211,217
050,29,105,"Missouri","Laclede County",3,26,390,200,190
050,29,105,"Missouri","Laclede County",3,27,428,212,216
050,29,105,"Missouri","Laclede County",3,28,423,219,204
050,29,105,"Missouri","Laclede County",3,29,424,218,206
050,29,105,"Missouri","Laclede County",3,30,425,212,213
050,29,105,"Missouri","Laclede County",3,31,440,215,225
050,29,105,"Missouri","Laclede County",3,32,394,188,206
050,29,105,"Missouri","Laclede County",3,33,407,197,210
050,29,105,"Missouri","Laclede County",3,34,414,216,198
050,29,105,"Missouri","Laclede County",3,35,401,206,195
050,29,105,"Missouri","Laclede County",3,36,424,210,214
050,29,105,"Missouri","Laclede County",3,37,443,211,232
050,29,105,"Missouri","Laclede County",3,38,464,228,236
050,29,105,"Missouri","Laclede County",3,39,469,238,231
050,29,105,"Missouri","Laclede County",3,40,453,230,223
050,29,105,"Missouri","Laclede County",3,41,440,220,220
050,29,105,"Missouri","Laclede County",3,42,436,216,220
050,29,105,"Missouri","Laclede County",3,43,438,213,225
050,29,105,"Missouri","Laclede County",3,44,415,216,199
050,29,105,"Missouri","Laclede County",3,45,384,183,201
050,29,105,"Missouri","Laclede County",3,46,381,185,196
050,29,105,"Missouri","Laclede County",3,47,399,197,202
050,29,105,"Missouri","Laclede County",3,48,412,200,212
050,29,105,"Missouri","Laclede County",3,49,452,228,224
050,29,105,"Missouri","Laclede County",3,50,490,247,243
050,29,105,"Missouri","Laclede County",3,51,488,253,235
050,29,105,"Missouri","Laclede County",3,52,462,236,226
050,29,105,"Missouri","Laclede County",3,53,446,221,225
050,29,105,"Missouri","Laclede County",3,54,462,231,231
050,29,105,"Missouri","Laclede County",3,55,455,238,217
050,29,105,"Missouri","Laclede County",3,56,505,260,245
050,29,105,"Missouri","Laclede County",3,57,563,298,265
050,29,105,"Missouri","Laclede County",3,58,546,280,266
050,29,105,"Missouri","Laclede County",3,59,533,279,254
050,29,105,"Missouri","Laclede County",3,60,516,268,248
050,29,105,"Missouri","Laclede County",3,61,480,246,234
050,29,105,"Missouri","Laclede County",3,62,468,229,239
050,29,105,"Missouri","Laclede County",3,63,469,227,242
050,29,105,"Missouri","Laclede County",3,64,457,217,240
050,29,105,"Missouri","Laclede County",3,65,459,227,232
050,29,105,"Missouri","Laclede County",3,66,430,214,216
050,29,105,"Missouri","Laclede County",3,67,403,192,211
050,29,105,"Missouri","Laclede County",3,68,385,183,202
050,29,105,"Missouri","Laclede County",3,69,396,184,212
050,29,105,"Missouri","Laclede County",3,70,365,179,186
050,29,105,"Missouri","Laclede County",3,71,343,162,181
050,29,105,"Missouri","Laclede County",3,72,361,163,198
050,29,105,"Missouri","Laclede County",3,73,348,164,184
050,29,105,"Missouri","Laclede County",3,74,387,170,217
050,29,105,"Missouri","Laclede County",3,75,263,114,149
050,29,105,"Missouri","Laclede County",3,76,248,111,137
050,29,105,"Missouri","Laclede County",3,77,258,124,134
050,29,105,"Missouri","Laclede County",3,78,263,133,130
050,29,105,"Missouri","Laclede County",3,79,221,101,120
050,29,105,"Missouri","Laclede County",3,80,179,78,101
050,29,105,"Missouri","Laclede County",3,81,167,69,98
050,29,105,"Missouri","Laclede County",3,82,152,61,91
050,29,105,"Missouri","Laclede County",3,83,145,60,85
050,29,105,"Missouri","Laclede County",3,84,109,46,63
050,29,105,"Missouri","Laclede County",3,85,616,227,389
050,29,105,"Missouri","Laclede County",4,0,469,242,227
050,29,105,"Missouri","Laclede County",4,1,467,251,216
050,29,105,"Missouri","Laclede County",4,2,475,240,235
050,29,105,"Missouri","Laclede County",4,3,502,258,244
050,29,105,"Missouri","Laclede County",4,4,499,267,232
050,29,105,"Missouri","Laclede County",4,5,522,284,238
050,29,105,"Missouri","Laclede County",4,6,504,259,245
050,29,105,"Missouri","Laclede County",4,7,511,261,250
050,29,105,"Missouri","Laclede County",4,8,501,255,246
050,29,105,"Missouri","Laclede County",4,9,464,248,216
050,29,105,"Missouri","Laclede County",4,10,478,232,246
050,29,105,"Missouri","Laclede County",4,11,484,233,251
050,29,105,"Missouri","Laclede County",4,12,513,245,268
050,29,105,"Missouri","Laclede County",4,13,509,258,251
050,29,105,"Missouri","Laclede County",4,14,521,277,244
050,29,105,"Missouri","Laclede County",4,15,560,316,244
050,29,105,"Missouri","Laclede County",4,16,558,289,269
050,29,105,"Missouri","Laclede County",4,17,568,291,277
050,29,105,"Missouri","Laclede County",4,18,444,238,206
050,29,105,"Missouri","Laclede County",4,19,334,166,168
050,29,105,"Missouri","Laclede County",4,20,343,166,177
050,29,105,"Missouri","Laclede County",4,21,376,203,173
050,29,105,"Missouri","Laclede County",4,22,410,211,199
050,29,105,"Missouri","Laclede County",4,23,398,213,185
050,29,105,"Missouri","Laclede County",4,24,384,204,180
050,29,105,"Missouri","Laclede County",4,25,410,202,208
050,29,105,"Missouri","Laclede County",4,26,408,208,200
050,29,105,"Missouri","Laclede County",4,27,427,214,213
050,29,105,"Missouri","Laclede County",4,28,429,223,206
050,29,105,"Missouri","Laclede County",4,29,426,220,206
050,29,105,"Missouri","Laclede County",4,30,450,235,215
050,29,105,"Missouri","Laclede County",4,31,432,211,221
050,29,105,"Missouri","Laclede County",4,32,439,213,226
050,29,105,"Missouri","Laclede County",4,33,395,191,204
050,29,105,"Missouri","Laclede County",4,34,415,200,215
050,29,105,"Missouri","Laclede County",4,35,411,221,190
050,29,105,"Missouri","Laclede County",4,36,395,209,186
050,29,105,"Missouri","Laclede County",4,37,444,216,228
050,29,105,"Missouri","Laclede County",4,38,458,215,243
050,29,105,"Missouri","Laclede County",4,39,473,235,238
050,29,105,"Missouri","Laclede County",4,40,454,227,227
050,29,105,"Missouri","Laclede County",4,41,464,233,231
050,29,105,"Missouri","Laclede County",4,42,446,216,230
050,29,105,"Missouri","Laclede County",4,43,445,219,226
050,29,105,"Missouri","Laclede County",4,44,432,213,219
050,29,105,"Missouri","Laclede County",4,45,409,202,207
050,29,105,"Missouri","Laclede County",4,46,398,200,198
050,29,105,"Missouri","Laclede County",4,47,385,190,195
050,29,105,"Missouri","Laclede County",4,48,390,195,195
050,29,105,"Missouri","Laclede County",4,49,408,200,208
050,29,105,"Missouri","Laclede County",4,50,454,234,220
050,29,105,"Missouri","Laclede County",4,51,490,244,246
050,29,105,"Missouri","Laclede County",4,52,492,258,234
050,29,105,"Missouri","Laclede County",4,53,470,245,225
050,29,105,"Missouri","Laclede County",4,54,447,219,228
050,29,105,"Missouri","Laclede County",4,55,470,236,234
050,29,105,"Missouri","Laclede County",4,56,453,234,219
050,29,105,"Missouri","Laclede County",4,57,495,258,237
050,29,105,"Missouri","Laclede County",4,58,569,298,271
050,29,105,"Missouri","Laclede County",4,59,537,277,260
050,29,105,"Missouri","Laclede County",4,60,541,281,260
050,29,105,"Missouri","Laclede County",4,61,517,268,249
050,29,105,"Missouri","Laclede County",4,62,478,247,231
050,29,105,"Missouri","Laclede County",4,63,464,223,241
050,29,105,"Missouri","Laclede County",4,64,451,221,230
050,29,105,"Missouri","Laclede County",4,65,442,201,241
050,29,105,"Missouri","Laclede County",4,66,452,221,231
050,29,105,"Missouri","Laclede County",4,67,419,204,215
050,29,105,"Missouri","Laclede County",4,68,397,190,207
050,29,105,"Missouri","Laclede County",4,69,385,183,202
050,29,105,"Missouri","Laclede County",4,70,380,174,206
050,29,105,"Missouri","Laclede County",4,71,350,166,184
050,29,105,"Missouri","Laclede County",4,72,344,162,182
050,29,105,"Missouri","Laclede County",4,73,352,163,189
050,29,105,"Missouri","Laclede County",4,74,331,155,176
050,29,105,"Missouri","Laclede County",4,75,371,165,206
050,29,105,"Missouri","Laclede County",4,76,243,108,135
050,29,105,"Missouri","Laclede County",4,77,239,112,127
050,29,105,"Missouri","Laclede County",4,78,231,105,126
050,29,105,"Missouri","Laclede County",4,79,261,127,134
050,29,105,"Missouri","Laclede County",4,80,198,91,107
050,29,105,"Missouri","Laclede County",4,81,169,73,96
050,29,105,"Missouri","Laclede County",4,82,153,63,90
050,29,105,"Missouri","Laclede County",4,83,141,60,81
050,29,105,"Missouri","Laclede County",4,84,121,50,71
050,29,105,"Missouri","Laclede County",4,85,601,239,362
050,29,105,"Missouri","Laclede County",5,0,466,240,226
050,29,105,"Missouri","Laclede County",5,1,482,248,234
050,29,105,"Missouri","Laclede County",5,2,459,253,206
050,29,105,"Missouri","Laclede County",5,3,481,236,245
050,29,105,"Missouri","Laclede County",5,4,508,258,250
050,29,105,"Missouri","Laclede County",5,5,497,266,231
050,29,105,"Missouri","Laclede County",5,6,541,293,248
050,29,105,"Missouri","Laclede County",5,7,510,249,261
050,29,105,"Missouri","Laclede County",5,8,521,264,257
050,29,105,"Missouri","Laclede County",5,9,505,251,254
050,29,105,"Missouri","Laclede County",5,10,462,239,223
050,29,105,"Missouri","Laclede County",5,11,483,234,249
050,29,105,"Missouri","Laclede County",5,12,487,242,245
050,29,105,"Missouri","Laclede County",5,13,522,249,273
050,29,105,"Missouri","Laclede County",5,14,518,261,257
050,29,105,"Missouri","Laclede County",5,15,537,279,258
050,29,105,"Missouri","Laclede County",5,16,562,325,237
050,29,105,"Missouri","Laclede County",5,17,565,300,265
050,29,105,"Missouri","Laclede County",5,18,461,244,217
050,29,105,"Missouri","Laclede County",5,19,363,194,169
050,29,105,"Missouri","Laclede County",5,20,345,174,171
050,29,105,"Missouri","Laclede County",5,21,354,170,184
050,29,105,"Missouri","Laclede County",5,22,389,210,179
050,29,105,"Missouri","Laclede County",5,23,443,235,208
050,29,105,"Missouri","Laclede County",5,24,412,215,197
050,29,105,"Missouri","Laclede County",5,25,414,218,196
050,29,105,"Missouri","Laclede County",5,26,411,203,208
050,29,105,"Missouri","Laclede County",5,27,431,217,214
050,29,105,"Missouri","Laclede County",5,28,405,204,201
050,29,105,"Missouri","Laclede County",5,29,444,228,216
050,29,105,"Missouri","Laclede County",5,30,445,230,215
050,29,105,"Missouri","Laclede County",5,31,466,243,223
050,29,105,"Missouri","Laclede County",5,32,437,219,218
050,29,105,"Missouri","Laclede County",5,33,453,222,231
050,29,105,"Missouri","Laclede County",5,34,395,191,204
050,29,105,"Missouri","Laclede County",5,35,411,196,215
050,29,105,"Missouri","Laclede County",5,36,415,221,194
050,29,105,"Missouri","Laclede County",5,37,408,212,196
050,29,105,"Missouri","Laclede County",5,38,441,212,229
050,29,105,"Missouri","Laclede County",5,39,448,212,236
050,29,105,"Missouri","Laclede County",5,40,487,240,247
050,29,105,"Missouri","Laclede County",5,41,463,233,230
050,29,105,"Missouri","Laclede County",5,42,485,245,240
050,29,105,"Missouri","Laclede County",5,43,432,214,218
050,29,105,"Missouri","Laclede County",5,44,447,221,226
050,29,105,"Missouri","Laclede County",5,45,434,214,220
050,29,105,"Missouri","Laclede County",5,46,419,214,205
050,29,105,"Missouri","Laclede County",5,47,406,199,207
050,29,105,"Missouri","Laclede County",5,48,383,188,195
050,29,105,"Missouri","Laclede County",5,49,395,198,197
050,29,105,"Missouri","Laclede County",5,50,431,208,223
050,29,105,"Missouri","Laclede County",5,51,460,230,230
050,29,105,"Missouri","Laclede County",5,52,496,248,248
050,29,105,"Missouri","Laclede County",5,53,504,265,239
050,29,105,"Missouri","Laclede County",5,54,473,252,221
050,29,105,"Missouri","Laclede County",5,55,464,230,234
050,29,105,"Missouri","Laclede County",5,56,468,241,227
050,29,105,"Missouri","Laclede County",5,57,456,243,213
050,29,105,"Missouri","Laclede County",5,58,500,255,245
050,29,105,"Missouri","Laclede County",5,59,567,306,261
050,29,105,"Missouri","Laclede County",5,60,541,275,266
050,29,105,"Missouri","Laclede County",5,61,541,281,260
050,29,105,"Missouri","Laclede County",5,62,508,267,241
050,29,105,"Missouri","Laclede County",5,63,480,242,238
050,29,105,"Missouri","Laclede County",5,64,461,223,238
050,29,105,"Missouri","Laclede County",5,65,444,213,231
050,29,105,"Missouri","Laclede County",5,66,435,197,238
050,29,105,"Missouri","Laclede County",5,67,445,214,231
050,29,105,"Missouri","Laclede County",5,68,413,203,210
050,29,105,"Missouri","Laclede County",5,69,396,187,209
050,29,105,"Missouri","Laclede County",5,70,372,179,193
050,29,105,"Missouri","Laclede County",5,71,366,163,203
050,29,105,"Missouri","Laclede County",5,72,347,161,186
050,29,105,"Missouri","Laclede County",5,73,330,159,171
050,29,105,"Missouri","Laclede County",5,74,328,153,175
050,29,105,"Missouri","Laclede County",5,75,315,145,170
050,29,105,"Missouri","Laclede County",5,76,357,152,205
050,29,105,"Missouri","Laclede County",5,77,235,111,124
050,29,105,"Missouri","Laclede County",5,78,223,99,124
050,29,105,"Missouri","Laclede County",5,79,227,99,128
050,29,105,"Missouri","Laclede County",5,80,238,120,118
050,29,105,"Missouri","Laclede County",5,81,184,84,100
050,29,105,"Missouri","Laclede County",5,82,146,63,83
050,29,105,"Missouri","Laclede County",5,83,144,62,82
050,29,105,"Missouri","Laclede County",5,84,124,53,71
050,29,105,"Missouri","Laclede County",5,85,613,254,359
050,29,107,"Missouri","Lafayette County",1,0,392,201,191
050,29,107,"Missouri","Lafayette County",1,1,382,204,178
050,29,107,"Missouri","Lafayette County",1,2,418,219,199
050,29,107,"Missouri","Lafayette County",1,3,417,230,187
050,29,107,"Missouri","Lafayette County",1,4,387,209,178
050,29,107,"Missouri","Lafayette County",1,5,407,217,190
050,29,107,"Missouri","Lafayette County",1,6,402,212,190
050,29,107,"Missouri","Lafayette County",1,7,414,209,205
050,29,107,"Missouri","Lafayette County",1,8,398,204,194
050,29,107,"Missouri","Lafayette County",1,9,425,220,205
050,29,107,"Missouri","Lafayette County",1,10,424,226,198
050,29,107,"Missouri","Lafayette County",1,11,450,223,227
050,29,107,"Missouri","Lafayette County",1,12,462,239,223
050,29,107,"Missouri","Lafayette County",1,13,483,233,250
050,29,107,"Missouri","Lafayette County",1,14,485,229,256
050,29,107,"Missouri","Lafayette County",1,15,445,224,221
050,29,107,"Missouri","Lafayette County",1,16,434,236,198
050,29,107,"Missouri","Lafayette County",1,17,456,240,216
050,29,107,"Missouri","Lafayette County",1,18,381,213,168
050,29,107,"Missouri","Lafayette County",1,19,299,164,135
050,29,107,"Missouri","Lafayette County",1,20,333,172,161
050,29,107,"Missouri","Lafayette County",1,21,330,175,155
050,29,107,"Missouri","Lafayette County",1,22,339,167,172
050,29,107,"Missouri","Lafayette County",1,23,344,178,166
050,29,107,"Missouri","Lafayette County",1,24,365,186,179
050,29,107,"Missouri","Lafayette County",1,25,383,185,198
050,29,107,"Missouri","Lafayette County",1,26,375,197,178
050,29,107,"Missouri","Lafayette County",1,27,402,197,205
050,29,107,"Missouri","Lafayette County",1,28,426,217,209
050,29,107,"Missouri","Lafayette County",1,29,427,227,200
050,29,107,"Missouri","Lafayette County",1,30,395,197,198
050,29,107,"Missouri","Lafayette County",1,31,369,196,173
050,29,107,"Missouri","Lafayette County",1,32,357,167,190
050,29,107,"Missouri","Lafayette County",1,33,369,179,190
050,29,107,"Missouri","Lafayette County",1,34,403,196,207
050,29,107,"Missouri","Lafayette County",1,35,422,209,213
050,29,107,"Missouri","Lafayette County",1,36,431,213,218
050,29,107,"Missouri","Lafayette County",1,37,390,203,187
050,29,107,"Missouri","Lafayette County",1,38,379,192,187
050,29,107,"Missouri","Lafayette County",1,39,396,193,203
050,29,107,"Missouri","Lafayette County",1,40,401,188,213
050,29,107,"Missouri","Lafayette County",1,41,358,187,171
050,29,107,"Missouri","Lafayette County",1,42,357,177,180
050,29,107,"Missouri","Lafayette County",1,43,378,186,192
050,29,107,"Missouri","Lafayette County",1,44,365,182,183
050,29,107,"Missouri","Lafayette County",1,45,373,180,193
050,29,107,"Missouri","Lafayette County",1,46,362,180,182
050,29,107,"Missouri","Lafayette County",1,47,406,203,203
050,29,107,"Missouri","Lafayette County",1,48,444,220,224
050,29,107,"Missouri","Lafayette County",1,49,459,225,234
050,29,107,"Missouri","Lafayette County",1,50,457,228,229
050,29,107,"Missouri","Lafayette County",1,51,413,207,206
050,29,107,"Missouri","Lafayette County",1,52,401,209,192
050,29,107,"Missouri","Lafayette County",1,53,472,236,236
050,29,107,"Missouri","Lafayette County",1,54,457,245,212
050,29,107,"Missouri","Lafayette County",1,55,460,235,225
050,29,107,"Missouri","Lafayette County",1,56,502,263,239
050,29,107,"Missouri","Lafayette County",1,57,491,242,249
050,29,107,"Missouri","Lafayette County",1,58,527,267,260
050,29,107,"Missouri","Lafayette County",1,59,492,238,254
050,29,107,"Missouri","Lafayette County",1,60,448,211,237
050,29,107,"Missouri","Lafayette County",1,61,475,245,230
050,29,107,"Missouri","Lafayette County",1,62,502,261,241
050,29,107,"Missouri","Lafayette County",1,63,451,225,226
050,29,107,"Missouri","Lafayette County",1,64,448,222,226
050,29,107,"Missouri","Lafayette County",1,65,444,217,227
050,29,107,"Missouri","Lafayette County",1,66,389,194,195
050,29,107,"Missouri","Lafayette County",1,67,342,177,165
050,29,107,"Missouri","Lafayette County",1,68,351,179,172
050,29,107,"Missouri","Lafayette County",1,69,339,145,194
050,29,107,"Missouri","Lafayette County",1,70,334,156,178
050,29,107,"Missouri","Lafayette County",1,71,326,159,167
050,29,107,"Missouri","Lafayette County",1,72,313,156,157
050,29,107,"Missouri","Lafayette County",1,73,313,152,161
050,29,107,"Missouri","Lafayette County",1,74,226,103,123
050,29,107,"Missouri","Lafayette County",1,75,226,104,122
050,29,107,"Missouri","Lafayette County",1,76,246,122,124
050,29,107,"Missouri","Lafayette County",1,77,260,123,137
050,29,107,"Missouri","Lafayette County",1,78,219,108,111
050,29,107,"Missouri","Lafayette County",1,79,204,101,103
050,29,107,"Missouri","Lafayette County",1,80,188,102,86
050,29,107,"Missouri","Lafayette County",1,81,163,83,80
050,29,107,"Missouri","Lafayette County",1,82,150,66,84
050,29,107,"Missouri","Lafayette County",1,83,136,58,78
050,29,107,"Missouri","Lafayette County",1,84,123,46,77
050,29,107,"Missouri","Lafayette County",1,85,796,290,506
050,29,107,"Missouri","Lafayette County",2,0,385,200,185
050,29,107,"Missouri","Lafayette County",2,1,387,206,181
050,29,107,"Missouri","Lafayette County",2,2,415,218,197
050,29,107,"Missouri","Lafayette County",2,3,420,228,192
050,29,107,"Missouri","Lafayette County",2,4,399,216,183
050,29,107,"Missouri","Lafayette County",2,5,402,215,187
050,29,107,"Missouri","Lafayette County",2,6,406,213,193
050,29,107,"Missouri","Lafayette County",2,7,413,208,205
050,29,107,"Missouri","Lafayette County",2,8,402,204,198
050,29,107,"Missouri","Lafayette County",2,9,420,219,201
050,29,107,"Missouri","Lafayette County",2,10,429,228,201
050,29,107,"Missouri","Lafayette County",2,11,444,225,219
050,29,107,"Missouri","Lafayette County",2,12,464,239,225
050,29,107,"Missouri","Lafayette County",2,13,481,236,245
050,29,107,"Missouri","Lafayette County",2,14,487,232,255
050,29,107,"Missouri","Lafayette County",2,15,456,226,230
050,29,107,"Missouri","Lafayette County",2,16,439,234,205
050,29,107,"Missouri","Lafayette County",2,17,446,237,209
050,29,107,"Missouri","Lafayette County",2,18,376,208,168
050,29,107,"Missouri","Lafayette County",2,19,305,169,136
050,29,107,"Missouri","Lafayette County",2,20,333,172,161
050,29,107,"Missouri","Lafayette County",2,21,333,175,158
050,29,107,"Missouri","Lafayette County",2,22,342,171,171
050,29,107,"Missouri","Lafayette County",2,23,350,180,170
050,29,107,"Missouri","Lafayette County",2,24,363,183,180
050,29,107,"Missouri","Lafayette County",2,25,385,188,197
050,29,107,"Missouri","Lafayette County",2,26,378,197,181
050,29,107,"Missouri","Lafayette County",2,27,400,200,200
050,29,107,"Missouri","Lafayette County",2,28,423,213,210
050,29,107,"Missouri","Lafayette County",2,29,431,228,203
050,29,107,"Missouri","Lafayette County",2,30,406,204,202
050,29,107,"Missouri","Lafayette County",2,31,377,201,176
050,29,107,"Missouri","Lafayette County",2,32,359,172,187
050,29,107,"Missouri","Lafayette County",2,33,370,178,192
050,29,107,"Missouri","Lafayette County",2,34,398,194,204
050,29,107,"Missouri","Lafayette County",2,35,421,209,212
050,29,107,"Missouri","Lafayette County",2,36,424,209,215
050,29,107,"Missouri","Lafayette County",2,37,403,207,196
050,29,107,"Missouri","Lafayette County",2,38,382,194,188
050,29,107,"Missouri","Lafayette County",2,39,393,195,198
050,29,107,"Missouri","Lafayette County",2,40,405,191,214
050,29,107,"Missouri","Lafayette County",2,41,368,187,181
050,29,107,"Missouri","Lafayette County",2,42,351,176,175
050,29,107,"Missouri","Lafayette County",2,43,382,188,194
050,29,107,"Missouri","Lafayette County",2,44,363,179,184
050,29,107,"Missouri","Lafayette County",2,45,373,181,192
050,29,107,"Missouri","Lafayette County",2,46,361,177,184
050,29,107,"Missouri","Lafayette County",2,47,396,198,198
050,29,107,"Missouri","Lafayette County",2,48,435,216,219
050,29,107,"Missouri","Lafayette County",2,49,460,226,234
050,29,107,"Missouri","Lafayette County",2,50,456,225,231
050,29,107,"Missouri","Lafayette County",2,51,428,215,213
050,29,107,"Missouri","Lafayette County",2,52,401,206,195
050,29,107,"Missouri","Lafayette County",2,53,459,235,224
050,29,107,"Missouri","Lafayette County",2,54,455,239,216
050,29,107,"Missouri","Lafayette County",2,55,460,236,224
050,29,107,"Missouri","Lafayette County",2,56,494,261,233
050,29,107,"Missouri","Lafayette County",2,57,492,247,245
050,29,107,"Missouri","Lafayette County",2,58,517,259,258
050,29,107,"Missouri","Lafayette County",2,59,499,247,252
050,29,107,"Missouri","Lafayette County",2,60,455,214,241
050,29,107,"Missouri","Lafayette County",2,61,466,233,233
050,29,107,"Missouri","Lafayette County",2,62,494,255,239
050,29,107,"Missouri","Lafayette County",2,63,467,237,230
050,29,107,"Missouri","Lafayette County",2,64,443,220,223
050,29,107,"Missouri","Lafayette County",2,65,442,216,226
050,29,107,"Missouri","Lafayette County",2,66,403,201,202
050,29,107,"Missouri","Lafayette County",2,67,350,179,171
050,29,107,"Missouri","Lafayette County",2,68,345,177,168
050,29,107,"Missouri","Lafayette County",2,69,345,156,189
050,29,107,"Missouri","Lafayette County",2,70,330,150,180
050,29,107,"Missouri","Lafayette County",2,71,327,158,169
050,29,107,"Missouri","Lafayette County",2,72,310,154,156
050,29,107,"Missouri","Lafayette County",2,73,329,163,166
050,29,107,"Missouri","Lafayette County",2,74,229,106,123
050,29,107,"Missouri","Lafayette County",2,75,229,105,124
050,29,107,"Missouri","Lafayette County",2,76,237,116,121
050,29,107,"Missouri","Lafayette County",2,77,260,123,137
050,29,107,"Missouri","Lafayette County",2,78,222,108,114
050,29,107,"Missouri","Lafayette County",2,79,204,100,104
050,29,107,"Missouri","Lafayette County",2,80,193,102,91
050,29,107,"Missouri","Lafayette County",2,81,165,84,81
050,29,107,"Missouri","Lafayette County",2,82,147,68,79
050,29,107,"Missouri","Lafayette County",2,83,137,59,78
050,29,107,"Missouri","Lafayette County",2,84,124,48,76
050,29,107,"Missouri","Lafayette County",2,85,800,296,504
050,29,107,"Missouri","Lafayette County",3,0,362,194,168
050,29,107,"Missouri","Lafayette County",3,1,407,210,197
050,29,107,"Missouri","Lafayette County",3,2,357,187,170
050,29,107,"Missouri","Lafayette County",3,3,407,211,196
050,29,107,"Missouri","Lafayette County",3,4,413,218,195
050,29,107,"Missouri","Lafayette County",3,5,395,211,184
050,29,107,"Missouri","Lafayette County",3,6,399,211,188
050,29,107,"Missouri","Lafayette County",3,7,395,210,185
050,29,107,"Missouri","Lafayette County",3,8,406,205,201
050,29,107,"Missouri","Lafayette County",3,9,387,193,194
050,29,107,"Missouri","Lafayette County",3,10,444,230,214
050,29,107,"Missouri","Lafayette County",3,11,422,213,209
050,29,107,"Missouri","Lafayette County",3,12,441,222,219
050,29,107,"Missouri","Lafayette County",3,13,470,243,227
050,29,107,"Missouri","Lafayette County",3,14,479,238,241
050,29,107,"Missouri","Lafayette County",3,15,493,241,252
050,29,107,"Missouri","Lafayette County",3,16,447,218,229
050,29,107,"Missouri","Lafayette County",3,17,432,223,209
050,29,107,"Missouri","Lafayette County",3,18,380,203,177
050,29,107,"Missouri","Lafayette County",3,19,296,168,128
050,29,107,"Missouri","Lafayette County",3,20,295,164,131
050,29,107,"Missouri","Lafayette County",3,21,342,175,167
050,29,107,"Missouri","Lafayette County",3,22,356,182,174
050,29,107,"Missouri","Lafayette County",3,23,385,192,193
050,29,107,"Missouri","Lafayette County",3,24,356,176,180
050,29,107,"Missouri","Lafayette County",3,25,348,171,177
050,29,107,"Missouri","Lafayette County",3,26,378,185,193
050,29,107,"Missouri","Lafayette County",3,27,369,200,169
050,29,107,"Missouri","Lafayette County",3,28,403,203,200
050,29,107,"Missouri","Lafayette County",3,29,414,219,195
050,29,107,"Missouri","Lafayette County",3,30,419,201,218
050,29,107,"Missouri","Lafayette County",3,31,402,213,189
050,29,107,"Missouri","Lafayette County",3,32,370,188,182
050,29,107,"Missouri","Lafayette County",3,33,374,179,195
050,29,107,"Missouri","Lafayette County",3,34,372,175,197
050,29,107,"Missouri","Lafayette County",3,35,401,196,205
050,29,107,"Missouri","Lafayette County",3,36,412,208,204
050,29,107,"Missouri","Lafayette County",3,37,421,214,207
050,29,107,"Missouri","Lafayette County",3,38,394,200,194
050,29,107,"Missouri","Lafayette County",3,39,386,200,186
050,29,107,"Missouri","Lafayette County",3,40,387,186,201
050,29,107,"Missouri","Lafayette County",3,41,390,188,202
050,29,107,"Missouri","Lafayette County",3,42,370,191,179
050,29,107,"Missouri","Lafayette County",3,43,370,187,183
050,29,107,"Missouri","Lafayette County",3,44,368,179,189
050,29,107,"Missouri","Lafayette County",3,45,363,174,189
050,29,107,"Missouri","Lafayette County",3,46,363,179,184
050,29,107,"Missouri","Lafayette County",3,47,369,187,182
050,29,107,"Missouri","Lafayette County",3,48,396,203,193
050,29,107,"Missouri","Lafayette County",3,49,411,207,204
050,29,107,"Missouri","Lafayette County",3,50,463,226,237
050,29,107,"Missouri","Lafayette County",3,51,477,236,241
050,29,107,"Missouri","Lafayette County",3,52,414,207,207
050,29,107,"Missouri","Lafayette County",3,53,406,226,180
050,29,107,"Missouri","Lafayette County",3,54,457,223,234
050,29,107,"Missouri","Lafayette County",3,55,446,228,218
050,29,107,"Missouri","Lafayette County",3,56,470,250,220
050,29,107,"Missouri","Lafayette County",3,57,483,259,224
050,29,107,"Missouri","Lafayette County",3,58,487,237,250
050,29,107,"Missouri","Lafayette County",3,59,507,254,253
050,29,107,"Missouri","Lafayette County",3,60,489,238,251
050,29,107,"Missouri","Lafayette County",3,61,471,222,249
050,29,107,"Missouri","Lafayette County",3,62,468,236,232
050,29,107,"Missouri","Lafayette County",3,63,486,251,235
050,29,107,"Missouri","Lafayette County",3,64,456,232,224
050,29,107,"Missouri","Lafayette County",3,65,430,214,216
050,29,107,"Missouri","Lafayette County",3,66,439,216,223
050,29,107,"Missouri","Lafayette County",3,67,398,195,203
050,29,107,"Missouri","Lafayette County",3,68,346,173,173
050,29,107,"Missouri","Lafayette County",3,69,345,174,171
050,29,107,"Missouri","Lafayette County",3,70,334,151,183
050,29,107,"Missouri","Lafayette County",3,71,326,147,179
050,29,107,"Missouri","Lafayette County",3,72,314,147,167
050,29,107,"Missouri","Lafayette County",3,73,309,151,158
050,29,107,"Missouri","Lafayette County",3,74,323,157,166
050,29,107,"Missouri","Lafayette County",3,75,226,97,129
050,29,107,"Missouri","Lafayette County",3,76,221,101,120
050,29,107,"Missouri","Lafayette County",3,77,224,112,112
050,29,107,"Missouri","Lafayette County",3,78,232,107,125
050,29,107,"Missouri","Lafayette County",3,79,206,101,105
050,29,107,"Missouri","Lafayette County",3,80,197,98,99
050,29,107,"Missouri","Lafayette County",3,81,180,90,90
050,29,107,"Missouri","Lafayette County",3,82,143,75,68
050,29,107,"Missouri","Lafayette County",3,83,146,70,76
050,29,107,"Missouri","Lafayette County",3,84,118,49,69
050,29,107,"Missouri","Lafayette County",3,85,781,284,497
050,29,107,"Missouri","Lafayette County",4,0,358,177,181
050,29,107,"Missouri","Lafayette County",4,1,378,190,188
050,29,107,"Missouri","Lafayette County",4,2,421,221,200
050,29,107,"Missouri","Lafayette County",4,3,384,209,175
050,29,107,"Missouri","Lafayette County",4,4,428,217,211
050,29,107,"Missouri","Lafayette County",4,5,409,214,195
050,29,107,"Missouri","Lafayette County",4,6,416,216,200
050,29,107,"Missouri","Lafayette County",4,7,400,212,188
050,29,107,"Missouri","Lafayette County",4,8,407,215,192
050,29,107,"Missouri","Lafayette County",4,9,402,204,198
050,29,107,"Missouri","Lafayette County",4,10,403,198,205
050,29,107,"Missouri","Lafayette County",4,11,434,218,216
050,29,107,"Missouri","Lafayette County",4,12,414,209,205
050,29,107,"Missouri","Lafayette County",4,13,449,225,224
050,29,107,"Missouri","Lafayette County",4,14,470,243,227
050,29,107,"Missouri","Lafayette County",4,15,484,247,237
050,29,107,"Missouri","Lafayette County",4,16,496,254,242
050,29,107,"Missouri","Lafayette County",4,17,453,222,231
050,29,107,"Missouri","Lafayette County",4,18,357,198,159
050,29,107,"Missouri","Lafayette County",4,19,290,163,127
050,29,107,"Missouri","Lafayette County",4,20,297,155,142
050,29,107,"Missouri","Lafayette County",4,21,304,162,142
050,29,107,"Missouri","Lafayette County",4,22,349,179,170
050,29,107,"Missouri","Lafayette County",4,23,357,186,171
050,29,107,"Missouri","Lafayette County",4,24,367,183,184
050,29,107,"Missouri","Lafayette County",4,25,374,182,192
050,29,107,"Missouri","Lafayette County",4,26,344,178,166
050,29,107,"Missouri","Lafayette County",4,27,379,186,193
050,29,107,"Missouri","Lafayette County",4,28,392,207,185
050,29,107,"Missouri","Lafayette County",4,29,424,213,211
050,29,107,"Missouri","Lafayette County",4,30,408,216,192
050,29,107,"Missouri","Lafayette County",4,31,426,212,214
050,29,107,"Missouri","Lafayette County",4,32,418,219,199
050,29,107,"Missouri","Lafayette County",4,33,402,197,205
050,29,107,"Missouri","Lafayette County",4,34,366,176,190
050,29,107,"Missouri","Lafayette County",4,35,373,183,190
050,29,107,"Missouri","Lafayette County",4,36,411,200,211
050,29,107,"Missouri","Lafayette County",4,37,425,216,209
050,29,107,"Missouri","Lafayette County",4,38,440,222,218
050,29,107,"Missouri","Lafayette County",4,39,404,205,199
050,29,107,"Missouri","Lafayette County",4,40,408,205,203
050,29,107,"Missouri","Lafayette County",4,41,390,190,200
050,29,107,"Missouri","Lafayette County",4,42,379,178,201
050,29,107,"Missouri","Lafayette County",4,43,384,196,188
050,29,107,"Missouri","Lafayette County",4,44,346,178,168
050,29,107,"Missouri","Lafayette County",4,45,366,184,182
050,29,107,"Missouri","Lafayette County",4,46,364,173,191
050,29,107,"Missouri","Lafayette County",4,47,387,205,182
050,29,107,"Missouri","Lafayette County",4,48,361,181,180
050,29,107,"Missouri","Lafayette County",4,49,402,202,200
050,29,107,"Missouri","Lafayette County",4,50,421,210,211
050,29,107,"Missouri","Lafayette County",4,51,474,234,240
050,29,107,"Missouri","Lafayette County",4,52,446,225,221
050,29,107,"Missouri","Lafayette County",4,53,435,225,210
050,29,107,"Missouri","Lafayette County",4,54,404,212,192
050,29,107,"Missouri","Lafayette County",4,55,454,212,242
050,29,107,"Missouri","Lafayette County",4,56,459,251,208
050,29,107,"Missouri","Lafayette County",4,57,463,247,216
050,29,107,"Missouri","Lafayette County",4,58,486,254,232
050,29,107,"Missouri","Lafayette County",4,59,485,228,257
050,29,107,"Missouri","Lafayette County",4,60,496,260,236
050,29,107,"Missouri","Lafayette County",4,61,490,238,252
050,29,107,"Missouri","Lafayette County",4,62,473,221,252
050,29,107,"Missouri","Lafayette County",4,63,456,232,224
050,29,107,"Missouri","Lafayette County",4,64,471,246,225
050,29,107,"Missouri","Lafayette County",4,65,452,227,225
050,29,107,"Missouri","Lafayette County",4,66,425,217,208
050,29,107,"Missouri","Lafayette County",4,67,431,216,215
050,29,107,"Missouri","Lafayette County",4,68,382,183,199
050,29,107,"Missouri","Lafayette County",4,69,340,168,172
050,29,107,"Missouri","Lafayette County",4,70,335,166,169
050,29,107,"Missouri","Lafayette County",4,71,328,152,176
050,29,107,"Missouri","Lafayette County",4,72,309,136,173
050,29,107,"Missouri","Lafayette County",4,73,309,142,167
050,29,107,"Missouri","Lafayette County",4,74,307,150,157
050,29,107,"Missouri","Lafayette County",4,75,310,146,164
050,29,107,"Missouri","Lafayette County",4,76,210,88,122
050,29,107,"Missouri","Lafayette County",4,77,211,95,116
050,29,107,"Missouri","Lafayette County",4,78,209,103,106
050,29,107,"Missouri","Lafayette County",4,79,217,104,113
050,29,107,"Missouri","Lafayette County",4,80,203,98,105
050,29,107,"Missouri","Lafayette County",4,81,175,84,91
050,29,107,"Missouri","Lafayette County",4,82,163,79,84
050,29,107,"Missouri","Lafayette County",4,83,138,74,64
050,29,107,"Missouri","Lafayette County",4,84,129,60,69
050,29,107,"Missouri","Lafayette County",4,85,771,290,481
050,29,107,"Missouri","Lafayette County",5,0,355,176,179
050,29,107,"Missouri","Lafayette County",5,1,348,168,180
050,29,107,"Missouri","Lafayette County",5,2,361,185,176
050,29,107,"Missouri","Lafayette County",5,3,416,221,195
050,29,107,"Missouri","Lafayette County",5,4,393,205,188
050,29,107,"Missouri","Lafayette County",5,5,436,213,223
050,29,107,"Missouri","Lafayette County",5,6,410,209,201
050,29,107,"Missouri","Lafayette County",5,7,413,215,198
050,29,107,"Missouri","Lafayette County",5,8,428,233,195
050,29,107,"Missouri","Lafayette County",5,9,398,211,187
050,29,107,"Missouri","Lafayette County",5,10,422,215,207
050,29,107,"Missouri","Lafayette County",5,11,416,209,207
050,29,107,"Missouri","Lafayette County",5,12,429,220,209
050,29,107,"Missouri","Lafayette County",5,13,423,208,215
050,29,107,"Missouri","Lafayette County",5,14,456,218,238
050,29,107,"Missouri","Lafayette County",5,15,485,251,234
050,29,107,"Missouri","Lafayette County",5,16,497,248,249
050,29,107,"Missouri","Lafayette County",5,17,503,253,250
050,29,107,"Missouri","Lafayette County",5,18,383,198,185
050,29,107,"Missouri","Lafayette County",5,19,281,162,119
050,29,107,"Missouri","Lafayette County",5,20,305,161,144
050,29,107,"Missouri","Lafayette County",5,21,331,175,156
050,29,107,"Missouri","Lafayette County",5,22,341,179,162
050,29,107,"Missouri","Lafayette County",5,23,369,198,171
050,29,107,"Missouri","Lafayette County",5,24,347,180,167
050,29,107,"Missouri","Lafayette County",5,25,378,191,187
050,29,107,"Missouri","Lafayette County",5,26,375,179,196
050,29,107,"Missouri","Lafayette County",5,27,342,167,175
050,29,107,"Missouri","Lafayette County",5,28,379,192,187
050,29,107,"Missouri","Lafayette County",5,29,413,216,197
050,29,107,"Missouri","Lafayette County",5,30,419,200,219
050,29,107,"Missouri","Lafayette County",5,31,409,226,183
050,29,107,"Missouri","Lafayette County",5,32,419,202,217
050,29,107,"Missouri","Lafayette County",5,33,436,228,208
050,29,107,"Missouri","Lafayette County",5,34,425,205,220
050,29,107,"Missouri","Lafayette County",5,35,383,190,193
050,29,107,"Missouri","Lafayette County",5,36,383,180,203
050,29,107,"Missouri","Lafayette County",5,37,402,199,203
050,29,107,"Missouri","Lafayette County",5,38,427,218,209
050,29,107,"Missouri","Lafayette County",5,39,440,221,219
050,29,107,"Missouri","Lafayette County",5,40,408,202,206
050,29,107,"Missouri","Lafayette County",5,41,412,209,203
050,29,107,"Missouri","Lafayette County",5,42,403,195,208
050,29,107,"Missouri","Lafayette County",5,43,401,188,213
050,29,107,"Missouri","Lafayette County",5,44,377,188,189
050,29,107,"Missouri","Lafayette County",5,45,358,181,177
050,29,107,"Missouri","Lafayette County",5,46,364,185,179
050,29,107,"Missouri","Lafayette County",5,47,384,188,196
050,29,107,"Missouri","Lafayette County",5,48,384,202,182
050,29,107,"Missouri","Lafayette County",5,49,376,186,190
050,29,107,"Missouri","Lafayette County",5,50,403,200,203
050,29,107,"Missouri","Lafayette County",5,51,440,219,221
050,29,107,"Missouri","Lafayette County",5,52,469,231,238
050,29,107,"Missouri","Lafayette County",5,53,470,246,224
050,29,107,"Missouri","Lafayette County",5,54,446,222,224
050,29,107,"Missouri","Lafayette County",5,55,392,205,187
050,29,107,"Missouri","Lafayette County",5,56,465,233,232
050,29,107,"Missouri","Lafayette County",5,57,438,240,198
050,29,107,"Missouri","Lafayette County",5,58,471,239,232
050,29,107,"Missouri","Lafayette County",5,59,472,249,223
050,29,107,"Missouri","Lafayette County",5,60,481,223,258
050,29,107,"Missouri","Lafayette County",5,61,503,261,242
050,29,107,"Missouri","Lafayette County",5,62,496,242,254
050,29,107,"Missouri","Lafayette County",5,63,454,207,247
050,29,107,"Missouri","Lafayette County",5,64,452,236,216
050,29,107,"Missouri","Lafayette County",5,65,452,235,217
050,29,107,"Missouri","Lafayette County",5,66,438,225,213
050,29,107,"Missouri","Lafayette County",5,67,428,214,214
050,29,107,"Missouri","Lafayette County",5,68,428,215,213
050,29,107,"Missouri","Lafayette County",5,69,377,179,198
050,29,107,"Missouri","Lafayette County",5,70,337,166,171
050,29,107,"Missouri","Lafayette County",5,71,327,163,164
050,29,107,"Missouri","Lafayette County",5,72,316,144,172
050,29,107,"Missouri","Lafayette County",5,73,309,134,175
050,29,107,"Missouri","Lafayette County",5,74,293,133,160
050,29,107,"Missouri","Lafayette County",5,75,298,139,159
050,29,107,"Missouri","Lafayette County",5,76,293,136,157
050,29,107,"Missouri","Lafayette County",5,77,201,81,120
050,29,107,"Missouri","Lafayette County",5,78,196,89,107
050,29,107,"Missouri","Lafayette County",5,79,197,99,98
050,29,107,"Missouri","Lafayette County",5,80,210,100,110
050,29,107,"Missouri","Lafayette County",5,81,186,85,101
050,29,107,"Missouri","Lafayette County",5,82,158,75,83
050,29,107,"Missouri","Lafayette County",5,83,154,75,79
050,29,107,"Missouri","Lafayette County",5,84,119,63,56
050,29,107,"Missouri","Lafayette County",5,85,784,306,478
050,29,109,"Missouri","Lawrence County",1,0,493,253,240
050,29,109,"Missouri","Lawrence County",1,1,508,270,238
050,29,109,"Missouri","Lawrence County",1,2,541,292,249
050,29,109,"Missouri","Lawrence County",1,3,528,289,239
050,29,109,"Missouri","Lawrence County",1,4,515,263,252
050,29,109,"Missouri","Lawrence County",1,5,510,264,246
050,29,109,"Missouri","Lawrence County",1,6,500,248,252
050,29,109,"Missouri","Lawrence County",1,7,523,278,245
050,29,109,"Missouri","Lawrence County",1,8,498,259,239
050,29,109,"Missouri","Lawrence County",1,9,536,287,249
050,29,109,"Missouri","Lawrence County",1,10,547,266,281
050,29,109,"Missouri","Lawrence County",1,11,557,284,273
050,29,109,"Missouri","Lawrence County",1,12,617,326,291
050,29,109,"Missouri","Lawrence County",1,13,574,291,283
050,29,109,"Missouri","Lawrence County",1,14,522,270,252
050,29,109,"Missouri","Lawrence County",1,15,588,310,278
050,29,109,"Missouri","Lawrence County",1,16,600,324,276
050,29,109,"Missouri","Lawrence County",1,17,580,312,268
050,29,109,"Missouri","Lawrence County",1,18,498,262,236
050,29,109,"Missouri","Lawrence County",1,19,400,217,183
050,29,109,"Missouri","Lawrence County",1,20,407,215,192
050,29,109,"Missouri","Lawrence County",1,21,368,204,164
050,29,109,"Missouri","Lawrence County",1,22,415,204,211
050,29,109,"Missouri","Lawrence County",1,23,425,202,223
050,29,109,"Missouri","Lawrence County",1,24,417,215,202
050,29,109,"Missouri","Lawrence County",1,25,444,223,221
050,29,109,"Missouri","Lawrence County",1,26,438,223,215
050,29,109,"Missouri","Lawrence County",1,27,444,226,218
050,29,109,"Missouri","Lawrence County",1,28,439,223,216
050,29,109,"Missouri","Lawrence County",1,29,422,214,208
050,29,109,"Missouri","Lawrence County",1,30,453,224,229
050,29,109,"Missouri","Lawrence County",1,31,406,204,202
050,29,109,"Missouri","Lawrence County",1,32,391,198,193
050,29,109,"Missouri","Lawrence County",1,33,430,211,219
050,29,109,"Missouri","Lawrence County",1,34,429,220,209
050,29,109,"Missouri","Lawrence County",1,35,423,211,212
050,29,109,"Missouri","Lawrence County",1,36,452,214,238
050,29,109,"Missouri","Lawrence County",1,37,441,201,240
050,29,109,"Missouri","Lawrence County",1,38,462,230,232
050,29,109,"Missouri","Lawrence County",1,39,513,267,246
050,29,109,"Missouri","Lawrence County",1,40,471,252,219
050,29,109,"Missouri","Lawrence County",1,41,469,233,236
050,29,109,"Missouri","Lawrence County",1,42,431,215,216
050,29,109,"Missouri","Lawrence County",1,43,422,207,215
050,29,109,"Missouri","Lawrence County",1,44,410,201,209
050,29,109,"Missouri","Lawrence County",1,45,433,226,207
050,29,109,"Missouri","Lawrence County",1,46,417,222,195
050,29,109,"Missouri","Lawrence County",1,47,438,225,213
050,29,109,"Missouri","Lawrence County",1,48,484,255,229
050,29,109,"Missouri","Lawrence County",1,49,513,275,238
050,29,109,"Missouri","Lawrence County",1,50,484,254,230
050,29,109,"Missouri","Lawrence County",1,51,489,251,238
050,29,109,"Missouri","Lawrence County",1,52,446,217,229
050,29,109,"Missouri","Lawrence County",1,53,444,212,232
050,29,109,"Missouri","Lawrence County",1,54,456,237,219
050,29,109,"Missouri","Lawrence County",1,55,522,275,247
050,29,109,"Missouri","Lawrence County",1,56,543,273,270
050,29,109,"Missouri","Lawrence County",1,57,544,269,275
050,29,109,"Missouri","Lawrence County",1,58,565,276,289
050,29,109,"Missouri","Lawrence County",1,59,561,270,291
050,29,109,"Missouri","Lawrence County",1,60,505,252,253
050,29,109,"Missouri","Lawrence County",1,61,482,232,250
050,29,109,"Missouri","Lawrence County",1,62,482,229,253
050,29,109,"Missouri","Lawrence County",1,63,473,231,242
050,29,109,"Missouri","Lawrence County",1,64,462,235,227
050,29,109,"Missouri","Lawrence County",1,65,465,231,234
050,29,109,"Missouri","Lawrence County",1,66,439,214,225
050,29,109,"Missouri","Lawrence County",1,67,425,209,216
050,29,109,"Missouri","Lawrence County",1,68,394,192,202
050,29,109,"Missouri","Lawrence County",1,69,348,173,175
050,29,109,"Missouri","Lawrence County",1,70,358,184,174
050,29,109,"Missouri","Lawrence County",1,71,360,169,191
050,29,109,"Missouri","Lawrence County",1,72,378,182,196
050,29,109,"Missouri","Lawrence County",1,73,363,173,190
050,29,109,"Missouri","Lawrence County",1,74,260,119,141
050,29,109,"Missouri","Lawrence County",1,75,294,132,162
050,29,109,"Missouri","Lawrence County",1,76,280,117,163
050,29,109,"Missouri","Lawrence County",1,77,259,119,140
050,29,109,"Missouri","Lawrence County",1,78,227,110,117
050,29,109,"Missouri","Lawrence County",1,79,191,91,100
050,29,109,"Missouri","Lawrence County",1,80,200,88,112
050,29,109,"Missouri","Lawrence County",1,81,206,100,106
050,29,109,"Missouri","Lawrence County",1,82,183,86,97
050,29,109,"Missouri","Lawrence County",1,83,163,69,94
050,29,109,"Missouri","Lawrence County",1,84,153,75,78
050,29,109,"Missouri","Lawrence County",1,85,865,370,495
050,29,109,"Missouri","Lawrence County",2,0,501,258,243
050,29,109,"Missouri","Lawrence County",2,1,503,267,236
050,29,109,"Missouri","Lawrence County",2,2,533,287,246
050,29,109,"Missouri","Lawrence County",2,3,528,289,239
050,29,109,"Missouri","Lawrence County",2,4,518,269,249
050,29,109,"Missouri","Lawrence County",2,5,513,263,250
050,29,109,"Missouri","Lawrence County",2,6,506,254,252
050,29,109,"Missouri","Lawrence County",2,7,516,271,245
050,29,109,"Missouri","Lawrence County",2,8,504,265,239
050,29,109,"Missouri","Lawrence County",2,9,526,280,246
050,29,109,"Missouri","Lawrence County",2,10,545,273,272
050,29,109,"Missouri","Lawrence County",2,11,555,282,273
050,29,109,"Missouri","Lawrence County",2,12,607,317,290
050,29,109,"Missouri","Lawrence County",2,13,583,299,284
050,29,109,"Missouri","Lawrence County",2,14,538,275,263
050,29,109,"Missouri","Lawrence County",2,15,571,300,271
050,29,109,"Missouri","Lawrence County",2,16,600,323,277
050,29,109,"Missouri","Lawrence County",2,17,582,314,268
050,29,109,"Missouri","Lawrence County",2,18,492,266,226
050,29,109,"Missouri","Lawrence County",2,19,398,214,184
050,29,109,"Missouri","Lawrence County",2,20,411,218,193
050,29,109,"Missouri","Lawrence County",2,21,383,208,175
050,29,109,"Missouri","Lawrence County",2,22,408,204,204
050,29,109,"Missouri","Lawrence County",2,23,424,203,221
050,29,109,"Missouri","Lawrence County",2,24,425,213,212
050,29,109,"Missouri","Lawrence County",2,25,438,223,215
050,29,109,"Missouri","Lawrence County",2,26,443,224,219
050,29,109,"Missouri","Lawrence County",2,27,444,226,218
050,29,109,"Missouri","Lawrence County",2,28,444,227,217
050,29,109,"Missouri","Lawrence County",2,29,433,218,215
050,29,109,"Missouri","Lawrence County",2,30,450,223,227
050,29,109,"Missouri","Lawrence County",2,31,416,210,206
050,29,109,"Missouri","Lawrence County",2,32,389,194,195
050,29,109,"Missouri","Lawrence County",2,33,425,209,216
050,29,109,"Missouri","Lawrence County",2,34,432,220,212
050,29,109,"Missouri","Lawrence County",2,35,425,214,211
050,29,109,"Missouri","Lawrence County",2,36,439,211,228
050,29,109,"Missouri","Lawrence County",2,37,442,203,239
050,29,109,"Missouri","Lawrence County",2,38,461,225,236
050,29,109,"Missouri","Lawrence County",2,39,499,260,239
050,29,109,"Missouri","Lawrence County",2,40,485,257,228
050,29,109,"Missouri","Lawrence County",2,41,466,235,231
050,29,109,"Missouri","Lawrence County",2,42,435,217,218
050,29,109,"Missouri","Lawrence County",2,43,424,208,216
050,29,109,"Missouri","Lawrence County",2,44,408,201,207
050,29,109,"Missouri","Lawrence County",2,45,430,222,208
050,29,109,"Missouri","Lawrence County",2,46,416,221,195
050,29,109,"Missouri","Lawrence County",2,47,427,222,205
050,29,109,"Missouri","Lawrence County",2,48,471,248,223
050,29,109,"Missouri","Lawrence County",2,49,507,272,235
050,29,109,"Missouri","Lawrence County",2,50,496,261,235
050,29,109,"Missouri","Lawrence County",2,51,488,251,237
050,29,109,"Missouri","Lawrence County",2,52,451,221,230
050,29,109,"Missouri","Lawrence County",2,53,443,212,231
050,29,109,"Missouri","Lawrence County",2,54,453,233,220
050,29,109,"Missouri","Lawrence County",2,55,506,265,241
050,29,109,"Missouri","Lawrence County",2,56,537,274,263
050,29,109,"Missouri","Lawrence County",2,57,541,268,273
050,29,109,"Missouri","Lawrence County",2,58,555,273,282
050,29,109,"Missouri","Lawrence County",2,59,561,271,290
050,29,109,"Missouri","Lawrence County",2,60,519,256,263
050,29,109,"Missouri","Lawrence County",2,61,486,236,250
050,29,109,"Missouri","Lawrence County",2,62,480,230,250
050,29,109,"Missouri","Lawrence County",2,63,477,232,245
050,29,109,"Missouri","Lawrence County",2,64,463,231,232
050,29,109,"Missouri","Lawrence County",2,65,461,231,230
050,29,109,"Missouri","Lawrence County",2,66,442,215,227
050,29,109,"Missouri","Lawrence County",2,67,429,211,218
050,29,109,"Missouri","Lawrence County",2,68,397,194,203
050,29,109,"Missouri","Lawrence County",2,69,361,177,184
050,29,109,"Missouri","Lawrence County",2,70,352,179,173
050,29,109,"Missouri","Lawrence County",2,71,363,174,189
050,29,109,"Missouri","Lawrence County",2,72,366,176,190
050,29,109,"Missouri","Lawrence County",2,73,385,185,200
050,29,109,"Missouri","Lawrence County",2,74,264,122,142
050,29,109,"Missouri","Lawrence County",2,75,285,129,156
050,29,109,"Missouri","Lawrence County",2,76,277,117,160
050,29,109,"Missouri","Lawrence County",2,77,269,121,148
050,29,109,"Missouri","Lawrence County",2,78,225,108,117
050,29,109,"Missouri","Lawrence County",2,79,193,93,100
050,29,109,"Missouri","Lawrence County",2,80,198,90,108
050,29,109,"Missouri","Lawrence County",2,81,196,93,103
050,29,109,"Missouri","Lawrence County",2,82,189,90,99
050,29,109,"Missouri","Lawrence County",2,83,164,72,92
050,29,109,"Missouri","Lawrence County",2,84,152,72,80
050,29,109,"Missouri","Lawrence County",2,85,857,367,490
050,29,109,"Missouri","Lawrence County",3,0,484,260,224
050,29,109,"Missouri","Lawrence County",3,1,494,240,254
050,29,109,"Missouri","Lawrence County",3,2,531,277,254
050,29,109,"Missouri","Lawrence County",3,3,544,307,237
050,29,109,"Missouri","Lawrence County",3,4,530,287,243
050,29,109,"Missouri","Lawrence County",3,5,521,268,253
050,29,109,"Missouri","Lawrence County",3,6,528,269,259
050,29,109,"Missouri","Lawrence County",3,7,501,251,250
050,29,109,"Missouri","Lawrence County",3,8,536,287,249
050,29,109,"Missouri","Lawrence County",3,9,525,272,253
050,29,109,"Missouri","Lawrence County",3,10,529,277,252
050,29,109,"Missouri","Lawrence County",3,11,544,274,270
050,29,109,"Missouri","Lawrence County",3,12,575,283,292
050,29,109,"Missouri","Lawrence County",3,13,602,319,283
050,29,109,"Missouri","Lawrence County",3,14,622,321,301
050,29,109,"Missouri","Lawrence County",3,15,548,283,265
050,29,109,"Missouri","Lawrence County",3,16,587,315,272
050,29,109,"Missouri","Lawrence County",3,17,601,319,282
050,29,109,"Missouri","Lawrence County",3,18,493,278,215
050,29,109,"Missouri","Lawrence County",3,19,402,216,186
050,29,109,"Missouri","Lawrence County",3,20,434,231,203
050,29,109,"Missouri","Lawrence County",3,21,424,229,195
050,29,109,"Missouri","Lawrence County",3,22,405,214,191
050,29,109,"Missouri","Lawrence County",3,23,423,200,223
050,29,109,"Missouri","Lawrence County",3,24,436,220,216
050,29,109,"Missouri","Lawrence County",3,25,429,213,216
050,29,109,"Missouri","Lawrence County",3,26,463,239,224
050,29,109,"Missouri","Lawrence County",3,27,454,223,231
050,29,109,"Missouri","Lawrence County",3,28,468,233,235
050,29,109,"Missouri","Lawrence County",3,29,451,233,218
050,29,109,"Missouri","Lawrence County",3,30,443,219,224
050,29,109,"Missouri","Lawrence County",3,31,450,226,224
050,29,109,"Missouri","Lawrence County",3,32,430,205,225
050,29,109,"Missouri","Lawrence County",3,33,432,223,209
050,29,109,"Missouri","Lawrence County",3,34,430,210,220
050,29,109,"Missouri","Lawrence County",3,35,440,224,216
050,29,109,"Missouri","Lawrence County",3,36,445,227,218
050,29,109,"Missouri","Lawrence County",3,37,448,220,228
050,29,109,"Missouri","Lawrence County",3,38,451,210,241
050,29,109,"Missouri","Lawrence County",3,39,460,225,235
050,29,109,"Missouri","Lawrence County",3,40,491,252,239
050,29,109,"Missouri","Lawrence County",3,41,474,249,225
050,29,109,"Missouri","Lawrence County",3,42,478,247,231
050,29,109,"Missouri","Lawrence County",3,43,447,223,224
050,29,109,"Missouri","Lawrence County",3,44,430,214,216
050,29,109,"Missouri","Lawrence County",3,45,402,195,207
050,29,109,"Missouri","Lawrence County",3,46,429,227,202
050,29,109,"Missouri","Lawrence County",3,47,429,235,194
050,29,109,"Missouri","Lawrence County",3,48,440,225,215
050,29,109,"Missouri","Lawrence County",3,49,481,255,226
050,29,109,"Missouri","Lawrence County",3,50,499,273,226
050,29,109,"Missouri","Lawrence County",3,51,487,255,232
050,29,109,"Missouri","Lawrence County",3,52,474,240,234
050,29,109,"Missouri","Lawrence County",3,53,436,217,219
050,29,109,"Missouri","Lawrence County",3,54,445,209,236
050,29,109,"Missouri","Lawrence County",3,55,465,239,226
050,29,109,"Missouri","Lawrence County",3,56,502,267,235
050,29,109,"Missouri","Lawrence County",3,57,514,269,245
050,29,109,"Missouri","Lawrence County",3,58,555,278,277
050,29,109,"Missouri","Lawrence County",3,59,551,266,285
050,29,109,"Missouri","Lawrence County",3,60,560,274,286
050,29,109,"Missouri","Lawrence County",3,61,508,252,256
050,29,109,"Missouri","Lawrence County",3,62,482,237,245
050,29,109,"Missouri","Lawrence County",3,63,481,230,251
050,29,109,"Missouri","Lawrence County",3,64,469,227,242
050,29,109,"Missouri","Lawrence County",3,65,467,237,230
050,29,109,"Missouri","Lawrence County",3,66,447,216,231
050,29,109,"Missouri","Lawrence County",3,67,430,211,219
050,29,109,"Missouri","Lawrence County",3,68,419,205,214
050,29,109,"Missouri","Lawrence County",3,69,391,186,205
050,29,109,"Missouri","Lawrence County",3,70,342,163,179
050,29,109,"Missouri","Lawrence County",3,71,342,172,170
050,29,109,"Missouri","Lawrence County",3,72,355,172,183
050,29,109,"Missouri","Lawrence County",3,73,353,174,179
050,29,109,"Missouri","Lawrence County",3,74,367,181,186
050,29,109,"Missouri","Lawrence County",3,75,251,116,135
050,29,109,"Missouri","Lawrence County",3,76,262,111,151
050,29,109,"Missouri","Lawrence County",3,77,257,105,152
050,29,109,"Missouri","Lawrence County",3,78,258,114,144
050,29,109,"Missouri","Lawrence County",3,79,206,96,110
050,29,109,"Missouri","Lawrence County",3,80,165,74,91
050,29,109,"Missouri","Lawrence County",3,81,177,77,100
050,29,109,"Missouri","Lawrence County",3,82,179,90,89
050,29,109,"Missouri","Lawrence County",3,83,185,87,98
050,29,109,"Missouri","Lawrence County",3,84,150,68,82
050,29,109,"Missouri","Lawrence County",3,85,823,349,474
050,29,109,"Missouri","Lawrence County",4,0,493,258,235
050,29,109,"Missouri","Lawrence County",4,1,504,274,230
050,29,109,"Missouri","Lawrence County",4,2,523,256,267
050,29,109,"Missouri","Lawrence County",4,3,541,288,253
050,29,109,"Missouri","Lawrence County",4,4,571,312,259
050,29,109,"Missouri","Lawrence County",4,5,527,277,250
050,29,109,"Missouri","Lawrence County",4,6,558,283,275
050,29,109,"Missouri","Lawrence County",4,7,541,285,256
050,29,109,"Missouri","Lawrence County",4,8,519,263,256
050,29,109,"Missouri","Lawrence County",4,9,541,300,241
050,29,109,"Missouri","Lawrence County",4,10,544,271,273
050,29,109,"Missouri","Lawrence County",4,11,545,288,257
050,29,109,"Missouri","Lawrence County",4,12,537,266,271
050,29,109,"Missouri","Lawrence County",4,13,580,291,289
050,29,109,"Missouri","Lawrence County",4,14,619,330,289
050,29,109,"Missouri","Lawrence County",4,15,632,332,300
050,29,109,"Missouri","Lawrence County",4,16,553,283,270
050,29,109,"Missouri","Lawrence County",4,17,610,331,279
050,29,109,"Missouri","Lawrence County",4,18,506,272,234
050,29,109,"Missouri","Lawrence County",4,19,383,219,164
050,29,109,"Missouri","Lawrence County",4,20,414,215,199
050,29,109,"Missouri","Lawrence County",4,21,443,238,205
050,29,109,"Missouri","Lawrence County",4,22,443,220,223
050,29,109,"Missouri","Lawrence County",4,23,429,225,204
050,29,109,"Missouri","Lawrence County",4,24,434,206,228
050,29,109,"Missouri","Lawrence County",4,25,445,222,223
050,29,109,"Missouri","Lawrence County",4,26,447,218,229
050,29,109,"Missouri","Lawrence County",4,27,467,250,217
050,29,109,"Missouri","Lawrence County",4,28,494,242,252
050,29,109,"Missouri","Lawrence County",4,29,455,229,226
050,29,109,"Missouri","Lawrence County",4,30,443,227,216
050,29,109,"Missouri","Lawrence County",4,31,478,251,227
050,29,109,"Missouri","Lawrence County",4,32,475,236,239
050,29,109,"Missouri","Lawrence County",4,33,429,205,224
050,29,109,"Missouri","Lawrence County",4,34,437,225,212
050,29,109,"Missouri","Lawrence County",4,35,433,218,215
050,29,109,"Missouri","Lawrence County",4,36,450,230,220
050,29,109,"Missouri","Lawrence County",4,37,464,237,227
050,29,109,"Missouri","Lawrence County",4,38,451,223,228
050,29,109,"Missouri","Lawrence County",4,39,453,215,238
050,29,109,"Missouri","Lawrence County",4,40,477,234,243
050,29,109,"Missouri","Lawrence County",4,41,502,256,246
050,29,109,"Missouri","Lawrence County",4,42,476,255,221
050,29,109,"Missouri","Lawrence County",4,43,475,251,224
050,29,109,"Missouri","Lawrence County",4,44,449,217,232
050,29,109,"Missouri","Lawrence County",4,45,427,214,213
050,29,109,"Missouri","Lawrence County",4,46,410,201,209
050,29,109,"Missouri","Lawrence County",4,47,428,220,208
050,29,109,"Missouri","Lawrence County",4,48,438,240,198
050,29,109,"Missouri","Lawrence County",4,49,451,229,222
050,29,109,"Missouri","Lawrence County",4,50,479,258,221
050,29,109,"Missouri","Lawrence County",4,51,518,286,232
050,29,109,"Missouri","Lawrence County",4,52,465,238,227
050,29,109,"Missouri","Lawrence County",4,53,471,236,235
050,29,109,"Missouri","Lawrence County",4,54,431,212,219
050,29,109,"Missouri","Lawrence County",4,55,455,210,245
050,29,109,"Missouri","Lawrence County",4,56,483,247,236
050,29,109,"Missouri","Lawrence County",4,57,492,257,235
050,29,109,"Missouri","Lawrence County",4,58,530,279,251
050,29,109,"Missouri","Lawrence County",4,59,552,274,278
050,29,109,"Missouri","Lawrence County",4,60,550,267,283
050,29,109,"Missouri","Lawrence County",4,61,553,272,281
050,29,109,"Missouri","Lawrence County",4,62,509,254,255
050,29,109,"Missouri","Lawrence County",4,63,482,233,249
050,29,109,"Missouri","Lawrence County",4,64,473,225,248
050,29,109,"Missouri","Lawrence County",4,65,459,220,239
050,29,109,"Missouri","Lawrence County",4,66,461,228,233
050,29,109,"Missouri","Lawrence County",4,67,447,219,228
050,29,109,"Missouri","Lawrence County",4,68,436,210,226
050,29,109,"Missouri","Lawrence County",4,69,420,199,221
050,29,109,"Missouri","Lawrence County",4,70,378,179,199
050,29,109,"Missouri","Lawrence County",4,71,335,158,177
050,29,109,"Missouri","Lawrence County",4,72,335,164,171
050,29,109,"Missouri","Lawrence County",4,73,341,169,172
050,29,109,"Missouri","Lawrence County",4,74,333,160,173
050,29,109,"Missouri","Lawrence County",4,75,353,176,177
050,29,109,"Missouri","Lawrence County",4,76,240,108,132
050,29,109,"Missouri","Lawrence County",4,77,242,104,138
050,29,109,"Missouri","Lawrence County",4,78,237,98,139
050,29,109,"Missouri","Lawrence County",4,79,242,104,138
050,29,109,"Missouri","Lawrence County",4,80,198,88,110
050,29,109,"Missouri","Lawrence County",4,81,144,66,78
050,29,109,"Missouri","Lawrence County",4,82,154,71,83
050,29,109,"Missouri","Lawrence County",4,83,170,82,88
050,29,109,"Missouri","Lawrence County",4,84,178,86,92
050,29,109,"Missouri","Lawrence County",4,85,799,344,455
050,29,109,"Missouri","Lawrence County",5,0,493,255,238
050,29,109,"Missouri","Lawrence County",5,1,475,240,235
050,29,109,"Missouri","Lawrence County",5,2,502,271,231
050,29,109,"Missouri","Lawrence County",5,3,526,259,267
050,29,109,"Missouri","Lawrence County",5,4,542,278,264
050,29,109,"Missouri","Lawrence County",5,5,586,332,254
050,29,109,"Missouri","Lawrence County",5,6,530,284,246
050,29,109,"Missouri","Lawrence County",5,7,576,302,274
050,29,109,"Missouri","Lawrence County",5,8,571,293,278
050,29,109,"Missouri","Lawrence County",5,9,520,254,266
050,29,109,"Missouri","Lawrence County",5,10,550,305,245
050,29,109,"Missouri","Lawrence County",5,11,552,269,283
050,29,109,"Missouri","Lawrence County",5,12,564,308,256
050,29,109,"Missouri","Lawrence County",5,13,555,278,277
050,29,109,"Missouri","Lawrence County",5,14,583,289,294
050,29,109,"Missouri","Lawrence County",5,15,617,320,297
050,29,109,"Missouri","Lawrence County",5,16,634,331,303
050,29,109,"Missouri","Lawrence County",5,17,576,300,276
050,29,109,"Missouri","Lawrence County",5,18,514,287,227
050,29,109,"Missouri","Lawrence County",5,19,400,213,187
050,29,109,"Missouri","Lawrence County",5,20,396,221,175
050,29,109,"Missouri","Lawrence County",5,21,422,218,204
050,29,109,"Missouri","Lawrence County",5,22,469,235,234
050,29,109,"Missouri","Lawrence County",5,23,446,212,234
050,29,109,"Missouri","Lawrence County",5,24,444,230,214
050,29,109,"Missouri","Lawrence County",5,25,437,208,229
050,29,109,"Missouri","Lawrence County",5,26,432,217,215
050,29,109,"Missouri","Lawrence County",5,27,463,230,233
050,29,109,"Missouri","Lawrence County",5,28,472,256,216
050,29,109,"Missouri","Lawrence County",5,29,492,240,252
050,29,109,"Missouri","Lawrence County",5,30,469,240,229
050,29,109,"Missouri","Lawrence County",5,31,465,241,224
050,29,109,"Missouri","Lawrence County",5,32,475,240,235
050,29,109,"Missouri","Lawrence County",5,33,487,242,245
050,29,109,"Missouri","Lawrence County",5,34,429,207,222
050,29,109,"Missouri","Lawrence County",5,35,448,225,223
050,29,109,"Missouri","Lawrence County",5,36,438,207,231
050,29,109,"Missouri","Lawrence County",5,37,458,236,222
050,29,109,"Missouri","Lawrence County",5,38,465,237,228
050,29,109,"Missouri","Lawrence County",5,39,473,239,234
050,29,109,"Missouri","Lawrence County",5,40,456,217,239
050,29,109,"Missouri","Lawrence County",5,41,488,237,251
050,29,109,"Missouri","Lawrence County",5,42,493,248,245
050,29,109,"Missouri","Lawrence County",5,43,477,259,218
050,29,109,"Missouri","Lawrence County",5,44,477,249,228
050,29,109,"Missouri","Lawrence County",5,45,437,208,229
050,29,109,"Missouri","Lawrence County",5,46,431,214,217
050,29,109,"Missouri","Lawrence County",5,47,414,207,207
050,29,109,"Missouri","Lawrence County",5,48,433,216,217
050,29,109,"Missouri","Lawrence County",5,49,448,236,212
050,29,109,"Missouri","Lawrence County",5,50,442,224,218
050,29,109,"Missouri","Lawrence County",5,51,484,263,221
050,29,109,"Missouri","Lawrence County",5,52,506,273,233
050,29,109,"Missouri","Lawrence County",5,53,479,244,235
050,29,109,"Missouri","Lawrence County",5,54,467,234,233
050,29,109,"Missouri","Lawrence County",5,55,439,218,221
050,29,109,"Missouri","Lawrence County",5,56,453,215,238
050,29,109,"Missouri","Lawrence County",5,57,467,240,227
050,29,109,"Missouri","Lawrence County",5,58,502,263,239
050,29,109,"Missouri","Lawrence County",5,59,525,270,255
050,29,109,"Missouri","Lawrence County",5,60,547,276,271
050,29,109,"Missouri","Lawrence County",5,61,548,265,283
050,29,109,"Missouri","Lawrence County",5,62,547,267,280
050,29,109,"Missouri","Lawrence County",5,63,513,252,261
050,29,109,"Missouri","Lawrence County",5,64,474,223,251
050,29,109,"Missouri","Lawrence County",5,65,471,225,246
050,29,109,"Missouri","Lawrence County",5,66,448,211,237
050,29,109,"Missouri","Lawrence County",5,67,450,223,227
050,29,109,"Missouri","Lawrence County",5,68,437,208,229
050,29,109,"Missouri","Lawrence County",5,69,426,204,222
050,29,109,"Missouri","Lawrence County",5,70,396,185,211
050,29,109,"Missouri","Lawrence County",5,71,362,174,188
050,29,109,"Missouri","Lawrence County",5,72,335,160,175
050,29,109,"Missouri","Lawrence County",5,73,325,161,164
050,29,109,"Missouri","Lawrence County",5,74,321,160,161
050,29,109,"Missouri","Lawrence County",5,75,323,153,170
050,29,109,"Missouri","Lawrence County",5,76,339,166,173
050,29,109,"Missouri","Lawrence County",5,77,225,102,123
050,29,109,"Missouri","Lawrence County",5,78,226,98,128
050,29,109,"Missouri","Lawrence County",5,79,216,89,127
050,29,109,"Missouri","Lawrence County",5,80,229,93,136
050,29,109,"Missouri","Lawrence County",5,81,170,75,95
050,29,109,"Missouri","Lawrence County",5,82,130,62,68
050,29,109,"Missouri","Lawrence County",5,83,154,70,84
050,29,109,"Missouri","Lawrence County",5,84,164,82,82
050,29,109,"Missouri","Lawrence County",5,85,832,361,471
050,29,111,"Missouri","Lewis County",1,0,114,57,57
050,29,111,"Missouri","Lewis County",1,1,122,57,65
050,29,111,"Missouri","Lewis County",1,2,115,61,54
050,29,111,"Missouri","Lewis County",1,3,113,57,56
050,29,111,"Missouri","Lewis County",1,4,124,64,60
050,29,111,"Missouri","Lewis County",1,5,118,68,50
050,29,111,"Missouri","Lewis County",1,6,121,62,59
050,29,111,"Missouri","Lewis County",1,7,113,52,61
050,29,111,"Missouri","Lewis County",1,8,111,58,53
050,29,111,"Missouri","Lewis County",1,9,113,66,47
050,29,111,"Missouri","Lewis County",1,10,121,65,56
050,29,111,"Missouri","Lewis County",1,11,136,71,65
050,29,111,"Missouri","Lewis County",1,12,133,76,57
050,29,111,"Missouri","Lewis County",1,13,139,79,60
050,29,111,"Missouri","Lewis County",1,14,128,68,60
050,29,111,"Missouri","Lewis County",1,15,120,58,62
050,29,111,"Missouri","Lewis County",1,16,130,59,71
050,29,111,"Missouri","Lewis County",1,17,134,68,66
050,29,111,"Missouri","Lewis County",1,18,163,82,81
050,29,111,"Missouri","Lewis County",1,19,284,141,143
050,29,111,"Missouri","Lewis County",1,20,262,126,136
050,29,111,"Missouri","Lewis County",1,21,299,155,144
050,29,111,"Missouri","Lewis County",1,22,236,129,107
050,29,111,"Missouri","Lewis County",1,23,123,65,58
050,29,111,"Missouri","Lewis County",1,24,118,74,44
050,29,111,"Missouri","Lewis County",1,25,104,59,45
050,29,111,"Missouri","Lewis County",1,26,96,49,47
050,29,111,"Missouri","Lewis County",1,27,112,58,54
050,29,111,"Missouri","Lewis County",1,28,101,55,46
050,29,111,"Missouri","Lewis County",1,29,101,51,50
050,29,111,"Missouri","Lewis County",1,30,105,51,54
050,29,111,"Missouri","Lewis County",1,31,89,41,48
050,29,111,"Missouri","Lewis County",1,32,104,45,59
050,29,111,"Missouri","Lewis County",1,33,108,52,56
050,29,111,"Missouri","Lewis County",1,34,87,44,43
050,29,111,"Missouri","Lewis County",1,35,93,46,47
050,29,111,"Missouri","Lewis County",1,36,104,56,48
050,29,111,"Missouri","Lewis County",1,37,114,53,61
050,29,111,"Missouri","Lewis County",1,38,121,59,62
050,29,111,"Missouri","Lewis County",1,39,111,53,58
050,29,111,"Missouri","Lewis County",1,40,110,52,58
050,29,111,"Missouri","Lewis County",1,41,103,50,53
050,29,111,"Missouri","Lewis County",1,42,91,50,41
050,29,111,"Missouri","Lewis County",1,43,110,45,65
050,29,111,"Missouri","Lewis County",1,44,96,47,49
050,29,111,"Missouri","Lewis County",1,45,91,51,40
050,29,111,"Missouri","Lewis County",1,46,96,53,43
050,29,111,"Missouri","Lewis County",1,47,91,42,49
050,29,111,"Missouri","Lewis County",1,48,102,49,53
050,29,111,"Missouri","Lewis County",1,49,112,57,55
050,29,111,"Missouri","Lewis County",1,50,124,57,67
050,29,111,"Missouri","Lewis County",1,51,113,52,61
050,29,111,"Missouri","Lewis County",1,52,113,59,54
050,29,111,"Missouri","Lewis County",1,53,116,61,55
050,29,111,"Missouri","Lewis County",1,54,121,60,61
050,29,111,"Missouri","Lewis County",1,55,122,58,64
050,29,111,"Missouri","Lewis County",1,56,132,70,62
050,29,111,"Missouri","Lewis County",1,57,136,67,69
050,29,111,"Missouri","Lewis County",1,58,149,74,75
050,29,111,"Missouri","Lewis County",1,59,153,76,77
050,29,111,"Missouri","Lewis County",1,60,139,72,67
050,29,111,"Missouri","Lewis County",1,61,133,60,73
050,29,111,"Missouri","Lewis County",1,62,143,68,75
050,29,111,"Missouri","Lewis County",1,63,130,67,63
050,29,111,"Missouri","Lewis County",1,64,137,75,62
050,29,111,"Missouri","Lewis County",1,65,133,63,70
050,29,111,"Missouri","Lewis County",1,66,117,53,64
050,29,111,"Missouri","Lewis County",1,67,95,44,51
050,29,111,"Missouri","Lewis County",1,68,94,47,47
050,29,111,"Missouri","Lewis County",1,69,98,50,48
050,29,111,"Missouri","Lewis County",1,70,98,42,56
050,29,111,"Missouri","Lewis County",1,71,99,49,50
050,29,111,"Missouri","Lewis County",1,72,101,55,46
050,29,111,"Missouri","Lewis County",1,73,95,48,47
050,29,111,"Missouri","Lewis County",1,74,71,37,34
050,29,111,"Missouri","Lewis County",1,75,81,41,40
050,29,111,"Missouri","Lewis County",1,76,89,42,47
050,29,111,"Missouri","Lewis County",1,77,75,37,38
050,29,111,"Missouri","Lewis County",1,78,58,33,25
050,29,111,"Missouri","Lewis County",1,79,56,29,27
050,29,111,"Missouri","Lewis County",1,80,60,23,37
050,29,111,"Missouri","Lewis County",1,81,50,19,31
050,29,111,"Missouri","Lewis County",1,82,51,15,36
050,29,111,"Missouri","Lewis County",1,83,38,15,23
050,29,111,"Missouri","Lewis County",1,84,33,13,20
050,29,111,"Missouri","Lewis County",1,85,237,88,149
050,29,111,"Missouri","Lewis County",2,0,110,60,50
050,29,111,"Missouri","Lewis County",2,1,119,56,63
050,29,111,"Missouri","Lewis County",2,2,116,59,57
050,29,111,"Missouri","Lewis County",2,3,114,58,56
050,29,111,"Missouri","Lewis County",2,4,121,63,58
050,29,111,"Missouri","Lewis County",2,5,119,66,53
050,29,111,"Missouri","Lewis County",2,6,120,63,57
050,29,111,"Missouri","Lewis County",2,7,116,57,59
050,29,111,"Missouri","Lewis County",2,8,114,58,56
050,29,111,"Missouri","Lewis County",2,9,113,63,50
050,29,111,"Missouri","Lewis County",2,10,122,66,56
050,29,111,"Missouri","Lewis County",2,11,132,69,63
050,29,111,"Missouri","Lewis County",2,12,132,73,59
050,29,111,"Missouri","Lewis County",2,13,137,78,59
050,29,111,"Missouri","Lewis County",2,14,130,71,59
050,29,111,"Missouri","Lewis County",2,15,121,60,61
050,29,111,"Missouri","Lewis County",2,16,129,59,70
050,29,111,"Missouri","Lewis County",2,17,132,65,67
050,29,111,"Missouri","Lewis County",2,18,164,83,81
050,29,111,"Missouri","Lewis County",2,19,287,141,146
050,29,111,"Missouri","Lewis County",2,20,260,125,135
050,29,111,"Missouri","Lewis County",2,21,301,155,146
050,29,111,"Missouri","Lewis County",2,22,232,130,102
050,29,111,"Missouri","Lewis County",2,23,124,67,57
050,29,111,"Missouri","Lewis County",2,24,117,71,46
050,29,111,"Missouri","Lewis County",2,25,105,60,45
050,29,111,"Missouri","Lewis County",2,26,99,52,47
050,29,111,"Missouri","Lewis County",2,27,108,56,52
050,29,111,"Missouri","Lewis County",2,28,105,57,48
050,29,111,"Missouri","Lewis County",2,29,102,52,50
050,29,111,"Missouri","Lewis County",2,30,104,50,54
050,29,111,"Missouri","Lewis County",2,31,92,42,50
050,29,111,"Missouri","Lewis County",2,32,102,45,57
050,29,111,"Missouri","Lewis County",2,33,104,48,56
050,29,111,"Missouri","Lewis County",2,34,93,47,46
050,29,111,"Missouri","Lewis County",2,35,94,47,47
050,29,111,"Missouri","Lewis County",2,36,100,52,48
050,29,111,"Missouri","Lewis County",2,37,111,54,57
050,29,111,"Missouri","Lewis County",2,38,120,58,62
050,29,111,"Missouri","Lewis County",2,39,114,54,60
050,29,111,"Missouri","Lewis County",2,40,113,54,59
050,29,111,"Missouri","Lewis County",2,41,104,51,53
050,29,111,"Missouri","Lewis County",2,42,94,50,44
050,29,111,"Missouri","Lewis County",2,43,108,48,60
050,29,111,"Missouri","Lewis County",2,44,98,46,52
050,29,111,"Missouri","Lewis County",2,45,94,51,43
050,29,111,"Missouri","Lewis County",2,46,96,53,43
050,29,111,"Missouri","Lewis County",2,47,92,44,48
050,29,111,"Missouri","Lewis County",2,48,101,48,53
050,29,111,"Missouri","Lewis County",2,49,110,55,55
050,29,111,"Missouri","Lewis County",2,50,121,57,64
050,29,111,"Missouri","Lewis County",2,51,114,53,61
050,29,111,"Missouri","Lewis County",2,52,112,57,55
050,29,111,"Missouri","Lewis County",2,53,115,60,55
050,29,111,"Missouri","Lewis County",2,54,120,60,60
050,29,111,"Missouri","Lewis County",2,55,121,58,63
050,29,111,"Missouri","Lewis County",2,56,129,68,61
050,29,111,"Missouri","Lewis County",2,57,136,68,68
050,29,111,"Missouri","Lewis County",2,58,146,73,73
050,29,111,"Missouri","Lewis County",2,59,153,76,77
050,29,111,"Missouri","Lewis County",2,60,141,73,68
050,29,111,"Missouri","Lewis County",2,61,135,63,72
050,29,111,"Missouri","Lewis County",2,62,139,66,73
050,29,111,"Missouri","Lewis County",2,63,136,68,68
050,29,111,"Missouri","Lewis County",2,64,135,72,63
050,29,111,"Missouri","Lewis County",2,65,135,66,69
050,29,111,"Missouri","Lewis County",2,66,121,56,65
050,29,111,"Missouri","Lewis County",2,67,100,46,54
050,29,111,"Missouri","Lewis County",2,68,95,47,48
050,29,111,"Missouri","Lewis County",2,69,98,49,49
050,29,111,"Missouri","Lewis County",2,70,98,45,53
050,29,111,"Missouri","Lewis County",2,71,98,47,51
050,29,111,"Missouri","Lewis County",2,72,99,53,46
050,29,111,"Missouri","Lewis County",2,73,100,52,48
050,29,111,"Missouri","Lewis County",2,74,72,38,34
050,29,111,"Missouri","Lewis County",2,75,78,40,38
050,29,111,"Missouri","Lewis County",2,76,84,40,44
050,29,111,"Missouri","Lewis County",2,77,80,40,40
050,29,111,"Missouri","Lewis County",2,78,59,32,27
050,29,111,"Missouri","Lewis County",2,79,57,30,27
050,29,111,"Missouri","Lewis County",2,80,58,23,35
050,29,111,"Missouri","Lewis County",2,81,49,18,31
050,29,111,"Missouri","Lewis County",2,82,51,15,36
050,29,111,"Missouri","Lewis County",2,83,37,14,23
050,29,111,"Missouri","Lewis County",2,84,33,13,20
050,29,111,"Missouri","Lewis County",2,85,237,89,148
050,29,111,"Missouri","Lewis County",3,0,94,47,47
050,29,111,"Missouri","Lewis County",3,1,121,70,51
050,29,111,"Missouri","Lewis County",3,2,118,56,62
050,29,111,"Missouri","Lewis County",3,3,123,62,61
050,29,111,"Missouri","Lewis County",3,4,121,64,57
050,29,111,"Missouri","Lewis County",3,5,120,66,54
050,29,111,"Missouri","Lewis County",3,6,119,63,56
050,29,111,"Missouri","Lewis County",3,7,117,67,50
050,29,111,"Missouri","Lewis County",3,8,111,55,56
050,29,111,"Missouri","Lewis County",3,9,120,57,63
050,29,111,"Missouri","Lewis County",3,10,110,63,47
050,29,111,"Missouri","Lewis County",3,11,135,73,62
050,29,111,"Missouri","Lewis County",3,12,130,69,61
050,29,111,"Missouri","Lewis County",3,13,131,73,58
050,29,111,"Missouri","Lewis County",3,14,142,81,61
050,29,111,"Missouri","Lewis County",3,15,129,72,57
050,29,111,"Missouri","Lewis County",3,16,121,59,62
050,29,111,"Missouri","Lewis County",3,17,130,57,73
050,29,111,"Missouri","Lewis County",3,18,174,87,87
050,29,111,"Missouri","Lewis County",3,19,285,140,145
050,29,111,"Missouri","Lewis County",3,20,247,116,131
050,29,111,"Missouri","Lewis County",3,21,289,150,139
050,29,111,"Missouri","Lewis County",3,22,220,128,92
050,29,111,"Missouri","Lewis County",3,23,138,72,66
050,29,111,"Missouri","Lewis County",3,24,117,64,53
050,29,111,"Missouri","Lewis County",3,25,98,57,41
050,29,111,"Missouri","Lewis County",3,26,100,55,45
050,29,111,"Missouri","Lewis County",3,27,103,56,47
050,29,111,"Missouri","Lewis County",3,28,108,57,51
050,29,111,"Missouri","Lewis County",3,29,105,54,51
050,29,111,"Missouri","Lewis County",3,30,98,47,51
050,29,111,"Missouri","Lewis County",3,31,103,50,53
050,29,111,"Missouri","Lewis County",3,32,91,44,47
050,29,111,"Missouri","Lewis County",3,33,104,50,54
050,29,111,"Missouri","Lewis County",3,34,104,47,57
050,29,111,"Missouri","Lewis County",3,35,92,43,49
050,29,111,"Missouri","Lewis County",3,36,96,45,51
050,29,111,"Missouri","Lewis County",3,37,95,50,45
050,29,111,"Missouri","Lewis County",3,38,108,55,53
050,29,111,"Missouri","Lewis County",3,39,119,58,61
050,29,111,"Missouri","Lewis County",3,40,117,56,61
050,29,111,"Missouri","Lewis County",3,41,115,55,60
050,29,111,"Missouri","Lewis County",3,42,96,43,53
050,29,111,"Missouri","Lewis County",3,43,98,53,45
050,29,111,"Missouri","Lewis County",3,44,107,48,59
050,29,111,"Missouri","Lewis County",3,45,97,47,50
050,29,111,"Missouri","Lewis County",3,46,91,48,43
050,29,111,"Missouri","Lewis County",3,47,95,50,45
050,29,111,"Missouri","Lewis County",3,48,94,46,48
050,29,111,"Missouri","Lewis County",3,49,102,48,54
050,29,111,"Missouri","Lewis County",3,50,113,57,56
050,29,111,"Missouri","Lewis County",3,51,119,55,64
050,29,111,"Missouri","Lewis County",3,52,115,54,61
050,29,111,"Missouri","Lewis County",3,53,109,55,54
050,29,111,"Missouri","Lewis County",3,54,119,63,56
050,29,111,"Missouri","Lewis County",3,55,117,59,58
050,29,111,"Missouri","Lewis County",3,56,120,60,60
050,29,111,"Missouri","Lewis County",3,57,131,65,66
050,29,111,"Missouri","Lewis County",3,58,133,67,66
050,29,111,"Missouri","Lewis County",3,59,143,71,72
050,29,111,"Missouri","Lewis County",3,60,150,76,74
050,29,111,"Missouri","Lewis County",3,61,142,72,70
050,29,111,"Missouri","Lewis County",3,62,131,62,69
050,29,111,"Missouri","Lewis County",3,63,138,66,72
050,29,111,"Missouri","Lewis County",3,64,142,72,70
050,29,111,"Missouri","Lewis County",3,65,131,70,61
050,29,111,"Missouri","Lewis County",3,66,134,66,68
050,29,111,"Missouri","Lewis County",3,67,122,57,65
050,29,111,"Missouri","Lewis County",3,68,98,47,51
050,29,111,"Missouri","Lewis County",3,69,88,43,45
050,29,111,"Missouri","Lewis County",3,70,92,48,44
050,29,111,"Missouri","Lewis County",3,71,95,42,53
050,29,111,"Missouri","Lewis County",3,72,95,45,50
050,29,111,"Missouri","Lewis County",3,73,97,53,44
050,29,111,"Missouri","Lewis County",3,74,100,53,47
050,29,111,"Missouri","Lewis County",3,75,72,36,36
050,29,111,"Missouri","Lewis County",3,76,73,36,37
050,29,111,"Missouri","Lewis County",3,77,74,33,41
050,29,111,"Missouri","Lewis County",3,78,75,35,40
050,29,111,"Missouri","Lewis County",3,79,57,29,28
050,29,111,"Missouri","Lewis County",3,80,57,29,28
050,29,111,"Missouri","Lewis County",3,81,50,20,30
050,29,111,"Missouri","Lewis County",3,82,52,17,35
050,29,111,"Missouri","Lewis County",3,83,41,13,28
050,29,111,"Missouri","Lewis County",3,84,36,13,23
050,29,111,"Missouri","Lewis County",3,85,235,90,145
050,29,111,"Missouri","Lewis County",4,0,85,36,49
050,29,111,"Missouri","Lewis County",4,1,94,51,43
050,29,111,"Missouri","Lewis County",4,2,117,66,51
050,29,111,"Missouri","Lewis County",4,3,118,58,60
050,29,111,"Missouri","Lewis County",4,4,114,56,58
050,29,111,"Missouri","Lewis County",4,5,114,59,55
050,29,111,"Missouri","Lewis County",4,6,116,62,54
050,29,111,"Missouri","Lewis County",4,7,119,65,54
050,29,111,"Missouri","Lewis County",4,8,123,66,57
050,29,111,"Missouri","Lewis County",4,9,111,55,56
050,29,111,"Missouri","Lewis County",4,10,121,58,63
050,29,111,"Missouri","Lewis County",4,11,107,58,49
050,29,111,"Missouri","Lewis County",4,12,127,70,57
050,29,111,"Missouri","Lewis County",4,13,130,69,61
050,29,111,"Missouri","Lewis County",4,14,131,75,56
050,29,111,"Missouri","Lewis County",4,15,145,84,61
050,29,111,"Missouri","Lewis County",4,16,128,68,60
050,29,111,"Missouri","Lewis County",4,17,122,60,62
050,29,111,"Missouri","Lewis County",4,18,163,76,87
050,29,111,"Missouri","Lewis County",4,19,290,143,147
050,29,111,"Missouri","Lewis County",4,20,248,115,133
050,29,111,"Missouri","Lewis County",4,21,289,143,146
050,29,111,"Missouri","Lewis County",4,22,218,130,88
050,29,111,"Missouri","Lewis County",4,23,110,62,48
050,29,111,"Missouri","Lewis County",4,24,129,72,57
050,29,111,"Missouri","Lewis County",4,25,106,53,53
050,29,111,"Missouri","Lewis County",4,26,92,53,39
050,29,111,"Missouri","Lewis County",4,27,101,59,42
050,29,111,"Missouri","Lewis County",4,28,97,51,46
050,29,111,"Missouri","Lewis County",4,29,112,60,52
050,29,111,"Missouri","Lewis County",4,30,109,58,51
050,29,111,"Missouri","Lewis County",4,31,95,45,50
050,29,111,"Missouri","Lewis County",4,32,102,49,53
050,29,111,"Missouri","Lewis County",4,33,95,47,48
050,29,111,"Missouri","Lewis County",4,34,95,43,52
050,29,111,"Missouri","Lewis County",4,35,105,47,58
050,29,111,"Missouri","Lewis County",4,36,90,41,49
050,29,111,"Missouri","Lewis County",4,37,100,49,51
050,29,111,"Missouri","Lewis County",4,38,98,49,49
050,29,111,"Missouri","Lewis County",4,39,108,52,56
050,29,111,"Missouri","Lewis County",4,40,125,60,65
050,29,111,"Missouri","Lewis County",4,41,112,57,55
050,29,111,"Missouri","Lewis County",4,42,108,52,56
050,29,111,"Missouri","Lewis County",4,43,97,43,54
050,29,111,"Missouri","Lewis County",4,44,93,50,43
050,29,111,"Missouri","Lewis County",4,45,99,46,53
050,29,111,"Missouri","Lewis County",4,46,103,48,55
050,29,111,"Missouri","Lewis County",4,47,93,49,44
050,29,111,"Missouri","Lewis County",4,48,95,49,46
050,29,111,"Missouri","Lewis County",4,49,96,44,52
050,29,111,"Missouri","Lewis County",4,50,101,50,51
050,29,111,"Missouri","Lewis County",4,51,112,53,59
050,29,111,"Missouri","Lewis County",4,52,120,59,61
050,29,111,"Missouri","Lewis County",4,53,114,53,61
050,29,111,"Missouri","Lewis County",4,54,113,56,57
050,29,111,"Missouri","Lewis County",4,55,112,57,55
050,29,111,"Missouri","Lewis County",4,56,121,62,59
050,29,111,"Missouri","Lewis County",4,57,120,58,62
050,29,111,"Missouri","Lewis County",4,58,134,69,65
050,29,111,"Missouri","Lewis County",4,59,135,66,69
050,29,111,"Missouri","Lewis County",4,60,146,75,71
050,29,111,"Missouri","Lewis County",4,61,151,78,73
050,29,111,"Missouri","Lewis County",4,62,140,71,69
050,29,111,"Missouri","Lewis County",4,63,134,63,71
050,29,111,"Missouri","Lewis County",4,64,136,68,68
050,29,111,"Missouri","Lewis County",4,65,137,70,67
050,29,111,"Missouri","Lewis County",4,66,130,70,60
050,29,111,"Missouri","Lewis County",4,67,134,67,67
050,29,111,"Missouri","Lewis County",4,68,125,57,68
050,29,111,"Missouri","Lewis County",4,69,95,44,51
050,29,111,"Missouri","Lewis County",4,70,84,42,42
050,29,111,"Missouri","Lewis County",4,71,91,46,45
050,29,111,"Missouri","Lewis County",4,72,91,40,51
050,29,111,"Missouri","Lewis County",4,73,92,43,49
050,29,111,"Missouri","Lewis County",4,74,98,52,46
050,29,111,"Missouri","Lewis County",4,75,92,47,45
050,29,111,"Missouri","Lewis County",4,76,65,34,31
050,29,111,"Missouri","Lewis County",4,77,65,32,33
050,29,111,"Missouri","Lewis County",4,78,68,30,38
050,29,111,"Missouri","Lewis County",4,79,67,32,35
050,29,111,"Missouri","Lewis County",4,80,58,30,28
050,29,111,"Missouri","Lewis County",4,81,50,26,24
050,29,111,"Missouri","Lewis County",4,82,53,19,34
050,29,111,"Missouri","Lewis County",4,83,39,13,26
050,29,111,"Missouri","Lewis County",4,84,38,10,28
050,29,111,"Missouri","Lewis County",4,85,230,90,140
050,29,111,"Missouri","Lewis County",5,0,96,41,55
050,29,111,"Missouri","Lewis County",5,1,81,38,43
050,29,111,"Missouri","Lewis County",5,2,90,46,44
050,29,111,"Missouri","Lewis County",5,3,112,66,46
050,29,111,"Missouri","Lewis County",5,4,115,55,60
050,29,111,"Missouri","Lewis County",5,5,119,62,57
050,29,111,"Missouri","Lewis County",5,6,106,54,52
050,29,111,"Missouri","Lewis County",5,7,119,62,57
050,29,111,"Missouri","Lewis County",5,8,126,72,54
050,29,111,"Missouri","Lewis County",5,9,118,65,53
050,29,111,"Missouri","Lewis County",5,10,108,54,54
050,29,111,"Missouri","Lewis County",5,11,123,59,64
050,29,111,"Missouri","Lewis County",5,12,105,57,48
050,29,111,"Missouri","Lewis County",5,13,120,66,54
050,29,111,"Missouri","Lewis County",5,14,124,64,60
050,29,111,"Missouri","Lewis County",5,15,122,70,52
050,29,111,"Missouri","Lewis County",5,16,148,84,64
050,29,111,"Missouri","Lewis County",5,17,131,70,61
050,29,111,"Missouri","Lewis County",5,18,158,77,81
050,29,111,"Missouri","Lewis County",5,19,294,140,154
050,29,111,"Missouri","Lewis County",5,20,263,122,141
050,29,111,"Missouri","Lewis County",5,21,286,140,146
050,29,111,"Missouri","Lewis County",5,22,224,126,98
050,29,111,"Missouri","Lewis County",5,23,120,71,49
050,29,111,"Missouri","Lewis County",5,24,110,58,52
050,29,111,"Missouri","Lewis County",5,25,114,60,54
050,29,111,"Missouri","Lewis County",5,26,98,47,51
050,29,111,"Missouri","Lewis County",5,27,95,58,37
050,29,111,"Missouri","Lewis County",5,28,101,58,43
050,29,111,"Missouri","Lewis County",5,29,90,50,40
050,29,111,"Missouri","Lewis County",5,30,111,58,53
050,29,111,"Missouri","Lewis County",5,31,106,55,51
050,29,111,"Missouri","Lewis County",5,32,96,43,53
050,29,111,"Missouri","Lewis County",5,33,96,48,48
050,29,111,"Missouri","Lewis County",5,34,93,45,48
050,29,111,"Missouri","Lewis County",5,35,96,43,53
050,29,111,"Missouri","Lewis County",5,36,102,44,58
050,29,111,"Missouri","Lewis County",5,37,94,46,48
050,29,111,"Missouri","Lewis County",5,38,98,46,52
050,29,111,"Missouri","Lewis County",5,39,100,52,48
050,29,111,"Missouri","Lewis County",5,40,103,47,56
050,29,111,"Missouri","Lewis County",5,41,124,58,66
050,29,111,"Missouri","Lewis County",5,42,117,61,56
050,29,111,"Missouri","Lewis County",5,43,107,52,55
050,29,111,"Missouri","Lewis County",5,44,93,40,53
050,29,111,"Missouri","Lewis County",5,45,92,49,43
050,29,111,"Missouri","Lewis County",5,46,99,46,53
050,29,111,"Missouri","Lewis County",5,47,100,46,54
050,29,111,"Missouri","Lewis County",5,48,94,49,45
050,29,111,"Missouri","Lewis County",5,49,96,49,47
050,29,111,"Missouri","Lewis County",5,50,93,44,49
050,29,111,"Missouri","Lewis County",5,51,101,50,51
050,29,111,"Missouri","Lewis County",5,52,108,51,57
050,29,111,"Missouri","Lewis County",5,53,119,59,60
050,29,111,"Missouri","Lewis County",5,54,116,50,66
050,29,111,"Missouri","Lewis County",5,55,113,57,56
050,29,111,"Missouri","Lewis County",5,56,116,59,57
050,29,111,"Missouri","Lewis County",5,57,123,61,62
050,29,111,"Missouri","Lewis County",5,58,121,57,64
050,29,111,"Missouri","Lewis County",5,59,135,68,67
050,29,111,"Missouri","Lewis County",5,60,132,65,67
050,29,111,"Missouri","Lewis County",5,61,147,73,74
050,29,111,"Missouri","Lewis County",5,62,152,80,72
050,29,111,"Missouri","Lewis County",5,63,143,73,70
050,29,111,"Missouri","Lewis County",5,64,134,64,70
050,29,111,"Missouri","Lewis County",5,65,132,67,65
050,29,111,"Missouri","Lewis County",5,66,132,68,64
050,29,111,"Missouri","Lewis County",5,67,133,72,61
050,29,111,"Missouri","Lewis County",5,68,135,68,67
050,29,111,"Missouri","Lewis County",5,69,118,54,64
050,29,111,"Missouri","Lewis County",5,70,91,44,47
050,29,111,"Missouri","Lewis County",5,71,81,40,41
050,29,111,"Missouri","Lewis County",5,72,88,44,44
050,29,111,"Missouri","Lewis County",5,73,87,39,48
050,29,111,"Missouri","Lewis County",5,74,93,44,49
050,29,111,"Missouri","Lewis County",5,75,92,49,43
050,29,111,"Missouri","Lewis County",5,76,84,43,41
050,29,111,"Missouri","Lewis County",5,77,61,31,30
050,29,111,"Missouri","Lewis County",5,78,62,29,33
050,29,111,"Missouri","Lewis County",5,79,63,27,36
050,29,111,"Missouri","Lewis County",5,80,64,30,34
050,29,111,"Missouri","Lewis County",5,81,48,26,22
050,29,111,"Missouri","Lewis County",5,82,54,26,28
050,29,111,"Missouri","Lewis County",5,83,40,15,25
050,29,111,"Missouri","Lewis County",5,84,35,10,25
050,29,111,"Missouri","Lewis County",5,85,239,93,146
050,29,113,"Missouri","Lincoln County",1,0,808,410,398
050,29,113,"Missouri","Lincoln County",1,1,850,408,442
050,29,113,"Missouri","Lincoln County",1,2,810,405,405
050,29,113,"Missouri","Lincoln County",1,3,848,428,420
050,29,113,"Missouri","Lincoln County",1,4,852,445,407
050,29,113,"Missouri","Lincoln County",1,5,853,414,439
050,29,113,"Missouri","Lincoln County",1,6,818,389,429
050,29,113,"Missouri","Lincoln County",1,7,829,430,399
050,29,113,"Missouri","Lincoln County",1,8,824,423,401
050,29,113,"Missouri","Lincoln County",1,9,832,423,409
050,29,113,"Missouri","Lincoln County",1,10,841,442,399
050,29,113,"Missouri","Lincoln County",1,11,864,456,408
050,29,113,"Missouri","Lincoln County",1,12,881,465,416
050,29,113,"Missouri","Lincoln County",1,13,864,458,406
050,29,113,"Missouri","Lincoln County",1,14,879,480,399
050,29,113,"Missouri","Lincoln County",1,15,841,446,395
050,29,113,"Missouri","Lincoln County",1,16,869,458,411
050,29,113,"Missouri","Lincoln County",1,17,814,417,397
050,29,113,"Missouri","Lincoln County",1,18,703,368,335
050,29,113,"Missouri","Lincoln County",1,19,564,296,268
050,29,113,"Missouri","Lincoln County",1,20,574,292,282
050,29,113,"Missouri","Lincoln County",1,21,621,318,303
050,29,113,"Missouri","Lincoln County",1,22,648,324,324
050,29,113,"Missouri","Lincoln County",1,23,701,343,358
050,29,113,"Missouri","Lincoln County",1,24,719,343,376
050,29,113,"Missouri","Lincoln County",1,25,714,365,349
050,29,113,"Missouri","Lincoln County",1,26,799,414,385
050,29,113,"Missouri","Lincoln County",1,27,865,422,443
050,29,113,"Missouri","Lincoln County",1,28,911,449,462
050,29,113,"Missouri","Lincoln County",1,29,928,465,463
050,29,113,"Missouri","Lincoln County",1,30,828,431,397
050,29,113,"Missouri","Lincoln County",1,31,824,402,422
050,29,113,"Missouri","Lincoln County",1,32,794,397,397
050,29,113,"Missouri","Lincoln County",1,33,830,416,414
050,29,113,"Missouri","Lincoln County",1,34,849,416,433
050,29,113,"Missouri","Lincoln County",1,35,776,381,395
050,29,113,"Missouri","Lincoln County",1,36,740,354,386
050,29,113,"Missouri","Lincoln County",1,37,805,406,399
050,29,113,"Missouri","Lincoln County",1,38,803,407,396
050,29,113,"Missouri","Lincoln County",1,39,817,424,393
050,29,113,"Missouri","Lincoln County",1,40,822,421,401
050,29,113,"Missouri","Lincoln County",1,41,750,380,370
050,29,113,"Missouri","Lincoln County",1,42,728,362,366
050,29,113,"Missouri","Lincoln County",1,43,710,350,360
050,29,113,"Missouri","Lincoln County",1,44,675,340,335
050,29,113,"Missouri","Lincoln County",1,45,645,325,320
050,29,113,"Missouri","Lincoln County",1,46,646,345,301
050,29,113,"Missouri","Lincoln County",1,47,683,352,331
050,29,113,"Missouri","Lincoln County",1,48,704,360,344
050,29,113,"Missouri","Lincoln County",1,49,814,417,397
050,29,113,"Missouri","Lincoln County",1,50,779,401,378
050,29,113,"Missouri","Lincoln County",1,51,730,386,344
050,29,113,"Missouri","Lincoln County",1,52,735,395,340
050,29,113,"Missouri","Lincoln County",1,53,795,395,400
050,29,113,"Missouri","Lincoln County",1,54,793,412,381
050,29,113,"Missouri","Lincoln County",1,55,867,410,457
050,29,113,"Missouri","Lincoln County",1,56,889,441,448
050,29,113,"Missouri","Lincoln County",1,57,879,443,436
050,29,113,"Missouri","Lincoln County",1,58,888,452,436
050,29,113,"Missouri","Lincoln County",1,59,899,452,447
050,29,113,"Missouri","Lincoln County",1,60,847,440,407
050,29,113,"Missouri","Lincoln County",1,61,795,427,368
050,29,113,"Missouri","Lincoln County",1,62,817,415,402
050,29,113,"Missouri","Lincoln County",1,63,794,393,401
050,29,113,"Missouri","Lincoln County",1,64,716,352,364
050,29,113,"Missouri","Lincoln County",1,65,707,361,346
050,29,113,"Missouri","Lincoln County",1,66,644,332,312
050,29,113,"Missouri","Lincoln County",1,67,588,298,290
050,29,113,"Missouri","Lincoln County",1,68,571,290,281
050,29,113,"Missouri","Lincoln County",1,69,496,226,270
050,29,113,"Missouri","Lincoln County",1,70,461,218,243
050,29,113,"Missouri","Lincoln County",1,71,459,234,225
050,29,113,"Missouri","Lincoln County",1,72,451,236,215
050,29,113,"Missouri","Lincoln County",1,73,444,218,226
050,29,113,"Missouri","Lincoln County",1,74,296,138,158
050,29,113,"Missouri","Lincoln County",1,75,296,144,152
050,29,113,"Missouri","Lincoln County",1,76,316,155,161
050,29,113,"Missouri","Lincoln County",1,77,321,157,164
050,29,113,"Missouri","Lincoln County",1,78,275,139,136
050,29,113,"Missouri","Lincoln County",1,79,239,117,122
050,29,113,"Missouri","Lincoln County",1,80,199,96,103
050,29,113,"Missouri","Lincoln County",1,81,206,88,118
050,29,113,"Missouri","Lincoln County",1,82,185,80,105
050,29,113,"Missouri","Lincoln County",1,83,134,61,73
050,29,113,"Missouri","Lincoln County",1,84,134,59,75
050,29,113,"Missouri","Lincoln County",1,85,766,292,474
050,29,113,"Missouri","Lincoln County",2,0,791,402,389
050,29,113,"Missouri","Lincoln County",2,1,838,408,430
050,29,113,"Missouri","Lincoln County",2,2,821,407,414
050,29,113,"Missouri","Lincoln County",2,3,836,423,413
050,29,113,"Missouri","Lincoln County",2,4,854,443,411
050,29,113,"Missouri","Lincoln County",2,5,854,422,432
050,29,113,"Missouri","Lincoln County",2,6,837,403,434
050,29,113,"Missouri","Lincoln County",2,7,831,423,408
050,29,113,"Missouri","Lincoln County",2,8,826,425,401
050,29,113,"Missouri","Lincoln County",2,9,829,423,406
050,29,113,"Missouri","Lincoln County",2,10,836,436,400
050,29,113,"Missouri","Lincoln County",2,11,858,453,405
050,29,113,"Missouri","Lincoln County",2,12,880,465,415
050,29,113,"Missouri","Lincoln County",2,13,871,462,409
050,29,113,"Missouri","Lincoln County",2,14,876,475,401
050,29,113,"Missouri","Lincoln County",2,15,852,456,396
050,29,113,"Missouri","Lincoln County",2,16,866,455,411
050,29,113,"Missouri","Lincoln County",2,17,830,427,403
050,29,113,"Missouri","Lincoln County",2,18,691,363,328
050,29,113,"Missouri","Lincoln County",2,19,565,297,268
050,29,113,"Missouri","Lincoln County",2,20,588,299,289
050,29,113,"Missouri","Lincoln County",2,21,618,317,301
050,29,113,"Missouri","Lincoln County",2,22,652,327,325
050,29,113,"Missouri","Lincoln County",2,23,704,347,357
050,29,113,"Missouri","Lincoln County",2,24,724,349,375
050,29,113,"Missouri","Lincoln County",2,25,729,367,362
050,29,113,"Missouri","Lincoln County",2,26,791,407,384
050,29,113,"Missouri","Lincoln County",2,27,862,427,435
050,29,113,"Missouri","Lincoln County",2,28,910,452,458
050,29,113,"Missouri","Lincoln County",2,29,928,462,466
050,29,113,"Missouri","Lincoln County",2,30,856,442,414
050,29,113,"Missouri","Lincoln County",2,31,827,410,417
050,29,113,"Missouri","Lincoln County",2,32,807,400,407
050,29,113,"Missouri","Lincoln County",2,33,822,413,409
050,29,113,"Missouri","Lincoln County",2,34,845,415,430
050,29,113,"Missouri","Lincoln County",2,35,800,393,407
050,29,113,"Missouri","Lincoln County",2,36,749,362,387
050,29,113,"Missouri","Lincoln County",2,37,794,399,395
050,29,113,"Missouri","Lincoln County",2,38,814,412,402
050,29,113,"Missouri","Lincoln County",2,39,813,419,394
050,29,113,"Missouri","Lincoln County",2,40,825,425,400
050,29,113,"Missouri","Lincoln County",2,41,768,389,379
050,29,113,"Missouri","Lincoln County",2,42,735,369,366
050,29,113,"Missouri","Lincoln County",2,43,719,357,362
050,29,113,"Missouri","Lincoln County",2,44,680,342,338
050,29,113,"Missouri","Lincoln County",2,45,658,330,328
050,29,113,"Missouri","Lincoln County",2,46,647,341,306
050,29,113,"Missouri","Lincoln County",2,47,672,348,324
050,29,113,"Missouri","Lincoln County",2,48,700,359,341
050,29,113,"Missouri","Lincoln County",2,49,800,410,390
050,29,113,"Missouri","Lincoln County",2,50,794,405,389
050,29,113,"Missouri","Lincoln County",2,51,742,391,351
050,29,113,"Missouri","Lincoln County",2,52,738,395,343
050,29,113,"Missouri","Lincoln County",2,53,783,397,386
050,29,113,"Missouri","Lincoln County",2,54,794,410,384
050,29,113,"Missouri","Lincoln County",2,55,846,409,437
050,29,113,"Missouri","Lincoln County",2,56,890,434,456
050,29,113,"Missouri","Lincoln County",2,57,880,443,437
050,29,113,"Missouri","Lincoln County",2,58,886,448,438
050,29,113,"Missouri","Lincoln County",2,59,900,455,445
050,29,113,"Missouri","Lincoln County",2,60,857,442,415
050,29,113,"Missouri","Lincoln County",2,61,807,430,377
050,29,113,"Missouri","Lincoln County",2,62,803,413,390
050,29,113,"Missouri","Lincoln County",2,63,802,397,405
050,29,113,"Missouri","Lincoln County",2,64,735,362,373
050,29,113,"Missouri","Lincoln County",2,65,714,360,354
050,29,113,"Missouri","Lincoln County",2,66,664,341,323
050,29,113,"Missouri","Lincoln County",2,67,601,306,295
050,29,113,"Missouri","Lincoln County",2,68,570,290,280
050,29,113,"Missouri","Lincoln County",2,69,516,242,274
050,29,113,"Missouri","Lincoln County",2,70,467,219,248
050,29,113,"Missouri","Lincoln County",2,71,457,231,226
050,29,113,"Missouri","Lincoln County",2,72,445,232,213
050,29,113,"Missouri","Lincoln County",2,73,471,235,236
050,29,113,"Missouri","Lincoln County",2,74,311,147,164
050,29,113,"Missouri","Lincoln County",2,75,298,145,153
050,29,113,"Missouri","Lincoln County",2,76,306,147,159
050,29,113,"Missouri","Lincoln County",2,77,324,160,164
050,29,113,"Missouri","Lincoln County",2,78,277,138,139
050,29,113,"Missouri","Lincoln County",2,79,243,120,123
050,29,113,"Missouri","Lincoln County",2,80,206,101,105
050,29,113,"Missouri","Lincoln County",2,81,202,90,112
050,29,113,"Missouri","Lincoln County",2,82,186,81,105
050,29,113,"Missouri","Lincoln County",2,83,144,66,78
050,29,113,"Missouri","Lincoln County",2,84,133,59,74
050,29,113,"Missouri","Lincoln County",2,85,783,304,479
050,29,113,"Missouri","Lincoln County",3,0,753,399,354
050,29,113,"Missouri","Lincoln County",3,1,853,429,424
050,29,113,"Missouri","Lincoln County",3,2,887,438,449
050,29,113,"Missouri","Lincoln County",3,3,855,423,432
050,29,113,"Missouri","Lincoln County",3,4,889,449,440
050,29,113,"Missouri","Lincoln County",3,5,893,454,439
050,29,113,"Missouri","Lincoln County",3,6,864,434,430
050,29,113,"Missouri","Lincoln County",3,7,879,421,458
050,29,113,"Missouri","Lincoln County",3,8,839,425,414
050,29,113,"Missouri","Lincoln County",3,9,864,440,424
050,29,113,"Missouri","Lincoln County",3,10,836,428,408
050,29,113,"Missouri","Lincoln County",3,11,878,458,420
050,29,113,"Missouri","Lincoln County",3,12,890,470,420
050,29,113,"Missouri","Lincoln County",3,13,905,476,429
050,29,113,"Missouri","Lincoln County",3,14,891,466,425
050,29,113,"Missouri","Lincoln County",3,15,871,470,401
050,29,113,"Missouri","Lincoln County",3,16,864,462,402
050,29,113,"Missouri","Lincoln County",3,17,873,455,418
050,29,113,"Missouri","Lincoln County",3,18,704,375,329
050,29,113,"Missouri","Lincoln County",3,19,564,299,265
050,29,113,"Missouri","Lincoln County",3,20,605,313,292
050,29,113,"Missouri","Lincoln County",3,21,635,320,315
050,29,113,"Missouri","Lincoln County",3,22,665,320,345
050,29,113,"Missouri","Lincoln County",3,23,738,373,365
050,29,113,"Missouri","Lincoln County",3,24,726,364,362
050,29,113,"Missouri","Lincoln County",3,25,785,379,406
050,29,113,"Missouri","Lincoln County",3,26,800,410,390
050,29,113,"Missouri","Lincoln County",3,27,827,412,415
050,29,113,"Missouri","Lincoln County",3,28,916,447,469
050,29,113,"Missouri","Lincoln County",3,29,957,458,499
050,29,113,"Missouri","Lincoln County",3,30,976,486,490
050,29,113,"Missouri","Lincoln County",3,31,923,477,446
050,29,113,"Missouri","Lincoln County",3,32,855,426,429
050,29,113,"Missouri","Lincoln County",3,33,836,429,407
050,29,113,"Missouri","Lincoln County",3,34,836,431,405
050,29,113,"Missouri","Lincoln County",3,35,844,409,435
050,29,113,"Missouri","Lincoln County",3,36,829,405,424
050,29,113,"Missouri","Lincoln County",3,37,781,387,394
050,29,113,"Missouri","Lincoln County",3,38,829,423,406
050,29,113,"Missouri","Lincoln County",3,39,855,429,426
050,29,113,"Missouri","Lincoln County",3,40,805,423,382
050,29,113,"Missouri","Lincoln County",3,41,851,443,408
050,29,113,"Missouri","Lincoln County",3,42,797,415,382
050,29,113,"Missouri","Lincoln County",3,43,767,379,388
050,29,113,"Missouri","Lincoln County",3,44,739,367,372
050,29,113,"Missouri","Lincoln County",3,45,691,344,347
050,29,113,"Missouri","Lincoln County",3,46,658,333,325
050,29,113,"Missouri","Lincoln County",3,47,659,348,311
050,29,113,"Missouri","Lincoln County",3,48,650,336,314
050,29,113,"Missouri","Lincoln County",3,49,711,374,337
050,29,113,"Missouri","Lincoln County",3,50,801,405,396
050,29,113,"Missouri","Lincoln County",3,51,795,407,388
050,29,113,"Missouri","Lincoln County",3,52,738,388,350
050,29,113,"Missouri","Lincoln County",3,53,752,393,359
050,29,113,"Missouri","Lincoln County",3,54,813,416,397
050,29,113,"Missouri","Lincoln County",3,55,811,414,397
050,29,113,"Missouri","Lincoln County",3,56,859,412,447
050,29,113,"Missouri","Lincoln County",3,57,891,442,449
050,29,113,"Missouri","Lincoln County",3,58,907,458,449
050,29,113,"Missouri","Lincoln County",3,59,896,453,443
050,29,113,"Missouri","Lincoln County",3,60,907,465,442
050,29,113,"Missouri","Lincoln County",3,61,855,434,421
050,29,113,"Missouri","Lincoln County",3,62,812,427,385
050,29,113,"Missouri","Lincoln County",3,63,807,408,399
050,29,113,"Missouri","Lincoln County",3,64,809,407,402
050,29,113,"Missouri","Lincoln County",3,65,735,368,367
050,29,113,"Missouri","Lincoln County",3,66,728,370,358
050,29,113,"Missouri","Lincoln County",3,67,673,353,320
050,29,113,"Missouri","Lincoln County",3,68,597,307,290
050,29,113,"Missouri","Lincoln County",3,69,572,288,284
050,29,113,"Missouri","Lincoln County",3,70,510,240,270
050,29,113,"Missouri","Lincoln County",3,71,457,214,243
050,29,113,"Missouri","Lincoln County",3,72,449,226,223
050,29,113,"Missouri","Lincoln County",3,73,439,226,213
050,29,113,"Missouri","Lincoln County",3,74,455,214,241
050,29,113,"Missouri","Lincoln County",3,75,296,144,152
050,29,113,"Missouri","Lincoln County",3,76,291,139,152
050,29,113,"Missouri","Lincoln County",3,77,295,143,152
050,29,113,"Missouri","Lincoln County",3,78,313,152,161
050,29,113,"Missouri","Lincoln County",3,79,272,129,143
050,29,113,"Missouri","Lincoln County",3,80,231,116,115
050,29,113,"Missouri","Lincoln County",3,81,207,95,112
050,29,113,"Missouri","Lincoln County",3,82,195,84,111
050,29,113,"Missouri","Lincoln County",3,83,161,76,85
050,29,113,"Missouri","Lincoln County",3,84,138,63,75
050,29,113,"Missouri","Lincoln County",3,85,775,306,469
050,29,113,"Missouri","Lincoln County",4,0,825,421,404
050,29,113,"Missouri","Lincoln County",4,1,817,458,359
050,29,113,"Missouri","Lincoln County",4,2,885,456,429
050,29,113,"Missouri","Lincoln County",4,3,886,437,449
050,29,113,"Missouri","Lincoln County",4,4,883,440,443
050,29,113,"Missouri","Lincoln County",4,5,887,447,440
050,29,113,"Missouri","Lincoln County",4,6,875,444,431
050,29,113,"Missouri","Lincoln County",4,7,889,449,440
050,29,113,"Missouri","Lincoln County",4,8,895,429,466
050,29,113,"Missouri","Lincoln County",4,9,862,432,430
050,29,113,"Missouri","Lincoln County",4,10,892,443,449
050,29,113,"Missouri","Lincoln County",4,11,866,450,416
050,29,113,"Missouri","Lincoln County",4,12,897,464,433
050,29,113,"Missouri","Lincoln County",4,13,921,491,430
050,29,113,"Missouri","Lincoln County",4,14,911,483,428
050,29,113,"Missouri","Lincoln County",4,15,922,487,435
050,29,113,"Missouri","Lincoln County",4,16,894,477,417
050,29,113,"Missouri","Lincoln County",4,17,870,468,402
050,29,113,"Missouri","Lincoln County",4,18,741,405,336
050,29,113,"Missouri","Lincoln County",4,19,557,302,255
050,29,113,"Missouri","Lincoln County",4,20,611,321,290
050,29,113,"Missouri","Lincoln County",4,21,651,338,313
050,29,113,"Missouri","Lincoln County",4,22,668,329,339
050,29,113,"Missouri","Lincoln County",4,23,718,351,367
050,29,113,"Missouri","Lincoln County",4,24,771,396,375
050,29,113,"Missouri","Lincoln County",4,25,773,394,379
050,29,113,"Missouri","Lincoln County",4,26,816,398,418
050,29,113,"Missouri","Lincoln County",4,27,852,438,414
050,29,113,"Missouri","Lincoln County",4,28,859,433,426
050,29,113,"Missouri","Lincoln County",4,29,965,480,485
050,29,113,"Missouri","Lincoln County",4,30,982,474,508
050,29,113,"Missouri","Lincoln County",4,31,1040,525,515
050,29,113,"Missouri","Lincoln County",4,32,940,481,459
050,29,113,"Missouri","Lincoln County",4,33,879,445,434
050,29,113,"Missouri","Lincoln County",4,34,870,441,429
050,29,113,"Missouri","Lincoln County",4,35,865,449,416
050,29,113,"Missouri","Lincoln County",4,36,889,436,453
050,29,113,"Missouri","Lincoln County",4,37,839,416,423
050,29,113,"Missouri","Lincoln County",4,38,799,406,393
050,29,113,"Missouri","Lincoln County",4,39,855,431,424
050,29,113,"Missouri","Lincoln County",4,40,862,423,439
050,29,113,"Missouri","Lincoln County",4,41,832,429,403
050,29,113,"Missouri","Lincoln County",4,42,862,458,404
050,29,113,"Missouri","Lincoln County",4,43,793,399,394
050,29,113,"Missouri","Lincoln County",4,44,779,382,397
050,29,113,"Missouri","Lincoln County",4,45,749,376,373
050,29,113,"Missouri","Lincoln County",4,46,707,360,347
050,29,113,"Missouri","Lincoln County",4,47,679,338,341
050,29,113,"Missouri","Lincoln County",4,48,674,363,311
050,29,113,"Missouri","Lincoln County",4,49,682,365,317
050,29,113,"Missouri","Lincoln County",4,50,733,367,366
050,29,113,"Missouri","Lincoln County",4,51,811,412,399
050,29,113,"Missouri","Lincoln County",4,52,817,421,396
050,29,113,"Missouri","Lincoln County",4,53,744,385,359
050,29,113,"Missouri","Lincoln County",4,54,771,396,375
050,29,113,"Missouri","Lincoln County",4,55,822,418,404
050,29,113,"Missouri","Lincoln County",4,56,811,420,391
050,29,113,"Missouri","Lincoln County",4,57,862,407,455
050,29,113,"Missouri","Lincoln County",4,58,901,452,449
050,29,113,"Missouri","Lincoln County",4,59,915,469,446
050,29,113,"Missouri","Lincoln County",4,60,911,461,450
050,29,113,"Missouri","Lincoln County",4,61,918,474,444
050,29,113,"Missouri","Lincoln County",4,62,861,425,436
050,29,113,"Missouri","Lincoln County",4,63,825,426,399
050,29,113,"Missouri","Lincoln County",4,64,808,407,401
050,29,113,"Missouri","Lincoln County",4,65,821,405,416
050,29,113,"Missouri","Lincoln County",4,66,715,361,354
050,29,113,"Missouri","Lincoln County",4,67,723,374,349
050,29,113,"Missouri","Lincoln County",4,68,671,356,315
050,29,113,"Missouri","Lincoln County",4,69,572,292,280
050,29,113,"Missouri","Lincoln County",4,70,573,299,274
050,29,113,"Missouri","Lincoln County",4,71,500,239,261
050,29,113,"Missouri","Lincoln County",4,72,455,206,249
050,29,113,"Missouri","Lincoln County",4,73,432,217,215
050,29,113,"Missouri","Lincoln County",4,74,426,211,215
050,29,113,"Missouri","Lincoln County",4,75,434,202,232
050,29,113,"Missouri","Lincoln County",4,76,281,139,142
050,29,113,"Missouri","Lincoln County",4,77,279,128,151
050,29,113,"Missouri","Lincoln County",4,78,274,132,142
050,29,113,"Missouri","Lincoln County",4,79,289,139,150
050,29,113,"Missouri","Lincoln County",4,80,257,128,129
050,29,113,"Missouri","Lincoln County",4,81,221,107,114
050,29,113,"Missouri","Lincoln County",4,82,197,87,110
050,29,113,"Missouri","Lincoln County",4,83,176,78,98
050,29,113,"Missouri","Lincoln County",4,84,155,69,86
050,29,113,"Missouri","Lincoln County",4,85,785,323,462
050,29,113,"Missouri","Lincoln County",5,0,808,413,395
050,29,113,"Missouri","Lincoln County",5,1,832,427,405
050,29,113,"Missouri","Lincoln County",5,2,843,479,364
050,29,113,"Missouri","Lincoln County",5,3,894,468,426
050,29,113,"Missouri","Lincoln County",5,4,911,446,465
050,29,113,"Missouri","Lincoln County",5,5,880,444,436
050,29,113,"Missouri","Lincoln County",5,6,896,465,431
050,29,113,"Missouri","Lincoln County",5,7,919,467,452
050,29,113,"Missouri","Lincoln County",5,8,903,451,452
050,29,113,"Missouri","Lincoln County",5,9,931,439,492
050,29,113,"Missouri","Lincoln County",5,10,896,450,446
050,29,113,"Missouri","Lincoln County",5,11,897,453,444
050,29,113,"Missouri","Lincoln County",5,12,899,471,428
050,29,113,"Missouri","Lincoln County",5,13,938,486,452
050,29,113,"Missouri","Lincoln County",5,14,932,496,436
050,29,113,"Missouri","Lincoln County",5,15,927,486,441
050,29,113,"Missouri","Lincoln County",5,16,939,490,449
050,29,113,"Missouri","Lincoln County",5,17,906,479,427
050,29,113,"Missouri","Lincoln County",5,18,727,395,332
050,29,113,"Missouri","Lincoln County",5,19,580,326,254
050,29,113,"Missouri","Lincoln County",5,20,602,319,283
050,29,113,"Missouri","Lincoln County",5,21,672,354,318
050,29,113,"Missouri","Lincoln County",5,22,701,349,352
050,29,113,"Missouri","Lincoln County",5,23,725,376,349
050,29,113,"Missouri","Lincoln County",5,24,767,373,394
050,29,113,"Missouri","Lincoln County",5,25,827,408,419
050,29,113,"Missouri","Lincoln County",5,26,800,413,387
050,29,113,"Missouri","Lincoln County",5,27,860,416,444
050,29,113,"Missouri","Lincoln County",5,28,902,457,445
050,29,113,"Missouri","Lincoln County",5,29,901,454,447
050,29,113,"Missouri","Lincoln County",5,30,984,486,498
050,29,113,"Missouri","Lincoln County",5,31,1025,485,540
050,29,113,"Missouri","Lincoln County",5,32,1065,548,517
050,29,113,"Missouri","Lincoln County",5,33,967,498,469
050,29,113,"Missouri","Lincoln County",5,34,890,442,448
050,29,113,"Missouri","Lincoln County",5,35,901,455,446
050,29,113,"Missouri","Lincoln County",5,36,908,474,434
050,29,113,"Missouri","Lincoln County",5,37,894,446,448
050,29,113,"Missouri","Lincoln County",5,38,872,430,442
050,29,113,"Missouri","Lincoln County",5,39,803,413,390
050,29,113,"Missouri","Lincoln County",5,40,846,427,419
050,29,113,"Missouri","Lincoln County",5,41,877,425,452
050,29,113,"Missouri","Lincoln County",5,42,842,442,400
050,29,113,"Missouri","Lincoln County",5,43,884,470,414
050,29,113,"Missouri","Lincoln County",5,44,813,410,403
050,29,113,"Missouri","Lincoln County",5,45,772,387,385
050,29,113,"Missouri","Lincoln County",5,46,760,382,378
050,29,113,"Missouri","Lincoln County",5,47,720,371,349
050,29,113,"Missouri","Lincoln County",5,48,691,336,355
050,29,113,"Missouri","Lincoln County",5,49,703,381,322
050,29,113,"Missouri","Lincoln County",5,50,710,376,334
050,29,113,"Missouri","Lincoln County",5,51,731,368,363
050,29,113,"Missouri","Lincoln County",5,52,845,428,417
050,29,113,"Missouri","Lincoln County",5,53,824,424,400
050,29,113,"Missouri","Lincoln County",5,54,760,397,363
050,29,113,"Missouri","Lincoln County",5,55,775,385,390
050,29,113,"Missouri","Lincoln County",5,56,830,423,407
050,29,113,"Missouri","Lincoln County",5,57,806,418,388
050,29,113,"Missouri","Lincoln County",5,58,863,399,464
050,29,113,"Missouri","Lincoln County",5,59,920,463,457
050,29,113,"Missouri","Lincoln County",5,60,919,468,451
050,29,113,"Missouri","Lincoln County",5,61,928,473,455
050,29,113,"Missouri","Lincoln County",5,62,915,473,442
050,29,113,"Missouri","Lincoln County",5,63,873,428,445
050,29,113,"Missouri","Lincoln County",5,64,840,442,398
050,29,113,"Missouri","Lincoln County",5,65,818,408,410
050,29,113,"Missouri","Lincoln County",5,66,823,407,416
050,29,113,"Missouri","Lincoln County",5,67,718,353,365
050,29,113,"Missouri","Lincoln County",5,68,725,369,356
050,29,113,"Missouri","Lincoln County",5,69,660,345,315
050,29,113,"Missouri","Lincoln County",5,70,584,304,280
050,29,113,"Missouri","Lincoln County",5,71,561,298,263
050,29,113,"Missouri","Lincoln County",5,72,489,230,259
050,29,113,"Missouri","Lincoln County",5,73,453,207,246
050,29,113,"Missouri","Lincoln County",5,74,412,202,210
050,29,113,"Missouri","Lincoln County",5,75,405,202,203
050,29,113,"Missouri","Lincoln County",5,76,415,199,216
050,29,113,"Missouri","Lincoln County",5,77,269,127,142
050,29,113,"Missouri","Lincoln County",5,78,269,123,146
050,29,113,"Missouri","Lincoln County",5,79,255,122,133
050,29,113,"Missouri","Lincoln County",5,80,265,134,131
050,29,113,"Missouri","Lincoln County",5,81,250,118,132
050,29,113,"Missouri","Lincoln County",5,82,207,97,110
050,29,113,"Missouri","Lincoln County",5,83,181,82,99
050,29,113,"Missouri","Lincoln County",5,84,172,73,99
050,29,113,"Missouri","Lincoln County",5,85,797,336,461
050,29,115,"Missouri","Linn County",1,0,135,68,67
050,29,115,"Missouri","Linn County",1,1,138,74,64
050,29,115,"Missouri","Linn County",1,2,124,61,63
050,29,115,"Missouri","Linn County",1,3,140,71,69
050,29,115,"Missouri","Linn County",1,4,142,73,69
050,29,115,"Missouri","Linn County",1,5,158,80,78
050,29,115,"Missouri","Linn County",1,6,165,81,84
050,29,115,"Missouri","Linn County",1,7,147,72,75
050,29,115,"Missouri","Linn County",1,8,146,82,64
050,29,115,"Missouri","Linn County",1,9,139,79,60
050,29,115,"Missouri","Linn County",1,10,150,77,73
050,29,115,"Missouri","Linn County",1,11,162,86,76
050,29,115,"Missouri","Linn County",1,12,180,94,86
050,29,115,"Missouri","Linn County",1,13,191,100,91
050,29,115,"Missouri","Linn County",1,14,188,95,93
050,29,115,"Missouri","Linn County",1,15,171,80,91
050,29,115,"Missouri","Linn County",1,16,176,85,91
050,29,115,"Missouri","Linn County",1,17,167,82,85
050,29,115,"Missouri","Linn County",1,18,136,69,67
050,29,115,"Missouri","Linn County",1,19,107,57,50
050,29,115,"Missouri","Linn County",1,20,116,59,57
050,29,115,"Missouri","Linn County",1,21,118,60,58
050,29,115,"Missouri","Linn County",1,22,123,71,52
050,29,115,"Missouri","Linn County",1,23,129,70,59
050,29,115,"Missouri","Linn County",1,24,121,54,67
050,29,115,"Missouri","Linn County",1,25,136,71,65
050,29,115,"Missouri","Linn County",1,26,141,73,68
050,29,115,"Missouri","Linn County",1,27,146,91,55
050,29,115,"Missouri","Linn County",1,28,153,76,77
050,29,115,"Missouri","Linn County",1,29,134,69,65
050,29,115,"Missouri","Linn County",1,30,117,60,57
050,29,115,"Missouri","Linn County",1,31,114,56,58
050,29,115,"Missouri","Linn County",1,32,109,54,55
050,29,115,"Missouri","Linn County",1,33,115,59,56
050,29,115,"Missouri","Linn County",1,34,133,64,69
050,29,115,"Missouri","Linn County",1,35,128,62,66
050,29,115,"Missouri","Linn County",1,36,129,64,65
050,29,115,"Missouri","Linn County",1,37,133,56,77
050,29,115,"Missouri","Linn County",1,38,139,62,77
050,29,115,"Missouri","Linn County",1,39,133,67,66
050,29,115,"Missouri","Linn County",1,40,130,71,59
050,29,115,"Missouri","Linn County",1,41,138,73,65
050,29,115,"Missouri","Linn County",1,42,148,69,79
050,29,115,"Missouri","Linn County",1,43,131,69,62
050,29,115,"Missouri","Linn County",1,44,130,66,64
050,29,115,"Missouri","Linn County",1,45,125,58,67
050,29,115,"Missouri","Linn County",1,46,123,68,55
050,29,115,"Missouri","Linn County",1,47,123,57,66
050,29,115,"Missouri","Linn County",1,48,113,54,59
050,29,115,"Missouri","Linn County",1,49,140,72,68
050,29,115,"Missouri","Linn County",1,50,148,73,75
050,29,115,"Missouri","Linn County",1,51,137,71,66
050,29,115,"Missouri","Linn County",1,52,135,67,68
050,29,115,"Missouri","Linn County",1,53,135,74,61
050,29,115,"Missouri","Linn County",1,54,127,63,64
050,29,115,"Missouri","Linn County",1,55,151,80,71
050,29,115,"Missouri","Linn County",1,56,165,82,83
050,29,115,"Missouri","Linn County",1,57,174,80,94
050,29,115,"Missouri","Linn County",1,58,167,82,85
050,29,115,"Missouri","Linn County",1,59,201,102,99
050,29,115,"Missouri","Linn County",1,60,205,95,110
050,29,115,"Missouri","Linn County",1,61,191,89,102
050,29,115,"Missouri","Linn County",1,62,184,91,93
050,29,115,"Missouri","Linn County",1,63,172,84,88
050,29,115,"Missouri","Linn County",1,64,167,76,91
050,29,115,"Missouri","Linn County",1,65,156,72,84
050,29,115,"Missouri","Linn County",1,66,165,84,81
050,29,115,"Missouri","Linn County",1,67,164,85,79
050,29,115,"Missouri","Linn County",1,68,149,68,81
050,29,115,"Missouri","Linn County",1,69,141,70,71
050,29,115,"Missouri","Linn County",1,70,135,64,71
050,29,115,"Missouri","Linn County",1,71,138,64,74
050,29,115,"Missouri","Linn County",1,72,142,66,76
050,29,115,"Missouri","Linn County",1,73,122,58,64
050,29,115,"Missouri","Linn County",1,74,105,46,59
050,29,115,"Missouri","Linn County",1,75,96,44,52
050,29,115,"Missouri","Linn County",1,76,97,49,48
050,29,115,"Missouri","Linn County",1,77,85,41,44
050,29,115,"Missouri","Linn County",1,78,83,40,43
050,29,115,"Missouri","Linn County",1,79,76,37,39
050,29,115,"Missouri","Linn County",1,80,74,29,45
050,29,115,"Missouri","Linn County",1,81,61,24,37
050,29,115,"Missouri","Linn County",1,82,59,21,38
050,29,115,"Missouri","Linn County",1,83,62,26,36
050,29,115,"Missouri","Linn County",1,84,48,20,28
050,29,115,"Missouri","Linn County",1,85,328,102,226
050,29,115,"Missouri","Linn County",2,0,132,64,68
050,29,115,"Missouri","Linn County",2,1,135,71,64
050,29,115,"Missouri","Linn County",2,2,128,65,63
050,29,115,"Missouri","Linn County",2,3,137,69,68
050,29,115,"Missouri","Linn County",2,4,143,73,70
050,29,115,"Missouri","Linn County",2,5,153,76,77
050,29,115,"Missouri","Linn County",2,6,164,80,84
050,29,115,"Missouri","Linn County",2,7,152,74,78
050,29,115,"Missouri","Linn County",2,8,145,79,66
050,29,115,"Missouri","Linn County",2,9,141,80,61
050,29,115,"Missouri","Linn County",2,10,147,77,70
050,29,115,"Missouri","Linn County",2,11,158,83,75
050,29,115,"Missouri","Linn County",2,12,177,92,85
050,29,115,"Missouri","Linn County",2,13,188,98,90
050,29,115,"Missouri","Linn County",2,14,186,94,92
050,29,115,"Missouri","Linn County",2,15,176,84,92
050,29,115,"Missouri","Linn County",2,16,174,84,90
050,29,115,"Missouri","Linn County",2,17,169,83,86
050,29,115,"Missouri","Linn County",2,18,137,70,67
050,29,115,"Missouri","Linn County",2,19,107,56,51
050,29,115,"Missouri","Linn County",2,20,119,61,58
050,29,115,"Missouri","Linn County",2,21,118,60,58
050,29,115,"Missouri","Linn County",2,22,124,70,54
050,29,115,"Missouri","Linn County",2,23,128,70,58
050,29,115,"Missouri","Linn County",2,24,123,60,63
050,29,115,"Missouri","Linn County",2,25,133,66,67
050,29,115,"Missouri","Linn County",2,26,137,72,65
050,29,115,"Missouri","Linn County",2,27,145,87,58
050,29,115,"Missouri","Linn County",2,28,150,80,70
050,29,115,"Missouri","Linn County",2,29,137,71,66
050,29,115,"Missouri","Linn County",2,30,123,63,60
050,29,115,"Missouri","Linn County",2,31,113,57,56
050,29,115,"Missouri","Linn County",2,32,110,54,56
050,29,115,"Missouri","Linn County",2,33,111,56,55
050,29,115,"Missouri","Linn County",2,34,129,63,66
050,29,115,"Missouri","Linn County",2,35,131,63,68
050,29,115,"Missouri","Linn County",2,36,127,62,65
050,29,115,"Missouri","Linn County",2,37,134,59,75
050,29,115,"Missouri","Linn County",2,38,139,62,77
050,29,115,"Missouri","Linn County",2,39,135,65,70
050,29,115,"Missouri","Linn County",2,40,132,71,61
050,29,115,"Missouri","Linn County",2,41,136,72,64
050,29,115,"Missouri","Linn County",2,42,145,70,75
050,29,115,"Missouri","Linn County",2,43,135,69,66
050,29,115,"Missouri","Linn County",2,44,128,66,62
050,29,115,"Missouri","Linn County",2,45,127,60,67
050,29,115,"Missouri","Linn County",2,46,121,65,56
050,29,115,"Missouri","Linn County",2,47,123,60,63
050,29,115,"Missouri","Linn County",2,48,117,56,61
050,29,115,"Missouri","Linn County",2,49,136,68,68
050,29,115,"Missouri","Linn County",2,50,146,73,73
050,29,115,"Missouri","Linn County",2,51,139,71,68
050,29,115,"Missouri","Linn County",2,52,136,68,68
050,29,115,"Missouri","Linn County",2,53,134,72,62
050,29,115,"Missouri","Linn County",2,54,128,65,63
050,29,115,"Missouri","Linn County",2,55,144,76,68
050,29,115,"Missouri","Linn County",2,56,162,82,80
050,29,115,"Missouri","Linn County",2,57,172,81,91
050,29,115,"Missouri","Linn County",2,58,169,81,88
050,29,115,"Missouri","Linn County",2,59,194,98,96
050,29,115,"Missouri","Linn County",2,60,205,96,109
050,29,115,"Missouri","Linn County",2,61,193,90,103
050,29,115,"Missouri","Linn County",2,62,188,92,96
050,29,115,"Missouri","Linn County",2,63,174,86,88
050,29,115,"Missouri","Linn County",2,64,168,78,90
050,29,115,"Missouri","Linn County",2,65,158,72,86
050,29,115,"Missouri","Linn County",2,66,162,80,82
050,29,115,"Missouri","Linn County",2,67,163,84,79
050,29,115,"Missouri","Linn County",2,68,152,72,80
050,29,115,"Missouri","Linn County",2,69,144,69,75
050,29,115,"Missouri","Linn County",2,70,135,65,70
050,29,115,"Missouri","Linn County",2,71,134,61,73
050,29,115,"Missouri","Linn County",2,72,137,64,73
050,29,115,"Missouri","Linn County",2,73,132,62,70
050,29,115,"Missouri","Linn County",2,74,103,46,57
050,29,115,"Missouri","Linn County",2,75,98,44,54
050,29,115,"Missouri","Linn County",2,76,94,47,47
050,29,115,"Missouri","Linn County",2,77,91,44,47
050,29,115,"Missouri","Linn County",2,78,83,40,43
050,29,115,"Missouri","Linn County",2,79,74,37,37
050,29,115,"Missouri","Linn County",2,80,72,31,41
050,29,115,"Missouri","Linn County",2,81,61,25,36
050,29,115,"Missouri","Linn County",2,82,60,22,38
050,29,115,"Missouri","Linn County",2,83,60,24,36
050,29,115,"Missouri","Linn County",2,84,51,21,30
050,29,115,"Missouri","Linn County",2,85,327,104,223
050,29,115,"Missouri","Linn County",3,0,132,69,63
050,29,115,"Missouri","Linn County",3,1,143,64,79
050,29,115,"Missouri","Linn County",3,2,150,75,75
050,29,115,"Missouri","Linn County",3,3,138,68,70
050,29,115,"Missouri","Linn County",3,4,146,71,75
050,29,115,"Missouri","Linn County",3,5,133,68,65
050,29,115,"Missouri","Linn County",3,6,147,76,71
050,29,115,"Missouri","Linn County",3,7,167,87,80
050,29,115,"Missouri","Linn County",3,8,157,73,84
050,29,115,"Missouri","Linn County",3,9,149,79,70
050,29,115,"Missouri","Linn County",3,10,139,82,57
050,29,115,"Missouri","Linn County",3,11,150,78,72
050,29,115,"Missouri","Linn County",3,12,157,86,71
050,29,115,"Missouri","Linn County",3,13,182,96,86
050,29,115,"Missouri","Linn County",3,14,194,98,96
050,29,115,"Missouri","Linn County",3,15,183,93,90
050,29,115,"Missouri","Linn County",3,16,185,91,94
050,29,115,"Missouri","Linn County",3,17,176,84,92
050,29,115,"Missouri","Linn County",3,18,151,74,77
050,29,115,"Missouri","Linn County",3,19,107,57,50
050,29,115,"Missouri","Linn County",3,20,107,54,53
050,29,115,"Missouri","Linn County",3,21,128,60,68
050,29,115,"Missouri","Linn County",3,22,124,62,62
050,29,115,"Missouri","Linn County",3,23,120,68,52
050,29,115,"Missouri","Linn County",3,24,143,76,67
050,29,115,"Missouri","Linn County",3,25,124,65,59
050,29,115,"Missouri","Linn County",3,26,128,65,63
050,29,115,"Missouri","Linn County",3,27,139,77,62
050,29,115,"Missouri","Linn County",3,28,141,81,60
050,29,115,"Missouri","Linn County",3,29,148,80,68
050,29,115,"Missouri","Linn County",3,30,142,75,67
050,29,115,"Missouri","Linn County",3,31,130,66,64
050,29,115,"Missouri","Linn County",3,32,116,58,58
050,29,115,"Missouri","Linn County",3,33,109,57,52
050,29,115,"Missouri","Linn County",3,34,106,55,51
050,29,115,"Missouri","Linn County",3,35,131,65,66
050,29,115,"Missouri","Linn County",3,36,137,65,72
050,29,115,"Missouri","Linn County",3,37,133,61,72
050,29,115,"Missouri","Linn County",3,38,135,61,74
050,29,115,"Missouri","Linn County",3,39,140,63,77
050,29,115,"Missouri","Linn County",3,40,130,64,66
050,29,115,"Missouri","Linn County",3,41,130,67,63
050,29,115,"Missouri","Linn County",3,42,137,73,64
050,29,115,"Missouri","Linn County",3,43,143,69,74
050,29,115,"Missouri","Linn County",3,44,138,71,67
050,29,115,"Missouri","Linn County",3,45,127,67,60
050,29,115,"Missouri","Linn County",3,46,130,59,71
050,29,115,"Missouri","Linn County",3,47,115,66,49
050,29,115,"Missouri","Linn County",3,48,119,56,63
050,29,115,"Missouri","Linn County",3,49,116,54,62
050,29,115,"Missouri","Linn County",3,50,136,67,69
050,29,115,"Missouri","Linn County",3,51,148,75,73
050,29,115,"Missouri","Linn County",3,52,138,70,68
050,29,115,"Missouri","Linn County",3,53,138,70,68
050,29,115,"Missouri","Linn County",3,54,131,71,60
050,29,115,"Missouri","Linn County",3,55,130,67,63
050,29,115,"Missouri","Linn County",3,56,143,72,71
050,29,115,"Missouri","Linn County",3,57,157,79,78
050,29,115,"Missouri","Linn County",3,58,166,77,89
050,29,115,"Missouri","Linn County",3,59,171,87,84
050,29,115,"Missouri","Linn County",3,60,187,91,96
050,29,115,"Missouri","Linn County",3,61,201,95,106
050,29,115,"Missouri","Linn County",3,62,191,90,101
050,29,115,"Missouri","Linn County",3,63,179,86,93
050,29,115,"Missouri","Linn County",3,64,172,82,90
050,29,115,"Missouri","Linn County",3,65,164,78,86
050,29,115,"Missouri","Linn County",3,66,153,67,86
050,29,115,"Missouri","Linn County",3,67,160,81,79
050,29,115,"Missouri","Linn County",3,68,162,79,83
050,29,115,"Missouri","Linn County",3,69,152,72,80
050,29,115,"Missouri","Linn County",3,70,139,66,73
050,29,115,"Missouri","Linn County",3,71,128,61,67
050,29,115,"Missouri","Linn County",3,72,135,62,73
050,29,115,"Missouri","Linn County",3,73,128,61,67
050,29,115,"Missouri","Linn County",3,74,128,58,70
050,29,115,"Missouri","Linn County",3,75,100,43,57
050,29,115,"Missouri","Linn County",3,76,92,41,51
050,29,115,"Missouri","Linn County",3,77,88,43,45
050,29,115,"Missouri","Linn County",3,78,87,41,46
050,29,115,"Missouri","Linn County",3,79,78,41,37
050,29,115,"Missouri","Linn County",3,80,61,31,30
050,29,115,"Missouri","Linn County",3,81,60,25,35
050,29,115,"Missouri","Linn County",3,82,60,24,36
050,29,115,"Missouri","Linn County",3,83,57,23,34
050,29,115,"Missouri","Linn County",3,84,52,16,36
050,29,115,"Missouri","Linn County",3,85,318,109,209
050,29,115,"Missouri","Linn County",4,0,134,72,62
050,29,115,"Missouri","Linn County",4,1,142,70,72
050,29,115,"Missouri","Linn County",4,2,144,66,78
050,29,115,"Missouri","Linn County",4,3,147,78,69
050,29,115,"Missouri","Linn County",4,4,140,68,72
050,29,115,"Missouri","Linn County",4,5,143,72,71
050,29,115,"Missouri","Linn County",4,6,140,72,68
050,29,115,"Missouri","Linn County",4,7,153,79,74
050,29,115,"Missouri","Linn County",4,8,167,89,78
050,29,115,"Missouri","Linn County",4,9,165,77,88
050,29,115,"Missouri","Linn County",4,10,146,79,67
050,29,115,"Missouri","Linn County",4,11,143,86,57
050,29,115,"Missouri","Linn County",4,12,154,79,75
050,29,115,"Missouri","Linn County",4,13,162,89,73
050,29,115,"Missouri","Linn County",4,14,183,92,91
050,29,115,"Missouri","Linn County",4,15,194,102,92
050,29,115,"Missouri","Linn County",4,16,177,84,93
050,29,115,"Missouri","Linn County",4,17,184,91,93
050,29,115,"Missouri","Linn County",4,18,149,75,74
050,29,115,"Missouri","Linn County",4,19,112,56,56
050,29,115,"Missouri","Linn County",4,20,114,62,52
050,29,115,"Missouri","Linn County",4,21,111,51,60
050,29,115,"Missouri","Linn County",4,22,134,63,71
050,29,115,"Missouri","Linn County",4,23,129,62,67
050,29,115,"Missouri","Linn County",4,24,123,71,52
050,29,115,"Missouri","Linn County",4,25,132,68,64
050,29,115,"Missouri","Linn County",4,26,133,67,66
050,29,115,"Missouri","Linn County",4,27,128,67,61
050,29,115,"Missouri","Linn County",4,28,141,75,66
050,29,115,"Missouri","Linn County",4,29,146,85,61
050,29,115,"Missouri","Linn County",4,30,150,76,74
050,29,115,"Missouri","Linn County",4,31,142,74,68
050,29,115,"Missouri","Linn County",4,32,132,65,67
050,29,115,"Missouri","Linn County",4,33,114,57,57
050,29,115,"Missouri","Linn County",4,34,103,51,52
050,29,115,"Missouri","Linn County",4,35,112,59,53
050,29,115,"Missouri","Linn County",4,36,136,70,66
050,29,115,"Missouri","Linn County",4,37,141,66,75
050,29,115,"Missouri","Linn County",4,38,134,67,67
050,29,115,"Missouri","Linn County",4,39,147,62,85
050,29,115,"Missouri","Linn County",4,40,135,61,74
050,29,115,"Missouri","Linn County",4,41,136,69,67
050,29,115,"Missouri","Linn County",4,42,121,63,58
050,29,115,"Missouri","Linn County",4,43,133,72,61
050,29,115,"Missouri","Linn County",4,44,140,68,72
050,29,115,"Missouri","Linn County",4,45,141,72,69
050,29,115,"Missouri","Linn County",4,46,134,72,62
050,29,115,"Missouri","Linn County",4,47,135,60,75
050,29,115,"Missouri","Linn County",4,48,113,66,47
050,29,115,"Missouri","Linn County",4,49,119,54,65
050,29,115,"Missouri","Linn County",4,50,118,52,66
050,29,115,"Missouri","Linn County",4,51,145,72,73
050,29,115,"Missouri","Linn County",4,52,143,68,75
050,29,115,"Missouri","Linn County",4,53,135,68,67
050,29,115,"Missouri","Linn County",4,54,141,71,70
050,29,115,"Missouri","Linn County",4,55,128,71,57
050,29,115,"Missouri","Linn County",4,56,128,65,63
050,29,115,"Missouri","Linn County",4,57,150,76,74
050,29,115,"Missouri","Linn County",4,58,153,77,76
050,29,115,"Missouri","Linn County",4,59,166,80,86
050,29,115,"Missouri","Linn County",4,60,175,86,89
050,29,115,"Missouri","Linn County",4,61,185,88,97
050,29,115,"Missouri","Linn County",4,62,198,94,104
050,29,115,"Missouri","Linn County",4,63,189,89,100
050,29,115,"Missouri","Linn County",4,64,181,86,95
050,29,115,"Missouri","Linn County",4,65,167,84,83
050,29,115,"Missouri","Linn County",4,66,164,77,87
050,29,115,"Missouri","Linn County",4,67,148,66,82
050,29,115,"Missouri","Linn County",4,68,158,77,81
050,29,115,"Missouri","Linn County",4,69,155,74,81
050,29,115,"Missouri","Linn County",4,70,142,67,75
050,29,115,"Missouri","Linn County",4,71,133,63,70
050,29,115,"Missouri","Linn County",4,72,121,59,62
050,29,115,"Missouri","Linn County",4,73,124,57,67
050,29,115,"Missouri","Linn County",4,74,123,57,66
050,29,115,"Missouri","Linn County",4,75,120,54,66
050,29,115,"Missouri","Linn County",4,76,91,39,52
050,29,115,"Missouri","Linn County",4,77,91,41,50
050,29,115,"Missouri","Linn County",4,78,82,39,43
050,29,115,"Missouri","Linn County",4,79,81,41,40
050,29,115,"Missouri","Linn County",4,80,71,37,34
050,29,115,"Missouri","Linn County",4,81,57,29,28
050,29,115,"Missouri","Linn County",4,82,57,24,33
050,29,115,"Missouri","Linn County",4,83,56,23,33
050,29,115,"Missouri","Linn County",4,84,52,19,33
050,29,115,"Missouri","Linn County",4,85,310,105,205
050,29,115,"Missouri","Linn County",5,0,135,72,63
050,29,115,"Missouri","Linn County",5,1,132,69,63
050,29,115,"Missouri","Linn County",5,2,137,65,72
050,29,115,"Missouri","Linn County",5,3,141,63,78
050,29,115,"Missouri","Linn County",5,4,153,79,74
050,29,115,"Missouri","Linn County",5,5,140,66,74
050,29,115,"Missouri","Linn County",5,6,134,64,70
050,29,115,"Missouri","Linn County",5,7,146,73,73
050,29,115,"Missouri","Linn County",5,8,157,87,70
050,29,115,"Missouri","Linn County",5,9,166,90,76
050,29,115,"Missouri","Linn County",5,10,169,83,86
050,29,115,"Missouri","Linn County",5,11,153,84,69
050,29,115,"Missouri","Linn County",5,12,144,87,57
050,29,115,"Missouri","Linn County",5,13,152,76,76
050,29,115,"Missouri","Linn County",5,14,165,90,75
050,29,115,"Missouri","Linn County",5,15,180,88,92
050,29,115,"Missouri","Linn County",5,16,183,100,83
050,29,115,"Missouri","Linn County",5,17,187,87,100
050,29,115,"Missouri","Linn County",5,18,153,80,73
050,29,115,"Missouri","Linn County",5,19,113,57,56
050,29,115,"Missouri","Linn County",5,20,117,58,59
050,29,115,"Missouri","Linn County",5,21,121,65,56
050,29,115,"Missouri","Linn County",5,22,114,52,62
050,29,115,"Missouri","Linn County",5,23,137,68,69
050,29,115,"Missouri","Linn County",5,24,129,60,69
050,29,115,"Missouri","Linn County",5,25,134,78,56
050,29,115,"Missouri","Linn County",5,26,138,71,67
050,29,115,"Missouri","Linn County",5,27,129,65,64
050,29,115,"Missouri","Linn County",5,28,125,64,61
050,29,115,"Missouri","Linn County",5,29,138,72,66
050,29,115,"Missouri","Linn County",5,30,135,76,59
050,29,115,"Missouri","Linn County",5,31,144,74,70
050,29,115,"Missouri","Linn County",5,32,143,75,68
050,29,115,"Missouri","Linn County",5,33,127,62,65
050,29,115,"Missouri","Linn County",5,34,120,59,61
050,29,115,"Missouri","Linn County",5,35,111,53,58
050,29,115,"Missouri","Linn County",5,36,112,59,53
050,29,115,"Missouri","Linn County",5,37,135,67,68
050,29,115,"Missouri","Linn County",5,38,139,67,72
050,29,115,"Missouri","Linn County",5,39,140,71,69
050,29,115,"Missouri","Linn County",5,40,146,66,80
050,29,115,"Missouri","Linn County",5,41,135,61,74
050,29,115,"Missouri","Linn County",5,42,143,72,71
050,29,115,"Missouri","Linn County",5,43,124,64,60
050,29,115,"Missouri","Linn County",5,44,133,69,64
050,29,115,"Missouri","Linn County",5,45,145,69,76
050,29,115,"Missouri","Linn County",5,46,135,66,69
050,29,115,"Missouri","Linn County",5,47,132,68,64
050,29,115,"Missouri","Linn County",5,48,132,60,72
050,29,115,"Missouri","Linn County",5,49,109,62,47
050,29,115,"Missouri","Linn County",5,50,123,58,65
050,29,115,"Missouri","Linn County",5,51,116,52,64
050,29,115,"Missouri","Linn County",5,52,148,73,75
050,29,115,"Missouri","Linn County",5,53,147,68,79
050,29,115,"Missouri","Linn County",5,54,130,67,63
050,29,115,"Missouri","Linn County",5,55,140,71,69
050,29,115,"Missouri","Linn County",5,56,127,72,55
050,29,115,"Missouri","Linn County",5,57,132,67,65
050,29,115,"Missouri","Linn County",5,58,148,74,74
050,29,115,"Missouri","Linn County",5,59,148,74,74
050,29,115,"Missouri","Linn County",5,60,170,80,90
050,29,115,"Missouri","Linn County",5,61,169,85,84
050,29,115,"Missouri","Linn County",5,62,184,90,94
050,29,115,"Missouri","Linn County",5,63,197,93,104
050,29,115,"Missouri","Linn County",5,64,194,90,104
050,29,115,"Missouri","Linn County",5,65,175,82,93
050,29,115,"Missouri","Linn County",5,66,159,79,80
050,29,115,"Missouri","Linn County",5,67,168,82,86
050,29,115,"Missouri","Linn County",5,68,152,66,86
050,29,115,"Missouri","Linn County",5,69,158,76,82
050,29,115,"Missouri","Linn County",5,70,149,71,78
050,29,115,"Missouri","Linn County",5,71,144,67,77
050,29,115,"Missouri","Linn County",5,72,128,62,66
050,29,115,"Missouri","Linn County",5,73,116,57,59
050,29,115,"Missouri","Linn County",5,74,117,53,64
050,29,115,"Missouri","Linn County",5,75,113,50,63
050,29,115,"Missouri","Linn County",5,76,109,50,59
050,29,115,"Missouri","Linn County",5,77,90,36,54
050,29,115,"Missouri","Linn County",5,78,84,36,48
050,29,115,"Missouri","Linn County",5,79,80,40,40
050,29,115,"Missouri","Linn County",5,80,73,37,36
050,29,115,"Missouri","Linn County",5,81,66,35,31
050,29,115,"Missouri","Linn County",5,82,54,27,27
050,29,115,"Missouri","Linn County",5,83,57,27,30
050,29,115,"Missouri","Linn County",5,84,52,20,32
050,29,115,"Missouri","Linn County",5,85,312,110,202
050,29,117,"Missouri","Livingston County",1,0,151,76,75
050,29,117,"Missouri","Livingston County",1,1,160,75,85
050,29,117,"Missouri","Livingston County",1,2,168,96,72
050,29,117,"Missouri","Livingston County",1,3,177,90,87
050,29,117,"Missouri","Livingston County",1,4,163,88,75
050,29,117,"Missouri","Livingston County",1,5,177,93,84
050,29,117,"Missouri","Livingston County",1,6,165,83,82
050,29,117,"Missouri","Livingston County",1,7,175,91,84
050,29,117,"Missouri","Livingston County",1,8,178,95,83
050,29,117,"Missouri","Livingston County",1,9,173,95,78
050,29,117,"Missouri","Livingston County",1,10,174,101,73
050,29,117,"Missouri","Livingston County",1,11,177,86,91
050,29,117,"Missouri","Livingston County",1,12,188,90,98
050,29,117,"Missouri","Livingston County",1,13,201,90,111
050,29,117,"Missouri","Livingston County",1,14,196,91,105
050,29,117,"Missouri","Livingston County",1,15,196,98,98
050,29,117,"Missouri","Livingston County",1,16,176,87,89
050,29,117,"Missouri","Livingston County",1,17,166,85,81
050,29,117,"Missouri","Livingston County",1,18,151,84,67
050,29,117,"Missouri","Livingston County",1,19,107,51,56
050,29,117,"Missouri","Livingston County",1,20,134,63,71
050,29,117,"Missouri","Livingston County",1,21,152,77,75
050,29,117,"Missouri","Livingston County",1,22,177,69,108
050,29,117,"Missouri","Livingston County",1,23,181,61,120
050,29,117,"Missouri","Livingston County",1,24,183,77,106
050,29,117,"Missouri","Livingston County",1,25,170,78,92
050,29,117,"Missouri","Livingston County",1,26,192,85,107
050,29,117,"Missouri","Livingston County",1,27,191,81,110
050,29,117,"Missouri","Livingston County",1,28,218,80,138
050,29,117,"Missouri","Livingston County",1,29,204,89,115
050,29,117,"Missouri","Livingston County",1,30,197,78,119
050,29,117,"Missouri","Livingston County",1,31,185,73,112
050,29,117,"Missouri","Livingston County",1,32,196,81,115
050,29,117,"Missouri","Livingston County",1,33,194,71,123
050,29,117,"Missouri","Livingston County",1,34,177,68,109
050,29,117,"Missouri","Livingston County",1,35,191,77,114
050,29,117,"Missouri","Livingston County",1,36,187,79,108
050,29,117,"Missouri","Livingston County",1,37,204,79,125
050,29,117,"Missouri","Livingston County",1,38,210,84,126
050,29,117,"Missouri","Livingston County",1,39,198,80,118
050,29,117,"Missouri","Livingston County",1,40,187,68,119
050,29,117,"Missouri","Livingston County",1,41,185,70,115
050,29,117,"Missouri","Livingston County",1,42,176,78,98
050,29,117,"Missouri","Livingston County",1,43,185,70,115
050,29,117,"Missouri","Livingston County",1,44,185,66,119
050,29,117,"Missouri","Livingston County",1,45,195,79,116
050,29,117,"Missouri","Livingston County",1,46,183,77,106
050,29,117,"Missouri","Livingston County",1,47,172,64,108
050,29,117,"Missouri","Livingston County",1,48,172,64,108
050,29,117,"Missouri","Livingston County",1,49,186,76,110
050,29,117,"Missouri","Livingston County",1,50,166,81,85
050,29,117,"Missouri","Livingston County",1,51,175,75,100
050,29,117,"Missouri","Livingston County",1,52,177,72,105
050,29,117,"Missouri","Livingston County",1,53,157,77,80
050,29,117,"Missouri","Livingston County",1,54,157,73,84
050,29,117,"Missouri","Livingston County",1,55,168,74,94
050,29,117,"Missouri","Livingston County",1,56,184,87,97
050,29,117,"Missouri","Livingston County",1,57,177,74,103
050,29,117,"Missouri","Livingston County",1,58,197,89,108
050,29,117,"Missouri","Livingston County",1,59,189,92,97
050,29,117,"Missouri","Livingston County",1,60,189,89,100
050,29,117,"Missouri","Livingston County",1,61,207,100,107
050,29,117,"Missouri","Livingston County",1,62,185,92,93
050,29,117,"Missouri","Livingston County",1,63,180,85,95
050,29,117,"Missouri","Livingston County",1,64,177,87,90
050,29,117,"Missouri","Livingston County",1,65,171,92,79
050,29,117,"Missouri","Livingston County",1,66,162,84,78
050,29,117,"Missouri","Livingston County",1,67,159,82,77
050,29,117,"Missouri","Livingston County",1,68,168,84,84
050,29,117,"Missouri","Livingston County",1,69,146,66,80
050,29,117,"Missouri","Livingston County",1,70,146,64,82
050,29,117,"Missouri","Livingston County",1,71,146,63,83
050,29,117,"Missouri","Livingston County",1,72,157,65,92
050,29,117,"Missouri","Livingston County",1,73,143,67,76
050,29,117,"Missouri","Livingston County",1,74,113,53,60
050,29,117,"Missouri","Livingston County",1,75,117,51,66
050,29,117,"Missouri","Livingston County",1,76,115,55,60
050,29,117,"Missouri","Livingston County",1,77,119,56,63
050,29,117,"Missouri","Livingston County",1,78,96,47,49
050,29,117,"Missouri","Livingston County",1,79,93,47,46
050,29,117,"Missouri","Livingston County",1,80,84,39,45
050,29,117,"Missouri","Livingston County",1,81,76,31,45
050,29,117,"Missouri","Livingston County",1,82,70,30,40
050,29,117,"Missouri","Livingston County",1,83,66,26,40
050,29,117,"Missouri","Livingston County",1,84,62,28,34
050,29,117,"Missouri","Livingston County",1,85,468,146,322
050,29,117,"Missouri","Livingston County",2,0,152,78,74
050,29,117,"Missouri","Livingston County",2,1,156,74,82
050,29,117,"Missouri","Livingston County",2,2,165,90,75
050,29,117,"Missouri","Livingston County",2,3,175,91,84
050,29,117,"Missouri","Livingston County",2,4,164,87,77
050,29,117,"Missouri","Livingston County",2,5,174,92,82
050,29,117,"Missouri","Livingston County",2,6,169,88,81
050,29,117,"Missouri","Livingston County",2,7,173,90,83
050,29,117,"Missouri","Livingston County",2,8,178,94,84
050,29,117,"Missouri","Livingston County",2,9,176,96,80
050,29,117,"Missouri","Livingston County",2,10,175,99,76
050,29,117,"Missouri","Livingston County",2,11,178,91,87
050,29,117,"Missouri","Livingston County",2,12,187,90,97
050,29,117,"Missouri","Livingston County",2,13,197,91,106
050,29,117,"Missouri","Livingston County",2,14,196,90,106
050,29,117,"Missouri","Livingston County",2,15,195,95,100
050,29,117,"Missouri","Livingston County",2,16,181,89,92
050,29,117,"Missouri","Livingston County",2,17,169,86,83
050,29,117,"Missouri","Livingston County",2,18,147,80,67
050,29,117,"Missouri","Livingston County",2,19,108,54,54
050,29,117,"Missouri","Livingston County",2,20,125,60,65
050,29,117,"Missouri","Livingston County",2,21,144,72,72
050,29,117,"Missouri","Livingston County",2,22,161,69,92
050,29,117,"Missouri","Livingston County",2,23,166,63,103
050,29,117,"Missouri","Livingston County",2,24,166,74,92
050,29,117,"Missouri","Livingston County",2,25,160,78,82
050,29,117,"Missouri","Livingston County",2,26,171,83,88
050,29,117,"Missouri","Livingston County",2,27,174,80,94
050,29,117,"Missouri","Livingston County",2,28,190,80,110
050,29,117,"Missouri","Livingston County",2,29,186,84,102
050,29,117,"Missouri","Livingston County",2,30,183,80,103
050,29,117,"Missouri","Livingston County",2,31,170,74,96
050,29,117,"Missouri","Livingston County",2,32,175,79,96
050,29,117,"Missouri","Livingston County",2,33,171,71,100
050,29,117,"Missouri","Livingston County",2,34,160,69,91
050,29,117,"Missouri","Livingston County",2,35,173,75,98
050,29,117,"Missouri","Livingston County",2,36,171,78,93
050,29,117,"Missouri","Livingston County",2,37,186,80,106
050,29,117,"Missouri","Livingston County",2,38,190,81,109
050,29,117,"Missouri","Livingston County",2,39,183,81,102
050,29,117,"Missouri","Livingston County",2,40,172,70,102
050,29,117,"Missouri","Livingston County",2,41,165,68,97
050,29,117,"Missouri","Livingston County",2,42,160,75,85
050,29,117,"Missouri","Livingston County",2,43,165,72,93
050,29,117,"Missouri","Livingston County",2,44,163,65,98
050,29,117,"Missouri","Livingston County",2,45,174,75,99
050,29,117,"Missouri","Livingston County",2,46,173,76,97
050,29,117,"Missouri","Livingston County",2,47,163,66,97
050,29,117,"Missouri","Livingston County",2,48,156,63,93
050,29,117,"Missouri","Livingston County",2,49,172,73,99
050,29,117,"Missouri","Livingston County",2,50,162,80,82
050,29,117,"Missouri","Livingston County",2,51,163,77,86
050,29,117,"Missouri","Livingston County",2,52,164,71,93
050,29,117,"Missouri","Livingston County",2,53,152,75,77
050,29,117,"Missouri","Livingston County",2,54,150,73,77
050,29,117,"Missouri","Livingston County",2,55,162,75,87
050,29,117,"Missouri","Livingston County",2,56,174,83,91
050,29,117,"Missouri","Livingston County",2,57,176,77,99
050,29,117,"Missouri","Livingston County",2,58,188,84,104
050,29,117,"Missouri","Livingston County",2,59,190,92,98
050,29,117,"Missouri","Livingston County",2,60,185,89,96
050,29,117,"Missouri","Livingston County",2,61,201,97,104
050,29,117,"Missouri","Livingston County",2,62,188,94,94
050,29,117,"Missouri","Livingston County",2,63,181,86,95
050,29,117,"Missouri","Livingston County",2,64,176,87,89
050,29,117,"Missouri","Livingston County",2,65,170,90,80
050,29,117,"Missouri","Livingston County",2,66,162,86,76
050,29,117,"Missouri","Livingston County",2,67,160,83,77
050,29,117,"Missouri","Livingston County",2,68,164,83,81
050,29,117,"Missouri","Livingston County",2,69,152,70,82
050,29,117,"Missouri","Livingston County",2,70,146,65,81
050,29,117,"Missouri","Livingston County",2,71,144,63,81
050,29,117,"Missouri","Livingston County",2,72,153,64,89
050,29,117,"Missouri","Livingston County",2,73,149,67,82
050,29,117,"Missouri","Livingston County",2,74,113,54,59
050,29,117,"Missouri","Livingston County",2,75,116,51,65
050,29,117,"Missouri","Livingston County",2,76,112,53,59
050,29,117,"Missouri","Livingston County",2,77,122,58,64
050,29,117,"Missouri","Livingston County",2,78,97,46,51
050,29,117,"Missouri","Livingston County",2,79,96,47,49
050,29,117,"Missouri","Livingston County",2,80,84,40,44
050,29,117,"Missouri","Livingston County",2,81,79,33,46
050,29,117,"Missouri","Livingston County",2,82,71,30,41
050,29,117,"Missouri","Livingston County",2,83,68,27,41
050,29,117,"Missouri","Livingston County",2,84,61,27,34
050,29,117,"Missouri","Livingston County",2,85,471,150,321
050,29,117,"Missouri","Livingston County",3,0,169,95,74
050,29,117,"Missouri","Livingston County",3,1,156,82,74
050,29,117,"Missouri","Livingston County",3,2,171,91,80
050,29,117,"Missouri","Livingston County",3,3,171,95,76
050,29,117,"Missouri","Livingston County",3,4,170,89,81
050,29,117,"Missouri","Livingston County",3,5,166,87,79
050,29,117,"Missouri","Livingston County",3,6,184,95,89
050,29,117,"Missouri","Livingston County",3,7,173,83,90
050,29,117,"Missouri","Livingston County",3,8,182,89,93
050,29,117,"Missouri","Livingston County",3,9,178,94,84
050,29,117,"Missouri","Livingston County",3,10,175,91,84
050,29,117,"Missouri","Livingston County",3,11,170,91,79
050,29,117,"Missouri","Livingston County",3,12,177,88,89
050,29,117,"Missouri","Livingston County",3,13,185,94,91
050,29,117,"Missouri","Livingston County",3,14,205,96,109
050,29,117,"Missouri","Livingston County",3,15,200,91,109
050,29,117,"Missouri","Livingston County",3,16,196,97,99
050,29,117,"Missouri","Livingston County",3,17,192,95,97
050,29,117,"Missouri","Livingston County",3,18,138,74,64
050,29,117,"Missouri","Livingston County",3,19,124,68,56
050,29,117,"Missouri","Livingston County",3,20,121,52,69
050,29,117,"Missouri","Livingston County",3,21,137,72,65
050,29,117,"Missouri","Livingston County",3,22,156,74,82
050,29,117,"Missouri","Livingston County",3,23,173,69,104
050,29,117,"Missouri","Livingston County",3,24,174,67,107
050,29,117,"Missouri","Livingston County",3,25,156,71,85
050,29,117,"Missouri","Livingston County",3,26,176,85,91
050,29,117,"Missouri","Livingston County",3,27,187,87,100
050,29,117,"Missouri","Livingston County",3,28,201,89,112
050,29,117,"Missouri","Livingston County",3,29,183,74,109
050,29,117,"Missouri","Livingston County",3,30,190,81,109
050,29,117,"Missouri","Livingston County",3,31,185,78,107
050,29,117,"Missouri","Livingston County",3,32,183,75,108
050,29,117,"Missouri","Livingston County",3,33,182,75,107
050,29,117,"Missouri","Livingston County",3,34,167,70,97
050,29,117,"Missouri","Livingston County",3,35,164,73,91
050,29,117,"Missouri","Livingston County",3,36,176,74,102
050,29,117,"Missouri","Livingston County",3,37,181,79,102
050,29,117,"Missouri","Livingston County",3,38,196,78,118
050,29,117,"Missouri","Livingston County",3,39,202,82,120
050,29,117,"Missouri","Livingston County",3,40,192,87,105
050,29,117,"Missouri","Livingston County",3,41,184,73,111
050,29,117,"Missouri","Livingston County",3,42,169,73,96
050,29,117,"Missouri","Livingston County",3,43,175,75,100
050,29,117,"Missouri","Livingston County",3,44,169,73,96
050,29,117,"Missouri","Livingston County",3,45,164,70,94
050,29,117,"Missouri","Livingston County",3,46,183,86,97
050,29,117,"Missouri","Livingston County",3,47,174,73,101
050,29,117,"Missouri","Livingston County",3,48,158,67,91
050,29,117,"Missouri","Livingston County",3,49,163,71,92
050,29,117,"Missouri","Livingston County",3,50,167,72,95
050,29,117,"Missouri","Livingston County",3,51,165,81,84
050,29,117,"Missouri","Livingston County",3,52,171,76,95
050,29,117,"Missouri","Livingston County",3,53,158,75,83
050,29,117,"Missouri","Livingston County",3,54,149,72,77
050,29,117,"Missouri","Livingston County",3,55,150,74,76
050,29,117,"Missouri","Livingston County",3,56,158,74,84
050,29,117,"Missouri","Livingston County",3,57,176,85,91
050,29,117,"Missouri","Livingston County",3,58,183,78,105
050,29,117,"Missouri","Livingston County",3,59,186,88,98
050,29,117,"Missouri","Livingston County",3,60,184,84,100
050,29,117,"Missouri","Livingston County",3,61,185,92,93
050,29,117,"Missouri","Livingston County",3,62,189,96,93
050,29,117,"Missouri","Livingston County",3,63,190,93,97
050,29,117,"Missouri","Livingston County",3,64,180,88,92
050,29,117,"Missouri","Livingston County",3,65,174,84,90
050,29,117,"Missouri","Livingston County",3,66,168,91,77
050,29,117,"Missouri","Livingston County",3,67,164,86,78
050,29,117,"Missouri","Livingston County",3,68,157,79,78
050,29,117,"Missouri","Livingston County",3,69,162,78,84
050,29,117,"Missouri","Livingston County",3,70,146,65,81
050,29,117,"Missouri","Livingston County",3,71,143,64,79
050,29,117,"Missouri","Livingston County",3,72,150,64,86
050,29,117,"Missouri","Livingston County",3,73,138,59,79
050,29,117,"Missouri","Livingston County",3,74,149,71,78
050,29,117,"Missouri","Livingston County",3,75,104,45,59
050,29,117,"Missouri","Livingston County",3,76,113,51,62
050,29,117,"Missouri","Livingston County",3,77,116,56,60
050,29,117,"Missouri","Livingston County",3,78,108,51,57
050,29,117,"Missouri","Livingston County",3,79,103,47,56
050,29,117,"Missouri","Livingston County",3,80,80,45,35
050,29,117,"Missouri","Livingston County",3,81,76,35,41
050,29,117,"Missouri","Livingston County",3,82,67,27,40
050,29,117,"Missouri","Livingston County",3,83,67,26,41
050,29,117,"Missouri","Livingston County",3,84,60,24,36
050,29,117,"Missouri","Livingston County",3,85,452,149,303
050,29,117,"Missouri","Livingston County",4,0,154,79,75
050,29,117,"Missouri","Livingston County",4,1,154,83,71
050,29,117,"Missouri","Livingston County",4,2,156,83,73
050,29,117,"Missouri","Livingston County",4,3,166,88,78
050,29,117,"Missouri","Livingston County",4,4,165,96,69
050,29,117,"Missouri","Livingston County",4,5,169,90,79
050,29,117,"Missouri","Livingston County",4,6,167,85,82
050,29,117,"Missouri","Livingston County",4,7,180,90,90
050,29,117,"Missouri","Livingston County",4,8,175,85,90
050,29,117,"Missouri","Livingston County",4,9,186,92,94
050,29,117,"Missouri","Livingston County",4,10,177,96,81
050,29,117,"Missouri","Livingston County",4,11,175,90,85
050,29,117,"Missouri","Livingston County",4,12,165,87,78
050,29,117,"Missouri","Livingston County",4,13,177,92,85
050,29,117,"Missouri","Livingston County",4,14,189,97,92
050,29,117,"Missouri","Livingston County",4,15,192,90,102
050,29,117,"Missouri","Livingston County",4,16,197,90,107
050,29,117,"Missouri","Livingston County",4,17,193,98,95
050,29,117,"Missouri","Livingston County",4,18,157,82,75
050,29,117,"Missouri","Livingston County",4,19,106,54,52
050,29,117,"Missouri","Livingston County",4,20,142,77,65
050,29,117,"Missouri","Livingston County",4,21,128,51,77
050,29,117,"Missouri","Livingston County",4,22,155,77,78
050,29,117,"Missouri","Livingston County",4,23,185,76,109
050,29,117,"Missouri","Livingston County",4,24,165,71,94
050,29,117,"Missouri","Livingston County",4,25,179,69,110
050,29,117,"Missouri","Livingston County",4,26,158,70,88
050,29,117,"Missouri","Livingston County",4,27,187,84,103
050,29,117,"Missouri","Livingston County",4,28,225,97,128
050,29,117,"Missouri","Livingston County",4,29,199,83,116
050,29,117,"Missouri","Livingston County",4,30,191,72,119
050,29,117,"Missouri","Livingston County",4,31,195,79,116
050,29,117,"Missouri","Livingston County",4,32,206,85,121
050,29,117,"Missouri","Livingston County",4,33,199,73,126
050,29,117,"Missouri","Livingston County",4,34,174,73,101
050,29,117,"Missouri","Livingston County",4,35,178,76,102
050,29,117,"Missouri","Livingston County",4,36,163,71,92
050,29,117,"Missouri","Livingston County",4,37,186,77,109
050,29,117,"Missouri","Livingston County",4,38,194,82,112
050,29,117,"Missouri","Livingston County",4,39,201,78,123
050,29,117,"Missouri","Livingston County",4,40,206,79,127
050,29,117,"Missouri","Livingston County",4,41,201,86,115
050,29,117,"Missouri","Livingston County",4,42,183,72,111
050,29,117,"Missouri","Livingston County",4,43,182,68,114
050,29,117,"Missouri","Livingston County",4,44,197,77,120
050,29,117,"Missouri","Livingston County",4,45,171,74,97
050,29,117,"Missouri","Livingston County",4,46,163,71,92
050,29,117,"Missouri","Livingston County",4,47,183,79,104
050,29,117,"Missouri","Livingston County",4,48,178,72,106
050,29,117,"Missouri","Livingston County",4,49,157,67,90
050,29,117,"Missouri","Livingston County",4,50,166,72,94
050,29,117,"Missouri","Livingston County",4,51,184,73,111
050,29,117,"Missouri","Livingston County",4,52,177,80,97
050,29,117,"Missouri","Livingston County",4,53,159,76,83
050,29,117,"Missouri","Livingston County",4,54,160,74,86
050,29,117,"Missouri","Livingston County",4,55,151,75,76
050,29,117,"Missouri","Livingston County",4,56,148,71,77
050,29,117,"Missouri","Livingston County",4,57,151,66,85
050,29,117,"Missouri","Livingston County",4,58,184,85,99
050,29,117,"Missouri","Livingston County",4,59,176,81,95
050,29,117,"Missouri","Livingston County",4,60,189,82,107
050,29,117,"Missouri","Livingston County",4,61,190,85,105
050,29,117,"Missouri","Livingston County",4,62,183,95,88
050,29,117,"Missouri","Livingston County",4,63,189,94,95
050,29,117,"Missouri","Livingston County",4,64,186,90,96
050,29,117,"Missouri","Livingston County",4,65,174,85,89
050,29,117,"Missouri","Livingston County",4,66,177,90,87
050,29,117,"Missouri","Livingston County",4,67,165,89,76
050,29,117,"Missouri","Livingston County",4,68,163,83,80
050,29,117,"Missouri","Livingston County",4,69,154,74,80
050,29,117,"Missouri","Livingston County",4,70,154,76,78
050,29,117,"Missouri","Livingston County",4,71,145,65,80
050,29,117,"Missouri","Livingston County",4,72,144,64,80
050,29,117,"Missouri","Livingston County",4,73,142,63,79
050,29,117,"Missouri","Livingston County",4,74,132,59,73
050,29,117,"Missouri","Livingston County",4,75,142,65,77
050,29,117,"Missouri","Livingston County",4,76,97,45,52
050,29,117,"Missouri","Livingston County",4,77,117,51,66
050,29,117,"Missouri","Livingston County",4,78,100,48,52
050,29,117,"Missouri","Livingston County",4,79,115,52,63
050,29,117,"Missouri","Livingston County",4,80,93,47,46
050,29,117,"Missouri","Livingston County",4,81,74,40,34
050,29,117,"Missouri","Livingston County",4,82,64,29,35
050,29,117,"Missouri","Livingston County",4,83,71,30,41
050,29,117,"Missouri","Livingston County",4,84,57,21,36
050,29,117,"Missouri","Livingston County",4,85,431,142,289
050,29,117,"Missouri","Livingston County",5,0,153,80,73
050,29,117,"Missouri","Livingston County",5,1,162,79,83
050,29,117,"Missouri","Livingston County",5,2,148,79,69
050,29,117,"Missouri","Livingston County",5,3,159,87,72
050,29,117,"Missouri","Livingston County",5,4,163,90,73
050,29,117,"Missouri","Livingston County",5,5,174,103,71
050,29,117,"Missouri","Livingston County",5,6,170,93,77
050,29,117,"Missouri","Livingston County",5,7,174,89,85
050,29,117,"Missouri","Livingston County",5,8,182,93,89
050,29,117,"Missouri","Livingston County",5,9,185,93,92
050,29,117,"Missouri","Livingston County",5,10,197,99,98
050,29,117,"Missouri","Livingston County",5,11,175,97,78
050,29,117,"Missouri","Livingston County",5,12,182,95,87
050,29,117,"Missouri","Livingston County",5,13,173,92,81
050,29,117,"Missouri","Livingston County",5,14,178,90,88
050,29,117,"Missouri","Livingston County",5,15,195,98,97
050,29,117,"Missouri","Livingston County",5,16,212,98,114
050,29,117,"Missouri","Livingston County",5,17,199,98,101
050,29,117,"Missouri","Livingston County",5,18,154,84,70
050,29,117,"Missouri","Livingston County",5,19,126,66,60
050,29,117,"Missouri","Livingston County",5,20,126,58,68
050,29,117,"Missouri","Livingston County",5,21,150,78,72
050,29,117,"Missouri","Livingston County",5,22,140,46,94
050,29,117,"Missouri","Livingston County",5,23,167,73,94
050,29,117,"Missouri","Livingston County",5,24,157,63,94
050,29,117,"Missouri","Livingston County",5,25,177,71,106
050,29,117,"Missouri","Livingston County",5,26,187,77,110
050,29,117,"Missouri","Livingston County",5,27,162,64,98
050,29,117,"Missouri","Livingston County",5,28,216,91,125
050,29,117,"Missouri","Livingston County",5,29,200,88,112
050,29,117,"Missouri","Livingston County",5,30,214,89,125
050,29,117,"Missouri","Livingston County",5,31,205,72,133
050,29,117,"Missouri","Livingston County",5,32,211,88,123
050,29,117,"Missouri","Livingston County",5,33,216,83,133
050,29,117,"Missouri","Livingston County",5,34,193,77,116
050,29,117,"Missouri","Livingston County",5,35,194,77,117
050,29,117,"Missouri","Livingston County",5,36,175,77,98
050,29,117,"Missouri","Livingston County",5,37,180,79,101
050,29,117,"Missouri","Livingston County",5,38,206,79,127
050,29,117,"Missouri","Livingston County",5,39,195,80,115
050,29,117,"Missouri","Livingston County",5,40,214,76,138
050,29,117,"Missouri","Livingston County",5,41,213,83,130
050,29,117,"Missouri","Livingston County",5,42,197,86,111
050,29,117,"Missouri","Livingston County",5,43,197,71,126
050,29,117,"Missouri","Livingston County",5,44,196,64,132
050,29,117,"Missouri","Livingston County",5,45,184,77,107
050,29,117,"Missouri","Livingston County",5,46,174,78,96
050,29,117,"Missouri","Livingston County",5,47,165,69,96
050,29,117,"Missouri","Livingston County",5,48,181,82,99
050,29,117,"Missouri","Livingston County",5,49,175,73,102
050,29,117,"Missouri","Livingston County",5,50,154,67,87
050,29,117,"Missouri","Livingston County",5,51,178,71,107
050,29,117,"Missouri","Livingston County",5,52,193,76,117
050,29,117,"Missouri","Livingston County",5,53,154,76,78
050,29,117,"Missouri","Livingston County",5,54,163,76,87
050,29,117,"Missouri","Livingston County",5,55,163,74,89
050,29,117,"Missouri","Livingston County",5,56,151,73,78
050,29,117,"Missouri","Livingston County",5,57,147,73,74
050,29,117,"Missouri","Livingston County",5,58,160,70,90
050,29,117,"Missouri","Livingston County",5,59,179,89,90
050,29,117,"Missouri","Livingston County",5,60,185,81,104
050,29,117,"Missouri","Livingston County",5,61,195,89,106
050,29,117,"Missouri","Livingston County",5,62,186,84,102
050,29,117,"Missouri","Livingston County",5,63,183,93,90
050,29,117,"Missouri","Livingston County",5,64,182,89,93
050,29,117,"Missouri","Livingston County",5,65,182,85,97
050,29,117,"Missouri","Livingston County",5,66,170,88,82
050,29,117,"Missouri","Livingston County",5,67,174,90,84
050,29,117,"Missouri","Livingston County",5,68,160,85,75
050,29,117,"Missouri","Livingston County",5,69,160,79,81
050,29,117,"Missouri","Livingston County",5,70,149,74,75
050,29,117,"Missouri","Livingston County",5,71,151,74,77
050,29,117,"Missouri","Livingston County",5,72,150,69,81
050,29,117,"Missouri","Livingston County",5,73,138,63,75
050,29,117,"Missouri","Livingston County",5,74,134,64,70
050,29,117,"Missouri","Livingston County",5,75,133,58,75
050,29,117,"Missouri","Livingston County",5,76,137,62,75
050,29,117,"Missouri","Livingston County",5,77,98,47,51
050,29,117,"Missouri","Livingston County",5,78,101,43,58
050,29,117,"Missouri","Livingston County",5,79,110,51,59
050,29,117,"Missouri","Livingston County",5,80,107,51,56
050,29,117,"Missouri","Livingston County",5,81,92,46,46
050,29,117,"Missouri","Livingston County",5,82,64,34,30
050,29,117,"Missouri","Livingston County",5,83,63,28,35
050,29,117,"Missouri","Livingston County",5,84,58,25,33
050,29,117,"Missouri","Livingston County",5,85,425,139,286
050,29,119,"Missouri","McDonald County",1,0,332,170,162
050,29,119,"Missouri","McDonald County",1,1,335,171,164
050,29,119,"Missouri","McDonald County",1,2,336,175,161
050,29,119,"Missouri","McDonald County",1,3,351,186,165
050,29,119,"Missouri","McDonald County",1,4,350,191,159
050,29,119,"Missouri","McDonald County",1,5,318,175,143
050,29,119,"Missouri","McDonald County",1,6,327,182,145
050,29,119,"Missouri","McDonald County",1,7,308,147,161
050,29,119,"Missouri","McDonald County",1,8,282,146,136
050,29,119,"Missouri","McDonald County",1,9,299,156,143
050,29,119,"Missouri","McDonald County",1,10,328,156,172
050,29,119,"Missouri","McDonald County",1,11,354,171,183
050,29,119,"Missouri","McDonald County",1,12,351,179,172
050,29,119,"Missouri","McDonald County",1,13,332,182,150
050,29,119,"Missouri","McDonald County",1,14,353,189,164
050,29,119,"Missouri","McDonald County",1,15,332,176,156
050,29,119,"Missouri","McDonald County",1,16,347,175,172
050,29,119,"Missouri","McDonald County",1,17,355,187,168
050,29,119,"Missouri","McDonald County",1,18,307,154,153
050,29,119,"Missouri","McDonald County",1,19,243,131,112
050,29,119,"Missouri","McDonald County",1,20,260,123,137
050,29,119,"Missouri","McDonald County",1,21,265,128,137
050,29,119,"Missouri","McDonald County",1,22,261,134,127
050,29,119,"Missouri","McDonald County",1,23,296,151,145
050,29,119,"Missouri","McDonald County",1,24,273,157,116
050,29,119,"Missouri","McDonald County",1,25,263,145,118
050,29,119,"Missouri","McDonald County",1,26,283,141,142
050,29,119,"Missouri","McDonald County",1,27,278,145,133
050,29,119,"Missouri","McDonald County",1,28,288,152,136
050,29,119,"Missouri","McDonald County",1,29,263,129,134
050,29,119,"Missouri","McDonald County",1,30,277,145,132
050,29,119,"Missouri","McDonald County",1,31,260,136,124
050,29,119,"Missouri","McDonald County",1,32,268,127,141
050,29,119,"Missouri","McDonald County",1,33,266,147,119
050,29,119,"Missouri","McDonald County",1,34,258,139,119
050,29,119,"Missouri","McDonald County",1,35,261,139,122
050,29,119,"Missouri","McDonald County",1,36,254,123,131
050,29,119,"Missouri","McDonald County",1,37,292,140,152
050,29,119,"Missouri","McDonald County",1,38,275,152,123
050,29,119,"Missouri","McDonald County",1,39,296,146,150
050,29,119,"Missouri","McDonald County",1,40,282,134,148
050,29,119,"Missouri","McDonald County",1,41,295,145,150
050,29,119,"Missouri","McDonald County",1,42,278,132,146
050,29,119,"Missouri","McDonald County",1,43,294,148,146
050,29,119,"Missouri","McDonald County",1,44,263,134,129
050,29,119,"Missouri","McDonald County",1,45,288,145,143
050,29,119,"Missouri","McDonald County",1,46,281,129,152
050,29,119,"Missouri","McDonald County",1,47,283,148,135
050,29,119,"Missouri","McDonald County",1,48,301,168,133
050,29,119,"Missouri","McDonald County",1,49,329,173,156
050,29,119,"Missouri","McDonald County",1,50,315,161,154
050,29,119,"Missouri","McDonald County",1,51,325,160,165
050,29,119,"Missouri","McDonald County",1,52,329,163,166
050,29,119,"Missouri","McDonald County",1,53,312,162,150
050,29,119,"Missouri","McDonald County",1,54,314,153,161
050,29,119,"Missouri","McDonald County",1,55,334,178,156
050,29,119,"Missouri","McDonald County",1,56,354,183,171
050,29,119,"Missouri","McDonald County",1,57,351,184,167
050,29,119,"Missouri","McDonald County",1,58,352,176,176
050,29,119,"Missouri","McDonald County",1,59,317,158,159
050,29,119,"Missouri","McDonald County",1,60,321,162,159
050,29,119,"Missouri","McDonald County",1,61,330,168,162
050,29,119,"Missouri","McDonald County",1,62,328,174,154
050,29,119,"Missouri","McDonald County",1,63,321,164,157
050,29,119,"Missouri","McDonald County",1,64,279,139,140
050,29,119,"Missouri","McDonald County",1,65,256,118,138
050,29,119,"Missouri","McDonald County",1,66,245,122,123
050,29,119,"Missouri","McDonald County",1,67,229,117,112
050,29,119,"Missouri","McDonald County",1,68,248,126,122
050,29,119,"Missouri","McDonald County",1,69,222,116,106
050,29,119,"Missouri","McDonald County",1,70,189,97,92
050,29,119,"Missouri","McDonald County",1,71,214,109,105
050,29,119,"Missouri","McDonald County",1,72,208,94,114
050,29,119,"Missouri","McDonald County",1,73,202,104,98
050,29,119,"Missouri","McDonald County",1,74,149,76,73
050,29,119,"Missouri","McDonald County",1,75,151,78,73
050,29,119,"Missouri","McDonald County",1,76,144,57,87
050,29,119,"Missouri","McDonald County",1,77,158,72,86
050,29,119,"Missouri","McDonald County",1,78,122,59,63
050,29,119,"Missouri","McDonald County",1,79,107,50,57
050,29,119,"Missouri","McDonald County",1,80,103,56,47
050,29,119,"Missouri","McDonald County",1,81,95,51,44
050,29,119,"Missouri","McDonald County",1,82,79,40,39
050,29,119,"Missouri","McDonald County",1,83,67,24,43
050,29,119,"Missouri","McDonald County",1,84,62,20,42
050,29,119,"Missouri","McDonald County",1,85,298,123,175
050,29,119,"Missouri","McDonald County",2,0,327,168,159
050,29,119,"Missouri","McDonald County",2,1,336,172,164
050,29,119,"Missouri","McDonald County",2,2,336,173,163
050,29,119,"Missouri","McDonald County",2,3,346,182,164
050,29,119,"Missouri","McDonald County",2,4,345,187,158
050,29,119,"Missouri","McDonald County",2,5,324,180,144
050,29,119,"Missouri","McDonald County",2,6,324,179,145
050,29,119,"Missouri","McDonald County",2,7,310,153,157
050,29,119,"Missouri","McDonald County",2,8,284,143,141
050,29,119,"Missouri","McDonald County",2,9,294,151,143
050,29,119,"Missouri","McDonald County",2,10,321,157,164
050,29,119,"Missouri","McDonald County",2,11,348,170,178
050,29,119,"Missouri","McDonald County",2,12,349,175,174
050,29,119,"Missouri","McDonald County",2,13,338,181,157
050,29,119,"Missouri","McDonald County",2,14,348,187,161
050,29,119,"Missouri","McDonald County",2,15,339,180,159
050,29,119,"Missouri","McDonald County",2,16,343,176,167
050,29,119,"Missouri","McDonald County",2,17,353,183,170
050,29,119,"Missouri","McDonald County",2,18,305,158,147
050,29,119,"Missouri","McDonald County",2,19,248,131,117
050,29,119,"Missouri","McDonald County",2,20,259,127,132
050,29,119,"Missouri","McDonald County",2,21,261,125,136
050,29,119,"Missouri","McDonald County",2,22,264,132,132
050,29,119,"Missouri","McDonald County",2,23,291,148,143
050,29,119,"Missouri","McDonald County",2,24,281,156,125
050,29,119,"Missouri","McDonald County",2,25,268,148,120
050,29,119,"Missouri","McDonald County",2,26,276,141,135
050,29,119,"Missouri","McDonald County",2,27,282,147,135
050,29,119,"Missouri","McDonald County",2,28,284,150,134
050,29,119,"Missouri","McDonald County",2,29,271,135,136
050,29,119,"Missouri","McDonald County",2,30,272,141,131
050,29,119,"Missouri","McDonald County",2,31,264,136,128
050,29,119,"Missouri","McDonald County",2,32,265,129,136
050,29,119,"Missouri","McDonald County",2,33,261,139,122
050,29,119,"Missouri","McDonald County",2,34,259,140,119
050,29,119,"Missouri","McDonald County",2,35,262,139,123
050,29,119,"Missouri","McDonald County",2,36,254,125,129
050,29,119,"Missouri","McDonald County",2,37,282,136,146
050,29,119,"Missouri","McDonald County",2,38,280,149,131
050,29,119,"Missouri","McDonald County",2,39,286,144,142
050,29,119,"Missouri","McDonald County",2,40,287,138,149
050,29,119,"Missouri","McDonald County",2,41,292,144,148
050,29,119,"Missouri","McDonald County",2,42,280,135,145
050,29,119,"Missouri","McDonald County",2,43,289,144,145
050,29,119,"Missouri","McDonald County",2,44,270,138,132
050,29,119,"Missouri","McDonald County",2,45,281,142,139
050,29,119,"Missouri","McDonald County",2,46,282,133,149
050,29,119,"Missouri","McDonald County",2,47,283,144,139
050,29,119,"Missouri","McDonald County",2,48,299,164,135
050,29,119,"Missouri","McDonald County",2,49,325,174,151
050,29,119,"Missouri","McDonald County",2,50,318,164,154
050,29,119,"Missouri","McDonald County",2,51,316,157,159
050,29,119,"Missouri","McDonald County",2,52,328,162,166
050,29,119,"Missouri","McDonald County",2,53,315,160,155
050,29,119,"Missouri","McDonald County",2,54,312,156,156
050,29,119,"Missouri","McDonald County",2,55,332,174,158
050,29,119,"Missouri","McDonald County",2,56,351,183,168
050,29,119,"Missouri","McDonald County",2,57,351,183,168
050,29,119,"Missouri","McDonald County",2,58,351,176,175
050,29,119,"Missouri","McDonald County",2,59,325,163,162
050,29,119,"Missouri","McDonald County",2,60,322,160,162
050,29,119,"Missouri","McDonald County",2,61,328,167,161
050,29,119,"Missouri","McDonald County",2,62,329,174,155
050,29,119,"Missouri","McDonald County",2,63,325,168,157
050,29,119,"Missouri","McDonald County",2,64,286,142,144
050,29,119,"Missouri","McDonald County",2,65,260,122,138
050,29,119,"Missouri","McDonald County",2,66,250,123,127
050,29,119,"Missouri","McDonald County",2,67,229,115,114
050,29,119,"Missouri","McDonald County",2,68,240,122,118
050,29,119,"Missouri","McDonald County",2,69,229,119,110
050,29,119,"Missouri","McDonald County",2,70,197,102,95
050,29,119,"Missouri","McDonald County",2,71,205,103,102
050,29,119,"Missouri","McDonald County",2,72,205,95,110
050,29,119,"Missouri","McDonald County",2,73,213,105,108
050,29,119,"Missouri","McDonald County",2,74,150,77,73
050,29,119,"Missouri","McDonald County",2,75,149,78,71
050,29,119,"Missouri","McDonald County",2,76,144,62,82
050,29,119,"Missouri","McDonald County",2,77,155,68,87
050,29,119,"Missouri","McDonald County",2,78,128,61,67
050,29,119,"Missouri","McDonald County",2,79,110,52,58
050,29,119,"Missouri","McDonald County",2,80,101,53,48
050,29,119,"Missouri","McDonald County",2,81,92,51,41
050,29,119,"Missouri","McDonald County",2,82,79,41,38
050,29,119,"Missouri","McDonald County",2,83,68,26,42
050,29,119,"Missouri","McDonald County",2,84,62,20,42
050,29,119,"Missouri","McDonald County",2,85,297,120,177
050,29,119,"Missouri","McDonald County",3,0,314,157,157
050,29,119,"Missouri","McDonald County",3,1,311,167,144
050,29,119,"Missouri","McDonald County",3,2,334,176,158
050,29,119,"Missouri","McDonald County",3,3,346,176,170
050,29,119,"Missouri","McDonald County",3,4,332,175,157
050,29,119,"Missouri","McDonald County",3,5,354,185,169
050,29,119,"Missouri","McDonald County",3,6,336,182,154
050,29,119,"Missouri","McDonald County",3,7,331,185,146
050,29,119,"Missouri","McDonald County",3,8,319,157,162
050,29,119,"Missouri","McDonald County",3,9,293,146,147
050,29,119,"Missouri","McDonald County",3,10,306,158,148
050,29,119,"Missouri","McDonald County",3,11,311,159,152
050,29,119,"Missouri","McDonald County",3,12,339,163,176
050,29,119,"Missouri","McDonald County",3,13,367,186,181
050,29,119,"Missouri","McDonald County",3,14,352,193,159
050,29,119,"Missouri","McDonald County",3,15,360,197,163
050,29,119,"Missouri","McDonald County",3,16,342,184,158
050,29,119,"Missouri","McDonald County",3,17,342,180,162
050,29,119,"Missouri","McDonald County",3,18,312,165,147
050,29,119,"Missouri","McDonald County",3,19,264,133,131
050,29,119,"Missouri","McDonald County",3,20,249,136,113
050,29,119,"Missouri","McDonald County",3,21,257,126,131
050,29,119,"Missouri","McDonald County",3,22,257,126,131
050,29,119,"Missouri","McDonald County",3,23,274,141,133
050,29,119,"Missouri","McDonald County",3,24,278,147,131
050,29,119,"Missouri","McDonald County",3,25,281,149,132
050,29,119,"Missouri","McDonald County",3,26,267,152,115
050,29,119,"Missouri","McDonald County",3,27,258,134,124
050,29,119,"Missouri","McDonald County",3,28,269,135,134
050,29,119,"Missouri","McDonald County",3,29,279,138,141
050,29,119,"Missouri","McDonald County",3,30,281,142,139
050,29,119,"Missouri","McDonald County",3,31,267,134,133
050,29,119,"Missouri","McDonald County",3,32,276,140,136
050,29,119,"Missouri","McDonald County",3,33,286,152,134
050,29,119,"Missouri","McDonald County",3,34,272,138,134
050,29,119,"Missouri","McDonald County",3,35,275,150,125
050,29,119,"Missouri","McDonald County",3,36,280,147,133
050,29,119,"Missouri","McDonald County",3,37,251,127,124
050,29,119,"Missouri","McDonald County",3,38,278,133,145
050,29,119,"Missouri","McDonald County",3,39,277,150,127
050,29,119,"Missouri","McDonald County",3,40,275,139,136
050,29,119,"Missouri","McDonald County",3,41,306,145,161
050,29,119,"Missouri","McDonald County",3,42,302,147,155
050,29,119,"Missouri","McDonald County",3,43,282,130,152
050,29,119,"Missouri","McDonald County",3,44,292,139,153
050,29,119,"Missouri","McDonald County",3,45,281,143,138
050,29,119,"Missouri","McDonald County",3,46,291,143,148
050,29,119,"Missouri","McDonald County",3,47,277,132,145
050,29,119,"Missouri","McDonald County",3,48,281,143,138
050,29,119,"Missouri","McDonald County",3,49,306,169,137
050,29,119,"Missouri","McDonald County",3,50,329,174,155
050,29,119,"Missouri","McDonald County",3,51,307,159,148
050,29,119,"Missouri","McDonald County",3,52,315,160,155
050,29,119,"Missouri","McDonald County",3,53,330,164,166
050,29,119,"Missouri","McDonald County",3,54,320,160,160
050,29,119,"Missouri","McDonald County",3,55,316,155,161
050,29,119,"Missouri","McDonald County",3,56,329,169,160
050,29,119,"Missouri","McDonald County",3,57,350,182,168
050,29,119,"Missouri","McDonald County",3,58,346,179,167
050,29,119,"Missouri","McDonald County",3,59,343,173,170
050,29,119,"Missouri","McDonald County",3,60,331,169,162
050,29,119,"Missouri","McDonald County",3,61,316,162,154
050,29,119,"Missouri","McDonald County",3,62,336,167,169
050,29,119,"Missouri","McDonald County",3,63,322,171,151
050,29,119,"Missouri","McDonald County",3,64,328,165,163
050,29,119,"Missouri","McDonald County",3,65,267,136,131
050,29,119,"Missouri","McDonald County",3,66,257,124,133
050,29,119,"Missouri","McDonald County",3,67,242,114,128
050,29,119,"Missouri","McDonald County",3,68,225,115,110
050,29,119,"Missouri","McDonald County",3,69,242,125,117
050,29,119,"Missouri","McDonald County",3,70,221,117,104
050,29,119,"Missouri","McDonald County",3,71,191,98,93
050,29,119,"Missouri","McDonald County",3,72,201,99,102
050,29,119,"Missouri","McDonald County",3,73,193,93,100
050,29,119,"Missouri","McDonald County",3,74,207,100,107
050,29,119,"Missouri","McDonald County",3,75,139,71,68
050,29,119,"Missouri","McDonald County",3,76,147,78,69
050,29,119,"Missouri","McDonald County",3,77,133,54,79
050,29,119,"Missouri","McDonald County",3,78,151,66,85
050,29,119,"Missouri","McDonald County",3,79,123,59,64
050,29,119,"Missouri","McDonald County",3,80,104,45,59
050,29,119,"Missouri","McDonald County",3,81,93,49,44
050,29,119,"Missouri","McDonald County",3,82,81,49,32
050,29,119,"Missouri","McDonald County",3,83,72,34,38
050,29,119,"Missouri","McDonald County",3,84,65,25,40
050,29,119,"Missouri","McDonald County",3,85,287,108,179
050,29,119,"Missouri","McDonald County",4,0,318,163,155
050,29,119,"Missouri","McDonald County",4,1,309,153,156
050,29,119,"Missouri","McDonald County",4,2,303,162,141
050,29,119,"Missouri","McDonald County",4,3,337,175,162
050,29,119,"Missouri","McDonald County",4,4,325,161,164
050,29,119,"Missouri","McDonald County",4,5,345,176,169
050,29,119,"Missouri","McDonald County",4,6,352,187,165
050,29,119,"Missouri","McDonald County",4,7,333,172,161
050,29,119,"Missouri","McDonald County",4,8,324,177,147
050,29,119,"Missouri","McDonald County",4,9,314,153,161
050,29,119,"Missouri","McDonald County",4,10,307,149,158
050,29,119,"Missouri","McDonald County",4,11,307,169,138
050,29,119,"Missouri","McDonald County",4,12,335,175,160
050,29,119,"Missouri","McDonald County",4,13,351,173,178
050,29,119,"Missouri","McDonald County",4,14,351,181,170
050,29,119,"Missouri","McDonald County",4,15,362,202,160
050,29,119,"Missouri","McDonald County",4,16,363,202,161
050,29,119,"Missouri","McDonald County",4,17,335,185,150
050,29,119,"Missouri","McDonald County",4,18,302,157,145
050,29,119,"Missouri","McDonald County",4,19,246,130,116
050,29,119,"Missouri","McDonald County",4,20,271,135,136
050,29,119,"Missouri","McDonald County",4,21,259,135,124
050,29,119,"Missouri","McDonald County",4,22,273,138,135
050,29,119,"Missouri","McDonald County",4,23,278,132,146
050,29,119,"Missouri","McDonald County",4,24,282,138,144
050,29,119,"Missouri","McDonald County",4,25,261,137,124
050,29,119,"Missouri","McDonald County",4,26,289,156,133
050,29,119,"Missouri","McDonald County",4,27,267,152,115
050,29,119,"Missouri","McDonald County",4,28,262,134,128
050,29,119,"Missouri","McDonald County",4,29,268,130,138
050,29,119,"Missouri","McDonald County",4,30,297,154,143
050,29,119,"Missouri","McDonald County",4,31,276,134,142
050,29,119,"Missouri","McDonald County",4,32,285,147,138
050,29,119,"Missouri","McDonald County",4,33,285,147,138
050,29,119,"Missouri","McDonald County",4,34,290,155,135
050,29,119,"Missouri","McDonald County",4,35,271,141,130
050,29,119,"Missouri","McDonald County",4,36,271,146,125
050,29,119,"Missouri","McDonald County",4,37,300,156,144
050,29,119,"Missouri","McDonald County",4,38,250,124,126
050,29,119,"Missouri","McDonald County",4,39,275,128,147
050,29,119,"Missouri","McDonald County",4,40,273,144,129
050,29,119,"Missouri","McDonald County",4,41,280,142,138
050,29,119,"Missouri","McDonald County",4,42,296,141,155
050,29,119,"Missouri","McDonald County",4,43,295,147,148
050,29,119,"Missouri","McDonald County",4,44,280,129,151
050,29,119,"Missouri","McDonald County",4,45,294,148,146
050,29,119,"Missouri","McDonald County",4,46,276,136,140
050,29,119,"Missouri","McDonald County",4,47,291,144,147
050,29,119,"Missouri","McDonald County",4,48,285,134,151
050,29,119,"Missouri","McDonald County",4,49,284,145,139
050,29,119,"Missouri","McDonald County",4,50,312,173,139
050,29,119,"Missouri","McDonald County",4,51,335,180,155
050,29,119,"Missouri","McDonald County",4,52,307,158,149
050,29,119,"Missouri","McDonald County",4,53,328,164,164
050,29,119,"Missouri","McDonald County",4,54,334,167,167
050,29,119,"Missouri","McDonald County",4,55,324,161,163
050,29,119,"Missouri","McDonald County",4,56,313,151,162
050,29,119,"Missouri","McDonald County",4,57,333,173,160
050,29,119,"Missouri","McDonald County",4,58,342,177,165
050,29,119,"Missouri","McDonald County",4,59,343,175,168
050,29,119,"Missouri","McDonald County",4,60,341,171,170
050,29,119,"Missouri","McDonald County",4,61,321,164,157
050,29,119,"Missouri","McDonald County",4,62,322,167,155
050,29,119,"Missouri","McDonald County",4,63,324,161,163
050,29,119,"Missouri","McDonald County",4,64,318,166,152
050,29,119,"Missouri","McDonald County",4,65,324,160,164
050,29,119,"Missouri","McDonald County",4,66,272,137,135
050,29,119,"Missouri","McDonald County",4,67,248,122,126
050,29,119,"Missouri","McDonald County",4,68,247,118,129
050,29,119,"Missouri","McDonald County",4,69,217,115,102
050,29,119,"Missouri","McDonald County",4,70,239,122,117
050,29,119,"Missouri","McDonald County",4,71,225,118,107
050,29,119,"Missouri","McDonald County",4,72,185,92,93
050,29,119,"Missouri","McDonald County",4,73,192,93,99
050,29,119,"Missouri","McDonald County",4,74,185,88,97
050,29,119,"Missouri","McDonald County",4,75,201,96,105
050,29,119,"Missouri","McDonald County",4,76,139,75,64
050,29,119,"Missouri","McDonald County",4,77,133,69,64
050,29,119,"Missouri","McDonald County",4,78,128,51,77
050,29,119,"Missouri","McDonald County",4,79,142,64,78
050,29,119,"Missouri","McDonald County",4,80,122,58,64
050,29,119,"Missouri","McDonald County",4,81,93,38,55
050,29,119,"Missouri","McDonald County",4,82,88,47,41
050,29,119,"Missouri","McDonald County",4,83,78,46,32
050,29,119,"Missouri","McDonald County",4,84,67,35,32
050,29,119,"Missouri","McDonald County",4,85,288,99,189
050,29,119,"Missouri","McDonald County",5,0,334,174,160
050,29,119,"Missouri","McDonald County",5,1,339,175,164
050,29,119,"Missouri","McDonald County",5,2,310,154,156
050,29,119,"Missouri","McDonald County",5,3,311,168,143
050,29,119,"Missouri","McDonald County",5,4,347,186,161
050,29,119,"Missouri","McDonald County",5,5,332,164,168
050,29,119,"Missouri","McDonald County",5,6,338,171,167
050,29,119,"Missouri","McDonald County",5,7,345,174,171
050,29,119,"Missouri","McDonald County",5,8,323,169,154
050,29,119,"Missouri","McDonald County",5,9,320,177,143
050,29,119,"Missouri","McDonald County",5,10,321,162,159
050,29,119,"Missouri","McDonald County",5,11,305,152,153
050,29,119,"Missouri","McDonald County",5,12,297,170,127
050,29,119,"Missouri","McDonald County",5,13,342,183,159
050,29,119,"Missouri","McDonald County",5,14,358,174,184
050,29,119,"Missouri","McDonald County",5,15,360,194,166
050,29,119,"Missouri","McDonald County",5,16,356,202,154
050,29,119,"Missouri","McDonald County",5,17,365,206,159
050,29,119,"Missouri","McDonald County",5,18,290,155,135
050,29,119,"Missouri","McDonald County",5,19,243,124,119
050,29,119,"Missouri","McDonald County",5,20,274,148,126
050,29,119,"Missouri","McDonald County",5,21,290,139,151
050,29,119,"Missouri","McDonald County",5,22,292,159,133
050,29,119,"Missouri","McDonald County",5,23,299,143,156
050,29,119,"Missouri","McDonald County",5,24,267,131,136
050,29,119,"Missouri","McDonald County",5,25,294,144,150
050,29,119,"Missouri","McDonald County",5,26,270,150,120
050,29,119,"Missouri","McDonald County",5,27,289,148,141
050,29,119,"Missouri","McDonald County",5,28,260,141,119
050,29,119,"Missouri","McDonald County",5,29,269,146,123
050,29,119,"Missouri","McDonald County",5,30,275,137,138
050,29,119,"Missouri","McDonald County",5,31,301,154,147
050,29,119,"Missouri","McDonald County",5,32,276,129,147
050,29,119,"Missouri","McDonald County",5,33,293,157,136
050,29,119,"Missouri","McDonald County",5,34,296,157,139
050,29,119,"Missouri","McDonald County",5,35,292,157,135
050,29,119,"Missouri","McDonald County",5,36,276,146,130
050,29,119,"Missouri","McDonald County",5,37,284,145,139
050,29,119,"Missouri","McDonald County",5,38,298,152,146
050,29,119,"Missouri","McDonald County",5,39,246,121,125
050,29,119,"Missouri","McDonald County",5,40,287,133,154
050,29,119,"Missouri","McDonald County",5,41,274,146,128
050,29,119,"Missouri","McDonald County",5,42,288,147,141
050,29,119,"Missouri","McDonald County",5,43,287,130,157
050,29,119,"Missouri","McDonald County",5,44,295,137,158
050,29,119,"Missouri","McDonald County",5,45,286,127,159
050,29,119,"Missouri","McDonald County",5,46,299,148,151
050,29,119,"Missouri","McDonald County",5,47,268,130,138
050,29,119,"Missouri","McDonald County",5,48,300,147,153
050,29,119,"Missouri","McDonald County",5,49,292,142,150
050,29,119,"Missouri","McDonald County",5,50,288,150,138
050,29,119,"Missouri","McDonald County",5,51,315,179,136
050,29,119,"Missouri","McDonald County",5,52,333,180,153
050,29,119,"Missouri","McDonald County",5,53,312,158,154
050,29,119,"Missouri","McDonald County",5,54,334,175,159
050,29,119,"Missouri","McDonald County",5,55,335,169,166
050,29,119,"Missouri","McDonald County",5,56,311,161,150
050,29,119,"Missouri","McDonald County",5,57,319,148,171
050,29,119,"Missouri","McDonald County",5,58,329,181,148
050,29,119,"Missouri","McDonald County",5,59,343,178,165
050,29,119,"Missouri","McDonald County",5,60,350,176,174
050,29,119,"Missouri","McDonald County",5,61,337,169,168
050,29,119,"Missouri","McDonald County",5,62,316,161,155
050,29,119,"Missouri","McDonald County",5,63,317,168,149
050,29,119,"Missouri","McDonald County",5,64,337,158,179
050,29,119,"Missouri","McDonald County",5,65,312,161,151
050,29,119,"Missouri","McDonald County",5,66,322,159,163
050,29,119,"Missouri","McDonald County",5,67,278,139,139
050,29,119,"Missouri","McDonald County",5,68,244,122,122
050,29,119,"Missouri","McDonald County",5,69,242,115,127
050,29,119,"Missouri","McDonald County",5,70,210,111,99
050,29,119,"Missouri","McDonald County",5,71,248,127,121
050,29,119,"Missouri","McDonald County",5,72,214,108,106
050,29,119,"Missouri","McDonald County",5,73,178,88,90
050,29,119,"Missouri","McDonald County",5,74,175,88,87
050,29,119,"Missouri","McDonald County",5,75,176,78,98
050,29,119,"Missouri","McDonald County",5,76,197,96,101
050,29,119,"Missouri","McDonald County",5,77,128,67,61
050,29,119,"Missouri","McDonald County",5,78,125,65,60
050,29,119,"Missouri","McDonald County",5,79,117,46,71
050,29,119,"Missouri","McDonald County",5,80,140,63,77
050,29,119,"Missouri","McDonald County",5,81,112,52,60
050,29,119,"Missouri","McDonald County",5,82,86,35,51
050,29,119,"Missouri","McDonald County",5,83,86,44,42
050,29,119,"Missouri","McDonald County",5,84,78,48,30
050,29,119,"Missouri","McDonald County",5,85,306,110,196
050,29,121,"Missouri","Macon County",1,0,171,89,82
050,29,121,"Missouri","Macon County",1,1,172,90,82
050,29,121,"Missouri","Macon County",1,2,172,91,81
050,29,121,"Missouri","Macon County",1,3,186,102,84
050,29,121,"Missouri","Macon County",1,4,172,93,79
050,29,121,"Missouri","Macon County",1,5,194,107,87
050,29,121,"Missouri","Macon County",1,6,189,101,88
050,29,121,"Missouri","Macon County",1,7,183,95,88
050,29,121,"Missouri","Macon County",1,8,194,102,92
050,29,121,"Missouri","Macon County",1,9,194,96,98
050,29,121,"Missouri","Macon County",1,10,201,89,112
050,29,121,"Missouri","Macon County",1,11,190,95,95
050,29,121,"Missouri","Macon County",1,12,211,111,100
050,29,121,"Missouri","Macon County",1,13,247,122,125
050,29,121,"Missouri","Macon County",1,14,232,112,120
050,29,121,"Missouri","Macon County",1,15,224,116,108
050,29,121,"Missouri","Macon County",1,16,224,115,109
050,29,121,"Missouri","Macon County",1,17,217,121,96
050,29,121,"Missouri","Macon County",1,18,183,96,87
050,29,121,"Missouri","Macon County",1,19,134,66,68
050,29,121,"Missouri","Macon County",1,20,142,74,68
050,29,121,"Missouri","Macon County",1,21,161,82,79
050,29,121,"Missouri","Macon County",1,22,149,82,67
050,29,121,"Missouri","Macon County",1,23,176,92,84
050,29,121,"Missouri","Macon County",1,24,153,77,76
050,29,121,"Missouri","Macon County",1,25,167,90,77
050,29,121,"Missouri","Macon County",1,26,164,81,83
050,29,121,"Missouri","Macon County",1,27,160,69,91
050,29,121,"Missouri","Macon County",1,28,161,85,76
050,29,121,"Missouri","Macon County",1,29,161,89,72
050,29,121,"Missouri","Macon County",1,30,149,77,72
050,29,121,"Missouri","Macon County",1,31,158,70,88
050,29,121,"Missouri","Macon County",1,32,141,73,68
050,29,121,"Missouri","Macon County",1,33,149,72,77
050,29,121,"Missouri","Macon County",1,34,161,74,87
050,29,121,"Missouri","Macon County",1,35,162,81,81
050,29,121,"Missouri","Macon County",1,36,161,83,78
050,29,121,"Missouri","Macon County",1,37,162,84,78
050,29,121,"Missouri","Macon County",1,38,163,77,86
050,29,121,"Missouri","Macon County",1,39,168,83,85
050,29,121,"Missouri","Macon County",1,40,185,89,96
050,29,121,"Missouri","Macon County",1,41,173,81,92
050,29,121,"Missouri","Macon County",1,42,167,86,81
050,29,121,"Missouri","Macon County",1,43,149,80,69
050,29,121,"Missouri","Macon County",1,44,174,89,85
050,29,121,"Missouri","Macon County",1,45,186,99,87
050,29,121,"Missouri","Macon County",1,46,177,103,74
050,29,121,"Missouri","Macon County",1,47,163,89,74
050,29,121,"Missouri","Macon County",1,48,166,79,87
050,29,121,"Missouri","Macon County",1,49,202,103,99
050,29,121,"Missouri","Macon County",1,50,205,106,99
050,29,121,"Missouri","Macon County",1,51,193,91,102
050,29,121,"Missouri","Macon County",1,52,188,100,88
050,29,121,"Missouri","Macon County",1,53,200,111,89
050,29,121,"Missouri","Macon County",1,54,171,94,77
050,29,121,"Missouri","Macon County",1,55,184,99,85
050,29,121,"Missouri","Macon County",1,56,192,103,89
050,29,121,"Missouri","Macon County",1,57,217,110,107
050,29,121,"Missouri","Macon County",1,58,222,113,109
050,29,121,"Missouri","Macon County",1,59,220,108,112
050,29,121,"Missouri","Macon County",1,60,219,115,104
050,29,121,"Missouri","Macon County",1,61,209,108,101
050,29,121,"Missouri","Macon County",1,62,206,94,112
050,29,121,"Missouri","Macon County",1,63,232,117,115
050,29,121,"Missouri","Macon County",1,64,217,109,108
050,29,121,"Missouri","Macon County",1,65,198,96,102
050,29,121,"Missouri","Macon County",1,66,195,94,101
050,29,121,"Missouri","Macon County",1,67,190,103,87
050,29,121,"Missouri","Macon County",1,68,199,91,108
050,29,121,"Missouri","Macon County",1,69,183,84,99
050,29,121,"Missouri","Macon County",1,70,170,81,89
050,29,121,"Missouri","Macon County",1,71,185,92,93
050,29,121,"Missouri","Macon County",1,72,189,96,93
050,29,121,"Missouri","Macon County",1,73,217,104,113
050,29,121,"Missouri","Macon County",1,74,133,64,69
050,29,121,"Missouri","Macon County",1,75,133,71,62
050,29,121,"Missouri","Macon County",1,76,143,65,78
050,29,121,"Missouri","Macon County",1,77,138,60,78
050,29,121,"Missouri","Macon County",1,78,138,61,77
050,29,121,"Missouri","Macon County",1,79,106,49,57
050,29,121,"Missouri","Macon County",1,80,105,51,54
050,29,121,"Missouri","Macon County",1,81,99,40,59
050,29,121,"Missouri","Macon County",1,82,78,38,40
050,29,121,"Missouri","Macon County",1,83,65,27,38
050,29,121,"Missouri","Macon County",1,84,71,30,41
050,29,121,"Missouri","Macon County",1,85,400,136,264
050,29,121,"Missouri","Macon County",2,0,169,83,86
050,29,121,"Missouri","Macon County",2,1,171,90,81
050,29,121,"Missouri","Macon County",2,2,171,90,81
050,29,121,"Missouri","Macon County",2,3,182,99,83
050,29,121,"Missouri","Macon County",2,4,178,97,81
050,29,121,"Missouri","Macon County",2,5,188,104,84
050,29,121,"Missouri","Macon County",2,6,190,103,87
050,29,121,"Missouri","Macon County",2,7,187,98,89
050,29,121,"Missouri","Macon County",2,8,191,99,92
050,29,121,"Missouri","Macon County",2,9,194,98,96
050,29,121,"Missouri","Macon County",2,10,199,90,109
050,29,121,"Missouri","Macon County",2,11,191,93,98
050,29,121,"Missouri","Macon County",2,12,209,109,100
050,29,121,"Missouri","Macon County",2,13,237,119,118
050,29,121,"Missouri","Macon County",2,14,237,116,121
050,29,121,"Missouri","Macon County",2,15,228,117,111
050,29,121,"Missouri","Macon County",2,16,223,115,108
050,29,121,"Missouri","Macon County",2,17,218,119,99
050,29,121,"Missouri","Macon County",2,18,181,96,85
050,29,121,"Missouri","Macon County",2,19,138,69,69
050,29,121,"Missouri","Macon County",2,20,145,74,71
050,29,121,"Missouri","Macon County",2,21,155,78,77
050,29,121,"Missouri","Macon County",2,22,157,84,73
050,29,121,"Missouri","Macon County",2,23,173,91,82
050,29,121,"Missouri","Macon County",2,24,161,83,78
050,29,121,"Missouri","Macon County",2,25,165,88,77
050,29,121,"Missouri","Macon County",2,26,167,84,83
050,29,121,"Missouri","Macon County",2,27,160,72,88
050,29,121,"Missouri","Macon County",2,28,164,83,81
050,29,121,"Missouri","Macon County",2,29,162,88,74
050,29,121,"Missouri","Macon County",2,30,152,78,74
050,29,121,"Missouri","Macon County",2,31,155,71,84
050,29,121,"Missouri","Macon County",2,32,146,72,74
050,29,121,"Missouri","Macon County",2,33,148,72,76
050,29,121,"Missouri","Macon County",2,34,158,74,84
050,29,121,"Missouri","Macon County",2,35,164,81,83
050,29,121,"Missouri","Macon County",2,36,159,82,77
050,29,121,"Missouri","Macon County",2,37,160,83,77
050,29,121,"Missouri","Macon County",2,38,163,78,85
050,29,121,"Missouri","Macon County",2,39,165,82,83
050,29,121,"Missouri","Macon County",2,40,182,87,95
050,29,121,"Missouri","Macon County",2,41,174,82,92
050,29,121,"Missouri","Macon County",2,42,167,84,83
050,29,121,"Missouri","Macon County",2,43,155,82,73
050,29,121,"Missouri","Macon County",2,44,167,86,81
050,29,121,"Missouri","Macon County",2,45,185,98,87
050,29,121,"Missouri","Macon County",2,46,177,101,76
050,29,121,"Missouri","Macon County",2,47,165,93,72
050,29,121,"Missouri","Macon County",2,48,166,81,85
050,29,121,"Missouri","Macon County",2,49,194,98,96
050,29,121,"Missouri","Macon County",2,50,205,106,99
050,29,121,"Missouri","Macon County",2,51,195,94,101
050,29,121,"Missouri","Macon County",2,52,189,98,91
050,29,121,"Missouri","Macon County",2,53,197,109,88
050,29,121,"Missouri","Macon County",2,54,179,100,79
050,29,121,"Missouri","Macon County",2,55,183,100,83
050,29,121,"Missouri","Macon County",2,56,191,102,89
050,29,121,"Missouri","Macon County",2,57,214,110,104
050,29,121,"Missouri","Macon County",2,58,220,112,108
050,29,121,"Missouri","Macon County",2,59,222,110,112
050,29,121,"Missouri","Macon County",2,60,218,114,104
050,29,121,"Missouri","Macon County",2,61,209,107,102
050,29,121,"Missouri","Macon County",2,62,205,97,108
050,29,121,"Missouri","Macon County",2,63,228,113,115
050,29,121,"Missouri","Macon County",2,64,219,111,108
050,29,121,"Missouri","Macon County",2,65,201,98,103
050,29,121,"Missouri","Macon County",2,66,196,94,102
050,29,121,"Missouri","Macon County",2,67,189,98,91
050,29,121,"Missouri","Macon County",2,68,193,92,101
050,29,121,"Missouri","Macon County",2,69,188,86,102
050,29,121,"Missouri","Macon County",2,70,171,80,91
050,29,121,"Missouri","Macon County",2,71,180,88,92
050,29,121,"Missouri","Macon County",2,72,182,93,89
050,29,121,"Missouri","Macon County",2,73,222,106,116
050,29,121,"Missouri","Macon County",2,74,143,69,74
050,29,121,"Missouri","Macon County",2,75,133,69,64
050,29,121,"Missouri","Macon County",2,76,138,64,74
050,29,121,"Missouri","Macon County",2,77,140,61,79
050,29,121,"Missouri","Macon County",2,78,132,60,72
050,29,121,"Missouri","Macon County",2,79,109,50,59
050,29,121,"Missouri","Macon County",2,80,104,50,54
050,29,121,"Missouri","Macon County",2,81,97,40,57
050,29,121,"Missouri","Macon County",2,82,79,37,42
050,29,121,"Missouri","Macon County",2,83,69,30,39
050,29,121,"Missouri","Macon County",2,84,69,29,40
050,29,121,"Missouri","Macon County",2,85,394,132,262
050,29,121,"Missouri","Macon County",3,0,183,95,88
050,29,121,"Missouri","Macon County",3,1,169,82,87
050,29,121,"Missouri","Macon County",3,2,165,88,77
050,29,121,"Missouri","Macon County",3,3,179,99,80
050,29,121,"Missouri","Macon County",3,4,194,104,90
050,29,121,"Missouri","Macon County",3,5,183,104,79
050,29,121,"Missouri","Macon County",3,6,188,100,88
050,29,121,"Missouri","Macon County",3,7,197,102,95
050,29,121,"Missouri","Macon County",3,8,183,96,87
050,29,121,"Missouri","Macon County",3,9,189,97,92
050,29,121,"Missouri","Macon County",3,10,199,103,96
050,29,121,"Missouri","Macon County",3,11,192,85,107
050,29,121,"Missouri","Macon County",3,12,185,91,94
050,29,121,"Missouri","Macon County",3,13,212,113,99
050,29,121,"Missouri","Macon County",3,14,229,118,111
050,29,121,"Missouri","Macon County",3,15,245,121,124
050,29,121,"Missouri","Macon County",3,16,226,111,115
050,29,121,"Missouri","Macon County",3,17,224,113,111
050,29,121,"Missouri","Macon County",3,18,195,111,84
050,29,121,"Missouri","Macon County",3,19,140,72,68
050,29,121,"Missouri","Macon County",3,20,142,74,68
050,29,121,"Missouri","Macon County",3,21,153,79,74
050,29,121,"Missouri","Macon County",3,22,167,79,88
050,29,121,"Missouri","Macon County",3,23,173,97,76
050,29,121,"Missouri","Macon County",3,24,178,99,79
050,29,121,"Missouri","Macon County",3,25,167,82,85
050,29,121,"Missouri","Macon County",3,26,177,95,82
050,29,121,"Missouri","Macon County",3,27,172,83,89
050,29,121,"Missouri","Macon County",3,28,151,68,83
050,29,121,"Missouri","Macon County",3,29,174,88,86
050,29,121,"Missouri","Macon County",3,30,165,88,77
050,29,121,"Missouri","Macon County",3,31,156,82,74
050,29,121,"Missouri","Macon County",3,32,153,72,81
050,29,121,"Missouri","Macon County",3,33,145,74,71
050,29,121,"Missouri","Macon County",3,34,154,75,79
050,29,121,"Missouri","Macon County",3,35,169,78,91
050,29,121,"Missouri","Macon County",3,36,153,77,76
050,29,121,"Missouri","Macon County",3,37,160,83,77
050,29,121,"Missouri","Macon County",3,38,159,80,79
050,29,121,"Missouri","Macon County",3,39,161,77,84
050,29,121,"Missouri","Macon County",3,40,167,83,84
050,29,121,"Missouri","Macon County",3,41,192,93,99
050,29,121,"Missouri","Macon County",3,42,169,77,92
050,29,121,"Missouri","Macon County",3,43,169,88,81
050,29,121,"Missouri","Macon County",3,44,158,82,76
050,29,121,"Missouri","Macon County",3,45,163,85,78
050,29,121,"Missouri","Macon County",3,46,185,100,85
050,29,121,"Missouri","Macon County",3,47,179,100,79
050,29,121,"Missouri","Macon County",3,48,165,94,71
050,29,121,"Missouri","Macon County",3,49,167,79,88
050,29,121,"Missouri","Macon County",3,50,191,97,94
050,29,121,"Missouri","Macon County",3,51,204,104,100
050,29,121,"Missouri","Macon County",3,52,194,93,101
050,29,121,"Missouri","Macon County",3,53,191,99,92
050,29,121,"Missouri","Macon County",3,54,199,110,89
050,29,121,"Missouri","Macon County",3,55,177,94,83
050,29,121,"Missouri","Macon County",3,56,174,96,78
050,29,121,"Missouri","Macon County",3,57,196,103,93
050,29,121,"Missouri","Macon County",3,58,208,105,103
050,29,121,"Missouri","Macon County",3,59,219,110,109
050,29,121,"Missouri","Macon County",3,60,220,109,111
050,29,121,"Missouri","Macon County",3,61,207,107,100
050,29,121,"Missouri","Macon County",3,62,210,108,102
050,29,121,"Missouri","Macon County",3,63,203,96,107
050,29,121,"Missouri","Macon County",3,64,229,114,115
050,29,121,"Missouri","Macon County",3,65,223,114,109
050,29,121,"Missouri","Macon County",3,66,201,93,108
050,29,121,"Missouri","Macon County",3,67,192,92,100
050,29,121,"Missouri","Macon County",3,68,187,101,86
050,29,121,"Missouri","Macon County",3,69,183,84,99
050,29,121,"Missouri","Macon County",3,70,179,84,95
050,29,121,"Missouri","Macon County",3,71,163,76,87
050,29,121,"Missouri","Macon County",3,72,173,84,89
050,29,121,"Missouri","Macon County",3,73,185,93,92
050,29,121,"Missouri","Macon County",3,74,203,97,106
050,29,121,"Missouri","Macon County",3,75,135,67,68
050,29,121,"Missouri","Macon County",3,76,124,65,59
050,29,121,"Missouri","Macon County",3,77,131,63,68
050,29,121,"Missouri","Macon County",3,78,141,60,81
050,29,121,"Missouri","Macon County",3,79,119,52,67
050,29,121,"Missouri","Macon County",3,80,105,50,55
050,29,121,"Missouri","Macon County",3,81,98,45,53
050,29,121,"Missouri","Macon County",3,82,87,39,48
050,29,121,"Missouri","Macon County",3,83,76,35,41
050,29,121,"Missouri","Macon County",3,84,64,28,36
050,29,121,"Missouri","Macon County",3,85,367,129,238
050,29,121,"Missouri","Macon County",4,0,173,88,85
050,29,121,"Missouri","Macon County",4,1,178,88,90
050,29,121,"Missouri","Macon County",4,2,160,72,88
050,29,121,"Missouri","Macon County",4,3,167,91,76
050,29,121,"Missouri","Macon County",4,4,181,99,82
050,29,121,"Missouri","Macon County",4,5,209,113,96
050,29,121,"Missouri","Macon County",4,6,186,106,80
050,29,121,"Missouri","Macon County",4,7,189,101,88
050,29,121,"Missouri","Macon County",4,8,195,99,96
050,29,121,"Missouri","Macon County",4,9,183,99,84
050,29,121,"Missouri","Macon County",4,10,195,103,92
050,29,121,"Missouri","Macon County",4,11,198,98,100
050,29,121,"Missouri","Macon County",4,12,198,88,110
050,29,121,"Missouri","Macon County",4,13,183,88,95
050,29,121,"Missouri","Macon County",4,14,217,113,104
050,29,121,"Missouri","Macon County",4,15,242,123,119
050,29,121,"Missouri","Macon County",4,16,253,125,128
050,29,121,"Missouri","Macon County",4,17,218,107,111
050,29,121,"Missouri","Macon County",4,18,190,101,89
050,29,121,"Missouri","Macon County",4,19,144,86,58
050,29,121,"Missouri","Macon County",4,20,141,69,72
050,29,121,"Missouri","Macon County",4,21,136,71,65
050,29,121,"Missouri","Macon County",4,22,156,78,78
050,29,121,"Missouri","Macon County",4,23,163,76,87
050,29,121,"Missouri","Macon County",4,24,173,102,71
050,29,121,"Missouri","Macon County",4,25,176,99,77
050,29,121,"Missouri","Macon County",4,26,154,76,78
050,29,121,"Missouri","Macon County",4,27,168,84,84
050,29,121,"Missouri","Macon County",4,28,164,80,84
050,29,121,"Missouri","Macon County",4,29,143,64,79
050,29,121,"Missouri","Macon County",4,30,168,90,78
050,29,121,"Missouri","Macon County",4,31,163,84,79
050,29,121,"Missouri","Macon County",4,32,150,77,73
050,29,121,"Missouri","Macon County",4,33,148,71,77
050,29,121,"Missouri","Macon County",4,34,143,73,70
050,29,121,"Missouri","Macon County",4,35,159,76,83
050,29,121,"Missouri","Macon County",4,36,176,83,93
050,29,121,"Missouri","Macon County",4,37,153,76,77
050,29,121,"Missouri","Macon County",4,38,167,84,83
050,29,121,"Missouri","Macon County",4,39,159,87,72
050,29,121,"Missouri","Macon County",4,40,163,78,85
050,29,121,"Missouri","Macon County",4,41,168,85,83
050,29,121,"Missouri","Macon County",4,42,185,86,99
050,29,121,"Missouri","Macon County",4,43,170,82,88
050,29,121,"Missouri","Macon County",4,44,172,88,84
050,29,121,"Missouri","Macon County",4,45,157,82,75
050,29,121,"Missouri","Macon County",4,46,160,83,77
050,29,121,"Missouri","Macon County",4,47,183,102,81
050,29,121,"Missouri","Macon County",4,48,186,103,83
050,29,121,"Missouri","Macon County",4,49,162,90,72
050,29,121,"Missouri","Macon County",4,50,170,87,83
050,29,121,"Missouri","Macon County",4,51,190,99,91
050,29,121,"Missouri","Macon County",4,52,205,102,103
050,29,121,"Missouri","Macon County",4,53,191,90,101
050,29,121,"Missouri","Macon County",4,54,188,97,91
050,29,121,"Missouri","Macon County",4,55,195,108,87
050,29,121,"Missouri","Macon County",4,56,180,97,83
050,29,121,"Missouri","Macon County",4,57,178,99,79
050,29,121,"Missouri","Macon County",4,58,191,97,94
050,29,121,"Missouri","Macon County",4,59,209,107,102
050,29,121,"Missouri","Macon County",4,60,223,110,113
050,29,121,"Missouri","Macon County",4,61,222,116,106
050,29,121,"Missouri","Macon County",4,62,218,116,102
050,29,121,"Missouri","Macon County",4,63,215,110,105
050,29,121,"Missouri","Macon County",4,64,203,96,107
050,29,121,"Missouri","Macon County",4,65,227,112,115
050,29,121,"Missouri","Macon County",4,66,214,107,107
050,29,121,"Missouri","Macon County",4,67,193,92,101
050,29,121,"Missouri","Macon County",4,68,186,93,93
050,29,121,"Missouri","Macon County",4,69,189,100,89
050,29,121,"Missouri","Macon County",4,70,179,81,98
050,29,121,"Missouri","Macon County",4,71,177,81,96
050,29,121,"Missouri","Macon County",4,72,158,76,82
050,29,121,"Missouri","Macon County",4,73,173,83,90
050,29,121,"Missouri","Macon County",4,74,171,87,84
050,29,121,"Missouri","Macon County",4,75,199,94,105
050,29,121,"Missouri","Macon County",4,76,127,62,65
050,29,121,"Missouri","Macon County",4,77,117,61,56
050,29,121,"Missouri","Macon County",4,78,132,62,70
050,29,121,"Missouri","Macon County",4,79,127,50,77
050,29,121,"Missouri","Macon County",4,80,110,52,58
050,29,121,"Missouri","Macon County",4,81,103,47,56
050,29,121,"Missouri","Macon County",4,82,83,40,43
050,29,121,"Missouri","Macon County",4,83,87,39,48
050,29,121,"Missouri","Macon County",4,84,71,32,39
050,29,121,"Missouri","Macon County",4,85,350,128,222
050,29,121,"Missouri","Macon County",5,0,173,89,84
050,29,121,"Missouri","Macon County",5,1,162,82,80
050,29,121,"Missouri","Macon County",5,2,185,95,90
050,29,121,"Missouri","Macon County",5,3,167,76,91
050,29,121,"Missouri","Macon County",5,4,166,92,74
050,29,121,"Missouri","Macon County",5,5,184,100,84
050,29,121,"Missouri","Macon County",5,6,210,116,94
050,29,121,"Missouri","Macon County",5,7,187,109,78
050,29,121,"Missouri","Macon County",5,8,187,96,91
050,29,121,"Missouri","Macon County",5,9,199,106,93
050,29,121,"Missouri","Macon County",5,10,186,97,89
050,29,121,"Missouri","Macon County",5,11,198,106,92
050,29,121,"Missouri","Macon County",5,12,202,96,106
050,29,121,"Missouri","Macon County",5,13,204,93,111
050,29,121,"Missouri","Macon County",5,14,194,96,98
050,29,121,"Missouri","Macon County",5,15,216,112,104
050,29,121,"Missouri","Macon County",5,16,237,121,116
050,29,121,"Missouri","Macon County",5,17,257,125,132
050,29,121,"Missouri","Macon County",5,18,186,97,89
050,29,121,"Missouri","Macon County",5,19,150,78,72
050,29,121,"Missouri","Macon County",5,20,163,97,66
050,29,121,"Missouri","Macon County",5,21,137,67,70
050,29,121,"Missouri","Macon County",5,22,156,75,81
050,29,121,"Missouri","Macon County",5,23,162,80,82
050,29,121,"Missouri","Macon County",5,24,149,72,77
050,29,121,"Missouri","Macon County",5,25,171,97,74
050,29,121,"Missouri","Macon County",5,26,168,95,73
050,29,121,"Missouri","Macon County",5,27,168,82,86
050,29,121,"Missouri","Macon County",5,28,165,83,82
050,29,121,"Missouri","Macon County",5,29,165,81,84
050,29,121,"Missouri","Macon County",5,30,137,62,75
050,29,121,"Missouri","Macon County",5,31,171,92,79
050,29,121,"Missouri","Macon County",5,32,155,79,76
050,29,121,"Missouri","Macon County",5,33,159,80,79
050,29,121,"Missouri","Macon County",5,34,145,66,79
050,29,121,"Missouri","Macon County",5,35,153,79,74
050,29,121,"Missouri","Macon County",5,36,157,73,84
050,29,121,"Missouri","Macon County",5,37,175,87,88
050,29,121,"Missouri","Macon County",5,38,154,75,79
050,29,121,"Missouri","Macon County",5,39,168,88,80
050,29,121,"Missouri","Macon County",5,40,166,89,77
050,29,121,"Missouri","Macon County",5,41,175,81,94
050,29,121,"Missouri","Macon County",5,42,176,92,84
050,29,121,"Missouri","Macon County",5,43,190,91,99
050,29,121,"Missouri","Macon County",5,44,172,85,87
050,29,121,"Missouri","Macon County",5,45,170,89,81
050,29,121,"Missouri","Macon County",5,46,157,82,75
050,29,121,"Missouri","Macon County",5,47,160,84,76
050,29,121,"Missouri","Macon County",5,48,194,106,88
050,29,121,"Missouri","Macon County",5,49,183,102,81
050,29,121,"Missouri","Macon County",5,50,156,86,70
050,29,121,"Missouri","Macon County",5,51,180,86,94
050,29,121,"Missouri","Macon County",5,52,193,101,92
050,29,121,"Missouri","Macon County",5,53,204,102,102
050,29,121,"Missouri","Macon County",5,54,195,93,102
050,29,121,"Missouri","Macon County",5,55,194,101,93
050,29,121,"Missouri","Macon County",5,56,201,112,89
050,29,121,"Missouri","Macon County",5,57,187,98,89
050,29,121,"Missouri","Macon County",5,58,187,98,89
050,29,121,"Missouri","Macon County",5,59,184,91,93
050,29,121,"Missouri","Macon County",5,60,214,107,107
050,29,121,"Missouri","Macon County",5,61,218,111,107
050,29,121,"Missouri","Macon County",5,62,226,116,110
050,29,121,"Missouri","Macon County",5,63,215,119,96
050,29,121,"Missouri","Macon County",5,64,212,108,104
050,29,121,"Missouri","Macon County",5,65,202,96,106
050,29,121,"Missouri","Macon County",5,66,225,106,119
050,29,121,"Missouri","Macon County",5,67,213,109,104
050,29,121,"Missouri","Macon County",5,68,195,93,102
050,29,121,"Missouri","Macon County",5,69,187,93,94
050,29,121,"Missouri","Macon County",5,70,185,99,86
050,29,121,"Missouri","Macon County",5,71,173,77,96
050,29,121,"Missouri","Macon County",5,72,176,82,94
050,29,121,"Missouri","Macon County",5,73,158,74,84
050,29,121,"Missouri","Macon County",5,74,159,76,83
050,29,121,"Missouri","Macon County",5,75,166,82,84
050,29,121,"Missouri","Macon County",5,76,192,91,101
050,29,121,"Missouri","Macon County",5,77,117,62,55
050,29,121,"Missouri","Macon County",5,78,121,59,62
050,29,121,"Missouri","Macon County",5,79,118,55,63
050,29,121,"Missouri","Macon County",5,80,122,51,71
050,29,121,"Missouri","Macon County",5,81,104,48,56
050,29,121,"Missouri","Macon County",5,82,88,43,45
050,29,121,"Missouri","Macon County",5,83,79,37,42
050,29,121,"Missouri","Macon County",5,84,86,37,49
050,29,121,"Missouri","Macon County",5,85,358,132,226
050,29,123,"Missouri","Madison County",1,0,128,66,62
050,29,123,"Missouri","Madison County",1,1,131,64,67
050,29,123,"Missouri","Madison County",1,2,154,69,85
050,29,123,"Missouri","Madison County",1,3,149,71,78
050,29,123,"Missouri","Madison County",1,4,132,67,65
050,29,123,"Missouri","Madison County",1,5,158,83,75
050,29,123,"Missouri","Madison County",1,6,151,76,75
050,29,123,"Missouri","Madison County",1,7,145,74,71
050,29,123,"Missouri","Madison County",1,8,158,80,78
050,29,123,"Missouri","Madison County",1,9,173,89,84
050,29,123,"Missouri","Madison County",1,10,193,110,83
050,29,123,"Missouri","Madison County",1,11,194,106,88
050,29,123,"Missouri","Madison County",1,12,184,88,96
050,29,123,"Missouri","Madison County",1,13,186,97,89
050,29,123,"Missouri","Madison County",1,14,163,92,71
050,29,123,"Missouri","Madison County",1,15,183,99,84
050,29,123,"Missouri","Madison County",1,16,188,96,92
050,29,123,"Missouri","Madison County",1,17,157,90,67
050,29,123,"Missouri","Madison County",1,18,139,76,63
050,29,123,"Missouri","Madison County",1,19,111,63,48
050,29,123,"Missouri","Madison County",1,20,129,66,63
050,29,123,"Missouri","Madison County",1,21,127,70,57
050,29,123,"Missouri","Madison County",1,22,131,75,56
050,29,123,"Missouri","Madison County",1,23,133,71,62
050,29,123,"Missouri","Madison County",1,24,141,75,66
050,29,123,"Missouri","Madison County",1,25,135,73,62
050,29,123,"Missouri","Madison County",1,26,127,72,55
050,29,123,"Missouri","Madison County",1,27,142,74,68
050,29,123,"Missouri","Madison County",1,28,159,76,83
050,29,123,"Missouri","Madison County",1,29,150,65,85
050,29,123,"Missouri","Madison County",1,30,156,78,78
050,29,123,"Missouri","Madison County",1,31,154,73,81
050,29,123,"Missouri","Madison County",1,32,146,83,63
050,29,123,"Missouri","Madison County",1,33,148,72,76
050,29,123,"Missouri","Madison County",1,34,138,66,72
050,29,123,"Missouri","Madison County",1,35,138,67,71
050,29,123,"Missouri","Madison County",1,36,147,75,72
050,29,123,"Missouri","Madison County",1,37,148,79,69
050,29,123,"Missouri","Madison County",1,38,148,89,59
050,29,123,"Missouri","Madison County",1,39,159,85,74
050,29,123,"Missouri","Madison County",1,40,148,69,79
050,29,123,"Missouri","Madison County",1,41,154,73,81
050,29,123,"Missouri","Madison County",1,42,168,85,83
050,29,123,"Missouri","Madison County",1,43,158,88,70
050,29,123,"Missouri","Madison County",1,44,135,78,57
050,29,123,"Missouri","Madison County",1,45,125,71,54
050,29,123,"Missouri","Madison County",1,46,136,63,73
050,29,123,"Missouri","Madison County",1,47,161,78,83
050,29,123,"Missouri","Madison County",1,48,167,85,82
050,29,123,"Missouri","Madison County",1,49,178,84,94
050,29,123,"Missouri","Madison County",1,50,172,77,95
050,29,123,"Missouri","Madison County",1,51,154,73,81
050,29,123,"Missouri","Madison County",1,52,149,83,66
050,29,123,"Missouri","Madison County",1,53,157,81,76
050,29,123,"Missouri","Madison County",1,54,173,85,88
050,29,123,"Missouri","Madison County",1,55,180,84,96
050,29,123,"Missouri","Madison County",1,56,188,98,90
050,29,123,"Missouri","Madison County",1,57,178,91,87
050,29,123,"Missouri","Madison County",1,58,191,98,93
050,29,123,"Missouri","Madison County",1,59,192,87,105
050,29,123,"Missouri","Madison County",1,60,179,88,91
050,29,123,"Missouri","Madison County",1,61,180,94,86
050,29,123,"Missouri","Madison County",1,62,180,99,81
050,29,123,"Missouri","Madison County",1,63,205,97,108
050,29,123,"Missouri","Madison County",1,64,169,84,85
050,29,123,"Missouri","Madison County",1,65,178,85,93
050,29,123,"Missouri","Madison County",1,66,173,85,88
050,29,123,"Missouri","Madison County",1,67,178,95,83
050,29,123,"Missouri","Madison County",1,68,133,69,64
050,29,123,"Missouri","Madison County",1,69,120,56,64
050,29,123,"Missouri","Madison County",1,70,124,53,71
050,29,123,"Missouri","Madison County",1,71,122,60,62
050,29,123,"Missouri","Madison County",1,72,124,57,67
050,29,123,"Missouri","Madison County",1,73,139,56,83
050,29,123,"Missouri","Madison County",1,74,88,45,43
050,29,123,"Missouri","Madison County",1,75,100,45,55
050,29,123,"Missouri","Madison County",1,76,99,42,57
050,29,123,"Missouri","Madison County",1,77,101,51,50
050,29,123,"Missouri","Madison County",1,78,92,45,47
050,29,123,"Missouri","Madison County",1,79,72,28,44
050,29,123,"Missouri","Madison County",1,80,70,28,42
050,29,123,"Missouri","Madison County",1,81,57,25,32
050,29,123,"Missouri","Madison County",1,82,61,28,33
050,29,123,"Missouri","Madison County",1,83,51,24,27
050,29,123,"Missouri","Madison County",1,84,41,19,22
050,29,123,"Missouri","Madison County",1,85,293,129,164
050,29,123,"Missouri","Madison County",2,0,119,65,54
050,29,123,"Missouri","Madison County",2,1,130,65,65
050,29,123,"Missouri","Madison County",2,2,149,68,81
050,29,123,"Missouri","Madison County",2,3,147,70,77
050,29,123,"Missouri","Madison County",2,4,138,69,69
050,29,123,"Missouri","Madison County",2,5,153,79,74
050,29,123,"Missouri","Madison County",2,6,155,79,76
050,29,123,"Missouri","Madison County",2,7,148,77,71
050,29,123,"Missouri","Madison County",2,8,153,77,76
050,29,123,"Missouri","Madison County",2,9,172,90,82
050,29,123,"Missouri","Madison County",2,10,190,106,84
050,29,123,"Missouri","Madison County",2,11,193,107,86
050,29,123,"Missouri","Madison County",2,12,187,91,96
050,29,123,"Missouri","Madison County",2,13,184,95,89
050,29,123,"Missouri","Madison County",2,14,167,92,75
050,29,123,"Missouri","Madison County",2,15,180,98,82
050,29,123,"Missouri","Madison County",2,16,185,95,90
050,29,123,"Missouri","Madison County",2,17,163,90,73
050,29,123,"Missouri","Madison County",2,18,134,75,59
050,29,123,"Missouri","Madison County",2,19,111,63,48
050,29,123,"Missouri","Madison County",2,20,129,67,62
050,29,123,"Missouri","Madison County",2,21,131,72,59
050,29,123,"Missouri","Madison County",2,22,133,75,58
050,29,123,"Missouri","Madison County",2,23,134,72,62
050,29,123,"Missouri","Madison County",2,24,139,74,65
050,29,123,"Missouri","Madison County",2,25,137,74,63
050,29,123,"Missouri","Madison County",2,26,130,74,56
050,29,123,"Missouri","Madison County",2,27,140,74,66
050,29,123,"Missouri","Madison County",2,28,154,76,78
050,29,123,"Missouri","Madison County",2,29,151,68,83
050,29,123,"Missouri","Madison County",2,30,156,75,81
050,29,123,"Missouri","Madison County",2,31,155,74,81
050,29,123,"Missouri","Madison County",2,32,149,81,68
050,29,123,"Missouri","Madison County",2,33,147,74,73
050,29,123,"Missouri","Madison County",2,34,140,67,73
050,29,123,"Missouri","Madison County",2,35,139,68,71
050,29,123,"Missouri","Madison County",2,36,143,73,70
050,29,123,"Missouri","Madison County",2,37,148,78,70
050,29,123,"Missouri","Madison County",2,38,149,86,63
050,29,123,"Missouri","Madison County",2,39,156,86,70
050,29,123,"Missouri","Madison County",2,40,152,74,78
050,29,123,"Missouri","Madison County",2,41,154,73,81
050,29,123,"Missouri","Madison County",2,42,164,82,82
050,29,123,"Missouri","Madison County",2,43,161,88,73
050,29,123,"Missouri","Madison County",2,44,138,79,59
050,29,123,"Missouri","Madison County",2,45,128,73,55
050,29,123,"Missouri","Madison County",2,46,135,66,69
050,29,123,"Missouri","Madison County",2,47,155,75,80
050,29,123,"Missouri","Madison County",2,48,166,83,83
050,29,123,"Missouri","Madison County",2,49,177,85,92
050,29,123,"Missouri","Madison County",2,50,172,79,93
050,29,123,"Missouri","Madison County",2,51,159,74,85
050,29,123,"Missouri","Madison County",2,52,152,82,70
050,29,123,"Missouri","Madison County",2,53,155,81,74
050,29,123,"Missouri","Madison County",2,54,166,83,83
050,29,123,"Missouri","Madison County",2,55,180,85,95
050,29,123,"Missouri","Madison County",2,56,186,94,92
050,29,123,"Missouri","Madison County",2,57,180,93,87
050,29,123,"Missouri","Madison County",2,58,189,98,91
050,29,123,"Missouri","Madison County",2,59,193,89,104
050,29,123,"Missouri","Madison County",2,60,183,88,95
050,29,123,"Missouri","Madison County",2,61,180,94,86
050,29,123,"Missouri","Madison County",2,62,181,98,83
050,29,123,"Missouri","Madison County",2,63,202,98,104
050,29,123,"Missouri","Madison County",2,64,177,87,90
050,29,123,"Missouri","Madison County",2,65,173,83,90
050,29,123,"Missouri","Madison County",2,66,175,86,89
050,29,123,"Missouri","Madison County",2,67,178,93,85
050,29,123,"Missouri","Madison County",2,68,140,73,67
050,29,123,"Missouri","Madison County",2,69,123,60,63
050,29,123,"Missouri","Madison County",2,70,123,54,69
050,29,123,"Missouri","Madison County",2,71,122,57,65
050,29,123,"Missouri","Madison County",2,72,120,55,65
050,29,123,"Missouri","Madison County",2,73,143,58,85
050,29,123,"Missouri","Madison County",2,74,93,44,49
050,29,123,"Missouri","Madison County",2,75,98,45,53
050,29,123,"Missouri","Madison County",2,76,95,41,54
050,29,123,"Missouri","Madison County",2,77,100,50,50
050,29,123,"Missouri","Madison County",2,78,90,45,45
050,29,123,"Missouri","Madison County",2,79,75,30,45
050,29,123,"Missouri","Madison County",2,80,72,29,43
050,29,123,"Missouri","Madison County",2,81,56,24,32
050,29,123,"Missouri","Madison County",2,82,60,28,32
050,29,123,"Missouri","Madison County",2,83,51,24,27
050,29,123,"Missouri","Madison County",2,84,45,21,24
050,29,123,"Missouri","Madison County",2,85,291,127,164
050,29,123,"Missouri","Madison County",3,0,137,66,71
050,29,123,"Missouri","Madison County",3,1,117,63,54
050,29,123,"Missouri","Madison County",3,2,127,65,62
050,29,123,"Missouri","Madison County",3,3,153,67,86
050,29,123,"Missouri","Madison County",3,4,156,72,84
050,29,123,"Missouri","Madison County",3,5,131,60,71
050,29,123,"Missouri","Madison County",3,6,149,78,71
050,29,123,"Missouri","Madison County",3,7,166,92,74
050,29,123,"Missouri","Madison County",3,8,139,75,64
050,29,123,"Missouri","Madison County",3,9,161,82,79
050,29,123,"Missouri","Madison County",3,10,171,91,80
050,29,123,"Missouri","Madison County",3,11,189,104,85
050,29,123,"Missouri","Madison County",3,12,181,101,80
050,29,123,"Missouri","Madison County",3,13,205,98,107
050,29,123,"Missouri","Madison County",3,14,186,92,94
050,29,123,"Missouri","Madison County",3,15,168,94,74
050,29,123,"Missouri","Madison County",3,16,172,89,83
050,29,123,"Missouri","Madison County",3,17,185,97,88
050,29,123,"Missouri","Madison County",3,18,146,83,63
050,29,123,"Missouri","Madison County",3,19,107,59,48
050,29,123,"Missouri","Madison County",3,20,117,65,52
050,29,123,"Missouri","Madison County",3,21,129,67,62
050,29,123,"Missouri","Madison County",3,22,135,75,60
050,29,123,"Missouri","Madison County",3,23,143,74,69
050,29,123,"Missouri","Madison County",3,24,141,77,64
050,29,123,"Missouri","Madison County",3,25,140,72,68
050,29,123,"Missouri","Madison County",3,26,152,84,68
050,29,123,"Missouri","Madison County",3,27,139,75,64
050,29,123,"Missouri","Madison County",3,28,148,78,70
050,29,123,"Missouri","Madison County",3,29,153,76,77
050,29,123,"Missouri","Madison County",3,30,151,68,83
050,29,123,"Missouri","Madison County",3,31,152,75,77
050,29,123,"Missouri","Madison County",3,32,157,80,77
050,29,123,"Missouri","Madison County",3,33,153,76,77
050,29,123,"Missouri","Madison County",3,34,150,78,72
050,29,123,"Missouri","Madison County",3,35,143,71,72
050,29,123,"Missouri","Madison County",3,36,142,72,70
050,29,123,"Missouri","Madison County",3,37,139,64,75
050,29,123,"Missouri","Madison County",3,38,159,84,75
050,29,123,"Missouri","Madison County",3,39,152,87,65
050,29,123,"Missouri","Madison County",3,40,157,85,72
050,29,123,"Missouri","Madison County",3,41,152,73,79
050,29,123,"Missouri","Madison County",3,42,162,79,83
050,29,123,"Missouri","Madison County",3,43,171,89,82
050,29,123,"Missouri","Madison County",3,44,162,86,76
050,29,123,"Missouri","Madison County",3,45,139,81,58
050,29,123,"Missouri","Madison County",3,46,131,76,55
050,29,123,"Missouri","Madison County",3,47,131,65,66
050,29,123,"Missouri","Madison County",3,48,158,74,84
050,29,123,"Missouri","Madison County",3,49,175,85,90
050,29,123,"Missouri","Madison County",3,50,180,88,92
050,29,123,"Missouri","Madison County",3,51,168,76,92
050,29,123,"Missouri","Madison County",3,52,157,73,84
050,29,123,"Missouri","Madison County",3,53,159,85,74
050,29,123,"Missouri","Madison County",3,54,157,83,74
050,29,123,"Missouri","Madison County",3,55,162,82,80
050,29,123,"Missouri","Madison County",3,56,179,89,90
050,29,123,"Missouri","Madison County",3,57,182,91,91
050,29,123,"Missouri","Madison County",3,58,183,96,87
050,29,123,"Missouri","Madison County",3,59,187,92,95
050,29,123,"Missouri","Madison County",3,60,192,93,99
050,29,123,"Missouri","Madison County",3,61,184,89,95
050,29,123,"Missouri","Madison County",3,62,172,86,86
050,29,123,"Missouri","Madison County",3,63,183,95,88
050,29,123,"Missouri","Madison County",3,64,203,103,100
050,29,123,"Missouri","Madison County",3,65,173,80,93
050,29,123,"Missouri","Madison County",3,66,165,82,83
050,29,123,"Missouri","Madison County",3,67,177,85,92
050,29,123,"Missouri","Madison County",3,68,169,87,82
050,29,123,"Missouri","Madison County",3,69,140,72,68
050,29,123,"Missouri","Madison County",3,70,128,62,66
050,29,123,"Missouri","Madison County",3,71,116,49,67
050,29,123,"Missouri","Madison County",3,72,117,54,63
050,29,123,"Missouri","Madison County",3,73,117,51,66
050,29,123,"Missouri","Madison County",3,74,136,56,80
050,29,123,"Missouri","Madison County",3,75,90,41,49
050,29,123,"Missouri","Madison County",3,76,82,40,42
050,29,123,"Missouri","Madison County",3,77,93,38,55
050,29,123,"Missouri","Madison County",3,78,90,47,43
050,29,123,"Missouri","Madison County",3,79,89,42,47
050,29,123,"Missouri","Madison County",3,80,76,26,50
050,29,123,"Missouri","Madison County",3,81,51,21,30
050,29,123,"Missouri","Madison County",3,82,51,22,29
050,29,123,"Missouri","Madison County",3,83,48,22,26
050,29,123,"Missouri","Madison County",3,84,43,15,28
050,29,123,"Missouri","Madison County",3,85,286,124,162
050,29,123,"Missouri","Madison County",4,0,126,80,46
050,29,123,"Missouri","Madison County",4,1,160,82,78
050,29,123,"Missouri","Madison County",4,2,133,75,58
050,29,123,"Missouri","Madison County",4,3,129,62,67
050,29,123,"Missouri","Madison County",4,4,162,76,86
050,29,123,"Missouri","Madison County",4,5,148,73,75
050,29,123,"Missouri","Madison County",4,6,132,62,70
050,29,123,"Missouri","Madison County",4,7,152,82,70
050,29,123,"Missouri","Madison County",4,8,158,92,66
050,29,123,"Missouri","Madison County",4,9,154,86,68
050,29,123,"Missouri","Madison County",4,10,162,80,82
050,29,123,"Missouri","Madison County",4,11,178,95,83
050,29,123,"Missouri","Madison County",4,12,185,98,87
050,29,123,"Missouri","Madison County",4,13,187,110,77
050,29,123,"Missouri","Madison County",4,14,198,98,100
050,29,123,"Missouri","Madison County",4,15,185,97,88
050,29,123,"Missouri","Madison County",4,16,162,84,78
050,29,123,"Missouri","Madison County",4,17,172,92,80
050,29,123,"Missouri","Madison County",4,18,163,87,76
050,29,123,"Missouri","Madison County",4,19,113,61,52
050,29,123,"Missouri","Madison County",4,20,112,59,53
050,29,123,"Missouri","Madison County",4,21,120,69,51
050,29,123,"Missouri","Madison County",4,22,136,70,66
050,29,123,"Missouri","Madison County",4,23,139,78,61
050,29,123,"Missouri","Madison County",4,24,153,82,71
050,29,123,"Missouri","Madison County",4,25,147,84,63
050,29,123,"Missouri","Madison County",4,26,143,77,66
050,29,123,"Missouri","Madison County",4,27,158,90,68
050,29,123,"Missouri","Madison County",4,28,148,79,69
050,29,123,"Missouri","Madison County",4,29,148,76,72
050,29,123,"Missouri","Madison County",4,30,155,77,78
050,29,123,"Missouri","Madison County",4,31,159,72,87
050,29,123,"Missouri","Madison County",4,32,155,81,74
050,29,123,"Missouri","Madison County",4,33,149,75,74
050,29,123,"Missouri","Madison County",4,34,159,87,72
050,29,123,"Missouri","Madison County",4,35,140,69,71
050,29,123,"Missouri","Madison County",4,36,145,71,74
050,29,123,"Missouri","Madison County",4,37,147,76,71
050,29,123,"Missouri","Madison County",4,38,146,68,78
050,29,123,"Missouri","Madison County",4,39,156,83,73
050,29,123,"Missouri","Madison County",4,40,159,88,71
050,29,123,"Missouri","Madison County",4,41,158,85,73
050,29,123,"Missouri","Madison County",4,42,155,80,75
050,29,123,"Missouri","Madison County",4,43,168,80,88
050,29,123,"Missouri","Madison County",4,44,174,92,82
050,29,123,"Missouri","Madison County",4,45,162,85,77
050,29,123,"Missouri","Madison County",4,46,138,81,57
050,29,123,"Missouri","Madison County",4,47,138,80,58
050,29,123,"Missouri","Madison County",4,48,136,68,68
050,29,123,"Missouri","Madison County",4,49,157,72,85
050,29,123,"Missouri","Madison County",4,50,177,92,85
050,29,123,"Missouri","Madison County",4,51,183,84,99
050,29,123,"Missouri","Madison County",4,52,175,81,94
050,29,123,"Missouri","Madison County",4,53,160,77,83
050,29,123,"Missouri","Madison County",4,54,157,86,71
050,29,123,"Missouri","Madison County",4,55,165,89,76
050,29,123,"Missouri","Madison County",4,56,160,80,80
050,29,123,"Missouri","Madison County",4,57,182,87,95
050,29,123,"Missouri","Madison County",4,58,183,92,91
050,29,123,"Missouri","Madison County",4,59,187,91,96
050,29,123,"Missouri","Madison County",4,60,187,97,90
050,29,123,"Missouri","Madison County",4,61,193,94,99
050,29,123,"Missouri","Madison County",4,62,182,87,95
050,29,123,"Missouri","Madison County",4,63,182,87,95
050,29,123,"Missouri","Madison County",4,64,177,97,80
050,29,123,"Missouri","Madison County",4,65,188,93,95
050,29,123,"Missouri","Madison County",4,66,171,83,88
050,29,123,"Missouri","Madison County",4,67,167,87,80
050,29,123,"Missouri","Madison County",4,68,169,82,87
050,29,123,"Missouri","Madison County",4,69,163,85,78
050,29,123,"Missouri","Madison County",4,70,139,68,71
050,29,123,"Missouri","Madison County",4,71,120,59,61
050,29,123,"Missouri","Madison County",4,72,110,50,60
050,29,123,"Missouri","Madison County",4,73,112,47,65
050,29,123,"Missouri","Madison County",4,74,108,48,60
050,29,123,"Missouri","Madison County",4,75,132,48,84
050,29,123,"Missouri","Madison County",4,76,75,39,36
050,29,123,"Missouri","Madison County",4,77,86,38,48
050,29,123,"Missouri","Madison County",4,78,79,35,44
050,29,123,"Missouri","Madison County",4,79,90,45,45
050,29,123,"Missouri","Madison County",4,80,91,42,49
050,29,123,"Missouri","Madison County",4,81,62,21,41
050,29,123,"Missouri","Madison County",4,82,47,19,28
050,29,123,"Missouri","Madison County",4,83,39,14,25
050,29,123,"Missouri","Madison County",4,84,49,21,28
050,29,123,"Missouri","Madison County",4,85,291,120,171
050,29,123,"Missouri","Madison County",5,0,127,80,47
050,29,123,"Missouri","Madison County",5,1,130,76,54
050,29,123,"Missouri","Madison County",5,2,150,76,74
050,29,123,"Missouri","Madison County",5,3,129,75,54
050,29,123,"Missouri","Madison County",5,4,137,68,69
050,29,123,"Missouri","Madison County",5,5,150,68,82
050,29,123,"Missouri","Madison County",5,6,159,79,80
050,29,123,"Missouri","Madison County",5,7,126,63,63
050,29,123,"Missouri","Madison County",5,8,146,82,64
050,29,123,"Missouri","Madison County",5,9,156,88,68
050,29,123,"Missouri","Madison County",5,10,158,92,66
050,29,123,"Missouri","Madison County",5,11,169,83,86
050,29,123,"Missouri","Madison County",5,12,167,89,78
050,29,123,"Missouri","Madison County",5,13,193,108,85
050,29,123,"Missouri","Madison County",5,14,196,112,84
050,29,123,"Missouri","Madison County",5,15,202,101,101
050,29,123,"Missouri","Madison County",5,16,179,83,96
050,29,123,"Missouri","Madison County",5,17,177,93,84
050,29,123,"Missouri","Madison County",5,18,149,87,62
050,29,123,"Missouri","Madison County",5,19,128,69,59
050,29,123,"Missouri","Madison County",5,20,115,67,48
050,29,123,"Missouri","Madison County",5,21,116,56,60
050,29,123,"Missouri","Madison County",5,22,126,71,55
050,29,123,"Missouri","Madison County",5,23,144,77,67
050,29,123,"Missouri","Madison County",5,24,143,78,65
050,29,123,"Missouri","Madison County",5,25,151,79,72
050,29,123,"Missouri","Madison County",5,26,156,91,65
050,29,123,"Missouri","Madison County",5,27,147,80,67
050,29,123,"Missouri","Madison County",5,28,164,91,73
050,29,123,"Missouri","Madison County",5,29,151,78,73
050,29,123,"Missouri","Madison County",5,30,138,74,64
050,29,123,"Missouri","Madison County",5,31,148,75,73
050,29,123,"Missouri","Madison County",5,32,150,65,85
050,29,123,"Missouri","Madison County",5,33,147,76,71
050,29,123,"Missouri","Madison County",5,34,148,79,69
050,29,123,"Missouri","Madison County",5,35,148,84,64
050,29,123,"Missouri","Madison County",5,36,134,66,68
050,29,123,"Missouri","Madison County",5,37,139,71,68
050,29,123,"Missouri","Madison County",5,38,153,77,76
050,29,123,"Missouri","Madison County",5,39,148,68,80
050,29,123,"Missouri","Madison County",5,40,160,88,72
050,29,123,"Missouri","Madison County",5,41,165,91,74
050,29,123,"Missouri","Madison County",5,42,158,88,70
050,29,123,"Missouri","Madison County",5,43,169,89,80
050,29,123,"Missouri","Madison County",5,44,169,85,84
050,29,123,"Missouri","Madison County",5,45,179,91,88
050,29,123,"Missouri","Madison County",5,46,166,87,79
050,29,123,"Missouri","Madison County",5,47,142,82,60
050,29,123,"Missouri","Madison County",5,48,138,82,56
050,29,123,"Missouri","Madison County",5,49,143,67,76
050,29,123,"Missouri","Madison County",5,50,149,71,78
050,29,123,"Missouri","Madison County",5,51,172,87,85
050,29,123,"Missouri","Madison County",5,52,175,81,94
050,29,123,"Missouri","Madison County",5,53,175,80,95
050,29,123,"Missouri","Madison County",5,54,164,83,81
050,29,123,"Missouri","Madison County",5,55,157,87,70
050,29,123,"Missouri","Madison County",5,56,162,88,74
050,29,123,"Missouri","Madison County",5,57,160,82,78
050,29,123,"Missouri","Madison County",5,58,185,90,95
050,29,123,"Missouri","Madison County",5,59,181,90,91
050,29,123,"Missouri","Madison County",5,60,182,89,93
050,29,123,"Missouri","Madison County",5,61,186,98,88
050,29,123,"Missouri","Madison County",5,62,190,93,97
050,29,123,"Missouri","Madison County",5,63,181,84,97
050,29,123,"Missouri","Madison County",5,64,186,91,95
050,29,123,"Missouri","Madison County",5,65,171,88,83
050,29,123,"Missouri","Madison County",5,66,185,92,93
050,29,123,"Missouri","Madison County",5,67,172,85,87
050,29,123,"Missouri","Madison County",5,68,157,82,75
050,29,123,"Missouri","Madison County",5,69,168,82,86
050,29,123,"Missouri","Madison County",5,70,161,80,81
050,29,123,"Missouri","Madison County",5,71,129,62,67
050,29,123,"Missouri","Madison County",5,72,112,56,56
050,29,123,"Missouri","Madison County",5,73,107,44,63
050,29,123,"Missouri","Madison County",5,74,105,45,60
050,29,123,"Missouri","Madison County",5,75,102,39,63
050,29,123,"Missouri","Madison County",5,76,117,45,72
050,29,123,"Missouri","Madison County",5,77,76,38,38
050,29,123,"Missouri","Madison County",5,78,72,34,38
050,29,123,"Missouri","Madison County",5,79,77,33,44
050,29,123,"Missouri","Madison County",5,80,91,44,47
050,29,123,"Missouri","Madison County",5,81,75,36,39
050,29,123,"Missouri","Madison County",5,82,60,21,39
050,29,123,"Missouri","Madison County",5,83,35,10,25
050,29,123,"Missouri","Madison County",5,84,37,11,26
050,29,123,"Missouri","Madison County",5,85,301,121,180
050,29,125,"Missouri","Maries County",1,0,84,43,41
050,29,125,"Missouri","Maries County",1,1,83,43,40
050,29,125,"Missouri","Maries County",1,2,65,33,32
050,29,125,"Missouri","Maries County",1,3,71,36,35
050,29,125,"Missouri","Maries County",1,4,95,46,49
050,29,125,"Missouri","Maries County",1,5,79,38,41
050,29,125,"Missouri","Maries County",1,6,83,48,35
050,29,125,"Missouri","Maries County",1,7,87,50,37
050,29,125,"Missouri","Maries County",1,8,93,50,43
050,29,125,"Missouri","Maries County",1,9,95,50,45
050,29,125,"Missouri","Maries County",1,10,108,59,49
050,29,125,"Missouri","Maries County",1,11,105,55,50
050,29,125,"Missouri","Maries County",1,12,111,63,48
050,29,125,"Missouri","Maries County",1,13,111,57,54
050,29,125,"Missouri","Maries County",1,14,120,57,63
050,29,125,"Missouri","Maries County",1,15,111,51,60
050,29,125,"Missouri","Maries County",1,16,104,59,45
050,29,125,"Missouri","Maries County",1,17,110,55,55
050,29,125,"Missouri","Maries County",1,18,93,44,49
050,29,125,"Missouri","Maries County",1,19,69,34,35
050,29,125,"Missouri","Maries County",1,20,79,44,35
050,29,125,"Missouri","Maries County",1,21,84,46,38
050,29,125,"Missouri","Maries County",1,22,87,48,39
050,29,125,"Missouri","Maries County",1,23,88,45,43
050,29,125,"Missouri","Maries County",1,24,95,50,45
050,29,125,"Missouri","Maries County",1,25,102,54,48
050,29,125,"Missouri","Maries County",1,26,86,41,45
050,29,125,"Missouri","Maries County",1,27,93,50,43
050,29,125,"Missouri","Maries County",1,28,85,44,41
050,29,125,"Missouri","Maries County",1,29,90,51,39
050,29,125,"Missouri","Maries County",1,30,83,43,40
050,29,125,"Missouri","Maries County",1,31,85,45,40
050,29,125,"Missouri","Maries County",1,32,88,41,47
050,29,125,"Missouri","Maries County",1,33,85,41,44
050,29,125,"Missouri","Maries County",1,34,102,45,57
050,29,125,"Missouri","Maries County",1,35,87,40,47
050,29,125,"Missouri","Maries County",1,36,91,44,47
050,29,125,"Missouri","Maries County",1,37,97,43,54
050,29,125,"Missouri","Maries County",1,38,88,45,43
050,29,125,"Missouri","Maries County",1,39,94,49,45
050,29,125,"Missouri","Maries County",1,40,103,56,47
050,29,125,"Missouri","Maries County",1,41,103,54,49
050,29,125,"Missouri","Maries County",1,42,91,49,42
050,29,125,"Missouri","Maries County",1,43,91,45,46
050,29,125,"Missouri","Maries County",1,44,94,52,42
050,29,125,"Missouri","Maries County",1,45,99,55,44
050,29,125,"Missouri","Maries County",1,46,86,47,39
050,29,125,"Missouri","Maries County",1,47,102,50,52
050,29,125,"Missouri","Maries County",1,48,110,50,60
050,29,125,"Missouri","Maries County",1,49,117,58,59
050,29,125,"Missouri","Maries County",1,50,112,56,56
050,29,125,"Missouri","Maries County",1,51,115,59,56
050,29,125,"Missouri","Maries County",1,52,109,50,59
050,29,125,"Missouri","Maries County",1,53,132,59,73
050,29,125,"Missouri","Maries County",1,54,117,52,65
050,29,125,"Missouri","Maries County",1,55,134,77,57
050,29,125,"Missouri","Maries County",1,56,142,75,67
050,29,125,"Missouri","Maries County",1,57,145,78,67
050,29,125,"Missouri","Maries County",1,58,151,84,67
050,29,125,"Missouri","Maries County",1,59,158,84,74
050,29,125,"Missouri","Maries County",1,60,136,69,67
050,29,125,"Missouri","Maries County",1,61,125,64,61
050,29,125,"Missouri","Maries County",1,62,133,66,67
050,29,125,"Missouri","Maries County",1,63,125,59,66
050,29,125,"Missouri","Maries County",1,64,110,56,54
050,29,125,"Missouri","Maries County",1,65,115,58,57
050,29,125,"Missouri","Maries County",1,66,113,60,53
050,29,125,"Missouri","Maries County",1,67,113,61,52
050,29,125,"Missouri","Maries County",1,68,111,57,54
050,29,125,"Missouri","Maries County",1,69,104,51,53
050,29,125,"Missouri","Maries County",1,70,111,47,64
050,29,125,"Missouri","Maries County",1,71,110,52,58
050,29,125,"Missouri","Maries County",1,72,99,48,51
050,29,125,"Missouri","Maries County",1,73,90,48,42
050,29,125,"Missouri","Maries County",1,74,73,34,39
050,29,125,"Missouri","Maries County",1,75,76,31,45
050,29,125,"Missouri","Maries County",1,76,73,28,45
050,29,125,"Missouri","Maries County",1,77,73,35,38
050,29,125,"Missouri","Maries County",1,78,72,36,36
050,29,125,"Missouri","Maries County",1,79,56,34,22
050,29,125,"Missouri","Maries County",1,80,57,33,24
050,29,125,"Missouri","Maries County",1,81,53,25,28
050,29,125,"Missouri","Maries County",1,82,39,15,24
050,29,125,"Missouri","Maries County",1,83,45,18,27
050,29,125,"Missouri","Maries County",1,84,43,21,22
050,29,125,"Missouri","Maries County",1,85,196,81,115
050,29,125,"Missouri","Maries County",2,0,96,56,40
050,29,125,"Missouri","Maries County",2,1,80,42,38
050,29,125,"Missouri","Maries County",2,2,69,35,34
050,29,125,"Missouri","Maries County",2,3,72,37,35
050,29,125,"Missouri","Maries County",2,4,90,44,46
050,29,125,"Missouri","Maries County",2,5,83,40,43
050,29,125,"Missouri","Maries County",2,6,82,46,36
050,29,125,"Missouri","Maries County",2,7,87,51,36
050,29,125,"Missouri","Maries County",2,8,93,50,43
050,29,125,"Missouri","Maries County",2,9,95,51,44
050,29,125,"Missouri","Maries County",2,10,103,56,47
050,29,125,"Missouri","Maries County",2,11,104,55,49
050,29,125,"Missouri","Maries County",2,12,111,61,50
050,29,125,"Missouri","Maries County",2,13,112,58,54
050,29,125,"Missouri","Maries County",2,14,118,57,61
050,29,125,"Missouri","Maries County",2,15,115,53,62
050,29,125,"Missouri","Maries County",2,16,107,58,49
050,29,125,"Missouri","Maries County",2,17,110,56,54
050,29,125,"Missouri","Maries County",2,18,93,44,49
050,29,125,"Missouri","Maries County",2,19,71,35,36
050,29,125,"Missouri","Maries County",2,20,81,44,37
050,29,125,"Missouri","Maries County",2,21,85,47,38
050,29,125,"Missouri","Maries County",2,22,87,48,39
050,29,125,"Missouri","Maries County",2,23,90,47,43
050,29,125,"Missouri","Maries County",2,24,96,51,45
050,29,125,"Missouri","Maries County",2,25,100,53,47
050,29,125,"Missouri","Maries County",2,26,88,44,44
050,29,125,"Missouri","Maries County",2,27,90,47,43
050,29,125,"Missouri","Maries County",2,28,86,45,41
050,29,125,"Missouri","Maries County",2,29,87,48,39
050,29,125,"Missouri","Maries County",2,30,86,46,40
050,29,125,"Missouri","Maries County",2,31,87,45,42
050,29,125,"Missouri","Maries County",2,32,89,42,47
050,29,125,"Missouri","Maries County",2,33,86,40,46
050,29,125,"Missouri","Maries County",2,34,99,46,53
050,29,125,"Missouri","Maries County",2,35,91,42,49
050,29,125,"Missouri","Maries County",2,36,89,42,47
050,29,125,"Missouri","Maries County",2,37,95,43,52
050,29,125,"Missouri","Maries County",2,38,90,45,45
050,29,125,"Missouri","Maries County",2,39,93,49,44
050,29,125,"Missouri","Maries County",2,40,103,56,47
050,29,125,"Missouri","Maries County",2,41,101,53,48
050,29,125,"Missouri","Maries County",2,42,95,51,44
050,29,125,"Missouri","Maries County",2,43,91,46,45
050,29,125,"Missouri","Maries County",2,44,94,50,44
050,29,125,"Missouri","Maries County",2,45,99,55,44
050,29,125,"Missouri","Maries County",2,46,89,48,41
050,29,125,"Missouri","Maries County",2,47,99,50,49
050,29,125,"Missouri","Maries County",2,48,108,50,58
050,29,125,"Missouri","Maries County",2,49,117,56,61
050,29,125,"Missouri","Maries County",2,50,113,56,57
050,29,125,"Missouri","Maries County",2,51,115,59,56
050,29,125,"Missouri","Maries County",2,52,110,53,57
050,29,125,"Missouri","Maries County",2,53,127,57,70
050,29,125,"Missouri","Maries County",2,54,121,54,67
050,29,125,"Missouri","Maries County",2,55,129,71,58
050,29,125,"Missouri","Maries County",2,56,142,77,65
050,29,125,"Missouri","Maries County",2,57,146,78,68
050,29,125,"Missouri","Maries County",2,58,149,83,66
050,29,125,"Missouri","Maries County",2,59,158,84,74
050,29,125,"Missouri","Maries County",2,60,142,73,69
050,29,125,"Missouri","Maries County",2,61,127,65,62
050,29,125,"Missouri","Maries County",2,62,131,66,65
050,29,125,"Missouri","Maries County",2,63,127,61,66
050,29,125,"Missouri","Maries County",2,64,111,55,56
050,29,125,"Missouri","Maries County",2,65,113,57,56
050,29,125,"Missouri","Maries County",2,66,112,58,54
050,29,125,"Missouri","Maries County",2,67,114,61,53
050,29,125,"Missouri","Maries County",2,68,111,58,53
050,29,125,"Missouri","Maries County",2,69,106,52,54
050,29,125,"Missouri","Maries County",2,70,109,48,61
050,29,125,"Missouri","Maries County",2,71,111,51,60
050,29,125,"Missouri","Maries County",2,72,100,48,52
050,29,125,"Missouri","Maries County",2,73,96,50,46
050,29,125,"Missouri","Maries County",2,74,73,36,37
050,29,125,"Missouri","Maries County",2,75,75,32,43
050,29,125,"Missouri","Maries County",2,76,74,29,45
050,29,125,"Missouri","Maries County",2,77,73,34,39
050,29,125,"Missouri","Maries County",2,78,69,35,34
050,29,125,"Missouri","Maries County",2,79,59,34,25
050,29,125,"Missouri","Maries County",2,80,56,33,23
050,29,125,"Missouri","Maries County",2,81,52,26,26
050,29,125,"Missouri","Maries County",2,82,41,17,24
050,29,125,"Missouri","Maries County",2,83,40,16,24
050,29,125,"Missouri","Maries County",2,84,42,18,24
050,29,125,"Missouri","Maries County",2,85,195,82,113
050,29,125,"Missouri","Maries County",3,0,82,44,38
050,29,125,"Missouri","Maries County",3,1,100,55,45
050,29,125,"Missouri","Maries County",3,2,78,38,40
050,29,125,"Missouri","Maries County",3,3,72,37,35
050,29,125,"Missouri","Maries County",3,4,80,40,40
050,29,125,"Missouri","Maries County",3,5,92,46,46
050,29,125,"Missouri","Maries County",3,6,79,38,41
050,29,125,"Missouri","Maries County",3,7,85,51,34
050,29,125,"Missouri","Maries County",3,8,92,54,38
050,29,125,"Missouri","Maries County",3,9,91,49,42
050,29,125,"Missouri","Maries County",3,10,96,51,45
050,29,125,"Missouri","Maries County",3,11,103,56,47
050,29,125,"Missouri","Maries County",3,12,102,54,48
050,29,125,"Missouri","Maries County",3,13,110,61,49
050,29,125,"Missouri","Maries County",3,14,111,59,52
050,29,125,"Missouri","Maries County",3,15,117,59,58
050,29,125,"Missouri","Maries County",3,16,118,53,65
050,29,125,"Missouri","Maries County",3,17,109,54,55
050,29,125,"Missouri","Maries County",3,18,91,49,42
050,29,125,"Missouri","Maries County",3,19,76,35,41
050,29,125,"Missouri","Maries County",3,20,80,42,38
050,29,125,"Missouri","Maries County",3,21,85,43,42
050,29,125,"Missouri","Maries County",3,22,87,47,40
050,29,125,"Missouri","Maries County",3,23,98,54,44
050,29,125,"Missouri","Maries County",3,24,92,50,42
050,29,125,"Missouri","Maries County",3,25,95,48,47
050,29,125,"Missouri","Maries County",3,26,95,49,46
050,29,125,"Missouri","Maries County",3,27,88,39,49
050,29,125,"Missouri","Maries County",3,28,82,42,40
050,29,125,"Missouri","Maries County",3,29,90,45,45
050,29,125,"Missouri","Maries County",3,30,87,48,39
050,29,125,"Missouri","Maries County",3,31,93,47,46
050,29,125,"Missouri","Maries County",3,32,86,46,40
050,29,125,"Missouri","Maries County",3,33,83,41,42
050,29,125,"Missouri","Maries County",3,34,93,47,46
050,29,125,"Missouri","Maries County",3,35,96,45,51
050,29,125,"Missouri","Maries County",3,36,94,42,52
050,29,125,"Missouri","Maries County",3,37,87,40,47
050,29,125,"Missouri","Maries County",3,38,96,41,55
050,29,125,"Missouri","Maries County",3,39,101,52,49
050,29,125,"Missouri","Maries County",3,40,89,48,41
050,29,125,"Missouri","Maries County",3,41,104,53,51
050,29,125,"Missouri","Maries County",3,42,101,54,47
050,29,125,"Missouri","Maries County",3,43,98,52,46
050,29,125,"Missouri","Maries County",3,44,88,45,43
050,29,125,"Missouri","Maries County",3,45,97,54,43
050,29,125,"Missouri","Maries County",3,46,102,55,47
050,29,125,"Missouri","Maries County",3,47,95,49,46
050,29,125,"Missouri","Maries County",3,48,92,47,45
050,29,125,"Missouri","Maries County",3,49,111,52,59
050,29,125,"Missouri","Maries County",3,50,111,52,59
050,29,125,"Missouri","Maries County",3,51,116,58,58
050,29,125,"Missouri","Maries County",3,52,111,59,52
050,29,125,"Missouri","Maries County",3,53,108,50,58
050,29,125,"Missouri","Maries County",3,54,128,60,68
050,29,125,"Missouri","Maries County",3,55,116,54,62
050,29,125,"Missouri","Maries County",3,56,129,71,58
050,29,125,"Missouri","Maries County",3,57,137,72,65
050,29,125,"Missouri","Maries County",3,58,149,84,65
050,29,125,"Missouri","Maries County",3,59,149,84,65
050,29,125,"Missouri","Maries County",3,60,158,81,77
050,29,125,"Missouri","Maries County",3,61,142,71,71
050,29,125,"Missouri","Maries County",3,62,119,63,56
050,29,125,"Missouri","Maries County",3,63,124,60,64
050,29,125,"Missouri","Maries County",3,64,120,57,63
050,29,125,"Missouri","Maries County",3,65,118,57,61
050,29,125,"Missouri","Maries County",3,66,112,55,57
050,29,125,"Missouri","Maries County",3,67,107,53,54
050,29,125,"Missouri","Maries County",3,68,112,57,55
050,29,125,"Missouri","Maries County",3,69,110,58,52
050,29,125,"Missouri","Maries County",3,70,95,45,50
050,29,125,"Missouri","Maries County",3,71,113,52,61
050,29,125,"Missouri","Maries County",3,72,103,45,58
050,29,125,"Missouri","Maries County",3,73,101,48,53
050,29,125,"Missouri","Maries County",3,74,93,48,45
050,29,125,"Missouri","Maries County",3,75,73,36,37
050,29,125,"Missouri","Maries County",3,76,68,29,39
050,29,125,"Missouri","Maries County",3,77,70,29,41
050,29,125,"Missouri","Maries County",3,78,69,31,38
050,29,125,"Missouri","Maries County",3,79,59,30,29
050,29,125,"Missouri","Maries County",3,80,57,33,24
050,29,125,"Missouri","Maries County",3,81,54,30,24
050,29,125,"Missouri","Maries County",3,82,49,27,22
050,29,125,"Missouri","Maries County",3,83,31,14,17
050,29,125,"Missouri","Maries County",3,84,35,12,23
050,29,125,"Missouri","Maries County",3,85,202,83,119
050,29,125,"Missouri","Maries County",4,0,97,50,47
050,29,125,"Missouri","Maries County",4,1,78,47,31
050,29,125,"Missouri","Maries County",4,2,91,47,44
050,29,125,"Missouri","Maries County",4,3,85,43,42
050,29,125,"Missouri","Maries County",4,4,77,42,35
050,29,125,"Missouri","Maries County",4,5,80,43,37
050,29,125,"Missouri","Maries County",4,6,91,47,44
050,29,125,"Missouri","Maries County",4,7,89,44,45
050,29,125,"Missouri","Maries County",4,8,84,48,36
050,29,125,"Missouri","Maries County",4,9,93,53,40
050,29,125,"Missouri","Maries County",4,10,91,49,42
050,29,125,"Missouri","Maries County",4,11,99,54,45
050,29,125,"Missouri","Maries County",4,12,107,59,48
050,29,125,"Missouri","Maries County",4,13,109,53,56
050,29,125,"Missouri","Maries County",4,14,115,63,52
050,29,125,"Missouri","Maries County",4,15,111,58,53
050,29,125,"Missouri","Maries County",4,16,123,66,57
050,29,125,"Missouri","Maries County",4,17,116,50,66
050,29,125,"Missouri","Maries County",4,18,90,50,40
050,29,125,"Missouri","Maries County",4,19,65,36,29
050,29,125,"Missouri","Maries County",4,20,79,38,41
050,29,125,"Missouri","Maries County",4,21,87,43,44
050,29,125,"Missouri","Maries County",4,22,88,46,42
050,29,125,"Missouri","Maries County",4,23,84,46,38
050,29,125,"Missouri","Maries County",4,24,98,58,40
050,29,125,"Missouri","Maries County",4,25,87,46,41
050,29,125,"Missouri","Maries County",4,26,96,52,44
050,29,125,"Missouri","Maries County",4,27,99,53,46
050,29,125,"Missouri","Maries County",4,28,83,36,47
050,29,125,"Missouri","Maries County",4,29,79,39,40
050,29,125,"Missouri","Maries County",4,30,101,48,53
050,29,125,"Missouri","Maries County",4,31,83,43,40
050,29,125,"Missouri","Maries County",4,32,92,44,48
050,29,125,"Missouri","Maries County",4,33,89,46,43
050,29,125,"Missouri","Maries County",4,34,86,44,42
050,29,125,"Missouri","Maries County",4,35,98,49,49
050,29,125,"Missouri","Maries County",4,36,101,50,51
050,29,125,"Missouri","Maries County",4,37,99,41,58
050,29,125,"Missouri","Maries County",4,38,88,40,48
050,29,125,"Missouri","Maries County",4,39,96,42,54
050,29,125,"Missouri","Maries County",4,40,100,49,51
050,29,125,"Missouri","Maries County",4,41,96,54,42
050,29,125,"Missouri","Maries County",4,42,113,61,52
050,29,125,"Missouri","Maries County",4,43,97,50,47
050,29,125,"Missouri","Maries County",4,44,98,52,46
050,29,125,"Missouri","Maries County",4,45,88,46,42
050,29,125,"Missouri","Maries County",4,46,95,50,45
050,29,125,"Missouri","Maries County",4,47,104,56,48
050,29,125,"Missouri","Maries County",4,48,86,46,40
050,29,125,"Missouri","Maries County",4,49,98,47,51
050,29,125,"Missouri","Maries County",4,50,109,50,59
050,29,125,"Missouri","Maries County",4,51,109,54,55
050,29,125,"Missouri","Maries County",4,52,113,56,57
050,29,125,"Missouri","Maries County",4,53,116,59,57
050,29,125,"Missouri","Maries County",4,54,109,53,56
050,29,125,"Missouri","Maries County",4,55,126,58,68
050,29,125,"Missouri","Maries County",4,56,119,58,61
050,29,125,"Missouri","Maries County",4,57,125,66,59
050,29,125,"Missouri","Maries County",4,58,139,75,64
050,29,125,"Missouri","Maries County",4,59,145,79,66
050,29,125,"Missouri","Maries County",4,60,148,83,65
050,29,125,"Missouri","Maries County",4,61,164,81,83
050,29,125,"Missouri","Maries County",4,62,145,73,72
050,29,125,"Missouri","Maries County",4,63,123,62,61
050,29,125,"Missouri","Maries County",4,64,127,62,65
050,29,125,"Missouri","Maries County",4,65,120,57,63
050,29,125,"Missouri","Maries County",4,66,111,52,59
050,29,125,"Missouri","Maries County",4,67,110,56,54
050,29,125,"Missouri","Maries County",4,68,115,57,58
050,29,125,"Missouri","Maries County",4,69,107,55,52
050,29,125,"Missouri","Maries County",4,70,101,55,46
050,29,125,"Missouri","Maries County",4,71,100,48,52
050,29,125,"Missouri","Maries County",4,72,106,47,59
050,29,125,"Missouri","Maries County",4,73,98,41,57
050,29,125,"Missouri","Maries County",4,74,98,44,54
050,29,125,"Missouri","Maries County",4,75,92,46,46
050,29,125,"Missouri","Maries County",4,76,63,31,32
050,29,125,"Missouri","Maries County",4,77,67,29,38
050,29,125,"Missouri","Maries County",4,78,65,26,39
050,29,125,"Missouri","Maries County",4,79,58,28,30
050,29,125,"Missouri","Maries County",4,80,56,31,25
050,29,125,"Missouri","Maries County",4,81,50,29,21
050,29,125,"Missouri","Maries County",4,82,51,30,21
050,29,125,"Missouri","Maries County",4,83,45,26,19
050,29,125,"Missouri","Maries County",4,84,22,7,15
050,29,125,"Missouri","Maries County",4,85,201,82,119
050,29,125,"Missouri","Maries County",5,0,95,49,46
050,29,125,"Missouri","Maries County",5,1,95,49,46
050,29,125,"Missouri","Maries County",5,2,73,38,35
050,29,125,"Missouri","Maries County",5,3,88,46,42
050,29,125,"Missouri","Maries County",5,4,85,42,43
050,29,125,"Missouri","Maries County",5,5,76,44,32
050,29,125,"Missouri","Maries County",5,6,84,44,40
050,29,125,"Missouri","Maries County",5,7,93,45,48
050,29,125,"Missouri","Maries County",5,8,91,47,44
050,29,125,"Missouri","Maries County",5,9,82,50,32
050,29,125,"Missouri","Maries County",5,10,101,59,42
050,29,125,"Missouri","Maries County",5,11,96,50,46
050,29,125,"Missouri","Maries County",5,12,98,53,45
050,29,125,"Missouri","Maries County",5,13,111,65,46
050,29,125,"Missouri","Maries County",5,14,110,55,55
050,29,125,"Missouri","Maries County",5,15,119,67,52
050,29,125,"Missouri","Maries County",5,16,111,57,54
050,29,125,"Missouri","Maries County",5,17,125,70,55
050,29,125,"Missouri","Maries County",5,18,88,41,47
050,29,125,"Missouri","Maries County",5,19,67,39,28
050,29,125,"Missouri","Maries County",5,20,72,38,34
050,29,125,"Missouri","Maries County",5,21,86,39,47
050,29,125,"Missouri","Maries County",5,22,86,44,42
050,29,125,"Missouri","Maries County",5,23,92,46,46
050,29,125,"Missouri","Maries County",5,24,95,52,43
050,29,125,"Missouri","Maries County",5,25,93,57,36
050,29,125,"Missouri","Maries County",5,26,80,43,37
050,29,125,"Missouri","Maries County",5,27,92,46,46
050,29,125,"Missouri","Maries County",5,28,94,55,39
050,29,125,"Missouri","Maries County",5,29,81,35,46
050,29,125,"Missouri","Maries County",5,30,76,39,37
050,29,125,"Missouri","Maries County",5,31,97,50,47
050,29,125,"Missouri","Maries County",5,32,86,48,38
050,29,125,"Missouri","Maries County",5,33,99,43,56
050,29,125,"Missouri","Maries County",5,34,91,49,42
050,29,125,"Missouri","Maries County",5,35,86,41,45
050,29,125,"Missouri","Maries County",5,36,89,46,43
050,29,125,"Missouri","Maries County",5,37,106,50,56
050,29,125,"Missouri","Maries County",5,38,107,45,62
050,29,125,"Missouri","Maries County",5,39,93,44,49
050,29,125,"Missouri","Maries County",5,40,99,42,57
050,29,125,"Missouri","Maries County",5,41,104,51,53
050,29,125,"Missouri","Maries County",5,42,96,55,41
050,29,125,"Missouri","Maries County",5,43,114,61,53
050,29,125,"Missouri","Maries County",5,44,102,52,50
050,29,125,"Missouri","Maries County",5,45,97,54,43
050,29,125,"Missouri","Maries County",5,46,92,47,45
050,29,125,"Missouri","Maries County",5,47,104,53,51
050,29,125,"Missouri","Maries County",5,48,103,58,45
050,29,125,"Missouri","Maries County",5,49,91,49,42
050,29,125,"Missouri","Maries County",5,50,99,47,52
050,29,125,"Missouri","Maries County",5,51,114,55,59
050,29,125,"Missouri","Maries County",5,52,113,55,58
050,29,125,"Missouri","Maries County",5,53,112,55,57
050,29,125,"Missouri","Maries County",5,54,114,58,56
050,29,125,"Missouri","Maries County",5,55,101,48,53
050,29,125,"Missouri","Maries County",5,56,129,62,67
050,29,125,"Missouri","Maries County",5,57,112,52,60
050,29,125,"Missouri","Maries County",5,58,133,68,65
050,29,125,"Missouri","Maries County",5,59,133,74,59
050,29,125,"Missouri","Maries County",5,60,146,80,66
050,29,125,"Missouri","Maries County",5,61,147,80,67
050,29,125,"Missouri","Maries County",5,62,166,81,85
050,29,125,"Missouri","Maries County",5,63,142,73,69
050,29,125,"Missouri","Maries County",5,64,125,63,62
050,29,125,"Missouri","Maries County",5,65,130,62,68
050,29,125,"Missouri","Maries County",5,66,113,54,59
050,29,125,"Missouri","Maries County",5,67,110,52,58
050,29,125,"Missouri","Maries County",5,68,107,54,53
050,29,125,"Missouri","Maries County",5,69,112,55,57
050,29,125,"Missouri","Maries County",5,70,99,51,48
050,29,125,"Missouri","Maries County",5,71,104,57,47
050,29,125,"Missouri","Maries County",5,72,94,43,51
050,29,125,"Missouri","Maries County",5,73,99,44,55
050,29,125,"Missouri","Maries County",5,74,95,38,57
050,29,125,"Missouri","Maries County",5,75,98,43,55
050,29,125,"Missouri","Maries County",5,76,84,43,41
050,29,125,"Missouri","Maries County",5,77,57,29,28
050,29,125,"Missouri","Maries County",5,78,60,25,35
050,29,125,"Missouri","Maries County",5,79,54,22,32
050,29,125,"Missouri","Maries County",5,80,57,29,28
050,29,125,"Missouri","Maries County",5,81,51,29,22
050,29,125,"Missouri","Maries County",5,82,47,27,20
050,29,125,"Missouri","Maries County",5,83,46,29,17
050,29,125,"Missouri","Maries County",5,84,40,22,18
050,29,125,"Missouri","Maries County",5,85,196,77,119
050,29,127,"Missouri","Marion County",1,0,348,176,172
050,29,127,"Missouri","Marion County",1,1,344,179,165
050,29,127,"Missouri","Marion County",1,2,365,199,166
050,29,127,"Missouri","Marion County",1,3,343,177,166
050,29,127,"Missouri","Marion County",1,4,382,187,195
050,29,127,"Missouri","Marion County",1,5,391,206,185
050,29,127,"Missouri","Marion County",1,6,387,193,194
050,29,127,"Missouri","Marion County",1,7,333,160,173
050,29,127,"Missouri","Marion County",1,8,354,172,182
050,29,127,"Missouri","Marion County",1,9,372,191,181
050,29,127,"Missouri","Marion County",1,10,356,159,197
050,29,127,"Missouri","Marion County",1,11,401,183,218
050,29,127,"Missouri","Marion County",1,12,420,204,216
050,29,127,"Missouri","Marion County",1,13,422,211,211
050,29,127,"Missouri","Marion County",1,14,401,196,205
050,29,127,"Missouri","Marion County",1,15,379,193,186
050,29,127,"Missouri","Marion County",1,16,373,179,194
050,29,127,"Missouri","Marion County",1,17,361,200,161
050,29,127,"Missouri","Marion County",1,18,359,191,168
050,29,127,"Missouri","Marion County",1,19,363,182,181
050,29,127,"Missouri","Marion County",1,20,399,205,194
050,29,127,"Missouri","Marion County",1,21,378,195,183
050,29,127,"Missouri","Marion County",1,22,343,165,178
050,29,127,"Missouri","Marion County",1,23,360,193,167
050,29,127,"Missouri","Marion County",1,24,332,174,158
050,29,127,"Missouri","Marion County",1,25,332,167,165
050,29,127,"Missouri","Marion County",1,26,333,166,167
050,29,127,"Missouri","Marion County",1,27,325,161,164
050,29,127,"Missouri","Marion County",1,28,335,150,185
050,29,127,"Missouri","Marion County",1,29,353,166,187
050,29,127,"Missouri","Marion County",1,30,347,159,188
050,29,127,"Missouri","Marion County",1,31,367,188,179
050,29,127,"Missouri","Marion County",1,32,309,150,159
050,29,127,"Missouri","Marion County",1,33,330,159,171
050,29,127,"Missouri","Marion County",1,34,370,200,170
050,29,127,"Missouri","Marion County",1,35,372,189,183
050,29,127,"Missouri","Marion County",1,36,376,192,184
050,29,127,"Missouri","Marion County",1,37,369,180,189
050,29,127,"Missouri","Marion County",1,38,366,171,195
050,29,127,"Missouri","Marion County",1,39,338,164,174
050,29,127,"Missouri","Marion County",1,40,353,171,182
050,29,127,"Missouri","Marion County",1,41,341,178,163
050,29,127,"Missouri","Marion County",1,42,318,161,157
050,29,127,"Missouri","Marion County",1,43,302,159,143
050,29,127,"Missouri","Marion County",1,44,319,164,155
050,29,127,"Missouri","Marion County",1,45,333,171,162
050,29,127,"Missouri","Marion County",1,46,309,156,153
050,29,127,"Missouri","Marion County",1,47,323,164,159
050,29,127,"Missouri","Marion County",1,48,336,183,153
050,29,127,"Missouri","Marion County",1,49,371,195,176
050,29,127,"Missouri","Marion County",1,50,367,185,182
050,29,127,"Missouri","Marion County",1,51,343,170,173
050,29,127,"Missouri","Marion County",1,52,322,159,163
050,29,127,"Missouri","Marion County",1,53,331,152,179
050,29,127,"Missouri","Marion County",1,54,318,158,160
050,29,127,"Missouri","Marion County",1,55,366,190,176
050,29,127,"Missouri","Marion County",1,56,398,195,203
050,29,127,"Missouri","Marion County",1,57,383,184,199
050,29,127,"Missouri","Marion County",1,58,419,204,215
050,29,127,"Missouri","Marion County",1,59,406,195,211
050,29,127,"Missouri","Marion County",1,60,393,192,201
050,29,127,"Missouri","Marion County",1,61,376,197,179
050,29,127,"Missouri","Marion County",1,62,392,199,193
050,29,127,"Missouri","Marion County",1,63,401,190,211
050,29,127,"Missouri","Marion County",1,64,373,174,199
050,29,127,"Missouri","Marion County",1,65,375,183,192
050,29,127,"Missouri","Marion County",1,66,356,165,191
050,29,127,"Missouri","Marion County",1,67,352,168,184
050,29,127,"Missouri","Marion County",1,68,336,168,168
050,29,127,"Missouri","Marion County",1,69,297,143,154
050,29,127,"Missouri","Marion County",1,70,286,130,156
050,29,127,"Missouri","Marion County",1,71,278,132,146
050,29,127,"Missouri","Marion County",1,72,263,124,139
050,29,127,"Missouri","Marion County",1,73,287,130,157
050,29,127,"Missouri","Marion County",1,74,198,95,103
050,29,127,"Missouri","Marion County",1,75,182,85,97
050,29,127,"Missouri","Marion County",1,76,199,96,103
050,29,127,"Missouri","Marion County",1,77,192,92,100
050,29,127,"Missouri","Marion County",1,78,163,71,92
050,29,127,"Missouri","Marion County",1,79,147,59,88
050,29,127,"Missouri","Marion County",1,80,133,56,77
050,29,127,"Missouri","Marion County",1,81,131,52,79
050,29,127,"Missouri","Marion County",1,82,121,47,74
050,29,127,"Missouri","Marion County",1,83,114,38,76
050,29,127,"Missouri","Marion County",1,84,103,37,66
050,29,127,"Missouri","Marion County",1,85,635,223,412
050,29,127,"Missouri","Marion County",2,0,328,166,162
050,29,127,"Missouri","Marion County",2,1,344,178,166
050,29,127,"Missouri","Marion County",2,2,357,192,165
050,29,127,"Missouri","Marion County",2,3,347,181,166
050,29,127,"Missouri","Marion County",2,4,374,184,190
050,29,127,"Missouri","Marion County",2,5,389,200,189
050,29,127,"Missouri","Marion County",2,6,387,196,191
050,29,127,"Missouri","Marion County",2,7,347,168,179
050,29,127,"Missouri","Marion County",2,8,348,171,177
050,29,127,"Missouri","Marion County",2,9,368,187,181
050,29,127,"Missouri","Marion County",2,10,361,165,196
050,29,127,"Missouri","Marion County",2,11,388,176,212
050,29,127,"Missouri","Marion County",2,12,417,200,217
050,29,127,"Missouri","Marion County",2,13,422,211,211
050,29,127,"Missouri","Marion County",2,14,404,200,204
050,29,127,"Missouri","Marion County",2,15,384,193,191
050,29,127,"Missouri","Marion County",2,16,372,182,190
050,29,127,"Missouri","Marion County",2,17,364,193,171
050,29,127,"Missouri","Marion County",2,18,348,186,162
050,29,127,"Missouri","Marion County",2,19,364,183,181
050,29,127,"Missouri","Marion County",2,20,400,205,195
050,29,127,"Missouri","Marion County",2,21,380,199,181
050,29,127,"Missouri","Marion County",2,22,348,168,180
050,29,127,"Missouri","Marion County",2,23,355,186,169
050,29,127,"Missouri","Marion County",2,24,336,179,157
050,29,127,"Missouri","Marion County",2,25,332,169,163
050,29,127,"Missouri","Marion County",2,26,332,167,165
050,29,127,"Missouri","Marion County",2,27,326,161,165
050,29,127,"Missouri","Marion County",2,28,328,151,177
050,29,127,"Missouri","Marion County",2,29,349,162,187
050,29,127,"Missouri","Marion County",2,30,352,163,189
050,29,127,"Missouri","Marion County",2,31,358,179,179
050,29,127,"Missouri","Marion County",2,32,319,156,163
050,29,127,"Missouri","Marion County",2,33,326,158,168
050,29,127,"Missouri","Marion County",2,34,361,191,170
050,29,127,"Missouri","Marion County",2,35,372,191,181
050,29,127,"Missouri","Marion County",2,36,370,188,182
050,29,127,"Missouri","Marion County",2,37,370,182,188
050,29,127,"Missouri","Marion County",2,38,367,175,192
050,29,127,"Missouri","Marion County",2,39,345,166,179
050,29,127,"Missouri","Marion County",2,40,349,169,180
050,29,127,"Missouri","Marion County",2,41,344,177,167
050,29,127,"Missouri","Marion County",2,42,317,162,155
050,29,127,"Missouri","Marion County",2,43,307,161,146
050,29,127,"Missouri","Marion County",2,44,313,163,150
050,29,127,"Missouri","Marion County",2,45,330,169,161
050,29,127,"Missouri","Marion County",2,46,314,158,156
050,29,127,"Missouri","Marion County",2,47,319,163,156
050,29,127,"Missouri","Marion County",2,48,332,176,156
050,29,127,"Missouri","Marion County",2,49,366,194,172
050,29,127,"Missouri","Marion County",2,50,366,184,182
050,29,127,"Missouri","Marion County",2,51,351,175,176
050,29,127,"Missouri","Marion County",2,52,326,161,165
050,29,127,"Missouri","Marion County",2,53,326,151,175
050,29,127,"Missouri","Marion County",2,54,319,155,164
050,29,127,"Missouri","Marion County",2,55,354,182,172
050,29,127,"Missouri","Marion County",2,56,394,196,198
050,29,127,"Missouri","Marion County",2,57,389,187,202
050,29,127,"Missouri","Marion County",2,58,409,199,210
050,29,127,"Missouri","Marion County",2,59,409,197,212
050,29,127,"Missouri","Marion County",2,60,393,191,202
050,29,127,"Missouri","Marion County",2,61,380,197,183
050,29,127,"Missouri","Marion County",2,62,385,196,189
050,29,127,"Missouri","Marion County",2,63,401,192,209
050,29,127,"Missouri","Marion County",2,64,377,176,201
050,29,127,"Missouri","Marion County",2,65,374,179,195
050,29,127,"Missouri","Marion County",2,66,361,170,191
050,29,127,"Missouri","Marion County",2,67,351,166,185
050,29,127,"Missouri","Marion County",2,68,336,165,171
050,29,127,"Missouri","Marion County",2,69,306,150,156
050,29,127,"Missouri","Marion County",2,70,287,132,155
050,29,127,"Missouri","Marion County",2,71,280,132,148
050,29,127,"Missouri","Marion County",2,72,262,123,139
050,29,127,"Missouri","Marion County",2,73,292,132,160
050,29,127,"Missouri","Marion County",2,74,204,97,107
050,29,127,"Missouri","Marion County",2,75,184,86,98
050,29,127,"Missouri","Marion County",2,76,194,94,100
050,29,127,"Missouri","Marion County",2,77,197,94,103
050,29,127,"Missouri","Marion County",2,78,166,74,92
050,29,127,"Missouri","Marion County",2,79,148,61,87
050,29,127,"Missouri","Marion County",2,80,135,57,78
050,29,127,"Missouri","Marion County",2,81,127,50,77
050,29,127,"Missouri","Marion County",2,82,122,46,76
050,29,127,"Missouri","Marion County",2,83,114,39,75
050,29,127,"Missouri","Marion County",2,84,103,37,66
050,29,127,"Missouri","Marion County",2,85,634,223,411
050,29,127,"Missouri","Marion County",3,0,352,179,173
050,29,127,"Missouri","Marion County",3,1,348,170,178
050,29,127,"Missouri","Marion County",3,2,351,182,169
050,29,127,"Missouri","Marion County",3,3,354,190,164
050,29,127,"Missouri","Marion County",3,4,349,182,167
050,29,127,"Missouri","Marion County",3,5,379,180,199
050,29,127,"Missouri","Marion County",3,6,386,198,188
050,29,127,"Missouri","Marion County",3,7,386,196,190
050,29,127,"Missouri","Marion County",3,8,353,169,184
050,29,127,"Missouri","Marion County",3,9,342,162,180
050,29,127,"Missouri","Marion County",3,10,366,186,180
050,29,127,"Missouri","Marion County",3,11,350,162,188
050,29,127,"Missouri","Marion County",3,12,383,175,208
050,29,127,"Missouri","Marion County",3,13,412,194,218
050,29,127,"Missouri","Marion County",3,14,420,207,213
050,29,127,"Missouri","Marion County",3,15,401,199,202
050,29,127,"Missouri","Marion County",3,16,383,192,191
050,29,127,"Missouri","Marion County",3,17,380,188,192
050,29,127,"Missouri","Marion County",3,18,354,186,168
050,29,127,"Missouri","Marion County",3,19,355,180,175
050,29,127,"Missouri","Marion County",3,20,389,210,179
050,29,127,"Missouri","Marion County",3,21,395,205,190
050,29,127,"Missouri","Marion County",3,22,379,199,180
050,29,127,"Missouri","Marion County",3,23,348,166,182
050,29,127,"Missouri","Marion County",3,24,337,186,151
050,29,127,"Missouri","Marion County",3,25,347,180,167
050,29,127,"Missouri","Marion County",3,26,339,170,169
050,29,127,"Missouri","Marion County",3,27,335,167,168
050,29,127,"Missouri","Marion County",3,28,340,171,169
050,29,127,"Missouri","Marion County",3,29,310,142,168
050,29,127,"Missouri","Marion County",3,30,355,157,198
050,29,127,"Missouri","Marion County",3,31,353,171,182
050,29,127,"Missouri","Marion County",3,32,359,174,185
050,29,127,"Missouri","Marion County",3,33,318,155,163
050,29,127,"Missouri","Marion County",3,34,325,161,164
050,29,127,"Missouri","Marion County",3,35,360,196,164
050,29,127,"Missouri","Marion County",3,36,370,195,175
050,29,127,"Missouri","Marion County",3,37,357,180,177
050,29,127,"Missouri","Marion County",3,38,370,189,181
050,29,127,"Missouri","Marion County",3,39,371,172,199
050,29,127,"Missouri","Marion County",3,40,353,164,189
050,29,127,"Missouri","Marion County",3,41,352,177,175
050,29,127,"Missouri","Marion County",3,42,344,173,171
050,29,127,"Missouri","Marion County",3,43,322,168,154
050,29,127,"Missouri","Marion County",3,44,312,164,148
050,29,127,"Missouri","Marion County",3,45,321,169,152
050,29,127,"Missouri","Marion County",3,46,327,164,163
050,29,127,"Missouri","Marion County",3,47,321,164,157
050,29,127,"Missouri","Marion County",3,48,309,147,162
050,29,127,"Missouri","Marion County",3,49,332,176,156
050,29,127,"Missouri","Marion County",3,50,357,187,170
050,29,127,"Missouri","Marion County",3,51,379,193,186
050,29,127,"Missouri","Marion County",3,52,357,178,179
050,29,127,"Missouri","Marion County",3,53,321,160,161
050,29,127,"Missouri","Marion County",3,54,322,148,174
050,29,127,"Missouri","Marion County",3,55,321,157,164
050,29,127,"Missouri","Marion County",3,56,347,180,167
050,29,127,"Missouri","Marion County",3,57,383,189,194
050,29,127,"Missouri","Marion County",3,58,387,181,206
050,29,127,"Missouri","Marion County",3,59,416,200,216
050,29,127,"Missouri","Marion County",3,60,403,193,210
050,29,127,"Missouri","Marion County",3,61,394,196,198
050,29,127,"Missouri","Marion County",3,62,370,188,182
050,29,127,"Missouri","Marion County",3,63,370,186,184
050,29,127,"Missouri","Marion County",3,64,399,192,207
050,29,127,"Missouri","Marion County",3,65,371,170,201
050,29,127,"Missouri","Marion County",3,66,360,172,188
050,29,127,"Missouri","Marion County",3,67,357,169,188
050,29,127,"Missouri","Marion County",3,68,352,165,187
050,29,127,"Missouri","Marion County",3,69,326,161,165
050,29,127,"Missouri","Marion County",3,70,289,139,150
050,29,127,"Missouri","Marion County",3,71,275,125,150
050,29,127,"Missouri","Marion County",3,72,267,120,147
050,29,127,"Missouri","Marion County",3,73,252,117,135
050,29,127,"Missouri","Marion County",3,74,277,120,157
050,29,127,"Missouri","Marion County",3,75,207,98,109
050,29,127,"Missouri","Marion County",3,76,182,85,97
050,29,127,"Missouri","Marion County",3,77,188,87,101
050,29,127,"Missouri","Marion County",3,78,191,90,101
050,29,127,"Missouri","Marion County",3,79,149,63,86
050,29,127,"Missouri","Marion County",3,80,141,60,81
050,29,127,"Missouri","Marion County",3,81,126,54,72
050,29,127,"Missouri","Marion County",3,82,118,42,76
050,29,127,"Missouri","Marion County",3,83,113,43,70
050,29,127,"Missouri","Marion County",3,84,102,33,69
050,29,127,"Missouri","Marion County",3,85,633,217,416
050,29,127,"Missouri","Marion County",4,0,320,154,166
050,29,127,"Missouri","Marion County",4,1,349,188,161
050,29,127,"Missouri","Marion County",4,2,352,172,180
050,29,127,"Missouri","Marion County",4,3,335,167,168
050,29,127,"Missouri","Marion County",4,4,346,183,163
050,29,127,"Missouri","Marion County",4,5,352,185,167
050,29,127,"Missouri","Marion County",4,6,389,184,205
050,29,127,"Missouri","Marion County",4,7,382,203,179
050,29,127,"Missouri","Marion County",4,8,387,197,190
050,29,127,"Missouri","Marion County",4,9,354,171,183
050,29,127,"Missouri","Marion County",4,10,351,172,179
050,29,127,"Missouri","Marion County",4,11,371,189,182
050,29,127,"Missouri","Marion County",4,12,354,167,187
050,29,127,"Missouri","Marion County",4,13,390,175,215
050,29,127,"Missouri","Marion County",4,14,416,199,217
050,29,127,"Missouri","Marion County",4,15,426,209,217
050,29,127,"Missouri","Marion County",4,16,400,193,207
050,29,127,"Missouri","Marion County",4,17,376,190,186
050,29,127,"Missouri","Marion County",4,18,358,183,175
050,29,127,"Missouri","Marion County",4,19,344,162,182
050,29,127,"Missouri","Marion County",4,20,365,187,178
050,29,127,"Missouri","Marion County",4,21,386,218,168
050,29,127,"Missouri","Marion County",4,22,377,182,195
050,29,127,"Missouri","Marion County",4,23,371,192,179
050,29,127,"Missouri","Marion County",4,24,340,173,167
050,29,127,"Missouri","Marion County",4,25,318,176,142
050,29,127,"Missouri","Marion County",4,26,345,182,163
050,29,127,"Missouri","Marion County",4,27,317,163,154
050,29,127,"Missouri","Marion County",4,28,334,170,164
050,29,127,"Missouri","Marion County",4,29,327,168,159
050,29,127,"Missouri","Marion County",4,30,316,144,172
050,29,127,"Missouri","Marion County",4,31,365,160,205
050,29,127,"Missouri","Marion County",4,32,350,169,181
050,29,127,"Missouri","Marion County",4,33,374,179,195
050,29,127,"Missouri","Marion County",4,34,334,164,170
050,29,127,"Missouri","Marion County",4,35,305,147,158
050,29,127,"Missouri","Marion County",4,36,375,209,166
050,29,127,"Missouri","Marion County",4,37,361,182,179
050,29,127,"Missouri","Marion County",4,38,363,190,173
050,29,127,"Missouri","Marion County",4,39,376,190,186
050,29,127,"Missouri","Marion County",4,40,367,170,197
050,29,127,"Missouri","Marion County",4,41,355,167,188
050,29,127,"Missouri","Marion County",4,42,352,174,178
050,29,127,"Missouri","Marion County",4,43,348,175,173
050,29,127,"Missouri","Marion County",4,44,328,176,152
050,29,127,"Missouri","Marion County",4,45,314,167,147
050,29,127,"Missouri","Marion County",4,46,314,166,148
050,29,127,"Missouri","Marion County",4,47,331,167,164
050,29,127,"Missouri","Marion County",4,48,309,160,149
050,29,127,"Missouri","Marion County",4,49,319,157,162
050,29,127,"Missouri","Marion County",4,50,329,174,155
050,29,127,"Missouri","Marion County",4,51,357,188,169
050,29,127,"Missouri","Marion County",4,52,368,192,176
050,29,127,"Missouri","Marion County",4,53,344,171,173
050,29,127,"Missouri","Marion County",4,54,318,152,166
050,29,127,"Missouri","Marion County",4,55,323,154,169
050,29,127,"Missouri","Marion County",4,56,325,155,170
050,29,127,"Missouri","Marion County",4,57,341,177,164
050,29,127,"Missouri","Marion County",4,58,373,184,189
050,29,127,"Missouri","Marion County",4,59,394,183,211
050,29,127,"Missouri","Marion County",4,60,417,199,218
050,29,127,"Missouri","Marion County",4,61,405,197,208
050,29,127,"Missouri","Marion County",4,62,387,187,200
050,29,127,"Missouri","Marion County",4,63,365,184,181
050,29,127,"Missouri","Marion County",4,64,367,187,180
050,29,127,"Missouri","Marion County",4,65,400,192,208
050,29,127,"Missouri","Marion County",4,66,365,165,200
050,29,127,"Missouri","Marion County",4,67,357,171,186
050,29,127,"Missouri","Marion County",4,68,345,161,184
050,29,127,"Missouri","Marion County",4,69,348,165,183
050,29,127,"Missouri","Marion County",4,70,307,153,154
050,29,127,"Missouri","Marion County",4,71,277,134,143
050,29,127,"Missouri","Marion County",4,72,263,121,142
050,29,127,"Missouri","Marion County",4,73,251,110,141
050,29,127,"Missouri","Marion County",4,74,243,109,134
050,29,127,"Missouri","Marion County",4,75,268,114,154
050,29,127,"Missouri","Marion County",4,76,202,98,104
050,29,127,"Missouri","Marion County",4,77,173,84,89
050,29,127,"Missouri","Marion County",4,78,176,77,99
050,29,127,"Missouri","Marion County",4,79,188,86,102
050,29,127,"Missouri","Marion County",4,80,143,62,81
050,29,127,"Missouri","Marion County",4,81,134,57,77
050,29,127,"Missouri","Marion County",4,82,116,46,70
050,29,127,"Missouri","Marion County",4,83,103,32,71
050,29,127,"Missouri","Marion County",4,84,107,42,65
050,29,127,"Missouri","Marion County",4,85,622,209,413
050,29,127,"Missouri","Marion County",5,0,338,163,175
050,29,127,"Missouri","Marion County",5,1,316,144,172
050,29,127,"Missouri","Marion County",5,2,338,164,174
050,29,127,"Missouri","Marion County",5,3,346,168,178
050,29,127,"Missouri","Marion County",5,4,326,157,169
050,29,127,"Missouri","Marion County",5,5,349,181,168
050,29,127,"Missouri","Marion County",5,6,342,179,163
050,29,127,"Missouri","Marion County",5,7,376,177,199
050,29,127,"Missouri","Marion County",5,8,376,194,182
050,29,127,"Missouri","Marion County",5,9,380,198,182
050,29,127,"Missouri","Marion County",5,10,337,159,178
050,29,127,"Missouri","Marion County",5,11,350,168,182
050,29,127,"Missouri","Marion County",5,12,374,193,181
050,29,127,"Missouri","Marion County",5,13,359,165,194
050,29,127,"Missouri","Marion County",5,14,390,177,213
050,29,127,"Missouri","Marion County",5,15,427,204,223
050,29,127,"Missouri","Marion County",5,16,416,203,213
050,29,127,"Missouri","Marion County",5,17,406,202,204
050,29,127,"Missouri","Marion County",5,18,353,183,170
050,29,127,"Missouri","Marion County",5,19,351,161,190
050,29,127,"Missouri","Marion County",5,20,358,180,178
050,29,127,"Missouri","Marion County",5,21,360,199,161
050,29,127,"Missouri","Marion County",5,22,355,190,165
050,29,127,"Missouri","Marion County",5,23,367,189,178
050,29,127,"Missouri","Marion County",5,24,346,180,166
050,29,127,"Missouri","Marion County",5,25,335,167,168
050,29,127,"Missouri","Marion County",5,26,334,181,153
050,29,127,"Missouri","Marion County",5,27,316,165,151
050,29,127,"Missouri","Marion County",5,28,313,160,153
050,29,127,"Missouri","Marion County",5,29,333,169,164
050,29,127,"Missouri","Marion County",5,30,327,166,161
050,29,127,"Missouri","Marion County",5,31,326,143,183
050,29,127,"Missouri","Marion County",5,32,346,156,190
050,29,127,"Missouri","Marion County",5,33,356,171,185
050,29,127,"Missouri","Marion County",5,34,367,175,192
050,29,127,"Missouri","Marion County",5,35,335,167,168
050,29,127,"Missouri","Marion County",5,36,322,156,166
050,29,127,"Missouri","Marion County",5,37,367,205,162
050,29,127,"Missouri","Marion County",5,38,358,185,173
050,29,127,"Missouri","Marion County",5,39,376,195,181
050,29,127,"Missouri","Marion County",5,40,377,187,190
050,29,127,"Missouri","Marion County",5,41,371,176,195
050,29,127,"Missouri","Marion County",5,42,348,165,183
050,29,127,"Missouri","Marion County",5,43,354,175,179
050,29,127,"Missouri","Marion County",5,44,348,179,169
050,29,127,"Missouri","Marion County",5,45,328,175,153
050,29,127,"Missouri","Marion County",5,46,297,161,136
050,29,127,"Missouri","Marion County",5,47,331,175,156
050,29,127,"Missouri","Marion County",5,48,313,156,157
050,29,127,"Missouri","Marion County",5,49,313,160,153
050,29,127,"Missouri","Marion County",5,50,305,147,158
050,29,127,"Missouri","Marion County",5,51,327,177,150
050,29,127,"Missouri","Marion County",5,52,363,192,171
050,29,127,"Missouri","Marion County",5,53,359,185,174
050,29,127,"Missouri","Marion County",5,54,346,171,175
050,29,127,"Missouri","Marion County",5,55,318,156,162
050,29,127,"Missouri","Marion County",5,56,328,157,171
050,29,127,"Missouri","Marion County",5,57,319,150,169
050,29,127,"Missouri","Marion County",5,58,336,184,152
050,29,127,"Missouri","Marion County",5,59,378,182,196
050,29,127,"Missouri","Marion County",5,60,390,179,211
050,29,127,"Missouri","Marion County",5,61,410,199,211
050,29,127,"Missouri","Marion County",5,62,407,195,212
050,29,127,"Missouri","Marion County",5,63,381,180,201
050,29,127,"Missouri","Marion County",5,64,362,184,178
050,29,127,"Missouri","Marion County",5,65,359,181,178
050,29,127,"Missouri","Marion County",5,66,393,185,208
050,29,127,"Missouri","Marion County",5,67,352,160,192
050,29,127,"Missouri","Marion County",5,68,352,167,185
050,29,127,"Missouri","Marion County",5,69,342,157,185
050,29,127,"Missouri","Marion County",5,70,338,161,177
050,29,127,"Missouri","Marion County",5,71,301,150,151
050,29,127,"Missouri","Marion County",5,72,270,130,140
050,29,127,"Missouri","Marion County",5,73,245,112,133
050,29,127,"Missouri","Marion County",5,74,234,100,134
050,29,127,"Missouri","Marion County",5,75,242,105,137
050,29,127,"Missouri","Marion County",5,76,262,112,150
050,29,127,"Missouri","Marion County",5,77,195,94,101
050,29,127,"Missouri","Marion County",5,78,168,78,90
050,29,127,"Missouri","Marion County",5,79,173,77,96
050,29,127,"Missouri","Marion County",5,80,180,86,94
050,29,127,"Missouri","Marion County",5,81,133,58,75
050,29,127,"Missouri","Marion County",5,82,122,48,74
050,29,127,"Missouri","Marion County",5,83,107,37,70
050,29,127,"Missouri","Marion County",5,84,97,29,68
050,29,127,"Missouri","Marion County",5,85,615,209,406
050,29,129,"Missouri","Mercer County",1,0,40,22,18
050,29,129,"Missouri","Mercer County",1,1,44,21,23
050,29,129,"Missouri","Mercer County",1,2,54,25,29
050,29,129,"Missouri","Mercer County",1,3,48,23,25
050,29,129,"Missouri","Mercer County",1,4,42,21,21
050,29,129,"Missouri","Mercer County",1,5,49,29,20
050,29,129,"Missouri","Mercer County",1,6,51,27,24
050,29,129,"Missouri","Mercer County",1,7,44,24,20
050,29,129,"Missouri","Mercer County",1,8,43,22,21
050,29,129,"Missouri","Mercer County",1,9,39,19,20
050,29,129,"Missouri","Mercer County",1,10,45,21,24
050,29,129,"Missouri","Mercer County",1,11,54,31,23
050,29,129,"Missouri","Mercer County",1,12,52,31,21
050,29,129,"Missouri","Mercer County",1,13,53,24,29
050,29,129,"Missouri","Mercer County",1,14,50,25,25
050,29,129,"Missouri","Mercer County",1,15,48,25,23
050,29,129,"Missouri","Mercer County",1,16,46,22,24
050,29,129,"Missouri","Mercer County",1,17,54,32,22
050,29,129,"Missouri","Mercer County",1,18,40,23,17
050,29,129,"Missouri","Mercer County",1,19,35,21,14
050,29,129,"Missouri","Mercer County",1,20,32,18,14
050,29,129,"Missouri","Mercer County",1,21,38,18,20
050,29,129,"Missouri","Mercer County",1,22,46,23,23
050,29,129,"Missouri","Mercer County",1,23,42,19,23
050,29,129,"Missouri","Mercer County",1,24,41,24,17
050,29,129,"Missouri","Mercer County",1,25,34,19,15
050,29,129,"Missouri","Mercer County",1,26,31,16,15
050,29,129,"Missouri","Mercer County",1,27,44,23,21
050,29,129,"Missouri","Mercer County",1,28,30,15,15
050,29,129,"Missouri","Mercer County",1,29,27,13,14
050,29,129,"Missouri","Mercer County",1,30,34,18,16
050,29,129,"Missouri","Mercer County",1,31,26,11,15
050,29,129,"Missouri","Mercer County",1,32,31,17,14
050,29,129,"Missouri","Mercer County",1,33,37,21,16
050,29,129,"Missouri","Mercer County",1,34,36,20,16
050,29,129,"Missouri","Mercer County",1,35,30,12,18
050,29,129,"Missouri","Mercer County",1,36,40,19,21
050,29,129,"Missouri","Mercer County",1,37,36,20,16
050,29,129,"Missouri","Mercer County",1,38,37,21,16
050,29,129,"Missouri","Mercer County",1,39,44,16,28
050,29,129,"Missouri","Mercer County",1,40,47,18,29
050,29,129,"Missouri","Mercer County",1,41,35,17,18
050,29,129,"Missouri","Mercer County",1,42,31,14,17
050,29,129,"Missouri","Mercer County",1,43,28,13,15
050,29,129,"Missouri","Mercer County",1,44,33,17,16
050,29,129,"Missouri","Mercer County",1,45,36,22,14
050,29,129,"Missouri","Mercer County",1,46,33,16,17
050,29,129,"Missouri","Mercer County",1,47,42,21,21
050,29,129,"Missouri","Mercer County",1,48,42,25,17
050,29,129,"Missouri","Mercer County",1,49,44,25,19
050,29,129,"Missouri","Mercer County",1,50,39,19,20
050,29,129,"Missouri","Mercer County",1,51,45,25,20
050,29,129,"Missouri","Mercer County",1,52,39,19,20
050,29,129,"Missouri","Mercer County",1,53,33,11,22
050,29,129,"Missouri","Mercer County",1,54,42,20,22
050,29,129,"Missouri","Mercer County",1,55,48,26,22
050,29,129,"Missouri","Mercer County",1,56,49,23,26
050,29,129,"Missouri","Mercer County",1,57,50,21,29
050,29,129,"Missouri","Mercer County",1,58,57,29,28
050,29,129,"Missouri","Mercer County",1,59,53,28,25
050,29,129,"Missouri","Mercer County",1,60,56,28,28
050,29,129,"Missouri","Mercer County",1,61,57,30,27
050,29,129,"Missouri","Mercer County",1,62,59,32,27
050,29,129,"Missouri","Mercer County",1,63,54,26,28
050,29,129,"Missouri","Mercer County",1,64,54,32,22
050,29,129,"Missouri","Mercer County",1,65,55,31,24
050,29,129,"Missouri","Mercer County",1,66,59,25,34
050,29,129,"Missouri","Mercer County",1,67,52,27,25
050,29,129,"Missouri","Mercer County",1,68,50,24,26
050,29,129,"Missouri","Mercer County",1,69,39,23,16
050,29,129,"Missouri","Mercer County",1,70,38,24,14
050,29,129,"Missouri","Mercer County",1,71,40,24,16
050,29,129,"Missouri","Mercer County",1,72,34,17,17
050,29,129,"Missouri","Mercer County",1,73,34,16,18
050,29,129,"Missouri","Mercer County",1,74,17,10,7
050,29,129,"Missouri","Mercer County",1,75,22,14,8
050,29,129,"Missouri","Mercer County",1,76,29,14,15
050,29,129,"Missouri","Mercer County",1,77,28,10,18
050,29,129,"Missouri","Mercer County",1,78,36,15,21
050,29,129,"Missouri","Mercer County",1,79,20,9,11
050,29,129,"Missouri","Mercer County",1,80,24,13,11
050,29,129,"Missouri","Mercer County",1,81,19,10,9
050,29,129,"Missouri","Mercer County",1,82,21,11,10
050,29,129,"Missouri","Mercer County",1,83,16,9,7
050,29,129,"Missouri","Mercer County",1,84,20,6,14
050,29,129,"Missouri","Mercer County",1,85,131,44,87
050,29,129,"Missouri","Mercer County",2,0,44,24,20
050,29,129,"Missouri","Mercer County",2,1,42,20,22
050,29,129,"Missouri","Mercer County",2,2,51,24,27
050,29,129,"Missouri","Mercer County",2,3,49,23,26
050,29,129,"Missouri","Mercer County",2,4,44,22,22
050,29,129,"Missouri","Mercer County",2,5,48,27,21
050,29,129,"Missouri","Mercer County",2,6,51,28,23
050,29,129,"Missouri","Mercer County",2,7,45,25,20
050,29,129,"Missouri","Mercer County",2,8,43,22,21
050,29,129,"Missouri","Mercer County",2,9,40,20,20
050,29,129,"Missouri","Mercer County",2,10,45,21,24
050,29,129,"Missouri","Mercer County",2,11,50,28,22
050,29,129,"Missouri","Mercer County",2,12,51,29,22
050,29,129,"Missouri","Mercer County",2,13,51,25,26
050,29,129,"Missouri","Mercer County",2,14,50,24,26
050,29,129,"Missouri","Mercer County",2,15,50,26,24
050,29,129,"Missouri","Mercer County",2,16,46,22,24
050,29,129,"Missouri","Mercer County",2,17,51,30,21
050,29,129,"Missouri","Mercer County",2,18,40,24,16
050,29,129,"Missouri","Mercer County",2,19,34,20,14
050,29,129,"Missouri","Mercer County",2,20,33,19,14
050,29,129,"Missouri","Mercer County",2,21,38,18,20
050,29,129,"Missouri","Mercer County",2,22,45,22,23
050,29,129,"Missouri","Mercer County",2,23,43,21,22
050,29,129,"Missouri","Mercer County",2,24,39,22,17
050,29,129,"Missouri","Mercer County",2,25,35,20,15
050,29,129,"Missouri","Mercer County",2,26,32,17,15
050,29,129,"Missouri","Mercer County",2,27,39,20,19
050,29,129,"Missouri","Mercer County",2,28,32,16,16
050,29,129,"Missouri","Mercer County",2,29,28,14,14
050,29,129,"Missouri","Mercer County",2,30,33,17,16
050,29,129,"Missouri","Mercer County",2,31,28,12,16
050,29,129,"Missouri","Mercer County",2,32,30,16,14
050,29,129,"Missouri","Mercer County",2,33,35,20,15
050,29,129,"Missouri","Mercer County",2,34,35,20,15
050,29,129,"Missouri","Mercer County",2,35,32,14,18
050,29,129,"Missouri","Mercer County",2,36,38,17,21
050,29,129,"Missouri","Mercer County",2,37,38,20,18
050,29,129,"Missouri","Mercer County",2,38,36,21,15
050,29,129,"Missouri","Mercer County",2,39,43,17,26
050,29,129,"Missouri","Mercer County",2,40,47,18,29
050,29,129,"Missouri","Mercer County",2,41,37,17,20
050,29,129,"Missouri","Mercer County",2,42,31,14,17
050,29,129,"Missouri","Mercer County",2,43,28,13,15
050,29,129,"Missouri","Mercer County",2,44,32,16,16
050,29,129,"Missouri","Mercer County",2,45,36,21,15
050,29,129,"Missouri","Mercer County",2,46,34,18,16
050,29,129,"Missouri","Mercer County",2,47,40,20,20
050,29,129,"Missouri","Mercer County",2,48,42,24,18
050,29,129,"Missouri","Mercer County",2,49,44,25,19
050,29,129,"Missouri","Mercer County",2,50,40,20,20
050,29,129,"Missouri","Mercer County",2,51,44,24,20
050,29,129,"Missouri","Mercer County",2,52,40,21,19
050,29,129,"Missouri","Mercer County",2,53,34,12,22
050,29,129,"Missouri","Mercer County",2,54,40,19,21
050,29,129,"Missouri","Mercer County",2,55,46,24,22
050,29,129,"Missouri","Mercer County",2,56,49,24,25
050,29,129,"Missouri","Mercer County",2,57,49,21,28
050,29,129,"Missouri","Mercer County",2,58,55,26,29
050,29,129,"Missouri","Mercer County",2,59,53,28,25
050,29,129,"Missouri","Mercer County",2,60,55,28,27
050,29,129,"Missouri","Mercer County",2,61,56,29,27
050,29,129,"Missouri","Mercer County",2,62,58,32,26
050,29,129,"Missouri","Mercer County",2,63,55,27,28
050,29,129,"Missouri","Mercer County",2,64,53,30,23
050,29,129,"Missouri","Mercer County",2,65,56,32,24
050,29,129,"Missouri","Mercer County",2,66,58,26,32
050,29,129,"Missouri","Mercer County",2,67,53,26,27
050,29,129,"Missouri","Mercer County",2,68,50,24,26
050,29,129,"Missouri","Mercer County",2,69,41,23,18
050,29,129,"Missouri","Mercer County",2,70,39,24,15
050,29,129,"Missouri","Mercer County",2,71,38,23,15
050,29,129,"Missouri","Mercer County",2,72,34,18,16
050,29,129,"Missouri","Mercer County",2,73,34,15,19
050,29,129,"Missouri","Mercer County",2,74,19,10,9
050,29,129,"Missouri","Mercer County",2,75,21,13,8
050,29,129,"Missouri","Mercer County",2,76,24,12,12
050,29,129,"Missouri","Mercer County",2,77,30,12,18
050,29,129,"Missouri","Mercer County",2,78,33,13,20
050,29,129,"Missouri","Mercer County",2,79,23,10,13
050,29,129,"Missouri","Mercer County",2,80,23,12,11
050,29,129,"Missouri","Mercer County",2,81,18,10,8
050,29,129,"Missouri","Mercer County",2,82,20,11,9
050,29,129,"Missouri","Mercer County",2,83,15,8,7
050,29,129,"Missouri","Mercer County",2,84,20,7,13
050,29,129,"Missouri","Mercer County",2,85,129,43,86
050,29,129,"Missouri","Mercer County",3,0,48,26,22
050,29,129,"Missouri","Mercer County",3,1,43,23,20
050,29,129,"Missouri","Mercer County",3,2,35,15,20
050,29,129,"Missouri","Mercer County",3,3,55,29,26
050,29,129,"Missouri","Mercer County",3,4,52,23,29
050,29,129,"Missouri","Mercer County",3,5,42,23,19
050,29,129,"Missouri","Mercer County",3,6,48,26,22
050,29,129,"Missouri","Mercer County",3,7,51,29,22
050,29,129,"Missouri","Mercer County",3,8,45,21,24
050,29,129,"Missouri","Mercer County",3,9,45,21,24
050,29,129,"Missouri","Mercer County",3,10,40,19,21
050,29,129,"Missouri","Mercer County",3,11,45,21,24
050,29,129,"Missouri","Mercer County",3,12,48,26,22
050,29,129,"Missouri","Mercer County",3,13,52,32,20
050,29,129,"Missouri","Mercer County",3,14,53,28,25
050,29,129,"Missouri","Mercer County",3,15,50,26,24
050,29,129,"Missouri","Mercer County",3,16,49,26,23
050,29,129,"Missouri","Mercer County",3,17,45,21,24
050,29,129,"Missouri","Mercer County",3,18,46,26,20
050,29,129,"Missouri","Mercer County",3,19,31,19,12
050,29,129,"Missouri","Mercer County",3,20,35,21,14
050,29,129,"Missouri","Mercer County",3,21,26,16,10
050,29,129,"Missouri","Mercer County",3,22,36,18,18
050,29,129,"Missouri","Mercer County",3,23,41,20,21
050,29,129,"Missouri","Mercer County",3,24,39,19,20
050,29,129,"Missouri","Mercer County",3,25,42,23,19
050,29,129,"Missouri","Mercer County",3,26,37,20,17
050,29,129,"Missouri","Mercer County",3,27,27,15,12
050,29,129,"Missouri","Mercer County",3,28,34,15,19
050,29,129,"Missouri","Mercer County",3,29,33,16,17
050,29,129,"Missouri","Mercer County",3,30,32,16,16
050,29,129,"Missouri","Mercer County",3,31,34,18,16
050,29,129,"Missouri","Mercer County",3,32,27,11,16
050,29,129,"Missouri","Mercer County",3,33,29,17,12
050,29,129,"Missouri","Mercer County",3,34,32,18,14
050,29,129,"Missouri","Mercer County",3,35,37,20,17
050,29,129,"Missouri","Mercer County",3,36,32,16,16
050,29,129,"Missouri","Mercer County",3,37,32,15,17
050,29,129,"Missouri","Mercer County",3,38,37,20,17
050,29,129,"Missouri","Mercer County",3,39,37,21,16
050,29,129,"Missouri","Mercer County",3,40,43,17,26
050,29,129,"Missouri","Mercer County",3,41,51,20,31
050,29,129,"Missouri","Mercer County",3,42,36,18,18
050,29,129,"Missouri","Mercer County",3,43,30,13,17
050,29,129,"Missouri","Mercer County",3,44,28,15,13
050,29,129,"Missouri","Mercer County",3,45,33,16,17
050,29,129,"Missouri","Mercer County",3,46,34,19,15
050,29,129,"Missouri","Mercer County",3,47,32,16,16
050,29,129,"Missouri","Mercer County",3,48,42,21,21
050,29,129,"Missouri","Mercer County",3,49,47,27,20
050,29,129,"Missouri","Mercer County",3,50,44,24,20
050,29,129,"Missouri","Mercer County",3,51,41,21,20
050,29,129,"Missouri","Mercer County",3,52,44,23,21
050,29,129,"Missouri","Mercer County",3,53,39,20,19
050,29,129,"Missouri","Mercer County",3,54,35,14,21
050,29,129,"Missouri","Mercer County",3,55,44,19,25
050,29,129,"Missouri","Mercer County",3,56,47,24,23
050,29,129,"Missouri","Mercer County",3,57,46,23,23
050,29,129,"Missouri","Mercer County",3,58,50,22,28
050,29,129,"Missouri","Mercer County",3,59,55,25,30
050,29,129,"Missouri","Mercer County",3,60,53,27,26
050,29,129,"Missouri","Mercer County",3,61,53,25,28
050,29,129,"Missouri","Mercer County",3,62,53,26,27
050,29,129,"Missouri","Mercer County",3,63,62,33,29
050,29,129,"Missouri","Mercer County",3,64,56,28,28
050,29,129,"Missouri","Mercer County",3,65,53,30,23
050,29,129,"Missouri","Mercer County",3,66,58,33,25
050,29,129,"Missouri","Mercer County",3,67,57,26,31
050,29,129,"Missouri","Mercer County",3,68,51,24,27
050,29,129,"Missouri","Mercer County",3,69,47,24,23
050,29,129,"Missouri","Mercer County",3,70,39,21,18
050,29,129,"Missouri","Mercer County",3,71,39,24,15
050,29,129,"Missouri","Mercer County",3,72,36,23,13
050,29,129,"Missouri","Mercer County",3,73,33,17,16
050,29,129,"Missouri","Mercer County",3,74,32,14,18
050,29,129,"Missouri","Mercer County",3,75,20,10,10
050,29,129,"Missouri","Mercer County",3,76,20,13,7
050,29,129,"Missouri","Mercer County",3,77,23,11,12
050,29,129,"Missouri","Mercer County",3,78,25,11,14
050,29,129,"Missouri","Mercer County",3,79,28,10,18
050,29,129,"Missouri","Mercer County",3,80,21,9,12
050,29,129,"Missouri","Mercer County",3,81,20,11,9
050,29,129,"Missouri","Mercer County",3,82,20,11,9
050,29,129,"Missouri","Mercer County",3,83,16,9,7
050,29,129,"Missouri","Mercer County",3,84,18,7,11
050,29,129,"Missouri","Mercer County",3,85,125,42,83
050,29,129,"Missouri","Mercer County",4,0,49,23,26
050,29,129,"Missouri","Mercer County",4,1,48,26,22
050,29,129,"Missouri","Mercer County",4,2,46,27,19
050,29,129,"Missouri","Mercer County",4,3,34,16,18
050,29,129,"Missouri","Mercer County",4,4,49,24,25
050,29,129,"Missouri","Mercer County",4,5,51,24,27
050,29,129,"Missouri","Mercer County",4,6,38,16,22
050,29,129,"Missouri","Mercer County",4,7,44,25,19
050,29,129,"Missouri","Mercer County",4,8,49,28,21
050,29,129,"Missouri","Mercer County",4,9,45,22,23
050,29,129,"Missouri","Mercer County",4,10,47,21,26
050,29,129,"Missouri","Mercer County",4,11,39,17,22
050,29,129,"Missouri","Mercer County",4,12,47,22,25
050,29,129,"Missouri","Mercer County",4,13,51,29,22
050,29,129,"Missouri","Mercer County",4,14,49,28,21
050,29,129,"Missouri","Mercer County",4,15,54,25,29
050,29,129,"Missouri","Mercer County",4,16,51,28,23
050,29,129,"Missouri","Mercer County",4,17,54,28,26
050,29,129,"Missouri","Mercer County",4,18,38,20,18
050,29,129,"Missouri","Mercer County",4,19,32,17,15
050,29,129,"Missouri","Mercer County",4,20,38,21,17
050,29,129,"Missouri","Mercer County",4,21,37,19,18
050,29,129,"Missouri","Mercer County",4,22,27,15,12
050,29,129,"Missouri","Mercer County",4,23,34,20,14
050,29,129,"Missouri","Mercer County",4,24,38,19,19
050,29,129,"Missouri","Mercer County",4,25,36,18,18
050,29,129,"Missouri","Mercer County",4,26,39,21,18
050,29,129,"Missouri","Mercer County",4,27,40,22,18
050,29,129,"Missouri","Mercer County",4,28,29,16,13
050,29,129,"Missouri","Mercer County",4,29,34,15,19
050,29,129,"Missouri","Mercer County",4,30,26,13,13
050,29,129,"Missouri","Mercer County",4,31,36,19,17
050,29,129,"Missouri","Mercer County",4,32,31,17,14
050,29,129,"Missouri","Mercer County",4,33,31,12,19
050,29,129,"Missouri","Mercer County",4,34,29,16,13
050,29,129,"Missouri","Mercer County",4,35,38,22,16
050,29,129,"Missouri","Mercer County",4,36,35,19,16
050,29,129,"Missouri","Mercer County",4,37,27,14,13
050,29,129,"Missouri","Mercer County",4,38,29,13,16
050,29,129,"Missouri","Mercer County",4,39,36,20,16
050,29,129,"Missouri","Mercer County",4,40,39,21,18
050,29,129,"Missouri","Mercer County",4,41,45,18,27
050,29,129,"Missouri","Mercer County",4,42,49,18,31
050,29,129,"Missouri","Mercer County",4,43,39,21,18
050,29,129,"Missouri","Mercer County",4,44,26,13,13
050,29,129,"Missouri","Mercer County",4,45,30,16,14
050,29,129,"Missouri","Mercer County",4,46,33,15,18
050,29,129,"Missouri","Mercer County",4,47,37,20,17
050,29,129,"Missouri","Mercer County",4,48,31,15,16
050,29,129,"Missouri","Mercer County",4,49,44,23,21
050,29,129,"Missouri","Mercer County",4,50,41,21,20
050,29,129,"Missouri","Mercer County",4,51,48,28,20
050,29,129,"Missouri","Mercer County",4,52,41,21,20
050,29,129,"Missouri","Mercer County",4,53,44,22,22
050,29,129,"Missouri","Mercer County",4,54,40,20,20
050,29,129,"Missouri","Mercer County",4,55,30,13,17
050,29,129,"Missouri","Mercer County",4,56,49,20,29
050,29,129,"Missouri","Mercer County",4,57,46,24,22
050,29,129,"Missouri","Mercer County",4,58,47,24,23
050,29,129,"Missouri","Mercer County",4,59,51,23,28
050,29,129,"Missouri","Mercer County",4,60,53,25,28
050,29,129,"Missouri","Mercer County",4,61,50,24,26
050,29,129,"Missouri","Mercer County",4,62,62,29,33
050,29,129,"Missouri","Mercer County",4,63,55,28,27
050,29,129,"Missouri","Mercer County",4,64,61,31,30
050,29,129,"Missouri","Mercer County",4,65,54,26,28
050,29,129,"Missouri","Mercer County",4,66,54,29,25
050,29,129,"Missouri","Mercer County",4,67,59,35,24
050,29,129,"Missouri","Mercer County",4,68,55,25,30
050,29,129,"Missouri","Mercer County",4,69,49,22,27
050,29,129,"Missouri","Mercer County",4,70,49,25,24
050,29,129,"Missouri","Mercer County",4,71,40,19,21
050,29,129,"Missouri","Mercer County",4,72,38,24,14
050,29,129,"Missouri","Mercer County",4,73,32,21,11
050,29,129,"Missouri","Mercer County",4,74,29,17,12
050,29,129,"Missouri","Mercer County",4,75,32,12,20
050,29,129,"Missouri","Mercer County",4,76,19,10,9
050,29,129,"Missouri","Mercer County",4,77,21,13,8
050,29,129,"Missouri","Mercer County",4,78,17,8,9
050,29,129,"Missouri","Mercer County",4,79,19,10,9
050,29,129,"Missouri","Mercer County",4,80,24,7,17
050,29,129,"Missouri","Mercer County",4,81,18,8,10
050,29,129,"Missouri","Mercer County",4,82,19,10,9
050,29,129,"Missouri","Mercer County",4,83,18,9,9
050,29,129,"Missouri","Mercer County",4,84,20,9,11
050,29,129,"Missouri","Mercer County",4,85,124,44,80
050,29,129,"Missouri","Mercer County",5,0,51,26,25
050,29,129,"Missouri","Mercer County",5,1,51,26,25
050,29,129,"Missouri","Mercer County",5,2,47,25,22
050,29,129,"Missouri","Mercer County",5,3,49,26,23
050,29,129,"Missouri","Mercer County",5,4,34,15,19
050,29,129,"Missouri","Mercer County",5,5,50,21,29
050,29,129,"Missouri","Mercer County",5,6,51,23,28
050,29,129,"Missouri","Mercer County",5,7,37,17,20
050,29,129,"Missouri","Mercer County",5,8,48,26,22
050,29,129,"Missouri","Mercer County",5,9,45,25,20
050,29,129,"Missouri","Mercer County",5,10,50,26,24
050,29,129,"Missouri","Mercer County",5,11,47,21,26
050,29,129,"Missouri","Mercer County",5,12,42,18,24
050,29,129,"Missouri","Mercer County",5,13,46,19,27
050,29,129,"Missouri","Mercer County",5,14,48,26,22
050,29,129,"Missouri","Mercer County",5,15,50,28,22
050,29,129,"Missouri","Mercer County",5,16,59,27,32
050,29,129,"Missouri","Mercer County",5,17,53,30,23
050,29,129,"Missouri","Mercer County",5,18,43,22,21
050,29,129,"Missouri","Mercer County",5,19,28,15,13
050,29,129,"Missouri","Mercer County",5,20,34,19,15
050,29,129,"Missouri","Mercer County",5,21,34,20,14
050,29,129,"Missouri","Mercer County",5,22,38,18,20
050,29,129,"Missouri","Mercer County",5,23,28,14,14
050,29,129,"Missouri","Mercer County",5,24,38,20,18
050,29,129,"Missouri","Mercer County",5,25,33,16,17
050,29,129,"Missouri","Mercer County",5,26,35,18,17
050,29,129,"Missouri","Mercer County",5,27,42,21,21
050,29,129,"Missouri","Mercer County",5,28,40,21,19
050,29,129,"Missouri","Mercer County",5,29,24,12,12
050,29,129,"Missouri","Mercer County",5,30,32,14,18
050,29,129,"Missouri","Mercer County",5,31,30,15,15
050,29,129,"Missouri","Mercer County",5,32,37,18,19
050,29,129,"Missouri","Mercer County",5,33,31,16,15
050,29,129,"Missouri","Mercer County",5,34,30,13,17
050,29,129,"Missouri","Mercer County",5,35,31,15,16
050,29,129,"Missouri","Mercer County",5,36,36,20,16
050,29,129,"Missouri","Mercer County",5,37,38,20,18
050,29,129,"Missouri","Mercer County",5,38,25,12,13
050,29,129,"Missouri","Mercer County",5,39,30,13,17
050,29,129,"Missouri","Mercer County",5,40,38,18,20
050,29,129,"Missouri","Mercer County",5,41,40,24,16
050,29,129,"Missouri","Mercer County",5,42,46,18,28
050,29,129,"Missouri","Mercer County",5,43,48,18,30
050,29,129,"Missouri","Mercer County",5,44,38,19,19
050,29,129,"Missouri","Mercer County",5,45,29,15,14
050,29,129,"Missouri","Mercer County",5,46,30,15,15
050,29,129,"Missouri","Mercer County",5,47,35,17,18
050,29,129,"Missouri","Mercer County",5,48,37,19,18
050,29,129,"Missouri","Mercer County",5,49,33,17,16
050,29,129,"Missouri","Mercer County",5,50,42,19,23
050,29,129,"Missouri","Mercer County",5,51,43,23,20
050,29,129,"Missouri","Mercer County",5,52,48,29,19
050,29,129,"Missouri","Mercer County",5,53,43,22,21
050,29,129,"Missouri","Mercer County",5,54,44,23,21
050,29,129,"Missouri","Mercer County",5,55,40,20,20
050,29,129,"Missouri","Mercer County",5,56,33,14,19
050,29,129,"Missouri","Mercer County",5,57,45,20,25
050,29,129,"Missouri","Mercer County",5,58,47,25,22
050,29,129,"Missouri","Mercer County",5,59,46,22,24
050,29,129,"Missouri","Mercer County",5,60,43,18,25
050,29,129,"Missouri","Mercer County",5,61,49,23,26
050,29,129,"Missouri","Mercer County",5,62,52,24,28
050,29,129,"Missouri","Mercer County",5,63,54,26,28
050,29,129,"Missouri","Mercer County",5,64,53,28,25
050,29,129,"Missouri","Mercer County",5,65,58,30,28
050,29,129,"Missouri","Mercer County",5,66,55,27,28
050,29,129,"Missouri","Mercer County",5,67,56,31,25
050,29,129,"Missouri","Mercer County",5,68,62,35,27
050,29,129,"Missouri","Mercer County",5,69,53,24,29
050,29,129,"Missouri","Mercer County",5,70,50,22,28
050,29,129,"Missouri","Mercer County",5,71,48,23,25
050,29,129,"Missouri","Mercer County",5,72,40,19,21
050,29,129,"Missouri","Mercer County",5,73,36,22,14
050,29,129,"Missouri","Mercer County",5,74,30,20,10
050,29,129,"Missouri","Mercer County",5,75,28,15,13
050,29,129,"Missouri","Mercer County",5,76,31,12,19
050,29,129,"Missouri","Mercer County",5,77,19,10,9
050,29,129,"Missouri","Mercer County",5,78,17,10,7
050,29,129,"Missouri","Mercer County",5,79,13,7,6
050,29,129,"Missouri","Mercer County",5,80,16,8,8
050,29,129,"Missouri","Mercer County",5,81,22,6,16
050,29,129,"Missouri","Mercer County",5,82,19,9,10
050,29,129,"Missouri","Mercer County",5,83,18,9,9
050,29,129,"Missouri","Mercer County",5,84,21,9,12
050,29,129,"Missouri","Mercer County",5,85,126,48,78
050,29,131,"Missouri","Miller County",1,0,301,154,147
050,29,131,"Missouri","Miller County",1,1,309,158,151
050,29,131,"Missouri","Miller County",1,2,305,159,146
050,29,131,"Missouri","Miller County",1,3,301,158,143
050,29,131,"Missouri","Miller County",1,4,317,159,158
050,29,131,"Missouri","Miller County",1,5,334,157,177
050,29,131,"Missouri","Miller County",1,6,325,159,166
050,29,131,"Missouri","Miller County",1,7,328,174,154
050,29,131,"Missouri","Miller County",1,8,302,155,147
050,29,131,"Missouri","Miller County",1,9,323,168,155
050,29,131,"Missouri","Miller County",1,10,335,171,164
050,29,131,"Missouri","Miller County",1,11,334,161,173
050,29,131,"Missouri","Miller County",1,12,364,188,176
050,29,131,"Missouri","Miller County",1,13,353,185,168
050,29,131,"Missouri","Miller County",1,14,334,181,153
050,29,131,"Missouri","Miller County",1,15,351,178,173
050,29,131,"Missouri","Miller County",1,16,342,171,171
050,29,131,"Missouri","Miller County",1,17,321,155,166
050,29,131,"Missouri","Miller County",1,18,275,144,131
050,29,131,"Missouri","Miller County",1,19,218,118,100
050,29,131,"Missouri","Miller County",1,20,247,135,112
050,29,131,"Missouri","Miller County",1,21,275,148,127
050,29,131,"Missouri","Miller County",1,22,278,147,131
050,29,131,"Missouri","Miller County",1,23,256,144,112
050,29,131,"Missouri","Miller County",1,24,260,129,131
050,29,131,"Missouri","Miller County",1,25,262,132,130
050,29,131,"Missouri","Miller County",1,26,257,136,121
050,29,131,"Missouri","Miller County",1,27,263,127,136
050,29,131,"Missouri","Miller County",1,28,290,143,147
050,29,131,"Missouri","Miller County",1,29,300,136,164
050,29,131,"Missouri","Miller County",1,30,294,142,152
050,29,131,"Missouri","Miller County",1,31,279,130,149
050,29,131,"Missouri","Miller County",1,32,268,131,137
050,29,131,"Missouri","Miller County",1,33,323,168,155
050,29,131,"Missouri","Miller County",1,34,300,163,137
050,29,131,"Missouri","Miller County",1,35,295,158,137
050,29,131,"Missouri","Miller County",1,36,305,156,149
050,29,131,"Missouri","Miller County",1,37,302,162,140
050,29,131,"Missouri","Miller County",1,38,321,160,161
050,29,131,"Missouri","Miller County",1,39,311,144,167
050,29,131,"Missouri","Miller County",1,40,295,143,152
050,29,131,"Missouri","Miller County",1,41,269,135,134
050,29,131,"Missouri","Miller County",1,42,272,142,130
050,29,131,"Missouri","Miller County",1,43,261,142,119
050,29,131,"Missouri","Miller County",1,44,271,133,138
050,29,131,"Missouri","Miller County",1,45,283,142,141
050,29,131,"Missouri","Miller County",1,46,271,136,135
050,29,131,"Missouri","Miller County",1,47,280,149,131
050,29,131,"Missouri","Miller County",1,48,291,151,140
050,29,131,"Missouri","Miller County",1,49,328,181,147
050,29,131,"Missouri","Miller County",1,50,326,185,141
050,29,131,"Missouri","Miller County",1,51,283,153,130
050,29,131,"Missouri","Miller County",1,52,288,153,135
050,29,131,"Missouri","Miller County",1,53,321,170,151
050,29,131,"Missouri","Miller County",1,54,321,162,159
050,29,131,"Missouri","Miller County",1,55,331,174,157
050,29,131,"Missouri","Miller County",1,56,355,182,173
050,29,131,"Missouri","Miller County",1,57,362,169,193
050,29,131,"Missouri","Miller County",1,58,355,177,178
050,29,131,"Missouri","Miller County",1,59,350,171,179
050,29,131,"Missouri","Miller County",1,60,349,169,180
050,29,131,"Missouri","Miller County",1,61,350,170,180
050,29,131,"Missouri","Miller County",1,62,349,172,177
050,29,131,"Missouri","Miller County",1,63,370,189,181
050,29,131,"Missouri","Miller County",1,64,352,176,176
050,29,131,"Missouri","Miller County",1,65,322,156,166
050,29,131,"Missouri","Miller County",1,66,318,148,170
050,29,131,"Missouri","Miller County",1,67,325,155,170
050,29,131,"Missouri","Miller County",1,68,307,151,156
050,29,131,"Missouri","Miller County",1,69,273,135,138
050,29,131,"Missouri","Miller County",1,70,295,141,154
050,29,131,"Missouri","Miller County",1,71,276,130,146
050,29,131,"Missouri","Miller County",1,72,263,124,139
050,29,131,"Missouri","Miller County",1,73,270,147,123
050,29,131,"Missouri","Miller County",1,74,183,98,85
050,29,131,"Missouri","Miller County",1,75,183,92,91
050,29,131,"Missouri","Miller County",1,76,193,84,109
050,29,131,"Missouri","Miller County",1,77,171,78,93
050,29,131,"Missouri","Miller County",1,78,150,68,82
050,29,131,"Missouri","Miller County",1,79,161,78,83
050,29,131,"Missouri","Miller County",1,80,119,54,65
050,29,131,"Missouri","Miller County",1,81,114,49,65
050,29,131,"Missouri","Miller County",1,82,109,46,63
050,29,131,"Missouri","Miller County",1,83,102,37,65
050,29,131,"Missouri","Miller County",1,84,92,44,48
050,29,131,"Missouri","Miller County",1,85,560,234,326
050,29,131,"Missouri","Miller County",2,0,304,155,149
050,29,131,"Missouri","Miller County",2,1,306,156,150
050,29,131,"Missouri","Miller County",2,2,303,156,147
050,29,131,"Missouri","Miller County",2,3,302,158,144
050,29,131,"Missouri","Miller County",2,4,318,161,157
050,29,131,"Missouri","Miller County",2,5,330,157,173
050,29,131,"Missouri","Miller County",2,6,331,161,170
050,29,131,"Missouri","Miller County",2,7,328,171,157
050,29,131,"Missouri","Miller County",2,8,308,160,148
050,29,131,"Missouri","Miller County",2,9,321,166,155
050,29,131,"Missouri","Miller County",2,10,333,171,162
050,29,131,"Missouri","Miller County",2,11,336,165,171
050,29,131,"Missouri","Miller County",2,12,357,183,174
050,29,131,"Missouri","Miller County",2,13,355,186,169
050,29,131,"Missouri","Miller County",2,14,341,183,158
050,29,131,"Missouri","Miller County",2,15,350,180,170
050,29,131,"Missouri","Miller County",2,16,345,173,172
050,29,131,"Missouri","Miller County",2,17,324,157,167
050,29,131,"Missouri","Miller County",2,18,271,141,130
050,29,131,"Missouri","Miller County",2,19,221,119,102
050,29,131,"Missouri","Miller County",2,20,247,134,113
050,29,131,"Missouri","Miller County",2,21,271,146,125
050,29,131,"Missouri","Miller County",2,22,281,150,131
050,29,131,"Missouri","Miller County",2,23,263,145,118
050,29,131,"Missouri","Miller County",2,24,260,132,128
050,29,131,"Missouri","Miller County",2,25,263,131,132
050,29,131,"Missouri","Miller County",2,26,260,135,125
050,29,131,"Missouri","Miller County",2,27,263,129,134
050,29,131,"Missouri","Miller County",2,28,284,138,146
050,29,131,"Missouri","Miller County",2,29,298,138,160
050,29,131,"Missouri","Miller County",2,30,301,143,158
050,29,131,"Missouri","Miller County",2,31,282,133,149
050,29,131,"Missouri","Miller County",2,32,272,130,142
050,29,131,"Missouri","Miller County",2,33,311,159,152
050,29,131,"Missouri","Miller County",2,34,308,165,143
050,29,131,"Missouri","Miller County",2,35,300,162,138
050,29,131,"Missouri","Miller County",2,36,301,154,147
050,29,131,"Missouri","Miller County",2,37,306,163,143
050,29,131,"Missouri","Miller County",2,38,319,161,158
050,29,131,"Missouri","Miller County",2,39,313,148,165
050,29,131,"Missouri","Miller County",2,40,300,143,157
050,29,131,"Missouri","Miller County",2,41,278,138,140
050,29,131,"Missouri","Miller County",2,42,270,140,130
050,29,131,"Missouri","Miller County",2,43,267,143,124
050,29,131,"Missouri","Miller County",2,44,265,133,132
050,29,131,"Missouri","Miller County",2,45,283,141,142
050,29,131,"Missouri","Miller County",2,46,272,136,136
050,29,131,"Missouri","Miller County",2,47,276,144,132
050,29,131,"Missouri","Miller County",2,48,289,151,138
050,29,131,"Missouri","Miller County",2,49,322,176,146
050,29,131,"Missouri","Miller County",2,50,329,186,143
050,29,131,"Missouri","Miller County",2,51,291,158,133
050,29,131,"Missouri","Miller County",2,52,287,153,134
050,29,131,"Missouri","Miller County",2,53,314,166,148
050,29,131,"Missouri","Miller County",2,54,320,165,155
050,29,131,"Missouri","Miller County",2,55,329,172,157
050,29,131,"Missouri","Miller County",2,56,352,183,169
050,29,131,"Missouri","Miller County",2,57,363,173,190
050,29,131,"Missouri","Miller County",2,58,353,173,180
050,29,131,"Missouri","Miller County",2,59,353,173,180
050,29,131,"Missouri","Miller County",2,60,347,168,179
050,29,131,"Missouri","Miller County",2,61,347,167,180
050,29,131,"Missouri","Miller County",2,62,348,171,177
050,29,131,"Missouri","Miller County",2,63,369,188,181
050,29,131,"Missouri","Miller County",2,64,352,176,176
050,29,131,"Missouri","Miller County",2,65,329,160,169
050,29,131,"Missouri","Miller County",2,66,315,147,168
050,29,131,"Missouri","Miller County",2,67,323,152,171
050,29,131,"Missouri","Miller County",2,68,306,150,156
050,29,131,"Missouri","Miller County",2,69,281,140,141
050,29,131,"Missouri","Miller County",2,70,286,137,149
050,29,131,"Missouri","Miller County",2,71,280,133,147
050,29,131,"Missouri","Miller County",2,72,261,121,140
050,29,131,"Missouri","Miller County",2,73,279,148,131
050,29,131,"Missouri","Miller County",2,74,192,103,89
050,29,131,"Missouri","Miller County",2,75,183,93,90
050,29,131,"Missouri","Miller County",2,76,186,85,101
050,29,131,"Missouri","Miller County",2,77,181,81,100
050,29,131,"Missouri","Miller County",2,78,149,68,81
050,29,131,"Missouri","Miller County",2,79,157,75,82
050,29,131,"Missouri","Miller County",2,80,127,59,68
050,29,131,"Missouri","Miller County",2,81,115,51,64
050,29,131,"Missouri","Miller County",2,82,105,45,60
050,29,131,"Missouri","Miller County",2,83,104,37,67
050,29,131,"Missouri","Miller County",2,84,94,44,50
050,29,131,"Missouri","Miller County",2,85,559,235,324
050,29,131,"Missouri","Miller County",3,0,292,150,142
050,29,131,"Missouri","Miller County",3,1,322,161,161
050,29,131,"Missouri","Miller County",3,2,309,161,148
050,29,131,"Missouri","Miller County",3,3,310,159,151
050,29,131,"Missouri","Miller County",3,4,304,163,141
050,29,131,"Missouri","Miller County",3,5,339,174,165
050,29,131,"Missouri","Miller County",3,6,356,168,188
050,29,131,"Missouri","Miller County",3,7,334,166,168
050,29,131,"Missouri","Miller County",3,8,326,177,149
050,29,131,"Missouri","Miller County",3,9,308,161,147
050,29,131,"Missouri","Miller County",3,10,322,165,157
050,29,131,"Missouri","Miller County",3,11,330,175,155
050,29,131,"Missouri","Miller County",3,12,330,161,169
050,29,131,"Missouri","Miller County",3,13,355,178,177
050,29,131,"Missouri","Miller County",3,14,358,186,172
050,29,131,"Missouri","Miller County",3,15,345,186,159
050,29,131,"Missouri","Miller County",3,16,342,172,170
050,29,131,"Missouri","Miller County",3,17,341,173,168
050,29,131,"Missouri","Miller County",3,18,279,147,132
050,29,131,"Missouri","Miller County",3,19,220,118,102
050,29,131,"Missouri","Miller County",3,20,232,121,111
050,29,131,"Missouri","Miller County",3,21,249,131,118
050,29,131,"Missouri","Miller County",3,22,286,151,135
050,29,131,"Missouri","Miller County",3,23,301,165,136
050,29,131,"Missouri","Miller County",3,24,271,146,125
050,29,131,"Missouri","Miller County",3,25,277,138,139
050,29,131,"Missouri","Miller County",3,26,271,135,136
050,29,131,"Missouri","Miller County",3,27,260,130,130
050,29,131,"Missouri","Miller County",3,28,259,121,138
050,29,131,"Missouri","Miller County",3,29,295,134,161
050,29,131,"Missouri","Miller County",3,30,301,147,154
050,29,131,"Missouri","Miller County",3,31,296,147,149
050,29,131,"Missouri","Miller County",3,32,300,144,156
050,29,131,"Missouri","Miller County",3,33,282,134,148
050,29,131,"Missouri","Miller County",3,34,322,163,159
050,29,131,"Missouri","Miller County",3,35,313,174,139
050,29,131,"Missouri","Miller County",3,36,296,160,136
050,29,131,"Missouri","Miller County",3,37,307,155,152
050,29,131,"Missouri","Miller County",3,38,318,172,146
050,29,131,"Missouri","Miller County",3,39,308,153,155
050,29,131,"Missouri","Miller County",3,40,312,150,162
050,29,131,"Missouri","Miller County",3,41,289,138,151
050,29,131,"Missouri","Miller County",3,42,280,139,141
050,29,131,"Missouri","Miller County",3,43,270,145,125
050,29,131,"Missouri","Miller County",3,44,272,140,132
050,29,131,"Missouri","Miller County",3,45,263,133,130
050,29,131,"Missouri","Miller County",3,46,284,136,148
050,29,131,"Missouri","Miller County",3,47,268,129,139
050,29,131,"Missouri","Miller County",3,48,270,140,130
050,29,131,"Missouri","Miller County",3,49,281,143,138
050,29,131,"Missouri","Miller County",3,50,329,183,146
050,29,131,"Missouri","Miller County",3,51,328,189,139
050,29,131,"Missouri","Miller County",3,52,292,153,139
050,29,131,"Missouri","Miller County",3,53,274,144,130
050,29,131,"Missouri","Miller County",3,54,314,161,153
050,29,131,"Missouri","Miller County",3,55,330,165,165
050,29,131,"Missouri","Miller County",3,56,342,181,161
050,29,131,"Missouri","Miller County",3,57,347,185,162
050,29,131,"Missouri","Miller County",3,58,361,169,192
050,29,131,"Missouri","Miller County",3,59,343,162,181
050,29,131,"Missouri","Miller County",3,60,348,172,176
050,29,131,"Missouri","Miller County",3,61,361,176,185
050,29,131,"Missouri","Miller County",3,62,343,161,182
050,29,131,"Missouri","Miller County",3,63,361,177,184
050,29,131,"Missouri","Miller County",3,64,372,190,182
050,29,131,"Missouri","Miller County",3,65,342,170,172
050,29,131,"Missouri","Miller County",3,66,322,154,168
050,29,131,"Missouri","Miller County",3,67,304,139,165
050,29,131,"Missouri","Miller County",3,68,324,155,169
050,29,131,"Missouri","Miller County",3,69,301,144,157
050,29,131,"Missouri","Miller County",3,70,283,141,142
050,29,131,"Missouri","Miller County",3,71,280,135,145
050,29,131,"Missouri","Miller County",3,72,286,131,155
050,29,131,"Missouri","Miller County",3,73,240,117,123
050,29,131,"Missouri","Miller County",3,74,270,143,127
050,29,131,"Missouri","Miller County",3,75,195,103,92
050,29,131,"Missouri","Miller County",3,76,175,85,90
050,29,131,"Missouri","Miller County",3,77,174,77,97
050,29,131,"Missouri","Miller County",3,78,178,80,98
050,29,131,"Missouri","Miller County",3,79,138,65,73
050,29,131,"Missouri","Miller County",3,80,148,71,77
050,29,131,"Missouri","Miller County",3,81,122,59,63
050,29,131,"Missouri","Miller County",3,82,99,42,57
050,29,131,"Missouri","Miller County",3,83,110,43,67
050,29,131,"Missouri","Miller County",3,84,95,37,58
050,29,131,"Missouri","Miller County",3,85,555,239,316
050,29,131,"Missouri","Miller County",4,0,303,154,149
050,29,131,"Missouri","Miller County",4,1,293,137,156
050,29,131,"Missouri","Miller County",4,2,333,166,167
050,29,131,"Missouri","Miller County",4,3,317,155,162
050,29,131,"Missouri","Miller County",4,4,318,167,151
050,29,131,"Missouri","Miller County",4,5,322,170,152
050,29,131,"Missouri","Miller County",4,6,358,181,177
050,29,131,"Missouri","Miller County",4,7,356,174,182
050,29,131,"Missouri","Miller County",4,8,336,158,178
050,29,131,"Missouri","Miller County",4,9,344,186,158
050,29,131,"Missouri","Miller County",4,10,325,173,152
050,29,131,"Missouri","Miller County",4,11,331,168,163
050,29,131,"Missouri","Miller County",4,12,339,185,154
050,29,131,"Missouri","Miller County",4,13,339,172,167
050,29,131,"Missouri","Miller County",4,14,368,186,182
050,29,131,"Missouri","Miller County",4,15,371,199,172
050,29,131,"Missouri","Miller County",4,16,363,198,165
050,29,131,"Missouri","Miller County",4,17,344,178,166
050,29,131,"Missouri","Miller County",4,18,305,155,150
050,29,131,"Missouri","Miller County",4,19,225,120,105
050,29,131,"Missouri","Miller County",4,20,234,127,107
050,29,131,"Missouri","Miller County",4,21,237,117,120
050,29,131,"Missouri","Miller County",4,22,281,147,134
050,29,131,"Missouri","Miller County",4,23,300,163,137
050,29,131,"Missouri","Miller County",4,24,300,163,137
050,29,131,"Missouri","Miller County",4,25,263,135,128
050,29,131,"Missouri","Miller County",4,26,293,147,146
050,29,131,"Missouri","Miller County",4,27,273,139,134
050,29,131,"Missouri","Miller County",4,28,272,133,139
050,29,131,"Missouri","Miller County",4,29,258,115,143
050,29,131,"Missouri","Miller County",4,30,286,130,156
050,29,131,"Missouri","Miller County",4,31,306,149,157
050,29,131,"Missouri","Miller County",4,32,304,146,158
050,29,131,"Missouri","Miller County",4,33,326,161,165
050,29,131,"Missouri","Miller County",4,34,297,144,153
050,29,131,"Missouri","Miller County",4,35,324,167,157
050,29,131,"Missouri","Miller County",4,36,306,168,138
050,29,131,"Missouri","Miller County",4,37,302,168,134
050,29,131,"Missouri","Miller County",4,38,310,155,155
050,29,131,"Missouri","Miller County",4,39,332,186,146
050,29,131,"Missouri","Miller County",4,40,321,155,166
050,29,131,"Missouri","Miller County",4,41,314,145,169
050,29,131,"Missouri","Miller County",4,42,290,145,145
050,29,131,"Missouri","Miller County",4,43,292,145,147
050,29,131,"Missouri","Miller County",4,44,283,146,137
050,29,131,"Missouri","Miller County",4,45,280,146,134
050,29,131,"Missouri","Miller County",4,46,273,135,138
050,29,131,"Missouri","Miller County",4,47,290,137,153
050,29,131,"Missouri","Miller County",4,48,283,134,149
050,29,131,"Missouri","Miller County",4,49,280,142,138
050,29,131,"Missouri","Miller County",4,50,294,154,140
050,29,131,"Missouri","Miller County",4,51,333,183,150
050,29,131,"Missouri","Miller County",4,52,336,198,138
050,29,131,"Missouri","Miller County",4,53,296,151,145
050,29,131,"Missouri","Miller County",4,54,277,142,135
050,29,131,"Missouri","Miller County",4,55,324,166,158
050,29,131,"Missouri","Miller County",4,56,344,177,167
050,29,131,"Missouri","Miller County",4,57,348,185,163
050,29,131,"Missouri","Miller County",4,58,340,177,163
050,29,131,"Missouri","Miller County",4,59,366,171,195
050,29,131,"Missouri","Miller County",4,60,357,169,188
050,29,131,"Missouri","Miller County",4,61,350,172,178
050,29,131,"Missouri","Miller County",4,62,358,175,183
050,29,131,"Missouri","Miller County",4,63,349,164,185
050,29,131,"Missouri","Miller County",4,64,368,182,186
050,29,131,"Missouri","Miller County",4,65,380,196,184
050,29,131,"Missouri","Miller County",4,66,330,164,166
050,29,131,"Missouri","Miller County",4,67,308,143,165
050,29,131,"Missouri","Miller County",4,68,294,140,154
050,29,131,"Missouri","Miller County",4,69,310,144,166
050,29,131,"Missouri","Miller County",4,70,295,137,158
050,29,131,"Missouri","Miller County",4,71,274,137,137
050,29,131,"Missouri","Miller County",4,72,276,125,151
050,29,131,"Missouri","Miller County",4,73,271,125,146
050,29,131,"Missouri","Miller County",4,74,231,110,121
050,29,131,"Missouri","Miller County",4,75,270,145,125
050,29,131,"Missouri","Miller County",4,76,185,94,91
050,29,131,"Missouri","Miller County",4,77,158,75,83
050,29,131,"Missouri","Miller County",4,78,165,74,91
050,29,131,"Missouri","Miller County",4,79,178,79,99
050,29,131,"Missouri","Miller County",4,80,128,59,69
050,29,131,"Missouri","Miller County",4,81,138,64,74
050,29,131,"Missouri","Miller County",4,82,101,48,53
050,29,131,"Missouri","Miller County",4,83,108,43,65
050,29,131,"Missouri","Miller County",4,84,97,43,54
050,29,131,"Missouri","Miller County",4,85,566,240,326
050,29,131,"Missouri","Miller County",5,0,304,155,149
050,29,131,"Missouri","Miller County",5,1,295,155,140
050,29,131,"Missouri","Miller County",5,2,297,142,155
050,29,131,"Missouri","Miller County",5,3,328,166,162
050,29,131,"Missouri","Miller County",5,4,317,160,157
050,29,131,"Missouri","Miller County",5,5,316,165,151
050,29,131,"Missouri","Miller County",5,6,332,174,158
050,29,131,"Missouri","Miller County",5,7,350,176,174
050,29,131,"Missouri","Miller County",5,8,367,178,189
050,29,131,"Missouri","Miller County",5,9,344,162,182
050,29,131,"Missouri","Miller County",5,10,334,190,144
050,29,131,"Missouri","Miller County",5,11,331,178,153
050,29,131,"Missouri","Miller County",5,12,332,165,167
050,29,131,"Missouri","Miller County",5,13,355,191,164
050,29,131,"Missouri","Miller County",5,14,336,175,161
050,29,131,"Missouri","Miller County",5,15,377,191,186
050,29,131,"Missouri","Miller County",5,16,383,203,180
050,29,131,"Missouri","Miller County",5,17,351,192,159
050,29,131,"Missouri","Miller County",5,18,284,146,138
050,29,131,"Missouri","Miller County",5,19,229,121,108
050,29,131,"Missouri","Miller County",5,20,248,130,118
050,29,131,"Missouri","Miller County",5,21,250,132,118
050,29,131,"Missouri","Miller County",5,22,241,130,111
050,29,131,"Missouri","Miller County",5,23,310,158,152
050,29,131,"Missouri","Miller County",5,24,288,153,135
050,29,131,"Missouri","Miller County",5,25,305,161,144
050,29,131,"Missouri","Miller County",5,26,276,141,135
050,29,131,"Missouri","Miller County",5,27,286,141,145
050,29,131,"Missouri","Miller County",5,28,277,145,132
050,29,131,"Missouri","Miller County",5,29,264,136,128
050,29,131,"Missouri","Miller County",5,30,264,120,144
050,29,131,"Missouri","Miller County",5,31,290,135,155
050,29,131,"Missouri","Miller County",5,32,320,158,162
050,29,131,"Missouri","Miller County",5,33,305,150,155
050,29,131,"Missouri","Miller County",5,34,334,158,176
050,29,131,"Missouri","Miller County",5,35,290,139,151
050,29,131,"Missouri","Miller County",5,36,320,165,155
050,29,131,"Missouri","Miller County",5,37,306,165,141
050,29,131,"Missouri","Miller County",5,38,305,167,138
050,29,131,"Missouri","Miller County",5,39,308,152,156
050,29,131,"Missouri","Miller County",5,40,337,190,147
050,29,131,"Missouri","Miller County",5,41,325,163,162
050,29,131,"Missouri","Miller County",5,42,320,147,173
050,29,131,"Missouri","Miller County",5,43,302,148,154
050,29,131,"Missouri","Miller County",5,44,288,141,147
050,29,131,"Missouri","Miller County",5,45,292,154,138
050,29,131,"Missouri","Miller County",5,46,282,150,132
050,29,131,"Missouri","Miller County",5,47,277,136,141
050,29,131,"Missouri","Miller County",5,48,300,146,154
050,29,131,"Missouri","Miller County",5,49,287,134,153
050,29,131,"Missouri","Miller County",5,50,301,156,145
050,29,131,"Missouri","Miller County",5,51,298,151,147
050,29,131,"Missouri","Miller County",5,52,349,194,155
050,29,131,"Missouri","Miller County",5,53,341,196,145
050,29,131,"Missouri","Miller County",5,54,299,149,150
050,29,131,"Missouri","Miller County",5,55,285,139,146
050,29,131,"Missouri","Miller County",5,56,324,167,157
050,29,131,"Missouri","Miller County",5,57,345,183,162
050,29,131,"Missouri","Miller County",5,58,354,187,167
050,29,131,"Missouri","Miller County",5,59,351,175,176
050,29,131,"Missouri","Miller County",5,60,375,173,202
050,29,131,"Missouri","Miller County",5,61,369,177,192
050,29,131,"Missouri","Miller County",5,62,358,172,186
050,29,131,"Missouri","Miller County",5,63,359,174,185
050,29,131,"Missouri","Miller County",5,64,348,163,185
050,29,131,"Missouri","Miller County",5,65,373,186,187
050,29,131,"Missouri","Miller County",5,66,369,191,178
050,29,131,"Missouri","Miller County",5,67,326,159,167
050,29,131,"Missouri","Miller County",5,68,292,138,154
050,29,131,"Missouri","Miller County",5,69,284,130,154
050,29,131,"Missouri","Miller County",5,70,300,137,163
050,29,131,"Missouri","Miller County",5,71,283,130,153
050,29,131,"Missouri","Miller County",5,72,272,131,141
050,29,131,"Missouri","Miller County",5,73,263,122,141
050,29,131,"Missouri","Miller County",5,74,259,118,141
050,29,131,"Missouri","Miller County",5,75,228,110,118
050,29,131,"Missouri","Miller County",5,76,254,133,121
050,29,131,"Missouri","Miller County",5,77,168,86,82
050,29,131,"Missouri","Miller County",5,78,155,73,82
050,29,131,"Missouri","Miller County",5,79,153,68,85
050,29,131,"Missouri","Miller County",5,80,173,75,98
050,29,131,"Missouri","Miller County",5,81,120,54,66
050,29,131,"Missouri","Miller County",5,82,116,53,63
050,29,131,"Missouri","Miller County",5,83,105,47,58
050,29,131,"Missouri","Miller County",5,84,96,42,54
050,29,131,"Missouri","Miller County",5,85,586,253,333
050,29,133,"Missouri","Mississippi County",1,0,151,77,74
050,29,133,"Missouri","Mississippi County",1,1,150,77,73
050,29,133,"Missouri","Mississippi County",1,2,129,66,63
050,29,133,"Missouri","Mississippi County",1,3,143,77,66
050,29,133,"Missouri","Mississippi County",1,4,126,58,68
050,29,133,"Missouri","Mississippi County",1,5,118,56,62
050,29,133,"Missouri","Mississippi County",1,6,125,66,59
050,29,133,"Missouri","Mississippi County",1,7,152,80,72
050,29,133,"Missouri","Mississippi County",1,8,140,60,80
050,29,133,"Missouri","Mississippi County",1,9,168,82,86
050,29,133,"Missouri","Mississippi County",1,10,187,90,97
050,29,133,"Missouri","Mississippi County",1,11,157,80,77
050,29,133,"Missouri","Mississippi County",1,12,163,81,82
050,29,133,"Missouri","Mississippi County",1,13,157,85,72
050,29,133,"Missouri","Mississippi County",1,14,164,87,77
050,29,133,"Missouri","Mississippi County",1,15,172,89,83
050,29,133,"Missouri","Mississippi County",1,16,164,92,72
050,29,133,"Missouri","Mississippi County",1,17,148,74,74
050,29,133,"Missouri","Mississippi County",1,18,145,84,61
050,29,133,"Missouri","Mississippi County",1,19,129,77,52
050,29,133,"Missouri","Mississippi County",1,20,129,75,54
050,29,133,"Missouri","Mississippi County",1,21,125,77,48
050,29,133,"Missouri","Mississippi County",1,22,137,76,61
050,29,133,"Missouri","Mississippi County",1,23,163,95,68
050,29,133,"Missouri","Mississippi County",1,24,170,104,66
050,29,133,"Missouri","Mississippi County",1,25,181,108,73
050,29,133,"Missouri","Mississippi County",1,26,185,116,69
050,29,133,"Missouri","Mississippi County",1,27,158,97,61
050,29,133,"Missouri","Mississippi County",1,28,183,114,69
050,29,133,"Missouri","Mississippi County",1,29,181,112,69
050,29,133,"Missouri","Mississippi County",1,30,166,104,62
050,29,133,"Missouri","Mississippi County",1,31,160,99,61
050,29,133,"Missouri","Mississippi County",1,32,152,86,66
050,29,133,"Missouri","Mississippi County",1,33,154,94,60
050,29,133,"Missouri","Mississippi County",1,34,151,86,65
050,29,133,"Missouri","Mississippi County",1,35,151,87,64
050,29,133,"Missouri","Mississippi County",1,36,163,96,67
050,29,133,"Missouri","Mississippi County",1,37,173,100,73
050,29,133,"Missouri","Mississippi County",1,38,152,90,62
050,29,133,"Missouri","Mississippi County",1,39,171,109,62
050,29,133,"Missouri","Mississippi County",1,40,167,96,71
050,29,133,"Missouri","Mississippi County",1,41,141,84,57
050,29,133,"Missouri","Mississippi County",1,42,154,91,63
050,29,133,"Missouri","Mississippi County",1,43,180,106,74
050,29,133,"Missouri","Mississippi County",1,44,163,91,72
050,29,133,"Missouri","Mississippi County",1,45,164,87,77
050,29,133,"Missouri","Mississippi County",1,46,164,92,72
050,29,133,"Missouri","Mississippi County",1,47,143,90,53
050,29,133,"Missouri","Mississippi County",1,48,155,94,61
050,29,133,"Missouri","Mississippi County",1,49,183,116,67
050,29,133,"Missouri","Mississippi County",1,50,168,107,61
050,29,133,"Missouri","Mississippi County",1,51,158,91,67
050,29,133,"Missouri","Mississippi County",1,52,173,96,77
050,29,133,"Missouri","Mississippi County",1,53,172,94,78
050,29,133,"Missouri","Mississippi County",1,54,162,84,78
050,29,133,"Missouri","Mississippi County",1,55,160,88,72
050,29,133,"Missouri","Mississippi County",1,56,172,91,81
050,29,133,"Missouri","Mississippi County",1,57,177,93,84
050,29,133,"Missouri","Mississippi County",1,58,176,83,93
050,29,133,"Missouri","Mississippi County",1,59,159,80,79
050,29,133,"Missouri","Mississippi County",1,60,168,80,88
050,29,133,"Missouri","Mississippi County",1,61,155,71,84
050,29,133,"Missouri","Mississippi County",1,62,148,71,77
050,29,133,"Missouri","Mississippi County",1,63,154,81,73
050,29,133,"Missouri","Mississippi County",1,64,160,83,77
050,29,133,"Missouri","Mississippi County",1,65,138,63,75
050,29,133,"Missouri","Mississippi County",1,66,149,71,78
050,29,133,"Missouri","Mississippi County",1,67,137,68,69
050,29,133,"Missouri","Mississippi County",1,68,132,64,68
050,29,133,"Missouri","Mississippi County",1,69,126,51,75
050,29,133,"Missouri","Mississippi County",1,70,134,59,75
050,29,133,"Missouri","Mississippi County",1,71,138,65,73
050,29,133,"Missouri","Mississippi County",1,72,144,69,75
050,29,133,"Missouri","Mississippi County",1,73,126,55,71
050,29,133,"Missouri","Mississippi County",1,74,91,39,52
050,29,133,"Missouri","Mississippi County",1,75,94,46,48
050,29,133,"Missouri","Mississippi County",1,76,110,49,61
050,29,133,"Missouri","Mississippi County",1,77,96,47,49
050,29,133,"Missouri","Mississippi County",1,78,88,40,48
050,29,133,"Missouri","Mississippi County",1,79,68,31,37
050,29,133,"Missouri","Mississippi County",1,80,76,38,38
050,29,133,"Missouri","Mississippi County",1,81,60,26,34
050,29,133,"Missouri","Mississippi County",1,82,67,28,39
050,29,133,"Missouri","Mississippi County",1,83,48,23,25
050,29,133,"Missouri","Mississippi County",1,84,39,14,25
050,29,133,"Missouri","Mississippi County",1,85,243,71,172
050,29,133,"Missouri","Mississippi County",2,0,152,82,70
050,29,133,"Missouri","Mississippi County",2,1,148,77,71
050,29,133,"Missouri","Mississippi County",2,2,135,69,66
050,29,133,"Missouri","Mississippi County",2,3,140,74,66
050,29,133,"Missouri","Mississippi County",2,4,131,63,68
050,29,133,"Missouri","Mississippi County",2,5,119,55,64
050,29,133,"Missouri","Mississippi County",2,6,125,64,61
050,29,133,"Missouri","Mississippi County",2,7,144,75,69
050,29,133,"Missouri","Mississippi County",2,8,141,64,77
050,29,133,"Missouri","Mississippi County",2,9,163,78,85
050,29,133,"Missouri","Mississippi County",2,10,182,86,96
050,29,133,"Missouri","Mississippi County",2,11,166,82,84
050,29,133,"Missouri","Mississippi County",2,12,161,81,80
050,29,133,"Missouri","Mississippi County",2,13,159,84,75
050,29,133,"Missouri","Mississippi County",2,14,162,85,77
050,29,133,"Missouri","Mississippi County",2,15,170,88,82
050,29,133,"Missouri","Mississippi County",2,16,165,90,75
050,29,133,"Missouri","Mississippi County",2,17,149,76,73
050,29,133,"Missouri","Mississippi County",2,18,139,78,61
050,29,133,"Missouri","Mississippi County",2,19,126,74,52
050,29,133,"Missouri","Mississippi County",2,20,126,73,53
050,29,133,"Missouri","Mississippi County",2,21,120,72,48
050,29,133,"Missouri","Mississippi County",2,22,126,68,58
050,29,133,"Missouri","Mississippi County",2,23,151,83,68
050,29,133,"Missouri","Mississippi County",2,24,155,88,67
050,29,133,"Missouri","Mississippi County",2,25,166,95,71
050,29,133,"Missouri","Mississippi County",2,26,170,101,69
050,29,133,"Missouri","Mississippi County",2,27,151,90,61
050,29,133,"Missouri","Mississippi County",2,28,164,97,67
050,29,133,"Missouri","Mississippi County",2,29,165,96,69
050,29,133,"Missouri","Mississippi County",2,30,153,91,62
050,29,133,"Missouri","Mississippi County",2,31,143,84,59
050,29,133,"Missouri","Mississippi County",2,32,140,75,65
050,29,133,"Missouri","Mississippi County",2,33,140,78,62
050,29,133,"Missouri","Mississippi County",2,34,138,75,63
050,29,133,"Missouri","Mississippi County",2,35,139,76,63
050,29,133,"Missouri","Mississippi County",2,36,148,82,66
050,29,133,"Missouri","Mississippi County",2,37,157,87,70
050,29,133,"Missouri","Mississippi County",2,38,145,81,64
050,29,133,"Missouri","Mississippi County",2,39,156,94,62
050,29,133,"Missouri","Mississippi County",2,40,157,88,69
050,29,133,"Missouri","Mississippi County",2,41,134,75,59
050,29,133,"Missouri","Mississippi County",2,42,137,77,60
050,29,133,"Missouri","Mississippi County",2,43,165,94,71
050,29,133,"Missouri","Mississippi County",2,44,156,82,74
050,29,133,"Missouri","Mississippi County",2,45,155,78,77
050,29,133,"Missouri","Mississippi County",2,46,154,80,74
050,29,133,"Missouri","Mississippi County",2,47,137,81,56
050,29,133,"Missouri","Mississippi County",2,48,143,84,59
050,29,133,"Missouri","Mississippi County",2,49,163,98,65
050,29,133,"Missouri","Mississippi County",2,50,161,98,63
050,29,133,"Missouri","Mississippi County",2,51,154,87,67
050,29,133,"Missouri","Mississippi County",2,52,162,89,73
050,29,133,"Missouri","Mississippi County",2,53,164,86,78
050,29,133,"Missouri","Mississippi County",2,54,157,79,78
050,29,133,"Missouri","Mississippi County",2,55,155,81,74
050,29,133,"Missouri","Mississippi County",2,56,166,87,79
050,29,133,"Missouri","Mississippi County",2,57,172,89,83
050,29,133,"Missouri","Mississippi County",2,58,172,82,90
050,29,133,"Missouri","Mississippi County",2,59,159,77,82
050,29,133,"Missouri","Mississippi County",2,60,163,76,87
050,29,133,"Missouri","Mississippi County",2,61,152,70,82
050,29,133,"Missouri","Mississippi County",2,62,150,71,79
050,29,133,"Missouri","Mississippi County",2,63,153,78,75
050,29,133,"Missouri","Mississippi County",2,64,155,79,76
050,29,133,"Missouri","Mississippi County",2,65,141,67,74
050,29,133,"Missouri","Mississippi County",2,66,145,68,77
050,29,133,"Missouri","Mississippi County",2,67,140,68,72
050,29,133,"Missouri","Mississippi County",2,68,131,63,68
050,29,133,"Missouri","Mississippi County",2,69,127,53,74
050,29,133,"Missouri","Mississippi County",2,70,130,54,76
050,29,133,"Missouri","Mississippi County",2,71,133,62,71
050,29,133,"Missouri","Mississippi County",2,72,139,65,74
050,29,133,"Missouri","Mississippi County",2,73,134,60,74
050,29,133,"Missouri","Mississippi County",2,74,92,39,53
050,29,133,"Missouri","Mississippi County",2,75,91,42,49
050,29,133,"Missouri","Mississippi County",2,76,105,49,56
050,29,133,"Missouri","Mississippi County",2,77,100,47,53
050,29,133,"Missouri","Mississippi County",2,78,86,40,46
050,29,133,"Missouri","Mississippi County",2,79,72,32,40
050,29,133,"Missouri","Mississippi County",2,80,74,36,38
050,29,133,"Missouri","Mississippi County",2,81,62,28,34
050,29,133,"Missouri","Mississippi County",2,82,64,28,36
050,29,133,"Missouri","Mississippi County",2,83,51,23,28
050,29,133,"Missouri","Mississippi County",2,84,39,15,24
050,29,133,"Missouri","Mississippi County",2,85,243,72,171
050,29,133,"Missouri","Mississippi County",3,0,122,59,63
050,29,133,"Missouri","Mississippi County",3,1,155,82,73
050,29,133,"Missouri","Mississippi County",3,2,144,75,69
050,29,133,"Missouri","Mississippi County",3,3,136,66,70
050,29,133,"Missouri","Mississippi County",3,4,140,75,65
050,29,133,"Missouri","Mississippi County",3,5,125,60,65
050,29,133,"Missouri","Mississippi County",3,6,119,55,64
050,29,133,"Missouri","Mississippi County",3,7,128,66,62
050,29,133,"Missouri","Mississippi County",3,8,143,71,72
050,29,133,"Missouri","Mississippi County",3,9,140,65,75
050,29,133,"Missouri","Mississippi County",3,10,166,81,85
050,29,133,"Missouri","Mississippi County",3,11,179,81,98
050,29,133,"Missouri","Mississippi County",3,12,163,81,82
050,29,133,"Missouri","Mississippi County",3,13,160,86,74
050,29,133,"Missouri","Mississippi County",3,14,156,82,74
050,29,133,"Missouri","Mississippi County",3,15,169,89,80
050,29,133,"Missouri","Mississippi County",3,16,166,87,79
050,29,133,"Missouri","Mississippi County",3,17,168,92,76
050,29,133,"Missouri","Mississippi County",3,18,127,70,57
050,29,133,"Missouri","Mississippi County",3,19,118,68,50
050,29,133,"Missouri","Mississippi County",3,20,137,82,55
050,29,133,"Missouri","Mississippi County",3,21,133,76,57
050,29,133,"Missouri","Mississippi County",3,22,124,74,50
050,29,133,"Missouri","Mississippi County",3,23,160,93,67
050,29,133,"Missouri","Mississippi County",3,24,149,82,67
050,29,133,"Missouri","Mississippi County",3,25,153,87,66
050,29,133,"Missouri","Mississippi County",3,26,176,100,76
050,29,133,"Missouri","Mississippi County",3,27,163,100,63
050,29,133,"Missouri","Mississippi County",3,28,149,88,61
050,29,133,"Missouri","Mississippi County",3,29,168,104,64
050,29,133,"Missouri","Mississippi County",3,30,163,93,70
050,29,133,"Missouri","Mississippi County",3,31,159,99,60
050,29,133,"Missouri","Mississippi County",3,32,147,90,57
050,29,133,"Missouri","Mississippi County",3,33,145,74,71
050,29,133,"Missouri","Mississippi County",3,34,141,76,65
050,29,133,"Missouri","Mississippi County",3,35,145,80,65
050,29,133,"Missouri","Mississippi County",3,36,143,79,64
050,29,133,"Missouri","Mississippi County",3,37,155,90,65
050,29,133,"Missouri","Mississippi County",3,38,152,85,67
050,29,133,"Missouri","Mississippi County",3,39,156,89,67
050,29,133,"Missouri","Mississippi County",3,40,156,95,61
050,29,133,"Missouri","Mississippi County",3,41,163,93,70
050,29,133,"Missouri","Mississippi County",3,42,133,75,58
050,29,133,"Missouri","Mississippi County",3,43,139,77,62
050,29,133,"Missouri","Mississippi County",3,44,165,90,75
050,29,133,"Missouri","Mississippi County",3,45,151,82,69
050,29,133,"Missouri","Mississippi County",3,46,159,81,78
050,29,133,"Missouri","Mississippi County",3,47,147,74,73
050,29,133,"Missouri","Mississippi County",3,48,137,83,54
050,29,133,"Missouri","Mississippi County",3,49,146,79,67
050,29,133,"Missouri","Mississippi County",3,50,166,98,68
050,29,133,"Missouri","Mississippi County",3,51,163,98,65
050,29,133,"Missouri","Mississippi County",3,52,159,90,69
050,29,133,"Missouri","Mississippi County",3,53,158,82,76
050,29,133,"Missouri","Mississippi County",3,54,150,78,72
050,29,133,"Missouri","Mississippi County",3,55,154,76,78
050,29,133,"Missouri","Mississippi County",3,56,165,88,77
050,29,133,"Missouri","Mississippi County",3,57,166,87,79
050,29,133,"Missouri","Mississippi County",3,58,176,92,84
050,29,133,"Missouri","Mississippi County",3,59,164,78,86
050,29,133,"Missouri","Mississippi County",3,60,158,73,85
050,29,133,"Missouri","Mississippi County",3,61,153,71,82
050,29,133,"Missouri","Mississippi County",3,62,153,70,83
050,29,133,"Missouri","Mississippi County",3,63,159,82,77
050,29,133,"Missouri","Mississippi County",3,64,148,70,78
050,29,133,"Missouri","Mississippi County",3,65,146,71,75
050,29,133,"Missouri","Mississippi County",3,66,137,67,70
050,29,133,"Missouri","Mississippi County",3,67,136,61,75
050,29,133,"Missouri","Mississippi County",3,68,133,63,70
050,29,133,"Missouri","Mississippi County",3,69,123,58,65
050,29,133,"Missouri","Mississippi County",3,70,123,53,70
050,29,133,"Missouri","Mississippi County",3,71,124,48,76
050,29,133,"Missouri","Mississippi County",3,72,125,55,70
050,29,133,"Missouri","Mississippi County",3,73,132,60,72
050,29,133,"Missouri","Mississippi County",3,74,128,58,70
050,29,133,"Missouri","Mississippi County",3,75,85,37,48
050,29,133,"Missouri","Mississippi County",3,76,89,40,49
050,29,133,"Missouri","Mississippi County",3,77,100,45,55
050,29,133,"Missouri","Mississippi County",3,78,90,39,51
050,29,133,"Missouri","Mississippi County",3,79,80,37,43
050,29,133,"Missouri","Mississippi County",3,80,66,30,36
050,29,133,"Missouri","Mississippi County",3,81,69,34,35
050,29,133,"Missouri","Mississippi County",3,82,58,26,32
050,29,133,"Missouri","Mississippi County",3,83,55,24,31
050,29,133,"Missouri","Mississippi County",3,84,45,19,26
050,29,133,"Missouri","Mississippi County",3,85,231,60,171
050,29,133,"Missouri","Mississippi County",4,0,138,66,72
050,29,133,"Missouri","Mississippi County",4,1,121,59,62
050,29,133,"Missouri","Mississippi County",4,2,158,83,75
050,29,133,"Missouri","Mississippi County",4,3,160,85,75
050,29,133,"Missouri","Mississippi County",4,4,130,65,65
050,29,133,"Missouri","Mississippi County",4,5,147,81,66
050,29,133,"Missouri","Mississippi County",4,6,123,59,64
050,29,133,"Missouri","Mississippi County",4,7,119,54,65
050,29,133,"Missouri","Mississippi County",4,8,123,65,58
050,29,133,"Missouri","Mississippi County",4,9,140,71,69
050,29,133,"Missouri","Mississippi County",4,10,148,66,82
050,29,133,"Missouri","Mississippi County",4,11,159,76,83
050,29,133,"Missouri","Mississippi County",4,12,178,82,96
050,29,133,"Missouri","Mississippi County",4,13,163,81,82
050,29,133,"Missouri","Mississippi County",4,14,162,87,75
050,29,133,"Missouri","Mississippi County",4,15,159,84,75
050,29,133,"Missouri","Mississippi County",4,16,164,87,77
050,29,133,"Missouri","Mississippi County",4,17,164,86,78
050,29,133,"Missouri","Mississippi County",4,18,142,83,59
050,29,133,"Missouri","Mississippi County",4,19,103,59,44
050,29,133,"Missouri","Mississippi County",4,20,125,70,55
050,29,133,"Missouri","Mississippi County",4,21,141,81,60
050,29,133,"Missouri","Mississippi County",4,22,137,73,64
050,29,133,"Missouri","Mississippi County",4,23,136,83,53
050,29,133,"Missouri","Mississippi County",4,24,143,76,67
050,29,133,"Missouri","Mississippi County",4,25,145,73,72
050,29,133,"Missouri","Mississippi County",4,26,151,87,64
050,29,133,"Missouri","Mississippi County",4,27,161,87,74
050,29,133,"Missouri","Mississippi County",4,28,147,86,61
050,29,133,"Missouri","Mississippi County",4,29,138,82,56
050,29,133,"Missouri","Mississippi County",4,30,155,92,63
050,29,133,"Missouri","Mississippi County",4,31,159,83,76
050,29,133,"Missouri","Mississippi County",4,32,145,84,61
050,29,133,"Missouri","Mississippi County",4,33,139,85,54
050,29,133,"Missouri","Mississippi County",4,34,126,63,63
050,29,133,"Missouri","Mississippi County",4,35,132,68,64
050,29,133,"Missouri","Mississippi County",4,36,138,74,64
050,29,133,"Missouri","Mississippi County",4,37,132,70,62
050,29,133,"Missouri","Mississippi County",4,38,140,75,65
050,29,133,"Missouri","Mississippi County",4,39,148,83,65
050,29,133,"Missouri","Mississippi County",4,40,140,75,65
050,29,133,"Missouri","Mississippi County",4,41,135,77,58
050,29,133,"Missouri","Mississippi County",4,42,148,83,65
050,29,133,"Missouri","Mississippi County",4,43,128,69,59
050,29,133,"Missouri","Mississippi County",4,44,127,65,62
050,29,133,"Missouri","Mississippi County",4,45,155,80,75
050,29,133,"Missouri","Mississippi County",4,46,143,74,69
050,29,133,"Missouri","Mississippi County",4,47,147,70,77
050,29,133,"Missouri","Mississippi County",4,48,148,73,75
050,29,133,"Missouri","Mississippi County",4,49,123,70,53
050,29,133,"Missouri","Mississippi County",4,50,142,72,70
050,29,133,"Missouri","Mississippi County",4,51,154,88,66
050,29,133,"Missouri","Mississippi County",4,52,158,92,66
050,29,133,"Missouri","Mississippi County",4,53,154,86,68
050,29,133,"Missouri","Mississippi County",4,54,143,72,71
050,29,133,"Missouri","Mississippi County",4,55,147,75,72
050,29,133,"Missouri","Mississippi County",4,56,155,73,82
050,29,133,"Missouri","Mississippi County",4,57,154,84,70
050,29,133,"Missouri","Mississippi County",4,58,154,81,73
050,29,133,"Missouri","Mississippi County",4,59,165,84,81
050,29,133,"Missouri","Mississippi County",4,60,156,71,85
050,29,133,"Missouri","Mississippi County",4,61,147,71,76
050,29,133,"Missouri","Mississippi County",4,62,157,71,86
050,29,133,"Missouri","Mississippi County",4,63,151,71,80
050,29,133,"Missouri","Mississippi County",4,64,158,79,79
050,29,133,"Missouri","Mississippi County",4,65,132,58,74
050,29,133,"Missouri","Mississippi County",4,66,145,71,74
050,29,133,"Missouri","Mississippi County",4,67,134,60,74
050,29,133,"Missouri","Mississippi County",4,68,128,57,71
050,29,133,"Missouri","Mississippi County",4,69,126,56,70
050,29,133,"Missouri","Mississippi County",4,70,121,57,64
050,29,133,"Missouri","Mississippi County",4,71,113,49,64
050,29,133,"Missouri","Mississippi County",4,72,111,39,72
050,29,133,"Missouri","Mississippi County",4,73,114,50,64
050,29,133,"Missouri","Mississippi County",4,74,127,59,68
050,29,133,"Missouri","Mississippi County",4,75,120,54,66
050,29,133,"Missouri","Mississippi County",4,76,76,31,45
050,29,133,"Missouri","Mississippi County",4,77,81,35,46
050,29,133,"Missouri","Mississippi County",4,78,90,42,48
050,29,133,"Missouri","Mississippi County",4,79,80,32,48
050,29,133,"Missouri","Mississippi County",4,80,75,39,36
050,29,133,"Missouri","Mississippi County",4,81,64,28,36
050,29,133,"Missouri","Mississippi County",4,82,69,34,35
050,29,133,"Missouri","Mississippi County",4,83,53,23,30
050,29,133,"Missouri","Mississippi County",4,84,47,20,27
050,29,133,"Missouri","Mississippi County",4,85,231,58,173
050,29,133,"Missouri","Mississippi County",5,0,142,69,73
050,29,133,"Missouri","Mississippi County",5,1,147,70,77
050,29,133,"Missouri","Mississippi County",5,2,129,66,63
050,29,133,"Missouri","Mississippi County",5,3,165,83,82
050,29,133,"Missouri","Mississippi County",5,4,160,87,73
050,29,133,"Missouri","Mississippi County",5,5,146,72,74
050,29,133,"Missouri","Mississippi County",5,6,142,78,64
050,29,133,"Missouri","Mississippi County",5,7,126,64,62
050,29,133,"Missouri","Mississippi County",5,8,117,55,62
050,29,133,"Missouri","Mississippi County",5,9,122,67,55
050,29,133,"Missouri","Mississippi County",5,10,139,74,65
050,29,133,"Missouri","Mississippi County",5,11,145,65,80
050,29,133,"Missouri","Mississippi County",5,12,163,76,87
050,29,133,"Missouri","Mississippi County",5,13,182,85,97
050,29,133,"Missouri","Mississippi County",5,14,158,78,80
050,29,133,"Missouri","Mississippi County",5,15,162,86,76
050,29,133,"Missouri","Mississippi County",5,16,160,88,72
050,29,133,"Missouri","Mississippi County",5,17,164,85,79
050,29,133,"Missouri","Mississippi County",5,18,144,82,62
050,29,133,"Missouri","Mississippi County",5,19,111,67,44
050,29,133,"Missouri","Mississippi County",5,20,120,67,53
050,29,133,"Missouri","Mississippi County",5,21,137,75,62
050,29,133,"Missouri","Mississippi County",5,22,138,80,58
050,29,133,"Missouri","Mississippi County",5,23,157,94,63
050,29,133,"Missouri","Mississippi County",5,24,148,88,60
050,29,133,"Missouri","Mississippi County",5,25,143,75,68
050,29,133,"Missouri","Mississippi County",5,26,155,87,68
050,29,133,"Missouri","Mississippi County",5,27,158,91,67
050,29,133,"Missouri","Mississippi County",5,28,166,95,71
050,29,133,"Missouri","Mississippi County",5,29,148,85,63
050,29,133,"Missouri","Mississippi County",5,30,150,92,58
050,29,133,"Missouri","Mississippi County",5,31,169,99,70
050,29,133,"Missouri","Mississippi County",5,32,160,88,72
050,29,133,"Missouri","Mississippi County",5,33,147,84,63
050,29,133,"Missouri","Mississippi County",5,34,144,87,57
050,29,133,"Missouri","Mississippi County",5,35,141,75,66
050,29,133,"Missouri","Mississippi County",5,36,140,78,62
050,29,133,"Missouri","Mississippi County",5,37,136,74,62
050,29,133,"Missouri","Mississippi County",5,38,134,73,61
050,29,133,"Missouri","Mississippi County",5,39,146,81,65
050,29,133,"Missouri","Mississippi County",5,40,154,92,62
050,29,133,"Missouri","Mississippi County",5,41,141,76,65
050,29,133,"Missouri","Mississippi County",5,42,134,80,54
050,29,133,"Missouri","Mississippi County",5,43,151,87,64
050,29,133,"Missouri","Mississippi County",5,44,127,66,61
050,29,133,"Missouri","Mississippi County",5,45,136,73,63
050,29,133,"Missouri","Mississippi County",5,46,162,87,75
050,29,133,"Missouri","Mississippi County",5,47,142,71,71
050,29,133,"Missouri","Mississippi County",5,48,165,89,76
050,29,133,"Missouri","Mississippi County",5,49,155,80,75
050,29,133,"Missouri","Mississippi County",5,50,128,74,54
050,29,133,"Missouri","Mississippi County",5,51,142,73,69
050,29,133,"Missouri","Mississippi County",5,52,156,92,64
050,29,133,"Missouri","Mississippi County",5,53,165,95,70
050,29,133,"Missouri","Mississippi County",5,54,150,83,67
050,29,133,"Missouri","Mississippi County",5,55,140,68,72
050,29,133,"Missouri","Mississippi County",5,56,142,72,70
050,29,133,"Missouri","Mississippi County",5,57,154,71,83
050,29,133,"Missouri","Mississippi County",5,58,158,89,69
050,29,133,"Missouri","Mississippi County",5,59,150,78,72
050,29,133,"Missouri","Mississippi County",5,60,161,79,82
050,29,133,"Missouri","Mississippi County",5,61,147,69,78
050,29,133,"Missouri","Mississippi County",5,62,148,73,75
050,29,133,"Missouri","Mississippi County",5,63,159,75,84
050,29,133,"Missouri","Mississippi County",5,64,149,71,78
050,29,133,"Missouri","Mississippi County",5,65,145,67,78
050,29,133,"Missouri","Mississippi County",5,66,137,64,73
050,29,133,"Missouri","Mississippi County",5,67,146,69,77
050,29,133,"Missouri","Mississippi County",5,68,131,60,71
050,29,133,"Missouri","Mississippi County",5,69,122,50,72
050,29,133,"Missouri","Mississippi County",5,70,125,55,70
050,29,133,"Missouri","Mississippi County",5,71,120,57,63
050,29,133,"Missouri","Mississippi County",5,72,99,41,58
050,29,133,"Missouri","Mississippi County",5,73,109,39,70
050,29,133,"Missouri","Mississippi County",5,74,114,50,64
050,29,133,"Missouri","Mississippi County",5,75,121,54,67
050,29,133,"Missouri","Mississippi County",5,76,114,48,66
050,29,133,"Missouri","Mississippi County",5,77,71,27,44
050,29,133,"Missouri","Mississippi County",5,78,70,29,41
050,29,133,"Missouri","Mississippi County",5,79,80,37,43
050,29,133,"Missouri","Mississippi County",5,80,72,32,40
050,29,133,"Missouri","Mississippi County",5,81,69,35,34
050,29,133,"Missouri","Mississippi County",5,82,61,28,33
050,29,133,"Missouri","Mississippi County",5,83,61,31,30
050,29,133,"Missouri","Mississippi County",5,84,44,18,26
050,29,133,"Missouri","Mississippi County",5,85,234,61,173
050,29,135,"Missouri","Moniteau County",1,0,186,96,90
050,29,135,"Missouri","Moniteau County",1,1,197,104,93
050,29,135,"Missouri","Moniteau County",1,2,194,96,98
050,29,135,"Missouri","Moniteau County",1,3,200,91,109
050,29,135,"Missouri","Moniteau County",1,4,216,107,109
050,29,135,"Missouri","Moniteau County",1,5,215,111,104
050,29,135,"Missouri","Moniteau County",1,6,204,107,97
050,29,135,"Missouri","Moniteau County",1,7,224,109,115
050,29,135,"Missouri","Moniteau County",1,8,241,122,119
050,29,135,"Missouri","Moniteau County",1,9,226,115,111
050,29,135,"Missouri","Moniteau County",1,10,222,114,108
050,29,135,"Missouri","Moniteau County",1,11,215,108,107
050,29,135,"Missouri","Moniteau County",1,12,242,135,107
050,29,135,"Missouri","Moniteau County",1,13,243,119,124
050,29,135,"Missouri","Moniteau County",1,14,218,121,97
050,29,135,"Missouri","Moniteau County",1,15,213,107,106
050,29,135,"Missouri","Moniteau County",1,16,212,106,106
050,29,135,"Missouri","Moniteau County",1,17,227,114,113
050,29,135,"Missouri","Moniteau County",1,18,193,104,89
050,29,135,"Missouri","Moniteau County",1,19,162,83,79
050,29,135,"Missouri","Moniteau County",1,20,172,90,82
050,29,135,"Missouri","Moniteau County",1,21,157,85,72
050,29,135,"Missouri","Moniteau County",1,22,176,92,84
050,29,135,"Missouri","Moniteau County",1,23,174,94,80
050,29,135,"Missouri","Moniteau County",1,24,186,100,86
050,29,135,"Missouri","Moniteau County",1,25,164,103,61
050,29,135,"Missouri","Moniteau County",1,26,187,110,77
050,29,135,"Missouri","Moniteau County",1,27,177,97,80
050,29,135,"Missouri","Moniteau County",1,28,198,111,87
050,29,135,"Missouri","Moniteau County",1,29,227,136,91
050,29,135,"Missouri","Moniteau County",1,30,208,118,90
050,29,135,"Missouri","Moniteau County",1,31,181,103,78
050,29,135,"Missouri","Moniteau County",1,32,182,89,93
050,29,135,"Missouri","Moniteau County",1,33,207,110,97
050,29,135,"Missouri","Moniteau County",1,34,204,115,89
050,29,135,"Missouri","Moniteau County",1,35,192,111,81
050,29,135,"Missouri","Moniteau County",1,36,209,115,94
050,29,135,"Missouri","Moniteau County",1,37,204,124,80
050,29,135,"Missouri","Moniteau County",1,38,222,130,92
050,29,135,"Missouri","Moniteau County",1,39,242,138,104
050,29,135,"Missouri","Moniteau County",1,40,207,121,86
050,29,135,"Missouri","Moniteau County",1,41,205,121,84
050,29,135,"Missouri","Moniteau County",1,42,199,110,89
050,29,135,"Missouri","Moniteau County",1,43,198,113,85
050,29,135,"Missouri","Moniteau County",1,44,200,109,91
050,29,135,"Missouri","Moniteau County",1,45,191,103,88
050,29,135,"Missouri","Moniteau County",1,46,181,100,81
050,29,135,"Missouri","Moniteau County",1,47,192,102,90
050,29,135,"Missouri","Moniteau County",1,48,197,113,84
050,29,135,"Missouri","Moniteau County",1,49,200,112,88
050,29,135,"Missouri","Moniteau County",1,50,197,109,88
050,29,135,"Missouri","Moniteau County",1,51,194,100,94
050,29,135,"Missouri","Moniteau County",1,52,174,93,81
050,29,135,"Missouri","Moniteau County",1,53,171,94,77
050,29,135,"Missouri","Moniteau County",1,54,199,112,87
050,29,135,"Missouri","Moniteau County",1,55,220,119,101
050,29,135,"Missouri","Moniteau County",1,56,215,103,112
050,29,135,"Missouri","Moniteau County",1,57,202,108,94
050,29,135,"Missouri","Moniteau County",1,58,201,101,100
050,29,135,"Missouri","Moniteau County",1,59,202,103,99
050,29,135,"Missouri","Moniteau County",1,60,203,106,97
050,29,135,"Missouri","Moniteau County",1,61,181,94,87
050,29,135,"Missouri","Moniteau County",1,62,191,93,98
050,29,135,"Missouri","Moniteau County",1,63,169,84,85
050,29,135,"Missouri","Moniteau County",1,64,174,87,87
050,29,135,"Missouri","Moniteau County",1,65,166,87,79
050,29,135,"Missouri","Moniteau County",1,66,173,82,91
050,29,135,"Missouri","Moniteau County",1,67,175,82,93
050,29,135,"Missouri","Moniteau County",1,68,155,75,80
050,29,135,"Missouri","Moniteau County",1,69,135,67,68
050,29,135,"Missouri","Moniteau County",1,70,127,62,65
050,29,135,"Missouri","Moniteau County",1,71,136,70,66
050,29,135,"Missouri","Moniteau County",1,72,146,71,75
050,29,135,"Missouri","Moniteau County",1,73,145,67,78
050,29,135,"Missouri","Moniteau County",1,74,103,48,55
050,29,135,"Missouri","Moniteau County",1,75,103,51,52
050,29,135,"Missouri","Moniteau County",1,76,92,41,51
050,29,135,"Missouri","Moniteau County",1,77,84,37,47
050,29,135,"Missouri","Moniteau County",1,78,82,41,41
050,29,135,"Missouri","Moniteau County",1,79,72,34,38
050,29,135,"Missouri","Moniteau County",1,80,73,39,34
050,29,135,"Missouri","Moniteau County",1,81,70,32,38
050,29,135,"Missouri","Moniteau County",1,82,62,29,33
050,29,135,"Missouri","Moniteau County",1,83,50,25,25
050,29,135,"Missouri","Moniteau County",1,84,49,21,28
050,29,135,"Missouri","Moniteau County",1,85,294,100,194
050,29,135,"Missouri","Moniteau County",2,0,192,98,94
050,29,135,"Missouri","Moniteau County",2,1,193,102,91
050,29,135,"Missouri","Moniteau County",2,2,194,96,98
050,29,135,"Missouri","Moniteau County",2,3,199,92,107
050,29,135,"Missouri","Moniteau County",2,4,216,105,111
050,29,135,"Missouri","Moniteau County",2,5,216,111,105
050,29,135,"Missouri","Moniteau County",2,6,209,109,100
050,29,135,"Missouri","Moniteau County",2,7,219,107,112
050,29,135,"Missouri","Moniteau County",2,8,239,120,119
050,29,135,"Missouri","Moniteau County",2,9,230,117,113
050,29,135,"Missouri","Moniteau County",2,10,222,113,109
050,29,135,"Missouri","Moniteau County",2,11,214,109,105
050,29,135,"Missouri","Moniteau County",2,12,238,130,108
050,29,135,"Missouri","Moniteau County",2,13,239,122,117
050,29,135,"Missouri","Moniteau County",2,14,224,120,104
050,29,135,"Missouri","Moniteau County",2,15,213,109,104
050,29,135,"Missouri","Moniteau County",2,16,214,108,106
050,29,135,"Missouri","Moniteau County",2,17,223,113,110
050,29,135,"Missouri","Moniteau County",2,18,192,102,90
050,29,135,"Missouri","Moniteau County",2,19,159,83,76
050,29,135,"Missouri","Moniteau County",2,20,171,88,83
050,29,135,"Missouri","Moniteau County",2,21,161,84,77
050,29,135,"Missouri","Moniteau County",2,22,172,88,84
050,29,135,"Missouri","Moniteau County",2,23,173,89,84
050,29,135,"Missouri","Moniteau County",2,24,176,93,83
050,29,135,"Missouri","Moniteau County",2,25,162,97,65
050,29,135,"Missouri","Moniteau County",2,26,176,101,75
050,29,135,"Missouri","Moniteau County",2,27,170,91,79
050,29,135,"Missouri","Moniteau County",2,28,185,100,85
050,29,135,"Missouri","Moniteau County",2,29,213,122,91
050,29,135,"Missouri","Moniteau County",2,30,205,115,90
050,29,135,"Missouri","Moniteau County",2,31,178,97,81
050,29,135,"Missouri","Moniteau County",2,32,173,82,91
050,29,135,"Missouri","Moniteau County",2,33,193,97,96
050,29,135,"Missouri","Moniteau County",2,34,195,104,91
050,29,135,"Missouri","Moniteau County",2,35,189,104,85
050,29,135,"Missouri","Moniteau County",2,36,194,104,90
050,29,135,"Missouri","Moniteau County",2,37,198,115,83
050,29,135,"Missouri","Moniteau County",2,38,209,119,90
050,29,135,"Missouri","Moniteau County",2,39,226,126,100
050,29,135,"Missouri","Moniteau County",2,40,208,117,91
050,29,135,"Missouri","Moniteau County",2,41,201,115,86
050,29,135,"Missouri","Moniteau County",2,42,193,106,87
050,29,135,"Missouri","Moniteau County",2,43,192,105,87
050,29,135,"Missouri","Moniteau County",2,44,190,101,89
050,29,135,"Missouri","Moniteau County",2,45,186,99,87
050,29,135,"Missouri","Moniteau County",2,46,176,93,83
050,29,135,"Missouri","Moniteau County",2,47,180,92,88
050,29,135,"Missouri","Moniteau County",2,48,189,103,86
050,29,135,"Missouri","Moniteau County",2,49,194,107,87
050,29,135,"Missouri","Moniteau County",2,50,191,103,88
050,29,135,"Missouri","Moniteau County",2,51,190,97,93
050,29,135,"Missouri","Moniteau County",2,52,172,89,83
050,29,135,"Missouri","Moniteau County",2,53,167,90,77
050,29,135,"Missouri","Moniteau County",2,54,191,106,85
050,29,135,"Missouri","Moniteau County",2,55,211,113,98
050,29,135,"Missouri","Moniteau County",2,56,213,104,109
050,29,135,"Missouri","Moniteau County",2,57,204,106,98
050,29,135,"Missouri","Moniteau County",2,58,201,101,100
050,29,135,"Missouri","Moniteau County",2,59,201,102,99
050,29,135,"Missouri","Moniteau County",2,60,199,103,96
050,29,135,"Missouri","Moniteau County",2,61,184,95,89
050,29,135,"Missouri","Moniteau County",2,62,185,91,94
050,29,135,"Missouri","Moniteau County",2,63,171,84,87
050,29,135,"Missouri","Moniteau County",2,64,171,84,87
050,29,135,"Missouri","Moniteau County",2,65,167,86,81
050,29,135,"Missouri","Moniteau County",2,66,170,82,88
050,29,135,"Missouri","Moniteau County",2,67,172,80,92
050,29,135,"Missouri","Moniteau County",2,68,156,74,82
050,29,135,"Missouri","Moniteau County",2,69,141,68,73
050,29,135,"Missouri","Moniteau County",2,70,127,62,65
050,29,135,"Missouri","Moniteau County",2,71,133,67,66
050,29,135,"Missouri","Moniteau County",2,72,138,68,70
050,29,135,"Missouri","Moniteau County",2,73,151,71,80
050,29,135,"Missouri","Moniteau County",2,74,103,48,55
050,29,135,"Missouri","Moniteau County",2,75,102,49,53
050,29,135,"Missouri","Moniteau County",2,76,94,43,51
050,29,135,"Missouri","Moniteau County",2,77,86,37,49
050,29,135,"Missouri","Moniteau County",2,78,80,39,41
050,29,135,"Missouri","Moniteau County",2,79,73,35,38
050,29,135,"Missouri","Moniteau County",2,80,73,38,35
050,29,135,"Missouri","Moniteau County",2,81,69,33,36
050,29,135,"Missouri","Moniteau County",2,82,62,30,32
050,29,135,"Missouri","Moniteau County",2,83,53,26,27
050,29,135,"Missouri","Moniteau County",2,84,46,21,25
050,29,135,"Missouri","Moniteau County",2,85,292,100,192
050,29,135,"Missouri","Moniteau County",3,0,200,107,93
050,29,135,"Missouri","Moniteau County",3,1,189,99,90
050,29,135,"Missouri","Moniteau County",3,2,197,104,93
050,29,135,"Missouri","Moniteau County",3,3,198,98,100
050,29,135,"Missouri","Moniteau County",3,4,198,91,107
050,29,135,"Missouri","Moniteau County",3,5,214,107,107
050,29,135,"Missouri","Moniteau County",3,6,212,105,107
050,29,135,"Missouri","Moniteau County",3,7,212,111,101
050,29,135,"Missouri","Moniteau County",3,8,221,109,112
050,29,135,"Missouri","Moniteau County",3,9,244,125,119
050,29,135,"Missouri","Moniteau County",3,10,223,114,109
050,29,135,"Missouri","Moniteau County",3,11,233,123,110
050,29,135,"Missouri","Moniteau County",3,12,217,109,108
050,29,135,"Missouri","Moniteau County",3,13,231,126,105
050,29,135,"Missouri","Moniteau County",3,14,247,129,118
050,29,135,"Missouri","Moniteau County",3,15,226,117,109
050,29,135,"Missouri","Moniteau County",3,16,217,114,103
050,29,135,"Missouri","Moniteau County",3,17,214,107,107
050,29,135,"Missouri","Moniteau County",3,18,196,102,94
050,29,135,"Missouri","Moniteau County",3,19,153,77,76
050,29,135,"Missouri","Moniteau County",3,20,172,97,75
050,29,135,"Missouri","Moniteau County",3,21,181,92,89
050,29,135,"Missouri","Moniteau County",3,22,165,89,76
050,29,135,"Missouri","Moniteau County",3,23,168,88,80
050,29,135,"Missouri","Moniteau County",3,24,176,95,81
050,29,135,"Missouri","Moniteau County",3,25,176,89,87
050,29,135,"Missouri","Moniteau County",3,26,158,97,61
050,29,135,"Missouri","Moniteau County",3,27,177,101,76
050,29,135,"Missouri","Moniteau County",3,28,171,101,70
050,29,135,"Missouri","Moniteau County",3,29,204,107,97
050,29,135,"Missouri","Moniteau County",3,30,217,120,97
050,29,135,"Missouri","Moniteau County",3,31,199,115,84
050,29,135,"Missouri","Moniteau County",3,32,165,92,73
050,29,135,"Missouri","Moniteau County",3,33,171,88,83
050,29,135,"Missouri","Moniteau County",3,34,205,102,103
050,29,135,"Missouri","Moniteau County",3,35,209,115,94
050,29,135,"Missouri","Moniteau County",3,36,182,101,81
050,29,135,"Missouri","Moniteau County",3,37,200,108,92
050,29,135,"Missouri","Moniteau County",3,38,201,118,83
050,29,135,"Missouri","Moniteau County",3,39,219,127,92
050,29,135,"Missouri","Moniteau County",3,40,224,122,102
050,29,135,"Missouri","Moniteau County",3,41,217,120,97
050,29,135,"Missouri","Moniteau County",3,42,203,114,89
050,29,135,"Missouri","Moniteau County",3,43,187,100,87
050,29,135,"Missouri","Moniteau County",3,44,192,104,88
050,29,135,"Missouri","Moniteau County",3,45,191,101,90
050,29,135,"Missouri","Moniteau County",3,46,193,108,85
050,29,135,"Missouri","Moniteau County",3,47,178,94,84
050,29,135,"Missouri","Moniteau County",3,48,176,88,88
050,29,135,"Missouri","Moniteau County",3,49,194,108,86
050,29,135,"Missouri","Moniteau County",3,50,187,103,84
050,29,135,"Missouri","Moniteau County",3,51,185,102,83
050,29,135,"Missouri","Moniteau County",3,52,192,99,93
050,29,135,"Missouri","Moniteau County",3,53,169,85,84
050,29,135,"Missouri","Moniteau County",3,54,175,94,81
050,29,135,"Missouri","Moniteau County",3,55,187,101,86
050,29,135,"Missouri","Moniteau County",3,56,217,115,102
050,29,135,"Missouri","Moniteau County",3,57,211,109,102
050,29,135,"Missouri","Moniteau County",3,58,202,103,99
050,29,135,"Missouri","Moniteau County",3,59,210,108,102
050,29,135,"Missouri","Moniteau County",3,60,202,103,99
050,29,135,"Missouri","Moniteau County",3,61,205,105,100
050,29,135,"Missouri","Moniteau County",3,62,178,91,87
050,29,135,"Missouri","Moniteau County",3,63,184,91,93
050,29,135,"Missouri","Moniteau County",3,64,171,82,89
050,29,135,"Missouri","Moniteau County",3,65,166,85,81
050,29,135,"Missouri","Moniteau County",3,66,166,88,78
050,29,135,"Missouri","Moniteau County",3,67,171,81,90
050,29,135,"Missouri","Moniteau County",3,68,168,74,94
050,29,135,"Missouri","Moniteau County",3,69,147,72,75
050,29,135,"Missouri","Moniteau County",3,70,136,65,71
050,29,135,"Missouri","Moniteau County",3,71,118,58,60
050,29,135,"Missouri","Moniteau County",3,72,127,63,64
050,29,135,"Missouri","Moniteau County",3,73,131,61,70
050,29,135,"Missouri","Moniteau County",3,74,147,69,78
050,29,135,"Missouri","Moniteau County",3,75,98,44,54
050,29,135,"Missouri","Moniteau County",3,76,101,47,54
050,29,135,"Missouri","Moniteau County",3,77,92,43,49
050,29,135,"Missouri","Moniteau County",3,78,84,40,44
050,29,135,"Missouri","Moniteau County",3,79,72,31,41
050,29,135,"Missouri","Moniteau County",3,80,70,35,35
050,29,135,"Missouri","Moniteau County",3,81,66,32,34
050,29,135,"Missouri","Moniteau County",3,82,66,33,33
050,29,135,"Missouri","Moniteau County",3,83,61,29,32
050,29,135,"Missouri","Moniteau County",3,84,36,19,17
050,29,135,"Missouri","Moniteau County",3,85,299,103,196
050,29,135,"Missouri","Moniteau County",4,0,200,110,90
050,29,135,"Missouri","Moniteau County",4,1,206,120,86
050,29,135,"Missouri","Moniteau County",4,2,194,99,95
050,29,135,"Missouri","Moniteau County",4,3,199,110,89
050,29,135,"Missouri","Moniteau County",4,4,199,100,99
050,29,135,"Missouri","Moniteau County",4,5,205,99,106
050,29,135,"Missouri","Moniteau County",4,6,212,102,110
050,29,135,"Missouri","Moniteau County",4,7,217,108,109
050,29,135,"Missouri","Moniteau County",4,8,212,115,97
050,29,135,"Missouri","Moniteau County",4,9,218,104,114
050,29,135,"Missouri","Moniteau County",4,10,241,121,120
050,29,135,"Missouri","Moniteau County",4,11,219,117,102
050,29,135,"Missouri","Moniteau County",4,12,239,121,118
050,29,135,"Missouri","Moniteau County",4,13,207,107,100
050,29,135,"Missouri","Moniteau County",4,14,240,131,109
050,29,135,"Missouri","Moniteau County",4,15,244,122,122
050,29,135,"Missouri","Moniteau County",4,16,219,116,103
050,29,135,"Missouri","Moniteau County",4,17,213,108,105
050,29,135,"Missouri","Moniteau County",4,18,178,94,84
050,29,135,"Missouri","Moniteau County",4,19,153,80,73
050,29,135,"Missouri","Moniteau County",4,20,152,78,74
050,29,135,"Missouri","Moniteau County",4,21,179,105,74
050,29,135,"Missouri","Moniteau County",4,22,180,93,87
050,29,135,"Missouri","Moniteau County",4,23,172,96,76
050,29,135,"Missouri","Moniteau County",4,24,168,91,77
050,29,135,"Missouri","Moniteau County",4,25,186,104,82
050,29,135,"Missouri","Moniteau County",4,26,175,91,84
050,29,135,"Missouri","Moniteau County",4,27,167,97,70
050,29,135,"Missouri","Moniteau County",4,28,170,97,73
050,29,135,"Missouri","Moniteau County",4,29,180,108,72
050,29,135,"Missouri","Moniteau County",4,30,205,106,99
050,29,135,"Missouri","Moniteau County",4,31,213,119,94
050,29,135,"Missouri","Moniteau County",4,32,194,111,83
050,29,135,"Missouri","Moniteau County",4,33,169,94,75
050,29,135,"Missouri","Moniteau County",4,34,172,86,86
050,29,135,"Missouri","Moniteau County",4,35,201,99,102
050,29,135,"Missouri","Moniteau County",4,36,198,109,89
050,29,135,"Missouri","Moniteau County",4,37,181,103,78
050,29,135,"Missouri","Moniteau County",4,38,196,109,87
050,29,135,"Missouri","Moniteau County",4,39,206,123,83
050,29,135,"Missouri","Moniteau County",4,40,211,118,93
050,29,135,"Missouri","Moniteau County",4,41,233,126,107
050,29,135,"Missouri","Moniteau County",4,42,223,124,99
050,29,135,"Missouri","Moniteau County",4,43,193,111,82
050,29,135,"Missouri","Moniteau County",4,44,192,104,88
050,29,135,"Missouri","Moniteau County",4,45,183,96,87
050,29,135,"Missouri","Moniteau County",4,46,194,108,86
050,29,135,"Missouri","Moniteau County",4,47,190,104,86
050,29,135,"Missouri","Moniteau County",4,48,170,88,82
050,29,135,"Missouri","Moniteau County",4,49,178,92,86
050,29,135,"Missouri","Moniteau County",4,50,184,97,87
050,29,135,"Missouri","Moniteau County",4,51,183,100,83
050,29,135,"Missouri","Moniteau County",4,52,187,102,85
050,29,135,"Missouri","Moniteau County",4,53,183,97,86
050,29,135,"Missouri","Moniteau County",4,54,172,89,83
050,29,135,"Missouri","Moniteau County",4,55,174,91,83
050,29,135,"Missouri","Moniteau County",4,56,179,95,84
050,29,135,"Missouri","Moniteau County",4,57,209,115,94
050,29,135,"Missouri","Moniteau County",4,58,206,107,99
050,29,135,"Missouri","Moniteau County",4,59,207,108,99
050,29,135,"Missouri","Moniteau County",4,60,206,103,103
050,29,135,"Missouri","Moniteau County",4,61,206,107,99
050,29,135,"Missouri","Moniteau County",4,62,202,101,101
050,29,135,"Missouri","Moniteau County",4,63,173,84,89
050,29,135,"Missouri","Moniteau County",4,64,179,89,90
050,29,135,"Missouri","Moniteau County",4,65,166,80,86
050,29,135,"Missouri","Moniteau County",4,66,165,84,81
050,29,135,"Missouri","Moniteau County",4,67,169,90,79
050,29,135,"Missouri","Moniteau County",4,68,166,76,90
050,29,135,"Missouri","Moniteau County",4,69,158,67,91
050,29,135,"Missouri","Moniteau County",4,70,142,67,75
050,29,135,"Missouri","Moniteau County",4,71,129,63,66
050,29,135,"Missouri","Moniteau County",4,72,115,54,61
050,29,135,"Missouri","Moniteau County",4,73,124,61,63
050,29,135,"Missouri","Moniteau County",4,74,128,60,68
050,29,135,"Missouri","Moniteau County",4,75,139,62,77
050,29,135,"Missouri","Moniteau County",4,76,100,42,58
050,29,135,"Missouri","Moniteau County",4,77,100,48,52
050,29,135,"Missouri","Moniteau County",4,78,89,44,45
050,29,135,"Missouri","Moniteau County",4,79,73,32,41
050,29,135,"Missouri","Moniteau County",4,80,65,27,38
050,29,135,"Missouri","Moniteau County",4,81,67,33,34
050,29,135,"Missouri","Moniteau County",4,82,63,32,31
050,29,135,"Missouri","Moniteau County",4,83,70,33,37
050,29,135,"Missouri","Moniteau County",4,84,46,22,24
050,29,135,"Missouri","Moniteau County",4,85,290,103,187
050,29,135,"Missouri","Moniteau County",5,0,199,110,89
050,29,135,"Missouri","Moniteau County",5,1,196,109,87
050,29,135,"Missouri","Moniteau County",5,2,211,122,89
050,29,135,"Missouri","Moniteau County",5,3,187,100,87
050,29,135,"Missouri","Moniteau County",5,4,197,111,86
050,29,135,"Missouri","Moniteau County",5,5,195,95,100
050,29,135,"Missouri","Moniteau County",5,6,204,100,104
050,29,135,"Missouri","Moniteau County",5,7,214,104,110
050,29,135,"Missouri","Moniteau County",5,8,223,115,108
050,29,135,"Missouri","Moniteau County",5,9,214,118,96
050,29,135,"Missouri","Moniteau County",5,10,209,102,107
050,29,135,"Missouri","Moniteau County",5,11,241,121,120
050,29,135,"Missouri","Moniteau County",5,12,215,112,103
050,29,135,"Missouri","Moniteau County",5,13,243,123,120
050,29,135,"Missouri","Moniteau County",5,14,209,106,103
050,29,135,"Missouri","Moniteau County",5,15,237,132,105
050,29,135,"Missouri","Moniteau County",5,16,245,125,120
050,29,135,"Missouri","Moniteau County",5,17,219,114,105
050,29,135,"Missouri","Moniteau County",5,18,181,95,86
050,29,135,"Missouri","Moniteau County",5,19,138,74,64
050,29,135,"Missouri","Moniteau County",5,20,162,82,80
050,29,135,"Missouri","Moniteau County",5,21,163,80,83
050,29,135,"Missouri","Moniteau County",5,22,192,109,83
050,29,135,"Missouri","Moniteau County",5,23,173,86,87
050,29,135,"Missouri","Moniteau County",5,24,183,104,79
050,29,135,"Missouri","Moniteau County",5,25,180,101,79
050,29,135,"Missouri","Moniteau County",5,26,192,104,88
050,29,135,"Missouri","Moniteau County",5,27,170,86,84
050,29,135,"Missouri","Moniteau County",5,28,168,98,70
050,29,135,"Missouri","Moniteau County",5,29,176,95,81
050,29,135,"Missouri","Moniteau County",5,30,187,108,79
050,29,135,"Missouri","Moniteau County",5,31,201,108,93
050,29,135,"Missouri","Moniteau County",5,32,211,115,96
050,29,135,"Missouri","Moniteau County",5,33,201,120,81
050,29,135,"Missouri","Moniteau County",5,34,173,97,76
050,29,135,"Missouri","Moniteau County",5,35,176,87,89
050,29,135,"Missouri","Moniteau County",5,36,199,96,103
050,29,135,"Missouri","Moniteau County",5,37,197,110,87
050,29,135,"Missouri","Moniteau County",5,38,188,104,84
050,29,135,"Missouri","Moniteau County",5,39,201,114,87
050,29,135,"Missouri","Moniteau County",5,40,195,111,84
050,29,135,"Missouri","Moniteau County",5,41,217,122,95
050,29,135,"Missouri","Moniteau County",5,42,231,126,105
050,29,135,"Missouri","Moniteau County",5,43,218,123,95
050,29,135,"Missouri","Moniteau County",5,44,194,106,88
050,29,135,"Missouri","Moniteau County",5,45,188,98,90
050,29,135,"Missouri","Moniteau County",5,46,193,105,88
050,29,135,"Missouri","Moniteau County",5,47,186,100,86
050,29,135,"Missouri","Moniteau County",5,48,182,94,88
050,29,135,"Missouri","Moniteau County",5,49,172,88,84
050,29,135,"Missouri","Moniteau County",5,50,172,84,88
050,29,135,"Missouri","Moniteau County",5,51,182,95,87
050,29,135,"Missouri","Moniteau County",5,52,187,100,87
050,29,135,"Missouri","Moniteau County",5,53,180,95,85
050,29,135,"Missouri","Moniteau County",5,54,188,100,88
050,29,135,"Missouri","Moniteau County",5,55,167,84,83
050,29,135,"Missouri","Moniteau County",5,56,169,90,79
050,29,135,"Missouri","Moniteau County",5,57,172,94,78
050,29,135,"Missouri","Moniteau County",5,58,213,115,98
050,29,135,"Missouri","Moniteau County",5,59,206,107,99
050,29,135,"Missouri","Moniteau County",5,60,203,107,96
050,29,135,"Missouri","Moniteau County",5,61,206,101,105
050,29,135,"Missouri","Moniteau County",5,62,210,110,100
050,29,135,"Missouri","Moniteau County",5,63,196,96,100
050,29,135,"Missouri","Moniteau County",5,64,171,83,88
050,29,135,"Missouri","Moniteau County",5,65,177,88,89
050,29,135,"Missouri","Moniteau County",5,66,163,78,85
050,29,135,"Missouri","Moniteau County",5,67,167,85,82
050,29,135,"Missouri","Moniteau County",5,68,161,84,77
050,29,135,"Missouri","Moniteau County",5,69,154,67,87
050,29,135,"Missouri","Moniteau County",5,70,150,65,85
050,29,135,"Missouri","Moniteau County",5,71,138,65,73
050,29,135,"Missouri","Moniteau County",5,72,126,62,64
050,29,135,"Missouri","Moniteau County",5,73,114,52,62
050,29,135,"Missouri","Moniteau County",5,74,118,58,60
050,29,135,"Missouri","Moniteau County",5,75,120,55,65
050,29,135,"Missouri","Moniteau County",5,76,134,59,75
050,29,135,"Missouri","Moniteau County",5,77,95,41,54
050,29,135,"Missouri","Moniteau County",5,78,95,48,47
050,29,135,"Missouri","Moniteau County",5,79,79,35,44
050,29,135,"Missouri","Moniteau County",5,80,65,28,37
050,29,135,"Missouri","Moniteau County",5,81,58,23,35
050,29,135,"Missouri","Moniteau County",5,82,62,32,30
050,29,135,"Missouri","Moniteau County",5,83,63,32,31
050,29,135,"Missouri","Moniteau County",5,84,55,27,28
050,29,135,"Missouri","Moniteau County",5,85,294,109,185
050,29,137,"Missouri","Monroe County",1,0,88,45,43
050,29,137,"Missouri","Monroe County",1,1,96,53,43
050,29,137,"Missouri","Monroe County",1,2,93,49,44
050,29,137,"Missouri","Monroe County",1,3,106,44,62
050,29,137,"Missouri","Monroe County",1,4,103,58,45
050,29,137,"Missouri","Monroe County",1,5,100,54,46
050,29,137,"Missouri","Monroe County",1,6,120,66,54
050,29,137,"Missouri","Monroe County",1,7,98,50,48
050,29,137,"Missouri","Monroe County",1,8,99,54,45
050,29,137,"Missouri","Monroe County",1,9,116,63,53
050,29,137,"Missouri","Monroe County",1,10,116,53,63
050,29,137,"Missouri","Monroe County",1,11,112,64,48
050,29,137,"Missouri","Monroe County",1,12,113,66,47
050,29,137,"Missouri","Monroe County",1,13,111,60,51
050,29,137,"Missouri","Monroe County",1,14,110,55,55
050,29,137,"Missouri","Monroe County",1,15,107,57,50
050,29,137,"Missouri","Monroe County",1,16,113,59,54
050,29,137,"Missouri","Monroe County",1,17,114,60,54
050,29,137,"Missouri","Monroe County",1,18,104,50,54
050,29,137,"Missouri","Monroe County",1,19,81,42,39
050,29,137,"Missouri","Monroe County",1,20,86,44,42
050,29,137,"Missouri","Monroe County",1,21,83,47,36
050,29,137,"Missouri","Monroe County",1,22,76,48,28
050,29,137,"Missouri","Monroe County",1,23,76,38,38
050,29,137,"Missouri","Monroe County",1,24,68,34,34
050,29,137,"Missouri","Monroe County",1,25,76,40,36
050,29,137,"Missouri","Monroe County",1,26,68,37,31
050,29,137,"Missouri","Monroe County",1,27,76,37,39
050,29,137,"Missouri","Monroe County",1,28,97,42,55
050,29,137,"Missouri","Monroe County",1,29,91,46,45
050,29,137,"Missouri","Monroe County",1,30,103,59,44
050,29,137,"Missouri","Monroe County",1,31,78,43,35
050,29,137,"Missouri","Monroe County",1,32,73,37,36
050,29,137,"Missouri","Monroe County",1,33,80,38,42
050,29,137,"Missouri","Monroe County",1,34,96,50,46
050,29,137,"Missouri","Monroe County",1,35,99,48,51
050,29,137,"Missouri","Monroe County",1,36,96,48,48
050,29,137,"Missouri","Monroe County",1,37,84,42,42
050,29,137,"Missouri","Monroe County",1,38,94,54,40
050,29,137,"Missouri","Monroe County",1,39,101,54,47
050,29,137,"Missouri","Monroe County",1,40,101,53,48
050,29,137,"Missouri","Monroe County",1,41,86,43,43
050,29,137,"Missouri","Monroe County",1,42,88,47,41
050,29,137,"Missouri","Monroe County",1,43,96,55,41
050,29,137,"Missouri","Monroe County",1,44,94,50,44
050,29,137,"Missouri","Monroe County",1,45,81,45,36
050,29,137,"Missouri","Monroe County",1,46,84,50,34
050,29,137,"Missouri","Monroe County",1,47,87,43,44
050,29,137,"Missouri","Monroe County",1,48,98,48,50
050,29,137,"Missouri","Monroe County",1,49,104,65,39
050,29,137,"Missouri","Monroe County",1,50,110,62,48
050,29,137,"Missouri","Monroe County",1,51,95,42,53
050,29,137,"Missouri","Monroe County",1,52,85,42,43
050,29,137,"Missouri","Monroe County",1,53,101,53,48
050,29,137,"Missouri","Monroe County",1,54,123,68,55
050,29,137,"Missouri","Monroe County",1,55,124,65,59
050,29,137,"Missouri","Monroe County",1,56,116,63,53
050,29,137,"Missouri","Monroe County",1,57,138,79,59
050,29,137,"Missouri","Monroe County",1,58,153,80,73
050,29,137,"Missouri","Monroe County",1,59,154,78,76
050,29,137,"Missouri","Monroe County",1,60,141,70,71
050,29,137,"Missouri","Monroe County",1,61,142,72,70
050,29,137,"Missouri","Monroe County",1,62,140,68,72
050,29,137,"Missouri","Monroe County",1,63,138,64,74
050,29,137,"Missouri","Monroe County",1,64,138,63,75
050,29,137,"Missouri","Monroe County",1,65,153,77,76
050,29,137,"Missouri","Monroe County",1,66,137,74,63
050,29,137,"Missouri","Monroe County",1,67,133,70,63
050,29,137,"Missouri","Monroe County",1,68,106,57,49
050,29,137,"Missouri","Monroe County",1,69,103,48,55
050,29,137,"Missouri","Monroe County",1,70,116,55,61
050,29,137,"Missouri","Monroe County",1,71,117,55,62
050,29,137,"Missouri","Monroe County",1,72,109,58,51
050,29,137,"Missouri","Monroe County",1,73,104,49,55
050,29,137,"Missouri","Monroe County",1,74,77,40,37
050,29,137,"Missouri","Monroe County",1,75,91,48,43
050,29,137,"Missouri","Monroe County",1,76,76,39,37
050,29,137,"Missouri","Monroe County",1,77,80,43,37
050,29,137,"Missouri","Monroe County",1,78,75,40,35
050,29,137,"Missouri","Monroe County",1,79,63,31,32
050,29,137,"Missouri","Monroe County",1,80,69,34,35
050,29,137,"Missouri","Monroe County",1,81,49,26,23
050,29,137,"Missouri","Monroe County",1,82,58,27,31
050,29,137,"Missouri","Monroe County",1,83,47,19,28
050,29,137,"Missouri","Monroe County",1,84,34,17,17
050,29,137,"Missouri","Monroe County",1,85,247,91,156
050,29,137,"Missouri","Monroe County",2,0,93,46,47
050,29,137,"Missouri","Monroe County",2,1,95,51,44
050,29,137,"Missouri","Monroe County",2,2,96,51,45
050,29,137,"Missouri","Monroe County",2,3,104,47,57
050,29,137,"Missouri","Monroe County",2,4,105,56,49
050,29,137,"Missouri","Monroe County",2,5,103,56,47
050,29,137,"Missouri","Monroe County",2,6,116,63,53
050,29,137,"Missouri","Monroe County",2,7,103,54,49
050,29,137,"Missouri","Monroe County",2,8,99,53,46
050,29,137,"Missouri","Monroe County",2,9,112,62,50
050,29,137,"Missouri","Monroe County",2,10,116,55,61
050,29,137,"Missouri","Monroe County",2,11,113,62,51
050,29,137,"Missouri","Monroe County",2,12,112,65,47
050,29,137,"Missouri","Monroe County",2,13,112,61,51
050,29,137,"Missouri","Monroe County",2,14,111,57,54
050,29,137,"Missouri","Monroe County",2,15,109,57,52
050,29,137,"Missouri","Monroe County",2,16,111,58,53
050,29,137,"Missouri","Monroe County",2,17,114,59,55
050,29,137,"Missouri","Monroe County",2,18,102,51,51
050,29,137,"Missouri","Monroe County",2,19,81,40,41
050,29,137,"Missouri","Monroe County",2,20,85,44,41
050,29,137,"Missouri","Monroe County",2,21,83,47,36
050,29,137,"Missouri","Monroe County",2,22,78,48,30
050,29,137,"Missouri","Monroe County",2,23,77,41,36
050,29,137,"Missouri","Monroe County",2,24,71,36,35
050,29,137,"Missouri","Monroe County",2,25,76,39,37
050,29,137,"Missouri","Monroe County",2,26,73,39,34
050,29,137,"Missouri","Monroe County",2,27,76,37,39
050,29,137,"Missouri","Monroe County",2,28,92,41,51
050,29,137,"Missouri","Monroe County",2,29,93,46,47
050,29,137,"Missouri","Monroe County",2,30,100,56,44
050,29,137,"Missouri","Monroe County",2,31,83,45,38
050,29,137,"Missouri","Monroe County",2,32,73,38,35
050,29,137,"Missouri","Monroe County",2,33,82,40,42
050,29,137,"Missouri","Monroe County",2,34,93,47,46
050,29,137,"Missouri","Monroe County",2,35,99,48,51
050,29,137,"Missouri","Monroe County",2,36,97,48,49
050,29,137,"Missouri","Monroe County",2,37,87,43,44
050,29,137,"Missouri","Monroe County",2,38,92,52,40
050,29,137,"Missouri","Monroe County",2,39,101,55,46
050,29,137,"Missouri","Monroe County",2,40,102,54,48
050,29,137,"Missouri","Monroe County",2,41,89,45,44
050,29,137,"Missouri","Monroe County",2,42,86,45,41
050,29,137,"Missouri","Monroe County",2,43,93,52,41
050,29,137,"Missouri","Monroe County",2,44,93,50,43
050,29,137,"Missouri","Monroe County",2,45,86,47,39
050,29,137,"Missouri","Monroe County",2,46,81,48,33
050,29,137,"Missouri","Monroe County",2,47,87,45,42
050,29,137,"Missouri","Monroe County",2,48,96,47,49
050,29,137,"Missouri","Monroe County",2,49,104,62,42
050,29,137,"Missouri","Monroe County",2,50,109,63,46
050,29,137,"Missouri","Monroe County",2,51,98,47,51
050,29,137,"Missouri","Monroe County",2,52,87,42,45
050,29,137,"Missouri","Monroe County",2,53,97,51,46
050,29,137,"Missouri","Monroe County",2,54,117,64,53
050,29,137,"Missouri","Monroe County",2,55,124,65,59
050,29,137,"Missouri","Monroe County",2,56,118,63,55
050,29,137,"Missouri","Monroe County",2,57,133,76,57
050,29,137,"Missouri","Monroe County",2,58,149,79,70
050,29,137,"Missouri","Monroe County",2,59,152,77,75
050,29,137,"Missouri","Monroe County",2,60,146,73,73
050,29,137,"Missouri","Monroe County",2,61,142,71,71
050,29,137,"Missouri","Monroe County",2,62,141,69,72
050,29,137,"Missouri","Monroe County",2,63,141,66,75
050,29,137,"Missouri","Monroe County",2,64,137,63,74
050,29,137,"Missouri","Monroe County",2,65,147,72,75
050,29,137,"Missouri","Monroe County",2,66,141,75,66
050,29,137,"Missouri","Monroe County",2,67,134,72,62
050,29,137,"Missouri","Monroe County",2,68,112,60,52
050,29,137,"Missouri","Monroe County",2,69,105,50,55
050,29,137,"Missouri","Monroe County",2,70,112,53,59
050,29,137,"Missouri","Monroe County",2,71,117,55,62
050,29,137,"Missouri","Monroe County",2,72,110,57,53
050,29,137,"Missouri","Monroe County",2,73,108,53,55
050,29,137,"Missouri","Monroe County",2,74,81,41,40
050,29,137,"Missouri","Monroe County",2,75,88,46,42
050,29,137,"Missouri","Monroe County",2,76,77,40,37
050,29,137,"Missouri","Monroe County",2,77,80,42,38
050,29,137,"Missouri","Monroe County",2,78,74,39,35
050,29,137,"Missouri","Monroe County",2,79,66,33,33
050,29,137,"Missouri","Monroe County",2,80,69,34,35
050,29,137,"Missouri","Monroe County",2,81,50,26,24
050,29,137,"Missouri","Monroe County",2,82,56,26,30
050,29,137,"Missouri","Monroe County",2,83,49,20,29
050,29,137,"Missouri","Monroe County",2,84,34,16,18
050,29,137,"Missouri","Monroe County",2,85,251,93,158
050,29,137,"Missouri","Monroe County",3,0,89,44,45
050,29,137,"Missouri","Monroe County",3,1,109,56,53
050,29,137,"Missouri","Monroe County",3,2,96,48,48
050,29,137,"Missouri","Monroe County",3,3,104,57,47
050,29,137,"Missouri","Monroe County",3,4,100,50,50
050,29,137,"Missouri","Monroe County",3,5,102,56,46
050,29,137,"Missouri","Monroe County",3,6,107,56,51
050,29,137,"Missouri","Monroe County",3,7,110,59,51
050,29,137,"Missouri","Monroe County",3,8,101,56,45
050,29,137,"Missouri","Monroe County",3,9,100,53,47
050,29,137,"Missouri","Monroe County",3,10,108,57,51
050,29,137,"Missouri","Monroe County",3,11,121,59,62
050,29,137,"Missouri","Monroe County",3,12,114,61,53
050,29,137,"Missouri","Monroe County",3,13,111,62,49
050,29,137,"Missouri","Monroe County",3,14,110,66,44
050,29,137,"Missouri","Monroe County",3,15,109,54,55
050,29,137,"Missouri","Monroe County",3,16,115,60,55
050,29,137,"Missouri","Monroe County",3,17,106,52,54
050,29,137,"Missouri","Monroe County",3,18,97,52,45
050,29,137,"Missouri","Monroe County",3,19,82,42,40
050,29,137,"Missouri","Monroe County",3,20,93,46,47
050,29,137,"Missouri","Monroe County",3,21,87,46,41
050,29,137,"Missouri","Monroe County",3,22,88,45,43
050,29,137,"Missouri","Monroe County",3,23,81,50,31
050,29,137,"Missouri","Monroe County",3,24,84,44,40
050,29,137,"Missouri","Monroe County",3,25,77,42,35
050,29,137,"Missouri","Monroe County",3,26,83,41,42
050,29,137,"Missouri","Monroe County",3,27,75,40,35
050,29,137,"Missouri","Monroe County",3,28,77,33,44
050,29,137,"Missouri","Monroe County",3,29,92,39,53
050,29,137,"Missouri","Monroe County",3,30,94,45,49
050,29,137,"Missouri","Monroe County",3,31,102,56,46
050,29,137,"Missouri","Monroe County",3,32,78,43,35
050,29,137,"Missouri","Monroe County",3,33,71,35,36
050,29,137,"Missouri","Monroe County",3,34,87,44,43
050,29,137,"Missouri","Monroe County",3,35,92,47,45
050,29,137,"Missouri","Monroe County",3,36,95,44,51
050,29,137,"Missouri","Monroe County",3,37,94,45,49
050,29,137,"Missouri","Monroe County",3,38,93,48,45
050,29,137,"Missouri","Monroe County",3,39,97,56,41
050,29,137,"Missouri","Monroe County",3,40,95,52,43
050,29,137,"Missouri","Monroe County",3,41,96,47,49
050,29,137,"Missouri","Monroe County",3,42,92,50,42
050,29,137,"Missouri","Monroe County",3,43,84,45,39
050,29,137,"Missouri","Monroe County",3,44,95,54,41
050,29,137,"Missouri","Monroe County",3,45,97,52,45
050,29,137,"Missouri","Monroe County",3,46,85,49,36
050,29,137,"Missouri","Monroe County",3,47,79,47,32
050,29,137,"Missouri","Monroe County",3,48,85,42,43
050,29,137,"Missouri","Monroe County",3,49,93,43,50
050,29,137,"Missouri","Monroe County",3,50,102,61,41
050,29,137,"Missouri","Monroe County",3,51,104,59,45
050,29,137,"Missouri","Monroe County",3,52,98,47,51
050,29,137,"Missouri","Monroe County",3,53,87,39,48
050,29,137,"Missouri","Monroe County",3,54,101,51,50
050,29,137,"Missouri","Monroe County",3,55,118,60,58
050,29,137,"Missouri","Monroe County",3,56,130,68,62
050,29,137,"Missouri","Monroe County",3,57,122,68,54
050,29,137,"Missouri","Monroe County",3,58,134,77,57
050,29,137,"Missouri","Monroe County",3,59,146,78,68
050,29,137,"Missouri","Monroe County",3,60,154,79,75
050,29,137,"Missouri","Monroe County",3,61,152,73,79
050,29,137,"Missouri","Monroe County",3,62,142,72,70
050,29,137,"Missouri","Monroe County",3,63,141,70,71
050,29,137,"Missouri","Monroe County",3,64,145,68,77
050,29,137,"Missouri","Monroe County",3,65,135,62,73
050,29,137,"Missouri","Monroe County",3,66,144,73,71
050,29,137,"Missouri","Monroe County",3,67,141,76,65
050,29,137,"Missouri","Monroe County",3,68,135,71,64
050,29,137,"Missouri","Monroe County",3,69,106,58,48
050,29,137,"Missouri","Monroe County",3,70,105,51,54
050,29,137,"Missouri","Monroe County",3,71,113,54,59
050,29,137,"Missouri","Monroe County",3,72,115,55,60
050,29,137,"Missouri","Monroe County",3,73,108,56,52
050,29,137,"Missouri","Monroe County",3,74,104,49,55
050,29,137,"Missouri","Monroe County",3,75,75,37,38
050,29,137,"Missouri","Monroe County",3,76,83,42,41
050,29,137,"Missouri","Monroe County",3,77,76,38,38
050,29,137,"Missouri","Monroe County",3,78,75,39,36
050,29,137,"Missouri","Monroe County",3,79,70,35,35
050,29,137,"Missouri","Monroe County",3,80,66,29,37
050,29,137,"Missouri","Monroe County",3,81,58,33,25
050,29,137,"Missouri","Monroe County",3,82,50,25,25
050,29,137,"Missouri","Monroe County",3,83,47,19,28
050,29,137,"Missouri","Monroe County",3,84,38,19,19
050,29,137,"Missouri","Monroe County",3,85,249,90,159
050,29,137,"Missouri","Monroe County",4,0,91,47,44
050,29,137,"Missouri","Monroe County",4,1,90,44,46
050,29,137,"Missouri","Monroe County",4,2,107,56,51
050,29,137,"Missouri","Monroe County",4,3,90,47,43
050,29,137,"Missouri","Monroe County",4,4,98,52,46
050,29,137,"Missouri","Monroe County",4,5,103,49,54
050,29,137,"Missouri","Monroe County",4,6,104,61,43
050,29,137,"Missouri","Monroe County",4,7,105,57,48
050,29,137,"Missouri","Monroe County",4,8,111,60,51
050,29,137,"Missouri","Monroe County",4,9,100,51,49
050,29,137,"Missouri","Monroe County",4,10,101,55,46
050,29,137,"Missouri","Monroe County",4,11,105,53,52
050,29,137,"Missouri","Monroe County",4,12,125,63,62
050,29,137,"Missouri","Monroe County",4,13,107,58,49
050,29,137,"Missouri","Monroe County",4,14,112,59,53
050,29,137,"Missouri","Monroe County",4,15,105,62,43
050,29,137,"Missouri","Monroe County",4,16,113,58,55
050,29,137,"Missouri","Monroe County",4,17,112,58,54
050,29,137,"Missouri","Monroe County",4,18,87,43,44
050,29,137,"Missouri","Monroe County",4,19,75,42,33
050,29,137,"Missouri","Monroe County",4,20,87,42,45
050,29,137,"Missouri","Monroe County",4,21,90,44,46
050,29,137,"Missouri","Monroe County",4,22,90,48,42
050,29,137,"Missouri","Monroe County",4,23,88,46,42
050,29,137,"Missouri","Monroe County",4,24,78,46,32
050,29,137,"Missouri","Monroe County",4,25,83,45,38
050,29,137,"Missouri","Monroe County",4,26,64,38,26
050,29,137,"Missouri","Monroe County",4,27,87,43,44
050,29,137,"Missouri","Monroe County",4,28,79,44,35
050,29,137,"Missouri","Monroe County",4,29,75,32,43
050,29,137,"Missouri","Monroe County",4,30,90,39,51
050,29,137,"Missouri","Monroe County",4,31,88,40,48
050,29,137,"Missouri","Monroe County",4,32,101,52,49
050,29,137,"Missouri","Monroe County",4,33,76,43,33
050,29,137,"Missouri","Monroe County",4,34,77,39,38
050,29,137,"Missouri","Monroe County",4,35,84,43,41
050,29,137,"Missouri","Monroe County",4,36,92,47,45
050,29,137,"Missouri","Monroe County",4,37,96,46,50
050,29,137,"Missouri","Monroe County",4,38,92,44,48
050,29,137,"Missouri","Monroe County",4,39,91,49,42
050,29,137,"Missouri","Monroe County",4,40,95,55,40
050,29,137,"Missouri","Monroe County",4,41,96,54,42
050,29,137,"Missouri","Monroe County",4,42,94,48,46
050,29,137,"Missouri","Monroe County",4,43,86,48,38
050,29,137,"Missouri","Monroe County",4,44,84,41,43
050,29,137,"Missouri","Monroe County",4,45,97,53,44
050,29,137,"Missouri","Monroe County",4,46,100,53,47
050,29,137,"Missouri","Monroe County",4,47,84,49,35
050,29,137,"Missouri","Monroe County",4,48,76,45,31
050,29,137,"Missouri","Monroe County",4,49,89,45,44
050,29,137,"Missouri","Monroe County",4,50,91,42,49
050,29,137,"Missouri","Monroe County",4,51,102,61,41
050,29,137,"Missouri","Monroe County",4,52,113,64,49
050,29,137,"Missouri","Monroe County",4,53,104,51,53
050,29,137,"Missouri","Monroe County",4,54,91,42,49
050,29,137,"Missouri","Monroe County",4,55,99,49,50
050,29,137,"Missouri","Monroe County",4,56,122,62,60
050,29,137,"Missouri","Monroe County",4,57,131,66,65
050,29,137,"Missouri","Monroe County",4,58,122,67,55
050,29,137,"Missouri","Monroe County",4,59,127,74,53
050,29,137,"Missouri","Monroe County",4,60,141,73,68
050,29,137,"Missouri","Monroe County",4,61,157,79,78
050,29,137,"Missouri","Monroe County",4,62,153,76,77
050,29,137,"Missouri","Monroe County",4,63,142,73,69
050,29,137,"Missouri","Monroe County",4,64,142,72,70
050,29,137,"Missouri","Monroe County",4,65,146,69,77
050,29,137,"Missouri","Monroe County",4,66,137,66,71
050,29,137,"Missouri","Monroe County",4,67,140,72,68
050,29,137,"Missouri","Monroe County",4,68,137,74,63
050,29,137,"Missouri","Monroe County",4,69,133,70,63
050,29,137,"Missouri","Monroe County",4,70,107,56,51
050,29,137,"Missouri","Monroe County",4,71,104,50,54
050,29,137,"Missouri","Monroe County",4,72,108,52,56
050,29,137,"Missouri","Monroe County",4,73,114,52,62
050,29,137,"Missouri","Monroe County",4,74,102,52,50
050,29,137,"Missouri","Monroe County",4,75,101,49,52
050,29,137,"Missouri","Monroe County",4,76,75,38,37
050,29,137,"Missouri","Monroe County",4,77,70,33,37
050,29,137,"Missouri","Monroe County",4,78,71,37,34
050,29,137,"Missouri","Monroe County",4,79,70,36,34
050,29,137,"Missouri","Monroe County",4,80,70,32,38
050,29,137,"Missouri","Monroe County",4,81,60,29,31
050,29,137,"Missouri","Monroe County",4,82,61,32,29
050,29,137,"Missouri","Monroe County",4,83,42,20,22
050,29,137,"Missouri","Monroe County",4,84,36,17,19
050,29,137,"Missouri","Monroe County",4,85,264,92,172
050,29,137,"Missouri","Monroe County",5,0,93,49,44
050,29,137,"Missouri","Monroe County",5,1,98,50,48
050,29,137,"Missouri","Monroe County",5,2,94,50,44
050,29,137,"Missouri","Monroe County",5,3,98,48,50
050,29,137,"Missouri","Monroe County",5,4,89,47,42
050,29,137,"Missouri","Monroe County",5,5,105,53,52
050,29,137,"Missouri","Monroe County",5,6,113,53,60
050,29,137,"Missouri","Monroe County",5,7,103,60,43
050,29,137,"Missouri","Monroe County",5,8,108,52,56
050,29,137,"Missouri","Monroe County",5,9,110,61,49
050,29,137,"Missouri","Monroe County",5,10,102,54,48
050,29,137,"Missouri","Monroe County",5,11,106,60,46
050,29,137,"Missouri","Monroe County",5,12,111,58,53
050,29,137,"Missouri","Monroe County",5,13,128,65,63
050,29,137,"Missouri","Monroe County",5,14,112,63,49
050,29,137,"Missouri","Monroe County",5,15,116,60,56
050,29,137,"Missouri","Monroe County",5,16,106,64,42
050,29,137,"Missouri","Monroe County",5,17,119,60,59
050,29,137,"Missouri","Monroe County",5,18,97,53,44
050,29,137,"Missouri","Monroe County",5,19,66,33,33
050,29,137,"Missouri","Monroe County",5,20,77,45,32
050,29,137,"Missouri","Monroe County",5,21,90,47,43
050,29,137,"Missouri","Monroe County",5,22,90,43,47
050,29,137,"Missouri","Monroe County",5,23,96,52,44
050,29,137,"Missouri","Monroe County",5,24,84,46,38
050,29,137,"Missouri","Monroe County",5,25,76,43,33
050,29,137,"Missouri","Monroe County",5,26,85,45,40
050,29,137,"Missouri","Monroe County",5,27,67,42,25
050,29,137,"Missouri","Monroe County",5,28,95,47,48
050,29,137,"Missouri","Monroe County",5,29,76,40,36
050,29,137,"Missouri","Monroe County",5,30,75,33,42
050,29,137,"Missouri","Monroe County",5,31,90,40,50
050,29,137,"Missouri","Monroe County",5,32,89,39,50
050,29,137,"Missouri","Monroe County",5,33,109,55,54
050,29,137,"Missouri","Monroe County",5,34,74,42,32
050,29,137,"Missouri","Monroe County",5,35,80,41,39
050,29,137,"Missouri","Monroe County",5,36,89,44,45
050,29,137,"Missouri","Monroe County",5,37,90,44,46
050,29,137,"Missouri","Monroe County",5,38,92,46,46
050,29,137,"Missouri","Monroe County",5,39,99,50,49
050,29,137,"Missouri","Monroe County",5,40,96,49,47
050,29,137,"Missouri","Monroe County",5,41,97,55,42
050,29,137,"Missouri","Monroe County",5,42,100,57,43
050,29,137,"Missouri","Monroe County",5,43,90,45,45
050,29,137,"Missouri","Monroe County",5,44,87,44,43
050,29,137,"Missouri","Monroe County",5,45,85,41,44
050,29,137,"Missouri","Monroe County",5,46,104,55,49
050,29,137,"Missouri","Monroe County",5,47,108,59,49
050,29,137,"Missouri","Monroe County",5,48,84,51,33
050,29,137,"Missouri","Monroe County",5,49,81,48,33
050,29,137,"Missouri","Monroe County",5,50,96,47,49
050,29,137,"Missouri","Monroe County",5,51,88,40,48
050,29,137,"Missouri","Monroe County",5,52,102,59,43
050,29,137,"Missouri","Monroe County",5,53,112,63,49
050,29,137,"Missouri","Monroe County",5,54,105,51,54
050,29,137,"Missouri","Monroe County",5,55,90,42,48
050,29,137,"Missouri","Monroe County",5,56,95,49,46
050,29,137,"Missouri","Monroe County",5,57,121,61,60
050,29,137,"Missouri","Monroe County",5,58,138,67,71
050,29,137,"Missouri","Monroe County",5,59,116,62,54
050,29,137,"Missouri","Monroe County",5,60,134,78,56
050,29,137,"Missouri","Monroe County",5,61,138,73,65
050,29,137,"Missouri","Monroe County",5,62,156,78,78
050,29,137,"Missouri","Monroe County",5,63,156,82,74
050,29,137,"Missouri","Monroe County",5,64,141,75,66
050,29,137,"Missouri","Monroe County",5,65,137,67,70
050,29,137,"Missouri","Monroe County",5,66,147,70,77
050,29,137,"Missouri","Monroe County",5,67,132,65,67
050,29,137,"Missouri","Monroe County",5,68,139,71,68
050,29,137,"Missouri","Monroe County",5,69,140,74,66
050,29,137,"Missouri","Monroe County",5,70,134,70,64
050,29,137,"Missouri","Monroe County",5,71,101,52,49
050,29,137,"Missouri","Monroe County",5,72,102,51,51
050,29,137,"Missouri","Monroe County",5,73,108,51,57
050,29,137,"Missouri","Monroe County",5,74,109,48,61
050,29,137,"Missouri","Monroe County",5,75,98,52,46
050,29,137,"Missouri","Monroe County",5,76,99,48,51
050,29,137,"Missouri","Monroe County",5,77,65,30,35
050,29,137,"Missouri","Monroe County",5,78,65,32,33
050,29,137,"Missouri","Monroe County",5,79,64,34,30
050,29,137,"Missouri","Monroe County",5,80,66,33,33
050,29,137,"Missouri","Monroe County",5,81,58,30,28
050,29,137,"Missouri","Monroe County",5,82,61,28,33
050,29,137,"Missouri","Monroe County",5,83,52,27,25
050,29,137,"Missouri","Monroe County",5,84,30,16,14
050,29,137,"Missouri","Monroe County",5,85,274,92,182
050,29,139,"Missouri","Montgomery County",1,0,133,66,67
050,29,139,"Missouri","Montgomery County",1,1,139,61,78
050,29,139,"Missouri","Montgomery County",1,2,123,68,55
050,29,139,"Missouri","Montgomery County",1,3,120,62,58
050,29,139,"Missouri","Montgomery County",1,4,130,58,72
050,29,139,"Missouri","Montgomery County",1,5,137,66,71
050,29,139,"Missouri","Montgomery County",1,6,133,69,64
050,29,139,"Missouri","Montgomery County",1,7,143,76,67
050,29,139,"Missouri","Montgomery County",1,8,133,74,59
050,29,139,"Missouri","Montgomery County",1,9,144,72,72
050,29,139,"Missouri","Montgomery County",1,10,128,65,63
050,29,139,"Missouri","Montgomery County",1,11,142,76,66
050,29,139,"Missouri","Montgomery County",1,12,149,82,67
050,29,139,"Missouri","Montgomery County",1,13,161,92,69
050,29,139,"Missouri","Montgomery County",1,14,159,85,74
050,29,139,"Missouri","Montgomery County",1,15,161,88,73
050,29,139,"Missouri","Montgomery County",1,16,143,75,68
050,29,139,"Missouri","Montgomery County",1,17,154,80,74
050,29,139,"Missouri","Montgomery County",1,18,129,75,54
050,29,139,"Missouri","Montgomery County",1,19,101,59,42
050,29,139,"Missouri","Montgomery County",1,20,100,58,42
050,29,139,"Missouri","Montgomery County",1,21,105,52,53
050,29,139,"Missouri","Montgomery County",1,22,105,56,49
050,29,139,"Missouri","Montgomery County",1,23,122,60,62
050,29,139,"Missouri","Montgomery County",1,24,111,57,54
050,29,139,"Missouri","Montgomery County",1,25,95,44,51
050,29,139,"Missouri","Montgomery County",1,26,123,70,53
050,29,139,"Missouri","Montgomery County",1,27,122,61,61
050,29,139,"Missouri","Montgomery County",1,28,131,68,63
050,29,139,"Missouri","Montgomery County",1,29,127,68,59
050,29,139,"Missouri","Montgomery County",1,30,131,68,63
050,29,139,"Missouri","Montgomery County",1,31,130,76,54
050,29,139,"Missouri","Montgomery County",1,32,112,59,53
050,29,139,"Missouri","Montgomery County",1,33,103,47,56
050,29,139,"Missouri","Montgomery County",1,34,118,59,59
050,29,139,"Missouri","Montgomery County",1,35,131,57,74
050,29,139,"Missouri","Montgomery County",1,36,135,66,69
050,29,139,"Missouri","Montgomery County",1,37,136,73,63
050,29,139,"Missouri","Montgomery County",1,38,128,64,64
050,29,139,"Missouri","Montgomery County",1,39,144,75,69
050,29,139,"Missouri","Montgomery County",1,40,131,67,64
050,29,139,"Missouri","Montgomery County",1,41,130,61,69
050,29,139,"Missouri","Montgomery County",1,42,134,64,70
050,29,139,"Missouri","Montgomery County",1,43,148,73,75
050,29,139,"Missouri","Montgomery County",1,44,121,64,57
050,29,139,"Missouri","Montgomery County",1,45,118,57,61
050,29,139,"Missouri","Montgomery County",1,46,121,63,58
050,29,139,"Missouri","Montgomery County",1,47,125,75,50
050,29,139,"Missouri","Montgomery County",1,48,145,83,62
050,29,139,"Missouri","Montgomery County",1,49,138,74,64
050,29,139,"Missouri","Montgomery County",1,50,140,77,63
050,29,139,"Missouri","Montgomery County",1,51,135,69,66
050,29,139,"Missouri","Montgomery County",1,52,132,61,71
050,29,139,"Missouri","Montgomery County",1,53,147,77,70
050,29,139,"Missouri","Montgomery County",1,54,155,81,74
050,29,139,"Missouri","Montgomery County",1,55,175,94,81
050,29,139,"Missouri","Montgomery County",1,56,187,101,86
050,29,139,"Missouri","Montgomery County",1,57,185,97,88
050,29,139,"Missouri","Montgomery County",1,58,206,99,107
050,29,139,"Missouri","Montgomery County",1,59,187,96,91
050,29,139,"Missouri","Montgomery County",1,60,195,90,105
050,29,139,"Missouri","Montgomery County",1,61,181,94,87
050,29,139,"Missouri","Montgomery County",1,62,173,85,88
050,29,139,"Missouri","Montgomery County",1,63,185,94,91
050,29,139,"Missouri","Montgomery County",1,64,164,87,77
050,29,139,"Missouri","Montgomery County",1,65,165,87,78
050,29,139,"Missouri","Montgomery County",1,66,151,70,81
050,29,139,"Missouri","Montgomery County",1,67,164,85,79
050,29,139,"Missouri","Montgomery County",1,68,140,78,62
050,29,139,"Missouri","Montgomery County",1,69,134,66,68
050,29,139,"Missouri","Montgomery County",1,70,115,56,59
050,29,139,"Missouri","Montgomery County",1,71,115,54,61
050,29,139,"Missouri","Montgomery County",1,72,106,58,48
050,29,139,"Missouri","Montgomery County",1,73,103,48,55
050,29,139,"Missouri","Montgomery County",1,74,70,31,39
050,29,139,"Missouri","Montgomery County",1,75,93,39,54
050,29,139,"Missouri","Montgomery County",1,76,104,47,57
050,29,139,"Missouri","Montgomery County",1,77,92,44,48
050,29,139,"Missouri","Montgomery County",1,78,87,41,46
050,29,139,"Missouri","Montgomery County",1,79,82,40,42
050,29,139,"Missouri","Montgomery County",1,80,61,30,31
050,29,139,"Missouri","Montgomery County",1,81,48,15,33
050,29,139,"Missouri","Montgomery County",1,82,56,24,32
050,29,139,"Missouri","Montgomery County",1,83,47,17,30
050,29,139,"Missouri","Montgomery County",1,84,44,22,22
050,29,139,"Missouri","Montgomery County",1,85,306,105,201
050,29,139,"Missouri","Montgomery County",2,0,141,71,70
050,29,139,"Missouri","Montgomery County",2,1,136,61,75
050,29,139,"Missouri","Montgomery County",2,2,126,67,59
050,29,139,"Missouri","Montgomery County",2,3,121,63,58
050,29,139,"Missouri","Montgomery County",2,4,127,59,68
050,29,139,"Missouri","Montgomery County",2,5,134,64,70
050,29,139,"Missouri","Montgomery County",2,6,133,68,65
050,29,139,"Missouri","Montgomery County",2,7,138,74,64
050,29,139,"Missouri","Montgomery County",2,8,134,74,60
050,29,139,"Missouri","Montgomery County",2,9,138,71,67
050,29,139,"Missouri","Montgomery County",2,10,130,65,65
050,29,139,"Missouri","Montgomery County",2,11,137,72,65
050,29,139,"Missouri","Montgomery County",2,12,146,80,66
050,29,139,"Missouri","Montgomery County",2,13,157,89,68
050,29,139,"Missouri","Montgomery County",2,14,160,86,74
050,29,139,"Missouri","Montgomery County",2,15,156,85,71
050,29,139,"Missouri","Montgomery County",2,16,148,79,69
050,29,139,"Missouri","Montgomery County",2,17,152,79,73
050,29,139,"Missouri","Montgomery County",2,18,127,74,53
050,29,139,"Missouri","Montgomery County",2,19,101,58,43
050,29,139,"Missouri","Montgomery County",2,20,103,60,43
050,29,139,"Missouri","Montgomery County",2,21,104,54,50
050,29,139,"Missouri","Montgomery County",2,22,107,56,51
050,29,139,"Missouri","Montgomery County",2,23,119,59,60
050,29,139,"Missouri","Montgomery County",2,24,114,58,56
050,29,139,"Missouri","Montgomery County",2,25,100,48,52
050,29,139,"Missouri","Montgomery County",2,26,115,62,53
050,29,139,"Missouri","Montgomery County",2,27,121,63,58
050,29,139,"Missouri","Montgomery County",2,28,130,66,64
050,29,139,"Missouri","Montgomery County",2,29,131,69,62
050,29,139,"Missouri","Montgomery County",2,30,132,70,62
050,29,139,"Missouri","Montgomery County",2,31,132,76,56
050,29,139,"Missouri","Montgomery County",2,32,115,62,53
050,29,139,"Missouri","Montgomery County",2,33,103,49,54
050,29,139,"Missouri","Montgomery County",2,34,114,56,58
050,29,139,"Missouri","Montgomery County",2,35,131,60,71
050,29,139,"Missouri","Montgomery County",2,36,133,63,70
050,29,139,"Missouri","Montgomery County",2,37,136,71,65
050,29,139,"Missouri","Montgomery County",2,38,132,68,64
050,29,139,"Missouri","Montgomery County",2,39,138,72,66
050,29,139,"Missouri","Montgomery County",2,40,136,70,66
050,29,139,"Missouri","Montgomery County",2,41,129,62,67
050,29,139,"Missouri","Montgomery County",2,42,133,64,69
050,29,139,"Missouri","Montgomery County",2,43,145,71,74
050,29,139,"Missouri","Montgomery County",2,44,126,65,61
050,29,139,"Missouri","Montgomery County",2,45,118,58,60
050,29,139,"Missouri","Montgomery County",2,46,119,61,58
050,29,139,"Missouri","Montgomery County",2,47,122,71,51
050,29,139,"Missouri","Montgomery County",2,48,139,80,59
050,29,139,"Missouri","Montgomery County",2,49,141,77,64
050,29,139,"Missouri","Montgomery County",2,50,140,77,63
050,29,139,"Missouri","Montgomery County",2,51,134,69,65
050,29,139,"Missouri","Montgomery County",2,52,132,62,70
050,29,139,"Missouri","Montgomery County",2,53,143,72,71
050,29,139,"Missouri","Montgomery County",2,54,153,79,74
050,29,139,"Missouri","Montgomery County",2,55,170,91,79
050,29,139,"Missouri","Montgomery County",2,56,186,100,86
050,29,139,"Missouri","Montgomery County",2,57,186,97,89
050,29,139,"Missouri","Montgomery County",2,58,199,98,101
050,29,139,"Missouri","Montgomery County",2,59,194,98,96
050,29,139,"Missouri","Montgomery County",2,60,191,91,100
050,29,139,"Missouri","Montgomery County",2,61,183,93,90
050,29,139,"Missouri","Montgomery County",2,62,174,86,88
050,29,139,"Missouri","Montgomery County",2,63,186,94,92
050,29,139,"Missouri","Montgomery County",2,64,166,87,79
050,29,139,"Missouri","Montgomery County",2,65,164,86,78
050,29,139,"Missouri","Montgomery County",2,66,156,75,81
050,29,139,"Missouri","Montgomery County",2,67,159,81,78
050,29,139,"Missouri","Montgomery County",2,68,144,79,65
050,29,139,"Missouri","Montgomery County",2,69,137,69,68
050,29,139,"Missouri","Montgomery County",2,70,118,58,60
050,29,139,"Missouri","Montgomery County",2,71,114,53,61
050,29,139,"Missouri","Montgomery County",2,72,106,56,50
050,29,139,"Missouri","Montgomery County",2,73,107,53,54
050,29,139,"Missouri","Montgomery County",2,74,73,33,40
050,29,139,"Missouri","Montgomery County",2,75,87,37,50
050,29,139,"Missouri","Montgomery County",2,76,100,45,55
050,29,139,"Missouri","Montgomery County",2,77,94,44,50
050,29,139,"Missouri","Montgomery County",2,78,86,41,45
050,29,139,"Missouri","Montgomery County",2,79,78,36,42
050,29,139,"Missouri","Montgomery County",2,80,66,32,34
050,29,139,"Missouri","Montgomery County",2,81,45,17,28
050,29,139,"Missouri","Montgomery County",2,82,53,22,31
050,29,139,"Missouri","Montgomery County",2,83,49,19,30
050,29,139,"Missouri","Montgomery County",2,84,44,20,24
050,29,139,"Missouri","Montgomery County",2,85,304,105,199
050,29,139,"Missouri","Montgomery County",3,0,118,63,55
050,29,139,"Missouri","Montgomery County",3,1,139,68,71
050,29,139,"Missouri","Montgomery County",3,2,138,60,78
050,29,139,"Missouri","Montgomery County",3,3,135,68,67
050,29,139,"Missouri","Montgomery County",3,4,127,66,61
050,29,139,"Missouri","Montgomery County",3,5,136,65,71
050,29,139,"Missouri","Montgomery County",3,6,143,71,72
050,29,139,"Missouri","Montgomery County",3,7,138,74,64
050,29,139,"Missouri","Montgomery County",3,8,139,74,65
050,29,139,"Missouri","Montgomery County",3,9,130,75,55
050,29,139,"Missouri","Montgomery County",3,10,146,80,66
050,29,139,"Missouri","Montgomery County",3,11,132,68,64
050,29,139,"Missouri","Montgomery County",3,12,141,76,65
050,29,139,"Missouri","Montgomery County",3,13,147,79,68
050,29,139,"Missouri","Montgomery County",3,14,153,89,64
050,29,139,"Missouri","Montgomery County",3,15,157,86,71
050,29,139,"Missouri","Montgomery County",3,16,153,85,68
050,29,139,"Missouri","Montgomery County",3,17,150,74,76
050,29,139,"Missouri","Montgomery County",3,18,137,72,65
050,29,139,"Missouri","Montgomery County",3,19,110,62,48
050,29,139,"Missouri","Montgomery County",3,20,108,64,44
050,29,139,"Missouri","Montgomery County",3,21,113,61,52
050,29,139,"Missouri","Montgomery County",3,22,113,59,54
050,29,139,"Missouri","Montgomery County",3,23,123,61,62
050,29,139,"Missouri","Montgomery County",3,24,122,66,56
050,29,139,"Missouri","Montgomery County",3,25,123,59,64
050,29,139,"Missouri","Montgomery County",3,26,100,45,55
050,29,139,"Missouri","Montgomery County",3,27,125,68,57
050,29,139,"Missouri","Montgomery County",3,28,112,57,55
050,29,139,"Missouri","Montgomery County",3,29,133,68,65
050,29,139,"Missouri","Montgomery County",3,30,138,66,72
050,29,139,"Missouri","Montgomery County",3,31,141,78,63
050,29,139,"Missouri","Montgomery County",3,32,138,79,59
050,29,139,"Missouri","Montgomery County",3,33,121,67,54
050,29,139,"Missouri","Montgomery County",3,34,108,51,57
050,29,139,"Missouri","Montgomery County",3,35,119,62,57
050,29,139,"Missouri","Montgomery County",3,36,131,64,67
050,29,139,"Missouri","Montgomery County",3,37,142,69,73
050,29,139,"Missouri","Montgomery County",3,38,143,76,67
050,29,139,"Missouri","Montgomery County",3,39,127,62,65
050,29,139,"Missouri","Montgomery County",3,40,139,70,69
050,29,139,"Missouri","Montgomery County",3,41,138,66,72
050,29,139,"Missouri","Montgomery County",3,42,130,61,69
050,29,139,"Missouri","Montgomery County",3,43,134,65,69
050,29,139,"Missouri","Montgomery County",3,44,142,70,72
050,29,139,"Missouri","Montgomery County",3,45,132,69,63
050,29,139,"Missouri","Montgomery County",3,46,126,60,66
050,29,139,"Missouri","Montgomery County",3,47,117,60,57
050,29,139,"Missouri","Montgomery County",3,48,126,77,49
050,29,139,"Missouri","Montgomery County",3,49,138,79,59
050,29,139,"Missouri","Montgomery County",3,50,136,74,62
050,29,139,"Missouri","Montgomery County",3,51,147,83,64
050,29,139,"Missouri","Montgomery County",3,52,139,72,67
050,29,139,"Missouri","Montgomery County",3,53,128,59,69
050,29,139,"Missouri","Montgomery County",3,54,147,75,72
050,29,139,"Missouri","Montgomery County",3,55,145,76,69
050,29,139,"Missouri","Montgomery County",3,56,177,93,84
050,29,139,"Missouri","Montgomery County",3,57,194,105,89
050,29,139,"Missouri","Montgomery County",3,58,186,96,90
050,29,139,"Missouri","Montgomery County",3,59,200,95,105
050,29,139,"Missouri","Montgomery County",3,60,200,99,101
050,29,139,"Missouri","Montgomery County",3,61,199,99,100
050,29,139,"Missouri","Montgomery County",3,62,189,97,92
050,29,139,"Missouri","Montgomery County",3,63,177,86,91
050,29,139,"Missouri","Montgomery County",3,64,182,91,91
050,29,139,"Missouri","Montgomery County",3,65,167,87,80
050,29,139,"Missouri","Montgomery County",3,66,160,81,79
050,29,139,"Missouri","Montgomery County",3,67,153,72,81
050,29,139,"Missouri","Montgomery County",3,68,153,77,76
050,29,139,"Missouri","Montgomery County",3,69,139,76,63
050,29,139,"Missouri","Montgomery County",3,70,132,66,66
050,29,139,"Missouri","Montgomery County",3,71,121,59,62
050,29,139,"Missouri","Montgomery County",3,72,113,56,57
050,29,139,"Missouri","Montgomery County",3,73,107,55,52
050,29,139,"Missouri","Montgomery County",3,74,98,48,50
050,29,139,"Missouri","Montgomery County",3,75,65,29,36
050,29,139,"Missouri","Montgomery County",3,76,82,36,46
050,29,139,"Missouri","Montgomery County",3,77,92,40,52
050,29,139,"Missouri","Montgomery County",3,78,93,43,50
050,29,139,"Missouri","Montgomery County",3,79,84,40,44
050,29,139,"Missouri","Montgomery County",3,80,72,30,42
050,29,139,"Missouri","Montgomery County",3,81,54,27,27
050,29,139,"Missouri","Montgomery County",3,82,35,11,24
050,29,139,"Missouri","Montgomery County",3,83,51,22,29
050,29,139,"Missouri","Montgomery County",3,84,48,17,31
050,29,139,"Missouri","Montgomery County",3,85,297,101,196
050,29,139,"Missouri","Montgomery County",4,0,123,70,53
050,29,139,"Missouri","Montgomery County",4,1,123,69,54
050,29,139,"Missouri","Montgomery County",4,2,142,71,71
050,29,139,"Missouri","Montgomery County",4,3,137,67,70
050,29,139,"Missouri","Montgomery County",4,4,140,73,67
050,29,139,"Missouri","Montgomery County",4,5,128,66,62
050,29,139,"Missouri","Montgomery County",4,6,131,63,68
050,29,139,"Missouri","Montgomery County",4,7,147,78,69
050,29,139,"Missouri","Montgomery County",4,8,133,70,63
050,29,139,"Missouri","Montgomery County",4,9,144,73,71
050,29,139,"Missouri","Montgomery County",4,10,136,77,59
050,29,139,"Missouri","Montgomery County",4,11,143,75,68
050,29,139,"Missouri","Montgomery County",4,12,137,75,62
050,29,139,"Missouri","Montgomery County",4,13,134,69,65
050,29,139,"Missouri","Montgomery County",4,14,146,77,69
050,29,139,"Missouri","Montgomery County",4,15,149,79,70
050,29,139,"Missouri","Montgomery County",4,16,163,93,70
050,29,139,"Missouri","Montgomery County",4,17,157,87,70
050,29,139,"Missouri","Montgomery County",4,18,128,66,62
050,29,139,"Missouri","Montgomery County",4,19,102,53,49
050,29,139,"Missouri","Montgomery County",4,20,120,69,51
050,29,139,"Missouri","Montgomery County",4,21,112,64,48
050,29,139,"Missouri","Montgomery County",4,22,115,59,56
050,29,139,"Missouri","Montgomery County",4,23,112,56,56
050,29,139,"Missouri","Montgomery County",4,24,132,71,61
050,29,139,"Missouri","Montgomery County",4,25,127,67,60
050,29,139,"Missouri","Montgomery County",4,26,124,60,64
050,29,139,"Missouri","Montgomery County",4,27,119,60,59
050,29,139,"Missouri","Montgomery County",4,28,134,77,57
050,29,139,"Missouri","Montgomery County",4,29,114,56,58
050,29,139,"Missouri","Montgomery County",4,30,126,62,64
050,29,139,"Missouri","Montgomery County",4,31,139,67,72
050,29,139,"Missouri","Montgomery County",4,32,143,81,62
050,29,139,"Missouri","Montgomery County",4,33,134,75,59
050,29,139,"Missouri","Montgomery County",4,34,125,68,57
050,29,139,"Missouri","Montgomery County",4,35,103,48,55
050,29,139,"Missouri","Montgomery County",4,36,117,57,60
050,29,139,"Missouri","Montgomery County",4,37,128,62,66
050,29,139,"Missouri","Montgomery County",4,38,140,66,74
050,29,139,"Missouri","Montgomery County",4,39,143,75,68
050,29,139,"Missouri","Montgomery County",4,40,134,61,73
050,29,139,"Missouri","Montgomery County",4,41,136,68,68
050,29,139,"Missouri","Montgomery County",4,42,141,69,72
050,29,139,"Missouri","Montgomery County",4,43,132,66,66
050,29,139,"Missouri","Montgomery County",4,44,135,68,67
050,29,139,"Missouri","Montgomery County",4,45,142,69,73
050,29,139,"Missouri","Montgomery County",4,46,131,71,60
050,29,139,"Missouri","Montgomery County",4,47,120,56,64
050,29,139,"Missouri","Montgomery County",4,48,122,63,59
050,29,139,"Missouri","Montgomery County",4,49,134,76,58
050,29,139,"Missouri","Montgomery County",4,50,140,79,61
050,29,139,"Missouri","Montgomery County",4,51,140,76,64
050,29,139,"Missouri","Montgomery County",4,52,148,81,67
050,29,139,"Missouri","Montgomery County",4,53,140,73,67
050,29,139,"Missouri","Montgomery County",4,54,133,63,70
050,29,139,"Missouri","Montgomery County",4,55,152,78,74
050,29,139,"Missouri","Montgomery County",4,56,141,74,67
050,29,139,"Missouri","Montgomery County",4,57,183,95,88
050,29,139,"Missouri","Montgomery County",4,58,197,109,88
050,29,139,"Missouri","Montgomery County",4,59,190,96,94
050,29,139,"Missouri","Montgomery County",4,60,207,95,112
050,29,139,"Missouri","Montgomery County",4,61,211,105,106
050,29,139,"Missouri","Montgomery County",4,62,196,94,102
050,29,139,"Missouri","Montgomery County",4,63,185,94,91
050,29,139,"Missouri","Montgomery County",4,64,170,81,89
050,29,139,"Missouri","Montgomery County",4,65,184,94,90
050,29,139,"Missouri","Montgomery County",4,66,168,83,85
050,29,139,"Missouri","Montgomery County",4,67,162,81,81
050,29,139,"Missouri","Montgomery County",4,68,147,68,79
050,29,139,"Missouri","Montgomery County",4,69,151,75,76
050,29,139,"Missouri","Montgomery County",4,70,134,74,60
050,29,139,"Missouri","Montgomery County",4,71,133,66,67
050,29,139,"Missouri","Montgomery County",4,72,113,58,55
050,29,139,"Missouri","Montgomery County",4,73,113,57,56
050,29,139,"Missouri","Montgomery County",4,74,98,55,43
050,29,139,"Missouri","Montgomery County",4,75,91,44,47
050,29,139,"Missouri","Montgomery County",4,76,63,26,37
050,29,139,"Missouri","Montgomery County",4,77,71,32,39
050,29,139,"Missouri","Montgomery County",4,78,91,39,52
050,29,139,"Missouri","Montgomery County",4,79,88,39,49
050,29,139,"Missouri","Montgomery County",4,80,79,35,44
050,29,139,"Missouri","Montgomery County",4,81,66,27,39
050,29,139,"Missouri","Montgomery County",4,82,52,27,25
050,29,139,"Missouri","Montgomery County",4,83,33,11,22
050,29,139,"Missouri","Montgomery County",4,84,47,20,27
050,29,139,"Missouri","Montgomery County",4,85,285,82,203
050,29,139,"Missouri","Montgomery County",5,0,122,70,52
050,29,139,"Missouri","Montgomery County",5,1,126,75,51
050,29,139,"Missouri","Montgomery County",5,2,121,67,54
050,29,139,"Missouri","Montgomery County",5,3,139,71,68
050,29,139,"Missouri","Montgomery County",5,4,142,76,66
050,29,139,"Missouri","Montgomery County",5,5,139,73,66
050,29,139,"Missouri","Montgomery County",5,6,123,58,65
050,29,139,"Missouri","Montgomery County",5,7,130,60,70
050,29,139,"Missouri","Montgomery County",5,8,138,66,72
050,29,139,"Missouri","Montgomery County",5,9,143,72,71
050,29,139,"Missouri","Montgomery County",5,10,149,75,74
050,29,139,"Missouri","Montgomery County",5,11,133,75,58
050,29,139,"Missouri","Montgomery County",5,12,144,77,67
050,29,139,"Missouri","Montgomery County",5,13,135,71,64
050,29,139,"Missouri","Montgomery County",5,14,133,71,62
050,29,139,"Missouri","Montgomery County",5,15,150,79,71
050,29,139,"Missouri","Montgomery County",5,16,156,89,67
050,29,139,"Missouri","Montgomery County",5,17,162,89,73
050,29,139,"Missouri","Montgomery County",5,18,126,70,56
050,29,139,"Missouri","Montgomery County",5,19,97,49,48
050,29,139,"Missouri","Montgomery County",5,20,109,56,53
050,29,139,"Missouri","Montgomery County",5,21,125,68,57
050,29,139,"Missouri","Montgomery County",5,22,136,76,60
050,29,139,"Missouri","Montgomery County",5,23,123,61,62
050,29,139,"Missouri","Montgomery County",5,24,122,68,54
050,29,139,"Missouri","Montgomery County",5,25,142,71,71
050,29,139,"Missouri","Montgomery County",5,26,120,60,60
050,29,139,"Missouri","Montgomery County",5,27,135,70,65
050,29,139,"Missouri","Montgomery County",5,28,115,56,59
050,29,139,"Missouri","Montgomery County",5,29,131,76,55
050,29,139,"Missouri","Montgomery County",5,30,117,62,55
050,29,139,"Missouri","Montgomery County",5,31,128,64,64
050,29,139,"Missouri","Montgomery County",5,32,140,68,72
050,29,139,"Missouri","Montgomery County",5,33,142,75,67
050,29,139,"Missouri","Montgomery County",5,34,136,75,61
050,29,139,"Missouri","Montgomery County",5,35,127,68,59
050,29,139,"Missouri","Montgomery County",5,36,104,48,56
050,29,139,"Missouri","Montgomery County",5,37,116,59,57
050,29,139,"Missouri","Montgomery County",5,38,130,61,69
050,29,139,"Missouri","Montgomery County",5,39,137,69,68
050,29,139,"Missouri","Montgomery County",5,40,145,72,73
050,29,139,"Missouri","Montgomery County",5,41,137,64,73
050,29,139,"Missouri","Montgomery County",5,42,133,70,63
050,29,139,"Missouri","Montgomery County",5,43,146,71,75
050,29,139,"Missouri","Montgomery County",5,44,134,68,66
050,29,139,"Missouri","Montgomery County",5,45,135,69,66
050,29,139,"Missouri","Montgomery County",5,46,146,74,72
050,29,139,"Missouri","Montgomery County",5,47,128,71,57
050,29,139,"Missouri","Montgomery County",5,48,116,55,61
050,29,139,"Missouri","Montgomery County",5,49,118,59,59
050,29,139,"Missouri","Montgomery County",5,50,134,77,57
050,29,139,"Missouri","Montgomery County",5,51,140,80,60
050,29,139,"Missouri","Montgomery County",5,52,143,78,65
050,29,139,"Missouri","Montgomery County",5,53,150,84,66
050,29,139,"Missouri","Montgomery County",5,54,144,73,71
050,29,139,"Missouri","Montgomery County",5,55,127,65,62
050,29,139,"Missouri","Montgomery County",5,56,152,75,77
050,29,139,"Missouri","Montgomery County",5,57,139,73,66
050,29,139,"Missouri","Montgomery County",5,58,185,97,88
050,29,139,"Missouri","Montgomery County",5,59,203,111,92
050,29,139,"Missouri","Montgomery County",5,60,190,95,95
050,29,139,"Missouri","Montgomery County",5,61,206,95,111
050,29,139,"Missouri","Montgomery County",5,62,202,101,101
050,29,139,"Missouri","Montgomery County",5,63,193,93,100
050,29,139,"Missouri","Montgomery County",5,64,177,84,93
050,29,139,"Missouri","Montgomery County",5,65,171,79,92
050,29,139,"Missouri","Montgomery County",5,66,182,91,91
050,29,139,"Missouri","Montgomery County",5,67,163,82,81
050,29,139,"Missouri","Montgomery County",5,68,162,80,82
050,29,139,"Missouri","Montgomery County",5,69,146,66,80
050,29,139,"Missouri","Montgomery County",5,70,146,71,75
050,29,139,"Missouri","Montgomery County",5,71,131,73,58
050,29,139,"Missouri","Montgomery County",5,72,126,62,64
050,29,139,"Missouri","Montgomery County",5,73,112,57,55
050,29,139,"Missouri","Montgomery County",5,74,104,52,52
050,29,139,"Missouri","Montgomery County",5,75,90,48,42
050,29,139,"Missouri","Montgomery County",5,76,87,42,45
050,29,139,"Missouri","Montgomery County",5,77,53,23,30
050,29,139,"Missouri","Montgomery County",5,78,67,29,38
050,29,139,"Missouri","Montgomery County",5,79,83,35,48
050,29,139,"Missouri","Montgomery County",5,80,79,31,48
050,29,139,"Missouri","Montgomery County",5,81,66,28,38
050,29,139,"Missouri","Montgomery County",5,82,63,26,37
050,29,139,"Missouri","Montgomery County",5,83,48,25,23
050,29,139,"Missouri","Montgomery County",5,84,30,10,20
050,29,139,"Missouri","Montgomery County",5,85,284,76,208
050,29,141,"Missouri","Morgan County",1,0,256,133,123
050,29,141,"Missouri","Morgan County",1,1,257,144,113
050,29,141,"Missouri","Morgan County",1,2,261,141,120
050,29,141,"Missouri","Morgan County",1,3,300,155,145
050,29,141,"Missouri","Morgan County",1,4,283,136,147
050,29,141,"Missouri","Morgan County",1,5,250,126,124
050,29,141,"Missouri","Morgan County",1,6,230,115,115
050,29,141,"Missouri","Morgan County",1,7,249,134,115
050,29,141,"Missouri","Morgan County",1,8,252,133,119
050,29,141,"Missouri","Morgan County",1,9,264,140,124
050,29,141,"Missouri","Morgan County",1,10,270,138,132
050,29,141,"Missouri","Morgan County",1,11,268,124,144
050,29,141,"Missouri","Morgan County",1,12,309,150,159
050,29,141,"Missouri","Morgan County",1,13,290,149,141
050,29,141,"Missouri","Morgan County",1,14,281,156,125
050,29,141,"Missouri","Morgan County",1,15,273,148,125
050,29,141,"Missouri","Morgan County",1,16,268,137,131
050,29,141,"Missouri","Morgan County",1,17,298,145,153
050,29,141,"Missouri","Morgan County",1,18,219,115,104
050,29,141,"Missouri","Morgan County",1,19,170,89,81
050,29,141,"Missouri","Morgan County",1,20,189,106,83
050,29,141,"Missouri","Morgan County",1,21,204,110,94
050,29,141,"Missouri","Morgan County",1,22,191,98,93
050,29,141,"Missouri","Morgan County",1,23,213,116,97
050,29,141,"Missouri","Morgan County",1,24,196,100,96
050,29,141,"Missouri","Morgan County",1,25,203,103,100
050,29,141,"Missouri","Morgan County",1,26,204,100,104
050,29,141,"Missouri","Morgan County",1,27,213,101,112
050,29,141,"Missouri","Morgan County",1,28,229,112,117
050,29,141,"Missouri","Morgan County",1,29,227,109,118
050,29,141,"Missouri","Morgan County",1,30,203,114,89
050,29,141,"Missouri","Morgan County",1,31,234,115,119
050,29,141,"Missouri","Morgan County",1,32,222,106,116
050,29,141,"Missouri","Morgan County",1,33,223,112,111
050,29,141,"Missouri","Morgan County",1,34,200,105,95
050,29,141,"Missouri","Morgan County",1,35,203,105,98
050,29,141,"Missouri","Morgan County",1,36,198,105,93
050,29,141,"Missouri","Morgan County",1,37,207,107,100
050,29,141,"Missouri","Morgan County",1,38,200,97,103
050,29,141,"Missouri","Morgan County",1,39,209,96,113
050,29,141,"Missouri","Morgan County",1,40,208,115,93
050,29,141,"Missouri","Morgan County",1,41,204,117,87
050,29,141,"Missouri","Morgan County",1,42,201,100,101
050,29,141,"Missouri","Morgan County",1,43,183,93,90
050,29,141,"Missouri","Morgan County",1,44,189,109,80
050,29,141,"Missouri","Morgan County",1,45,197,103,94
050,29,141,"Missouri","Morgan County",1,46,197,99,98
050,29,141,"Missouri","Morgan County",1,47,201,100,101
050,29,141,"Missouri","Morgan County",1,48,221,107,114
050,29,141,"Missouri","Morgan County",1,49,231,120,111
050,29,141,"Missouri","Morgan County",1,50,231,112,119
050,29,141,"Missouri","Morgan County",1,51,250,125,125
050,29,141,"Missouri","Morgan County",1,52,244,131,113
050,29,141,"Missouri","Morgan County",1,53,270,138,132
050,29,141,"Missouri","Morgan County",1,54,275,140,135
050,29,141,"Missouri","Morgan County",1,55,314,140,174
050,29,141,"Missouri","Morgan County",1,56,328,172,156
050,29,141,"Missouri","Morgan County",1,57,321,161,160
050,29,141,"Missouri","Morgan County",1,58,327,163,164
050,29,141,"Missouri","Morgan County",1,59,340,180,160
050,29,141,"Missouri","Morgan County",1,60,337,172,165
050,29,141,"Missouri","Morgan County",1,61,324,161,163
050,29,141,"Missouri","Morgan County",1,62,350,177,173
050,29,141,"Missouri","Morgan County",1,63,339,173,166
050,29,141,"Missouri","Morgan County",1,64,359,186,173
050,29,141,"Missouri","Morgan County",1,65,324,165,159
050,29,141,"Missouri","Morgan County",1,66,327,173,154
050,29,141,"Missouri","Morgan County",1,67,318,152,166
050,29,141,"Missouri","Morgan County",1,68,326,173,153
050,29,141,"Missouri","Morgan County",1,69,300,156,144
050,29,141,"Missouri","Morgan County",1,70,271,140,131
050,29,141,"Missouri","Morgan County",1,71,258,145,113
050,29,141,"Missouri","Morgan County",1,72,276,147,129
050,29,141,"Missouri","Morgan County",1,73,278,127,151
050,29,141,"Missouri","Morgan County",1,74,215,104,111
050,29,141,"Missouri","Morgan County",1,75,202,102,100
050,29,141,"Missouri","Morgan County",1,76,211,106,105
050,29,141,"Missouri","Morgan County",1,77,217,107,110
050,29,141,"Missouri","Morgan County",1,78,173,83,90
050,29,141,"Missouri","Morgan County",1,79,150,74,76
050,29,141,"Missouri","Morgan County",1,80,149,77,72
050,29,141,"Missouri","Morgan County",1,81,139,75,64
050,29,141,"Missouri","Morgan County",1,82,120,60,60
050,29,141,"Missouri","Morgan County",1,83,102,47,55
050,29,141,"Missouri","Morgan County",1,84,100,46,54
050,29,141,"Missouri","Morgan County",1,85,489,195,294
050,29,141,"Missouri","Morgan County",2,0,247,130,117
050,29,141,"Missouri","Morgan County",2,1,252,137,115
050,29,141,"Missouri","Morgan County",2,2,261,141,120
050,29,141,"Missouri","Morgan County",2,3,289,151,138
050,29,141,"Missouri","Morgan County",2,4,286,141,145
050,29,141,"Missouri","Morgan County",2,5,255,127,128
050,29,141,"Missouri","Morgan County",2,6,234,119,115
050,29,141,"Missouri","Morgan County",2,7,243,127,116
050,29,141,"Missouri","Morgan County",2,8,250,133,117
050,29,141,"Missouri","Morgan County",2,9,259,136,123
050,29,141,"Missouri","Morgan County",2,10,270,137,133
050,29,141,"Missouri","Morgan County",2,11,269,127,142
050,29,141,"Missouri","Morgan County",2,12,302,146,156
050,29,141,"Missouri","Morgan County",2,13,293,149,144
050,29,141,"Missouri","Morgan County",2,14,282,152,130
050,29,141,"Missouri","Morgan County",2,15,274,150,124
050,29,141,"Missouri","Morgan County",2,16,271,141,130
050,29,141,"Missouri","Morgan County",2,17,290,145,145
050,29,141,"Missouri","Morgan County",2,18,223,117,106
050,29,141,"Missouri","Morgan County",2,19,172,91,81
050,29,141,"Missouri","Morgan County",2,20,191,105,86
050,29,141,"Missouri","Morgan County",2,21,205,111,94
050,29,141,"Missouri","Morgan County",2,22,198,103,95
050,29,141,"Missouri","Morgan County",2,23,212,115,97
050,29,141,"Missouri","Morgan County",2,24,202,106,96
050,29,141,"Missouri","Morgan County",2,25,203,104,99
050,29,141,"Missouri","Morgan County",2,26,204,100,104
050,29,141,"Missouri","Morgan County",2,27,212,102,110
050,29,141,"Missouri","Morgan County",2,28,222,109,113
050,29,141,"Missouri","Morgan County",2,29,227,112,115
050,29,141,"Missouri","Morgan County",2,30,207,111,96
050,29,141,"Missouri","Morgan County",2,31,227,117,110
050,29,141,"Missouri","Morgan County",2,32,224,107,117
050,29,141,"Missouri","Morgan County",2,33,220,109,111
050,29,141,"Missouri","Morgan County",2,34,207,109,98
050,29,141,"Missouri","Morgan County",2,35,201,105,96
050,29,141,"Missouri","Morgan County",2,36,197,105,92
050,29,141,"Missouri","Morgan County",2,37,203,103,100
050,29,141,"Missouri","Morgan County",2,38,202,99,103
050,29,141,"Missouri","Morgan County",2,39,209,98,111
050,29,141,"Missouri","Morgan County",2,40,211,113,98
050,29,141,"Missouri","Morgan County",2,41,202,115,87
050,29,141,"Missouri","Morgan County",2,42,198,103,95
050,29,141,"Missouri","Morgan County",2,43,189,96,93
050,29,141,"Missouri","Morgan County",2,44,186,104,82
050,29,141,"Missouri","Morgan County",2,45,194,103,91
050,29,141,"Missouri","Morgan County",2,46,195,98,97
050,29,141,"Missouri","Morgan County",2,47,199,99,100
050,29,141,"Missouri","Morgan County",2,48,219,108,111
050,29,141,"Missouri","Morgan County",2,49,229,117,112
050,29,141,"Missouri","Morgan County",2,50,232,114,118
050,29,141,"Missouri","Morgan County",2,51,248,123,125
050,29,141,"Missouri","Morgan County",2,52,247,130,117
050,29,141,"Missouri","Morgan County",2,53,264,137,127
050,29,141,"Missouri","Morgan County",2,54,271,138,133
050,29,141,"Missouri","Morgan County",2,55,306,140,166
050,29,141,"Missouri","Morgan County",2,56,329,166,163
050,29,141,"Missouri","Morgan County",2,57,327,166,161
050,29,141,"Missouri","Morgan County",2,58,325,163,162
050,29,141,"Missouri","Morgan County",2,59,343,181,162
050,29,141,"Missouri","Morgan County",2,60,337,175,162
050,29,141,"Missouri","Morgan County",2,61,329,165,164
050,29,141,"Missouri","Morgan County",2,62,343,172,171
050,29,141,"Missouri","Morgan County",2,63,347,178,169
050,29,141,"Missouri","Morgan County",2,64,350,179,171
050,29,141,"Missouri","Morgan County",2,65,336,173,163
050,29,141,"Missouri","Morgan County",2,66,324,171,153
050,29,141,"Missouri","Morgan County",2,67,318,156,162
050,29,141,"Missouri","Morgan County",2,68,319,166,153
050,29,141,"Missouri","Morgan County",2,69,302,156,146
050,29,141,"Missouri","Morgan County",2,70,278,144,134
050,29,141,"Missouri","Morgan County",2,71,262,144,118
050,29,141,"Missouri","Morgan County",2,72,269,145,124
050,29,141,"Missouri","Morgan County",2,73,291,140,151
050,29,141,"Missouri","Morgan County",2,74,215,102,113
050,29,141,"Missouri","Morgan County",2,75,203,99,104
050,29,141,"Missouri","Morgan County",2,76,204,105,99
050,29,141,"Missouri","Morgan County",2,77,217,108,109
050,29,141,"Missouri","Morgan County",2,78,180,86,94
050,29,141,"Missouri","Morgan County",2,79,150,75,75
050,29,141,"Missouri","Morgan County",2,80,147,74,73
050,29,141,"Missouri","Morgan County",2,81,136,74,62
050,29,141,"Missouri","Morgan County",2,82,124,62,62
050,29,141,"Missouri","Morgan County",2,83,104,50,54
050,29,141,"Missouri","Morgan County",2,84,100,45,55
050,29,141,"Missouri","Morgan County",2,85,501,201,300
050,29,141,"Missouri","Morgan County",3,0,270,146,124
050,29,141,"Missouri","Morgan County",3,1,260,139,121
050,29,141,"Missouri","Morgan County",3,2,259,145,114
050,29,141,"Missouri","Morgan County",3,3,279,153,126
050,29,141,"Missouri","Morgan County",3,4,293,154,139
050,29,141,"Missouri","Morgan County",3,5,286,142,144
050,29,141,"Missouri","Morgan County",3,6,264,135,129
050,29,141,"Missouri","Morgan County",3,7,235,120,115
050,29,141,"Missouri","Morgan County",3,8,260,128,132
050,29,141,"Missouri","Morgan County",3,9,241,123,118
050,29,141,"Missouri","Morgan County",3,10,263,134,129
050,29,141,"Missouri","Morgan County",3,11,265,133,132
050,29,141,"Missouri","Morgan County",3,12,270,131,139
050,29,141,"Missouri","Morgan County",3,13,311,149,162
050,29,141,"Missouri","Morgan County",3,14,305,157,148
050,29,141,"Missouri","Morgan County",3,15,293,154,139
050,29,141,"Missouri","Morgan County",3,16,273,153,120
050,29,141,"Missouri","Morgan County",3,17,283,144,139
050,29,141,"Missouri","Morgan County",3,18,232,117,115
050,29,141,"Missouri","Morgan County",3,19,181,94,87
050,29,141,"Missouri","Morgan County",3,20,182,97,85
050,29,141,"Missouri","Morgan County",3,21,217,123,94
050,29,141,"Missouri","Morgan County",3,22,209,114,95
050,29,141,"Missouri","Morgan County",3,23,212,101,111
050,29,141,"Missouri","Morgan County",3,24,218,120,98
050,29,141,"Missouri","Morgan County",3,25,205,111,94
050,29,141,"Missouri","Morgan County",3,26,215,107,108
050,29,141,"Missouri","Morgan County",3,27,219,102,117
050,29,141,"Missouri","Morgan County",3,28,213,109,104
050,29,141,"Missouri","Morgan County",3,29,235,118,117
050,29,141,"Missouri","Morgan County",3,30,242,116,126
050,29,141,"Missouri","Morgan County",3,31,218,113,105
050,29,141,"Missouri","Morgan County",3,32,225,123,102
050,29,141,"Missouri","Morgan County",3,33,228,115,113
050,29,141,"Missouri","Morgan County",3,34,229,119,110
050,29,141,"Missouri","Morgan County",3,35,215,114,101
050,29,141,"Missouri","Morgan County",3,36,208,102,106
050,29,141,"Missouri","Morgan County",3,37,206,109,97
050,29,141,"Missouri","Morgan County",3,38,206,103,103
050,29,141,"Missouri","Morgan County",3,39,202,99,103
050,29,141,"Missouri","Morgan County",3,40,215,105,110
050,29,141,"Missouri","Morgan County",3,41,215,119,96
050,29,141,"Missouri","Morgan County",3,42,220,124,96
050,29,141,"Missouri","Morgan County",3,43,200,100,100
050,29,141,"Missouri","Morgan County",3,44,195,102,93
050,29,141,"Missouri","Morgan County",3,45,180,100,80
050,29,141,"Missouri","Morgan County",3,46,207,111,96
050,29,141,"Missouri","Morgan County",3,47,203,100,103
050,29,141,"Missouri","Morgan County",3,48,204,100,104
050,29,141,"Missouri","Morgan County",3,49,226,111,115
050,29,141,"Missouri","Morgan County",3,50,238,123,115
050,29,141,"Missouri","Morgan County",3,51,237,118,119
050,29,141,"Missouri","Morgan County",3,52,258,131,127
050,29,141,"Missouri","Morgan County",3,53,245,130,115
050,29,141,"Missouri","Morgan County",3,54,266,136,130
050,29,141,"Missouri","Morgan County",3,55,288,144,144
050,29,141,"Missouri","Morgan County",3,56,312,145,167
050,29,141,"Missouri","Morgan County",3,57,348,175,173
050,29,141,"Missouri","Morgan County",3,58,338,167,171
050,29,141,"Missouri","Morgan County",3,59,348,178,170
050,29,141,"Missouri","Morgan County",3,60,362,193,169
050,29,141,"Missouri","Morgan County",3,61,353,177,176
050,29,141,"Missouri","Morgan County",3,62,366,184,182
050,29,141,"Missouri","Morgan County",3,63,371,179,192
050,29,141,"Missouri","Morgan County",3,64,353,179,174
050,29,141,"Missouri","Morgan County",3,65,358,186,172
050,29,141,"Missouri","Morgan County",3,66,321,163,158
050,29,141,"Missouri","Morgan County",3,67,316,169,147
050,29,141,"Missouri","Morgan County",3,68,312,153,159
050,29,141,"Missouri","Morgan County",3,69,324,172,152
050,29,141,"Missouri","Morgan County",3,70,293,147,146
050,29,141,"Missouri","Morgan County",3,71,272,141,131
050,29,141,"Missouri","Morgan County",3,72,257,141,116
050,29,141,"Missouri","Morgan County",3,73,254,139,115
050,29,141,"Missouri","Morgan County",3,74,282,136,146
050,29,141,"Missouri","Morgan County",3,75,205,95,110
050,29,141,"Missouri","Morgan County",3,76,192,97,95
050,29,141,"Missouri","Morgan County",3,77,192,95,97
050,29,141,"Missouri","Morgan County",3,78,197,90,107
050,29,141,"Missouri","Morgan County",3,79,170,83,87
050,29,141,"Missouri","Morgan County",3,80,136,66,70
050,29,141,"Missouri","Morgan County",3,81,134,67,67
050,29,141,"Missouri","Morgan County",3,82,133,64,69
050,29,141,"Missouri","Morgan County",3,83,101,52,49
050,29,141,"Missouri","Morgan County",3,84,101,47,54
050,29,141,"Missouri","Morgan County",3,85,505,201,304
050,29,141,"Missouri","Morgan County",4,0,258,135,123
050,29,141,"Missouri","Morgan County",4,1,286,150,136
050,29,141,"Missouri","Morgan County",4,2,264,134,130
050,29,141,"Missouri","Morgan County",4,3,266,152,114
050,29,141,"Missouri","Morgan County",4,4,274,141,133
050,29,141,"Missouri","Morgan County",4,5,303,150,153
050,29,141,"Missouri","Morgan County",4,6,298,146,152
050,29,141,"Missouri","Morgan County",4,7,276,139,137
050,29,141,"Missouri","Morgan County",4,8,251,130,121
050,29,141,"Missouri","Morgan County",4,9,267,137,130
050,29,141,"Missouri","Morgan County",4,10,256,138,118
050,29,141,"Missouri","Morgan County",4,11,264,134,130
050,29,141,"Missouri","Morgan County",4,12,272,131,141
050,29,141,"Missouri","Morgan County",4,13,282,134,148
050,29,141,"Missouri","Morgan County",4,14,309,149,160
050,29,141,"Missouri","Morgan County",4,15,313,159,154
050,29,141,"Missouri","Morgan County",4,16,306,156,150
050,29,141,"Missouri","Morgan County",4,17,273,153,120
050,29,141,"Missouri","Morgan County",4,18,228,127,101
050,29,141,"Missouri","Morgan County",4,19,177,87,90
050,29,141,"Missouri","Morgan County",4,20,178,93,85
050,29,141,"Missouri","Morgan County",4,21,204,111,93
050,29,141,"Missouri","Morgan County",4,22,227,129,98
050,29,141,"Missouri","Morgan County",4,23,225,119,106
050,29,141,"Missouri","Morgan County",4,24,218,96,122
050,29,141,"Missouri","Morgan County",4,25,232,126,106
050,29,141,"Missouri","Morgan County",4,26,205,104,101
050,29,141,"Missouri","Morgan County",4,27,202,97,105
050,29,141,"Missouri","Morgan County",4,28,217,104,113
050,29,141,"Missouri","Morgan County",4,29,222,107,115
050,29,141,"Missouri","Morgan County",4,30,242,128,114
050,29,141,"Missouri","Morgan County",4,31,252,124,128
050,29,141,"Missouri","Morgan County",4,32,223,114,109
050,29,141,"Missouri","Morgan County",4,33,243,127,116
050,29,141,"Missouri","Morgan County",4,34,239,119,120
050,29,141,"Missouri","Morgan County",4,35,228,122,106
050,29,141,"Missouri","Morgan County",4,36,224,120,104
050,29,141,"Missouri","Morgan County",4,37,226,109,117
050,29,141,"Missouri","Morgan County",4,38,211,106,105
050,29,141,"Missouri","Morgan County",4,39,217,105,112
050,29,141,"Missouri","Morgan County",4,40,209,103,106
050,29,141,"Missouri","Morgan County",4,41,225,116,109
050,29,141,"Missouri","Morgan County",4,42,224,123,101
050,29,141,"Missouri","Morgan County",4,43,225,127,98
050,29,141,"Missouri","Morgan County",4,44,214,117,97
050,29,141,"Missouri","Morgan County",4,45,194,98,96
050,29,141,"Missouri","Morgan County",4,46,193,106,87
050,29,141,"Missouri","Morgan County",4,47,210,116,94
050,29,141,"Missouri","Morgan County",4,48,202,101,101
050,29,141,"Missouri","Morgan County",4,49,208,103,105
050,29,141,"Missouri","Morgan County",4,50,246,123,123
050,29,141,"Missouri","Morgan County",4,51,247,129,118
050,29,141,"Missouri","Morgan County",4,52,244,114,130
050,29,141,"Missouri","Morgan County",4,53,271,134,137
050,29,141,"Missouri","Morgan County",4,54,262,136,126
050,29,141,"Missouri","Morgan County",4,55,276,141,135
050,29,141,"Missouri","Morgan County",4,56,288,143,145
050,29,141,"Missouri","Morgan County",4,57,323,153,170
050,29,141,"Missouri","Morgan County",4,58,356,180,176
050,29,141,"Missouri","Morgan County",4,59,351,171,180
050,29,141,"Missouri","Morgan County",4,60,355,183,172
050,29,141,"Missouri","Morgan County",4,61,374,190,184
050,29,141,"Missouri","Morgan County",4,62,360,182,178
050,29,141,"Missouri","Morgan County",4,63,362,186,176
050,29,141,"Missouri","Morgan County",4,64,374,170,204
050,29,141,"Missouri","Morgan County",4,65,355,181,174
050,29,141,"Missouri","Morgan County",4,66,353,177,176
050,29,141,"Missouri","Morgan County",4,67,317,169,148
050,29,141,"Missouri","Morgan County",4,68,314,163,151
050,29,141,"Missouri","Morgan County",4,69,312,150,162
050,29,141,"Missouri","Morgan County",4,70,317,170,147
050,29,141,"Missouri","Morgan County",4,71,283,141,142
050,29,141,"Missouri","Morgan County",4,72,271,144,127
050,29,141,"Missouri","Morgan County",4,73,252,139,113
050,29,141,"Missouri","Morgan County",4,74,234,126,108
050,29,141,"Missouri","Morgan County",4,75,270,130,140
050,29,141,"Missouri","Morgan County",4,76,195,88,107
050,29,141,"Missouri","Morgan County",4,77,185,91,94
050,29,141,"Missouri","Morgan County",4,78,162,72,90
050,29,141,"Missouri","Morgan County",4,79,189,90,99
050,29,141,"Missouri","Morgan County",4,80,153,73,80
050,29,141,"Missouri","Morgan County",4,81,121,57,64
050,29,141,"Missouri","Morgan County",4,82,126,60,66
050,29,141,"Missouri","Morgan County",4,83,114,60,54
050,29,141,"Missouri","Morgan County",4,84,105,52,53
050,29,141,"Missouri","Morgan County",4,85,507,212,295
050,29,141,"Missouri","Morgan County",5,0,259,135,124
050,29,141,"Missouri","Morgan County",5,1,254,134,120
050,29,141,"Missouri","Morgan County",5,2,270,144,126
050,29,141,"Missouri","Morgan County",5,3,280,147,133
050,29,141,"Missouri","Morgan County",5,4,268,156,112
050,29,141,"Missouri","Morgan County",5,5,287,157,130
050,29,141,"Missouri","Morgan County",5,6,308,150,158
050,29,141,"Missouri","Morgan County",5,7,295,144,151
050,29,141,"Missouri","Morgan County",5,8,271,133,138
050,29,141,"Missouri","Morgan County",5,9,267,134,133
050,29,141,"Missouri","Morgan County",5,10,267,131,136
050,29,141,"Missouri","Morgan County",5,11,265,147,118
050,29,141,"Missouri","Morgan County",5,12,276,140,136
050,29,141,"Missouri","Morgan County",5,13,273,137,136
050,29,141,"Missouri","Morgan County",5,14,287,139,148
050,29,141,"Missouri","Morgan County",5,15,308,145,163
050,29,141,"Missouri","Morgan County",5,16,323,164,159
050,29,141,"Missouri","Morgan County",5,17,298,152,146
050,29,141,"Missouri","Morgan County",5,18,225,134,91
050,29,141,"Missouri","Morgan County",5,19,183,98,85
050,29,141,"Missouri","Morgan County",5,20,195,94,101
050,29,141,"Missouri","Morgan County",5,21,190,102,88
050,29,141,"Missouri","Morgan County",5,22,211,110,101
050,29,141,"Missouri","Morgan County",5,23,237,132,105
050,29,141,"Missouri","Morgan County",5,24,220,113,107
050,29,141,"Missouri","Morgan County",5,25,224,103,121
050,29,141,"Missouri","Morgan County",5,26,221,115,106
050,29,141,"Missouri","Morgan County",5,27,208,107,101
050,29,141,"Missouri","Morgan County",5,28,200,109,91
050,29,141,"Missouri","Morgan County",5,29,230,105,125
050,29,141,"Missouri","Morgan County",5,30,230,114,116
050,29,141,"Missouri","Morgan County",5,31,242,129,113
050,29,141,"Missouri","Morgan County",5,32,248,119,129
050,29,141,"Missouri","Morgan County",5,33,223,108,115
050,29,141,"Missouri","Morgan County",5,34,241,132,109
050,29,141,"Missouri","Morgan County",5,35,241,114,127
050,29,141,"Missouri","Morgan County",5,36,233,125,108
050,29,141,"Missouri","Morgan County",5,37,231,121,110
050,29,141,"Missouri","Morgan County",5,38,231,111,120
050,29,141,"Missouri","Morgan County",5,39,215,110,105
050,29,141,"Missouri","Morgan County",5,40,229,112,117
050,29,141,"Missouri","Morgan County",5,41,218,107,111
050,29,141,"Missouri","Morgan County",5,42,226,115,111
050,29,141,"Missouri","Morgan County",5,43,234,124,110
050,29,141,"Missouri","Morgan County",5,44,222,122,100
050,29,141,"Missouri","Morgan County",5,45,214,118,96
050,29,141,"Missouri","Morgan County",5,46,195,98,97
050,29,141,"Missouri","Morgan County",5,47,200,106,94
050,29,141,"Missouri","Morgan County",5,48,208,118,90
050,29,141,"Missouri","Morgan County",5,49,207,98,109
050,29,141,"Missouri","Morgan County",5,50,222,108,114
050,29,141,"Missouri","Morgan County",5,51,244,125,119
050,29,141,"Missouri","Morgan County",5,52,250,135,115
050,29,141,"Missouri","Morgan County",5,53,247,111,136
050,29,141,"Missouri","Morgan County",5,54,284,139,145
050,29,141,"Missouri","Morgan County",5,55,258,134,124
050,29,141,"Missouri","Morgan County",5,56,284,145,139
050,29,141,"Missouri","Morgan County",5,57,295,139,156
050,29,141,"Missouri","Morgan County",5,58,346,162,184
050,29,141,"Missouri","Morgan County",5,59,356,181,175
050,29,141,"Missouri","Morgan County",5,60,357,177,180
050,29,141,"Missouri","Morgan County",5,61,367,185,182
050,29,141,"Missouri","Morgan County",5,62,382,200,182
050,29,141,"Missouri","Morgan County",5,63,367,179,188
050,29,141,"Missouri","Morgan County",5,64,375,186,189
050,29,141,"Missouri","Morgan County",5,65,384,179,205
050,29,141,"Missouri","Morgan County",5,66,351,171,180
050,29,141,"Missouri","Morgan County",5,67,350,179,171
050,29,141,"Missouri","Morgan County",5,68,319,170,149
050,29,141,"Missouri","Morgan County",5,69,305,152,153
050,29,141,"Missouri","Morgan County",5,70,298,143,155
050,29,141,"Missouri","Morgan County",5,71,311,164,147
050,29,141,"Missouri","Morgan County",5,72,281,141,140
050,29,141,"Missouri","Morgan County",5,73,255,135,120
050,29,141,"Missouri","Morgan County",5,74,236,129,107
050,29,141,"Missouri","Morgan County",5,75,223,118,105
050,29,141,"Missouri","Morgan County",5,76,255,120,135
050,29,141,"Missouri","Morgan County",5,77,186,81,105
050,29,141,"Missouri","Morgan County",5,78,165,78,87
050,29,141,"Missouri","Morgan County",5,79,155,74,81
050,29,141,"Missouri","Morgan County",5,80,175,77,98
050,29,141,"Missouri","Morgan County",5,81,137,62,75
050,29,141,"Missouri","Morgan County",5,82,114,53,61
050,29,141,"Missouri","Morgan County",5,83,103,53,50
050,29,141,"Missouri","Morgan County",5,84,110,58,52
050,29,141,"Missouri","Morgan County",5,85,535,234,301
050,29,143,"Missouri","New Madrid County",1,0,208,106,102
050,29,143,"Missouri","New Madrid County",1,1,201,101,100
050,29,143,"Missouri","New Madrid County",1,2,219,101,118
050,29,143,"Missouri","New Madrid County",1,3,201,98,103
050,29,143,"Missouri","New Madrid County",1,4,195,103,92
050,29,143,"Missouri","New Madrid County",1,5,220,112,108
050,29,143,"Missouri","New Madrid County",1,6,206,93,113
050,29,143,"Missouri","New Madrid County",1,7,198,104,94
050,29,143,"Missouri","New Madrid County",1,8,206,112,94
050,29,143,"Missouri","New Madrid County",1,9,212,117,95
050,29,143,"Missouri","New Madrid County",1,10,222,111,111
050,29,143,"Missouri","New Madrid County",1,11,222,112,110
050,29,143,"Missouri","New Madrid County",1,12,249,124,125
050,29,143,"Missouri","New Madrid County",1,13,246,130,116
050,29,143,"Missouri","New Madrid County",1,14,235,127,108
050,29,143,"Missouri","New Madrid County",1,15,223,118,105
050,29,143,"Missouri","New Madrid County",1,16,213,111,102
050,29,143,"Missouri","New Madrid County",1,17,207,99,108
050,29,143,"Missouri","New Madrid County",1,18,175,88,87
050,29,143,"Missouri","New Madrid County",1,19,155,77,78
050,29,143,"Missouri","New Madrid County",1,20,140,63,77
050,29,143,"Missouri","New Madrid County",1,21,160,82,78
050,29,143,"Missouri","New Madrid County",1,22,181,94,87
050,29,143,"Missouri","New Madrid County",1,23,185,92,93
050,29,143,"Missouri","New Madrid County",1,24,150,74,76
050,29,143,"Missouri","New Madrid County",1,25,170,85,85
050,29,143,"Missouri","New Madrid County",1,26,175,99,76
050,29,143,"Missouri","New Madrid County",1,27,194,90,104
050,29,143,"Missouri","New Madrid County",1,28,219,105,114
050,29,143,"Missouri","New Madrid County",1,29,193,103,90
050,29,143,"Missouri","New Madrid County",1,30,201,107,94
050,29,143,"Missouri","New Madrid County",1,31,177,81,96
050,29,143,"Missouri","New Madrid County",1,32,172,75,97
050,29,143,"Missouri","New Madrid County",1,33,175,68,107
050,29,143,"Missouri","New Madrid County",1,34,182,83,99
050,29,143,"Missouri","New Madrid County",1,35,184,93,91
050,29,143,"Missouri","New Madrid County",1,36,175,79,96
050,29,143,"Missouri","New Madrid County",1,37,176,80,96
050,29,143,"Missouri","New Madrid County",1,38,182,86,96
050,29,143,"Missouri","New Madrid County",1,39,175,84,91
050,29,143,"Missouri","New Madrid County",1,40,192,92,100
050,29,143,"Missouri","New Madrid County",1,41,183,87,96
050,29,143,"Missouri","New Madrid County",1,42,178,83,95
050,29,143,"Missouri","New Madrid County",1,43,202,98,104
050,29,143,"Missouri","New Madrid County",1,44,196,88,108
050,29,143,"Missouri","New Madrid County",1,45,197,90,107
050,29,143,"Missouri","New Madrid County",1,46,189,101,88
050,29,143,"Missouri","New Madrid County",1,47,215,112,103
050,29,143,"Missouri","New Madrid County",1,48,240,116,124
050,29,143,"Missouri","New Madrid County",1,49,205,106,99
050,29,143,"Missouri","New Madrid County",1,50,192,96,96
050,29,143,"Missouri","New Madrid County",1,51,211,97,114
050,29,143,"Missouri","New Madrid County",1,52,210,107,103
050,29,143,"Missouri","New Madrid County",1,53,222,107,115
050,29,143,"Missouri","New Madrid County",1,54,204,90,114
050,29,143,"Missouri","New Madrid County",1,55,228,104,124
050,29,143,"Missouri","New Madrid County",1,56,228,109,119
050,29,143,"Missouri","New Madrid County",1,57,259,120,139
050,29,143,"Missouri","New Madrid County",1,58,262,129,133
050,29,143,"Missouri","New Madrid County",1,59,268,126,142
050,29,143,"Missouri","New Madrid County",1,60,249,117,132
050,29,143,"Missouri","New Madrid County",1,61,239,116,123
050,29,143,"Missouri","New Madrid County",1,62,231,104,127
050,29,143,"Missouri","New Madrid County",1,63,232,106,126
050,29,143,"Missouri","New Madrid County",1,64,246,119,127
050,29,143,"Missouri","New Madrid County",1,65,216,98,118
050,29,143,"Missouri","New Madrid County",1,66,215,95,120
050,29,143,"Missouri","New Madrid County",1,67,202,102,100
050,29,143,"Missouri","New Madrid County",1,68,176,85,91
050,29,143,"Missouri","New Madrid County",1,69,181,78,103
050,29,143,"Missouri","New Madrid County",1,70,184,78,106
050,29,143,"Missouri","New Madrid County",1,71,198,93,105
050,29,143,"Missouri","New Madrid County",1,72,187,94,93
050,29,143,"Missouri","New Madrid County",1,73,178,83,95
050,29,143,"Missouri","New Madrid County",1,74,119,50,69
050,29,143,"Missouri","New Madrid County",1,75,127,56,71
050,29,143,"Missouri","New Madrid County",1,76,136,61,75
050,29,143,"Missouri","New Madrid County",1,77,137,64,73
050,29,143,"Missouri","New Madrid County",1,78,104,43,61
050,29,143,"Missouri","New Madrid County",1,79,89,32,57
050,29,143,"Missouri","New Madrid County",1,80,75,26,49
050,29,143,"Missouri","New Madrid County",1,81,83,36,47
050,29,143,"Missouri","New Madrid County",1,82,85,36,49
050,29,143,"Missouri","New Madrid County",1,83,80,26,54
050,29,143,"Missouri","New Madrid County",1,84,61,26,35
050,29,143,"Missouri","New Madrid County",1,85,338,116,222
050,29,143,"Missouri","New Madrid County",2,0,197,98,99
050,29,143,"Missouri","New Madrid County",2,1,202,99,103
050,29,143,"Missouri","New Madrid County",2,2,213,98,115
050,29,143,"Missouri","New Madrid County",2,3,202,96,106
050,29,143,"Missouri","New Madrid County",2,4,196,101,95
050,29,143,"Missouri","New Madrid County",2,5,210,107,103
050,29,143,"Missouri","New Madrid County",2,6,207,96,111
050,29,143,"Missouri","New Madrid County",2,7,202,103,99
050,29,143,"Missouri","New Madrid County",2,8,204,111,93
050,29,143,"Missouri","New Madrid County",2,9,212,117,95
050,29,143,"Missouri","New Madrid County",2,10,220,112,108
050,29,143,"Missouri","New Madrid County",2,11,216,110,106
050,29,143,"Missouri","New Madrid County",2,12,240,121,119
050,29,143,"Missouri","New Madrid County",2,13,242,127,115
050,29,143,"Missouri","New Madrid County",2,14,235,127,108
050,29,143,"Missouri","New Madrid County",2,15,223,120,103
050,29,143,"Missouri","New Madrid County",2,16,214,111,103
050,29,143,"Missouri","New Madrid County",2,17,205,100,105
050,29,143,"Missouri","New Madrid County",2,18,173,85,88
050,29,143,"Missouri","New Madrid County",2,19,150,74,76
050,29,143,"Missouri","New Madrid County",2,20,144,65,79
050,29,143,"Missouri","New Madrid County",2,21,158,79,79
050,29,143,"Missouri","New Madrid County",2,22,178,91,87
050,29,143,"Missouri","New Madrid County",2,23,183,91,92
050,29,143,"Missouri","New Madrid County",2,24,159,79,80
050,29,143,"Missouri","New Madrid County",2,25,167,86,81
050,29,143,"Missouri","New Madrid County",2,26,176,96,80
050,29,143,"Missouri","New Madrid County",2,27,187,91,96
050,29,143,"Missouri","New Madrid County",2,28,213,101,112
050,29,143,"Missouri","New Madrid County",2,29,200,103,97
050,29,143,"Missouri","New Madrid County",2,30,196,103,93
050,29,143,"Missouri","New Madrid County",2,31,180,86,94
050,29,143,"Missouri","New Madrid County",2,32,174,76,98
050,29,143,"Missouri","New Madrid County",2,33,173,68,105
050,29,143,"Missouri","New Madrid County",2,34,179,78,101
050,29,143,"Missouri","New Madrid County",2,35,183,89,94
050,29,143,"Missouri","New Madrid County",2,36,173,81,92
050,29,143,"Missouri","New Madrid County",2,37,174,79,95
050,29,143,"Missouri","New Madrid County",2,38,179,85,94
050,29,143,"Missouri","New Madrid County",2,39,176,85,91
050,29,143,"Missouri","New Madrid County",2,40,187,89,98
050,29,143,"Missouri","New Madrid County",2,41,184,87,97
050,29,143,"Missouri","New Madrid County",2,42,176,83,93
050,29,143,"Missouri","New Madrid County",2,43,198,95,103
050,29,143,"Missouri","New Madrid County",2,44,192,87,105
050,29,143,"Missouri","New Madrid County",2,45,198,90,108
050,29,143,"Missouri","New Madrid County",2,46,190,97,93
050,29,143,"Missouri","New Madrid County",2,47,210,110,100
050,29,143,"Missouri","New Madrid County",2,48,233,114,119
050,29,143,"Missouri","New Madrid County",2,49,213,108,105
050,29,143,"Missouri","New Madrid County",2,50,194,97,97
050,29,143,"Missouri","New Madrid County",2,51,204,95,109
050,29,143,"Missouri","New Madrid County",2,52,210,105,105
050,29,143,"Missouri","New Madrid County",2,53,219,107,112
050,29,143,"Missouri","New Madrid County",2,54,206,93,113
050,29,143,"Missouri","New Madrid County",2,55,223,102,121
050,29,143,"Missouri","New Madrid County",2,56,229,108,121
050,29,143,"Missouri","New Madrid County",2,57,251,117,134
050,29,143,"Missouri","New Madrid County",2,58,262,127,135
050,29,143,"Missouri","New Madrid County",2,59,265,125,140
050,29,143,"Missouri","New Madrid County",2,60,253,117,136
050,29,143,"Missouri","New Madrid County",2,61,238,114,124
050,29,143,"Missouri","New Madrid County",2,62,233,108,125
050,29,143,"Missouri","New Madrid County",2,63,228,103,125
050,29,143,"Missouri","New Madrid County",2,64,236,113,123
050,29,143,"Missouri","New Madrid County",2,65,222,102,120
050,29,143,"Missouri","New Madrid County",2,66,211,93,118
050,29,143,"Missouri","New Madrid County",2,67,201,99,102
050,29,143,"Missouri","New Madrid County",2,68,181,89,92
050,29,143,"Missouri","New Madrid County",2,69,182,81,101
050,29,143,"Missouri","New Madrid County",2,70,182,77,105
050,29,143,"Missouri","New Madrid County",2,71,194,89,105
050,29,143,"Missouri","New Madrid County",2,72,183,91,92
050,29,143,"Missouri","New Madrid County",2,73,189,88,101
050,29,143,"Missouri","New Madrid County",2,74,126,55,71
050,29,143,"Missouri","New Madrid County",2,75,125,54,71
050,29,143,"Missouri","New Madrid County",2,76,132,60,72
050,29,143,"Missouri","New Madrid County",2,77,139,63,76
050,29,143,"Missouri","New Madrid County",2,78,108,44,64
050,29,143,"Missouri","New Madrid County",2,79,94,35,59
050,29,143,"Missouri","New Madrid County",2,80,78,27,51
050,29,143,"Missouri","New Madrid County",2,81,79,33,46
050,29,143,"Missouri","New Madrid County",2,82,83,37,46
050,29,143,"Missouri","New Madrid County",2,83,79,27,52
050,29,143,"Missouri","New Madrid County",2,84,62,24,38
050,29,143,"Missouri","New Madrid County",2,85,328,113,215
050,29,143,"Missouri","New Madrid County",3,0,212,101,111
050,29,143,"Missouri","New Madrid County",3,1,186,92,94
050,29,143,"Missouri","New Madrid County",3,2,190,89,101
050,29,143,"Missouri","New Madrid County",3,3,208,107,101
050,29,143,"Missouri","New Madrid County",3,4,206,102,104
050,29,143,"Missouri","New Madrid County",3,5,190,103,87
050,29,143,"Missouri","New Madrid County",3,6,207,101,106
050,29,143,"Missouri","New Madrid County",3,7,219,101,118
050,29,143,"Missouri","New Madrid County",3,8,206,109,97
050,29,143,"Missouri","New Madrid County",3,9,194,104,90
050,29,143,"Missouri","New Madrid County",3,10,219,122,97
050,29,143,"Missouri","New Madrid County",3,11,223,110,113
050,29,143,"Missouri","New Madrid County",3,12,217,112,105
050,29,143,"Missouri","New Madrid County",3,13,242,119,123
050,29,143,"Missouri","New Madrid County",3,14,238,121,117
050,29,143,"Missouri","New Madrid County",3,15,233,121,112
050,29,143,"Missouri","New Madrid County",3,16,230,124,106
050,29,143,"Missouri","New Madrid County",3,17,209,105,104
050,29,143,"Missouri","New Madrid County",3,18,165,84,81
050,29,143,"Missouri","New Madrid County",3,19,132,64,68
050,29,143,"Missouri","New Madrid County",3,20,164,82,82
050,29,143,"Missouri","New Madrid County",3,21,139,62,77
050,29,143,"Missouri","New Madrid County",3,22,176,81,95
050,29,143,"Missouri","New Madrid County",3,23,183,87,96
050,29,143,"Missouri","New Madrid County",3,24,170,83,87
050,29,143,"Missouri","New Madrid County",3,25,168,87,81
050,29,143,"Missouri","New Madrid County",3,26,157,72,85
050,29,143,"Missouri","New Madrid County",3,27,160,92,68
050,29,143,"Missouri","New Madrid County",3,28,174,85,89
050,29,143,"Missouri","New Madrid County",3,29,212,94,118
050,29,143,"Missouri","New Madrid County",3,30,203,110,93
050,29,143,"Missouri","New Madrid County",3,31,192,101,91
050,29,143,"Missouri","New Madrid County",3,32,188,88,100
050,29,143,"Missouri","New Madrid County",3,33,174,78,96
050,29,143,"Missouri","New Madrid County",3,34,169,72,97
050,29,143,"Missouri","New Madrid County",3,35,179,81,98
050,29,143,"Missouri","New Madrid County",3,36,179,88,91
050,29,143,"Missouri","New Madrid County",3,37,170,77,93
050,29,143,"Missouri","New Madrid County",3,38,165,69,96
050,29,143,"Missouri","New Madrid County",3,39,175,85,90
050,29,143,"Missouri","New Madrid County",3,40,179,85,94
050,29,143,"Missouri","New Madrid County",3,41,189,93,96
050,29,143,"Missouri","New Madrid County",3,42,175,84,91
050,29,143,"Missouri","New Madrid County",3,43,168,77,91
050,29,143,"Missouri","New Madrid County",3,44,195,94,101
050,29,143,"Missouri","New Madrid County",3,45,192,86,106
050,29,143,"Missouri","New Madrid County",3,46,206,93,113
050,29,143,"Missouri","New Madrid County",3,47,194,99,95
050,29,143,"Missouri","New Madrid County",3,48,201,105,96
050,29,143,"Missouri","New Madrid County",3,49,224,107,117
050,29,143,"Missouri","New Madrid County",3,50,210,109,101
050,29,143,"Missouri","New Madrid County",3,51,190,93,97
050,29,143,"Missouri","New Madrid County",3,52,202,94,108
050,29,143,"Missouri","New Madrid County",3,53,194,96,98
050,29,143,"Missouri","New Madrid County",3,54,209,99,110
050,29,143,"Missouri","New Madrid County",3,55,205,93,112
050,29,143,"Missouri","New Madrid County",3,56,218,101,117
050,29,143,"Missouri","New Madrid County",3,57,221,103,118
050,29,143,"Missouri","New Madrid County",3,58,244,112,132
050,29,143,"Missouri","New Madrid County",3,59,264,124,140
050,29,143,"Missouri","New Madrid County",3,60,259,123,136
050,29,143,"Missouri","New Madrid County",3,61,241,109,132
050,29,143,"Missouri","New Madrid County",3,62,234,117,117
050,29,143,"Missouri","New Madrid County",3,63,217,101,116
050,29,143,"Missouri","New Madrid County",3,64,219,99,120
050,29,143,"Missouri","New Madrid County",3,65,220,100,120
050,29,143,"Missouri","New Madrid County",3,66,217,101,116
050,29,143,"Missouri","New Madrid County",3,67,200,89,111
050,29,143,"Missouri","New Madrid County",3,68,193,92,101
050,29,143,"Missouri","New Madrid County",3,69,173,84,89
050,29,143,"Missouri","New Madrid County",3,70,180,77,103
050,29,143,"Missouri","New Madrid County",3,71,177,73,104
050,29,143,"Missouri","New Madrid County",3,72,181,84,97
050,29,143,"Missouri","New Madrid County",3,73,177,86,91
050,29,143,"Missouri","New Madrid County",3,74,174,82,92
050,29,143,"Missouri","New Madrid County",3,75,116,51,65
050,29,143,"Missouri","New Madrid County",3,76,120,55,65
050,29,143,"Missouri","New Madrid County",3,77,117,52,65
050,29,143,"Missouri","New Madrid County",3,78,129,56,73
050,29,143,"Missouri","New Madrid County",3,79,105,46,59
050,29,143,"Missouri","New Madrid County",3,80,86,33,53
050,29,143,"Missouri","New Madrid County",3,81,66,22,44
050,29,143,"Missouri","New Madrid County",3,82,70,26,44
050,29,143,"Missouri","New Madrid County",3,83,82,31,51
050,29,143,"Missouri","New Madrid County",3,84,70,28,42
050,29,143,"Missouri","New Madrid County",3,85,309,104,205
050,29,143,"Missouri","New Madrid County",4,0,185,74,111
050,29,143,"Missouri","New Madrid County",4,1,210,94,116
050,29,143,"Missouri","New Madrid County",4,2,178,85,93
050,29,143,"Missouri","New Madrid County",4,3,188,90,98
050,29,143,"Missouri","New Madrid County",4,4,200,109,91
050,29,143,"Missouri","New Madrid County",4,5,195,89,106
050,29,143,"Missouri","New Madrid County",4,6,196,108,88
050,29,143,"Missouri","New Madrid County",4,7,206,103,103
050,29,143,"Missouri","New Madrid County",4,8,217,99,118
050,29,143,"Missouri","New Madrid County",4,9,215,110,105
050,29,143,"Missouri","New Madrid County",4,10,191,109,82
050,29,143,"Missouri","New Madrid County",4,11,215,119,96
050,29,143,"Missouri","New Madrid County",4,12,219,103,116
050,29,143,"Missouri","New Madrid County",4,13,209,105,104
050,29,143,"Missouri","New Madrid County",4,14,245,122,123
050,29,143,"Missouri","New Madrid County",4,15,238,121,117
050,29,143,"Missouri","New Madrid County",4,16,233,121,112
050,29,143,"Missouri","New Madrid County",4,17,225,120,105
050,29,143,"Missouri","New Madrid County",4,18,171,87,84
050,29,143,"Missouri","New Madrid County",4,19,132,66,66
050,29,143,"Missouri","New Madrid County",4,20,137,66,71
050,29,143,"Missouri","New Madrid County",4,21,162,79,83
050,29,143,"Missouri","New Madrid County",4,22,153,66,87
050,29,143,"Missouri","New Madrid County",4,23,180,88,92
050,29,143,"Missouri","New Madrid County",4,24,178,86,92
050,29,143,"Missouri","New Madrid County",4,25,164,80,84
050,29,143,"Missouri","New Madrid County",4,26,166,83,83
050,29,143,"Missouri","New Madrid County",4,27,154,69,85
050,29,143,"Missouri","New Madrid County",4,28,159,87,72
050,29,143,"Missouri","New Madrid County",4,29,167,82,85
050,29,143,"Missouri","New Madrid County",4,30,209,98,111
050,29,143,"Missouri","New Madrid County",4,31,192,96,96
050,29,143,"Missouri","New Madrid County",4,32,186,94,92
050,29,143,"Missouri","New Madrid County",4,33,186,90,96
050,29,143,"Missouri","New Madrid County",4,34,178,79,99
050,29,143,"Missouri","New Madrid County",4,35,170,76,94
050,29,143,"Missouri","New Madrid County",4,36,168,73,95
050,29,143,"Missouri","New Madrid County",4,37,183,88,95
050,29,143,"Missouri","New Madrid County",4,38,166,70,96
050,29,143,"Missouri","New Madrid County",4,39,158,70,88
050,29,143,"Missouri","New Madrid County",4,40,170,83,87
050,29,143,"Missouri","New Madrid County",4,41,177,84,93
050,29,143,"Missouri","New Madrid County",4,42,183,92,91
050,29,143,"Missouri","New Madrid County",4,43,178,86,92
050,29,143,"Missouri","New Madrid County",4,44,164,74,90
050,29,143,"Missouri","New Madrid County",4,45,195,94,101
050,29,143,"Missouri","New Madrid County",4,46,192,85,107
050,29,143,"Missouri","New Madrid County",4,47,202,90,112
050,29,143,"Missouri","New Madrid County",4,48,196,95,101
050,29,143,"Missouri","New Madrid County",4,49,195,103,92
050,29,143,"Missouri","New Madrid County",4,50,215,103,112
050,29,143,"Missouri","New Madrid County",4,51,212,108,104
050,29,143,"Missouri","New Madrid County",4,52,193,94,99
050,29,143,"Missouri","New Madrid County",4,53,193,92,101
050,29,143,"Missouri","New Madrid County",4,54,190,90,100
050,29,143,"Missouri","New Madrid County",4,55,201,96,105
050,29,143,"Missouri","New Madrid County",4,56,202,91,111
050,29,143,"Missouri","New Madrid County",4,57,211,100,111
050,29,143,"Missouri","New Madrid County",4,58,213,100,113
050,29,143,"Missouri","New Madrid County",4,59,230,108,122
050,29,143,"Missouri","New Madrid County",4,60,251,120,131
050,29,143,"Missouri","New Madrid County",4,61,253,115,138
050,29,143,"Missouri","New Madrid County",4,62,234,107,127
050,29,143,"Missouri","New Madrid County",4,63,220,112,108
050,29,143,"Missouri","New Madrid County",4,64,208,95,113
050,29,143,"Missouri","New Madrid County",4,65,209,88,121
050,29,143,"Missouri","New Madrid County",4,66,216,100,116
050,29,143,"Missouri","New Madrid County",4,67,194,90,104
050,29,143,"Missouri","New Madrid County",4,68,199,89,110
050,29,143,"Missouri","New Madrid County",4,69,183,91,92
050,29,143,"Missouri","New Madrid County",4,70,176,84,92
050,29,143,"Missouri","New Madrid County",4,71,174,76,98
050,29,143,"Missouri","New Madrid County",4,72,169,69,100
050,29,143,"Missouri","New Madrid County",4,73,175,80,95
050,29,143,"Missouri","New Madrid County",4,74,159,72,87
050,29,143,"Missouri","New Madrid County",4,75,160,74,86
050,29,143,"Missouri","New Madrid County",4,76,112,49,63
050,29,143,"Missouri","New Madrid County",4,77,115,52,63
050,29,143,"Missouri","New Madrid County",4,78,109,47,62
050,29,143,"Missouri","New Madrid County",4,79,125,55,70
050,29,143,"Missouri","New Madrid County",4,80,97,40,57
050,29,143,"Missouri","New Madrid County",4,81,80,33,47
050,29,143,"Missouri","New Madrid County",4,82,58,16,42
050,29,143,"Missouri","New Madrid County",4,83,64,19,45
050,29,143,"Missouri","New Madrid County",4,84,72,30,42
050,29,143,"Missouri","New Madrid County",4,85,302,102,200
050,29,143,"Missouri","New Madrid County",5,0,181,72,109
050,29,143,"Missouri","New Madrid County",5,1,184,71,113
050,29,143,"Missouri","New Madrid County",5,2,203,93,110
050,29,143,"Missouri","New Madrid County",5,3,178,88,90
050,29,143,"Missouri","New Madrid County",5,4,198,97,101
050,29,143,"Missouri","New Madrid County",5,5,189,101,88
050,29,143,"Missouri","New Madrid County",5,6,206,97,109
050,29,143,"Missouri","New Madrid County",5,7,181,105,76
050,29,143,"Missouri","New Madrid County",5,8,191,98,93
050,29,143,"Missouri","New Madrid County",5,9,210,95,115
050,29,143,"Missouri","New Madrid County",5,10,201,101,100
050,29,143,"Missouri","New Madrid County",5,11,188,105,83
050,29,143,"Missouri","New Madrid County",5,12,211,111,100
050,29,143,"Missouri","New Madrid County",5,13,216,97,119
050,29,143,"Missouri","New Madrid County",5,14,213,109,104
050,29,143,"Missouri","New Madrid County",5,15,240,120,120
050,29,143,"Missouri","New Madrid County",5,16,230,113,117
050,29,143,"Missouri","New Madrid County",5,17,229,117,112
050,29,143,"Missouri","New Madrid County",5,18,184,100,84
050,29,143,"Missouri","New Madrid County",5,19,133,70,63
050,29,143,"Missouri","New Madrid County",5,20,142,66,76
050,29,143,"Missouri","New Madrid County",5,21,137,63,74
050,29,143,"Missouri","New Madrid County",5,22,169,78,91
050,29,143,"Missouri","New Madrid County",5,23,153,67,86
050,29,143,"Missouri","New Madrid County",5,24,173,81,92
050,29,143,"Missouri","New Madrid County",5,25,185,89,96
050,29,143,"Missouri","New Madrid County",5,26,172,91,81
050,29,143,"Missouri","New Madrid County",5,27,158,79,79
050,29,143,"Missouri","New Madrid County",5,28,158,74,84
050,29,143,"Missouri","New Madrid County",5,29,155,86,69
050,29,143,"Missouri","New Madrid County",5,30,162,81,81
050,29,143,"Missouri","New Madrid County",5,31,201,95,106
050,29,143,"Missouri","New Madrid County",5,32,193,103,90
050,29,143,"Missouri","New Madrid County",5,33,187,98,89
050,29,143,"Missouri","New Madrid County",5,34,182,87,95
050,29,143,"Missouri","New Madrid County",5,35,180,80,100
050,29,143,"Missouri","New Madrid County",5,36,167,71,96
050,29,143,"Missouri","New Madrid County",5,37,174,77,97
050,29,143,"Missouri","New Madrid County",5,38,183,83,100
050,29,143,"Missouri","New Madrid County",5,39,167,74,93
050,29,143,"Missouri","New Madrid County",5,40,164,75,89
050,29,143,"Missouri","New Madrid County",5,41,169,84,85
050,29,143,"Missouri","New Madrid County",5,42,173,85,88
050,29,143,"Missouri","New Madrid County",5,43,180,89,91
050,29,143,"Missouri","New Madrid County",5,44,171,84,87
050,29,143,"Missouri","New Madrid County",5,45,160,71,89
050,29,143,"Missouri","New Madrid County",5,46,197,96,101
050,29,143,"Missouri","New Madrid County",5,47,190,87,103
050,29,143,"Missouri","New Madrid County",5,48,199,90,109
050,29,143,"Missouri","New Madrid County",5,49,196,97,99
050,29,143,"Missouri","New Madrid County",5,50,198,104,94
050,29,143,"Missouri","New Madrid County",5,51,216,100,116
050,29,143,"Missouri","New Madrid County",5,52,200,105,95
050,29,143,"Missouri","New Madrid County",5,53,181,87,94
050,29,143,"Missouri","New Madrid County",5,54,192,89,103
050,29,143,"Missouri","New Madrid County",5,55,191,93,98
050,29,143,"Missouri","New Madrid County",5,56,196,93,103
050,29,143,"Missouri","New Madrid County",5,57,194,88,106
050,29,143,"Missouri","New Madrid County",5,58,212,101,111
050,29,143,"Missouri","New Madrid County",5,59,206,100,106
050,29,143,"Missouri","New Madrid County",5,60,222,100,122
050,29,143,"Missouri","New Madrid County",5,61,240,110,130
050,29,143,"Missouri","New Madrid County",5,62,255,116,139
050,29,143,"Missouri","New Madrid County",5,63,223,103,120
050,29,143,"Missouri","New Madrid County",5,64,218,107,111
050,29,143,"Missouri","New Madrid County",5,65,197,86,111
050,29,143,"Missouri","New Madrid County",5,66,195,80,115
050,29,143,"Missouri","New Madrid County",5,67,199,90,109
050,29,143,"Missouri","New Madrid County",5,68,187,89,98
050,29,143,"Missouri","New Madrid County",5,69,191,88,103
050,29,143,"Missouri","New Madrid County",5,70,181,91,90
050,29,143,"Missouri","New Madrid County",5,71,173,82,91
050,29,143,"Missouri","New Madrid County",5,72,162,70,92
050,29,143,"Missouri","New Madrid County",5,73,162,62,100
050,29,143,"Missouri","New Madrid County",5,74,161,70,91
050,29,143,"Missouri","New Madrid County",5,75,150,67,83
050,29,143,"Missouri","New Madrid County",5,76,154,72,82
050,29,143,"Missouri","New Madrid County",5,77,100,43,57
050,29,143,"Missouri","New Madrid County",5,78,106,46,60
050,29,143,"Missouri","New Madrid County",5,79,105,44,61
050,29,143,"Missouri","New Madrid County",5,80,115,47,68
050,29,143,"Missouri","New Madrid County",5,81,87,37,50
050,29,143,"Missouri","New Madrid County",5,82,73,29,44
050,29,143,"Missouri","New Madrid County",5,83,57,11,46
050,29,143,"Missouri","New Madrid County",5,84,56,20,36
050,29,143,"Missouri","New Madrid County",5,85,306,102,204
050,29,145,"Missouri","Newton County",1,0,718,369,349
050,29,145,"Missouri","Newton County",1,1,711,374,337
050,29,145,"Missouri","Newton County",1,2,744,387,357
050,29,145,"Missouri","Newton County",1,3,714,379,335
050,29,145,"Missouri","Newton County",1,4,736,395,341
050,29,145,"Missouri","Newton County",1,5,733,416,317
050,29,145,"Missouri","Newton County",1,6,723,393,330
050,29,145,"Missouri","Newton County",1,7,738,379,359
050,29,145,"Missouri","Newton County",1,8,791,423,368
050,29,145,"Missouri","Newton County",1,9,762,388,374
050,29,145,"Missouri","Newton County",1,10,809,412,397
050,29,145,"Missouri","Newton County",1,11,828,426,402
050,29,145,"Missouri","Newton County",1,12,879,460,419
050,29,145,"Missouri","Newton County",1,13,893,470,423
050,29,145,"Missouri","Newton County",1,14,844,436,408
050,29,145,"Missouri","Newton County",1,15,816,413,403
050,29,145,"Missouri","Newton County",1,16,800,413,387
050,29,145,"Missouri","Newton County",1,17,847,439,408
050,29,145,"Missouri","Newton County",1,18,750,397,353
050,29,145,"Missouri","Newton County",1,19,660,364,296
050,29,145,"Missouri","Newton County",1,20,643,346,297
050,29,145,"Missouri","Newton County",1,21,639,334,305
050,29,145,"Missouri","Newton County",1,22,651,354,297
050,29,145,"Missouri","Newton County",1,23,711,360,351
050,29,145,"Missouri","Newton County",1,24,664,336,328
050,29,145,"Missouri","Newton County",1,25,667,347,320
050,29,145,"Missouri","Newton County",1,26,668,350,318
050,29,145,"Missouri","Newton County",1,27,675,338,337
050,29,145,"Missouri","Newton County",1,28,726,371,355
050,29,145,"Missouri","Newton County",1,29,720,370,350
050,29,145,"Missouri","Newton County",1,30,683,338,345
050,29,145,"Missouri","Newton County",1,31,680,341,339
050,29,145,"Missouri","Newton County",1,32,697,363,334
050,29,145,"Missouri","Newton County",1,33,666,337,329
050,29,145,"Missouri","Newton County",1,34,687,363,324
050,29,145,"Missouri","Newton County",1,35,709,365,344
050,29,145,"Missouri","Newton County",1,36,661,337,324
050,29,145,"Missouri","Newton County",1,37,673,322,351
050,29,145,"Missouri","Newton County",1,38,713,335,378
050,29,145,"Missouri","Newton County",1,39,725,372,353
050,29,145,"Missouri","Newton County",1,40,672,336,336
050,29,145,"Missouri","Newton County",1,41,676,345,331
050,29,145,"Missouri","Newton County",1,42,687,357,330
050,29,145,"Missouri","Newton County",1,43,682,340,342
050,29,145,"Missouri","Newton County",1,44,632,316,316
050,29,145,"Missouri","Newton County",1,45,644,315,329
050,29,145,"Missouri","Newton County",1,46,645,333,312
050,29,145,"Missouri","Newton County",1,47,698,363,335
050,29,145,"Missouri","Newton County",1,48,737,378,359
050,29,145,"Missouri","Newton County",1,49,786,387,399
050,29,145,"Missouri","Newton County",1,50,757,383,374
050,29,145,"Missouri","Newton County",1,51,741,369,372
050,29,145,"Missouri","Newton County",1,52,733,362,371
050,29,145,"Missouri","Newton County",1,53,744,380,364
050,29,145,"Missouri","Newton County",1,54,745,390,355
050,29,145,"Missouri","Newton County",1,55,807,403,404
050,29,145,"Missouri","Newton County",1,56,814,404,410
050,29,145,"Missouri","Newton County",1,57,872,436,436
050,29,145,"Missouri","Newton County",1,58,884,461,423
050,29,145,"Missouri","Newton County",1,59,836,424,412
050,29,145,"Missouri","Newton County",1,60,775,389,386
050,29,145,"Missouri","Newton County",1,61,816,400,416
050,29,145,"Missouri","Newton County",1,62,829,420,409
050,29,145,"Missouri","Newton County",1,63,784,367,417
050,29,145,"Missouri","Newton County",1,64,747,346,401
050,29,145,"Missouri","Newton County",1,65,758,363,395
050,29,145,"Missouri","Newton County",1,66,738,360,378
050,29,145,"Missouri","Newton County",1,67,670,333,337
050,29,145,"Missouri","Newton County",1,68,620,285,335
050,29,145,"Missouri","Newton County",1,69,592,273,319
050,29,145,"Missouri","Newton County",1,70,599,293,306
050,29,145,"Missouri","Newton County",1,71,591,299,292
050,29,145,"Missouri","Newton County",1,72,632,306,326
050,29,145,"Missouri","Newton County",1,73,646,316,330
050,29,145,"Missouri","Newton County",1,74,468,217,251
050,29,145,"Missouri","Newton County",1,75,440,193,247
050,29,145,"Missouri","Newton County",1,76,440,196,244
050,29,145,"Missouri","Newton County",1,77,457,210,247
050,29,145,"Missouri","Newton County",1,78,392,180,212
050,29,145,"Missouri","Newton County",1,79,335,150,185
050,29,145,"Missouri","Newton County",1,80,282,113,169
050,29,145,"Missouri","Newton County",1,81,278,116,162
050,29,145,"Missouri","Newton County",1,82,272,125,147
050,29,145,"Missouri","Newton County",1,83,244,103,141
050,29,145,"Missouri","Newton County",1,84,206,85,121
050,29,145,"Missouri","Newton County",1,85,1090,392,698
050,29,145,"Missouri","Newton County",2,0,704,367,337
050,29,145,"Missouri","Newton County",2,1,714,374,340
050,29,145,"Missouri","Newton County",2,2,736,384,352
050,29,145,"Missouri","Newton County",2,3,722,381,341
050,29,145,"Missouri","Newton County",2,4,732,392,340
050,29,145,"Missouri","Newton County",2,5,736,410,326
050,29,145,"Missouri","Newton County",2,6,729,400,329
050,29,145,"Missouri","Newton County",2,7,741,387,354
050,29,145,"Missouri","Newton County",2,8,778,411,367
050,29,145,"Missouri","Newton County",2,9,773,399,374
050,29,145,"Missouri","Newton County",2,10,801,408,393
050,29,145,"Missouri","Newton County",2,11,823,423,400
050,29,145,"Missouri","Newton County",2,12,872,454,418
050,29,145,"Missouri","Newton County",2,13,892,466,426
050,29,145,"Missouri","Newton County",2,14,859,446,413
050,29,145,"Missouri","Newton County",2,15,824,419,405
050,29,145,"Missouri","Newton County",2,16,807,415,392
050,29,145,"Missouri","Newton County",2,17,837,435,402
050,29,145,"Missouri","Newton County",2,18,750,396,354
050,29,145,"Missouri","Newton County",2,19,664,364,300
050,29,145,"Missouri","Newton County",2,20,646,347,299
050,29,145,"Missouri","Newton County",2,21,634,335,299
050,29,145,"Missouri","Newton County",2,22,659,352,307
050,29,145,"Missouri","Newton County",2,23,693,355,338
050,29,145,"Missouri","Newton County",2,24,673,344,329
050,29,145,"Missouri","Newton County",2,25,672,349,323
050,29,145,"Missouri","Newton County",2,26,668,350,318
050,29,145,"Missouri","Newton County",2,27,675,343,332
050,29,145,"Missouri","Newton County",2,28,718,367,351
050,29,145,"Missouri","Newton County",2,29,718,369,349
050,29,145,"Missouri","Newton County",2,30,693,347,346
050,29,145,"Missouri","Newton County",2,31,684,342,342
050,29,145,"Missouri","Newton County",2,32,697,360,337
050,29,145,"Missouri","Newton County",2,33,676,346,330
050,29,145,"Missouri","Newton County",2,34,683,360,323
050,29,145,"Missouri","Newton County",2,35,712,368,344
050,29,145,"Missouri","Newton County",2,36,665,340,325
050,29,145,"Missouri","Newton County",2,37,675,326,349
050,29,145,"Missouri","Newton County",2,38,709,335,374
050,29,145,"Missouri","Newton County",2,39,721,363,358
050,29,145,"Missouri","Newton County",2,40,692,346,346
050,29,145,"Missouri","Newton County",2,41,679,344,335
050,29,145,"Missouri","Newton County",2,42,684,352,332
050,29,145,"Missouri","Newton County",2,43,691,347,344
050,29,145,"Missouri","Newton County",2,44,636,318,318
050,29,145,"Missouri","Newton County",2,45,645,315,330
050,29,145,"Missouri","Newton County",2,46,645,332,313
050,29,145,"Missouri","Newton County",2,47,677,349,328
050,29,145,"Missouri","Newton County",2,48,724,372,352
050,29,145,"Missouri","Newton County",2,49,783,391,392
050,29,145,"Missouri","Newton County",2,50,766,385,381
050,29,145,"Missouri","Newton County",2,51,741,369,372
050,29,145,"Missouri","Newton County",2,52,733,363,370
050,29,145,"Missouri","Newton County",2,53,737,372,365
050,29,145,"Missouri","Newton County",2,54,743,389,354
050,29,145,"Missouri","Newton County",2,55,788,398,390
050,29,145,"Missouri","Newton County",2,56,815,405,410
050,29,145,"Missouri","Newton County",2,57,863,432,431
050,29,145,"Missouri","Newton County",2,58,877,453,424
050,29,145,"Missouri","Newton County",2,59,846,430,416
050,29,145,"Missouri","Newton County",2,60,783,392,391
050,29,145,"Missouri","Newton County",2,61,801,397,404
050,29,145,"Missouri","Newton County",2,62,822,412,410
050,29,145,"Missouri","Newton County",2,63,798,378,420
050,29,145,"Missouri","Newton County",2,64,749,347,402
050,29,145,"Missouri","Newton County",2,65,750,357,393
050,29,145,"Missouri","Newton County",2,66,742,361,381
050,29,145,"Missouri","Newton County",2,67,685,339,346
050,29,145,"Missouri","Newton County",2,68,626,293,333
050,29,145,"Missouri","Newton County",2,69,602,279,323
050,29,145,"Missouri","Newton County",2,70,594,283,311
050,29,145,"Missouri","Newton County",2,71,593,298,295
050,29,145,"Missouri","Newton County",2,72,605,296,309
050,29,145,"Missouri","Newton County",2,73,674,330,344
050,29,145,"Missouri","Newton County",2,74,475,222,253
050,29,145,"Missouri","Newton County",2,75,443,196,247
050,29,145,"Missouri","Newton County",2,76,429,192,237
050,29,145,"Missouri","Newton County",2,77,460,210,250
050,29,145,"Missouri","Newton County",2,78,394,180,214
050,29,145,"Missouri","Newton County",2,79,344,155,189
050,29,145,"Missouri","Newton County",2,80,292,123,169
050,29,145,"Missouri","Newton County",2,81,266,107,159
050,29,145,"Missouri","Newton County",2,82,274,123,151
050,29,145,"Missouri","Newton County",2,83,249,107,142
050,29,145,"Missouri","Newton County",2,84,211,87,124
050,29,145,"Missouri","Newton County",2,85,1101,393,708
050,29,145,"Missouri","Newton County",3,0,673,342,331
050,29,145,"Missouri","Newton County",3,1,733,391,342
050,29,145,"Missouri","Newton County",3,2,750,384,366
050,29,145,"Missouri","Newton County",3,3,736,381,355
050,29,145,"Missouri","Newton County",3,4,729,387,342
050,29,145,"Missouri","Newton County",3,5,759,406,353
050,29,145,"Missouri","Newton County",3,6,745,415,330
050,29,145,"Missouri","Newton County",3,7,743,411,332
050,29,145,"Missouri","Newton County",3,8,757,393,364
050,29,145,"Missouri","Newton County",3,9,789,413,376
050,29,145,"Missouri","Newton County",3,10,779,406,373
050,29,145,"Missouri","Newton County",3,11,823,422,401
050,29,145,"Missouri","Newton County",3,12,843,432,411
050,29,145,"Missouri","Newton County",3,13,896,456,440
050,29,145,"Missouri","Newton County",3,14,906,474,432
050,29,145,"Missouri","Newton County",3,15,869,449,420
050,29,145,"Missouri","Newton County",3,16,846,433,413
050,29,145,"Missouri","Newton County",3,17,811,416,395
050,29,145,"Missouri","Newton County",3,18,750,386,364
050,29,145,"Missouri","Newton County",3,19,669,355,314
050,29,145,"Missouri","Newton County",3,20,664,357,307
050,29,145,"Missouri","Newton County",3,21,651,356,295
050,29,145,"Missouri","Newton County",3,22,688,351,337
050,29,145,"Missouri","Newton County",3,23,680,374,306
050,29,145,"Missouri","Newton County",3,24,713,357,356
050,29,145,"Missouri","Newton County",3,25,696,357,339
050,29,145,"Missouri","Newton County",3,26,720,382,338
050,29,145,"Missouri","Newton County",3,27,674,351,323
050,29,145,"Missouri","Newton County",3,28,708,367,341
050,29,145,"Missouri","Newton County",3,29,734,366,368
050,29,145,"Missouri","Newton County",3,30,730,359,371
050,29,145,"Missouri","Newton County",3,31,700,364,336
050,29,145,"Missouri","Newton County",3,32,728,367,361
050,29,145,"Missouri","Newton County",3,33,715,358,357
050,29,145,"Missouri","Newton County",3,34,709,371,338
050,29,145,"Missouri","Newton County",3,35,704,352,352
050,29,145,"Missouri","Newton County",3,36,708,366,342
050,29,145,"Missouri","Newton County",3,37,690,355,335
050,29,145,"Missouri","Newton County",3,38,686,338,348
050,29,145,"Missouri","Newton County",3,39,693,327,366
050,29,145,"Missouri","Newton County",3,40,731,368,363
050,29,145,"Missouri","Newton County",3,41,707,353,354
050,29,145,"Missouri","Newton County",3,42,711,365,346
050,29,145,"Missouri","Newton County",3,43,680,355,325
050,29,145,"Missouri","Newton County",3,44,702,352,350
050,29,145,"Missouri","Newton County",3,45,650,320,330
050,29,145,"Missouri","Newton County",3,46,641,324,317
050,29,145,"Missouri","Newton County",3,47,644,326,318
050,29,145,"Missouri","Newton County",3,48,676,345,331
050,29,145,"Missouri","Newton County",3,49,738,375,363
050,29,145,"Missouri","Newton County",3,50,764,385,379
050,29,145,"Missouri","Newton County",3,51,790,400,390
050,29,145,"Missouri","Newton County",3,52,752,379,373
050,29,145,"Missouri","Newton County",3,53,740,362,378
050,29,145,"Missouri","Newton County",3,54,750,378,372
050,29,145,"Missouri","Newton County",3,55,754,398,356
050,29,145,"Missouri","Newton County",3,56,793,397,396
050,29,145,"Missouri","Newton County",3,57,814,399,415
050,29,145,"Missouri","Newton County",3,58,868,436,432
050,29,145,"Missouri","Newton County",3,59,867,447,420
050,29,145,"Missouri","Newton County",3,60,842,425,417
050,29,145,"Missouri","Newton County",3,61,790,389,401
050,29,145,"Missouri","Newton County",3,62,796,394,402
050,29,145,"Missouri","Newton County",3,63,809,403,406
050,29,145,"Missouri","Newton County",3,64,797,381,416
050,29,145,"Missouri","Newton County",3,65,739,339,400
050,29,145,"Missouri","Newton County",3,66,741,347,394
050,29,145,"Missouri","Newton County",3,67,731,361,370
050,29,145,"Missouri","Newton County",3,68,680,336,344
050,29,145,"Missouri","Newton County",3,69,621,297,324
050,29,145,"Missouri","Newton County",3,70,595,268,327
050,29,145,"Missouri","Newton County",3,71,569,262,307
050,29,145,"Missouri","Newton County",3,72,576,289,287
050,29,145,"Missouri","Newton County",3,73,601,294,307
050,29,145,"Missouri","Newton County",3,74,663,318,345
050,29,145,"Missouri","Newton County",3,75,455,212,243
050,29,145,"Missouri","Newton County",3,76,420,190,230
050,29,145,"Missouri","Newton County",3,77,394,172,222
050,29,145,"Missouri","Newton County",3,78,434,197,237
050,29,145,"Missouri","Newton County",3,79,376,171,205
050,29,145,"Missouri","Newton County",3,80,331,149,182
050,29,145,"Missouri","Newton County",3,81,261,109,152
050,29,145,"Missouri","Newton County",3,82,245,97,148
050,29,145,"Missouri","Newton County",3,83,269,122,147
050,29,145,"Missouri","Newton County",3,84,229,94,135
050,29,145,"Missouri","Newton County",3,85,1107,401,706
050,29,145,"Missouri","Newton County",4,0,692,357,335
050,29,145,"Missouri","Newton County",4,1,688,367,321
050,29,145,"Missouri","Newton County",4,2,768,424,344
050,29,145,"Missouri","Newton County",4,3,730,376,354
050,29,145,"Missouri","Newton County",4,4,771,413,358
050,29,145,"Missouri","Newton County",4,5,755,409,346
050,29,145,"Missouri","Newton County",4,6,780,413,367
050,29,145,"Missouri","Newton County",4,7,784,439,345
050,29,145,"Missouri","Newton County",4,8,790,432,358
050,29,145,"Missouri","Newton County",4,9,800,417,383
050,29,145,"Missouri","Newton County",4,10,818,431,387
050,29,145,"Missouri","Newton County",4,11,784,405,379
050,29,145,"Missouri","Newton County",4,12,837,419,418
050,29,145,"Missouri","Newton County",4,13,857,430,427
050,29,145,"Missouri","Newton County",4,14,916,459,457
050,29,145,"Missouri","Newton County",4,15,892,461,431
050,29,145,"Missouri","Newton County",4,16,877,452,425
050,29,145,"Missouri","Newton County",4,17,829,427,402
050,29,145,"Missouri","Newton County",4,18,735,379,356
050,29,145,"Missouri","Newton County",4,19,672,362,310
050,29,145,"Missouri","Newton County",4,20,654,350,304
050,29,145,"Missouri","Newton County",4,21,650,352,298
050,29,145,"Missouri","Newton County",4,22,679,369,310
050,29,145,"Missouri","Newton County",4,23,693,345,348
050,29,145,"Missouri","Newton County",4,24,723,400,323
050,29,145,"Missouri","Newton County",4,25,741,364,377
050,29,145,"Missouri","Newton County",4,26,702,352,350
050,29,145,"Missouri","Newton County",4,27,718,371,347
050,29,145,"Missouri","Newton County",4,28,683,357,326
050,29,145,"Missouri","Newton County",4,29,710,367,343
050,29,145,"Missouri","Newton County",4,30,726,358,368
050,29,145,"Missouri","Newton County",4,31,741,378,363
050,29,145,"Missouri","Newton County",4,32,712,364,348
050,29,145,"Missouri","Newton County",4,33,757,389,368
050,29,145,"Missouri","Newton County",4,34,730,370,360
050,29,145,"Missouri","Newton County",4,35,720,378,342
050,29,145,"Missouri","Newton County",4,36,722,358,364
050,29,145,"Missouri","Newton County",4,37,723,375,348
050,29,145,"Missouri","Newton County",4,38,675,342,333
050,29,145,"Missouri","Newton County",4,39,723,358,365
050,29,145,"Missouri","Newton County",4,40,699,328,371
050,29,145,"Missouri","Newton County",4,41,757,379,378
050,29,145,"Missouri","Newton County",4,42,735,375,360
050,29,145,"Missouri","Newton County",4,43,711,364,347
050,29,145,"Missouri","Newton County",4,44,693,367,326
050,29,145,"Missouri","Newton County",4,45,709,346,363
050,29,145,"Missouri","Newton County",4,46,659,332,327
050,29,145,"Missouri","Newton County",4,47,634,304,330
050,29,145,"Missouri","Newton County",4,48,641,331,310
050,29,145,"Missouri","Newton County",4,49,688,358,330
050,29,145,"Missouri","Newton County",4,50,744,379,365
050,29,145,"Missouri","Newton County",4,51,776,396,380
050,29,145,"Missouri","Newton County",4,52,782,400,382
050,29,145,"Missouri","Newton County",4,53,749,364,385
050,29,145,"Missouri","Newton County",4,54,740,369,371
050,29,145,"Missouri","Newton County",4,55,751,376,375
050,29,145,"Missouri","Newton County",4,56,744,391,353
050,29,145,"Missouri","Newton County",4,57,818,414,404
050,29,145,"Missouri","Newton County",4,58,815,405,410
050,29,145,"Missouri","Newton County",4,59,857,428,429
050,29,145,"Missouri","Newton County",4,60,858,445,413
050,29,145,"Missouri","Newton County",4,61,843,424,419
050,29,145,"Missouri","Newton County",4,62,777,382,395
050,29,145,"Missouri","Newton County",4,63,772,374,398
050,29,145,"Missouri","Newton County",4,64,810,406,404
050,29,145,"Missouri","Newton County",4,65,770,363,407
050,29,145,"Missouri","Newton County",4,66,743,337,406
050,29,145,"Missouri","Newton County",4,67,725,342,383
050,29,145,"Missouri","Newton County",4,68,723,356,367
050,29,145,"Missouri","Newton County",4,69,671,329,342
050,29,145,"Missouri","Newton County",4,70,630,296,334
050,29,145,"Missouri","Newton County",4,71,572,258,314
050,29,145,"Missouri","Newton County",4,72,559,251,308
050,29,145,"Missouri","Newton County",4,73,572,283,289
050,29,145,"Missouri","Newton County",4,74,573,276,297
050,29,145,"Missouri","Newton County",4,75,650,318,332
050,29,145,"Missouri","Newton County",4,76,437,206,231
050,29,145,"Missouri","Newton County",4,77,410,178,232
050,29,145,"Missouri","Newton County",4,78,358,155,203
050,29,145,"Missouri","Newton County",4,79,421,185,236
050,29,145,"Missouri","Newton County",4,80,349,158,191
050,29,145,"Missouri","Newton County",4,81,303,135,168
050,29,145,"Missouri","Newton County",4,82,241,101,140
050,29,145,"Missouri","Newton County",4,83,244,97,147
050,29,145,"Missouri","Newton County",4,84,256,113,143
050,29,145,"Missouri","Newton County",4,85,1170,435,735
050,29,145,"Missouri","Newton County",5,0,688,356,332
050,29,145,"Missouri","Newton County",5,1,730,367,363
050,29,145,"Missouri","Newton County",5,2,710,382,328
050,29,145,"Missouri","Newton County",5,3,775,420,355
050,29,145,"Missouri","Newton County",5,4,752,388,364
050,29,145,"Missouri","Newton County",5,5,773,403,370
050,29,145,"Missouri","Newton County",5,6,769,420,349
050,29,145,"Missouri","Newton County",5,7,835,442,393
050,29,145,"Missouri","Newton County",5,8,817,459,358
050,29,145,"Missouri","Newton County",5,9,794,440,354
050,29,145,"Missouri","Newton County",5,10,807,422,385
050,29,145,"Missouri","Newton County",5,11,845,434,411
050,29,145,"Missouri","Newton County",5,12,814,408,406
050,29,145,"Missouri","Newton County",5,13,856,434,422
050,29,145,"Missouri","Newton County",5,14,848,422,426
050,29,145,"Missouri","Newton County",5,15,906,445,461
050,29,145,"Missouri","Newton County",5,16,886,463,423
050,29,145,"Missouri","Newton County",5,17,879,454,425
050,29,145,"Missouri","Newton County",5,18,743,399,344
050,29,145,"Missouri","Newton County",5,19,657,343,314
050,29,145,"Missouri","Newton County",5,20,681,358,323
050,29,145,"Missouri","Newton County",5,21,646,344,302
050,29,145,"Missouri","Newton County",5,22,712,374,338
050,29,145,"Missouri","Newton County",5,23,691,381,310
050,29,145,"Missouri","Newton County",5,24,739,385,354
050,29,145,"Missouri","Newton County",5,25,750,398,352
050,29,145,"Missouri","Newton County",5,26,752,367,385
050,29,145,"Missouri","Newton County",5,27,676,336,340
050,29,145,"Missouri","Newton County",5,28,711,370,341
050,29,145,"Missouri","Newton County",5,29,684,348,336
050,29,145,"Missouri","Newton County",5,30,721,374,347
050,29,145,"Missouri","Newton County",5,31,734,352,382
050,29,145,"Missouri","Newton County",5,32,764,397,367
050,29,145,"Missouri","Newton County",5,33,707,359,348
050,29,145,"Missouri","Newton County",5,34,750,383,367
050,29,145,"Missouri","Newton County",5,35,738,362,376
050,29,145,"Missouri","Newton County",5,36,734,382,352
050,29,145,"Missouri","Newton County",5,37,761,374,387
050,29,145,"Missouri","Newton County",5,38,745,385,360
050,29,145,"Missouri","Newton County",5,39,700,344,356
050,29,145,"Missouri","Newton County",5,40,723,366,357
050,29,145,"Missouri","Newton County",5,41,700,327,373
050,29,145,"Missouri","Newton County",5,42,765,385,380
050,29,145,"Missouri","Newton County",5,43,717,362,355
050,29,145,"Missouri","Newton County",5,44,712,360,352
050,29,145,"Missouri","Newton County",5,45,713,386,327
050,29,145,"Missouri","Newton County",5,46,698,339,359
050,29,145,"Missouri","Newton County",5,47,656,321,335
050,29,145,"Missouri","Newton County",5,48,635,312,323
050,29,145,"Missouri","Newton County",5,49,663,341,322
050,29,145,"Missouri","Newton County",5,50,709,367,342
050,29,145,"Missouri","Newton County",5,51,743,382,361
050,29,145,"Missouri","Newton County",5,52,771,387,384
050,29,145,"Missouri","Newton County",5,53,791,391,400
050,29,145,"Missouri","Newton County",5,54,748,364,384
050,29,145,"Missouri","Newton County",5,55,742,361,381
050,29,145,"Missouri","Newton County",5,56,742,371,371
050,29,145,"Missouri","Newton County",5,57,722,381,341
050,29,145,"Missouri","Newton County",5,58,792,401,391
050,29,145,"Missouri","Newton County",5,59,800,398,402
050,29,145,"Missouri","Newton County",5,60,836,412,424
050,29,145,"Missouri","Newton County",5,61,868,450,418
050,29,145,"Missouri","Newton County",5,62,850,428,422
050,29,145,"Missouri","Newton County",5,63,767,377,390
050,29,145,"Missouri","Newton County",5,64,785,377,408
050,29,145,"Missouri","Newton County",5,65,810,398,412
050,29,145,"Missouri","Newton County",5,66,776,361,415
050,29,145,"Missouri","Newton County",5,67,735,332,403
050,29,145,"Missouri","Newton County",5,68,711,328,383
050,29,145,"Missouri","Newton County",5,69,709,354,355
050,29,145,"Missouri","Newton County",5,70,663,320,343
050,29,145,"Missouri","Newton County",5,71,616,286,330
050,29,145,"Missouri","Newton County",5,72,559,253,306
050,29,145,"Missouri","Newton County",5,73,550,245,305
050,29,145,"Missouri","Newton County",5,74,549,266,283
050,29,145,"Missouri","Newton County",5,75,558,276,282
050,29,145,"Missouri","Newton County",5,76,625,306,319
050,29,145,"Missouri","Newton County",5,77,427,190,237
050,29,145,"Missouri","Newton County",5,78,382,163,219
050,29,145,"Missouri","Newton County",5,79,348,147,201
050,29,145,"Missouri","Newton County",5,80,390,170,220
050,29,145,"Missouri","Newton County",5,81,334,152,182
050,29,145,"Missouri","Newton County",5,82,283,127,156
050,29,145,"Missouri","Newton County",5,83,227,95,132
050,29,145,"Missouri","Newton County",5,84,226,86,140
050,29,145,"Missouri","Newton County",5,85,1271,495,776
050,29,147,"Missouri","Nodaway County",1,0,209,105,104
050,29,147,"Missouri","Nodaway County",1,1,208,102,106
050,29,147,"Missouri","Nodaway County",1,2,191,115,76
050,29,147,"Missouri","Nodaway County",1,3,209,112,97
050,29,147,"Missouri","Nodaway County",1,4,216,110,106
050,29,147,"Missouri","Nodaway County",1,5,190,93,97
050,29,147,"Missouri","Nodaway County",1,6,190,94,96
050,29,147,"Missouri","Nodaway County",1,7,187,93,94
050,29,147,"Missouri","Nodaway County",1,8,189,100,89
050,29,147,"Missouri","Nodaway County",1,9,189,103,86
050,29,147,"Missouri","Nodaway County",1,10,194,100,94
050,29,147,"Missouri","Nodaway County",1,11,209,109,100
050,29,147,"Missouri","Nodaway County",1,12,196,107,89
050,29,147,"Missouri","Nodaway County",1,13,203,106,97
050,29,147,"Missouri","Nodaway County",1,14,197,101,96
050,29,147,"Missouri","Nodaway County",1,15,190,105,85
050,29,147,"Missouri","Nodaway County",1,16,204,95,109
050,29,147,"Missouri","Nodaway County",1,17,225,115,110
050,29,147,"Missouri","Nodaway County",1,18,356,151,205
050,29,147,"Missouri","Nodaway County",1,19,667,290,377
050,29,147,"Missouri","Nodaway County",1,20,980,451,529
050,29,147,"Missouri","Nodaway County",1,21,1118,515,603
050,29,147,"Missouri","Nodaway County",1,22,931,482,449
050,29,147,"Missouri","Nodaway County",1,23,513,312,201
050,29,147,"Missouri","Nodaway County",1,24,378,214,164
050,29,147,"Missouri","Nodaway County",1,25,284,162,122
050,29,147,"Missouri","Nodaway County",1,26,237,132,105
050,29,147,"Missouri","Nodaway County",1,27,263,137,126
050,29,147,"Missouri","Nodaway County",1,28,253,145,108
050,29,147,"Missouri","Nodaway County",1,29,245,138,107
050,29,147,"Missouri","Nodaway County",1,30,235,146,89
050,29,147,"Missouri","Nodaway County",1,31,228,144,84
050,29,147,"Missouri","Nodaway County",1,32,195,124,71
050,29,147,"Missouri","Nodaway County",1,33,210,111,99
050,29,147,"Missouri","Nodaway County",1,34,221,108,113
050,29,147,"Missouri","Nodaway County",1,35,214,108,106
050,29,147,"Missouri","Nodaway County",1,36,212,113,99
050,29,147,"Missouri","Nodaway County",1,37,225,127,98
050,29,147,"Missouri","Nodaway County",1,38,240,127,113
050,29,147,"Missouri","Nodaway County",1,39,260,141,119
050,29,147,"Missouri","Nodaway County",1,40,245,136,109
050,29,147,"Missouri","Nodaway County",1,41,227,121,106
050,29,147,"Missouri","Nodaway County",1,42,203,107,96
050,29,147,"Missouri","Nodaway County",1,43,192,111,81
050,29,147,"Missouri","Nodaway County",1,44,199,104,95
050,29,147,"Missouri","Nodaway County",1,45,194,94,100
050,29,147,"Missouri","Nodaway County",1,46,194,95,99
050,29,147,"Missouri","Nodaway County",1,47,188,108,80
050,29,147,"Missouri","Nodaway County",1,48,202,107,95
050,29,147,"Missouri","Nodaway County",1,49,231,115,116
050,29,147,"Missouri","Nodaway County",1,50,192,100,92
050,29,147,"Missouri","Nodaway County",1,51,191,103,88
050,29,147,"Missouri","Nodaway County",1,52,183,95,88
050,29,147,"Missouri","Nodaway County",1,53,223,114,109
050,29,147,"Missouri","Nodaway County",1,54,247,128,119
050,29,147,"Missouri","Nodaway County",1,55,246,121,125
050,29,147,"Missouri","Nodaway County",1,56,257,126,131
050,29,147,"Missouri","Nodaway County",1,57,284,140,144
050,29,147,"Missouri","Nodaway County",1,58,274,138,136
050,29,147,"Missouri","Nodaway County",1,59,252,134,118
050,29,147,"Missouri","Nodaway County",1,60,251,122,129
050,29,147,"Missouri","Nodaway County",1,61,243,121,122
050,29,147,"Missouri","Nodaway County",1,62,222,123,99
050,29,147,"Missouri","Nodaway County",1,63,238,123,115
050,29,147,"Missouri","Nodaway County",1,64,240,118,122
050,29,147,"Missouri","Nodaway County",1,65,250,121,129
050,29,147,"Missouri","Nodaway County",1,66,213,102,111
050,29,147,"Missouri","Nodaway County",1,67,222,101,121
050,29,147,"Missouri","Nodaway County",1,68,229,114,115
050,29,147,"Missouri","Nodaway County",1,69,192,99,93
050,29,147,"Missouri","Nodaway County",1,70,179,83,96
050,29,147,"Missouri","Nodaway County",1,71,163,78,85
050,29,147,"Missouri","Nodaway County",1,72,193,100,93
050,29,147,"Missouri","Nodaway County",1,73,163,85,78
050,29,147,"Missouri","Nodaway County",1,74,122,62,60
050,29,147,"Missouri","Nodaway County",1,75,135,62,73
050,29,147,"Missouri","Nodaway County",1,76,144,66,78
050,29,147,"Missouri","Nodaway County",1,77,132,57,75
050,29,147,"Missouri","Nodaway County",1,78,123,51,72
050,29,147,"Missouri","Nodaway County",1,79,113,53,60
050,29,147,"Missouri","Nodaway County",1,80,102,45,57
050,29,147,"Missouri","Nodaway County",1,81,99,45,54
050,29,147,"Missouri","Nodaway County",1,82,98,43,55
050,29,147,"Missouri","Nodaway County",1,83,88,37,51
050,29,147,"Missouri","Nodaway County",1,84,89,32,57
050,29,147,"Missouri","Nodaway County",1,85,507,180,327
050,29,147,"Missouri","Nodaway County",2,0,222,119,103
050,29,147,"Missouri","Nodaway County",2,1,206,103,103
050,29,147,"Missouri","Nodaway County",2,2,191,110,81
050,29,147,"Missouri","Nodaway County",2,3,208,114,94
050,29,147,"Missouri","Nodaway County",2,4,215,112,103
050,29,147,"Missouri","Nodaway County",2,5,196,97,99
050,29,147,"Missouri","Nodaway County",2,6,192,93,99
050,29,147,"Missouri","Nodaway County",2,7,188,94,94
050,29,147,"Missouri","Nodaway County",2,8,188,98,90
050,29,147,"Missouri","Nodaway County",2,9,188,102,86
050,29,147,"Missouri","Nodaway County",2,10,193,101,92
050,29,147,"Missouri","Nodaway County",2,11,205,106,99
050,29,147,"Missouri","Nodaway County",2,12,202,109,93
050,29,147,"Missouri","Nodaway County",2,13,200,106,94
050,29,147,"Missouri","Nodaway County",2,14,197,102,95
050,29,147,"Missouri","Nodaway County",2,15,192,104,88
050,29,147,"Missouri","Nodaway County",2,16,207,100,107
050,29,147,"Missouri","Nodaway County",2,17,226,113,113
050,29,147,"Missouri","Nodaway County",2,18,357,151,206
050,29,147,"Missouri","Nodaway County",2,19,668,287,381
050,29,147,"Missouri","Nodaway County",2,20,968,443,525
050,29,147,"Missouri","Nodaway County",2,21,1100,506,594
050,29,147,"Missouri","Nodaway County",2,22,923,475,448
050,29,147,"Missouri","Nodaway County",2,23,496,300,196
050,29,147,"Missouri","Nodaway County",2,24,364,200,164
050,29,147,"Missouri","Nodaway County",2,25,275,152,123
050,29,147,"Missouri","Nodaway County",2,26,229,124,105
050,29,147,"Missouri","Nodaway County",2,27,247,127,120
050,29,147,"Missouri","Nodaway County",2,28,247,135,112
050,29,147,"Missouri","Nodaway County",2,29,239,134,105
050,29,147,"Missouri","Nodaway County",2,30,229,135,94
050,29,147,"Missouri","Nodaway County",2,31,219,134,85
050,29,147,"Missouri","Nodaway County",2,32,192,117,75
050,29,147,"Missouri","Nodaway County",2,33,197,103,94
050,29,147,"Missouri","Nodaway County",2,34,211,101,110
050,29,147,"Missouri","Nodaway County",2,35,209,102,107
050,29,147,"Missouri","Nodaway County",2,36,205,107,98
050,29,147,"Missouri","Nodaway County",2,37,217,118,99
050,29,147,"Missouri","Nodaway County",2,38,231,121,110
050,29,147,"Missouri","Nodaway County",2,39,249,134,115
050,29,147,"Missouri","Nodaway County",2,40,242,130,112
050,29,147,"Missouri","Nodaway County",2,41,224,117,107
050,29,147,"Missouri","Nodaway County",2,42,199,103,96
050,29,147,"Missouri","Nodaway County",2,43,188,105,83
050,29,147,"Missouri","Nodaway County",2,44,187,97,90
050,29,147,"Missouri","Nodaway County",2,45,193,93,100
050,29,147,"Missouri","Nodaway County",2,46,189,91,98
050,29,147,"Missouri","Nodaway County",2,47,186,101,85
050,29,147,"Missouri","Nodaway County",2,48,194,102,92
050,29,147,"Missouri","Nodaway County",2,49,220,108,112
050,29,147,"Missouri","Nodaway County",2,50,198,99,99
050,29,147,"Missouri","Nodaway County",2,51,184,97,87
050,29,147,"Missouri","Nodaway County",2,52,180,94,86
050,29,147,"Missouri","Nodaway County",2,53,211,107,104
050,29,147,"Missouri","Nodaway County",2,54,239,123,116
050,29,147,"Missouri","Nodaway County",2,55,244,120,124
050,29,147,"Missouri","Nodaway County",2,56,255,124,131
050,29,147,"Missouri","Nodaway County",2,57,278,136,142
050,29,147,"Missouri","Nodaway County",2,58,271,136,135
050,29,147,"Missouri","Nodaway County",2,59,256,134,122
050,29,147,"Missouri","Nodaway County",2,60,249,124,125
050,29,147,"Missouri","Nodaway County",2,61,245,122,123
050,29,147,"Missouri","Nodaway County",2,62,224,122,102
050,29,147,"Missouri","Nodaway County",2,63,236,123,113
050,29,147,"Missouri","Nodaway County",2,64,236,117,119
050,29,147,"Missouri","Nodaway County",2,65,244,116,128
050,29,147,"Missouri","Nodaway County",2,66,223,107,116
050,29,147,"Missouri","Nodaway County",2,67,221,102,119
050,29,147,"Missouri","Nodaway County",2,68,224,111,113
050,29,147,"Missouri","Nodaway County",2,69,202,103,99
050,29,147,"Missouri","Nodaway County",2,70,181,86,95
050,29,147,"Missouri","Nodaway County",2,71,164,79,85
050,29,147,"Missouri","Nodaway County",2,72,184,94,90
050,29,147,"Missouri","Nodaway County",2,73,178,92,86
050,29,147,"Missouri","Nodaway County",2,74,122,63,59
050,29,147,"Missouri","Nodaway County",2,75,132,62,70
050,29,147,"Missouri","Nodaway County",2,76,140,64,76
050,29,147,"Missouri","Nodaway County",2,77,139,62,77
050,29,147,"Missouri","Nodaway County",2,78,121,51,70
050,29,147,"Missouri","Nodaway County",2,79,113,51,62
050,29,147,"Missouri","Nodaway County",2,80,105,47,58
050,29,147,"Missouri","Nodaway County",2,81,101,46,55
050,29,147,"Missouri","Nodaway County",2,82,96,42,54
050,29,147,"Missouri","Nodaway County",2,83,90,38,52
050,29,147,"Missouri","Nodaway County",2,84,88,33,55
050,29,147,"Missouri","Nodaway County",2,85,513,184,329
050,29,147,"Missouri","Nodaway County",3,0,218,107,111
050,29,147,"Missouri","Nodaway County",3,1,221,111,110
050,29,147,"Missouri","Nodaway County",3,2,202,101,101
050,29,147,"Missouri","Nodaway County",3,3,188,109,79
050,29,147,"Missouri","Nodaway County",3,4,207,117,90
050,29,147,"Missouri","Nodaway County",3,5,214,114,100
050,29,147,"Missouri","Nodaway County",3,6,198,99,99
050,29,147,"Missouri","Nodaway County",3,7,195,92,103
050,29,147,"Missouri","Nodaway County",3,8,187,95,92
050,29,147,"Missouri","Nodaway County",3,9,186,95,91
050,29,147,"Missouri","Nodaway County",3,10,182,101,81
050,29,147,"Missouri","Nodaway County",3,11,194,99,95
050,29,147,"Missouri","Nodaway County",3,12,208,109,99
050,29,147,"Missouri","Nodaway County",3,13,196,108,88
050,29,147,"Missouri","Nodaway County",3,14,195,111,84
050,29,147,"Missouri","Nodaway County",3,15,195,102,93
050,29,147,"Missouri","Nodaway County",3,16,203,112,91
050,29,147,"Missouri","Nodaway County",3,17,224,114,110
050,29,147,"Missouri","Nodaway County",3,18,351,146,205
050,29,147,"Missouri","Nodaway County",3,19,664,282,382
050,29,147,"Missouri","Nodaway County",3,20,946,418,528
050,29,147,"Missouri","Nodaway County",3,21,1094,497,597
050,29,147,"Missouri","Nodaway County",3,22,966,491,475
050,29,147,"Missouri","Nodaway County",3,23,478,295,183
050,29,147,"Missouri","Nodaway County",3,24,358,192,166
050,29,147,"Missouri","Nodaway County",3,25,277,159,118
050,29,147,"Missouri","Nodaway County",3,26,236,129,107
050,29,147,"Missouri","Nodaway County",3,27,237,124,113
050,29,147,"Missouri","Nodaway County",3,28,235,125,110
050,29,147,"Missouri","Nodaway County",3,29,250,140,110
050,29,147,"Missouri","Nodaway County",3,30,246,138,108
050,29,147,"Missouri","Nodaway County",3,31,211,118,93
050,29,147,"Missouri","Nodaway County",3,32,216,134,82
050,29,147,"Missouri","Nodaway County",3,33,191,116,75
050,29,147,"Missouri","Nodaway County",3,34,198,104,94
050,29,147,"Missouri","Nodaway County",3,35,212,103,109
050,29,147,"Missouri","Nodaway County",3,36,211,104,107
050,29,147,"Missouri","Nodaway County",3,37,201,106,95
050,29,147,"Missouri","Nodaway County",3,38,220,117,103
050,29,147,"Missouri","Nodaway County",3,39,243,135,108
050,29,147,"Missouri","Nodaway County",3,40,244,129,115
050,29,147,"Missouri","Nodaway County",3,41,243,132,111
050,29,147,"Missouri","Nodaway County",3,42,223,117,106
050,29,147,"Missouri","Nodaway County",3,43,207,110,97
050,29,147,"Missouri","Nodaway County",3,44,178,102,76
050,29,147,"Missouri","Nodaway County",3,45,182,96,86
050,29,147,"Missouri","Nodaway County",3,46,188,91,97
050,29,147,"Missouri","Nodaway County",3,47,192,92,100
050,29,147,"Missouri","Nodaway County",3,48,179,97,82
050,29,147,"Missouri","Nodaway County",3,49,198,106,92
050,29,147,"Missouri","Nodaway County",3,50,217,106,111
050,29,147,"Missouri","Nodaway County",3,51,187,91,96
050,29,147,"Missouri","Nodaway County",3,52,183,94,89
050,29,147,"Missouri","Nodaway County",3,53,176,85,91
050,29,147,"Missouri","Nodaway County",3,54,215,110,105
050,29,147,"Missouri","Nodaway County",3,55,233,124,109
050,29,147,"Missouri","Nodaway County",3,56,241,117,124
050,29,147,"Missouri","Nodaway County",3,57,263,133,130
050,29,147,"Missouri","Nodaway County",3,58,264,131,133
050,29,147,"Missouri","Nodaway County",3,59,259,132,127
050,29,147,"Missouri","Nodaway County",3,60,251,131,120
050,29,147,"Missouri","Nodaway County",3,61,246,120,126
050,29,147,"Missouri","Nodaway County",3,62,239,119,120
050,29,147,"Missouri","Nodaway County",3,63,225,121,104
050,29,147,"Missouri","Nodaway County",3,64,240,128,112
050,29,147,"Missouri","Nodaway County",3,65,229,109,120
050,29,147,"Missouri","Nodaway County",3,66,234,111,123
050,29,147,"Missouri","Nodaway County",3,67,222,105,117
050,29,147,"Missouri","Nodaway County",3,68,220,103,117
050,29,147,"Missouri","Nodaway County",3,69,218,106,112
050,29,147,"Missouri","Nodaway County",3,70,201,98,103
050,29,147,"Missouri","Nodaway County",3,71,176,82,94
050,29,147,"Missouri","Nodaway County",3,72,164,77,87
050,29,147,"Missouri","Nodaway County",3,73,175,85,90
050,29,147,"Missouri","Nodaway County",3,74,171,89,82
050,29,147,"Missouri","Nodaway County",3,75,118,61,57
050,29,147,"Missouri","Nodaway County",3,76,135,63,72
050,29,147,"Missouri","Nodaway County",3,77,136,65,71
050,29,147,"Missouri","Nodaway County",3,78,139,62,77
050,29,147,"Missouri","Nodaway County",3,79,114,46,68
050,29,147,"Missouri","Nodaway County",3,80,108,45,63
050,29,147,"Missouri","Nodaway County",3,81,101,45,56
050,29,147,"Missouri","Nodaway County",3,82,99,44,55
050,29,147,"Missouri","Nodaway County",3,83,87,37,50
050,29,147,"Missouri","Nodaway County",3,84,82,34,48
050,29,147,"Missouri","Nodaway County",3,85,527,188,339
050,29,147,"Missouri","Nodaway County",4,0,210,99,111
050,29,147,"Missouri","Nodaway County",4,1,207,97,110
050,29,147,"Missouri","Nodaway County",4,2,216,111,105
050,29,147,"Missouri","Nodaway County",4,3,201,100,101
050,29,147,"Missouri","Nodaway County",4,4,178,102,76
050,29,147,"Missouri","Nodaway County",4,5,203,111,92
050,29,147,"Missouri","Nodaway County",4,6,212,116,96
050,29,147,"Missouri","Nodaway County",4,7,196,96,100
050,29,147,"Missouri","Nodaway County",4,8,189,90,99
050,29,147,"Missouri","Nodaway County",4,9,181,88,93
050,29,147,"Missouri","Nodaway County",4,10,197,103,94
050,29,147,"Missouri","Nodaway County",4,11,183,101,82
050,29,147,"Missouri","Nodaway County",4,12,191,99,92
050,29,147,"Missouri","Nodaway County",4,13,197,104,93
050,29,147,"Missouri","Nodaway County",4,14,197,109,88
050,29,147,"Missouri","Nodaway County",4,15,191,109,82
050,29,147,"Missouri","Nodaway County",4,16,215,105,110
050,29,147,"Missouri","Nodaway County",4,17,226,121,105
050,29,147,"Missouri","Nodaway County",4,18,352,149,203
050,29,147,"Missouri","Nodaway County",4,19,646,276,370
050,29,147,"Missouri","Nodaway County",4,20,919,413,506
050,29,147,"Missouri","Nodaway County",4,21,1078,481,597
050,29,147,"Missouri","Nodaway County",4,22,946,494,452
050,29,147,"Missouri","Nodaway County",4,23,527,311,216
050,29,147,"Missouri","Nodaway County",4,24,352,193,159
050,29,147,"Missouri","Nodaway County",4,25,273,146,127
050,29,147,"Missouri","Nodaway County",4,26,221,126,95
050,29,147,"Missouri","Nodaway County",4,27,209,116,93
050,29,147,"Missouri","Nodaway County",4,28,223,120,103
050,29,147,"Missouri","Nodaway County",4,29,228,124,104
050,29,147,"Missouri","Nodaway County",4,30,225,116,109
050,29,147,"Missouri","Nodaway County",4,31,233,125,108
050,29,147,"Missouri","Nodaway County",4,32,203,110,93
050,29,147,"Missouri","Nodaway County",4,33,211,131,80
050,29,147,"Missouri","Nodaway County",4,34,187,113,74
050,29,147,"Missouri","Nodaway County",4,35,187,94,93
050,29,147,"Missouri","Nodaway County",4,36,205,96,109
050,29,147,"Missouri","Nodaway County",4,37,208,98,110
050,29,147,"Missouri","Nodaway County",4,38,194,101,93
050,29,147,"Missouri","Nodaway County",4,39,213,114,99
050,29,147,"Missouri","Nodaway County",4,40,225,119,106
050,29,147,"Missouri","Nodaway County",4,41,236,122,114
050,29,147,"Missouri","Nodaway County",4,42,241,128,113
050,29,147,"Missouri","Nodaway County",4,43,218,113,105
050,29,147,"Missouri","Nodaway County",4,44,203,106,97
050,29,147,"Missouri","Nodaway County",4,45,175,95,80
050,29,147,"Missouri","Nodaway County",4,46,175,92,83
050,29,147,"Missouri","Nodaway County",4,47,181,87,94
050,29,147,"Missouri","Nodaway County",4,48,181,83,98
050,29,147,"Missouri","Nodaway County",4,49,182,97,85
050,29,147,"Missouri","Nodaway County",4,50,192,103,89
050,29,147,"Missouri","Nodaway County",4,51,198,96,102
050,29,147,"Missouri","Nodaway County",4,52,183,88,95
050,29,147,"Missouri","Nodaway County",4,53,182,89,93
050,29,147,"Missouri","Nodaway County",4,54,179,86,93
050,29,147,"Missouri","Nodaway County",4,55,205,106,99
050,29,147,"Missouri","Nodaway County",4,56,234,120,114
050,29,147,"Missouri","Nodaway County",4,57,252,125,127
050,29,147,"Missouri","Nodaway County",4,58,250,126,124
050,29,147,"Missouri","Nodaway County",4,59,252,128,124
050,29,147,"Missouri","Nodaway County",4,60,249,129,120
050,29,147,"Missouri","Nodaway County",4,61,253,128,125
050,29,147,"Missouri","Nodaway County",4,62,243,118,125
050,29,147,"Missouri","Nodaway County",4,63,231,113,118
050,29,147,"Missouri","Nodaway County",4,64,223,123,100
050,29,147,"Missouri","Nodaway County",4,65,231,124,107
050,29,147,"Missouri","Nodaway County",4,66,225,112,113
050,29,147,"Missouri","Nodaway County",4,67,241,113,128
050,29,147,"Missouri","Nodaway County",4,68,213,97,116
050,29,147,"Missouri","Nodaway County",4,69,210,94,116
050,29,147,"Missouri","Nodaway County",4,70,218,105,113
050,29,147,"Missouri","Nodaway County",4,71,194,94,100
050,29,147,"Missouri","Nodaway County",4,72,173,81,92
050,29,147,"Missouri","Nodaway County",4,73,159,74,85
050,29,147,"Missouri","Nodaway County",4,74,167,80,87
050,29,147,"Missouri","Nodaway County",4,75,164,84,80
050,29,147,"Missouri","Nodaway County",4,76,120,61,59
050,29,147,"Missouri","Nodaway County",4,77,138,66,72
050,29,147,"Missouri","Nodaway County",4,78,136,67,69
050,29,147,"Missouri","Nodaway County",4,79,126,54,72
050,29,147,"Missouri","Nodaway County",4,80,108,41,67
050,29,147,"Missouri","Nodaway County",4,81,104,44,60
050,29,147,"Missouri","Nodaway County",4,82,97,41,56
050,29,147,"Missouri","Nodaway County",4,83,97,42,55
050,29,147,"Missouri","Nodaway County",4,84,83,36,47
050,29,147,"Missouri","Nodaway County",4,85,538,191,347
050,29,147,"Missouri","Nodaway County",5,0,211,100,111
050,29,147,"Missouri","Nodaway County",5,1,197,91,106
050,29,147,"Missouri","Nodaway County",5,2,202,94,108
050,29,147,"Missouri","Nodaway County",5,3,205,105,100
050,29,147,"Missouri","Nodaway County",5,4,200,97,103
050,29,147,"Missouri","Nodaway County",5,5,174,97,77
050,29,147,"Missouri","Nodaway County",5,6,195,107,88
050,29,147,"Missouri","Nodaway County",5,7,208,114,94
050,29,147,"Missouri","Nodaway County",5,8,186,92,94
050,29,147,"Missouri","Nodaway County",5,9,191,95,96
050,29,147,"Missouri","Nodaway County",5,10,178,84,94
050,29,147,"Missouri","Nodaway County",5,11,198,103,95
050,29,147,"Missouri","Nodaway County",5,12,178,97,81
050,29,147,"Missouri","Nodaway County",5,13,199,105,94
050,29,147,"Missouri","Nodaway County",5,14,200,104,96
050,29,147,"Missouri","Nodaway County",5,15,197,109,88
050,29,147,"Missouri","Nodaway County",5,16,211,115,96
050,29,147,"Missouri","Nodaway County",5,17,231,122,109
050,29,147,"Missouri","Nodaway County",5,18,345,147,198
050,29,147,"Missouri","Nodaway County",5,19,654,282,372
050,29,147,"Missouri","Nodaway County",5,20,919,416,503
050,29,147,"Missouri","Nodaway County",5,21,1032,455,577
050,29,147,"Missouri","Nodaway County",5,22,928,466,462
050,29,147,"Missouri","Nodaway County",5,23,516,316,200
050,29,147,"Missouri","Nodaway County",5,24,379,197,182
050,29,147,"Missouri","Nodaway County",5,25,280,169,111
050,29,147,"Missouri","Nodaway County",5,26,221,121,100
050,29,147,"Missouri","Nodaway County",5,27,211,131,80
050,29,147,"Missouri","Nodaway County",5,28,200,119,81
050,29,147,"Missouri","Nodaway County",5,29,219,119,100
050,29,147,"Missouri","Nodaway County",5,30,231,136,95
050,29,147,"Missouri","Nodaway County",5,31,224,120,104
050,29,147,"Missouri","Nodaway County",5,32,224,130,94
050,29,147,"Missouri","Nodaway County",5,33,201,112,89
050,29,147,"Missouri","Nodaway County",5,34,211,130,81
050,29,147,"Missouri","Nodaway County",5,35,187,116,71
050,29,147,"Missouri","Nodaway County",5,36,189,99,90
050,29,147,"Missouri","Nodaway County",5,37,205,94,111
050,29,147,"Missouri","Nodaway County",5,38,215,106,109
050,29,147,"Missouri","Nodaway County",5,39,204,109,95
050,29,147,"Missouri","Nodaway County",5,40,215,111,104
050,29,147,"Missouri","Nodaway County",5,41,227,123,104
050,29,147,"Missouri","Nodaway County",5,42,238,124,114
050,29,147,"Missouri","Nodaway County",5,43,241,137,104
050,29,147,"Missouri","Nodaway County",5,44,218,115,103
050,29,147,"Missouri","Nodaway County",5,45,202,109,93
050,29,147,"Missouri","Nodaway County",5,46,176,98,78
050,29,147,"Missouri","Nodaway County",5,47,180,100,80
050,29,147,"Missouri","Nodaway County",5,48,181,90,91
050,29,147,"Missouri","Nodaway County",5,49,194,93,101
050,29,147,"Missouri","Nodaway County",5,50,179,99,80
050,29,147,"Missouri","Nodaway County",5,51,186,100,86
050,29,147,"Missouri","Nodaway County",5,52,205,100,105
050,29,147,"Missouri","Nodaway County",5,53,181,84,97
050,29,147,"Missouri","Nodaway County",5,54,192,99,93
050,29,147,"Missouri","Nodaway County",5,55,177,90,87
050,29,147,"Missouri","Nodaway County",5,56,206,103,103
050,29,147,"Missouri","Nodaway County",5,57,241,127,114
050,29,147,"Missouri","Nodaway County",5,58,242,124,118
050,29,147,"Missouri","Nodaway County",5,59,238,123,115
050,29,147,"Missouri","Nodaway County",5,60,245,121,124
050,29,147,"Missouri","Nodaway County",5,61,246,124,122
050,29,147,"Missouri","Nodaway County",5,62,247,126,121
050,29,147,"Missouri","Nodaway County",5,63,241,117,124
050,29,147,"Missouri","Nodaway County",5,64,228,114,114
050,29,147,"Missouri","Nodaway County",5,65,213,116,97
050,29,147,"Missouri","Nodaway County",5,66,223,122,101
050,29,147,"Missouri","Nodaway County",5,67,228,111,117
050,29,147,"Missouri","Nodaway County",5,68,233,107,126
050,29,147,"Missouri","Nodaway County",5,69,209,95,114
050,29,147,"Missouri","Nodaway County",5,70,208,92,116
050,29,147,"Missouri","Nodaway County",5,71,214,103,111
050,29,147,"Missouri","Nodaway County",5,72,195,95,100
050,29,147,"Missouri","Nodaway County",5,73,170,77,93
050,29,147,"Missouri","Nodaway County",5,74,152,70,82
050,29,147,"Missouri","Nodaway County",5,75,161,76,85
050,29,147,"Missouri","Nodaway County",5,76,164,82,82
050,29,147,"Missouri","Nodaway County",5,77,118,62,56
050,29,147,"Missouri","Nodaway County",5,78,137,66,71
050,29,147,"Missouri","Nodaway County",5,79,127,63,64
050,29,147,"Missouri","Nodaway County",5,80,119,48,71
050,29,147,"Missouri","Nodaway County",5,81,106,42,64
050,29,147,"Missouri","Nodaway County",5,82,99,39,60
050,29,147,"Missouri","Nodaway County",5,83,89,37,52
050,29,147,"Missouri","Nodaway County",5,84,97,43,54
050,29,147,"Missouri","Nodaway County",5,85,551,205,346
050,29,149,"Missouri","Oregon County",1,0,95,48,47
050,29,149,"Missouri","Oregon County",1,1,90,42,48
050,29,149,"Missouri","Oregon County",1,2,98,54,44
050,29,149,"Missouri","Oregon County",1,3,100,55,45
050,29,149,"Missouri","Oregon County",1,4,99,57,42
050,29,149,"Missouri","Oregon County",1,5,111,65,46
050,29,149,"Missouri","Oregon County",1,6,102,59,43
050,29,149,"Missouri","Oregon County",1,7,102,48,54
050,29,149,"Missouri","Oregon County",1,8,120,61,59
050,29,149,"Missouri","Oregon County",1,9,113,59,54
050,29,149,"Missouri","Oregon County",1,10,113,60,53
050,29,149,"Missouri","Oregon County",1,11,113,63,50
050,29,149,"Missouri","Oregon County",1,12,119,58,61
050,29,149,"Missouri","Oregon County",1,13,112,62,50
050,29,149,"Missouri","Oregon County",1,14,128,70,58
050,29,149,"Missouri","Oregon County",1,15,123,63,60
050,29,149,"Missouri","Oregon County",1,16,121,49,72
050,29,149,"Missouri","Oregon County",1,17,119,53,66
050,29,149,"Missouri","Oregon County",1,18,95,48,47
050,29,149,"Missouri","Oregon County",1,19,75,39,36
050,29,149,"Missouri","Oregon County",1,20,67,31,36
050,29,149,"Missouri","Oregon County",1,21,78,39,39
050,29,149,"Missouri","Oregon County",1,22,82,41,41
050,29,149,"Missouri","Oregon County",1,23,70,31,39
050,29,149,"Missouri","Oregon County",1,24,86,43,43
050,29,149,"Missouri","Oregon County",1,25,84,46,38
050,29,149,"Missouri","Oregon County",1,26,85,45,40
050,29,149,"Missouri","Oregon County",1,27,103,54,49
050,29,149,"Missouri","Oregon County",1,28,93,48,45
050,29,149,"Missouri","Oregon County",1,29,95,47,48
050,29,149,"Missouri","Oregon County",1,30,96,51,45
050,29,149,"Missouri","Oregon County",1,31,78,35,43
050,29,149,"Missouri","Oregon County",1,32,96,47,49
050,29,149,"Missouri","Oregon County",1,33,81,39,42
050,29,149,"Missouri","Oregon County",1,34,78,40,38
050,29,149,"Missouri","Oregon County",1,35,68,30,38
050,29,149,"Missouri","Oregon County",1,36,89,40,49
050,29,149,"Missouri","Oregon County",1,37,87,41,46
050,29,149,"Missouri","Oregon County",1,38,76,40,36
050,29,149,"Missouri","Oregon County",1,39,94,48,46
050,29,149,"Missouri","Oregon County",1,40,84,42,42
050,29,149,"Missouri","Oregon County",1,41,91,40,51
050,29,149,"Missouri","Oregon County",1,42,87,46,41
050,29,149,"Missouri","Oregon County",1,43,76,36,40
050,29,149,"Missouri","Oregon County",1,44,91,46,45
050,29,149,"Missouri","Oregon County",1,45,98,52,46
050,29,149,"Missouri","Oregon County",1,46,89,49,40
050,29,149,"Missouri","Oregon County",1,47,87,40,47
050,29,149,"Missouri","Oregon County",1,48,100,48,52
050,29,149,"Missouri","Oregon County",1,49,107,58,49
050,29,149,"Missouri","Oregon County",1,50,87,40,47
050,29,149,"Missouri","Oregon County",1,51,107,55,52
050,29,149,"Missouri","Oregon County",1,52,111,51,60
050,29,149,"Missouri","Oregon County",1,53,111,58,53
050,29,149,"Missouri","Oregon County",1,54,103,53,50
050,29,149,"Missouri","Oregon County",1,55,121,64,57
050,29,149,"Missouri","Oregon County",1,56,143,73,70
050,29,149,"Missouri","Oregon County",1,57,138,61,77
050,29,149,"Missouri","Oregon County",1,58,154,71,83
050,29,149,"Missouri","Oregon County",1,59,150,81,69
050,29,149,"Missouri","Oregon County",1,60,143,79,64
050,29,149,"Missouri","Oregon County",1,61,127,65,62
050,29,149,"Missouri","Oregon County",1,62,136,67,69
050,29,149,"Missouri","Oregon County",1,63,143,70,73
050,29,149,"Missouri","Oregon County",1,64,128,70,58
050,29,149,"Missouri","Oregon County",1,65,120,61,59
050,29,149,"Missouri","Oregon County",1,66,122,61,61
050,29,149,"Missouri","Oregon County",1,67,129,59,70
050,29,149,"Missouri","Oregon County",1,68,120,54,66
050,29,149,"Missouri","Oregon County",1,69,113,66,47
050,29,149,"Missouri","Oregon County",1,70,105,50,55
050,29,149,"Missouri","Oregon County",1,71,105,50,55
050,29,149,"Missouri","Oregon County",1,72,114,54,60
050,29,149,"Missouri","Oregon County",1,73,121,61,60
050,29,149,"Missouri","Oregon County",1,74,83,41,42
050,29,149,"Missouri","Oregon County",1,75,82,37,45
050,29,149,"Missouri","Oregon County",1,76,76,35,41
050,29,149,"Missouri","Oregon County",1,77,73,34,39
050,29,149,"Missouri","Oregon County",1,78,78,41,37
050,29,149,"Missouri","Oregon County",1,79,67,35,32
050,29,149,"Missouri","Oregon County",1,80,69,30,39
050,29,149,"Missouri","Oregon County",1,81,64,29,35
050,29,149,"Missouri","Oregon County",1,82,50,26,24
050,29,149,"Missouri","Oregon County",1,83,44,21,23
050,29,149,"Missouri","Oregon County",1,84,36,16,20
050,29,149,"Missouri","Oregon County",1,85,219,77,142
050,29,149,"Missouri","Oregon County",2,0,93,46,47
050,29,149,"Missouri","Oregon County",2,1,90,44,46
050,29,149,"Missouri","Oregon County",2,2,96,51,45
050,29,149,"Missouri","Oregon County",2,3,99,54,45
050,29,149,"Missouri","Oregon County",2,4,99,56,43
050,29,149,"Missouri","Oregon County",2,5,108,62,46
050,29,149,"Missouri","Oregon County",2,6,102,59,43
050,29,149,"Missouri","Oregon County",2,7,104,51,53
050,29,149,"Missouri","Oregon County",2,8,115,58,57
050,29,149,"Missouri","Oregon County",2,9,113,60,53
050,29,149,"Missouri","Oregon County",2,10,114,61,53
050,29,149,"Missouri","Oregon County",2,11,114,63,51
050,29,149,"Missouri","Oregon County",2,12,118,59,59
050,29,149,"Missouri","Oregon County",2,13,114,61,53
050,29,149,"Missouri","Oregon County",2,14,125,67,58
050,29,149,"Missouri","Oregon County",2,15,123,63,60
050,29,149,"Missouri","Oregon County",2,16,121,53,68
050,29,149,"Missouri","Oregon County",2,17,121,53,68
050,29,149,"Missouri","Oregon County",2,18,96,48,48
050,29,149,"Missouri","Oregon County",2,19,76,39,37
050,29,149,"Missouri","Oregon County",2,20,70,33,37
050,29,149,"Missouri","Oregon County",2,21,77,38,39
050,29,149,"Missouri","Oregon County",2,22,81,40,41
050,29,149,"Missouri","Oregon County",2,23,74,34,40
050,29,149,"Missouri","Oregon County",2,24,81,41,40
050,29,149,"Missouri","Oregon County",2,25,83,45,38
050,29,149,"Missouri","Oregon County",2,26,88,47,41
050,29,149,"Missouri","Oregon County",2,27,98,51,47
050,29,149,"Missouri","Oregon County",2,28,94,48,46
050,29,149,"Missouri","Oregon County",2,29,94,47,47
050,29,149,"Missouri","Oregon County",2,30,95,49,46
050,29,149,"Missouri","Oregon County",2,31,82,38,44
050,29,149,"Missouri","Oregon County",2,32,92,44,48
050,29,149,"Missouri","Oregon County",2,33,85,42,43
050,29,149,"Missouri","Oregon County",2,34,78,40,38
050,29,149,"Missouri","Oregon County",2,35,71,33,38
050,29,149,"Missouri","Oregon County",2,36,83,37,46
050,29,149,"Missouri","Oregon County",2,37,87,40,47
050,29,149,"Missouri","Oregon County",2,38,80,40,40
050,29,149,"Missouri","Oregon County",2,39,91,46,45
050,29,149,"Missouri","Oregon County",2,40,88,44,44
050,29,149,"Missouri","Oregon County",2,41,91,41,50
050,29,149,"Missouri","Oregon County",2,42,88,45,43
050,29,149,"Missouri","Oregon County",2,43,80,39,41
050,29,149,"Missouri","Oregon County",2,44,87,43,44
050,29,149,"Missouri","Oregon County",2,45,96,51,45
050,29,149,"Missouri","Oregon County",2,46,91,50,41
050,29,149,"Missouri","Oregon County",2,47,86,41,45
050,29,149,"Missouri","Oregon County",2,48,98,47,51
050,29,149,"Missouri","Oregon County",2,49,105,55,50
050,29,149,"Missouri","Oregon County",2,50,92,44,48
050,29,149,"Missouri","Oregon County",2,51,103,51,52
050,29,149,"Missouri","Oregon County",2,52,111,53,58
050,29,149,"Missouri","Oregon County",2,53,111,56,55
050,29,149,"Missouri","Oregon County",2,54,103,53,50
050,29,149,"Missouri","Oregon County",2,55,115,60,55
050,29,149,"Missouri","Oregon County",2,56,139,71,68
050,29,149,"Missouri","Oregon County",2,57,138,64,74
050,29,149,"Missouri","Oregon County",2,58,147,67,80
050,29,149,"Missouri","Oregon County",2,59,152,79,73
050,29,149,"Missouri","Oregon County",2,60,144,80,64
050,29,149,"Missouri","Oregon County",2,61,131,68,63
050,29,149,"Missouri","Oregon County",2,62,133,67,66
050,29,149,"Missouri","Oregon County",2,63,142,70,72
050,29,149,"Missouri","Oregon County",2,64,131,70,61
050,29,149,"Missouri","Oregon County",2,65,119,62,57
050,29,149,"Missouri","Oregon County",2,66,121,62,59
050,29,149,"Missouri","Oregon County",2,67,127,59,68
050,29,149,"Missouri","Oregon County",2,68,119,53,66
050,29,149,"Missouri","Oregon County",2,69,114,63,51
050,29,149,"Missouri","Oregon County",2,70,106,54,52
050,29,149,"Missouri","Oregon County",2,71,103,49,54
050,29,149,"Missouri","Oregon County",2,72,110,52,58
050,29,149,"Missouri","Oregon County",2,73,126,63,63
050,29,149,"Missouri","Oregon County",2,74,85,42,43
050,29,149,"Missouri","Oregon County",2,75,80,36,44
050,29,149,"Missouri","Oregon County",2,76,76,34,42
050,29,149,"Missouri","Oregon County",2,77,75,35,40
050,29,149,"Missouri","Oregon County",2,78,75,38,37
050,29,149,"Missouri","Oregon County",2,79,66,33,33
050,29,149,"Missouri","Oregon County",2,80,67,31,36
050,29,149,"Missouri","Oregon County",2,81,64,30,34
050,29,149,"Missouri","Oregon County",2,82,52,27,25
050,29,149,"Missouri","Oregon County",2,83,44,21,23
050,29,149,"Missouri","Oregon County",2,84,36,17,19
050,29,149,"Missouri","Oregon County",2,85,216,75,141
050,29,149,"Missouri","Oregon County",3,0,104,50,54
050,29,149,"Missouri","Oregon County",3,1,103,49,54
050,29,149,"Missouri","Oregon County",3,2,98,47,51
050,29,149,"Missouri","Oregon County",3,3,100,55,45
050,29,149,"Missouri","Oregon County",3,4,95,47,48
050,29,149,"Missouri","Oregon County",3,5,102,54,48
050,29,149,"Missouri","Oregon County",3,6,100,55,45
050,29,149,"Missouri","Oregon County",3,7,111,64,47
050,29,149,"Missouri","Oregon County",3,8,111,53,58
050,29,149,"Missouri","Oregon County",3,9,120,61,59
050,29,149,"Missouri","Oregon County",3,10,116,60,56
050,29,149,"Missouri","Oregon County",3,11,112,59,53
050,29,149,"Missouri","Oregon County",3,12,114,66,48
050,29,149,"Missouri","Oregon County",3,13,119,56,63
050,29,149,"Missouri","Oregon County",3,14,111,60,51
050,29,149,"Missouri","Oregon County",3,15,127,68,59
050,29,149,"Missouri","Oregon County",3,16,124,64,60
050,29,149,"Missouri","Oregon County",3,17,122,59,63
050,29,149,"Missouri","Oregon County",3,18,97,45,52
050,29,149,"Missouri","Oregon County",3,19,73,36,37
050,29,149,"Missouri","Oregon County",3,20,75,37,38
050,29,149,"Missouri","Oregon County",3,21,66,34,32
050,29,149,"Missouri","Oregon County",3,22,85,43,42
050,29,149,"Missouri","Oregon County",3,23,86,43,43
050,29,149,"Missouri","Oregon County",3,24,72,34,38
050,29,149,"Missouri","Oregon County",3,25,93,49,44
050,29,149,"Missouri","Oregon County",3,26,78,40,38
050,29,149,"Missouri","Oregon County",3,27,97,51,46
050,29,149,"Missouri","Oregon County",3,28,95,49,46
050,29,149,"Missouri","Oregon County",3,29,100,52,48
050,29,149,"Missouri","Oregon County",3,30,92,47,45
050,29,149,"Missouri","Oregon County",3,31,98,48,50
050,29,149,"Missouri","Oregon County",3,32,80,36,44
050,29,149,"Missouri","Oregon County",3,33,86,39,47
050,29,149,"Missouri","Oregon County",3,34,87,42,45
050,29,149,"Missouri","Oregon County",3,35,84,43,41
050,29,149,"Missouri","Oregon County",3,36,77,38,39
050,29,149,"Missouri","Oregon County",3,37,84,36,48
050,29,149,"Missouri","Oregon County",3,38,87,42,45
050,29,149,"Missouri","Oregon County",3,39,86,44,42
050,29,149,"Missouri","Oregon County",3,40,90,46,44
050,29,149,"Missouri","Oregon County",3,41,87,47,40
050,29,149,"Missouri","Oregon County",3,42,92,41,51
050,29,149,"Missouri","Oregon County",3,43,80,42,38
050,29,149,"Missouri","Oregon County",3,44,88,40,48
050,29,149,"Missouri","Oregon County",3,45,89,45,44
050,29,149,"Missouri","Oregon County",3,46,90,48,42
050,29,149,"Missouri","Oregon County",3,47,92,50,42
050,29,149,"Missouri","Oregon County",3,48,91,44,47
050,29,149,"Missouri","Oregon County",3,49,100,47,53
050,29,149,"Missouri","Oregon County",3,50,106,57,49
050,29,149,"Missouri","Oregon County",3,51,99,45,54
050,29,149,"Missouri","Oregon County",3,52,105,52,53
050,29,149,"Missouri","Oregon County",3,53,116,55,61
050,29,149,"Missouri","Oregon County",3,54,108,56,52
050,29,149,"Missouri","Oregon County",3,55,109,57,52
050,29,149,"Missouri","Oregon County",3,56,116,61,55
050,29,149,"Missouri","Oregon County",3,57,137,72,65
050,29,149,"Missouri","Oregon County",3,58,137,64,73
050,29,149,"Missouri","Oregon County",3,59,154,72,82
050,29,149,"Missouri","Oregon County",3,60,147,76,71
050,29,149,"Missouri","Oregon County",3,61,149,78,71
050,29,149,"Missouri","Oregon County",3,62,127,65,62
050,29,149,"Missouri","Oregon County",3,63,124,61,63
050,29,149,"Missouri","Oregon County",3,64,146,71,75
050,29,149,"Missouri","Oregon County",3,65,127,70,57
050,29,149,"Missouri","Oregon County",3,66,123,63,60
050,29,149,"Missouri","Oregon County",3,67,115,63,52
050,29,149,"Missouri","Oregon County",3,68,121,56,65
050,29,149,"Missouri","Oregon County",3,69,112,50,62
050,29,149,"Missouri","Oregon County",3,70,110,60,50
050,29,149,"Missouri","Oregon County",3,71,103,49,54
050,29,149,"Missouri","Oregon County",3,72,100,47,53
050,29,149,"Missouri","Oregon County",3,73,109,53,56
050,29,149,"Missouri","Oregon County",3,74,123,63,60
050,29,149,"Missouri","Oregon County",3,75,75,36,39
050,29,149,"Missouri","Oregon County",3,76,77,35,42
050,29,149,"Missouri","Oregon County",3,77,70,32,38
050,29,149,"Missouri","Oregon County",3,78,77,38,39
050,29,149,"Missouri","Oregon County",3,79,70,32,38
050,29,149,"Missouri","Oregon County",3,80,58,25,33
050,29,149,"Missouri","Oregon County",3,81,54,27,27
050,29,149,"Missouri","Oregon County",3,82,60,28,32
050,29,149,"Missouri","Oregon County",3,83,48,25,23
050,29,149,"Missouri","Oregon County",3,84,42,21,21
050,29,149,"Missouri","Oregon County",3,85,205,70,135
050,29,149,"Missouri","Oregon County",4,0,107,48,59
050,29,149,"Missouri","Oregon County",4,1,112,52,60
050,29,149,"Missouri","Oregon County",4,2,109,51,58
050,29,149,"Missouri","Oregon County",4,3,98,53,45
050,29,149,"Missouri","Oregon County",4,4,113,59,54
050,29,149,"Missouri","Oregon County",4,5,96,47,49
050,29,149,"Missouri","Oregon County",4,6,99,50,49
050,29,149,"Missouri","Oregon County",4,7,103,55,48
050,29,149,"Missouri","Oregon County",4,8,112,62,50
050,29,149,"Missouri","Oregon County",4,9,115,49,66
050,29,149,"Missouri","Oregon County",4,10,125,64,61
050,29,149,"Missouri","Oregon County",4,11,118,65,53
050,29,149,"Missouri","Oregon County",4,12,112,56,56
050,29,149,"Missouri","Oregon County",4,13,116,69,47
050,29,149,"Missouri","Oregon County",4,14,127,65,62
050,29,149,"Missouri","Oregon County",4,15,114,60,54
050,29,149,"Missouri","Oregon County",4,16,136,73,63
050,29,149,"Missouri","Oregon County",4,17,122,63,59
050,29,149,"Missouri","Oregon County",4,18,110,54,56
050,29,149,"Missouri","Oregon County",4,19,78,39,39
050,29,149,"Missouri","Oregon County",4,20,73,33,40
050,29,149,"Missouri","Oregon County",4,21,77,42,35
050,29,149,"Missouri","Oregon County",4,22,69,31,38
050,29,149,"Missouri","Oregon County",4,23,88,40,48
050,29,149,"Missouri","Oregon County",4,24,92,51,41
050,29,149,"Missouri","Oregon County",4,25,72,36,36
050,29,149,"Missouri","Oregon County",4,26,96,52,44
050,29,149,"Missouri","Oregon County",4,27,86,40,46
050,29,149,"Missouri","Oregon County",4,28,106,60,46
050,29,149,"Missouri","Oregon County",4,29,100,48,52
050,29,149,"Missouri","Oregon County",4,30,104,59,45
050,29,149,"Missouri","Oregon County",4,31,97,46,51
050,29,149,"Missouri","Oregon County",4,32,101,54,47
050,29,149,"Missouri","Oregon County",4,33,73,33,40
050,29,149,"Missouri","Oregon County",4,34,89,45,44
050,29,149,"Missouri","Oregon County",4,35,88,40,48
050,29,149,"Missouri","Oregon County",4,36,90,42,48
050,29,149,"Missouri","Oregon County",4,37,80,41,39
050,29,149,"Missouri","Oregon County",4,38,93,43,50
050,29,149,"Missouri","Oregon County",4,39,95,45,50
050,29,149,"Missouri","Oregon County",4,40,90,44,46
050,29,149,"Missouri","Oregon County",4,41,90,44,46
050,29,149,"Missouri","Oregon County",4,42,96,50,46
050,29,149,"Missouri","Oregon County",4,43,93,42,51
050,29,149,"Missouri","Oregon County",4,44,88,42,46
050,29,149,"Missouri","Oregon County",4,45,92,43,49
050,29,149,"Missouri","Oregon County",4,46,95,51,44
050,29,149,"Missouri","Oregon County",4,47,92,49,43
050,29,149,"Missouri","Oregon County",4,48,92,54,38
050,29,149,"Missouri","Oregon County",4,49,84,39,45
050,29,149,"Missouri","Oregon County",4,50,103,48,55
050,29,149,"Missouri","Oregon County",4,51,112,60,52
050,29,149,"Missouri","Oregon County",4,52,95,46,49
050,29,149,"Missouri","Oregon County",4,53,102,49,53
050,29,149,"Missouri","Oregon County",4,54,111,52,59
050,29,149,"Missouri","Oregon County",4,55,101,52,49
050,29,149,"Missouri","Oregon County",4,56,106,54,52
050,29,149,"Missouri","Oregon County",4,57,112,59,53
050,29,149,"Missouri","Oregon County",4,58,132,71,61
050,29,149,"Missouri","Oregon County",4,59,129,57,72
050,29,149,"Missouri","Oregon County",4,60,139,66,73
050,29,149,"Missouri","Oregon County",4,61,151,77,74
050,29,149,"Missouri","Oregon County",4,62,149,79,70
050,29,149,"Missouri","Oregon County",4,63,133,66,67
050,29,149,"Missouri","Oregon County",4,64,129,67,62
050,29,149,"Missouri","Oregon County",4,65,142,68,74
050,29,149,"Missouri","Oregon County",4,66,119,65,54
050,29,149,"Missouri","Oregon County",4,67,122,62,60
050,29,149,"Missouri","Oregon County",4,68,116,63,53
050,29,149,"Missouri","Oregon County",4,69,120,57,63
050,29,149,"Missouri","Oregon County",4,70,112,52,60
050,29,149,"Missouri","Oregon County",4,71,107,60,47
050,29,149,"Missouri","Oregon County",4,72,100,46,54
050,29,149,"Missouri","Oregon County",4,73,97,45,52
050,29,149,"Missouri","Oregon County",4,74,105,52,53
050,29,149,"Missouri","Oregon County",4,75,119,59,60
050,29,149,"Missouri","Oregon County",4,76,69,34,35
050,29,149,"Missouri","Oregon County",4,77,67,28,39
050,29,149,"Missouri","Oregon County",4,78,66,30,36
050,29,149,"Missouri","Oregon County",4,79,69,29,40
050,29,149,"Missouri","Oregon County",4,80,60,22,38
050,29,149,"Missouri","Oregon County",4,81,46,22,24
050,29,149,"Missouri","Oregon County",4,82,50,25,25
050,29,149,"Missouri","Oregon County",4,83,58,27,31
050,29,149,"Missouri","Oregon County",4,84,46,25,21
050,29,149,"Missouri","Oregon County",4,85,206,68,138
050,29,149,"Missouri","Oregon County",5,0,104,47,57
050,29,149,"Missouri","Oregon County",5,1,116,45,71
050,29,149,"Missouri","Oregon County",5,2,109,56,53
050,29,149,"Missouri","Oregon County",5,3,110,52,58
050,29,149,"Missouri","Oregon County",5,4,94,46,48
050,29,149,"Missouri","Oregon County",5,5,115,60,55
050,29,149,"Missouri","Oregon County",5,6,96,45,51
050,29,149,"Missouri","Oregon County",5,7,104,51,53
050,29,149,"Missouri","Oregon County",5,8,100,54,46
050,29,149,"Missouri","Oregon County",5,9,119,65,54
050,29,149,"Missouri","Oregon County",5,10,121,57,64
050,29,149,"Missouri","Oregon County",5,11,134,70,64
050,29,149,"Missouri","Oregon County",5,12,121,62,59
050,29,149,"Missouri","Oregon County",5,13,116,60,56
050,29,149,"Missouri","Oregon County",5,14,120,72,48
050,29,149,"Missouri","Oregon County",5,15,129,66,63
050,29,149,"Missouri","Oregon County",5,16,113,60,53
050,29,149,"Missouri","Oregon County",5,17,131,68,63
050,29,149,"Missouri","Oregon County",5,18,100,51,49
050,29,149,"Missouri","Oregon County",5,19,84,43,41
050,29,149,"Missouri","Oregon County",5,20,91,48,43
050,29,149,"Missouri","Oregon County",5,21,80,38,42
050,29,149,"Missouri","Oregon County",5,22,78,41,37
050,29,149,"Missouri","Oregon County",5,23,78,37,41
050,29,149,"Missouri","Oregon County",5,24,86,41,45
050,29,149,"Missouri","Oregon County",5,25,90,51,39
050,29,149,"Missouri","Oregon County",5,26,71,39,32
050,29,149,"Missouri","Oregon County",5,27,96,48,48
050,29,149,"Missouri","Oregon County",5,28,88,42,46
050,29,149,"Missouri","Oregon County",5,29,102,53,49
050,29,149,"Missouri","Oregon County",5,30,118,58,60
050,29,149,"Missouri","Oregon County",5,31,110,64,46
050,29,149,"Missouri","Oregon County",5,32,96,47,49
050,29,149,"Missouri","Oregon County",5,33,102,55,47
050,29,149,"Missouri","Oregon County",5,34,75,34,41
050,29,149,"Missouri","Oregon County",5,35,83,42,41
050,29,149,"Missouri","Oregon County",5,36,94,43,51
050,29,149,"Missouri","Oregon County",5,37,89,41,48
050,29,149,"Missouri","Oregon County",5,38,89,45,44
050,29,149,"Missouri","Oregon County",5,39,99,42,57
050,29,149,"Missouri","Oregon County",5,40,92,47,45
050,29,149,"Missouri","Oregon County",5,41,90,44,46
050,29,149,"Missouri","Oregon County",5,42,94,47,47
050,29,149,"Missouri","Oregon County",5,43,97,45,52
050,29,149,"Missouri","Oregon County",5,44,91,43,48
050,29,149,"Missouri","Oregon County",5,45,80,38,42
050,29,149,"Missouri","Oregon County",5,46,81,34,47
050,29,149,"Missouri","Oregon County",5,47,99,56,43
050,29,149,"Missouri","Oregon County",5,48,95,57,38
050,29,149,"Missouri","Oregon County",5,49,89,51,38
050,29,149,"Missouri","Oregon County",5,50,85,39,46
050,29,149,"Missouri","Oregon County",5,51,106,50,56
050,29,149,"Missouri","Oregon County",5,52,109,60,49
050,29,149,"Missouri","Oregon County",5,53,93,43,50
050,29,149,"Missouri","Oregon County",5,54,101,50,51
050,29,149,"Missouri","Oregon County",5,55,105,49,56
050,29,149,"Missouri","Oregon County",5,56,106,50,56
050,29,149,"Missouri","Oregon County",5,57,108,55,53
050,29,149,"Missouri","Oregon County",5,58,123,68,55
050,29,149,"Missouri","Oregon County",5,59,131,65,66
050,29,149,"Missouri","Oregon County",5,60,129,58,71
050,29,149,"Missouri","Oregon County",5,61,141,66,75
050,29,149,"Missouri","Oregon County",5,62,148,75,73
050,29,149,"Missouri","Oregon County",5,63,152,78,74
050,29,149,"Missouri","Oregon County",5,64,129,63,66
050,29,149,"Missouri","Oregon County",5,65,128,71,57
050,29,149,"Missouri","Oregon County",5,66,139,64,75
050,29,149,"Missouri","Oregon County",5,67,119,64,55
050,29,149,"Missouri","Oregon County",5,68,118,62,56
050,29,149,"Missouri","Oregon County",5,69,115,63,52
050,29,149,"Missouri","Oregon County",5,70,110,52,58
050,29,149,"Missouri","Oregon County",5,71,107,48,59
050,29,149,"Missouri","Oregon County",5,72,104,59,45
050,29,149,"Missouri","Oregon County",5,73,95,42,53
050,29,149,"Missouri","Oregon County",5,74,91,43,48
050,29,149,"Missouri","Oregon County",5,75,98,47,51
050,29,149,"Missouri","Oregon County",5,76,113,55,58
050,29,149,"Missouri","Oregon County",5,77,62,30,32
050,29,149,"Missouri","Oregon County",5,78,63,27,36
050,29,149,"Missouri","Oregon County",5,79,61,24,37
050,29,149,"Missouri","Oregon County",5,80,59,20,39
050,29,149,"Missouri","Oregon County",5,81,48,19,29
050,29,149,"Missouri","Oregon County",5,82,45,24,21
050,29,149,"Missouri","Oregon County",5,83,49,25,24
050,29,149,"Missouri","Oregon County",5,84,53,25,28
050,29,149,"Missouri","Oregon County",5,85,218,74,144
050,29,151,"Missouri","Osage County",1,0,138,70,68
050,29,151,"Missouri","Osage County",1,1,146,76,70
050,29,151,"Missouri","Osage County",1,2,146,72,74
050,29,151,"Missouri","Osage County",1,3,162,81,81
050,29,151,"Missouri","Osage County",1,4,151,75,76
050,29,151,"Missouri","Osage County",1,5,157,75,82
050,29,151,"Missouri","Osage County",1,6,143,77,66
050,29,151,"Missouri","Osage County",1,7,158,76,82
050,29,151,"Missouri","Osage County",1,8,163,79,84
050,29,151,"Missouri","Osage County",1,9,160,75,85
050,29,151,"Missouri","Osage County",1,10,164,83,81
050,29,151,"Missouri","Osage County",1,11,179,99,80
050,29,151,"Missouri","Osage County",1,12,196,111,85
050,29,151,"Missouri","Osage County",1,13,209,107,102
050,29,151,"Missouri","Osage County",1,14,203,103,100
050,29,151,"Missouri","Osage County",1,15,208,97,111
050,29,151,"Missouri","Osage County",1,16,203,105,98
050,29,151,"Missouri","Osage County",1,17,191,96,95
050,29,151,"Missouri","Osage County",1,18,170,94,76
050,29,151,"Missouri","Osage County",1,19,217,152,65
050,29,151,"Missouri","Osage County",1,20,177,106,71
050,29,151,"Missouri","Osage County",1,21,148,74,74
050,29,151,"Missouri","Osage County",1,22,152,83,69
050,29,151,"Missouri","Osage County",1,23,146,78,68
050,29,151,"Missouri","Osage County",1,24,139,72,67
050,29,151,"Missouri","Osage County",1,25,143,79,64
050,29,151,"Missouri","Osage County",1,26,144,71,73
050,29,151,"Missouri","Osage County",1,27,150,75,75
050,29,151,"Missouri","Osage County",1,28,155,89,66
050,29,151,"Missouri","Osage County",1,29,157,96,61
050,29,151,"Missouri","Osage County",1,30,152,75,77
050,29,151,"Missouri","Osage County",1,31,152,73,79
050,29,151,"Missouri","Osage County",1,32,130,64,66
050,29,151,"Missouri","Osage County",1,33,148,74,74
050,29,151,"Missouri","Osage County",1,34,131,62,69
050,29,151,"Missouri","Osage County",1,35,142,69,73
050,29,151,"Missouri","Osage County",1,36,146,74,72
050,29,151,"Missouri","Osage County",1,37,154,81,73
050,29,151,"Missouri","Osage County",1,38,157,81,76
050,29,151,"Missouri","Osage County",1,39,163,90,73
050,29,151,"Missouri","Osage County",1,40,161,82,79
050,29,151,"Missouri","Osage County",1,41,170,83,87
050,29,151,"Missouri","Osage County",1,42,162,86,76
050,29,151,"Missouri","Osage County",1,43,148,81,67
050,29,151,"Missouri","Osage County",1,44,167,83,84
050,29,151,"Missouri","Osage County",1,45,144,72,72
050,29,151,"Missouri","Osage County",1,46,157,81,76
050,29,151,"Missouri","Osage County",1,47,154,85,69
050,29,151,"Missouri","Osage County",1,48,164,90,74
050,29,151,"Missouri","Osage County",1,49,180,93,87
050,29,151,"Missouri","Osage County",1,50,190,100,90
050,29,151,"Missouri","Osage County",1,51,177,92,85
050,29,151,"Missouri","Osage County",1,52,181,92,89
050,29,151,"Missouri","Osage County",1,53,173,87,86
050,29,151,"Missouri","Osage County",1,54,180,89,91
050,29,151,"Missouri","Osage County",1,55,195,97,98
050,29,151,"Missouri","Osage County",1,56,201,109,92
050,29,151,"Missouri","Osage County",1,57,202,108,94
050,29,151,"Missouri","Osage County",1,58,225,127,98
050,29,151,"Missouri","Osage County",1,59,218,117,101
050,29,151,"Missouri","Osage County",1,60,211,104,107
050,29,151,"Missouri","Osage County",1,61,192,95,97
050,29,151,"Missouri","Osage County",1,62,198,105,93
050,29,151,"Missouri","Osage County",1,63,186,97,89
050,29,151,"Missouri","Osage County",1,64,168,85,83
050,29,151,"Missouri","Osage County",1,65,181,98,83
050,29,151,"Missouri","Osage County",1,66,160,80,80
050,29,151,"Missouri","Osage County",1,67,153,79,74
050,29,151,"Missouri","Osage County",1,68,151,79,72
050,29,151,"Missouri","Osage County",1,69,136,65,71
050,29,151,"Missouri","Osage County",1,70,117,54,63
050,29,151,"Missouri","Osage County",1,71,119,63,56
050,29,151,"Missouri","Osage County",1,72,125,68,57
050,29,151,"Missouri","Osage County",1,73,115,62,53
050,29,151,"Missouri","Osage County",1,74,99,47,52
050,29,151,"Missouri","Osage County",1,75,86,43,43
050,29,151,"Missouri","Osage County",1,76,75,37,38
050,29,151,"Missouri","Osage County",1,77,85,42,43
050,29,151,"Missouri","Osage County",1,78,87,42,45
050,29,151,"Missouri","Osage County",1,79,76,33,43
050,29,151,"Missouri","Osage County",1,80,75,32,43
050,29,151,"Missouri","Osage County",1,81,71,30,41
050,29,151,"Missouri","Osage County",1,82,64,30,34
050,29,151,"Missouri","Osage County",1,83,49,20,29
050,29,151,"Missouri","Osage County",1,84,45,23,22
050,29,151,"Missouri","Osage County",1,85,252,96,156
050,29,151,"Missouri","Osage County",2,0,137,67,70
050,29,151,"Missouri","Osage County",2,1,145,75,70
050,29,151,"Missouri","Osage County",2,2,145,72,73
050,29,151,"Missouri","Osage County",2,3,155,78,77
050,29,151,"Missouri","Osage County",2,4,153,76,77
050,29,151,"Missouri","Osage County",2,5,154,74,80
050,29,151,"Missouri","Osage County",2,6,147,77,70
050,29,151,"Missouri","Osage County",2,7,155,76,79
050,29,151,"Missouri","Osage County",2,8,161,77,84
050,29,151,"Missouri","Osage County",2,9,158,74,84
050,29,151,"Missouri","Osage County",2,10,162,81,81
050,29,151,"Missouri","Osage County",2,11,176,95,81
050,29,151,"Missouri","Osage County",2,12,192,108,84
050,29,151,"Missouri","Osage County",2,13,205,107,98
050,29,151,"Missouri","Osage County",2,14,206,104,102
050,29,151,"Missouri","Osage County",2,15,205,98,107
050,29,151,"Missouri","Osage County",2,16,204,103,101
050,29,151,"Missouri","Osage County",2,17,195,99,96
050,29,151,"Missouri","Osage County",2,18,174,97,77
050,29,151,"Missouri","Osage County",2,19,214,148,66
050,29,151,"Missouri","Osage County",2,20,176,105,71
050,29,151,"Missouri","Osage County",2,21,150,77,73
050,29,151,"Missouri","Osage County",2,22,153,82,71
050,29,151,"Missouri","Osage County",2,23,148,79,69
050,29,151,"Missouri","Osage County",2,24,140,73,67
050,29,151,"Missouri","Osage County",2,25,144,77,67
050,29,151,"Missouri","Osage County",2,26,145,75,70
050,29,151,"Missouri","Osage County",2,27,148,74,74
050,29,151,"Missouri","Osage County",2,28,153,85,68
050,29,151,"Missouri","Osage County",2,29,156,93,63
050,29,151,"Missouri","Osage County",2,30,155,80,75
050,29,151,"Missouri","Osage County",2,31,151,73,78
050,29,151,"Missouri","Osage County",2,32,134,66,68
050,29,151,"Missouri","Osage County",2,33,141,71,70
050,29,151,"Missouri","Osage County",2,34,135,65,70
050,29,151,"Missouri","Osage County",2,35,141,68,73
050,29,151,"Missouri","Osage County",2,36,145,72,73
050,29,151,"Missouri","Osage County",2,37,153,80,73
050,29,151,"Missouri","Osage County",2,38,158,82,76
050,29,151,"Missouri","Osage County",2,39,161,88,73
050,29,151,"Missouri","Osage County",2,40,162,84,78
050,29,151,"Missouri","Osage County",2,41,168,83,85
050,29,151,"Missouri","Osage County",2,42,163,84,79
050,29,151,"Missouri","Osage County",2,43,153,83,70
050,29,151,"Missouri","Osage County",2,44,160,81,79
050,29,151,"Missouri","Osage County",2,45,149,74,75
050,29,151,"Missouri","Osage County",2,46,152,78,74
050,29,151,"Missouri","Osage County",2,47,154,84,70
050,29,151,"Missouri","Osage County",2,48,161,89,72
050,29,151,"Missouri","Osage County",2,49,176,92,84
050,29,151,"Missouri","Osage County",2,50,187,97,90
050,29,151,"Missouri","Osage County",2,51,178,92,86
050,29,151,"Missouri","Osage County",2,52,178,91,87
050,29,151,"Missouri","Osage County",2,53,176,88,88
050,29,151,"Missouri","Osage County",2,54,177,88,89
050,29,151,"Missouri","Osage County",2,55,189,93,96
050,29,151,"Missouri","Osage County",2,56,199,106,93
050,29,151,"Missouri","Osage County",2,57,202,109,93
050,29,151,"Missouri","Osage County",2,58,219,122,97
050,29,151,"Missouri","Osage County",2,59,221,120,101
050,29,151,"Missouri","Osage County",2,60,212,107,105
050,29,151,"Missouri","Osage County",2,61,196,97,99
050,29,151,"Missouri","Osage County",2,62,196,101,95
050,29,151,"Missouri","Osage County",2,63,192,101,91
050,29,151,"Missouri","Osage County",2,64,174,90,84
050,29,151,"Missouri","Osage County",2,65,178,94,84
050,29,151,"Missouri","Osage County",2,66,165,85,80
050,29,151,"Missouri","Osage County",2,67,155,79,76
050,29,151,"Missouri","Osage County",2,68,150,78,72
050,29,151,"Missouri","Osage County",2,69,137,68,69
050,29,151,"Missouri","Osage County",2,70,120,56,64
050,29,151,"Missouri","Osage County",2,71,119,61,58
050,29,151,"Missouri","Osage County",2,72,123,66,57
050,29,151,"Missouri","Osage County",2,73,122,66,56
050,29,151,"Missouri","Osage County",2,74,95,47,48
050,29,151,"Missouri","Osage County",2,75,89,44,45
050,29,151,"Missouri","Osage County",2,76,76,37,39
050,29,151,"Missouri","Osage County",2,77,86,42,44
050,29,151,"Missouri","Osage County",2,78,86,42,44
050,29,151,"Missouri","Osage County",2,79,77,34,43
050,29,151,"Missouri","Osage County",2,80,75,32,43
050,29,151,"Missouri","Osage County",2,81,72,31,41
050,29,151,"Missouri","Osage County",2,82,64,29,35
050,29,151,"Missouri","Osage County",2,83,50,20,30
050,29,151,"Missouri","Osage County",2,84,45,21,24
050,29,151,"Missouri","Osage County",2,85,251,94,157
050,29,151,"Missouri","Osage County",3,0,138,67,71
050,29,151,"Missouri","Osage County",3,1,151,70,81
050,29,151,"Missouri","Osage County",3,2,154,78,76
050,29,151,"Missouri","Osage County",3,3,154,78,76
050,29,151,"Missouri","Osage County",3,4,160,81,79
050,29,151,"Missouri","Osage County",3,5,170,82,88
050,29,151,"Missouri","Osage County",3,6,165,76,89
050,29,151,"Missouri","Osage County",3,7,150,76,74
050,29,151,"Missouri","Osage County",3,8,156,76,80
050,29,151,"Missouri","Osage County",3,9,159,77,82
050,29,151,"Missouri","Osage County",3,10,160,78,82
050,29,151,"Missouri","Osage County",3,11,171,87,84
050,29,151,"Missouri","Osage County",3,12,183,99,84
050,29,151,"Missouri","Osage County",3,13,192,106,86
050,29,151,"Missouri","Osage County",3,14,217,115,102
050,29,151,"Missouri","Osage County",3,15,205,103,102
050,29,151,"Missouri","Osage County",3,16,201,97,104
050,29,151,"Missouri","Osage County",3,17,206,101,105
050,29,151,"Missouri","Osage County",3,18,177,103,74
050,29,151,"Missouri","Osage County",3,19,218,158,60
050,29,151,"Missouri","Osage County",3,20,184,101,83
050,29,151,"Missouri","Osage County",3,21,153,86,67
050,29,151,"Missouri","Osage County",3,22,147,76,71
050,29,151,"Missouri","Osage County",3,23,163,88,75
050,29,151,"Missouri","Osage County",3,24,140,69,71
050,29,151,"Missouri","Osage County",3,25,141,75,66
050,29,151,"Missouri","Osage County",3,26,140,73,67
050,29,151,"Missouri","Osage County",3,27,152,76,76
050,29,151,"Missouri","Osage County",3,28,164,78,86
050,29,151,"Missouri","Osage County",3,29,168,92,76
050,29,151,"Missouri","Osage County",3,30,158,95,63
050,29,151,"Missouri","Osage County",3,31,157,84,73
050,29,151,"Missouri","Osage County",3,32,150,72,78
050,29,151,"Missouri","Osage County",3,33,138,70,68
050,29,151,"Missouri","Osage County",3,34,140,72,68
050,29,151,"Missouri","Osage County",3,35,143,70,73
050,29,151,"Missouri","Osage County",3,36,145,71,74
050,29,151,"Missouri","Osage County",3,37,151,72,79
050,29,151,"Missouri","Osage County",3,38,158,82,76
050,29,151,"Missouri","Osage County",3,39,161,87,74
050,29,151,"Missouri","Osage County",3,40,160,90,70
050,29,151,"Missouri","Osage County",3,41,172,88,84
050,29,151,"Missouri","Osage County",3,42,172,85,87
050,29,151,"Missouri","Osage County",3,43,166,84,82
050,29,151,"Missouri","Osage County",3,44,150,81,69
050,29,151,"Missouri","Osage County",3,45,161,78,83
050,29,151,"Missouri","Osage County",3,46,148,73,75
050,29,151,"Missouri","Osage County",3,47,150,78,72
050,29,151,"Missouri","Osage County",3,48,162,88,74
050,29,151,"Missouri","Osage County",3,49,154,84,70
050,29,151,"Missouri","Osage County",3,50,175,91,84
050,29,151,"Missouri","Osage County",3,51,189,97,92
050,29,151,"Missouri","Osage County",3,52,182,93,89
050,29,151,"Missouri","Osage County",3,53,178,89,89
050,29,151,"Missouri","Osage County",3,54,176,88,88
050,29,151,"Missouri","Osage County",3,55,172,88,84
050,29,151,"Missouri","Osage County",3,56,191,95,96
050,29,151,"Missouri","Osage County",3,57,203,109,94
050,29,151,"Missouri","Osage County",3,58,201,111,90
050,29,151,"Missouri","Osage County",3,59,210,118,92
050,29,151,"Missouri","Osage County",3,60,218,118,100
050,29,151,"Missouri","Osage County",3,61,207,102,105
050,29,151,"Missouri","Osage County",3,62,195,96,99
050,29,151,"Missouri","Osage County",3,63,192,98,94
050,29,151,"Missouri","Osage County",3,64,195,102,93
050,29,151,"Missouri","Osage County",3,65,176,90,86
050,29,151,"Missouri","Osage County",3,66,172,92,80
050,29,151,"Missouri","Osage County",3,67,163,84,79
050,29,151,"Missouri","Osage County",3,68,155,79,76
050,29,151,"Missouri","Osage County",3,69,141,71,70
050,29,151,"Missouri","Osage County",3,70,133,65,68
050,29,151,"Missouri","Osage County",3,71,121,56,65
050,29,151,"Missouri","Osage County",3,72,116,60,56
050,29,151,"Missouri","Osage County",3,73,121,65,56
050,29,151,"Missouri","Osage County",3,74,122,64,58
050,29,151,"Missouri","Osage County",3,75,88,42,46
050,29,151,"Missouri","Osage County",3,76,87,44,43
050,29,151,"Missouri","Osage County",3,77,75,35,40
050,29,151,"Missouri","Osage County",3,78,74,35,39
050,29,151,"Missouri","Osage County",3,79,80,38,42
050,29,151,"Missouri","Osage County",3,80,74,33,41
050,29,151,"Missouri","Osage County",3,81,75,35,40
050,29,151,"Missouri","Osage County",3,82,63,24,39
050,29,151,"Missouri","Osage County",3,83,59,27,32
050,29,151,"Missouri","Osage County",3,84,47,20,27
050,29,151,"Missouri","Osage County",3,85,237,87,150
050,29,151,"Missouri","Osage County",4,0,165,76,89
050,29,151,"Missouri","Osage County",4,1,131,69,62
050,29,151,"Missouri","Osage County",4,2,157,77,80
050,29,151,"Missouri","Osage County",4,3,155,80,75
050,29,151,"Missouri","Osage County",4,4,148,75,73
050,29,151,"Missouri","Osage County",4,5,168,85,83
050,29,151,"Missouri","Osage County",4,6,174,85,89
050,29,151,"Missouri","Osage County",4,7,161,76,85
050,29,151,"Missouri","Osage County",4,8,161,79,82
050,29,151,"Missouri","Osage County",4,9,164,81,83
050,29,151,"Missouri","Osage County",4,10,153,72,81
050,29,151,"Missouri","Osage County",4,11,164,78,86
050,29,151,"Missouri","Osage County",4,12,171,83,88
050,29,151,"Missouri","Osage County",4,13,188,102,86
050,29,151,"Missouri","Osage County",4,14,191,105,86
050,29,151,"Missouri","Osage County",4,15,216,109,107
050,29,151,"Missouri","Osage County",4,16,201,100,101
050,29,151,"Missouri","Osage County",4,17,203,101,102
050,29,151,"Missouri","Osage County",4,18,198,111,87
050,29,151,"Missouri","Osage County",4,19,221,160,61
050,29,151,"Missouri","Osage County",4,20,167,101,66
050,29,151,"Missouri","Osage County",4,21,165,80,85
050,29,151,"Missouri","Osage County",4,22,165,92,73
050,29,151,"Missouri","Osage County",4,23,147,76,71
050,29,151,"Missouri","Osage County",4,24,168,84,84
050,29,151,"Missouri","Osage County",4,25,139,71,68
050,29,151,"Missouri","Osage County",4,26,137,69,68
050,29,151,"Missouri","Osage County",4,27,131,69,62
050,29,151,"Missouri","Osage County",4,28,138,68,70
050,29,151,"Missouri","Osage County",4,29,159,75,84
050,29,151,"Missouri","Osage County",4,30,167,92,75
050,29,151,"Missouri","Osage County",4,31,158,95,63
050,29,151,"Missouri","Osage County",4,32,158,84,74
050,29,151,"Missouri","Osage County",4,33,146,67,79
050,29,151,"Missouri","Osage County",4,34,148,73,75
050,29,151,"Missouri","Osage County",4,35,142,73,69
050,29,151,"Missouri","Osage County",4,36,146,71,75
050,29,151,"Missouri","Osage County",4,37,143,72,71
050,29,151,"Missouri","Osage County",4,38,152,73,79
050,29,151,"Missouri","Osage County",4,39,159,81,78
050,29,151,"Missouri","Osage County",4,40,165,90,75
050,29,151,"Missouri","Osage County",4,41,165,94,71
050,29,151,"Missouri","Osage County",4,42,167,83,84
050,29,151,"Missouri","Osage County",4,43,178,89,89
050,29,151,"Missouri","Osage County",4,44,166,86,80
050,29,151,"Missouri","Osage County",4,45,145,79,66
050,29,151,"Missouri","Osage County",4,46,155,74,81
050,29,151,"Missouri","Osage County",4,47,152,76,76
050,29,151,"Missouri","Osage County",4,48,149,77,72
050,29,151,"Missouri","Osage County",4,49,160,89,71
050,29,151,"Missouri","Osage County",4,50,159,86,73
050,29,151,"Missouri","Osage County",4,51,174,94,80
050,29,151,"Missouri","Osage County",4,52,190,94,96
050,29,151,"Missouri","Osage County",4,53,182,92,90
050,29,151,"Missouri","Osage County",4,54,180,89,91
050,29,151,"Missouri","Osage County",4,55,175,86,89
050,29,151,"Missouri","Osage County",4,56,173,87,86
050,29,151,"Missouri","Osage County",4,57,183,88,95
050,29,151,"Missouri","Osage County",4,58,201,110,91
050,29,151,"Missouri","Osage County",4,59,195,107,88
050,29,151,"Missouri","Osage County",4,60,212,121,91
050,29,151,"Missouri","Osage County",4,61,218,117,101
050,29,151,"Missouri","Osage County",4,62,207,100,107
050,29,151,"Missouri","Osage County",4,63,201,99,102
050,29,151,"Missouri","Osage County",4,64,190,96,94
050,29,151,"Missouri","Osage County",4,65,197,102,95
050,29,151,"Missouri","Osage County",4,66,173,87,86
050,29,151,"Missouri","Osage County",4,67,169,89,80
050,29,151,"Missouri","Osage County",4,68,165,86,79
050,29,151,"Missouri","Osage County",4,69,149,77,72
050,29,151,"Missouri","Osage County",4,70,140,70,70
050,29,151,"Missouri","Osage County",4,71,130,63,67
050,29,151,"Missouri","Osage County",4,72,117,56,61
050,29,151,"Missouri","Osage County",4,73,115,57,58
050,29,151,"Missouri","Osage County",4,74,118,62,56
050,29,151,"Missouri","Osage County",4,75,112,60,52
050,29,151,"Missouri","Osage County",4,76,84,39,45
050,29,151,"Missouri","Osage County",4,77,81,39,42
050,29,151,"Missouri","Osage County",4,78,68,31,37
050,29,151,"Missouri","Osage County",4,79,68,31,37
050,29,151,"Missouri","Osage County",4,80,76,35,41
050,29,151,"Missouri","Osage County",4,81,71,34,37
050,29,151,"Missouri","Osage County",4,82,66,28,38
050,29,151,"Missouri","Osage County",4,83,54,20,34
050,29,151,"Missouri","Osage County",4,84,54,25,29
050,29,151,"Missouri","Osage County",4,85,224,74,150
050,29,151,"Missouri","Osage County",5,0,162,74,88
050,29,151,"Missouri","Osage County",5,1,177,84,93
050,29,151,"Missouri","Osage County",5,2,141,74,67
050,29,151,"Missouri","Osage County",5,3,174,83,91
050,29,151,"Missouri","Osage County",5,4,159,87,72
050,29,151,"Missouri","Osage County",5,5,151,81,70
050,29,151,"Missouri","Osage County",5,6,164,83,81
050,29,151,"Missouri","Osage County",5,7,181,90,91
050,29,151,"Missouri","Osage County",5,8,164,77,87
050,29,151,"Missouri","Osage County",5,9,159,81,78
050,29,151,"Missouri","Osage County",5,10,163,78,85
050,29,151,"Missouri","Osage County",5,11,158,77,81
050,29,151,"Missouri","Osage County",5,12,165,78,87
050,29,151,"Missouri","Osage County",5,13,171,83,88
050,29,151,"Missouri","Osage County",5,14,188,101,87
050,29,151,"Missouri","Osage County",5,15,189,102,87
050,29,151,"Missouri","Osage County",5,16,212,104,108
050,29,151,"Missouri","Osage County",5,17,201,102,99
050,29,151,"Missouri","Osage County",5,18,183,104,79
050,29,151,"Missouri","Osage County",5,19,227,161,66
050,29,151,"Missouri","Osage County",5,20,186,117,69
050,29,151,"Missouri","Osage County",5,21,151,85,66
050,29,151,"Missouri","Osage County",5,22,173,84,89
050,29,151,"Missouri","Osage County",5,23,169,85,84
050,29,151,"Missouri","Osage County",5,24,152,78,74
050,29,151,"Missouri","Osage County",5,25,170,91,79
050,29,151,"Missouri","Osage County",5,26,136,72,64
050,29,151,"Missouri","Osage County",5,27,135,68,67
050,29,151,"Missouri","Osage County",5,28,139,72,67
050,29,151,"Missouri","Osage County",5,29,130,64,66
050,29,151,"Missouri","Osage County",5,30,167,80,87
050,29,151,"Missouri","Osage County",5,31,167,92,75
050,29,151,"Missouri","Osage County",5,32,159,92,67
050,29,151,"Missouri","Osage County",5,33,165,87,78
050,29,151,"Missouri","Osage County",5,34,150,69,81
050,29,151,"Missouri","Osage County",5,35,147,70,77
050,29,151,"Missouri","Osage County",5,36,149,77,72
050,29,151,"Missouri","Osage County",5,37,145,71,74
050,29,151,"Missouri","Osage County",5,38,149,75,74
050,29,151,"Missouri","Osage County",5,39,153,75,78
050,29,151,"Missouri","Osage County",5,40,156,80,76
050,29,151,"Missouri","Osage County",5,41,166,90,76
050,29,151,"Missouri","Osage County",5,42,165,93,72
050,29,151,"Missouri","Osage County",5,43,166,84,82
050,29,151,"Missouri","Osage County",5,44,177,89,88
050,29,151,"Missouri","Osage County",5,45,171,91,80
050,29,151,"Missouri","Osage County",5,46,149,81,68
050,29,151,"Missouri","Osage County",5,47,150,71,79
050,29,151,"Missouri","Osage County",5,48,151,75,76
050,29,151,"Missouri","Osage County",5,49,146,77,69
050,29,151,"Missouri","Osage County",5,50,160,89,71
050,29,151,"Missouri","Osage County",5,51,153,83,70
050,29,151,"Missouri","Osage County",5,52,174,93,81
050,29,151,"Missouri","Osage County",5,53,188,93,95
050,29,151,"Missouri","Osage County",5,54,191,96,95
050,29,151,"Missouri","Osage County",5,55,177,87,90
050,29,151,"Missouri","Osage County",5,56,184,88,96
050,29,151,"Missouri","Osage County",5,57,176,89,87
050,29,151,"Missouri","Osage County",5,58,178,87,91
050,29,151,"Missouri","Osage County",5,59,206,111,95
050,29,151,"Missouri","Osage County",5,60,191,105,86
050,29,151,"Missouri","Osage County",5,61,207,118,89
050,29,151,"Missouri","Osage County",5,62,214,116,98
050,29,151,"Missouri","Osage County",5,63,204,97,107
050,29,151,"Missouri","Osage County",5,64,192,94,98
050,29,151,"Missouri","Osage County",5,65,188,96,92
050,29,151,"Missouri","Osage County",5,66,195,104,91
050,29,151,"Missouri","Osage County",5,67,169,85,84
050,29,151,"Missouri","Osage County",5,68,166,87,79
050,29,151,"Missouri","Osage County",5,69,160,84,76
050,29,151,"Missouri","Osage County",5,70,148,76,72
050,29,151,"Missouri","Osage County",5,71,139,70,69
050,29,151,"Missouri","Osage County",5,72,128,63,65
050,29,151,"Missouri","Osage County",5,73,113,54,59
050,29,151,"Missouri","Osage County",5,74,111,53,58
050,29,151,"Missouri","Osage County",5,75,117,62,55
050,29,151,"Missouri","Osage County",5,76,110,57,53
050,29,151,"Missouri","Osage County",5,77,81,34,47
050,29,151,"Missouri","Osage County",5,78,75,35,40
050,29,151,"Missouri","Osage County",5,79,64,28,36
050,29,151,"Missouri","Osage County",5,80,64,28,36
050,29,151,"Missouri","Osage County",5,81,75,36,39
050,29,151,"Missouri","Osage County",5,82,60,24,36
050,29,151,"Missouri","Osage County",5,83,58,24,34
050,29,151,"Missouri","Osage County",5,84,49,18,31
050,29,151,"Missouri","Osage County",5,85,225,71,154
050,29,153,"Missouri","Ozark County",1,0,66,35,31
050,29,153,"Missouri","Ozark County",1,1,73,39,34
050,29,153,"Missouri","Ozark County",1,2,85,48,37
050,29,153,"Missouri","Ozark County",1,3,84,47,37
050,29,153,"Missouri","Ozark County",1,4,65,33,32
050,29,153,"Missouri","Ozark County",1,5,81,45,36
050,29,153,"Missouri","Ozark County",1,6,83,45,38
050,29,153,"Missouri","Ozark County",1,7,81,42,39
050,29,153,"Missouri","Ozark County",1,8,85,43,42
050,29,153,"Missouri","Ozark County",1,9,85,43,42
050,29,153,"Missouri","Ozark County",1,10,86,51,35
050,29,153,"Missouri","Ozark County",1,11,106,63,43
050,29,153,"Missouri","Ozark County",1,12,114,58,56
050,29,153,"Missouri","Ozark County",1,13,124,60,64
050,29,153,"Missouri","Ozark County",1,14,105,53,52
050,29,153,"Missouri","Ozark County",1,15,108,57,51
050,29,153,"Missouri","Ozark County",1,16,98,54,44
050,29,153,"Missouri","Ozark County",1,17,93,42,51
050,29,153,"Missouri","Ozark County",1,18,85,43,42
050,29,153,"Missouri","Ozark County",1,19,58,28,30
050,29,153,"Missouri","Ozark County",1,20,52,29,23
050,29,153,"Missouri","Ozark County",1,21,61,33,28
050,29,153,"Missouri","Ozark County",1,22,67,37,30
050,29,153,"Missouri","Ozark County",1,23,63,35,28
050,29,153,"Missouri","Ozark County",1,24,56,30,26
050,29,153,"Missouri","Ozark County",1,25,59,32,27
050,29,153,"Missouri","Ozark County",1,26,68,35,33
050,29,153,"Missouri","Ozark County",1,27,66,35,31
050,29,153,"Missouri","Ozark County",1,28,66,29,37
050,29,153,"Missouri","Ozark County",1,29,72,40,32
050,29,153,"Missouri","Ozark County",1,30,71,38,33
050,29,153,"Missouri","Ozark County",1,31,65,34,31
050,29,153,"Missouri","Ozark County",1,32,64,26,38
050,29,153,"Missouri","Ozark County",1,33,66,26,40
050,29,153,"Missouri","Ozark County",1,34,80,35,45
050,29,153,"Missouri","Ozark County",1,35,90,42,48
050,29,153,"Missouri","Ozark County",1,36,83,42,41
050,29,153,"Missouri","Ozark County",1,37,78,37,41
050,29,153,"Missouri","Ozark County",1,38,90,46,44
050,29,153,"Missouri","Ozark County",1,39,82,42,40
050,29,153,"Missouri","Ozark County",1,40,75,34,41
050,29,153,"Missouri","Ozark County",1,41,89,47,42
050,29,153,"Missouri","Ozark County",1,42,89,49,40
050,29,153,"Missouri","Ozark County",1,43,89,39,50
050,29,153,"Missouri","Ozark County",1,44,80,41,39
050,29,153,"Missouri","Ozark County",1,45,89,42,47
050,29,153,"Missouri","Ozark County",1,46,90,44,46
050,29,153,"Missouri","Ozark County",1,47,77,42,35
050,29,153,"Missouri","Ozark County",1,48,87,45,42
050,29,153,"Missouri","Ozark County",1,49,98,51,47
050,29,153,"Missouri","Ozark County",1,50,99,52,47
050,29,153,"Missouri","Ozark County",1,51,106,58,48
050,29,153,"Missouri","Ozark County",1,52,100,48,52
050,29,153,"Missouri","Ozark County",1,53,109,58,51
050,29,153,"Missouri","Ozark County",1,54,109,47,62
050,29,153,"Missouri","Ozark County",1,55,114,51,63
050,29,153,"Missouri","Ozark County",1,56,120,63,57
050,29,153,"Missouri","Ozark County",1,57,129,75,54
050,29,153,"Missouri","Ozark County",1,58,146,72,74
050,29,153,"Missouri","Ozark County",1,59,150,68,82
050,29,153,"Missouri","Ozark County",1,60,156,75,81
050,29,153,"Missouri","Ozark County",1,61,170,86,84
050,29,153,"Missouri","Ozark County",1,62,184,95,89
050,29,153,"Missouri","Ozark County",1,63,176,87,89
050,29,153,"Missouri","Ozark County",1,64,165,75,90
050,29,153,"Missouri","Ozark County",1,65,162,81,81
050,29,153,"Missouri","Ozark County",1,66,167,100,67
050,29,153,"Missouri","Ozark County",1,67,151,87,64
050,29,153,"Missouri","Ozark County",1,68,159,80,79
050,29,153,"Missouri","Ozark County",1,69,150,79,71
050,29,153,"Missouri","Ozark County",1,70,151,77,74
050,29,153,"Missouri","Ozark County",1,71,146,70,76
050,29,153,"Missouri","Ozark County",1,72,139,68,71
050,29,153,"Missouri","Ozark County",1,73,137,66,71
050,29,153,"Missouri","Ozark County",1,74,105,47,58
050,29,153,"Missouri","Ozark County",1,75,101,54,47
050,29,153,"Missouri","Ozark County",1,76,98,56,42
050,29,153,"Missouri","Ozark County",1,77,112,62,50
050,29,153,"Missouri","Ozark County",1,78,85,48,37
050,29,153,"Missouri","Ozark County",1,79,80,46,34
050,29,153,"Missouri","Ozark County",1,80,68,31,37
050,29,153,"Missouri","Ozark County",1,81,71,33,38
050,29,153,"Missouri","Ozark County",1,82,63,32,31
050,29,153,"Missouri","Ozark County",1,83,49,24,25
050,29,153,"Missouri","Ozark County",1,84,50,23,27
050,29,153,"Missouri","Ozark County",1,85,248,109,139
050,29,153,"Missouri","Ozark County",2,0,59,28,31
050,29,153,"Missouri","Ozark County",2,1,71,38,33
050,29,153,"Missouri","Ozark County",2,2,81,45,36
050,29,153,"Missouri","Ozark County",2,3,84,47,37
050,29,153,"Missouri","Ozark County",2,4,67,35,32
050,29,153,"Missouri","Ozark County",2,5,77,42,35
050,29,153,"Missouri","Ozark County",2,6,81,44,37
050,29,153,"Missouri","Ozark County",2,7,81,43,38
050,29,153,"Missouri","Ozark County",2,8,85,43,42
050,29,153,"Missouri","Ozark County",2,9,85,43,42
050,29,153,"Missouri","Ozark County",2,10,84,48,36
050,29,153,"Missouri","Ozark County",2,11,100,60,40
050,29,153,"Missouri","Ozark County",2,12,113,59,54
050,29,153,"Missouri","Ozark County",2,13,122,60,62
050,29,153,"Missouri","Ozark County",2,14,108,53,55
050,29,153,"Missouri","Ozark County",2,15,106,56,50
050,29,153,"Missouri","Ozark County",2,16,100,53,47
050,29,153,"Missouri","Ozark County",2,17,94,46,48
050,29,153,"Missouri","Ozark County",2,18,82,41,41
050,29,153,"Missouri","Ozark County",2,19,59,29,30
050,29,153,"Missouri","Ozark County",2,20,55,29,26
050,29,153,"Missouri","Ozark County",2,21,60,32,28
050,29,153,"Missouri","Ozark County",2,22,65,36,29
050,29,153,"Missouri","Ozark County",2,23,64,35,29
050,29,153,"Missouri","Ozark County",2,24,59,32,27
050,29,153,"Missouri","Ozark County",2,25,59,33,26
050,29,153,"Missouri","Ozark County",2,26,66,35,31
050,29,153,"Missouri","Ozark County",2,27,66,35,31
050,29,153,"Missouri","Ozark County",2,28,67,31,36
050,29,153,"Missouri","Ozark County",2,29,68,36,32
050,29,153,"Missouri","Ozark County",2,30,72,39,33
050,29,153,"Missouri","Ozark County",2,31,68,36,32
050,29,153,"Missouri","Ozark County",2,32,64,27,37
050,29,153,"Missouri","Ozark County",2,33,65,25,40
050,29,153,"Missouri","Ozark County",2,34,77,33,44
050,29,153,"Missouri","Ozark County",2,35,89,41,48
050,29,153,"Missouri","Ozark County",2,36,84,42,42
050,29,153,"Missouri","Ozark County",2,37,81,39,42
050,29,153,"Missouri","Ozark County",2,38,86,44,42
050,29,153,"Missouri","Ozark County",2,39,83,43,40
050,29,153,"Missouri","Ozark County",2,40,77,36,41
050,29,153,"Missouri","Ozark County",2,41,86,44,42
050,29,153,"Missouri","Ozark County",2,42,91,49,42
050,29,153,"Missouri","Ozark County",2,43,92,43,49
050,29,153,"Missouri","Ozark County",2,44,81,40,41
050,29,153,"Missouri","Ozark County",2,45,88,42,46
050,29,153,"Missouri","Ozark County",2,46,90,44,46
050,29,153,"Missouri","Ozark County",2,47,81,43,38
050,29,153,"Missouri","Ozark County",2,48,84,44,40
050,29,153,"Missouri","Ozark County",2,49,96,50,46
050,29,153,"Missouri","Ozark County",2,50,97,52,45
050,29,153,"Missouri","Ozark County",2,51,105,57,48
050,29,153,"Missouri","Ozark County",2,52,100,50,50
050,29,153,"Missouri","Ozark County",2,53,107,56,51
050,29,153,"Missouri","Ozark County",2,54,110,50,60
050,29,153,"Missouri","Ozark County",2,55,113,50,63
050,29,153,"Missouri","Ozark County",2,56,118,60,58
050,29,153,"Missouri","Ozark County",2,57,127,72,55
050,29,153,"Missouri","Ozark County",2,58,141,72,69
050,29,153,"Missouri","Ozark County",2,59,150,69,81
050,29,153,"Missouri","Ozark County",2,60,155,74,81
050,29,153,"Missouri","Ozark County",2,61,169,85,84
050,29,153,"Missouri","Ozark County",2,62,181,92,89
050,29,153,"Missouri","Ozark County",2,63,179,89,90
050,29,153,"Missouri","Ozark County",2,64,167,78,89
050,29,153,"Missouri","Ozark County",2,65,163,80,83
050,29,153,"Missouri","Ozark County",2,66,167,97,70
050,29,153,"Missouri","Ozark County",2,67,156,91,65
050,29,153,"Missouri","Ozark County",2,68,155,81,74
050,29,153,"Missouri","Ozark County",2,69,152,78,74
050,29,153,"Missouri","Ozark County",2,70,148,77,71
050,29,153,"Missouri","Ozark County",2,71,148,73,75
050,29,153,"Missouri","Ozark County",2,72,137,66,71
050,29,153,"Missouri","Ozark County",2,73,145,70,75
050,29,153,"Missouri","Ozark County",2,74,105,48,57
050,29,153,"Missouri","Ozark County",2,75,100,52,48
050,29,153,"Missouri","Ozark County",2,76,96,53,43
050,29,153,"Missouri","Ozark County",2,77,108,61,47
050,29,153,"Missouri","Ozark County",2,78,88,49,39
050,29,153,"Missouri","Ozark County",2,79,77,43,34
050,29,153,"Missouri","Ozark County",2,80,70,34,36
050,29,153,"Missouri","Ozark County",2,81,69,33,36
050,29,153,"Missouri","Ozark County",2,82,62,30,32
050,29,153,"Missouri","Ozark County",2,83,52,26,26
050,29,153,"Missouri","Ozark County",2,84,48,22,26
050,29,153,"Missouri","Ozark County",2,85,249,111,138
050,29,153,"Missouri","Ozark County",3,0,69,35,34
050,29,153,"Missouri","Ozark County",3,1,76,37,39
050,29,153,"Missouri","Ozark County",3,2,72,38,34
050,29,153,"Missouri","Ozark County",3,3,91,49,42
050,29,153,"Missouri","Ozark County",3,4,90,54,36
050,29,153,"Missouri","Ozark County",3,5,75,40,35
050,29,153,"Missouri","Ozark County",3,6,87,48,39
050,29,153,"Missouri","Ozark County",3,7,81,45,36
050,29,153,"Missouri","Ozark County",3,8,88,47,41
050,29,153,"Missouri","Ozark County",3,9,95,47,48
050,29,153,"Missouri","Ozark County",3,10,94,48,46
050,29,153,"Missouri","Ozark County",3,11,96,50,46
050,29,153,"Missouri","Ozark County",3,12,115,69,46
050,29,153,"Missouri","Ozark County",3,13,124,61,63
050,29,153,"Missouri","Ozark County",3,14,122,63,59
050,29,153,"Missouri","Ozark County",3,15,115,61,54
050,29,153,"Missouri","Ozark County",3,16,111,56,55
050,29,153,"Missouri","Ozark County",3,17,106,59,47
050,29,153,"Missouri","Ozark County",3,18,89,43,46
050,29,153,"Missouri","Ozark County",3,19,64,30,34
050,29,153,"Missouri","Ozark County",3,20,61,28,33
050,29,153,"Missouri","Ozark County",3,21,61,30,31
050,29,153,"Missouri","Ozark County",3,22,69,35,34
050,29,153,"Missouri","Ozark County",3,23,71,39,32
050,29,153,"Missouri","Ozark County",3,24,67,33,34
050,29,153,"Missouri","Ozark County",3,25,68,38,30
050,29,153,"Missouri","Ozark County",3,26,60,34,26
050,29,153,"Missouri","Ozark County",3,27,69,38,31
050,29,153,"Missouri","Ozark County",3,28,67,35,32
050,29,153,"Missouri","Ozark County",3,29,74,31,43
050,29,153,"Missouri","Ozark County",3,30,71,38,33
050,29,153,"Missouri","Ozark County",3,31,73,37,36
050,29,153,"Missouri","Ozark County",3,32,72,39,33
050,29,153,"Missouri","Ozark County",3,33,74,32,42
050,29,153,"Missouri","Ozark County",3,34,73,29,44
050,29,153,"Missouri","Ozark County",3,35,74,35,39
050,29,153,"Missouri","Ozark County",3,36,102,46,56
050,29,153,"Missouri","Ozark County",3,37,88,44,44
050,29,153,"Missouri","Ozark County",3,38,90,45,45
050,29,153,"Missouri","Ozark County",3,39,92,47,45
050,29,153,"Missouri","Ozark County",3,40,85,45,40
050,29,153,"Missouri","Ozark County",3,41,86,44,42
050,29,153,"Missouri","Ozark County",3,42,94,49,45
050,29,153,"Missouri","Ozark County",3,43,94,50,44
050,29,153,"Missouri","Ozark County",3,44,98,47,51
050,29,153,"Missouri","Ozark County",3,45,84,42,42
050,29,153,"Missouri","Ozark County",3,46,91,45,46
050,29,153,"Missouri","Ozark County",3,47,97,45,52
050,29,153,"Missouri","Ozark County",3,48,84,44,40
050,29,153,"Missouri","Ozark County",3,49,90,48,42
050,29,153,"Missouri","Ozark County",3,50,96,49,47
050,29,153,"Missouri","Ozark County",3,51,97,51,46
050,29,153,"Missouri","Ozark County",3,52,105,54,51
050,29,153,"Missouri","Ozark County",3,53,106,55,51
050,29,153,"Missouri","Ozark County",3,54,111,56,55
050,29,153,"Missouri","Ozark County",3,55,121,51,70
050,29,153,"Missouri","Ozark County",3,56,121,58,63
050,29,153,"Missouri","Ozark County",3,57,132,67,65
050,29,153,"Missouri","Ozark County",3,58,137,75,62
050,29,153,"Missouri","Ozark County",3,59,137,71,66
050,29,153,"Missouri","Ozark County",3,60,156,76,80
050,29,153,"Missouri","Ozark County",3,61,167,79,88
050,29,153,"Missouri","Ozark County",3,62,180,93,87
050,29,153,"Missouri","Ozark County",3,63,183,92,91
050,29,153,"Missouri","Ozark County",3,64,173,85,88
050,29,153,"Missouri","Ozark County",3,65,168,77,91
050,29,153,"Missouri","Ozark County",3,66,167,82,85
050,29,153,"Missouri","Ozark County",3,67,168,98,70
050,29,153,"Missouri","Ozark County",3,68,153,87,66
050,29,153,"Missouri","Ozark County",3,69,166,88,78
050,29,153,"Missouri","Ozark County",3,70,149,77,72
050,29,153,"Missouri","Ozark County",3,71,140,74,66
050,29,153,"Missouri","Ozark County",3,72,140,67,73
050,29,153,"Missouri","Ozark County",3,73,127,61,66
050,29,153,"Missouri","Ozark County",3,74,142,68,74
050,29,153,"Missouri","Ozark County",3,75,93,42,51
050,29,153,"Missouri","Ozark County",3,76,98,50,48
050,29,153,"Missouri","Ozark County",3,77,94,51,43
050,29,153,"Missouri","Ozark County",3,78,103,58,45
050,29,153,"Missouri","Ozark County",3,79,79,42,37
050,29,153,"Missouri","Ozark County",3,80,70,39,31
050,29,153,"Missouri","Ozark County",3,81,58,29,29
050,29,153,"Missouri","Ozark County",3,82,62,31,31
050,29,153,"Missouri","Ozark County",3,83,53,22,31
050,29,153,"Missouri","Ozark County",3,84,46,23,23
050,29,153,"Missouri","Ozark County",3,85,248,109,139
050,29,153,"Missouri","Ozark County",4,0,73,37,36
050,29,153,"Missouri","Ozark County",4,1,70,35,35
050,29,153,"Missouri","Ozark County",4,2,73,35,38
050,29,153,"Missouri","Ozark County",4,3,83,45,38
050,29,153,"Missouri","Ozark County",4,4,82,46,36
050,29,153,"Missouri","Ozark County",4,5,100,59,41
050,29,153,"Missouri","Ozark County",4,6,74,37,37
050,29,153,"Missouri","Ozark County",4,7,104,55,49
050,29,153,"Missouri","Ozark County",4,8,81,46,35
050,29,153,"Missouri","Ozark County",4,9,104,56,48
050,29,153,"Missouri","Ozark County",4,10,106,55,51
050,29,153,"Missouri","Ozark County",4,11,101,50,51
050,29,153,"Missouri","Ozark County",4,12,104,53,51
050,29,153,"Missouri","Ozark County",4,13,111,66,45
050,29,153,"Missouri","Ozark County",4,14,126,60,66
050,29,153,"Missouri","Ozark County",4,15,123,65,58
050,29,153,"Missouri","Ozark County",4,16,109,60,49
050,29,153,"Missouri","Ozark County",4,17,115,57,58
050,29,153,"Missouri","Ozark County",4,18,92,48,44
050,29,153,"Missouri","Ozark County",4,19,65,32,33
050,29,153,"Missouri","Ozark County",4,20,68,33,35
050,29,153,"Missouri","Ozark County",4,21,65,30,35
050,29,153,"Missouri","Ozark County",4,22,60,30,30
050,29,153,"Missouri","Ozark County",4,23,72,42,30
050,29,153,"Missouri","Ozark County",4,24,76,41,35
050,29,153,"Missouri","Ozark County",4,25,73,37,36
050,29,153,"Missouri","Ozark County",4,26,64,40,24
050,29,153,"Missouri","Ozark County",4,27,62,32,30
050,29,153,"Missouri","Ozark County",4,28,77,40,37
050,29,153,"Missouri","Ozark County",4,29,71,38,33
050,29,153,"Missouri","Ozark County",4,30,76,34,42
050,29,153,"Missouri","Ozark County",4,31,83,44,39
050,29,153,"Missouri","Ozark County",4,32,82,45,37
050,29,153,"Missouri","Ozark County",4,33,82,45,37
050,29,153,"Missouri","Ozark County",4,34,75,32,43
050,29,153,"Missouri","Ozark County",4,35,78,30,48
050,29,153,"Missouri","Ozark County",4,36,84,39,45
050,29,153,"Missouri","Ozark County",4,37,100,46,54
050,29,153,"Missouri","Ozark County",4,38,99,54,45
050,29,153,"Missouri","Ozark County",4,39,95,47,48
050,29,153,"Missouri","Ozark County",4,40,96,50,46
050,29,153,"Missouri","Ozark County",4,41,94,48,46
050,29,153,"Missouri","Ozark County",4,42,88,44,44
050,29,153,"Missouri","Ozark County",4,43,95,52,43
050,29,153,"Missouri","Ozark County",4,44,103,57,46
050,29,153,"Missouri","Ozark County",4,45,103,50,53
050,29,153,"Missouri","Ozark County",4,46,87,42,45
050,29,153,"Missouri","Ozark County",4,47,96,49,47
050,29,153,"Missouri","Ozark County",4,48,91,45,46
050,29,153,"Missouri","Ozark County",4,49,95,49,46
050,29,153,"Missouri","Ozark County",4,50,98,52,46
050,29,153,"Missouri","Ozark County",4,51,103,53,50
050,29,153,"Missouri","Ozark County",4,52,103,58,45
050,29,153,"Missouri","Ozark County",4,53,111,55,56
050,29,153,"Missouri","Ozark County",4,54,111,57,54
050,29,153,"Missouri","Ozark County",4,55,118,59,59
050,29,153,"Missouri","Ozark County",4,56,124,54,70
050,29,153,"Missouri","Ozark County",4,57,128,62,66
050,29,153,"Missouri","Ozark County",4,58,135,71,64
050,29,153,"Missouri","Ozark County",4,59,140,74,66
050,29,153,"Missouri","Ozark County",4,60,139,71,68
050,29,153,"Missouri","Ozark County",4,61,160,74,86
050,29,153,"Missouri","Ozark County",4,62,172,80,92
050,29,153,"Missouri","Ozark County",4,63,177,96,81
050,29,153,"Missouri","Ozark County",4,64,188,94,94
050,29,153,"Missouri","Ozark County",4,65,176,87,89
050,29,153,"Missouri","Ozark County",4,66,163,74,89
050,29,153,"Missouri","Ozark County",4,67,174,85,89
050,29,153,"Missouri","Ozark County",4,68,174,102,72
050,29,153,"Missouri","Ozark County",4,69,153,90,63
050,29,153,"Missouri","Ozark County",4,70,166,85,81
050,29,153,"Missouri","Ozark County",4,71,140,69,71
050,29,153,"Missouri","Ozark County",4,72,133,71,62
050,29,153,"Missouri","Ozark County",4,73,122,59,63
050,29,153,"Missouri","Ozark County",4,74,126,57,69
050,29,153,"Missouri","Ozark County",4,75,133,65,68
050,29,153,"Missouri","Ozark County",4,76,90,43,47
050,29,153,"Missouri","Ozark County",4,77,95,51,44
050,29,153,"Missouri","Ozark County",4,78,85,46,39
050,29,153,"Missouri","Ozark County",4,79,92,49,43
050,29,153,"Missouri","Ozark County",4,80,80,40,40
050,29,153,"Missouri","Ozark County",4,81,62,34,28
050,29,153,"Missouri","Ozark County",4,82,55,29,26
050,29,153,"Missouri","Ozark County",4,83,52,25,27
050,29,153,"Missouri","Ozark County",4,84,51,21,30
050,29,153,"Missouri","Ozark County",4,85,239,110,129
050,29,153,"Missouri","Ozark County",5,0,82,42,40
050,29,153,"Missouri","Ozark County",5,1,74,32,42
050,29,153,"Missouri","Ozark County",5,2,70,33,37
050,29,153,"Missouri","Ozark County",5,3,69,33,36
050,29,153,"Missouri","Ozark County",5,4,83,46,37
050,29,153,"Missouri","Ozark County",5,5,86,43,43
050,29,153,"Missouri","Ozark County",5,6,92,56,36
050,29,153,"Missouri","Ozark County",5,7,76,39,37
050,29,153,"Missouri","Ozark County",5,8,112,59,53
050,29,153,"Missouri","Ozark County",5,9,78,41,37
050,29,153,"Missouri","Ozark County",5,10,102,51,51
050,29,153,"Missouri","Ozark County",5,11,105,55,50
050,29,153,"Missouri","Ozark County",5,12,102,48,54
050,29,153,"Missouri","Ozark County",5,13,111,57,54
050,29,153,"Missouri","Ozark County",5,14,112,66,46
050,29,153,"Missouri","Ozark County",5,15,128,63,65
050,29,153,"Missouri","Ozark County",5,16,127,65,62
050,29,153,"Missouri","Ozark County",5,17,106,57,49
050,29,153,"Missouri","Ozark County",5,18,98,51,47
050,29,153,"Missouri","Ozark County",5,19,68,33,35
050,29,153,"Missouri","Ozark County",5,20,63,32,31
050,29,153,"Missouri","Ozark County",5,21,65,37,28
050,29,153,"Missouri","Ozark County",5,22,70,31,39
050,29,153,"Missouri","Ozark County",5,23,58,28,30
050,29,153,"Missouri","Ozark County",5,24,76,46,30
050,29,153,"Missouri","Ozark County",5,25,78,41,37
050,29,153,"Missouri","Ozark County",5,26,77,40,37
050,29,153,"Missouri","Ozark County",5,27,65,42,23
050,29,153,"Missouri","Ozark County",5,28,62,34,28
050,29,153,"Missouri","Ozark County",5,29,84,43,41
050,29,153,"Missouri","Ozark County",5,30,73,38,35
050,29,153,"Missouri","Ozark County",5,31,82,40,42
050,29,153,"Missouri","Ozark County",5,32,77,39,38
050,29,153,"Missouri","Ozark County",5,33,81,43,38
050,29,153,"Missouri","Ozark County",5,34,86,46,40
050,29,153,"Missouri","Ozark County",5,35,79,35,44
050,29,153,"Missouri","Ozark County",5,36,73,26,47
050,29,153,"Missouri","Ozark County",5,37,86,38,48
050,29,153,"Missouri","Ozark County",5,38,106,51,55
050,29,153,"Missouri","Ozark County",5,39,100,55,45
050,29,153,"Missouri","Ozark County",5,40,102,51,51
050,29,153,"Missouri","Ozark County",5,41,101,50,51
050,29,153,"Missouri","Ozark County",5,42,93,47,46
050,29,153,"Missouri","Ozark County",5,43,90,47,43
050,29,153,"Missouri","Ozark County",5,44,96,55,41
050,29,153,"Missouri","Ozark County",5,45,104,57,47
050,29,153,"Missouri","Ozark County",5,46,105,48,57
050,29,153,"Missouri","Ozark County",5,47,92,48,44
050,29,153,"Missouri","Ozark County",5,48,97,50,47
050,29,153,"Missouri","Ozark County",5,49,92,46,46
050,29,153,"Missouri","Ozark County",5,50,91,46,45
050,29,153,"Missouri","Ozark County",5,51,100,54,46
050,29,153,"Missouri","Ozark County",5,52,102,54,48
050,29,153,"Missouri","Ozark County",5,53,107,61,46
050,29,153,"Missouri","Ozark County",5,54,115,59,56
050,29,153,"Missouri","Ozark County",5,55,121,62,59
050,29,153,"Missouri","Ozark County",5,56,126,64,62
050,29,153,"Missouri","Ozark County",5,57,137,59,78
050,29,153,"Missouri","Ozark County",5,58,121,57,64
050,29,153,"Missouri","Ozark County",5,59,144,74,70
050,29,153,"Missouri","Ozark County",5,60,140,76,64
050,29,153,"Missouri","Ozark County",5,61,142,69,73
050,29,153,"Missouri","Ozark County",5,62,163,76,87
050,29,153,"Missouri","Ozark County",5,63,176,83,93
050,29,153,"Missouri","Ozark County",5,64,176,98,78
050,29,153,"Missouri","Ozark County",5,65,188,91,97
050,29,153,"Missouri","Ozark County",5,66,174,82,92
050,29,153,"Missouri","Ozark County",5,67,165,76,89
050,29,153,"Missouri","Ozark County",5,68,170,82,88
050,29,153,"Missouri","Ozark County",5,69,169,97,72
050,29,153,"Missouri","Ozark County",5,70,152,88,64
050,29,153,"Missouri","Ozark County",5,71,154,78,76
050,29,153,"Missouri","Ozark County",5,72,147,72,75
050,29,153,"Missouri","Ozark County",5,73,125,71,54
050,29,153,"Missouri","Ozark County",5,74,125,58,67
050,29,153,"Missouri","Ozark County",5,75,123,56,67
050,29,153,"Missouri","Ozark County",5,76,124,61,63
050,29,153,"Missouri","Ozark County",5,77,90,43,47
050,29,153,"Missouri","Ozark County",5,78,84,45,39
050,29,153,"Missouri","Ozark County",5,79,74,39,35
050,29,153,"Missouri","Ozark County",5,80,87,45,42
050,29,153,"Missouri","Ozark County",5,81,68,36,32
050,29,153,"Missouri","Ozark County",5,82,57,34,23
050,29,153,"Missouri","Ozark County",5,83,44,19,25
050,29,153,"Missouri","Ozark County",5,84,51,23,28
050,29,153,"Missouri","Ozark County",5,85,244,110,134
050,29,155,"Missouri","Pemiscot County",1,0,216,108,108
050,29,155,"Missouri","Pemiscot County",1,1,241,112,129
050,29,155,"Missouri","Pemiscot County",1,2,241,118,123
050,29,155,"Missouri","Pemiscot County",1,3,231,111,120
050,29,155,"Missouri","Pemiscot County",1,4,231,119,112
050,29,155,"Missouri","Pemiscot County",1,5,235,119,116
050,29,155,"Missouri","Pemiscot County",1,6,224,107,117
050,29,155,"Missouri","Pemiscot County",1,7,235,116,119
050,29,155,"Missouri","Pemiscot County",1,8,222,101,121
050,29,155,"Missouri","Pemiscot County",1,9,216,107,109
050,29,155,"Missouri","Pemiscot County",1,10,210,110,100
050,29,155,"Missouri","Pemiscot County",1,11,237,132,105
050,29,155,"Missouri","Pemiscot County",1,12,239,128,111
050,29,155,"Missouri","Pemiscot County",1,13,221,123,98
050,29,155,"Missouri","Pemiscot County",1,14,221,117,104
050,29,155,"Missouri","Pemiscot County",1,15,209,111,98
050,29,155,"Missouri","Pemiscot County",1,16,215,114,101
050,29,155,"Missouri","Pemiscot County",1,17,234,127,107
050,29,155,"Missouri","Pemiscot County",1,18,189,101,88
050,29,155,"Missouri","Pemiscot County",1,19,161,81,80
050,29,155,"Missouri","Pemiscot County",1,20,156,75,81
050,29,155,"Missouri","Pemiscot County",1,21,173,87,86
050,29,155,"Missouri","Pemiscot County",1,22,191,93,98
050,29,155,"Missouri","Pemiscot County",1,23,184,89,95
050,29,155,"Missouri","Pemiscot County",1,24,162,67,95
050,29,155,"Missouri","Pemiscot County",1,25,167,75,92
050,29,155,"Missouri","Pemiscot County",1,26,176,91,85
050,29,155,"Missouri","Pemiscot County",1,27,177,90,87
050,29,155,"Missouri","Pemiscot County",1,28,198,98,100
050,29,155,"Missouri","Pemiscot County",1,29,191,86,105
050,29,155,"Missouri","Pemiscot County",1,30,214,98,116
050,29,155,"Missouri","Pemiscot County",1,31,182,85,97
050,29,155,"Missouri","Pemiscot County",1,32,169,81,88
050,29,155,"Missouri","Pemiscot County",1,33,166,75,91
050,29,155,"Missouri","Pemiscot County",1,34,195,84,111
050,29,155,"Missouri","Pemiscot County",1,35,200,95,105
050,29,155,"Missouri","Pemiscot County",1,36,174,77,97
050,29,155,"Missouri","Pemiscot County",1,37,165,80,85
050,29,155,"Missouri","Pemiscot County",1,38,183,86,97
050,29,155,"Missouri","Pemiscot County",1,39,176,83,93
050,29,155,"Missouri","Pemiscot County",1,40,175,83,92
050,29,155,"Missouri","Pemiscot County",1,41,180,87,93
050,29,155,"Missouri","Pemiscot County",1,42,193,86,107
050,29,155,"Missouri","Pemiscot County",1,43,203,94,109
050,29,155,"Missouri","Pemiscot County",1,44,179,87,92
050,29,155,"Missouri","Pemiscot County",1,45,161,80,81
050,29,155,"Missouri","Pemiscot County",1,46,165,83,82
050,29,155,"Missouri","Pemiscot County",1,47,164,85,79
050,29,155,"Missouri","Pemiscot County",1,48,166,83,83
050,29,155,"Missouri","Pemiscot County",1,49,198,91,107
050,29,155,"Missouri","Pemiscot County",1,50,197,91,106
050,29,155,"Missouri","Pemiscot County",1,51,181,85,96
050,29,155,"Missouri","Pemiscot County",1,52,183,90,93
050,29,155,"Missouri","Pemiscot County",1,53,192,93,99
050,29,155,"Missouri","Pemiscot County",1,54,197,91,106
050,29,155,"Missouri","Pemiscot County",1,55,223,114,109
050,29,155,"Missouri","Pemiscot County",1,56,215,95,120
050,29,155,"Missouri","Pemiscot County",1,57,225,110,115
050,29,155,"Missouri","Pemiscot County",1,58,217,99,118
050,29,155,"Missouri","Pemiscot County",1,59,219,103,116
050,29,155,"Missouri","Pemiscot County",1,60,208,92,116
050,29,155,"Missouri","Pemiscot County",1,61,217,107,110
050,29,155,"Missouri","Pemiscot County",1,62,223,100,123
050,29,155,"Missouri","Pemiscot County",1,63,211,95,116
050,29,155,"Missouri","Pemiscot County",1,64,196,91,105
050,29,155,"Missouri","Pemiscot County",1,65,208,100,108
050,29,155,"Missouri","Pemiscot County",1,66,195,84,111
050,29,155,"Missouri","Pemiscot County",1,67,194,86,108
050,29,155,"Missouri","Pemiscot County",1,68,175,86,89
050,29,155,"Missouri","Pemiscot County",1,69,152,77,75
050,29,155,"Missouri","Pemiscot County",1,70,143,68,75
050,29,155,"Missouri","Pemiscot County",1,71,135,70,65
050,29,155,"Missouri","Pemiscot County",1,72,142,66,76
050,29,155,"Missouri","Pemiscot County",1,73,151,62,89
050,29,155,"Missouri","Pemiscot County",1,74,107,41,66
050,29,155,"Missouri","Pemiscot County",1,75,112,59,53
050,29,155,"Missouri","Pemiscot County",1,76,108,45,63
050,29,155,"Missouri","Pemiscot County",1,77,107,43,64
050,29,155,"Missouri","Pemiscot County",1,78,97,43,54
050,29,155,"Missouri","Pemiscot County",1,79,85,37,48
050,29,155,"Missouri","Pemiscot County",1,80,75,35,40
050,29,155,"Missouri","Pemiscot County",1,81,68,31,37
050,29,155,"Missouri","Pemiscot County",1,82,55,23,32
050,29,155,"Missouri","Pemiscot County",1,83,50,16,34
050,29,155,"Missouri","Pemiscot County",1,84,60,19,41
050,29,155,"Missouri","Pemiscot County",1,85,328,104,224
050,29,155,"Missouri","Pemiscot County",2,0,218,110,108
050,29,155,"Missouri","Pemiscot County",2,1,235,110,125
050,29,155,"Missouri","Pemiscot County",2,2,242,117,125
050,29,155,"Missouri","Pemiscot County",2,3,232,115,117
050,29,155,"Missouri","Pemiscot County",2,4,235,120,115
050,29,155,"Missouri","Pemiscot County",2,5,233,118,115
050,29,155,"Missouri","Pemiscot County",2,6,227,111,116
050,29,155,"Missouri","Pemiscot County",2,7,232,113,119
050,29,155,"Missouri","Pemiscot County",2,8,224,105,119
050,29,155,"Missouri","Pemiscot County",2,9,216,106,110
050,29,155,"Missouri","Pemiscot County",2,10,209,109,100
050,29,155,"Missouri","Pemiscot County",2,11,229,127,102
050,29,155,"Missouri","Pemiscot County",2,12,238,128,110
050,29,155,"Missouri","Pemiscot County",2,13,225,124,101
050,29,155,"Missouri","Pemiscot County",2,14,217,117,100
050,29,155,"Missouri","Pemiscot County",2,15,209,111,98
050,29,155,"Missouri","Pemiscot County",2,16,214,114,100
050,29,155,"Missouri","Pemiscot County",2,17,228,123,105
050,29,155,"Missouri","Pemiscot County",2,18,189,102,87
050,29,155,"Missouri","Pemiscot County",2,19,157,80,77
050,29,155,"Missouri","Pemiscot County",2,20,161,77,84
050,29,155,"Missouri","Pemiscot County",2,21,170,85,85
050,29,155,"Missouri","Pemiscot County",2,22,190,93,97
050,29,155,"Missouri","Pemiscot County",2,23,186,89,97
050,29,155,"Missouri","Pemiscot County",2,24,163,70,93
050,29,155,"Missouri","Pemiscot County",2,25,164,72,92
050,29,155,"Missouri","Pemiscot County",2,26,174,87,87
050,29,155,"Missouri","Pemiscot County",2,27,178,91,87
050,29,155,"Missouri","Pemiscot County",2,28,193,96,97
050,29,155,"Missouri","Pemiscot County",2,29,194,91,103
050,29,155,"Missouri","Pemiscot County",2,30,208,95,113
050,29,155,"Missouri","Pemiscot County",2,31,190,88,102
050,29,155,"Missouri","Pemiscot County",2,32,172,81,91
050,29,155,"Missouri","Pemiscot County",2,33,165,75,90
050,29,155,"Missouri","Pemiscot County",2,34,188,82,106
050,29,155,"Missouri","Pemiscot County",2,35,199,93,106
050,29,155,"Missouri","Pemiscot County",2,36,176,80,96
050,29,155,"Missouri","Pemiscot County",2,37,163,78,85
050,29,155,"Missouri","Pemiscot County",2,38,178,83,95
050,29,155,"Missouri","Pemiscot County",2,39,176,84,92
050,29,155,"Missouri","Pemiscot County",2,40,177,85,92
050,29,155,"Missouri","Pemiscot County",2,41,177,85,92
050,29,155,"Missouri","Pemiscot County",2,42,187,84,103
050,29,155,"Missouri","Pemiscot County",2,43,200,93,107
050,29,155,"Missouri","Pemiscot County",2,44,181,86,95
050,29,155,"Missouri","Pemiscot County",2,45,166,83,83
050,29,155,"Missouri","Pemiscot County",2,46,164,82,82
050,29,155,"Missouri","Pemiscot County",2,47,164,84,80
050,29,155,"Missouri","Pemiscot County",2,48,162,81,81
050,29,155,"Missouri","Pemiscot County",2,49,190,89,101
050,29,155,"Missouri","Pemiscot County",2,50,195,90,105
050,29,155,"Missouri","Pemiscot County",2,51,182,85,97
050,29,155,"Missouri","Pemiscot County",2,52,183,89,94
050,29,155,"Missouri","Pemiscot County",2,53,191,94,97
050,29,155,"Missouri","Pemiscot County",2,54,194,92,102
050,29,155,"Missouri","Pemiscot County",2,55,217,109,108
050,29,155,"Missouri","Pemiscot County",2,56,214,98,116
050,29,155,"Missouri","Pemiscot County",2,57,222,106,116
050,29,155,"Missouri","Pemiscot County",2,58,221,103,118
050,29,155,"Missouri","Pemiscot County",2,59,216,101,115
050,29,155,"Missouri","Pemiscot County",2,60,211,95,116
050,29,155,"Missouri","Pemiscot County",2,61,216,104,112
050,29,155,"Missouri","Pemiscot County",2,62,217,100,117
050,29,155,"Missouri","Pemiscot County",2,63,212,95,117
050,29,155,"Missouri","Pemiscot County",2,64,198,92,106
050,29,155,"Missouri","Pemiscot County",2,65,203,96,107
050,29,155,"Missouri","Pemiscot County",2,66,197,88,109
050,29,155,"Missouri","Pemiscot County",2,67,189,84,105
050,29,155,"Missouri","Pemiscot County",2,68,176,84,92
050,29,155,"Missouri","Pemiscot County",2,69,160,80,80
050,29,155,"Missouri","Pemiscot County",2,70,143,70,73
050,29,155,"Missouri","Pemiscot County",2,71,136,69,67
050,29,155,"Missouri","Pemiscot County",2,72,134,64,70
050,29,155,"Missouri","Pemiscot County",2,73,157,66,91
050,29,155,"Missouri","Pemiscot County",2,74,106,41,65
050,29,155,"Missouri","Pemiscot County",2,75,110,55,55
050,29,155,"Missouri","Pemiscot County",2,76,107,48,59
050,29,155,"Missouri","Pemiscot County",2,77,108,44,64
050,29,155,"Missouri","Pemiscot County",2,78,96,40,56
050,29,155,"Missouri","Pemiscot County",2,79,86,37,49
050,29,155,"Missouri","Pemiscot County",2,80,75,34,41
050,29,155,"Missouri","Pemiscot County",2,81,68,31,37
050,29,155,"Missouri","Pemiscot County",2,82,57,25,32
050,29,155,"Missouri","Pemiscot County",2,83,49,17,32
050,29,155,"Missouri","Pemiscot County",2,84,54,18,36
050,29,155,"Missouri","Pemiscot County",2,85,323,101,222
050,29,155,"Missouri","Pemiscot County",3,0,228,118,110
050,29,155,"Missouri","Pemiscot County",3,1,208,103,105
050,29,155,"Missouri","Pemiscot County",3,2,223,104,119
050,29,155,"Missouri","Pemiscot County",3,3,232,106,126
050,29,155,"Missouri","Pemiscot County",3,4,218,111,107
050,29,155,"Missouri","Pemiscot County",3,5,237,115,122
050,29,155,"Missouri","Pemiscot County",3,6,217,117,100
050,29,155,"Missouri","Pemiscot County",3,7,217,112,105
050,29,155,"Missouri","Pemiscot County",3,8,231,107,124
050,29,155,"Missouri","Pemiscot County",3,9,214,104,110
050,29,155,"Missouri","Pemiscot County",3,10,216,107,109
050,29,155,"Missouri","Pemiscot County",3,11,204,102,102
050,29,155,"Missouri","Pemiscot County",3,12,230,123,107
050,29,155,"Missouri","Pemiscot County",3,13,237,133,104
050,29,155,"Missouri","Pemiscot County",3,14,221,126,95
050,29,155,"Missouri","Pemiscot County",3,15,212,115,97
050,29,155,"Missouri","Pemiscot County",3,16,211,114,97
050,29,155,"Missouri","Pemiscot County",3,17,212,115,97
050,29,155,"Missouri","Pemiscot County",3,18,195,107,88
050,29,155,"Missouri","Pemiscot County",3,19,147,78,69
050,29,155,"Missouri","Pemiscot County",3,20,169,89,80
050,29,155,"Missouri","Pemiscot County",3,21,156,75,81
050,29,155,"Missouri","Pemiscot County",3,22,165,85,80
050,29,155,"Missouri","Pemiscot County",3,23,199,98,101
050,29,155,"Missouri","Pemiscot County",3,24,181,97,84
050,29,155,"Missouri","Pemiscot County",3,25,161,72,89
050,29,155,"Missouri","Pemiscot County",3,26,158,77,81
050,29,155,"Missouri","Pemiscot County",3,27,162,78,84
050,29,155,"Missouri","Pemiscot County",3,28,168,81,87
050,29,155,"Missouri","Pemiscot County",3,29,186,91,95
050,29,155,"Missouri","Pemiscot County",3,30,198,89,109
050,29,155,"Missouri","Pemiscot County",3,31,208,94,114
050,29,155,"Missouri","Pemiscot County",3,32,179,75,104
050,29,155,"Missouri","Pemiscot County",3,33,167,75,92
050,29,155,"Missouri","Pemiscot County",3,34,162,72,90
050,29,155,"Missouri","Pemiscot County",3,35,187,81,106
050,29,155,"Missouri","Pemiscot County",3,36,192,88,104
050,29,155,"Missouri","Pemiscot County",3,37,160,68,92
050,29,155,"Missouri","Pemiscot County",3,38,164,77,87
050,29,155,"Missouri","Pemiscot County",3,39,173,82,91
050,29,155,"Missouri","Pemiscot County",3,40,168,79,89
050,29,155,"Missouri","Pemiscot County",3,41,174,85,89
050,29,155,"Missouri","Pemiscot County",3,42,175,79,96
050,29,155,"Missouri","Pemiscot County",3,43,181,82,99
050,29,155,"Missouri","Pemiscot County",3,44,193,86,107
050,29,155,"Missouri","Pemiscot County",3,45,175,80,95
050,29,155,"Missouri","Pemiscot County",3,46,160,76,84
050,29,155,"Missouri","Pemiscot County",3,47,160,78,82
050,29,155,"Missouri","Pemiscot County",3,48,169,84,85
050,29,155,"Missouri","Pemiscot County",3,49,160,83,77
050,29,155,"Missouri","Pemiscot County",3,50,177,81,96
050,29,155,"Missouri","Pemiscot County",3,51,189,86,103
050,29,155,"Missouri","Pemiscot County",3,52,181,86,95
050,29,155,"Missouri","Pemiscot County",3,53,181,85,96
050,29,155,"Missouri","Pemiscot County",3,54,191,96,95
050,29,155,"Missouri","Pemiscot County",3,55,192,95,97
050,29,155,"Missouri","Pemiscot County",3,56,212,101,111
050,29,155,"Missouri","Pemiscot County",3,57,204,98,106
050,29,155,"Missouri","Pemiscot County",3,58,219,107,112
050,29,155,"Missouri","Pemiscot County",3,59,208,99,109
050,29,155,"Missouri","Pemiscot County",3,60,199,96,103
050,29,155,"Missouri","Pemiscot County",3,61,212,92,120
050,29,155,"Missouri","Pemiscot County",3,62,216,106,110
050,29,155,"Missouri","Pemiscot County",3,63,200,87,113
050,29,155,"Missouri","Pemiscot County",3,64,213,97,116
050,29,155,"Missouri","Pemiscot County",3,65,186,86,100
050,29,155,"Missouri","Pemiscot County",3,66,192,90,102
050,29,155,"Missouri","Pemiscot County",3,67,186,86,100
050,29,155,"Missouri","Pemiscot County",3,68,187,83,104
050,29,155,"Missouri","Pemiscot County",3,69,167,78,89
050,29,155,"Missouri","Pemiscot County",3,70,156,80,76
050,29,155,"Missouri","Pemiscot County",3,71,135,64,71
050,29,155,"Missouri","Pemiscot County",3,72,127,66,61
050,29,155,"Missouri","Pemiscot County",3,73,134,62,72
050,29,155,"Missouri","Pemiscot County",3,74,154,66,88
050,29,155,"Missouri","Pemiscot County",3,75,104,42,62
050,29,155,"Missouri","Pemiscot County",3,76,98,46,52
050,29,155,"Missouri","Pemiscot County",3,77,98,45,53
050,29,155,"Missouri","Pemiscot County",3,78,104,39,65
050,29,155,"Missouri","Pemiscot County",3,79,86,36,50
050,29,155,"Missouri","Pemiscot County",3,80,79,32,47
050,29,155,"Missouri","Pemiscot County",3,81,69,30,39
050,29,155,"Missouri","Pemiscot County",3,82,64,29,35
050,29,155,"Missouri","Pemiscot County",3,83,52,24,28
050,29,155,"Missouri","Pemiscot County",3,84,44,13,31
050,29,155,"Missouri","Pemiscot County",3,85,305,96,209
050,29,155,"Missouri","Pemiscot County",4,0,198,106,92
050,29,155,"Missouri","Pemiscot County",4,1,229,119,110
050,29,155,"Missouri","Pemiscot County",4,2,195,102,93
050,29,155,"Missouri","Pemiscot County",4,3,213,104,109
050,29,155,"Missouri","Pemiscot County",4,4,224,104,120
050,29,155,"Missouri","Pemiscot County",4,5,219,106,113
050,29,155,"Missouri","Pemiscot County",4,6,238,116,122
050,29,155,"Missouri","Pemiscot County",4,7,210,117,93
050,29,155,"Missouri","Pemiscot County",4,8,221,115,106
050,29,155,"Missouri","Pemiscot County",4,9,218,101,117
050,29,155,"Missouri","Pemiscot County",4,10,209,100,109
050,29,155,"Missouri","Pemiscot County",4,11,212,110,102
050,29,155,"Missouri","Pemiscot County",4,12,208,110,98
050,29,155,"Missouri","Pemiscot County",4,13,221,124,97
050,29,155,"Missouri","Pemiscot County",4,14,234,128,106
050,29,155,"Missouri","Pemiscot County",4,15,213,122,91
050,29,155,"Missouri","Pemiscot County",4,16,215,117,98
050,29,155,"Missouri","Pemiscot County",4,17,219,115,104
050,29,155,"Missouri","Pemiscot County",4,18,178,104,74
050,29,155,"Missouri","Pemiscot County",4,19,154,81,73
050,29,155,"Missouri","Pemiscot County",4,20,142,77,65
050,29,155,"Missouri","Pemiscot County",4,21,172,86,86
050,29,155,"Missouri","Pemiscot County",4,22,159,75,84
050,29,155,"Missouri","Pemiscot County",4,23,164,84,80
050,29,155,"Missouri","Pemiscot County",4,24,189,93,96
050,29,155,"Missouri","Pemiscot County",4,25,178,90,88
050,29,155,"Missouri","Pemiscot County",4,26,155,69,86
050,29,155,"Missouri","Pemiscot County",4,27,166,78,88
050,29,155,"Missouri","Pemiscot County",4,28,146,76,70
050,29,155,"Missouri","Pemiscot County",4,29,166,79,87
050,29,155,"Missouri","Pemiscot County",4,30,185,92,93
050,29,155,"Missouri","Pemiscot County",4,31,204,95,109
050,29,155,"Missouri","Pemiscot County",4,32,199,88,111
050,29,155,"Missouri","Pemiscot County",4,33,169,68,101
050,29,155,"Missouri","Pemiscot County",4,34,159,71,88
050,29,155,"Missouri","Pemiscot County",4,35,166,78,88
050,29,155,"Missouri","Pemiscot County",4,36,182,76,106
050,29,155,"Missouri","Pemiscot County",4,37,181,84,97
050,29,155,"Missouri","Pemiscot County",4,38,151,62,89
050,29,155,"Missouri","Pemiscot County",4,39,166,78,88
050,29,155,"Missouri","Pemiscot County",4,40,176,84,92
050,29,155,"Missouri","Pemiscot County",4,41,167,82,85
050,29,155,"Missouri","Pemiscot County",4,42,172,84,88
050,29,155,"Missouri","Pemiscot County",4,43,169,80,89
050,29,155,"Missouri","Pemiscot County",4,44,171,76,95
050,29,155,"Missouri","Pemiscot County",4,45,190,84,106
050,29,155,"Missouri","Pemiscot County",4,46,175,78,97
050,29,155,"Missouri","Pemiscot County",4,47,158,79,79
050,29,155,"Missouri","Pemiscot County",4,48,155,77,78
050,29,155,"Missouri","Pemiscot County",4,49,155,74,81
050,29,155,"Missouri","Pemiscot County",4,50,149,75,74
050,29,155,"Missouri","Pemiscot County",4,51,167,79,88
050,29,155,"Missouri","Pemiscot County",4,52,184,87,97
050,29,155,"Missouri","Pemiscot County",4,53,176,82,94
050,29,155,"Missouri","Pemiscot County",4,54,176,84,92
050,29,155,"Missouri","Pemiscot County",4,55,186,94,92
050,29,155,"Missouri","Pemiscot County",4,56,175,82,93
050,29,155,"Missouri","Pemiscot County",4,57,210,105,105
050,29,155,"Missouri","Pemiscot County",4,58,197,95,102
050,29,155,"Missouri","Pemiscot County",4,59,209,101,108
050,29,155,"Missouri","Pemiscot County",4,60,202,94,108
050,29,155,"Missouri","Pemiscot County",4,61,194,91,103
050,29,155,"Missouri","Pemiscot County",4,62,208,95,113
050,29,155,"Missouri","Pemiscot County",4,63,202,91,111
050,29,155,"Missouri","Pemiscot County",4,64,193,87,106
050,29,155,"Missouri","Pemiscot County",4,65,200,87,113
050,29,155,"Missouri","Pemiscot County",4,66,176,83,93
050,29,155,"Missouri","Pemiscot County",4,67,183,86,97
050,29,155,"Missouri","Pemiscot County",4,68,177,87,90
050,29,155,"Missouri","Pemiscot County",4,69,180,83,97
050,29,155,"Missouri","Pemiscot County",4,70,166,78,88
050,29,155,"Missouri","Pemiscot County",4,71,144,76,68
050,29,155,"Missouri","Pemiscot County",4,72,128,61,67
050,29,155,"Missouri","Pemiscot County",4,73,124,59,65
050,29,155,"Missouri","Pemiscot County",4,74,128,59,69
050,29,155,"Missouri","Pemiscot County",4,75,147,64,83
050,29,155,"Missouri","Pemiscot County",4,76,93,35,58
050,29,155,"Missouri","Pemiscot County",4,77,91,46,45
050,29,155,"Missouri","Pemiscot County",4,78,88,36,52
050,29,155,"Missouri","Pemiscot County",4,79,89,36,53
050,29,155,"Missouri","Pemiscot County",4,80,80,31,49
050,29,155,"Missouri","Pemiscot County",4,81,78,31,47
050,29,155,"Missouri","Pemiscot County",4,82,61,26,35
050,29,155,"Missouri","Pemiscot County",4,83,54,26,28
050,29,155,"Missouri","Pemiscot County",4,84,47,21,26
050,29,155,"Missouri","Pemiscot County",4,85,288,91,197
050,29,155,"Missouri","Pemiscot County",5,0,178,99,79
050,29,155,"Missouri","Pemiscot County",5,1,211,103,108
050,29,155,"Missouri","Pemiscot County",5,2,223,115,108
050,29,155,"Missouri","Pemiscot County",5,3,201,100,101
050,29,155,"Missouri","Pemiscot County",5,4,207,99,108
050,29,155,"Missouri","Pemiscot County",5,5,219,98,121
050,29,155,"Missouri","Pemiscot County",5,6,214,101,113
050,29,155,"Missouri","Pemiscot County",5,7,236,119,117
050,29,155,"Missouri","Pemiscot County",5,8,202,112,90
050,29,155,"Missouri","Pemiscot County",5,9,214,119,95
050,29,155,"Missouri","Pemiscot County",5,10,217,106,111
050,29,155,"Missouri","Pemiscot County",5,11,198,94,104
050,29,155,"Missouri","Pemiscot County",5,12,212,113,99
050,29,155,"Missouri","Pemiscot County",5,13,212,114,98
050,29,155,"Missouri","Pemiscot County",5,14,229,130,99
050,29,155,"Missouri","Pemiscot County",5,15,232,124,108
050,29,155,"Missouri","Pemiscot County",5,16,206,113,93
050,29,155,"Missouri","Pemiscot County",5,17,207,112,95
050,29,155,"Missouri","Pemiscot County",5,18,183,101,82
050,29,155,"Missouri","Pemiscot County",5,19,140,81,59
050,29,155,"Missouri","Pemiscot County",5,20,159,82,77
050,29,155,"Missouri","Pemiscot County",5,21,141,80,61
050,29,155,"Missouri","Pemiscot County",5,22,173,80,93
050,29,155,"Missouri","Pemiscot County",5,23,165,80,85
050,29,155,"Missouri","Pemiscot County",5,24,162,86,76
050,29,155,"Missouri","Pemiscot County",5,25,187,90,97
050,29,155,"Missouri","Pemiscot County",5,26,178,87,91
050,29,155,"Missouri","Pemiscot County",5,27,156,67,89
050,29,155,"Missouri","Pemiscot County",5,28,151,66,85
050,29,155,"Missouri","Pemiscot County",5,29,163,81,82
050,29,155,"Missouri","Pemiscot County",5,30,168,78,90
050,29,155,"Missouri","Pemiscot County",5,31,200,101,99
050,29,155,"Missouri","Pemiscot County",5,32,194,88,106
050,29,155,"Missouri","Pemiscot County",5,33,193,86,107
050,29,155,"Missouri","Pemiscot County",5,34,164,65,99
050,29,155,"Missouri","Pemiscot County",5,35,161,70,91
050,29,155,"Missouri","Pemiscot County",5,36,163,80,83
050,29,155,"Missouri","Pemiscot County",5,37,179,71,108
050,29,155,"Missouri","Pemiscot County",5,38,172,79,93
050,29,155,"Missouri","Pemiscot County",5,39,158,61,97
050,29,155,"Missouri","Pemiscot County",5,40,162,83,79
050,29,155,"Missouri","Pemiscot County",5,41,171,86,85
050,29,155,"Missouri","Pemiscot County",5,42,161,75,86
050,29,155,"Missouri","Pemiscot County",5,43,171,87,84
050,29,155,"Missouri","Pemiscot County",5,44,169,77,92
050,29,155,"Missouri","Pemiscot County",5,45,163,72,91
050,29,155,"Missouri","Pemiscot County",5,46,194,86,108
050,29,155,"Missouri","Pemiscot County",5,47,178,80,98
050,29,155,"Missouri","Pemiscot County",5,48,158,77,81
050,29,155,"Missouri","Pemiscot County",5,49,151,75,76
050,29,155,"Missouri","Pemiscot County",5,50,150,73,77
050,29,155,"Missouri","Pemiscot County",5,51,147,74,73
050,29,155,"Missouri","Pemiscot County",5,52,164,81,83
050,29,155,"Missouri","Pemiscot County",5,53,180,84,96
050,29,155,"Missouri","Pemiscot County",5,54,172,81,91
050,29,155,"Missouri","Pemiscot County",5,55,181,92,89
050,29,155,"Missouri","Pemiscot County",5,56,170,83,87
050,29,155,"Missouri","Pemiscot County",5,57,168,81,87
050,29,155,"Missouri","Pemiscot County",5,58,208,106,102
050,29,155,"Missouri","Pemiscot County",5,59,183,84,99
050,29,155,"Missouri","Pemiscot County",5,60,196,93,103
050,29,155,"Missouri","Pemiscot County",5,61,196,89,107
050,29,155,"Missouri","Pemiscot County",5,62,190,92,98
050,29,155,"Missouri","Pemiscot County",5,63,192,82,110
050,29,155,"Missouri","Pemiscot County",5,64,197,88,109
050,29,155,"Missouri","Pemiscot County",5,65,184,84,100
050,29,155,"Missouri","Pemiscot County",5,66,198,88,110
050,29,155,"Missouri","Pemiscot County",5,67,168,80,88
050,29,155,"Missouri","Pemiscot County",5,68,175,83,92
050,29,155,"Missouri","Pemiscot County",5,69,166,82,84
050,29,155,"Missouri","Pemiscot County",5,70,174,81,93
050,29,155,"Missouri","Pemiscot County",5,71,158,71,87
050,29,155,"Missouri","Pemiscot County",5,72,136,73,63
050,29,155,"Missouri","Pemiscot County",5,73,125,56,69
050,29,155,"Missouri","Pemiscot County",5,74,113,55,58
050,29,155,"Missouri","Pemiscot County",5,75,123,59,64
050,29,155,"Missouri","Pemiscot County",5,76,132,55,77
050,29,155,"Missouri","Pemiscot County",5,77,87,35,52
050,29,155,"Missouri","Pemiscot County",5,78,88,43,45
050,29,155,"Missouri","Pemiscot County",5,79,75,32,43
050,29,155,"Missouri","Pemiscot County",5,80,82,32,50
050,29,155,"Missouri","Pemiscot County",5,81,74,28,46
050,29,155,"Missouri","Pemiscot County",5,82,74,29,45
050,29,155,"Missouri","Pemiscot County",5,83,51,22,29
050,29,155,"Missouri","Pemiscot County",5,84,49,23,26
050,29,155,"Missouri","Pemiscot County",5,85,281,96,185
050,29,157,"Missouri","Perry County",1,0,210,106,104
050,29,157,"Missouri","Perry County",1,1,205,108,97
050,29,157,"Missouri","Perry County",1,2,212,114,98
050,29,157,"Missouri","Perry County",1,3,213,106,107
050,29,157,"Missouri","Perry County",1,4,241,127,114
050,29,157,"Missouri","Perry County",1,5,220,117,103
050,29,157,"Missouri","Perry County",1,6,226,114,112
050,29,157,"Missouri","Perry County",1,7,222,101,121
050,29,157,"Missouri","Perry County",1,8,235,108,127
050,29,157,"Missouri","Perry County",1,9,224,113,111
050,29,157,"Missouri","Perry County",1,10,231,120,111
050,29,157,"Missouri","Perry County",1,11,259,144,115
050,29,157,"Missouri","Perry County",1,12,286,153,133
050,29,157,"Missouri","Perry County",1,13,298,151,147
050,29,157,"Missouri","Perry County",1,14,278,153,125
050,29,157,"Missouri","Perry County",1,15,253,142,111
050,29,157,"Missouri","Perry County",1,16,298,152,146
050,29,157,"Missouri","Perry County",1,17,272,136,136
050,29,157,"Missouri","Perry County",1,18,220,127,93
050,29,157,"Missouri","Perry County",1,19,184,102,82
050,29,157,"Missouri","Perry County",1,20,190,99,91
050,29,157,"Missouri","Perry County",1,21,195,103,92
050,29,157,"Missouri","Perry County",1,22,190,99,91
050,29,157,"Missouri","Perry County",1,23,229,112,117
050,29,157,"Missouri","Perry County",1,24,223,99,124
050,29,157,"Missouri","Perry County",1,25,220,109,111
050,29,157,"Missouri","Perry County",1,26,224,117,107
050,29,157,"Missouri","Perry County",1,27,218,109,109
050,29,157,"Missouri","Perry County",1,28,218,102,116
050,29,157,"Missouri","Perry County",1,29,221,106,115
050,29,157,"Missouri","Perry County",1,30,224,111,113
050,29,157,"Missouri","Perry County",1,31,205,106,99
050,29,157,"Missouri","Perry County",1,32,194,96,98
050,29,157,"Missouri","Perry County",1,33,220,108,112
050,29,157,"Missouri","Perry County",1,34,203,106,97
050,29,157,"Missouri","Perry County",1,35,221,120,101
050,29,157,"Missouri","Perry County",1,36,214,112,102
050,29,157,"Missouri","Perry County",1,37,213,107,106
050,29,157,"Missouri","Perry County",1,38,236,118,118
050,29,157,"Missouri","Perry County",1,39,230,118,112
050,29,157,"Missouri","Perry County",1,40,236,133,103
050,29,157,"Missouri","Perry County",1,41,217,109,108
050,29,157,"Missouri","Perry County",1,42,253,128,125
050,29,157,"Missouri","Perry County",1,43,245,128,117
050,29,157,"Missouri","Perry County",1,44,219,108,111
050,29,157,"Missouri","Perry County",1,45,218,104,114
050,29,157,"Missouri","Perry County",1,46,228,109,119
050,29,157,"Missouri","Perry County",1,47,214,111,103
050,29,157,"Missouri","Perry County",1,48,236,127,109
050,29,157,"Missouri","Perry County",1,49,254,127,127
050,29,157,"Missouri","Perry County",1,50,227,116,111
050,29,157,"Missouri","Perry County",1,51,249,125,124
050,29,157,"Missouri","Perry County",1,52,250,128,122
050,29,157,"Missouri","Perry County",1,53,254,133,121
050,29,157,"Missouri","Perry County",1,54,258,142,116
050,29,157,"Missouri","Perry County",1,55,267,129,138
050,29,157,"Missouri","Perry County",1,56,272,140,132
050,29,157,"Missouri","Perry County",1,57,295,152,143
050,29,157,"Missouri","Perry County",1,58,285,149,136
050,29,157,"Missouri","Perry County",1,59,288,152,136
050,29,157,"Missouri","Perry County",1,60,283,147,136
050,29,157,"Missouri","Perry County",1,61,243,118,125
050,29,157,"Missouri","Perry County",1,62,241,103,138
050,29,157,"Missouri","Perry County",1,63,239,109,130
050,29,157,"Missouri","Perry County",1,64,253,129,124
050,29,157,"Missouri","Perry County",1,65,258,127,131
050,29,157,"Missouri","Perry County",1,66,260,120,140
050,29,157,"Missouri","Perry County",1,67,240,122,118
050,29,157,"Missouri","Perry County",1,68,235,124,111
050,29,157,"Missouri","Perry County",1,69,208,102,106
050,29,157,"Missouri","Perry County",1,70,202,96,106
050,29,157,"Missouri","Perry County",1,71,193,94,99
050,29,157,"Missouri","Perry County",1,72,173,83,90
050,29,157,"Missouri","Perry County",1,73,160,75,85
050,29,157,"Missouri","Perry County",1,74,130,70,60
050,29,157,"Missouri","Perry County",1,75,127,64,63
050,29,157,"Missouri","Perry County",1,76,130,61,69
050,29,157,"Missouri","Perry County",1,77,124,57,67
050,29,157,"Missouri","Perry County",1,78,131,64,67
050,29,157,"Missouri","Perry County",1,79,133,67,66
050,29,157,"Missouri","Perry County",1,80,112,51,61
050,29,157,"Missouri","Perry County",1,81,111,55,56
050,29,157,"Missouri","Perry County",1,82,89,42,47
050,29,157,"Missouri","Perry County",1,83,78,37,41
050,29,157,"Missouri","Perry County",1,84,76,34,42
050,29,157,"Missouri","Perry County",1,85,485,153,332
050,29,157,"Missouri","Perry County",2,0,204,108,96
050,29,157,"Missouri","Perry County",2,1,204,106,98
050,29,157,"Missouri","Perry County",2,2,208,111,97
050,29,157,"Missouri","Perry County",2,3,211,107,104
050,29,157,"Missouri","Perry County",2,4,234,122,112
050,29,157,"Missouri","Perry County",2,5,227,121,106
050,29,157,"Missouri","Perry County",2,6,226,116,110
050,29,157,"Missouri","Perry County",2,7,224,105,119
050,29,157,"Missouri","Perry County",2,8,232,108,124
050,29,157,"Missouri","Perry County",2,9,225,112,113
050,29,157,"Missouri","Perry County",2,10,230,121,109
050,29,157,"Missouri","Perry County",2,11,253,139,114
050,29,157,"Missouri","Perry County",2,12,283,151,132
050,29,157,"Missouri","Perry County",2,13,295,152,143
050,29,157,"Missouri","Perry County",2,14,281,151,130
050,29,157,"Missouri","Perry County",2,15,261,145,116
050,29,157,"Missouri","Perry County",2,16,290,150,140
050,29,157,"Missouri","Perry County",2,17,279,140,139
050,29,157,"Missouri","Perry County",2,18,221,124,97
050,29,157,"Missouri","Perry County",2,19,183,101,82
050,29,157,"Missouri","Perry County",2,20,196,105,91
050,29,157,"Missouri","Perry County",2,21,195,102,93
050,29,157,"Missouri","Perry County",2,22,192,100,92
050,29,157,"Missouri","Perry County",2,23,223,109,114
050,29,157,"Missouri","Perry County",2,24,223,103,120
050,29,157,"Missouri","Perry County",2,25,222,107,115
050,29,157,"Missouri","Perry County",2,26,225,117,108
050,29,157,"Missouri","Perry County",2,27,217,109,108
050,29,157,"Missouri","Perry County",2,28,218,104,114
050,29,157,"Missouri","Perry County",2,29,221,105,116
050,29,157,"Missouri","Perry County",2,30,225,111,114
050,29,157,"Missouri","Perry County",2,31,212,108,104
050,29,157,"Missouri","Perry County",2,32,195,97,98
050,29,157,"Missouri","Perry County",2,33,214,105,109
050,29,157,"Missouri","Perry County",2,34,209,107,102
050,29,157,"Missouri","Perry County",2,35,221,118,103
050,29,157,"Missouri","Perry County",2,36,214,112,102
050,29,157,"Missouri","Perry County",2,37,216,109,107
050,29,157,"Missouri","Perry County",2,38,233,117,116
050,29,157,"Missouri","Perry County",2,39,230,117,113
050,29,157,"Missouri","Perry County",2,40,235,128,107
050,29,157,"Missouri","Perry County",2,41,224,116,108
050,29,157,"Missouri","Perry County",2,42,242,123,119
050,29,157,"Missouri","Perry County",2,43,249,129,120
050,29,157,"Missouri","Perry County",2,44,224,112,112
050,29,157,"Missouri","Perry County",2,45,219,106,113
050,29,157,"Missouri","Perry County",2,46,224,107,117
050,29,157,"Missouri","Perry County",2,47,216,111,105
050,29,157,"Missouri","Perry County",2,48,232,124,108
050,29,157,"Missouri","Perry County",2,49,249,127,122
050,29,157,"Missouri","Perry County",2,50,231,118,113
050,29,157,"Missouri","Perry County",2,51,244,123,121
050,29,157,"Missouri","Perry County",2,52,250,127,123
050,29,157,"Missouri","Perry County",2,53,254,132,122
050,29,157,"Missouri","Perry County",2,54,256,139,117
050,29,157,"Missouri","Perry County",2,55,263,131,132
050,29,157,"Missouri","Perry County",2,56,271,137,134
050,29,157,"Missouri","Perry County",2,57,291,151,140
050,29,157,"Missouri","Perry County",2,58,287,150,137
050,29,157,"Missouri","Perry County",2,59,291,155,136
050,29,157,"Missouri","Perry County",2,60,283,147,136
050,29,157,"Missouri","Perry County",2,61,251,124,127
050,29,157,"Missouri","Perry County",2,62,239,106,133
050,29,157,"Missouri","Perry County",2,63,243,109,134
050,29,157,"Missouri","Perry County",2,64,249,124,125
050,29,157,"Missouri","Perry County",2,65,255,127,128
050,29,157,"Missouri","Perry County",2,66,262,123,139
050,29,157,"Missouri","Perry County",2,67,242,121,121
050,29,157,"Missouri","Perry County",2,68,234,122,112
050,29,157,"Missouri","Perry County",2,69,215,107,108
050,29,157,"Missouri","Perry County",2,70,203,97,106
050,29,157,"Missouri","Perry County",2,71,197,95,102
050,29,157,"Missouri","Perry County",2,72,173,83,90
050,29,157,"Missouri","Perry County",2,73,169,81,88
050,29,157,"Missouri","Perry County",2,74,129,68,61
050,29,157,"Missouri","Perry County",2,75,126,64,62
050,29,157,"Missouri","Perry County",2,76,125,59,66
050,29,157,"Missouri","Perry County",2,77,128,59,69
050,29,157,"Missouri","Perry County",2,78,127,61,66
050,29,157,"Missouri","Perry County",2,79,133,67,66
050,29,157,"Missouri","Perry County",2,80,117,55,62
050,29,157,"Missouri","Perry County",2,81,111,53,58
050,29,157,"Missouri","Perry County",2,82,93,44,49
050,29,157,"Missouri","Perry County",2,83,80,37,43
050,29,157,"Missouri","Perry County",2,84,72,33,39
050,29,157,"Missouri","Perry County",2,85,490,158,332
050,29,157,"Missouri","Perry County",3,0,213,122,91
050,29,157,"Missouri","Perry County",3,1,217,114,103
050,29,157,"Missouri","Perry County",3,2,204,106,98
050,29,157,"Missouri","Perry County",3,3,195,107,88
050,29,157,"Missouri","Perry County",3,4,206,110,96
050,29,157,"Missouri","Perry County",3,5,235,122,113
050,29,157,"Missouri","Perry County",3,6,235,122,113
050,29,157,"Missouri","Perry County",3,7,222,117,105
050,29,157,"Missouri","Perry County",3,8,231,113,118
050,29,157,"Missouri","Perry County",3,9,219,98,121
050,29,157,"Missouri","Perry County",3,10,229,118,111
050,29,157,"Missouri","Perry County",3,11,239,122,117
050,29,157,"Missouri","Perry County",3,12,256,137,119
050,29,157,"Missouri","Perry County",3,13,284,147,137
050,29,157,"Missouri","Perry County",3,14,297,152,145
050,29,157,"Missouri","Perry County",3,15,269,143,126
050,29,157,"Missouri","Perry County",3,16,266,145,121
050,29,157,"Missouri","Perry County",3,17,292,148,144
050,29,157,"Missouri","Perry County",3,18,239,130,109
050,29,157,"Missouri","Perry County",3,19,175,96,79
050,29,157,"Missouri","Perry County",3,20,206,115,91
050,29,157,"Missouri","Perry County",3,21,207,111,96
050,29,157,"Missouri","Perry County",3,22,204,106,98
050,29,157,"Missouri","Perry County",3,23,207,108,99
050,29,157,"Missouri","Perry County",3,24,230,114,116
050,29,157,"Missouri","Perry County",3,25,223,97,126
050,29,157,"Missouri","Perry County",3,26,215,102,113
050,29,157,"Missouri","Perry County",3,27,224,120,104
050,29,157,"Missouri","Perry County",3,28,206,101,105
050,29,157,"Missouri","Perry County",3,29,222,109,113
050,29,157,"Missouri","Perry County",3,30,220,105,115
050,29,157,"Missouri","Perry County",3,31,232,112,120
050,29,157,"Missouri","Perry County",3,32,210,106,104
050,29,157,"Missouri","Perry County",3,33,185,96,89
050,29,157,"Missouri","Perry County",3,34,224,114,110
050,29,157,"Missouri","Perry County",3,35,218,111,107
050,29,157,"Missouri","Perry County",3,36,219,114,105
050,29,157,"Missouri","Perry County",3,37,204,105,99
050,29,157,"Missouri","Perry County",3,38,222,112,110
050,29,157,"Missouri","Perry County",3,39,240,123,117
050,29,157,"Missouri","Perry County",3,40,226,112,114
050,29,157,"Missouri","Perry County",3,41,229,123,106
050,29,157,"Missouri","Perry County",3,42,235,122,113
050,29,157,"Missouri","Perry County",3,43,250,130,120
050,29,157,"Missouri","Perry County",3,44,244,126,118
050,29,157,"Missouri","Perry County",3,45,224,109,115
050,29,157,"Missouri","Perry County",3,46,228,108,120
050,29,157,"Missouri","Perry County",3,47,215,104,111
050,29,157,"Missouri","Perry County",3,48,209,102,107
050,29,157,"Missouri","Perry County",3,49,233,123,110
050,29,157,"Missouri","Perry County",3,50,247,126,121
050,29,157,"Missouri","Perry County",3,51,234,121,113
050,29,157,"Missouri","Perry County",3,52,240,120,120
050,29,157,"Missouri","Perry County",3,53,255,132,123
050,29,157,"Missouri","Perry County",3,54,255,132,123
050,29,157,"Missouri","Perry County",3,55,251,133,118
050,29,157,"Missouri","Perry County",3,56,263,133,130
050,29,157,"Missouri","Perry County",3,57,271,140,131
050,29,157,"Missouri","Perry County",3,58,282,147,135
050,29,157,"Missouri","Perry County",3,59,288,154,134
050,29,157,"Missouri","Perry County",3,60,287,145,142
050,29,157,"Missouri","Perry County",3,61,285,148,137
050,29,157,"Missouri","Perry County",3,62,245,124,121
050,29,157,"Missouri","Perry County",3,63,243,109,134
050,29,157,"Missouri","Perry County",3,64,238,108,130
050,29,157,"Missouri","Perry County",3,65,245,118,127
050,29,157,"Missouri","Perry County",3,66,249,122,127
050,29,157,"Missouri","Perry County",3,67,249,115,134
050,29,157,"Missouri","Perry County",3,68,247,125,122
050,29,157,"Missouri","Perry County",3,69,224,116,108
050,29,157,"Missouri","Perry County",3,70,208,104,104
050,29,157,"Missouri","Perry County",3,71,204,95,109
050,29,157,"Missouri","Perry County",3,72,187,91,96
050,29,157,"Missouri","Perry County",3,73,166,78,88
050,29,157,"Missouri","Perry County",3,74,171,84,87
050,29,157,"Missouri","Perry County",3,75,125,67,58
050,29,157,"Missouri","Perry County",3,76,122,59,63
050,29,157,"Missouri","Perry County",3,77,114,54,60
050,29,157,"Missouri","Perry County",3,78,124,55,69
050,29,157,"Missouri","Perry County",3,79,126,62,64
050,29,157,"Missouri","Perry County",3,80,125,63,62
050,29,157,"Missouri","Perry County",3,81,114,56,58
050,29,157,"Missouri","Perry County",3,82,98,45,53
050,29,157,"Missouri","Perry County",3,83,90,37,53
050,29,157,"Missouri","Perry County",3,84,68,32,36
050,29,157,"Missouri","Perry County",3,85,498,170,328
050,29,157,"Missouri","Perry County",4,0,203,108,95
050,29,157,"Missouri","Perry County",4,1,218,124,94
050,29,157,"Missouri","Perry County",4,2,212,114,98
050,29,157,"Missouri","Perry County",4,3,210,112,98
050,29,157,"Missouri","Perry County",4,4,213,111,102
050,29,157,"Missouri","Perry County",4,5,210,111,99
050,29,157,"Missouri","Perry County",4,6,240,127,113
050,29,157,"Missouri","Perry County",4,7,226,121,105
050,29,157,"Missouri","Perry County",4,8,225,109,116
050,29,157,"Missouri","Perry County",4,9,221,107,114
050,29,157,"Missouri","Perry County",4,10,224,99,125
050,29,157,"Missouri","Perry County",4,11,231,118,113
050,29,157,"Missouri","Perry County",4,12,239,122,117
050,29,157,"Missouri","Perry County",4,13,246,135,111
050,29,157,"Missouri","Perry County",4,14,287,154,133
050,29,157,"Missouri","Perry County",4,15,292,150,142
050,29,157,"Missouri","Perry County",4,16,275,143,132
050,29,157,"Missouri","Perry County",4,17,256,140,116
050,29,157,"Missouri","Perry County",4,18,240,127,113
050,29,157,"Missouri","Perry County",4,19,185,102,83
050,29,157,"Missouri","Perry County",4,20,183,101,82
050,29,157,"Missouri","Perry County",4,21,203,113,90
050,29,157,"Missouri","Perry County",4,22,221,117,104
050,29,157,"Missouri","Perry County",4,23,209,109,100
050,29,157,"Missouri","Perry County",4,24,198,103,95
050,29,157,"Missouri","Perry County",4,25,226,111,115
050,29,157,"Missouri","Perry County",4,26,234,102,132
050,29,157,"Missouri","Perry County",4,27,212,103,109
050,29,157,"Missouri","Perry County",4,28,210,123,87
050,29,157,"Missouri","Perry County",4,29,206,102,104
050,29,157,"Missouri","Perry County",4,30,223,113,110
050,29,157,"Missouri","Perry County",4,31,225,105,120
050,29,157,"Missouri","Perry County",4,32,228,111,117
050,29,157,"Missouri","Perry County",4,33,199,103,96
050,29,157,"Missouri","Perry County",4,34,186,96,90
050,29,157,"Missouri","Perry County",4,35,225,114,111
050,29,157,"Missouri","Perry County",4,36,223,113,110
050,29,157,"Missouri","Perry County",4,37,225,120,105
050,29,157,"Missouri","Perry County",4,38,208,111,97
050,29,157,"Missouri","Perry County",4,39,231,121,110
050,29,157,"Missouri","Perry County",4,40,239,123,116
050,29,157,"Missouri","Perry County",4,41,231,115,116
050,29,157,"Missouri","Perry County",4,42,236,126,110
050,29,157,"Missouri","Perry County",4,43,235,123,112
050,29,157,"Missouri","Perry County",4,44,238,121,117
050,29,157,"Missouri","Perry County",4,45,244,125,119
050,29,157,"Missouri","Perry County",4,46,224,109,115
050,29,157,"Missouri","Perry County",4,47,216,107,109
050,29,157,"Missouri","Perry County",4,48,215,103,112
050,29,157,"Missouri","Perry County",4,49,206,101,105
050,29,157,"Missouri","Perry County",4,50,239,128,111
050,29,157,"Missouri","Perry County",4,51,244,126,118
050,29,157,"Missouri","Perry County",4,52,238,120,118
050,29,157,"Missouri","Perry County",4,53,239,118,121
050,29,157,"Missouri","Perry County",4,54,251,130,121
050,29,157,"Missouri","Perry County",4,55,247,128,119
050,29,157,"Missouri","Perry County",4,56,242,125,117
050,29,157,"Missouri","Perry County",4,57,266,139,127
050,29,157,"Missouri","Perry County",4,58,263,134,129
050,29,157,"Missouri","Perry County",4,59,289,157,132
050,29,157,"Missouri","Perry County",4,60,278,143,135
050,29,157,"Missouri","Perry County",4,61,295,152,143
050,29,157,"Missouri","Perry County",4,62,284,150,134
050,29,157,"Missouri","Perry County",4,63,244,122,122
050,29,157,"Missouri","Perry County",4,64,243,107,136
050,29,157,"Missouri","Perry County",4,65,237,105,132
050,29,157,"Missouri","Perry County",4,66,240,114,126
050,29,157,"Missouri","Perry County",4,67,238,119,119
050,29,157,"Missouri","Perry County",4,68,250,117,133
050,29,157,"Missouri","Perry County",4,69,231,112,119
050,29,157,"Missouri","Perry County",4,70,220,115,105
050,29,157,"Missouri","Perry County",4,71,203,101,102
050,29,157,"Missouri","Perry County",4,72,203,98,105
050,29,157,"Missouri","Perry County",4,73,176,86,90
050,29,157,"Missouri","Perry County",4,74,162,76,86
050,29,157,"Missouri","Perry County",4,75,164,83,81
050,29,157,"Missouri","Perry County",4,76,122,62,60
050,29,157,"Missouri","Perry County",4,77,120,59,61
050,29,157,"Missouri","Perry County",4,78,108,50,58
050,29,157,"Missouri","Perry County",4,79,119,51,68
050,29,157,"Missouri","Perry County",4,80,123,62,61
050,29,157,"Missouri","Perry County",4,81,123,63,60
050,29,157,"Missouri","Perry County",4,82,100,49,51
050,29,157,"Missouri","Perry County",4,83,95,38,57
050,29,157,"Missouri","Perry County",4,84,77,33,44
050,29,157,"Missouri","Perry County",4,85,493,172,321
050,29,157,"Missouri","Perry County",5,0,203,108,95
050,29,157,"Missouri","Perry County",5,1,217,116,101
050,29,157,"Missouri","Perry County",5,2,215,124,91
050,29,157,"Missouri","Perry County",5,3,220,113,107
050,29,157,"Missouri","Perry County",5,4,216,124,92
050,29,157,"Missouri","Perry County",5,5,204,106,98
050,29,157,"Missouri","Perry County",5,6,217,114,103
050,29,157,"Missouri","Perry County",5,7,236,119,117
050,29,157,"Missouri","Perry County",5,8,225,119,106
050,29,157,"Missouri","Perry County",5,9,221,107,114
050,29,157,"Missouri","Perry County",5,10,220,106,114
050,29,157,"Missouri","Perry County",5,11,226,103,123
050,29,157,"Missouri","Perry County",5,12,229,117,112
050,29,157,"Missouri","Perry County",5,13,237,119,118
050,29,157,"Missouri","Perry County",5,14,248,132,116
050,29,157,"Missouri","Perry County",5,15,284,151,133
050,29,157,"Missouri","Perry County",5,16,291,153,138
050,29,157,"Missouri","Perry County",5,17,276,136,140
050,29,157,"Missouri","Perry County",5,18,205,118,87
050,29,157,"Missouri","Perry County",5,19,190,99,91
050,29,157,"Missouri","Perry County",5,20,198,111,87
050,29,157,"Missouri","Perry County",5,21,192,106,86
050,29,157,"Missouri","Perry County",5,22,203,111,92
050,29,157,"Missouri","Perry County",5,23,236,121,115
050,29,157,"Missouri","Perry County",5,24,208,107,101
050,29,157,"Missouri","Perry County",5,25,204,110,94
050,29,157,"Missouri","Perry County",5,26,222,107,115
050,29,157,"Missouri","Perry County",5,27,230,99,131
050,29,157,"Missouri","Perry County",5,28,205,100,105
050,29,157,"Missouri","Perry County",5,29,208,124,84
050,29,157,"Missouri","Perry County",5,30,204,100,104
050,29,157,"Missouri","Perry County",5,31,223,110,113
050,29,157,"Missouri","Perry County",5,32,222,101,121
050,29,157,"Missouri","Perry County",5,33,229,108,121
050,29,157,"Missouri","Perry County",5,34,205,106,99
050,29,157,"Missouri","Perry County",5,35,203,107,96
050,29,157,"Missouri","Perry County",5,36,230,114,116
050,29,157,"Missouri","Perry County",5,37,223,115,108
050,29,157,"Missouri","Perry County",5,38,227,121,106
050,29,157,"Missouri","Perry County",5,39,217,124,93
050,29,157,"Missouri","Perry County",5,40,229,120,109
050,29,157,"Missouri","Perry County",5,41,244,126,118
050,29,157,"Missouri","Perry County",5,42,240,123,117
050,29,157,"Missouri","Perry County",5,43,244,133,111
050,29,157,"Missouri","Perry County",5,44,233,119,114
050,29,157,"Missouri","Perry County",5,45,245,121,124
050,29,157,"Missouri","Perry County",5,46,250,125,125
050,29,157,"Missouri","Perry County",5,47,221,108,113
050,29,157,"Missouri","Perry County",5,48,216,107,109
050,29,157,"Missouri","Perry County",5,49,218,106,112
050,29,157,"Missouri","Perry County",5,50,208,97,111
050,29,157,"Missouri","Perry County",5,51,249,131,118
050,29,157,"Missouri","Perry County",5,52,238,125,113
050,29,157,"Missouri","Perry County",5,53,238,119,119
050,29,157,"Missouri","Perry County",5,54,244,117,127
050,29,157,"Missouri","Perry County",5,55,243,127,116
050,29,157,"Missouri","Perry County",5,56,248,130,118
050,29,157,"Missouri","Perry County",5,57,249,129,120
050,29,157,"Missouri","Perry County",5,58,261,137,124
050,29,157,"Missouri","Perry County",5,59,273,141,132
050,29,157,"Missouri","Perry County",5,60,287,153,134
050,29,157,"Missouri","Perry County",5,61,278,141,137
050,29,157,"Missouri","Perry County",5,62,291,155,136
050,29,157,"Missouri","Perry County",5,63,281,152,129
050,29,157,"Missouri","Perry County",5,64,246,118,128
050,29,157,"Missouri","Perry County",5,65,242,101,141
050,29,157,"Missouri","Perry County",5,66,242,108,134
050,29,157,"Missouri","Perry County",5,67,236,111,125
050,29,157,"Missouri","Perry County",5,68,244,125,119
050,29,157,"Missouri","Perry County",5,69,245,114,131
050,29,157,"Missouri","Perry County",5,70,225,110,115
050,29,157,"Missouri","Perry County",5,71,219,113,106
050,29,157,"Missouri","Perry County",5,72,199,102,97
050,29,157,"Missouri","Perry County",5,73,192,92,100
050,29,157,"Missouri","Perry County",5,74,178,85,93
050,29,157,"Missouri","Perry County",5,75,162,75,87
050,29,157,"Missouri","Perry County",5,76,160,80,80
050,29,157,"Missouri","Perry County",5,77,117,60,57
050,29,157,"Missouri","Perry County",5,78,110,53,57
050,29,157,"Missouri","Perry County",5,79,99,45,54
050,29,157,"Missouri","Perry County",5,80,116,49,67
050,29,157,"Missouri","Perry County",5,81,120,63,57
050,29,157,"Missouri","Perry County",5,82,110,58,52
050,29,157,"Missouri","Perry County",5,83,96,42,54
050,29,157,"Missouri","Perry County",5,84,84,35,49
050,29,157,"Missouri","Perry County",5,85,511,183,328
050,29,159,"Missouri","Pettis County",1,0,604,306,298
050,29,159,"Missouri","Pettis County",1,1,614,320,294
050,29,159,"Missouri","Pettis County",1,2,580,310,270
050,29,159,"Missouri","Pettis County",1,3,571,297,274
050,29,159,"Missouri","Pettis County",1,4,588,292,296
050,29,159,"Missouri","Pettis County",1,5,587,309,278
050,29,159,"Missouri","Pettis County",1,6,596,289,307
050,29,159,"Missouri","Pettis County",1,7,586,308,278
050,29,159,"Missouri","Pettis County",1,8,585,327,258
050,29,159,"Missouri","Pettis County",1,9,588,314,274
050,29,159,"Missouri","Pettis County",1,10,600,321,279
050,29,159,"Missouri","Pettis County",1,11,609,333,276
050,29,159,"Missouri","Pettis County",1,12,649,340,309
050,29,159,"Missouri","Pettis County",1,13,651,341,310
050,29,159,"Missouri","Pettis County",1,14,647,352,295
050,29,159,"Missouri","Pettis County",1,15,594,321,273
050,29,159,"Missouri","Pettis County",1,16,579,314,265
050,29,159,"Missouri","Pettis County",1,17,602,307,295
050,29,159,"Missouri","Pettis County",1,18,521,276,245
050,29,159,"Missouri","Pettis County",1,19,459,252,207
050,29,159,"Missouri","Pettis County",1,20,490,241,249
050,29,159,"Missouri","Pettis County",1,21,507,263,244
050,29,159,"Missouri","Pettis County",1,22,507,261,246
050,29,159,"Missouri","Pettis County",1,23,510,257,253
050,29,159,"Missouri","Pettis County",1,24,504,253,251
050,29,159,"Missouri","Pettis County",1,25,497,248,249
050,29,159,"Missouri","Pettis County",1,26,514,230,284
050,29,159,"Missouri","Pettis County",1,27,537,265,272
050,29,159,"Missouri","Pettis County",1,28,565,292,273
050,29,159,"Missouri","Pettis County",1,29,597,291,306
050,29,159,"Missouri","Pettis County",1,30,554,270,284
050,29,159,"Missouri","Pettis County",1,31,540,261,279
050,29,159,"Missouri","Pettis County",1,32,523,271,252
050,29,159,"Missouri","Pettis County",1,33,540,277,263
050,29,159,"Missouri","Pettis County",1,34,575,292,283
050,29,159,"Missouri","Pettis County",1,35,585,309,276
050,29,159,"Missouri","Pettis County",1,36,565,270,295
050,29,159,"Missouri","Pettis County",1,37,568,285,283
050,29,159,"Missouri","Pettis County",1,38,536,261,275
050,29,159,"Missouri","Pettis County",1,39,558,290,268
050,29,159,"Missouri","Pettis County",1,40,561,283,278
050,29,159,"Missouri","Pettis County",1,41,543,291,252
050,29,159,"Missouri","Pettis County",1,42,508,266,242
050,29,159,"Missouri","Pettis County",1,43,455,229,226
050,29,159,"Missouri","Pettis County",1,44,464,232,232
050,29,159,"Missouri","Pettis County",1,45,487,236,251
050,29,159,"Missouri","Pettis County",1,46,460,241,219
050,29,159,"Missouri","Pettis County",1,47,487,234,253
050,29,159,"Missouri","Pettis County",1,48,491,257,234
050,29,159,"Missouri","Pettis County",1,49,491,249,242
050,29,159,"Missouri","Pettis County",1,50,482,247,235
050,29,159,"Missouri","Pettis County",1,51,457,241,216
050,29,159,"Missouri","Pettis County",1,52,469,252,217
050,29,159,"Missouri","Pettis County",1,53,492,243,249
050,29,159,"Missouri","Pettis County",1,54,529,256,273
050,29,159,"Missouri","Pettis County",1,55,555,272,283
050,29,159,"Missouri","Pettis County",1,56,566,286,280
050,29,159,"Missouri","Pettis County",1,57,606,294,312
050,29,159,"Missouri","Pettis County",1,58,596,283,313
050,29,159,"Missouri","Pettis County",1,59,632,310,322
050,29,159,"Missouri","Pettis County",1,60,591,306,285
050,29,159,"Missouri","Pettis County",1,61,549,290,259
050,29,159,"Missouri","Pettis County",1,62,556,283,273
050,29,159,"Missouri","Pettis County",1,63,561,281,280
050,29,159,"Missouri","Pettis County",1,64,542,261,281
050,29,159,"Missouri","Pettis County",1,65,540,255,285
050,29,159,"Missouri","Pettis County",1,66,480,233,247
050,29,159,"Missouri","Pettis County",1,67,451,219,232
050,29,159,"Missouri","Pettis County",1,68,455,218,237
050,29,159,"Missouri","Pettis County",1,69,421,204,217
050,29,159,"Missouri","Pettis County",1,70,427,221,206
050,29,159,"Missouri","Pettis County",1,71,399,204,195
050,29,159,"Missouri","Pettis County",1,72,360,173,187
050,29,159,"Missouri","Pettis County",1,73,370,175,195
050,29,159,"Missouri","Pettis County",1,74,266,120,146
050,29,159,"Missouri","Pettis County",1,75,287,138,149
050,29,159,"Missouri","Pettis County",1,76,264,116,148
050,29,159,"Missouri","Pettis County",1,77,246,107,139
050,29,159,"Missouri","Pettis County",1,78,243,111,132
050,29,159,"Missouri","Pettis County",1,79,207,86,121
050,29,159,"Missouri","Pettis County",1,80,195,83,112
050,29,159,"Missouri","Pettis County",1,81,186,77,109
050,29,159,"Missouri","Pettis County",1,82,174,81,93
050,29,159,"Missouri","Pettis County",1,83,166,67,99
050,29,159,"Missouri","Pettis County",1,84,159,63,96
050,29,159,"Missouri","Pettis County",1,85,976,336,640
050,29,159,"Missouri","Pettis County",2,0,605,313,292
050,29,159,"Missouri","Pettis County",2,1,607,318,289
050,29,159,"Missouri","Pettis County",2,2,588,311,277
050,29,159,"Missouri","Pettis County",2,3,573,298,275
050,29,159,"Missouri","Pettis County",2,4,587,297,290
050,29,159,"Missouri","Pettis County",2,5,588,305,283
050,29,159,"Missouri","Pettis County",2,6,599,297,302
050,29,159,"Missouri","Pettis County",2,7,590,305,285
050,29,159,"Missouri","Pettis County",2,8,585,323,262
050,29,159,"Missouri","Pettis County",2,9,589,318,271
050,29,159,"Missouri","Pettis County",2,10,594,319,275
050,29,159,"Missouri","Pettis County",2,11,600,325,275
050,29,159,"Missouri","Pettis County",2,12,649,342,307
050,29,159,"Missouri","Pettis County",2,13,650,341,309
050,29,159,"Missouri","Pettis County",2,14,649,349,300
050,29,159,"Missouri","Pettis County",2,15,608,329,279
050,29,159,"Missouri","Pettis County",2,16,585,317,268
050,29,159,"Missouri","Pettis County",2,17,598,314,284
050,29,159,"Missouri","Pettis County",2,18,519,274,245
050,29,159,"Missouri","Pettis County",2,19,459,248,211
050,29,159,"Missouri","Pettis County",2,20,493,248,245
050,29,159,"Missouri","Pettis County",2,21,512,262,250
050,29,159,"Missouri","Pettis County",2,22,503,256,247
050,29,159,"Missouri","Pettis County",2,23,516,262,254
050,29,159,"Missouri","Pettis County",2,24,507,258,249
050,29,159,"Missouri","Pettis County",2,25,498,250,248
050,29,159,"Missouri","Pettis County",2,26,509,236,273
050,29,159,"Missouri","Pettis County",2,27,534,260,274
050,29,159,"Missouri","Pettis County",2,28,549,279,270
050,29,159,"Missouri","Pettis County",2,29,588,290,298
050,29,159,"Missouri","Pettis County",2,30,569,274,295
050,29,159,"Missouri","Pettis County",2,31,542,261,281
050,29,159,"Missouri","Pettis County",2,32,525,268,257
050,29,159,"Missouri","Pettis County",2,33,538,277,261
050,29,159,"Missouri","Pettis County",2,34,570,291,279
050,29,159,"Missouri","Pettis County",2,35,591,308,283
050,29,159,"Missouri","Pettis County",2,36,568,280,288
050,29,159,"Missouri","Pettis County",2,37,564,278,286
050,29,159,"Missouri","Pettis County",2,38,547,268,279
050,29,159,"Missouri","Pettis County",2,39,549,280,269
050,29,159,"Missouri","Pettis County",2,40,563,286,277
050,29,159,"Missouri","Pettis County",2,41,548,291,257
050,29,159,"Missouri","Pettis County",2,42,513,270,243
050,29,159,"Missouri","Pettis County",2,43,471,238,233
050,29,159,"Missouri","Pettis County",2,44,456,228,228
050,29,159,"Missouri","Pettis County",2,45,480,235,245
050,29,159,"Missouri","Pettis County",2,46,466,241,225
050,29,159,"Missouri","Pettis County",2,47,481,236,245
050,29,159,"Missouri","Pettis County",2,48,491,251,240
050,29,159,"Missouri","Pettis County",2,49,491,249,242
050,29,159,"Missouri","Pettis County",2,50,488,248,240
050,29,159,"Missouri","Pettis County",2,51,459,241,218
050,29,159,"Missouri","Pettis County",2,52,467,250,217
050,29,159,"Missouri","Pettis County",2,53,487,244,243
050,29,159,"Missouri","Pettis County",2,54,518,253,265
050,29,159,"Missouri","Pettis County",2,55,548,268,280
050,29,159,"Missouri","Pettis County",2,56,561,281,280
050,29,159,"Missouri","Pettis County",2,57,595,291,304
050,29,159,"Missouri","Pettis County",2,58,601,285,316
050,29,159,"Missouri","Pettis County",2,59,621,302,319
050,29,159,"Missouri","Pettis County",2,60,598,306,292
050,29,159,"Missouri","Pettis County",2,61,554,293,261
050,29,159,"Missouri","Pettis County",2,62,548,280,268
050,29,159,"Missouri","Pettis County",2,63,559,282,277
050,29,159,"Missouri","Pettis County",2,64,544,266,278
050,29,159,"Missouri","Pettis County",2,65,535,251,284
050,29,159,"Missouri","Pettis County",2,66,495,238,257
050,29,159,"Missouri","Pettis County",2,67,450,219,231
050,29,159,"Missouri","Pettis County",2,68,447,216,231
050,29,159,"Missouri","Pettis County",2,69,435,210,225
050,29,159,"Missouri","Pettis County",2,70,425,216,209
050,29,159,"Missouri","Pettis County",2,71,406,205,201
050,29,159,"Missouri","Pettis County",2,72,359,177,182
050,29,159,"Missouri","Pettis County",2,73,381,181,200
050,29,159,"Missouri","Pettis County",2,74,268,121,147
050,29,159,"Missouri","Pettis County",2,75,281,132,149
050,29,159,"Missouri","Pettis County",2,76,261,119,142
050,29,159,"Missouri","Pettis County",2,77,256,112,144
050,29,159,"Missouri","Pettis County",2,78,238,109,129
050,29,159,"Missouri","Pettis County",2,79,211,89,122
050,29,159,"Missouri","Pettis County",2,80,193,81,112
050,29,159,"Missouri","Pettis County",2,81,184,76,108
050,29,159,"Missouri","Pettis County",2,82,176,77,99
050,29,159,"Missouri","Pettis County",2,83,161,67,94
050,29,159,"Missouri","Pettis County",2,84,157,63,94
050,29,159,"Missouri","Pettis County",2,85,985,338,647
050,29,159,"Missouri","Pettis County",3,0,578,294,284
050,29,159,"Missouri","Pettis County",3,1,627,322,305
050,29,159,"Missouri","Pettis County",3,2,621,321,300
050,29,159,"Missouri","Pettis County",3,3,585,312,273
050,29,159,"Missouri","Pettis County",3,4,586,312,274
050,29,159,"Missouri","Pettis County",3,5,593,297,296
050,29,159,"Missouri","Pettis County",3,6,601,311,290
050,29,159,"Missouri","Pettis County",3,7,610,309,301
050,29,159,"Missouri","Pettis County",3,8,599,312,287
050,29,159,"Missouri","Pettis County",3,9,601,333,268
050,29,159,"Missouri","Pettis County",3,10,594,317,277
050,29,159,"Missouri","Pettis County",3,11,587,327,260
050,29,159,"Missouri","Pettis County",3,12,598,325,273
050,29,159,"Missouri","Pettis County",3,13,643,329,314
050,29,159,"Missouri","Pettis County",3,14,646,344,302
050,29,159,"Missouri","Pettis County",3,15,632,337,295
050,29,159,"Missouri","Pettis County",3,16,605,318,287
050,29,159,"Missouri","Pettis County",3,17,577,318,259
050,29,159,"Missouri","Pettis County",3,18,518,281,237
050,29,159,"Missouri","Pettis County",3,19,452,233,219
050,29,159,"Missouri","Pettis County",3,20,496,262,234
050,29,159,"Missouri","Pettis County",3,21,552,289,263
050,29,159,"Missouri","Pettis County",3,22,536,259,277
050,29,159,"Missouri","Pettis County",3,23,538,275,263
050,29,159,"Missouri","Pettis County",3,24,514,266,248
050,29,159,"Missouri","Pettis County",3,25,499,249,250
050,29,159,"Missouri","Pettis County",3,26,506,254,252
050,29,159,"Missouri","Pettis County",3,27,519,236,283
050,29,159,"Missouri","Pettis County",3,28,539,266,273
050,29,159,"Missouri","Pettis County",3,29,560,288,272
050,29,159,"Missouri","Pettis County",3,30,581,276,305
050,29,159,"Missouri","Pettis County",3,31,564,272,292
050,29,159,"Missouri","Pettis County",3,32,527,262,265
050,29,159,"Missouri","Pettis County",3,33,540,275,265
050,29,159,"Missouri","Pettis County",3,34,570,293,277
050,29,159,"Missouri","Pettis County",3,35,569,291,278
050,29,159,"Missouri","Pettis County",3,36,596,319,277
050,29,159,"Missouri","Pettis County",3,37,556,273,283
050,29,159,"Missouri","Pettis County",3,38,573,284,289
050,29,159,"Missouri","Pettis County",3,39,555,267,288
050,29,159,"Missouri","Pettis County",3,40,556,278,278
050,29,159,"Missouri","Pettis County",3,41,572,292,280
050,29,159,"Missouri","Pettis County",3,42,550,297,253
050,29,159,"Missouri","Pettis County",3,43,497,253,244
050,29,159,"Missouri","Pettis County",3,44,469,246,223
050,29,159,"Missouri","Pettis County",3,45,456,223,233
050,29,159,"Missouri","Pettis County",3,46,480,238,242
050,29,159,"Missouri","Pettis County",3,47,481,253,228
050,29,159,"Missouri","Pettis County",3,48,481,244,237
050,29,159,"Missouri","Pettis County",3,49,486,239,247
050,29,159,"Missouri","Pettis County",3,50,499,262,237
050,29,159,"Missouri","Pettis County",3,51,485,253,232
050,29,159,"Missouri","Pettis County",3,52,463,239,224
050,29,159,"Missouri","Pettis County",3,53,463,256,207
050,29,159,"Missouri","Pettis County",3,54,480,247,233
050,29,159,"Missouri","Pettis County",3,55,518,248,270
050,29,159,"Missouri","Pettis County",3,56,529,255,274
050,29,159,"Missouri","Pettis County",3,57,561,282,279
050,29,159,"Missouri","Pettis County",3,58,593,288,305
050,29,159,"Missouri","Pettis County",3,59,593,283,310
050,29,159,"Missouri","Pettis County",3,60,603,292,311
050,29,159,"Missouri","Pettis County",3,61,597,314,283
050,29,159,"Missouri","Pettis County",3,62,536,276,260
050,29,159,"Missouri","Pettis County",3,63,536,273,263
050,29,159,"Missouri","Pettis County",3,64,559,274,285
050,29,159,"Missouri","Pettis County",3,65,522,252,270
050,29,159,"Missouri","Pettis County",3,66,538,254,284
050,29,159,"Missouri","Pettis County",3,67,464,218,246
050,29,159,"Missouri","Pettis County",3,68,450,217,233
050,29,159,"Missouri","Pettis County",3,69,433,206,227
050,29,159,"Missouri","Pettis County",3,70,412,198,214
050,29,159,"Missouri","Pettis County",3,71,423,210,213
050,29,159,"Missouri","Pettis County",3,72,381,192,189
050,29,159,"Missouri","Pettis County",3,73,357,169,188
050,29,159,"Missouri","Pettis County",3,74,364,176,188
050,29,159,"Missouri","Pettis County",3,75,257,110,147
050,29,159,"Missouri","Pettis County",3,76,262,122,140
050,29,159,"Missouri","Pettis County",3,77,260,119,141
050,29,159,"Missouri","Pettis County",3,78,247,109,138
050,29,159,"Missouri","Pettis County",3,79,215,93,122
050,29,159,"Missouri","Pettis County",3,80,196,79,117
050,29,159,"Missouri","Pettis County",3,81,180,72,108
050,29,159,"Missouri","Pettis County",3,82,176,70,106
050,29,159,"Missouri","Pettis County",3,83,167,70,97
050,29,159,"Missouri","Pettis County",3,84,143,65,78
050,29,159,"Missouri","Pettis County",3,85,980,348,632
050,29,159,"Missouri","Pettis County",4,0,581,297,284
050,29,159,"Missouri","Pettis County",4,1,562,298,264
050,29,159,"Missouri","Pettis County",4,2,635,335,300
050,29,159,"Missouri","Pettis County",4,3,628,320,308
050,29,159,"Missouri","Pettis County",4,4,593,317,276
050,29,159,"Missouri","Pettis County",4,5,586,312,274
050,29,159,"Missouri","Pettis County",4,6,596,296,300
050,29,159,"Missouri","Pettis County",4,7,603,311,292
050,29,159,"Missouri","Pettis County",4,8,610,315,295
050,29,159,"Missouri","Pettis County",4,9,606,313,293
050,29,159,"Missouri","Pettis County",4,10,615,337,278
050,29,159,"Missouri","Pettis County",4,11,587,312,275
050,29,159,"Missouri","Pettis County",4,12,599,335,264
050,29,159,"Missouri","Pettis County",4,13,606,338,268
050,29,159,"Missouri","Pettis County",4,14,642,332,310
050,29,159,"Missouri","Pettis County",4,15,634,333,301
050,29,159,"Missouri","Pettis County",4,16,638,334,304
050,29,159,"Missouri","Pettis County",4,17,639,345,294
050,29,159,"Missouri","Pettis County",4,18,508,284,224
050,29,159,"Missouri","Pettis County",4,19,450,248,202
050,29,159,"Missouri","Pettis County",4,20,474,239,235
050,29,159,"Missouri","Pettis County",4,21,556,291,265
050,29,159,"Missouri","Pettis County",4,22,556,280,276
050,29,159,"Missouri","Pettis County",4,23,560,263,297
050,29,159,"Missouri","Pettis County",4,24,498,260,238
050,29,159,"Missouri","Pettis County",4,25,503,267,236
050,29,159,"Missouri","Pettis County",4,26,502,255,247
050,29,159,"Missouri","Pettis County",4,27,504,258,246
050,29,159,"Missouri","Pettis County",4,28,499,220,279
050,29,159,"Missouri","Pettis County",4,29,544,259,285
050,29,159,"Missouri","Pettis County",4,30,545,275,270
050,29,159,"Missouri","Pettis County",4,31,579,277,302
050,29,159,"Missouri","Pettis County",4,32,560,273,287
050,29,159,"Missouri","Pettis County",4,33,556,288,268
050,29,159,"Missouri","Pettis County",4,34,548,276,272
050,29,159,"Missouri","Pettis County",4,35,562,298,264
050,29,159,"Missouri","Pettis County",4,36,563,290,273
050,29,159,"Missouri","Pettis County",4,37,603,317,286
050,29,159,"Missouri","Pettis County",4,38,562,286,276
050,29,159,"Missouri","Pettis County",4,39,577,282,295
050,29,159,"Missouri","Pettis County",4,40,553,264,289
050,29,159,"Missouri","Pettis County",4,41,567,287,280
050,29,159,"Missouri","Pettis County",4,42,574,295,279
050,29,159,"Missouri","Pettis County",4,43,551,300,251
050,29,159,"Missouri","Pettis County",4,44,495,251,244
050,29,159,"Missouri","Pettis County",4,45,477,239,238
050,29,159,"Missouri","Pettis County",4,46,455,227,228
050,29,159,"Missouri","Pettis County",4,47,488,234,254
050,29,159,"Missouri","Pettis County",4,48,474,256,218
050,29,159,"Missouri","Pettis County",4,49,480,237,243
050,29,159,"Missouri","Pettis County",4,50,507,258,249
050,29,159,"Missouri","Pettis County",4,51,499,264,235
050,29,159,"Missouri","Pettis County",4,52,475,244,231
050,29,159,"Missouri","Pettis County",4,53,466,239,227
050,29,159,"Missouri","Pettis County",4,54,454,251,203
050,29,159,"Missouri","Pettis County",4,55,490,250,240
050,29,159,"Missouri","Pettis County",4,56,493,240,253
050,29,159,"Missouri","Pettis County",4,57,534,261,273
050,29,159,"Missouri","Pettis County",4,58,559,276,283
050,29,159,"Missouri","Pettis County",4,59,604,296,308
050,29,159,"Missouri","Pettis County",4,60,579,278,301
050,29,159,"Missouri","Pettis County",4,61,605,300,305
050,29,159,"Missouri","Pettis County",4,62,577,302,275
050,29,159,"Missouri","Pettis County",4,63,517,264,253
050,29,159,"Missouri","Pettis County",4,64,533,268,265
050,29,159,"Missouri","Pettis County",4,65,541,262,279
050,29,159,"Missouri","Pettis County",4,66,515,244,271
050,29,159,"Missouri","Pettis County",4,67,517,247,270
050,29,159,"Missouri","Pettis County",4,68,455,209,246
050,29,159,"Missouri","Pettis County",4,69,444,217,227
050,29,159,"Missouri","Pettis County",4,70,415,195,220
050,29,159,"Missouri","Pettis County",4,71,406,190,216
050,29,159,"Missouri","Pettis County",4,72,406,201,205
050,29,159,"Missouri","Pettis County",4,73,371,181,190
050,29,159,"Missouri","Pettis County",4,74,351,165,186
050,29,159,"Missouri","Pettis County",4,75,353,167,186
050,29,159,"Missouri","Pettis County",4,76,245,104,141
050,29,159,"Missouri","Pettis County",4,77,255,116,139
050,29,159,"Missouri","Pettis County",4,78,248,117,131
050,29,159,"Missouri","Pettis County",4,79,231,101,130
050,29,159,"Missouri","Pettis County",4,80,209,88,121
050,29,159,"Missouri","Pettis County",4,81,187,77,110
050,29,159,"Missouri","Pettis County",4,82,174,71,103
050,29,159,"Missouri","Pettis County",4,83,167,65,102
050,29,159,"Missouri","Pettis County",4,84,150,63,87
050,29,159,"Missouri","Pettis County",4,85,982,360,622
050,29,159,"Missouri","Pettis County",5,0,586,297,289
050,29,159,"Missouri","Pettis County",5,1,591,310,281
050,29,159,"Missouri","Pettis County",5,2,560,301,259
050,29,159,"Missouri","Pettis County",5,3,631,326,305
050,29,159,"Missouri","Pettis County",5,4,617,314,303
050,29,159,"Missouri","Pettis County",5,5,610,318,292
050,29,159,"Missouri","Pettis County",5,6,575,306,269
050,29,159,"Missouri","Pettis County",5,7,592,295,297
050,29,159,"Missouri","Pettis County",5,8,588,312,276
050,29,159,"Missouri","Pettis County",5,9,606,318,288
050,29,159,"Missouri","Pettis County",5,10,587,304,283
050,29,159,"Missouri","Pettis County",5,11,611,336,275
050,29,159,"Missouri","Pettis County",5,12,602,319,283
050,29,159,"Missouri","Pettis County",5,13,604,340,264
050,29,159,"Missouri","Pettis County",5,14,601,330,271
050,29,159,"Missouri","Pettis County",5,15,651,331,320
050,29,159,"Missouri","Pettis County",5,16,641,335,306
050,29,159,"Missouri","Pettis County",5,17,664,359,305
050,29,159,"Missouri","Pettis County",5,18,543,301,242
050,29,159,"Missouri","Pettis County",5,19,443,245,198
050,29,159,"Missouri","Pettis County",5,20,483,258,225
050,29,159,"Missouri","Pettis County",5,21,513,258,255
050,29,159,"Missouri","Pettis County",5,22,557,283,274
050,29,159,"Missouri","Pettis County",5,23,594,302,292
050,29,159,"Missouri","Pettis County",5,24,560,265,295
050,29,159,"Missouri","Pettis County",5,25,499,264,235
050,29,159,"Missouri","Pettis County",5,26,526,274,252
050,29,159,"Missouri","Pettis County",5,27,501,261,240
050,29,159,"Missouri","Pettis County",5,28,482,233,249
050,29,159,"Missouri","Pettis County",5,29,501,224,277
050,29,159,"Missouri","Pettis County",5,30,543,266,277
050,29,159,"Missouri","Pettis County",5,31,534,264,270
050,29,159,"Missouri","Pettis County",5,32,598,295,303
050,29,159,"Missouri","Pettis County",5,33,551,267,284
050,29,159,"Missouri","Pettis County",5,34,540,277,263
050,29,159,"Missouri","Pettis County",5,35,545,274,271
050,29,159,"Missouri","Pettis County",5,36,560,288,272
050,29,159,"Missouri","Pettis County",5,37,553,285,268
050,29,159,"Missouri","Pettis County",5,38,618,331,287
050,29,159,"Missouri","Pettis County",5,39,575,288,287
050,29,159,"Missouri","Pettis County",5,40,573,281,292
050,29,159,"Missouri","Pettis County",5,41,551,266,285
050,29,159,"Missouri","Pettis County",5,42,573,296,277
050,29,159,"Missouri","Pettis County",5,43,578,298,280
050,29,159,"Missouri","Pettis County",5,44,543,297,246
050,29,159,"Missouri","Pettis County",5,45,497,240,257
050,29,159,"Missouri","Pettis County",5,46,466,228,238
050,29,159,"Missouri","Pettis County",5,47,456,227,229
050,29,159,"Missouri","Pettis County",5,48,490,240,250
050,29,159,"Missouri","Pettis County",5,49,454,239,215
050,29,159,"Missouri","Pettis County",5,50,492,248,244
050,29,159,"Missouri","Pettis County",5,51,494,255,239
050,29,159,"Missouri","Pettis County",5,52,505,267,238
050,29,159,"Missouri","Pettis County",5,53,470,244,226
050,29,159,"Missouri","Pettis County",5,54,452,228,224
050,29,159,"Missouri","Pettis County",5,55,452,244,208
050,29,159,"Missouri","Pettis County",5,56,473,234,239
050,29,159,"Missouri","Pettis County",5,57,498,246,252
050,29,159,"Missouri","Pettis County",5,58,534,260,274
050,29,159,"Missouri","Pettis County",5,59,562,275,287
050,29,159,"Missouri","Pettis County",5,60,591,290,301
050,29,159,"Missouri","Pettis County",5,61,581,278,303
050,29,159,"Missouri","Pettis County",5,62,599,294,305
050,29,159,"Missouri","Pettis County",5,63,576,299,277
050,29,159,"Missouri","Pettis County",5,64,522,269,253
050,29,159,"Missouri","Pettis County",5,65,517,252,265
050,29,159,"Missouri","Pettis County",5,66,549,269,280
050,29,159,"Missouri","Pettis County",5,67,488,226,262
050,29,159,"Missouri","Pettis County",5,68,517,243,274
050,29,159,"Missouri","Pettis County",5,69,455,212,243
050,29,159,"Missouri","Pettis County",5,70,430,207,223
050,29,159,"Missouri","Pettis County",5,71,408,181,227
050,29,159,"Missouri","Pettis County",5,72,393,186,207
050,29,159,"Missouri","Pettis County",5,73,396,191,205
050,29,159,"Missouri","Pettis County",5,74,364,178,186
050,29,159,"Missouri","Pettis County",5,75,340,154,186
050,29,159,"Missouri","Pettis County",5,76,336,160,176
050,29,159,"Missouri","Pettis County",5,77,234,97,137
050,29,159,"Missouri","Pettis County",5,78,248,117,131
050,29,159,"Missouri","Pettis County",5,79,229,105,124
050,29,159,"Missouri","Pettis County",5,80,220,95,125
050,29,159,"Missouri","Pettis County",5,81,198,83,115
050,29,159,"Missouri","Pettis County",5,82,183,73,110
050,29,159,"Missouri","Pettis County",5,83,164,64,100
050,29,159,"Missouri","Pettis County",5,84,147,56,91
050,29,159,"Missouri","Pettis County",5,85,996,373,623
050,29,161,"Missouri","Phelps County",1,0,440,226,214
050,29,161,"Missouri","Phelps County",1,1,476,257,219
050,29,161,"Missouri","Phelps County",1,2,494,266,228
050,29,161,"Missouri","Phelps County",1,3,509,256,253
050,29,161,"Missouri","Phelps County",1,4,504,259,245
050,29,161,"Missouri","Phelps County",1,5,518,276,242
050,29,161,"Missouri","Phelps County",1,6,495,270,225
050,29,161,"Missouri","Phelps County",1,7,515,249,266
050,29,161,"Missouri","Phelps County",1,8,530,253,277
050,29,161,"Missouri","Phelps County",1,9,514,258,256
050,29,161,"Missouri","Phelps County",1,10,515,278,237
050,29,161,"Missouri","Phelps County",1,11,580,306,274
050,29,161,"Missouri","Phelps County",1,12,604,309,295
050,29,161,"Missouri","Phelps County",1,13,562,281,281
050,29,161,"Missouri","Phelps County",1,14,554,282,272
050,29,161,"Missouri","Phelps County",1,15,548,303,245
050,29,161,"Missouri","Phelps County",1,16,572,303,269
050,29,161,"Missouri","Phelps County",1,17,529,272,257
050,29,161,"Missouri","Phelps County",1,18,707,433,274
050,29,161,"Missouri","Phelps County",1,19,1147,782,365
050,29,161,"Missouri","Phelps County",1,20,1181,754,427
050,29,161,"Missouri","Phelps County",1,21,1114,706,408
050,29,161,"Missouri","Phelps County",1,22,1060,676,384
050,29,161,"Missouri","Phelps County",1,23,983,657,326
050,29,161,"Missouri","Phelps County",1,24,797,509,288
050,29,161,"Missouri","Phelps County",1,25,618,379,239
050,29,161,"Missouri","Phelps County",1,26,521,305,216
050,29,161,"Missouri","Phelps County",1,27,522,277,245
050,29,161,"Missouri","Phelps County",1,28,536,276,260
050,29,161,"Missouri","Phelps County",1,29,543,267,276
050,29,161,"Missouri","Phelps County",1,30,509,268,241
050,29,161,"Missouri","Phelps County",1,31,531,276,255
050,29,161,"Missouri","Phelps County",1,32,468,243,225
050,29,161,"Missouri","Phelps County",1,33,519,271,248
050,29,161,"Missouri","Phelps County",1,34,518,269,249
050,29,161,"Missouri","Phelps County",1,35,536,267,269
050,29,161,"Missouri","Phelps County",1,36,516,274,242
050,29,161,"Missouri","Phelps County",1,37,546,283,263
050,29,161,"Missouri","Phelps County",1,38,517,250,267
050,29,161,"Missouri","Phelps County",1,39,553,276,277
050,29,161,"Missouri","Phelps County",1,40,524,256,268
050,29,161,"Missouri","Phelps County",1,41,485,252,233
050,29,161,"Missouri","Phelps County",1,42,521,284,237
050,29,161,"Missouri","Phelps County",1,43,439,222,217
050,29,161,"Missouri","Phelps County",1,44,415,219,196
050,29,161,"Missouri","Phelps County",1,45,423,206,217
050,29,161,"Missouri","Phelps County",1,46,428,223,205
050,29,161,"Missouri","Phelps County",1,47,451,242,209
050,29,161,"Missouri","Phelps County",1,48,506,272,234
050,29,161,"Missouri","Phelps County",1,49,512,267,245
050,29,161,"Missouri","Phelps County",1,50,491,242,249
050,29,161,"Missouri","Phelps County",1,51,485,246,239
050,29,161,"Missouri","Phelps County",1,52,476,240,236
050,29,161,"Missouri","Phelps County",1,53,457,219,238
050,29,161,"Missouri","Phelps County",1,54,492,239,253
050,29,161,"Missouri","Phelps County",1,55,534,264,270
050,29,161,"Missouri","Phelps County",1,56,549,263,286
050,29,161,"Missouri","Phelps County",1,57,561,270,291
050,29,161,"Missouri","Phelps County",1,58,579,286,293
050,29,161,"Missouri","Phelps County",1,59,606,293,313
050,29,161,"Missouri","Phelps County",1,60,612,316,296
050,29,161,"Missouri","Phelps County",1,61,591,278,313
050,29,161,"Missouri","Phelps County",1,62,561,282,279
050,29,161,"Missouri","Phelps County",1,63,509,254,255
050,29,161,"Missouri","Phelps County",1,64,524,263,261
050,29,161,"Missouri","Phelps County",1,65,488,225,263
050,29,161,"Missouri","Phelps County",1,66,499,246,253
050,29,161,"Missouri","Phelps County",1,67,468,228,240
050,29,161,"Missouri","Phelps County",1,68,440,211,229
050,29,161,"Missouri","Phelps County",1,69,421,187,234
050,29,161,"Missouri","Phelps County",1,70,402,190,212
050,29,161,"Missouri","Phelps County",1,71,400,193,207
050,29,161,"Missouri","Phelps County",1,72,427,212,215
050,29,161,"Missouri","Phelps County",1,73,427,213,214
050,29,161,"Missouri","Phelps County",1,74,303,146,157
050,29,161,"Missouri","Phelps County",1,75,298,138,160
050,29,161,"Missouri","Phelps County",1,76,302,141,161
050,29,161,"Missouri","Phelps County",1,77,292,128,164
050,29,161,"Missouri","Phelps County",1,78,254,116,138
050,29,161,"Missouri","Phelps County",1,79,218,97,121
050,29,161,"Missouri","Phelps County",1,80,219,94,125
050,29,161,"Missouri","Phelps County",1,81,202,90,112
050,29,161,"Missouri","Phelps County",1,82,190,83,107
050,29,161,"Missouri","Phelps County",1,83,179,85,94
050,29,161,"Missouri","Phelps County",1,84,151,70,81
050,29,161,"Missouri","Phelps County",1,85,924,349,575
050,29,161,"Missouri","Phelps County",2,0,435,220,215
050,29,161,"Missouri","Phelps County",2,1,467,249,218
050,29,161,"Missouri","Phelps County",2,2,492,264,228
050,29,161,"Missouri","Phelps County",2,3,499,255,244
050,29,161,"Missouri","Phelps County",2,4,505,259,246
050,29,161,"Missouri","Phelps County",2,5,514,272,242
050,29,161,"Missouri","Phelps County",2,6,502,272,230
050,29,161,"Missouri","Phelps County",2,7,508,251,257
050,29,161,"Missouri","Phelps County",2,8,521,248,273
050,29,161,"Missouri","Phelps County",2,9,519,259,260
050,29,161,"Missouri","Phelps County",2,10,516,275,241
050,29,161,"Missouri","Phelps County",2,11,564,298,266
050,29,161,"Missouri","Phelps County",2,12,600,309,291
050,29,161,"Missouri","Phelps County",2,13,572,290,282
050,29,161,"Missouri","Phelps County",2,14,556,282,274
050,29,161,"Missouri","Phelps County",2,15,549,300,249
050,29,161,"Missouri","Phelps County",2,16,568,303,265
050,29,161,"Missouri","Phelps County",2,17,543,285,258
050,29,161,"Missouri","Phelps County",2,18,703,430,273
050,29,161,"Missouri","Phelps County",2,19,1145,777,368
050,29,161,"Missouri","Phelps County",2,20,1190,760,430
050,29,161,"Missouri","Phelps County",2,21,1101,698,403
050,29,161,"Missouri","Phelps County",2,22,1039,660,379
050,29,161,"Missouri","Phelps County",2,23,976,650,326
050,29,161,"Missouri","Phelps County",2,24,802,518,284
050,29,161,"Missouri","Phelps County",2,25,614,370,244
050,29,161,"Missouri","Phelps County",2,26,533,315,218
050,29,161,"Missouri","Phelps County",2,27,521,279,242
050,29,161,"Missouri","Phelps County",2,28,530,271,259
050,29,161,"Missouri","Phelps County",2,29,541,268,273
050,29,161,"Missouri","Phelps County",2,30,518,268,250
050,29,161,"Missouri","Phelps County",2,31,522,273,249
050,29,161,"Missouri","Phelps County",2,32,478,246,232
050,29,161,"Missouri","Phelps County",2,33,506,263,243
050,29,161,"Missouri","Phelps County",2,34,517,268,249
050,29,161,"Missouri","Phelps County",2,35,535,268,267
050,29,161,"Missouri","Phelps County",2,36,515,270,245
050,29,161,"Missouri","Phelps County",2,37,537,279,258
050,29,161,"Missouri","Phelps County",2,38,526,258,268
050,29,161,"Missouri","Phelps County",2,39,542,270,272
050,29,161,"Missouri","Phelps County",2,40,530,261,269
050,29,161,"Missouri","Phelps County",2,41,488,248,240
050,29,161,"Missouri","Phelps County",2,42,513,277,236
050,29,161,"Missouri","Phelps County",2,43,459,238,221
050,29,161,"Missouri","Phelps County",2,44,415,216,199
050,29,161,"Missouri","Phelps County",2,45,419,208,211
050,29,161,"Missouri","Phelps County",2,46,422,216,206
050,29,161,"Missouri","Phelps County",2,47,445,235,210
050,29,161,"Missouri","Phelps County",2,48,495,267,228
050,29,161,"Missouri","Phelps County",2,49,507,268,239
050,29,161,"Missouri","Phelps County",2,50,498,248,250
050,29,161,"Missouri","Phelps County",2,51,484,243,241
050,29,161,"Missouri","Phelps County",2,52,473,239,234
050,29,161,"Missouri","Phelps County",2,53,464,227,237
050,29,161,"Missouri","Phelps County",2,54,480,233,247
050,29,161,"Missouri","Phelps County",2,55,526,259,267
050,29,161,"Missouri","Phelps County",2,56,546,264,282
050,29,161,"Missouri","Phelps County",2,57,554,266,288
050,29,161,"Missouri","Phelps County",2,58,574,281,293
050,29,161,"Missouri","Phelps County",2,59,598,289,309
050,29,161,"Missouri","Phelps County",2,60,603,305,298
050,29,161,"Missouri","Phelps County",2,61,594,288,306
050,29,161,"Missouri","Phelps County",2,62,563,278,285
050,29,161,"Missouri","Phelps County",2,63,526,263,263
050,29,161,"Missouri","Phelps County",2,64,518,259,259
050,29,161,"Missouri","Phelps County",2,65,493,234,259
050,29,161,"Missouri","Phelps County",2,66,495,240,255
050,29,161,"Missouri","Phelps County",2,67,472,230,242
050,29,161,"Missouri","Phelps County",2,68,442,211,231
050,29,161,"Missouri","Phelps County",2,69,430,195,235
050,29,161,"Missouri","Phelps County",2,70,403,189,214
050,29,161,"Missouri","Phelps County",2,71,401,190,211
050,29,161,"Missouri","Phelps County",2,72,415,204,211
050,29,161,"Missouri","Phelps County",2,73,448,225,223
050,29,161,"Missouri","Phelps County",2,74,311,151,160
050,29,161,"Missouri","Phelps County",2,75,298,140,158
050,29,161,"Missouri","Phelps County",2,76,301,142,159
050,29,161,"Missouri","Phelps County",2,77,299,133,166
050,29,161,"Missouri","Phelps County",2,78,258,117,141
050,29,161,"Missouri","Phelps County",2,79,223,100,123
050,29,161,"Missouri","Phelps County",2,80,214,91,123
050,29,161,"Missouri","Phelps County",2,81,197,88,109
050,29,161,"Missouri","Phelps County",2,82,190,84,106
050,29,161,"Missouri","Phelps County",2,83,178,85,93
050,29,161,"Missouri","Phelps County",2,84,152,70,82
050,29,161,"Missouri","Phelps County",2,85,924,351,573
050,29,161,"Missouri","Phelps County",3,0,400,221,179
050,29,161,"Missouri","Phelps County",3,1,450,221,229
050,29,161,"Missouri","Phelps County",3,2,484,251,233
050,29,161,"Missouri","Phelps County",3,3,495,268,227
050,29,161,"Missouri","Phelps County",3,4,519,266,253
050,29,161,"Missouri","Phelps County",3,5,526,263,263
050,29,161,"Missouri","Phelps County",3,6,532,278,254
050,29,161,"Missouri","Phelps County",3,7,526,281,245
050,29,161,"Missouri","Phelps County",3,8,518,254,264
050,29,161,"Missouri","Phelps County",3,9,541,254,287
050,29,161,"Missouri","Phelps County",3,10,549,272,277
050,29,161,"Missouri","Phelps County",3,11,527,273,254
050,29,161,"Missouri","Phelps County",3,12,563,295,268
050,29,161,"Missouri","Phelps County",3,13,608,319,289
050,29,161,"Missouri","Phelps County",3,14,579,287,292
050,29,161,"Missouri","Phelps County",3,15,563,284,279
050,29,161,"Missouri","Phelps County",3,16,551,291,260
050,29,161,"Missouri","Phelps County",3,17,593,330,263
050,29,161,"Missouri","Phelps County",3,18,736,456,280
050,29,161,"Missouri","Phelps County",3,19,1180,793,387
050,29,161,"Missouri","Phelps County",3,20,1198,765,433
050,29,161,"Missouri","Phelps County",3,21,1084,695,389
050,29,161,"Missouri","Phelps County",3,22,1039,629,410
050,29,161,"Missouri","Phelps County",3,23,981,663,318
050,29,161,"Missouri","Phelps County",3,24,784,504,280
050,29,161,"Missouri","Phelps County",3,25,631,377,254
050,29,161,"Missouri","Phelps County",3,26,563,332,231
050,29,161,"Missouri","Phelps County",3,27,524,297,227
050,29,161,"Missouri","Phelps County",3,28,509,275,234
050,29,161,"Missouri","Phelps County",3,29,513,258,255
050,29,161,"Missouri","Phelps County",3,30,517,259,258
050,29,161,"Missouri","Phelps County",3,31,514,269,245
050,29,161,"Missouri","Phelps County",3,32,518,259,259
050,29,161,"Missouri","Phelps County",3,33,481,251,230
050,29,161,"Missouri","Phelps County",3,34,513,270,243
050,29,161,"Missouri","Phelps County",3,35,540,277,263
050,29,161,"Missouri","Phelps County",3,36,535,271,264
050,29,161,"Missouri","Phelps County",3,37,524,272,252
050,29,161,"Missouri","Phelps County",3,38,552,284,268
050,29,161,"Missouri","Phelps County",3,39,532,261,271
050,29,161,"Missouri","Phelps County",3,40,550,283,267
050,29,161,"Missouri","Phelps County",3,41,531,259,272
050,29,161,"Missouri","Phelps County",3,42,515,262,253
050,29,161,"Missouri","Phelps County",3,43,504,266,238
050,29,161,"Missouri","Phelps County",3,44,466,235,231
050,29,161,"Missouri","Phelps County",3,45,425,214,211
050,29,161,"Missouri","Phelps County",3,46,440,224,216
050,29,161,"Missouri","Phelps County",3,47,428,218,210
050,29,161,"Missouri","Phelps County",3,48,457,246,211
050,29,161,"Missouri","Phelps County",3,49,492,266,226
050,29,161,"Missouri","Phelps County",3,50,513,277,236
050,29,161,"Missouri","Phelps County",3,51,492,237,255
050,29,161,"Missouri","Phelps County",3,52,487,244,243
050,29,161,"Missouri","Phelps County",3,53,470,242,228
050,29,161,"Missouri","Phelps County",3,54,465,225,240
050,29,161,"Missouri","Phelps County",3,55,492,232,260
050,29,161,"Missouri","Phelps County",3,56,523,262,261
050,29,161,"Missouri","Phelps County",3,57,547,265,282
050,29,161,"Missouri","Phelps County",3,58,554,265,289
050,29,161,"Missouri","Phelps County",3,59,581,286,295
050,29,161,"Missouri","Phelps County",3,60,600,287,313
050,29,161,"Missouri","Phelps County",3,61,598,302,296
050,29,161,"Missouri","Phelps County",3,62,587,286,301
050,29,161,"Missouri","Phelps County",3,63,577,281,296
050,29,161,"Missouri","Phelps County",3,64,521,265,256
050,29,161,"Missouri","Phelps County",3,65,505,249,256
050,29,161,"Missouri","Phelps County",3,66,486,226,260
050,29,161,"Missouri","Phelps County",3,67,492,240,252
050,29,161,"Missouri","Phelps County",3,68,457,217,240
050,29,161,"Missouri","Phelps County",3,69,438,202,236
050,29,161,"Missouri","Phelps County",3,70,411,189,222
050,29,161,"Missouri","Phelps County",3,71,404,190,214
050,29,161,"Missouri","Phelps County",3,72,387,182,205
050,29,161,"Missouri","Phelps County",3,73,395,192,203
050,29,161,"Missouri","Phelps County",3,74,428,213,215
050,29,161,"Missouri","Phelps County",3,75,301,145,156
050,29,161,"Missouri","Phelps County",3,76,289,141,148
050,29,161,"Missouri","Phelps County",3,77,265,118,147
050,29,161,"Missouri","Phelps County",3,78,285,129,156
050,29,161,"Missouri","Phelps County",3,79,248,110,138
050,29,161,"Missouri","Phelps County",3,80,221,96,125
050,29,161,"Missouri","Phelps County",3,81,192,79,113
050,29,161,"Missouri","Phelps County",3,82,189,85,104
050,29,161,"Missouri","Phelps County",3,83,177,86,91
050,29,161,"Missouri","Phelps County",3,84,144,65,79
050,29,161,"Missouri","Phelps County",3,85,878,342,536
050,29,161,"Missouri","Phelps County",4,0,431,224,207
050,29,161,"Missouri","Phelps County",4,1,410,224,186
050,29,161,"Missouri","Phelps County",4,2,450,228,222
050,29,161,"Missouri","Phelps County",4,3,481,240,241
050,29,161,"Missouri","Phelps County",4,4,507,272,235
050,29,161,"Missouri","Phelps County",4,5,518,272,246
050,29,161,"Missouri","Phelps County",4,6,541,275,266
050,29,161,"Missouri","Phelps County",4,7,541,281,260
050,29,161,"Missouri","Phelps County",4,8,529,278,251
050,29,161,"Missouri","Phelps County",4,9,529,261,268
050,29,161,"Missouri","Phelps County",4,10,563,252,311
050,29,161,"Missouri","Phelps County",4,11,585,285,300
050,29,161,"Missouri","Phelps County",4,12,552,287,265
050,29,161,"Missouri","Phelps County",4,13,583,312,271
050,29,161,"Missouri","Phelps County",4,14,655,339,316
050,29,161,"Missouri","Phelps County",4,15,576,292,284
050,29,161,"Missouri","Phelps County",4,16,587,300,287
050,29,161,"Missouri","Phelps County",4,17,572,313,259
050,29,161,"Missouri","Phelps County",4,18,771,488,283
050,29,161,"Missouri","Phelps County",4,19,1169,801,368
050,29,161,"Missouri","Phelps County",4,20,1188,751,437
050,29,161,"Missouri","Phelps County",4,21,1112,705,407
050,29,161,"Missouri","Phelps County",4,22,1011,626,385
050,29,161,"Missouri","Phelps County",4,23,1021,651,370
050,29,161,"Missouri","Phelps County",4,24,795,525,270
050,29,161,"Missouri","Phelps County",4,25,608,361,247
050,29,161,"Missouri","Phelps County",4,26,589,350,239
050,29,161,"Missouri","Phelps County",4,27,550,317,233
050,29,161,"Missouri","Phelps County",4,28,516,291,225
050,29,161,"Missouri","Phelps County",4,29,511,268,243
050,29,161,"Missouri","Phelps County",4,30,486,249,237
050,29,161,"Missouri","Phelps County",4,31,534,283,251
050,29,161,"Missouri","Phelps County",4,32,493,251,242
050,29,161,"Missouri","Phelps County",4,33,534,266,268
050,29,161,"Missouri","Phelps County",4,34,497,255,242
050,29,161,"Missouri","Phelps County",4,35,521,263,258
050,29,161,"Missouri","Phelps County",4,36,518,275,243
050,29,161,"Missouri","Phelps County",4,37,537,266,271
050,29,161,"Missouri","Phelps County",4,38,513,263,250
050,29,161,"Missouri","Phelps County",4,39,561,292,269
050,29,161,"Missouri","Phelps County",4,40,529,264,265
050,29,161,"Missouri","Phelps County",4,41,552,272,280
050,29,161,"Missouri","Phelps County",4,42,556,270,286
050,29,161,"Missouri","Phelps County",4,43,502,258,244
050,29,161,"Missouri","Phelps County",4,44,524,275,249
050,29,161,"Missouri","Phelps County",4,45,463,235,228
050,29,161,"Missouri","Phelps County",4,46,433,214,219
050,29,161,"Missouri","Phelps County",4,47,447,216,231
050,29,161,"Missouri","Phelps County",4,48,465,234,231
050,29,161,"Missouri","Phelps County",4,49,454,248,206
050,29,161,"Missouri","Phelps County",4,50,511,278,233
050,29,161,"Missouri","Phelps County",4,51,501,269,232
050,29,161,"Missouri","Phelps County",4,52,468,223,245
050,29,161,"Missouri","Phelps County",4,53,484,245,239
050,29,161,"Missouri","Phelps County",4,54,476,234,242
050,29,161,"Missouri","Phelps County",4,55,458,218,240
050,29,161,"Missouri","Phelps County",4,56,495,239,256
050,29,161,"Missouri","Phelps County",4,57,530,268,262
050,29,161,"Missouri","Phelps County",4,58,535,262,273
050,29,161,"Missouri","Phelps County",4,59,562,277,285
050,29,161,"Missouri","Phelps County",4,60,574,282,292
050,29,161,"Missouri","Phelps County",4,61,596,291,305
050,29,161,"Missouri","Phelps County",4,62,575,283,292
050,29,161,"Missouri","Phelps County",4,63,579,277,302
050,29,161,"Missouri","Phelps County",4,64,580,273,307
050,29,161,"Missouri","Phelps County",4,65,519,261,258
050,29,161,"Missouri","Phelps County",4,66,500,243,257
050,29,161,"Missouri","Phelps County",4,67,499,230,269
050,29,161,"Missouri","Phelps County",4,68,470,224,246
050,29,161,"Missouri","Phelps County",4,69,448,218,230
050,29,161,"Missouri","Phelps County",4,70,439,205,234
050,29,161,"Missouri","Phelps County",4,71,411,190,221
050,29,161,"Missouri","Phelps County",4,72,395,178,217
050,29,161,"Missouri","Phelps County",4,73,381,181,200
050,29,161,"Missouri","Phelps County",4,74,378,175,203
050,29,161,"Missouri","Phelps County",4,75,426,209,217
050,29,161,"Missouri","Phelps County",4,76,295,148,147
050,29,161,"Missouri","Phelps County",4,77,268,128,140
050,29,161,"Missouri","Phelps County",4,78,259,116,143
050,29,161,"Missouri","Phelps County",4,79,266,123,143
050,29,161,"Missouri","Phelps County",4,80,247,107,140
050,29,161,"Missouri","Phelps County",4,81,188,82,106
050,29,161,"Missouri","Phelps County",4,82,189,78,111
050,29,161,"Missouri","Phelps County",4,83,183,86,97
050,29,161,"Missouri","Phelps County",4,84,150,67,83
050,29,161,"Missouri","Phelps County",4,85,868,343,525
050,29,161,"Missouri","Phelps County",5,0,428,224,204
050,29,161,"Missouri","Phelps County",5,1,457,238,219
050,29,161,"Missouri","Phelps County",5,2,418,229,189
050,29,161,"Missouri","Phelps County",5,3,462,239,223
050,29,161,"Missouri","Phelps County",5,4,499,261,238
050,29,161,"Missouri","Phelps County",5,5,510,273,237
050,29,161,"Missouri","Phelps County",5,6,533,282,251
050,29,161,"Missouri","Phelps County",5,7,548,275,273
050,29,161,"Missouri","Phelps County",5,8,548,278,270
050,29,161,"Missouri","Phelps County",5,9,529,288,241
050,29,161,"Missouri","Phelps County",5,10,533,260,273
050,29,161,"Missouri","Phelps County",5,11,554,262,292
050,29,161,"Missouri","Phelps County",5,12,567,281,286
050,29,161,"Missouri","Phelps County",5,13,554,292,262
050,29,161,"Missouri","Phelps County",5,14,588,305,283
050,29,161,"Missouri","Phelps County",5,15,659,341,318
050,29,161,"Missouri","Phelps County",5,16,587,290,297
050,29,161,"Missouri","Phelps County",5,17,600,317,283
050,29,161,"Missouri","Phelps County",5,18,723,457,266
050,29,161,"Missouri","Phelps County",5,19,1191,801,390
050,29,161,"Missouri","Phelps County",5,20,1208,769,439
050,29,161,"Missouri","Phelps County",5,21,1085,671,414
050,29,161,"Missouri","Phelps County",5,22,1042,659,383
050,29,161,"Missouri","Phelps County",5,23,974,629,345
050,29,161,"Missouri","Phelps County",5,24,867,548,319
050,29,161,"Missouri","Phelps County",5,25,582,354,228
050,29,161,"Missouri","Phelps County",5,26,575,346,229
050,29,161,"Missouri","Phelps County",5,27,575,332,243
050,29,161,"Missouri","Phelps County",5,28,539,301,238
050,29,161,"Missouri","Phelps County",5,29,523,291,232
050,29,161,"Missouri","Phelps County",5,30,503,250,253
050,29,161,"Missouri","Phelps County",5,31,486,258,228
050,29,161,"Missouri","Phelps County",5,32,508,258,250
050,29,161,"Missouri","Phelps County",5,33,502,268,234
050,29,161,"Missouri","Phelps County",5,34,521,253,268
050,29,161,"Missouri","Phelps County",5,35,483,243,240
050,29,161,"Missouri","Phelps County",5,36,502,255,247
050,29,161,"Missouri","Phelps County",5,37,514,268,246
050,29,161,"Missouri","Phelps County",5,38,537,257,280
050,29,161,"Missouri","Phelps County",5,39,523,264,259
050,29,161,"Missouri","Phelps County",5,40,559,295,264
050,29,161,"Missouri","Phelps County",5,41,520,257,263
050,29,161,"Missouri","Phelps County",5,42,566,276,290
050,29,161,"Missouri","Phelps County",5,43,545,264,281
050,29,161,"Missouri","Phelps County",5,44,501,256,245
050,29,161,"Missouri","Phelps County",5,45,517,265,252
050,29,161,"Missouri","Phelps County",5,46,448,228,220
050,29,161,"Missouri","Phelps County",5,47,430,206,224
050,29,161,"Missouri","Phelps County",5,48,456,228,228
050,29,161,"Missouri","Phelps County",5,49,444,227,217
050,29,161,"Missouri","Phelps County",5,50,458,244,214
050,29,161,"Missouri","Phelps County",5,51,511,273,238
050,29,161,"Missouri","Phelps County",5,52,481,260,221
050,29,161,"Missouri","Phelps County",5,53,468,226,242
050,29,161,"Missouri","Phelps County",5,54,486,246,240
050,29,161,"Missouri","Phelps County",5,55,475,230,245
050,29,161,"Missouri","Phelps County",5,56,461,226,235
050,29,161,"Missouri","Phelps County",5,57,488,235,253
050,29,161,"Missouri","Phelps County",5,58,526,262,264
050,29,161,"Missouri","Phelps County",5,59,537,261,276
050,29,161,"Missouri","Phelps County",5,60,568,282,286
050,29,161,"Missouri","Phelps County",5,61,572,282,290
050,29,161,"Missouri","Phelps County",5,62,581,276,305
050,29,161,"Missouri","Phelps County",5,63,564,280,284
050,29,161,"Missouri","Phelps County",5,64,581,272,309
050,29,161,"Missouri","Phelps County",5,65,574,267,307
050,29,161,"Missouri","Phelps County",5,66,515,260,255
050,29,161,"Missouri","Phelps County",5,67,493,244,249
050,29,161,"Missouri","Phelps County",5,68,491,223,268
050,29,161,"Missouri","Phelps County",5,69,463,218,245
050,29,161,"Missouri","Phelps County",5,70,429,206,223
050,29,161,"Missouri","Phelps County",5,71,432,198,234
050,29,161,"Missouri","Phelps County",5,72,402,178,224
050,29,161,"Missouri","Phelps County",5,73,383,171,212
050,29,161,"Missouri","Phelps County",5,74,360,167,193
050,29,161,"Missouri","Phelps County",5,75,370,174,196
050,29,161,"Missouri","Phelps County",5,76,416,208,208
050,29,161,"Missouri","Phelps County",5,77,274,134,140
050,29,161,"Missouri","Phelps County",5,78,265,127,138
050,29,161,"Missouri","Phelps County",5,79,241,111,130
050,29,161,"Missouri","Phelps County",5,80,262,121,141
050,29,161,"Missouri","Phelps County",5,81,218,93,125
050,29,161,"Missouri","Phelps County",5,82,177,77,100
050,29,161,"Missouri","Phelps County",5,83,185,78,107
050,29,161,"Missouri","Phelps County",5,84,160,71,89
050,29,161,"Missouri","Phelps County",5,85,894,354,540
050,29,163,"Missouri","Pike County",1,0,200,103,97
050,29,163,"Missouri","Pike County",1,1,207,107,100
050,29,163,"Missouri","Pike County",1,2,201,114,87
050,29,163,"Missouri","Pike County",1,3,203,114,89
050,29,163,"Missouri","Pike County",1,4,225,117,108
050,29,163,"Missouri","Pike County",1,5,223,120,103
050,29,163,"Missouri","Pike County",1,6,230,114,116
050,29,163,"Missouri","Pike County",1,7,214,94,120
050,29,163,"Missouri","Pike County",1,8,230,114,116
050,29,163,"Missouri","Pike County",1,9,235,129,106
050,29,163,"Missouri","Pike County",1,10,234,119,115
050,29,163,"Missouri","Pike County",1,11,255,119,136
050,29,163,"Missouri","Pike County",1,12,221,114,107
050,29,163,"Missouri","Pike County",1,13,225,128,97
050,29,163,"Missouri","Pike County",1,14,245,132,113
050,29,163,"Missouri","Pike County",1,15,226,123,103
050,29,163,"Missouri","Pike County",1,16,253,137,116
050,29,163,"Missouri","Pike County",1,17,216,114,102
050,29,163,"Missouri","Pike County",1,18,201,114,87
050,29,163,"Missouri","Pike County",1,19,143,76,67
050,29,163,"Missouri","Pike County",1,20,156,87,69
050,29,163,"Missouri","Pike County",1,21,174,105,69
050,29,163,"Missouri","Pike County",1,22,199,118,81
050,29,163,"Missouri","Pike County",1,23,225,143,82
050,29,163,"Missouri","Pike County",1,24,227,143,84
050,29,163,"Missouri","Pike County",1,25,215,132,83
050,29,163,"Missouri","Pike County",1,26,230,149,81
050,29,163,"Missouri","Pike County",1,27,247,141,106
050,29,163,"Missouri","Pike County",1,28,253,147,106
050,29,163,"Missouri","Pike County",1,29,243,137,106
050,29,163,"Missouri","Pike County",1,30,233,141,92
050,29,163,"Missouri","Pike County",1,31,226,134,92
050,29,163,"Missouri","Pike County",1,32,215,124,91
050,29,163,"Missouri","Pike County",1,33,218,131,87
050,29,163,"Missouri","Pike County",1,34,205,126,79
050,29,163,"Missouri","Pike County",1,35,224,135,89
050,29,163,"Missouri","Pike County",1,36,229,124,105
050,29,163,"Missouri","Pike County",1,37,217,112,105
050,29,163,"Missouri","Pike County",1,38,216,126,90
050,29,163,"Missouri","Pike County",1,39,220,124,96
050,29,163,"Missouri","Pike County",1,40,241,135,106
050,29,163,"Missouri","Pike County",1,41,205,115,90
050,29,163,"Missouri","Pike County",1,42,206,108,98
050,29,163,"Missouri","Pike County",1,43,198,118,80
050,29,163,"Missouri","Pike County",1,44,192,114,78
050,29,163,"Missouri","Pike County",1,45,204,126,78
050,29,163,"Missouri","Pike County",1,46,215,135,80
050,29,163,"Missouri","Pike County",1,47,217,132,85
050,29,163,"Missouri","Pike County",1,48,210,124,86
050,29,163,"Missouri","Pike County",1,49,229,131,98
050,29,163,"Missouri","Pike County",1,50,218,119,99
050,29,163,"Missouri","Pike County",1,51,215,121,94
050,29,163,"Missouri","Pike County",1,52,223,132,91
050,29,163,"Missouri","Pike County",1,53,201,114,87
050,29,163,"Missouri","Pike County",1,54,229,138,91
050,29,163,"Missouri","Pike County",1,55,222,125,97
050,29,163,"Missouri","Pike County",1,56,242,132,110
050,29,163,"Missouri","Pike County",1,57,228,116,112
050,29,163,"Missouri","Pike County",1,58,244,131,113
050,29,163,"Missouri","Pike County",1,59,236,118,118
050,29,163,"Missouri","Pike County",1,60,249,126,123
050,29,163,"Missouri","Pike County",1,61,251,131,120
050,29,163,"Missouri","Pike County",1,62,247,129,118
050,29,163,"Missouri","Pike County",1,63,239,117,122
050,29,163,"Missouri","Pike County",1,64,230,109,121
050,29,163,"Missouri","Pike County",1,65,218,103,115
050,29,163,"Missouri","Pike County",1,66,207,107,100
050,29,163,"Missouri","Pike County",1,67,193,107,86
050,29,163,"Missouri","Pike County",1,68,203,106,97
050,29,163,"Missouri","Pike County",1,69,190,92,98
050,29,163,"Missouri","Pike County",1,70,186,84,102
050,29,163,"Missouri","Pike County",1,71,159,71,88
050,29,163,"Missouri","Pike County",1,72,178,87,91
050,29,163,"Missouri","Pike County",1,73,176,92,84
050,29,163,"Missouri","Pike County",1,74,128,59,69
050,29,163,"Missouri","Pike County",1,75,139,60,79
050,29,163,"Missouri","Pike County",1,76,134,56,78
050,29,163,"Missouri","Pike County",1,77,116,46,70
050,29,163,"Missouri","Pike County",1,78,120,54,66
050,29,163,"Missouri","Pike County",1,79,119,55,64
050,29,163,"Missouri","Pike County",1,80,110,51,59
050,29,163,"Missouri","Pike County",1,81,99,48,51
050,29,163,"Missouri","Pike County",1,82,86,40,46
050,29,163,"Missouri","Pike County",1,83,71,30,41
050,29,163,"Missouri","Pike County",1,84,57,24,33
050,29,163,"Missouri","Pike County",1,85,342,126,216
050,29,163,"Missouri","Pike County",2,0,197,107,90
050,29,163,"Missouri","Pike County",2,1,205,107,98
050,29,163,"Missouri","Pike County",2,2,203,113,90
050,29,163,"Missouri","Pike County",2,3,203,114,89
050,29,163,"Missouri","Pike County",2,4,220,117,103
050,29,163,"Missouri","Pike County",2,5,226,121,105
050,29,163,"Missouri","Pike County",2,6,229,116,113
050,29,163,"Missouri","Pike County",2,7,220,99,121
050,29,163,"Missouri","Pike County",2,8,226,108,118
050,29,163,"Missouri","Pike County",2,9,236,126,110
050,29,163,"Missouri","Pike County",2,10,232,120,112
050,29,163,"Missouri","Pike County",2,11,250,118,132
050,29,163,"Missouri","Pike County",2,12,230,116,114
050,29,163,"Missouri","Pike County",2,13,227,127,100
050,29,163,"Missouri","Pike County",2,14,242,133,109
050,29,163,"Missouri","Pike County",2,15,235,128,107
050,29,163,"Missouri","Pike County",2,16,245,132,113
050,29,163,"Missouri","Pike County",2,17,225,121,104
050,29,163,"Missouri","Pike County",2,18,195,110,85
050,29,163,"Missouri","Pike County",2,19,148,81,67
050,29,163,"Missouri","Pike County",2,20,155,85,70
050,29,163,"Missouri","Pike County",2,21,168,99,69
050,29,163,"Missouri","Pike County",2,22,196,116,80
050,29,163,"Missouri","Pike County",2,23,213,131,82
050,29,163,"Missouri","Pike County",2,24,220,136,84
050,29,163,"Missouri","Pike County",2,25,210,128,82
050,29,163,"Missouri","Pike County",2,26,225,142,83
050,29,163,"Missouri","Pike County",2,27,235,137,98
050,29,163,"Missouri","Pike County",2,28,242,138,104
050,29,163,"Missouri","Pike County",2,29,237,132,105
050,29,163,"Missouri","Pike County",2,30,232,134,98
050,29,163,"Missouri","Pike County",2,31,220,129,91
050,29,163,"Missouri","Pike County",2,32,212,120,92
050,29,163,"Missouri","Pike County",2,33,213,125,88
050,29,163,"Missouri","Pike County",2,34,202,121,81
050,29,163,"Missouri","Pike County",2,35,219,130,89
050,29,163,"Missouri","Pike County",2,36,218,119,99
050,29,163,"Missouri","Pike County",2,37,214,109,105
050,29,163,"Missouri","Pike County",2,38,215,121,94
050,29,163,"Missouri","Pike County",2,39,212,117,95
050,29,163,"Missouri","Pike County",2,40,237,132,105
050,29,163,"Missouri","Pike County",2,41,208,114,94
050,29,163,"Missouri","Pike County",2,42,201,105,96
050,29,163,"Missouri","Pike County",2,43,197,111,86
050,29,163,"Missouri","Pike County",2,44,188,110,78
050,29,163,"Missouri","Pike County",2,45,198,120,78
050,29,163,"Missouri","Pike County",2,46,207,128,79
050,29,163,"Missouri","Pike County",2,47,211,127,84
050,29,163,"Missouri","Pike County",2,48,206,121,85
050,29,163,"Missouri","Pike County",2,49,223,128,95
050,29,163,"Missouri","Pike County",2,50,215,116,99
050,29,163,"Missouri","Pike County",2,51,211,118,93
050,29,163,"Missouri","Pike County",2,52,216,125,91
050,29,163,"Missouri","Pike County",2,53,199,112,87
050,29,163,"Missouri","Pike County",2,54,222,131,91
050,29,163,"Missouri","Pike County",2,55,216,121,95
050,29,163,"Missouri","Pike County",2,56,235,127,108
050,29,163,"Missouri","Pike County",2,57,226,117,109
050,29,163,"Missouri","Pike County",2,58,239,126,113
050,29,163,"Missouri","Pike County",2,59,238,121,117
050,29,163,"Missouri","Pike County",2,60,245,122,123
050,29,163,"Missouri","Pike County",2,61,247,127,120
050,29,163,"Missouri","Pike County",2,62,246,129,117
050,29,163,"Missouri","Pike County",2,63,243,119,124
050,29,163,"Missouri","Pike County",2,64,229,109,120
050,29,163,"Missouri","Pike County",2,65,216,101,115
050,29,163,"Missouri","Pike County",2,66,211,105,106
050,29,163,"Missouri","Pike County",2,67,192,103,89
050,29,163,"Missouri","Pike County",2,68,200,105,95
050,29,163,"Missouri","Pike County",2,69,193,94,99
050,29,163,"Missouri","Pike County",2,70,184,84,100
050,29,163,"Missouri","Pike County",2,71,165,73,92
050,29,163,"Missouri","Pike County",2,72,170,81,89
050,29,163,"Missouri","Pike County",2,73,186,95,91
050,29,163,"Missouri","Pike County",2,74,130,62,68
050,29,163,"Missouri","Pike County",2,75,139,61,78
050,29,163,"Missouri","Pike County",2,76,130,53,77
050,29,163,"Missouri","Pike County",2,77,122,49,73
050,29,163,"Missouri","Pike County",2,78,115,51,64
050,29,163,"Missouri","Pike County",2,79,117,53,64
050,29,163,"Missouri","Pike County",2,80,113,53,60
050,29,163,"Missouri","Pike County",2,81,100,48,52
050,29,163,"Missouri","Pike County",2,82,88,41,47
050,29,163,"Missouri","Pike County",2,83,73,32,41
050,29,163,"Missouri","Pike County",2,84,60,25,35
050,29,163,"Missouri","Pike County",2,85,341,125,216
050,29,163,"Missouri","Pike County",3,0,219,107,112
050,29,163,"Missouri","Pike County",3,1,199,109,90
050,29,163,"Missouri","Pike County",3,2,217,114,103
050,29,163,"Missouri","Pike County",3,3,206,118,88
050,29,163,"Missouri","Pike County",3,4,209,115,94
050,29,163,"Missouri","Pike County",3,5,221,118,103
050,29,163,"Missouri","Pike County",3,6,218,121,97
050,29,163,"Missouri","Pike County",3,7,224,114,110
050,29,163,"Missouri","Pike County",3,8,220,96,124
050,29,163,"Missouri","Pike County",3,9,228,117,111
050,29,163,"Missouri","Pike County",3,10,235,125,110
050,29,163,"Missouri","Pike County",3,11,235,121,114
050,29,163,"Missouri","Pike County",3,12,259,121,138
050,29,163,"Missouri","Pike County",3,13,240,123,117
050,29,163,"Missouri","Pike County",3,14,224,127,97
050,29,163,"Missouri","Pike County",3,15,244,131,113
050,29,163,"Missouri","Pike County",3,16,238,128,110
050,29,163,"Missouri","Pike County",3,17,247,136,111
050,29,163,"Missouri","Pike County",3,18,202,116,86
050,29,163,"Missouri","Pike County",3,19,164,92,72
050,29,163,"Missouri","Pike County",3,20,167,94,73
050,29,163,"Missouri","Pike County",3,21,164,90,74
050,29,163,"Missouri","Pike County",3,22,195,113,82
050,29,163,"Missouri","Pike County",3,23,195,113,82
050,29,163,"Missouri","Pike County",3,24,225,133,92
050,29,163,"Missouri","Pike County",3,25,212,128,84
050,29,163,"Missouri","Pike County",3,26,217,143,74
050,29,163,"Missouri","Pike County",3,27,229,145,84
050,29,163,"Missouri","Pike County",3,28,220,128,92
050,29,163,"Missouri","Pike County",3,29,249,136,113
050,29,163,"Missouri","Pike County",3,30,248,143,105
050,29,163,"Missouri","Pike County",3,31,245,141,104
050,29,163,"Missouri","Pike County",3,32,228,130,98
050,29,163,"Missouri","Pike County",3,33,235,143,92
050,29,163,"Missouri","Pike County",3,34,218,129,89
050,29,163,"Missouri","Pike County",3,35,208,126,82
050,29,163,"Missouri","Pike County",3,36,224,131,93
050,29,163,"Missouri","Pike County",3,37,216,116,100
050,29,163,"Missouri","Pike County",3,38,232,122,110
050,29,163,"Missouri","Pike County",3,39,224,128,96
050,29,163,"Missouri","Pike County",3,40,217,125,92
050,29,163,"Missouri","Pike County",3,41,234,132,102
050,29,163,"Missouri","Pike County",3,42,205,109,96
050,29,163,"Missouri","Pike County",3,43,203,109,94
050,29,163,"Missouri","Pike County",3,44,209,118,91
050,29,163,"Missouri","Pike County",3,45,198,118,80
050,29,163,"Missouri","Pike County",3,46,213,129,84
050,29,163,"Missouri","Pike County",3,47,205,121,84
050,29,163,"Missouri","Pike County",3,48,197,119,78
050,29,163,"Missouri","Pike County",3,49,221,135,86
050,29,163,"Missouri","Pike County",3,50,205,111,94
050,29,163,"Missouri","Pike County",3,51,220,121,99
050,29,163,"Missouri","Pike County",3,52,210,119,91
050,29,163,"Missouri","Pike County",3,53,209,119,90
050,29,163,"Missouri","Pike County",3,54,216,125,91
050,29,163,"Missouri","Pike County",3,55,216,123,93
050,29,163,"Missouri","Pike County",3,56,215,120,95
050,29,163,"Missouri","Pike County",3,57,239,129,110
050,29,163,"Missouri","Pike County",3,58,216,110,106
050,29,163,"Missouri","Pike County",3,59,232,123,109
050,29,163,"Missouri","Pike County",3,60,246,127,119
050,29,163,"Missouri","Pike County",3,61,245,119,126
050,29,163,"Missouri","Pike County",3,62,250,133,117
050,29,163,"Missouri","Pike County",3,63,245,129,116
050,29,163,"Missouri","Pike County",3,64,245,122,123
050,29,163,"Missouri","Pike County",3,65,226,109,117
050,29,163,"Missouri","Pike County",3,66,211,99,112
050,29,163,"Missouri","Pike County",3,67,207,104,103
050,29,163,"Missouri","Pike County",3,68,185,100,85
050,29,163,"Missouri","Pike County",3,69,194,99,95
050,29,163,"Missouri","Pike County",3,70,189,91,98
050,29,163,"Missouri","Pike County",3,71,183,83,100
050,29,163,"Missouri","Pike County",3,72,155,70,85
050,29,163,"Missouri","Pike County",3,73,157,72,85
050,29,163,"Missouri","Pike County",3,74,177,89,88
050,29,163,"Missouri","Pike County",3,75,133,66,67
050,29,163,"Missouri","Pike County",3,76,132,54,78
050,29,163,"Missouri","Pike County",3,77,120,47,73
050,29,163,"Missouri","Pike County",3,78,114,44,70
050,29,163,"Missouri","Pike County",3,79,105,44,61
050,29,163,"Missouri","Pike County",3,80,113,51,62
050,29,163,"Missouri","Pike County",3,81,107,47,60
050,29,163,"Missouri","Pike County",3,82,90,44,46
050,29,163,"Missouri","Pike County",3,83,80,39,41
050,29,163,"Missouri","Pike County",3,84,68,30,38
050,29,163,"Missouri","Pike County",3,85,339,125,214
050,29,163,"Missouri","Pike County",4,0,193,91,102
050,29,163,"Missouri","Pike County",4,1,201,94,107
050,29,163,"Missouri","Pike County",4,2,196,104,92
050,29,163,"Missouri","Pike County",4,3,216,119,97
050,29,163,"Missouri","Pike County",4,4,215,122,93
050,29,163,"Missouri","Pike County",4,5,201,110,91
050,29,163,"Missouri","Pike County",4,6,221,115,106
050,29,163,"Missouri","Pike County",4,7,229,123,106
050,29,163,"Missouri","Pike County",4,8,236,120,116
050,29,163,"Missouri","Pike County",4,9,232,104,128
050,29,163,"Missouri","Pike County",4,10,225,110,115
050,29,163,"Missouri","Pike County",4,11,230,123,107
050,29,163,"Missouri","Pike County",4,12,237,122,115
050,29,163,"Missouri","Pike County",4,13,259,122,137
050,29,163,"Missouri","Pike County",4,14,237,119,118
050,29,163,"Missouri","Pike County",4,15,233,129,104
050,29,163,"Missouri","Pike County",4,16,238,130,108
050,29,163,"Missouri","Pike County",4,17,246,133,113
050,29,163,"Missouri","Pike County",4,18,211,122,89
050,29,163,"Missouri","Pike County",4,19,153,90,63
050,29,163,"Missouri","Pike County",4,20,171,98,73
050,29,163,"Missouri","Pike County",4,21,179,104,75
050,29,163,"Missouri","Pike County",4,22,186,104,82
050,29,163,"Missouri","Pike County",4,23,192,115,77
050,29,163,"Missouri","Pike County",4,24,211,129,82
050,29,163,"Missouri","Pike County",4,25,200,112,88
050,29,163,"Missouri","Pike County",4,26,214,133,81
050,29,163,"Missouri","Pike County",4,27,220,136,84
050,29,163,"Missouri","Pike County",4,28,228,147,81
050,29,163,"Missouri","Pike County",4,29,216,128,88
050,29,163,"Missouri","Pike County",4,30,251,136,115
050,29,163,"Missouri","Pike County",4,31,243,141,102
050,29,163,"Missouri","Pike County",4,32,235,126,109
050,29,163,"Missouri","Pike County",4,33,243,142,101
050,29,163,"Missouri","Pike County",4,34,235,137,98
050,29,163,"Missouri","Pike County",4,35,224,137,87
050,29,163,"Missouri","Pike County",4,36,203,121,82
050,29,163,"Missouri","Pike County",4,37,218,124,94
050,29,163,"Missouri","Pike County",4,38,227,126,101
050,29,163,"Missouri","Pike County",4,39,226,117,109
050,29,163,"Missouri","Pike County",4,40,237,138,99
050,29,163,"Missouri","Pike County",4,41,208,121,87
050,29,163,"Missouri","Pike County",4,42,227,126,101
050,29,163,"Missouri","Pike County",4,43,192,100,92
050,29,163,"Missouri","Pike County",4,44,212,108,104
050,29,163,"Missouri","Pike County",4,45,219,129,90
050,29,163,"Missouri","Pike County",4,46,205,125,80
050,29,163,"Missouri","Pike County",4,47,212,130,82
050,29,163,"Missouri","Pike County",4,48,205,119,86
050,29,163,"Missouri","Pike County",4,49,218,136,82
050,29,163,"Missouri","Pike County",4,50,209,120,89
050,29,163,"Missouri","Pike County",4,51,215,121,94
050,29,163,"Missouri","Pike County",4,52,222,119,103
050,29,163,"Missouri","Pike County",4,53,196,105,91
050,29,163,"Missouri","Pike County",4,54,230,136,94
050,29,163,"Missouri","Pike County",4,55,204,115,89
050,29,163,"Missouri","Pike County",4,56,215,118,97
050,29,163,"Missouri","Pike County",4,57,218,125,93
050,29,163,"Missouri","Pike County",4,58,235,123,112
050,29,163,"Missouri","Pike County",4,59,210,104,106
050,29,163,"Missouri","Pike County",4,60,242,131,111
050,29,163,"Missouri","Pike County",4,61,238,120,118
050,29,163,"Missouri","Pike County",4,62,252,124,128
050,29,163,"Missouri","Pike County",4,63,252,136,116
050,29,163,"Missouri","Pike County",4,64,242,126,116
050,29,163,"Missouri","Pike County",4,65,241,122,119
050,29,163,"Missouri","Pike County",4,66,233,112,121
050,29,163,"Missouri","Pike County",4,67,213,102,111
050,29,163,"Missouri","Pike County",4,68,211,106,105
050,29,163,"Missouri","Pike County",4,69,176,93,83
050,29,163,"Missouri","Pike County",4,70,187,98,89
050,29,163,"Missouri","Pike County",4,71,182,88,94
050,29,163,"Missouri","Pike County",4,72,185,85,100
050,29,163,"Missouri","Pike County",4,73,148,65,83
050,29,163,"Missouri","Pike County",4,74,152,70,82
050,29,163,"Missouri","Pike County",4,75,181,90,91
050,29,163,"Missouri","Pike County",4,76,127,61,66
050,29,163,"Missouri","Pike County",4,77,118,49,69
050,29,163,"Missouri","Pike County",4,78,119,46,73
050,29,163,"Missouri","Pike County",4,79,106,38,68
050,29,163,"Missouri","Pike County",4,80,101,41,60
050,29,163,"Missouri","Pike County",4,81,107,48,59
050,29,163,"Missouri","Pike County",4,82,100,44,56
050,29,163,"Missouri","Pike County",4,83,84,42,42
050,29,163,"Missouri","Pike County",4,84,76,37,39
050,29,163,"Missouri","Pike County",4,85,351,135,216
050,29,163,"Missouri","Pike County",5,0,193,92,101
050,29,163,"Missouri","Pike County",5,1,211,105,106
050,29,163,"Missouri","Pike County",5,2,206,95,111
050,29,163,"Missouri","Pike County",5,3,190,103,87
050,29,163,"Missouri","Pike County",5,4,224,124,100
050,29,163,"Missouri","Pike County",5,5,208,116,92
050,29,163,"Missouri","Pike County",5,6,209,112,97
050,29,163,"Missouri","Pike County",5,7,229,122,107
050,29,163,"Missouri","Pike County",5,8,223,119,104
050,29,163,"Missouri","Pike County",5,9,245,127,118
050,29,163,"Missouri","Pike County",5,10,217,95,122
050,29,163,"Missouri","Pike County",5,11,229,116,113
050,29,163,"Missouri","Pike County",5,12,230,122,108
050,29,163,"Missouri","Pike County",5,13,238,128,110
050,29,163,"Missouri","Pike County",5,14,274,132,142
050,29,163,"Missouri","Pike County",5,15,234,119,115
050,29,163,"Missouri","Pike County",5,16,242,131,111
050,29,163,"Missouri","Pike County",5,17,244,134,110
050,29,163,"Missouri","Pike County",5,18,218,121,97
050,29,163,"Missouri","Pike County",5,19,169,97,72
050,29,163,"Missouri","Pike County",5,20,173,103,70
050,29,163,"Missouri","Pike County",5,21,194,117,77
050,29,163,"Missouri","Pike County",5,22,202,120,82
050,29,163,"Missouri","Pike County",5,23,187,108,79
050,29,163,"Missouri","Pike County",5,24,221,134,87
050,29,163,"Missouri","Pike County",5,25,209,125,84
050,29,163,"Missouri","Pike County",5,26,225,136,89
050,29,163,"Missouri","Pike County",5,27,209,127,82
050,29,163,"Missouri","Pike County",5,28,225,145,80
050,29,163,"Missouri","Pike County",5,29,240,153,87
050,29,163,"Missouri","Pike County",5,30,223,134,89
050,29,163,"Missouri","Pike County",5,31,251,141,110
050,29,163,"Missouri","Pike County",5,32,241,138,103
050,29,163,"Missouri","Pike County",5,33,242,134,108
050,29,163,"Missouri","Pike County",5,34,245,141,104
050,29,163,"Missouri","Pike County",5,35,249,146,103
050,29,163,"Missouri","Pike County",5,36,222,131,91
050,29,163,"Missouri","Pike County",5,37,199,117,82
050,29,163,"Missouri","Pike County",5,38,241,141,100
050,29,163,"Missouri","Pike County",5,39,226,125,101
050,29,163,"Missouri","Pike County",5,40,244,134,110
050,29,163,"Missouri","Pike County",5,41,241,144,97
050,29,163,"Missouri","Pike County",5,42,225,129,96
050,29,163,"Missouri","Pike County",5,43,225,132,93
050,29,163,"Missouri","Pike County",5,44,197,104,93
050,29,163,"Missouri","Pike County",5,45,228,121,107
050,29,163,"Missouri","Pike County",5,46,231,144,87
050,29,163,"Missouri","Pike County",5,47,206,125,81
050,29,163,"Missouri","Pike County",5,48,214,126,88
050,29,163,"Missouri","Pike County",5,49,210,128,82
050,29,163,"Missouri","Pike County",5,50,200,119,81
050,29,163,"Missouri","Pike County",5,51,224,132,92
050,29,163,"Missouri","Pike County",5,52,214,120,94
050,29,163,"Missouri","Pike County",5,53,217,113,104
050,29,163,"Missouri","Pike County",5,54,211,112,99
050,29,163,"Missouri","Pike County",5,55,218,123,95
050,29,163,"Missouri","Pike County",5,56,210,120,90
050,29,163,"Missouri","Pike County",5,57,221,117,104
050,29,163,"Missouri","Pike County",5,58,215,122,93
050,29,163,"Missouri","Pike County",5,59,225,118,107
050,29,163,"Missouri","Pike County",5,60,219,111,108
050,29,163,"Missouri","Pike County",5,61,238,126,112
050,29,163,"Missouri","Pike County",5,62,241,125,116
050,29,163,"Missouri","Pike County",5,63,264,135,129
050,29,163,"Missouri","Pike County",5,64,254,140,114
050,29,163,"Missouri","Pike County",5,65,234,124,110
050,29,163,"Missouri","Pike County",5,66,239,118,121
050,29,163,"Missouri","Pike County",5,67,229,111,118
050,29,163,"Missouri","Pike County",5,68,212,99,113
050,29,163,"Missouri","Pike County",5,69,208,104,104
050,29,163,"Missouri","Pike County",5,70,171,89,82
050,29,163,"Missouri","Pike County",5,71,181,93,88
050,29,163,"Missouri","Pike County",5,72,178,86,92
050,29,163,"Missouri","Pike County",5,73,177,81,96
050,29,163,"Missouri","Pike County",5,74,142,63,79
050,29,163,"Missouri","Pike County",5,75,157,74,83
050,29,163,"Missouri","Pike County",5,76,170,81,89
050,29,163,"Missouri","Pike County",5,77,115,55,60
050,29,163,"Missouri","Pike County",5,78,116,48,68
050,29,163,"Missouri","Pike County",5,79,111,40,71
050,29,163,"Missouri","Pike County",5,80,108,37,71
050,29,163,"Missouri","Pike County",5,81,95,39,56
050,29,163,"Missouri","Pike County",5,82,101,46,55
050,29,163,"Missouri","Pike County",5,83,92,41,51
050,29,163,"Missouri","Pike County",5,84,78,41,37
050,29,163,"Missouri","Pike County",5,85,372,151,221
050,29,165,"Missouri","Platte County",1,0,1200,619,581
050,29,165,"Missouri","Platte County",1,1,1260,656,604
050,29,165,"Missouri","Platte County",1,2,1266,623,643
050,29,165,"Missouri","Platte County",1,3,1252,625,627
050,29,165,"Missouri","Platte County",1,4,1363,702,661
050,29,165,"Missouri","Platte County",1,5,1373,711,662
050,29,165,"Missouri","Platte County",1,6,1343,657,686
050,29,165,"Missouri","Platte County",1,7,1431,691,740
050,29,165,"Missouri","Platte County",1,8,1450,748,702
050,29,165,"Missouri","Platte County",1,9,1462,761,701
050,29,165,"Missouri","Platte County",1,10,1497,744,753
050,29,165,"Missouri","Platte County",1,11,1499,766,733
050,29,165,"Missouri","Platte County",1,12,1522,761,761
050,29,165,"Missouri","Platte County",1,13,1503,799,704
050,29,165,"Missouri","Platte County",1,14,1489,767,722
050,29,165,"Missouri","Platte County",1,15,1486,758,728
050,29,165,"Missouri","Platte County",1,16,1488,746,742
050,29,165,"Missouri","Platte County",1,17,1471,751,720
050,29,165,"Missouri","Platte County",1,18,1223,652,571
050,29,165,"Missouri","Platte County",1,19,1093,546,547
050,29,165,"Missouri","Platte County",1,20,1104,551,553
050,29,165,"Missouri","Platte County",1,21,1170,597,573
050,29,165,"Missouri","Platte County",1,22,1189,578,611
050,29,165,"Missouri","Platte County",1,23,1252,594,658
050,29,165,"Missouri","Platte County",1,24,1258,604,654
050,29,165,"Missouri","Platte County",1,25,1297,664,633
050,29,165,"Missouri","Platte County",1,26,1346,699,647
050,29,165,"Missouri","Platte County",1,27,1403,687,716
050,29,165,"Missouri","Platte County",1,28,1380,706,674
050,29,165,"Missouri","Platte County",1,29,1427,719,708
050,29,165,"Missouri","Platte County",1,30,1402,693,709
050,29,165,"Missouri","Platte County",1,31,1414,717,697
050,29,165,"Missouri","Platte County",1,32,1370,676,694
050,29,165,"Missouri","Platte County",1,33,1449,738,711
050,29,165,"Missouri","Platte County",1,34,1500,760,740
050,29,165,"Missouri","Platte County",1,35,1478,713,765
050,29,165,"Missouri","Platte County",1,36,1533,758,775
050,29,165,"Missouri","Platte County",1,37,1579,772,807
050,29,165,"Missouri","Platte County",1,38,1666,837,829
050,29,165,"Missouri","Platte County",1,39,1667,830,837
050,29,165,"Missouri","Platte County",1,40,1612,829,783
050,29,165,"Missouri","Platte County",1,41,1485,765,720
050,29,165,"Missouri","Platte County",1,42,1432,733,699
050,29,165,"Missouri","Platte County",1,43,1412,707,705
050,29,165,"Missouri","Platte County",1,44,1401,721,680
050,29,165,"Missouri","Platte County",1,45,1416,724,692
050,29,165,"Missouri","Platte County",1,46,1331,659,672
050,29,165,"Missouri","Platte County",1,47,1330,662,668
050,29,165,"Missouri","Platte County",1,48,1465,719,746
050,29,165,"Missouri","Platte County",1,49,1595,820,775
050,29,165,"Missouri","Platte County",1,50,1487,749,738
050,29,165,"Missouri","Platte County",1,51,1351,656,695
050,29,165,"Missouri","Platte County",1,52,1268,618,650
050,29,165,"Missouri","Platte County",1,53,1383,692,691
050,29,165,"Missouri","Platte County",1,54,1360,714,646
050,29,165,"Missouri","Platte County",1,55,1339,672,667
050,29,165,"Missouri","Platte County",1,56,1457,736,721
050,29,165,"Missouri","Platte County",1,57,1447,716,731
050,29,165,"Missouri","Platte County",1,58,1516,754,762
050,29,165,"Missouri","Platte County",1,59,1441,717,724
050,29,165,"Missouri","Platte County",1,60,1358,681,677
050,29,165,"Missouri","Platte County",1,61,1307,642,665
050,29,165,"Missouri","Platte County",1,62,1302,593,709
050,29,165,"Missouri","Platte County",1,63,1272,616,656
050,29,165,"Missouri","Platte County",1,64,1259,607,652
050,29,165,"Missouri","Platte County",1,65,1163,582,581
050,29,165,"Missouri","Platte County",1,66,1127,538,589
050,29,165,"Missouri","Platte County",1,67,1092,538,554
050,29,165,"Missouri","Platte County",1,68,1046,492,554
050,29,165,"Missouri","Platte County",1,69,1008,489,519
050,29,165,"Missouri","Platte County",1,70,968,468,500
050,29,165,"Missouri","Platte County",1,71,945,450,495
050,29,165,"Missouri","Platte County",1,72,934,447,487
050,29,165,"Missouri","Platte County",1,73,907,425,482
050,29,165,"Missouri","Platte County",1,74,641,305,336
050,29,165,"Missouri","Platte County",1,75,676,317,359
050,29,165,"Missouri","Platte County",1,76,660,323,337
050,29,165,"Missouri","Platte County",1,77,645,305,340
050,29,165,"Missouri","Platte County",1,78,546,276,270
050,29,165,"Missouri","Platte County",1,79,482,221,261
050,29,165,"Missouri","Platte County",1,80,387,172,215
050,29,165,"Missouri","Platte County",1,81,376,167,209
050,29,165,"Missouri","Platte County",1,82,321,138,183
050,29,165,"Missouri","Platte County",1,83,287,112,175
050,29,165,"Missouri","Platte County",1,84,249,106,143
050,29,165,"Missouri","Platte County",1,85,1692,562,1130
050,29,165,"Missouri","Platte County",2,0,1205,619,586
050,29,165,"Missouri","Platte County",2,1,1247,646,601
050,29,165,"Missouri","Platte County",2,2,1267,630,637
050,29,165,"Missouri","Platte County",2,3,1261,626,635
050,29,165,"Missouri","Platte County",2,4,1356,694,662
050,29,165,"Missouri","Platte County",2,5,1379,712,667
050,29,165,"Missouri","Platte County",2,6,1365,676,689
050,29,165,"Missouri","Platte County",2,7,1415,687,728
050,29,165,"Missouri","Platte County",2,8,1452,736,716
050,29,165,"Missouri","Platte County",2,9,1466,760,706
050,29,165,"Missouri","Platte County",2,10,1487,747,740
050,29,165,"Missouri","Platte County",2,11,1500,760,740
050,29,165,"Missouri","Platte County",2,12,1530,767,763
050,29,165,"Missouri","Platte County",2,13,1521,795,726
050,29,165,"Missouri","Platte County",2,14,1504,780,724
050,29,165,"Missouri","Platte County",2,15,1491,763,728
050,29,165,"Missouri","Platte County",2,16,1494,753,741
050,29,165,"Missouri","Platte County",2,17,1476,752,724
050,29,165,"Missouri","Platte County",2,18,1231,650,581
050,29,165,"Missouri","Platte County",2,19,1095,553,542
050,29,165,"Missouri","Platte County",2,20,1123,560,563
050,29,165,"Missouri","Platte County",2,21,1163,591,572
050,29,165,"Missouri","Platte County",2,22,1206,590,616
050,29,165,"Missouri","Platte County",2,23,1253,596,657
050,29,165,"Missouri","Platte County",2,24,1263,610,653
050,29,165,"Missouri","Platte County",2,25,1290,653,637
050,29,165,"Missouri","Platte County",2,26,1348,692,656
050,29,165,"Missouri","Platte County",2,27,1385,686,699
050,29,165,"Missouri","Platte County",2,28,1394,706,688
050,29,165,"Missouri","Platte County",2,29,1418,710,708
050,29,165,"Missouri","Platte County",2,30,1428,707,721
050,29,165,"Missouri","Platte County",2,31,1414,711,703
050,29,165,"Missouri","Platte County",2,32,1390,691,699
050,29,165,"Missouri","Platte County",2,33,1444,730,714
050,29,165,"Missouri","Platte County",2,34,1485,749,736
050,29,165,"Missouri","Platte County",2,35,1495,732,763
050,29,165,"Missouri","Platte County",2,36,1517,750,767
050,29,165,"Missouri","Platte County",2,37,1578,776,802
050,29,165,"Missouri","Platte County",2,38,1661,828,833
050,29,165,"Missouri","Platte County",2,39,1669,835,834
050,29,165,"Missouri","Platte County",2,40,1644,837,807
050,29,165,"Missouri","Platte County",2,41,1523,782,741
050,29,165,"Missouri","Platte County",2,42,1436,735,701
050,29,165,"Missouri","Platte County",2,43,1433,722,711
050,29,165,"Missouri","Platte County",2,44,1393,714,679
050,29,165,"Missouri","Platte County",2,45,1428,730,698
050,29,165,"Missouri","Platte County",2,46,1349,673,676
050,29,165,"Missouri","Platte County",2,47,1331,658,673
050,29,165,"Missouri","Platte County",2,48,1438,710,728
050,29,165,"Missouri","Platte County",2,49,1572,801,771
050,29,165,"Missouri","Platte County",2,50,1515,766,749
050,29,165,"Missouri","Platte County",2,51,1377,673,704
050,29,165,"Missouri","Platte County",2,52,1289,628,661
050,29,165,"Missouri","Platte County",2,53,1354,676,678
050,29,165,"Missouri","Platte County",2,54,1361,707,654
050,29,165,"Missouri","Platte County",2,55,1342,684,658
050,29,165,"Missouri","Platte County",2,56,1428,718,710
050,29,165,"Missouri","Platte County",2,57,1455,725,730
050,29,165,"Missouri","Platte County",2,58,1498,745,753
050,29,165,"Missouri","Platte County",2,59,1465,728,737
050,29,165,"Missouri","Platte County",2,60,1375,689,686
050,29,165,"Missouri","Platte County",2,61,1317,648,669
050,29,165,"Missouri","Platte County",2,62,1294,600,694
050,29,165,"Missouri","Platte County",2,63,1290,616,674
050,29,165,"Missouri","Platte County",2,64,1262,606,656
050,29,165,"Missouri","Platte County",2,65,1176,585,591
050,29,165,"Missouri","Platte County",2,66,1133,546,587
050,29,165,"Missouri","Platte County",2,67,1098,539,559
050,29,165,"Missouri","Platte County",2,68,1052,499,553
050,29,165,"Missouri","Platte County",2,69,1017,492,525
050,29,165,"Missouri","Platte County",2,70,975,474,501
050,29,165,"Missouri","Platte County",2,71,954,455,499
050,29,165,"Missouri","Platte County",2,72,928,443,485
050,29,165,"Missouri","Platte County",2,73,960,452,508
050,29,165,"Missouri","Platte County",2,74,663,310,353
050,29,165,"Missouri","Platte County",2,75,669,313,356
050,29,165,"Missouri","Platte County",2,76,661,320,341
050,29,165,"Missouri","Platte County",2,77,660,314,346
050,29,165,"Missouri","Platte County",2,78,561,279,282
050,29,165,"Missouri","Platte County",2,79,494,230,264
050,29,165,"Missouri","Platte County",2,80,409,183,226
050,29,165,"Missouri","Platte County",2,81,377,165,212
050,29,165,"Missouri","Platte County",2,82,329,144,185
050,29,165,"Missouri","Platte County",2,83,285,115,170
050,29,165,"Missouri","Platte County",2,84,255,107,148
050,29,165,"Missouri","Platte County",2,85,1702,566,1136
050,29,165,"Missouri","Platte County",3,0,1208,642,566
050,29,165,"Missouri","Platte County",3,1,1215,606,609
050,29,165,"Missouri","Platte County",3,2,1257,655,602
050,29,165,"Missouri","Platte County",3,3,1300,661,639
050,29,165,"Missouri","Platte County",3,4,1266,618,648
050,29,165,"Missouri","Platte County",3,5,1362,686,676
050,29,165,"Missouri","Platte County",3,6,1384,699,685
050,29,165,"Missouri","Platte County",3,7,1403,694,709
050,29,165,"Missouri","Platte County",3,8,1404,682,722
050,29,165,"Missouri","Platte County",3,9,1484,756,728
050,29,165,"Missouri","Platte County",3,10,1469,767,702
050,29,165,"Missouri","Platte County",3,11,1487,743,744
050,29,165,"Missouri","Platte County",3,12,1509,756,753
050,29,165,"Missouri","Platte County",3,13,1531,767,764
050,29,165,"Missouri","Platte County",3,14,1540,804,736
050,29,165,"Missouri","Platte County",3,15,1525,787,738
050,29,165,"Missouri","Platte County",3,16,1498,791,707
050,29,165,"Missouri","Platte County",3,17,1538,771,767
050,29,165,"Missouri","Platte County",3,18,1301,669,632
050,29,165,"Missouri","Platte County",3,19,1091,554,537
050,29,165,"Missouri","Platte County",3,20,1149,583,566
050,29,165,"Missouri","Platte County",3,21,1197,603,594
050,29,165,"Missouri","Platte County",3,22,1246,624,622
050,29,165,"Missouri","Platte County",3,23,1344,637,707
050,29,165,"Missouri","Platte County",3,24,1341,652,689
050,29,165,"Missouri","Platte County",3,25,1342,671,671
050,29,165,"Missouri","Platte County",3,26,1325,626,699
050,29,165,"Missouri","Platte County",3,27,1359,700,659
050,29,165,"Missouri","Platte County",3,28,1450,717,733
050,29,165,"Missouri","Platte County",3,29,1412,699,713
050,29,165,"Missouri","Platte County",3,30,1378,695,683
050,29,165,"Missouri","Platte County",3,31,1464,718,746
050,29,165,"Missouri","Platte County",3,32,1459,730,729
050,29,165,"Missouri","Platte County",3,33,1461,747,714
050,29,165,"Missouri","Platte County",3,34,1454,731,723
050,29,165,"Missouri","Platte County",3,35,1508,756,752
050,29,165,"Missouri","Platte County",3,36,1517,747,770
050,29,165,"Missouri","Platte County",3,37,1564,756,808
050,29,165,"Missouri","Platte County",3,38,1601,777,824
050,29,165,"Missouri","Platte County",3,39,1676,822,854
050,29,165,"Missouri","Platte County",3,40,1710,851,859
050,29,165,"Missouri","Platte County",3,41,1685,864,821
050,29,165,"Missouri","Platte County",3,42,1567,796,771
050,29,165,"Missouri","Platte County",3,43,1471,751,720
050,29,165,"Missouri","Platte County",3,44,1465,724,741
050,29,165,"Missouri","Platte County",3,45,1395,732,663
050,29,165,"Missouri","Platte County",3,46,1433,745,688
050,29,165,"Missouri","Platte County",3,47,1345,666,679
050,29,165,"Missouri","Platte County",3,48,1356,671,685
050,29,165,"Missouri","Platte County",3,49,1411,703,708
050,29,165,"Missouri","Platte County",3,50,1567,807,760
050,29,165,"Missouri","Platte County",3,51,1479,737,742
050,29,165,"Missouri","Platte County",3,52,1379,675,704
050,29,165,"Missouri","Platte County",3,53,1299,651,648
050,29,165,"Missouri","Platte County",3,54,1342,650,692
050,29,165,"Missouri","Platte County",3,55,1346,694,652
050,29,165,"Missouri","Platte County",3,56,1358,696,662
050,29,165,"Missouri","Platte County",3,57,1434,736,698
050,29,165,"Missouri","Platte County",3,58,1437,716,721
050,29,165,"Missouri","Platte County",3,59,1487,731,756
050,29,165,"Missouri","Platte County",3,60,1469,727,742
050,29,165,"Missouri","Platte County",3,61,1373,688,685
050,29,165,"Missouri","Platte County",3,62,1303,633,670
050,29,165,"Missouri","Platte County",3,63,1286,608,678
050,29,165,"Missouri","Platte County",3,64,1291,615,676
050,29,165,"Missouri","Platte County",3,65,1227,596,631
050,29,165,"Missouri","Platte County",3,66,1157,572,585
050,29,165,"Missouri","Platte County",3,67,1140,549,591
050,29,165,"Missouri","Platte County",3,68,1097,524,573
050,29,165,"Missouri","Platte County",3,69,1024,485,539
050,29,165,"Missouri","Platte County",3,70,1008,484,524
050,29,165,"Missouri","Platte County",3,71,958,454,504
050,29,165,"Missouri","Platte County",3,72,943,447,496
050,29,165,"Missouri","Platte County",3,73,923,426,497
050,29,165,"Missouri","Platte County",3,74,936,436,500
050,29,165,"Missouri","Platte County",3,75,656,307,349
050,29,165,"Missouri","Platte County",3,76,657,303,354
050,29,165,"Missouri","Platte County",3,77,645,301,344
050,29,165,"Missouri","Platte County",3,78,640,304,336
050,29,165,"Missouri","Platte County",3,79,554,264,290
050,29,165,"Missouri","Platte County",3,80,462,220,242
050,29,165,"Missouri","Platte County",3,81,404,179,225
050,29,165,"Missouri","Platte County",3,82,351,159,192
050,29,165,"Missouri","Platte County",3,83,312,127,185
050,29,165,"Missouri","Platte County",3,84,261,113,148
050,29,165,"Missouri","Platte County",3,85,1682,574,1108
050,29,165,"Missouri","Platte County",4,0,1201,648,553
050,29,165,"Missouri","Platte County",4,1,1326,695,631
050,29,165,"Missouri","Platte County",4,2,1238,618,620
050,29,165,"Missouri","Platte County",4,3,1289,662,627
050,29,165,"Missouri","Platte County",4,4,1315,665,650
050,29,165,"Missouri","Platte County",4,5,1309,642,667
050,29,165,"Missouri","Platte County",4,6,1360,698,662
050,29,165,"Missouri","Platte County",4,7,1441,731,710
050,29,165,"Missouri","Platte County",4,8,1389,703,686
050,29,165,"Missouri","Platte County",4,9,1455,711,744
050,29,165,"Missouri","Platte County",4,10,1508,775,733
050,29,165,"Missouri","Platte County",4,11,1493,777,716
050,29,165,"Missouri","Platte County",4,12,1533,749,784
050,29,165,"Missouri","Platte County",4,13,1547,768,779
050,29,165,"Missouri","Platte County",4,14,1568,784,784
050,29,165,"Missouri","Platte County",4,15,1545,814,731
050,29,165,"Missouri","Platte County",4,16,1524,797,727
050,29,165,"Missouri","Platte County",4,17,1518,807,711
050,29,165,"Missouri","Platte County",4,18,1330,698,632
050,29,165,"Missouri","Platte County",4,19,1113,557,556
050,29,165,"Missouri","Platte County",4,20,1131,567,564
050,29,165,"Missouri","Platte County",4,21,1191,600,591
050,29,165,"Missouri","Platte County",4,22,1306,625,681
050,29,165,"Missouri","Platte County",4,23,1329,648,681
050,29,165,"Missouri","Platte County",4,24,1368,648,720
050,29,165,"Missouri","Platte County",4,25,1426,711,715
050,29,165,"Missouri","Platte County",4,26,1370,687,683
050,29,165,"Missouri","Platte County",4,27,1345,658,687
050,29,165,"Missouri","Platte County",4,28,1427,759,668
050,29,165,"Missouri","Platte County",4,29,1474,732,742
050,29,165,"Missouri","Platte County",4,30,1454,714,740
050,29,165,"Missouri","Platte County",4,31,1463,731,732
050,29,165,"Missouri","Platte County",4,32,1507,729,778
050,29,165,"Missouri","Platte County",4,33,1512,764,748
050,29,165,"Missouri","Platte County",4,34,1490,767,723
050,29,165,"Missouri","Platte County",4,35,1470,728,742
050,29,165,"Missouri","Platte County",4,36,1566,777,789
050,29,165,"Missouri","Platte County",4,37,1550,769,781
050,29,165,"Missouri","Platte County",4,38,1608,786,822
050,29,165,"Missouri","Platte County",4,39,1613,790,823
050,29,165,"Missouri","Platte County",4,40,1704,848,856
050,29,165,"Missouri","Platte County",4,41,1725,855,870
050,29,165,"Missouri","Platte County",4,42,1653,848,805
050,29,165,"Missouri","Platte County",4,43,1591,803,788
050,29,165,"Missouri","Platte County",4,44,1482,765,717
050,29,165,"Missouri","Platte County",4,45,1472,726,746
050,29,165,"Missouri","Platte County",4,46,1401,729,672
050,29,165,"Missouri","Platte County",4,47,1442,747,695
050,29,165,"Missouri","Platte County",4,48,1367,675,692
050,29,165,"Missouri","Platte County",4,49,1363,667,696
050,29,165,"Missouri","Platte County",4,50,1390,695,695
050,29,165,"Missouri","Platte County",4,51,1566,804,762
050,29,165,"Missouri","Platte County",4,52,1501,751,750
050,29,165,"Missouri","Platte County",4,53,1395,692,703
050,29,165,"Missouri","Platte County",4,54,1323,660,663
050,29,165,"Missouri","Platte County",4,55,1347,652,695
050,29,165,"Missouri","Platte County",4,56,1356,707,649
050,29,165,"Missouri","Platte County",4,57,1348,689,659
050,29,165,"Missouri","Platte County",4,58,1417,724,693
050,29,165,"Missouri","Platte County",4,59,1439,728,711
050,29,165,"Missouri","Platte County",4,60,1496,727,769
050,29,165,"Missouri","Platte County",4,61,1466,729,737
050,29,165,"Missouri","Platte County",4,62,1370,680,690
050,29,165,"Missouri","Platte County",4,63,1278,627,651
050,29,165,"Missouri","Platte County",4,64,1308,615,693
050,29,165,"Missouri","Platte County",4,65,1273,616,657
050,29,165,"Missouri","Platte County",4,66,1204,567,637
050,29,165,"Missouri","Platte County",4,67,1143,561,582
050,29,165,"Missouri","Platte County",4,68,1131,541,590
050,29,165,"Missouri","Platte County",4,69,1062,507,555
050,29,165,"Missouri","Platte County",4,70,1001,479,522
050,29,165,"Missouri","Platte County",4,71,1001,460,541
050,29,165,"Missouri","Platte County",4,72,944,433,511
050,29,165,"Missouri","Platte County",4,73,937,443,494
050,29,165,"Missouri","Platte County",4,74,932,426,506
050,29,165,"Missouri","Platte County",4,75,925,435,490
050,29,165,"Missouri","Platte County",4,76,633,290,343
050,29,165,"Missouri","Platte County",4,77,640,288,352
050,29,165,"Missouri","Platte County",4,78,636,298,338
050,29,165,"Missouri","Platte County",4,79,629,293,336
050,29,165,"Missouri","Platte County",4,80,527,254,273
050,29,165,"Missouri","Platte County",4,81,450,212,238
050,29,165,"Missouri","Platte County",4,82,389,168,221
050,29,165,"Missouri","Platte County",4,83,323,142,181
050,29,165,"Missouri","Platte County",4,84,287,123,164
050,29,165,"Missouri","Platte County",4,85,1701,566,1135
050,29,165,"Missouri","Platte County",5,0,1215,651,564
050,29,165,"Missouri","Platte County",5,1,1199,630,569
050,29,165,"Missouri","Platte County",5,2,1327,702,625
050,29,165,"Missouri","Platte County",5,3,1244,606,638
050,29,165,"Missouri","Platte County",5,4,1313,688,625
050,29,165,"Missouri","Platte County",5,5,1328,665,663
050,29,165,"Missouri","Platte County",5,6,1363,685,678
050,29,165,"Missouri","Platte County",5,7,1413,709,704
050,29,165,"Missouri","Platte County",5,8,1494,749,745
050,29,165,"Missouri","Platte County",5,9,1402,690,712
050,29,165,"Missouri","Platte County",5,10,1488,725,763
050,29,165,"Missouri","Platte County",5,11,1521,769,752
050,29,165,"Missouri","Platte County",5,12,1530,798,732
050,29,165,"Missouri","Platte County",5,13,1531,745,786
050,29,165,"Missouri","Platte County",5,14,1577,788,789
050,29,165,"Missouri","Platte County",5,15,1601,807,794
050,29,165,"Missouri","Platte County",5,16,1537,809,728
050,29,165,"Missouri","Platte County",5,17,1532,818,714
050,29,165,"Missouri","Platte County",5,18,1341,728,613
050,29,165,"Missouri","Platte County",5,19,1122,557,565
050,29,165,"Missouri","Platte County",5,20,1176,594,582
050,29,165,"Missouri","Platte County",5,21,1193,618,575
050,29,165,"Missouri","Platte County",5,22,1292,623,669
050,29,165,"Missouri","Platte County",5,23,1405,668,737
050,29,165,"Missouri","Platte County",5,24,1371,680,691
050,29,165,"Missouri","Platte County",5,25,1368,670,698
050,29,165,"Missouri","Platte County",5,26,1481,710,771
050,29,165,"Missouri","Platte County",5,27,1454,722,732
050,29,165,"Missouri","Platte County",5,28,1378,706,672
050,29,165,"Missouri","Platte County",5,29,1423,740,683
050,29,165,"Missouri","Platte County",5,30,1478,722,756
050,29,165,"Missouri","Platte County",5,31,1459,696,763
050,29,165,"Missouri","Platte County",5,32,1481,745,736
050,29,165,"Missouri","Platte County",5,33,1567,787,780
050,29,165,"Missouri","Platte County",5,34,1503,749,754
050,29,165,"Missouri","Platte County",5,35,1480,752,728
050,29,165,"Missouri","Platte County",5,36,1497,734,763
050,29,165,"Missouri","Platte County",5,37,1565,778,787
050,29,165,"Missouri","Platte County",5,38,1587,780,807
050,29,165,"Missouri","Platte County",5,39,1621,799,822
050,29,165,"Missouri","Platte County",5,40,1655,819,836
050,29,165,"Missouri","Platte County",5,41,1747,879,868
050,29,165,"Missouri","Platte County",5,42,1719,856,863
050,29,165,"Missouri","Platte County",5,43,1684,867,817
050,29,165,"Missouri","Platte County",5,44,1577,783,794
050,29,165,"Missouri","Platte County",5,45,1468,745,723
050,29,165,"Missouri","Platte County",5,46,1480,734,746
050,29,165,"Missouri","Platte County",5,47,1383,719,664
050,29,165,"Missouri","Platte County",5,48,1465,752,713
050,29,165,"Missouri","Platte County",5,49,1369,671,698
050,29,165,"Missouri","Platte County",5,50,1390,675,715
050,29,165,"Missouri","Platte County",5,51,1386,689,697
050,29,165,"Missouri","Platte County",5,52,1551,802,749
050,29,165,"Missouri","Platte County",5,53,1495,743,752
050,29,165,"Missouri","Platte County",5,54,1401,692,709
050,29,165,"Missouri","Platte County",5,55,1301,649,652
050,29,165,"Missouri","Platte County",5,56,1358,662,696
050,29,165,"Missouri","Platte County",5,57,1354,713,641
050,29,165,"Missouri","Platte County",5,58,1339,685,654
050,29,165,"Missouri","Platte County",5,59,1416,710,706
050,29,165,"Missouri","Platte County",5,60,1435,732,703
050,29,165,"Missouri","Platte County",5,61,1482,719,763
050,29,165,"Missouri","Platte County",5,62,1449,707,742
050,29,165,"Missouri","Platte County",5,63,1343,662,681
050,29,165,"Missouri","Platte County",5,64,1298,633,665
050,29,165,"Missouri","Platte County",5,65,1288,603,685
050,29,165,"Missouri","Platte County",5,66,1244,600,644
050,29,165,"Missouri","Platte County",5,67,1190,572,618
050,29,165,"Missouri","Platte County",5,68,1123,547,576
050,29,165,"Missouri","Platte County",5,69,1131,542,589
050,29,165,"Missouri","Platte County",5,70,1050,499,551
050,29,165,"Missouri","Platte County",5,71,989,467,522
050,29,165,"Missouri","Platte County",5,72,996,456,540
050,29,165,"Missouri","Platte County",5,73,934,423,511
050,29,165,"Missouri","Platte County",5,74,935,443,492
050,29,165,"Missouri","Platte County",5,75,889,407,482
050,29,165,"Missouri","Platte County",5,76,913,421,492
050,29,165,"Missouri","Platte County",5,77,606,267,339
050,29,165,"Missouri","Platte County",5,78,621,283,338
050,29,165,"Missouri","Platte County",5,79,630,290,340
050,29,165,"Missouri","Platte County",5,80,596,282,314
050,29,165,"Missouri","Platte County",5,81,514,245,269
050,29,165,"Missouri","Platte County",5,82,425,204,221
050,29,165,"Missouri","Platte County",5,83,368,156,212
050,29,165,"Missouri","Platte County",5,84,305,135,170
050,29,165,"Missouri","Platte County",5,85,1791,610,1181
050,29,167,"Missouri","Polk County",1,0,411,212,199
050,29,167,"Missouri","Polk County",1,1,420,219,201
050,29,167,"Missouri","Polk County",1,2,379,180,199
050,29,167,"Missouri","Polk County",1,3,382,193,189
050,29,167,"Missouri","Polk County",1,4,396,210,186
050,29,167,"Missouri","Polk County",1,5,402,197,205
050,29,167,"Missouri","Polk County",1,6,403,198,205
050,29,167,"Missouri","Polk County",1,7,361,183,178
050,29,167,"Missouri","Polk County",1,8,381,184,197
050,29,167,"Missouri","Polk County",1,9,390,196,194
050,29,167,"Missouri","Polk County",1,10,385,195,190
050,29,167,"Missouri","Polk County",1,11,416,209,207
050,29,167,"Missouri","Polk County",1,12,436,215,221
050,29,167,"Missouri","Polk County",1,13,451,229,222
050,29,167,"Missouri","Polk County",1,14,429,228,201
050,29,167,"Missouri","Polk County",1,15,424,221,203
050,29,167,"Missouri","Polk County",1,16,423,234,189
050,29,167,"Missouri","Polk County",1,17,425,230,195
050,29,167,"Missouri","Polk County",1,18,419,214,205
050,29,167,"Missouri","Polk County",1,19,571,252,319
050,29,167,"Missouri","Polk County",1,20,548,272,276
050,29,167,"Missouri","Polk County",1,21,514,234,280
050,29,167,"Missouri","Polk County",1,22,568,278,290
050,29,167,"Missouri","Polk County",1,23,482,224,258
050,29,167,"Missouri","Polk County",1,24,482,270,212
050,29,167,"Missouri","Polk County",1,25,404,198,206
050,29,167,"Missouri","Polk County",1,26,391,210,181
050,29,167,"Missouri","Polk County",1,27,375,200,175
050,29,167,"Missouri","Polk County",1,28,346,178,168
050,29,167,"Missouri","Polk County",1,29,369,198,171
050,29,167,"Missouri","Polk County",1,30,347,176,171
050,29,167,"Missouri","Polk County",1,31,360,180,180
050,29,167,"Missouri","Polk County",1,32,326,163,163
050,29,167,"Missouri","Polk County",1,33,332,172,160
050,29,167,"Missouri","Polk County",1,34,331,162,169
050,29,167,"Missouri","Polk County",1,35,341,170,171
050,29,167,"Missouri","Polk County",1,36,364,178,186
050,29,167,"Missouri","Polk County",1,37,404,210,194
050,29,167,"Missouri","Polk County",1,38,363,190,173
050,29,167,"Missouri","Polk County",1,39,355,177,178
050,29,167,"Missouri","Polk County",1,40,361,180,181
050,29,167,"Missouri","Polk County",1,41,333,166,167
050,29,167,"Missouri","Polk County",1,42,336,166,170
050,29,167,"Missouri","Polk County",1,43,321,165,156
050,29,167,"Missouri","Polk County",1,44,306,158,148
050,29,167,"Missouri","Polk County",1,45,336,183,153
050,29,167,"Missouri","Polk County",1,46,349,179,170
050,29,167,"Missouri","Polk County",1,47,343,165,178
050,29,167,"Missouri","Polk County",1,48,370,179,191
050,29,167,"Missouri","Polk County",1,49,427,212,215
050,29,167,"Missouri","Polk County",1,50,376,189,187
050,29,167,"Missouri","Polk County",1,51,350,193,157
050,29,167,"Missouri","Polk County",1,52,330,164,166
050,29,167,"Missouri","Polk County",1,53,348,176,172
050,29,167,"Missouri","Polk County",1,54,388,178,210
050,29,167,"Missouri","Polk County",1,55,427,206,221
050,29,167,"Missouri","Polk County",1,56,442,222,220
050,29,167,"Missouri","Polk County",1,57,444,228,216
050,29,167,"Missouri","Polk County",1,58,468,251,217
050,29,167,"Missouri","Polk County",1,59,443,233,210
050,29,167,"Missouri","Polk County",1,60,441,219,222
050,29,167,"Missouri","Polk County",1,61,412,199,213
050,29,167,"Missouri","Polk County",1,62,406,188,218
050,29,167,"Missouri","Polk County",1,63,393,188,205
050,29,167,"Missouri","Polk County",1,64,377,186,191
050,29,167,"Missouri","Polk County",1,65,341,161,180
050,29,167,"Missouri","Polk County",1,66,326,152,174
050,29,167,"Missouri","Polk County",1,67,360,177,183
050,29,167,"Missouri","Polk County",1,68,345,166,179
050,29,167,"Missouri","Polk County",1,69,318,160,158
050,29,167,"Missouri","Polk County",1,70,316,158,158
050,29,167,"Missouri","Polk County",1,71,298,145,153
050,29,167,"Missouri","Polk County",1,72,312,149,163
050,29,167,"Missouri","Polk County",1,73,321,157,164
050,29,167,"Missouri","Polk County",1,74,227,103,124
050,29,167,"Missouri","Polk County",1,75,246,115,131
050,29,167,"Missouri","Polk County",1,76,242,109,133
050,29,167,"Missouri","Polk County",1,77,232,106,126
050,29,167,"Missouri","Polk County",1,78,200,100,100
050,29,167,"Missouri","Polk County",1,79,199,105,94
050,29,167,"Missouri","Polk County",1,80,180,76,104
050,29,167,"Missouri","Polk County",1,81,151,66,85
050,29,167,"Missouri","Polk County",1,82,130,55,75
050,29,167,"Missouri","Polk County",1,83,129,51,78
050,29,167,"Missouri","Polk County",1,84,119,48,71
050,29,167,"Missouri","Polk County",1,85,699,225,474
050,29,167,"Missouri","Polk County",2,0,410,216,194
050,29,167,"Missouri","Polk County",2,1,414,214,200
050,29,167,"Missouri","Polk County",2,2,389,191,198
050,29,167,"Missouri","Polk County",2,3,380,190,190
050,29,167,"Missouri","Polk County",2,4,398,207,191
050,29,167,"Missouri","Polk County",2,5,402,199,203
050,29,167,"Missouri","Polk County",2,6,404,198,206
050,29,167,"Missouri","Polk County",2,7,375,188,187
050,29,167,"Missouri","Polk County",2,8,380,186,194
050,29,167,"Missouri","Polk County",2,9,388,193,195
050,29,167,"Missouri","Polk County",2,10,390,197,193
050,29,167,"Missouri","Polk County",2,11,410,206,204
050,29,167,"Missouri","Polk County",2,12,433,215,218
050,29,167,"Missouri","Polk County",2,13,445,226,219
050,29,167,"Missouri","Polk County",2,14,436,228,208
050,29,167,"Missouri","Polk County",2,15,423,222,201
050,29,167,"Missouri","Polk County",2,16,428,234,194
050,29,167,"Missouri","Polk County",2,17,424,230,194
050,29,167,"Missouri","Polk County",2,18,417,215,202
050,29,167,"Missouri","Polk County",2,19,572,253,319
050,29,167,"Missouri","Polk County",2,20,554,275,279
050,29,167,"Missouri","Polk County",2,21,512,233,279
050,29,167,"Missouri","Polk County",2,22,572,277,295
050,29,167,"Missouri","Polk County",2,23,481,224,257
050,29,167,"Missouri","Polk County",2,24,467,254,213
050,29,167,"Missouri","Polk County",2,25,410,206,204
050,29,167,"Missouri","Polk County",2,26,389,206,183
050,29,167,"Missouri","Polk County",2,27,379,201,178
050,29,167,"Missouri","Polk County",2,28,357,187,170
050,29,167,"Missouri","Polk County",2,29,370,197,173
050,29,167,"Missouri","Polk County",2,30,358,185,173
050,29,167,"Missouri","Polk County",2,31,359,180,179
050,29,167,"Missouri","Polk County",2,32,337,167,170
050,29,167,"Missouri","Polk County",2,33,332,171,161
050,29,167,"Missouri","Polk County",2,34,332,164,168
050,29,167,"Missouri","Polk County",2,35,341,169,172
050,29,167,"Missouri","Polk County",2,36,361,176,185
050,29,167,"Missouri","Polk County",2,37,392,201,191
050,29,167,"Missouri","Polk County",2,38,376,196,180
050,29,167,"Missouri","Polk County",2,39,357,180,177
050,29,167,"Missouri","Polk County",2,40,361,180,181
050,29,167,"Missouri","Polk County",2,41,343,171,172
050,29,167,"Missouri","Polk County",2,42,331,164,167
050,29,167,"Missouri","Polk County",2,43,329,168,161
050,29,167,"Missouri","Polk County",2,44,307,160,147
050,29,167,"Missouri","Polk County",2,45,330,177,153
050,29,167,"Missouri","Polk County",2,46,345,179,166
050,29,167,"Missouri","Polk County",2,47,342,168,174
050,29,167,"Missouri","Polk County",2,48,365,178,187
050,29,167,"Missouri","Polk County",2,49,414,206,208
050,29,167,"Missouri","Polk County",2,50,386,193,193
050,29,167,"Missouri","Polk County",2,51,356,193,163
050,29,167,"Missouri","Polk County",2,52,336,172,164
050,29,167,"Missouri","Polk County",2,53,340,171,169
050,29,167,"Missouri","Polk County",2,54,379,179,200
050,29,167,"Missouri","Polk County",2,55,420,201,219
050,29,167,"Missouri","Polk County",2,56,438,218,220
050,29,167,"Missouri","Polk County",2,57,443,226,217
050,29,167,"Missouri","Polk County",2,58,464,245,219
050,29,167,"Missouri","Polk County",2,59,454,240,214
050,29,167,"Missouri","Polk County",2,60,441,222,219
050,29,167,"Missouri","Polk County",2,61,413,201,212
050,29,167,"Missouri","Polk County",2,62,408,191,217
050,29,167,"Missouri","Polk County",2,63,398,189,209
050,29,167,"Missouri","Polk County",2,64,381,186,195
050,29,167,"Missouri","Polk County",2,65,349,166,183
050,29,167,"Missouri","Polk County",2,66,329,154,175
050,29,167,"Missouri","Polk County",2,67,351,170,181
050,29,167,"Missouri","Polk County",2,68,344,166,178
050,29,167,"Missouri","Polk County",2,69,326,163,163
050,29,167,"Missouri","Polk County",2,70,317,159,158
050,29,167,"Missouri","Polk County",2,71,303,148,155
050,29,167,"Missouri","Polk County",2,72,306,147,159
050,29,167,"Missouri","Polk County",2,73,335,162,173
050,29,167,"Missouri","Polk County",2,74,234,108,126
050,29,167,"Missouri","Polk County",2,75,242,111,131
050,29,167,"Missouri","Polk County",2,76,240,109,131
050,29,167,"Missouri","Polk County",2,77,241,110,131
050,29,167,"Missouri","Polk County",2,78,202,98,104
050,29,167,"Missouri","Polk County",2,79,199,104,95
050,29,167,"Missouri","Polk County",2,80,185,82,103
050,29,167,"Missouri","Polk County",2,81,152,68,84
050,29,167,"Missouri","Polk County",2,82,135,57,78
050,29,167,"Missouri","Polk County",2,83,128,52,76
050,29,167,"Missouri","Polk County",2,84,115,42,73
050,29,167,"Missouri","Polk County",2,85,706,227,479
050,29,167,"Missouri","Polk County",3,0,356,201,155
050,29,167,"Missouri","Polk County",3,1,440,233,207
050,29,167,"Missouri","Polk County",3,2,410,219,191
050,29,167,"Missouri","Polk County",3,3,407,204,203
050,29,167,"Missouri","Polk County",3,4,390,197,193
050,29,167,"Missouri","Polk County",3,5,407,216,191
050,29,167,"Missouri","Polk County",3,6,407,214,193
050,29,167,"Missouri","Polk County",3,7,412,195,217
050,29,167,"Missouri","Polk County",3,8,398,194,204
050,29,167,"Missouri","Polk County",3,9,390,184,206
050,29,167,"Missouri","Polk County",3,10,385,190,195
050,29,167,"Missouri","Polk County",3,11,388,192,196
050,29,167,"Missouri","Polk County",3,12,422,213,209
050,29,167,"Missouri","Polk County",3,13,444,219,225
050,29,167,"Missouri","Polk County",3,14,470,240,230
050,29,167,"Missouri","Polk County",3,15,437,238,199
050,29,167,"Missouri","Polk County",3,16,432,233,199
050,29,167,"Missouri","Polk County",3,17,415,227,188
050,29,167,"Missouri","Polk County",3,18,419,218,201
050,29,167,"Missouri","Polk County",3,19,579,267,312
050,29,167,"Missouri","Polk County",3,20,545,280,265
050,29,167,"Missouri","Polk County",3,21,506,228,278
050,29,167,"Missouri","Polk County",3,22,603,286,317
050,29,167,"Missouri","Polk County",3,23,489,217,272
050,29,167,"Missouri","Polk County",3,24,439,241,198
050,29,167,"Missouri","Polk County",3,25,436,233,203
050,29,167,"Missouri","Polk County",3,26,389,198,191
050,29,167,"Missouri","Polk County",3,27,384,194,190
050,29,167,"Missouri","Polk County",3,28,365,188,177
050,29,167,"Missouri","Polk County",3,29,343,191,152
050,29,167,"Missouri","Polk County",3,30,393,215,178
050,29,167,"Missouri","Polk County",3,31,361,178,183
050,29,167,"Missouri","Polk County",3,32,374,176,198
050,29,167,"Missouri","Polk County",3,33,356,173,183
050,29,167,"Missouri","Polk County",3,34,335,173,162
050,29,167,"Missouri","Polk County",3,35,350,176,174
050,29,167,"Missouri","Polk County",3,36,359,180,179
050,29,167,"Missouri","Polk County",3,37,363,177,186
050,29,167,"Missouri","Polk County",3,38,401,202,199
050,29,167,"Missouri","Polk County",3,39,382,198,184
050,29,167,"Missouri","Polk County",3,40,370,185,185
050,29,167,"Missouri","Polk County",3,41,375,188,187
050,29,167,"Missouri","Polk County",3,42,344,168,176
050,29,167,"Missouri","Polk County",3,43,342,177,165
050,29,167,"Missouri","Polk County",3,44,321,163,158
050,29,167,"Missouri","Polk County",3,45,305,155,150
050,29,167,"Missouri","Polk County",3,46,341,186,155
050,29,167,"Missouri","Polk County",3,47,349,178,171
050,29,167,"Missouri","Polk County",3,48,349,177,172
050,29,167,"Missouri","Polk County",3,49,364,181,183
050,29,167,"Missouri","Polk County",3,50,423,210,213
050,29,167,"Missouri","Polk County",3,51,387,194,193
050,29,167,"Missouri","Polk County",3,52,375,203,172
050,29,167,"Missouri","Polk County",3,53,334,170,164
050,29,167,"Missouri","Polk County",3,54,347,170,177
050,29,167,"Missouri","Polk County",3,55,397,186,211
050,29,167,"Missouri","Polk County",3,56,431,210,221
050,29,167,"Missouri","Polk County",3,57,448,216,232
050,29,167,"Missouri","Polk County",3,58,465,237,228
050,29,167,"Missouri","Polk County",3,59,464,244,220
050,29,167,"Missouri","Polk County",3,60,473,248,225
050,29,167,"Missouri","Polk County",3,61,437,219,218
050,29,167,"Missouri","Polk County",3,62,415,205,210
050,29,167,"Missouri","Polk County",3,63,410,188,222
050,29,167,"Missouri","Polk County",3,64,379,179,200
050,29,167,"Missouri","Polk County",3,65,372,177,195
050,29,167,"Missouri","Polk County",3,66,345,165,180
050,29,167,"Missouri","Polk County",3,67,343,155,188
050,29,167,"Missouri","Polk County",3,68,349,171,178
050,29,167,"Missouri","Polk County",3,69,327,160,167
050,29,167,"Missouri","Polk County",3,70,320,158,162
050,29,167,"Missouri","Polk County",3,71,305,156,149
050,29,167,"Missouri","Polk County",3,72,303,145,158
050,29,167,"Missouri","Polk County",3,73,297,144,153
050,29,167,"Missouri","Polk County",3,74,331,155,176
050,29,167,"Missouri","Polk County",3,75,230,103,127
050,29,167,"Missouri","Polk County",3,76,219,101,118
050,29,167,"Missouri","Polk County",3,77,230,106,124
050,29,167,"Missouri","Polk County",3,78,231,107,124
050,29,167,"Missouri","Polk County",3,79,188,96,92
050,29,167,"Missouri","Polk County",3,80,182,91,91
050,29,167,"Missouri","Polk County",3,81,166,72,94
050,29,167,"Missouri","Polk County",3,82,145,63,82
050,29,167,"Missouri","Polk County",3,83,126,53,73
050,29,167,"Missouri","Polk County",3,84,116,43,73
050,29,167,"Missouri","Polk County",3,85,691,216,475
050,29,167,"Missouri","Polk County",4,0,379,205,174
050,29,167,"Missouri","Polk County",4,1,377,206,171
050,29,167,"Missouri","Polk County",4,2,454,229,225
050,29,167,"Missouri","Polk County",4,3,422,218,204
050,29,167,"Missouri","Polk County",4,4,436,227,209
050,29,167,"Missouri","Polk County",4,5,402,211,191
050,29,167,"Missouri","Polk County",4,6,419,223,196
050,29,167,"Missouri","Polk County",4,7,413,206,207
050,29,167,"Missouri","Polk County",4,8,430,211,219
050,29,167,"Missouri","Polk County",4,9,408,194,214
050,29,167,"Missouri","Polk County",4,10,402,188,214
050,29,167,"Missouri","Polk County",4,11,394,203,191
050,29,167,"Missouri","Polk County",4,12,399,200,199
050,29,167,"Missouri","Polk County",4,13,434,222,212
050,29,167,"Missouri","Polk County",4,14,456,230,226
050,29,167,"Missouri","Polk County",4,15,482,249,233
050,29,167,"Missouri","Polk County",4,16,449,243,206
050,29,167,"Missouri","Polk County",4,17,438,244,194
050,29,167,"Missouri","Polk County",4,18,426,230,196
050,29,167,"Missouri","Polk County",4,19,561,259,302
050,29,167,"Missouri","Polk County",4,20,556,286,270
050,29,167,"Missouri","Polk County",4,21,486,221,265
050,29,167,"Missouri","Polk County",4,22,585,269,316
050,29,167,"Missouri","Polk County",4,23,532,254,278
050,29,167,"Missouri","Polk County",4,24,452,222,230
050,29,167,"Missouri","Polk County",4,25,425,224,201
050,29,167,"Missouri","Polk County",4,26,415,226,189
050,29,167,"Missouri","Polk County",4,27,395,202,193
050,29,167,"Missouri","Polk County",4,28,376,191,185
050,29,167,"Missouri","Polk County",4,29,386,209,177
050,29,167,"Missouri","Polk County",4,30,362,205,157
050,29,167,"Missouri","Polk County",4,31,406,225,181
050,29,167,"Missouri","Polk County",4,32,381,192,189
050,29,167,"Missouri","Polk County",4,33,388,189,199
050,29,167,"Missouri","Polk County",4,34,375,184,191
050,29,167,"Missouri","Polk County",4,35,356,184,172
050,29,167,"Missouri","Polk County",4,36,377,190,187
050,29,167,"Missouri","Polk County",4,37,363,190,173
050,29,167,"Missouri","Polk County",4,38,369,178,191
050,29,167,"Missouri","Polk County",4,39,403,200,203
050,29,167,"Missouri","Polk County",4,40,386,197,189
050,29,167,"Missouri","Polk County",4,41,383,186,197
050,29,167,"Missouri","Polk County",4,42,382,186,196
050,29,167,"Missouri","Polk County",4,43,361,170,191
050,29,167,"Missouri","Polk County",4,44,349,184,165
050,29,167,"Missouri","Polk County",4,45,332,165,167
050,29,167,"Missouri","Polk County",4,46,314,155,159
050,29,167,"Missouri","Polk County",4,47,325,176,149
050,29,167,"Missouri","Polk County",4,48,355,185,170
050,29,167,"Missouri","Polk County",4,49,351,176,175
050,29,167,"Missouri","Polk County",4,50,377,183,194
050,29,167,"Missouri","Polk County",4,51,414,208,206
050,29,167,"Missouri","Polk County",4,52,394,195,199
050,29,167,"Missouri","Polk County",4,53,366,198,168
050,29,167,"Missouri","Polk County",4,54,335,171,164
050,29,167,"Missouri","Polk County",4,55,353,172,181
050,29,167,"Missouri","Polk County",4,56,406,193,213
050,29,167,"Missouri","Polk County",4,57,440,220,220
050,29,167,"Missouri","Polk County",4,58,450,216,234
050,29,167,"Missouri","Polk County",4,59,466,237,229
050,29,167,"Missouri","Polk County",4,60,448,234,214
050,29,167,"Missouri","Polk County",4,61,469,240,229
050,29,167,"Missouri","Polk County",4,62,434,222,212
050,29,167,"Missouri","Polk County",4,63,403,196,207
050,29,167,"Missouri","Polk County",4,64,420,196,224
050,29,167,"Missouri","Polk County",4,65,376,176,200
050,29,167,"Missouri","Polk County",4,66,376,173,203
050,29,167,"Missouri","Polk County",4,67,356,168,188
050,29,167,"Missouri","Polk County",4,68,343,157,186
050,29,167,"Missouri","Polk County",4,69,334,171,163
050,29,167,"Missouri","Polk County",4,70,338,169,169
050,29,167,"Missouri","Polk County",4,71,295,146,149
050,29,167,"Missouri","Polk County",4,72,305,156,149
050,29,167,"Missouri","Polk County",4,73,293,144,149
050,29,167,"Missouri","Polk County",4,74,285,137,148
050,29,167,"Missouri","Polk County",4,75,336,155,181
050,29,167,"Missouri","Polk County",4,76,218,98,120
050,29,167,"Missouri","Polk County",4,77,210,96,114
050,29,167,"Missouri","Polk County",4,78,224,105,119
050,29,167,"Missouri","Polk County",4,79,227,109,118
050,29,167,"Missouri","Polk County",4,80,172,81,91
050,29,167,"Missouri","Polk County",4,81,172,87,85
050,29,167,"Missouri","Polk County",4,82,154,65,89
050,29,167,"Missouri","Polk County",4,83,144,66,78
050,29,167,"Missouri","Polk County",4,84,116,43,73
050,29,167,"Missouri","Polk County",4,85,703,224,479
050,29,167,"Missouri","Polk County",5,0,377,204,173
050,29,167,"Missouri","Polk County",5,1,384,204,180
050,29,167,"Missouri","Polk County",5,2,386,215,171
050,29,167,"Missouri","Polk County",5,3,462,232,230
050,29,167,"Missouri","Polk County",5,4,448,237,211
050,29,167,"Missouri","Polk County",5,5,423,217,206
050,29,167,"Missouri","Polk County",5,6,425,214,211
050,29,167,"Missouri","Polk County",5,7,418,209,209
050,29,167,"Missouri","Polk County",5,8,417,208,209
050,29,167,"Missouri","Polk County",5,9,434,216,218
050,29,167,"Missouri","Polk County",5,10,403,198,205
050,29,167,"Missouri","Polk County",5,11,411,194,217
050,29,167,"Missouri","Polk County",5,12,406,213,193
050,29,167,"Missouri","Polk County",5,13,408,200,208
050,29,167,"Missouri","Polk County",5,14,433,222,211
050,29,167,"Missouri","Polk County",5,15,455,231,224
050,29,167,"Missouri","Polk County",5,16,486,252,234
050,29,167,"Missouri","Polk County",5,17,430,230,200
050,29,167,"Missouri","Polk County",5,18,433,230,203
050,29,167,"Missouri","Polk County",5,19,564,265,299
050,29,167,"Missouri","Polk County",5,20,529,277,252
050,29,167,"Missouri","Polk County",5,21,488,230,258
050,29,167,"Missouri","Polk County",5,22,573,273,300
050,29,167,"Missouri","Polk County",5,23,496,230,266
050,29,167,"Missouri","Polk County",5,24,492,262,230
050,29,167,"Missouri","Polk County",5,25,395,187,208
050,29,167,"Missouri","Polk County",5,26,382,202,180
050,29,167,"Missouri","Polk County",5,27,405,217,188
050,29,167,"Missouri","Polk County",5,28,396,200,196
050,29,167,"Missouri","Polk County",5,29,385,193,192
050,29,167,"Missouri","Polk County",5,30,375,200,175
050,29,167,"Missouri","Polk County",5,31,362,208,154
050,29,167,"Missouri","Polk County",5,32,386,206,180
050,29,167,"Missouri","Polk County",5,33,388,195,193
050,29,167,"Missouri","Polk County",5,34,400,192,208
050,29,167,"Missouri","Polk County",5,35,386,188,198
050,29,167,"Missouri","Polk County",5,36,389,203,186
050,29,167,"Missouri","Polk County",5,37,381,193,188
050,29,167,"Missouri","Polk County",5,38,366,192,174
050,29,167,"Missouri","Polk County",5,39,375,177,198
050,29,167,"Missouri","Polk County",5,40,404,204,200
050,29,167,"Missouri","Polk County",5,41,384,195,189
050,29,167,"Missouri","Polk County",5,42,377,177,200
050,29,167,"Missouri","Polk County",5,43,386,191,195
050,29,167,"Missouri","Polk County",5,44,371,178,193
050,29,167,"Missouri","Polk County",5,45,345,186,159
050,29,167,"Missouri","Polk County",5,46,345,177,168
050,29,167,"Missouri","Polk County",5,47,315,155,160
050,29,167,"Missouri","Polk County",5,48,334,182,152
050,29,167,"Missouri","Polk County",5,49,347,182,165
050,29,167,"Missouri","Polk County",5,50,353,167,186
050,29,167,"Missouri","Polk County",5,51,372,173,199
050,29,167,"Missouri","Polk County",5,52,420,208,212
050,29,167,"Missouri","Polk County",5,53,379,191,188
050,29,167,"Missouri","Polk County",5,54,360,198,162
050,29,167,"Missouri","Polk County",5,55,339,173,166
050,29,167,"Missouri","Polk County",5,56,355,170,185
050,29,167,"Missouri","Polk County",5,57,396,189,207
050,29,167,"Missouri","Polk County",5,58,448,223,225
050,29,167,"Missouri","Polk County",5,59,448,214,234
050,29,167,"Missouri","Polk County",5,60,468,235,233
050,29,167,"Missouri","Polk County",5,61,452,231,221
050,29,167,"Missouri","Polk County",5,62,459,236,223
050,29,167,"Missouri","Polk County",5,63,436,222,214
050,29,167,"Missouri","Polk County",5,64,389,191,198
050,29,167,"Missouri","Polk County",5,65,417,191,226
050,29,167,"Missouri","Polk County",5,66,375,176,199
050,29,167,"Missouri","Polk County",5,67,384,169,215
050,29,167,"Missouri","Polk County",5,68,345,162,183
050,29,167,"Missouri","Polk County",5,69,338,154,184
050,29,167,"Missouri","Polk County",5,70,333,165,168
050,29,167,"Missouri","Polk County",5,71,324,166,158
050,29,167,"Missouri","Polk County",5,72,298,146,152
050,29,167,"Missouri","Polk County",5,73,299,156,143
050,29,167,"Missouri","Polk County",5,74,278,133,145
050,29,167,"Missouri","Polk County",5,75,290,136,154
050,29,167,"Missouri","Polk County",5,76,305,140,165
050,29,167,"Missouri","Polk County",5,77,211,98,113
050,29,167,"Missouri","Polk County",5,78,204,96,108
050,29,167,"Missouri","Polk County",5,79,207,103,104
050,29,167,"Missouri","Polk County",5,80,209,93,116
050,29,167,"Missouri","Polk County",5,81,162,80,82
050,29,167,"Missouri","Polk County",5,82,162,79,83
050,29,167,"Missouri","Polk County",5,83,148,66,82
050,29,167,"Missouri","Polk County",5,84,134,57,77
050,29,167,"Missouri","Polk County",5,85,723,231,492
050,29,169,"Missouri","Pulaski County",1,0,704,362,342
050,29,169,"Missouri","Pulaski County",1,1,714,393,321
050,29,169,"Missouri","Pulaski County",1,2,731,385,346
050,29,169,"Missouri","Pulaski County",1,3,732,383,349
050,29,169,"Missouri","Pulaski County",1,4,707,373,334
050,29,169,"Missouri","Pulaski County",1,5,697,345,352
050,29,169,"Missouri","Pulaski County",1,6,667,329,338
050,29,169,"Missouri","Pulaski County",1,7,670,335,335
050,29,169,"Missouri","Pulaski County",1,8,638,314,324
050,29,169,"Missouri","Pulaski County",1,9,678,354,324
050,29,169,"Missouri","Pulaski County",1,10,676,348,328
050,29,169,"Missouri","Pulaski County",1,11,645,341,304
050,29,169,"Missouri","Pulaski County",1,12,649,336,313
050,29,169,"Missouri","Pulaski County",1,13,615,308,307
050,29,169,"Missouri","Pulaski County",1,14,603,315,288
050,29,169,"Missouri","Pulaski County",1,15,568,296,272
050,29,169,"Missouri","Pulaski County",1,16,538,285,253
050,29,169,"Missouri","Pulaski County",1,17,580,322,258
050,29,169,"Missouri","Pulaski County",1,18,1630,1210,420
050,29,169,"Missouri","Pulaski County",1,19,2690,2121,569
050,29,169,"Missouri","Pulaski County",1,20,2181,1655,526
050,29,169,"Missouri","Pulaski County",1,21,1590,1163,427
050,29,169,"Missouri","Pulaski County",1,22,1370,973,397
050,29,169,"Missouri","Pulaski County",1,23,1194,797,397
050,29,169,"Missouri","Pulaski County",1,24,1064,687,377
050,29,169,"Missouri","Pulaski County",1,25,1037,631,406
050,29,169,"Missouri","Pulaski County",1,26,1077,658,419
050,29,169,"Missouri","Pulaski County",1,27,1061,634,427
050,29,169,"Missouri","Pulaski County",1,28,1011,583,428
050,29,169,"Missouri","Pulaski County",1,29,1005,561,444
050,29,169,"Missouri","Pulaski County",1,30,956,527,429
050,29,169,"Missouri","Pulaski County",1,31,929,487,442
050,29,169,"Missouri","Pulaski County",1,32,899,485,414
050,29,169,"Missouri","Pulaski County",1,33,870,483,387
050,29,169,"Missouri","Pulaski County",1,34,847,441,406
050,29,169,"Missouri","Pulaski County",1,35,844,480,364
050,29,169,"Missouri","Pulaski County",1,36,813,464,349
050,29,169,"Missouri","Pulaski County",1,37,768,432,336
050,29,169,"Missouri","Pulaski County",1,38,711,373,338
050,29,169,"Missouri","Pulaski County",1,39,708,374,334
050,29,169,"Missouri","Pulaski County",1,40,679,361,318
050,29,169,"Missouri","Pulaski County",1,41,602,333,269
050,29,169,"Missouri","Pulaski County",1,42,614,320,294
050,29,169,"Missouri","Pulaski County",1,43,542,267,275
050,29,169,"Missouri","Pulaski County",1,44,525,261,264
050,29,169,"Missouri","Pulaski County",1,45,480,246,234
050,29,169,"Missouri","Pulaski County",1,46,432,228,204
050,29,169,"Missouri","Pulaski County",1,47,440,218,222
050,29,169,"Missouri","Pulaski County",1,48,464,235,229
050,29,169,"Missouri","Pulaski County",1,49,502,251,251
050,29,169,"Missouri","Pulaski County",1,50,457,234,223
050,29,169,"Missouri","Pulaski County",1,51,433,216,217
050,29,169,"Missouri","Pulaski County",1,52,421,215,206
050,29,169,"Missouri","Pulaski County",1,53,437,207,230
050,29,169,"Missouri","Pulaski County",1,54,471,239,232
050,29,169,"Missouri","Pulaski County",1,55,490,250,240
050,29,169,"Missouri","Pulaski County",1,56,480,245,235
050,29,169,"Missouri","Pulaski County",1,57,465,225,240
050,29,169,"Missouri","Pulaski County",1,58,478,222,256
050,29,169,"Missouri","Pulaski County",1,59,467,202,265
050,29,169,"Missouri","Pulaski County",1,60,461,218,243
050,29,169,"Missouri","Pulaski County",1,61,420,211,209
050,29,169,"Missouri","Pulaski County",1,62,419,220,199
050,29,169,"Missouri","Pulaski County",1,63,412,218,194
050,29,169,"Missouri","Pulaski County",1,64,414,203,211
050,29,169,"Missouri","Pulaski County",1,65,381,188,193
050,29,169,"Missouri","Pulaski County",1,66,346,167,179
050,29,169,"Missouri","Pulaski County",1,67,338,150,188
050,29,169,"Missouri","Pulaski County",1,68,326,151,175
050,29,169,"Missouri","Pulaski County",1,69,279,133,146
050,29,169,"Missouri","Pulaski County",1,70,278,128,150
050,29,169,"Missouri","Pulaski County",1,71,261,128,133
050,29,169,"Missouri","Pulaski County",1,72,302,157,145
050,29,169,"Missouri","Pulaski County",1,73,283,137,146
050,29,169,"Missouri","Pulaski County",1,74,191,90,101
050,29,169,"Missouri","Pulaski County",1,75,194,94,100
050,29,169,"Missouri","Pulaski County",1,76,185,89,96
050,29,169,"Missouri","Pulaski County",1,77,189,83,106
050,29,169,"Missouri","Pulaski County",1,78,160,69,91
050,29,169,"Missouri","Pulaski County",1,79,151,61,90
050,29,169,"Missouri","Pulaski County",1,80,113,46,67
050,29,169,"Missouri","Pulaski County",1,81,114,48,66
050,29,169,"Missouri","Pulaski County",1,82,108,42,66
050,29,169,"Missouri","Pulaski County",1,83,114,55,59
050,29,169,"Missouri","Pulaski County",1,84,97,44,53
050,29,169,"Missouri","Pulaski County",1,85,478,175,303
050,29,169,"Missouri","Pulaski County",2,0,706,371,335
050,29,169,"Missouri","Pulaski County",2,1,708,386,322
050,29,169,"Missouri","Pulaski County",2,2,732,392,340
050,29,169,"Missouri","Pulaski County",2,3,730,387,343
050,29,169,"Missouri","Pulaski County",2,4,717,375,342
050,29,169,"Missouri","Pulaski County",2,5,696,348,348
050,29,169,"Missouri","Pulaski County",2,6,673,332,341
050,29,169,"Missouri","Pulaski County",2,7,664,330,334
050,29,169,"Missouri","Pulaski County",2,8,645,317,328
050,29,169,"Missouri","Pulaski County",2,9,664,341,323
050,29,169,"Missouri","Pulaski County",2,10,670,346,324
050,29,169,"Missouri","Pulaski County",2,11,646,339,307
050,29,169,"Missouri","Pulaski County",2,12,642,333,309
050,29,169,"Missouri","Pulaski County",2,13,616,312,304
050,29,169,"Missouri","Pulaski County",2,14,599,311,288
050,29,169,"Missouri","Pulaski County",2,15,574,302,272
050,29,169,"Missouri","Pulaski County",2,16,539,283,256
050,29,169,"Missouri","Pulaski County",2,17,583,326,257
050,29,169,"Missouri","Pulaski County",2,18,1645,1217,428
050,29,169,"Missouri","Pulaski County",2,19,2700,2126,574
050,29,169,"Missouri","Pulaski County",2,20,2170,1645,525
050,29,169,"Missouri","Pulaski County",2,21,1592,1163,429
050,29,169,"Missouri","Pulaski County",2,22,1365,967,398
050,29,169,"Missouri","Pulaski County",2,23,1197,800,397
050,29,169,"Missouri","Pulaski County",2,24,1066,685,381
050,29,169,"Missouri","Pulaski County",2,25,1043,638,405
050,29,169,"Missouri","Pulaski County",2,26,1081,658,423
050,29,169,"Missouri","Pulaski County",2,27,1043,621,422
050,29,169,"Missouri","Pulaski County",2,28,1022,593,429
050,29,169,"Missouri","Pulaski County",2,29,1000,563,437
050,29,169,"Missouri","Pulaski County",2,30,964,529,435
050,29,169,"Missouri","Pulaski County",2,31,936,493,443
050,29,169,"Missouri","Pulaski County",2,32,894,481,413
050,29,169,"Missouri","Pulaski County",2,33,871,479,392
050,29,169,"Missouri","Pulaski County",2,34,838,444,394
050,29,169,"Missouri","Pulaski County",2,35,835,465,370
050,29,169,"Missouri","Pulaski County",2,36,804,460,344
050,29,169,"Missouri","Pulaski County",2,37,765,430,335
050,29,169,"Missouri","Pulaski County",2,38,723,384,339
050,29,169,"Missouri","Pulaski County",2,39,698,366,332
050,29,169,"Missouri","Pulaski County",2,40,691,368,323
050,29,169,"Missouri","Pulaski County",2,41,621,339,282
050,29,169,"Missouri","Pulaski County",2,42,607,320,287
050,29,169,"Missouri","Pulaski County",2,43,554,275,279
050,29,169,"Missouri","Pulaski County",2,44,518,257,261
050,29,169,"Missouri","Pulaski County",2,45,493,248,245
050,29,169,"Missouri","Pulaski County",2,46,437,228,209
050,29,169,"Missouri","Pulaski County",2,47,434,218,216
050,29,169,"Missouri","Pulaski County",2,48,457,230,227
050,29,169,"Missouri","Pulaski County",2,49,487,245,242
050,29,169,"Missouri","Pulaski County",2,50,469,239,230
050,29,169,"Missouri","Pulaski County",2,51,433,218,215
050,29,169,"Missouri","Pulaski County",2,52,421,213,208
050,29,169,"Missouri","Pulaski County",2,53,435,211,224
050,29,169,"Missouri","Pulaski County",2,54,460,228,232
050,29,169,"Missouri","Pulaski County",2,55,481,245,236
050,29,169,"Missouri","Pulaski County",2,56,485,247,238
050,29,169,"Missouri","Pulaski County",2,57,473,232,241
050,29,169,"Missouri","Pulaski County",2,58,474,223,251
050,29,169,"Missouri","Pulaski County",2,59,471,206,265
050,29,169,"Missouri","Pulaski County",2,60,458,212,246
050,29,169,"Missouri","Pulaski County",2,61,429,213,216
050,29,169,"Missouri","Pulaski County",2,62,419,222,197
050,29,169,"Missouri","Pulaski County",2,63,417,220,197
050,29,169,"Missouri","Pulaski County",2,64,407,203,204
050,29,169,"Missouri","Pulaski County",2,65,388,190,198
050,29,169,"Missouri","Pulaski County",2,66,357,174,183
050,29,169,"Missouri","Pulaski County",2,67,340,155,185
050,29,169,"Missouri","Pulaski County",2,68,323,147,176
050,29,169,"Missouri","Pulaski County",2,69,290,136,154
050,29,169,"Missouri","Pulaski County",2,70,277,128,149
050,29,169,"Missouri","Pulaski County",2,71,263,126,137
050,29,169,"Missouri","Pulaski County",2,72,287,147,140
050,29,169,"Missouri","Pulaski County",2,73,300,148,152
050,29,169,"Missouri","Pulaski County",2,74,200,96,104
050,29,169,"Missouri","Pulaski County",2,75,194,93,101
050,29,169,"Missouri","Pulaski County",2,76,187,89,98
050,29,169,"Missouri","Pulaski County",2,77,188,85,103
050,29,169,"Missouri","Pulaski County",2,78,158,68,90
050,29,169,"Missouri","Pulaski County",2,79,147,61,86
050,29,169,"Missouri","Pulaski County",2,80,122,49,73
050,29,169,"Missouri","Pulaski County",2,81,112,46,66
050,29,169,"Missouri","Pulaski County",2,82,108,39,69
050,29,169,"Missouri","Pulaski County",2,83,108,51,57
050,29,169,"Missouri","Pulaski County",2,84,98,44,54
050,29,169,"Missouri","Pulaski County",2,85,476,178,298
050,29,169,"Missouri","Pulaski County",3,0,679,358,321
050,29,169,"Missouri","Pulaski County",3,1,756,393,363
050,29,169,"Missouri","Pulaski County",3,2,705,388,317
050,29,169,"Missouri","Pulaski County",3,3,747,406,341
050,29,169,"Missouri","Pulaski County",3,4,678,364,314
050,29,169,"Missouri","Pulaski County",3,5,706,364,342
050,29,169,"Missouri","Pulaski County",3,6,679,334,345
050,29,169,"Missouri","Pulaski County",3,7,686,347,339
050,29,169,"Missouri","Pulaski County",3,8,671,330,341
050,29,169,"Missouri","Pulaski County",3,9,633,322,311
050,29,169,"Missouri","Pulaski County",3,10,649,346,303
050,29,169,"Missouri","Pulaski County",3,11,687,361,326
050,29,169,"Missouri","Pulaski County",3,12,602,320,282
050,29,169,"Missouri","Pulaski County",3,13,654,342,312
050,29,169,"Missouri","Pulaski County",3,14,607,315,292
050,29,169,"Missouri","Pulaski County",3,15,568,308,260
050,29,169,"Missouri","Pulaski County",3,16,570,309,261
050,29,169,"Missouri","Pulaski County",3,17,570,322,248
050,29,169,"Missouri","Pulaski County",3,18,1624,1208,416
050,29,169,"Missouri","Pulaski County",3,19,2717,2153,564
050,29,169,"Missouri","Pulaski County",3,20,2170,1648,522
050,29,169,"Missouri","Pulaski County",3,21,1570,1153,417
050,29,169,"Missouri","Pulaski County",3,22,1332,965,367
050,29,169,"Missouri","Pulaski County",3,23,1187,792,395
050,29,169,"Missouri","Pulaski County",3,24,1037,654,383
050,29,169,"Missouri","Pulaski County",3,25,945,586,359
050,29,169,"Missouri","Pulaski County",3,26,1027,630,397
050,29,169,"Missouri","Pulaski County",3,27,1009,582,427
050,29,169,"Missouri","Pulaski County",3,28,949,546,403
050,29,169,"Missouri","Pulaski County",3,29,923,522,401
050,29,169,"Missouri","Pulaski County",3,30,954,521,433
050,29,169,"Missouri","Pulaski County",3,31,976,521,455
050,29,169,"Missouri","Pulaski County",3,32,924,500,424
050,29,169,"Missouri","Pulaski County",3,33,924,503,421
050,29,169,"Missouri","Pulaski County",3,34,847,457,390
050,29,169,"Missouri","Pulaski County",3,35,805,433,372
050,29,169,"Missouri","Pulaski County",3,36,841,469,372
050,29,169,"Missouri","Pulaski County",3,37,743,424,319
050,29,169,"Missouri","Pulaski County",3,38,726,410,316
050,29,169,"Missouri","Pulaski County",3,39,681,358,323
050,29,169,"Missouri","Pulaski County",3,40,665,352,313
050,29,169,"Missouri","Pulaski County",3,41,662,356,306
050,29,169,"Missouri","Pulaski County",3,42,579,316,263
050,29,169,"Missouri","Pulaski County",3,43,570,303,267
050,29,169,"Missouri","Pulaski County",3,44,550,276,274
050,29,169,"Missouri","Pulaski County",3,45,504,248,256
050,29,169,"Missouri","Pulaski County",3,46,482,234,248
050,29,169,"Missouri","Pulaski County",3,47,448,238,210
050,29,169,"Missouri","Pulaski County",3,48,431,214,217
050,29,169,"Missouri","Pulaski County",3,49,445,233,212
050,29,169,"Missouri","Pulaski County",3,50,490,243,247
050,29,169,"Missouri","Pulaski County",3,51,446,226,220
050,29,169,"Missouri","Pulaski County",3,52,411,205,206
050,29,169,"Missouri","Pulaski County",3,53,420,209,211
050,29,169,"Missouri","Pulaski County",3,54,437,210,227
050,29,169,"Missouri","Pulaski County",3,55,462,230,232
050,29,169,"Missouri","Pulaski County",3,56,474,243,231
050,29,169,"Missouri","Pulaski County",3,57,478,240,238
050,29,169,"Missouri","Pulaski County",3,58,468,229,239
050,29,169,"Missouri","Pulaski County",3,59,475,220,255
050,29,169,"Missouri","Pulaski County",3,60,466,209,257
050,29,169,"Missouri","Pulaski County",3,61,445,204,241
050,29,169,"Missouri","Pulaski County",3,62,420,209,211
050,29,169,"Missouri","Pulaski County",3,63,421,220,201
050,29,169,"Missouri","Pulaski County",3,64,396,204,192
050,29,169,"Missouri","Pulaski County",3,65,392,194,198
050,29,169,"Missouri","Pulaski County",3,66,388,189,199
050,29,169,"Missouri","Pulaski County",3,67,348,167,181
050,29,169,"Missouri","Pulaski County",3,68,332,151,181
050,29,169,"Missouri","Pulaski County",3,69,309,139,170
050,29,169,"Missouri","Pulaski County",3,70,278,131,147
050,29,169,"Missouri","Pulaski County",3,71,266,123,143
050,29,169,"Missouri","Pulaski County",3,72,252,117,135
050,29,169,"Missouri","Pulaski County",3,73,268,138,130
050,29,169,"Missouri","Pulaski County",3,74,293,147,146
050,29,169,"Missouri","Pulaski County",3,75,183,87,96
050,29,169,"Missouri","Pulaski County",3,76,180,81,99
050,29,169,"Missouri","Pulaski County",3,77,168,78,90
050,29,169,"Missouri","Pulaski County",3,78,165,75,90
050,29,169,"Missouri","Pulaski County",3,79,149,64,85
050,29,169,"Missouri","Pulaski County",3,80,138,59,79
050,29,169,"Missouri","Pulaski County",3,81,105,41,64
050,29,169,"Missouri","Pulaski County",3,82,109,41,68
050,29,169,"Missouri","Pulaski County",3,83,99,40,59
050,29,169,"Missouri","Pulaski County",3,84,103,49,54
050,29,169,"Missouri","Pulaski County",3,85,487,187,300
050,29,169,"Missouri","Pulaski County",4,0,698,329,369
050,29,169,"Missouri","Pulaski County",4,1,665,368,297
050,29,169,"Missouri","Pulaski County",4,2,749,394,355
050,29,169,"Missouri","Pulaski County",4,3,684,370,314
050,29,169,"Missouri","Pulaski County",4,4,715,394,321
050,29,169,"Missouri","Pulaski County",4,5,687,352,335
050,29,169,"Missouri","Pulaski County",4,6,632,325,307
050,29,169,"Missouri","Pulaski County",4,7,714,352,362
050,29,169,"Missouri","Pulaski County",4,8,684,341,343
050,29,169,"Missouri","Pulaski County",4,9,633,305,328
050,29,169,"Missouri","Pulaski County",4,10,615,316,299
050,29,169,"Missouri","Pulaski County",4,11,641,345,296
050,29,169,"Missouri","Pulaski County",4,12,674,361,313
050,29,169,"Missouri","Pulaski County",4,13,587,320,267
050,29,169,"Missouri","Pulaski County",4,14,635,323,312
050,29,169,"Missouri","Pulaski County",4,15,621,333,288
050,29,169,"Missouri","Pulaski County",4,16,562,311,251
050,29,169,"Missouri","Pulaski County",4,17,630,363,267
050,29,169,"Missouri","Pulaski County",4,18,1603,1190,413
050,29,169,"Missouri","Pulaski County",4,19,2661,2099,562
050,29,169,"Missouri","Pulaski County",4,20,2155,1633,522
050,29,169,"Missouri","Pulaski County",4,21,1567,1158,409
050,29,169,"Missouri","Pulaski County",4,22,1338,960,378
050,29,169,"Missouri","Pulaski County",4,23,1176,798,378
050,29,169,"Missouri","Pulaski County",4,24,1021,641,380
050,29,169,"Missouri","Pulaski County",4,25,953,579,374
050,29,169,"Missouri","Pulaski County",4,26,926,557,369
050,29,169,"Missouri","Pulaski County",4,27,1001,588,413
050,29,169,"Missouri","Pulaski County",4,28,994,578,416
050,29,169,"Missouri","Pulaski County",4,29,875,502,373
050,29,169,"Missouri","Pulaski County",4,30,875,495,380
050,29,169,"Missouri","Pulaski County",4,31,942,503,439
050,29,169,"Missouri","Pulaski County",4,32,939,509,430
050,29,169,"Missouri","Pulaski County",4,33,914,498,416
050,29,169,"Missouri","Pulaski County",4,34,857,478,379
050,29,169,"Missouri","Pulaski County",4,35,824,434,390
050,29,169,"Missouri","Pulaski County",4,36,802,426,376
050,29,169,"Missouri","Pulaski County",4,37,772,419,353
050,29,169,"Missouri","Pulaski County",4,38,754,424,330
050,29,169,"Missouri","Pulaski County",4,39,721,404,317
050,29,169,"Missouri","Pulaski County",4,40,699,377,322
050,29,169,"Missouri","Pulaski County",4,41,634,327,307
050,29,169,"Missouri","Pulaski County",4,42,631,329,302
050,29,169,"Missouri","Pulaski County",4,43,564,303,261
050,29,169,"Missouri","Pulaski County",4,44,561,297,264
050,29,169,"Missouri","Pulaski County",4,45,529,262,267
050,29,169,"Missouri","Pulaski County",4,46,497,247,250
050,29,169,"Missouri","Pulaski County",4,47,475,236,239
050,29,169,"Missouri","Pulaski County",4,48,443,236,207
050,29,169,"Missouri","Pulaski County",4,49,416,200,216
050,29,169,"Missouri","Pulaski County",4,50,452,239,213
050,29,169,"Missouri","Pulaski County",4,51,468,227,241
050,29,169,"Missouri","Pulaski County",4,52,447,221,226
050,29,169,"Missouri","Pulaski County",4,53,417,207,210
050,29,169,"Missouri","Pulaski County",4,54,427,223,204
050,29,169,"Missouri","Pulaski County",4,55,430,206,224
050,29,169,"Missouri","Pulaski County",4,56,454,228,226
050,29,169,"Missouri","Pulaski County",4,57,471,239,232
050,29,169,"Missouri","Pulaski County",4,58,480,247,233
050,29,169,"Missouri","Pulaski County",4,59,456,219,237
050,29,169,"Missouri","Pulaski County",4,60,458,214,244
050,29,169,"Missouri","Pulaski County",4,61,459,205,254
050,29,169,"Missouri","Pulaski County",4,62,449,206,243
050,29,169,"Missouri","Pulaski County",4,63,415,201,214
050,29,169,"Missouri","Pulaski County",4,64,409,216,193
050,29,169,"Missouri","Pulaski County",4,65,389,197,192
050,29,169,"Missouri","Pulaski County",4,66,386,196,190
050,29,169,"Missouri","Pulaski County",4,67,384,188,196
050,29,169,"Missouri","Pulaski County",4,68,335,167,168
050,29,169,"Missouri","Pulaski County",4,69,330,151,179
050,29,169,"Missouri","Pulaski County",4,70,309,141,168
050,29,169,"Missouri","Pulaski County",4,71,274,122,152
050,29,169,"Missouri","Pulaski County",4,72,259,118,141
050,29,169,"Missouri","Pulaski County",4,73,243,112,131
050,29,169,"Missouri","Pulaski County",4,74,260,132,128
050,29,169,"Missouri","Pulaski County",4,75,284,141,143
050,29,169,"Missouri","Pulaski County",4,76,187,85,102
050,29,169,"Missouri","Pulaski County",4,77,160,72,88
050,29,169,"Missouri","Pulaski County",4,78,153,71,82
050,29,169,"Missouri","Pulaski County",4,79,156,70,86
050,29,169,"Missouri","Pulaski County",4,80,148,64,84
050,29,169,"Missouri","Pulaski County",4,81,131,56,75
050,29,169,"Missouri","Pulaski County",4,82,108,39,69
050,29,169,"Missouri","Pulaski County",4,83,91,38,53
050,29,169,"Missouri","Pulaski County",4,84,91,38,53
050,29,169,"Missouri","Pulaski County",4,85,495,194,301
050,29,169,"Missouri","Pulaski County",5,0,693,329,364
050,29,169,"Missouri","Pulaski County",5,1,683,335,348
050,29,169,"Missouri","Pulaski County",5,2,630,338,292
050,29,169,"Missouri","Pulaski County",5,3,724,380,344
050,29,169,"Missouri","Pulaski County",5,4,646,344,302
050,29,169,"Missouri","Pulaski County",5,5,728,397,331
050,29,169,"Missouri","Pulaski County",5,6,665,349,316
050,29,169,"Missouri","Pulaski County",5,7,668,340,328
050,29,169,"Missouri","Pulaski County",5,8,697,355,342
050,29,169,"Missouri","Pulaski County",5,9,664,324,340
050,29,169,"Missouri","Pulaski County",5,10,618,311,307
050,29,169,"Missouri","Pulaski County",5,11,613,314,299
050,29,169,"Missouri","Pulaski County",5,12,631,336,295
050,29,169,"Missouri","Pulaski County",5,13,668,354,314
050,29,169,"Missouri","Pulaski County",5,14,571,305,266
050,29,169,"Missouri","Pulaski County",5,15,620,326,294
050,29,169,"Missouri","Pulaski County",5,16,613,331,282
050,29,169,"Missouri","Pulaski County",5,17,614,362,252
050,29,169,"Missouri","Pulaski County",5,18,1622,1203,419
050,29,169,"Missouri","Pulaski County",5,19,2629,2080,549
050,29,169,"Missouri","Pulaski County",5,20,2122,1626,496
050,29,169,"Missouri","Pulaski County",5,21,1589,1171,418
050,29,169,"Missouri","Pulaski County",5,22,1330,955,375
050,29,169,"Missouri","Pulaski County",5,23,1207,813,394
050,29,169,"Missouri","Pulaski County",5,24,1015,640,375
050,29,169,"Missouri","Pulaski County",5,25,957,581,376
050,29,169,"Missouri","Pulaski County",5,26,941,576,365
050,29,169,"Missouri","Pulaski County",5,27,862,514,348
050,29,169,"Missouri","Pulaski County",5,28,959,536,423
050,29,169,"Missouri","Pulaski County",5,29,886,503,383
050,29,169,"Missouri","Pulaski County",5,30,869,489,380
050,29,169,"Missouri","Pulaski County",5,31,895,498,397
050,29,169,"Missouri","Pulaski County",5,32,901,490,411
050,29,169,"Missouri","Pulaski County",5,33,909,493,416
050,29,169,"Missouri","Pulaski County",5,34,846,451,395
050,29,169,"Missouri","Pulaski County",5,35,840,484,356
050,29,169,"Missouri","Pulaski County",5,36,819,436,383
050,29,169,"Missouri","Pulaski County",5,37,761,400,361
050,29,169,"Missouri","Pulaski County",5,38,782,415,367
050,29,169,"Missouri","Pulaski County",5,39,755,427,328
050,29,169,"Missouri","Pulaski County",5,40,713,402,311
050,29,169,"Missouri","Pulaski County",5,41,666,360,306
050,29,169,"Missouri","Pulaski County",5,42,644,336,308
050,29,169,"Missouri","Pulaski County",5,43,609,310,299
050,29,169,"Missouri","Pulaski County",5,44,515,268,247
050,29,169,"Missouri","Pulaski County",5,45,554,291,263
050,29,169,"Missouri","Pulaski County",5,46,524,245,279
050,29,169,"Missouri","Pulaski County",5,47,506,257,249
050,29,169,"Missouri","Pulaski County",5,48,470,226,244
050,29,169,"Missouri","Pulaski County",5,49,443,239,204
050,29,169,"Missouri","Pulaski County",5,50,395,193,202
050,29,169,"Missouri","Pulaski County",5,51,445,236,209
050,29,169,"Missouri","Pulaski County",5,52,452,212,240
050,29,169,"Missouri","Pulaski County",5,53,445,224,221
050,29,169,"Missouri","Pulaski County",5,54,407,201,206
050,29,169,"Missouri","Pulaski County",5,55,427,219,208
050,29,169,"Missouri","Pulaski County",5,56,418,203,215
050,29,169,"Missouri","Pulaski County",5,57,444,226,218
050,29,169,"Missouri","Pulaski County",5,58,450,238,212
050,29,169,"Missouri","Pulaski County",5,59,469,241,228
050,29,169,"Missouri","Pulaski County",5,60,445,211,234
050,29,169,"Missouri","Pulaski County",5,61,466,221,245
050,29,169,"Missouri","Pulaski County",5,62,449,203,246
050,29,169,"Missouri","Pulaski County",5,63,433,185,248
050,29,169,"Missouri","Pulaski County",5,64,430,212,218
050,29,169,"Missouri","Pulaski County",5,65,407,207,200
050,29,169,"Missouri","Pulaski County",5,66,389,199,190
050,29,169,"Missouri","Pulaski County",5,67,375,194,181
050,29,169,"Missouri","Pulaski County",5,68,375,182,193
050,29,169,"Missouri","Pulaski County",5,69,326,165,161
050,29,169,"Missouri","Pulaski County",5,70,327,150,177
050,29,169,"Missouri","Pulaski County",5,71,301,134,167
050,29,169,"Missouri","Pulaski County",5,72,272,123,149
050,29,169,"Missouri","Pulaski County",5,73,248,113,135
050,29,169,"Missouri","Pulaski County",5,74,242,112,130
050,29,169,"Missouri","Pulaski County",5,75,245,123,122
050,29,169,"Missouri","Pulaski County",5,76,280,134,146
050,29,169,"Missouri","Pulaski County",5,77,169,73,96
050,29,169,"Missouri","Pulaski County",5,78,153,73,80
050,29,169,"Missouri","Pulaski County",5,79,147,67,80
050,29,169,"Missouri","Pulaski County",5,80,148,65,83
050,29,169,"Missouri","Pulaski County",5,81,137,60,77
050,29,169,"Missouri","Pulaski County",5,82,128,51,77
050,29,169,"Missouri","Pulaski County",5,83,98,37,61
050,29,169,"Missouri","Pulaski County",5,84,83,35,48
050,29,169,"Missouri","Pulaski County",5,85,501,193,308
050,29,171,"Missouri","Putnam County",1,0,52,27,25
050,29,171,"Missouri","Putnam County",1,1,64,33,31
050,29,171,"Missouri","Putnam County",1,2,67,37,30
050,29,171,"Missouri","Putnam County",1,3,67,32,35
050,29,171,"Missouri","Putnam County",1,4,51,26,25
050,29,171,"Missouri","Putnam County",1,5,60,34,26
050,29,171,"Missouri","Putnam County",1,6,63,32,31
050,29,171,"Missouri","Putnam County",1,7,60,34,26
050,29,171,"Missouri","Putnam County",1,8,52,27,25
050,29,171,"Missouri","Putnam County",1,9,53,30,23
050,29,171,"Missouri","Putnam County",1,10,62,30,32
050,29,171,"Missouri","Putnam County",1,11,49,30,19
050,29,171,"Missouri","Putnam County",1,12,61,34,27
050,29,171,"Missouri","Putnam County",1,13,57,34,23
050,29,171,"Missouri","Putnam County",1,14,71,39,32
050,29,171,"Missouri","Putnam County",1,15,62,33,29
050,29,171,"Missouri","Putnam County",1,16,58,28,30
050,29,171,"Missouri","Putnam County",1,17,58,27,31
050,29,171,"Missouri","Putnam County",1,18,54,25,29
050,29,171,"Missouri","Putnam County",1,19,46,23,23
050,29,171,"Missouri","Putnam County",1,20,50,26,24
050,29,171,"Missouri","Putnam County",1,21,45,25,20
050,29,171,"Missouri","Putnam County",1,22,38,21,17
050,29,171,"Missouri","Putnam County",1,23,30,19,11
050,29,171,"Missouri","Putnam County",1,24,40,22,18
050,29,171,"Missouri","Putnam County",1,25,37,18,19
050,29,171,"Missouri","Putnam County",1,26,44,19,25
050,29,171,"Missouri","Putnam County",1,27,49,25,24
050,29,171,"Missouri","Putnam County",1,28,59,29,30
050,29,171,"Missouri","Putnam County",1,29,56,31,25
050,29,171,"Missouri","Putnam County",1,30,41,22,19
050,29,171,"Missouri","Putnam County",1,31,50,22,28
050,29,171,"Missouri","Putnam County",1,32,48,23,25
050,29,171,"Missouri","Putnam County",1,33,50,25,25
050,29,171,"Missouri","Putnam County",1,34,43,22,21
050,29,171,"Missouri","Putnam County",1,35,49,28,21
050,29,171,"Missouri","Putnam County",1,36,50,25,25
050,29,171,"Missouri","Putnam County",1,37,43,21,22
050,29,171,"Missouri","Putnam County",1,38,51,27,24
050,29,171,"Missouri","Putnam County",1,39,50,27,23
050,29,171,"Missouri","Putnam County",1,40,53,28,25
050,29,171,"Missouri","Putnam County",1,41,51,26,25
050,29,171,"Missouri","Putnam County",1,42,48,25,23
050,29,171,"Missouri","Putnam County",1,43,47,27,20
050,29,171,"Missouri","Putnam County",1,44,45,23,22
050,29,171,"Missouri","Putnam County",1,45,51,28,23
050,29,171,"Missouri","Putnam County",1,46,47,24,23
050,29,171,"Missouri","Putnam County",1,47,39,20,19
050,29,171,"Missouri","Putnam County",1,48,56,26,30
050,29,171,"Missouri","Putnam County",1,49,63,30,33
050,29,171,"Missouri","Putnam County",1,50,60,31,29
050,29,171,"Missouri","Putnam County",1,51,55,32,23
050,29,171,"Missouri","Putnam County",1,52,59,33,26
050,29,171,"Missouri","Putnam County",1,53,50,30,20
050,29,171,"Missouri","Putnam County",1,54,53,27,26
050,29,171,"Missouri","Putnam County",1,55,68,36,32
050,29,171,"Missouri","Putnam County",1,56,68,38,30
050,29,171,"Missouri","Putnam County",1,57,68,36,32
050,29,171,"Missouri","Putnam County",1,58,79,37,42
050,29,171,"Missouri","Putnam County",1,59,67,39,28
050,29,171,"Missouri","Putnam County",1,60,67,41,26
050,29,171,"Missouri","Putnam County",1,61,68,35,33
050,29,171,"Missouri","Putnam County",1,62,65,27,38
050,29,171,"Missouri","Putnam County",1,63,68,34,34
050,29,171,"Missouri","Putnam County",1,64,66,32,34
050,29,171,"Missouri","Putnam County",1,65,70,32,38
050,29,171,"Missouri","Putnam County",1,66,72,37,35
050,29,171,"Missouri","Putnam County",1,67,75,38,37
050,29,171,"Missouri","Putnam County",1,68,67,29,38
050,29,171,"Missouri","Putnam County",1,69,58,30,28
050,29,171,"Missouri","Putnam County",1,70,66,34,32
050,29,171,"Missouri","Putnam County",1,71,57,31,26
050,29,171,"Missouri","Putnam County",1,72,59,26,33
050,29,171,"Missouri","Putnam County",1,73,63,30,33
050,29,171,"Missouri","Putnam County",1,74,46,26,20
050,29,171,"Missouri","Putnam County",1,75,50,25,25
050,29,171,"Missouri","Putnam County",1,76,47,25,22
050,29,171,"Missouri","Putnam County",1,77,40,21,19
050,29,171,"Missouri","Putnam County",1,78,44,19,25
050,29,171,"Missouri","Putnam County",1,79,30,16,14
050,29,171,"Missouri","Putnam County",1,80,30,14,16
050,29,171,"Missouri","Putnam County",1,81,32,11,21
050,29,171,"Missouri","Putnam County",1,82,28,13,15
050,29,171,"Missouri","Putnam County",1,83,26,13,13
050,29,171,"Missouri","Putnam County",1,84,25,11,14
050,29,171,"Missouri","Putnam County",1,85,142,51,91
050,29,171,"Missouri","Putnam County",2,0,53,25,28
050,29,171,"Missouri","Putnam County",2,1,61,31,30
050,29,171,"Missouri","Putnam County",2,2,68,37,31
050,29,171,"Missouri","Putnam County",2,3,67,34,33
050,29,171,"Missouri","Putnam County",2,4,56,28,28
050,29,171,"Missouri","Putnam County",2,5,58,32,26
050,29,171,"Missouri","Putnam County",2,6,62,33,29
050,29,171,"Missouri","Putnam County",2,7,60,33,27
050,29,171,"Missouri","Putnam County",2,8,53,28,25
050,29,171,"Missouri","Putnam County",2,9,53,29,24
050,29,171,"Missouri","Putnam County",2,10,60,31,29
050,29,171,"Missouri","Putnam County",2,11,52,30,22
050,29,171,"Missouri","Putnam County",2,12,59,34,25
050,29,171,"Missouri","Putnam County",2,13,57,33,24
050,29,171,"Missouri","Putnam County",2,14,67,37,30
050,29,171,"Missouri","Putnam County",2,15,64,34,30
050,29,171,"Missouri","Putnam County",2,16,59,29,30
050,29,171,"Missouri","Putnam County",2,17,58,28,30
050,29,171,"Missouri","Putnam County",2,18,52,24,28
050,29,171,"Missouri","Putnam County",2,19,46,23,23
050,29,171,"Missouri","Putnam County",2,20,51,26,25
050,29,171,"Missouri","Putnam County",2,21,47,26,21
050,29,171,"Missouri","Putnam County",2,22,40,22,18
050,29,171,"Missouri","Putnam County",2,23,32,20,12
050,29,171,"Missouri","Putnam County",2,24,37,20,17
050,29,171,"Missouri","Putnam County",2,25,38,19,19
050,29,171,"Missouri","Putnam County",2,26,42,19,23
050,29,171,"Missouri","Putnam County",2,27,48,23,25
050,29,171,"Missouri","Putnam County",2,28,57,29,28
050,29,171,"Missouri","Putnam County",2,29,57,31,26
050,29,171,"Missouri","Putnam County",2,30,45,24,21
050,29,171,"Missouri","Putnam County",2,31,48,22,26
050,29,171,"Missouri","Putnam County",2,32,49,23,26
050,29,171,"Missouri","Putnam County",2,33,48,24,24
050,29,171,"Missouri","Putnam County",2,34,46,24,22
050,29,171,"Missouri","Putnam County",2,35,48,26,22
050,29,171,"Missouri","Putnam County",2,36,49,25,24
050,29,171,"Missouri","Putnam County",2,37,45,22,23
050,29,171,"Missouri","Putnam County",2,38,48,25,23
050,29,171,"Missouri","Putnam County",2,39,50,27,23
050,29,171,"Missouri","Putnam County",2,40,52,28,24
050,29,171,"Missouri","Putnam County",2,41,51,26,25
050,29,171,"Missouri","Putnam County",2,42,49,25,24
050,29,171,"Missouri","Putnam County",2,43,48,27,21
050,29,171,"Missouri","Putnam County",2,44,45,23,22
050,29,171,"Missouri","Putnam County",2,45,51,28,23
050,29,171,"Missouri","Putnam County",2,46,49,26,23
050,29,171,"Missouri","Putnam County",2,47,42,22,20
050,29,171,"Missouri","Putnam County",2,48,52,24,28
050,29,171,"Missouri","Putnam County",2,49,62,29,33
050,29,171,"Missouri","Putnam County",2,50,62,31,31
050,29,171,"Missouri","Putnam County",2,51,57,32,25
050,29,171,"Missouri","Putnam County",2,52,57,32,25
050,29,171,"Missouri","Putnam County",2,53,52,31,21
050,29,171,"Missouri","Putnam County",2,54,53,28,25
050,29,171,"Missouri","Putnam County",2,55,65,34,31
050,29,171,"Missouri","Putnam County",2,56,68,37,31
050,29,171,"Missouri","Putnam County",2,57,68,36,32
050,29,171,"Missouri","Putnam County",2,58,77,37,40
050,29,171,"Missouri","Putnam County",2,59,71,39,32
050,29,171,"Missouri","Putnam County",2,60,66,39,27
050,29,171,"Missouri","Putnam County",2,61,67,36,31
050,29,171,"Missouri","Putnam County",2,62,66,29,37
050,29,171,"Missouri","Putnam County",2,63,67,32,35
050,29,171,"Missouri","Putnam County",2,64,66,32,34
050,29,171,"Missouri","Putnam County",2,65,70,33,37
050,29,171,"Missouri","Putnam County",2,66,73,37,36
050,29,171,"Missouri","Putnam County",2,67,73,37,36
050,29,171,"Missouri","Putnam County",2,68,69,31,38
050,29,171,"Missouri","Putnam County",2,69,60,30,30
050,29,171,"Missouri","Putnam County",2,70,64,34,30
050,29,171,"Missouri","Putnam County",2,71,60,32,28
050,29,171,"Missouri","Putnam County",2,72,58,27,31
050,29,171,"Missouri","Putnam County",2,73,63,30,33
050,29,171,"Missouri","Putnam County",2,74,47,26,21
050,29,171,"Missouri","Putnam County",2,75,49,25,24
050,29,171,"Missouri","Putnam County",2,76,47,25,22
050,29,171,"Missouri","Putnam County",2,77,42,22,20
050,29,171,"Missouri","Putnam County",2,78,42,19,23
050,29,171,"Missouri","Putnam County",2,79,33,17,16
050,29,171,"Missouri","Putnam County",2,80,30,14,16
050,29,171,"Missouri","Putnam County",2,81,32,12,20
050,29,171,"Missouri","Putnam County",2,82,29,13,16
050,29,171,"Missouri","Putnam County",2,83,25,12,13
050,29,171,"Missouri","Putnam County",2,84,26,11,15
050,29,171,"Missouri","Putnam County",2,85,144,52,92
050,29,171,"Missouri","Putnam County",3,0,59,32,27
050,29,171,"Missouri","Putnam County",3,1,61,24,37
050,29,171,"Missouri","Putnam County",3,2,64,36,28
050,29,171,"Missouri","Putnam County",3,3,66,35,31
050,29,171,"Missouri","Putnam County",3,4,73,39,34
050,29,171,"Missouri","Putnam County",3,5,58,30,28
050,29,171,"Missouri","Putnam County",3,6,52,30,22
050,29,171,"Missouri","Putnam County",3,7,56,29,27
050,29,171,"Missouri","Putnam County",3,8,55,26,29
050,29,171,"Missouri","Putnam County",3,9,52,28,24
050,29,171,"Missouri","Putnam County",3,10,52,28,24
050,29,171,"Missouri","Putnam County",3,11,68,33,35
050,29,171,"Missouri","Putnam County",3,12,54,31,23
050,29,171,"Missouri","Putnam County",3,13,63,33,30
050,29,171,"Missouri","Putnam County",3,14,60,33,27
050,29,171,"Missouri","Putnam County",3,15,64,34,30
050,29,171,"Missouri","Putnam County",3,16,64,33,31
050,29,171,"Missouri","Putnam County",3,17,58,29,29
050,29,171,"Missouri","Putnam County",3,18,52,27,25
050,29,171,"Missouri","Putnam County",3,19,43,20,23
050,29,171,"Missouri","Putnam County",3,20,48,24,24
050,29,171,"Missouri","Putnam County",3,21,56,25,31
050,29,171,"Missouri","Putnam County",3,22,49,29,20
050,29,171,"Missouri","Putnam County",3,23,47,25,22
050,29,171,"Missouri","Putnam County",3,24,37,23,14
050,29,171,"Missouri","Putnam County",3,25,42,24,18
050,29,171,"Missouri","Putnam County",3,26,39,19,20
050,29,171,"Missouri","Putnam County",3,27,40,20,20
050,29,171,"Missouri","Putnam County",3,28,52,26,26
050,29,171,"Missouri","Putnam County",3,29,57,30,27
050,29,171,"Missouri","Putnam County",3,30,54,32,22
050,29,171,"Missouri","Putnam County",3,31,42,19,23
050,29,171,"Missouri","Putnam County",3,32,45,21,24
050,29,171,"Missouri","Putnam County",3,33,48,22,26
050,29,171,"Missouri","Putnam County",3,34,45,23,22
050,29,171,"Missouri","Putnam County",3,35,44,24,20
050,29,171,"Missouri","Putnam County",3,36,52,29,23
050,29,171,"Missouri","Putnam County",3,37,55,28,27
050,29,171,"Missouri","Putnam County",3,38,45,22,23
050,29,171,"Missouri","Putnam County",3,39,48,22,26
050,29,171,"Missouri","Putnam County",3,40,51,27,24
050,29,171,"Missouri","Putnam County",3,41,51,28,23
050,29,171,"Missouri","Putnam County",3,42,52,27,25
050,29,171,"Missouri","Putnam County",3,43,43,23,20
050,29,171,"Missouri","Putnam County",3,44,49,28,21
050,29,171,"Missouri","Putnam County",3,45,48,26,22
050,29,171,"Missouri","Putnam County",3,46,55,30,25
050,29,171,"Missouri","Putnam County",3,47,51,28,23
050,29,171,"Missouri","Putnam County",3,48,38,21,17
050,29,171,"Missouri","Putnam County",3,49,51,24,27
050,29,171,"Missouri","Putnam County",3,50,60,27,33
050,29,171,"Missouri","Putnam County",3,51,65,33,32
050,29,171,"Missouri","Putnam County",3,52,57,32,25
050,29,171,"Missouri","Putnam County",3,53,53,31,22
050,29,171,"Missouri","Putnam County",3,54,54,32,22
050,29,171,"Missouri","Putnam County",3,55,53,28,25
050,29,171,"Missouri","Putnam County",3,56,58,29,29
050,29,171,"Missouri","Putnam County",3,57,65,38,27
050,29,171,"Missouri","Putnam County",3,58,69,36,33
050,29,171,"Missouri","Putnam County",3,59,81,39,42
050,29,171,"Missouri","Putnam County",3,60,73,40,33
050,29,171,"Missouri","Putnam County",3,61,67,39,28
050,29,171,"Missouri","Putnam County",3,62,65,32,33
050,29,171,"Missouri","Putnam County",3,63,65,30,35
050,29,171,"Missouri","Putnam County",3,64,70,35,35
050,29,171,"Missouri","Putnam County",3,65,69,33,36
050,29,171,"Missouri","Putnam County",3,66,73,35,38
050,29,171,"Missouri","Putnam County",3,67,72,40,32
050,29,171,"Missouri","Putnam County",3,68,71,37,34
050,29,171,"Missouri","Putnam County",3,69,68,31,37
050,29,171,"Missouri","Putnam County",3,70,58,29,29
050,29,171,"Missouri","Putnam County",3,71,62,33,29
050,29,171,"Missouri","Putnam County",3,72,60,32,28
050,29,171,"Missouri","Putnam County",3,73,51,22,29
050,29,171,"Missouri","Putnam County",3,74,62,30,32
050,29,171,"Missouri","Putnam County",3,75,44,24,20
050,29,171,"Missouri","Putnam County",3,76,46,25,21
050,29,171,"Missouri","Putnam County",3,77,40,21,19
050,29,171,"Missouri","Putnam County",3,78,40,20,20
050,29,171,"Missouri","Putnam County",3,79,45,21,24
050,29,171,"Missouri","Putnam County",3,80,27,10,17
050,29,171,"Missouri","Putnam County",3,81,29,12,17
050,29,171,"Missouri","Putnam County",3,82,29,11,18
050,29,171,"Missouri","Putnam County",3,83,28,12,16
050,29,171,"Missouri","Putnam County",3,84,26,10,16
050,29,171,"Missouri","Putnam County",3,85,132,48,84
050,29,171,"Missouri","Putnam County",4,0,56,25,31
050,29,171,"Missouri","Putnam County",4,1,57,36,21
050,29,171,"Missouri","Putnam County",4,2,62,26,36
050,29,171,"Missouri","Putnam County",4,3,59,37,22
050,29,171,"Missouri","Putnam County",4,4,63,37,26
050,29,171,"Missouri","Putnam County",4,5,72,38,34
050,29,171,"Missouri","Putnam County",4,6,60,30,30
050,29,171,"Missouri","Putnam County",4,7,49,26,23
050,29,171,"Missouri","Putnam County",4,8,60,31,29
050,29,171,"Missouri","Putnam County",4,9,58,26,32
050,29,171,"Missouri","Putnam County",4,10,54,32,22
050,29,171,"Missouri","Putnam County",4,11,57,32,25
050,29,171,"Missouri","Putnam County",4,12,73,38,35
050,29,171,"Missouri","Putnam County",4,13,52,30,22
050,29,171,"Missouri","Putnam County",4,14,63,37,26
050,29,171,"Missouri","Putnam County",4,15,60,34,26
050,29,171,"Missouri","Putnam County",4,16,66,36,30
050,29,171,"Missouri","Putnam County",4,17,67,39,28
050,29,171,"Missouri","Putnam County",4,18,50,26,24
050,29,171,"Missouri","Putnam County",4,19,38,18,20
050,29,171,"Missouri","Putnam County",4,20,45,20,25
050,29,171,"Missouri","Putnam County",4,21,48,24,24
050,29,171,"Missouri","Putnam County",4,22,55,25,30
050,29,171,"Missouri","Putnam County",4,23,50,29,21
050,29,171,"Missouri","Putnam County",4,24,46,24,22
050,29,171,"Missouri","Putnam County",4,25,38,21,17
050,29,171,"Missouri","Putnam County",4,26,46,23,23
050,29,171,"Missouri","Putnam County",4,27,48,25,23
050,29,171,"Missouri","Putnam County",4,28,41,20,21
050,29,171,"Missouri","Putnam County",4,29,52,23,29
050,29,171,"Missouri","Putnam County",4,30,62,36,26
050,29,171,"Missouri","Putnam County",4,31,51,28,23
050,29,171,"Missouri","Putnam County",4,32,46,22,24
050,29,171,"Missouri","Putnam County",4,33,44,21,23
050,29,171,"Missouri","Putnam County",4,34,50,22,28
050,29,171,"Missouri","Putnam County",4,35,40,19,21
050,29,171,"Missouri","Putnam County",4,36,43,24,19
050,29,171,"Missouri","Putnam County",4,37,57,30,27
050,29,171,"Missouri","Putnam County",4,38,58,31,27
050,29,171,"Missouri","Putnam County",4,39,44,23,21
050,29,171,"Missouri","Putnam County",4,40,48,23,25
050,29,171,"Missouri","Putnam County",4,41,53,30,23
050,29,171,"Missouri","Putnam County",4,42,51,28,23
050,29,171,"Missouri","Putnam County",4,43,55,27,28
050,29,171,"Missouri","Putnam County",4,44,41,22,19
050,29,171,"Missouri","Putnam County",4,45,47,28,19
050,29,171,"Missouri","Putnam County",4,46,47,22,25
050,29,171,"Missouri","Putnam County",4,47,55,31,24
050,29,171,"Missouri","Putnam County",4,48,47,27,20
050,29,171,"Missouri","Putnam County",4,49,37,20,17
050,29,171,"Missouri","Putnam County",4,50,45,22,23
050,29,171,"Missouri","Putnam County",4,51,60,27,33
050,29,171,"Missouri","Putnam County",4,52,58,29,29
050,29,171,"Missouri","Putnam County",4,53,57,31,26
050,29,171,"Missouri","Putnam County",4,54,57,34,23
050,29,171,"Missouri","Putnam County",4,55,55,32,23
050,29,171,"Missouri","Putnam County",4,56,54,26,28
050,29,171,"Missouri","Putnam County",4,57,60,29,31
050,29,171,"Missouri","Putnam County",4,58,66,38,28
050,29,171,"Missouri","Putnam County",4,59,65,33,32
050,29,171,"Missouri","Putnam County",4,60,90,41,49
050,29,171,"Missouri","Putnam County",4,61,68,35,33
050,29,171,"Missouri","Putnam County",4,62,67,38,29
050,29,171,"Missouri","Putnam County",4,63,64,32,32
050,29,171,"Missouri","Putnam County",4,64,67,31,36
050,29,171,"Missouri","Putnam County",4,65,74,35,39
050,29,171,"Missouri","Putnam County",4,66,65,32,33
050,29,171,"Missouri","Putnam County",4,67,73,37,36
050,29,171,"Missouri","Putnam County",4,68,70,39,31
050,29,171,"Missouri","Putnam County",4,69,56,27,29
050,29,171,"Missouri","Putnam County",4,70,67,30,37
050,29,171,"Missouri","Putnam County",4,71,55,25,30
050,29,171,"Missouri","Putnam County",4,72,59,31,28
050,29,171,"Missouri","Putnam County",4,73,58,32,26
050,29,171,"Missouri","Putnam County",4,74,47,21,26
050,29,171,"Missouri","Putnam County",4,75,58,27,31
050,29,171,"Missouri","Putnam County",4,76,43,24,19
050,29,171,"Missouri","Putnam County",4,77,39,23,16
050,29,171,"Missouri","Putnam County",4,78,38,21,17
050,29,171,"Missouri","Putnam County",4,79,42,22,20
050,29,171,"Missouri","Putnam County",4,80,41,16,25
050,29,171,"Missouri","Putnam County",4,81,25,8,17
050,29,171,"Missouri","Putnam County",4,82,26,11,15
050,29,171,"Missouri","Putnam County",4,83,26,9,17
050,29,171,"Missouri","Putnam County",4,84,28,9,19
050,29,171,"Missouri","Putnam County",4,85,118,47,71
050,29,171,"Missouri","Putnam County",5,0,61,25,36
050,29,171,"Missouri","Putnam County",5,1,50,24,26
050,29,171,"Missouri","Putnam County",5,2,59,37,22
050,29,171,"Missouri","Putnam County",5,3,58,24,34
050,29,171,"Missouri","Putnam County",5,4,62,36,26
050,29,171,"Missouri","Putnam County",5,5,55,33,22
050,29,171,"Missouri","Putnam County",5,6,70,34,36
050,29,171,"Missouri","Putnam County",5,7,62,32,30
050,29,171,"Missouri","Putnam County",5,8,55,29,26
050,29,171,"Missouri","Putnam County",5,9,63,34,29
050,29,171,"Missouri","Putnam County",5,10,60,28,32
050,29,171,"Missouri","Putnam County",5,11,59,35,24
050,29,171,"Missouri","Putnam County",5,12,61,37,24
050,29,171,"Missouri","Putnam County",5,13,75,40,35
050,29,171,"Missouri","Putnam County",5,14,49,27,22
050,29,171,"Missouri","Putnam County",5,15,69,38,31
050,29,171,"Missouri","Putnam County",5,16,54,26,28
050,29,171,"Missouri","Putnam County",5,17,65,39,26
050,29,171,"Missouri","Putnam County",5,18,57,32,25
050,29,171,"Missouri","Putnam County",5,19,36,20,16
050,29,171,"Missouri","Putnam County",5,20,40,20,20
050,29,171,"Missouri","Putnam County",5,21,43,18,25
050,29,171,"Missouri","Putnam County",5,22,51,25,26
050,29,171,"Missouri","Putnam County",5,23,52,25,27
050,29,171,"Missouri","Putnam County",5,24,52,28,24
050,29,171,"Missouri","Putnam County",5,25,44,24,20
050,29,171,"Missouri","Putnam County",5,26,40,19,21
050,29,171,"Missouri","Putnam County",5,27,50,24,26
050,29,171,"Missouri","Putnam County",5,28,44,21,23
050,29,171,"Missouri","Putnam County",5,29,37,17,20
050,29,171,"Missouri","Putnam County",5,30,53,22,31
050,29,171,"Missouri","Putnam County",5,31,60,34,26
050,29,171,"Missouri","Putnam County",5,32,51,29,22
050,29,171,"Missouri","Putnam County",5,33,46,19,27
050,29,171,"Missouri","Putnam County",5,34,44,22,22
050,29,171,"Missouri","Putnam County",5,35,50,23,27
050,29,171,"Missouri","Putnam County",5,36,41,20,21
050,29,171,"Missouri","Putnam County",5,37,46,24,22
050,29,171,"Missouri","Putnam County",5,38,55,29,26
050,29,171,"Missouri","Putnam County",5,39,59,35,24
050,29,171,"Missouri","Putnam County",5,40,49,24,25
050,29,171,"Missouri","Putnam County",5,41,47,23,24
050,29,171,"Missouri","Putnam County",5,42,55,29,26
050,29,171,"Missouri","Putnam County",5,43,53,30,23
050,29,171,"Missouri","Putnam County",5,44,51,25,26
050,29,171,"Missouri","Putnam County",5,45,43,24,19
050,29,171,"Missouri","Putnam County",5,46,47,28,19
050,29,171,"Missouri","Putnam County",5,47,49,24,25
050,29,171,"Missouri","Putnam County",5,48,53,31,22
050,29,171,"Missouri","Putnam County",5,49,45,27,18
050,29,171,"Missouri","Putnam County",5,50,33,19,14
050,29,171,"Missouri","Putnam County",5,51,49,23,26
050,29,171,"Missouri","Putnam County",5,52,61,28,33
050,29,171,"Missouri","Putnam County",5,53,58,28,30
050,29,171,"Missouri","Putnam County",5,54,58,31,27
050,29,171,"Missouri","Putnam County",5,55,56,34,22
050,29,171,"Missouri","Putnam County",5,56,58,33,25
050,29,171,"Missouri","Putnam County",5,57,59,28,31
050,29,171,"Missouri","Putnam County",5,58,59,29,30
050,29,171,"Missouri","Putnam County",5,59,62,35,27
050,29,171,"Missouri","Putnam County",5,60,69,36,33
050,29,171,"Missouri","Putnam County",5,61,92,43,49
050,29,171,"Missouri","Putnam County",5,62,70,35,35
050,29,171,"Missouri","Putnam County",5,63,67,40,27
050,29,171,"Missouri","Putnam County",5,64,65,31,34
050,29,171,"Missouri","Putnam County",5,65,67,31,36
050,29,171,"Missouri","Putnam County",5,66,70,33,37
050,29,171,"Missouri","Putnam County",5,67,64,33,31
050,29,171,"Missouri","Putnam County",5,68,73,37,36
050,29,171,"Missouri","Putnam County",5,69,64,34,30
050,29,171,"Missouri","Putnam County",5,70,53,24,29
050,29,171,"Missouri","Putnam County",5,71,63,28,35
050,29,171,"Missouri","Putnam County",5,72,53,25,28
050,29,171,"Missouri","Putnam County",5,73,55,28,27
050,29,171,"Missouri","Putnam County",5,74,55,32,23
050,29,171,"Missouri","Putnam County",5,75,41,19,22
050,29,171,"Missouri","Putnam County",5,76,54,25,29
050,29,171,"Missouri","Putnam County",5,77,35,22,13
050,29,171,"Missouri","Putnam County",5,78,38,22,16
050,29,171,"Missouri","Putnam County",5,79,41,24,17
050,29,171,"Missouri","Putnam County",5,80,39,17,22
050,29,171,"Missouri","Putnam County",5,81,40,14,26
050,29,171,"Missouri","Putnam County",5,82,24,8,16
050,29,171,"Missouri","Putnam County",5,83,22,8,14
050,29,171,"Missouri","Putnam County",5,84,26,7,19
050,29,171,"Missouri","Putnam County",5,85,115,44,71
050,29,173,"Missouri","Ralls County",1,0,87,44,43
050,29,173,"Missouri","Ralls County",1,1,100,54,46
050,29,173,"Missouri","Ralls County",1,2,111,60,51
050,29,173,"Missouri","Ralls County",1,3,111,61,50
050,29,173,"Missouri","Ralls County",1,4,103,49,54
050,29,173,"Missouri","Ralls County",1,5,96,46,50
050,29,173,"Missouri","Ralls County",1,6,109,51,58
050,29,173,"Missouri","Ralls County",1,7,109,61,48
050,29,173,"Missouri","Ralls County",1,8,107,61,46
050,29,173,"Missouri","Ralls County",1,9,109,61,48
050,29,173,"Missouri","Ralls County",1,10,115,63,52
050,29,173,"Missouri","Ralls County",1,11,152,75,77
050,29,173,"Missouri","Ralls County",1,12,162,82,80
050,29,173,"Missouri","Ralls County",1,13,136,66,70
050,29,173,"Missouri","Ralls County",1,14,133,66,67
050,29,173,"Missouri","Ralls County",1,15,147,76,71
050,29,173,"Missouri","Ralls County",1,16,148,74,74
050,29,173,"Missouri","Ralls County",1,17,124,65,59
050,29,173,"Missouri","Ralls County",1,18,99,58,41
050,29,173,"Missouri","Ralls County",1,19,82,49,33
050,29,173,"Missouri","Ralls County",1,20,98,52,46
050,29,173,"Missouri","Ralls County",1,21,87,47,40
050,29,173,"Missouri","Ralls County",1,22,91,51,40
050,29,173,"Missouri","Ralls County",1,23,102,50,52
050,29,173,"Missouri","Ralls County",1,24,106,54,52
050,29,173,"Missouri","Ralls County",1,25,110,54,56
050,29,173,"Missouri","Ralls County",1,26,102,50,52
050,29,173,"Missouri","Ralls County",1,27,107,53,54
050,29,173,"Missouri","Ralls County",1,28,106,58,48
050,29,173,"Missouri","Ralls County",1,29,103,50,53
050,29,173,"Missouri","Ralls County",1,30,88,36,52
050,29,173,"Missouri","Ralls County",1,31,101,49,52
050,29,173,"Missouri","Ralls County",1,32,108,55,53
050,29,173,"Missouri","Ralls County",1,33,102,50,52
050,29,173,"Missouri","Ralls County",1,34,105,51,54
050,29,173,"Missouri","Ralls County",1,35,115,61,54
050,29,173,"Missouri","Ralls County",1,36,116,57,59
050,29,173,"Missouri","Ralls County",1,37,107,58,49
050,29,173,"Missouri","Ralls County",1,38,107,57,50
050,29,173,"Missouri","Ralls County",1,39,110,52,58
050,29,173,"Missouri","Ralls County",1,40,124,62,62
050,29,173,"Missouri","Ralls County",1,41,114,60,54
050,29,173,"Missouri","Ralls County",1,42,138,76,62
050,29,173,"Missouri","Ralls County",1,43,135,67,68
050,29,173,"Missouri","Ralls County",1,44,130,63,67
050,29,173,"Missouri","Ralls County",1,45,120,61,59
050,29,173,"Missouri","Ralls County",1,46,129,67,62
050,29,173,"Missouri","Ralls County",1,47,132,71,61
050,29,173,"Missouri","Ralls County",1,48,121,64,57
050,29,173,"Missouri","Ralls County",1,49,137,72,65
050,29,173,"Missouri","Ralls County",1,50,148,76,72
050,29,173,"Missouri","Ralls County",1,51,134,72,62
050,29,173,"Missouri","Ralls County",1,52,133,71,62
050,29,173,"Missouri","Ralls County",1,53,145,71,74
050,29,173,"Missouri","Ralls County",1,54,140,66,74
050,29,173,"Missouri","Ralls County",1,55,155,78,77
050,29,173,"Missouri","Ralls County",1,56,171,79,92
050,29,173,"Missouri","Ralls County",1,57,181,90,91
050,29,173,"Missouri","Ralls County",1,58,173,97,76
050,29,173,"Missouri","Ralls County",1,59,177,93,84
050,29,173,"Missouri","Ralls County",1,60,164,83,81
050,29,173,"Missouri","Ralls County",1,61,157,82,75
050,29,173,"Missouri","Ralls County",1,62,159,78,81
050,29,173,"Missouri","Ralls County",1,63,168,95,73
050,29,173,"Missouri","Ralls County",1,64,161,84,77
050,29,173,"Missouri","Ralls County",1,65,145,61,84
050,29,173,"Missouri","Ralls County",1,66,155,74,81
050,29,173,"Missouri","Ralls County",1,67,156,75,81
050,29,173,"Missouri","Ralls County",1,68,143,67,76
050,29,173,"Missouri","Ralls County",1,69,132,67,65
050,29,173,"Missouri","Ralls County",1,70,144,78,66
050,29,173,"Missouri","Ralls County",1,71,142,78,64
050,29,173,"Missouri","Ralls County",1,72,137,68,69
050,29,173,"Missouri","Ralls County",1,73,131,66,65
050,29,173,"Missouri","Ralls County",1,74,93,43,50
050,29,173,"Missouri","Ralls County",1,75,102,49,53
050,29,173,"Missouri","Ralls County",1,76,106,53,53
050,29,173,"Missouri","Ralls County",1,77,93,40,53
050,29,173,"Missouri","Ralls County",1,78,78,39,39
050,29,173,"Missouri","Ralls County",1,79,82,42,40
050,29,173,"Missouri","Ralls County",1,80,70,35,35
050,29,173,"Missouri","Ralls County",1,81,54,29,25
050,29,173,"Missouri","Ralls County",1,82,49,25,24
050,29,173,"Missouri","Ralls County",1,83,37,18,19
050,29,173,"Missouri","Ralls County",1,84,37,21,16
050,29,173,"Missouri","Ralls County",1,85,213,76,137
050,29,173,"Missouri","Ralls County",2,0,98,49,49
050,29,173,"Missouri","Ralls County",2,1,97,51,46
050,29,173,"Missouri","Ralls County",2,2,109,59,50
050,29,173,"Missouri","Ralls County",2,3,110,60,50
050,29,173,"Missouri","Ralls County",2,4,104,51,53
050,29,173,"Missouri","Ralls County",2,5,97,47,50
050,29,173,"Missouri","Ralls County",2,6,106,50,56
050,29,173,"Missouri","Ralls County",2,7,111,60,51
050,29,173,"Missouri","Ralls County",2,8,107,61,46
050,29,173,"Missouri","Ralls County",2,9,106,59,47
050,29,173,"Missouri","Ralls County",2,10,113,62,51
050,29,173,"Missouri","Ralls County",2,11,143,73,70
050,29,173,"Missouri","Ralls County",2,12,157,78,79
050,29,173,"Missouri","Ralls County",2,13,140,69,71
050,29,173,"Missouri","Ralls County",2,14,132,65,67
050,29,173,"Missouri","Ralls County",2,15,145,73,72
050,29,173,"Missouri","Ralls County",2,16,148,75,73
050,29,173,"Missouri","Ralls County",2,17,128,67,61
050,29,173,"Missouri","Ralls County",2,18,99,57,42
050,29,173,"Missouri","Ralls County",2,19,81,48,33
050,29,173,"Missouri","Ralls County",2,20,96,52,44
050,29,173,"Missouri","Ralls County",2,21,91,49,42
050,29,173,"Missouri","Ralls County",2,22,91,51,40
050,29,173,"Missouri","Ralls County",2,23,102,52,50
050,29,173,"Missouri","Ralls County",2,24,106,54,52
050,29,173,"Missouri","Ralls County",2,25,108,54,54
050,29,173,"Missouri","Ralls County",2,26,105,53,52
050,29,173,"Missouri","Ralls County",2,27,106,53,53
050,29,173,"Missouri","Ralls County",2,28,109,59,50
050,29,173,"Missouri","Ralls County",2,29,103,51,52
050,29,173,"Missouri","Ralls County",2,30,93,39,54
050,29,173,"Missouri","Ralls County",2,31,100,47,53
050,29,173,"Missouri","Ralls County",2,32,107,54,53
050,29,173,"Missouri","Ralls County",2,33,103,50,53
050,29,173,"Missouri","Ralls County",2,34,103,50,53
050,29,173,"Missouri","Ralls County",2,35,112,58,54
050,29,173,"Missouri","Ralls County",2,36,115,57,58
050,29,173,"Missouri","Ralls County",2,37,109,58,51
050,29,173,"Missouri","Ralls County",2,38,109,58,51
050,29,173,"Missouri","Ralls County",2,39,110,54,56
050,29,173,"Missouri","Ralls County",2,40,121,60,61
050,29,173,"Missouri","Ralls County",2,41,116,59,57
050,29,173,"Missouri","Ralls County",2,42,134,73,61
050,29,173,"Missouri","Ralls County",2,43,137,70,67
050,29,173,"Missouri","Ralls County",2,44,129,64,65
050,29,173,"Missouri","Ralls County",2,45,124,62,62
050,29,173,"Missouri","Ralls County",2,46,126,66,60
050,29,173,"Missouri","Ralls County",2,47,130,69,61
050,29,173,"Missouri","Ralls County",2,48,123,66,57
050,29,173,"Missouri","Ralls County",2,49,134,70,64
050,29,173,"Missouri","Ralls County",2,50,149,77,72
050,29,173,"Missouri","Ralls County",2,51,137,73,64
050,29,173,"Missouri","Ralls County",2,52,133,71,62
050,29,173,"Missouri","Ralls County",2,53,143,71,72
050,29,173,"Missouri","Ralls County",2,54,140,67,73
050,29,173,"Missouri","Ralls County",2,55,153,76,77
050,29,173,"Missouri","Ralls County",2,56,168,78,90
050,29,173,"Missouri","Ralls County",2,57,180,88,92
050,29,173,"Missouri","Ralls County",2,58,175,95,80
050,29,173,"Missouri","Ralls County",2,59,177,94,83
050,29,173,"Missouri","Ralls County",2,60,167,86,81
050,29,173,"Missouri","Ralls County",2,61,158,82,76
050,29,173,"Missouri","Ralls County",2,62,160,80,80
050,29,173,"Missouri","Ralls County",2,63,167,91,76
050,29,173,"Missouri","Ralls County",2,64,163,87,76
050,29,173,"Missouri","Ralls County",2,65,148,67,81
050,29,173,"Missouri","Ralls County",2,66,151,71,80
050,29,173,"Missouri","Ralls County",2,67,154,75,79
050,29,173,"Missouri","Ralls County",2,68,146,69,77
050,29,173,"Missouri","Ralls County",2,69,135,67,68
050,29,173,"Missouri","Ralls County",2,70,139,73,66
050,29,173,"Missouri","Ralls County",2,71,144,78,66
050,29,173,"Missouri","Ralls County",2,72,134,69,65
050,29,173,"Missouri","Ralls County",2,73,139,70,69
050,29,173,"Missouri","Ralls County",2,74,93,43,50
050,29,173,"Missouri","Ralls County",2,75,100,48,52
050,29,173,"Missouri","Ralls County",2,76,105,52,53
050,29,173,"Missouri","Ralls County",2,77,97,43,54
050,29,173,"Missouri","Ralls County",2,78,80,39,41
050,29,173,"Missouri","Ralls County",2,79,76,40,36
050,29,173,"Missouri","Ralls County",2,80,72,36,36
050,29,173,"Missouri","Ralls County",2,81,56,28,28
050,29,173,"Missouri","Ralls County",2,82,49,25,24
050,29,173,"Missouri","Ralls County",2,83,38,18,20
050,29,173,"Missouri","Ralls County",2,84,36,20,16
050,29,173,"Missouri","Ralls County",2,85,213,78,135
050,29,173,"Missouri","Ralls County",3,0,86,38,48
050,29,173,"Missouri","Ralls County",3,1,95,49,46
050,29,173,"Missouri","Ralls County",3,2,93,46,47
050,29,173,"Missouri","Ralls County",3,3,109,56,53
050,29,173,"Missouri","Ralls County",3,4,112,61,51
050,29,173,"Missouri","Ralls County",3,5,117,57,60
050,29,173,"Missouri","Ralls County",3,6,100,51,49
050,29,173,"Missouri","Ralls County",3,7,104,49,55
050,29,173,"Missouri","Ralls County",3,8,112,62,50
050,29,173,"Missouri","Ralls County",3,9,109,62,47
050,29,173,"Missouri","Ralls County",3,10,112,59,53
050,29,173,"Missouri","Ralls County",3,11,121,67,54
050,29,173,"Missouri","Ralls County",3,12,143,73,70
050,29,173,"Missouri","Ralls County",3,13,157,77,80
050,29,173,"Missouri","Ralls County",3,14,146,73,73
050,29,173,"Missouri","Ralls County",3,15,132,64,68
050,29,173,"Missouri","Ralls County",3,16,141,73,68
050,29,173,"Missouri","Ralls County",3,17,145,76,69
050,29,173,"Missouri","Ralls County",3,18,104,54,50
050,29,173,"Missouri","Ralls County",3,19,80,45,35
050,29,173,"Missouri","Ralls County",3,20,87,52,35
050,29,173,"Missouri","Ralls County",3,21,101,55,46
050,29,173,"Missouri","Ralls County",3,22,81,42,39
050,29,173,"Missouri","Ralls County",3,23,89,51,38
050,29,173,"Missouri","Ralls County",3,24,104,49,55
050,29,173,"Missouri","Ralls County",3,25,96,45,51
050,29,173,"Missouri","Ralls County",3,26,104,50,54
050,29,173,"Missouri","Ralls County",3,27,109,51,58
050,29,173,"Missouri","Ralls County",3,28,108,55,53
050,29,173,"Missouri","Ralls County",3,29,111,59,52
050,29,173,"Missouri","Ralls County",3,30,105,51,54
050,29,173,"Missouri","Ralls County",3,31,88,40,48
050,29,173,"Missouri","Ralls County",3,32,108,49,59
050,29,173,"Missouri","Ralls County",3,33,112,59,53
050,29,173,"Missouri","Ralls County",3,34,107,48,59
050,29,173,"Missouri","Ralls County",3,35,108,55,53
050,29,173,"Missouri","Ralls County",3,36,115,58,57
050,29,173,"Missouri","Ralls County",3,37,114,62,52
050,29,173,"Missouri","Ralls County",3,38,111,58,53
050,29,173,"Missouri","Ralls County",3,39,102,57,45
050,29,173,"Missouri","Ralls County",3,40,111,53,58
050,29,173,"Missouri","Ralls County",3,41,116,56,60
050,29,173,"Missouri","Ralls County",3,42,122,61,61
050,29,173,"Missouri","Ralls County",3,43,136,73,63
050,29,173,"Missouri","Ralls County",3,44,138,72,66
050,29,173,"Missouri","Ralls County",3,45,131,64,67
050,29,173,"Missouri","Ralls County",3,46,124,65,59
050,29,173,"Missouri","Ralls County",3,47,126,67,59
050,29,173,"Missouri","Ralls County",3,48,135,70,65
050,29,173,"Missouri","Ralls County",3,49,124,67,57
050,29,173,"Missouri","Ralls County",3,50,139,75,64
050,29,173,"Missouri","Ralls County",3,51,147,76,71
050,29,173,"Missouri","Ralls County",3,52,134,69,65
050,29,173,"Missouri","Ralls County",3,53,137,73,64
050,29,173,"Missouri","Ralls County",3,54,149,75,74
050,29,173,"Missouri","Ralls County",3,55,136,65,71
050,29,173,"Missouri","Ralls County",3,56,163,78,85
050,29,173,"Missouri","Ralls County",3,57,175,80,95
050,29,173,"Missouri","Ralls County",3,58,179,90,89
050,29,173,"Missouri","Ralls County",3,59,172,93,79
050,29,173,"Missouri","Ralls County",3,60,183,97,86
050,29,173,"Missouri","Ralls County",3,61,165,83,82
050,29,173,"Missouri","Ralls County",3,62,162,83,79
050,29,173,"Missouri","Ralls County",3,63,157,78,79
050,29,173,"Missouri","Ralls County",3,64,169,91,78
050,29,173,"Missouri","Ralls County",3,65,162,89,73
050,29,173,"Missouri","Ralls County",3,66,148,67,81
050,29,173,"Missouri","Ralls County",3,67,149,73,76
050,29,173,"Missouri","Ralls County",3,68,156,74,82
050,29,173,"Missouri","Ralls County",3,69,144,68,76
050,29,173,"Missouri","Ralls County",3,70,133,65,68
050,29,173,"Missouri","Ralls County",3,71,136,69,67
050,29,173,"Missouri","Ralls County",3,72,142,80,62
050,29,173,"Missouri","Ralls County",3,73,130,69,61
050,29,173,"Missouri","Ralls County",3,74,130,62,68
050,29,173,"Missouri","Ralls County",3,75,90,41,49
050,29,173,"Missouri","Ralls County",3,76,91,45,46
050,29,173,"Missouri","Ralls County",3,77,94,45,49
050,29,173,"Missouri","Ralls County",3,78,92,42,50
050,29,173,"Missouri","Ralls County",3,79,76,36,40
050,29,173,"Missouri","Ralls County",3,80,69,37,32
050,29,173,"Missouri","Ralls County",3,81,70,34,36
050,29,173,"Missouri","Ralls County",3,82,52,29,23
050,29,173,"Missouri","Ralls County",3,83,44,20,24
050,29,173,"Missouri","Ralls County",3,84,40,18,22
050,29,173,"Missouri","Ralls County",3,85,212,83,129
050,29,173,"Missouri","Ralls County",4,0,96,47,49
050,29,173,"Missouri","Ralls County",4,1,93,40,53
050,29,173,"Missouri","Ralls County",4,2,95,47,48
050,29,173,"Missouri","Ralls County",4,3,104,55,49
050,29,173,"Missouri","Ralls County",4,4,115,61,54
050,29,173,"Missouri","Ralls County",4,5,115,60,55
050,29,173,"Missouri","Ralls County",4,6,117,61,56
050,29,173,"Missouri","Ralls County",4,7,99,46,53
050,29,173,"Missouri","Ralls County",4,8,107,52,55
050,29,173,"Missouri","Ralls County",4,9,117,65,52
050,29,173,"Missouri","Ralls County",4,10,111,62,49
050,29,173,"Missouri","Ralls County",4,11,115,59,56
050,29,173,"Missouri","Ralls County",4,12,119,65,54
050,29,173,"Missouri","Ralls County",4,13,154,81,73
050,29,173,"Missouri","Ralls County",4,14,163,81,82
050,29,173,"Missouri","Ralls County",4,15,142,73,69
050,29,173,"Missouri","Ralls County",4,16,133,62,71
050,29,173,"Missouri","Ralls County",4,17,133,69,64
050,29,173,"Missouri","Ralls County",4,18,124,68,56
050,29,173,"Missouri","Ralls County",4,19,82,39,43
050,29,173,"Missouri","Ralls County",4,20,87,50,37
050,29,173,"Missouri","Ralls County",4,21,77,45,32
050,29,173,"Missouri","Ralls County",4,22,95,54,41
050,29,173,"Missouri","Ralls County",4,23,93,48,45
050,29,173,"Missouri","Ralls County",4,24,85,50,35
050,29,173,"Missouri","Ralls County",4,25,104,47,57
050,29,173,"Missouri","Ralls County",4,26,97,41,56
050,29,173,"Missouri","Ralls County",4,27,97,45,52
050,29,173,"Missouri","Ralls County",4,28,110,46,64
050,29,173,"Missouri","Ralls County",4,29,112,53,59
050,29,173,"Missouri","Ralls County",4,30,123,67,56
050,29,173,"Missouri","Ralls County",4,31,111,54,57
050,29,173,"Missouri","Ralls County",4,32,94,43,51
050,29,173,"Missouri","Ralls County",4,33,110,53,57
050,29,173,"Missouri","Ralls County",4,34,109,55,54
050,29,173,"Missouri","Ralls County",4,35,116,55,61
050,29,173,"Missouri","Ralls County",4,36,103,52,51
050,29,173,"Missouri","Ralls County",4,37,121,58,63
050,29,173,"Missouri","Ralls County",4,38,110,57,53
050,29,173,"Missouri","Ralls County",4,39,121,61,60
050,29,173,"Missouri","Ralls County",4,40,99,55,44
050,29,173,"Missouri","Ralls County",4,41,105,49,56
050,29,173,"Missouri","Ralls County",4,42,122,62,60
050,29,173,"Missouri","Ralls County",4,43,128,64,64
050,29,173,"Missouri","Ralls County",4,44,137,73,64
050,29,173,"Missouri","Ralls County",4,45,134,71,63
050,29,173,"Missouri","Ralls County",4,46,130,63,67
050,29,173,"Missouri","Ralls County",4,47,128,68,60
050,29,173,"Missouri","Ralls County",4,48,126,65,61
050,29,173,"Missouri","Ralls County",4,49,120,65,55
050,29,173,"Missouri","Ralls County",4,50,129,68,61
050,29,173,"Missouri","Ralls County",4,51,141,73,68
050,29,173,"Missouri","Ralls County",4,52,152,76,76
050,29,173,"Missouri","Ralls County",4,53,136,68,68
050,29,173,"Missouri","Ralls County",4,54,137,76,61
050,29,173,"Missouri","Ralls County",4,55,151,72,79
050,29,173,"Missouri","Ralls County",4,56,134,64,70
050,29,173,"Missouri","Ralls County",4,57,163,79,84
050,29,173,"Missouri","Ralls County",4,58,176,79,97
050,29,173,"Missouri","Ralls County",4,59,182,90,92
050,29,173,"Missouri","Ralls County",4,60,172,92,80
050,29,173,"Missouri","Ralls County",4,61,184,99,85
050,29,173,"Missouri","Ralls County",4,62,171,86,85
050,29,173,"Missouri","Ralls County",4,63,157,84,73
050,29,173,"Missouri","Ralls County",4,64,158,80,78
050,29,173,"Missouri","Ralls County",4,65,166,94,72
050,29,173,"Missouri","Ralls County",4,66,163,89,74
050,29,173,"Missouri","Ralls County",4,67,148,67,81
050,29,173,"Missouri","Ralls County",4,68,150,73,77
050,29,173,"Missouri","Ralls County",4,69,150,70,80
050,29,173,"Missouri","Ralls County",4,70,143,68,75
050,29,173,"Missouri","Ralls County",4,71,132,63,69
050,29,173,"Missouri","Ralls County",4,72,131,64,67
050,29,173,"Missouri","Ralls County",4,73,141,82,59
050,29,173,"Missouri","Ralls County",4,74,121,62,59
050,29,173,"Missouri","Ralls County",4,75,129,60,69
050,29,173,"Missouri","Ralls County",4,76,86,37,49
050,29,173,"Missouri","Ralls County",4,77,85,38,47
050,29,173,"Missouri","Ralls County",4,78,93,47,46
050,29,173,"Missouri","Ralls County",4,79,79,34,45
050,29,173,"Missouri","Ralls County",4,80,66,31,35
050,29,173,"Missouri","Ralls County",4,81,64,33,31
050,29,173,"Missouri","Ralls County",4,82,63,33,30
050,29,173,"Missouri","Ralls County",4,83,48,24,24
050,29,173,"Missouri","Ralls County",4,84,43,19,24
050,29,173,"Missouri","Ralls County",4,85,228,90,138
050,29,173,"Missouri","Ralls County",5,0,97,48,49
050,29,173,"Missouri","Ralls County",5,1,102,54,48
050,29,173,"Missouri","Ralls County",5,2,93,44,49
050,29,173,"Missouri","Ralls County",5,3,99,50,49
050,29,173,"Missouri","Ralls County",5,4,117,64,53
050,29,173,"Missouri","Ralls County",5,5,116,61,55
050,29,173,"Missouri","Ralls County",5,6,123,66,57
050,29,173,"Missouri","Ralls County",5,7,123,69,54
050,29,173,"Missouri","Ralls County",5,8,104,48,56
050,29,173,"Missouri","Ralls County",5,9,114,55,59
050,29,173,"Missouri","Ralls County",5,10,126,69,57
050,29,173,"Missouri","Ralls County",5,11,113,63,50
050,29,173,"Missouri","Ralls County",5,12,116,59,57
050,29,173,"Missouri","Ralls County",5,13,118,66,52
050,29,173,"Missouri","Ralls County",5,14,150,77,73
050,29,173,"Missouri","Ralls County",5,15,160,80,80
050,29,173,"Missouri","Ralls County",5,16,144,72,72
050,29,173,"Missouri","Ralls County",5,17,136,67,69
050,29,173,"Missouri","Ralls County",5,18,113,59,54
050,29,173,"Missouri","Ralls County",5,19,88,52,36
050,29,173,"Missouri","Ralls County",5,20,78,36,42
050,29,173,"Missouri","Ralls County",5,21,95,54,41
050,29,173,"Missouri","Ralls County",5,22,88,51,37
050,29,173,"Missouri","Ralls County",5,23,104,59,45
050,29,173,"Missouri","Ralls County",5,24,94,50,44
050,29,173,"Missouri","Ralls County",5,25,82,46,36
050,29,173,"Missouri","Ralls County",5,26,103,49,54
050,29,173,"Missouri","Ralls County",5,27,96,41,55
050,29,173,"Missouri","Ralls County",5,28,98,45,53
050,29,173,"Missouri","Ralls County",5,29,109,46,63
050,29,173,"Missouri","Ralls County",5,30,113,53,60
050,29,173,"Missouri","Ralls County",5,31,122,64,58
050,29,173,"Missouri","Ralls County",5,32,128,59,69
050,29,173,"Missouri","Ralls County",5,33,99,49,50
050,29,173,"Missouri","Ralls County",5,34,114,59,55
050,29,173,"Missouri","Ralls County",5,35,107,55,52
050,29,173,"Missouri","Ralls County",5,36,113,51,62
050,29,173,"Missouri","Ralls County",5,37,112,56,56
050,29,173,"Missouri","Ralls County",5,38,121,58,63
050,29,173,"Missouri","Ralls County",5,39,114,60,54
050,29,173,"Missouri","Ralls County",5,40,117,58,59
050,29,173,"Missouri","Ralls County",5,41,104,58,46
050,29,173,"Missouri","Ralls County",5,42,110,50,60
050,29,173,"Missouri","Ralls County",5,43,127,62,65
050,29,173,"Missouri","Ralls County",5,44,127,63,64
050,29,173,"Missouri","Ralls County",5,45,148,77,71
050,29,173,"Missouri","Ralls County",5,46,136,70,66
050,29,173,"Missouri","Ralls County",5,47,131,64,67
050,29,173,"Missouri","Ralls County",5,48,125,66,59
050,29,173,"Missouri","Ralls County",5,49,134,68,66
050,29,173,"Missouri","Ralls County",5,50,125,69,56
050,29,173,"Missouri","Ralls County",5,51,129,70,59
050,29,173,"Missouri","Ralls County",5,52,143,73,70
050,29,173,"Missouri","Ralls County",5,53,148,70,78
050,29,173,"Missouri","Ralls County",5,54,137,70,67
050,29,173,"Missouri","Ralls County",5,55,137,77,60
050,29,173,"Missouri","Ralls County",5,56,147,70,77
050,29,173,"Missouri","Ralls County",5,57,131,63,68
050,29,173,"Missouri","Ralls County",5,58,164,79,85
050,29,173,"Missouri","Ralls County",5,59,179,84,95
050,29,173,"Missouri","Ralls County",5,60,170,84,86
050,29,173,"Missouri","Ralls County",5,61,171,88,83
050,29,173,"Missouri","Ralls County",5,62,187,101,86
050,29,173,"Missouri","Ralls County",5,63,170,86,84
050,29,173,"Missouri","Ralls County",5,64,161,85,76
050,29,173,"Missouri","Ralls County",5,65,153,77,76
050,29,173,"Missouri","Ralls County",5,66,158,92,66
050,29,173,"Missouri","Ralls County",5,67,159,89,70
050,29,173,"Missouri","Ralls County",5,68,149,68,81
050,29,173,"Missouri","Ralls County",5,69,144,69,75
050,29,173,"Missouri","Ralls County",5,70,152,73,79
050,29,173,"Missouri","Ralls County",5,71,139,67,72
050,29,173,"Missouri","Ralls County",5,72,131,61,70
050,29,173,"Missouri","Ralls County",5,73,131,66,65
050,29,173,"Missouri","Ralls County",5,74,134,77,57
050,29,173,"Missouri","Ralls County",5,75,115,59,56
050,29,173,"Missouri","Ralls County",5,76,126,58,68
050,29,173,"Missouri","Ralls County",5,77,80,30,50
050,29,173,"Missouri","Ralls County",5,78,80,38,42
050,29,173,"Missouri","Ralls County",5,79,85,41,44
050,29,173,"Missouri","Ralls County",5,80,69,27,42
050,29,173,"Missouri","Ralls County",5,81,63,28,35
050,29,173,"Missouri","Ralls County",5,82,62,33,29
050,29,173,"Missouri","Ralls County",5,83,59,29,30
050,29,173,"Missouri","Ralls County",5,84,48,24,24
050,29,173,"Missouri","Ralls County",5,85,252,102,150
050,29,175,"Missouri","Randolph County",1,0,290,148,142
050,29,175,"Missouri","Randolph County",1,1,308,148,160
050,29,175,"Missouri","Randolph County",1,2,303,147,156
050,29,175,"Missouri","Randolph County",1,3,277,133,144
050,29,175,"Missouri","Randolph County",1,4,288,154,134
050,29,175,"Missouri","Randolph County",1,5,265,133,132
050,29,175,"Missouri","Randolph County",1,6,301,161,140
050,29,175,"Missouri","Randolph County",1,7,275,151,124
050,29,175,"Missouri","Randolph County",1,8,293,151,142
050,29,175,"Missouri","Randolph County",1,9,290,147,143
050,29,175,"Missouri","Randolph County",1,10,308,172,136
050,29,175,"Missouri","Randolph County",1,11,326,167,159
050,29,175,"Missouri","Randolph County",1,12,326,174,152
050,29,175,"Missouri","Randolph County",1,13,313,156,157
050,29,175,"Missouri","Randolph County",1,14,315,162,153
050,29,175,"Missouri","Randolph County",1,15,310,165,145
050,29,175,"Missouri","Randolph County",1,16,311,167,144
050,29,175,"Missouri","Randolph County",1,17,312,152,160
050,29,175,"Missouri","Randolph County",1,18,293,148,145
050,29,175,"Missouri","Randolph County",1,19,252,136,116
050,29,175,"Missouri","Randolph County",1,20,243,132,111
050,29,175,"Missouri","Randolph County",1,21,292,163,129
050,29,175,"Missouri","Randolph County",1,22,320,180,140
050,29,175,"Missouri","Randolph County",1,23,344,194,150
050,29,175,"Missouri","Randolph County",1,24,353,207,146
050,29,175,"Missouri","Randolph County",1,25,333,187,146
050,29,175,"Missouri","Randolph County",1,26,344,193,151
050,29,175,"Missouri","Randolph County",1,27,354,201,153
050,29,175,"Missouri","Randolph County",1,28,338,195,143
050,29,175,"Missouri","Randolph County",1,29,363,204,159
050,29,175,"Missouri","Randolph County",1,30,347,202,145
050,29,175,"Missouri","Randolph County",1,31,360,207,153
050,29,175,"Missouri","Randolph County",1,32,325,189,136
050,29,175,"Missouri","Randolph County",1,33,329,194,135
050,29,175,"Missouri","Randolph County",1,34,350,199,151
050,29,175,"Missouri","Randolph County",1,35,325,198,127
050,29,175,"Missouri","Randolph County",1,36,301,182,119
050,29,175,"Missouri","Randolph County",1,37,332,189,143
050,29,175,"Missouri","Randolph County",1,38,346,185,161
050,29,175,"Missouri","Randolph County",1,39,313,166,147
050,29,175,"Missouri","Randolph County",1,40,330,179,151
050,29,175,"Missouri","Randolph County",1,41,311,175,136
050,29,175,"Missouri","Randolph County",1,42,307,181,126
050,29,175,"Missouri","Randolph County",1,43,335,190,145
050,29,175,"Missouri","Randolph County",1,44,299,170,129
050,29,175,"Missouri","Randolph County",1,45,300,176,124
050,29,175,"Missouri","Randolph County",1,46,293,156,137
050,29,175,"Missouri","Randolph County",1,47,311,177,134
050,29,175,"Missouri","Randolph County",1,48,334,191,143
050,29,175,"Missouri","Randolph County",1,49,349,195,154
050,29,175,"Missouri","Randolph County",1,50,353,197,156
050,29,175,"Missouri","Randolph County",1,51,348,177,171
050,29,175,"Missouri","Randolph County",1,52,299,148,151
050,29,175,"Missouri","Randolph County",1,53,297,153,144
050,29,175,"Missouri","Randolph County",1,54,312,160,152
050,29,175,"Missouri","Randolph County",1,55,324,179,145
050,29,175,"Missouri","Randolph County",1,56,339,189,150
050,29,175,"Missouri","Randolph County",1,57,353,199,154
050,29,175,"Missouri","Randolph County",1,58,354,188,166
050,29,175,"Missouri","Randolph County",1,59,347,173,174
050,29,175,"Missouri","Randolph County",1,60,324,161,163
050,29,175,"Missouri","Randolph County",1,61,303,152,151
050,29,175,"Missouri","Randolph County",1,62,312,154,158
050,29,175,"Missouri","Randolph County",1,63,291,139,152
050,29,175,"Missouri","Randolph County",1,64,279,140,139
050,29,175,"Missouri","Randolph County",1,65,269,136,133
050,29,175,"Missouri","Randolph County",1,66,275,134,141
050,29,175,"Missouri","Randolph County",1,67,269,122,147
050,29,175,"Missouri","Randolph County",1,68,270,130,140
050,29,175,"Missouri","Randolph County",1,69,265,139,126
050,29,175,"Missouri","Randolph County",1,70,249,122,127
050,29,175,"Missouri","Randolph County",1,71,215,98,117
050,29,175,"Missouri","Randolph County",1,72,198,85,113
050,29,175,"Missouri","Randolph County",1,73,217,114,103
050,29,175,"Missouri","Randolph County",1,74,170,75,95
050,29,175,"Missouri","Randolph County",1,75,158,68,90
050,29,175,"Missouri","Randolph County",1,76,163,72,91
050,29,175,"Missouri","Randolph County",1,77,157,72,85
050,29,175,"Missouri","Randolph County",1,78,139,66,73
050,29,175,"Missouri","Randolph County",1,79,125,57,68
050,29,175,"Missouri","Randolph County",1,80,119,52,67
050,29,175,"Missouri","Randolph County",1,81,107,39,68
050,29,175,"Missouri","Randolph County",1,82,91,30,61
050,29,175,"Missouri","Randolph County",1,83,96,39,57
050,29,175,"Missouri","Randolph County",1,84,82,39,43
050,29,175,"Missouri","Randolph County",1,85,501,151,350
050,29,175,"Missouri","Randolph County",2,0,282,144,138
050,29,175,"Missouri","Randolph County",2,1,304,148,156
050,29,175,"Missouri","Randolph County",2,2,303,146,157
050,29,175,"Missouri","Randolph County",2,3,282,137,145
050,29,175,"Missouri","Randolph County",2,4,284,149,135
050,29,175,"Missouri","Randolph County",2,5,271,139,132
050,29,175,"Missouri","Randolph County",2,6,293,156,137
050,29,175,"Missouri","Randolph County",2,7,278,153,125
050,29,175,"Missouri","Randolph County",2,8,284,148,136
050,29,175,"Missouri","Randolph County",2,9,288,147,141
050,29,175,"Missouri","Randolph County",2,10,301,164,137
050,29,175,"Missouri","Randolph County",2,11,319,167,152
050,29,175,"Missouri","Randolph County",2,12,325,173,152
050,29,175,"Missouri","Randolph County",2,13,314,159,155
050,29,175,"Missouri","Randolph County",2,14,314,160,154
050,29,175,"Missouri","Randolph County",2,15,309,161,148
050,29,175,"Missouri","Randolph County",2,16,312,165,147
050,29,175,"Missouri","Randolph County",2,17,308,153,155
050,29,175,"Missouri","Randolph County",2,18,286,144,142
050,29,175,"Missouri","Randolph County",2,19,248,131,117
050,29,175,"Missouri","Randolph County",2,20,248,134,114
050,29,175,"Missouri","Randolph County",2,21,285,158,127
050,29,175,"Missouri","Randolph County",2,22,311,172,139
050,29,175,"Missouri","Randolph County",2,23,338,188,150
050,29,175,"Missouri","Randolph County",2,24,344,198,146
050,29,175,"Missouri","Randolph County",2,25,331,185,146
050,29,175,"Missouri","Randolph County",2,26,337,186,151
050,29,175,"Missouri","Randolph County",2,27,344,192,152
050,29,175,"Missouri","Randolph County",2,28,337,187,150
050,29,175,"Missouri","Randolph County",2,29,353,197,156
050,29,175,"Missouri","Randolph County",2,30,345,197,148
050,29,175,"Missouri","Randolph County",2,31,347,197,150
050,29,175,"Missouri","Randolph County",2,32,321,183,138
050,29,175,"Missouri","Randolph County",2,33,321,187,134
050,29,175,"Missouri","Randolph County",2,34,338,193,145
050,29,175,"Missouri","Randolph County",2,35,325,192,133
050,29,175,"Missouri","Randolph County",2,36,297,177,120
050,29,175,"Missouri","Randolph County",2,37,317,178,139
050,29,175,"Missouri","Randolph County",2,38,332,176,156
050,29,175,"Missouri","Randolph County",2,39,315,164,151
050,29,175,"Missouri","Randolph County",2,40,324,172,152
050,29,175,"Missouri","Randolph County",2,41,308,171,137
050,29,175,"Missouri","Randolph County",2,42,302,174,128
050,29,175,"Missouri","Randolph County",2,43,325,184,141
050,29,175,"Missouri","Randolph County",2,44,297,167,130
050,29,175,"Missouri","Randolph County",2,45,294,171,123
050,29,175,"Missouri","Randolph County",2,46,286,153,133
050,29,175,"Missouri","Randolph County",2,47,299,165,134
050,29,175,"Missouri","Randolph County",2,48,322,182,140
050,29,175,"Missouri","Randolph County",2,49,342,189,153
050,29,175,"Missouri","Randolph County",2,50,342,188,154
050,29,175,"Missouri","Randolph County",2,51,343,177,166
050,29,175,"Missouri","Randolph County",2,52,309,154,155
050,29,175,"Missouri","Randolph County",2,53,290,145,145
050,29,175,"Missouri","Randolph County",2,54,304,156,148
050,29,175,"Missouri","Randolph County",2,55,319,172,147
050,29,175,"Missouri","Randolph County",2,56,331,183,148
050,29,175,"Missouri","Randolph County",2,57,348,194,154
050,29,175,"Missouri","Randolph County",2,58,355,190,165
050,29,175,"Missouri","Randolph County",2,59,346,174,172
050,29,175,"Missouri","Randolph County",2,60,327,162,165
050,29,175,"Missouri","Randolph County",2,61,306,152,154
050,29,175,"Missouri","Randolph County",2,62,311,154,157
050,29,175,"Missouri","Randolph County",2,63,297,143,154
050,29,175,"Missouri","Randolph County",2,64,276,137,139
050,29,175,"Missouri","Randolph County",2,65,272,136,136
050,29,175,"Missouri","Randolph County",2,66,274,135,139
050,29,175,"Missouri","Randolph County",2,67,268,124,144
050,29,175,"Missouri","Randolph County",2,68,268,126,142
050,29,175,"Missouri","Randolph County",2,69,265,136,129
050,29,175,"Missouri","Randolph County",2,70,246,121,125
050,29,175,"Missouri","Randolph County",2,71,219,103,116
050,29,175,"Missouri","Randolph County",2,72,199,87,112
050,29,175,"Missouri","Randolph County",2,73,224,113,111
050,29,175,"Missouri","Randolph County",2,74,170,78,92
050,29,175,"Missouri","Randolph County",2,75,159,69,90
050,29,175,"Missouri","Randolph County",2,76,155,68,87
050,29,175,"Missouri","Randolph County",2,77,163,75,88
050,29,175,"Missouri","Randolph County",2,78,139,66,73
050,29,175,"Missouri","Randolph County",2,79,128,59,69
050,29,175,"Missouri","Randolph County",2,80,121,53,68
050,29,175,"Missouri","Randolph County",2,81,107,41,66
050,29,175,"Missouri","Randolph County",2,82,92,31,61
050,29,175,"Missouri","Randolph County",2,83,95,37,58
050,29,175,"Missouri","Randolph County",2,84,83,38,45
050,29,175,"Missouri","Randolph County",2,85,507,155,352
050,29,175,"Missouri","Randolph County",3,0,267,131,136
050,29,175,"Missouri","Randolph County",3,1,284,147,137
050,29,175,"Missouri","Randolph County",3,2,313,153,160
050,29,175,"Missouri","Randolph County",3,3,306,152,154
050,29,175,"Missouri","Randolph County",3,4,282,139,143
050,29,175,"Missouri","Randolph County",3,5,287,154,133
050,29,175,"Missouri","Randolph County",3,6,265,141,124
050,29,175,"Missouri","Randolph County",3,7,291,149,142
050,29,175,"Missouri","Randolph County",3,8,288,152,136
050,29,175,"Missouri","Randolph County",3,9,275,149,126
050,29,175,"Missouri","Randolph County",3,10,301,148,153
050,29,175,"Missouri","Randolph County",3,11,304,164,140
050,29,175,"Missouri","Randolph County",3,12,321,168,153
050,29,175,"Missouri","Randolph County",3,13,328,169,159
050,29,175,"Missouri","Randolph County",3,14,324,160,164
050,29,175,"Missouri","Randolph County",3,15,318,164,154
050,29,175,"Missouri","Randolph County",3,16,304,158,146
050,29,175,"Missouri","Randolph County",3,17,314,173,141
050,29,175,"Missouri","Randolph County",3,18,286,154,132
050,29,175,"Missouri","Randolph County",3,19,260,129,131
050,29,175,"Missouri","Randolph County",3,20,267,149,118
050,29,175,"Missouri","Randolph County",3,21,279,156,123
050,29,175,"Missouri","Randolph County",3,22,290,158,132
050,29,175,"Missouri","Randolph County",3,23,332,188,144
050,29,175,"Missouri","Randolph County",3,24,330,193,137
050,29,175,"Missouri","Randolph County",3,25,349,198,151
050,29,175,"Missouri","Randolph County",3,26,343,198,145
050,29,175,"Missouri","Randolph County",3,27,350,197,153
050,29,175,"Missouri","Randolph County",3,28,329,185,144
050,29,175,"Missouri","Randolph County",3,29,353,203,150
050,29,175,"Missouri","Randolph County",3,30,345,197,148
050,29,175,"Missouri","Randolph County",3,31,340,198,142
050,29,175,"Missouri","Randolph County",3,32,345,196,149
050,29,175,"Missouri","Randolph County",3,33,336,202,134
050,29,175,"Missouri","Randolph County",3,34,329,192,137
050,29,175,"Missouri","Randolph County",3,35,333,185,148
050,29,175,"Missouri","Randolph County",3,36,335,197,138
050,29,175,"Missouri","Randolph County",3,37,309,175,134
050,29,175,"Missouri","Randolph County",3,38,303,167,136
050,29,175,"Missouri","Randolph County",3,39,334,181,153
050,29,175,"Missouri","Randolph County",3,40,323,168,155
050,29,175,"Missouri","Randolph County",3,41,333,177,156
050,29,175,"Missouri","Randolph County",3,42,316,180,136
050,29,175,"Missouri","Randolph County",3,43,313,185,128
050,29,175,"Missouri","Randolph County",3,44,329,190,139
050,29,175,"Missouri","Randolph County",3,45,299,172,127
050,29,175,"Missouri","Randolph County",3,46,284,163,121
050,29,175,"Missouri","Randolph County",3,47,290,154,136
050,29,175,"Missouri","Randolph County",3,48,304,176,128
050,29,175,"Missouri","Randolph County",3,49,337,195,142
050,29,175,"Missouri","Randolph County",3,50,310,173,137
050,29,175,"Missouri","Randolph County",3,51,352,196,156
050,29,175,"Missouri","Randolph County",3,52,343,182,161
050,29,175,"Missouri","Randolph County",3,53,298,142,156
050,29,175,"Missouri","Randolph County",3,54,294,152,142
050,29,175,"Missouri","Randolph County",3,55,299,151,148
050,29,175,"Missouri","Randolph County",3,56,312,168,144
050,29,175,"Missouri","Randolph County",3,57,322,175,147
050,29,175,"Missouri","Randolph County",3,58,356,199,157
050,29,175,"Missouri","Randolph County",3,59,348,178,170
050,29,175,"Missouri","Randolph County",3,60,337,169,168
050,29,175,"Missouri","Randolph County",3,61,318,157,161
050,29,175,"Missouri","Randolph County",3,62,310,152,158
050,29,175,"Missouri","Randolph County",3,63,306,147,159
050,29,175,"Missouri","Randolph County",3,64,286,141,145
050,29,175,"Missouri","Randolph County",3,65,266,131,135
050,29,175,"Missouri","Randolph County",3,66,274,142,132
050,29,175,"Missouri","Randolph County",3,67,263,130,133
050,29,175,"Missouri","Randolph County",3,68,259,114,145
050,29,175,"Missouri","Randolph County",3,69,260,120,140
050,29,175,"Missouri","Randolph County",3,70,255,128,127
050,29,175,"Missouri","Randolph County",3,71,234,112,122
050,29,175,"Missouri","Randolph County",3,72,217,101,116
050,29,175,"Missouri","Randolph County",3,73,186,81,105
050,29,175,"Missouri","Randolph County",3,74,221,109,112
050,29,175,"Missouri","Randolph County",3,75,170,78,92
050,29,175,"Missouri","Randolph County",3,76,150,65,85
050,29,175,"Missouri","Randolph County",3,77,152,68,84
050,29,175,"Missouri","Randolph County",3,78,153,71,82
050,29,175,"Missouri","Randolph County",3,79,129,63,66
050,29,175,"Missouri","Randolph County",3,80,124,57,67
050,29,175,"Missouri","Randolph County",3,81,116,51,65
050,29,175,"Missouri","Randolph County",3,82,91,34,57
050,29,175,"Missouri","Randolph County",3,83,92,24,68
050,29,175,"Missouri","Randolph County",3,84,78,33,45
050,29,175,"Missouri","Randolph County",3,85,505,156,349
050,29,175,"Missouri","Randolph County",4,0,281,144,137
050,29,175,"Missouri","Randolph County",4,1,290,142,148
050,29,175,"Missouri","Randolph County",4,2,305,160,145
050,29,175,"Missouri","Randolph County",4,3,302,141,161
050,29,175,"Missouri","Randolph County",4,4,311,159,152
050,29,175,"Missouri","Randolph County",4,5,274,133,141
050,29,175,"Missouri","Randolph County",4,6,283,153,130
050,29,175,"Missouri","Randolph County",4,7,271,144,127
050,29,175,"Missouri","Randolph County",4,8,298,156,142
050,29,175,"Missouri","Randolph County",4,9,292,154,138
050,29,175,"Missouri","Randolph County",4,10,292,154,138
050,29,175,"Missouri","Randolph County",4,11,306,153,153
050,29,175,"Missouri","Randolph County",4,12,316,165,151
050,29,175,"Missouri","Randolph County",4,13,334,171,163
050,29,175,"Missouri","Randolph County",4,14,325,169,156
050,29,175,"Missouri","Randolph County",4,15,332,160,172
050,29,175,"Missouri","Randolph County",4,16,312,158,154
050,29,175,"Missouri","Randolph County",4,17,316,167,149
050,29,175,"Missouri","Randolph County",4,18,290,165,125
050,29,175,"Missouri","Randolph County",4,19,228,122,106
050,29,175,"Missouri","Randolph County",4,20,263,140,123
050,29,175,"Missouri","Randolph County",4,21,283,157,126
050,29,175,"Missouri","Randolph County",4,22,290,164,126
050,29,175,"Missouri","Randolph County",4,23,306,173,133
050,29,175,"Missouri","Randolph County",4,24,335,197,138
050,29,175,"Missouri","Randolph County",4,25,331,193,138
050,29,175,"Missouri","Randolph County",4,26,368,218,150
050,29,175,"Missouri","Randolph County",4,27,352,204,148
050,29,175,"Missouri","Randolph County",4,28,332,180,152
050,29,175,"Missouri","Randolph County",4,29,331,190,141
050,29,175,"Missouri","Randolph County",4,30,345,199,146
050,29,175,"Missouri","Randolph County",4,31,334,194,140
050,29,175,"Missouri","Randolph County",4,32,335,187,148
050,29,175,"Missouri","Randolph County",4,33,351,207,144
050,29,175,"Missouri","Randolph County",4,34,332,196,136
050,29,175,"Missouri","Randolph County",4,35,336,194,142
050,29,175,"Missouri","Randolph County",4,36,336,190,146
050,29,175,"Missouri","Randolph County",4,37,338,195,143
050,29,175,"Missouri","Randolph County",4,38,299,167,132
050,29,175,"Missouri","Randolph County",4,39,319,172,147
050,29,175,"Missouri","Randolph County",4,40,350,193,157
050,29,175,"Missouri","Randolph County",4,41,316,159,157
050,29,175,"Missouri","Randolph County",4,42,347,193,154
050,29,175,"Missouri","Randolph County",4,43,327,186,141
050,29,175,"Missouri","Randolph County",4,44,313,185,128
050,29,175,"Missouri","Randolph County",4,45,334,194,140
050,29,175,"Missouri","Randolph County",4,46,302,165,137
050,29,175,"Missouri","Randolph County",4,47,299,171,128
050,29,175,"Missouri","Randolph County",4,48,297,163,134
050,29,175,"Missouri","Randolph County",4,49,305,172,133
050,29,175,"Missouri","Randolph County",4,50,308,176,132
050,29,175,"Missouri","Randolph County",4,51,310,169,141
050,29,175,"Missouri","Randolph County",4,52,351,200,151
050,29,175,"Missouri","Randolph County",4,53,326,173,153
050,29,175,"Missouri","Randolph County",4,54,297,142,155
050,29,175,"Missouri","Randolph County",4,55,290,148,142
050,29,175,"Missouri","Randolph County",4,56,293,150,143
050,29,175,"Missouri","Randolph County",4,57,308,163,145
050,29,175,"Missouri","Randolph County",4,58,325,178,147
050,29,175,"Missouri","Randolph County",4,59,353,196,157
050,29,175,"Missouri","Randolph County",4,60,335,169,166
050,29,175,"Missouri","Randolph County",4,61,333,171,162
050,29,175,"Missouri","Randolph County",4,62,318,157,161
050,29,175,"Missouri","Randolph County",4,63,295,145,150
050,29,175,"Missouri","Randolph County",4,64,297,144,153
050,29,175,"Missouri","Randolph County",4,65,280,131,149
050,29,175,"Missouri","Randolph County",4,66,271,135,136
050,29,175,"Missouri","Randolph County",4,67,264,135,129
050,29,175,"Missouri","Randolph County",4,68,252,122,130
050,29,175,"Missouri","Randolph County",4,69,251,109,142
050,29,175,"Missouri","Randolph County",4,70,253,115,138
050,29,175,"Missouri","Randolph County",4,71,239,120,119
050,29,175,"Missouri","Randolph County",4,72,228,109,119
050,29,175,"Missouri","Randolph County",4,73,210,99,111
050,29,175,"Missouri","Randolph County",4,74,177,72,105
050,29,175,"Missouri","Randolph County",4,75,217,108,109
050,29,175,"Missouri","Randolph County",4,76,155,70,85
050,29,175,"Missouri","Randolph County",4,77,144,63,81
050,29,175,"Missouri","Randolph County",4,78,146,64,82
050,29,175,"Missouri","Randolph County",4,79,139,64,75
050,29,175,"Missouri","Randolph County",4,80,127,61,66
050,29,175,"Missouri","Randolph County",4,81,116,52,64
050,29,175,"Missouri","Randolph County",4,82,100,43,57
050,29,175,"Missouri","Randolph County",4,83,85,31,54
050,29,175,"Missouri","Randolph County",4,84,75,20,55
050,29,175,"Missouri","Randolph County",4,85,494,159,335
050,29,175,"Missouri","Randolph County",5,0,280,143,137
050,29,175,"Missouri","Randolph County",5,1,288,138,150
050,29,175,"Missouri","Randolph County",5,2,288,134,154
050,29,175,"Missouri","Randolph County",5,3,291,146,145
050,29,175,"Missouri","Randolph County",5,4,306,148,158
050,29,175,"Missouri","Randolph County",5,5,311,160,151
050,29,175,"Missouri","Randolph County",5,6,291,140,151
050,29,175,"Missouri","Randolph County",5,7,287,153,134
050,29,175,"Missouri","Randolph County",5,8,274,141,133
050,29,175,"Missouri","Randolph County",5,9,282,153,129
050,29,175,"Missouri","Randolph County",5,10,291,157,134
050,29,175,"Missouri","Randolph County",5,11,280,151,129
050,29,175,"Missouri","Randolph County",5,12,308,149,159
050,29,175,"Missouri","Randolph County",5,13,317,164,153
050,29,175,"Missouri","Randolph County",5,14,327,171,156
050,29,175,"Missouri","Randolph County",5,15,324,165,159
050,29,175,"Missouri","Randolph County",5,16,326,160,166
050,29,175,"Missouri","Randolph County",5,17,314,162,152
050,29,175,"Missouri","Randolph County",5,18,269,141,128
050,29,175,"Missouri","Randolph County",5,19,236,135,101
050,29,175,"Missouri","Randolph County",5,20,249,138,111
050,29,175,"Missouri","Randolph County",5,21,273,146,127
050,29,175,"Missouri","Randolph County",5,22,300,157,143
050,29,175,"Missouri","Randolph County",5,23,295,168,127
050,29,175,"Missouri","Randolph County",5,24,296,158,138
050,29,175,"Missouri","Randolph County",5,25,329,188,141
050,29,175,"Missouri","Randolph County",5,26,336,191,145
050,29,175,"Missouri","Randolph County",5,27,361,201,160
050,29,175,"Missouri","Randolph County",5,28,316,166,150
050,29,175,"Missouri","Randolph County",5,29,322,178,144
050,29,175,"Missouri","Randolph County",5,30,311,171,140
050,29,175,"Missouri","Randolph County",5,31,341,197,144
050,29,175,"Missouri","Randolph County",5,32,319,174,145
050,29,175,"Missouri","Randolph County",5,33,332,179,153
050,29,175,"Missouri","Randolph County",5,34,326,190,136
050,29,175,"Missouri","Randolph County",5,35,309,174,135
050,29,175,"Missouri","Randolph County",5,36,300,159,141
050,29,175,"Missouri","Randolph County",5,37,319,173,146
050,29,175,"Missouri","Randolph County",5,38,305,170,135
050,29,175,"Missouri","Randolph County",5,39,296,162,134
050,29,175,"Missouri","Randolph County",5,40,302,159,143
050,29,175,"Missouri","Randolph County",5,41,325,176,149
050,29,175,"Missouri","Randolph County",5,42,304,154,150
050,29,175,"Missouri","Randolph County",5,43,336,184,152
050,29,175,"Missouri","Randolph County",5,44,308,166,142
050,29,175,"Missouri","Randolph County",5,45,308,180,128
050,29,175,"Missouri","Randolph County",5,46,319,179,140
050,29,175,"Missouri","Randolph County",5,47,298,159,139
050,29,175,"Missouri","Randolph County",5,48,292,165,127
050,29,175,"Missouri","Randolph County",5,49,294,146,148
050,29,175,"Missouri","Randolph County",5,50,277,150,127
050,29,175,"Missouri","Randolph County",5,51,301,165,136
050,29,175,"Missouri","Randolph County",5,52,313,171,142
050,29,175,"Missouri","Randolph County",5,53,333,186,147
050,29,175,"Missouri","Randolph County",5,54,334,176,158
050,29,175,"Missouri","Randolph County",5,55,282,131,151
050,29,175,"Missouri","Randolph County",5,56,286,144,142
050,29,175,"Missouri","Randolph County",5,57,279,137,142
050,29,175,"Missouri","Randolph County",5,58,315,171,144
050,29,175,"Missouri","Randolph County",5,59,314,166,148
050,29,175,"Missouri","Randolph County",5,60,339,189,150
050,29,175,"Missouri","Randolph County",5,61,323,162,161
050,29,175,"Missouri","Randolph County",5,62,335,165,170
050,29,175,"Missouri","Randolph County",5,63,310,152,158
050,29,175,"Missouri","Randolph County",5,64,279,139,140
050,29,175,"Missouri","Randolph County",5,65,284,136,148
050,29,175,"Missouri","Randolph County",5,66,283,132,151
050,29,175,"Missouri","Randolph County",5,67,260,128,132
050,29,175,"Missouri","Randolph County",5,68,258,129,129
050,29,175,"Missouri","Randolph County",5,69,250,119,131
050,29,175,"Missouri","Randolph County",5,70,241,106,135
050,29,175,"Missouri","Randolph County",5,71,246,113,133
050,29,175,"Missouri","Randolph County",5,72,234,116,118
050,29,175,"Missouri","Randolph County",5,73,216,107,109
050,29,175,"Missouri","Randolph County",5,74,195,89,106
050,29,175,"Missouri","Randolph County",5,75,172,71,101
050,29,175,"Missouri","Randolph County",5,76,199,98,101
050,29,175,"Missouri","Randolph County",5,77,155,70,85
050,29,175,"Missouri","Randolph County",5,78,136,61,75
050,29,175,"Missouri","Randolph County",5,79,135,57,78
050,29,175,"Missouri","Randolph County",5,80,137,62,75
050,29,175,"Missouri","Randolph County",5,81,111,55,56
050,29,175,"Missouri","Randolph County",5,82,105,47,58
050,29,175,"Missouri","Randolph County",5,83,91,35,56
050,29,175,"Missouri","Randolph County",5,84,69,27,42
050,29,175,"Missouri","Randolph County",5,85,501,154,347
050,29,177,"Missouri","Ray County",1,0,260,132,128
050,29,177,"Missouri","Ray County",1,1,277,141,136
050,29,177,"Missouri","Ray County",1,2,253,126,127
050,29,177,"Missouri","Ray County",1,3,277,149,128
050,29,177,"Missouri","Ray County",1,4,261,139,122
050,29,177,"Missouri","Ray County",1,5,281,148,133
050,29,177,"Missouri","Ray County",1,6,263,136,127
050,29,177,"Missouri","Ray County",1,7,277,128,149
050,29,177,"Missouri","Ray County",1,8,290,149,141
050,29,177,"Missouri","Ray County",1,9,297,161,136
050,29,177,"Missouri","Ray County",1,10,305,161,144
050,29,177,"Missouri","Ray County",1,11,324,167,157
050,29,177,"Missouri","Ray County",1,12,324,158,166
050,29,177,"Missouri","Ray County",1,13,325,149,176
050,29,177,"Missouri","Ray County",1,14,295,148,147
050,29,177,"Missouri","Ray County",1,15,304,157,147
050,29,177,"Missouri","Ray County",1,16,325,177,148
050,29,177,"Missouri","Ray County",1,17,329,184,145
050,29,177,"Missouri","Ray County",1,18,280,163,117
050,29,177,"Missouri","Ray County",1,19,215,115,100
050,29,177,"Missouri","Ray County",1,20,211,112,99
050,29,177,"Missouri","Ray County",1,21,231,116,115
050,29,177,"Missouri","Ray County",1,22,252,130,122
050,29,177,"Missouri","Ray County",1,23,267,138,129
050,29,177,"Missouri","Ray County",1,24,259,139,120
050,29,177,"Missouri","Ray County",1,25,250,133,117
050,29,177,"Missouri","Ray County",1,26,264,139,125
050,29,177,"Missouri","Ray County",1,27,258,136,122
050,29,177,"Missouri","Ray County",1,28,241,116,125
050,29,177,"Missouri","Ray County",1,29,270,127,143
050,29,177,"Missouri","Ray County",1,30,289,149,140
050,29,177,"Missouri","Ray County",1,31,240,117,123
050,29,177,"Missouri","Ray County",1,32,249,136,113
050,29,177,"Missouri","Ray County",1,33,269,132,137
050,29,177,"Missouri","Ray County",1,34,269,136,133
050,29,177,"Missouri","Ray County",1,35,241,126,115
050,29,177,"Missouri","Ray County",1,36,234,124,110
050,29,177,"Missouri","Ray County",1,37,270,141,129
050,29,177,"Missouri","Ray County",1,38,273,141,132
050,29,177,"Missouri","Ray County",1,39,280,139,141
050,29,177,"Missouri","Ray County",1,40,295,150,145
050,29,177,"Missouri","Ray County",1,41,287,146,141
050,29,177,"Missouri","Ray County",1,42,287,142,145
050,29,177,"Missouri","Ray County",1,43,284,144,140
050,29,177,"Missouri","Ray County",1,44,255,127,128
050,29,177,"Missouri","Ray County",1,45,261,135,126
050,29,177,"Missouri","Ray County",1,46,264,134,130
050,29,177,"Missouri","Ray County",1,47,288,146,142
050,29,177,"Missouri","Ray County",1,48,302,164,138
050,29,177,"Missouri","Ray County",1,49,322,170,152
050,29,177,"Missouri","Ray County",1,50,293,158,135
050,29,177,"Missouri","Ray County",1,51,295,156,139
050,29,177,"Missouri","Ray County",1,52,307,146,161
050,29,177,"Missouri","Ray County",1,53,320,154,166
050,29,177,"Missouri","Ray County",1,54,324,158,166
050,29,177,"Missouri","Ray County",1,55,340,167,173
050,29,177,"Missouri","Ray County",1,56,366,188,178
050,29,177,"Missouri","Ray County",1,57,367,195,172
050,29,177,"Missouri","Ray County",1,58,373,200,173
050,29,177,"Missouri","Ray County",1,59,349,177,172
050,29,177,"Missouri","Ray County",1,60,350,178,172
050,29,177,"Missouri","Ray County",1,61,387,195,192
050,29,177,"Missouri","Ray County",1,62,376,188,188
050,29,177,"Missouri","Ray County",1,63,361,183,178
050,29,177,"Missouri","Ray County",1,64,337,162,175
050,29,177,"Missouri","Ray County",1,65,287,142,145
050,29,177,"Missouri","Ray County",1,66,279,140,139
050,29,177,"Missouri","Ray County",1,67,286,144,142
050,29,177,"Missouri","Ray County",1,68,280,139,141
050,29,177,"Missouri","Ray County",1,69,243,123,120
050,29,177,"Missouri","Ray County",1,70,243,115,128
050,29,177,"Missouri","Ray County",1,71,222,101,121
050,29,177,"Missouri","Ray County",1,72,228,94,134
050,29,177,"Missouri","Ray County",1,73,245,111,134
050,29,177,"Missouri","Ray County",1,74,178,83,95
050,29,177,"Missouri","Ray County",1,75,172,86,86
050,29,177,"Missouri","Ray County",1,76,161,73,88
050,29,177,"Missouri","Ray County",1,77,189,90,99
050,29,177,"Missouri","Ray County",1,78,176,72,104
050,29,177,"Missouri","Ray County",1,79,151,62,89
050,29,177,"Missouri","Ray County",1,80,122,52,70
050,29,177,"Missouri","Ray County",1,81,118,58,60
050,29,177,"Missouri","Ray County",1,82,99,47,52
050,29,177,"Missouri","Ray County",1,83,84,37,47
050,29,177,"Missouri","Ray County",1,84,77,30,47
050,29,177,"Missouri","Ray County",1,85,452,165,287
050,29,177,"Missouri","Ray County",2,0,264,135,129
050,29,177,"Missouri","Ray County",2,1,270,137,133
050,29,177,"Missouri","Ray County",2,2,261,131,130
050,29,177,"Missouri","Ray County",2,3,269,143,126
050,29,177,"Missouri","Ray County",2,4,268,144,124
050,29,177,"Missouri","Ray County",2,5,278,147,131
050,29,177,"Missouri","Ray County",2,6,268,138,130
050,29,177,"Missouri","Ray County",2,7,273,129,144
050,29,177,"Missouri","Ray County",2,8,284,142,142
050,29,177,"Missouri","Ray County",2,9,294,157,137
050,29,177,"Missouri","Ray County",2,10,304,161,143
050,29,177,"Missouri","Ray County",2,11,319,165,154
050,29,177,"Missouri","Ray County",2,12,327,163,164
050,29,177,"Missouri","Ray County",2,13,322,151,171
050,29,177,"Missouri","Ray County",2,14,300,147,153
050,29,177,"Missouri","Ray County",2,15,300,153,147
050,29,177,"Missouri","Ray County",2,16,321,174,147
050,29,177,"Missouri","Ray County",2,17,326,182,144
050,29,177,"Missouri","Ray County",2,18,277,161,116
050,29,177,"Missouri","Ray County",2,19,215,118,97
050,29,177,"Missouri","Ray County",2,20,217,114,103
050,29,177,"Missouri","Ray County",2,21,232,117,115
050,29,177,"Missouri","Ray County",2,22,251,129,122
050,29,177,"Missouri","Ray County",2,23,267,137,130
050,29,177,"Missouri","Ray County",2,24,259,137,122
050,29,177,"Missouri","Ray County",2,25,251,134,117
050,29,177,"Missouri","Ray County",2,26,259,137,122
050,29,177,"Missouri","Ray County",2,27,254,134,120
050,29,177,"Missouri","Ray County",2,28,243,119,124
050,29,177,"Missouri","Ray County",2,29,264,126,138
050,29,177,"Missouri","Ray County",2,30,283,142,141
050,29,177,"Missouri","Ray County",2,31,251,124,127
050,29,177,"Missouri","Ray County",2,32,248,133,115
050,29,177,"Missouri","Ray County",2,33,268,134,134
050,29,177,"Missouri","Ray County",2,34,270,136,134
050,29,177,"Missouri","Ray County",2,35,252,131,121
050,29,177,"Missouri","Ray County",2,36,235,125,110
050,29,177,"Missouri","Ray County",2,37,262,137,125
050,29,177,"Missouri","Ray County",2,38,274,143,131
050,29,177,"Missouri","Ray County",2,39,279,140,139
050,29,177,"Missouri","Ray County",2,40,293,149,144
050,29,177,"Missouri","Ray County",2,41,293,149,144
050,29,177,"Missouri","Ray County",2,42,288,143,145
050,29,177,"Missouri","Ray County",2,43,290,144,146
050,29,177,"Missouri","Ray County",2,44,258,129,129
050,29,177,"Missouri","Ray County",2,45,261,135,126
050,29,177,"Missouri","Ray County",2,46,264,135,129
050,29,177,"Missouri","Ray County",2,47,282,143,139
050,29,177,"Missouri","Ray County",2,48,301,160,141
050,29,177,"Missouri","Ray County",2,49,320,169,151
050,29,177,"Missouri","Ray County",2,50,302,162,140
050,29,177,"Missouri","Ray County",2,51,297,158,139
050,29,177,"Missouri","Ray County",2,52,301,147,154
050,29,177,"Missouri","Ray County",2,53,314,149,165
050,29,177,"Missouri","Ray County",2,54,320,157,163
050,29,177,"Missouri","Ray County",2,55,333,164,169
050,29,177,"Missouri","Ray County",2,56,357,180,177
050,29,177,"Missouri","Ray County",2,57,365,193,172
050,29,177,"Missouri","Ray County",2,58,367,196,171
050,29,177,"Missouri","Ray County",2,59,357,183,174
050,29,177,"Missouri","Ray County",2,60,348,177,171
050,29,177,"Missouri","Ray County",2,61,374,189,185
050,29,177,"Missouri","Ray County",2,62,377,189,188
050,29,177,"Missouri","Ray County",2,63,368,186,182
050,29,177,"Missouri","Ray County",2,64,334,162,172
050,29,177,"Missouri","Ray County",2,65,296,145,151
050,29,177,"Missouri","Ray County",2,66,279,140,139
050,29,177,"Missouri","Ray County",2,67,283,142,141
050,29,177,"Missouri","Ray County",2,68,276,136,140
050,29,177,"Missouri","Ray County",2,69,254,128,126
050,29,177,"Missouri","Ray County",2,70,240,115,125
050,29,177,"Missouri","Ray County",2,71,226,105,121
050,29,177,"Missouri","Ray County",2,72,219,92,127
050,29,177,"Missouri","Ray County",2,73,252,112,140
050,29,177,"Missouri","Ray County",2,74,181,84,97
050,29,177,"Missouri","Ray County",2,75,174,84,90
050,29,177,"Missouri","Ray County",2,76,159,74,85
050,29,177,"Missouri","Ray County",2,77,185,87,98
050,29,177,"Missouri","Ray County",2,78,173,72,101
050,29,177,"Missouri","Ray County",2,79,153,62,91
050,29,177,"Missouri","Ray County",2,80,128,54,74
050,29,177,"Missouri","Ray County",2,81,116,54,62
050,29,177,"Missouri","Ray County",2,82,104,50,54
050,29,177,"Missouri","Ray County",2,83,85,38,47
050,29,177,"Missouri","Ray County",2,84,79,32,47
050,29,177,"Missouri","Ray County",2,85,448,166,282
050,29,177,"Missouri","Ray County",3,0,271,138,133
050,29,177,"Missouri","Ray County",3,1,259,141,118
050,29,177,"Missouri","Ray County",3,2,258,132,126
050,29,177,"Missouri","Ray County",3,3,262,127,135
050,29,177,"Missouri","Ray County",3,4,275,143,132
050,29,177,"Missouri","Ray County",3,5,269,140,129
050,29,177,"Missouri","Ray County",3,6,287,143,144
050,29,177,"Missouri","Ray County",3,7,284,149,135
050,29,177,"Missouri","Ray County",3,8,282,135,147
050,29,177,"Missouri","Ray County",3,9,293,143,150
050,29,177,"Missouri","Ray County",3,10,296,151,145
050,29,177,"Missouri","Ray County",3,11,299,165,134
050,29,177,"Missouri","Ray County",3,12,329,179,150
050,29,177,"Missouri","Ray County",3,13,326,160,166
050,29,177,"Missouri","Ray County",3,14,323,154,169
050,29,177,"Missouri","Ray County",3,15,303,142,161
050,29,177,"Missouri","Ray County",3,16,299,150,149
050,29,177,"Missouri","Ray County",3,17,313,172,141
050,29,177,"Missouri","Ray County",3,18,265,149,116
050,29,177,"Missouri","Ray County",3,19,219,131,88
050,29,177,"Missouri","Ray County",3,20,226,119,107
050,29,177,"Missouri","Ray County",3,21,228,117,111
050,29,177,"Missouri","Ray County",3,22,240,120,120
050,29,177,"Missouri","Ray County",3,23,260,139,121
050,29,177,"Missouri","Ray County",3,24,267,140,127
050,29,177,"Missouri","Ray County",3,25,259,136,123
050,29,177,"Missouri","Ray County",3,26,232,122,110
050,29,177,"Missouri","Ray County",3,27,258,139,119
050,29,177,"Missouri","Ray County",3,28,248,126,122
050,29,177,"Missouri","Ray County",3,29,244,120,124
050,29,177,"Missouri","Ray County",3,30,271,134,137
050,29,177,"Missouri","Ray County",3,31,281,131,150
050,29,177,"Missouri","Ray County",3,32,248,120,128
050,29,177,"Missouri","Ray County",3,33,251,138,113
050,29,177,"Missouri","Ray County",3,34,272,136,136
050,29,177,"Missouri","Ray County",3,35,273,136,137
050,29,177,"Missouri","Ray County",3,36,260,134,126
050,29,177,"Missouri","Ray County",3,37,238,126,112
050,29,177,"Missouri","Ray County",3,38,267,132,135
050,29,177,"Missouri","Ray County",3,39,284,146,138
050,29,177,"Missouri","Ray County",3,40,278,140,138
050,29,177,"Missouri","Ray County",3,41,300,146,154
050,29,177,"Missouri","Ray County",3,42,303,149,154
050,29,177,"Missouri","Ray County",3,43,286,142,144
050,29,177,"Missouri","Ray County",3,44,287,144,143
050,29,177,"Missouri","Ray County",3,45,251,123,128
050,29,177,"Missouri","Ray County",3,46,275,142,133
050,29,177,"Missouri","Ray County",3,47,266,136,130
050,29,177,"Missouri","Ray County",3,48,280,140,140
050,29,177,"Missouri","Ray County",3,49,293,157,136
050,29,177,"Missouri","Ray County",3,50,310,158,152
050,29,177,"Missouri","Ray County",3,51,298,160,138
050,29,177,"Missouri","Ray County",3,52,293,157,136
050,29,177,"Missouri","Ray County",3,53,296,148,148
050,29,177,"Missouri","Ray County",3,54,310,151,159
050,29,177,"Missouri","Ray County",3,55,309,156,153
050,29,177,"Missouri","Ray County",3,56,331,171,160
050,29,177,"Missouri","Ray County",3,57,364,185,179
050,29,177,"Missouri","Ray County",3,58,371,197,174
050,29,177,"Missouri","Ray County",3,59,377,201,176
050,29,177,"Missouri","Ray County",3,60,354,180,174
050,29,177,"Missouri","Ray County",3,61,347,176,171
050,29,177,"Missouri","Ray County",3,62,364,186,178
050,29,177,"Missouri","Ray County",3,63,374,188,186
050,29,177,"Missouri","Ray County",3,64,373,187,186
050,29,177,"Missouri","Ray County",3,65,331,156,175
050,29,177,"Missouri","Ray County",3,66,283,139,144
050,29,177,"Missouri","Ray County",3,67,273,134,139
050,29,177,"Missouri","Ray County",3,68,275,140,135
050,29,177,"Missouri","Ray County",3,69,268,132,136
050,29,177,"Missouri","Ray County",3,70,252,127,125
050,29,177,"Missouri","Ray County",3,71,240,119,121
050,29,177,"Missouri","Ray County",3,72,211,98,113
050,29,177,"Missouri","Ray County",3,73,212,91,121
050,29,177,"Missouri","Ray County",3,74,238,106,132
050,29,177,"Missouri","Ray County",3,75,169,75,94
050,29,177,"Missouri","Ray County",3,76,162,76,86
050,29,177,"Missouri","Ray County",3,77,156,73,83
050,29,177,"Missouri","Ray County",3,78,175,80,95
050,29,177,"Missouri","Ray County",3,79,161,64,97
050,29,177,"Missouri","Ray County",3,80,139,58,81
050,29,177,"Missouri","Ray County",3,81,116,47,69
050,29,177,"Missouri","Ray County",3,82,106,50,56
050,29,177,"Missouri","Ray County",3,83,90,40,50
050,29,177,"Missouri","Ray County",3,84,76,33,43
050,29,177,"Missouri","Ray County",3,85,447,170,277
050,29,177,"Missouri","Ray County",4,0,249,133,116
050,29,177,"Missouri","Ray County",4,1,287,138,149
050,29,177,"Missouri","Ray County",4,2,259,139,120
050,29,177,"Missouri","Ray County",4,3,264,136,128
050,29,177,"Missouri","Ray County",4,4,289,137,152
050,29,177,"Missouri","Ray County",4,5,289,145,144
050,29,177,"Missouri","Ray County",4,6,269,145,124
050,29,177,"Missouri","Ray County",4,7,283,142,141
050,29,177,"Missouri","Ray County",4,8,294,149,145
050,29,177,"Missouri","Ray County",4,9,287,141,146
050,29,177,"Missouri","Ray County",4,10,286,138,148
050,29,177,"Missouri","Ray County",4,11,297,154,143
050,29,177,"Missouri","Ray County",4,12,318,174,144
050,29,177,"Missouri","Ray County",4,13,334,181,153
050,29,177,"Missouri","Ray County",4,14,331,161,170
050,29,177,"Missouri","Ray County",4,15,324,152,172
050,29,177,"Missouri","Ray County",4,16,306,144,162
050,29,177,"Missouri","Ray County",4,17,295,149,146
050,29,177,"Missouri","Ray County",4,18,269,155,114
050,29,177,"Missouri","Ray County",4,19,196,109,87
050,29,177,"Missouri","Ray County",4,20,225,130,95
050,29,177,"Missouri","Ray County",4,21,243,129,114
050,29,177,"Missouri","Ray County",4,22,249,127,122
050,29,177,"Missouri","Ray County",4,23,264,137,127
050,29,177,"Missouri","Ray County",4,24,268,144,124
050,29,177,"Missouri","Ray County",4,25,267,150,117
050,29,177,"Missouri","Ray County",4,26,262,121,141
050,29,177,"Missouri","Ray County",4,27,251,126,125
050,29,177,"Missouri","Ray County",4,28,255,132,123
050,29,177,"Missouri","Ray County",4,29,254,125,129
050,29,177,"Missouri","Ray County",4,30,256,122,134
050,29,177,"Missouri","Ray County",4,31,291,152,139
050,29,177,"Missouri","Ray County",4,32,272,129,143
050,29,177,"Missouri","Ray County",4,33,251,122,129
050,29,177,"Missouri","Ray County",4,34,250,131,119
050,29,177,"Missouri","Ray County",4,35,277,137,140
050,29,177,"Missouri","Ray County",4,36,268,130,138
050,29,177,"Missouri","Ray County",4,37,276,147,129
050,29,177,"Missouri","Ray County",4,38,241,130,111
050,29,177,"Missouri","Ray County",4,39,267,140,127
050,29,177,"Missouri","Ray County",4,40,281,144,137
050,29,177,"Missouri","Ray County",4,41,282,139,143
050,29,177,"Missouri","Ray County",4,42,295,148,147
050,29,177,"Missouri","Ray County",4,43,301,147,154
050,29,177,"Missouri","Ray County",4,44,282,141,141
050,29,177,"Missouri","Ray County",4,45,293,148,145
050,29,177,"Missouri","Ray County",4,46,266,130,136
050,29,177,"Missouri","Ray County",4,47,280,145,135
050,29,177,"Missouri","Ray County",4,48,268,134,134
050,29,177,"Missouri","Ray County",4,49,271,136,135
050,29,177,"Missouri","Ray County",4,50,289,155,134
050,29,177,"Missouri","Ray County",4,51,311,154,157
050,29,177,"Missouri","Ray County",4,52,298,158,140
050,29,177,"Missouri","Ray County",4,53,296,157,139
050,29,177,"Missouri","Ray County",4,54,303,150,153
050,29,177,"Missouri","Ray County",4,55,311,155,156
050,29,177,"Missouri","Ray County",4,56,313,156,157
050,29,177,"Missouri","Ray County",4,57,326,168,158
050,29,177,"Missouri","Ray County",4,58,354,183,171
050,29,177,"Missouri","Ray County",4,59,362,188,174
050,29,177,"Missouri","Ray County",4,60,376,201,175
050,29,177,"Missouri","Ray County",4,61,352,174,178
050,29,177,"Missouri","Ray County",4,62,345,179,166
050,29,177,"Missouri","Ray County",4,63,361,185,176
050,29,177,"Missouri","Ray County",4,64,359,184,175
050,29,177,"Missouri","Ray County",4,65,371,182,189
050,29,177,"Missouri","Ray County",4,66,319,149,170
050,29,177,"Missouri","Ray County",4,67,271,133,138
050,29,177,"Missouri","Ray County",4,68,262,130,132
050,29,177,"Missouri","Ray County",4,69,259,128,131
050,29,177,"Missouri","Ray County",4,70,258,130,128
050,29,177,"Missouri","Ray County",4,71,245,123,122
050,29,177,"Missouri","Ray County",4,72,218,111,107
050,29,177,"Missouri","Ray County",4,73,196,95,101
050,29,177,"Missouri","Ray County",4,74,205,86,119
050,29,177,"Missouri","Ray County",4,75,225,96,129
050,29,177,"Missouri","Ray County",4,76,151,66,85
050,29,177,"Missouri","Ray County",4,77,160,75,85
050,29,177,"Missouri","Ray County",4,78,147,71,76
050,29,177,"Missouri","Ray County",4,79,163,72,91
050,29,177,"Missouri","Ray County",4,80,145,59,86
050,29,177,"Missouri","Ray County",4,81,125,51,74
050,29,177,"Missouri","Ray County",4,82,100,42,58
050,29,177,"Missouri","Ray County",4,83,90,37,53
050,29,177,"Missouri","Ray County",4,84,82,36,46
050,29,177,"Missouri","Ray County",4,85,441,164,277
050,29,177,"Missouri","Ray County",5,0,243,130,113
050,29,177,"Missouri","Ray County",5,1,264,151,113
050,29,177,"Missouri","Ray County",5,2,276,138,138
050,29,177,"Missouri","Ray County",5,3,281,150,131
050,29,177,"Missouri","Ray County",5,4,277,135,142
050,29,177,"Missouri","Ray County",5,5,282,133,149
050,29,177,"Missouri","Ray County",5,6,300,157,143
050,29,177,"Missouri","Ray County",5,7,278,151,127
050,29,177,"Missouri","Ray County",5,8,291,147,144
050,29,177,"Missouri","Ray County",5,9,311,168,143
050,29,177,"Missouri","Ray County",5,10,299,151,148
050,29,177,"Missouri","Ray County",5,11,283,133,150
050,29,177,"Missouri","Ray County",5,12,297,162,135
050,29,177,"Missouri","Ray County",5,13,320,173,147
050,29,177,"Missouri","Ray County",5,14,339,182,157
050,29,177,"Missouri","Ray County",5,15,328,164,164
050,29,177,"Missouri","Ray County",5,16,333,158,175
050,29,177,"Missouri","Ray County",5,17,303,148,155
050,29,177,"Missouri","Ray County",5,18,250,139,111
050,29,177,"Missouri","Ray County",5,19,211,128,83
050,29,177,"Missouri","Ray County",5,20,212,116,96
050,29,177,"Missouri","Ray County",5,21,227,136,91
050,29,177,"Missouri","Ray County",5,22,249,132,117
050,29,177,"Missouri","Ray County",5,23,253,137,116
050,29,177,"Missouri","Ray County",5,24,262,128,134
050,29,177,"Missouri","Ray County",5,25,268,139,129
050,29,177,"Missouri","Ray County",5,26,266,147,119
050,29,177,"Missouri","Ray County",5,27,256,121,135
050,29,177,"Missouri","Ray County",5,28,250,128,122
050,29,177,"Missouri","Ray County",5,29,251,127,124
050,29,177,"Missouri","Ray County",5,30,261,130,131
050,29,177,"Missouri","Ray County",5,31,265,122,143
050,29,177,"Missouri","Ray County",5,32,288,150,138
050,29,177,"Missouri","Ray County",5,33,263,126,137
050,29,177,"Missouri","Ray County",5,34,261,124,137
050,29,177,"Missouri","Ray County",5,35,245,132,113
050,29,177,"Missouri","Ray County",5,36,278,134,144
050,29,177,"Missouri","Ray County",5,37,280,134,146
050,29,177,"Missouri","Ray County",5,38,281,150,131
050,29,177,"Missouri","Ray County",5,39,247,133,114
050,29,177,"Missouri","Ray County",5,40,268,135,133
050,29,177,"Missouri","Ray County",5,41,293,151,142
050,29,177,"Missouri","Ray County",5,42,279,138,141
050,29,177,"Missouri","Ray County",5,43,307,162,145
050,29,177,"Missouri","Ray County",5,44,307,150,157
050,29,177,"Missouri","Ray County",5,45,287,147,140
050,29,177,"Missouri","Ray County",5,46,300,152,148
050,29,177,"Missouri","Ray County",5,47,269,132,137
050,29,177,"Missouri","Ray County",5,48,279,144,135
050,29,177,"Missouri","Ray County",5,49,266,129,137
050,29,177,"Missouri","Ray County",5,50,263,131,132
050,29,177,"Missouri","Ray County",5,51,292,156,136
050,29,177,"Missouri","Ray County",5,52,310,150,160
050,29,177,"Missouri","Ray County",5,53,288,154,134
050,29,177,"Missouri","Ray County",5,54,309,160,149
050,29,177,"Missouri","Ray County",5,55,294,144,150
050,29,177,"Missouri","Ray County",5,56,311,157,154
050,29,177,"Missouri","Ray County",5,57,311,153,158
050,29,177,"Missouri","Ray County",5,58,315,165,150
050,29,177,"Missouri","Ray County",5,59,353,176,177
050,29,177,"Missouri","Ray County",5,60,360,186,174
050,29,177,"Missouri","Ray County",5,61,374,197,177
050,29,177,"Missouri","Ray County",5,62,338,170,168
050,29,177,"Missouri","Ray County",5,63,347,181,166
050,29,177,"Missouri","Ray County",5,64,351,179,172
050,29,177,"Missouri","Ray County",5,65,352,178,174
050,29,177,"Missouri","Ray County",5,66,364,178,186
050,29,177,"Missouri","Ray County",5,67,320,148,172
050,29,177,"Missouri","Ray County",5,68,259,128,131
050,29,177,"Missouri","Ray County",5,69,256,126,130
050,29,177,"Missouri","Ray County",5,70,263,129,134
050,29,177,"Missouri","Ray County",5,71,263,133,130
050,29,177,"Missouri","Ray County",5,72,231,119,112
050,29,177,"Missouri","Ray County",5,73,208,108,100
050,29,177,"Missouri","Ray County",5,74,187,90,97
050,29,177,"Missouri","Ray County",5,75,202,81,121
050,29,177,"Missouri","Ray County",5,76,209,87,122
050,29,177,"Missouri","Ray County",5,77,144,63,81
050,29,177,"Missouri","Ray County",5,78,153,69,84
050,29,177,"Missouri","Ray County",5,79,138,65,73
050,29,177,"Missouri","Ray County",5,80,150,67,83
050,29,177,"Missouri","Ray County",5,81,134,55,79
050,29,177,"Missouri","Ray County",5,82,112,46,66
050,29,177,"Missouri","Ray County",5,83,96,35,61
050,29,177,"Missouri","Ray County",5,84,86,35,51
050,29,177,"Missouri","Ray County",5,85,455,169,286
050,29,179,"Missouri","Reynolds County",1,0,64,32,32
050,29,179,"Missouri","Reynolds County",1,1,60,28,32
050,29,179,"Missouri","Reynolds County",1,2,48,24,24
050,29,179,"Missouri","Reynolds County",1,3,53,26,27
050,29,179,"Missouri","Reynolds County",1,4,61,29,32
050,29,179,"Missouri","Reynolds County",1,5,63,35,28
050,29,179,"Missouri","Reynolds County",1,6,58,29,29
050,29,179,"Missouri","Reynolds County",1,7,53,27,26
050,29,179,"Missouri","Reynolds County",1,8,63,36,27
050,29,179,"Missouri","Reynolds County",1,9,74,36,38
050,29,179,"Missouri","Reynolds County",1,10,65,31,34
050,29,179,"Missouri","Reynolds County",1,11,70,34,36
050,29,179,"Missouri","Reynolds County",1,12,67,39,28
050,29,179,"Missouri","Reynolds County",1,13,82,49,33
050,29,179,"Missouri","Reynolds County",1,14,76,44,32
050,29,179,"Missouri","Reynolds County",1,15,85,45,40
050,29,179,"Missouri","Reynolds County",1,16,82,54,28
050,29,179,"Missouri","Reynolds County",1,17,87,55,32
050,29,179,"Missouri","Reynolds County",1,18,79,45,34
050,29,179,"Missouri","Reynolds County",1,19,51,30,21
050,29,179,"Missouri","Reynolds County",1,20,51,34,17
050,29,179,"Missouri","Reynolds County",1,21,48,29,19
050,29,179,"Missouri","Reynolds County",1,22,55,30,25
050,29,179,"Missouri","Reynolds County",1,23,45,28,17
050,29,179,"Missouri","Reynolds County",1,24,56,33,23
050,29,179,"Missouri","Reynolds County",1,25,65,34,31
050,29,179,"Missouri","Reynolds County",1,26,62,29,33
050,29,179,"Missouri","Reynolds County",1,27,52,29,23
050,29,179,"Missouri","Reynolds County",1,28,58,31,27
050,29,179,"Missouri","Reynolds County",1,29,68,36,32
050,29,179,"Missouri","Reynolds County",1,30,60,31,29
050,29,179,"Missouri","Reynolds County",1,31,63,35,28
050,29,179,"Missouri","Reynolds County",1,32,65,33,32
050,29,179,"Missouri","Reynolds County",1,33,46,23,23
050,29,179,"Missouri","Reynolds County",1,34,57,25,32
050,29,179,"Missouri","Reynolds County",1,35,62,28,34
050,29,179,"Missouri","Reynolds County",1,36,66,38,28
050,29,179,"Missouri","Reynolds County",1,37,73,43,30
050,29,179,"Missouri","Reynolds County",1,38,77,35,42
050,29,179,"Missouri","Reynolds County",1,39,70,37,33
050,29,179,"Missouri","Reynolds County",1,40,72,37,35
050,29,179,"Missouri","Reynolds County",1,41,68,37,31
050,29,179,"Missouri","Reynolds County",1,42,60,34,26
050,29,179,"Missouri","Reynolds County",1,43,50,23,27
050,29,179,"Missouri","Reynolds County",1,44,57,28,29
050,29,179,"Missouri","Reynolds County",1,45,76,41,35
050,29,179,"Missouri","Reynolds County",1,46,83,39,44
050,29,179,"Missouri","Reynolds County",1,47,78,40,38
050,29,179,"Missouri","Reynolds County",1,48,85,42,43
050,29,179,"Missouri","Reynolds County",1,49,90,43,47
050,29,179,"Missouri","Reynolds County",1,50,65,34,31
050,29,179,"Missouri","Reynolds County",1,51,67,37,30
050,29,179,"Missouri","Reynolds County",1,52,82,43,39
050,29,179,"Missouri","Reynolds County",1,53,79,37,42
050,29,179,"Missouri","Reynolds County",1,54,86,49,37
050,29,179,"Missouri","Reynolds County",1,55,92,57,35
050,29,179,"Missouri","Reynolds County",1,56,100,50,50
050,29,179,"Missouri","Reynolds County",1,57,103,50,53
050,29,179,"Missouri","Reynolds County",1,58,97,54,43
050,29,179,"Missouri","Reynolds County",1,59,109,63,46
050,29,179,"Missouri","Reynolds County",1,60,105,50,55
050,29,179,"Missouri","Reynolds County",1,61,107,60,47
050,29,179,"Missouri","Reynolds County",1,62,104,53,51
050,29,179,"Missouri","Reynolds County",1,63,99,48,51
050,29,179,"Missouri","Reynolds County",1,64,87,40,47
050,29,179,"Missouri","Reynolds County",1,65,82,41,41
050,29,179,"Missouri","Reynolds County",1,66,99,54,45
050,29,179,"Missouri","Reynolds County",1,67,95,48,47
050,29,179,"Missouri","Reynolds County",1,68,79,36,43
050,29,179,"Missouri","Reynolds County",1,69,74,35,39
050,29,179,"Missouri","Reynolds County",1,70,72,39,33
050,29,179,"Missouri","Reynolds County",1,71,72,36,36
050,29,179,"Missouri","Reynolds County",1,72,80,45,35
050,29,179,"Missouri","Reynolds County",1,73,89,56,33
050,29,179,"Missouri","Reynolds County",1,74,62,30,32
050,29,179,"Missouri","Reynolds County",1,75,65,31,34
050,29,179,"Missouri","Reynolds County",1,76,58,31,27
050,29,179,"Missouri","Reynolds County",1,77,46,24,22
050,29,179,"Missouri","Reynolds County",1,78,46,18,28
050,29,179,"Missouri","Reynolds County",1,79,51,21,30
050,29,179,"Missouri","Reynolds County",1,80,43,22,21
050,29,179,"Missouri","Reynolds County",1,81,47,24,23
050,29,179,"Missouri","Reynolds County",1,82,46,28,18
050,29,179,"Missouri","Reynolds County",1,83,31,18,13
050,29,179,"Missouri","Reynolds County",1,84,37,17,20
050,29,179,"Missouri","Reynolds County",1,85,182,74,108
050,29,179,"Missouri","Reynolds County",2,0,67,33,34
050,29,179,"Missouri","Reynolds County",2,1,58,27,31
050,29,179,"Missouri","Reynolds County",2,2,50,24,26
050,29,179,"Missouri","Reynolds County",2,3,51,25,26
050,29,179,"Missouri","Reynolds County",2,4,60,29,31
050,29,179,"Missouri","Reynolds County",2,5,61,33,28
050,29,179,"Missouri","Reynolds County",2,6,57,30,27
050,29,179,"Missouri","Reynolds County",2,7,52,26,26
050,29,179,"Missouri","Reynolds County",2,8,60,33,27
050,29,179,"Missouri","Reynolds County",2,9,72,36,36
050,29,179,"Missouri","Reynolds County",2,10,66,31,35
050,29,179,"Missouri","Reynolds County",2,11,69,34,35
050,29,179,"Missouri","Reynolds County",2,12,69,38,31
050,29,179,"Missouri","Reynolds County",2,13,79,47,32
050,29,179,"Missouri","Reynolds County",2,14,79,46,33
050,29,179,"Missouri","Reynolds County",2,15,83,45,38
050,29,179,"Missouri","Reynolds County",2,16,85,54,31
050,29,179,"Missouri","Reynolds County",2,17,87,56,31
050,29,179,"Missouri","Reynolds County",2,18,76,45,31
050,29,179,"Missouri","Reynolds County",2,19,52,30,22
050,29,179,"Missouri","Reynolds County",2,20,52,33,19
050,29,179,"Missouri","Reynolds County",2,21,49,30,19
050,29,179,"Missouri","Reynolds County",2,22,55,31,24
050,29,179,"Missouri","Reynolds County",2,23,48,29,19
050,29,179,"Missouri","Reynolds County",2,24,54,32,22
050,29,179,"Missouri","Reynolds County",2,25,62,33,29
050,29,179,"Missouri","Reynolds County",2,26,62,30,32
050,29,179,"Missouri","Reynolds County",2,27,54,29,25
050,29,179,"Missouri","Reynolds County",2,28,56,31,25
050,29,179,"Missouri","Reynolds County",2,29,67,35,32
050,29,179,"Missouri","Reynolds County",2,30,62,32,30
050,29,179,"Missouri","Reynolds County",2,31,62,33,29
050,29,179,"Missouri","Reynolds County",2,32,64,33,31
050,29,179,"Missouri","Reynolds County",2,33,51,26,25
050,29,179,"Missouri","Reynolds County",2,34,54,25,29
050,29,179,"Missouri","Reynolds County",2,35,61,28,33
050,29,179,"Missouri","Reynolds County",2,36,64,35,29
050,29,179,"Missouri","Reynolds County",2,37,72,42,30
050,29,179,"Missouri","Reynolds County",2,38,77,37,40
050,29,179,"Missouri","Reynolds County",2,39,71,37,34
050,29,179,"Missouri","Reynolds County",2,40,71,37,34
050,29,179,"Missouri","Reynolds County",2,41,68,36,32
050,29,179,"Missouri","Reynolds County",2,42,62,35,27
050,29,179,"Missouri","Reynolds County",2,43,53,26,27
050,29,179,"Missouri","Reynolds County",2,44,54,26,28
050,29,179,"Missouri","Reynolds County",2,45,72,38,34
050,29,179,"Missouri","Reynolds County",2,46,81,39,42
050,29,179,"Missouri","Reynolds County",2,47,79,40,39
050,29,179,"Missouri","Reynolds County",2,48,84,42,42
050,29,179,"Missouri","Reynolds County",2,49,86,42,44
050,29,179,"Missouri","Reynolds County",2,50,73,37,36
050,29,179,"Missouri","Reynolds County",2,51,66,36,30
050,29,179,"Missouri","Reynolds County",2,52,81,43,38
050,29,179,"Missouri","Reynolds County",2,53,78,38,40
050,29,179,"Missouri","Reynolds County",2,54,84,46,38
050,29,179,"Missouri","Reynolds County",2,55,91,55,36
050,29,179,"Missouri","Reynolds County",2,56,99,53,46
050,29,179,"Missouri","Reynolds County",2,57,103,50,53
050,29,179,"Missouri","Reynolds County",2,58,98,53,45
050,29,179,"Missouri","Reynolds County",2,59,109,62,47
050,29,179,"Missouri","Reynolds County",2,60,105,53,52
050,29,179,"Missouri","Reynolds County",2,61,105,57,48
050,29,179,"Missouri","Reynolds County",2,62,104,54,50
050,29,179,"Missouri","Reynolds County",2,63,101,49,52
050,29,179,"Missouri","Reynolds County",2,64,89,41,48
050,29,179,"Missouri","Reynolds County",2,65,82,40,42
050,29,179,"Missouri","Reynolds County",2,66,94,50,44
050,29,179,"Missouri","Reynolds County",2,67,95,49,46
050,29,179,"Missouri","Reynolds County",2,68,81,37,44
050,29,179,"Missouri","Reynolds County",2,69,75,35,40
050,29,179,"Missouri","Reynolds County",2,70,72,39,33
050,29,179,"Missouri","Reynolds County",2,71,71,37,34
050,29,179,"Missouri","Reynolds County",2,72,75,41,34
050,29,179,"Missouri","Reynolds County",2,73,92,57,35
050,29,179,"Missouri","Reynolds County",2,74,64,33,31
050,29,179,"Missouri","Reynolds County",2,75,65,31,34
050,29,179,"Missouri","Reynolds County",2,76,59,30,29
050,29,179,"Missouri","Reynolds County",2,77,50,26,24
050,29,179,"Missouri","Reynolds County",2,78,45,20,25
050,29,179,"Missouri","Reynolds County",2,79,49,19,30
050,29,179,"Missouri","Reynolds County",2,80,43,21,22
050,29,179,"Missouri","Reynolds County",2,81,45,23,22
050,29,179,"Missouri","Reynolds County",2,82,47,28,19
050,29,179,"Missouri","Reynolds County",2,83,33,19,14
050,29,179,"Missouri","Reynolds County",2,84,34,17,17
050,29,179,"Missouri","Reynolds County",2,85,184,76,108
050,29,179,"Missouri","Reynolds County",3,0,61,31,30
050,29,179,"Missouri","Reynolds County",3,1,63,28,35
050,29,179,"Missouri","Reynolds County",3,2,57,24,33
050,29,179,"Missouri","Reynolds County",3,3,55,25,30
050,29,179,"Missouri","Reynolds County",3,4,55,27,28
050,29,179,"Missouri","Reynolds County",3,5,67,34,33
050,29,179,"Missouri","Reynolds County",3,6,59,34,25
050,29,179,"Missouri","Reynolds County",3,7,58,29,29
050,29,179,"Missouri","Reynolds County",3,8,49,29,20
050,29,179,"Missouri","Reynolds County",3,9,56,33,23
050,29,179,"Missouri","Reynolds County",3,10,69,33,36
050,29,179,"Missouri","Reynolds County",3,11,64,30,34
050,29,179,"Missouri","Reynolds County",3,12,67,32,35
050,29,179,"Missouri","Reynolds County",3,13,69,42,27
050,29,179,"Missouri","Reynolds County",3,14,82,48,34
050,29,179,"Missouri","Reynolds County",3,15,81,47,34
050,29,179,"Missouri","Reynolds County",3,16,92,52,40
050,29,179,"Missouri","Reynolds County",3,17,84,51,33
050,29,179,"Missouri","Reynolds County",3,18,76,49,27
050,29,179,"Missouri","Reynolds County",3,19,50,28,22
050,29,179,"Missouri","Reynolds County",3,20,51,26,25
050,29,179,"Missouri","Reynolds County",3,21,53,29,24
050,29,179,"Missouri","Reynolds County",3,22,60,38,22
050,29,179,"Missouri","Reynolds County",3,23,65,37,28
050,29,179,"Missouri","Reynolds County",3,24,52,30,22
050,29,179,"Missouri","Reynolds County",3,25,54,32,22
050,29,179,"Missouri","Reynolds County",3,26,62,34,28
050,29,179,"Missouri","Reynolds County",3,27,60,28,32
050,29,179,"Missouri","Reynolds County",3,28,54,28,26
050,29,179,"Missouri","Reynolds County",3,29,56,29,27
050,29,179,"Missouri","Reynolds County",3,30,66,33,33
050,29,179,"Missouri","Reynolds County",3,31,67,34,33
050,29,179,"Missouri","Reynolds County",3,32,60,33,27
050,29,179,"Missouri","Reynolds County",3,33,69,38,31
050,29,179,"Missouri","Reynolds County",3,34,44,24,20
050,29,179,"Missouri","Reynolds County",3,35,51,25,26
050,29,179,"Missouri","Reynolds County",3,36,65,28,37
050,29,179,"Missouri","Reynolds County",3,37,69,37,32
050,29,179,"Missouri","Reynolds County",3,38,74,42,32
050,29,179,"Missouri","Reynolds County",3,39,74,35,39
050,29,179,"Missouri","Reynolds County",3,40,74,39,35
050,29,179,"Missouri","Reynolds County",3,41,79,39,40
050,29,179,"Missouri","Reynolds County",3,42,70,40,30
050,29,179,"Missouri","Reynolds County",3,43,59,36,23
050,29,179,"Missouri","Reynolds County",3,44,57,29,28
050,29,179,"Missouri","Reynolds County",3,45,60,28,32
050,29,179,"Missouri","Reynolds County",3,46,78,40,38
050,29,179,"Missouri","Reynolds County",3,47,82,39,43
050,29,179,"Missouri","Reynolds County",3,48,79,38,41
050,29,179,"Missouri","Reynolds County",3,49,87,43,44
050,29,179,"Missouri","Reynolds County",3,50,82,43,39
050,29,179,"Missouri","Reynolds County",3,51,77,40,37
050,29,179,"Missouri","Reynolds County",3,52,74,41,33
050,29,179,"Missouri","Reynolds County",3,53,73,39,34
050,29,179,"Missouri","Reynolds County",3,54,89,46,43
050,29,179,"Missouri","Reynolds County",3,55,85,45,40
050,29,179,"Missouri","Reynolds County",3,56,94,54,40
050,29,179,"Missouri","Reynolds County",3,57,101,52,49
050,29,179,"Missouri","Reynolds County",3,58,95,48,47
050,29,179,"Missouri","Reynolds County",3,59,102,53,49
050,29,179,"Missouri","Reynolds County",3,60,109,57,52
050,29,179,"Missouri","Reynolds County",3,61,94,48,46
050,29,179,"Missouri","Reynolds County",3,62,106,55,51
050,29,179,"Missouri","Reynolds County",3,63,106,58,48
050,29,179,"Missouri","Reynolds County",3,64,98,47,51
050,29,179,"Missouri","Reynolds County",3,65,92,43,49
050,29,179,"Missouri","Reynolds County",3,66,81,40,41
050,29,179,"Missouri","Reynolds County",3,67,94,51,43
050,29,179,"Missouri","Reynolds County",3,68,88,47,41
050,29,179,"Missouri","Reynolds County",3,69,79,37,42
050,29,179,"Missouri","Reynolds County",3,70,72,33,39
050,29,179,"Missouri","Reynolds County",3,71,63,35,28
050,29,179,"Missouri","Reynolds County",3,72,68,33,35
050,29,179,"Missouri","Reynolds County",3,73,82,43,39
050,29,179,"Missouri","Reynolds County",3,74,86,52,34
050,29,179,"Missouri","Reynolds County",3,75,62,36,26
050,29,179,"Missouri","Reynolds County",3,76,64,31,33
050,29,179,"Missouri","Reynolds County",3,77,53,26,27
050,29,179,"Missouri","Reynolds County",3,78,45,24,21
050,29,179,"Missouri","Reynolds County",3,79,46,21,25
050,29,179,"Missouri","Reynolds County",3,80,39,17,22
050,29,179,"Missouri","Reynolds County",3,81,42,17,25
050,29,179,"Missouri","Reynolds County",3,82,41,28,13
050,29,179,"Missouri","Reynolds County",3,83,35,19,16
050,29,179,"Missouri","Reynolds County",3,84,30,17,13
050,29,179,"Missouri","Reynolds County",3,85,192,81,111
050,29,179,"Missouri","Reynolds County",4,0,57,25,32
050,29,179,"Missouri","Reynolds County",4,1,55,26,29
050,29,179,"Missouri","Reynolds County",4,2,66,29,37
050,29,179,"Missouri","Reynolds County",4,3,51,23,28
050,29,179,"Missouri","Reynolds County",4,4,53,26,27
050,29,179,"Missouri","Reynolds County",4,5,51,25,26
050,29,179,"Missouri","Reynolds County",4,6,59,29,30
050,29,179,"Missouri","Reynolds County",4,7,58,31,27
050,29,179,"Missouri","Reynolds County",4,8,61,31,30
050,29,179,"Missouri","Reynolds County",4,9,51,32,19
050,29,179,"Missouri","Reynolds County",4,10,55,32,23
050,29,179,"Missouri","Reynolds County",4,11,69,33,36
050,29,179,"Missouri","Reynolds County",4,12,63,30,33
050,29,179,"Missouri","Reynolds County",4,13,68,32,36
050,29,179,"Missouri","Reynolds County",4,14,74,46,28
050,29,179,"Missouri","Reynolds County",4,15,85,48,37
050,29,179,"Missouri","Reynolds County",4,16,84,53,31
050,29,179,"Missouri","Reynolds County",4,17,93,54,39
050,29,179,"Missouri","Reynolds County",4,18,72,44,28
050,29,179,"Missouri","Reynolds County",4,19,51,33,18
050,29,179,"Missouri","Reynolds County",4,20,48,25,23
050,29,179,"Missouri","Reynolds County",4,21,50,25,25
050,29,179,"Missouri","Reynolds County",4,22,57,36,21
050,29,179,"Missouri","Reynolds County",4,23,60,36,24
050,29,179,"Missouri","Reynolds County",4,24,62,39,23
050,29,179,"Missouri","Reynolds County",4,25,49,25,24
050,29,179,"Missouri","Reynolds County",4,26,52,29,23
050,29,179,"Missouri","Reynolds County",4,27,63,33,30
050,29,179,"Missouri","Reynolds County",4,28,59,28,31
050,29,179,"Missouri","Reynolds County",4,29,51,27,24
050,29,179,"Missouri","Reynolds County",4,30,57,29,28
050,29,179,"Missouri","Reynolds County",4,31,67,32,35
050,29,179,"Missouri","Reynolds County",4,32,68,37,31
050,29,179,"Missouri","Reynolds County",4,33,64,35,29
050,29,179,"Missouri","Reynolds County",4,34,63,34,29
050,29,179,"Missouri","Reynolds County",4,35,45,25,20
050,29,179,"Missouri","Reynolds County",4,36,50,23,27
050,29,179,"Missouri","Reynolds County",4,37,65,24,41
050,29,179,"Missouri","Reynolds County",4,38,68,37,31
050,29,179,"Missouri","Reynolds County",4,39,74,42,32
050,29,179,"Missouri","Reynolds County",4,40,69,32,37
050,29,179,"Missouri","Reynolds County",4,41,76,42,34
050,29,179,"Missouri","Reynolds County",4,42,77,36,41
050,29,179,"Missouri","Reynolds County",4,43,73,41,32
050,29,179,"Missouri","Reynolds County",4,44,59,38,21
050,29,179,"Missouri","Reynolds County",4,45,57,27,30
050,29,179,"Missouri","Reynolds County",4,46,61,29,32
050,29,179,"Missouri","Reynolds County",4,47,76,42,34
050,29,179,"Missouri","Reynolds County",4,48,87,38,49
050,29,179,"Missouri","Reynolds County",4,49,76,38,38
050,29,179,"Missouri","Reynolds County",4,50,87,43,44
050,29,179,"Missouri","Reynolds County",4,51,81,43,38
050,29,179,"Missouri","Reynolds County",4,52,84,44,40
050,29,179,"Missouri","Reynolds County",4,53,70,37,33
050,29,179,"Missouri","Reynolds County",4,54,77,42,35
050,29,179,"Missouri","Reynolds County",4,55,94,49,45
050,29,179,"Missouri","Reynolds County",4,56,88,49,39
050,29,179,"Missouri","Reynolds County",4,57,93,55,38
050,29,179,"Missouri","Reynolds County",4,58,100,53,47
050,29,179,"Missouri","Reynolds County",4,59,97,44,53
050,29,179,"Missouri","Reynolds County",4,60,109,55,54
050,29,179,"Missouri","Reynolds County",4,61,100,55,45
050,29,179,"Missouri","Reynolds County",4,62,102,53,49
050,29,179,"Missouri","Reynolds County",4,63,113,59,54
050,29,179,"Missouri","Reynolds County",4,64,108,58,50
050,29,179,"Missouri","Reynolds County",4,65,98,47,51
050,29,179,"Missouri","Reynolds County",4,66,93,43,50
050,29,179,"Missouri","Reynolds County",4,67,80,36,44
050,29,179,"Missouri","Reynolds County",4,68,92,49,43
050,29,179,"Missouri","Reynolds County",4,69,84,45,39
050,29,179,"Missouri","Reynolds County",4,70,79,37,42
050,29,179,"Missouri","Reynolds County",4,71,63,30,33
050,29,179,"Missouri","Reynolds County",4,72,59,33,26
050,29,179,"Missouri","Reynolds County",4,73,68,35,33
050,29,179,"Missouri","Reynolds County",4,74,70,34,36
050,29,179,"Missouri","Reynolds County",4,75,77,50,27
050,29,179,"Missouri","Reynolds County",4,76,58,32,26
050,29,179,"Missouri","Reynolds County",4,77,58,28,30
050,29,179,"Missouri","Reynolds County",4,78,47,22,25
050,29,179,"Missouri","Reynolds County",4,79,45,22,23
050,29,179,"Missouri","Reynolds County",4,80,37,19,18
050,29,179,"Missouri","Reynolds County",4,81,38,16,22
050,29,179,"Missouri","Reynolds County",4,82,39,20,19
050,29,179,"Missouri","Reynolds County",4,83,28,17,11
050,29,179,"Missouri","Reynolds County",4,84,34,16,18
050,29,179,"Missouri","Reynolds County",4,85,187,80,107
050,29,179,"Missouri","Reynolds County",5,0,57,24,33
050,29,179,"Missouri","Reynolds County",5,1,54,17,37
050,29,179,"Missouri","Reynolds County",5,2,54,27,27
050,29,179,"Missouri","Reynolds County",5,3,55,24,31
050,29,179,"Missouri","Reynolds County",5,4,57,27,30
050,29,179,"Missouri","Reynolds County",5,5,58,31,27
050,29,179,"Missouri","Reynolds County",5,6,52,24,28
050,29,179,"Missouri","Reynolds County",5,7,60,28,32
050,29,179,"Missouri","Reynolds County",5,8,56,29,27
050,29,179,"Missouri","Reynolds County",5,9,63,33,30
050,29,179,"Missouri","Reynolds County",5,10,55,35,20
050,29,179,"Missouri","Reynolds County",5,11,58,33,25
050,29,179,"Missouri","Reynolds County",5,12,73,36,37
050,29,179,"Missouri","Reynolds County",5,13,67,33,34
050,29,179,"Missouri","Reynolds County",5,14,65,30,35
050,29,179,"Missouri","Reynolds County",5,15,70,45,25
050,29,179,"Missouri","Reynolds County",5,16,89,53,36
050,29,179,"Missouri","Reynolds County",5,17,86,57,29
050,29,179,"Missouri","Reynolds County",5,18,78,48,30
050,29,179,"Missouri","Reynolds County",5,19,53,34,19
050,29,179,"Missouri","Reynolds County",5,20,52,29,23
050,29,179,"Missouri","Reynolds County",5,21,48,24,24
050,29,179,"Missouri","Reynolds County",5,22,62,31,31
050,29,179,"Missouri","Reynolds County",5,23,60,38,22
050,29,179,"Missouri","Reynolds County",5,24,69,42,27
050,29,179,"Missouri","Reynolds County",5,25,62,37,25
050,29,179,"Missouri","Reynolds County",5,26,45,26,19
050,29,179,"Missouri","Reynolds County",5,27,53,32,21
050,29,179,"Missouri","Reynolds County",5,28,64,36,28
050,29,179,"Missouri","Reynolds County",5,29,56,26,30
050,29,179,"Missouri","Reynolds County",5,30,50,27,23
050,29,179,"Missouri","Reynolds County",5,31,48,20,28
050,29,179,"Missouri","Reynolds County",5,32,67,34,33
050,29,179,"Missouri","Reynolds County",5,33,69,35,34
050,29,179,"Missouri","Reynolds County",5,34,64,34,30
050,29,179,"Missouri","Reynolds County",5,35,66,33,33
050,29,179,"Missouri","Reynolds County",5,36,52,28,24
050,29,179,"Missouri","Reynolds County",5,37,50,24,26
050,29,179,"Missouri","Reynolds County",5,38,70,27,43
050,29,179,"Missouri","Reynolds County",5,39,71,37,34
050,29,179,"Missouri","Reynolds County",5,40,73,41,32
050,29,179,"Missouri","Reynolds County",5,41,69,31,38
050,29,179,"Missouri","Reynolds County",5,42,75,42,33
050,29,179,"Missouri","Reynolds County",5,43,77,36,41
050,29,179,"Missouri","Reynolds County",5,44,75,43,32
050,29,179,"Missouri","Reynolds County",5,45,64,40,24
050,29,179,"Missouri","Reynolds County",5,46,55,27,28
050,29,179,"Missouri","Reynolds County",5,47,63,30,33
050,29,179,"Missouri","Reynolds County",5,48,76,41,35
050,29,179,"Missouri","Reynolds County",5,49,89,44,45
050,29,179,"Missouri","Reynolds County",5,50,77,40,37
050,29,179,"Missouri","Reynolds County",5,51,87,43,44
050,29,179,"Missouri","Reynolds County",5,52,89,48,41
050,29,179,"Missouri","Reynolds County",5,53,74,37,37
050,29,179,"Missouri","Reynolds County",5,54,70,39,31
050,29,179,"Missouri","Reynolds County",5,55,78,43,35
050,29,179,"Missouri","Reynolds County",5,56,91,48,43
050,29,179,"Missouri","Reynolds County",5,57,89,49,40
050,29,179,"Missouri","Reynolds County",5,58,90,55,35
050,29,179,"Missouri","Reynolds County",5,59,107,56,51
050,29,179,"Missouri","Reynolds County",5,60,104,44,60
050,29,179,"Missouri","Reynolds County",5,61,96,48,48
050,29,179,"Missouri","Reynolds County",5,62,101,56,45
050,29,179,"Missouri","Reynolds County",5,63,103,53,50
050,29,179,"Missouri","Reynolds County",5,64,111,59,52
050,29,179,"Missouri","Reynolds County",5,65,104,56,48
050,29,179,"Missouri","Reynolds County",5,66,94,43,51
050,29,179,"Missouri","Reynolds County",5,67,95,44,51
050,29,179,"Missouri","Reynolds County",5,68,71,33,38
050,29,179,"Missouri","Reynolds County",5,69,87,46,41
050,29,179,"Missouri","Reynolds County",5,70,84,46,38
050,29,179,"Missouri","Reynolds County",5,71,75,36,39
050,29,179,"Missouri","Reynolds County",5,72,58,28,30
050,29,179,"Missouri","Reynolds County",5,73,62,33,29
050,29,179,"Missouri","Reynolds County",5,74,61,31,30
050,29,179,"Missouri","Reynolds County",5,75,64,34,30
050,29,179,"Missouri","Reynolds County",5,76,76,46,30
050,29,179,"Missouri","Reynolds County",5,77,53,26,27
050,29,179,"Missouri","Reynolds County",5,78,52,27,25
050,29,179,"Missouri","Reynolds County",5,79,45,21,24
050,29,179,"Missouri","Reynolds County",5,80,38,20,18
050,29,179,"Missouri","Reynolds County",5,81,37,17,20
050,29,179,"Missouri","Reynolds County",5,82,33,20,13
050,29,179,"Missouri","Reynolds County",5,83,27,10,17
050,29,179,"Missouri","Reynolds County",5,84,28,15,13
050,29,179,"Missouri","Reynolds County",5,85,185,78,107
050,29,181,"Missouri","Ripley County",1,0,123,62,61
050,29,181,"Missouri","Ripley County",1,1,128,67,61
050,29,181,"Missouri","Ripley County",1,2,128,68,60
050,29,181,"Missouri","Ripley County",1,3,117,60,57
050,29,181,"Missouri","Ripley County",1,4,128,63,65
050,29,181,"Missouri","Ripley County",1,5,141,79,62
050,29,181,"Missouri","Ripley County",1,6,146,77,69
050,29,181,"Missouri","Ripley County",1,7,148,76,72
050,29,181,"Missouri","Ripley County",1,8,145,76,69
050,29,181,"Missouri","Ripley County",1,9,147,67,80
050,29,181,"Missouri","Ripley County",1,10,167,74,93
050,29,181,"Missouri","Ripley County",1,11,153,79,74
050,29,181,"Missouri","Ripley County",1,12,140,75,65
050,29,181,"Missouri","Ripley County",1,13,126,66,60
050,29,181,"Missouri","Ripley County",1,14,149,79,70
050,29,181,"Missouri","Ripley County",1,15,131,72,59
050,29,181,"Missouri","Ripley County",1,16,134,70,64
050,29,181,"Missouri","Ripley County",1,17,145,76,69
050,29,181,"Missouri","Ripley County",1,18,121,68,53
050,29,181,"Missouri","Ripley County",1,19,93,56,37
050,29,181,"Missouri","Ripley County",1,20,89,52,37
050,29,181,"Missouri","Ripley County",1,21,90,41,49
050,29,181,"Missouri","Ripley County",1,22,90,43,47
050,29,181,"Missouri","Ripley County",1,23,100,54,46
050,29,181,"Missouri","Ripley County",1,24,119,62,57
050,29,181,"Missouri","Ripley County",1,25,103,53,50
050,29,181,"Missouri","Ripley County",1,26,106,52,54
050,29,181,"Missouri","Ripley County",1,27,121,58,63
050,29,181,"Missouri","Ripley County",1,28,131,67,64
050,29,181,"Missouri","Ripley County",1,29,133,58,75
050,29,181,"Missouri","Ripley County",1,30,130,56,74
050,29,181,"Missouri","Ripley County",1,31,138,60,78
050,29,181,"Missouri","Ripley County",1,32,120,59,61
050,29,181,"Missouri","Ripley County",1,33,120,60,60
050,29,181,"Missouri","Ripley County",1,34,123,61,62
050,29,181,"Missouri","Ripley County",1,35,116,65,51
050,29,181,"Missouri","Ripley County",1,36,119,71,48
050,29,181,"Missouri","Ripley County",1,37,113,61,52
050,29,181,"Missouri","Ripley County",1,38,125,61,64
050,29,181,"Missouri","Ripley County",1,39,121,58,63
050,29,181,"Missouri","Ripley County",1,40,130,71,59
050,29,181,"Missouri","Ripley County",1,41,124,61,63
050,29,181,"Missouri","Ripley County",1,42,111,57,54
050,29,181,"Missouri","Ripley County",1,43,127,63,64
050,29,181,"Missouri","Ripley County",1,44,134,71,63
050,29,181,"Missouri","Ripley County",1,45,129,73,56
050,29,181,"Missouri","Ripley County",1,46,121,60,61
050,29,181,"Missouri","Ripley County",1,47,128,66,62
050,29,181,"Missouri","Ripley County",1,48,135,74,61
050,29,181,"Missouri","Ripley County",1,49,146,78,68
050,29,181,"Missouri","Ripley County",1,50,136,65,71
050,29,181,"Missouri","Ripley County",1,51,116,66,50
050,29,181,"Missouri","Ripley County",1,52,118,66,52
050,29,181,"Missouri","Ripley County",1,53,134,66,68
050,29,181,"Missouri","Ripley County",1,54,143,66,77
050,29,181,"Missouri","Ripley County",1,55,152,76,76
050,29,181,"Missouri","Ripley County",1,56,151,81,70
050,29,181,"Missouri","Ripley County",1,57,159,80,79
050,29,181,"Missouri","Ripley County",1,58,183,86,97
050,29,181,"Missouri","Ripley County",1,59,173,82,91
050,29,181,"Missouri","Ripley County",1,60,163,87,76
050,29,181,"Missouri","Ripley County",1,61,148,78,70
050,29,181,"Missouri","Ripley County",1,62,155,77,78
050,29,181,"Missouri","Ripley County",1,63,165,77,88
050,29,181,"Missouri","Ripley County",1,64,154,75,79
050,29,181,"Missouri","Ripley County",1,65,139,68,71
050,29,181,"Missouri","Ripley County",1,66,132,61,71
050,29,181,"Missouri","Ripley County",1,67,125,57,68
050,29,181,"Missouri","Ripley County",1,68,134,70,64
050,29,181,"Missouri","Ripley County",1,69,121,64,57
050,29,181,"Missouri","Ripley County",1,70,120,57,63
050,29,181,"Missouri","Ripley County",1,71,117,56,61
050,29,181,"Missouri","Ripley County",1,72,113,61,52
050,29,181,"Missouri","Ripley County",1,73,103,47,56
050,29,181,"Missouri","Ripley County",1,74,85,39,46
050,29,181,"Missouri","Ripley County",1,75,95,43,52
050,29,181,"Missouri","Ripley County",1,76,91,43,48
050,29,181,"Missouri","Ripley County",1,77,88,39,49
050,29,181,"Missouri","Ripley County",1,78,72,30,42
050,29,181,"Missouri","Ripley County",1,79,79,33,46
050,29,181,"Missouri","Ripley County",1,80,71,32,39
050,29,181,"Missouri","Ripley County",1,81,65,31,34
050,29,181,"Missouri","Ripley County",1,82,50,27,23
050,29,181,"Missouri","Ripley County",1,83,45,21,24
050,29,181,"Missouri","Ripley County",1,84,53,22,31
050,29,181,"Missouri","Ripley County",1,85,227,99,128
050,29,181,"Missouri","Ripley County",2,0,127,64,63
050,29,181,"Missouri","Ripley County",2,1,128,67,61
050,29,181,"Missouri","Ripley County",2,2,130,69,61
050,29,181,"Missouri","Ripley County",2,3,122,64,58
050,29,181,"Missouri","Ripley County",2,4,127,63,64
050,29,181,"Missouri","Ripley County",2,5,139,75,64
050,29,181,"Missouri","Ripley County",2,6,147,78,69
050,29,181,"Missouri","Ripley County",2,7,148,77,71
050,29,181,"Missouri","Ripley County",2,8,144,75,69
050,29,181,"Missouri","Ripley County",2,9,147,68,79
050,29,181,"Missouri","Ripley County",2,10,161,72,89
050,29,181,"Missouri","Ripley County",2,11,154,77,77
050,29,181,"Missouri","Ripley County",2,12,143,75,68
050,29,181,"Missouri","Ripley County",2,13,129,68,61
050,29,181,"Missouri","Ripley County",2,14,144,77,67
050,29,181,"Missouri","Ripley County",2,15,135,73,62
050,29,181,"Missouri","Ripley County",2,16,134,71,63
050,29,181,"Missouri","Ripley County",2,17,143,76,67
050,29,181,"Missouri","Ripley County",2,18,119,66,53
050,29,181,"Missouri","Ripley County",2,19,93,55,38
050,29,181,"Missouri","Ripley County",2,20,94,54,40
050,29,181,"Missouri","Ripley County",2,21,92,44,48
050,29,181,"Missouri","Ripley County",2,22,91,43,48
050,29,181,"Missouri","Ripley County",2,23,100,53,47
050,29,181,"Missouri","Ripley County",2,24,116,61,55
050,29,181,"Missouri","Ripley County",2,25,107,56,51
050,29,181,"Missouri","Ripley County",2,26,104,52,52
050,29,181,"Missouri","Ripley County",2,27,118,57,61
050,29,181,"Missouri","Ripley County",2,28,130,66,64
050,29,181,"Missouri","Ripley County",2,29,135,62,73
050,29,181,"Missouri","Ripley County",2,30,131,56,75
050,29,181,"Missouri","Ripley County",2,31,136,60,76
050,29,181,"Missouri","Ripley County",2,32,126,60,66
050,29,181,"Missouri","Ripley County",2,33,119,59,60
050,29,181,"Missouri","Ripley County",2,34,122,60,62
050,29,181,"Missouri","Ripley County",2,35,120,66,54
050,29,181,"Missouri","Ripley County",2,36,118,70,48
050,29,181,"Missouri","Ripley County",2,37,115,64,51
050,29,181,"Missouri","Ripley County",2,38,122,61,61
050,29,181,"Missouri","Ripley County",2,39,122,58,64
050,29,181,"Missouri","Ripley County",2,40,128,69,59
050,29,181,"Missouri","Ripley County",2,41,126,63,63
050,29,181,"Missouri","Ripley County",2,42,112,57,55
050,29,181,"Missouri","Ripley County",2,43,125,62,63
050,29,181,"Missouri","Ripley County",2,44,130,68,62
050,29,181,"Missouri","Ripley County",2,45,130,72,58
050,29,181,"Missouri","Ripley County",2,46,122,62,60
050,29,181,"Missouri","Ripley County",2,47,127,65,62
050,29,181,"Missouri","Ripley County",2,48,133,72,61
050,29,181,"Missouri","Ripley County",2,49,145,78,67
050,29,181,"Missouri","Ripley County",2,50,138,69,69
050,29,181,"Missouri","Ripley County",2,51,119,65,54
050,29,181,"Missouri","Ripley County",2,52,117,65,52
050,29,181,"Missouri","Ripley County",2,53,131,66,65
050,29,181,"Missouri","Ripley County",2,54,141,66,75
050,29,181,"Missouri","Ripley County",2,55,145,72,73
050,29,181,"Missouri","Ripley County",2,56,151,79,72
050,29,181,"Missouri","Ripley County",2,57,155,78,77
050,29,181,"Missouri","Ripley County",2,58,177,84,93
050,29,181,"Missouri","Ripley County",2,59,173,81,92
050,29,181,"Missouri","Ripley County",2,60,164,85,79
050,29,181,"Missouri","Ripley County",2,61,151,80,71
050,29,181,"Missouri","Ripley County",2,62,152,76,76
050,29,181,"Missouri","Ripley County",2,63,162,76,86
050,29,181,"Missouri","Ripley County",2,64,154,75,79
050,29,181,"Missouri","Ripley County",2,65,142,70,72
050,29,181,"Missouri","Ripley County",2,66,132,61,71
050,29,181,"Missouri","Ripley County",2,67,126,58,68
050,29,181,"Missouri","Ripley County",2,68,131,66,65
050,29,181,"Missouri","Ripley County",2,69,124,65,59
050,29,181,"Missouri","Ripley County",2,70,117,55,62
050,29,181,"Missouri","Ripley County",2,71,117,57,60
050,29,181,"Missouri","Ripley County",2,72,112,59,53
050,29,181,"Missouri","Ripley County",2,73,111,53,58
050,29,181,"Missouri","Ripley County",2,74,84,39,45
050,29,181,"Missouri","Ripley County",2,75,92,43,49
050,29,181,"Missouri","Ripley County",2,76,90,41,49
050,29,181,"Missouri","Ripley County",2,77,89,40,49
050,29,181,"Missouri","Ripley County",2,78,75,31,44
050,29,181,"Missouri","Ripley County",2,79,76,32,44
050,29,181,"Missouri","Ripley County",2,80,73,32,41
050,29,181,"Missouri","Ripley County",2,81,66,31,35
050,29,181,"Missouri","Ripley County",2,82,54,28,26
050,29,181,"Missouri","Ripley County",2,83,45,22,23
050,29,181,"Missouri","Ripley County",2,84,49,21,28
050,29,181,"Missouri","Ripley County",2,85,224,97,127
050,29,181,"Missouri","Ripley County",3,0,162,88,74
050,29,181,"Missouri","Ripley County",3,1,107,46,61
050,29,181,"Missouri","Ripley County",3,2,144,72,72
050,29,181,"Missouri","Ripley County",3,3,128,63,65
050,29,181,"Missouri","Ripley County",3,4,122,68,54
050,29,181,"Missouri","Ripley County",3,5,118,53,65
050,29,181,"Missouri","Ripley County",3,6,141,79,62
050,29,181,"Missouri","Ripley County",3,7,157,84,73
050,29,181,"Missouri","Ripley County",3,8,147,77,70
050,29,181,"Missouri","Ripley County",3,9,148,81,67
050,29,181,"Missouri","Ripley County",3,10,152,68,84
050,29,181,"Missouri","Ripley County",3,11,159,77,82
050,29,181,"Missouri","Ripley County",3,12,153,74,79
050,29,181,"Missouri","Ripley County",3,13,152,78,74
050,29,181,"Missouri","Ripley County",3,14,131,67,64
050,29,181,"Missouri","Ripley County",3,15,140,72,68
050,29,181,"Missouri","Ripley County",3,16,136,74,62
050,29,181,"Missouri","Ripley County",3,17,139,71,68
050,29,181,"Missouri","Ripley County",3,18,125,70,55
050,29,181,"Missouri","Ripley County",3,19,91,51,40
050,29,181,"Missouri","Ripley County",3,20,107,60,47
050,29,181,"Missouri","Ripley County",3,21,113,55,58
050,29,181,"Missouri","Ripley County",3,22,97,48,49
050,29,181,"Missouri","Ripley County",3,23,96,41,55
050,29,181,"Missouri","Ripley County",3,24,109,59,50
050,29,181,"Missouri","Ripley County",3,25,104,53,51
050,29,181,"Missouri","Ripley County",3,26,106,58,48
050,29,181,"Missouri","Ripley County",3,27,110,51,59
050,29,181,"Missouri","Ripley County",3,28,120,56,64
050,29,181,"Missouri","Ripley County",3,29,128,70,58
050,29,181,"Missouri","Ripley County",3,30,129,56,73
050,29,181,"Missouri","Ripley County",3,31,129,56,73
050,29,181,"Missouri","Ripley County",3,32,142,69,73
050,29,181,"Missouri","Ripley County",3,33,131,61,70
050,29,181,"Missouri","Ripley County",3,34,126,65,61
050,29,181,"Missouri","Ripley County",3,35,120,59,61
050,29,181,"Missouri","Ripley County",3,36,125,69,56
050,29,181,"Missouri","Ripley County",3,37,111,67,44
050,29,181,"Missouri","Ripley County",3,38,122,66,56
050,29,181,"Missouri","Ripley County",3,39,126,63,63
050,29,181,"Missouri","Ripley County",3,40,123,57,66
050,29,181,"Missouri","Ripley County",3,41,119,62,57
050,29,181,"Missouri","Ripley County",3,42,126,63,63
050,29,181,"Missouri","Ripley County",3,43,117,56,61
050,29,181,"Missouri","Ripley County",3,44,130,60,70
050,29,181,"Missouri","Ripley County",3,45,121,67,54
050,29,181,"Missouri","Ripley County",3,46,123,69,54
050,29,181,"Missouri","Ripley County",3,47,125,65,60
050,29,181,"Missouri","Ripley County",3,48,129,64,65
050,29,181,"Missouri","Ripley County",3,49,130,71,59
050,29,181,"Missouri","Ripley County",3,50,146,79,67
050,29,181,"Missouri","Ripley County",3,51,132,65,67
050,29,181,"Missouri","Ripley County",3,52,117,67,50
050,29,181,"Missouri","Ripley County",3,53,115,61,54
050,29,181,"Missouri","Ripley County",3,54,127,65,62
050,29,181,"Missouri","Ripley County",3,55,137,62,75
050,29,181,"Missouri","Ripley County",3,56,147,71,76
050,29,181,"Missouri","Ripley County",3,57,147,76,71
050,29,181,"Missouri","Ripley County",3,58,150,77,73
050,29,181,"Missouri","Ripley County",3,59,174,81,93
050,29,181,"Missouri","Ripley County",3,60,165,76,89
050,29,181,"Missouri","Ripley County",3,61,164,85,79
050,29,181,"Missouri","Ripley County",3,62,144,78,66
050,29,181,"Missouri","Ripley County",3,63,151,75,76
050,29,181,"Missouri","Ripley County",3,64,149,68,81
050,29,181,"Missouri","Ripley County",3,65,151,76,75
050,29,181,"Missouri","Ripley County",3,66,144,68,76
050,29,181,"Missouri","Ripley County",3,67,129,59,70
050,29,181,"Missouri","Ripley County",3,68,121,53,68
050,29,181,"Missouri","Ripley County",3,69,129,62,67
050,29,181,"Missouri","Ripley County",3,70,122,65,57
050,29,181,"Missouri","Ripley County",3,71,112,51,61
050,29,181,"Missouri","Ripley County",3,72,111,56,55
050,29,181,"Missouri","Ripley County",3,73,110,58,52
050,29,181,"Missouri","Ripley County",3,74,103,51,52
050,29,181,"Missouri","Ripley County",3,75,74,34,40
050,29,181,"Missouri","Ripley County",3,76,86,38,48
050,29,181,"Missouri","Ripley County",3,77,91,40,51
050,29,181,"Missouri","Ripley County",3,78,83,37,46
050,29,181,"Missouri","Ripley County",3,79,62,24,38
050,29,181,"Missouri","Ripley County",3,80,67,29,38
050,29,181,"Missouri","Ripley County",3,81,61,26,35
050,29,181,"Missouri","Ripley County",3,82,65,30,35
050,29,181,"Missouri","Ripley County",3,83,48,26,22
050,29,181,"Missouri","Ripley County",3,84,36,17,19
050,29,181,"Missouri","Ripley County",3,85,229,103,126
050,29,181,"Missouri","Ripley County",4,0,129,73,56
050,29,181,"Missouri","Ripley County",4,1,172,101,71
050,29,181,"Missouri","Ripley County",4,2,115,49,66
050,29,181,"Missouri","Ripley County",4,3,139,68,71
050,29,181,"Missouri","Ripley County",4,4,138,72,66
050,29,181,"Missouri","Ripley County",4,5,131,76,55
050,29,181,"Missouri","Ripley County",4,6,132,65,67
050,29,181,"Missouri","Ripley County",4,7,146,80,66
050,29,181,"Missouri","Ripley County",4,8,160,87,73
050,29,181,"Missouri","Ripley County",4,9,149,75,74
050,29,181,"Missouri","Ripley County",4,10,140,73,67
050,29,181,"Missouri","Ripley County",4,11,156,67,89
050,29,181,"Missouri","Ripley County",4,12,162,79,83
050,29,181,"Missouri","Ripley County",4,13,156,76,80
050,29,181,"Missouri","Ripley County",4,14,157,84,73
050,29,181,"Missouri","Ripley County",4,15,133,68,65
050,29,181,"Missouri","Ripley County",4,16,142,74,68
050,29,181,"Missouri","Ripley County",4,17,134,72,62
050,29,181,"Missouri","Ripley County",4,18,115,60,55
050,29,181,"Missouri","Ripley County",4,19,94,47,47
050,29,181,"Missouri","Ripley County",4,20,95,50,45
050,29,181,"Missouri","Ripley County",4,21,106,55,51
050,29,181,"Missouri","Ripley County",4,22,117,58,59
050,29,181,"Missouri","Ripley County",4,23,100,48,52
050,29,181,"Missouri","Ripley County",4,24,102,48,54
050,29,181,"Missouri","Ripley County",4,25,122,66,56
050,29,181,"Missouri","Ripley County",4,26,110,59,51
050,29,181,"Missouri","Ripley County",4,27,109,61,48
050,29,181,"Missouri","Ripley County",4,28,108,49,59
050,29,181,"Missouri","Ripley County",4,29,126,56,70
050,29,181,"Missouri","Ripley County",4,30,120,65,55
050,29,181,"Missouri","Ripley County",4,31,127,53,74
050,29,181,"Missouri","Ripley County",4,32,136,63,73
050,29,181,"Missouri","Ripley County",4,33,147,65,82
050,29,181,"Missouri","Ripley County",4,34,128,60,68
050,29,181,"Missouri","Ripley County",4,35,126,62,64
050,29,181,"Missouri","Ripley County",4,36,129,65,64
050,29,181,"Missouri","Ripley County",4,37,128,70,58
050,29,181,"Missouri","Ripley County",4,38,115,70,45
050,29,181,"Missouri","Ripley County",4,39,131,65,66
050,29,181,"Missouri","Ripley County",4,40,125,63,62
050,29,181,"Missouri","Ripley County",4,41,129,59,70
050,29,181,"Missouri","Ripley County",4,42,132,68,64
050,29,181,"Missouri","Ripley County",4,43,121,61,60
050,29,181,"Missouri","Ripley County",4,44,124,63,61
050,29,181,"Missouri","Ripley County",4,45,125,61,64
050,29,181,"Missouri","Ripley County",4,46,124,68,56
050,29,181,"Missouri","Ripley County",4,47,126,66,60
050,29,181,"Missouri","Ripley County",4,48,118,62,56
050,29,181,"Missouri","Ripley County",4,49,127,65,62
050,29,181,"Missouri","Ripley County",4,50,135,77,58
050,29,181,"Missouri","Ripley County",4,51,165,87,78
050,29,181,"Missouri","Ripley County",4,52,138,67,71
050,29,181,"Missouri","Ripley County",4,53,122,65,57
050,29,181,"Missouri","Ripley County",4,54,112,61,51
050,29,181,"Missouri","Ripley County",4,55,125,65,60
050,29,181,"Missouri","Ripley County",4,56,125,59,66
050,29,181,"Missouri","Ripley County",4,57,151,78,73
050,29,181,"Missouri","Ripley County",4,58,148,76,72
050,29,181,"Missouri","Ripley County",4,59,146,71,75
050,29,181,"Missouri","Ripley County",4,60,175,83,92
050,29,181,"Missouri","Ripley County",4,61,165,76,89
050,29,181,"Missouri","Ripley County",4,62,155,78,77
050,29,181,"Missouri","Ripley County",4,63,138,76,62
050,29,181,"Missouri","Ripley County",4,64,148,77,71
050,29,181,"Missouri","Ripley County",4,65,141,64,77
050,29,181,"Missouri","Ripley County",4,66,153,78,75
050,29,181,"Missouri","Ripley County",4,67,142,67,75
050,29,181,"Missouri","Ripley County",4,68,122,53,69
050,29,181,"Missouri","Ripley County",4,69,112,48,64
050,29,181,"Missouri","Ripley County",4,70,126,62,64
050,29,181,"Missouri","Ripley County",4,71,128,65,63
050,29,181,"Missouri","Ripley County",4,72,107,45,62
050,29,181,"Missouri","Ripley County",4,73,95,49,46
050,29,181,"Missouri","Ripley County",4,74,103,55,48
050,29,181,"Missouri","Ripley County",4,75,103,51,52
050,29,181,"Missouri","Ripley County",4,76,69,34,35
050,29,181,"Missouri","Ripley County",4,77,84,35,49
050,29,181,"Missouri","Ripley County",4,78,85,37,48
050,29,181,"Missouri","Ripley County",4,79,75,34,41
050,29,181,"Missouri","Ripley County",4,80,53,21,32
050,29,181,"Missouri","Ripley County",4,81,57,23,34
050,29,181,"Missouri","Ripley County",4,82,53,25,28
050,29,181,"Missouri","Ripley County",4,83,58,26,32
050,29,181,"Missouri","Ripley County",4,84,47,26,21
050,29,181,"Missouri","Ripley County",4,85,220,99,121
050,29,181,"Missouri","Ripley County",5,0,130,75,55
050,29,181,"Missouri","Ripley County",5,1,143,74,69
050,29,181,"Missouri","Ripley County",5,2,156,88,68
050,29,181,"Missouri","Ripley County",5,3,125,59,66
050,29,181,"Missouri","Ripley County",5,4,147,75,72
050,29,181,"Missouri","Ripley County",5,5,146,78,68
050,29,181,"Missouri","Ripley County",5,6,140,81,59
050,29,181,"Missouri","Ripley County",5,7,136,65,71
050,29,181,"Missouri","Ripley County",5,8,150,88,62
050,29,181,"Missouri","Ripley County",5,9,164,86,78
050,29,181,"Missouri","Ripley County",5,10,164,79,85
050,29,181,"Missouri","Ripley County",5,11,148,74,74
050,29,181,"Missouri","Ripley County",5,12,159,70,89
050,29,181,"Missouri","Ripley County",5,13,167,81,86
050,29,181,"Missouri","Ripley County",5,14,160,84,76
050,29,181,"Missouri","Ripley County",5,15,161,88,73
050,29,181,"Missouri","Ripley County",5,16,135,69,66
050,29,181,"Missouri","Ripley County",5,17,147,77,70
050,29,181,"Missouri","Ripley County",5,18,118,64,54
050,29,181,"Missouri","Ripley County",5,19,90,49,41
050,29,181,"Missouri","Ripley County",5,20,103,53,50
050,29,181,"Missouri","Ripley County",5,21,96,52,44
050,29,181,"Missouri","Ripley County",5,22,121,65,56
050,29,181,"Missouri","Ripley County",5,23,124,62,62
050,29,181,"Missouri","Ripley County",5,24,104,50,54
050,29,181,"Missouri","Ripley County",5,25,99,46,53
050,29,181,"Missouri","Ripley County",5,26,110,61,49
050,29,181,"Missouri","Ripley County",5,27,108,57,51
050,29,181,"Missouri","Ripley County",5,28,112,64,48
050,29,181,"Missouri","Ripley County",5,29,111,51,60
050,29,181,"Missouri","Ripley County",5,30,118,50,68
050,29,181,"Missouri","Ripley County",5,31,128,72,56
050,29,181,"Missouri","Ripley County",5,32,128,51,77
050,29,181,"Missouri","Ripley County",5,33,138,66,72
050,29,181,"Missouri","Ripley County",5,34,151,68,83
050,29,181,"Missouri","Ripley County",5,35,134,62,72
050,29,181,"Missouri","Ripley County",5,36,133,61,72
050,29,181,"Missouri","Ripley County",5,37,141,68,73
050,29,181,"Missouri","Ripley County",5,38,130,68,62
050,29,181,"Missouri","Ripley County",5,39,124,76,48
050,29,181,"Missouri","Ripley County",5,40,130,66,64
050,29,181,"Missouri","Ripley County",5,41,124,58,66
050,29,181,"Missouri","Ripley County",5,42,127,59,68
050,29,181,"Missouri","Ripley County",5,43,128,68,60
050,29,181,"Missouri","Ripley County",5,44,125,63,62
050,29,181,"Missouri","Ripley County",5,45,128,67,61
050,29,181,"Missouri","Ripley County",5,46,134,65,69
050,29,181,"Missouri","Ripley County",5,47,120,67,53
050,29,181,"Missouri","Ripley County",5,48,126,63,63
050,29,181,"Missouri","Ripley County",5,49,122,64,58
050,29,181,"Missouri","Ripley County",5,50,125,64,61
050,29,181,"Missouri","Ripley County",5,51,134,77,57
050,29,181,"Missouri","Ripley County",5,52,163,87,76
050,29,181,"Missouri","Ripley County",5,53,145,70,75
050,29,181,"Missouri","Ripley County",5,54,122,65,57
050,29,181,"Missouri","Ripley County",5,55,111,59,52
050,29,181,"Missouri","Ripley County",5,56,122,63,59
050,29,181,"Missouri","Ripley County",5,57,122,57,65
050,29,181,"Missouri","Ripley County",5,58,143,73,70
050,29,181,"Missouri","Ripley County",5,59,148,73,75
050,29,181,"Missouri","Ripley County",5,60,142,70,72
050,29,181,"Missouri","Ripley County",5,61,173,83,90
050,29,181,"Missouri","Ripley County",5,62,161,74,87
050,29,181,"Missouri","Ripley County",5,63,149,77,72
050,29,181,"Missouri","Ripley County",5,64,142,82,60
050,29,181,"Missouri","Ripley County",5,65,145,76,69
050,29,181,"Missouri","Ripley County",5,66,139,68,71
050,29,181,"Missouri","Ripley County",5,67,146,74,72
050,29,181,"Missouri","Ripley County",5,68,136,63,73
050,29,181,"Missouri","Ripley County",5,69,117,48,69
050,29,181,"Missouri","Ripley County",5,70,111,48,63
050,29,181,"Missouri","Ripley County",5,71,122,61,61
050,29,181,"Missouri","Ripley County",5,72,121,56,65
050,29,181,"Missouri","Ripley County",5,73,99,41,58
050,29,181,"Missouri","Ripley County",5,74,86,44,42
050,29,181,"Missouri","Ripley County",5,75,101,55,46
050,29,181,"Missouri","Ripley County",5,76,96,50,46
050,29,181,"Missouri","Ripley County",5,77,68,33,35
050,29,181,"Missouri","Ripley County",5,78,77,32,45
050,29,181,"Missouri","Ripley County",5,79,78,36,42
050,29,181,"Missouri","Ripley County",5,80,70,33,37
050,29,181,"Missouri","Ripley County",5,81,46,17,29
050,29,181,"Missouri","Ripley County",5,82,50,21,29
050,29,181,"Missouri","Ripley County",5,83,43,18,25
050,29,181,"Missouri","Ripley County",5,84,58,26,32
050,29,181,"Missouri","Ripley County",5,85,232,111,121
050,29,183,"Missouri","St. Charles County",1,0,4214,2155,2059
050,29,183,"Missouri","St. Charles County",1,1,4414,2272,2142
050,29,183,"Missouri","St. Charles County",1,2,4573,2325,2248
050,29,183,"Missouri","St. Charles County",1,3,4830,2471,2359
050,29,183,"Missouri","St. Charles County",1,4,4968,2502,2466
050,29,183,"Missouri","St. Charles County",1,5,4991,2509,2482
050,29,183,"Missouri","St. Charles County",1,6,5150,2626,2524
050,29,183,"Missouri","St. Charles County",1,7,5153,2653,2500
050,29,183,"Missouri","St. Charles County",1,8,5085,2645,2440
050,29,183,"Missouri","St. Charles County",1,9,5322,2712,2610
050,29,183,"Missouri","St. Charles County",1,10,5510,2812,2698
050,29,183,"Missouri","St. Charles County",1,11,5675,2958,2717
050,29,183,"Missouri","St. Charles County",1,12,5776,3024,2752
050,29,183,"Missouri","St. Charles County",1,13,5719,2885,2834
050,29,183,"Missouri","St. Charles County",1,14,5642,2824,2818
050,29,183,"Missouri","St. Charles County",1,15,5695,2836,2859
050,29,183,"Missouri","St. Charles County",1,16,5770,2965,2805
050,29,183,"Missouri","St. Charles County",1,17,5603,2924,2679
050,29,183,"Missouri","St. Charles County",1,18,4883,2526,2357
050,29,183,"Missouri","St. Charles County",1,19,4401,2273,2128
050,29,183,"Missouri","St. Charles County",1,20,4599,2353,2246
050,29,183,"Missouri","St. Charles County",1,21,4687,2368,2319
050,29,183,"Missouri","St. Charles County",1,22,4644,2320,2324
050,29,183,"Missouri","St. Charles County",1,23,4695,2364,2331
050,29,183,"Missouri","St. Charles County",1,24,4722,2402,2320
050,29,183,"Missouri","St. Charles County",1,25,4547,2326,2221
050,29,183,"Missouri","St. Charles County",1,26,4616,2340,2276
050,29,183,"Missouri","St. Charles County",1,27,4845,2518,2327
050,29,183,"Missouri","St. Charles County",1,28,4949,2491,2458
050,29,183,"Missouri","St. Charles County",1,29,4992,2475,2517
050,29,183,"Missouri","St. Charles County",1,30,5078,2557,2521
050,29,183,"Missouri","St. Charles County",1,31,5207,2608,2599
050,29,183,"Missouri","St. Charles County",1,32,5282,2591,2691
050,29,183,"Missouri","St. Charles County",1,33,5485,2766,2719
050,29,183,"Missouri","St. Charles County",1,34,5702,2877,2825
050,29,183,"Missouri","St. Charles County",1,35,5838,2909,2929
050,29,183,"Missouri","St. Charles County",1,36,5848,2927,2921
050,29,183,"Missouri","St. Charles County",1,37,6094,3065,3029
050,29,183,"Missouri","St. Charles County",1,38,5959,3043,2916
050,29,183,"Missouri","St. Charles County",1,39,5990,3020,2970
050,29,183,"Missouri","St. Charles County",1,40,5786,2909,2877
050,29,183,"Missouri","St. Charles County",1,41,5531,2833,2698
050,29,183,"Missouri","St. Charles County",1,42,5383,2760,2623
050,29,183,"Missouri","St. Charles County",1,43,5116,2569,2547
050,29,183,"Missouri","St. Charles County",1,44,4950,2488,2462
050,29,183,"Missouri","St. Charles County",1,45,4985,2529,2456
050,29,183,"Missouri","St. Charles County",1,46,4812,2456,2356
050,29,183,"Missouri","St. Charles County",1,47,4894,2447,2447
050,29,183,"Missouri","St. Charles County",1,48,5270,2591,2679
050,29,183,"Missouri","St. Charles County",1,49,5606,2786,2820
050,29,183,"Missouri","St. Charles County",1,50,5283,2618,2665
050,29,183,"Missouri","St. Charles County",1,51,5140,2567,2573
050,29,183,"Missouri","St. Charles County",1,52,4973,2463,2510
050,29,183,"Missouri","St. Charles County",1,53,5133,2550,2583
050,29,183,"Missouri","St. Charles County",1,54,5246,2589,2657
050,29,183,"Missouri","St. Charles County",1,55,5665,2772,2893
050,29,183,"Missouri","St. Charles County",1,56,5847,2880,2967
050,29,183,"Missouri","St. Charles County",1,57,5773,2847,2926
050,29,183,"Missouri","St. Charles County",1,58,5934,2920,3014
050,29,183,"Missouri","St. Charles County",1,59,5908,2904,3004
050,29,183,"Missouri","St. Charles County",1,60,5724,2807,2917
050,29,183,"Missouri","St. Charles County",1,61,5592,2741,2851
050,29,183,"Missouri","St. Charles County",1,62,5473,2691,2782
050,29,183,"Missouri","St. Charles County",1,63,5232,2577,2655
050,29,183,"Missouri","St. Charles County",1,64,4948,2429,2519
050,29,183,"Missouri","St. Charles County",1,65,4693,2266,2427
050,29,183,"Missouri","St. Charles County",1,66,4425,2110,2315
050,29,183,"Missouri","St. Charles County",1,67,4195,1954,2241
050,29,183,"Missouri","St. Charles County",1,68,4140,1941,2199
050,29,183,"Missouri","St. Charles County",1,69,3857,1775,2082
050,29,183,"Missouri","St. Charles County",1,70,3633,1680,1953
050,29,183,"Missouri","St. Charles County",1,71,3585,1631,1954
050,29,183,"Missouri","St. Charles County",1,72,3652,1662,1990
050,29,183,"Missouri","St. Charles County",1,73,3608,1673,1935
050,29,183,"Missouri","St. Charles County",1,74,2473,1114,1359
050,29,183,"Missouri","St. Charles County",1,75,2489,1166,1323
050,29,183,"Missouri","St. Charles County",1,76,2495,1125,1370
050,29,183,"Missouri","St. Charles County",1,77,2462,1083,1379
050,29,183,"Missouri","St. Charles County",1,78,2056,912,1144
050,29,183,"Missouri","St. Charles County",1,79,1803,782,1021
050,29,183,"Missouri","St. Charles County",1,80,1621,701,920
050,29,183,"Missouri","St. Charles County",1,81,1581,673,908
050,29,183,"Missouri","St. Charles County",1,82,1463,618,845
050,29,183,"Missouri","St. Charles County",1,83,1332,564,768
050,29,183,"Missouri","St. Charles County",1,84,1242,515,727
050,29,183,"Missouri","St. Charles County",1,85,7109,2504,4605
050,29,183,"Missouri","St. Charles County",2,0,4230,2153,2077
050,29,183,"Missouri","St. Charles County",2,1,4386,2251,2135
050,29,183,"Missouri","St. Charles County",2,2,4583,2338,2245
050,29,183,"Missouri","St. Charles County",2,3,4784,2440,2344
050,29,183,"Missouri","St. Charles County",2,4,4971,2512,2459
050,29,183,"Missouri","St. Charles County",2,5,5018,2518,2500
050,29,183,"Missouri","St. Charles County",2,6,5136,2614,2522
050,29,183,"Missouri","St. Charles County",2,7,5161,2652,2509
050,29,183,"Missouri","St. Charles County",2,8,5108,2650,2458
050,29,183,"Missouri","St. Charles County",2,9,5278,2703,2575
050,29,183,"Missouri","St. Charles County",2,10,5475,2789,2686
050,29,183,"Missouri","St. Charles County",2,11,5623,2918,2705
050,29,183,"Missouri","St. Charles County",2,12,5790,3030,2760
050,29,183,"Missouri","St. Charles County",2,13,5735,2919,2816
050,29,183,"Missouri","St. Charles County",2,14,5675,2841,2834
050,29,183,"Missouri","St. Charles County",2,15,5698,2843,2855
050,29,183,"Missouri","St. Charles County",2,16,5761,2940,2821
050,29,183,"Missouri","St. Charles County",2,17,5647,2930,2717
050,29,183,"Missouri","St. Charles County",2,18,4886,2552,2334
050,29,183,"Missouri","St. Charles County",2,19,4416,2284,2132
050,29,183,"Missouri","St. Charles County",2,20,4649,2381,2268
050,29,183,"Missouri","St. Charles County",2,21,4703,2373,2330
050,29,183,"Missouri","St. Charles County",2,22,4678,2340,2338
050,29,183,"Missouri","St. Charles County",2,23,4687,2354,2333
050,29,183,"Missouri","St. Charles County",2,24,4690,2381,2309
050,29,183,"Missouri","St. Charles County",2,25,4598,2354,2244
050,29,183,"Missouri","St. Charles County",2,26,4651,2372,2279
050,29,183,"Missouri","St. Charles County",2,27,4803,2477,2326
050,29,183,"Missouri","St. Charles County",2,28,4946,2501,2445
050,29,183,"Missouri","St. Charles County",2,29,5025,2493,2532
050,29,183,"Missouri","St. Charles County",2,30,5131,2569,2562
050,29,183,"Missouri","St. Charles County",2,31,5211,2612,2599
050,29,183,"Missouri","St. Charles County",2,32,5286,2605,2681
050,29,183,"Missouri","St. Charles County",2,33,5464,2741,2723
050,29,183,"Missouri","St. Charles County",2,34,5674,2865,2809
050,29,183,"Missouri","St. Charles County",2,35,5864,2931,2933
050,29,183,"Missouri","St. Charles County",2,36,5834,2913,2921
050,29,183,"Missouri","St. Charles County",2,37,6061,3049,3012
050,29,183,"Missouri","St. Charles County",2,38,6027,3065,2962
050,29,183,"Missouri","St. Charles County",2,39,5987,3028,2959
050,29,183,"Missouri","St. Charles County",2,40,5879,2957,2922
050,29,183,"Missouri","St. Charles County",2,41,5604,2858,2746
050,29,183,"Missouri","St. Charles County",2,42,5404,2771,2633
050,29,183,"Missouri","St. Charles County",2,43,5210,2628,2582
050,29,183,"Missouri","St. Charles County",2,44,4948,2491,2457
050,29,183,"Missouri","St. Charles County",2,45,5003,2536,2467
050,29,183,"Missouri","St. Charles County",2,46,4843,2471,2372
050,29,183,"Missouri","St. Charles County",2,47,4873,2452,2421
050,29,183,"Missouri","St. Charles County",2,48,5178,2553,2625
050,29,183,"Missouri","St. Charles County",2,49,5548,2751,2797
050,29,183,"Missouri","St. Charles County",2,50,5376,2668,2708
050,29,183,"Missouri","St. Charles County",2,51,5154,2569,2585
050,29,183,"Missouri","St. Charles County",2,52,4997,2478,2519
050,29,183,"Missouri","St. Charles County",2,53,5092,2526,2566
050,29,183,"Missouri","St. Charles County",2,54,5207,2575,2632
050,29,183,"Missouri","St. Charles County",2,55,5561,2723,2838
050,29,183,"Missouri","St. Charles County",2,56,5824,2863,2961
050,29,183,"Missouri","St. Charles County",2,57,5806,2862,2944
050,29,183,"Missouri","St. Charles County",2,58,5881,2892,2989
050,29,183,"Missouri","St. Charles County",2,59,5948,2931,3017
050,29,183,"Missouri","St. Charles County",2,60,5756,2823,2933
050,29,183,"Missouri","St. Charles County",2,61,5607,2746,2861
050,29,183,"Missouri","St. Charles County",2,62,5490,2695,2795
050,29,183,"Missouri","St. Charles County",2,63,5337,2626,2711
050,29,183,"Missouri","St. Charles County",2,64,4980,2441,2539
050,29,183,"Missouri","St. Charles County",2,65,4748,2299,2449
050,29,183,"Missouri","St. Charles County",2,66,4483,2143,2340
050,29,183,"Missouri","St. Charles County",2,67,4240,1983,2257
050,29,183,"Missouri","St. Charles County",2,68,4119,1924,2195
050,29,183,"Missouri","St. Charles County",2,69,3943,1820,2123
050,29,183,"Missouri","St. Charles County",2,70,3661,1686,1975
050,29,183,"Missouri","St. Charles County",2,71,3597,1635,1962
050,29,183,"Missouri","St. Charles County",2,72,3565,1616,1949
050,29,183,"Missouri","St. Charles County",2,73,3785,1744,2041
050,29,183,"Missouri","St. Charles County",2,74,2568,1165,1403
050,29,183,"Missouri","St. Charles County",2,75,2483,1147,1336
050,29,183,"Missouri","St. Charles County",2,76,2458,1116,1342
050,29,183,"Missouri","St. Charles County",2,77,2509,1103,1406
050,29,183,"Missouri","St. Charles County",2,78,2097,927,1170
050,29,183,"Missouri","St. Charles County",2,79,1838,804,1034
050,29,183,"Missouri","St. Charles County",2,80,1655,712,943
050,29,183,"Missouri","St. Charles County",2,81,1580,672,908
050,29,183,"Missouri","St. Charles County",2,82,1478,619,859
050,29,183,"Missouri","St. Charles County",2,83,1336,564,772
050,29,183,"Missouri","St. Charles County",2,84,1255,524,731
050,29,183,"Missouri","St. Charles County",2,85,7183,2547,4636
050,29,183,"Missouri","St. Charles County",3,0,4063,2121,1942
050,29,183,"Missouri","St. Charles County",3,1,4365,2208,2157
050,29,183,"Missouri","St. Charles County",3,2,4474,2301,2173
050,29,183,"Missouri","St. Charles County",3,3,4680,2383,2297
050,29,183,"Missouri","St. Charles County",3,4,4862,2502,2360
050,29,183,"Missouri","St. Charles County",3,5,5039,2520,2519
050,29,183,"Missouri","St. Charles County",3,6,5148,2571,2577
050,29,183,"Missouri","St. Charles County",3,7,5219,2652,2567
050,29,183,"Missouri","St. Charles County",3,8,5208,2687,2521
050,29,183,"Missouri","St. Charles County",3,9,5128,2643,2485
050,29,183,"Missouri","St. Charles County",3,10,5342,2725,2617
050,29,183,"Missouri","St. Charles County",3,11,5524,2835,2689
050,29,183,"Missouri","St. Charles County",3,12,5694,2947,2747
050,29,183,"Missouri","St. Charles County",3,13,5818,3057,2761
050,29,183,"Missouri","St. Charles County",3,14,5766,2954,2812
050,29,183,"Missouri","St. Charles County",3,15,5741,2891,2850
050,29,183,"Missouri","St. Charles County",3,16,5737,2875,2862
050,29,183,"Missouri","St. Charles County",3,17,5762,2965,2797
050,29,183,"Missouri","St. Charles County",3,18,5063,2692,2371
050,29,183,"Missouri","St. Charles County",3,19,4416,2314,2102
050,29,183,"Missouri","St. Charles County",3,20,4713,2417,2296
050,29,183,"Missouri","St. Charles County",3,21,4812,2423,2389
050,29,183,"Missouri","St. Charles County",3,22,4854,2454,2400
050,29,183,"Missouri","St. Charles County",3,23,4714,2409,2305
050,29,183,"Missouri","St. Charles County",3,24,4704,2419,2285
050,29,183,"Missouri","St. Charles County",3,25,4792,2411,2381
050,29,183,"Missouri","St. Charles County",3,26,4777,2469,2308
050,29,183,"Missouri","St. Charles County",3,27,4890,2480,2410
050,29,183,"Missouri","St. Charles County",3,28,4955,2544,2411
050,29,183,"Missouri","St. Charles County",3,29,5073,2549,2524
050,29,183,"Missouri","St. Charles County",3,30,5160,2542,2618
050,29,183,"Missouri","St. Charles County",3,31,5317,2685,2632
050,29,183,"Missouri","St. Charles County",3,32,5284,2660,2624
050,29,183,"Missouri","St. Charles County",3,33,5436,2653,2783
050,29,183,"Missouri","St. Charles County",3,34,5610,2791,2819
050,29,183,"Missouri","St. Charles County",3,35,5808,2953,2855
050,29,183,"Missouri","St. Charles County",3,36,5918,2972,2946
050,29,183,"Missouri","St. Charles County",3,37,5903,2957,2946
050,29,183,"Missouri","St. Charles County",3,38,6106,3089,3017
050,29,183,"Missouri","St. Charles County",3,39,6066,3080,2986
050,29,183,"Missouri","St. Charles County",3,40,6022,3043,2979
050,29,183,"Missouri","St. Charles County",3,41,5886,2955,2931
050,29,183,"Missouri","St. Charles County",3,42,5633,2867,2766
050,29,183,"Missouri","St. Charles County",3,43,5419,2780,2639
050,29,183,"Missouri","St. Charles County",3,44,5229,2624,2605
050,29,183,"Missouri","St. Charles County",3,45,4950,2481,2469
050,29,183,"Missouri","St. Charles County",3,46,5021,2524,2497
050,29,183,"Missouri","St. Charles County",3,47,4854,2480,2374
050,29,183,"Missouri","St. Charles County",3,48,4917,2461,2456
050,29,183,"Missouri","St. Charles County",3,49,5195,2572,2623
050,29,183,"Missouri","St. Charles County",3,50,5576,2762,2814
050,29,183,"Missouri","St. Charles County",3,51,5408,2702,2706
050,29,183,"Missouri","St. Charles County",3,52,5166,2570,2596
050,29,183,"Missouri","St. Charles County",3,53,4968,2457,2511
050,29,183,"Missouri","St. Charles County",3,54,5120,2537,2583
050,29,183,"Missouri","St. Charles County",3,55,5196,2569,2627
050,29,183,"Missouri","St. Charles County",3,56,5534,2717,2817
050,29,183,"Missouri","St. Charles County",3,57,5790,2842,2948
050,29,183,"Missouri","St. Charles County",3,58,5758,2831,2927
050,29,183,"Missouri","St. Charles County",3,59,5853,2881,2972
050,29,183,"Missouri","St. Charles County",3,60,5929,2897,3032
050,29,183,"Missouri","St. Charles County",3,61,5716,2805,2911
050,29,183,"Missouri","St. Charles County",3,62,5576,2725,2851
050,29,183,"Missouri","St. Charles County",3,63,5428,2669,2759
050,29,183,"Missouri","St. Charles County",3,64,5371,2643,2728
050,29,183,"Missouri","St. Charles County",3,65,4954,2411,2543
050,29,183,"Missouri","St. Charles County",3,66,4703,2268,2435
050,29,183,"Missouri","St. Charles County",3,67,4442,2115,2327
050,29,183,"Missouri","St. Charles County",3,68,4197,1947,2250
050,29,183,"Missouri","St. Charles County",3,69,4078,1908,2170
050,29,183,"Missouri","St. Charles County",3,70,3924,1803,2121
050,29,183,"Missouri","St. Charles County",3,71,3581,1638,1943
050,29,183,"Missouri","St. Charles County",3,72,3522,1592,1930
050,29,183,"Missouri","St. Charles County",3,73,3456,1549,1907
050,29,183,"Missouri","St. Charles County",3,74,3713,1687,2026
050,29,183,"Missouri","St. Charles County",3,75,2515,1136,1379
050,29,183,"Missouri","St. Charles County",3,76,2413,1094,1319
050,29,183,"Missouri","St. Charles County",3,77,2371,1058,1313
050,29,183,"Missouri","St. Charles County",3,78,2442,1070,1372
050,29,183,"Missouri","St. Charles County",3,79,2015,874,1141
050,29,183,"Missouri","St. Charles County",3,80,1780,774,1006
050,29,183,"Missouri","St. Charles County",3,81,1560,663,897
050,29,183,"Missouri","St. Charles County",3,82,1481,616,865
050,29,183,"Missouri","St. Charles County",3,83,1375,563,812
050,29,183,"Missouri","St. Charles County",3,84,1265,521,744
050,29,183,"Missouri","St. Charles County",3,85,7222,2607,4615
050,29,183,"Missouri","St. Charles County",4,0,4205,2203,2002
050,29,183,"Missouri","St. Charles County",4,1,4210,2198,2012
050,29,183,"Missouri","St. Charles County",4,2,4523,2287,2236
050,29,183,"Missouri","St. Charles County",4,3,4588,2356,2232
050,29,183,"Missouri","St. Charles County",4,4,4787,2444,2343
050,29,183,"Missouri","St. Charles County",4,5,4941,2547,2394
050,29,183,"Missouri","St. Charles County",4,6,5123,2577,2546
050,29,183,"Missouri","St. Charles County",4,7,5302,2632,2670
050,29,183,"Missouri","St. Charles County",4,8,5268,2682,2586
050,29,183,"Missouri","St. Charles County",4,9,5290,2708,2582
050,29,183,"Missouri","St. Charles County",4,10,5239,2699,2540
050,29,183,"Missouri","St. Charles County",4,11,5400,2743,2657
050,29,183,"Missouri","St. Charles County",4,12,5583,2862,2721
050,29,183,"Missouri","St. Charles County",4,13,5742,2991,2751
050,29,183,"Missouri","St. Charles County",4,14,5925,3117,2808
050,29,183,"Missouri","St. Charles County",4,15,5799,2986,2813
050,29,183,"Missouri","St. Charles County",4,16,5780,2914,2866
050,29,183,"Missouri","St. Charles County",4,17,5775,2874,2901
050,29,183,"Missouri","St. Charles County",4,18,5120,2719,2401
050,29,183,"Missouri","St. Charles County",4,19,4409,2347,2062
050,29,183,"Missouri","St. Charles County",4,20,4565,2380,2185
050,29,183,"Missouri","St. Charles County",4,21,4853,2417,2436
050,29,183,"Missouri","St. Charles County",4,22,4962,2479,2483
050,29,183,"Missouri","St. Charles County",4,23,4813,2414,2399
050,29,183,"Missouri","St. Charles County",4,24,4656,2388,2268
050,29,183,"Missouri","St. Charles County",4,25,4682,2400,2282
050,29,183,"Missouri","St. Charles County",4,26,4759,2438,2321
050,29,183,"Missouri","St. Charles County",4,27,4761,2458,2303
050,29,183,"Missouri","St. Charles County",4,28,4899,2446,2453
050,29,183,"Missouri","St. Charles County",4,29,5037,2549,2488
050,29,183,"Missouri","St. Charles County",4,30,5226,2606,2620
050,29,183,"Missouri","St. Charles County",4,31,5297,2646,2651
050,29,183,"Missouri","St. Charles County",4,32,5486,2749,2737
050,29,183,"Missouri","St. Charles County",4,33,5443,2744,2699
050,29,183,"Missouri","St. Charles County",4,34,5521,2736,2785
050,29,183,"Missouri","St. Charles County",4,35,5720,2846,2874
050,29,183,"Missouri","St. Charles County",4,36,5909,3004,2905
050,29,183,"Missouri","St. Charles County",4,37,6002,3031,2971
050,29,183,"Missouri","St. Charles County",4,38,6018,3011,3007
050,29,183,"Missouri","St. Charles County",4,39,6162,3117,3045
050,29,183,"Missouri","St. Charles County",4,40,6142,3119,3023
050,29,183,"Missouri","St. Charles County",4,41,6063,3059,3004
050,29,183,"Missouri","St. Charles County",4,42,5930,2981,2949
050,29,183,"Missouri","St. Charles County",4,43,5732,2911,2821
050,29,183,"Missouri","St. Charles County",4,44,5462,2796,2666
050,29,183,"Missouri","St. Charles County",4,45,5224,2618,2606
050,29,183,"Missouri","St. Charles County",4,46,4961,2487,2474
050,29,183,"Missouri","St. Charles County",4,47,5048,2537,2511
050,29,183,"Missouri","St. Charles County",4,48,4860,2480,2380
050,29,183,"Missouri","St. Charles County",4,49,4889,2449,2440
050,29,183,"Missouri","St. Charles County",4,50,5128,2523,2605
050,29,183,"Missouri","St. Charles County",4,51,5547,2780,2767
050,29,183,"Missouri","St. Charles County",4,52,5410,2690,2720
050,29,183,"Missouri","St. Charles County",4,53,5140,2565,2575
050,29,183,"Missouri","St. Charles County",4,54,4939,2420,2519
050,29,183,"Missouri","St. Charles County",4,55,5064,2502,2562
050,29,183,"Missouri","St. Charles County",4,56,5195,2577,2618
050,29,183,"Missouri","St. Charles County",4,57,5525,2698,2827
050,29,183,"Missouri","St. Charles County",4,58,5717,2786,2931
050,29,183,"Missouri","St. Charles County",4,59,5714,2791,2923
050,29,183,"Missouri","St. Charles County",4,60,5784,2834,2950
050,29,183,"Missouri","St. Charles County",4,61,5864,2851,3013
050,29,183,"Missouri","St. Charles County",4,62,5621,2761,2860
050,29,183,"Missouri","St. Charles County",4,63,5526,2696,2830
050,29,183,"Missouri","St. Charles County",4,64,5411,2673,2738
050,29,183,"Missouri","St. Charles County",4,65,5326,2596,2730
050,29,183,"Missouri","St. Charles County",4,66,4917,2374,2543
050,29,183,"Missouri","St. Charles County",4,67,4659,2229,2430
050,29,183,"Missouri","St. Charles County",4,68,4410,2060,2350
050,29,183,"Missouri","St. Charles County",4,69,4156,1935,2221
050,29,183,"Missouri","St. Charles County",4,70,4033,1889,2144
050,29,183,"Missouri","St. Charles County",4,71,3886,1774,2112
050,29,183,"Missouri","St. Charles County",4,72,3501,1588,1913
050,29,183,"Missouri","St. Charles County",4,73,3506,1563,1943
050,29,183,"Missouri","St. Charles County",4,74,3432,1521,1911
050,29,183,"Missouri","St. Charles County",4,75,3625,1635,1990
050,29,183,"Missouri","St. Charles County",4,76,2480,1119,1361
050,29,183,"Missouri","St. Charles County",4,77,2331,1051,1280
050,29,183,"Missouri","St. Charles County",4,78,2302,1026,1276
050,29,183,"Missouri","St. Charles County",4,79,2363,1029,1334
050,29,183,"Missouri","St. Charles County",4,80,1945,847,1098
050,29,183,"Missouri","St. Charles County",4,81,1706,729,977
050,29,183,"Missouri","St. Charles County",4,82,1462,604,858
050,29,183,"Missouri","St. Charles County",4,83,1394,558,836
050,29,183,"Missouri","St. Charles County",4,84,1322,526,796
050,29,183,"Missouri","St. Charles County",4,85,7366,2653,4713
050,29,183,"Missouri","St. Charles County",5,0,4060,2126,1934
050,29,183,"Missouri","St. Charles County",5,1,4344,2246,2098
050,29,183,"Missouri","St. Charles County",5,2,4308,2277,2031
050,29,183,"Missouri","St. Charles County",5,3,4639,2323,2316
050,29,183,"Missouri","St. Charles County",5,4,4678,2409,2269
050,29,183,"Missouri","St. Charles County",5,5,4885,2517,2368
050,29,183,"Missouri","St. Charles County",5,6,5000,2589,2411
050,29,183,"Missouri","St. Charles County",5,7,5169,2599,2570
050,29,183,"Missouri","St. Charles County",5,8,5332,2626,2706
050,29,183,"Missouri","St. Charles County",5,9,5261,2681,2580
050,29,183,"Missouri","St. Charles County",5,10,5361,2746,2615
050,29,183,"Missouri","St. Charles County",5,11,5291,2717,2574
050,29,183,"Missouri","St. Charles County",5,12,5454,2783,2671
050,29,183,"Missouri","St. Charles County",5,13,5607,2856,2751
050,29,183,"Missouri","St. Charles County",5,14,5755,2981,2774
050,29,183,"Missouri","St. Charles County",5,15,5993,3173,2820
050,29,183,"Missouri","St. Charles County",5,16,5808,2989,2819
050,29,183,"Missouri","St. Charles County",5,17,5849,2966,2883
050,29,183,"Missouri","St. Charles County",5,18,5066,2627,2439
050,29,183,"Missouri","St. Charles County",5,19,4496,2409,2087
050,29,183,"Missouri","St. Charles County",5,20,4689,2473,2216
050,29,183,"Missouri","St. Charles County",5,21,4706,2381,2325
050,29,183,"Missouri","St. Charles County",5,22,5040,2471,2569
050,29,183,"Missouri","St. Charles County",5,23,4973,2485,2488
050,29,183,"Missouri","St. Charles County",5,24,4784,2418,2366
050,29,183,"Missouri","St. Charles County",5,25,4643,2412,2231
050,29,183,"Missouri","St. Charles County",5,26,4657,2368,2289
050,29,183,"Missouri","St. Charles County",5,27,4760,2438,2322
050,29,183,"Missouri","St. Charles County",5,28,4890,2503,2387
050,29,183,"Missouri","St. Charles County",5,29,4949,2461,2488
050,29,183,"Missouri","St. Charles County",5,30,5197,2626,2571
050,29,183,"Missouri","St. Charles County",5,31,5355,2691,2664
050,29,183,"Missouri","St. Charles County",5,32,5422,2722,2700
050,29,183,"Missouri","St. Charles County",5,33,5609,2815,2794
050,29,183,"Missouri","St. Charles County",5,34,5558,2801,2757
050,29,183,"Missouri","St. Charles County",5,35,5604,2778,2826
050,29,183,"Missouri","St. Charles County",5,36,5811,2904,2907
050,29,183,"Missouri","St. Charles County",5,37,5938,3027,2911
050,29,183,"Missouri","St. Charles County",5,38,6050,3073,2977
050,29,183,"Missouri","St. Charles County",5,39,6069,3025,3044
050,29,183,"Missouri","St. Charles County",5,40,6220,3164,3056
050,29,183,"Missouri","St. Charles County",5,41,6170,3135,3035
050,29,183,"Missouri","St. Charles County",5,42,6125,3103,3022
050,29,183,"Missouri","St. Charles County",5,43,5923,2977,2946
050,29,183,"Missouri","St. Charles County",5,44,5722,2911,2811
050,29,183,"Missouri","St. Charles County",5,45,5475,2812,2663
050,29,183,"Missouri","St. Charles County",5,46,5217,2611,2606
050,29,183,"Missouri","St. Charles County",5,47,4984,2504,2480
050,29,183,"Missouri","St. Charles County",5,48,5052,2547,2505
050,29,183,"Missouri","St. Charles County",5,49,4802,2466,2336
050,29,183,"Missouri","St. Charles County",5,50,4859,2402,2457
050,29,183,"Missouri","St. Charles County",5,51,5125,2563,2562
050,29,183,"Missouri","St. Charles County",5,52,5483,2740,2743
050,29,183,"Missouri","St. Charles County",5,53,5377,2656,2721
050,29,183,"Missouri","St. Charles County",5,54,5116,2547,2569
050,29,183,"Missouri","St. Charles County",5,55,4879,2402,2477
050,29,183,"Missouri","St. Charles County",5,56,5064,2511,2553
050,29,183,"Missouri","St. Charles County",5,57,5146,2524,2622
050,29,183,"Missouri","St. Charles County",5,58,5496,2696,2800
050,29,183,"Missouri","St. Charles County",5,59,5697,2792,2905
050,29,183,"Missouri","St. Charles County",5,60,5701,2788,2913
050,29,183,"Missouri","St. Charles County",5,61,5730,2787,2943
050,29,183,"Missouri","St. Charles County",5,62,5791,2802,2989
050,29,183,"Missouri","St. Charles County",5,63,5565,2729,2836
050,29,183,"Missouri","St. Charles County",5,64,5505,2691,2814
050,29,183,"Missouri","St. Charles County",5,65,5404,2644,2760
050,29,183,"Missouri","St. Charles County",5,66,5257,2541,2716
050,29,183,"Missouri","St. Charles County",5,67,4887,2350,2537
050,29,183,"Missouri","St. Charles County",5,68,4632,2201,2431
050,29,183,"Missouri","St. Charles County",5,69,4360,2028,2332
050,29,183,"Missouri","St. Charles County",5,70,4109,1894,2215
050,29,183,"Missouri","St. Charles County",5,71,4001,1865,2136
050,29,183,"Missouri","St. Charles County",5,72,3825,1731,2094
050,29,183,"Missouri","St. Charles County",5,73,3482,1557,1925
050,29,183,"Missouri","St. Charles County",5,74,3473,1536,1937
050,29,183,"Missouri","St. Charles County",5,75,3359,1494,1865
050,29,183,"Missouri","St. Charles County",5,76,3557,1602,1955
050,29,183,"Missouri","St. Charles County",5,77,2419,1082,1337
050,29,183,"Missouri","St. Charles County",5,78,2247,1026,1221
050,29,183,"Missouri","St. Charles County",5,79,2221,989,1232
050,29,183,"Missouri","St. Charles County",5,80,2297,1002,1295
050,29,183,"Missouri","St. Charles County",5,81,1879,806,1073
050,29,183,"Missouri","St. Charles County",5,82,1608,671,937
050,29,183,"Missouri","St. Charles County",5,83,1394,566,828
050,29,183,"Missouri","St. Charles County",5,84,1330,517,813
050,29,183,"Missouri","St. Charles County",5,85,7634,2729,4905
050,29,185,"Missouri","St. Clair County",1,0,88,45,43
050,29,185,"Missouri","St. Clair County",1,1,94,46,48
050,29,185,"Missouri","St. Clair County",1,2,97,57,40
050,29,185,"Missouri","St. Clair County",1,3,99,54,45
050,29,185,"Missouri","St. Clair County",1,4,127,62,65
050,29,185,"Missouri","St. Clair County",1,5,120,74,46
050,29,185,"Missouri","St. Clair County",1,6,101,54,47
050,29,185,"Missouri","St. Clair County",1,7,93,49,44
050,29,185,"Missouri","St. Clair County",1,8,90,45,45
050,29,185,"Missouri","St. Clair County",1,9,93,46,47
050,29,185,"Missouri","St. Clair County",1,10,111,61,50
050,29,185,"Missouri","St. Clair County",1,11,102,46,56
050,29,185,"Missouri","St. Clair County",1,12,108,48,60
050,29,185,"Missouri","St. Clair County",1,13,125,63,62
050,29,185,"Missouri","St. Clair County",1,14,108,56,52
050,29,185,"Missouri","St. Clair County",1,15,136,70,66
050,29,185,"Missouri","St. Clair County",1,16,118,60,58
050,29,185,"Missouri","St. Clair County",1,17,112,61,51
050,29,185,"Missouri","St. Clair County",1,18,105,57,48
050,29,185,"Missouri","St. Clair County",1,19,75,44,31
050,29,185,"Missouri","St. Clair County",1,20,70,45,25
050,29,185,"Missouri","St. Clair County",1,21,72,42,30
050,29,185,"Missouri","St. Clair County",1,22,67,36,31
050,29,185,"Missouri","St. Clair County",1,23,83,45,38
050,29,185,"Missouri","St. Clair County",1,24,82,41,41
050,29,185,"Missouri","St. Clair County",1,25,92,43,49
050,29,185,"Missouri","St. Clair County",1,26,84,43,41
050,29,185,"Missouri","St. Clair County",1,27,100,48,52
050,29,185,"Missouri","St. Clair County",1,28,89,45,44
050,29,185,"Missouri","St. Clair County",1,29,95,55,40
050,29,185,"Missouri","St. Clair County",1,30,95,55,40
050,29,185,"Missouri","St. Clair County",1,31,84,51,33
050,29,185,"Missouri","St. Clair County",1,32,82,44,38
050,29,185,"Missouri","St. Clair County",1,33,92,43,49
050,29,185,"Missouri","St. Clair County",1,34,98,41,57
050,29,185,"Missouri","St. Clair County",1,35,89,36,53
050,29,185,"Missouri","St. Clair County",1,36,88,49,39
050,29,185,"Missouri","St. Clair County",1,37,107,61,46
050,29,185,"Missouri","St. Clair County",1,38,93,52,41
050,29,185,"Missouri","St. Clair County",1,39,82,35,47
050,29,185,"Missouri","St. Clair County",1,40,87,49,38
050,29,185,"Missouri","St. Clair County",1,41,89,46,43
050,29,185,"Missouri","St. Clair County",1,42,87,48,39
050,29,185,"Missouri","St. Clair County",1,43,92,45,47
050,29,185,"Missouri","St. Clair County",1,44,85,40,45
050,29,185,"Missouri","St. Clair County",1,45,96,48,48
050,29,185,"Missouri","St. Clair County",1,46,94,52,42
050,29,185,"Missouri","St. Clair County",1,47,112,56,56
050,29,185,"Missouri","St. Clair County",1,48,112,58,54
050,29,185,"Missouri","St. Clair County",1,49,131,71,60
050,29,185,"Missouri","St. Clair County",1,50,111,59,52
050,29,185,"Missouri","St. Clair County",1,51,102,49,53
050,29,185,"Missouri","St. Clair County",1,52,107,52,55
050,29,185,"Missouri","St. Clair County",1,53,113,55,58
050,29,185,"Missouri","St. Clair County",1,54,116,60,56
050,29,185,"Missouri","St. Clair County",1,55,124,62,62
050,29,185,"Missouri","St. Clair County",1,56,144,67,77
050,29,185,"Missouri","St. Clair County",1,57,144,85,59
050,29,185,"Missouri","St. Clair County",1,58,148,85,63
050,29,185,"Missouri","St. Clair County",1,59,164,89,75
050,29,185,"Missouri","St. Clair County",1,60,161,81,80
050,29,185,"Missouri","St. Clair County",1,61,151,73,78
050,29,185,"Missouri","St. Clair County",1,62,155,80,75
050,29,185,"Missouri","St. Clair County",1,63,158,84,74
050,29,185,"Missouri","St. Clair County",1,64,142,79,63
050,29,185,"Missouri","St. Clair County",1,65,132,67,65
050,29,185,"Missouri","St. Clair County",1,66,140,72,68
050,29,185,"Missouri","St. Clair County",1,67,133,70,63
050,29,185,"Missouri","St. Clair County",1,68,149,81,68
050,29,185,"Missouri","St. Clair County",1,69,149,86,63
050,29,185,"Missouri","St. Clair County",1,70,140,73,67
050,29,185,"Missouri","St. Clair County",1,71,129,64,65
050,29,185,"Missouri","St. Clair County",1,72,124,55,69
050,29,185,"Missouri","St. Clair County",1,73,128,61,67
050,29,185,"Missouri","St. Clair County",1,74,108,53,55
050,29,185,"Missouri","St. Clair County",1,75,98,53,45
050,29,185,"Missouri","St. Clair County",1,76,101,43,58
050,29,185,"Missouri","St. Clair County",1,77,92,44,48
050,29,185,"Missouri","St. Clair County",1,78,90,43,47
050,29,185,"Missouri","St. Clair County",1,79,83,45,38
050,29,185,"Missouri","St. Clair County",1,80,64,37,27
050,29,185,"Missouri","St. Clair County",1,81,74,33,41
050,29,185,"Missouri","St. Clair County",1,82,73,34,39
050,29,185,"Missouri","St. Clair County",1,83,57,30,27
050,29,185,"Missouri","St. Clair County",1,84,58,29,29
050,29,185,"Missouri","St. Clair County",1,85,290,104,186
050,29,185,"Missouri","St. Clair County",2,0,89,42,47
050,29,185,"Missouri","St. Clair County",2,1,93,47,46
050,29,185,"Missouri","St. Clair County",2,2,96,54,42
050,29,185,"Missouri","St. Clair County",2,3,102,56,46
050,29,185,"Missouri","St. Clair County",2,4,123,62,61
050,29,185,"Missouri","St. Clair County",2,5,124,72,52
050,29,185,"Missouri","St. Clair County",2,6,108,61,47
050,29,185,"Missouri","St. Clair County",2,7,98,53,45
050,29,185,"Missouri","St. Clair County",2,8,92,46,46
050,29,185,"Missouri","St. Clair County",2,9,96,48,48
050,29,185,"Missouri","St. Clair County",2,10,110,58,52
050,29,185,"Missouri","St. Clair County",2,11,105,49,56
050,29,185,"Missouri","St. Clair County",2,12,110,50,60
050,29,185,"Missouri","St. Clair County",2,13,122,60,62
050,29,185,"Missouri","St. Clair County",2,14,118,61,57
050,29,185,"Missouri","St. Clair County",2,15,130,67,63
050,29,185,"Missouri","St. Clair County",2,16,123,63,60
050,29,185,"Missouri","St. Clair County",2,17,116,63,53
050,29,185,"Missouri","St. Clair County",2,18,100,56,44
050,29,185,"Missouri","St. Clair County",2,19,77,44,33
050,29,185,"Missouri","St. Clair County",2,20,73,47,26
050,29,185,"Missouri","St. Clair County",2,21,70,41,29
050,29,185,"Missouri","St. Clair County",2,22,70,38,32
050,29,185,"Missouri","St. Clair County",2,23,79,43,36
050,29,185,"Missouri","St. Clair County",2,24,85,45,40
050,29,185,"Missouri","St. Clair County",2,25,94,45,49
050,29,185,"Missouri","St. Clair County",2,26,84,41,43
050,29,185,"Missouri","St. Clair County",2,27,98,47,51
050,29,185,"Missouri","St. Clair County",2,28,94,47,47
050,29,185,"Missouri","St. Clair County",2,29,96,54,42
050,29,185,"Missouri","St. Clair County",2,30,96,55,41
050,29,185,"Missouri","St. Clair County",2,31,86,52,34
050,29,185,"Missouri","St. Clair County",2,32,85,46,39
050,29,185,"Missouri","St. Clair County",2,33,89,42,47
050,29,185,"Missouri","St. Clair County",2,34,100,43,57
050,29,185,"Missouri","St. Clair County",2,35,91,37,54
050,29,185,"Missouri","St. Clair County",2,36,90,48,42
050,29,185,"Missouri","St. Clair County",2,37,105,59,46
050,29,185,"Missouri","St. Clair County",2,38,97,54,43
050,29,185,"Missouri","St. Clair County",2,39,85,40,45
050,29,185,"Missouri","St. Clair County",2,40,88,47,41
050,29,185,"Missouri","St. Clair County",2,41,90,48,42
050,29,185,"Missouri","St. Clair County",2,42,89,48,41
050,29,185,"Missouri","St. Clair County",2,43,92,47,45
050,29,185,"Missouri","St. Clair County",2,44,87,42,45
050,29,185,"Missouri","St. Clair County",2,45,96,48,48
050,29,185,"Missouri","St. Clair County",2,46,94,51,43
050,29,185,"Missouri","St. Clair County",2,47,109,56,53
050,29,185,"Missouri","St. Clair County",2,48,111,56,55
050,29,185,"Missouri","St. Clair County",2,49,128,68,60
050,29,185,"Missouri","St. Clair County",2,50,115,61,54
050,29,185,"Missouri","St. Clair County",2,51,106,53,53
050,29,185,"Missouri","St. Clair County",2,52,108,53,55
050,29,185,"Missouri","St. Clair County",2,53,110,53,57
050,29,185,"Missouri","St. Clair County",2,54,116,59,57
050,29,185,"Missouri","St. Clair County",2,55,124,62,62
050,29,185,"Missouri","St. Clair County",2,56,139,65,74
050,29,185,"Missouri","St. Clair County",2,57,145,82,63
050,29,185,"Missouri","St. Clair County",2,58,149,86,63
050,29,185,"Missouri","St. Clair County",2,59,162,88,74
050,29,185,"Missouri","St. Clair County",2,60,161,82,79
050,29,185,"Missouri","St. Clair County",2,61,154,76,78
050,29,185,"Missouri","St. Clair County",2,62,154,78,76
050,29,185,"Missouri","St. Clair County",2,63,158,84,74
050,29,185,"Missouri","St. Clair County",2,64,146,80,66
050,29,185,"Missouri","St. Clair County",2,65,136,72,64
050,29,185,"Missouri","St. Clair County",2,66,139,71,68
050,29,185,"Missouri","St. Clair County",2,67,135,71,64
050,29,185,"Missouri","St. Clair County",2,68,143,78,65
050,29,185,"Missouri","St. Clair County",2,69,151,86,65
050,29,185,"Missouri","St. Clair County",2,70,139,75,64
050,29,185,"Missouri","St. Clair County",2,71,130,64,66
050,29,185,"Missouri","St. Clair County",2,72,121,55,66
050,29,185,"Missouri","St. Clair County",2,73,132,62,70
050,29,185,"Missouri","St. Clair County",2,74,106,52,54
050,29,185,"Missouri","St. Clair County",2,75,99,52,47
050,29,185,"Missouri","St. Clair County",2,76,100,45,55
050,29,185,"Missouri","St. Clair County",2,77,96,45,51
050,29,185,"Missouri","St. Clair County",2,78,87,41,46
050,29,185,"Missouri","St. Clair County",2,79,81,43,38
050,29,185,"Missouri","St. Clair County",2,80,68,39,29
050,29,185,"Missouri","St. Clair County",2,81,69,32,37
050,29,185,"Missouri","St. Clair County",2,82,74,34,40
050,29,185,"Missouri","St. Clair County",2,83,60,31,29
050,29,185,"Missouri","St. Clair County",2,84,58,29,29
050,29,185,"Missouri","St. Clair County",2,85,293,106,187
050,29,185,"Missouri","St. Clair County",3,0,105,50,55
050,29,185,"Missouri","St. Clair County",3,1,84,41,43
050,29,185,"Missouri","St. Clair County",3,2,98,50,48
050,29,185,"Missouri","St. Clair County",3,3,93,47,46
050,29,185,"Missouri","St. Clair County",3,4,105,53,52
050,29,185,"Missouri","St. Clair County",3,5,113,56,57
050,29,185,"Missouri","St. Clair County",3,6,123,74,49
050,29,185,"Missouri","St. Clair County",3,7,109,61,48
050,29,185,"Missouri","St. Clair County",3,8,104,55,49
050,29,185,"Missouri","St. Clair County",3,9,91,44,47
050,29,185,"Missouri","St. Clair County",3,10,97,52,45
050,29,185,"Missouri","St. Clair County",3,11,121,63,58
050,29,185,"Missouri","St. Clair County",3,12,103,50,53
050,29,185,"Missouri","St. Clair County",3,13,108,51,57
050,29,185,"Missouri","St. Clair County",3,14,126,63,63
050,29,185,"Missouri","St. Clair County",3,15,119,65,54
050,29,185,"Missouri","St. Clair County",3,16,124,57,67
050,29,185,"Missouri","St. Clair County",3,17,128,67,61
050,29,185,"Missouri","St. Clair County",3,18,88,54,34
050,29,185,"Missouri","St. Clair County",3,19,79,47,32
050,29,185,"Missouri","St. Clair County",3,20,76,44,32
050,29,185,"Missouri","St. Clair County",3,21,73,40,33
050,29,185,"Missouri","St. Clair County",3,22,80,45,35
050,29,185,"Missouri","St. Clair County",3,23,79,44,35
050,29,185,"Missouri","St. Clair County",3,24,84,51,33
050,29,185,"Missouri","St. Clair County",3,25,87,40,47
050,29,185,"Missouri","St. Clair County",3,26,79,40,39
050,29,185,"Missouri","St. Clair County",3,27,86,46,40
050,29,185,"Missouri","St. Clair County",3,28,104,46,58
050,29,185,"Missouri","St. Clair County",3,29,102,51,51
050,29,185,"Missouri","St. Clair County",3,30,96,54,42
050,29,185,"Missouri","St. Clair County",3,31,97,57,40
050,29,185,"Missouri","St. Clair County",3,32,91,52,39
050,29,185,"Missouri","St. Clair County",3,33,81,45,36
050,29,185,"Missouri","St. Clair County",3,34,98,53,45
050,29,185,"Missouri","St. Clair County",3,35,95,44,51
050,29,185,"Missouri","St. Clair County",3,36,92,40,52
050,29,185,"Missouri","St. Clair County",3,37,97,49,48
050,29,185,"Missouri","St. Clair County",3,38,108,59,49
050,29,185,"Missouri","St. Clair County",3,39,97,51,46
050,29,185,"Missouri","St. Clair County",3,40,91,42,49
050,29,185,"Missouri","St. Clair County",3,41,92,46,46
050,29,185,"Missouri","St. Clair County",3,42,95,51,44
050,29,185,"Missouri","St. Clair County",3,43,94,48,46
050,29,185,"Missouri","St. Clair County",3,44,92,52,40
050,29,185,"Missouri","St. Clair County",3,45,89,45,44
050,29,185,"Missouri","St. Clair County",3,46,94,44,50
050,29,185,"Missouri","St. Clair County",3,47,95,50,45
050,29,185,"Missouri","St. Clair County",3,48,113,56,57
050,29,185,"Missouri","St. Clair County",3,49,110,56,54
050,29,185,"Missouri","St. Clair County",3,50,135,73,62
050,29,185,"Missouri","St. Clair County",3,51,115,61,54
050,29,185,"Missouri","St. Clair County",3,52,113,61,52
050,29,185,"Missouri","St. Clair County",3,53,110,50,60
050,29,185,"Missouri","St. Clair County",3,54,118,55,63
050,29,185,"Missouri","St. Clair County",3,55,121,64,57
050,29,185,"Missouri","St. Clair County",3,56,122,59,63
050,29,185,"Missouri","St. Clair County",3,57,137,65,72
050,29,185,"Missouri","St. Clair County",3,58,153,84,69
050,29,185,"Missouri","St. Clair County",3,59,151,85,66
050,29,185,"Missouri","St. Clair County",3,60,164,90,74
050,29,185,"Missouri","St. Clair County",3,61,174,88,86
050,29,185,"Missouri","St. Clair County",3,62,155,76,79
050,29,185,"Missouri","St. Clair County",3,63,152,78,74
050,29,185,"Missouri","St. Clair County",3,64,159,88,71
050,29,185,"Missouri","St. Clair County",3,65,144,77,67
050,29,185,"Missouri","St. Clair County",3,66,137,71,66
050,29,185,"Missouri","St. Clair County",3,67,139,69,70
050,29,185,"Missouri","St. Clair County",3,68,134,70,64
050,29,185,"Missouri","St. Clair County",3,69,141,75,66
050,29,185,"Missouri","St. Clair County",3,70,149,87,62
050,29,185,"Missouri","St. Clair County",3,71,135,74,61
050,29,185,"Missouri","St. Clair County",3,72,123,58,65
050,29,185,"Missouri","St. Clair County",3,73,120,58,62
050,29,185,"Missouri","St. Clair County",3,74,131,59,72
050,29,185,"Missouri","St. Clair County",3,75,101,51,50
050,29,185,"Missouri","St. Clair County",3,76,95,49,46
050,29,185,"Missouri","St. Clair County",3,77,97,43,54
050,29,185,"Missouri","St. Clair County",3,78,92,43,49
050,29,185,"Missouri","St. Clair County",3,79,80,37,43
050,29,185,"Missouri","St. Clair County",3,80,76,40,36
050,29,185,"Missouri","St. Clair County",3,81,62,36,26
050,29,185,"Missouri","St. Clair County",3,82,65,29,36
050,29,185,"Missouri","St. Clair County",3,83,65,29,36
050,29,185,"Missouri","St. Clair County",3,84,64,30,34
050,29,185,"Missouri","St. Clair County",3,85,299,109,190
050,29,185,"Missouri","St. Clair County",4,0,115,61,54
050,29,185,"Missouri","St. Clair County",4,1,100,48,52
050,29,185,"Missouri","St. Clair County",4,2,92,50,42
050,29,185,"Missouri","St. Clair County",4,3,103,52,51
050,29,185,"Missouri","St. Clair County",4,4,92,46,46
050,29,185,"Missouri","St. Clair County",4,5,105,56,49
050,29,185,"Missouri","St. Clair County",4,6,122,61,61
050,29,185,"Missouri","St. Clair County",4,7,127,81,46
050,29,185,"Missouri","St. Clair County",4,8,126,77,49
050,29,185,"Missouri","St. Clair County",4,9,114,62,52
050,29,185,"Missouri","St. Clair County",4,10,100,52,48
050,29,185,"Missouri","St. Clair County",4,11,115,64,51
050,29,185,"Missouri","St. Clair County",4,12,117,63,54
050,29,185,"Missouri","St. Clair County",4,13,111,54,57
050,29,185,"Missouri","St. Clair County",4,14,114,51,63
050,29,185,"Missouri","St. Clair County",4,15,126,66,60
050,29,185,"Missouri","St. Clair County",4,16,125,65,60
050,29,185,"Missouri","St. Clair County",4,17,122,55,67
050,29,185,"Missouri","St. Clair County",4,18,103,55,48
050,29,185,"Missouri","St. Clair County",4,19,65,41,24
050,29,185,"Missouri","St. Clair County",4,20,80,50,30
050,29,185,"Missouri","St. Clair County",4,21,76,40,36
050,29,185,"Missouri","St. Clair County",4,22,77,39,38
050,29,185,"Missouri","St. Clair County",4,23,75,39,36
050,29,185,"Missouri","St. Clair County",4,24,87,51,36
050,29,185,"Missouri","St. Clair County",4,25,98,56,42
050,29,185,"Missouri","St. Clair County",4,26,80,33,47
050,29,185,"Missouri","St. Clair County",4,27,81,41,40
050,29,185,"Missouri","St. Clair County",4,28,94,47,47
050,29,185,"Missouri","St. Clair County",4,29,107,48,59
050,29,185,"Missouri","St. Clair County",4,30,112,57,55
050,29,185,"Missouri","St. Clair County",4,31,98,53,45
050,29,185,"Missouri","St. Clair County",4,32,103,57,46
050,29,185,"Missouri","St. Clair County",4,33,87,49,38
050,29,185,"Missouri","St. Clair County",4,34,95,57,38
050,29,185,"Missouri","St. Clair County",4,35,102,59,43
050,29,185,"Missouri","St. Clair County",4,36,103,51,52
050,29,185,"Missouri","St. Clair County",4,37,102,43,59
050,29,185,"Missouri","St. Clair County",4,38,96,47,49
050,29,185,"Missouri","St. Clair County",4,39,108,56,52
050,29,185,"Missouri","St. Clair County",4,40,109,56,53
050,29,185,"Missouri","St. Clair County",4,41,89,38,51
050,29,185,"Missouri","St. Clair County",4,42,106,52,54
050,29,185,"Missouri","St. Clair County",4,43,100,52,48
050,29,185,"Missouri","St. Clair County",4,44,102,51,51
050,29,185,"Missouri","St. Clair County",4,45,92,49,43
050,29,185,"Missouri","St. Clair County",4,46,93,46,47
050,29,185,"Missouri","St. Clair County",4,47,96,47,49
050,29,185,"Missouri","St. Clair County",4,48,100,48,52
050,29,185,"Missouri","St. Clair County",4,49,115,55,60
050,29,185,"Missouri","St. Clair County",4,50,121,64,57
050,29,185,"Missouri","St. Clair County",4,51,142,80,62
050,29,185,"Missouri","St. Clair County",4,52,120,65,55
050,29,185,"Missouri","St. Clair County",4,53,111,61,50
050,29,185,"Missouri","St. Clair County",4,54,109,49,60
050,29,185,"Missouri","St. Clair County",4,55,121,59,62
050,29,185,"Missouri","St. Clair County",4,56,124,69,55
050,29,185,"Missouri","St. Clair County",4,57,116,55,61
050,29,185,"Missouri","St. Clair County",4,58,134,65,69
050,29,185,"Missouri","St. Clair County",4,59,154,81,73
050,29,185,"Missouri","St. Clair County",4,60,160,85,75
050,29,185,"Missouri","St. Clair County",4,61,176,97,79
050,29,185,"Missouri","St. Clair County",4,62,184,94,90
050,29,185,"Missouri","St. Clair County",4,63,149,72,77
050,29,185,"Missouri","St. Clair County",4,64,145,78,67
050,29,185,"Missouri","St. Clair County",4,65,161,87,74
050,29,185,"Missouri","St. Clair County",4,66,148,81,67
050,29,185,"Missouri","St. Clair County",4,67,138,71,67
050,29,185,"Missouri","St. Clair County",4,68,127,63,64
050,29,185,"Missouri","St. Clair County",4,69,129,68,61
050,29,185,"Missouri","St. Clair County",4,70,137,71,66
050,29,185,"Missouri","St. Clair County",4,71,149,87,62
050,29,185,"Missouri","St. Clair County",4,72,134,73,61
050,29,185,"Missouri","St. Clair County",4,73,121,56,65
050,29,185,"Missouri","St. Clair County",4,74,115,57,58
050,29,185,"Missouri","St. Clair County",4,75,121,54,67
050,29,185,"Missouri","St. Clair County",4,76,105,52,53
050,29,185,"Missouri","St. Clair County",4,77,87,48,39
050,29,185,"Missouri","St. Clair County",4,78,90,43,47
050,29,185,"Missouri","St. Clair County",4,79,86,38,48
050,29,185,"Missouri","St. Clair County",4,80,78,37,41
050,29,185,"Missouri","St. Clair County",4,81,74,39,35
050,29,185,"Missouri","St. Clair County",4,82,58,31,27
050,29,185,"Missouri","St. Clair County",4,83,54,23,31
050,29,185,"Missouri","St. Clair County",4,84,59,25,34
050,29,185,"Missouri","St. Clair County",4,85,301,113,188
050,29,185,"Missouri","St. Clair County",5,0,116,62,54
050,29,185,"Missouri","St. Clair County",5,1,115,62,53
050,29,185,"Missouri","St. Clair County",5,2,105,50,55
050,29,185,"Missouri","St. Clair County",5,3,91,50,41
050,29,185,"Missouri","St. Clair County",5,4,109,52,57
050,29,185,"Missouri","St. Clair County",5,5,103,54,49
050,29,185,"Missouri","St. Clair County",5,6,110,59,51
050,29,185,"Missouri","St. Clair County",5,7,121,60,61
050,29,185,"Missouri","St. Clair County",5,8,138,83,55
050,29,185,"Missouri","St. Clair County",5,9,126,79,47
050,29,185,"Missouri","St. Clair County",5,10,104,53,51
050,29,185,"Missouri","St. Clair County",5,11,98,49,49
050,29,185,"Missouri","St. Clair County",5,12,115,60,55
050,29,185,"Missouri","St. Clair County",5,13,123,67,56
050,29,185,"Missouri","St. Clair County",5,14,114,55,59
050,29,185,"Missouri","St. Clair County",5,15,114,54,60
050,29,185,"Missouri","St. Clair County",5,16,123,66,57
050,29,185,"Missouri","St. Clair County",5,17,130,66,64
050,29,185,"Missouri","St. Clair County",5,18,105,52,53
050,29,185,"Missouri","St. Clair County",5,19,80,45,35
050,29,185,"Missouri","St. Clair County",5,20,80,49,31
050,29,185,"Missouri","St. Clair County",5,21,77,45,32
050,29,185,"Missouri","St. Clair County",5,22,75,32,43
050,29,185,"Missouri","St. Clair County",5,23,85,39,46
050,29,185,"Missouri","St. Clair County",5,24,88,49,39
050,29,185,"Missouri","St. Clair County",5,25,93,50,43
050,29,185,"Missouri","St. Clair County",5,26,82,47,35
050,29,185,"Missouri","St. Clair County",5,27,85,36,49
050,29,185,"Missouri","St. Clair County",5,28,84,46,38
050,29,185,"Missouri","St. Clair County",5,29,108,53,55
050,29,185,"Missouri","St. Clair County",5,30,119,56,63
050,29,185,"Missouri","St. Clair County",5,31,114,56,58
050,29,185,"Missouri","St. Clair County",5,32,95,46,49
050,29,185,"Missouri","St. Clair County",5,33,99,55,44
050,29,185,"Missouri","St. Clair County",5,34,96,54,42
050,29,185,"Missouri","St. Clair County",5,35,99,65,34
050,29,185,"Missouri","St. Clair County",5,36,105,65,40
050,29,185,"Missouri","St. Clair County",5,37,109,58,51
050,29,185,"Missouri","St. Clair County",5,38,102,42,60
050,29,185,"Missouri","St. Clair County",5,39,95,46,49
050,29,185,"Missouri","St. Clair County",5,40,123,60,63
050,29,185,"Missouri","St. Clair County",5,41,117,61,56
050,29,185,"Missouri","St. Clair County",5,42,93,41,52
050,29,185,"Missouri","St. Clair County",5,43,106,45,61
050,29,185,"Missouri","St. Clair County",5,44,111,57,54
050,29,185,"Missouri","St. Clair County",5,45,100,48,52
050,29,185,"Missouri","St. Clair County",5,46,97,50,47
050,29,185,"Missouri","St. Clair County",5,47,96,53,43
050,29,185,"Missouri","St. Clair County",5,48,96,46,50
050,29,185,"Missouri","St. Clair County",5,49,100,49,51
050,29,185,"Missouri","St. Clair County",5,50,119,55,64
050,29,185,"Missouri","St. Clair County",5,51,133,69,64
050,29,185,"Missouri","St. Clair County",5,52,141,79,62
050,29,185,"Missouri","St. Clair County",5,53,118,65,53
050,29,185,"Missouri","St. Clair County",5,54,121,66,55
050,29,185,"Missouri","St. Clair County",5,55,115,50,65
050,29,185,"Missouri","St. Clair County",5,56,117,57,60
050,29,185,"Missouri","St. Clair County",5,57,128,70,58
050,29,185,"Missouri","St. Clair County",5,58,123,61,62
050,29,185,"Missouri","St. Clair County",5,59,136,67,69
050,29,185,"Missouri","St. Clair County",5,60,160,88,72
050,29,185,"Missouri","St. Clair County",5,61,165,91,74
050,29,185,"Missouri","St. Clair County",5,62,177,98,79
050,29,185,"Missouri","St. Clair County",5,63,174,90,84
050,29,185,"Missouri","St. Clair County",5,64,149,69,80
050,29,185,"Missouri","St. Clair County",5,65,143,70,73
050,29,185,"Missouri","St. Clair County",5,66,154,80,74
050,29,185,"Missouri","St. Clair County",5,67,147,79,68
050,29,185,"Missouri","St. Clair County",5,68,134,70,64
050,29,185,"Missouri","St. Clair County",5,69,131,67,64
050,29,185,"Missouri","St. Clair County",5,70,127,66,61
050,29,185,"Missouri","St. Clair County",5,71,133,71,62
050,29,185,"Missouri","St. Clair County",5,72,144,79,65
050,29,185,"Missouri","St. Clair County",5,73,130,73,57
050,29,185,"Missouri","St. Clair County",5,74,115,53,62
050,29,185,"Missouri","St. Clair County",5,75,112,54,58
050,29,185,"Missouri","St. Clair County",5,76,125,56,69
050,29,185,"Missouri","St. Clair County",5,77,102,52,50
050,29,185,"Missouri","St. Clair County",5,78,81,46,35
050,29,185,"Missouri","St. Clair County",5,79,85,41,44
050,29,185,"Missouri","St. Clair County",5,80,80,37,43
050,29,185,"Missouri","St. Clair County",5,81,73,33,40
050,29,185,"Missouri","St. Clair County",5,82,67,34,33
050,29,185,"Missouri","St. Clair County",5,83,47,24,23
050,29,185,"Missouri","St. Clair County",5,84,55,23,32
050,29,185,"Missouri","St. Clair County",5,85,322,124,198
050,29,186,"Missouri","Ste. Genevieve County",1,0,212,110,102
050,29,186,"Missouri","Ste. Genevieve County",1,1,220,114,106
050,29,186,"Missouri","Ste. Genevieve County",1,2,212,111,101
050,29,186,"Missouri","Ste. Genevieve County",1,3,201,103,98
050,29,186,"Missouri","Ste. Genevieve County",1,4,192,97,95
050,29,186,"Missouri","Ste. Genevieve County",1,5,213,110,103
050,29,186,"Missouri","Ste. Genevieve County",1,6,216,125,91
050,29,186,"Missouri","Ste. Genevieve County",1,7,209,117,92
050,29,186,"Missouri","Ste. Genevieve County",1,8,204,106,98
050,29,186,"Missouri","Ste. Genevieve County",1,9,224,94,130
050,29,186,"Missouri","Ste. Genevieve County",1,10,226,120,106
050,29,186,"Missouri","Ste. Genevieve County",1,11,249,133,116
050,29,186,"Missouri","Ste. Genevieve County",1,12,229,116,113
050,29,186,"Missouri","Ste. Genevieve County",1,13,247,138,109
050,29,186,"Missouri","Ste. Genevieve County",1,14,214,120,94
050,29,186,"Missouri","Ste. Genevieve County",1,15,230,125,105
050,29,186,"Missouri","Ste. Genevieve County",1,16,247,124,123
050,29,186,"Missouri","Ste. Genevieve County",1,17,254,129,125
050,29,186,"Missouri","Ste. Genevieve County",1,18,203,113,90
050,29,186,"Missouri","Ste. Genevieve County",1,19,142,73,69
050,29,186,"Missouri","Ste. Genevieve County",1,20,167,89,78
050,29,186,"Missouri","Ste. Genevieve County",1,21,190,94,96
050,29,186,"Missouri","Ste. Genevieve County",1,22,193,96,97
050,29,186,"Missouri","Ste. Genevieve County",1,23,198,106,92
050,29,186,"Missouri","Ste. Genevieve County",1,24,204,108,96
050,29,186,"Missouri","Ste. Genevieve County",1,25,183,92,91
050,29,186,"Missouri","Ste. Genevieve County",1,26,187,106,81
050,29,186,"Missouri","Ste. Genevieve County",1,27,252,140,112
050,29,186,"Missouri","Ste. Genevieve County",1,28,238,136,102
050,29,186,"Missouri","Ste. Genevieve County",1,29,199,112,87
050,29,186,"Missouri","Ste. Genevieve County",1,30,224,141,83
050,29,186,"Missouri","Ste. Genevieve County",1,31,214,99,115
050,29,186,"Missouri","Ste. Genevieve County",1,32,193,102,91
050,29,186,"Missouri","Ste. Genevieve County",1,33,204,113,91
050,29,186,"Missouri","Ste. Genevieve County",1,34,213,117,96
050,29,186,"Missouri","Ste. Genevieve County",1,35,239,140,99
050,29,186,"Missouri","Ste. Genevieve County",1,36,209,116,93
050,29,186,"Missouri","Ste. Genevieve County",1,37,239,140,99
050,29,186,"Missouri","Ste. Genevieve County",1,38,229,121,108
050,29,186,"Missouri","Ste. Genevieve County",1,39,245,133,112
050,29,186,"Missouri","Ste. Genevieve County",1,40,237,137,100
050,29,186,"Missouri","Ste. Genevieve County",1,41,213,119,94
050,29,186,"Missouri","Ste. Genevieve County",1,42,194,103,91
050,29,186,"Missouri","Ste. Genevieve County",1,43,203,105,98
050,29,186,"Missouri","Ste. Genevieve County",1,44,224,123,101
050,29,186,"Missouri","Ste. Genevieve County",1,45,195,100,95
050,29,186,"Missouri","Ste. Genevieve County",1,46,173,93,80
050,29,186,"Missouri","Ste. Genevieve County",1,47,200,106,94
050,29,186,"Missouri","Ste. Genevieve County",1,48,232,123,109
050,29,186,"Missouri","Ste. Genevieve County",1,49,253,131,122
050,29,186,"Missouri","Ste. Genevieve County",1,50,229,125,104
050,29,186,"Missouri","Ste. Genevieve County",1,51,206,96,110
050,29,186,"Missouri","Ste. Genevieve County",1,52,215,109,106
050,29,186,"Missouri","Ste. Genevieve County",1,53,230,110,120
050,29,186,"Missouri","Ste. Genevieve County",1,54,257,138,119
050,29,186,"Missouri","Ste. Genevieve County",1,55,285,142,143
050,29,186,"Missouri","Ste. Genevieve County",1,56,278,142,136
050,29,186,"Missouri","Ste. Genevieve County",1,57,294,154,140
050,29,186,"Missouri","Ste. Genevieve County",1,58,309,166,143
050,29,186,"Missouri","Ste. Genevieve County",1,59,318,173,145
050,29,186,"Missouri","Ste. Genevieve County",1,60,320,173,147
050,29,186,"Missouri","Ste. Genevieve County",1,61,294,152,142
050,29,186,"Missouri","Ste. Genevieve County",1,62,305,156,149
050,29,186,"Missouri","Ste. Genevieve County",1,63,283,141,142
050,29,186,"Missouri","Ste. Genevieve County",1,64,281,141,140
050,29,186,"Missouri","Ste. Genevieve County",1,65,271,142,129
050,29,186,"Missouri","Ste. Genevieve County",1,66,270,135,135
050,29,186,"Missouri","Ste. Genevieve County",1,67,265,131,134
050,29,186,"Missouri","Ste. Genevieve County",1,68,240,124,116
050,29,186,"Missouri","Ste. Genevieve County",1,69,224,126,98
050,29,186,"Missouri","Ste. Genevieve County",1,70,201,104,97
050,29,186,"Missouri","Ste. Genevieve County",1,71,202,100,102
050,29,186,"Missouri","Ste. Genevieve County",1,72,201,100,101
050,29,186,"Missouri","Ste. Genevieve County",1,73,201,105,96
050,29,186,"Missouri","Ste. Genevieve County",1,74,140,79,61
050,29,186,"Missouri","Ste. Genevieve County",1,75,121,54,67
050,29,186,"Missouri","Ste. Genevieve County",1,76,136,63,73
050,29,186,"Missouri","Ste. Genevieve County",1,77,142,73,69
050,29,186,"Missouri","Ste. Genevieve County",1,78,115,53,62
050,29,186,"Missouri","Ste. Genevieve County",1,79,99,35,64
050,29,186,"Missouri","Ste. Genevieve County",1,80,81,33,48
050,29,186,"Missouri","Ste. Genevieve County",1,81,103,46,57
050,29,186,"Missouri","Ste. Genevieve County",1,82,87,39,48
050,29,186,"Missouri","Ste. Genevieve County",1,83,83,36,47
050,29,186,"Missouri","Ste. Genevieve County",1,84,72,34,38
050,29,186,"Missouri","Ste. Genevieve County",1,85,432,189,243
050,29,186,"Missouri","Ste. Genevieve County",2,0,207,107,100
050,29,186,"Missouri","Ste. Genevieve County",2,1,218,114,104
050,29,186,"Missouri","Ste. Genevieve County",2,2,216,113,103
050,29,186,"Missouri","Ste. Genevieve County",2,3,204,105,99
050,29,186,"Missouri","Ste. Genevieve County",2,4,198,101,97
050,29,186,"Missouri","Ste. Genevieve County",2,5,207,106,101
050,29,186,"Missouri","Ste. Genevieve County",2,6,219,123,96
050,29,186,"Missouri","Ste. Genevieve County",2,7,212,119,93
050,29,186,"Missouri","Ste. Genevieve County",2,8,205,107,98
050,29,186,"Missouri","Ste. Genevieve County",2,9,217,97,120
050,29,186,"Missouri","Ste. Genevieve County",2,10,223,112,111
050,29,186,"Missouri","Ste. Genevieve County",2,11,243,129,114
050,29,186,"Missouri","Ste. Genevieve County",2,12,237,123,114
050,29,186,"Missouri","Ste. Genevieve County",2,13,241,133,108
050,29,186,"Missouri","Ste. Genevieve County",2,14,221,125,96
050,29,186,"Missouri","Ste. Genevieve County",2,15,225,123,102
050,29,186,"Missouri","Ste. Genevieve County",2,16,246,126,120
050,29,186,"Missouri","Ste. Genevieve County",2,17,251,128,123
050,29,186,"Missouri","Ste. Genevieve County",2,18,202,111,91
050,29,186,"Missouri","Ste. Genevieve County",2,19,146,77,69
050,29,186,"Missouri","Ste. Genevieve County",2,20,166,88,78
050,29,186,"Missouri","Ste. Genevieve County",2,21,185,93,92
050,29,186,"Missouri","Ste. Genevieve County",2,22,192,94,98
050,29,186,"Missouri","Ste. Genevieve County",2,23,197,104,93
050,29,186,"Missouri","Ste. Genevieve County",2,24,201,108,93
050,29,186,"Missouri","Ste. Genevieve County",2,25,185,94,91
050,29,186,"Missouri","Ste. Genevieve County",2,26,190,105,85
050,29,186,"Missouri","Ste. Genevieve County",2,27,243,136,107
050,29,186,"Missouri","Ste. Genevieve County",2,28,235,134,101
050,29,186,"Missouri","Ste. Genevieve County",2,29,208,118,90
050,29,186,"Missouri","Ste. Genevieve County",2,30,226,139,87
050,29,186,"Missouri","Ste. Genevieve County",2,31,207,102,105
050,29,186,"Missouri","Ste. Genevieve County",2,32,200,103,97
050,29,186,"Missouri","Ste. Genevieve County",2,33,207,113,94
050,29,186,"Missouri","Ste. Genevieve County",2,34,212,119,93
050,29,186,"Missouri","Ste. Genevieve County",2,35,239,139,100
050,29,186,"Missouri","Ste. Genevieve County",2,36,209,117,92
050,29,186,"Missouri","Ste. Genevieve County",2,37,238,141,97
050,29,186,"Missouri","Ste. Genevieve County",2,38,231,125,106
050,29,186,"Missouri","Ste. Genevieve County",2,39,242,131,111
050,29,186,"Missouri","Ste. Genevieve County",2,40,237,134,103
050,29,186,"Missouri","Ste. Genevieve County",2,41,216,121,95
050,29,186,"Missouri","Ste. Genevieve County",2,42,195,105,90
050,29,186,"Missouri","Ste. Genevieve County",2,43,200,103,97
050,29,186,"Missouri","Ste. Genevieve County",2,44,219,119,100
050,29,186,"Missouri","Ste. Genevieve County",2,45,203,106,97
050,29,186,"Missouri","Ste. Genevieve County",2,46,177,93,84
050,29,186,"Missouri","Ste. Genevieve County",2,47,199,109,90
050,29,186,"Missouri","Ste. Genevieve County",2,48,219,114,105
050,29,186,"Missouri","Ste. Genevieve County",2,49,250,131,119
050,29,186,"Missouri","Ste. Genevieve County",2,50,233,125,108
050,29,186,"Missouri","Ste. Genevieve County",2,51,209,100,109
050,29,186,"Missouri","Ste. Genevieve County",2,52,213,107,106
050,29,186,"Missouri","Ste. Genevieve County",2,53,227,111,116
050,29,186,"Missouri","Ste. Genevieve County",2,54,250,131,119
050,29,186,"Missouri","Ste. Genevieve County",2,55,280,141,139
050,29,186,"Missouri","Ste. Genevieve County",2,56,280,143,137
050,29,186,"Missouri","Ste. Genevieve County",2,57,291,152,139
050,29,186,"Missouri","Ste. Genevieve County",2,58,303,161,142
050,29,186,"Missouri","Ste. Genevieve County",2,59,319,173,146
050,29,186,"Missouri","Ste. Genevieve County",2,60,318,174,144
050,29,186,"Missouri","Ste. Genevieve County",2,61,300,157,143
050,29,186,"Missouri","Ste. Genevieve County",2,62,302,155,147
050,29,186,"Missouri","Ste. Genevieve County",2,63,288,144,144
050,29,186,"Missouri","Ste. Genevieve County",2,64,281,142,139
050,29,186,"Missouri","Ste. Genevieve County",2,65,273,142,131
050,29,186,"Missouri","Ste. Genevieve County",2,66,272,137,135
050,29,186,"Missouri","Ste. Genevieve County",2,67,264,130,134
050,29,186,"Missouri","Ste. Genevieve County",2,68,245,125,120
050,29,186,"Missouri","Ste. Genevieve County",2,69,230,127,103
050,29,186,"Missouri","Ste. Genevieve County",2,70,204,107,97
050,29,186,"Missouri","Ste. Genevieve County",2,71,201,101,100
050,29,186,"Missouri","Ste. Genevieve County",2,72,197,98,99
050,29,186,"Missouri","Ste. Genevieve County",2,73,207,106,101
050,29,186,"Missouri","Ste. Genevieve County",2,74,147,81,66
050,29,186,"Missouri","Ste. Genevieve County",2,75,124,59,65
050,29,186,"Missouri","Ste. Genevieve County",2,76,131,61,70
050,29,186,"Missouri","Ste. Genevieve County",2,77,141,70,71
050,29,186,"Missouri","Ste. Genevieve County",2,78,119,57,62
050,29,186,"Missouri","Ste. Genevieve County",2,79,103,38,65
050,29,186,"Missouri","Ste. Genevieve County",2,80,80,33,47
050,29,186,"Missouri","Ste. Genevieve County",2,81,98,42,56
050,29,186,"Missouri","Ste. Genevieve County",2,82,89,39,50
050,29,186,"Missouri","Ste. Genevieve County",2,83,82,36,46
050,29,186,"Missouri","Ste. Genevieve County",2,84,75,34,41
050,29,186,"Missouri","Ste. Genevieve County",2,85,434,189,245
050,29,186,"Missouri","Ste. Genevieve County",3,0,194,100,94
050,29,186,"Missouri","Ste. Genevieve County",3,1,217,112,105
050,29,186,"Missouri","Ste. Genevieve County",3,2,231,121,110
050,29,186,"Missouri","Ste. Genevieve County",3,3,213,109,104
050,29,186,"Missouri","Ste. Genevieve County",3,4,209,104,105
050,29,186,"Missouri","Ste. Genevieve County",3,5,206,103,103
050,29,186,"Missouri","Ste. Genevieve County",3,6,222,111,111
050,29,186,"Missouri","Ste. Genevieve County",3,7,226,128,98
050,29,186,"Missouri","Ste. Genevieve County",3,8,214,111,103
050,29,186,"Missouri","Ste. Genevieve County",3,9,207,106,101
050,29,186,"Missouri","Ste. Genevieve County",3,10,214,101,113
050,29,186,"Missouri","Ste. Genevieve County",3,11,221,113,108
050,29,186,"Missouri","Ste. Genevieve County",3,12,254,142,112
050,29,186,"Missouri","Ste. Genevieve County",3,13,239,123,116
050,29,186,"Missouri","Ste. Genevieve County",3,14,242,133,109
050,29,186,"Missouri","Ste. Genevieve County",3,15,206,115,91
050,29,186,"Missouri","Ste. Genevieve County",3,16,223,124,99
050,29,186,"Missouri","Ste. Genevieve County",3,17,242,122,120
050,29,186,"Missouri","Ste. Genevieve County",3,18,203,105,98
050,29,186,"Missouri","Ste. Genevieve County",3,19,157,87,70
050,29,186,"Missouri","Ste. Genevieve County",3,20,172,94,78
050,29,186,"Missouri","Ste. Genevieve County",3,21,173,94,79
050,29,186,"Missouri","Ste. Genevieve County",3,22,187,91,96
050,29,186,"Missouri","Ste. Genevieve County",3,23,188,93,95
050,29,186,"Missouri","Ste. Genevieve County",3,24,215,122,93
050,29,186,"Missouri","Ste. Genevieve County",3,25,191,96,95
050,29,186,"Missouri","Ste. Genevieve County",3,26,189,103,86
050,29,186,"Missouri","Ste. Genevieve County",3,27,210,113,97
050,29,186,"Missouri","Ste. Genevieve County",3,28,228,128,100
050,29,186,"Missouri","Ste. Genevieve County",3,29,237,134,103
050,29,186,"Missouri","Ste. Genevieve County",3,30,244,141,103
050,29,186,"Missouri","Ste. Genevieve County",3,31,204,114,90
050,29,186,"Missouri","Ste. Genevieve County",3,32,227,115,112
050,29,186,"Missouri","Ste. Genevieve County",3,33,211,108,103
050,29,186,"Missouri","Ste. Genevieve County",3,34,210,114,96
050,29,186,"Missouri","Ste. Genevieve County",3,35,229,140,89
050,29,186,"Missouri","Ste. Genevieve County",3,36,218,122,96
050,29,186,"Missouri","Ste. Genevieve County",3,37,236,140,96
050,29,186,"Missouri","Ste. Genevieve County",3,38,241,138,103
050,29,186,"Missouri","Ste. Genevieve County",3,39,241,127,114
050,29,186,"Missouri","Ste. Genevieve County",3,40,238,129,109
050,29,186,"Missouri","Ste. Genevieve County",3,41,226,118,108
050,29,186,"Missouri","Ste. Genevieve County",3,42,213,119,94
050,29,186,"Missouri","Ste. Genevieve County",3,43,194,101,93
050,29,186,"Missouri","Ste. Genevieve County",3,44,212,116,96
050,29,186,"Missouri","Ste. Genevieve County",3,45,216,117,99
050,29,186,"Missouri","Ste. Genevieve County",3,46,194,97,97
050,29,186,"Missouri","Ste. Genevieve County",3,47,206,115,91
050,29,186,"Missouri","Ste. Genevieve County",3,48,182,94,88
050,29,186,"Missouri","Ste. Genevieve County",3,49,231,123,108
050,29,186,"Missouri","Ste. Genevieve County",3,50,243,127,116
050,29,186,"Missouri","Ste. Genevieve County",3,51,219,111,108
050,29,186,"Missouri","Ste. Genevieve County",3,52,209,105,104
050,29,186,"Missouri","Ste. Genevieve County",3,53,212,106,106
050,29,186,"Missouri","Ste. Genevieve County",3,54,225,114,111
050,29,186,"Missouri","Ste. Genevieve County",3,55,255,128,127
050,29,186,"Missouri","Ste. Genevieve County",3,56,284,144,140
050,29,186,"Missouri","Ste. Genevieve County",3,57,281,143,138
050,29,186,"Missouri","Ste. Genevieve County",3,58,289,147,142
050,29,186,"Missouri","Ste. Genevieve County",3,59,303,163,140
050,29,186,"Missouri","Ste. Genevieve County",3,60,324,174,150
050,29,186,"Missouri","Ste. Genevieve County",3,61,323,180,143
050,29,186,"Missouri","Ste. Genevieve County",3,62,300,153,147
050,29,186,"Missouri","Ste. Genevieve County",3,63,306,160,146
050,29,186,"Missouri","Ste. Genevieve County",3,64,289,148,141
050,29,186,"Missouri","Ste. Genevieve County",3,65,276,137,139
050,29,186,"Missouri","Ste. Genevieve County",3,66,265,137,128
050,29,186,"Missouri","Ste. Genevieve County",3,67,259,128,131
050,29,186,"Missouri","Ste. Genevieve County",3,68,259,131,128
050,29,186,"Missouri","Ste. Genevieve County",3,69,243,124,119
050,29,186,"Missouri","Ste. Genevieve County",3,70,217,119,98
050,29,186,"Missouri","Ste. Genevieve County",3,71,202,106,96
050,29,186,"Missouri","Ste. Genevieve County",3,72,188,96,92
050,29,186,"Missouri","Ste. Genevieve County",3,73,182,89,93
050,29,186,"Missouri","Ste. Genevieve County",3,74,214,109,105
050,29,186,"Missouri","Ste. Genevieve County",3,75,134,71,63
050,29,186,"Missouri","Ste. Genevieve County",3,76,123,58,65
050,29,186,"Missouri","Ste. Genevieve County",3,77,123,56,67
050,29,186,"Missouri","Ste. Genevieve County",3,78,137,70,67
050,29,186,"Missouri","Ste. Genevieve County",3,79,120,53,67
050,29,186,"Missouri","Ste. Genevieve County",3,80,88,35,53
050,29,186,"Missouri","Ste. Genevieve County",3,81,86,34,52
050,29,186,"Missouri","Ste. Genevieve County",3,82,93,40,53
050,29,186,"Missouri","Ste. Genevieve County",3,83,77,35,42
050,29,186,"Missouri","Ste. Genevieve County",3,84,80,36,44
050,29,186,"Missouri","Ste. Genevieve County",3,85,438,186,252
050,29,186,"Missouri","Ste. Genevieve County",4,0,185,88,97
050,29,186,"Missouri","Ste. Genevieve County",4,1,187,97,90
050,29,186,"Missouri","Ste. Genevieve County",4,2,223,116,107
050,29,186,"Missouri","Ste. Genevieve County",4,3,230,120,110
050,29,186,"Missouri","Ste. Genevieve County",4,4,230,115,115
050,29,186,"Missouri","Ste. Genevieve County",4,5,210,103,107
050,29,186,"Missouri","Ste. Genevieve County",4,6,227,118,109
050,29,186,"Missouri","Ste. Genevieve County",4,7,222,108,114
050,29,186,"Missouri","Ste. Genevieve County",4,8,222,126,96
050,29,186,"Missouri","Ste. Genevieve County",4,9,215,111,104
050,29,186,"Missouri","Ste. Genevieve County",4,10,220,112,108
050,29,186,"Missouri","Ste. Genevieve County",4,11,212,100,112
050,29,186,"Missouri","Ste. Genevieve County",4,12,225,116,109
050,29,186,"Missouri","Ste. Genevieve County",4,13,255,149,106
050,29,186,"Missouri","Ste. Genevieve County",4,14,233,116,117
050,29,186,"Missouri","Ste. Genevieve County",4,15,244,133,111
050,29,186,"Missouri","Ste. Genevieve County",4,16,214,121,93
050,29,186,"Missouri","Ste. Genevieve County",4,17,214,116,98
050,29,186,"Missouri","Ste. Genevieve County",4,18,204,104,100
050,29,186,"Missouri","Ste. Genevieve County",4,19,153,82,71
050,29,186,"Missouri","Ste. Genevieve County",4,20,173,97,76
050,29,186,"Missouri","Ste. Genevieve County",4,21,178,99,79
050,29,186,"Missouri","Ste. Genevieve County",4,22,165,83,82
050,29,186,"Missouri","Ste. Genevieve County",4,23,178,92,86
050,29,186,"Missouri","Ste. Genevieve County",4,24,208,113,95
050,29,186,"Missouri","Ste. Genevieve County",4,25,207,113,94
050,29,186,"Missouri","Ste. Genevieve County",4,26,195,106,89
050,29,186,"Missouri","Ste. Genevieve County",4,27,214,121,93
050,29,186,"Missouri","Ste. Genevieve County",4,28,211,105,106
050,29,186,"Missouri","Ste. Genevieve County",4,29,233,136,97
050,29,186,"Missouri","Ste. Genevieve County",4,30,249,144,105
050,29,186,"Missouri","Ste. Genevieve County",4,31,215,114,101
050,29,186,"Missouri","Ste. Genevieve County",4,32,216,123,93
050,29,186,"Missouri","Ste. Genevieve County",4,33,246,127,119
050,29,186,"Missouri","Ste. Genevieve County",4,34,223,120,103
050,29,186,"Missouri","Ste. Genevieve County",4,35,236,133,103
050,29,186,"Missouri","Ste. Genevieve County",4,36,214,123,91
050,29,186,"Missouri","Ste. Genevieve County",4,37,243,140,103
050,29,186,"Missouri","Ste. Genevieve County",4,38,232,134,98
050,29,186,"Missouri","Ste. Genevieve County",4,39,260,143,117
050,29,186,"Missouri","Ste. Genevieve County",4,40,226,119,107
050,29,186,"Missouri","Ste. Genevieve County",4,41,236,123,113
050,29,186,"Missouri","Ste. Genevieve County",4,42,225,119,106
050,29,186,"Missouri","Ste. Genevieve County",4,43,211,112,99
050,29,186,"Missouri","Ste. Genevieve County",4,44,212,115,97
050,29,186,"Missouri","Ste. Genevieve County",4,45,211,112,99
050,29,186,"Missouri","Ste. Genevieve County",4,46,210,110,100
050,29,186,"Missouri","Ste. Genevieve County",4,47,211,115,96
050,29,186,"Missouri","Ste. Genevieve County",4,48,188,97,91
050,29,186,"Missouri","Ste. Genevieve County",4,49,194,103,91
050,29,186,"Missouri","Ste. Genevieve County",4,50,229,124,105
050,29,186,"Missouri","Ste. Genevieve County",4,51,227,111,116
050,29,186,"Missouri","Ste. Genevieve County",4,52,215,110,105
050,29,186,"Missouri","Ste. Genevieve County",4,53,211,108,103
050,29,186,"Missouri","Ste. Genevieve County",4,54,213,101,112
050,29,186,"Missouri","Ste. Genevieve County",4,55,232,113,119
050,29,186,"Missouri","Ste. Genevieve County",4,56,250,130,120
050,29,186,"Missouri","Ste. Genevieve County",4,57,280,143,137
050,29,186,"Missouri","Ste. Genevieve County",4,58,273,134,139
050,29,186,"Missouri","Ste. Genevieve County",4,59,289,148,141
050,29,186,"Missouri","Ste. Genevieve County",4,60,305,165,140
050,29,186,"Missouri","Ste. Genevieve County",4,61,321,176,145
050,29,186,"Missouri","Ste. Genevieve County",4,62,309,173,136
050,29,186,"Missouri","Ste. Genevieve County",4,63,298,148,150
050,29,186,"Missouri","Ste. Genevieve County",4,64,303,161,142
050,29,186,"Missouri","Ste. Genevieve County",4,65,288,149,139
050,29,186,"Missouri","Ste. Genevieve County",4,66,268,131,137
050,29,186,"Missouri","Ste. Genevieve County",4,67,259,139,120
050,29,186,"Missouri","Ste. Genevieve County",4,68,254,128,126
050,29,186,"Missouri","Ste. Genevieve County",4,69,254,128,126
050,29,186,"Missouri","Ste. Genevieve County",4,70,235,123,112
050,29,186,"Missouri","Ste. Genevieve County",4,71,216,120,96
050,29,186,"Missouri","Ste. Genevieve County",4,72,193,102,91
050,29,186,"Missouri","Ste. Genevieve County",4,73,179,88,91
050,29,186,"Missouri","Ste. Genevieve County",4,74,182,91,91
050,29,186,"Missouri","Ste. Genevieve County",4,75,201,97,104
050,29,186,"Missouri","Ste. Genevieve County",4,76,134,70,64
050,29,186,"Missouri","Ste. Genevieve County",4,77,114,51,63
050,29,186,"Missouri","Ste. Genevieve County",4,78,117,55,62
050,29,186,"Missouri","Ste. Genevieve County",4,79,133,60,73
050,29,186,"Missouri","Ste. Genevieve County",4,80,102,49,53
050,29,186,"Missouri","Ste. Genevieve County",4,81,92,35,57
050,29,186,"Missouri","Ste. Genevieve County",4,82,81,32,49
050,29,186,"Missouri","Ste. Genevieve County",4,83,85,33,52
050,29,186,"Missouri","Ste. Genevieve County",4,84,73,33,40
050,29,186,"Missouri","Ste. Genevieve County",4,85,453,184,269
050,29,186,"Missouri","Ste. Genevieve County",5,0,182,87,95
050,29,186,"Missouri","Ste. Genevieve County",5,1,195,99,96
050,29,186,"Missouri","Ste. Genevieve County",5,2,189,101,88
050,29,186,"Missouri","Ste. Genevieve County",5,3,235,120,115
050,29,186,"Missouri","Ste. Genevieve County",5,4,236,123,113
050,29,186,"Missouri","Ste. Genevieve County",5,5,227,114,113
050,29,186,"Missouri","Ste. Genevieve County",5,6,230,113,117
050,29,186,"Missouri","Ste. Genevieve County",5,7,226,116,110
050,29,186,"Missouri","Ste. Genevieve County",5,8,228,115,113
050,29,186,"Missouri","Ste. Genevieve County",5,9,225,127,98
050,29,186,"Missouri","Ste. Genevieve County",5,10,212,106,106
050,29,186,"Missouri","Ste. Genevieve County",5,11,223,112,111
050,29,186,"Missouri","Ste. Genevieve County",5,12,211,100,111
050,29,186,"Missouri","Ste. Genevieve County",5,13,220,114,106
050,29,186,"Missouri","Ste. Genevieve County",5,14,257,146,111
050,29,186,"Missouri","Ste. Genevieve County",5,15,230,116,114
050,29,186,"Missouri","Ste. Genevieve County",5,16,252,136,116
050,29,186,"Missouri","Ste. Genevieve County",5,17,216,124,92
050,29,186,"Missouri","Ste. Genevieve County",5,18,189,102,87
050,29,186,"Missouri","Ste. Genevieve County",5,19,162,87,75
050,29,186,"Missouri","Ste. Genevieve County",5,20,181,96,85
050,29,186,"Missouri","Ste. Genevieve County",5,21,190,103,87
050,29,186,"Missouri","Ste. Genevieve County",5,22,183,95,88
050,29,186,"Missouri","Ste. Genevieve County",5,23,169,86,83
050,29,186,"Missouri","Ste. Genevieve County",5,24,188,104,84
050,29,186,"Missouri","Ste. Genevieve County",5,25,197,104,93
050,29,186,"Missouri","Ste. Genevieve County",5,26,216,118,98
050,29,186,"Missouri","Ste. Genevieve County",5,27,230,128,102
050,29,186,"Missouri","Ste. Genevieve County",5,28,192,112,80
050,29,186,"Missouri","Ste. Genevieve County",5,29,212,111,101
050,29,186,"Missouri","Ste. Genevieve County",5,30,248,144,104
050,29,186,"Missouri","Ste. Genevieve County",5,31,223,119,104
050,29,186,"Missouri","Ste. Genevieve County",5,32,221,123,98
050,29,186,"Missouri","Ste. Genevieve County",5,33,219,128,91
050,29,186,"Missouri","Ste. Genevieve County",5,34,247,128,119
050,29,186,"Missouri","Ste. Genevieve County",5,35,235,131,104
050,29,186,"Missouri","Ste. Genevieve County",5,36,203,104,99
050,29,186,"Missouri","Ste. Genevieve County",5,37,239,143,96
050,29,186,"Missouri","Ste. Genevieve County",5,38,233,134,99
050,29,186,"Missouri","Ste. Genevieve County",5,39,236,137,99
050,29,186,"Missouri","Ste. Genevieve County",5,40,246,132,114
050,29,186,"Missouri","Ste. Genevieve County",5,41,217,110,107
050,29,186,"Missouri","Ste. Genevieve County",5,42,228,118,110
050,29,186,"Missouri","Ste. Genevieve County",5,43,221,113,108
050,29,186,"Missouri","Ste. Genevieve County",5,44,224,123,101
050,29,186,"Missouri","Ste. Genevieve County",5,45,225,120,105
050,29,186,"Missouri","Ste. Genevieve County",5,46,208,104,104
050,29,186,"Missouri","Ste. Genevieve County",5,47,226,131,95
050,29,186,"Missouri","Ste. Genevieve County",5,48,194,97,97
050,29,186,"Missouri","Ste. Genevieve County",5,49,199,107,92
050,29,186,"Missouri","Ste. Genevieve County",5,50,195,103,92
050,29,186,"Missouri","Ste. Genevieve County",5,51,218,111,107
050,29,186,"Missouri","Ste. Genevieve County",5,52,232,114,118
050,29,186,"Missouri","Ste. Genevieve County",5,53,225,119,106
050,29,186,"Missouri","Ste. Genevieve County",5,54,199,103,96
050,29,186,"Missouri","Ste. Genevieve County",5,55,216,100,116
050,29,186,"Missouri","Ste. Genevieve County",5,56,221,109,112
050,29,186,"Missouri","Ste. Genevieve County",5,57,246,129,117
050,29,186,"Missouri","Ste. Genevieve County",5,58,279,143,136
050,29,186,"Missouri","Ste. Genevieve County",5,59,259,126,133
050,29,186,"Missouri","Ste. Genevieve County",5,60,289,142,147
050,29,186,"Missouri","Ste. Genevieve County",5,61,299,164,135
050,29,186,"Missouri","Ste. Genevieve County",5,62,317,171,146
050,29,186,"Missouri","Ste. Genevieve County",5,63,303,167,136
050,29,186,"Missouri","Ste. Genevieve County",5,64,297,145,152
050,29,186,"Missouri","Ste. Genevieve County",5,65,292,156,136
050,29,186,"Missouri","Ste. Genevieve County",5,66,287,150,137
050,29,186,"Missouri","Ste. Genevieve County",5,67,263,127,136
050,29,186,"Missouri","Ste. Genevieve County",5,68,250,136,114
050,29,186,"Missouri","Ste. Genevieve County",5,69,250,125,125
050,29,186,"Missouri","Ste. Genevieve County",5,70,253,125,128
050,29,186,"Missouri","Ste. Genevieve County",5,71,235,122,113
050,29,186,"Missouri","Ste. Genevieve County",5,72,208,114,94
050,29,186,"Missouri","Ste. Genevieve County",5,73,186,98,88
050,29,186,"Missouri","Ste. Genevieve County",5,74,179,89,90
050,29,186,"Missouri","Ste. Genevieve County",5,75,170,80,90
050,29,186,"Missouri","Ste. Genevieve County",5,76,198,97,101
050,29,186,"Missouri","Ste. Genevieve County",5,77,126,64,62
050,29,186,"Missouri","Ste. Genevieve County",5,78,112,49,63
050,29,186,"Missouri","Ste. Genevieve County",5,79,120,49,71
050,29,186,"Missouri","Ste. Genevieve County",5,80,114,53,61
050,29,186,"Missouri","Ste. Genevieve County",5,81,104,49,55
050,29,186,"Missouri","Ste. Genevieve County",5,82,86,34,52
050,29,186,"Missouri","Ste. Genevieve County",5,83,70,25,45
050,29,186,"Missouri","Ste. Genevieve County",5,84,81,33,48
050,29,186,"Missouri","Ste. Genevieve County",5,85,468,188,280
050,29,187,"Missouri","St. Francois County",1,0,666,338,328
050,29,187,"Missouri","St. Francois County",1,1,700,350,350
050,29,187,"Missouri","St. Francois County",1,2,724,361,363
050,29,187,"Missouri","St. Francois County",1,3,747,379,368
050,29,187,"Missouri","St. Francois County",1,4,754,364,390
050,29,187,"Missouri","St. Francois County",1,5,727,367,360
050,29,187,"Missouri","St. Francois County",1,6,744,382,362
050,29,187,"Missouri","St. Francois County",1,7,748,359,389
050,29,187,"Missouri","St. Francois County",1,8,765,374,391
050,29,187,"Missouri","St. Francois County",1,9,772,401,371
050,29,187,"Missouri","St. Francois County",1,10,796,402,394
050,29,187,"Missouri","St. Francois County",1,11,845,431,414
050,29,187,"Missouri","St. Francois County",1,12,887,455,432
050,29,187,"Missouri","St. Francois County",1,13,902,474,428
050,29,187,"Missouri","St. Francois County",1,14,859,453,406
050,29,187,"Missouri","St. Francois County",1,15,829,395,434
050,29,187,"Missouri","St. Francois County",1,16,820,392,428
050,29,187,"Missouri","St. Francois County",1,17,877,441,436
050,29,187,"Missouri","St. Francois County",1,18,808,422,386
050,29,187,"Missouri","St. Francois County",1,19,795,434,361
050,29,187,"Missouri","St. Francois County",1,20,809,451,358
050,29,187,"Missouri","St. Francois County",1,21,818,497,321
050,29,187,"Missouri","St. Francois County",1,22,839,491,348
050,29,187,"Missouri","St. Francois County",1,23,849,508,341
050,29,187,"Missouri","St. Francois County",1,24,874,547,327
050,29,187,"Missouri","St. Francois County",1,25,889,553,336
050,29,187,"Missouri","St. Francois County",1,26,955,559,396
050,29,187,"Missouri","St. Francois County",1,27,936,562,374
050,29,187,"Missouri","St. Francois County",1,28,955,548,407
050,29,187,"Missouri","St. Francois County",1,29,1047,623,424
050,29,187,"Missouri","St. Francois County",1,30,1014,590,424
050,29,187,"Missouri","St. Francois County",1,31,965,568,397
050,29,187,"Missouri","St. Francois County",1,32,857,495,362
050,29,187,"Missouri","St. Francois County",1,33,901,528,373
050,29,187,"Missouri","St. Francois County",1,34,936,542,394
050,29,187,"Missouri","St. Francois County",1,35,906,519,387
050,29,187,"Missouri","St. Francois County",1,36,924,540,384
050,29,187,"Missouri","St. Francois County",1,37,946,529,417
050,29,187,"Missouri","St. Francois County",1,38,924,520,404
050,29,187,"Missouri","St. Francois County",1,39,949,521,428
050,29,187,"Missouri","St. Francois County",1,40,936,523,413
050,29,187,"Missouri","St. Francois County",1,41,889,489,400
050,29,187,"Missouri","St. Francois County",1,42,918,535,383
050,29,187,"Missouri","St. Francois County",1,43,876,522,354
050,29,187,"Missouri","St. Francois County",1,44,825,465,360
050,29,187,"Missouri","St. Francois County",1,45,862,492,370
050,29,187,"Missouri","St. Francois County",1,46,828,463,365
050,29,187,"Missouri","St. Francois County",1,47,854,477,377
050,29,187,"Missouri","St. Francois County",1,48,885,480,405
050,29,187,"Missouri","St. Francois County",1,49,995,574,421
050,29,187,"Missouri","St. Francois County",1,50,915,519,396
050,29,187,"Missouri","St. Francois County",1,51,845,466,379
050,29,187,"Missouri","St. Francois County",1,52,800,435,365
050,29,187,"Missouri","St. Francois County",1,53,801,441,360
050,29,187,"Missouri","St. Francois County",1,54,800,439,361
050,29,187,"Missouri","St. Francois County",1,55,865,464,401
050,29,187,"Missouri","St. Francois County",1,56,909,495,414
050,29,187,"Missouri","St. Francois County",1,57,935,500,435
050,29,187,"Missouri","St. Francois County",1,58,941,499,442
050,29,187,"Missouri","St. Francois County",1,59,916,463,453
050,29,187,"Missouri","St. Francois County",1,60,865,439,426
050,29,187,"Missouri","St. Francois County",1,61,872,444,428
050,29,187,"Missouri","St. Francois County",1,62,846,433,413
050,29,187,"Missouri","St. Francois County",1,63,842,434,408
050,29,187,"Missouri","St. Francois County",1,64,817,403,414
050,29,187,"Missouri","St. Francois County",1,65,758,386,372
050,29,187,"Missouri","St. Francois County",1,66,723,375,348
050,29,187,"Missouri","St. Francois County",1,67,743,379,364
050,29,187,"Missouri","St. Francois County",1,68,681,354,327
050,29,187,"Missouri","St. Francois County",1,69,636,314,322
050,29,187,"Missouri","St. Francois County",1,70,609,288,321
050,29,187,"Missouri","St. Francois County",1,71,589,276,313
050,29,187,"Missouri","St. Francois County",1,72,643,290,353
050,29,187,"Missouri","St. Francois County",1,73,625,289,336
050,29,187,"Missouri","St. Francois County",1,74,420,182,238
050,29,187,"Missouri","St. Francois County",1,75,429,207,222
050,29,187,"Missouri","St. Francois County",1,76,452,205,247
050,29,187,"Missouri","St. Francois County",1,77,462,209,253
050,29,187,"Missouri","St. Francois County",1,78,389,175,214
050,29,187,"Missouri","St. Francois County",1,79,330,150,180
050,29,187,"Missouri","St. Francois County",1,80,328,138,190
050,29,187,"Missouri","St. Francois County",1,81,305,125,180
050,29,187,"Missouri","St. Francois County",1,82,297,121,176
050,29,187,"Missouri","St. Francois County",1,83,248,110,138
050,29,187,"Missouri","St. Francois County",1,84,215,86,129
050,29,187,"Missouri","St. Francois County",1,85,1142,387,755
050,29,187,"Missouri","St. Francois County",2,0,673,344,329
050,29,187,"Missouri","St. Francois County",2,1,691,345,346
050,29,187,"Missouri","St. Francois County",2,2,718,357,361
050,29,187,"Missouri","St. Francois County",2,3,740,371,369
050,29,187,"Missouri","St. Francois County",2,4,752,367,385
050,29,187,"Missouri","St. Francois County",2,5,732,365,367
050,29,187,"Missouri","St. Francois County",2,6,741,377,364
050,29,187,"Missouri","St. Francois County",2,7,746,363,383
050,29,187,"Missouri","St. Francois County",2,8,766,371,395
050,29,187,"Missouri","St. Francois County",2,9,770,395,375
050,29,187,"Missouri","St. Francois County",2,10,790,401,389
050,29,187,"Missouri","St. Francois County",2,11,827,420,407
050,29,187,"Missouri","St. Francois County",2,12,881,450,431
050,29,187,"Missouri","St. Francois County",2,13,893,466,427
050,29,187,"Missouri","St. Francois County",2,14,872,459,413
050,29,187,"Missouri","St. Francois County",2,15,836,407,429
050,29,187,"Missouri","St. Francois County",2,16,823,394,429
050,29,187,"Missouri","St. Francois County",2,17,868,431,437
050,29,187,"Missouri","St. Francois County",2,18,807,421,386
050,29,187,"Missouri","St. Francois County",2,19,796,429,367
050,29,187,"Missouri","St. Francois County",2,20,808,447,361
050,29,187,"Missouri","St. Francois County",2,21,808,480,328
050,29,187,"Missouri","St. Francois County",2,22,822,476,346
050,29,187,"Missouri","St. Francois County",2,23,843,494,349
050,29,187,"Missouri","St. Francois County",2,24,854,524,330
050,29,187,"Missouri","St. Francois County",2,25,876,539,337
050,29,187,"Missouri","St. Francois County",2,26,922,538,384
050,29,187,"Missouri","St. Francois County",2,27,921,545,376
050,29,187,"Missouri","St. Francois County",2,28,928,529,399
050,29,187,"Missouri","St. Francois County",2,29,1012,592,420
050,29,187,"Missouri","St. Francois County",2,30,1009,581,428
050,29,187,"Missouri","St. Francois County",2,31,952,551,401
050,29,187,"Missouri","St. Francois County",2,32,857,487,370
050,29,187,"Missouri","St. Francois County",2,33,875,505,370
050,29,187,"Missouri","St. Francois County",2,34,915,524,391
050,29,187,"Missouri","St. Francois County",2,35,901,512,389
050,29,187,"Missouri","St. Francois County",2,36,895,513,382
050,29,187,"Missouri","St. Francois County",2,37,920,507,413
050,29,187,"Missouri","St. Francois County",2,38,926,516,410
050,29,187,"Missouri","St. Francois County",2,39,927,506,421
050,29,187,"Missouri","St. Francois County",2,40,927,509,418
050,29,187,"Missouri","St. Francois County",2,41,889,487,402
050,29,187,"Missouri","St. Francois County",2,42,897,514,383
050,29,187,"Missouri","St. Francois County",2,43,875,512,363
050,29,187,"Missouri","St. Francois County",2,44,813,460,353
050,29,187,"Missouri","St. Francois County",2,45,849,479,370
050,29,187,"Missouri","St. Francois County",2,46,821,456,365
050,29,187,"Missouri","St. Francois County",2,47,834,459,375
050,29,187,"Missouri","St. Francois County",2,48,871,470,401
050,29,187,"Missouri","St. Francois County",2,49,963,544,419
050,29,187,"Missouri","St. Francois County",2,50,922,519,403
050,29,187,"Missouri","St. Francois County",2,51,850,466,384
050,29,187,"Missouri","St. Francois County",2,52,789,426,363
050,29,187,"Missouri","St. Francois County",2,53,795,433,362
050,29,187,"Missouri","St. Francois County",2,54,792,433,359
050,29,187,"Missouri","St. Francois County",2,55,838,448,390
050,29,187,"Missouri","St. Francois County",2,56,898,483,415
050,29,187,"Missouri","St. Francois County",2,57,921,490,431
050,29,187,"Missouri","St. Francois County",2,58,938,495,443
050,29,187,"Missouri","St. Francois County",2,59,926,471,455
050,29,187,"Missouri","St. Francois County",2,60,869,438,431
050,29,187,"Missouri","St. Francois County",2,61,868,440,428
050,29,187,"Missouri","St. Francois County",2,62,846,429,417
050,29,187,"Missouri","St. Francois County",2,63,846,434,412
050,29,187,"Missouri","St. Francois County",2,64,812,401,411
050,29,187,"Missouri","St. Francois County",2,65,771,390,381
050,29,187,"Missouri","St. Francois County",2,66,731,377,354
050,29,187,"Missouri","St. Francois County",2,67,732,373,359
050,29,187,"Missouri","St. Francois County",2,68,689,355,334
050,29,187,"Missouri","St. Francois County",2,69,651,325,326
050,29,187,"Missouri","St. Francois County",2,70,610,290,320
050,29,187,"Missouri","St. Francois County",2,71,594,281,313
050,29,187,"Missouri","St. Francois County",2,72,621,281,340
050,29,187,"Missouri","St. Francois County",2,73,656,301,355
050,29,187,"Missouri","St. Francois County",2,74,437,192,245
050,29,187,"Missouri","St. Francois County",2,75,430,202,228
050,29,187,"Missouri","St. Francois County",2,76,436,202,234
050,29,187,"Missouri","St. Francois County",2,77,466,211,255
050,29,187,"Missouri","St. Francois County",2,78,398,175,223
050,29,187,"Missouri","St. Francois County",2,79,335,151,184
050,29,187,"Missouri","St. Francois County",2,80,329,139,190
050,29,187,"Missouri","St. Francois County",2,81,303,127,176
050,29,187,"Missouri","St. Francois County",2,82,293,118,175
050,29,187,"Missouri","St. Francois County",2,83,254,110,144
050,29,187,"Missouri","St. Francois County",2,84,217,87,130
050,29,187,"Missouri","St. Francois County",2,85,1148,388,760
050,29,187,"Missouri","St. Francois County",3,0,652,331,321
050,29,187,"Missouri","St. Francois County",3,1,687,354,333
050,29,187,"Missouri","St. Francois County",3,2,707,352,355
050,29,187,"Missouri","St. Francois County",3,3,734,360,374
050,29,187,"Missouri","St. Francois County",3,4,759,380,379
050,29,187,"Missouri","St. Francois County",3,5,765,381,384
050,29,187,"Missouri","St. Francois County",3,6,756,374,382
050,29,187,"Missouri","St. Francois County",3,7,762,386,376
050,29,187,"Missouri","St. Francois County",3,8,758,371,387
050,29,187,"Missouri","St. Francois County",3,9,773,379,394
050,29,187,"Missouri","St. Francois County",3,10,777,394,383
050,29,187,"Missouri","St. Francois County",3,11,804,410,394
050,29,187,"Missouri","St. Francois County",3,12,850,430,420
050,29,187,"Missouri","St. Francois County",3,13,897,462,435
050,29,187,"Missouri","St. Francois County",3,14,890,457,433
050,29,187,"Missouri","St. Francois County",3,15,865,457,408
050,29,187,"Missouri","St. Francois County",3,16,843,401,442
050,29,187,"Missouri","St. Francois County",3,17,835,405,430
050,29,187,"Missouri","St. Francois County",3,18,802,419,383
050,29,187,"Missouri","St. Francois County",3,19,794,431,363
050,29,187,"Missouri","St. Francois County",3,20,841,476,365
050,29,187,"Missouri","St. Francois County",3,21,864,508,356
050,29,187,"Missouri","St. Francois County",3,22,837,470,367
050,29,187,"Missouri","St. Francois County",3,23,854,493,361
050,29,187,"Missouri","St. Francois County",3,24,881,508,373
050,29,187,"Missouri","St. Francois County",3,25,878,553,325
050,29,187,"Missouri","St. Francois County",3,26,922,553,369
050,29,187,"Missouri","St. Francois County",3,27,954,557,397
050,29,187,"Missouri","St. Francois County",3,28,925,533,392
050,29,187,"Missouri","St. Francois County",3,29,970,570,400
050,29,187,"Missouri","St. Francois County",3,30,1026,604,422
050,29,187,"Missouri","St. Francois County",3,31,1000,563,437
050,29,187,"Missouri","St. Francois County",3,32,903,521,382
050,29,187,"Missouri","St. Francois County",3,33,897,514,383
050,29,187,"Missouri","St. Francois County",3,34,927,528,399
050,29,187,"Missouri","St. Francois County",3,35,926,530,396
050,29,187,"Missouri","St. Francois County",3,36,917,525,392
050,29,187,"Missouri","St. Francois County",3,37,879,489,390
050,29,187,"Missouri","St. Francois County",3,38,971,552,419
050,29,187,"Missouri","St. Francois County",3,39,935,524,411
050,29,187,"Missouri","St. Francois County",3,40,912,489,423
050,29,187,"Missouri","St. Francois County",3,41,934,518,416
050,29,187,"Missouri","St. Francois County",3,42,906,508,398
050,29,187,"Missouri","St. Francois County",3,43,914,527,387
050,29,187,"Missouri","St. Francois County",3,44,864,509,355
050,29,187,"Missouri","St. Francois County",3,45,811,464,347
050,29,187,"Missouri","St. Francois County",3,46,854,478,376
050,29,187,"Missouri","St. Francois County",3,47,814,452,362
050,29,187,"Missouri","St. Francois County",3,48,850,470,380
050,29,187,"Missouri","St. Francois County",3,49,879,488,391
050,29,187,"Missouri","St. Francois County",3,50,955,527,428
050,29,187,"Missouri","St. Francois County",3,51,936,520,416
050,29,187,"Missouri","St. Francois County",3,52,828,447,381
050,29,187,"Missouri","St. Francois County",3,53,801,427,374
050,29,187,"Missouri","St. Francois County",3,54,793,431,362
050,29,187,"Missouri","St. Francois County",3,55,794,426,368
050,29,187,"Missouri","St. Francois County",3,56,850,450,400
050,29,187,"Missouri","St. Francois County",3,57,879,464,415
050,29,187,"Missouri","St. Francois County",3,58,916,487,429
050,29,187,"Missouri","St. Francois County",3,59,945,490,455
050,29,187,"Missouri","St. Francois County",3,60,888,437,451
050,29,187,"Missouri","St. Francois County",3,61,889,453,436
050,29,187,"Missouri","St. Francois County",3,62,861,436,425
050,29,187,"Missouri","St. Francois County",3,63,856,433,423
050,29,187,"Missouri","St. Francois County",3,64,813,410,403
050,29,187,"Missouri","St. Francois County",3,65,787,382,405
050,29,187,"Missouri","St. Francois County",3,66,748,376,372
050,29,187,"Missouri","St. Francois County",3,67,707,359,348
050,29,187,"Missouri","St. Francois County",3,68,733,370,363
050,29,187,"Missouri","St. Francois County",3,69,685,348,337
050,29,187,"Missouri","St. Francois County",3,70,637,310,327
050,29,187,"Missouri","St. Francois County",3,71,596,284,312
050,29,187,"Missouri","St. Francois County",3,72,587,277,310
050,29,187,"Missouri","St. Francois County",3,73,580,266,314
050,29,187,"Missouri","St. Francois County",3,74,623,280,343
050,29,187,"Missouri","St. Francois County",3,75,431,183,248
050,29,187,"Missouri","St. Francois County",3,76,419,198,221
050,29,187,"Missouri","St. Francois County",3,77,407,194,213
050,29,187,"Missouri","St. Francois County",3,78,447,186,261
050,29,187,"Missouri","St. Francois County",3,79,350,156,194
050,29,187,"Missouri","St. Francois County",3,80,332,140,192
050,29,187,"Missouri","St. Francois County",3,81,292,123,169
050,29,187,"Missouri","St. Francois County",3,82,280,117,163
050,29,187,"Missouri","St. Francois County",3,83,258,109,149
050,29,187,"Missouri","St. Francois County",3,84,234,94,140
050,29,187,"Missouri","St. Francois County",3,85,1118,371,747
050,29,187,"Missouri","St. Francois County",4,0,655,310,345
050,29,187,"Missouri","St. Francois County",4,1,652,338,314
050,29,187,"Missouri","St. Francois County",4,2,694,358,336
050,29,187,"Missouri","St. Francois County",4,3,729,365,364
050,29,187,"Missouri","St. Francois County",4,4,718,356,362
050,29,187,"Missouri","St. Francois County",4,5,774,391,383
050,29,187,"Missouri","St. Francois County",4,6,792,392,400
050,29,187,"Missouri","St. Francois County",4,7,754,378,376
050,29,187,"Missouri","St. Francois County",4,8,764,383,381
050,29,187,"Missouri","St. Francois County",4,9,756,373,383
050,29,187,"Missouri","St. Francois County",4,10,783,385,398
050,29,187,"Missouri","St. Francois County",4,11,779,398,381
050,29,187,"Missouri","St. Francois County",4,12,819,420,399
050,29,187,"Missouri","St. Francois County",4,13,867,430,437
050,29,187,"Missouri","St. Francois County",4,14,910,466,444
050,29,187,"Missouri","St. Francois County",4,15,907,465,442
050,29,187,"Missouri","St. Francois County",4,16,878,460,418
050,29,187,"Missouri","St. Francois County",4,17,846,398,448
050,29,187,"Missouri","St. Francois County",4,18,775,400,375
050,29,187,"Missouri","St. Francois County",4,19,769,417,352
050,29,187,"Missouri","St. Francois County",4,20,807,451,356
050,29,187,"Missouri","St. Francois County",4,21,855,507,348
050,29,187,"Missouri","St. Francois County",4,22,865,493,372
050,29,187,"Missouri","St. Francois County",4,23,878,502,376
050,29,187,"Missouri","St. Francois County",4,24,878,522,356
050,29,187,"Missouri","St. Francois County",4,25,888,518,370
050,29,187,"Missouri","St. Francois County",4,26,867,538,329
050,29,187,"Missouri","St. Francois County",4,27,918,540,378
050,29,187,"Missouri","St. Francois County",4,28,931,532,399
050,29,187,"Missouri","St. Francois County",4,29,923,543,380
050,29,187,"Missouri","St. Francois County",4,30,972,567,405
050,29,187,"Missouri","St. Francois County",4,31,999,562,437
050,29,187,"Missouri","St. Francois County",4,32,942,518,424
050,29,187,"Missouri","St. Francois County",4,33,924,523,401
050,29,187,"Missouri","St. Francois County",4,34,937,514,423
050,29,187,"Missouri","St. Francois County",4,35,904,520,384
050,29,187,"Missouri","St. Francois County",4,36,921,521,400
050,29,187,"Missouri","St. Francois County",4,37,884,481,403
050,29,187,"Missouri","St. Francois County",4,38,891,500,391
050,29,187,"Missouri","St. Francois County",4,39,949,546,403
050,29,187,"Missouri","St. Francois County",4,40,922,496,426
050,29,187,"Missouri","St. Francois County",4,41,917,491,426
050,29,187,"Missouri","St. Francois County",4,42,944,531,413
050,29,187,"Missouri","St. Francois County",4,43,918,512,406
050,29,187,"Missouri","St. Francois County",4,44,889,496,393
050,29,187,"Missouri","St. Francois County",4,45,873,506,367
050,29,187,"Missouri","St. Francois County",4,46,808,461,347
050,29,187,"Missouri","St. Francois County",4,47,829,467,362
050,29,187,"Missouri","St. Francois County",4,48,826,450,376
050,29,187,"Missouri","St. Francois County",4,49,858,476,382
050,29,187,"Missouri","St. Francois County",4,50,842,461,381
050,29,187,"Missouri","St. Francois County",4,51,948,516,432
050,29,187,"Missouri","St. Francois County",4,52,889,483,406
050,29,187,"Missouri","St. Francois County",4,53,834,441,393
050,29,187,"Missouri","St. Francois County",4,54,796,426,370
050,29,187,"Missouri","St. Francois County",4,55,789,424,365
050,29,187,"Missouri","St. Francois County",4,56,810,432,378
050,29,187,"Missouri","St. Francois County",4,57,829,431,398
050,29,187,"Missouri","St. Francois County",4,58,870,463,407
050,29,187,"Missouri","St. Francois County",4,59,895,459,436
050,29,187,"Missouri","St. Francois County",4,60,919,459,460
050,29,187,"Missouri","St. Francois County",4,61,905,447,458
050,29,187,"Missouri","St. Francois County",4,62,850,425,425
050,29,187,"Missouri","St. Francois County",4,63,887,450,437
050,29,187,"Missouri","St. Francois County",4,64,836,415,421
050,29,187,"Missouri","St. Francois County",4,65,799,395,404
050,29,187,"Missouri","St. Francois County",4,66,787,386,401
050,29,187,"Missouri","St. Francois County",4,67,730,357,373
050,29,187,"Missouri","St. Francois County",4,68,698,355,343
050,29,187,"Missouri","St. Francois County",4,69,726,362,364
050,29,187,"Missouri","St. Francois County",4,70,673,334,339
050,29,187,"Missouri","St. Francois County",4,71,611,298,313
050,29,187,"Missouri","St. Francois County",4,72,593,279,314
050,29,187,"Missouri","St. Francois County",4,73,556,269,287
050,29,187,"Missouri","St. Francois County",4,74,561,252,309
050,29,187,"Missouri","St. Francois County",4,75,600,266,334
050,29,187,"Missouri","St. Francois County",4,76,417,174,243
050,29,187,"Missouri","St. Francois County",4,77,382,181,201
050,29,187,"Missouri","St. Francois County",4,78,398,181,217
050,29,187,"Missouri","St. Francois County",4,79,398,167,231
050,29,187,"Missouri","St. Francois County",4,80,344,145,199
050,29,187,"Missouri","St. Francois County",4,81,299,128,171
050,29,187,"Missouri","St. Francois County",4,82,275,117,158
050,29,187,"Missouri","St. Francois County",4,83,233,96,137
050,29,187,"Missouri","St. Francois County",4,84,244,98,146
050,29,187,"Missouri","St. Francois County",4,85,1145,384,761
050,29,187,"Missouri","St. Francois County",5,0,643,303,340
050,29,187,"Missouri","St. Francois County",5,1,635,302,333
050,29,187,"Missouri","St. Francois County",5,2,650,333,317
050,29,187,"Missouri","St. Francois County",5,3,706,364,342
050,29,187,"Missouri","St. Francois County",5,4,713,351,362
050,29,187,"Missouri","St. Francois County",5,5,728,354,374
050,29,187,"Missouri","St. Francois County",5,6,776,403,373
050,29,187,"Missouri","St. Francois County",5,7,788,403,385
050,29,187,"Missouri","St. Francois County",5,8,765,379,386
050,29,187,"Missouri","St. Francois County",5,9,779,393,386
050,29,187,"Missouri","St. Francois County",5,10,754,368,386
050,29,187,"Missouri","St. Francois County",5,11,767,380,387
050,29,187,"Missouri","St. Francois County",5,12,779,399,380
050,29,187,"Missouri","St. Francois County",5,13,807,412,395
050,29,187,"Missouri","St. Francois County",5,14,872,428,444
050,29,187,"Missouri","St. Francois County",5,15,914,461,453
050,29,187,"Missouri","St. Francois County",5,16,901,463,438
050,29,187,"Missouri","St. Francois County",5,17,887,466,421
050,29,187,"Missouri","St. Francois County",5,18,779,384,395
050,29,187,"Missouri","St. Francois County",5,19,760,408,352
050,29,187,"Missouri","St. Francois County",5,20,798,448,350
050,29,187,"Missouri","St. Francois County",5,21,860,510,350
050,29,187,"Missouri","St. Francois County",5,22,883,505,378
050,29,187,"Missouri","St. Francois County",5,23,891,511,380
050,29,187,"Missouri","St. Francois County",5,24,910,526,384
050,29,187,"Missouri","St. Francois County",5,25,913,556,357
050,29,187,"Missouri","St. Francois County",5,26,892,512,380
050,29,187,"Missouri","St. Francois County",5,27,878,547,331
050,29,187,"Missouri","St. Francois County",5,28,909,535,374
050,29,187,"Missouri","St. Francois County",5,29,967,565,402
050,29,187,"Missouri","St. Francois County",5,30,931,542,389
050,29,187,"Missouri","St. Francois County",5,31,963,552,411
050,29,187,"Missouri","St. Francois County",5,32,952,525,427
050,29,187,"Missouri","St. Francois County",5,33,987,550,437
050,29,187,"Missouri","St. Francois County",5,34,947,533,414
050,29,187,"Missouri","St. Francois County",5,35,963,534,429
050,29,187,"Missouri","St. Francois County",5,36,918,521,397
050,29,187,"Missouri","St. Francois County",5,37,883,485,398
050,29,187,"Missouri","St. Francois County",5,38,912,521,391
050,29,187,"Missouri","St. Francois County",5,39,898,503,395
050,29,187,"Missouri","St. Francois County",5,40,934,521,413
050,29,187,"Missouri","St. Francois County",5,41,921,499,422
050,29,187,"Missouri","St. Francois County",5,42,946,522,424
050,29,187,"Missouri","St. Francois County",5,43,941,535,406
050,29,187,"Missouri","St. Francois County",5,44,903,497,406
050,29,187,"Missouri","St. Francois County",5,45,909,511,398
050,29,187,"Missouri","St. Francois County",5,46,867,496,371
050,29,187,"Missouri","St. Francois County",5,47,810,463,347
050,29,187,"Missouri","St. Francois County",5,48,835,469,366
050,29,187,"Missouri","St. Francois County",5,49,835,459,376
050,29,187,"Missouri","St. Francois County",5,50,847,462,385
050,29,187,"Missouri","St. Francois County",5,51,826,440,386
050,29,187,"Missouri","St. Francois County",5,52,918,502,416
050,29,187,"Missouri","St. Francois County",5,53,885,480,405
050,29,187,"Missouri","St. Francois County",5,54,834,436,398
050,29,187,"Missouri","St. Francois County",5,55,787,420,367
050,29,187,"Missouri","St. Francois County",5,56,795,420,375
050,29,187,"Missouri","St. Francois County",5,57,793,421,372
050,29,187,"Missouri","St. Francois County",5,58,815,435,380
050,29,187,"Missouri","St. Francois County",5,59,863,449,414
050,29,187,"Missouri","St. Francois County",5,60,897,448,449
050,29,187,"Missouri","St. Francois County",5,61,930,462,468
050,29,187,"Missouri","St. Francois County",5,62,866,430,436
050,29,187,"Missouri","St. Francois County",5,63,844,427,417
050,29,187,"Missouri","St. Francois County",5,64,863,433,430
050,29,187,"Missouri","St. Francois County",5,65,818,399,419
050,29,187,"Missouri","St. Francois County",5,66,791,395,396
050,29,187,"Missouri","St. Francois County",5,67,764,367,397
050,29,187,"Missouri","St. Francois County",5,68,719,351,368
050,29,187,"Missouri","St. Francois County",5,69,680,343,337
050,29,187,"Missouri","St. Francois County",5,70,708,353,355
050,29,187,"Missouri","St. Francois County",5,71,655,326,329
050,29,187,"Missouri","St. Francois County",5,72,599,286,313
050,29,187,"Missouri","St. Francois County",5,73,564,265,299
050,29,187,"Missouri","St. Francois County",5,74,547,264,283
050,29,187,"Missouri","St. Francois County",5,75,545,242,303
050,29,187,"Missouri","St. Francois County",5,76,585,262,323
050,29,187,"Missouri","St. Francois County",5,77,391,167,224
050,29,187,"Missouri","St. Francois County",5,78,373,163,210
050,29,187,"Missouri","St. Francois County",5,79,360,166,194
050,29,187,"Missouri","St. Francois County",5,80,395,160,235
050,29,187,"Missouri","St. Francois County",5,81,315,136,179
050,29,187,"Missouri","St. Francois County",5,82,284,122,162
050,29,187,"Missouri","St. Francois County",5,83,238,104,134
050,29,187,"Missouri","St. Francois County",5,84,215,84,131
050,29,187,"Missouri","St. Francois County",5,85,1190,409,781
050,29,189,"Missouri","St. Louis County",1,0,11336,5779,5557
050,29,189,"Missouri","St. Louis County",1,1,11481,5855,5626
050,29,189,"Missouri","St. Louis County",1,2,11694,6062,5632
050,29,189,"Missouri","St. Louis County",1,3,12020,6161,5859
050,29,189,"Missouri","St. Louis County",1,4,12237,6192,6045
050,29,189,"Missouri","St. Louis County",1,5,12285,6251,6034
050,29,189,"Missouri","St. Louis County",1,6,12080,6180,5900
050,29,189,"Missouri","St. Louis County",1,7,12018,6146,5872
050,29,189,"Missouri","St. Louis County",1,8,12476,6459,6017
050,29,189,"Missouri","St. Louis County",1,9,12365,6456,5909
050,29,189,"Missouri","St. Louis County",1,10,12418,6404,6014
050,29,189,"Missouri","St. Louis County",1,11,12743,6537,6206
050,29,189,"Missouri","St. Louis County",1,12,13234,6665,6569
050,29,189,"Missouri","St. Louis County",1,13,13190,6758,6432
050,29,189,"Missouri","St. Louis County",1,14,13141,6658,6483
050,29,189,"Missouri","St. Louis County",1,15,13120,6584,6536
050,29,189,"Missouri","St. Louis County",1,16,13427,6828,6599
050,29,189,"Missouri","St. Louis County",1,17,13155,6756,6399
050,29,189,"Missouri","St. Louis County",1,18,12428,6360,6068
050,29,189,"Missouri","St. Louis County",1,19,12234,6149,6085
050,29,189,"Missouri","St. Louis County",1,20,11860,5925,5935
050,29,189,"Missouri","St. Louis County",1,21,11563,5779,5784
050,29,189,"Missouri","St. Louis County",1,22,11807,5891,5916
050,29,189,"Missouri","St. Louis County",1,23,12020,5918,6102
050,29,189,"Missouri","St. Louis County",1,24,12358,6081,6277
050,29,189,"Missouri","St. Louis County",1,25,12578,6215,6363
050,29,189,"Missouri","St. Louis County",1,26,12978,6524,6454
050,29,189,"Missouri","St. Louis County",1,27,13250,6519,6731
050,29,189,"Missouri","St. Louis County",1,28,13301,6415,6886
050,29,189,"Missouri","St. Louis County",1,29,12972,6311,6661
050,29,189,"Missouri","St. Louis County",1,30,12607,6065,6542
050,29,189,"Missouri","St. Louis County",1,31,12447,5924,6523
050,29,189,"Missouri","St. Louis County",1,32,12503,6006,6497
050,29,189,"Missouri","St. Louis County",1,33,12719,6203,6516
050,29,189,"Missouri","St. Louis County",1,34,13083,6423,6660
050,29,189,"Missouri","St. Louis County",1,35,13064,6320,6744
050,29,189,"Missouri","St. Louis County",1,36,12963,6330,6633
050,29,189,"Missouri","St. Louis County",1,37,13428,6604,6824
050,29,189,"Missouri","St. Louis County",1,38,13044,6317,6727
050,29,189,"Missouri","St. Louis County",1,39,12945,6292,6653
050,29,189,"Missouri","St. Louis County",1,40,12658,6067,6591
050,29,189,"Missouri","St. Louis County",1,41,12305,5947,6358
050,29,189,"Missouri","St. Louis County",1,42,11993,5748,6245
050,29,189,"Missouri","St. Louis County",1,43,11577,5551,6026
050,29,189,"Missouri","St. Louis County",1,44,11346,5284,6062
050,29,189,"Missouri","St. Louis County",1,45,11214,5283,5931
050,29,189,"Missouri","St. Louis County",1,46,10949,5206,5743
050,29,189,"Missouri","St. Louis County",1,47,11326,5305,6021
050,29,189,"Missouri","St. Louis County",1,48,12096,5761,6335
050,29,189,"Missouri","St. Louis County",1,49,12945,6143,6802
050,29,189,"Missouri","St. Louis County",1,50,12474,5962,6512
050,29,189,"Missouri","St. Louis County",1,51,12077,5766,6311
050,29,189,"Missouri","St. Louis County",1,52,11979,5657,6322
050,29,189,"Missouri","St. Louis County",1,53,12148,5815,6333
050,29,189,"Missouri","St. Louis County",1,54,12708,5994,6714
050,29,189,"Missouri","St. Louis County",1,55,13530,6400,7130
050,29,189,"Missouri","St. Louis County",1,56,13787,6494,7293
050,29,189,"Missouri","St. Louis County",1,57,14038,6679,7359
050,29,189,"Missouri","St. Louis County",1,58,14348,6833,7515
050,29,189,"Missouri","St. Louis County",1,59,14420,6811,7609
050,29,189,"Missouri","St. Louis County",1,60,14336,6759,7577
050,29,189,"Missouri","St. Louis County",1,61,14200,6777,7423
050,29,189,"Missouri","St. Louis County",1,62,14294,6786,7508
050,29,189,"Missouri","St. Louis County",1,63,13766,6424,7342
050,29,189,"Missouri","St. Louis County",1,64,13243,6211,7032
050,29,189,"Missouri","St. Louis County",1,65,12918,6106,6812
050,29,189,"Missouri","St. Louis County",1,66,12418,5749,6669
050,29,189,"Missouri","St. Louis County",1,67,11743,5393,6350
050,29,189,"Missouri","St. Louis County",1,68,11546,5220,6326
050,29,189,"Missouri","St. Louis County",1,69,10585,4719,5866
050,29,189,"Missouri","St. Louis County",1,70,10109,4451,5658
050,29,189,"Missouri","St. Louis County",1,71,9997,4478,5519
050,29,189,"Missouri","St. Louis County",1,72,9789,4332,5457
050,29,189,"Missouri","St. Louis County",1,73,10007,4415,5592
050,29,189,"Missouri","St. Louis County",1,74,6998,3043,3955
050,29,189,"Missouri","St. Louis County",1,75,6801,2963,3838
050,29,189,"Missouri","St. Louis County",1,76,6792,2978,3814
050,29,189,"Missouri","St. Louis County",1,77,6846,2950,3896
050,29,189,"Missouri","St. Louis County",1,78,5816,2466,3350
050,29,189,"Missouri","St. Louis County",1,79,5191,2137,3054
050,29,189,"Missouri","St. Louis County",1,80,4641,1895,2746
050,29,189,"Missouri","St. Louis County",1,81,4565,1852,2713
050,29,189,"Missouri","St. Louis County",1,82,4221,1679,2542
050,29,189,"Missouri","St. Louis County",1,83,3772,1508,2264
050,29,189,"Missouri","St. Louis County",1,84,3604,1394,2210
050,29,189,"Missouri","St. Louis County",1,85,23617,7872,15745
050,29,189,"Missouri","St. Louis County",2,0,11129,5645,5484
050,29,189,"Missouri","St. Louis County",2,1,11470,5854,5616
050,29,189,"Missouri","St. Louis County",2,2,11687,6038,5649
050,29,189,"Missouri","St. Louis County",2,3,11929,6129,5800
050,29,189,"Missouri","St. Louis County",2,4,12227,6202,6025
050,29,189,"Missouri","St. Louis County",2,5,12280,6239,6041
050,29,189,"Missouri","St. Louis County",2,6,12145,6198,5947
050,29,189,"Missouri","St. Louis County",2,7,12051,6162,5889
050,29,189,"Missouri","St. Louis County",2,8,12335,6365,5970
050,29,189,"Missouri","St. Louis County",2,9,12382,6451,5931
050,29,189,"Missouri","St. Louis County",2,10,12391,6408,5983
050,29,189,"Missouri","St. Louis County",2,11,12622,6479,6143
050,29,189,"Missouri","St. Louis County",2,12,13171,6661,6510
050,29,189,"Missouri","St. Louis County",2,13,13219,6738,6481
050,29,189,"Missouri","St. Louis County",2,14,13151,6681,6470
050,29,189,"Missouri","St. Louis County",2,15,13150,6620,6530
050,29,189,"Missouri","St. Louis County",2,16,13377,6785,6592
050,29,189,"Missouri","St. Louis County",2,17,13217,6766,6451
050,29,189,"Missouri","St. Louis County",2,18,12375,6332,6043
050,29,189,"Missouri","St. Louis County",2,19,12215,6142,6073
050,29,189,"Missouri","St. Louis County",2,20,12012,5993,6019
050,29,189,"Missouri","St. Louis County",2,21,11535,5758,5777
050,29,189,"Missouri","St. Louis County",2,22,11741,5845,5896
050,29,189,"Missouri","St. Louis County",2,23,12015,5932,6083
050,29,189,"Missouri","St. Louis County",2,24,12274,6039,6235
050,29,189,"Missouri","St. Louis County",2,25,12511,6168,6343
050,29,189,"Missouri","St. Louis County",2,26,12876,6447,6429
050,29,189,"Missouri","St. Louis County",2,27,13134,6488,6646
050,29,189,"Missouri","St. Louis County",2,28,13264,6435,6829
050,29,189,"Missouri","St. Louis County",2,29,13047,6328,6719
050,29,189,"Missouri","St. Louis County",2,30,12768,6144,6624
050,29,189,"Missouri","St. Louis County",2,31,12454,5951,6503
050,29,189,"Missouri","St. Louis County",2,32,12459,5970,6489
050,29,189,"Missouri","St. Louis County",2,33,12661,6164,6497
050,29,189,"Missouri","St. Louis County",2,34,13006,6372,6634
050,29,189,"Missouri","St. Louis County",2,35,13153,6389,6764
050,29,189,"Missouri","St. Louis County",2,36,12925,6303,6622
050,29,189,"Missouri","St. Louis County",2,37,13348,6556,6792
050,29,189,"Missouri","St. Louis County",2,38,13179,6402,6777
050,29,189,"Missouri","St. Louis County",2,39,12905,6266,6639
050,29,189,"Missouri","St. Louis County",2,40,12824,6172,6652
050,29,189,"Missouri","St. Louis County",2,41,12391,5970,6421
050,29,189,"Missouri","St. Louis County",2,42,11985,5756,6229
050,29,189,"Missouri","St. Louis County",2,43,11765,5635,6130
050,29,189,"Missouri","St. Louis County",2,44,11287,5295,5992
050,29,189,"Missouri","St. Louis County",2,45,11295,5308,5987
050,29,189,"Missouri","St. Louis County",2,46,10974,5210,5764
050,29,189,"Missouri","St. Louis County",2,47,11182,5252,5930
050,29,189,"Missouri","St. Louis County",2,48,11891,5639,6252
050,29,189,"Missouri","St. Louis County",2,49,12775,6077,6698
050,29,189,"Missouri","St. Louis County",2,50,12577,6004,6573
050,29,189,"Missouri","St. Louis County",2,51,12099,5778,6321
050,29,189,"Missouri","St. Louis County",2,52,11945,5660,6285
050,29,189,"Missouri","St. Louis County",2,53,12083,5765,6318
050,29,189,"Missouri","St. Louis County",2,54,12504,5920,6584
050,29,189,"Missouri","St. Louis County",2,55,13292,6279,7013
050,29,189,"Missouri","St. Louis County",2,56,13738,6475,7263
050,29,189,"Missouri","St. Louis County",2,57,13951,6624,7327
050,29,189,"Missouri","St. Louis County",2,58,14205,6762,7443
050,29,189,"Missouri","St. Louis County",2,59,14408,6825,7583
050,29,189,"Missouri","St. Louis County",2,60,14261,6723,7538
050,29,189,"Missouri","St. Louis County",2,61,14165,6734,7431
050,29,189,"Missouri","St. Louis County",2,62,14194,6746,7448
050,29,189,"Missouri","St. Louis County",2,63,13933,6525,7408
050,29,189,"Missouri","St. Louis County",2,64,13248,6204,7044
050,29,189,"Missouri","St. Louis County",2,65,12905,6083,6822
050,29,189,"Missouri","St. Louis County",2,66,12501,5814,6687
050,29,189,"Missouri","St. Louis County",2,67,11803,5422,6381
050,29,189,"Missouri","St. Louis County",2,68,11449,5185,6264
050,29,189,"Missouri","St. Louis County",2,69,10822,4831,5991
050,29,189,"Missouri","St. Louis County",2,70,10128,4473,5655
050,29,189,"Missouri","St. Louis County",2,71,9976,4448,5528
050,29,189,"Missouri","St. Louis County",2,72,9629,4270,5359
050,29,189,"Missouri","St. Louis County",2,73,10331,4564,5767
050,29,189,"Missouri","St. Louis County",2,74,7214,3142,4072
050,29,189,"Missouri","St. Louis County",2,75,6805,2955,3850
050,29,189,"Missouri","St. Louis County",2,76,6670,2901,3769
050,29,189,"Missouri","St. Louis County",2,77,6888,2968,3920
050,29,189,"Missouri","St. Louis County",2,78,5890,2517,3373
050,29,189,"Missouri","St. Louis County",2,79,5248,2170,3078
050,29,189,"Missouri","St. Louis County",2,80,4688,1910,2778
050,29,189,"Missouri","St. Louis County",2,81,4503,1827,2676
050,29,189,"Missouri","St. Louis County",2,82,4225,1676,2549
050,29,189,"Missouri","St. Louis County",2,83,3801,1520,2281
050,29,189,"Missouri","St. Louis County",2,84,3556,1376,2180
050,29,189,"Missouri","St. Louis County",2,85,23336,7802,15534
050,29,189,"Missouri","St. Louis County",3,0,10457,5387,5070
050,29,189,"Missouri","St. Louis County",3,1,11158,5691,5467
050,29,189,"Missouri","St. Louis County",3,2,11556,5915,5641
050,29,189,"Missouri","St. Louis County",3,3,11738,6051,5687
050,29,189,"Missouri","St. Louis County",3,4,12028,6167,5861
050,29,189,"Missouri","St. Louis County",3,5,12240,6256,5984
050,29,189,"Missouri","St. Louis County",3,6,12277,6255,6022
050,29,189,"Missouri","St. Louis County",3,7,12192,6219,5973
050,29,189,"Missouri","St. Louis County",3,8,12056,6174,5882
050,29,189,"Missouri","St. Louis County",3,9,12273,6324,5949
050,29,189,"Missouri","St. Louis County",3,10,12352,6455,5897
050,29,189,"Missouri","St. Louis County",3,11,12367,6375,5992
050,29,189,"Missouri","St. Louis County",3,12,12668,6514,6154
050,29,189,"Missouri","St. Louis County",3,13,13171,6642,6529
050,29,189,"Missouri","St. Louis County",3,14,13261,6740,6521
050,29,189,"Missouri","St. Louis County",3,15,13165,6687,6478
050,29,189,"Missouri","St. Louis County",3,16,13140,6627,6513
050,29,189,"Missouri","St. Louis County",3,17,13319,6751,6568
050,29,189,"Missouri","St. Louis County",3,18,12530,6428,6102
050,29,189,"Missouri","St. Louis County",3,19,11951,6011,5940
050,29,189,"Missouri","St. Louis County",3,20,12054,6031,6023
050,29,189,"Missouri","St. Louis County",3,21,11780,5840,5940
050,29,189,"Missouri","St. Louis County",3,22,11653,5711,5942
050,29,189,"Missouri","St. Louis County",3,23,11954,5932,6022
050,29,189,"Missouri","St. Louis County",3,24,12216,6059,6157
050,29,189,"Missouri","St. Louis County",3,25,12084,5956,6128
050,29,189,"Missouri","St. Louis County",3,26,12394,6098,6296
050,29,189,"Missouri","St. Louis County",3,27,12692,6367,6325
050,29,189,"Missouri","St. Louis County",3,28,13052,6460,6592
050,29,189,"Missouri","St. Louis County",3,29,13198,6379,6819
050,29,189,"Missouri","St. Louis County",3,30,13033,6319,6714
050,29,189,"Missouri","St. Louis County",3,31,12789,6138,6651
050,29,189,"Missouri","St. Louis County",3,32,12574,6014,6560
050,29,189,"Missouri","St. Louis County",3,33,12455,5965,6490
050,29,189,"Missouri","St. Louis County",3,34,12641,6108,6533
050,29,189,"Missouri","St. Louis County",3,35,12997,6352,6645
050,29,189,"Missouri","St. Louis County",3,36,13225,6432,6793
050,29,189,"Missouri","St. Louis County",3,37,12985,6339,6646
050,29,189,"Missouri","St. Louis County",3,38,13254,6436,6818
050,29,189,"Missouri","St. Louis County",3,39,13177,6411,6766
050,29,189,"Missouri","St. Louis County",3,40,12860,6236,6624
050,29,189,"Missouri","St. Louis County",3,41,12733,6089,6644
050,29,189,"Missouri","St. Louis County",3,42,12345,5944,6401
050,29,189,"Missouri","St. Louis County",3,43,12017,5799,6218
050,29,189,"Missouri","St. Louis County",3,44,11691,5585,6106
050,29,189,"Missouri","St. Louis County",3,45,11249,5279,5970
050,29,189,"Missouri","St. Louis County",3,46,11218,5308,5910
050,29,189,"Missouri","St. Louis County",3,47,10934,5185,5749
050,29,189,"Missouri","St. Louis County",3,48,11105,5196,5909
050,29,189,"Missouri","St. Louis County",3,49,11784,5605,6179
050,29,189,"Missouri","St. Louis County",3,50,12660,6018,6642
050,29,189,"Missouri","St. Louis County",3,51,12447,5890,6557
050,29,189,"Missouri","St. Louis County",3,52,11959,5737,6222
050,29,189,"Missouri","St. Louis County",3,53,11800,5605,6195
050,29,189,"Missouri","St. Louis County",3,54,11912,5664,6248
050,29,189,"Missouri","St. Louis County",3,55,12293,5807,6486
050,29,189,"Missouri","St. Louis County",3,56,13094,6143,6951
050,29,189,"Missouri","St. Louis County",3,57,13515,6334,7181
050,29,189,"Missouri","St. Louis County",3,58,13666,6495,7171
050,29,189,"Missouri","St. Louis County",3,59,13933,6600,7333
050,29,189,"Missouri","St. Louis County",3,60,14109,6672,7437
050,29,189,"Missouri","St. Louis County",3,61,13964,6582,7382
050,29,189,"Missouri","St. Louis County",3,62,13890,6592,7298
050,29,189,"Missouri","St. Louis County",3,63,13845,6537,7308
050,29,189,"Missouri","St. Louis County",3,64,13646,6356,7290
050,29,189,"Missouri","St. Louis County",3,65,12947,6030,6917
050,29,189,"Missouri","St. Louis County",3,66,12602,5914,6688
050,29,189,"Missouri","St. Louis County",3,67,12202,5611,6591
050,29,189,"Missouri","St. Louis County",3,68,11527,5271,6256
050,29,189,"Missouri","St. Louis County",3,69,11163,5035,6128
050,29,189,"Missouri","St. Louis County",3,70,10502,4677,5825
050,29,189,"Missouri","St. Louis County",3,71,9889,4340,5549
050,29,189,"Missouri","St. Louis County",3,72,9700,4319,5381
050,29,189,"Missouri","St. Louis County",3,73,9379,4107,5272
050,29,189,"Missouri","St. Louis County",3,74,9971,4403,5568
050,29,189,"Missouri","St. Louis County",3,75,6968,2992,3976
050,29,189,"Missouri","St. Louis County",3,76,6569,2818,3751
050,29,189,"Missouri","St. Louis County",3,77,6415,2766,3649
050,29,189,"Missouri","St. Louis County",3,78,6578,2819,3759
050,29,189,"Missouri","St. Louis County",3,79,5576,2332,3244
050,29,189,"Missouri","St. Louis County",3,80,4966,2048,2918
050,29,189,"Missouri","St. Louis County",3,81,4427,1794,2633
050,29,189,"Missouri","St. Louis County",3,82,4178,1685,2493
050,29,189,"Missouri","St. Louis County",3,83,3977,1569,2408
050,29,189,"Missouri","St. Louis County",3,84,3502,1352,2150
050,29,189,"Missouri","St. Louis County",3,85,22626,7587,15039
050,29,189,"Missouri","St. Louis County",4,0,10423,5333,5090
050,29,189,"Missouri","St. Louis County",4,1,10485,5430,5055
050,29,189,"Missouri","St. Louis County",4,2,11160,5694,5466
050,29,189,"Missouri","St. Louis County",4,3,11533,5901,5632
050,29,189,"Missouri","St. Louis County",4,4,11738,6028,5710
050,29,189,"Missouri","St. Louis County",4,5,11972,6154,5818
050,29,189,"Missouri","St. Louis County",4,6,12252,6250,6002
050,29,189,"Missouri","St. Louis County",4,7,12212,6222,5990
050,29,189,"Missouri","St. Louis County",4,8,12159,6239,5920
050,29,189,"Missouri","St. Louis County",4,9,12033,6175,5858
050,29,189,"Missouri","St. Louis County",4,10,12271,6359,5912
050,29,189,"Missouri","St. Louis County",4,11,12369,6489,5880
050,29,189,"Missouri","St. Louis County",4,12,12322,6339,5983
050,29,189,"Missouri","St. Louis County",4,13,12677,6486,6191
050,29,189,"Missouri","St. Louis County",4,14,13136,6625,6511
050,29,189,"Missouri","St. Louis County",4,15,13205,6697,6508
050,29,189,"Missouri","St. Louis County",4,16,13109,6680,6429
050,29,189,"Missouri","St. Louis County",4,17,13031,6583,6448
050,29,189,"Missouri","St. Louis County",4,18,12400,6337,6063
050,29,189,"Missouri","St. Louis County",4,19,11659,5933,5726
050,29,189,"Missouri","St. Louis County",4,20,11487,5775,5712
050,29,189,"Missouri","St. Louis County",4,21,11530,5749,5781
050,29,189,"Missouri","St. Louis County",4,22,11863,5747,6116
050,29,189,"Missouri","St. Louis County",4,23,11649,5731,5918
050,29,189,"Missouri","St. Louis County",4,24,11904,5844,6060
050,29,189,"Missouri","St. Louis County",4,25,12103,5920,6183
050,29,189,"Missouri","St. Louis County",4,26,12011,5935,6076
050,29,189,"Missouri","St. Louis County",4,27,12189,6003,6186
050,29,189,"Missouri","St. Louis County",4,28,12422,6263,6159
050,29,189,"Missouri","St. Louis County",4,29,12873,6369,6504
050,29,189,"Missouri","St. Louis County",4,30,13108,6357,6751
050,29,189,"Missouri","St. Louis County",4,31,13063,6365,6698
050,29,189,"Missouri","St. Louis County",4,32,12917,6213,6704
050,29,189,"Missouri","St. Louis County",4,33,12646,6012,6634
050,29,189,"Missouri","St. Louis County",4,34,12439,5941,6498
050,29,189,"Missouri","St. Louis County",4,35,12676,6140,6536
050,29,189,"Missouri","St. Louis County",4,36,13000,6343,6657
050,29,189,"Missouri","St. Louis County",4,37,13203,6441,6762
050,29,189,"Missouri","St. Louis County",4,38,12882,6271,6611
050,29,189,"Missouri","St. Louis County",4,39,13166,6404,6762
050,29,189,"Missouri","St. Louis County",4,40,13071,6346,6725
050,29,189,"Missouri","St. Louis County",4,41,12841,6236,6605
050,29,189,"Missouri","St. Louis County",4,42,12671,6038,6633
050,29,189,"Missouri","St. Louis County",4,43,12303,5929,6374
050,29,189,"Missouri","St. Louis County",4,44,11962,5727,6235
050,29,189,"Missouri","St. Louis County",4,45,11645,5566,6079
050,29,189,"Missouri","St. Louis County",4,46,11078,5185,5893
050,29,189,"Missouri","St. Louis County",4,47,11119,5249,5870
050,29,189,"Missouri","St. Louis County",4,48,10862,5139,5723
050,29,189,"Missouri","St. Louis County",4,49,10926,5125,5801
050,29,189,"Missouri","St. Louis County",4,50,11657,5527,6130
050,29,189,"Missouri","St. Louis County",4,51,12547,5970,6577
050,29,189,"Missouri","St. Louis County",4,52,12298,5830,6468
050,29,189,"Missouri","St. Louis County",4,53,11800,5634,6166
050,29,189,"Missouri","St. Louis County",4,54,11578,5541,6037
050,29,189,"Missouri","St. Louis County",4,55,11762,5622,6140
050,29,189,"Missouri","St. Louis County",4,56,12133,5730,6403
050,29,189,"Missouri","St. Louis County",4,57,12920,6059,6861
050,29,189,"Missouri","St. Louis County",4,58,13178,6144,7034
050,29,189,"Missouri","St. Louis County",4,59,13420,6374,7046
050,29,189,"Missouri","St. Louis County",4,60,13699,6499,7200
050,29,189,"Missouri","St. Louis County",4,61,13803,6501,7302
050,29,189,"Missouri","St. Louis County",4,62,13766,6467,7299
050,29,189,"Missouri","St. Louis County",4,63,13566,6361,7205
050,29,189,"Missouri","St. Louis County",4,64,13564,6365,7199
050,29,189,"Missouri","St. Louis County",4,65,13320,6161,7159
050,29,189,"Missouri","St. Louis County",4,66,12648,5861,6787
050,29,189,"Missouri","St. Louis County",4,67,12263,5698,6565
050,29,189,"Missouri","St. Louis County",4,68,11862,5430,6432
050,29,189,"Missouri","St. Louis County",4,69,11251,5104,6147
050,29,189,"Missouri","St. Louis County",4,70,10827,4860,5967
050,29,189,"Missouri","St. Louis County",4,71,10289,4586,5703
050,29,189,"Missouri","St. Louis County",4,72,9552,4154,5398
050,29,189,"Missouri","St. Louis County",4,73,9495,4193,5302
050,29,189,"Missouri","St. Louis County",4,74,9018,3929,5089
050,29,189,"Missouri","St. Louis County",4,75,9614,4202,5412
050,29,189,"Missouri","St. Louis County",4,76,6714,2831,3883
050,29,189,"Missouri","St. Louis County",4,77,6342,2696,3646
050,29,189,"Missouri","St. Louis County",4,78,6146,2634,3512
050,29,189,"Missouri","St. Louis County",4,79,6233,2623,3610
050,29,189,"Missouri","St. Louis County",4,80,5303,2202,3101
050,29,189,"Missouri","St. Louis County",4,81,4723,1935,2788
050,29,189,"Missouri","St. Louis County",4,82,4092,1628,2464
050,29,189,"Missouri","St. Louis County",4,83,3911,1588,2323
050,29,189,"Missouri","St. Louis County",4,84,3682,1417,2265
050,29,189,"Missouri","St. Louis County",4,85,22060,7383,14677
050,29,189,"Missouri","St. Louis County",5,0,10015,5133,4882
050,29,189,"Missouri","St. Louis County",5,1,10525,5358,5167
050,29,189,"Missouri","St. Louis County",5,2,10588,5464,5124
050,29,189,"Missouri","St. Louis County",5,3,11311,5769,5542
050,29,189,"Missouri","St. Louis County",5,4,11650,5954,5696
050,29,189,"Missouri","St. Louis County",5,5,11753,6049,5704
050,29,189,"Missouri","St. Louis County",5,6,11899,6118,5781
050,29,189,"Missouri","St. Louis County",5,7,12214,6257,5957
050,29,189,"Missouri","St. Louis County",5,8,12181,6191,5990
050,29,189,"Missouri","St. Louis County",5,9,12164,6247,5917
050,29,189,"Missouri","St. Louis County",5,10,11946,6098,5848
050,29,189,"Missouri","St. Louis County",5,11,12250,6357,5893
050,29,189,"Missouri","St. Louis County",5,12,12405,6481,5924
050,29,189,"Missouri","St. Louis County",5,13,12336,6363,5973
050,29,189,"Missouri","St. Louis County",5,14,12696,6495,6201
050,29,189,"Missouri","St. Louis County",5,15,13108,6637,6471
050,29,189,"Missouri","St. Louis County",5,16,13216,6734,6482
050,29,189,"Missouri","St. Louis County",5,17,12987,6610,6377
050,29,189,"Missouri","St. Louis County",5,18,12175,6209,5966
050,29,189,"Missouri","St. Louis County",5,19,11739,5916,5823
050,29,189,"Missouri","St. Louis County",5,20,11553,5823,5730
050,29,189,"Missouri","St. Louis County",5,21,11248,5616,5632
050,29,189,"Missouri","St. Louis County",5,22,11753,5752,6001
050,29,189,"Missouri","St. Louis County",5,23,11978,5839,6139
050,29,189,"Missouri","St. Louis County",5,24,11705,5772,5933
050,29,189,"Missouri","St. Louis County",5,25,11805,5818,5987
050,29,189,"Missouri","St. Louis County",5,26,12067,5951,6116
050,29,189,"Missouri","St. Louis County",5,27,11871,5870,6001
050,29,189,"Missouri","St. Louis County",5,28,11915,5900,6015
050,29,189,"Missouri","St. Louis County",5,29,12445,6224,6221
050,29,189,"Missouri","St. Louis County",5,30,12833,6321,6512
050,29,189,"Missouri","St. Louis County",5,31,12960,6258,6702
050,29,189,"Missouri","St. Louis County",5,32,13126,6357,6769
050,29,189,"Missouri","St. Louis County",5,33,13029,6238,6791
050,29,189,"Missouri","St. Louis County",5,34,12753,6086,6667
050,29,189,"Missouri","St. Louis County",5,35,12411,5903,6508
050,29,189,"Missouri","St. Louis County",5,36,12767,6214,6553
050,29,189,"Missouri","St. Louis County",5,37,13038,6307,6731
050,29,189,"Missouri","St. Louis County",5,38,13118,6353,6765
050,29,189,"Missouri","St. Louis County",5,39,12742,6220,6522
050,29,189,"Missouri","St. Louis County",5,40,13171,6353,6818
050,29,189,"Missouri","St. Louis County",5,41,13006,6297,6709
050,29,189,"Missouri","St. Louis County",5,42,12724,6171,6553
050,29,189,"Missouri","St. Louis County",5,43,12632,6041,6591
050,29,189,"Missouri","St. Louis County",5,44,12318,5909,6409
050,29,189,"Missouri","St. Louis County",5,45,11875,5684,6191
050,29,189,"Missouri","St. Louis County",5,46,11645,5578,6067
050,29,189,"Missouri","St. Louis County",5,47,11019,5133,5886
050,29,189,"Missouri","St. Louis County",5,48,11060,5250,5810
050,29,189,"Missouri","St. Louis County",5,49,10737,5077,5660
050,29,189,"Missouri","St. Louis County",5,50,10810,5083,5727
050,29,189,"Missouri","St. Louis County",5,51,11546,5469,6077
050,29,189,"Missouri","St. Louis County",5,52,12360,5872,6488
050,29,189,"Missouri","St. Louis County",5,53,12173,5792,6381
050,29,189,"Missouri","St. Louis County",5,54,11691,5598,6093
050,29,189,"Missouri","St. Louis County",5,55,11446,5478,5968
050,29,189,"Missouri","St. Louis County",5,56,11667,5529,6138
050,29,189,"Missouri","St. Louis County",5,57,11972,5659,6313
050,29,189,"Missouri","St. Louis County",5,58,12703,5958,6745
050,29,189,"Missouri","St. Louis County",5,59,12989,6045,6944
050,29,189,"Missouri","St. Louis County",5,60,13229,6285,6944
050,29,189,"Missouri","St. Louis County",5,61,13447,6365,7082
050,29,189,"Missouri","St. Louis County",5,62,13574,6388,7186
050,29,189,"Missouri","St. Louis County",5,63,13501,6314,7187
050,29,189,"Missouri","St. Louis County",5,64,13345,6246,7099
050,29,189,"Missouri","St. Louis County",5,65,13299,6227,7072
050,29,189,"Missouri","St. Louis County",5,66,13069,6000,7069
050,29,189,"Missouri","St. Louis County",5,67,12392,5705,6687
050,29,189,"Missouri","St. Louis County",5,68,12030,5592,6438
050,29,189,"Missouri","St. Louis County",5,69,11595,5268,6327
050,29,189,"Missouri","St. Louis County",5,70,10940,4955,5985
050,29,189,"Missouri","St. Louis County",5,71,10615,4754,5861
050,29,189,"Missouri","St. Louis County",5,72,10011,4449,5562
050,29,189,"Missouri","St. Louis County",5,73,9377,4025,5352
050,29,189,"Missouri","St. Louis County",5,74,9209,4038,5171
050,29,189,"Missouri","St. Louis County",5,75,8748,3761,4987
050,29,189,"Missouri","St. Louis County",5,76,9349,4040,5309
050,29,189,"Missouri","St. Louis County",5,77,6498,2723,3775
050,29,189,"Missouri","St. Louis County",5,78,6110,2604,3506
050,29,189,"Missouri","St. Louis County",5,79,5882,2477,3405
050,29,189,"Missouri","St. Louis County",5,80,5958,2483,3475
050,29,189,"Missouri","St. Louis County",5,81,5055,2087,2968
050,29,189,"Missouri","St. Louis County",5,82,4459,1800,2659
050,29,189,"Missouri","St. Louis County",5,83,3855,1548,2307
050,29,189,"Missouri","St. Louis County",5,84,3667,1454,2213
050,29,189,"Missouri","St. Louis County",5,85,22026,7420,14606
050,29,195,"Missouri","Saline County",1,0,251,130,121
050,29,195,"Missouri","Saline County",1,1,253,135,118
050,29,195,"Missouri","Saline County",1,2,242,132,110
050,29,195,"Missouri","Saline County",1,3,232,123,109
050,29,195,"Missouri","Saline County",1,4,267,124,143
050,29,195,"Missouri","Saline County",1,5,295,150,145
050,29,195,"Missouri","Saline County",1,6,299,154,145
050,29,195,"Missouri","Saline County",1,7,275,152,123
050,29,195,"Missouri","Saline County",1,8,294,146,148
050,29,195,"Missouri","Saline County",1,9,297,138,159
050,29,195,"Missouri","Saline County",1,10,306,146,160
050,29,195,"Missouri","Saline County",1,11,313,164,149
050,29,195,"Missouri","Saline County",1,12,300,161,139
050,29,195,"Missouri","Saline County",1,13,298,157,141
050,29,195,"Missouri","Saline County",1,14,280,140,140
050,29,195,"Missouri","Saline County",1,15,286,147,139
050,29,195,"Missouri","Saline County",1,16,294,165,129
050,29,195,"Missouri","Saline County",1,17,312,163,149
050,29,195,"Missouri","Saline County",1,18,482,245,237
050,29,195,"Missouri","Saline County",1,19,794,495,299
050,29,195,"Missouri","Saline County",1,20,529,276,253
050,29,195,"Missouri","Saline County",1,21,533,294,239
050,29,195,"Missouri","Saline County",1,22,460,294,166
050,29,195,"Missouri","Saline County",1,23,361,210,151
050,29,195,"Missouri","Saline County",1,24,261,132,129
050,29,195,"Missouri","Saline County",1,25,244,121,123
050,29,195,"Missouri","Saline County",1,26,243,125,118
050,29,195,"Missouri","Saline County",1,27,289,160,129
050,29,195,"Missouri","Saline County",1,28,284,150,134
050,29,195,"Missouri","Saline County",1,29,264,121,143
050,29,195,"Missouri","Saline County",1,30,238,118,120
050,29,195,"Missouri","Saline County",1,31,260,125,135
050,29,195,"Missouri","Saline County",1,32,271,129,142
050,29,195,"Missouri","Saline County",1,33,269,141,128
050,29,195,"Missouri","Saline County",1,34,251,129,122
050,29,195,"Missouri","Saline County",1,35,253,126,127
050,29,195,"Missouri","Saline County",1,36,248,119,129
050,29,195,"Missouri","Saline County",1,37,274,127,147
050,29,195,"Missouri","Saline County",1,38,275,139,136
050,29,195,"Missouri","Saline County",1,39,261,140,121
050,29,195,"Missouri","Saline County",1,40,256,137,119
050,29,195,"Missouri","Saline County",1,41,257,138,119
050,29,195,"Missouri","Saline County",1,42,260,143,117
050,29,195,"Missouri","Saline County",1,43,249,131,118
050,29,195,"Missouri","Saline County",1,44,254,115,139
050,29,195,"Missouri","Saline County",1,45,253,122,131
050,29,195,"Missouri","Saline County",1,46,249,130,119
050,29,195,"Missouri","Saline County",1,47,235,121,114
050,29,195,"Missouri","Saline County",1,48,255,122,133
050,29,195,"Missouri","Saline County",1,49,264,137,127
050,29,195,"Missouri","Saline County",1,50,256,128,128
050,29,195,"Missouri","Saline County",1,51,262,130,132
050,29,195,"Missouri","Saline County",1,52,263,128,135
050,29,195,"Missouri","Saline County",1,53,263,138,125
050,29,195,"Missouri","Saline County",1,54,251,135,116
050,29,195,"Missouri","Saline County",1,55,294,156,138
050,29,195,"Missouri","Saline County",1,56,283,139,144
050,29,195,"Missouri","Saline County",1,57,315,164,151
050,29,195,"Missouri","Saline County",1,58,323,144,179
050,29,195,"Missouri","Saline County",1,59,305,141,164
050,29,195,"Missouri","Saline County",1,60,307,159,148
050,29,195,"Missouri","Saline County",1,61,309,144,165
050,29,195,"Missouri","Saline County",1,62,315,165,150
050,29,195,"Missouri","Saline County",1,63,295,141,154
050,29,195,"Missouri","Saline County",1,64,277,136,141
050,29,195,"Missouri","Saline County",1,65,266,139,127
050,29,195,"Missouri","Saline County",1,66,270,131,139
050,29,195,"Missouri","Saline County",1,67,262,124,138
050,29,195,"Missouri","Saline County",1,68,234,122,112
050,29,195,"Missouri","Saline County",1,69,227,122,105
050,29,195,"Missouri","Saline County",1,70,224,116,108
050,29,195,"Missouri","Saline County",1,71,205,106,99
050,29,195,"Missouri","Saline County",1,72,207,97,110
050,29,195,"Missouri","Saline County",1,73,229,107,122
050,29,195,"Missouri","Saline County",1,74,165,80,85
050,29,195,"Missouri","Saline County",1,75,161,79,82
050,29,195,"Missouri","Saline County",1,76,163,67,96
050,29,195,"Missouri","Saline County",1,77,157,59,98
050,29,195,"Missouri","Saline County",1,78,129,56,73
050,29,195,"Missouri","Saline County",1,79,128,60,68
050,29,195,"Missouri","Saline County",1,80,129,53,76
050,29,195,"Missouri","Saline County",1,81,115,42,73
050,29,195,"Missouri","Saline County",1,82,100,44,56
050,29,195,"Missouri","Saline County",1,83,93,40,53
050,29,195,"Missouri","Saline County",1,84,80,34,46
050,29,195,"Missouri","Saline County",1,85,495,162,333
050,29,195,"Missouri","Saline County",2,0,253,126,127
050,29,195,"Missouri","Saline County",2,1,256,134,122
050,29,195,"Missouri","Saline County",2,2,244,132,112
050,29,195,"Missouri","Saline County",2,3,231,123,108
050,29,195,"Missouri","Saline County",2,4,257,123,134
050,29,195,"Missouri","Saline County",2,5,290,146,144
050,29,195,"Missouri","Saline County",2,6,299,154,145
050,29,195,"Missouri","Saline County",2,7,282,152,130
050,29,195,"Missouri","Saline County",2,8,290,147,143
050,29,195,"Missouri","Saline County",2,9,298,141,157
050,29,195,"Missouri","Saline County",2,10,303,145,158
050,29,195,"Missouri","Saline County",2,11,309,159,150
050,29,195,"Missouri","Saline County",2,12,305,163,142
050,29,195,"Missouri","Saline County",2,13,295,155,140
050,29,195,"Missouri","Saline County",2,14,282,144,138
050,29,195,"Missouri","Saline County",2,15,287,147,140
050,29,195,"Missouri","Saline County",2,16,294,162,132
050,29,195,"Missouri","Saline County",2,17,308,161,147
050,29,195,"Missouri","Saline County",2,18,476,242,234
050,29,195,"Missouri","Saline County",2,19,795,492,303
050,29,195,"Missouri","Saline County",2,20,526,274,252
050,29,195,"Missouri","Saline County",2,21,539,301,238
050,29,195,"Missouri","Saline County",2,22,466,295,171
050,29,195,"Missouri","Saline County",2,23,358,210,148
050,29,195,"Missouri","Saline County",2,24,258,134,124
050,29,195,"Missouri","Saline County",2,25,244,120,124
050,29,195,"Missouri","Saline County",2,26,244,124,120
050,29,195,"Missouri","Saline County",2,27,275,149,126
050,29,195,"Missouri","Saline County",2,28,287,154,133
050,29,195,"Missouri","Saline County",2,29,268,125,143
050,29,195,"Missouri","Saline County",2,30,245,120,125
050,29,195,"Missouri","Saline County",2,31,254,121,133
050,29,195,"Missouri","Saline County",2,32,266,127,139
050,29,195,"Missouri","Saline County",2,33,270,139,131
050,29,195,"Missouri","Saline County",2,34,254,129,125
050,29,195,"Missouri","Saline County",2,35,255,128,127
050,29,195,"Missouri","Saline County",2,36,247,119,128
050,29,195,"Missouri","Saline County",2,37,264,123,141
050,29,195,"Missouri","Saline County",2,38,280,139,141
050,29,195,"Missouri","Saline County",2,39,262,140,122
050,29,195,"Missouri","Saline County",2,40,259,139,120
050,29,195,"Missouri","Saline County",2,41,255,137,118
050,29,195,"Missouri","Saline County",2,42,253,139,114
050,29,195,"Missouri","Saline County",2,43,254,135,119
050,29,195,"Missouri","Saline County",2,44,250,116,134
050,29,195,"Missouri","Saline County",2,45,257,124,133
050,29,195,"Missouri","Saline County",2,46,251,128,123
050,29,195,"Missouri","Saline County",2,47,238,125,113
050,29,195,"Missouri","Saline County",2,48,252,122,130
050,29,195,"Missouri","Saline County",2,49,264,136,128
050,29,195,"Missouri","Saline County",2,50,260,131,129
050,29,195,"Missouri","Saline County",2,51,264,132,132
050,29,195,"Missouri","Saline County",2,52,264,128,136
050,29,195,"Missouri","Saline County",2,53,264,135,129
050,29,195,"Missouri","Saline County",2,54,253,134,119
050,29,195,"Missouri","Saline County",2,55,286,152,134
050,29,195,"Missouri","Saline County",2,56,285,142,143
050,29,195,"Missouri","Saline County",2,57,307,159,148
050,29,195,"Missouri","Saline County",2,58,323,149,174
050,29,195,"Missouri","Saline County",2,59,310,142,168
050,29,195,"Missouri","Saline County",2,60,307,155,152
050,29,195,"Missouri","Saline County",2,61,308,147,161
050,29,195,"Missouri","Saline County",2,62,314,161,153
050,29,195,"Missouri","Saline County",2,63,302,146,156
050,29,195,"Missouri","Saline County",2,64,278,136,142
050,29,195,"Missouri","Saline County",2,65,270,139,131
050,29,195,"Missouri","Saline County",2,66,268,132,136
050,29,195,"Missouri","Saline County",2,67,263,125,138
050,29,195,"Missouri","Saline County",2,68,238,121,117
050,29,195,"Missouri","Saline County",2,69,229,122,107
050,29,195,"Missouri","Saline County",2,70,220,114,106
050,29,195,"Missouri","Saline County",2,71,208,108,100
050,29,195,"Missouri","Saline County",2,72,200,95,105
050,29,195,"Missouri","Saline County",2,73,232,108,124
050,29,195,"Missouri","Saline County",2,74,170,81,89
050,29,195,"Missouri","Saline County",2,75,162,80,82
050,29,195,"Missouri","Saline County",2,76,160,67,93
050,29,195,"Missouri","Saline County",2,77,159,61,98
050,29,195,"Missouri","Saline County",2,78,132,54,78
050,29,195,"Missouri","Saline County",2,79,126,57,69
050,29,195,"Missouri","Saline County",2,80,128,55,73
050,29,195,"Missouri","Saline County",2,81,117,44,73
050,29,195,"Missouri","Saline County",2,82,103,43,60
050,29,195,"Missouri","Saline County",2,83,93,41,52
050,29,195,"Missouri","Saline County",2,84,81,34,47
050,29,195,"Missouri","Saline County",2,85,498,165,333
050,29,195,"Missouri","Saline County",3,0,238,128,110
050,29,195,"Missouri","Saline County",3,1,258,126,132
050,29,195,"Missouri","Saline County",3,2,264,132,132
050,29,195,"Missouri","Saline County",3,3,240,131,109
050,29,195,"Missouri","Saline County",3,4,232,121,111
050,29,195,"Missouri","Saline County",3,5,261,129,132
050,29,195,"Missouri","Saline County",3,6,284,141,143
050,29,195,"Missouri","Saline County",3,7,298,150,148
050,29,195,"Missouri","Saline County",3,8,272,150,122
050,29,195,"Missouri","Saline County",3,9,296,150,146
050,29,195,"Missouri","Saline County",3,10,311,146,165
050,29,195,"Missouri","Saline County",3,11,295,138,157
050,29,195,"Missouri","Saline County",3,12,318,171,147
050,29,195,"Missouri","Saline County",3,13,303,159,144
050,29,195,"Missouri","Saline County",3,14,286,152,134
050,29,195,"Missouri","Saline County",3,15,289,147,142
050,29,195,"Missouri","Saline County",3,16,300,159,141
050,29,195,"Missouri","Saline County",3,17,292,155,137
050,29,195,"Missouri","Saline County",3,18,472,246,226
050,29,195,"Missouri","Saline County",3,19,798,485,313
050,29,195,"Missouri","Saline County",3,20,533,273,260
050,29,195,"Missouri","Saline County",3,21,543,317,226
050,29,195,"Missouri","Saline County",3,22,477,299,178
050,29,195,"Missouri","Saline County",3,23,361,218,143
050,29,195,"Missouri","Saline County",3,24,260,141,119
050,29,195,"Missouri","Saline County",3,25,257,122,135
050,29,195,"Missouri","Saline County",3,26,257,129,128
050,29,195,"Missouri","Saline County",3,27,235,116,119
050,29,195,"Missouri","Saline County",3,28,280,160,120
050,29,195,"Missouri","Saline County",3,29,277,147,130
050,29,195,"Missouri","Saline County",3,30,255,126,129
050,29,195,"Missouri","Saline County",3,31,241,116,125
050,29,195,"Missouri","Saline County",3,32,250,118,132
050,29,195,"Missouri","Saline County",3,33,267,127,140
050,29,195,"Missouri","Saline County",3,34,256,127,129
050,29,195,"Missouri","Saline County",3,35,259,129,130
050,29,195,"Missouri","Saline County",3,36,256,121,135
050,29,195,"Missouri","Saline County",3,37,248,115,133
050,29,195,"Missouri","Saline County",3,38,271,131,140
050,29,195,"Missouri","Saline County",3,39,277,137,140
050,29,195,"Missouri","Saline County",3,40,264,142,122
050,29,195,"Missouri","Saline County",3,41,255,137,118
050,29,195,"Missouri","Saline County",3,42,255,140,115
050,29,195,"Missouri","Saline County",3,43,250,139,111
050,29,195,"Missouri","Saline County",3,44,250,129,121
050,29,195,"Missouri","Saline County",3,45,249,118,131
050,29,195,"Missouri","Saline County",3,46,255,122,133
050,29,195,"Missouri","Saline County",3,47,254,131,123
050,29,195,"Missouri","Saline County",3,48,245,133,112
050,29,195,"Missouri","Saline County",3,49,257,126,131
050,29,195,"Missouri","Saline County",3,50,259,132,127
050,29,195,"Missouri","Saline County",3,51,266,132,134
050,29,195,"Missouri","Saline County",3,52,248,125,123
050,29,195,"Missouri","Saline County",3,53,273,132,141
050,29,195,"Missouri","Saline County",3,54,263,135,128
050,29,195,"Missouri","Saline County",3,55,250,133,117
050,29,195,"Missouri","Saline County",3,56,276,147,129
050,29,195,"Missouri","Saline County",3,57,288,142,146
050,29,195,"Missouri","Saline County",3,58,307,159,148
050,29,195,"Missouri","Saline County",3,59,315,144,171
050,29,195,"Missouri","Saline County",3,60,301,137,164
050,29,195,"Missouri","Saline County",3,61,312,152,160
050,29,195,"Missouri","Saline County",3,62,306,149,157
050,29,195,"Missouri","Saline County",3,63,302,152,150
050,29,195,"Missouri","Saline County",3,64,293,144,149
050,29,195,"Missouri","Saline County",3,65,274,136,138
050,29,195,"Missouri","Saline County",3,66,266,140,126
050,29,195,"Missouri","Saline County",3,67,266,129,137
050,29,195,"Missouri","Saline County",3,68,257,122,135
050,29,195,"Missouri","Saline County",3,69,231,116,115
050,29,195,"Missouri","Saline County",3,70,222,118,104
050,29,195,"Missouri","Saline County",3,71,210,111,99
050,29,195,"Missouri","Saline County",3,72,202,102,100
050,29,195,"Missouri","Saline County",3,73,197,94,103
050,29,195,"Missouri","Saline County",3,74,225,106,119
050,29,195,"Missouri","Saline County",3,75,164,82,82
050,29,195,"Missouri","Saline County",3,76,149,73,76
050,29,195,"Missouri","Saline County",3,77,145,65,80
050,29,195,"Missouri","Saline County",3,78,160,60,100
050,29,195,"Missouri","Saline County",3,79,127,47,80
050,29,195,"Missouri","Saline County",3,80,114,48,66
050,29,195,"Missouri","Saline County",3,81,115,50,65
050,29,195,"Missouri","Saline County",3,82,115,43,72
050,29,195,"Missouri","Saline County",3,83,95,40,55
050,29,195,"Missouri","Saline County",3,84,89,35,54
050,29,195,"Missouri","Saline County",3,85,470,163,307
050,29,195,"Missouri","Saline County",4,0,240,117,123
050,29,195,"Missouri","Saline County",4,1,234,125,109
050,29,195,"Missouri","Saline County",4,2,265,134,131
050,29,195,"Missouri","Saline County",4,3,251,124,127
050,29,195,"Missouri","Saline County",4,4,239,133,106
050,29,195,"Missouri","Saline County",4,5,219,121,98
050,29,195,"Missouri","Saline County",4,6,254,124,130
050,29,195,"Missouri","Saline County",4,7,293,152,141
050,29,195,"Missouri","Saline County",4,8,296,148,148
050,29,195,"Missouri","Saline County",4,9,276,150,126
050,29,195,"Missouri","Saline County",4,10,285,147,138
050,29,195,"Missouri","Saline County",4,11,299,144,155
050,29,195,"Missouri","Saline County",4,12,303,139,164
050,29,195,"Missouri","Saline County",4,13,314,162,152
050,29,195,"Missouri","Saline County",4,14,294,160,134
050,29,195,"Missouri","Saline County",4,15,300,155,145
050,29,195,"Missouri","Saline County",4,16,288,150,138
050,29,195,"Missouri","Saline County",4,17,289,146,143
050,29,195,"Missouri","Saline County",4,18,457,240,217
050,29,195,"Missouri","Saline County",4,19,782,483,299
050,29,195,"Missouri","Saline County",4,20,510,262,248
050,29,195,"Missouri","Saline County",4,21,556,323,233
050,29,195,"Missouri","Saline County",4,22,484,307,177
050,29,195,"Missouri","Saline County",4,23,347,214,133
050,29,195,"Missouri","Saline County",4,24,273,148,125
050,29,195,"Missouri","Saline County",4,25,257,130,127
050,29,195,"Missouri","Saline County",4,26,248,131,117
050,29,195,"Missouri","Saline County",4,27,241,118,123
050,29,195,"Missouri","Saline County",4,28,243,124,119
050,29,195,"Missouri","Saline County",4,29,274,151,123
050,29,195,"Missouri","Saline County",4,30,271,140,131
050,29,195,"Missouri","Saline County",4,31,254,123,131
050,29,195,"Missouri","Saline County",4,32,239,117,122
050,29,195,"Missouri","Saline County",4,33,244,121,123
050,29,195,"Missouri","Saline County",4,34,249,120,129
050,29,195,"Missouri","Saline County",4,35,247,122,125
050,29,195,"Missouri","Saline County",4,36,256,128,128
050,29,195,"Missouri","Saline County",4,37,250,119,131
050,29,195,"Missouri","Saline County",4,38,243,112,131
050,29,195,"Missouri","Saline County",4,39,267,129,138
050,29,195,"Missouri","Saline County",4,40,277,136,141
050,29,195,"Missouri","Saline County",4,41,264,141,123
050,29,195,"Missouri","Saline County",4,42,253,138,115
050,29,195,"Missouri","Saline County",4,43,257,142,115
050,29,195,"Missouri","Saline County",4,44,245,132,113
050,29,195,"Missouri","Saline County",4,45,248,131,117
050,29,195,"Missouri","Saline County",4,46,246,119,127
050,29,195,"Missouri","Saline County",4,47,256,122,134
050,29,195,"Missouri","Saline County",4,48,266,139,127
050,29,195,"Missouri","Saline County",4,49,245,131,114
050,29,195,"Missouri","Saline County",4,50,257,121,136
050,29,195,"Missouri","Saline County",4,51,254,126,128
050,29,195,"Missouri","Saline County",4,52,267,134,133
050,29,195,"Missouri","Saline County",4,53,248,121,127
050,29,195,"Missouri","Saline County",4,54,277,142,135
050,29,195,"Missouri","Saline County",4,55,261,132,129
050,29,195,"Missouri","Saline County",4,56,246,130,116
050,29,195,"Missouri","Saline County",4,57,271,150,121
050,29,195,"Missouri","Saline County",4,58,287,140,147
050,29,195,"Missouri","Saline County",4,59,290,149,141
050,29,195,"Missouri","Saline County",4,60,300,137,163
050,29,195,"Missouri","Saline County",4,61,305,136,169
050,29,195,"Missouri","Saline County",4,62,306,151,155
050,29,195,"Missouri","Saline County",4,63,296,144,152
050,29,195,"Missouri","Saline County",4,64,303,154,149
050,29,195,"Missouri","Saline County",4,65,283,139,144
050,29,195,"Missouri","Saline County",4,66,269,137,132
050,29,195,"Missouri","Saline County",4,67,261,134,127
050,29,195,"Missouri","Saline County",4,68,258,124,134
050,29,195,"Missouri","Saline County",4,69,250,116,134
050,29,195,"Missouri","Saline County",4,70,219,104,115
050,29,195,"Missouri","Saline County",4,71,223,119,104
050,29,195,"Missouri","Saline County",4,72,202,105,97
050,29,195,"Missouri","Saline County",4,73,195,99,96
050,29,195,"Missouri","Saline County",4,74,193,90,103
050,29,195,"Missouri","Saline County",4,75,221,106,115
050,29,195,"Missouri","Saline County",4,76,159,79,80
050,29,195,"Missouri","Saline County",4,77,138,68,70
050,29,195,"Missouri","Saline County",4,78,133,59,74
050,29,195,"Missouri","Saline County",4,79,155,56,99
050,29,195,"Missouri","Saline County",4,80,118,41,77
050,29,195,"Missouri","Saline County",4,81,106,40,66
050,29,195,"Missouri","Saline County",4,82,110,49,61
050,29,195,"Missouri","Saline County",4,83,109,41,68
050,29,195,"Missouri","Saline County",4,84,94,35,59
050,29,195,"Missouri","Saline County",4,85,451,159,292
050,29,195,"Missouri","Saline County",5,0,239,116,123
050,29,195,"Missouri","Saline County",5,1,241,124,117
050,29,195,"Missouri","Saline County",5,2,244,128,116
050,29,195,"Missouri","Saline County",5,3,273,145,128
050,29,195,"Missouri","Saline County",5,4,261,126,135
050,29,195,"Missouri","Saline County",5,5,246,135,111
050,29,195,"Missouri","Saline County",5,6,235,129,106
050,29,195,"Missouri","Saline County",5,7,261,129,132
050,29,195,"Missouri","Saline County",5,8,297,148,149
050,29,195,"Missouri","Saline County",5,9,306,150,156
050,29,195,"Missouri","Saline County",5,10,278,148,130
050,29,195,"Missouri","Saline County",5,11,294,156,138
050,29,195,"Missouri","Saline County",5,12,314,159,155
050,29,195,"Missouri","Saline County",5,13,302,137,165
050,29,195,"Missouri","Saline County",5,14,313,165,148
050,29,195,"Missouri","Saline County",5,15,297,159,138
050,29,195,"Missouri","Saline County",5,16,293,154,139
050,29,195,"Missouri","Saline County",5,17,278,139,139
050,29,195,"Missouri","Saline County",5,18,447,229,218
050,29,195,"Missouri","Saline County",5,19,786,486,300
050,29,195,"Missouri","Saline County",5,20,507,262,245
050,29,195,"Missouri","Saline County",5,21,555,313,242
050,29,195,"Missouri","Saline County",5,22,482,311,171
050,29,195,"Missouri","Saline County",5,23,382,221,161
050,29,195,"Missouri","Saline County",5,24,267,145,122
050,29,195,"Missouri","Saline County",5,25,284,146,138
050,29,195,"Missouri","Saline County",5,26,265,138,127
050,29,195,"Missouri","Saline County",5,27,245,132,113
050,29,195,"Missouri","Saline County",5,28,257,134,123
050,29,195,"Missouri","Saline County",5,29,237,115,122
050,29,195,"Missouri","Saline County",5,30,279,155,124
050,29,195,"Missouri","Saline County",5,31,266,136,130
050,29,195,"Missouri","Saline County",5,32,248,119,129
050,29,195,"Missouri","Saline County",5,33,256,126,130
050,29,195,"Missouri","Saline County",5,34,237,110,127
050,29,195,"Missouri","Saline County",5,35,250,125,125
050,29,195,"Missouri","Saline County",5,36,243,118,125
050,29,195,"Missouri","Saline County",5,37,253,127,126
050,29,195,"Missouri","Saline County",5,38,241,113,128
050,29,195,"Missouri","Saline County",5,39,242,110,132
050,29,195,"Missouri","Saline County",5,40,274,134,140
050,29,195,"Missouri","Saline County",5,41,279,134,145
050,29,195,"Missouri","Saline County",5,42,272,143,129
050,29,195,"Missouri","Saline County",5,43,255,143,112
050,29,195,"Missouri","Saline County",5,44,253,134,119
050,29,195,"Missouri","Saline County",5,45,244,130,114
050,29,195,"Missouri","Saline County",5,46,248,133,115
050,29,195,"Missouri","Saline County",5,47,241,120,121
050,29,195,"Missouri","Saline County",5,48,256,124,132
050,29,195,"Missouri","Saline County",5,49,267,140,127
050,29,195,"Missouri","Saline County",5,50,234,127,107
050,29,195,"Missouri","Saline County",5,51,262,118,144
050,29,195,"Missouri","Saline County",5,52,249,122,127
050,29,195,"Missouri","Saline County",5,53,271,138,133
050,29,195,"Missouri","Saline County",5,54,239,115,124
050,29,195,"Missouri","Saline County",5,55,281,141,140
050,29,195,"Missouri","Saline County",5,56,252,127,125
050,29,195,"Missouri","Saline County",5,57,248,134,114
050,29,195,"Missouri","Saline County",5,58,265,149,116
050,29,195,"Missouri","Saline County",5,59,288,143,145
050,29,195,"Missouri","Saline County",5,60,280,145,135
050,29,195,"Missouri","Saline County",5,61,297,132,165
050,29,195,"Missouri","Saline County",5,62,302,142,160
050,29,195,"Missouri","Saline County",5,63,298,147,151
050,29,195,"Missouri","Saline County",5,64,291,140,151
050,29,195,"Missouri","Saline County",5,65,295,148,147
050,29,195,"Missouri","Saline County",5,66,278,135,143
050,29,195,"Missouri","Saline County",5,67,264,135,129
050,29,195,"Missouri","Saline County",5,68,244,124,120
050,29,195,"Missouri","Saline County",5,69,254,119,135
050,29,195,"Missouri","Saline County",5,70,244,110,134
050,29,195,"Missouri","Saline County",5,71,211,104,107
050,29,195,"Missouri","Saline County",5,72,212,108,104
050,29,195,"Missouri","Saline County",5,73,195,100,95
050,29,195,"Missouri","Saline County",5,74,186,92,94
050,29,195,"Missouri","Saline County",5,75,187,92,95
050,29,195,"Missouri","Saline County",5,76,211,96,115
050,29,195,"Missouri","Saline County",5,77,147,79,68
050,29,195,"Missouri","Saline County",5,78,126,61,65
050,29,195,"Missouri","Saline County",5,79,129,52,77
050,29,195,"Missouri","Saline County",5,80,146,49,97
050,29,195,"Missouri","Saline County",5,81,103,31,72
050,29,195,"Missouri","Saline County",5,82,103,37,66
050,29,195,"Missouri","Saline County",5,83,106,47,59
050,29,195,"Missouri","Saline County",5,84,108,37,71
050,29,195,"Missouri","Saline County",5,85,453,163,290
050,29,197,"Missouri","Schuyler County",1,0,58,31,27
050,29,197,"Missouri","Schuyler County",1,1,60,37,23
050,29,197,"Missouri","Schuyler County",1,2,71,36,35
050,29,197,"Missouri","Schuyler County",1,3,74,38,36
050,29,197,"Missouri","Schuyler County",1,4,62,31,31
050,29,197,"Missouri","Schuyler County",1,5,55,29,26
050,29,197,"Missouri","Schuyler County",1,6,57,31,26
050,29,197,"Missouri","Schuyler County",1,7,57,34,23
050,29,197,"Missouri","Schuyler County",1,8,58,33,25
050,29,197,"Missouri","Schuyler County",1,9,57,25,32
050,29,197,"Missouri","Schuyler County",1,10,52,24,28
050,29,197,"Missouri","Schuyler County",1,11,47,21,26
050,29,197,"Missouri","Schuyler County",1,12,61,33,28
050,29,197,"Missouri","Schuyler County",1,13,65,33,32
050,29,197,"Missouri","Schuyler County",1,14,65,31,34
050,29,197,"Missouri","Schuyler County",1,15,48,21,27
050,29,197,"Missouri","Schuyler County",1,16,40,16,24
050,29,197,"Missouri","Schuyler County",1,17,51,26,25
050,29,197,"Missouri","Schuyler County",1,18,49,27,22
050,29,197,"Missouri","Schuyler County",1,19,42,25,17
050,29,197,"Missouri","Schuyler County",1,20,42,20,22
050,29,197,"Missouri","Schuyler County",1,21,42,19,23
050,29,197,"Missouri","Schuyler County",1,22,45,22,23
050,29,197,"Missouri","Schuyler County",1,23,50,22,28
050,29,197,"Missouri","Schuyler County",1,24,46,24,22
050,29,197,"Missouri","Schuyler County",1,25,58,26,32
050,29,197,"Missouri","Schuyler County",1,26,50,25,25
050,29,197,"Missouri","Schuyler County",1,27,52,27,25
050,29,197,"Missouri","Schuyler County",1,28,58,32,26
050,29,197,"Missouri","Schuyler County",1,29,52,27,25
050,29,197,"Missouri","Schuyler County",1,30,47,24,23
050,29,197,"Missouri","Schuyler County",1,31,53,27,26
050,29,197,"Missouri","Schuyler County",1,32,46,23,23
050,29,197,"Missouri","Schuyler County",1,33,37,27,10
050,29,197,"Missouri","Schuyler County",1,34,41,24,17
050,29,197,"Missouri","Schuyler County",1,35,34,15,19
050,29,197,"Missouri","Schuyler County",1,36,35,18,17
050,29,197,"Missouri","Schuyler County",1,37,36,21,15
050,29,197,"Missouri","Schuyler County",1,38,40,20,20
050,29,197,"Missouri","Schuyler County",1,39,43,21,22
050,29,197,"Missouri","Schuyler County",1,40,33,14,19
050,29,197,"Missouri","Schuyler County",1,41,43,18,25
050,29,197,"Missouri","Schuyler County",1,42,54,24,30
050,29,197,"Missouri","Schuyler County",1,43,40,17,23
050,29,197,"Missouri","Schuyler County",1,44,39,20,19
050,29,197,"Missouri","Schuyler County",1,45,38,21,17
050,29,197,"Missouri","Schuyler County",1,46,42,24,18
050,29,197,"Missouri","Schuyler County",1,47,40,21,19
050,29,197,"Missouri","Schuyler County",1,48,46,22,24
050,29,197,"Missouri","Schuyler County",1,49,48,24,24
050,29,197,"Missouri","Schuyler County",1,50,51,24,27
050,29,197,"Missouri","Schuyler County",1,51,39,18,21
050,29,197,"Missouri","Schuyler County",1,52,36,18,18
050,29,197,"Missouri","Schuyler County",1,53,49,24,25
050,29,197,"Missouri","Schuyler County",1,54,57,28,29
050,29,197,"Missouri","Schuyler County",1,55,55,29,26
050,29,197,"Missouri","Schuyler County",1,56,58,35,23
050,29,197,"Missouri","Schuyler County",1,57,45,25,20
050,29,197,"Missouri","Schuyler County",1,58,58,33,25
050,29,197,"Missouri","Schuyler County",1,59,62,34,28
050,29,197,"Missouri","Schuyler County",1,60,62,28,34
050,29,197,"Missouri","Schuyler County",1,61,59,28,31
050,29,197,"Missouri","Schuyler County",1,62,58,27,31
050,29,197,"Missouri","Schuyler County",1,63,62,29,33
050,29,197,"Missouri","Schuyler County",1,64,50,24,26
050,29,197,"Missouri","Schuyler County",1,65,40,20,20
050,29,197,"Missouri","Schuyler County",1,66,42,24,18
050,29,197,"Missouri","Schuyler County",1,67,42,24,18
050,29,197,"Missouri","Schuyler County",1,68,43,20,23
050,29,197,"Missouri","Schuyler County",1,69,53,28,25
050,29,197,"Missouri","Schuyler County",1,70,40,19,21
050,29,197,"Missouri","Schuyler County",1,71,34,17,17
050,29,197,"Missouri","Schuyler County",1,72,35,15,20
050,29,197,"Missouri","Schuyler County",1,73,44,22,22
050,29,197,"Missouri","Schuyler County",1,74,24,8,16
050,29,197,"Missouri","Schuyler County",1,75,30,13,17
050,29,197,"Missouri","Schuyler County",1,76,38,18,20
050,29,197,"Missouri","Schuyler County",1,77,37,18,19
050,29,197,"Missouri","Schuyler County",1,78,33,14,19
050,29,197,"Missouri","Schuyler County",1,79,30,12,18
050,29,197,"Missouri","Schuyler County",1,80,29,11,18
050,29,197,"Missouri","Schuyler County",1,81,24,11,13
050,29,197,"Missouri","Schuyler County",1,82,27,17,10
050,29,197,"Missouri","Schuyler County",1,83,16,8,8
050,29,197,"Missouri","Schuyler County",1,84,12,5,7
050,29,197,"Missouri","Schuyler County",1,85,96,33,63
050,29,197,"Missouri","Schuyler County",2,0,58,32,26
050,29,197,"Missouri","Schuyler County",2,1,60,35,25
050,29,197,"Missouri","Schuyler County",2,2,69,36,33
050,29,197,"Missouri","Schuyler County",2,3,71,37,34
050,29,197,"Missouri","Schuyler County",2,4,62,31,31
050,29,197,"Missouri","Schuyler County",2,5,55,29,26
050,29,197,"Missouri","Schuyler County",2,6,57,32,25
050,29,197,"Missouri","Schuyler County",2,7,57,34,23
050,29,197,"Missouri","Schuyler County",2,8,57,32,25
050,29,197,"Missouri","Schuyler County",2,9,56,27,29
050,29,197,"Missouri","Schuyler County",2,10,53,24,29
050,29,197,"Missouri","Schuyler County",2,11,48,22,26
050,29,197,"Missouri","Schuyler County",2,12,58,31,27
050,29,197,"Missouri","Schuyler County",2,13,63,32,31
050,29,197,"Missouri","Schuyler County",2,14,64,31,33
050,29,197,"Missouri","Schuyler County",2,15,51,22,29
050,29,197,"Missouri","Schuyler County",2,16,42,17,25
050,29,197,"Missouri","Schuyler County",2,17,49,24,25
050,29,197,"Missouri","Schuyler County",2,18,47,26,21
050,29,197,"Missouri","Schuyler County",2,19,39,23,16
050,29,197,"Missouri","Schuyler County",2,20,43,22,21
050,29,197,"Missouri","Schuyler County",2,21,43,19,24
050,29,197,"Missouri","Schuyler County",2,22,46,22,24
050,29,197,"Missouri","Schuyler County",2,23,48,21,27
050,29,197,"Missouri","Schuyler County",2,24,46,24,22
050,29,197,"Missouri","Schuyler County",2,25,54,25,29
050,29,197,"Missouri","Schuyler County",2,26,53,26,27
050,29,197,"Missouri","Schuyler County",2,27,52,27,25
050,29,197,"Missouri","Schuyler County",2,28,56,30,26
050,29,197,"Missouri","Schuyler County",2,29,52,27,25
050,29,197,"Missouri","Schuyler County",2,30,49,25,24
050,29,197,"Missouri","Schuyler County",2,31,50,26,24
050,29,197,"Missouri","Schuyler County",2,32,47,24,23
050,29,197,"Missouri","Schuyler County",2,33,39,26,13
050,29,197,"Missouri","Schuyler County",2,34,40,24,16
050,29,197,"Missouri","Schuyler County",2,35,36,17,19
050,29,197,"Missouri","Schuyler County",2,36,34,17,17
050,29,197,"Missouri","Schuyler County",2,37,36,20,16
050,29,197,"Missouri","Schuyler County",2,38,40,20,20
050,29,197,"Missouri","Schuyler County",2,39,42,20,22
050,29,197,"Missouri","Schuyler County",2,40,36,16,20
050,29,197,"Missouri","Schuyler County",2,41,39,17,22
050,29,197,"Missouri","Schuyler County",2,42,51,22,29
050,29,197,"Missouri","Schuyler County",2,43,43,19,24
050,29,197,"Missouri","Schuyler County",2,44,38,19,19
050,29,197,"Missouri","Schuyler County",2,45,38,21,17
050,29,197,"Missouri","Schuyler County",2,46,41,23,18
050,29,197,"Missouri","Schuyler County",2,47,40,22,18
050,29,197,"Missouri","Schuyler County",2,48,44,21,23
050,29,197,"Missouri","Schuyler County",2,49,50,25,25
050,29,197,"Missouri","Schuyler County",2,50,51,25,26
050,29,197,"Missouri","Schuyler County",2,51,41,19,22
050,29,197,"Missouri","Schuyler County",2,52,36,18,18
050,29,197,"Missouri","Schuyler County",2,53,46,23,23
050,29,197,"Missouri","Schuyler County",2,54,56,28,28
050,29,197,"Missouri","Schuyler County",2,55,55,29,26
050,29,197,"Missouri","Schuyler County",2,56,57,33,24
050,29,197,"Missouri","Schuyler County",2,57,48,27,21
050,29,197,"Missouri","Schuyler County",2,58,54,31,23
050,29,197,"Missouri","Schuyler County",2,59,61,34,27
050,29,197,"Missouri","Schuyler County",2,60,60,28,32
050,29,197,"Missouri","Schuyler County",2,61,58,28,30
050,29,197,"Missouri","Schuyler County",2,62,58,27,31
050,29,197,"Missouri","Schuyler County",2,63,62,29,33
050,29,197,"Missouri","Schuyler County",2,64,51,25,26
050,29,197,"Missouri","Schuyler County",2,65,43,21,22
050,29,197,"Missouri","Schuyler County",2,66,41,23,18
050,29,197,"Missouri","Schuyler County",2,67,42,24,18
050,29,197,"Missouri","Schuyler County",2,68,42,21,21
050,29,197,"Missouri","Schuyler County",2,69,51,26,25
050,29,197,"Missouri","Schuyler County",2,70,42,21,21
050,29,197,"Missouri","Schuyler County",2,71,35,17,18
050,29,197,"Missouri","Schuyler County",2,72,34,15,19
050,29,197,"Missouri","Schuyler County",2,73,44,21,23
050,29,197,"Missouri","Schuyler County",2,74,28,11,17
050,29,197,"Missouri","Schuyler County",2,75,27,12,15
050,29,197,"Missouri","Schuyler County",2,76,36,17,19
050,29,197,"Missouri","Schuyler County",2,77,38,18,20
050,29,197,"Missouri","Schuyler County",2,78,32,13,19
050,29,197,"Missouri","Schuyler County",2,79,31,13,18
050,29,197,"Missouri","Schuyler County",2,80,29,11,18
050,29,197,"Missouri","Schuyler County",2,81,25,11,14
050,29,197,"Missouri","Schuyler County",2,82,27,16,11
050,29,197,"Missouri","Schuyler County",2,83,17,9,8
050,29,197,"Missouri","Schuyler County",2,84,13,6,7
050,29,197,"Missouri","Schuyler County",2,85,93,31,62
050,29,197,"Missouri","Schuyler County",3,0,69,38,31
050,29,197,"Missouri","Schuyler County",3,1,50,27,23
050,29,197,"Missouri","Schuyler County",3,2,61,36,25
050,29,197,"Missouri","Schuyler County",3,3,67,38,29
050,29,197,"Missouri","Schuyler County",3,4,70,39,31
050,29,197,"Missouri","Schuyler County",3,5,65,34,31
050,29,197,"Missouri","Schuyler County",3,6,63,34,29
050,29,197,"Missouri","Schuyler County",3,7,58,33,25
050,29,197,"Missouri","Schuyler County",3,8,60,37,23
050,29,197,"Missouri","Schuyler County",3,9,57,31,26
050,29,197,"Missouri","Schuyler County",3,10,57,30,27
050,29,197,"Missouri","Schuyler County",3,11,56,26,30
050,29,197,"Missouri","Schuyler County",3,12,55,26,29
050,29,197,"Missouri","Schuyler County",3,13,64,35,29
050,29,197,"Missouri","Schuyler County",3,14,66,32,34
050,29,197,"Missouri","Schuyler County",3,15,62,30,32
050,29,197,"Missouri","Schuyler County",3,16,51,23,28
050,29,197,"Missouri","Schuyler County",3,17,39,14,25
050,29,197,"Missouri","Schuyler County",3,18,40,22,18
050,29,197,"Missouri","Schuyler County",3,19,39,24,15
050,29,197,"Missouri","Schuyler County",3,20,41,24,17
050,29,197,"Missouri","Schuyler County",3,21,44,24,20
050,29,197,"Missouri","Schuyler County",3,22,49,20,29
050,29,197,"Missouri","Schuyler County",3,23,46,23,23
050,29,197,"Missouri","Schuyler County",3,24,51,24,27
050,29,197,"Missouri","Schuyler County",3,25,50,28,22
050,29,197,"Missouri","Schuyler County",3,26,48,24,24
050,29,197,"Missouri","Schuyler County",3,27,44,23,21
050,29,197,"Missouri","Schuyler County",3,28,53,25,28
050,29,197,"Missouri","Schuyler County",3,29,50,25,25
050,29,197,"Missouri","Schuyler County",3,30,51,27,24
050,29,197,"Missouri","Schuyler County",3,31,44,22,22
050,29,197,"Missouri","Schuyler County",3,32,52,25,27
050,29,197,"Missouri","Schuyler County",3,33,52,27,25
050,29,197,"Missouri","Schuyler County",3,34,38,25,13
050,29,197,"Missouri","Schuyler County",3,35,37,21,16
050,29,197,"Missouri","Schuyler County",3,36,33,15,18
050,29,197,"Missouri","Schuyler County",3,37,35,20,15
050,29,197,"Missouri","Schuyler County",3,38,41,23,18
050,29,197,"Missouri","Schuyler County",3,39,46,23,23
050,29,197,"Missouri","Schuyler County",3,40,38,21,17
050,29,197,"Missouri","Schuyler County",3,41,37,17,20
050,29,197,"Missouri","Schuyler County",3,42,43,17,26
050,29,197,"Missouri","Schuyler County",3,43,47,21,26
050,29,197,"Missouri","Schuyler County",3,44,41,18,23
050,29,197,"Missouri","Schuyler County",3,45,37,19,18
050,29,197,"Missouri","Schuyler County",3,46,38,20,18
050,29,197,"Missouri","Schuyler County",3,47,41,23,18
050,29,197,"Missouri","Schuyler County",3,48,40,22,18
050,29,197,"Missouri","Schuyler County",3,49,44,21,23
050,29,197,"Missouri","Schuyler County",3,50,49,23,26
050,29,197,"Missouri","Schuyler County",3,51,50,24,26
050,29,197,"Missouri","Schuyler County",3,52,40,19,21
050,29,197,"Missouri","Schuyler County",3,53,36,18,18
050,29,197,"Missouri","Schuyler County",3,54,47,23,24
050,29,197,"Missouri","Schuyler County",3,55,55,29,26
050,29,197,"Missouri","Schuyler County",3,56,55,27,28
050,29,197,"Missouri","Schuyler County",3,57,58,33,25
050,29,197,"Missouri","Schuyler County",3,58,52,30,22
050,29,197,"Missouri","Schuyler County",3,59,52,29,23
050,29,197,"Missouri","Schuyler County",3,60,63,35,28
050,29,197,"Missouri","Schuyler County",3,61,57,28,29
050,29,197,"Missouri","Schuyler County",3,62,60,29,31
050,29,197,"Missouri","Schuyler County",3,63,56,26,30
050,29,197,"Missouri","Schuyler County",3,64,62,28,34
050,29,197,"Missouri","Schuyler County",3,65,48,23,25
050,29,197,"Missouri","Schuyler County",3,66,38,20,18
050,29,197,"Missouri","Schuyler County",3,67,39,23,16
050,29,197,"Missouri","Schuyler County",3,68,39,21,18
050,29,197,"Missouri","Schuyler County",3,69,40,19,21
050,29,197,"Missouri","Schuyler County",3,70,49,26,23
050,29,197,"Missouri","Schuyler County",3,71,39,18,21
050,29,197,"Missouri","Schuyler County",3,72,33,14,19
050,29,197,"Missouri","Schuyler County",3,73,36,17,19
050,29,197,"Missouri","Schuyler County",3,74,45,21,24
050,29,197,"Missouri","Schuyler County",3,75,24,7,17
050,29,197,"Missouri","Schuyler County",3,76,25,12,13
050,29,197,"Missouri","Schuyler County",3,77,36,17,19
050,29,197,"Missouri","Schuyler County",3,78,35,17,18
050,29,197,"Missouri","Schuyler County",3,79,32,14,18
050,29,197,"Missouri","Schuyler County",3,80,29,9,20
050,29,197,"Missouri","Schuyler County",3,81,28,11,17
050,29,197,"Missouri","Schuyler County",3,82,25,11,14
050,29,197,"Missouri","Schuyler County",3,83,24,15,9
050,29,197,"Missouri","Schuyler County",3,84,17,8,9
050,29,197,"Missouri","Schuyler County",3,85,82,34,48
050,29,197,"Missouri","Schuyler County",4,0,61,31,30
050,29,197,"Missouri","Schuyler County",4,1,61,30,31
050,29,197,"Missouri","Schuyler County",4,2,48,26,22
050,29,197,"Missouri","Schuyler County",4,3,66,39,27
050,29,197,"Missouri","Schuyler County",4,4,72,38,34
050,29,197,"Missouri","Schuyler County",4,5,72,38,34
050,29,197,"Missouri","Schuyler County",4,6,66,35,31
050,29,197,"Missouri","Schuyler County",4,7,55,30,25
050,29,197,"Missouri","Schuyler County",4,8,57,34,23
050,29,197,"Missouri","Schuyler County",4,9,57,35,22
050,29,197,"Missouri","Schuyler County",4,10,60,36,24
050,29,197,"Missouri","Schuyler County",4,11,57,28,29
050,29,197,"Missouri","Schuyler County",4,12,52,23,29
050,29,197,"Missouri","Schuyler County",4,13,52,24,28
050,29,197,"Missouri","Schuyler County",4,14,62,33,29
050,29,197,"Missouri","Schuyler County",4,15,66,31,35
050,29,197,"Missouri","Schuyler County",4,16,58,25,33
050,29,197,"Missouri","Schuyler County",4,17,49,23,26
050,29,197,"Missouri","Schuyler County",4,18,34,12,22
050,29,197,"Missouri","Schuyler County",4,19,25,14,11
050,29,197,"Missouri","Schuyler County",4,20,38,22,16
050,29,197,"Missouri","Schuyler County",4,21,46,26,20
050,29,197,"Missouri","Schuyler County",4,22,44,25,19
050,29,197,"Missouri","Schuyler County",4,23,54,21,33
050,29,197,"Missouri","Schuyler County",4,24,52,26,26
050,29,197,"Missouri","Schuyler County",4,25,56,26,30
050,29,197,"Missouri","Schuyler County",4,26,45,26,19
050,29,197,"Missouri","Schuyler County",4,27,54,22,32
050,29,197,"Missouri","Schuyler County",4,28,45,23,22
050,29,197,"Missouri","Schuyler County",4,29,45,22,23
050,29,197,"Missouri","Schuyler County",4,30,51,25,26
050,29,197,"Missouri","Schuyler County",4,31,46,22,24
050,29,197,"Missouri","Schuyler County",4,32,43,22,21
050,29,197,"Missouri","Schuyler County",4,33,51,26,25
050,29,197,"Missouri","Schuyler County",4,34,46,23,23
050,29,197,"Missouri","Schuyler County",4,35,39,25,14
050,29,197,"Missouri","Schuyler County",4,36,41,24,17
050,29,197,"Missouri","Schuyler County",4,37,32,13,19
050,29,197,"Missouri","Schuyler County",4,38,32,18,14
050,29,197,"Missouri","Schuyler County",4,39,42,23,19
050,29,197,"Missouri","Schuyler County",4,40,44,21,23
050,29,197,"Missouri","Schuyler County",4,41,38,21,17
050,29,197,"Missouri","Schuyler County",4,42,37,17,20
050,29,197,"Missouri","Schuyler County",4,43,42,17,25
050,29,197,"Missouri","Schuyler County",4,44,48,21,27
050,29,197,"Missouri","Schuyler County",4,45,45,19,26
050,29,197,"Missouri","Schuyler County",4,46,36,18,18
050,29,197,"Missouri","Schuyler County",4,47,38,19,19
050,29,197,"Missouri","Schuyler County",4,48,42,23,19
050,29,197,"Missouri","Schuyler County",4,49,41,23,18
050,29,197,"Missouri","Schuyler County",4,50,44,22,22
050,29,197,"Missouri","Schuyler County",4,51,48,23,25
050,29,197,"Missouri","Schuyler County",4,52,50,24,26
050,29,197,"Missouri","Schuyler County",4,53,41,19,22
050,29,197,"Missouri","Schuyler County",4,54,43,18,25
050,29,197,"Missouri","Schuyler County",4,55,46,24,22
050,29,197,"Missouri","Schuyler County",4,56,53,27,26
050,29,197,"Missouri","Schuyler County",4,57,58,27,31
050,29,197,"Missouri","Schuyler County",4,58,61,35,26
050,29,197,"Missouri","Schuyler County",4,59,50,27,23
050,29,197,"Missouri","Schuyler County",4,60,50,28,22
050,29,197,"Missouri","Schuyler County",4,61,63,35,28
050,29,197,"Missouri","Schuyler County",4,62,60,29,31
050,29,197,"Missouri","Schuyler County",4,63,60,30,30
050,29,197,"Missouri","Schuyler County",4,64,55,28,27
050,29,197,"Missouri","Schuyler County",4,65,58,26,32
050,29,197,"Missouri","Schuyler County",4,66,52,26,26
050,29,197,"Missouri","Schuyler County",4,67,39,21,18
050,29,197,"Missouri","Schuyler County",4,68,38,22,16
050,29,197,"Missouri","Schuyler County",4,69,37,20,17
050,29,197,"Missouri","Schuyler County",4,70,38,18,20
050,29,197,"Missouri","Schuyler County",4,71,46,24,22
050,29,197,"Missouri","Schuyler County",4,72,38,18,20
050,29,197,"Missouri","Schuyler County",4,73,32,13,19
050,29,197,"Missouri","Schuyler County",4,74,37,17,20
050,29,197,"Missouri","Schuyler County",4,75,41,19,22
050,29,197,"Missouri","Schuyler County",4,76,23,8,15
050,29,197,"Missouri","Schuyler County",4,77,22,10,12
050,29,197,"Missouri","Schuyler County",4,78,31,14,17
050,29,197,"Missouri","Schuyler County",4,79,33,17,16
050,29,197,"Missouri","Schuyler County",4,80,34,13,21
050,29,197,"Missouri","Schuyler County",4,81,29,10,19
050,29,197,"Missouri","Schuyler County",4,82,28,12,16
050,29,197,"Missouri","Schuyler County",4,83,16,7,9
050,29,197,"Missouri","Schuyler County",4,84,24,15,9
050,29,197,"Missouri","Schuyler County",4,85,79,37,42
050,29,197,"Missouri","Schuyler County",5,0,62,31,31
050,29,197,"Missouri","Schuyler County",5,1,62,32,30
050,29,197,"Missouri","Schuyler County",5,2,65,35,30
050,29,197,"Missouri","Schuyler County",5,3,48,27,21
050,29,197,"Missouri","Schuyler County",5,4,70,43,27
050,29,197,"Missouri","Schuyler County",5,5,63,36,27
050,29,197,"Missouri","Schuyler County",5,6,71,39,32
050,29,197,"Missouri","Schuyler County",5,7,67,36,31
050,29,197,"Missouri","Schuyler County",5,8,54,29,25
050,29,197,"Missouri","Schuyler County",5,9,57,32,25
050,29,197,"Missouri","Schuyler County",5,10,55,33,22
050,29,197,"Missouri","Schuyler County",5,11,65,39,26
050,29,197,"Missouri","Schuyler County",5,12,60,28,32
050,29,197,"Missouri","Schuyler County",5,13,53,21,32
050,29,197,"Missouri","Schuyler County",5,14,56,28,28
050,29,197,"Missouri","Schuyler County",5,15,68,36,32
050,29,197,"Missouri","Schuyler County",5,16,65,33,32
050,29,197,"Missouri","Schuyler County",5,17,61,26,35
050,29,197,"Missouri","Schuyler County",5,18,44,20,24
050,29,197,"Missouri","Schuyler County",5,19,28,10,18
050,29,197,"Missouri","Schuyler County",5,20,30,16,14
050,29,197,"Missouri","Schuyler County",5,21,37,21,16
050,29,197,"Missouri","Schuyler County",5,22,50,28,22
050,29,197,"Missouri","Schuyler County",5,23,49,28,21
050,29,197,"Missouri","Schuyler County",5,24,59,22,37
050,29,197,"Missouri","Schuyler County",5,25,46,24,22
050,29,197,"Missouri","Schuyler County",5,26,57,27,30
050,29,197,"Missouri","Schuyler County",5,27,50,25,25
050,29,197,"Missouri","Schuyler County",5,28,52,23,29
050,29,197,"Missouri","Schuyler County",5,29,48,26,22
050,29,197,"Missouri","Schuyler County",5,30,42,26,16
050,29,197,"Missouri","Schuyler County",5,31,41,18,23
050,29,197,"Missouri","Schuyler County",5,32,44,22,22
050,29,197,"Missouri","Schuyler County",5,33,41,22,19
050,29,197,"Missouri","Schuyler County",5,34,51,29,22
050,29,197,"Missouri","Schuyler County",5,35,44,22,22
050,29,197,"Missouri","Schuyler County",5,36,43,24,19
050,29,197,"Missouri","Schuyler County",5,37,40,22,18
050,29,197,"Missouri","Schuyler County",5,38,33,13,20
050,29,197,"Missouri","Schuyler County",5,39,35,19,16
050,29,197,"Missouri","Schuyler County",5,40,47,28,19
050,29,197,"Missouri","Schuyler County",5,41,47,24,23
050,29,197,"Missouri","Schuyler County",5,42,39,22,17
050,29,197,"Missouri","Schuyler County",5,43,47,22,25
050,29,197,"Missouri","Schuyler County",5,44,42,17,25
050,29,197,"Missouri","Schuyler County",5,45,49,21,28
050,29,197,"Missouri","Schuyler County",5,46,45,19,26
050,29,197,"Missouri","Schuyler County",5,47,43,24,19
050,29,197,"Missouri","Schuyler County",5,48,42,22,20
050,29,197,"Missouri","Schuyler County",5,49,41,23,18
050,29,197,"Missouri","Schuyler County",5,50,39,22,17
050,29,197,"Missouri","Schuyler County",5,51,46,22,24
050,29,197,"Missouri","Schuyler County",5,52,48,23,25
050,29,197,"Missouri","Schuyler County",5,53,51,24,27
050,29,197,"Missouri","Schuyler County",5,54,44,18,26
050,29,197,"Missouri","Schuyler County",5,55,45,19,26
050,29,197,"Missouri","Schuyler County",5,56,44,22,22
050,29,197,"Missouri","Schuyler County",5,57,57,30,27
050,29,197,"Missouri","Schuyler County",5,58,55,25,30
050,29,197,"Missouri","Schuyler County",5,59,59,34,25
050,29,197,"Missouri","Schuyler County",5,60,54,28,26
050,29,197,"Missouri","Schuyler County",5,61,54,29,25
050,29,197,"Missouri","Schuyler County",5,62,63,34,29
050,29,197,"Missouri","Schuyler County",5,63,58,28,30
050,29,197,"Missouri","Schuyler County",5,64,59,30,29
050,29,197,"Missouri","Schuyler County",5,65,52,27,25
050,29,197,"Missouri","Schuyler County",5,66,56,25,31
050,29,197,"Missouri","Schuyler County",5,67,52,27,25
050,29,197,"Missouri","Schuyler County",5,68,33,16,17
050,29,197,"Missouri","Schuyler County",5,69,37,20,17
050,29,197,"Missouri","Schuyler County",5,70,32,17,15
050,29,197,"Missouri","Schuyler County",5,71,35,17,18
050,29,197,"Missouri","Schuyler County",5,72,47,24,23
050,29,197,"Missouri","Schuyler County",5,73,39,20,19
050,29,197,"Missouri","Schuyler County",5,74,31,13,18
050,29,197,"Missouri","Schuyler County",5,75,34,16,18
050,29,197,"Missouri","Schuyler County",5,76,39,19,20
050,29,197,"Missouri","Schuyler County",5,77,21,7,14
050,29,197,"Missouri","Schuyler County",5,78,18,8,10
050,29,197,"Missouri","Schuyler County",5,79,29,14,15
050,29,197,"Missouri","Schuyler County",5,80,32,15,17
050,29,197,"Missouri","Schuyler County",5,81,30,12,18
050,29,197,"Missouri","Schuyler County",5,82,30,13,17
050,29,197,"Missouri","Schuyler County",5,83,22,9,13
050,29,197,"Missouri","Schuyler County",5,84,16,7,9
050,29,197,"Missouri","Schuyler County",5,85,84,47,37
050,29,199,"Missouri","Scotland County",1,0,72,39,33
050,29,199,"Missouri","Scotland County",1,1,69,37,32
050,29,199,"Missouri","Scotland County",1,2,72,29,43
050,29,199,"Missouri","Scotland County",1,3,87,39,48
050,29,199,"Missouri","Scotland County",1,4,86,44,42
050,29,199,"Missouri","Scotland County",1,5,65,42,23
050,29,199,"Missouri","Scotland County",1,6,82,36,46
050,29,199,"Missouri","Scotland County",1,7,77,38,39
050,29,199,"Missouri","Scotland County",1,8,83,43,40
050,29,199,"Missouri","Scotland County",1,9,73,37,36
050,29,199,"Missouri","Scotland County",1,10,76,43,33
050,29,199,"Missouri","Scotland County",1,11,77,40,37
050,29,199,"Missouri","Scotland County",1,12,81,39,42
050,29,199,"Missouri","Scotland County",1,13,80,36,44
050,29,199,"Missouri","Scotland County",1,14,76,35,41
050,29,199,"Missouri","Scotland County",1,15,75,38,37
050,29,199,"Missouri","Scotland County",1,16,73,35,38
050,29,199,"Missouri","Scotland County",1,17,71,35,36
050,29,199,"Missouri","Scotland County",1,18,60,36,24
050,29,199,"Missouri","Scotland County",1,19,49,28,21
050,29,199,"Missouri","Scotland County",1,20,48,31,17
050,29,199,"Missouri","Scotland County",1,21,50,26,24
050,29,199,"Missouri","Scotland County",1,22,55,24,31
050,29,199,"Missouri","Scotland County",1,23,57,32,25
050,29,199,"Missouri","Scotland County",1,24,54,29,25
050,29,199,"Missouri","Scotland County",1,25,55,25,30
050,29,199,"Missouri","Scotland County",1,26,61,34,27
050,29,199,"Missouri","Scotland County",1,27,54,29,25
050,29,199,"Missouri","Scotland County",1,28,57,30,27
050,29,199,"Missouri","Scotland County",1,29,59,35,24
050,29,199,"Missouri","Scotland County",1,30,53,27,26
050,29,199,"Missouri","Scotland County",1,31,48,20,28
050,29,199,"Missouri","Scotland County",1,32,41,21,20
050,29,199,"Missouri","Scotland County",1,33,44,22,22
050,29,199,"Missouri","Scotland County",1,34,44,26,18
050,29,199,"Missouri","Scotland County",1,35,58,31,27
050,29,199,"Missouri","Scotland County",1,36,52,31,21
050,29,199,"Missouri","Scotland County",1,37,49,24,25
050,29,199,"Missouri","Scotland County",1,38,47,20,27
050,29,199,"Missouri","Scotland County",1,39,54,32,22
050,29,199,"Missouri","Scotland County",1,40,44,25,19
050,29,199,"Missouri","Scotland County",1,41,52,20,32
050,29,199,"Missouri","Scotland County",1,42,52,22,30
050,29,199,"Missouri","Scotland County",1,43,51,28,23
050,29,199,"Missouri","Scotland County",1,44,49,30,19
050,29,199,"Missouri","Scotland County",1,45,52,29,23
050,29,199,"Missouri","Scotland County",1,46,50,25,25
050,29,199,"Missouri","Scotland County",1,47,45,24,21
050,29,199,"Missouri","Scotland County",1,48,42,22,20
050,29,199,"Missouri","Scotland County",1,49,49,27,22
050,29,199,"Missouri","Scotland County",1,50,41,19,22
050,29,199,"Missouri","Scotland County",1,51,41,22,19
050,29,199,"Missouri","Scotland County",1,52,44,24,20
050,29,199,"Missouri","Scotland County",1,53,49,24,25
050,29,199,"Missouri","Scotland County",1,54,55,23,32
050,29,199,"Missouri","Scotland County",1,55,66,29,37
050,29,199,"Missouri","Scotland County",1,56,60,31,29
050,29,199,"Missouri","Scotland County",1,57,64,33,31
050,29,199,"Missouri","Scotland County",1,58,65,39,26
050,29,199,"Missouri","Scotland County",1,59,66,35,31
050,29,199,"Missouri","Scotland County",1,60,57,28,29
050,29,199,"Missouri","Scotland County",1,61,58,29,29
050,29,199,"Missouri","Scotland County",1,62,57,24,33
050,29,199,"Missouri","Scotland County",1,63,55,22,33
050,29,199,"Missouri","Scotland County",1,64,58,24,34
050,29,199,"Missouri","Scotland County",1,65,54,23,31
050,29,199,"Missouri","Scotland County",1,66,51,28,23
050,29,199,"Missouri","Scotland County",1,67,53,31,22
050,29,199,"Missouri","Scotland County",1,68,57,35,22
050,29,199,"Missouri","Scotland County",1,69,47,24,23
050,29,199,"Missouri","Scotland County",1,70,37,19,18
050,29,199,"Missouri","Scotland County",1,71,45,23,22
050,29,199,"Missouri","Scotland County",1,72,45,22,23
050,29,199,"Missouri","Scotland County",1,73,47,24,23
050,29,199,"Missouri","Scotland County",1,74,34,16,18
050,29,199,"Missouri","Scotland County",1,75,37,20,17
050,29,199,"Missouri","Scotland County",1,76,33,16,17
050,29,199,"Missouri","Scotland County",1,77,33,16,17
050,29,199,"Missouri","Scotland County",1,78,34,15,19
050,29,199,"Missouri","Scotland County",1,79,32,16,16
050,29,199,"Missouri","Scotland County",1,80,23,10,13
050,29,199,"Missouri","Scotland County",1,81,27,9,18
050,29,199,"Missouri","Scotland County",1,82,28,8,20
050,29,199,"Missouri","Scotland County",1,83,24,10,14
050,29,199,"Missouri","Scotland County",1,84,13,3,10
050,29,199,"Missouri","Scotland County",1,85,117,38,79
050,29,199,"Missouri","Scotland County",2,0,75,41,34
050,29,199,"Missouri","Scotland County",2,1,67,36,31
050,29,199,"Missouri","Scotland County",2,2,72,31,41
050,29,199,"Missouri","Scotland County",2,3,83,36,47
050,29,199,"Missouri","Scotland County",2,4,86,43,43
050,29,199,"Missouri","Scotland County",2,5,68,41,27
050,29,199,"Missouri","Scotland County",2,6,77,37,40
050,29,199,"Missouri","Scotland County",2,7,78,37,41
050,29,199,"Missouri","Scotland County",2,8,82,42,40
050,29,199,"Missouri","Scotland County",2,9,74,38,36
050,29,199,"Missouri","Scotland County",2,10,75,41,34
050,29,199,"Missouri","Scotland County",2,11,76,41,35
050,29,199,"Missouri","Scotland County",2,12,80,39,41
050,29,199,"Missouri","Scotland County",2,13,81,37,44
050,29,199,"Missouri","Scotland County",2,14,77,35,42
050,29,199,"Missouri","Scotland County",2,15,76,38,38
050,29,199,"Missouri","Scotland County",2,16,74,36,38
050,29,199,"Missouri","Scotland County",2,17,71,36,35
050,29,199,"Missouri","Scotland County",2,18,57,33,24
050,29,199,"Missouri","Scotland County",2,19,49,29,20
050,29,199,"Missouri","Scotland County",2,20,49,31,18
050,29,199,"Missouri","Scotland County",2,21,49,26,23
050,29,199,"Missouri","Scotland County",2,22,53,25,28
050,29,199,"Missouri","Scotland County",2,23,58,31,27
050,29,199,"Missouri","Scotland County",2,24,54,29,25
050,29,199,"Missouri","Scotland County",2,25,54,26,28
050,29,199,"Missouri","Scotland County",2,26,59,32,27
050,29,199,"Missouri","Scotland County",2,27,55,30,25
050,29,199,"Missouri","Scotland County",2,28,57,30,27
050,29,199,"Missouri","Scotland County",2,29,58,34,24
050,29,199,"Missouri","Scotland County",2,30,54,28,26
050,29,199,"Missouri","Scotland County",2,31,49,21,28
050,29,199,"Missouri","Scotland County",2,32,43,21,22
050,29,199,"Missouri","Scotland County",2,33,43,22,21
050,29,199,"Missouri","Scotland County",2,34,44,25,19
050,29,199,"Missouri","Scotland County",2,35,55,30,25
050,29,199,"Missouri","Scotland County",2,36,52,30,22
050,29,199,"Missouri","Scotland County",2,37,49,25,24
050,29,199,"Missouri","Scotland County",2,38,48,21,27
050,29,199,"Missouri","Scotland County",2,39,52,29,23
050,29,199,"Missouri","Scotland County",2,40,47,27,20
050,29,199,"Missouri","Scotland County",2,41,50,21,29
050,29,199,"Missouri","Scotland County",2,42,51,21,30
050,29,199,"Missouri","Scotland County",2,43,52,27,25
050,29,199,"Missouri","Scotland County",2,44,48,29,19
050,29,199,"Missouri","Scotland County",2,45,52,30,22
050,29,199,"Missouri","Scotland County",2,46,49,26,23
050,29,199,"Missouri","Scotland County",2,47,46,24,22
050,29,199,"Missouri","Scotland County",2,48,43,23,20
050,29,199,"Missouri","Scotland County",2,49,47,26,21
050,29,199,"Missouri","Scotland County",2,50,42,21,21
050,29,199,"Missouri","Scotland County",2,51,41,21,20
050,29,199,"Missouri","Scotland County",2,52,42,23,19
050,29,199,"Missouri","Scotland County",2,53,48,24,24
050,29,199,"Missouri","Scotland County",2,54,53,23,30
050,29,199,"Missouri","Scotland County",2,55,64,28,36
050,29,199,"Missouri","Scotland County",2,56,61,30,31
050,29,199,"Missouri","Scotland County",2,57,63,32,31
050,29,199,"Missouri","Scotland County",2,58,65,38,27
050,29,199,"Missouri","Scotland County",2,59,67,37,30
050,29,199,"Missouri","Scotland County",2,60,58,30,28
050,29,199,"Missouri","Scotland County",2,61,58,29,29
050,29,199,"Missouri","Scotland County",2,62,58,26,32
050,29,199,"Missouri","Scotland County",2,63,56,23,33
050,29,199,"Missouri","Scotland County",2,64,57,24,33
050,29,199,"Missouri","Scotland County",2,65,53,22,31
050,29,199,"Missouri","Scotland County",2,66,52,27,25
050,29,199,"Missouri","Scotland County",2,67,51,30,21
050,29,199,"Missouri","Scotland County",2,68,53,32,21
050,29,199,"Missouri","Scotland County",2,69,49,26,23
050,29,199,"Missouri","Scotland County",2,70,40,21,19
050,29,199,"Missouri","Scotland County",2,71,44,23,21
050,29,199,"Missouri","Scotland County",2,72,44,22,22
050,29,199,"Missouri","Scotland County",2,73,49,25,24
050,29,199,"Missouri","Scotland County",2,74,34,17,17
050,29,199,"Missouri","Scotland County",2,75,37,19,18
050,29,199,"Missouri","Scotland County",2,76,34,17,17
050,29,199,"Missouri","Scotland County",2,77,33,16,17
050,29,199,"Missouri","Scotland County",2,78,33,15,18
050,29,199,"Missouri","Scotland County",2,79,32,16,16
050,29,199,"Missouri","Scotland County",2,80,25,11,14
050,29,199,"Missouri","Scotland County",2,81,27,10,17
050,29,199,"Missouri","Scotland County",2,82,28,8,20
050,29,199,"Missouri","Scotland County",2,83,24,9,15
050,29,199,"Missouri","Scotland County",2,84,16,5,11
050,29,199,"Missouri","Scotland County",2,85,118,39,79
050,29,199,"Missouri","Scotland County",3,0,76,34,42
050,29,199,"Missouri","Scotland County",3,1,77,45,32
050,29,199,"Missouri","Scotland County",3,2,61,31,30
050,29,199,"Missouri","Scotland County",3,3,79,30,49
050,29,199,"Missouri","Scotland County",3,4,86,41,45
050,29,199,"Missouri","Scotland County",3,5,86,42,44
050,29,199,"Missouri","Scotland County",3,6,67,38,29
050,29,199,"Missouri","Scotland County",3,7,78,39,39
050,29,199,"Missouri","Scotland County",3,8,77,37,40
050,29,199,"Missouri","Scotland County",3,9,80,40,40
050,29,199,"Missouri","Scotland County",3,10,75,37,38
050,29,199,"Missouri","Scotland County",3,11,73,40,33
050,29,199,"Missouri","Scotland County",3,12,70,39,31
050,29,199,"Missouri","Scotland County",3,13,77,36,41
050,29,199,"Missouri","Scotland County",3,14,79,38,41
050,29,199,"Missouri","Scotland County",3,15,73,36,37
050,29,199,"Missouri","Scotland County",3,16,73,39,34
050,29,199,"Missouri","Scotland County",3,17,76,38,38
050,29,199,"Missouri","Scotland County",3,18,59,31,28
050,29,199,"Missouri","Scotland County",3,19,44,26,18
050,29,199,"Missouri","Scotland County",3,20,53,28,25
050,29,199,"Missouri","Scotland County",3,21,53,30,23
050,29,199,"Missouri","Scotland County",3,22,50,24,26
050,29,199,"Missouri","Scotland County",3,23,55,28,27
050,29,199,"Missouri","Scotland County",3,24,58,29,29
050,29,199,"Missouri","Scotland County",3,25,55,31,24
050,29,199,"Missouri","Scotland County",3,26,50,22,28
050,29,199,"Missouri","Scotland County",3,27,59,32,27
050,29,199,"Missouri","Scotland County",3,28,55,27,28
050,29,199,"Missouri","Scotland County",3,29,60,32,28
050,29,199,"Missouri","Scotland County",3,30,60,34,26
050,29,199,"Missouri","Scotland County",3,31,54,27,27
050,29,199,"Missouri","Scotland County",3,32,47,20,27
050,29,199,"Missouri","Scotland County",3,33,42,20,22
050,29,199,"Missouri","Scotland County",3,34,44,21,23
050,29,199,"Missouri","Scotland County",3,35,39,24,15
050,29,199,"Missouri","Scotland County",3,36,53,29,24
050,29,199,"Missouri","Scotland County",3,37,53,29,24
050,29,199,"Missouri","Scotland County",3,38,45,22,23
050,29,199,"Missouri","Scotland County",3,39,45,19,26
050,29,199,"Missouri","Scotland County",3,40,52,28,24
050,29,199,"Missouri","Scotland County",3,41,47,25,22
050,29,199,"Missouri","Scotland County",3,42,51,22,29
050,29,199,"Missouri","Scotland County",3,43,52,20,32
050,29,199,"Missouri","Scotland County",3,44,50,27,23
050,29,199,"Missouri","Scotland County",3,45,52,30,22
050,29,199,"Missouri","Scotland County",3,46,52,31,21
050,29,199,"Missouri","Scotland County",3,47,45,24,21
050,29,199,"Missouri","Scotland County",3,48,44,23,21
050,29,199,"Missouri","Scotland County",3,49,41,21,20
050,29,199,"Missouri","Scotland County",3,50,47,25,22
050,29,199,"Missouri","Scotland County",3,51,41,21,20
050,29,199,"Missouri","Scotland County",3,52,41,21,20
050,29,199,"Missouri","Scotland County",3,53,40,23,17
050,29,199,"Missouri","Scotland County",3,54,47,23,24
050,29,199,"Missouri","Scotland County",3,55,55,25,30
050,29,199,"Missouri","Scotland County",3,56,59,25,34
050,29,199,"Missouri","Scotland County",3,57,60,29,31
050,29,199,"Missouri","Scotland County",3,58,65,33,32
050,29,199,"Missouri","Scotland County",3,59,63,36,27
050,29,199,"Missouri","Scotland County",3,60,65,36,29
050,29,199,"Missouri","Scotland County",3,61,58,29,29
050,29,199,"Missouri","Scotland County",3,62,58,28,30
050,29,199,"Missouri","Scotland County",3,63,58,25,33
050,29,199,"Missouri","Scotland County",3,64,55,24,31
050,29,199,"Missouri","Scotland County",3,65,52,22,30
050,29,199,"Missouri","Scotland County",3,66,52,21,31
050,29,199,"Missouri","Scotland County",3,67,51,26,25
050,29,199,"Missouri","Scotland County",3,68,48,26,22
050,29,199,"Missouri","Scotland County",3,69,53,32,21
050,29,199,"Missouri","Scotland County",3,70,48,27,21
050,29,199,"Missouri","Scotland County",3,71,41,21,20
050,29,199,"Missouri","Scotland County",3,72,42,23,19
050,29,199,"Missouri","Scotland County",3,73,41,20,21
050,29,199,"Missouri","Scotland County",3,74,46,24,22
050,29,199,"Missouri","Scotland County",3,75,36,18,18
050,29,199,"Missouri","Scotland County",3,76,35,17,18
050,29,199,"Missouri","Scotland County",3,77,29,15,14
050,29,199,"Missouri","Scotland County",3,78,31,14,17
050,29,199,"Missouri","Scotland County",3,79,31,15,16
050,29,199,"Missouri","Scotland County",3,80,31,15,16
050,29,199,"Missouri","Scotland County",3,81,23,11,12
050,29,199,"Missouri","Scotland County",3,82,27,8,19
050,29,199,"Missouri","Scotland County",3,83,26,7,19
050,29,199,"Missouri","Scotland County",3,84,24,9,15
050,29,199,"Missouri","Scotland County",3,85,113,36,77
050,29,199,"Missouri","Scotland County",4,0,85,43,42
050,29,199,"Missouri","Scotland County",4,1,78,36,42
050,29,199,"Missouri","Scotland County",4,2,76,44,32
050,29,199,"Missouri","Scotland County",4,3,58,30,28
050,29,199,"Missouri","Scotland County",4,4,78,33,45
050,29,199,"Missouri","Scotland County",4,5,75,35,40
050,29,199,"Missouri","Scotland County",4,6,78,39,39
050,29,199,"Missouri","Scotland County",4,7,65,37,28
050,29,199,"Missouri","Scotland County",4,8,75,37,38
050,29,199,"Missouri","Scotland County",4,9,77,36,41
050,29,199,"Missouri","Scotland County",4,10,81,40,41
050,29,199,"Missouri","Scotland County",4,11,77,38,39
050,29,199,"Missouri","Scotland County",4,12,74,39,35
050,29,199,"Missouri","Scotland County",4,13,75,40,35
050,29,199,"Missouri","Scotland County",4,14,78,37,41
050,29,199,"Missouri","Scotland County",4,15,80,39,41
050,29,199,"Missouri","Scotland County",4,16,72,37,35
050,29,199,"Missouri","Scotland County",4,17,75,39,36
050,29,199,"Missouri","Scotland County",4,18,62,32,30
050,29,199,"Missouri","Scotland County",4,19,42,24,18
050,29,199,"Missouri","Scotland County",4,20,41,27,14
050,29,199,"Missouri","Scotland County",4,21,54,29,25
050,29,199,"Missouri","Scotland County",4,22,56,35,21
050,29,199,"Missouri","Scotland County",4,23,51,23,28
050,29,199,"Missouri","Scotland County",4,24,57,27,30
050,29,199,"Missouri","Scotland County",4,25,54,22,32
050,29,199,"Missouri","Scotland County",4,26,51,30,21
050,29,199,"Missouri","Scotland County",4,27,52,25,27
050,29,199,"Missouri","Scotland County",4,28,55,31,24
050,29,199,"Missouri","Scotland County",4,29,51,23,28
050,29,199,"Missouri","Scotland County",4,30,61,30,31
050,29,199,"Missouri","Scotland County",4,31,60,34,26
050,29,199,"Missouri","Scotland County",4,32,53,28,25
050,29,199,"Missouri","Scotland County",4,33,51,20,31
050,29,199,"Missouri","Scotland County",4,34,48,22,26
050,29,199,"Missouri","Scotland County",4,35,44,21,23
050,29,199,"Missouri","Scotland County",4,36,37,22,15
050,29,199,"Missouri","Scotland County",4,37,52,29,23
050,29,199,"Missouri","Scotland County",4,38,53,28,25
050,29,199,"Missouri","Scotland County",4,39,45,22,23
050,29,199,"Missouri","Scotland County",4,40,46,19,27
050,29,199,"Missouri","Scotland County",4,41,49,28,21
050,29,199,"Missouri","Scotland County",4,42,46,25,21
050,29,199,"Missouri","Scotland County",4,43,51,21,30
050,29,199,"Missouri","Scotland County",4,44,51,20,31
050,29,199,"Missouri","Scotland County",4,45,52,28,24
050,29,199,"Missouri","Scotland County",4,46,53,31,22
050,29,199,"Missouri","Scotland County",4,47,52,31,21
050,29,199,"Missouri","Scotland County",4,48,43,24,19
050,29,199,"Missouri","Scotland County",4,49,42,22,20
050,29,199,"Missouri","Scotland County",4,50,40,20,20
050,29,199,"Missouri","Scotland County",4,51,48,23,25
050,29,199,"Missouri","Scotland County",4,52,42,21,21
050,29,199,"Missouri","Scotland County",4,53,41,21,20
050,29,199,"Missouri","Scotland County",4,54,40,24,16
050,29,199,"Missouri","Scotland County",4,55,48,23,25
050,29,199,"Missouri","Scotland County",4,56,52,23,29
050,29,199,"Missouri","Scotland County",4,57,56,26,30
050,29,199,"Missouri","Scotland County",4,58,58,26,32
050,29,199,"Missouri","Scotland County",4,59,61,29,32
050,29,199,"Missouri","Scotland County",4,60,62,35,27
050,29,199,"Missouri","Scotland County",4,61,64,34,30
050,29,199,"Missouri","Scotland County",4,62,57,29,28
050,29,199,"Missouri","Scotland County",4,63,57,26,31
050,29,199,"Missouri","Scotland County",4,64,60,26,34
050,29,199,"Missouri","Scotland County",4,65,54,24,30
050,29,199,"Missouri","Scotland County",4,66,50,21,29
050,29,199,"Missouri","Scotland County",4,67,51,20,31
050,29,199,"Missouri","Scotland County",4,68,52,26,26
050,29,199,"Missouri","Scotland County",4,69,47,26,21
050,29,199,"Missouri","Scotland County",4,70,54,33,21
050,29,199,"Missouri","Scotland County",4,71,46,27,19
050,29,199,"Missouri","Scotland County",4,72,38,19,19
050,29,199,"Missouri","Scotland County",4,73,39,22,17
050,29,199,"Missouri","Scotland County",4,74,42,21,21
050,29,199,"Missouri","Scotland County",4,75,47,25,22
050,29,199,"Missouri","Scotland County",4,76,30,14,16
050,29,199,"Missouri","Scotland County",4,77,31,15,16
050,29,199,"Missouri","Scotland County",4,78,29,15,14
050,29,199,"Missouri","Scotland County",4,79,31,14,17
050,29,199,"Missouri","Scotland County",4,80,31,14,17
050,29,199,"Missouri","Scotland County",4,81,31,16,15
050,29,199,"Missouri","Scotland County",4,82,22,9,13
050,29,199,"Missouri","Scotland County",4,83,23,7,16
050,29,199,"Missouri","Scotland County",4,84,24,6,18
050,29,199,"Missouri","Scotland County",4,85,117,39,78
050,29,199,"Missouri","Scotland County",5,0,83,42,41
050,29,199,"Missouri","Scotland County",5,1,86,45,41
050,29,199,"Missouri","Scotland County",5,2,83,37,46
050,29,199,"Missouri","Scotland County",5,3,73,39,34
050,29,199,"Missouri","Scotland County",5,4,56,31,25
050,29,199,"Missouri","Scotland County",5,5,80,33,47
050,29,199,"Missouri","Scotland County",5,6,78,35,43
050,29,199,"Missouri","Scotland County",5,7,84,42,42
050,29,199,"Missouri","Scotland County",5,8,66,37,29
050,29,199,"Missouri","Scotland County",5,9,73,37,36
050,29,199,"Missouri","Scotland County",5,10,77,36,41
050,29,199,"Missouri","Scotland County",5,11,79,39,40
050,29,199,"Missouri","Scotland County",5,12,81,40,41
050,29,199,"Missouri","Scotland County",5,13,77,41,36
050,29,199,"Missouri","Scotland County",5,14,68,37,31
050,29,199,"Missouri","Scotland County",5,15,79,38,41
050,29,199,"Missouri","Scotland County",5,16,81,40,41
050,29,199,"Missouri","Scotland County",5,17,72,37,35
050,29,199,"Missouri","Scotland County",5,18,62,33,29
050,29,199,"Missouri","Scotland County",5,19,49,23,26
050,29,199,"Missouri","Scotland County",5,20,41,22,19
050,29,199,"Missouri","Scotland County",5,21,46,27,19
050,29,199,"Missouri","Scotland County",5,22,58,30,28
050,29,199,"Missouri","Scotland County",5,23,51,33,18
050,29,199,"Missouri","Scotland County",5,24,56,25,31
050,29,199,"Missouri","Scotland County",5,25,57,27,30
050,29,199,"Missouri","Scotland County",5,26,63,26,37
050,29,199,"Missouri","Scotland County",5,27,48,29,19
050,29,199,"Missouri","Scotland County",5,28,51,22,29
050,29,199,"Missouri","Scotland County",5,29,53,31,22
050,29,199,"Missouri","Scotland County",5,30,55,26,29
050,29,199,"Missouri","Scotland County",5,31,59,30,29
050,29,199,"Missouri","Scotland County",5,32,55,30,25
050,29,199,"Missouri","Scotland County",5,33,50,26,24
050,29,199,"Missouri","Scotland County",5,34,52,20,32
050,29,199,"Missouri","Scotland County",5,35,46,23,23
050,29,199,"Missouri","Scotland County",5,36,47,24,23
050,29,199,"Missouri","Scotland County",5,37,35,20,15
050,29,199,"Missouri","Scotland County",5,38,56,33,23
050,29,199,"Missouri","Scotland County",5,39,53,27,26
050,29,199,"Missouri","Scotland County",5,40,46,22,24
050,29,199,"Missouri","Scotland County",5,41,48,20,28
050,29,199,"Missouri","Scotland County",5,42,48,28,20
050,29,199,"Missouri","Scotland County",5,43,45,22,23
050,29,199,"Missouri","Scotland County",5,44,48,21,27
050,29,199,"Missouri","Scotland County",5,45,51,20,31
050,29,199,"Missouri","Scotland County",5,46,52,28,24
050,29,199,"Missouri","Scotland County",5,47,53,31,22
050,29,199,"Missouri","Scotland County",5,48,52,31,21
050,29,199,"Missouri","Scotland County",5,49,40,22,18
050,29,199,"Missouri","Scotland County",5,50,43,22,21
050,29,199,"Missouri","Scotland County",5,51,41,20,21
050,29,199,"Missouri","Scotland County",5,52,49,22,27
050,29,199,"Missouri","Scotland County",5,53,41,19,22
050,29,199,"Missouri","Scotland County",5,54,42,22,20
050,29,199,"Missouri","Scotland County",5,55,41,24,17
050,29,199,"Missouri","Scotland County",5,56,46,22,24
050,29,199,"Missouri","Scotland County",5,57,53,25,28
050,29,199,"Missouri","Scotland County",5,58,54,24,30
050,29,199,"Missouri","Scotland County",5,59,57,25,32
050,29,199,"Missouri","Scotland County",5,60,60,29,31
050,29,199,"Missouri","Scotland County",5,61,63,35,28
050,29,199,"Missouri","Scotland County",5,62,67,34,33
050,29,199,"Missouri","Scotland County",5,63,56,28,28
050,29,199,"Missouri","Scotland County",5,64,56,27,29
050,29,199,"Missouri","Scotland County",5,65,56,23,33
050,29,199,"Missouri","Scotland County",5,66,51,19,32
050,29,199,"Missouri","Scotland County",5,67,48,20,28
050,29,199,"Missouri","Scotland County",5,68,51,20,31
050,29,199,"Missouri","Scotland County",5,69,54,27,27
050,29,199,"Missouri","Scotland County",5,70,48,27,21
050,29,199,"Missouri","Scotland County",5,71,52,33,19
050,29,199,"Missouri","Scotland County",5,72,47,27,20
050,29,199,"Missouri","Scotland County",5,73,35,17,18
050,29,199,"Missouri","Scotland County",5,74,35,20,15
050,29,199,"Missouri","Scotland County",5,75,43,22,21
050,29,199,"Missouri","Scotland County",5,76,46,24,22
050,29,199,"Missouri","Scotland County",5,77,27,13,14
050,29,199,"Missouri","Scotland County",5,78,31,15,16
050,29,199,"Missouri","Scotland County",5,79,29,15,14
050,29,199,"Missouri","Scotland County",5,80,29,12,17
050,29,199,"Missouri","Scotland County",5,81,31,15,16
050,29,199,"Missouri","Scotland County",5,82,30,13,17
050,29,199,"Missouri","Scotland County",5,83,18,7,11
050,29,199,"Missouri","Scotland County",5,84,21,6,15
050,29,199,"Missouri","Scotland County",5,85,123,39,84
050,29,201,"Missouri","Scott County",1,0,475,243,232
050,29,201,"Missouri","Scott County",1,1,493,255,238
050,29,201,"Missouri","Scott County",1,2,518,259,259
050,29,201,"Missouri","Scott County",1,3,483,256,227
050,29,201,"Missouri","Scott County",1,4,472,263,209
050,29,201,"Missouri","Scott County",1,5,497,260,237
050,29,201,"Missouri","Scott County",1,6,504,261,243
050,29,201,"Missouri","Scott County",1,7,504,254,250
050,29,201,"Missouri","Scott County",1,8,500,265,235
050,29,201,"Missouri","Scott County",1,9,524,274,250
050,29,201,"Missouri","Scott County",1,10,521,286,235
050,29,201,"Missouri","Scott County",1,11,553,285,268
050,29,201,"Missouri","Scott County",1,12,524,258,266
050,29,201,"Missouri","Scott County",1,13,555,268,287
050,29,201,"Missouri","Scott County",1,14,535,271,264
050,29,201,"Missouri","Scott County",1,15,542,278,264
050,29,201,"Missouri","Scott County",1,16,534,297,237
050,29,201,"Missouri","Scott County",1,17,501,270,231
050,29,201,"Missouri","Scott County",1,18,456,237,219
050,29,201,"Missouri","Scott County",1,19,345,175,170
050,29,201,"Missouri","Scott County",1,20,360,188,172
050,29,201,"Missouri","Scott County",1,21,392,206,186
050,29,201,"Missouri","Scott County",1,22,422,200,222
050,29,201,"Missouri","Scott County",1,23,431,217,214
050,29,201,"Missouri","Scott County",1,24,439,227,212
050,29,201,"Missouri","Scott County",1,25,458,225,233
050,29,201,"Missouri","Scott County",1,26,490,250,240
050,29,201,"Missouri","Scott County",1,27,495,239,256
050,29,201,"Missouri","Scott County",1,28,535,256,279
050,29,201,"Missouri","Scott County",1,29,519,262,257
050,29,201,"Missouri","Scott County",1,30,504,247,257
050,29,201,"Missouri","Scott County",1,31,447,211,236
050,29,201,"Missouri","Scott County",1,32,433,201,232
050,29,201,"Missouri","Scott County",1,33,445,218,227
050,29,201,"Missouri","Scott County",1,34,435,219,216
050,29,201,"Missouri","Scott County",1,35,447,224,223
050,29,201,"Missouri","Scott County",1,36,464,227,237
050,29,201,"Missouri","Scott County",1,37,477,226,251
050,29,201,"Missouri","Scott County",1,38,467,221,246
050,29,201,"Missouri","Scott County",1,39,459,228,231
050,29,201,"Missouri","Scott County",1,40,463,220,243
050,29,201,"Missouri","Scott County",1,41,447,216,231
050,29,201,"Missouri","Scott County",1,42,446,224,222
050,29,201,"Missouri","Scott County",1,43,403,196,207
050,29,201,"Missouri","Scott County",1,44,433,207,226
050,29,201,"Missouri","Scott County",1,45,409,194,215
050,29,201,"Missouri","Scott County",1,46,408,198,210
050,29,201,"Missouri","Scott County",1,47,449,220,229
050,29,201,"Missouri","Scott County",1,48,497,251,246
050,29,201,"Missouri","Scott County",1,49,518,258,260
050,29,201,"Missouri","Scott County",1,50,497,237,260
050,29,201,"Missouri","Scott County",1,51,450,221,229
050,29,201,"Missouri","Scott County",1,52,454,227,227
050,29,201,"Missouri","Scott County",1,53,468,233,235
050,29,201,"Missouri","Scott County",1,54,483,236,247
050,29,201,"Missouri","Scott County",1,55,514,252,262
050,29,201,"Missouri","Scott County",1,56,511,243,268
050,29,201,"Missouri","Scott County",1,57,529,262,267
050,29,201,"Missouri","Scott County",1,58,562,288,274
050,29,201,"Missouri","Scott County",1,59,516,256,260
050,29,201,"Missouri","Scott County",1,60,509,245,264
050,29,201,"Missouri","Scott County",1,61,507,248,259
050,29,201,"Missouri","Scott County",1,62,483,243,240
050,29,201,"Missouri","Scott County",1,63,474,221,253
050,29,201,"Missouri","Scott County",1,64,472,214,258
050,29,201,"Missouri","Scott County",1,65,475,213,262
050,29,201,"Missouri","Scott County",1,66,473,213,260
050,29,201,"Missouri","Scott County",1,67,443,209,234
050,29,201,"Missouri","Scott County",1,68,442,210,232
050,29,201,"Missouri","Scott County",1,69,421,199,222
050,29,201,"Missouri","Scott County",1,70,415,188,227
050,29,201,"Missouri","Scott County",1,71,384,171,213
050,29,201,"Missouri","Scott County",1,72,380,177,203
050,29,201,"Missouri","Scott County",1,73,393,182,211
050,29,201,"Missouri","Scott County",1,74,277,124,153
050,29,201,"Missouri","Scott County",1,75,282,125,157
050,29,201,"Missouri","Scott County",1,76,286,139,147
050,29,201,"Missouri","Scott County",1,77,256,112,144
050,29,201,"Missouri","Scott County",1,78,255,104,151
050,29,201,"Missouri","Scott County",1,79,226,93,133
050,29,201,"Missouri","Scott County",1,80,181,70,111
050,29,201,"Missouri","Scott County",1,81,200,81,119
050,29,201,"Missouri","Scott County",1,82,171,71,100
050,29,201,"Missouri","Scott County",1,83,151,67,84
050,29,201,"Missouri","Scott County",1,84,120,43,77
050,29,201,"Missouri","Scott County",1,85,766,269,497
050,29,201,"Missouri","Scott County",2,0,467,234,233
050,29,201,"Missouri","Scott County",2,1,488,252,236
050,29,201,"Missouri","Scott County",2,2,506,257,249
050,29,201,"Missouri","Scott County",2,3,486,255,231
050,29,201,"Missouri","Scott County",2,4,475,260,215
050,29,201,"Missouri","Scott County",2,5,491,261,230
050,29,201,"Missouri","Scott County",2,6,501,263,238
050,29,201,"Missouri","Scott County",2,7,503,257,246
050,29,201,"Missouri","Scott County",2,8,499,259,240
050,29,201,"Missouri","Scott County",2,9,515,270,245
050,29,201,"Missouri","Scott County",2,10,519,281,238
050,29,201,"Missouri","Scott County",2,11,543,284,259
050,29,201,"Missouri","Scott County",2,12,539,266,273
050,29,201,"Missouri","Scott County",2,13,549,265,284
050,29,201,"Missouri","Scott County",2,14,541,272,269
050,29,201,"Missouri","Scott County",2,15,541,278,263
050,29,201,"Missouri","Scott County",2,16,538,296,242
050,29,201,"Missouri","Scott County",2,17,510,276,234
050,29,201,"Missouri","Scott County",2,18,446,236,210
050,29,201,"Missouri","Scott County",2,19,353,179,174
050,29,201,"Missouri","Scott County",2,20,372,192,180
050,29,201,"Missouri","Scott County",2,21,391,203,188
050,29,201,"Missouri","Scott County",2,22,422,204,218
050,29,201,"Missouri","Scott County",2,23,433,215,218
050,29,201,"Missouri","Scott County",2,24,435,225,210
050,29,201,"Missouri","Scott County",2,25,452,227,225
050,29,201,"Missouri","Scott County",2,26,478,241,237
050,29,201,"Missouri","Scott County",2,27,495,241,254
050,29,201,"Missouri","Scott County",2,28,524,253,271
050,29,201,"Missouri","Scott County",2,29,520,259,261
050,29,201,"Missouri","Scott County",2,30,510,253,257
050,29,201,"Missouri","Scott County",2,31,460,219,241
050,29,201,"Missouri","Scott County",2,32,436,203,233
050,29,201,"Missouri","Scott County",2,33,439,212,227
050,29,201,"Missouri","Scott County",2,34,441,220,221
050,29,201,"Missouri","Scott County",2,35,448,225,223
050,29,201,"Missouri","Scott County",2,36,457,225,232
050,29,201,"Missouri","Scott County",2,37,473,225,248
050,29,201,"Missouri","Scott County",2,38,468,220,248
050,29,201,"Missouri","Scott County",2,39,461,224,237
050,29,201,"Missouri","Scott County",2,40,466,222,244
050,29,201,"Missouri","Scott County",2,41,453,218,235
050,29,201,"Missouri","Scott County",2,42,443,219,224
050,29,201,"Missouri","Scott County",2,43,419,207,212
050,29,201,"Missouri","Scott County",2,44,421,202,219
050,29,201,"Missouri","Scott County",2,45,415,195,220
050,29,201,"Missouri","Scott County",2,46,407,197,210
050,29,201,"Missouri","Scott County",2,47,435,213,222
050,29,201,"Missouri","Scott County",2,48,485,243,242
050,29,201,"Missouri","Scott County",2,49,517,259,258
050,29,201,"Missouri","Scott County",2,50,506,245,261
050,29,201,"Missouri","Scott County",2,51,460,224,236
050,29,201,"Missouri","Scott County",2,52,454,226,228
050,29,201,"Missouri","Scott County",2,53,460,227,233
050,29,201,"Missouri","Scott County",2,54,480,236,244
050,29,201,"Missouri","Scott County",2,55,502,243,259
050,29,201,"Missouri","Scott County",2,56,510,243,267
050,29,201,"Missouri","Scott County",2,57,525,259,266
050,29,201,"Missouri","Scott County",2,58,551,281,270
050,29,201,"Missouri","Scott County",2,59,527,263,264
050,29,201,"Missouri","Scott County",2,60,508,247,261
050,29,201,"Missouri","Scott County",2,61,504,247,257
050,29,201,"Missouri","Scott County",2,62,487,244,243
050,29,201,"Missouri","Scott County",2,63,481,227,254
050,29,201,"Missouri","Scott County",2,64,465,210,255
050,29,201,"Missouri","Scott County",2,65,471,211,260
050,29,201,"Missouri","Scott County",2,66,474,213,261
050,29,201,"Missouri","Scott County",2,67,447,208,239
050,29,201,"Missouri","Scott County",2,68,435,205,230
050,29,201,"Missouri","Scott County",2,69,427,202,225
050,29,201,"Missouri","Scott County",2,70,412,188,224
050,29,201,"Missouri","Scott County",2,71,395,177,218
050,29,201,"Missouri","Scott County",2,72,371,171,200
050,29,201,"Missouri","Scott County",2,73,405,186,219
050,29,201,"Missouri","Scott County",2,74,284,129,155
050,29,201,"Missouri","Scott County",2,75,282,125,157
050,29,201,"Missouri","Scott County",2,76,275,128,147
050,29,201,"Missouri","Scott County",2,77,267,121,146
050,29,201,"Missouri","Scott County",2,78,251,103,148
050,29,201,"Missouri","Scott County",2,79,229,93,136
050,29,201,"Missouri","Scott County",2,80,186,74,112
050,29,201,"Missouri","Scott County",2,81,191,77,114
050,29,201,"Missouri","Scott County",2,82,174,72,102
050,29,201,"Missouri","Scott County",2,83,153,67,86
050,29,201,"Missouri","Scott County",2,84,123,48,75
050,29,201,"Missouri","Scott County",2,85,762,265,497
050,29,201,"Missouri","Scott County",3,0,485,243,242
050,29,201,"Missouri","Scott County",3,1,464,238,226
050,29,201,"Missouri","Scott County",3,2,494,259,235
050,29,201,"Missouri","Scott County",3,3,516,266,250
050,29,201,"Missouri","Scott County",3,4,484,248,236
050,29,201,"Missouri","Scott County",3,5,478,265,213
050,29,201,"Missouri","Scott County",3,6,500,269,231
050,29,201,"Missouri","Scott County",3,7,506,263,243
050,29,201,"Missouri","Scott County",3,8,490,256,234
050,29,201,"Missouri","Scott County",3,9,481,249,232
050,29,201,"Missouri","Scott County",3,10,511,269,242
050,29,201,"Missouri","Scott County",3,11,544,289,255
050,29,201,"Missouri","Scott County",3,12,535,284,251
050,29,201,"Missouri","Scott County",3,13,538,263,275
050,29,201,"Missouri","Scott County",3,14,551,272,279
050,29,201,"Missouri","Scott County",3,15,538,271,267
050,29,201,"Missouri","Scott County",3,16,537,286,251
050,29,201,"Missouri","Scott County",3,17,528,289,239
050,29,201,"Missouri","Scott County",3,18,437,243,194
050,29,201,"Missouri","Scott County",3,19,360,182,178
050,29,201,"Missouri","Scott County",3,20,387,186,201
050,29,201,"Missouri","Scott County",3,21,384,193,191
050,29,201,"Missouri","Scott County",3,22,409,211,198
050,29,201,"Missouri","Scott County",3,23,440,212,228
050,29,201,"Missouri","Scott County",3,24,441,215,226
050,29,201,"Missouri","Scott County",3,25,462,235,227
050,29,201,"Missouri","Scott County",3,26,456,218,238
050,29,201,"Missouri","Scott County",3,27,457,226,231
050,29,201,"Missouri","Scott County",3,28,496,234,262
050,29,201,"Missouri","Scott County",3,29,492,244,248
050,29,201,"Missouri","Scott County",3,30,535,258,277
050,29,201,"Missouri","Scott County",3,31,506,246,260
050,29,201,"Missouri","Scott County",3,32,459,224,235
050,29,201,"Missouri","Scott County",3,33,432,206,226
050,29,201,"Missouri","Scott County",3,34,458,225,233
050,29,201,"Missouri","Scott County",3,35,436,214,222
050,29,201,"Missouri","Scott County",3,36,447,224,223
050,29,201,"Missouri","Scott County",3,37,457,219,238
050,29,201,"Missouri","Scott County",3,38,472,230,242
050,29,201,"Missouri","Scott County",3,39,469,222,247
050,29,201,"Missouri","Scott County",3,40,447,222,225
050,29,201,"Missouri","Scott County",3,41,462,228,234
050,29,201,"Missouri","Scott County",3,42,441,201,240
050,29,201,"Missouri","Scott County",3,43,428,212,216
050,29,201,"Missouri","Scott County",3,44,423,210,213
050,29,201,"Missouri","Scott County",3,45,423,204,219
050,29,201,"Missouri","Scott County",3,46,425,199,226
050,29,201,"Missouri","Scott County",3,47,404,195,209
050,29,201,"Missouri","Scott County",3,48,430,211,219
050,29,201,"Missouri","Scott County",3,49,473,245,228
050,29,201,"Missouri","Scott County",3,50,501,248,253
050,29,201,"Missouri","Scott County",3,51,511,247,264
050,29,201,"Missouri","Scott County",3,52,449,210,239
050,29,201,"Missouri","Scott County",3,53,460,234,226
050,29,201,"Missouri","Scott County",3,54,450,223,227
050,29,201,"Missouri","Scott County",3,55,477,235,242
050,29,201,"Missouri","Scott County",3,56,491,238,253
050,29,201,"Missouri","Scott County",3,57,525,253,272
050,29,201,"Missouri","Scott County",3,58,521,262,259
050,29,201,"Missouri","Scott County",3,59,543,269,274
050,29,201,"Missouri","Scott County",3,60,516,258,258
050,29,201,"Missouri","Scott County",3,61,499,244,255
050,29,201,"Missouri","Scott County",3,62,483,233,250
050,29,201,"Missouri","Scott County",3,63,485,239,246
050,29,201,"Missouri","Scott County",3,64,461,215,246
050,29,201,"Missouri","Scott County",3,65,463,207,256
050,29,201,"Missouri","Scott County",3,66,459,207,252
050,29,201,"Missouri","Scott County",3,67,466,207,259
050,29,201,"Missouri","Scott County",3,68,427,200,227
050,29,201,"Missouri","Scott County",3,69,435,203,232
050,29,201,"Missouri","Scott County",3,70,424,202,222
050,29,201,"Missouri","Scott County",3,71,400,182,218
050,29,201,"Missouri","Scott County",3,72,383,173,210
050,29,201,"Missouri","Scott County",3,73,368,167,201
050,29,201,"Missouri","Scott County",3,74,392,183,209
050,29,201,"Missouri","Scott County",3,75,277,124,153
050,29,201,"Missouri","Scott County",3,76,262,112,150
050,29,201,"Missouri","Scott County",3,77,257,117,140
050,29,201,"Missouri","Scott County",3,78,261,121,140
050,29,201,"Missouri","Scott County",3,79,229,91,138
050,29,201,"Missouri","Scott County",3,80,213,94,119
050,29,201,"Missouri","Scott County",3,81,180,70,110
050,29,201,"Missouri","Scott County",3,82,170,68,102
050,29,201,"Missouri","Scott County",3,83,153,58,95
050,29,201,"Missouri","Scott County",3,84,139,60,79
050,29,201,"Missouri","Scott County",3,85,728,249,479
050,29,201,"Missouri","Scott County",4,0,457,238,219
050,29,201,"Missouri","Scott County",4,1,497,251,246
050,29,201,"Missouri","Scott County",4,2,473,242,231
050,29,201,"Missouri","Scott County",4,3,504,264,240
050,29,201,"Missouri","Scott County",4,4,526,271,255
050,29,201,"Missouri","Scott County",4,5,490,261,229
050,29,201,"Missouri","Scott County",4,6,471,260,211
050,29,201,"Missouri","Scott County",4,7,491,268,223
050,29,201,"Missouri","Scott County",4,8,502,265,237
050,29,201,"Missouri","Scott County",4,9,484,256,228
050,29,201,"Missouri","Scott County",4,10,500,263,237
050,29,201,"Missouri","Scott County",4,11,509,267,242
050,29,201,"Missouri","Scott County",4,12,523,275,248
050,29,201,"Missouri","Scott County",4,13,543,295,248
050,29,201,"Missouri","Scott County",4,14,540,258,282
050,29,201,"Missouri","Scott County",4,15,556,274,282
050,29,201,"Missouri","Scott County",4,16,550,286,264
050,29,201,"Missouri","Scott County",4,17,536,285,251
050,29,201,"Missouri","Scott County",4,18,456,257,199
050,29,201,"Missouri","Scott County",4,19,334,184,150
050,29,201,"Missouri","Scott County",4,20,390,192,198
050,29,201,"Missouri","Scott County",4,21,389,190,199
050,29,201,"Missouri","Scott County",4,22,415,204,211
050,29,201,"Missouri","Scott County",4,23,433,214,219
050,29,201,"Missouri","Scott County",4,24,473,235,238
050,29,201,"Missouri","Scott County",4,25,438,200,238
050,29,201,"Missouri","Scott County",4,26,476,238,238
050,29,201,"Missouri","Scott County",4,27,452,216,236
050,29,201,"Missouri","Scott County",4,28,476,236,240
050,29,201,"Missouri","Scott County",4,29,497,238,259
050,29,201,"Missouri","Scott County",4,30,504,252,252
050,29,201,"Missouri","Scott County",4,31,539,265,274
050,29,201,"Missouri","Scott County",4,32,514,253,261
050,29,201,"Missouri","Scott County",4,33,461,225,236
050,29,201,"Missouri","Scott County",4,34,427,207,220
050,29,201,"Missouri","Scott County",4,35,452,228,224
050,29,201,"Missouri","Scott County",4,36,442,216,226
050,29,201,"Missouri","Scott County",4,37,440,212,228
050,29,201,"Missouri","Scott County",4,38,457,214,243
050,29,201,"Missouri","Scott County",4,39,464,220,244
050,29,201,"Missouri","Scott County",4,40,469,223,246
050,29,201,"Missouri","Scott County",4,41,451,223,228
050,29,201,"Missouri","Scott County",4,42,460,221,239
050,29,201,"Missouri","Scott County",4,43,433,198,235
050,29,201,"Missouri","Scott County",4,44,422,217,205
050,29,201,"Missouri","Scott County",4,45,421,212,209
050,29,201,"Missouri","Scott County",4,46,430,207,223
050,29,201,"Missouri","Scott County",4,47,424,199,225
050,29,201,"Missouri","Scott County",4,48,397,196,201
050,29,201,"Missouri","Scott County",4,49,440,216,224
050,29,201,"Missouri","Scott County",4,50,470,237,233
050,29,201,"Missouri","Scott County",4,51,497,243,254
050,29,201,"Missouri","Scott County",4,52,503,249,254
050,29,201,"Missouri","Scott County",4,53,442,204,238
050,29,201,"Missouri","Scott County",4,54,467,239,228
050,29,201,"Missouri","Scott County",4,55,444,216,228
050,29,201,"Missouri","Scott County",4,56,475,234,241
050,29,201,"Missouri","Scott County",4,57,505,247,258
050,29,201,"Missouri","Scott County",4,58,519,249,270
050,29,201,"Missouri","Scott County",4,59,525,253,272
050,29,201,"Missouri","Scott County",4,60,537,263,274
050,29,201,"Missouri","Scott County",4,61,507,256,251
050,29,201,"Missouri","Scott County",4,62,476,228,248
050,29,201,"Missouri","Scott County",4,63,470,223,247
050,29,201,"Missouri","Scott County",4,64,473,231,242
050,29,201,"Missouri","Scott County",4,65,453,210,243
050,29,201,"Missouri","Scott County",4,66,451,203,248
050,29,201,"Missouri","Scott County",4,67,445,198,247
050,29,201,"Missouri","Scott County",4,68,452,202,250
050,29,201,"Missouri","Scott County",4,69,422,198,224
050,29,201,"Missouri","Scott County",4,70,420,197,223
050,29,201,"Missouri","Scott County",4,71,403,190,213
050,29,201,"Missouri","Scott County",4,72,376,171,205
050,29,201,"Missouri","Scott County",4,73,364,163,201
050,29,201,"Missouri","Scott County",4,74,358,164,194
050,29,201,"Missouri","Scott County",4,75,384,181,203
050,29,201,"Missouri","Scott County",4,76,255,110,145
050,29,201,"Missouri","Scott County",4,77,260,107,153
050,29,201,"Missouri","Scott County",4,78,249,112,137
050,29,201,"Missouri","Scott County",4,79,244,112,132
050,29,201,"Missouri","Scott County",4,80,205,87,118
050,29,201,"Missouri","Scott County",4,81,206,82,124
050,29,201,"Missouri","Scott County",4,82,160,58,102
050,29,201,"Missouri","Scott County",4,83,149,57,92
050,29,201,"Missouri","Scott County",4,84,142,55,87
050,29,201,"Missouri","Scott County",4,85,732,255,477
050,29,201,"Missouri","Scott County",5,0,461,240,221
050,29,201,"Missouri","Scott County",5,1,426,218,208
050,29,201,"Missouri","Scott County",5,2,506,250,256
050,29,201,"Missouri","Scott County",5,3,480,242,238
050,29,201,"Missouri","Scott County",5,4,475,235,240
050,29,201,"Missouri","Scott County",5,5,537,275,262
050,29,201,"Missouri","Scott County",5,6,501,267,234
050,29,201,"Missouri","Scott County",5,7,509,282,227
050,29,201,"Missouri","Scott County",5,8,501,273,228
050,29,201,"Missouri","Scott County",5,9,502,267,235
050,29,201,"Missouri","Scott County",5,10,494,254,240
050,29,201,"Missouri","Scott County",5,11,504,272,232
050,29,201,"Missouri","Scott County",5,12,511,272,239
050,29,201,"Missouri","Scott County",5,13,522,279,243
050,29,201,"Missouri","Scott County",5,14,551,292,259
050,29,201,"Missouri","Scott County",5,15,544,260,284
050,29,201,"Missouri","Scott County",5,16,562,274,288
050,29,201,"Missouri","Scott County",5,17,527,275,252
050,29,201,"Missouri","Scott County",5,18,443,245,198
050,29,201,"Missouri","Scott County",5,19,364,195,169
050,29,201,"Missouri","Scott County",5,20,384,213,171
050,29,201,"Missouri","Scott County",5,21,418,206,212
050,29,201,"Missouri","Scott County",5,22,448,217,231
050,29,201,"Missouri","Scott County",5,23,433,220,213
050,29,201,"Missouri","Scott County",5,24,466,237,229
050,29,201,"Missouri","Scott County",5,25,463,241,222
050,29,201,"Missouri","Scott County",5,26,446,195,251
050,29,201,"Missouri","Scott County",5,27,468,239,229
050,29,201,"Missouri","Scott County",5,28,473,238,235
050,29,201,"Missouri","Scott County",5,29,447,222,225
050,29,201,"Missouri","Scott County",5,30,513,248,265
050,29,201,"Missouri","Scott County",5,31,485,240,245
050,29,201,"Missouri","Scott County",5,32,556,266,290
050,29,201,"Missouri","Scott County",5,33,514,253,261
050,29,201,"Missouri","Scott County",5,34,460,228,232
050,29,201,"Missouri","Scott County",5,35,407,193,214
050,29,201,"Missouri","Scott County",5,36,435,216,219
050,29,201,"Missouri","Scott County",5,37,441,216,225
050,29,201,"Missouri","Scott County",5,38,448,220,228
050,29,201,"Missouri","Scott County",5,39,471,216,255
050,29,201,"Missouri","Scott County",5,40,460,214,246
050,29,201,"Missouri","Scott County",5,41,474,228,246
050,29,201,"Missouri","Scott County",5,42,438,219,219
050,29,201,"Missouri","Scott County",5,43,471,225,246
050,29,201,"Missouri","Scott County",5,44,435,211,224
050,29,201,"Missouri","Scott County",5,45,424,215,209
050,29,201,"Missouri","Scott County",5,46,434,220,214
050,29,201,"Missouri","Scott County",5,47,440,212,228
050,29,201,"Missouri","Scott County",5,48,410,191,219
050,29,201,"Missouri","Scott County",5,49,397,195,202
050,29,201,"Missouri","Scott County",5,50,419,206,213
050,29,201,"Missouri","Scott County",5,51,455,228,227
050,29,201,"Missouri","Scott County",5,52,502,241,261
050,29,201,"Missouri","Scott County",5,53,490,249,241
050,29,201,"Missouri","Scott County",5,54,430,202,228
050,29,201,"Missouri","Scott County",5,55,460,231,229
050,29,201,"Missouri","Scott County",5,56,443,217,226
050,29,201,"Missouri","Scott County",5,57,495,246,249
050,29,201,"Missouri","Scott County",5,58,498,243,255
050,29,201,"Missouri","Scott County",5,59,518,238,280
050,29,201,"Missouri","Scott County",5,60,514,252,262
050,29,201,"Missouri","Scott County",5,61,525,257,268
050,29,201,"Missouri","Scott County",5,62,488,245,243
050,29,201,"Missouri","Scott County",5,63,472,221,251
050,29,201,"Missouri","Scott County",5,64,468,221,247
050,29,201,"Missouri","Scott County",5,65,465,228,237
050,29,201,"Missouri","Scott County",5,66,443,203,240
050,29,201,"Missouri","Scott County",5,67,436,193,243
050,29,201,"Missouri","Scott County",5,68,429,190,239
050,29,201,"Missouri","Scott County",5,69,447,198,249
050,29,201,"Missouri","Scott County",5,70,411,193,218
050,29,201,"Missouri","Scott County",5,71,403,192,211
050,29,201,"Missouri","Scott County",5,72,395,192,203
050,29,201,"Missouri","Scott County",5,73,370,164,206
050,29,201,"Missouri","Scott County",5,74,355,158,197
050,29,201,"Missouri","Scott County",5,75,356,163,193
050,29,201,"Missouri","Scott County",5,76,355,161,194
050,29,201,"Missouri","Scott County",5,77,246,99,147
050,29,201,"Missouri","Scott County",5,78,250,105,145
050,29,201,"Missouri","Scott County",5,79,237,103,134
050,29,201,"Missouri","Scott County",5,80,223,108,115
050,29,201,"Missouri","Scott County",5,81,201,80,121
050,29,201,"Missouri","Scott County",5,82,187,71,116
050,29,201,"Missouri","Scott County",5,83,142,48,94
050,29,201,"Missouri","Scott County",5,84,133,48,85
050,29,201,"Missouri","Scott County",5,85,749,268,481
050,29,203,"Missouri","Shannon County",1,0,74,39,35
050,29,203,"Missouri","Shannon County",1,1,79,42,37
050,29,203,"Missouri","Shannon County",1,2,85,39,46
050,29,203,"Missouri","Shannon County",1,3,78,35,43
050,29,203,"Missouri","Shannon County",1,4,76,35,41
050,29,203,"Missouri","Shannon County",1,5,71,42,29
050,29,203,"Missouri","Shannon County",1,6,77,40,37
050,29,203,"Missouri","Shannon County",1,7,82,42,40
050,29,203,"Missouri","Shannon County",1,8,85,44,41
050,29,203,"Missouri","Shannon County",1,9,92,43,49
050,29,203,"Missouri","Shannon County",1,10,85,40,45
050,29,203,"Missouri","Shannon County",1,11,95,49,46
050,29,203,"Missouri","Shannon County",1,12,105,57,48
050,29,203,"Missouri","Shannon County",1,13,90,51,39
050,29,203,"Missouri","Shannon County",1,14,102,57,45
050,29,203,"Missouri","Shannon County",1,15,95,51,44
050,29,203,"Missouri","Shannon County",1,16,84,44,40
050,29,203,"Missouri","Shannon County",1,17,76,44,32
050,29,203,"Missouri","Shannon County",1,18,72,42,30
050,29,203,"Missouri","Shannon County",1,19,59,26,33
050,29,203,"Missouri","Shannon County",1,20,59,28,31
050,29,203,"Missouri","Shannon County",1,21,64,33,31
050,29,203,"Missouri","Shannon County",1,22,64,31,33
050,29,203,"Missouri","Shannon County",1,23,62,32,30
050,29,203,"Missouri","Shannon County",1,24,64,34,30
050,29,203,"Missouri","Shannon County",1,25,70,31,39
050,29,203,"Missouri","Shannon County",1,26,79,37,42
050,29,203,"Missouri","Shannon County",1,27,71,34,37
050,29,203,"Missouri","Shannon County",1,28,75,35,40
050,29,203,"Missouri","Shannon County",1,29,83,41,42
050,29,203,"Missouri","Shannon County",1,30,81,45,36
050,29,203,"Missouri","Shannon County",1,31,81,48,33
050,29,203,"Missouri","Shannon County",1,32,76,41,35
050,29,203,"Missouri","Shannon County",1,33,74,40,34
050,29,203,"Missouri","Shannon County",1,34,74,39,35
050,29,203,"Missouri","Shannon County",1,35,75,41,34
050,29,203,"Missouri","Shannon County",1,36,72,42,30
050,29,203,"Missouri","Shannon County",1,37,74,40,34
050,29,203,"Missouri","Shannon County",1,38,67,34,33
050,29,203,"Missouri","Shannon County",1,39,75,41,34
050,29,203,"Missouri","Shannon County",1,40,71,36,35
050,29,203,"Missouri","Shannon County",1,41,66,33,33
050,29,203,"Missouri","Shannon County",1,42,67,40,27
050,29,203,"Missouri","Shannon County",1,43,64,35,29
050,29,203,"Missouri","Shannon County",1,44,74,37,37
050,29,203,"Missouri","Shannon County",1,45,69,35,34
050,29,203,"Missouri","Shannon County",1,46,72,34,38
050,29,203,"Missouri","Shannon County",1,47,83,43,40
050,29,203,"Missouri","Shannon County",1,48,84,43,41
050,29,203,"Missouri","Shannon County",1,49,86,43,43
050,29,203,"Missouri","Shannon County",1,50,93,53,40
050,29,203,"Missouri","Shannon County",1,51,77,38,39
050,29,203,"Missouri","Shannon County",1,52,91,49,42
050,29,203,"Missouri","Shannon County",1,53,92,49,43
050,29,203,"Missouri","Shannon County",1,54,95,53,42
050,29,203,"Missouri","Shannon County",1,55,98,43,55
050,29,203,"Missouri","Shannon County",1,56,116,56,60
050,29,203,"Missouri","Shannon County",1,57,119,65,54
050,29,203,"Missouri","Shannon County",1,58,116,62,54
050,29,203,"Missouri","Shannon County",1,59,125,63,62
050,29,203,"Missouri","Shannon County",1,60,120,56,64
050,29,203,"Missouri","Shannon County",1,61,120,57,63
050,29,203,"Missouri","Shannon County",1,62,112,62,50
050,29,203,"Missouri","Shannon County",1,63,115,58,57
050,29,203,"Missouri","Shannon County",1,64,116,53,63
050,29,203,"Missouri","Shannon County",1,65,115,57,58
050,29,203,"Missouri","Shannon County",1,66,96,52,44
050,29,203,"Missouri","Shannon County",1,67,89,46,43
050,29,203,"Missouri","Shannon County",1,68,101,48,53
050,29,203,"Missouri","Shannon County",1,69,81,37,44
050,29,203,"Missouri","Shannon County",1,70,95,49,46
050,29,203,"Missouri","Shannon County",1,71,88,39,49
050,29,203,"Missouri","Shannon County",1,72,94,50,44
050,29,203,"Missouri","Shannon County",1,73,90,50,40
050,29,203,"Missouri","Shannon County",1,74,65,31,34
050,29,203,"Missouri","Shannon County",1,75,67,30,37
050,29,203,"Missouri","Shannon County",1,76,73,40,33
050,29,203,"Missouri","Shannon County",1,77,68,36,32
050,29,203,"Missouri","Shannon County",1,78,61,26,35
050,29,203,"Missouri","Shannon County",1,79,60,28,32
050,29,203,"Missouri","Shannon County",1,80,50,24,26
050,29,203,"Missouri","Shannon County",1,81,47,18,29
050,29,203,"Missouri","Shannon County",1,82,40,17,23
050,29,203,"Missouri","Shannon County",1,83,40,16,24
050,29,203,"Missouri","Shannon County",1,84,24,6,18
050,29,203,"Missouri","Shannon County",1,85,139,40,99
050,29,203,"Missouri","Shannon County",2,0,70,35,35
050,29,203,"Missouri","Shannon County",2,1,76,40,36
050,29,203,"Missouri","Shannon County",2,2,84,40,44
050,29,203,"Missouri","Shannon County",2,3,79,35,44
050,29,203,"Missouri","Shannon County",2,4,76,35,41
050,29,203,"Missouri","Shannon County",2,5,73,41,32
050,29,203,"Missouri","Shannon County",2,6,78,42,36
050,29,203,"Missouri","Shannon County",2,7,82,42,40
050,29,203,"Missouri","Shannon County",2,8,85,43,42
050,29,203,"Missouri","Shannon County",2,9,92,45,47
050,29,203,"Missouri","Shannon County",2,10,86,41,45
050,29,203,"Missouri","Shannon County",2,11,93,47,46
050,29,203,"Missouri","Shannon County",2,12,102,55,47
050,29,203,"Missouri","Shannon County",2,13,94,54,40
050,29,203,"Missouri","Shannon County",2,14,99,56,43
050,29,203,"Missouri","Shannon County",2,15,97,52,45
050,29,203,"Missouri","Shannon County",2,16,85,46,39
050,29,203,"Missouri","Shannon County",2,17,78,45,33
050,29,203,"Missouri","Shannon County",2,18,68,39,29
050,29,203,"Missouri","Shannon County",2,19,57,27,30
050,29,203,"Missouri","Shannon County",2,20,61,28,33
050,29,203,"Missouri","Shannon County",2,21,64,32,32
050,29,203,"Missouri","Shannon County",2,22,65,31,34
050,29,203,"Missouri","Shannon County",2,23,63,32,31
050,29,203,"Missouri","Shannon County",2,24,64,34,30
050,29,203,"Missouri","Shannon County",2,25,69,32,37
050,29,203,"Missouri","Shannon County",2,26,77,35,42
050,29,203,"Missouri","Shannon County",2,27,72,34,38
050,29,203,"Missouri","Shannon County",2,28,74,35,39
050,29,203,"Missouri","Shannon County",2,29,82,40,42
050,29,203,"Missouri","Shannon County",2,30,84,46,38
050,29,203,"Missouri","Shannon County",2,31,81,46,35
050,29,203,"Missouri","Shannon County",2,32,75,42,33
050,29,203,"Missouri","Shannon County",2,33,75,41,34
050,29,203,"Missouri","Shannon County",2,34,76,40,36
050,29,203,"Missouri","Shannon County",2,35,75,41,34
050,29,203,"Missouri","Shannon County",2,36,73,42,31
050,29,203,"Missouri","Shannon County",2,37,74,41,33
050,29,203,"Missouri","Shannon County",2,38,68,35,33
050,29,203,"Missouri","Shannon County",2,39,74,40,34
050,29,203,"Missouri","Shannon County",2,40,73,38,35
050,29,203,"Missouri","Shannon County",2,41,69,34,35
050,29,203,"Missouri","Shannon County",2,42,68,39,29
050,29,203,"Missouri","Shannon County",2,43,67,38,29
050,29,203,"Missouri","Shannon County",2,44,71,36,35
050,29,203,"Missouri","Shannon County",2,45,71,36,35
050,29,203,"Missouri","Shannon County",2,46,72,34,38
050,29,203,"Missouri","Shannon County",2,47,82,42,40
050,29,203,"Missouri","Shannon County",2,48,84,43,41
050,29,203,"Missouri","Shannon County",2,49,85,42,43
050,29,203,"Missouri","Shannon County",2,50,91,50,41
050,29,203,"Missouri","Shannon County",2,51,82,42,40
050,29,203,"Missouri","Shannon County",2,52,86,45,41
050,29,203,"Missouri","Shannon County",2,53,92,49,43
050,29,203,"Missouri","Shannon County",2,54,95,53,42
050,29,203,"Missouri","Shannon County",2,55,96,43,53
050,29,203,"Missouri","Shannon County",2,56,112,53,59
050,29,203,"Missouri","Shannon County",2,57,118,63,55
050,29,203,"Missouri","Shannon County",2,58,117,63,54
050,29,203,"Missouri","Shannon County",2,59,123,63,60
050,29,203,"Missouri","Shannon County",2,60,120,57,63
050,29,203,"Missouri","Shannon County",2,61,118,55,63
050,29,203,"Missouri","Shannon County",2,62,112,60,52
050,29,203,"Missouri","Shannon County",2,63,115,59,56
050,29,203,"Missouri","Shannon County",2,64,115,54,61
050,29,203,"Missouri","Shannon County",2,65,114,56,58
050,29,203,"Missouri","Shannon County",2,66,99,52,47
050,29,203,"Missouri","Shannon County",2,67,90,47,43
050,29,203,"Missouri","Shannon County",2,68,98,47,51
050,29,203,"Missouri","Shannon County",2,69,86,40,46
050,29,203,"Missouri","Shannon County",2,70,91,45,46
050,29,203,"Missouri","Shannon County",2,71,91,42,49
050,29,203,"Missouri","Shannon County",2,72,91,46,45
050,29,203,"Missouri","Shannon County",2,73,95,53,42
050,29,203,"Missouri","Shannon County",2,74,66,33,33
050,29,203,"Missouri","Shannon County",2,75,66,31,35
050,29,203,"Missouri","Shannon County",2,76,72,38,34
050,29,203,"Missouri","Shannon County",2,77,70,38,32
050,29,203,"Missouri","Shannon County",2,78,60,28,32
050,29,203,"Missouri","Shannon County",2,79,59,28,31
050,29,203,"Missouri","Shannon County",2,80,53,25,28
050,29,203,"Missouri","Shannon County",2,81,47,19,28
050,29,203,"Missouri","Shannon County",2,82,38,15,23
050,29,203,"Missouri","Shannon County",2,83,39,15,24
050,29,203,"Missouri","Shannon County",2,84,26,7,19
050,29,203,"Missouri","Shannon County",2,85,143,41,102
050,29,203,"Missouri","Shannon County",3,0,88,50,38
050,29,203,"Missouri","Shannon County",3,1,63,28,35
050,29,203,"Missouri","Shannon County",3,2,80,39,41
050,29,203,"Missouri","Shannon County",3,3,89,43,46
050,29,203,"Missouri","Shannon County",3,4,83,34,49
050,29,203,"Missouri","Shannon County",3,5,78,38,40
050,29,203,"Missouri","Shannon County",3,6,90,45,45
050,29,203,"Missouri","Shannon County",3,7,79,41,38
050,29,203,"Missouri","Shannon County",3,8,88,45,43
050,29,203,"Missouri","Shannon County",3,9,86,42,44
050,29,203,"Missouri","Shannon County",3,10,89,43,46
050,29,203,"Missouri","Shannon County",3,11,88,40,48
050,29,203,"Missouri","Shannon County",3,12,97,49,48
050,29,203,"Missouri","Shannon County",3,13,102,54,48
050,29,203,"Missouri","Shannon County",3,14,97,54,43
050,29,203,"Missouri","Shannon County",3,15,98,58,40
050,29,203,"Missouri","Shannon County",3,16,97,51,46
050,29,203,"Missouri","Shannon County",3,17,89,46,43
050,29,203,"Missouri","Shannon County",3,18,69,43,26
050,29,203,"Missouri","Shannon County",3,19,52,30,22
050,29,203,"Missouri","Shannon County",3,20,60,27,33
050,29,203,"Missouri","Shannon County",3,21,61,30,31
050,29,203,"Missouri","Shannon County",3,22,72,34,38
050,29,203,"Missouri","Shannon County",3,23,56,28,28
050,29,203,"Missouri","Shannon County",3,24,63,34,29
050,29,203,"Missouri","Shannon County",3,25,60,30,30
050,29,203,"Missouri","Shannon County",3,26,69,32,37
050,29,203,"Missouri","Shannon County",3,27,79,35,44
050,29,203,"Missouri","Shannon County",3,28,76,38,38
050,29,203,"Missouri","Shannon County",3,29,74,38,36
050,29,203,"Missouri","Shannon County",3,30,80,40,40
050,29,203,"Missouri","Shannon County",3,31,84,43,41
050,29,203,"Missouri","Shannon County",3,32,85,48,37
050,29,203,"Missouri","Shannon County",3,33,74,41,33
050,29,203,"Missouri","Shannon County",3,34,86,47,39
050,29,203,"Missouri","Shannon County",3,35,77,42,35
050,29,203,"Missouri","Shannon County",3,36,79,41,38
050,29,203,"Missouri","Shannon County",3,37,74,42,32
050,29,203,"Missouri","Shannon County",3,38,76,44,32
050,29,203,"Missouri","Shannon County",3,39,76,39,37
050,29,203,"Missouri","Shannon County",3,40,79,41,38
050,29,203,"Missouri","Shannon County",3,41,78,39,39
050,29,203,"Missouri","Shannon County",3,42,68,34,34
050,29,203,"Missouri","Shannon County",3,43,67,35,32
050,29,203,"Missouri","Shannon County",3,44,66,35,31
050,29,203,"Missouri","Shannon County",3,45,76,39,37
050,29,203,"Missouri","Shannon County",3,46,72,37,35
050,29,203,"Missouri","Shannon County",3,47,72,37,35
050,29,203,"Missouri","Shannon County",3,48,85,44,41
050,29,203,"Missouri","Shannon County",3,49,85,42,43
050,29,203,"Missouri","Shannon County",3,50,84,42,42
050,29,203,"Missouri","Shannon County",3,51,95,54,41
050,29,203,"Missouri","Shannon County",3,52,85,44,41
050,29,203,"Missouri","Shannon County",3,53,89,46,43
050,29,203,"Missouri","Shannon County",3,54,98,57,41
050,29,203,"Missouri","Shannon County",3,55,91,48,43
050,29,203,"Missouri","Shannon County",3,56,94,45,49
050,29,203,"Missouri","Shannon County",3,57,109,50,59
050,29,203,"Missouri","Shannon County",3,58,119,63,56
050,29,203,"Missouri","Shannon County",3,59,115,62,53
050,29,203,"Missouri","Shannon County",3,60,122,63,59
050,29,203,"Missouri","Shannon County",3,61,119,58,61
050,29,203,"Missouri","Shannon County",3,62,121,53,68
050,29,203,"Missouri","Shannon County",3,63,112,62,50
050,29,203,"Missouri","Shannon County",3,64,119,58,61
050,29,203,"Missouri","Shannon County",3,65,117,57,60
050,29,203,"Missouri","Shannon County",3,66,109,53,56
050,29,203,"Missouri","Shannon County",3,67,99,51,48
050,29,203,"Missouri","Shannon County",3,68,90,47,43
050,29,203,"Missouri","Shannon County",3,69,93,45,48
050,29,203,"Missouri","Shannon County",3,70,89,44,45
050,29,203,"Missouri","Shannon County",3,71,90,48,42
050,29,203,"Missouri","Shannon County",3,72,95,44,51
050,29,203,"Missouri","Shannon County",3,73,88,47,41
050,29,203,"Missouri","Shannon County",3,74,86,47,39
050,29,203,"Missouri","Shannon County",3,75,63,31,32
050,29,203,"Missouri","Shannon County",3,76,64,33,31
050,29,203,"Missouri","Shannon County",3,77,66,33,33
050,29,203,"Missouri","Shannon County",3,78,59,33,26
050,29,203,"Missouri","Shannon County",3,79,58,29,29
050,29,203,"Missouri","Shannon County",3,80,52,23,29
050,29,203,"Missouri","Shannon County",3,81,54,23,31
050,29,203,"Missouri","Shannon County",3,82,36,15,21
050,29,203,"Missouri","Shannon County",3,83,37,14,23
050,29,203,"Missouri","Shannon County",3,84,35,13,22
050,29,203,"Missouri","Shannon County",3,85,127,38,89
050,29,203,"Missouri","Shannon County",4,0,84,52,32
050,29,203,"Missouri","Shannon County",4,1,92,52,40
050,29,203,"Missouri","Shannon County",4,2,64,28,36
050,29,203,"Missouri","Shannon County",4,3,87,45,42
050,29,203,"Missouri","Shannon County",4,4,95,47,48
050,29,203,"Missouri","Shannon County",4,5,94,41,53
050,29,203,"Missouri","Shannon County",4,6,83,39,44
050,29,203,"Missouri","Shannon County",4,7,97,49,48
050,29,203,"Missouri","Shannon County",4,8,84,43,41
050,29,203,"Missouri","Shannon County",4,9,95,51,44
050,29,203,"Missouri","Shannon County",4,10,88,45,43
050,29,203,"Missouri","Shannon County",4,11,94,43,51
050,29,203,"Missouri","Shannon County",4,12,94,43,51
050,29,203,"Missouri","Shannon County",4,13,100,50,50
050,29,203,"Missouri","Shannon County",4,14,93,47,46
050,29,203,"Missouri","Shannon County",4,15,93,54,39
050,29,203,"Missouri","Shannon County",4,16,100,57,43
050,29,203,"Missouri","Shannon County",4,17,98,51,47
050,29,203,"Missouri","Shannon County",4,18,81,43,38
050,29,203,"Missouri","Shannon County",4,19,53,32,21
050,29,203,"Missouri","Shannon County",4,20,55,33,22
050,29,203,"Missouri","Shannon County",4,21,56,25,31
050,29,203,"Missouri","Shannon County",4,22,65,29,36
050,29,203,"Missouri","Shannon County",4,23,71,35,36
050,29,203,"Missouri","Shannon County",4,24,58,28,30
050,29,203,"Missouri","Shannon County",4,25,64,34,30
050,29,203,"Missouri","Shannon County",4,26,65,33,32
050,29,203,"Missouri","Shannon County",4,27,75,35,40
050,29,203,"Missouri","Shannon County",4,28,76,37,39
050,29,203,"Missouri","Shannon County",4,29,74,34,40
050,29,203,"Missouri","Shannon County",4,30,79,41,38
050,29,203,"Missouri","Shannon County",4,31,82,41,41
050,29,203,"Missouri","Shannon County",4,32,93,47,46
050,29,203,"Missouri","Shannon County",4,33,85,45,40
050,29,203,"Missouri","Shannon County",4,34,82,46,36
050,29,203,"Missouri","Shannon County",4,35,88,50,38
050,29,203,"Missouri","Shannon County",4,36,78,43,35
050,29,203,"Missouri","Shannon County",4,37,78,41,37
050,29,203,"Missouri","Shannon County",4,38,78,46,32
050,29,203,"Missouri","Shannon County",4,39,72,39,33
050,29,203,"Missouri","Shannon County",4,40,76,38,38
050,29,203,"Missouri","Shannon County",4,41,76,39,37
050,29,203,"Missouri","Shannon County",4,42,78,39,39
050,29,203,"Missouri","Shannon County",4,43,69,32,37
050,29,203,"Missouri","Shannon County",4,44,70,39,31
050,29,203,"Missouri","Shannon County",4,45,67,36,31
050,29,203,"Missouri","Shannon County",4,46,86,44,42
050,29,203,"Missouri","Shannon County",4,47,79,40,39
050,29,203,"Missouri","Shannon County",4,48,69,34,35
050,29,203,"Missouri","Shannon County",4,49,86,45,41
050,29,203,"Missouri","Shannon County",4,50,86,41,45
050,29,203,"Missouri","Shannon County",4,51,81,41,40
050,29,203,"Missouri","Shannon County",4,52,98,54,44
050,29,203,"Missouri","Shannon County",4,53,92,48,44
050,29,203,"Missouri","Shannon County",4,54,94,50,44
050,29,203,"Missouri","Shannon County",4,55,91,50,41
050,29,203,"Missouri","Shannon County",4,56,95,51,44
050,29,203,"Missouri","Shannon County",4,57,97,48,49
050,29,203,"Missouri","Shannon County",4,58,112,51,61
050,29,203,"Missouri","Shannon County",4,59,123,66,57
050,29,203,"Missouri","Shannon County",4,60,118,62,56
050,29,203,"Missouri","Shannon County",4,61,125,65,60
050,29,203,"Missouri","Shannon County",4,62,122,60,62
050,29,203,"Missouri","Shannon County",4,63,122,51,71
050,29,203,"Missouri","Shannon County",4,64,109,57,52
050,29,203,"Missouri","Shannon County",4,65,116,57,59
050,29,203,"Missouri","Shannon County",4,66,116,60,56
050,29,203,"Missouri","Shannon County",4,67,109,53,56
050,29,203,"Missouri","Shannon County",4,68,100,51,49
050,29,203,"Missouri","Shannon County",4,69,88,45,43
050,29,203,"Missouri","Shannon County",4,70,90,45,45
050,29,203,"Missouri","Shannon County",4,71,90,42,48
050,29,203,"Missouri","Shannon County",4,72,90,48,42
050,29,203,"Missouri","Shannon County",4,73,92,45,47
050,29,203,"Missouri","Shannon County",4,74,85,46,39
050,29,203,"Missouri","Shannon County",4,75,87,48,39
050,29,203,"Missouri","Shannon County",4,76,64,33,31
050,29,203,"Missouri","Shannon County",4,77,61,31,30
050,29,203,"Missouri","Shannon County",4,78,54,25,29
050,29,203,"Missouri","Shannon County",4,79,59,34,25
050,29,203,"Missouri","Shannon County",4,80,57,28,29
050,29,203,"Missouri","Shannon County",4,81,53,24,29
050,29,203,"Missouri","Shannon County",4,82,46,22,24
050,29,203,"Missouri","Shannon County",4,83,32,10,22
050,29,203,"Missouri","Shannon County",4,84,34,11,23
050,29,203,"Missouri","Shannon County",4,85,129,37,92
050,29,203,"Missouri","Shannon County",5,0,85,52,33
050,29,203,"Missouri","Shannon County",5,1,86,55,31
050,29,203,"Missouri","Shannon County",5,2,95,54,41
050,29,203,"Missouri","Shannon County",5,3,69,34,35
050,29,203,"Missouri","Shannon County",5,4,93,46,47
050,29,203,"Missouri","Shannon County",5,5,96,49,47
050,29,203,"Missouri","Shannon County",5,6,96,43,53
050,29,203,"Missouri","Shannon County",5,7,83,42,41
050,29,203,"Missouri","Shannon County",5,8,97,48,49
050,29,203,"Missouri","Shannon County",5,9,84,42,42
050,29,203,"Missouri","Shannon County",5,10,94,51,43
050,29,203,"Missouri","Shannon County",5,11,83,47,36
050,29,203,"Missouri","Shannon County",5,12,93,44,49
050,29,203,"Missouri","Shannon County",5,13,93,39,54
050,29,203,"Missouri","Shannon County",5,14,106,57,49
050,29,203,"Missouri","Shannon County",5,15,94,46,48
050,29,203,"Missouri","Shannon County",5,16,98,56,42
050,29,203,"Missouri","Shannon County",5,17,103,60,43
050,29,203,"Missouri","Shannon County",5,18,81,44,37
050,29,203,"Missouri","Shannon County",5,19,56,29,27
050,29,203,"Missouri","Shannon County",5,20,52,29,23
050,29,203,"Missouri","Shannon County",5,21,58,34,24
050,29,203,"Missouri","Shannon County",5,22,60,27,33
050,29,203,"Missouri","Shannon County",5,23,63,28,35
050,29,203,"Missouri","Shannon County",5,24,64,33,31
050,29,203,"Missouri","Shannon County",5,25,60,31,29
050,29,203,"Missouri","Shannon County",5,26,65,32,33
050,29,203,"Missouri","Shannon County",5,27,75,38,37
050,29,203,"Missouri","Shannon County",5,28,78,37,41
050,29,203,"Missouri","Shannon County",5,29,70,36,34
050,29,203,"Missouri","Shannon County",5,30,71,35,36
050,29,203,"Missouri","Shannon County",5,31,83,39,44
050,29,203,"Missouri","Shannon County",5,32,82,41,41
050,29,203,"Missouri","Shannon County",5,33,92,47,45
050,29,203,"Missouri","Shannon County",5,34,91,47,44
050,29,203,"Missouri","Shannon County",5,35,85,47,38
050,29,203,"Missouri","Shannon County",5,36,90,47,43
050,29,203,"Missouri","Shannon County",5,37,80,44,36
050,29,203,"Missouri","Shannon County",5,38,77,42,35
050,29,203,"Missouri","Shannon County",5,39,74,43,31
050,29,203,"Missouri","Shannon County",5,40,73,39,34
050,29,203,"Missouri","Shannon County",5,41,70,34,36
050,29,203,"Missouri","Shannon County",5,42,82,40,42
050,29,203,"Missouri","Shannon County",5,43,79,39,40
050,29,203,"Missouri","Shannon County",5,44,70,30,40
050,29,203,"Missouri","Shannon County",5,45,75,45,30
050,29,203,"Missouri","Shannon County",5,46,70,40,30
050,29,203,"Missouri","Shannon County",5,47,79,38,41
050,29,203,"Missouri","Shannon County",5,48,78,37,41
050,29,203,"Missouri","Shannon County",5,49,75,37,38
050,29,203,"Missouri","Shannon County",5,50,85,44,41
050,29,203,"Missouri","Shannon County",5,51,80,39,41
050,29,203,"Missouri","Shannon County",5,52,86,44,42
050,29,203,"Missouri","Shannon County",5,53,100,51,49
050,29,203,"Missouri","Shannon County",5,54,92,50,42
050,29,203,"Missouri","Shannon County",5,55,91,49,42
050,29,203,"Missouri","Shannon County",5,56,90,49,41
050,29,203,"Missouri","Shannon County",5,57,95,52,43
050,29,203,"Missouri","Shannon County",5,58,101,48,53
050,29,203,"Missouri","Shannon County",5,59,108,49,59
050,29,203,"Missouri","Shannon County",5,60,123,66,57
050,29,203,"Missouri","Shannon County",5,61,118,61,57
050,29,203,"Missouri","Shannon County",5,62,123,63,60
050,29,203,"Missouri","Shannon County",5,63,124,63,61
050,29,203,"Missouri","Shannon County",5,64,125,52,73
050,29,203,"Missouri","Shannon County",5,65,110,61,49
050,29,203,"Missouri","Shannon County",5,66,114,59,55
050,29,203,"Missouri","Shannon County",5,67,115,59,56
050,29,203,"Missouri","Shannon County",5,68,106,48,58
050,29,203,"Missouri","Shannon County",5,69,96,49,47
050,29,203,"Missouri","Shannon County",5,70,89,46,43
050,29,203,"Missouri","Shannon County",5,71,91,43,48
050,29,203,"Missouri","Shannon County",5,72,87,40,47
050,29,203,"Missouri","Shannon County",5,73,87,45,42
050,29,203,"Missouri","Shannon County",5,74,91,44,47
050,29,203,"Missouri","Shannon County",5,75,85,45,40
050,29,203,"Missouri","Shannon County",5,76,86,50,36
050,29,203,"Missouri","Shannon County",5,77,60,30,30
050,29,203,"Missouri","Shannon County",5,78,54,27,27
050,29,203,"Missouri","Shannon County",5,79,55,26,29
050,29,203,"Missouri","Shannon County",5,80,54,30,24
050,29,203,"Missouri","Shannon County",5,81,58,28,30
050,29,203,"Missouri","Shannon County",5,82,46,22,24
050,29,203,"Missouri","Shannon County",5,83,44,17,27
050,29,203,"Missouri","Shannon County",5,84,29,7,22
050,29,203,"Missouri","Shannon County",5,85,134,39,95
050,29,205,"Missouri","Shelby County",1,0,74,38,36
050,29,205,"Missouri","Shelby County",1,1,80,40,40
050,29,205,"Missouri","Shelby County",1,2,80,42,38
050,29,205,"Missouri","Shelby County",1,3,84,37,47
050,29,205,"Missouri","Shelby County",1,4,73,40,33
050,29,205,"Missouri","Shelby County",1,5,77,42,35
050,29,205,"Missouri","Shelby County",1,6,69,37,32
050,29,205,"Missouri","Shelby County",1,7,65,27,38
050,29,205,"Missouri","Shelby County",1,8,85,40,45
050,29,205,"Missouri","Shelby County",1,9,80,38,42
050,29,205,"Missouri","Shelby County",1,10,86,53,33
050,29,205,"Missouri","Shelby County",1,11,106,61,45
050,29,205,"Missouri","Shelby County",1,12,95,50,45
050,29,205,"Missouri","Shelby County",1,13,92,54,38
050,29,205,"Missouri","Shelby County",1,14,100,58,42
050,29,205,"Missouri","Shelby County",1,15,88,51,37
050,29,205,"Missouri","Shelby County",1,16,83,47,36
050,29,205,"Missouri","Shelby County",1,17,83,48,35
050,29,205,"Missouri","Shelby County",1,18,71,35,36
050,29,205,"Missouri","Shelby County",1,19,62,29,33
050,29,205,"Missouri","Shelby County",1,20,58,29,29
050,29,205,"Missouri","Shelby County",1,21,51,27,24
050,29,205,"Missouri","Shelby County",1,22,61,32,29
050,29,205,"Missouri","Shelby County",1,23,51,22,29
050,29,205,"Missouri","Shelby County",1,24,69,33,36
050,29,205,"Missouri","Shelby County",1,25,74,42,32
050,29,205,"Missouri","Shelby County",1,26,55,29,26
050,29,205,"Missouri","Shelby County",1,27,63,25,38
050,29,205,"Missouri","Shelby County",1,28,56,24,32
050,29,205,"Missouri","Shelby County",1,29,57,25,32
050,29,205,"Missouri","Shelby County",1,30,59,31,28
050,29,205,"Missouri","Shelby County",1,31,62,28,34
050,29,205,"Missouri","Shelby County",1,32,59,31,28
050,29,205,"Missouri","Shelby County",1,33,57,33,24
050,29,205,"Missouri","Shelby County",1,34,62,29,33
050,29,205,"Missouri","Shelby County",1,35,69,34,35
050,29,205,"Missouri","Shelby County",1,36,72,36,36
050,29,205,"Missouri","Shelby County",1,37,78,39,39
050,29,205,"Missouri","Shelby County",1,38,78,41,37
050,29,205,"Missouri","Shelby County",1,39,74,34,40
050,29,205,"Missouri","Shelby County",1,40,93,48,45
050,29,205,"Missouri","Shelby County",1,41,80,48,32
050,29,205,"Missouri","Shelby County",1,42,71,42,29
050,29,205,"Missouri","Shelby County",1,43,65,36,29
050,29,205,"Missouri","Shelby County",1,44,60,35,25
050,29,205,"Missouri","Shelby County",1,45,71,35,36
050,29,205,"Missouri","Shelby County",1,46,63,30,33
050,29,205,"Missouri","Shelby County",1,47,51,25,26
050,29,205,"Missouri","Shelby County",1,48,51,29,22
050,29,205,"Missouri","Shelby County",1,49,61,29,32
050,29,205,"Missouri","Shelby County",1,50,57,32,25
050,29,205,"Missouri","Shelby County",1,51,65,34,31
050,29,205,"Missouri","Shelby County",1,52,56,29,27
050,29,205,"Missouri","Shelby County",1,53,59,30,29
050,29,205,"Missouri","Shelby County",1,54,74,29,45
050,29,205,"Missouri","Shelby County",1,55,86,38,48
050,29,205,"Missouri","Shelby County",1,56,96,44,52
050,29,205,"Missouri","Shelby County",1,57,94,52,42
050,29,205,"Missouri","Shelby County",1,58,97,57,40
050,29,205,"Missouri","Shelby County",1,59,97,56,41
050,29,205,"Missouri","Shelby County",1,60,98,57,41
050,29,205,"Missouri","Shelby County",1,61,88,46,42
050,29,205,"Missouri","Shelby County",1,62,87,42,45
050,29,205,"Missouri","Shelby County",1,63,85,40,45
050,29,205,"Missouri","Shelby County",1,64,86,45,41
050,29,205,"Missouri","Shelby County",1,65,89,43,46
050,29,205,"Missouri","Shelby County",1,66,83,45,38
050,29,205,"Missouri","Shelby County",1,67,85,47,38
050,29,205,"Missouri","Shelby County",1,68,95,51,44
050,29,205,"Missouri","Shelby County",1,69,78,44,34
050,29,205,"Missouri","Shelby County",1,70,71,40,31
050,29,205,"Missouri","Shelby County",1,71,57,26,31
050,29,205,"Missouri","Shelby County",1,72,56,26,30
050,29,205,"Missouri","Shelby County",1,73,61,30,31
050,29,205,"Missouri","Shelby County",1,74,52,23,29
050,29,205,"Missouri","Shelby County",1,75,53,24,29
050,29,205,"Missouri","Shelby County",1,76,51,22,29
050,29,205,"Missouri","Shelby County",1,77,51,21,30
050,29,205,"Missouri","Shelby County",1,78,47,22,25
050,29,205,"Missouri","Shelby County",1,79,41,19,22
050,29,205,"Missouri","Shelby County",1,80,44,19,25
050,29,205,"Missouri","Shelby County",1,81,37,17,20
050,29,205,"Missouri","Shelby County",1,82,35,16,19
050,29,205,"Missouri","Shelby County",1,83,26,11,15
050,29,205,"Missouri","Shelby County",1,84,25,11,14
050,29,205,"Missouri","Shelby County",1,85,176,56,120
050,29,205,"Missouri","Shelby County",2,0,72,33,39
050,29,205,"Missouri","Shelby County",2,1,78,40,38
050,29,205,"Missouri","Shelby County",2,2,79,40,39
050,29,205,"Missouri","Shelby County",2,3,82,37,45
050,29,205,"Missouri","Shelby County",2,4,75,39,36
050,29,205,"Missouri","Shelby County",2,5,76,41,35
050,29,205,"Missouri","Shelby County",2,6,70,37,33
050,29,205,"Missouri","Shelby County",2,7,67,29,38
050,29,205,"Missouri","Shelby County",2,8,81,37,44
050,29,205,"Missouri","Shelby County",2,9,83,39,44
050,29,205,"Missouri","Shelby County",2,10,85,51,34
050,29,205,"Missouri","Shelby County",2,11,103,60,43
050,29,205,"Missouri","Shelby County",2,12,98,53,45
050,29,205,"Missouri","Shelby County",2,13,90,52,38
050,29,205,"Missouri","Shelby County",2,14,98,57,41
050,29,205,"Missouri","Shelby County",2,15,90,51,39
050,29,205,"Missouri","Shelby County",2,16,85,47,38
050,29,205,"Missouri","Shelby County",2,17,81,47,34
050,29,205,"Missouri","Shelby County",2,18,71,37,34
050,29,205,"Missouri","Shelby County",2,19,63,30,33
050,29,205,"Missouri","Shelby County",2,20,59,30,29
050,29,205,"Missouri","Shelby County",2,21,52,28,24
050,29,205,"Missouri","Shelby County",2,22,58,30,28
050,29,205,"Missouri","Shelby County",2,23,53,24,29
050,29,205,"Missouri","Shelby County",2,24,66,31,35
050,29,205,"Missouri","Shelby County",2,25,71,39,32
050,29,205,"Missouri","Shelby County",2,26,59,32,27
050,29,205,"Missouri","Shelby County",2,27,61,26,35
050,29,205,"Missouri","Shelby County",2,28,57,24,33
050,29,205,"Missouri","Shelby County",2,29,57,25,32
050,29,205,"Missouri","Shelby County",2,30,59,30,29
050,29,205,"Missouri","Shelby County",2,31,61,29,32
050,29,205,"Missouri","Shelby County",2,32,61,31,30
050,29,205,"Missouri","Shelby County",2,33,57,32,25
050,29,205,"Missouri","Shelby County",2,34,61,29,32
050,29,205,"Missouri","Shelby County",2,35,67,33,34
050,29,205,"Missouri","Shelby County",2,36,70,35,35
050,29,205,"Missouri","Shelby County",2,37,76,38,38
050,29,205,"Missouri","Shelby County",2,38,79,41,38
050,29,205,"Missouri","Shelby County",2,39,75,36,39
050,29,205,"Missouri","Shelby County",2,40,89,45,44
050,29,205,"Missouri","Shelby County",2,41,82,47,35
050,29,205,"Missouri","Shelby County",2,42,74,45,29
050,29,205,"Missouri","Shelby County",2,43,68,38,30
050,29,205,"Missouri","Shelby County",2,44,61,34,27
050,29,205,"Missouri","Shelby County",2,45,70,35,35
050,29,205,"Missouri","Shelby County",2,46,64,31,33
050,29,205,"Missouri","Shelby County",2,47,53,26,27
050,29,205,"Missouri","Shelby County",2,48,51,28,23
050,29,205,"Missouri","Shelby County",2,49,59,30,29
050,29,205,"Missouri","Shelby County",2,50,57,31,26
050,29,205,"Missouri","Shelby County",2,51,64,34,30
050,29,205,"Missouri","Shelby County",2,52,58,31,27
050,29,205,"Missouri","Shelby County",2,53,58,29,29
050,29,205,"Missouri","Shelby County",2,54,71,29,42
050,29,205,"Missouri","Shelby County",2,55,82,35,47
050,29,205,"Missouri","Shelby County",2,56,94,43,51
050,29,205,"Missouri","Shelby County",2,57,95,50,45
050,29,205,"Missouri","Shelby County",2,58,96,56,40
050,29,205,"Missouri","Shelby County",2,59,99,57,42
050,29,205,"Missouri","Shelby County",2,60,97,56,41
050,29,205,"Missouri","Shelby County",2,61,91,49,42
050,29,205,"Missouri","Shelby County",2,62,86,43,43
050,29,205,"Missouri","Shelby County",2,63,86,41,45
050,29,205,"Missouri","Shelby County",2,64,85,44,41
050,29,205,"Missouri","Shelby County",2,65,88,44,44
050,29,205,"Missouri","Shelby County",2,66,85,45,40
050,29,205,"Missouri","Shelby County",2,67,85,47,38
050,29,205,"Missouri","Shelby County",2,68,91,49,42
050,29,205,"Missouri","Shelby County",2,69,82,46,36
050,29,205,"Missouri","Shelby County",2,70,71,40,31
050,29,205,"Missouri","Shelby County",2,71,60,29,31
050,29,205,"Missouri","Shelby County",2,72,55,25,30
050,29,205,"Missouri","Shelby County",2,73,62,30,32
050,29,205,"Missouri","Shelby County",2,74,51,23,28
050,29,205,"Missouri","Shelby County",2,75,51,24,27
050,29,205,"Missouri","Shelby County",2,76,49,21,28
050,29,205,"Missouri","Shelby County",2,77,51,22,29
050,29,205,"Missouri","Shelby County",2,78,47,21,26
050,29,205,"Missouri","Shelby County",2,79,42,19,23
050,29,205,"Missouri","Shelby County",2,80,44,19,25
050,29,205,"Missouri","Shelby County",2,81,36,17,19
050,29,205,"Missouri","Shelby County",2,82,36,16,20
050,29,205,"Missouri","Shelby County",2,83,27,12,15
050,29,205,"Missouri","Shelby County",2,84,25,10,15
050,29,205,"Missouri","Shelby County",2,85,173,55,118
050,29,205,"Missouri","Shelby County",3,0,59,26,33
050,29,205,"Missouri","Shelby County",3,1,73,34,39
050,29,205,"Missouri","Shelby County",3,2,81,44,37
050,29,205,"Missouri","Shelby County",3,3,69,33,36
050,29,205,"Missouri","Shelby County",3,4,74,33,41
050,29,205,"Missouri","Shelby County",3,5,82,41,41
050,29,205,"Missouri","Shelby County",3,6,77,42,35
050,29,205,"Missouri","Shelby County",3,7,71,37,34
050,29,205,"Missouri","Shelby County",3,8,72,31,41
050,29,205,"Missouri","Shelby County",3,9,82,33,49
050,29,205,"Missouri","Shelby County",3,10,79,41,38
050,29,205,"Missouri","Shelby County",3,11,90,53,37
050,29,205,"Missouri","Shelby County",3,12,94,54,40
050,29,205,"Missouri","Shelby County",3,13,87,45,42
050,29,205,"Missouri","Shelby County",3,14,94,56,38
050,29,205,"Missouri","Shelby County",3,15,91,52,39
050,29,205,"Missouri","Shelby County",3,16,90,51,39
050,29,205,"Missouri","Shelby County",3,17,83,48,35
050,29,205,"Missouri","Shelby County",3,18,74,44,30
050,29,205,"Missouri","Shelby County",3,19,62,32,30
050,29,205,"Missouri","Shelby County",3,20,62,30,32
050,29,205,"Missouri","Shelby County",3,21,54,29,25
050,29,205,"Missouri","Shelby County",3,22,46,24,22
050,29,205,"Missouri","Shelby County",3,23,48,25,23
050,29,205,"Missouri","Shelby County",3,24,60,26,34
050,29,205,"Missouri","Shelby County",3,25,62,32,30
050,29,205,"Missouri","Shelby County",3,26,72,39,33
050,29,205,"Missouri","Shelby County",3,27,64,33,31
050,29,205,"Missouri","Shelby County",3,28,59,25,34
050,29,205,"Missouri","Shelby County",3,29,62,28,34
050,29,205,"Missouri","Shelby County",3,30,61,27,34
050,29,205,"Missouri","Shelby County",3,31,61,30,31
050,29,205,"Missouri","Shelby County",3,32,64,32,32
050,29,205,"Missouri","Shelby County",3,33,55,27,28
050,29,205,"Missouri","Shelby County",3,34,59,34,25
050,29,205,"Missouri","Shelby County",3,35,60,30,30
050,29,205,"Missouri","Shelby County",3,36,68,32,36
050,29,205,"Missouri","Shelby County",3,37,69,34,35
050,29,205,"Missouri","Shelby County",3,38,75,41,34
050,29,205,"Missouri","Shelby County",3,39,75,39,36
050,29,205,"Missouri","Shelby County",3,40,70,34,36
050,29,205,"Missouri","Shelby County",3,41,83,43,40
050,29,205,"Missouri","Shelby County",3,42,78,45,33
050,29,205,"Missouri","Shelby County",3,43,71,42,29
050,29,205,"Missouri","Shelby County",3,44,61,34,27
050,29,205,"Missouri","Shelby County",3,45,60,33,27
050,29,205,"Missouri","Shelby County",3,46,68,32,36
050,29,205,"Missouri","Shelby County",3,47,67,34,33
050,29,205,"Missouri","Shelby County",3,48,53,27,26
050,29,205,"Missouri","Shelby County",3,49,50,26,24
050,29,205,"Missouri","Shelby County",3,50,60,31,29
050,29,205,"Missouri","Shelby County",3,51,55,29,26
050,29,205,"Missouri","Shelby County",3,52,65,34,31
050,29,205,"Missouri","Shelby County",3,53,53,29,24
050,29,205,"Missouri","Shelby County",3,54,56,27,29
050,29,205,"Missouri","Shelby County",3,55,72,30,42
050,29,205,"Missouri","Shelby County",3,56,80,36,44
050,29,205,"Missouri","Shelby County",3,57,90,41,49
050,29,205,"Missouri","Shelby County",3,58,92,51,41
050,29,205,"Missouri","Shelby County",3,59,98,57,41
050,29,205,"Missouri","Shelby County",3,60,96,54,42
050,29,205,"Missouri","Shelby County",3,61,96,56,40
050,29,205,"Missouri","Shelby County",3,62,87,47,40
050,29,205,"Missouri","Shelby County",3,63,83,40,43
050,29,205,"Missouri","Shelby County",3,64,84,40,44
050,29,205,"Missouri","Shelby County",3,65,79,42,37
050,29,205,"Missouri","Shelby County",3,66,85,41,44
050,29,205,"Missouri","Shelby County",3,67,85,44,41
050,29,205,"Missouri","Shelby County",3,68,83,47,36
050,29,205,"Missouri","Shelby County",3,69,86,47,39
050,29,205,"Missouri","Shelby County",3,70,80,44,36
050,29,205,"Missouri","Shelby County",3,71,70,40,30
050,29,205,"Missouri","Shelby County",3,72,58,29,29
050,29,205,"Missouri","Shelby County",3,73,48,21,27
050,29,205,"Missouri","Shelby County",3,74,59,29,30
050,29,205,"Missouri","Shelby County",3,75,50,23,27
050,29,205,"Missouri","Shelby County",3,76,51,23,28
050,29,205,"Missouri","Shelby County",3,77,45,19,26
050,29,205,"Missouri","Shelby County",3,78,47,22,25
050,29,205,"Missouri","Shelby County",3,79,46,18,28
050,29,205,"Missouri","Shelby County",3,80,43,18,25
050,29,205,"Missouri","Shelby County",3,81,40,21,19
050,29,205,"Missouri","Shelby County",3,82,33,12,21
050,29,205,"Missouri","Shelby County",3,83,34,16,18
050,29,205,"Missouri","Shelby County",3,84,29,12,17
050,29,205,"Missouri","Shelby County",3,85,166,54,112
050,29,205,"Missouri","Shelby County",4,0,65,30,35
050,29,205,"Missouri","Shelby County",4,1,74,37,37
050,29,205,"Missouri","Shelby County",4,2,66,30,36
050,29,205,"Missouri","Shelby County",4,3,84,43,41
050,29,205,"Missouri","Shelby County",4,4,69,37,32
050,29,205,"Missouri","Shelby County",4,5,79,33,46
050,29,205,"Missouri","Shelby County",4,6,80,43,37
050,29,205,"Missouri","Shelby County",4,7,82,47,35
050,29,205,"Missouri","Shelby County",4,8,68,37,31
050,29,205,"Missouri","Shelby County",4,9,78,32,46
050,29,205,"Missouri","Shelby County",4,10,85,41,44
050,29,205,"Missouri","Shelby County",4,11,89,50,39
050,29,205,"Missouri","Shelby County",4,12,84,48,36
050,29,205,"Missouri","Shelby County",4,13,92,53,39
050,29,205,"Missouri","Shelby County",4,14,104,56,48
050,29,205,"Missouri","Shelby County",4,15,94,51,43
050,29,205,"Missouri","Shelby County",4,16,86,49,37
050,29,205,"Missouri","Shelby County",4,17,91,53,38
050,29,205,"Missouri","Shelby County",4,18,78,45,33
050,29,205,"Missouri","Shelby County",4,19,65,36,29
050,29,205,"Missouri","Shelby County",4,20,58,31,27
050,29,205,"Missouri","Shelby County",4,21,61,29,32
050,29,205,"Missouri","Shelby County",4,22,56,30,26
050,29,205,"Missouri","Shelby County",4,23,50,22,28
050,29,205,"Missouri","Shelby County",4,24,57,28,29
050,29,205,"Missouri","Shelby County",4,25,53,25,28
050,29,205,"Missouri","Shelby County",4,26,65,32,33
050,29,205,"Missouri","Shelby County",4,27,76,44,32
050,29,205,"Missouri","Shelby County",4,28,64,33,31
050,29,205,"Missouri","Shelby County",4,29,62,30,32
050,29,205,"Missouri","Shelby County",4,30,66,31,35
050,29,205,"Missouri","Shelby County",4,31,61,28,33
050,29,205,"Missouri","Shelby County",4,32,61,28,33
050,29,205,"Missouri","Shelby County",4,33,64,32,32
050,29,205,"Missouri","Shelby County",4,34,58,31,27
050,29,205,"Missouri","Shelby County",4,35,55,29,26
050,29,205,"Missouri","Shelby County",4,36,57,29,28
050,29,205,"Missouri","Shelby County",4,37,68,30,38
050,29,205,"Missouri","Shelby County",4,38,68,33,35
050,29,205,"Missouri","Shelby County",4,39,75,42,33
050,29,205,"Missouri","Shelby County",4,40,80,40,40
050,29,205,"Missouri","Shelby County",4,41,70,34,36
050,29,205,"Missouri","Shelby County",4,42,83,41,42
050,29,205,"Missouri","Shelby County",4,43,77,45,32
050,29,205,"Missouri","Shelby County",4,44,70,42,28
050,29,205,"Missouri","Shelby County",4,45,62,35,27
050,29,205,"Missouri","Shelby County",4,46,63,32,31
050,29,205,"Missouri","Shelby County",4,47,70,32,38
050,29,205,"Missouri","Shelby County",4,48,64,30,34
050,29,205,"Missouri","Shelby County",4,49,58,28,30
050,29,205,"Missouri","Shelby County",4,50,51,26,25
050,29,205,"Missouri","Shelby County",4,51,62,32,30
050,29,205,"Missouri","Shelby County",4,52,50,28,22
050,29,205,"Missouri","Shelby County",4,53,65,34,31
050,29,205,"Missouri","Shelby County",4,54,50,26,24
050,29,205,"Missouri","Shelby County",4,55,55,26,29
050,29,205,"Missouri","Shelby County",4,56,71,29,42
050,29,205,"Missouri","Shelby County",4,57,82,35,47
050,29,205,"Missouri","Shelby County",4,58,89,41,48
050,29,205,"Missouri","Shelby County",4,59,96,52,44
050,29,205,"Missouri","Shelby County",4,60,91,52,39
050,29,205,"Missouri","Shelby County",4,61,97,56,41
050,29,205,"Missouri","Shelby County",4,62,93,52,41
050,29,205,"Missouri","Shelby County",4,63,86,46,40
050,29,205,"Missouri","Shelby County",4,64,85,43,42
050,29,205,"Missouri","Shelby County",4,65,85,42,43
050,29,205,"Missouri","Shelby County",4,66,76,44,32
050,29,205,"Missouri","Shelby County",4,67,86,39,47
050,29,205,"Missouri","Shelby County",4,68,82,43,39
050,29,205,"Missouri","Shelby County",4,69,79,44,35
050,29,205,"Missouri","Shelby County",4,70,84,46,38
050,29,205,"Missouri","Shelby County",4,71,77,44,33
050,29,205,"Missouri","Shelby County",4,72,70,38,32
050,29,205,"Missouri","Shelby County",4,73,59,28,31
050,29,205,"Missouri","Shelby County",4,74,47,21,26
050,29,205,"Missouri","Shelby County",4,75,57,30,27
050,29,205,"Missouri","Shelby County",4,76,47,23,24
050,29,205,"Missouri","Shelby County",4,77,49,23,26
050,29,205,"Missouri","Shelby County",4,78,40,17,23
050,29,205,"Missouri","Shelby County",4,79,45,17,28
050,29,205,"Missouri","Shelby County",4,80,45,17,28
050,29,205,"Missouri","Shelby County",4,81,36,17,19
050,29,205,"Missouri","Shelby County",4,82,35,15,20
050,29,205,"Missouri","Shelby County",4,83,29,11,18
050,29,205,"Missouri","Shelby County",4,84,32,16,16
050,29,205,"Missouri","Shelby County",4,85,168,58,110
050,29,205,"Missouri","Shelby County",5,0,65,30,35
050,29,205,"Missouri","Shelby County",5,1,64,32,32
050,29,205,"Missouri","Shelby County",5,2,70,33,37
050,29,205,"Missouri","Shelby County",5,3,69,33,36
050,29,205,"Missouri","Shelby County",5,4,85,45,40
050,29,205,"Missouri","Shelby County",5,5,64,33,31
050,29,205,"Missouri","Shelby County",5,6,76,34,42
050,29,205,"Missouri","Shelby County",5,7,80,43,37
050,29,205,"Missouri","Shelby County",5,8,75,41,34
050,29,205,"Missouri","Shelby County",5,9,77,38,39
050,29,205,"Missouri","Shelby County",5,10,81,39,42
050,29,205,"Missouri","Shelby County",5,11,86,40,46
050,29,205,"Missouri","Shelby County",5,12,81,43,38
050,29,205,"Missouri","Shelby County",5,13,76,44,32
050,29,205,"Missouri","Shelby County",5,14,99,57,42
050,29,205,"Missouri","Shelby County",5,15,100,52,48
050,29,205,"Missouri","Shelby County",5,16,96,51,45
050,29,205,"Missouri","Shelby County",5,17,81,49,32
050,29,205,"Missouri","Shelby County",5,18,80,46,34
050,29,205,"Missouri","Shelby County",5,19,64,35,29
050,29,205,"Missouri","Shelby County",5,20,62,35,27
050,29,205,"Missouri","Shelby County",5,21,54,30,24
050,29,205,"Missouri","Shelby County",5,22,56,26,30
050,29,205,"Missouri","Shelby County",5,23,62,31,31
050,29,205,"Missouri","Shelby County",5,24,60,24,36
050,29,205,"Missouri","Shelby County",5,25,56,29,27
050,29,205,"Missouri","Shelby County",5,26,52,28,24
050,29,205,"Missouri","Shelby County",5,27,66,30,36
050,29,205,"Missouri","Shelby County",5,28,75,43,32
050,29,205,"Missouri","Shelby County",5,29,67,36,31
050,29,205,"Missouri","Shelby County",5,30,61,30,31
050,29,205,"Missouri","Shelby County",5,31,65,27,38
050,29,205,"Missouri","Shelby County",5,32,64,30,34
050,29,205,"Missouri","Shelby County",5,33,60,30,30
050,29,205,"Missouri","Shelby County",5,34,68,35,33
050,29,205,"Missouri","Shelby County",5,35,60,32,28
050,29,205,"Missouri","Shelby County",5,36,50,27,23
050,29,205,"Missouri","Shelby County",5,37,59,27,32
050,29,205,"Missouri","Shelby County",5,38,67,31,36
050,29,205,"Missouri","Shelby County",5,39,67,32,35
050,29,205,"Missouri","Shelby County",5,40,71,40,31
050,29,205,"Missouri","Shelby County",5,41,77,40,37
050,29,205,"Missouri","Shelby County",5,42,70,33,37
050,29,205,"Missouri","Shelby County",5,43,75,37,38
050,29,205,"Missouri","Shelby County",5,44,80,45,35
050,29,205,"Missouri","Shelby County",5,45,72,43,29
050,29,205,"Missouri","Shelby County",5,46,67,39,28
050,29,205,"Missouri","Shelby County",5,47,58,29,29
050,29,205,"Missouri","Shelby County",5,48,70,33,37
050,29,205,"Missouri","Shelby County",5,49,65,30,35
050,29,205,"Missouri","Shelby County",5,50,59,28,31
050,29,205,"Missouri","Shelby County",5,51,51,27,24
050,29,205,"Missouri","Shelby County",5,52,59,28,31
050,29,205,"Missouri","Shelby County",5,53,51,29,22
050,29,205,"Missouri","Shelby County",5,54,63,35,28
050,29,205,"Missouri","Shelby County",5,55,51,22,29
050,29,205,"Missouri","Shelby County",5,56,59,27,32
050,29,205,"Missouri","Shelby County",5,57,74,31,43
050,29,205,"Missouri","Shelby County",5,58,76,36,40
050,29,205,"Missouri","Shelby County",5,59,89,42,47
050,29,205,"Missouri","Shelby County",5,60,94,50,44
050,29,205,"Missouri","Shelby County",5,61,92,55,37
050,29,205,"Missouri","Shelby County",5,62,99,58,41
050,29,205,"Missouri","Shelby County",5,63,94,52,42
050,29,205,"Missouri","Shelby County",5,64,90,47,43
050,29,205,"Missouri","Shelby County",5,65,90,45,45
050,29,205,"Missouri","Shelby County",5,66,86,43,43
050,29,205,"Missouri","Shelby County",5,67,74,42,32
050,29,205,"Missouri","Shelby County",5,68,87,42,45
050,29,205,"Missouri","Shelby County",5,69,73,38,35
050,29,205,"Missouri","Shelby County",5,70,77,42,35
050,29,205,"Missouri","Shelby County",5,71,78,42,36
050,29,205,"Missouri","Shelby County",5,72,72,41,31
050,29,205,"Missouri","Shelby County",5,73,65,33,32
050,29,205,"Missouri","Shelby County",5,74,57,27,30
050,29,205,"Missouri","Shelby County",5,75,45,21,24
050,29,205,"Missouri","Shelby County",5,76,51,29,22
050,29,205,"Missouri","Shelby County",5,77,44,22,22
050,29,205,"Missouri","Shelby County",5,78,44,21,23
050,29,205,"Missouri","Shelby County",5,79,38,12,26
050,29,205,"Missouri","Shelby County",5,80,44,16,28
050,29,205,"Missouri","Shelby County",5,81,37,15,22
050,29,205,"Missouri","Shelby County",5,82,30,12,18
050,29,205,"Missouri","Shelby County",5,83,31,14,17
050,29,205,"Missouri","Shelby County",5,84,26,10,16
050,29,205,"Missouri","Shelby County",5,85,176,66,110
050,29,207,"Missouri","Stoddard County",1,0,326,171,155
050,29,207,"Missouri","Stoddard County",1,1,323,169,154
050,29,207,"Missouri","Stoddard County",1,2,332,166,166
050,29,207,"Missouri","Stoddard County",1,3,308,164,144
050,29,207,"Missouri","Stoddard County",1,4,319,182,137
050,29,207,"Missouri","Stoddard County",1,5,358,197,161
050,29,207,"Missouri","Stoddard County",1,6,368,199,169
050,29,207,"Missouri","Stoddard County",1,7,366,185,181
050,29,207,"Missouri","Stoddard County",1,8,339,175,164
050,29,207,"Missouri","Stoddard County",1,9,342,180,162
050,29,207,"Missouri","Stoddard County",1,10,329,152,177
050,29,207,"Missouri","Stoddard County",1,11,369,186,183
050,29,207,"Missouri","Stoddard County",1,12,384,191,193
050,29,207,"Missouri","Stoddard County",1,13,386,200,186
050,29,207,"Missouri","Stoddard County",1,14,385,199,186
050,29,207,"Missouri","Stoddard County",1,15,388,199,189
050,29,207,"Missouri","Stoddard County",1,16,396,191,205
050,29,207,"Missouri","Stoddard County",1,17,357,180,177
050,29,207,"Missouri","Stoddard County",1,18,310,172,138
050,29,207,"Missouri","Stoddard County",1,19,274,145,129
050,29,207,"Missouri","Stoddard County",1,20,291,163,128
050,29,207,"Missouri","Stoddard County",1,21,296,159,137
050,29,207,"Missouri","Stoddard County",1,22,275,157,118
050,29,207,"Missouri","Stoddard County",1,23,314,156,158
050,29,207,"Missouri","Stoddard County",1,24,318,156,162
050,29,207,"Missouri","Stoddard County",1,25,323,161,162
050,29,207,"Missouri","Stoddard County",1,26,342,161,181
050,29,207,"Missouri","Stoddard County",1,27,338,161,177
050,29,207,"Missouri","Stoddard County",1,28,324,168,156
050,29,207,"Missouri","Stoddard County",1,29,356,185,171
050,29,207,"Missouri","Stoddard County",1,30,363,179,184
050,29,207,"Missouri","Stoddard County",1,31,320,155,165
050,29,207,"Missouri","Stoddard County",1,32,332,172,160
050,29,207,"Missouri","Stoddard County",1,33,329,159,170
050,29,207,"Missouri","Stoddard County",1,34,351,179,172
050,29,207,"Missouri","Stoddard County",1,35,339,176,163
050,29,207,"Missouri","Stoddard County",1,36,321,155,166
050,29,207,"Missouri","Stoddard County",1,37,347,173,174
050,29,207,"Missouri","Stoddard County",1,38,371,180,191
050,29,207,"Missouri","Stoddard County",1,39,359,181,178
050,29,207,"Missouri","Stoddard County",1,40,358,182,176
050,29,207,"Missouri","Stoddard County",1,41,364,183,181
050,29,207,"Missouri","Stoddard County",1,42,354,169,185
050,29,207,"Missouri","Stoddard County",1,43,328,155,173
050,29,207,"Missouri","Stoddard County",1,44,328,161,167
050,29,207,"Missouri","Stoddard County",1,45,336,182,154
050,29,207,"Missouri","Stoddard County",1,46,344,178,166
050,29,207,"Missouri","Stoddard County",1,47,349,177,172
050,29,207,"Missouri","Stoddard County",1,48,353,173,180
050,29,207,"Missouri","Stoddard County",1,49,401,201,200
050,29,207,"Missouri","Stoddard County",1,50,375,197,178
050,29,207,"Missouri","Stoddard County",1,51,371,201,170
050,29,207,"Missouri","Stoddard County",1,52,342,177,165
050,29,207,"Missouri","Stoddard County",1,53,337,171,166
050,29,207,"Missouri","Stoddard County",1,54,351,175,176
050,29,207,"Missouri","Stoddard County",1,55,384,187,197
050,29,207,"Missouri","Stoddard County",1,56,449,221,228
050,29,207,"Missouri","Stoddard County",1,57,429,217,212
050,29,207,"Missouri","Stoddard County",1,58,436,219,217
050,29,207,"Missouri","Stoddard County",1,59,420,213,207
050,29,207,"Missouri","Stoddard County",1,60,364,184,180
050,29,207,"Missouri","Stoddard County",1,61,358,170,188
050,29,207,"Missouri","Stoddard County",1,62,422,194,228
050,29,207,"Missouri","Stoddard County",1,63,412,195,217
050,29,207,"Missouri","Stoddard County",1,64,394,179,215
050,29,207,"Missouri","Stoddard County",1,65,382,175,207
050,29,207,"Missouri","Stoddard County",1,66,364,163,201
050,29,207,"Missouri","Stoddard County",1,67,353,165,188
050,29,207,"Missouri","Stoddard County",1,68,322,147,175
050,29,207,"Missouri","Stoddard County",1,69,296,140,156
050,29,207,"Missouri","Stoddard County",1,70,322,154,168
050,29,207,"Missouri","Stoddard County",1,71,302,144,158
050,29,207,"Missouri","Stoddard County",1,72,311,147,164
050,29,207,"Missouri","Stoddard County",1,73,329,152,177
050,29,207,"Missouri","Stoddard County",1,74,238,112,126
050,29,207,"Missouri","Stoddard County",1,75,235,107,128
050,29,207,"Missouri","Stoddard County",1,76,226,106,120
050,29,207,"Missouri","Stoddard County",1,77,211,93,118
050,29,207,"Missouri","Stoddard County",1,78,193,90,103
050,29,207,"Missouri","Stoddard County",1,79,179,77,102
050,29,207,"Missouri","Stoddard County",1,80,185,91,94
050,29,207,"Missouri","Stoddard County",1,81,165,74,91
050,29,207,"Missouri","Stoddard County",1,82,134,56,78
050,29,207,"Missouri","Stoddard County",1,83,121,47,74
050,29,207,"Missouri","Stoddard County",1,84,119,53,66
050,29,207,"Missouri","Stoddard County",1,85,763,279,484
050,29,207,"Missouri","Stoddard County",2,0,325,169,156
050,29,207,"Missouri","Stoddard County",2,1,325,169,156
050,29,207,"Missouri","Stoddard County",2,2,328,165,163
050,29,207,"Missouri","Stoddard County",2,3,310,163,147
050,29,207,"Missouri","Stoddard County",2,4,317,179,138
050,29,207,"Missouri","Stoddard County",2,5,349,194,155
050,29,207,"Missouri","Stoddard County",2,6,368,199,169
050,29,207,"Missouri","Stoddard County",2,7,367,188,179
050,29,207,"Missouri","Stoddard County",2,8,346,180,166
050,29,207,"Missouri","Stoddard County",2,9,343,181,162
050,29,207,"Missouri","Stoddard County",2,10,336,161,175
050,29,207,"Missouri","Stoddard County",2,11,357,177,180
050,29,207,"Missouri","Stoddard County",2,12,383,192,191
050,29,207,"Missouri","Stoddard County",2,13,387,199,188
050,29,207,"Missouri","Stoddard County",2,14,384,198,186
050,29,207,"Missouri","Stoddard County",2,15,389,198,191
050,29,207,"Missouri","Stoddard County",2,16,395,193,202
050,29,207,"Missouri","Stoddard County",2,17,366,183,183
050,29,207,"Missouri","Stoddard County",2,18,310,168,142
050,29,207,"Missouri","Stoddard County",2,19,270,145,125
050,29,207,"Missouri","Stoddard County",2,20,293,162,131
050,29,207,"Missouri","Stoddard County",2,21,293,160,133
050,29,207,"Missouri","Stoddard County",2,22,283,159,124
050,29,207,"Missouri","Stoddard County",2,23,309,158,151
050,29,207,"Missouri","Stoddard County",2,24,318,158,160
050,29,207,"Missouri","Stoddard County",2,25,325,163,162
050,29,207,"Missouri","Stoddard County",2,26,339,161,178
050,29,207,"Missouri","Stoddard County",2,27,334,158,176
050,29,207,"Missouri","Stoddard County",2,28,327,166,161
050,29,207,"Missouri","Stoddard County",2,29,347,179,168
050,29,207,"Missouri","Stoddard County",2,30,361,182,179
050,29,207,"Missouri","Stoddard County",2,31,328,161,167
050,29,207,"Missouri","Stoddard County",2,32,327,168,159
050,29,207,"Missouri","Stoddard County",2,33,331,161,170
050,29,207,"Missouri","Stoddard County",2,34,348,176,172
050,29,207,"Missouri","Stoddard County",2,35,346,181,165
050,29,207,"Missouri","Stoddard County",2,36,323,159,164
050,29,207,"Missouri","Stoddard County",2,37,342,170,172
050,29,207,"Missouri","Stoddard County",2,38,366,179,187
050,29,207,"Missouri","Stoddard County",2,39,361,181,180
050,29,207,"Missouri","Stoddard County",2,40,363,184,179
050,29,207,"Missouri","Stoddard County",2,41,362,182,180
050,29,207,"Missouri","Stoddard County",2,42,350,169,181
050,29,207,"Missouri","Stoddard County",2,43,336,158,178
050,29,207,"Missouri","Stoddard County",2,44,321,157,164
050,29,207,"Missouri","Stoddard County",2,45,335,177,158
050,29,207,"Missouri","Stoddard County",2,46,342,179,163
050,29,207,"Missouri","Stoddard County",2,47,345,176,169
050,29,207,"Missouri","Stoddard County",2,48,353,175,178
050,29,207,"Missouri","Stoddard County",2,49,391,196,195
050,29,207,"Missouri","Stoddard County",2,50,383,198,185
050,29,207,"Missouri","Stoddard County",2,51,370,197,173
050,29,207,"Missouri","Stoddard County",2,52,348,183,165
050,29,207,"Missouri","Stoddard County",2,53,340,175,165
050,29,207,"Missouri","Stoddard County",2,54,347,175,172
050,29,207,"Missouri","Stoddard County",2,55,374,185,189
050,29,207,"Missouri","Stoddard County",2,56,435,214,221
050,29,207,"Missouri","Stoddard County",2,57,433,217,216
050,29,207,"Missouri","Stoddard County",2,58,433,217,216
050,29,207,"Missouri","Stoddard County",2,59,422,211,211
050,29,207,"Missouri","Stoddard County",2,60,375,190,185
050,29,207,"Missouri","Stoddard County",2,61,358,173,185
050,29,207,"Missouri","Stoddard County",2,62,407,189,218
050,29,207,"Missouri","Stoddard County",2,63,416,195,221
050,29,207,"Missouri","Stoddard County",2,64,396,182,214
050,29,207,"Missouri","Stoddard County",2,65,385,176,209
050,29,207,"Missouri","Stoddard County",2,66,367,168,199
050,29,207,"Missouri","Stoddard County",2,67,353,163,190
050,29,207,"Missouri","Stoddard County",2,68,326,149,177
050,29,207,"Missouri","Stoddard County",2,69,302,142,160
050,29,207,"Missouri","Stoddard County",2,70,311,149,162
050,29,207,"Missouri","Stoddard County",2,71,306,145,161
050,29,207,"Missouri","Stoddard County",2,72,301,142,159
050,29,207,"Missouri","Stoddard County",2,73,337,154,183
050,29,207,"Missouri","Stoddard County",2,74,238,111,127
050,29,207,"Missouri","Stoddard County",2,75,236,107,129
050,29,207,"Missouri","Stoddard County",2,76,222,102,120
050,29,207,"Missouri","Stoddard County",2,77,218,97,121
050,29,207,"Missouri","Stoddard County",2,78,189,88,101
050,29,207,"Missouri","Stoddard County",2,79,180,78,102
050,29,207,"Missouri","Stoddard County",2,80,185,89,96
050,29,207,"Missouri","Stoddard County",2,81,168,79,89
050,29,207,"Missouri","Stoddard County",2,82,136,58,78
050,29,207,"Missouri","Stoddard County",2,83,123,48,75
050,29,207,"Missouri","Stoddard County",2,84,116,51,65
050,29,207,"Missouri","Stoddard County",2,85,761,282,479
050,29,207,"Missouri","Stoddard County",3,0,329,168,161
050,29,207,"Missouri","Stoddard County",3,1,327,168,159
050,29,207,"Missouri","Stoddard County",3,2,329,168,161
050,29,207,"Missouri","Stoddard County",3,3,324,165,159
050,29,207,"Missouri","Stoddard County",3,4,327,174,153
050,29,207,"Missouri","Stoddard County",3,5,306,170,136
050,29,207,"Missouri","Stoddard County",3,6,334,183,151
050,29,207,"Missouri","Stoddard County",3,7,362,198,164
050,29,207,"Missouri","Stoddard County",3,8,362,188,174
050,29,207,"Missouri","Stoddard County",3,9,346,181,165
050,29,207,"Missouri","Stoddard County",3,10,341,179,162
050,29,207,"Missouri","Stoddard County",3,11,335,163,172
050,29,207,"Missouri","Stoddard County",3,12,358,181,177
050,29,207,"Missouri","Stoddard County",3,13,389,199,190
050,29,207,"Missouri","Stoddard County",3,14,385,197,188
050,29,207,"Missouri","Stoddard County",3,15,385,204,181
050,29,207,"Missouri","Stoddard County",3,16,389,206,183
050,29,207,"Missouri","Stoddard County",3,17,388,194,194
050,29,207,"Missouri","Stoddard County",3,18,319,167,152
050,29,207,"Missouri","Stoddard County",3,19,252,138,114
050,29,207,"Missouri","Stoddard County",3,20,287,151,136
050,29,207,"Missouri","Stoddard County",3,21,303,164,139
050,29,207,"Missouri","Stoddard County",3,22,310,157,153
050,29,207,"Missouri","Stoddard County",3,23,306,172,134
050,29,207,"Missouri","Stoddard County",3,24,297,152,145
050,29,207,"Missouri","Stoddard County",3,25,325,164,161
050,29,207,"Missouri","Stoddard County",3,26,319,163,156
050,29,207,"Missouri","Stoddard County",3,27,335,163,172
050,29,207,"Missouri","Stoddard County",3,28,335,164,171
050,29,207,"Missouri","Stoddard County",3,29,332,179,153
050,29,207,"Missouri","Stoddard County",3,30,325,168,157
050,29,207,"Missouri","Stoddard County",3,31,372,191,181
050,29,207,"Missouri","Stoddard County",3,32,330,164,166
050,29,207,"Missouri","Stoddard County",3,33,323,162,161
050,29,207,"Missouri","Stoddard County",3,34,338,167,171
050,29,207,"Missouri","Stoddard County",3,35,356,179,177
050,29,207,"Missouri","Stoddard County",3,36,342,170,172
050,29,207,"Missouri","Stoddard County",3,37,326,166,160
050,29,207,"Missouri","Stoddard County",3,38,338,165,173
050,29,207,"Missouri","Stoddard County",3,39,358,170,188
050,29,207,"Missouri","Stoddard County",3,40,360,180,180
050,29,207,"Missouri","Stoddard County",3,41,365,187,178
050,29,207,"Missouri","Stoddard County",3,42,360,180,180
050,29,207,"Missouri","Stoddard County",3,43,342,162,180
050,29,207,"Missouri","Stoddard County",3,44,327,156,171
050,29,207,"Missouri","Stoddard County",3,45,323,165,158
050,29,207,"Missouri","Stoddard County",3,46,338,182,156
050,29,207,"Missouri","Stoddard County",3,47,346,178,168
050,29,207,"Missouri","Stoddard County",3,48,338,174,164
050,29,207,"Missouri","Stoddard County",3,49,370,186,184
050,29,207,"Missouri","Stoddard County",3,50,396,203,193
050,29,207,"Missouri","Stoddard County",3,51,374,193,181
050,29,207,"Missouri","Stoddard County",3,52,370,196,174
050,29,207,"Missouri","Stoddard County",3,53,349,183,166
050,29,207,"Missouri","Stoddard County",3,54,339,176,163
050,29,207,"Missouri","Stoddard County",3,55,331,166,165
050,29,207,"Missouri","Stoddard County",3,56,373,186,187
050,29,207,"Missouri","Stoddard County",3,57,435,220,215
050,29,207,"Missouri","Stoddard County",3,58,424,209,215
050,29,207,"Missouri","Stoddard County",3,59,421,207,214
050,29,207,"Missouri","Stoddard County",3,60,413,204,209
050,29,207,"Missouri","Stoddard County",3,61,381,194,187
050,29,207,"Missouri","Stoddard County",3,62,359,171,188
050,29,207,"Missouri","Stoddard County",3,63,397,184,213
050,29,207,"Missouri","Stoddard County",3,64,419,199,220
050,29,207,"Missouri","Stoddard County",3,65,380,175,205
050,29,207,"Missouri","Stoddard County",3,66,383,175,208
050,29,207,"Missouri","Stoddard County",3,67,368,167,201
050,29,207,"Missouri","Stoddard County",3,68,342,159,183
050,29,207,"Missouri","Stoddard County",3,69,322,152,170
050,29,207,"Missouri","Stoddard County",3,70,300,144,156
050,29,207,"Missouri","Stoddard County",3,71,299,139,160
050,29,207,"Missouri","Stoddard County",3,72,298,142,156
050,29,207,"Missouri","Stoddard County",3,73,282,131,151
050,29,207,"Missouri","Stoddard County",3,74,322,146,176
050,29,207,"Missouri","Stoddard County",3,75,229,108,121
050,29,207,"Missouri","Stoddard County",3,76,226,102,124
050,29,207,"Missouri","Stoddard County",3,77,215,93,122
050,29,207,"Missouri","Stoddard County",3,78,195,90,105
050,29,207,"Missouri","Stoddard County",3,79,176,80,96
050,29,207,"Missouri","Stoddard County",3,80,176,75,101
050,29,207,"Missouri","Stoddard County",3,81,174,86,88
050,29,207,"Missouri","Stoddard County",3,82,144,64,80
050,29,207,"Missouri","Stoddard County",3,83,131,53,78
050,29,207,"Missouri","Stoddard County",3,84,110,43,67
050,29,207,"Missouri","Stoddard County",3,85,753,283,470
050,29,207,"Missouri","Stoddard County",4,0,327,170,157
050,29,207,"Missouri","Stoddard County",4,1,328,163,165
050,29,207,"Missouri","Stoddard County",4,2,325,171,154
050,29,207,"Missouri","Stoddard County",4,3,319,168,151
050,29,207,"Missouri","Stoddard County",4,4,312,160,152
050,29,207,"Missouri","Stoddard County",4,5,329,172,157
050,29,207,"Missouri","Stoddard County",4,6,306,166,140
050,29,207,"Missouri","Stoddard County",4,7,339,184,155
050,29,207,"Missouri","Stoddard County",4,8,366,202,164
050,29,207,"Missouri","Stoddard County",4,9,354,181,173
050,29,207,"Missouri","Stoddard County",4,10,345,178,167
050,29,207,"Missouri","Stoddard County",4,11,347,186,161
050,29,207,"Missouri","Stoddard County",4,12,339,165,174
050,29,207,"Missouri","Stoddard County",4,13,358,177,181
050,29,207,"Missouri","Stoddard County",4,14,381,195,186
050,29,207,"Missouri","Stoddard County",4,15,372,193,179
050,29,207,"Missouri","Stoddard County",4,16,395,215,180
050,29,207,"Missouri","Stoddard County",4,17,386,206,180
050,29,207,"Missouri","Stoddard County",4,18,322,171,151
050,29,207,"Missouri","Stoddard County",4,19,246,132,114
050,29,207,"Missouri","Stoddard County",4,20,252,141,111
050,29,207,"Missouri","Stoddard County",4,21,295,152,143
050,29,207,"Missouri","Stoddard County",4,22,305,163,142
050,29,207,"Missouri","Stoddard County",4,23,340,169,171
050,29,207,"Missouri","Stoddard County",4,24,310,177,133
050,29,207,"Missouri","Stoddard County",4,25,309,156,153
050,29,207,"Missouri","Stoddard County",4,26,328,163,165
050,29,207,"Missouri","Stoddard County",4,27,326,174,152
050,29,207,"Missouri","Stoddard County",4,28,328,161,167
050,29,207,"Missouri","Stoddard County",4,29,334,162,172
050,29,207,"Missouri","Stoddard County",4,30,338,181,157
050,29,207,"Missouri","Stoddard County",4,31,341,177,164
050,29,207,"Missouri","Stoddard County",4,32,369,193,176
050,29,207,"Missouri","Stoddard County",4,33,323,148,175
050,29,207,"Missouri","Stoddard County",4,34,330,164,166
050,29,207,"Missouri","Stoddard County",4,35,348,173,175
050,29,207,"Missouri","Stoddard County",4,36,351,173,178
050,29,207,"Missouri","Stoddard County",4,37,341,171,170
050,29,207,"Missouri","Stoddard County",4,38,326,164,162
050,29,207,"Missouri","Stoddard County",4,39,353,177,176
050,29,207,"Missouri","Stoddard County",4,40,368,178,190
050,29,207,"Missouri","Stoddard County",4,41,354,173,181
050,29,207,"Missouri","Stoddard County",4,42,376,198,178
050,29,207,"Missouri","Stoddard County",4,43,359,181,178
050,29,207,"Missouri","Stoddard County",4,44,349,164,185
050,29,207,"Missouri","Stoddard County",4,45,329,154,175
050,29,207,"Missouri","Stoddard County",4,46,321,161,160
050,29,207,"Missouri","Stoddard County",4,47,336,177,159
050,29,207,"Missouri","Stoddard County",4,48,341,173,168
050,29,207,"Missouri","Stoddard County",4,49,351,181,170
050,29,207,"Missouri","Stoddard County",4,50,369,185,184
050,29,207,"Missouri","Stoddard County",4,51,393,200,193
050,29,207,"Missouri","Stoddard County",4,52,370,189,181
050,29,207,"Missouri","Stoddard County",4,53,370,196,174
050,29,207,"Missouri","Stoddard County",4,54,352,186,166
050,29,207,"Missouri","Stoddard County",4,55,331,177,154
050,29,207,"Missouri","Stoddard County",4,56,329,167,162
050,29,207,"Missouri","Stoddard County",4,57,368,181,187
050,29,207,"Missouri","Stoddard County",4,58,427,218,209
050,29,207,"Missouri","Stoddard County",4,59,403,194,209
050,29,207,"Missouri","Stoddard County",4,60,420,206,214
050,29,207,"Missouri","Stoddard County",4,61,412,204,208
050,29,207,"Missouri","Stoddard County",4,62,375,185,190
050,29,207,"Missouri","Stoddard County",4,63,342,167,175
050,29,207,"Missouri","Stoddard County",4,64,401,182,219
050,29,207,"Missouri","Stoddard County",4,65,397,189,208
050,29,207,"Missouri","Stoddard County",4,66,378,172,206
050,29,207,"Missouri","Stoddard County",4,67,370,169,201
050,29,207,"Missouri","Stoddard County",4,68,353,164,189
050,29,207,"Missouri","Stoddard County",4,69,339,156,183
050,29,207,"Missouri","Stoddard County",4,70,318,145,173
050,29,207,"Missouri","Stoddard County",4,71,291,136,155
050,29,207,"Missouri","Stoddard County",4,72,292,137,155
050,29,207,"Missouri","Stoddard County",4,73,286,135,151
050,29,207,"Missouri","Stoddard County",4,74,268,116,152
050,29,207,"Missouri","Stoddard County",4,75,313,137,176
050,29,207,"Missouri","Stoddard County",4,76,215,100,115
050,29,207,"Missouri","Stoddard County",4,77,220,94,126
050,29,207,"Missouri","Stoddard County",4,78,196,90,106
050,29,207,"Missouri","Stoddard County",4,79,182,80,102
050,29,207,"Missouri","Stoddard County",4,80,167,75,92
050,29,207,"Missouri","Stoddard County",4,81,172,79,93
050,29,207,"Missouri","Stoddard County",4,82,152,74,78
050,29,207,"Missouri","Stoddard County",4,83,136,56,80
050,29,207,"Missouri","Stoddard County",4,84,117,46,71
050,29,207,"Missouri","Stoddard County",4,85,739,288,451
050,29,207,"Missouri","Stoddard County",5,0,328,171,157
050,29,207,"Missouri","Stoddard County",5,1,345,182,163
050,29,207,"Missouri","Stoddard County",5,2,335,171,164
050,29,207,"Missouri","Stoddard County",5,3,333,166,167
050,29,207,"Missouri","Stoddard County",5,4,315,160,155
050,29,207,"Missouri","Stoddard County",5,5,326,173,153
050,29,207,"Missouri","Stoddard County",5,6,320,173,147
050,29,207,"Missouri","Stoddard County",5,7,304,162,142
050,29,207,"Missouri","Stoddard County",5,8,332,179,153
050,29,207,"Missouri","Stoddard County",5,9,373,200,173
050,29,207,"Missouri","Stoddard County",5,10,343,176,167
050,29,207,"Missouri","Stoddard County",5,11,346,177,169
050,29,207,"Missouri","Stoddard County",5,12,350,190,160
050,29,207,"Missouri","Stoddard County",5,13,338,163,175
050,29,207,"Missouri","Stoddard County",5,14,362,184,178
050,29,207,"Missouri","Stoddard County",5,15,376,194,182
050,29,207,"Missouri","Stoddard County",5,16,382,193,189
050,29,207,"Missouri","Stoddard County",5,17,399,214,185
050,29,207,"Missouri","Stoddard County",5,18,323,176,147
050,29,207,"Missouri","Stoddard County",5,19,262,140,122
050,29,207,"Missouri","Stoddard County",5,20,262,140,122
050,29,207,"Missouri","Stoddard County",5,21,288,158,130
050,29,207,"Missouri","Stoddard County",5,22,317,159,158
050,29,207,"Missouri","Stoddard County",5,23,312,158,154
050,29,207,"Missouri","Stoddard County",5,24,335,180,155
050,29,207,"Missouri","Stoddard County",5,25,326,193,133
050,29,207,"Missouri","Stoddard County",5,26,322,161,161
050,29,207,"Missouri","Stoddard County",5,27,347,180,167
050,29,207,"Missouri","Stoddard County",5,28,322,172,150
050,29,207,"Missouri","Stoddard County",5,29,330,163,167
050,29,207,"Missouri","Stoddard County",5,30,323,162,161
050,29,207,"Missouri","Stoddard County",5,31,348,187,161
050,29,207,"Missouri","Stoddard County",5,32,332,173,159
050,29,207,"Missouri","Stoddard County",5,33,366,185,181
050,29,207,"Missouri","Stoddard County",5,34,331,152,179
050,29,207,"Missouri","Stoddard County",5,35,332,164,168
050,29,207,"Missouri","Stoddard County",5,36,351,172,179
050,29,207,"Missouri","Stoddard County",5,37,367,185,182
050,29,207,"Missouri","Stoddard County",5,38,334,168,166
050,29,207,"Missouri","Stoddard County",5,39,326,163,163
050,29,207,"Missouri","Stoddard County",5,40,345,171,174
050,29,207,"Missouri","Stoddard County",5,41,375,183,192
050,29,207,"Missouri","Stoddard County",5,42,355,169,186
050,29,207,"Missouri","Stoddard County",5,43,378,194,184
050,29,207,"Missouri","Stoddard County",5,44,358,176,182
050,29,207,"Missouri","Stoddard County",5,45,333,155,178
050,29,207,"Missouri","Stoddard County",5,46,333,156,177
050,29,207,"Missouri","Stoddard County",5,47,327,162,165
050,29,207,"Missouri","Stoddard County",5,48,338,179,159
050,29,207,"Missouri","Stoddard County",5,49,348,179,169
050,29,207,"Missouri","Stoddard County",5,50,341,173,168
050,29,207,"Missouri","Stoddard County",5,51,364,188,176
050,29,207,"Missouri","Stoddard County",5,52,399,206,193
050,29,207,"Missouri","Stoddard County",5,53,372,190,182
050,29,207,"Missouri","Stoddard County",5,54,373,191,182
050,29,207,"Missouri","Stoddard County",5,55,355,187,168
050,29,207,"Missouri","Stoddard County",5,56,328,170,158
050,29,207,"Missouri","Stoddard County",5,57,328,168,160
050,29,207,"Missouri","Stoddard County",5,58,370,180,190
050,29,207,"Missouri","Stoddard County",5,59,422,218,204
050,29,207,"Missouri","Stoddard County",5,60,399,192,207
050,29,207,"Missouri","Stoddard County",5,61,410,197,213
050,29,207,"Missouri","Stoddard County",5,62,408,199,209
050,29,207,"Missouri","Stoddard County",5,63,379,192,187
050,29,207,"Missouri","Stoddard County",5,64,342,165,177
050,29,207,"Missouri","Stoddard County",5,65,385,177,208
050,29,207,"Missouri","Stoddard County",5,66,396,190,206
050,29,207,"Missouri","Stoddard County",5,67,374,166,208
050,29,207,"Missouri","Stoddard County",5,68,361,168,193
050,29,207,"Missouri","Stoddard County",5,69,343,157,186
050,29,207,"Missouri","Stoddard County",5,70,334,154,180
050,29,207,"Missouri","Stoddard County",5,71,303,134,169
050,29,207,"Missouri","Stoddard County",5,72,281,134,147
050,29,207,"Missouri","Stoddard County",5,73,284,131,153
050,29,207,"Missouri","Stoddard County",5,74,263,122,141
050,29,207,"Missouri","Stoddard County",5,75,252,104,148
050,29,207,"Missouri","Stoddard County",5,76,292,126,166
050,29,207,"Missouri","Stoddard County",5,77,206,94,112
050,29,207,"Missouri","Stoddard County",5,78,200,86,114
050,29,207,"Missouri","Stoddard County",5,79,179,78,101
050,29,207,"Missouri","Stoddard County",5,80,166,72,94
050,29,207,"Missouri","Stoddard County",5,81,160,76,84
050,29,207,"Missouri","Stoddard County",5,82,146,66,80
050,29,207,"Missouri","Stoddard County",5,83,148,69,79
050,29,207,"Missouri","Stoddard County",5,84,120,51,69
050,29,207,"Missouri","Stoddard County",5,85,761,295,466
050,29,209,"Missouri","Stone County",1,0,247,125,122
050,29,209,"Missouri","Stone County",1,1,250,119,131
050,29,209,"Missouri","Stone County",1,2,266,145,121
050,29,209,"Missouri","Stone County",1,3,265,153,112
050,29,209,"Missouri","Stone County",1,4,248,131,117
050,29,209,"Missouri","Stone County",1,5,246,119,127
050,29,209,"Missouri","Stone County",1,6,258,135,123
050,29,209,"Missouri","Stone County",1,7,252,132,120
050,29,209,"Missouri","Stone County",1,8,260,136,124
050,29,209,"Missouri","Stone County",1,9,282,156,126
050,29,209,"Missouri","Stone County",1,10,325,169,156
050,29,209,"Missouri","Stone County",1,11,321,157,164
050,29,209,"Missouri","Stone County",1,12,322,172,150
050,29,209,"Missouri","Stone County",1,13,329,171,158
050,29,209,"Missouri","Stone County",1,14,307,159,148
050,29,209,"Missouri","Stone County",1,15,318,162,156
050,29,209,"Missouri","Stone County",1,16,342,186,156
050,29,209,"Missouri","Stone County",1,17,330,171,159
050,29,209,"Missouri","Stone County",1,18,302,154,148
050,29,209,"Missouri","Stone County",1,19,239,128,111
050,29,209,"Missouri","Stone County",1,20,257,139,118
050,29,209,"Missouri","Stone County",1,21,249,127,122
050,29,209,"Missouri","Stone County",1,22,257,135,122
050,29,209,"Missouri","Stone County",1,23,270,128,142
050,29,209,"Missouri","Stone County",1,24,238,125,113
050,29,209,"Missouri","Stone County",1,25,239,129,110
050,29,209,"Missouri","Stone County",1,26,243,136,107
050,29,209,"Missouri","Stone County",1,27,236,123,113
050,29,209,"Missouri","Stone County",1,28,262,138,124
050,29,209,"Missouri","Stone County",1,29,257,131,126
050,29,209,"Missouri","Stone County",1,30,224,106,118
050,29,209,"Missouri","Stone County",1,31,264,129,135
050,29,209,"Missouri","Stone County",1,32,254,117,137
050,29,209,"Missouri","Stone County",1,33,256,120,136
050,29,209,"Missouri","Stone County",1,34,277,136,141
050,29,209,"Missouri","Stone County",1,35,247,123,124
050,29,209,"Missouri","Stone County",1,36,269,140,129
050,29,209,"Missouri","Stone County",1,37,273,127,146
050,29,209,"Missouri","Stone County",1,38,314,154,160
050,29,209,"Missouri","Stone County",1,39,282,141,141
050,29,209,"Missouri","Stone County",1,40,282,153,129
050,29,209,"Missouri","Stone County",1,41,277,147,130
050,29,209,"Missouri","Stone County",1,42,304,156,148
050,29,209,"Missouri","Stone County",1,43,296,145,151
050,29,209,"Missouri","Stone County",1,44,301,136,165
050,29,209,"Missouri","Stone County",1,45,296,137,159
050,29,209,"Missouri","Stone County",1,46,317,140,177
050,29,209,"Missouri","Stone County",1,47,317,146,171
050,29,209,"Missouri","Stone County",1,48,363,174,189
050,29,209,"Missouri","Stone County",1,49,370,171,199
050,29,209,"Missouri","Stone County",1,50,356,167,189
050,29,209,"Missouri","Stone County",1,51,355,177,178
050,29,209,"Missouri","Stone County",1,52,380,201,179
050,29,209,"Missouri","Stone County",1,53,393,197,196
050,29,209,"Missouri","Stone County",1,54,398,193,205
050,29,209,"Missouri","Stone County",1,55,434,198,236
050,29,209,"Missouri","Stone County",1,56,468,209,259
050,29,209,"Missouri","Stone County",1,57,515,244,271
050,29,209,"Missouri","Stone County",1,58,598,292,306
050,29,209,"Missouri","Stone County",1,59,565,252,313
050,29,209,"Missouri","Stone County",1,60,553,272,281
050,29,209,"Missouri","Stone County",1,61,561,265,296
050,29,209,"Missouri","Stone County",1,62,563,281,282
050,29,209,"Missouri","Stone County",1,63,633,309,324
050,29,209,"Missouri","Stone County",1,64,635,322,313
050,29,209,"Missouri","Stone County",1,65,672,349,323
050,29,209,"Missouri","Stone County",1,66,638,315,323
050,29,209,"Missouri","Stone County",1,67,612,274,338
050,29,209,"Missouri","Stone County",1,68,644,295,349
050,29,209,"Missouri","Stone County",1,69,593,279,314
050,29,209,"Missouri","Stone County",1,70,593,286,307
050,29,209,"Missouri","Stone County",1,71,606,310,296
050,29,209,"Missouri","Stone County",1,72,612,317,295
050,29,209,"Missouri","Stone County",1,73,615,319,296
050,29,209,"Missouri","Stone County",1,74,397,199,198
050,29,209,"Missouri","Stone County",1,75,374,182,192
050,29,209,"Missouri","Stone County",1,76,413,206,207
050,29,209,"Missouri","Stone County",1,77,403,206,197
050,29,209,"Missouri","Stone County",1,78,328,158,170
050,29,209,"Missouri","Stone County",1,79,316,162,154
050,29,209,"Missouri","Stone County",1,80,287,148,139
050,29,209,"Missouri","Stone County",1,81,260,125,135
050,29,209,"Missouri","Stone County",1,82,214,103,111
050,29,209,"Missouri","Stone County",1,83,177,91,86
050,29,209,"Missouri","Stone County",1,84,178,83,95
050,29,209,"Missouri","Stone County",1,85,743,329,414
050,29,209,"Missouri","Stone County",2,0,255,125,130
050,29,209,"Missouri","Stone County",2,1,250,121,129
050,29,209,"Missouri","Stone County",2,2,267,143,124
050,29,209,"Missouri","Stone County",2,3,266,153,113
050,29,209,"Missouri","Stone County",2,4,253,137,116
050,29,209,"Missouri","Stone County",2,5,246,122,124
050,29,209,"Missouri","Stone County",2,6,258,132,126
050,29,209,"Missouri","Stone County",2,7,254,133,121
050,29,209,"Missouri","Stone County",2,8,260,137,123
050,29,209,"Missouri","Stone County",2,9,281,154,127
050,29,209,"Missouri","Stone County",2,10,315,167,148
050,29,209,"Missouri","Stone County",2,11,322,161,161
050,29,209,"Missouri","Stone County",2,12,325,170,155
050,29,209,"Missouri","Stone County",2,13,329,171,158
050,29,209,"Missouri","Stone County",2,14,313,163,150
050,29,209,"Missouri","Stone County",2,15,318,162,156
050,29,209,"Missouri","Stone County",2,16,339,181,158
050,29,209,"Missouri","Stone County",2,17,337,177,160
050,29,209,"Missouri","Stone County",2,18,297,155,142
050,29,209,"Missouri","Stone County",2,19,240,128,112
050,29,209,"Missouri","Stone County",2,20,257,138,119
050,29,209,"Missouri","Stone County",2,21,252,130,122
050,29,209,"Missouri","Stone County",2,22,263,136,127
050,29,209,"Missouri","Stone County",2,23,269,129,140
050,29,209,"Missouri","Stone County",2,24,245,128,117
050,29,209,"Missouri","Stone County",2,25,240,129,111
050,29,209,"Missouri","Stone County",2,26,241,134,107
050,29,209,"Missouri","Stone County",2,27,238,128,110
050,29,209,"Missouri","Stone County",2,28,258,137,121
050,29,209,"Missouri","Stone County",2,29,262,134,128
050,29,209,"Missouri","Stone County",2,30,236,115,121
050,29,209,"Missouri","Stone County",2,31,259,125,134
050,29,209,"Missouri","Stone County",2,32,259,121,138
050,29,209,"Missouri","Stone County",2,33,259,121,138
050,29,209,"Missouri","Stone County",2,34,274,132,142
050,29,209,"Missouri","Stone County",2,35,259,128,131
050,29,209,"Missouri","Stone County",2,36,264,136,128
050,29,209,"Missouri","Stone County",2,37,276,131,145
050,29,209,"Missouri","Stone County",2,38,308,149,159
050,29,209,"Missouri","Stone County",2,39,290,144,146
050,29,209,"Missouri","Stone County",2,40,288,155,133
050,29,209,"Missouri","Stone County",2,41,280,151,129
050,29,209,"Missouri","Stone County",2,42,296,154,142
050,29,209,"Missouri","Stone County",2,43,303,150,153
050,29,209,"Missouri","Stone County",2,44,298,138,160
050,29,209,"Missouri","Stone County",2,45,300,139,161
050,29,209,"Missouri","Stone County",2,46,313,140,173
050,29,209,"Missouri","Stone County",2,47,318,144,174
050,29,209,"Missouri","Stone County",2,48,354,166,188
050,29,209,"Missouri","Stone County",2,49,374,174,200
050,29,209,"Missouri","Stone County",2,50,360,168,192
050,29,209,"Missouri","Stone County",2,51,358,177,181
050,29,209,"Missouri","Stone County",2,52,377,197,180
050,29,209,"Missouri","Stone County",2,53,394,200,194
050,29,209,"Missouri","Stone County",2,54,395,194,201
050,29,209,"Missouri","Stone County",2,55,429,197,232
050,29,209,"Missouri","Stone County",2,56,466,210,256
050,29,209,"Missouri","Stone County",2,57,510,238,272
050,29,209,"Missouri","Stone County",2,58,584,282,302
050,29,209,"Missouri","Stone County",2,59,584,267,317
050,29,209,"Missouri","Stone County",2,60,558,267,291
050,29,209,"Missouri","Stone County",2,61,563,271,292
050,29,209,"Missouri","Stone County",2,62,572,282,290
050,29,209,"Missouri","Stone County",2,63,630,309,321
050,29,209,"Missouri","Stone County",2,64,634,316,318
050,29,209,"Missouri","Stone County",2,65,664,342,322
050,29,209,"Missouri","Stone County",2,66,647,322,325
050,29,209,"Missouri","Stone County",2,67,618,283,335
050,29,209,"Missouri","Stone County",2,68,631,287,344
050,29,209,"Missouri","Stone County",2,69,611,286,325
050,29,209,"Missouri","Stone County",2,70,593,284,309
050,29,209,"Missouri","Stone County",2,71,601,304,297
050,29,209,"Missouri","Stone County",2,72,595,308,287
050,29,209,"Missouri","Stone County",2,73,645,334,311
050,29,209,"Missouri","Stone County",2,74,419,214,205
050,29,209,"Missouri","Stone County",2,75,378,185,193
050,29,209,"Missouri","Stone County",2,76,393,195,198
050,29,209,"Missouri","Stone County",2,77,414,209,205
050,29,209,"Missouri","Stone County",2,78,331,163,168
050,29,209,"Missouri","Stone County",2,79,313,158,155
050,29,209,"Missouri","Stone County",2,80,291,150,141
050,29,209,"Missouri","Stone County",2,81,261,128,133
050,29,209,"Missouri","Stone County",2,82,222,106,116
050,29,209,"Missouri","Stone County",2,83,181,90,91
050,29,209,"Missouri","Stone County",2,84,175,82,93
050,29,209,"Missouri","Stone County",2,85,757,336,421
050,29,209,"Missouri","Stone County",3,0,258,132,126
050,29,209,"Missouri","Stone County",3,1,259,130,129
050,29,209,"Missouri","Stone County",3,2,255,124,131
050,29,209,"Missouri","Stone County",3,3,256,131,125
050,29,209,"Missouri","Stone County",3,4,254,135,119
050,29,209,"Missouri","Stone County",3,5,254,137,117
050,29,209,"Missouri","Stone County",3,6,263,125,138
050,29,209,"Missouri","Stone County",3,7,277,145,132
050,29,209,"Missouri","Stone County",3,8,284,146,138
050,29,209,"Missouri","Stone County",3,9,267,149,118
050,29,209,"Missouri","Stone County",3,10,285,151,134
050,29,209,"Missouri","Stone County",3,11,335,176,159
050,29,209,"Missouri","Stone County",3,12,331,164,167
050,29,209,"Missouri","Stone County",3,13,330,169,161
050,29,209,"Missouri","Stone County",3,14,331,179,152
050,29,209,"Missouri","Stone County",3,15,330,169,161
050,29,209,"Missouri","Stone County",3,16,325,166,159
050,29,209,"Missouri","Stone County",3,17,342,192,150
050,29,209,"Missouri","Stone County",3,18,296,165,131
050,29,209,"Missouri","Stone County",3,19,229,121,108
050,29,209,"Missouri","Stone County",3,20,247,137,110
050,29,209,"Missouri","Stone County",3,21,273,147,126
050,29,209,"Missouri","Stone County",3,22,252,131,121
050,29,209,"Missouri","Stone County",3,23,267,137,130
050,29,209,"Missouri","Stone County",3,24,273,130,143
050,29,209,"Missouri","Stone County",3,25,243,124,119
050,29,209,"Missouri","Stone County",3,26,244,128,116
050,29,209,"Missouri","Stone County",3,27,240,134,106
050,29,209,"Missouri","Stone County",3,28,223,120,103
050,29,209,"Missouri","Stone County",3,29,261,127,134
050,29,209,"Missouri","Stone County",3,30,257,136,121
050,29,209,"Missouri","Stone County",3,31,242,122,120
050,29,209,"Missouri","Stone County",3,32,250,122,128
050,29,209,"Missouri","Stone County",3,33,260,117,143
050,29,209,"Missouri","Stone County",3,34,254,118,136
050,29,209,"Missouri","Stone County",3,35,283,131,152
050,29,209,"Missouri","Stone County",3,36,275,146,129
050,29,209,"Missouri","Stone County",3,37,281,142,139
050,29,209,"Missouri","Stone County",3,38,291,144,147
050,29,209,"Missouri","Stone County",3,39,309,152,157
050,29,209,"Missouri","Stone County",3,40,289,136,153
050,29,209,"Missouri","Stone County",3,41,296,157,139
050,29,209,"Missouri","Stone County",3,42,279,147,132
050,29,209,"Missouri","Stone County",3,43,308,152,156
050,29,209,"Missouri","Stone County",3,44,306,155,151
050,29,209,"Missouri","Stone County",3,45,327,151,176
050,29,209,"Missouri","Stone County",3,46,305,141,164
050,29,209,"Missouri","Stone County",3,47,317,141,176
050,29,209,"Missouri","Stone County",3,48,333,157,176
050,29,209,"Missouri","Stone County",3,49,370,189,181
050,29,209,"Missouri","Stone County",3,50,374,168,206
050,29,209,"Missouri","Stone County",3,51,372,174,198
050,29,209,"Missouri","Stone County",3,52,363,181,182
050,29,209,"Missouri","Stone County",3,53,405,204,201
050,29,209,"Missouri","Stone County",3,54,409,211,198
050,29,209,"Missouri","Stone County",3,55,409,199,210
050,29,209,"Missouri","Stone County",3,56,451,223,228
050,29,209,"Missouri","Stone County",3,57,475,215,260
050,29,209,"Missouri","Stone County",3,58,555,254,301
050,29,209,"Missouri","Stone County",3,59,616,293,323
050,29,209,"Missouri","Stone County",3,60,614,284,330
050,29,209,"Missouri","Stone County",3,61,577,281,296
050,29,209,"Missouri","Stone County",3,62,592,288,304
050,29,209,"Missouri","Stone County",3,63,617,296,321
050,29,209,"Missouri","Stone County",3,64,652,324,328
050,29,209,"Missouri","Stone County",3,65,661,329,332
050,29,209,"Missouri","Stone County",3,66,680,356,324
050,29,209,"Missouri","Stone County",3,67,663,334,329
050,29,209,"Missouri","Stone County",3,68,615,279,336
050,29,209,"Missouri","Stone County",3,69,629,283,346
050,29,209,"Missouri","Stone County",3,70,608,288,320
050,29,209,"Missouri","Stone County",3,71,585,288,297
050,29,209,"Missouri","Stone County",3,72,568,281,287
050,29,209,"Missouri","Stone County",3,73,575,294,281
050,29,209,"Missouri","Stone County",3,74,608,313,295
050,29,209,"Missouri","Stone County",3,75,402,208,194
050,29,209,"Missouri","Stone County",3,76,371,179,192
050,29,209,"Missouri","Stone County",3,77,371,184,187
050,29,209,"Missouri","Stone County",3,78,385,192,193
050,29,209,"Missouri","Stone County",3,79,313,153,160
050,29,209,"Missouri","Stone County",3,80,297,154,143
050,29,209,"Missouri","Stone County",3,81,262,138,124
050,29,209,"Missouri","Stone County",3,82,243,121,122
050,29,209,"Missouri","Stone County",3,83,199,96,103
050,29,209,"Missouri","Stone County",3,84,154,79,75
050,29,209,"Missouri","Stone County",3,85,806,352,454
050,29,209,"Missouri","Stone County",4,0,269,140,129
050,29,209,"Missouri","Stone County",4,1,259,126,133
050,29,209,"Missouri","Stone County",4,2,279,145,134
050,29,209,"Missouri","Stone County",4,3,262,135,127
050,29,209,"Missouri","Stone County",4,4,250,129,121
050,29,209,"Missouri","Stone County",4,5,258,144,114
050,29,209,"Missouri","Stone County",4,6,266,149,117
050,29,209,"Missouri","Stone County",4,7,273,137,136
050,29,209,"Missouri","Stone County",4,8,288,151,137
050,29,209,"Missouri","Stone County",4,9,294,151,143
050,29,209,"Missouri","Stone County",4,10,279,148,131
050,29,209,"Missouri","Stone County",4,11,290,159,131
050,29,209,"Missouri","Stone County",4,12,351,184,167
050,29,209,"Missouri","Stone County",4,13,354,166,188
050,29,209,"Missouri","Stone County",4,14,340,178,162
050,29,209,"Missouri","Stone County",4,15,358,192,166
050,29,209,"Missouri","Stone County",4,16,346,177,169
050,29,209,"Missouri","Stone County",4,17,343,180,163
050,29,209,"Missouri","Stone County",4,18,299,172,127
050,29,209,"Missouri","Stone County",4,19,228,126,102
050,29,209,"Missouri","Stone County",4,20,248,129,119
050,29,209,"Missouri","Stone County",4,21,250,138,112
050,29,209,"Missouri","Stone County",4,22,296,155,141
050,29,209,"Missouri","Stone County",4,23,258,135,123
050,29,209,"Missouri","Stone County",4,24,262,132,130
050,29,209,"Missouri","Stone County",4,25,279,142,137
050,29,209,"Missouri","Stone County",4,26,238,121,117
050,29,209,"Missouri","Stone County",4,27,264,138,126
050,29,209,"Missouri","Stone County",4,28,243,136,107
050,29,209,"Missouri","Stone County",4,29,254,140,114
050,29,209,"Missouri","Stone County",4,30,259,130,129
050,29,209,"Missouri","Stone County",4,31,253,140,113
050,29,209,"Missouri","Stone County",4,32,255,126,129
050,29,209,"Missouri","Stone County",4,33,252,121,131
050,29,209,"Missouri","Stone County",4,34,273,116,157
050,29,209,"Missouri","Stone County",4,35,261,118,143
050,29,209,"Missouri","Stone County",4,36,296,145,151
050,29,209,"Missouri","Stone County",4,37,294,157,137
050,29,209,"Missouri","Stone County",4,38,299,155,144
050,29,209,"Missouri","Stone County",4,39,309,146,163
050,29,209,"Missouri","Stone County",4,40,334,166,168
050,29,209,"Missouri","Stone County",4,41,298,142,156
050,29,209,"Missouri","Stone County",4,42,305,161,144
050,29,209,"Missouri","Stone County",4,43,286,153,133
050,29,209,"Missouri","Stone County",4,44,307,150,157
050,29,209,"Missouri","Stone County",4,45,311,158,153
050,29,209,"Missouri","Stone County",4,46,330,153,177
050,29,209,"Missouri","Stone County",4,47,312,151,161
050,29,209,"Missouri","Stone County",4,48,327,150,177
050,29,209,"Missouri","Stone County",4,49,338,155,183
050,29,209,"Missouri","Stone County",4,50,379,197,182
050,29,209,"Missouri","Stone County",4,51,387,171,216
050,29,209,"Missouri","Stone County",4,52,386,177,209
050,29,209,"Missouri","Stone County",4,53,381,183,198
050,29,209,"Missouri","Stone County",4,54,411,208,203
050,29,209,"Missouri","Stone County",4,55,414,218,196
050,29,209,"Missouri","Stone County",4,56,410,200,210
050,29,209,"Missouri","Stone County",4,57,468,230,238
050,29,209,"Missouri","Stone County",4,58,486,238,248
050,29,209,"Missouri","Stone County",4,59,558,256,302
050,29,209,"Missouri","Stone County",4,60,627,288,339
050,29,209,"Missouri","Stone County",4,61,643,293,350
050,29,209,"Missouri","Stone County",4,62,620,307,313
050,29,209,"Missouri","Stone County",4,63,654,305,349
050,29,209,"Missouri","Stone County",4,64,662,333,329
050,29,209,"Missouri","Stone County",4,65,685,341,344
050,29,209,"Missouri","Stone County",4,66,667,338,329
050,29,209,"Missouri","Stone County",4,67,685,365,320
050,29,209,"Missouri","Stone County",4,68,682,347,335
050,29,209,"Missouri","Stone County",4,69,612,280,332
050,29,209,"Missouri","Stone County",4,70,612,271,341
050,29,209,"Missouri","Stone County",4,71,599,285,314
050,29,209,"Missouri","Stone County",4,72,546,278,268
050,29,209,"Missouri","Stone County",4,73,543,268,275
050,29,209,"Missouri","Stone County",4,74,563,284,279
050,29,209,"Missouri","Stone County",4,75,590,304,286
050,29,209,"Missouri","Stone County",4,76,397,203,194
050,29,209,"Missouri","Stone County",4,77,353,169,184
050,29,209,"Missouri","Stone County",4,78,347,171,176
050,29,209,"Missouri","Stone County",4,79,365,183,182
050,29,209,"Missouri","Stone County",4,80,295,144,151
050,29,209,"Missouri","Stone County",4,81,258,123,135
050,29,209,"Missouri","Stone County",4,82,240,124,116
050,29,209,"Missouri","Stone County",4,83,222,112,110
050,29,209,"Missouri","Stone County",4,84,176,84,92
050,29,209,"Missouri","Stone County",4,85,834,365,469
050,29,209,"Missouri","Stone County",5,0,268,140,128
050,29,209,"Missouri","Stone County",5,1,278,155,123
050,29,209,"Missouri","Stone County",5,2,275,130,145
050,29,209,"Missouri","Stone County",5,3,290,159,131
050,29,209,"Missouri","Stone County",5,4,268,136,132
050,29,209,"Missouri","Stone County",5,5,275,150,125
050,29,209,"Missouri","Stone County",5,6,286,153,133
050,29,209,"Missouri","Stone County",5,7,273,154,119
050,29,209,"Missouri","Stone County",5,8,286,149,137
050,29,209,"Missouri","Stone County",5,9,306,174,132
050,29,209,"Missouri","Stone County",5,10,304,160,144
050,29,209,"Missouri","Stone County",5,11,295,157,138
050,29,209,"Missouri","Stone County",5,12,308,171,137
050,29,209,"Missouri","Stone County",5,13,364,195,169
050,29,209,"Missouri","Stone County",5,14,340,157,183
050,29,209,"Missouri","Stone County",5,15,349,180,169
050,29,209,"Missouri","Stone County",5,16,381,201,180
050,29,209,"Missouri","Stone County",5,17,360,185,175
050,29,209,"Missouri","Stone County",5,18,291,155,136
050,29,209,"Missouri","Stone County",5,19,230,130,100
050,29,209,"Missouri","Stone County",5,20,255,136,119
050,29,209,"Missouri","Stone County",5,21,257,134,123
050,29,209,"Missouri","Stone County",5,22,271,146,125
050,29,209,"Missouri","Stone County",5,23,315,169,146
050,29,209,"Missouri","Stone County",5,24,270,137,133
050,29,209,"Missouri","Stone County",5,25,253,120,133
050,29,209,"Missouri","Stone County",5,26,282,148,134
050,29,209,"Missouri","Stone County",5,27,244,124,120
050,29,209,"Missouri","Stone County",5,28,255,127,128
050,29,209,"Missouri","Stone County",5,29,255,131,124
050,29,209,"Missouri","Stone County",5,30,240,135,105
050,29,209,"Missouri","Stone County",5,31,269,124,145
050,29,209,"Missouri","Stone County",5,32,269,153,116
050,29,209,"Missouri","Stone County",5,33,270,124,146
050,29,209,"Missouri","Stone County",5,34,251,117,134
050,29,209,"Missouri","Stone County",5,35,279,123,156
050,29,209,"Missouri","Stone County",5,36,276,132,144
050,29,209,"Missouri","Stone County",5,37,308,151,157
050,29,209,"Missouri","Stone County",5,38,288,155,133
050,29,209,"Missouri","Stone County",5,39,304,153,151
050,29,209,"Missouri","Stone County",5,40,328,159,169
050,29,209,"Missouri","Stone County",5,41,352,174,178
050,29,209,"Missouri","Stone County",5,42,315,154,161
050,29,209,"Missouri","Stone County",5,43,318,165,153
050,29,209,"Missouri","Stone County",5,44,288,154,134
050,29,209,"Missouri","Stone County",5,45,317,163,154
050,29,209,"Missouri","Stone County",5,46,323,153,170
050,29,209,"Missouri","Stone County",5,47,332,151,181
050,29,209,"Missouri","Stone County",5,48,331,157,174
050,29,209,"Missouri","Stone County",5,49,335,160,175
050,29,209,"Missouri","Stone County",5,50,360,168,192
050,29,209,"Missouri","Stone County",5,51,373,194,179
050,29,209,"Missouri","Stone County",5,52,395,178,217
050,29,209,"Missouri","Stone County",5,53,412,183,229
050,29,209,"Missouri","Stone County",5,54,392,192,200
050,29,209,"Missouri","Stone County",5,55,423,219,204
050,29,209,"Missouri","Stone County",5,56,435,230,205
050,29,209,"Missouri","Stone County",5,57,428,214,214
050,29,209,"Missouri","Stone County",5,58,484,232,252
050,29,209,"Missouri","Stone County",5,59,503,241,262
050,29,209,"Missouri","Stone County",5,60,578,264,314
050,29,209,"Missouri","Stone County",5,61,630,287,343
050,29,209,"Missouri","Stone County",5,62,679,314,365
050,29,209,"Missouri","Stone County",5,63,643,320,323
050,29,209,"Missouri","Stone County",5,64,687,323,364
050,29,209,"Missouri","Stone County",5,65,679,341,338
050,29,209,"Missouri","Stone County",5,66,699,347,352
050,29,209,"Missouri","Stone County",5,67,660,340,320
050,29,209,"Missouri","Stone County",5,68,685,375,310
050,29,209,"Missouri","Stone County",5,69,675,341,334
050,29,209,"Missouri","Stone County",5,70,611,275,336
050,29,209,"Missouri","Stone County",5,71,605,265,340
050,29,209,"Missouri","Stone County",5,72,582,281,301
050,29,209,"Missouri","Stone County",5,73,534,273,261
050,29,209,"Missouri","Stone County",5,74,523,253,270
050,29,209,"Missouri","Stone County",5,75,553,279,274
050,29,209,"Missouri","Stone County",5,76,577,302,275
050,29,209,"Missouri","Stone County",5,77,379,192,187
050,29,209,"Missouri","Stone County",5,78,320,152,168
050,29,209,"Missouri","Stone County",5,79,328,158,170
050,29,209,"Missouri","Stone County",5,80,345,180,165
050,29,209,"Missouri","Stone County",5,81,263,123,140
050,29,209,"Missouri","Stone County",5,82,234,113,121
050,29,209,"Missouri","Stone County",5,83,213,109,104
050,29,209,"Missouri","Stone County",5,84,201,101,100
050,29,209,"Missouri","Stone County",5,85,893,386,507
050,29,211,"Missouri","Sullivan County",1,0,89,46,43
050,29,211,"Missouri","Sullivan County",1,1,83,47,36
050,29,211,"Missouri","Sullivan County",1,2,71,42,29
050,29,211,"Missouri","Sullivan County",1,3,78,43,35
050,29,211,"Missouri","Sullivan County",1,4,77,41,36
050,29,211,"Missouri","Sullivan County",1,5,83,42,41
050,29,211,"Missouri","Sullivan County",1,6,78,42,36
050,29,211,"Missouri","Sullivan County",1,7,75,44,31
050,29,211,"Missouri","Sullivan County",1,8,73,41,32
050,29,211,"Missouri","Sullivan County",1,9,68,35,33
050,29,211,"Missouri","Sullivan County",1,10,73,35,38
050,29,211,"Missouri","Sullivan County",1,11,60,36,24
050,29,211,"Missouri","Sullivan County",1,12,65,36,29
050,29,211,"Missouri","Sullivan County",1,13,76,41,35
050,29,211,"Missouri","Sullivan County",1,14,78,43,35
050,29,211,"Missouri","Sullivan County",1,15,78,39,39
050,29,211,"Missouri","Sullivan County",1,16,69,31,38
050,29,211,"Missouri","Sullivan County",1,17,68,31,37
050,29,211,"Missouri","Sullivan County",1,18,75,49,26
050,29,211,"Missouri","Sullivan County",1,19,62,39,23
050,29,211,"Missouri","Sullivan County",1,20,72,38,34
050,29,211,"Missouri","Sullivan County",1,21,65,34,31
050,29,211,"Missouri","Sullivan County",1,22,65,33,32
050,29,211,"Missouri","Sullivan County",1,23,67,32,35
050,29,211,"Missouri","Sullivan County",1,24,80,35,45
050,29,211,"Missouri","Sullivan County",1,25,78,35,43
050,29,211,"Missouri","Sullivan County",1,26,70,33,37
050,29,211,"Missouri","Sullivan County",1,27,66,35,31
050,29,211,"Missouri","Sullivan County",1,28,66,35,31
050,29,211,"Missouri","Sullivan County",1,29,63,40,23
050,29,211,"Missouri","Sullivan County",1,30,73,37,36
050,29,211,"Missouri","Sullivan County",1,31,62,32,30
050,29,211,"Missouri","Sullivan County",1,32,57,28,29
050,29,211,"Missouri","Sullivan County",1,33,56,29,27
050,29,211,"Missouri","Sullivan County",1,34,55,28,27
050,29,211,"Missouri","Sullivan County",1,35,63,33,30
050,29,211,"Missouri","Sullivan County",1,36,50,30,20
050,29,211,"Missouri","Sullivan County",1,37,55,22,33
050,29,211,"Missouri","Sullivan County",1,38,57,30,27
050,29,211,"Missouri","Sullivan County",1,39,67,35,32
050,29,211,"Missouri","Sullivan County",1,40,70,39,31
050,29,211,"Missouri","Sullivan County",1,41,68,35,33
050,29,211,"Missouri","Sullivan County",1,42,62,32,30
050,29,211,"Missouri","Sullivan County",1,43,72,35,37
050,29,211,"Missouri","Sullivan County",1,44,73,40,33
050,29,211,"Missouri","Sullivan County",1,45,76,38,38
050,29,211,"Missouri","Sullivan County",1,46,62,32,30
050,29,211,"Missouri","Sullivan County",1,47,71,37,34
050,29,211,"Missouri","Sullivan County",1,48,88,47,41
050,29,211,"Missouri","Sullivan County",1,49,82,45,37
050,29,211,"Missouri","Sullivan County",1,50,87,41,46
050,29,211,"Missouri","Sullivan County",1,51,85,42,43
050,29,211,"Missouri","Sullivan County",1,52,77,37,40
050,29,211,"Missouri","Sullivan County",1,53,88,37,51
050,29,211,"Missouri","Sullivan County",1,54,79,39,40
050,29,211,"Missouri","Sullivan County",1,55,82,47,35
050,29,211,"Missouri","Sullivan County",1,56,90,47,43
050,29,211,"Missouri","Sullivan County",1,57,93,42,51
050,29,211,"Missouri","Sullivan County",1,58,91,48,43
050,29,211,"Missouri","Sullivan County",1,59,80,45,35
050,29,211,"Missouri","Sullivan County",1,60,104,60,44
050,29,211,"Missouri","Sullivan County",1,61,95,58,37
050,29,211,"Missouri","Sullivan County",1,62,88,54,34
050,29,211,"Missouri","Sullivan County",1,63,75,47,28
050,29,211,"Missouri","Sullivan County",1,64,65,37,28
050,29,211,"Missouri","Sullivan County",1,65,72,35,37
050,29,211,"Missouri","Sullivan County",1,66,76,39,37
050,29,211,"Missouri","Sullivan County",1,67,80,43,37
050,29,211,"Missouri","Sullivan County",1,68,78,44,34
050,29,211,"Missouri","Sullivan County",1,69,73,34,39
050,29,211,"Missouri","Sullivan County",1,70,70,31,39
050,29,211,"Missouri","Sullivan County",1,71,62,27,35
050,29,211,"Missouri","Sullivan County",1,72,72,35,37
050,29,211,"Missouri","Sullivan County",1,73,69,35,34
050,29,211,"Missouri","Sullivan County",1,74,51,30,21
050,29,211,"Missouri","Sullivan County",1,75,44,26,18
050,29,211,"Missouri","Sullivan County",1,76,50,20,30
050,29,211,"Missouri","Sullivan County",1,77,46,21,25
050,29,211,"Missouri","Sullivan County",1,78,40,19,21
050,29,211,"Missouri","Sullivan County",1,79,35,14,21
050,29,211,"Missouri","Sullivan County",1,80,33,11,22
050,29,211,"Missouri","Sullivan County",1,81,39,19,20
050,29,211,"Missouri","Sullivan County",1,82,32,18,14
050,29,211,"Missouri","Sullivan County",1,83,39,22,17
050,29,211,"Missouri","Sullivan County",1,84,28,16,12
050,29,211,"Missouri","Sullivan County",1,85,139,37,102
050,29,211,"Missouri","Sullivan County",2,0,86,44,42
050,29,211,"Missouri","Sullivan County",2,1,82,44,38
050,29,211,"Missouri","Sullivan County",2,2,76,44,32
050,29,211,"Missouri","Sullivan County",2,3,76,43,33
050,29,211,"Missouri","Sullivan County",2,4,79,42,37
050,29,211,"Missouri","Sullivan County",2,5,83,43,40
050,29,211,"Missouri","Sullivan County",2,6,79,43,36
050,29,211,"Missouri","Sullivan County",2,7,73,42,31
050,29,211,"Missouri","Sullivan County",2,8,74,42,32
050,29,211,"Missouri","Sullivan County",2,9,68,36,32
050,29,211,"Missouri","Sullivan County",2,10,71,35,36
050,29,211,"Missouri","Sullivan County",2,11,62,35,27
050,29,211,"Missouri","Sullivan County",2,12,64,37,27
050,29,211,"Missouri","Sullivan County",2,13,72,40,32
050,29,211,"Missouri","Sullivan County",2,14,78,42,36
050,29,211,"Missouri","Sullivan County",2,15,78,41,37
050,29,211,"Missouri","Sullivan County",2,16,71,33,38
050,29,211,"Missouri","Sullivan County",2,17,68,31,37
050,29,211,"Missouri","Sullivan County",2,18,71,43,28
050,29,211,"Missouri","Sullivan County",2,19,64,40,24
050,29,211,"Missouri","Sullivan County",2,20,70,39,31
050,29,211,"Missouri","Sullivan County",2,21,68,35,33
050,29,211,"Missouri","Sullivan County",2,22,66,34,32
050,29,211,"Missouri","Sullivan County",2,23,67,33,34
050,29,211,"Missouri","Sullivan County",2,24,81,37,44
050,29,211,"Missouri","Sullivan County",2,25,77,35,42
050,29,211,"Missouri","Sullivan County",2,26,74,34,40
050,29,211,"Missouri","Sullivan County",2,27,67,35,32
050,29,211,"Missouri","Sullivan County",2,28,67,36,31
050,29,211,"Missouri","Sullivan County",2,29,65,40,25
050,29,211,"Missouri","Sullivan County",2,30,70,38,32
050,29,211,"Missouri","Sullivan County",2,31,64,33,31
050,29,211,"Missouri","Sullivan County",2,32,58,29,29
050,29,211,"Missouri","Sullivan County",2,33,56,28,28
050,29,211,"Missouri","Sullivan County",2,34,56,29,27
050,29,211,"Missouri","Sullivan County",2,35,59,31,28
050,29,211,"Missouri","Sullivan County",2,36,54,31,23
050,29,211,"Missouri","Sullivan County",2,37,54,24,30
050,29,211,"Missouri","Sullivan County",2,38,57,29,28
050,29,211,"Missouri","Sullivan County",2,39,63,33,30
050,29,211,"Missouri","Sullivan County",2,40,67,37,30
050,29,211,"Missouri","Sullivan County",2,41,69,37,32
050,29,211,"Missouri","Sullivan County",2,42,63,32,31
050,29,211,"Missouri","Sullivan County",2,43,70,35,35
050,29,211,"Missouri","Sullivan County",2,44,72,39,33
050,29,211,"Missouri","Sullivan County",2,45,76,39,37
050,29,211,"Missouri","Sullivan County",2,46,64,33,31
050,29,211,"Missouri","Sullivan County",2,47,69,36,33
050,29,211,"Missouri","Sullivan County",2,48,85,44,41
050,29,211,"Missouri","Sullivan County",2,49,83,46,37
050,29,211,"Missouri","Sullivan County",2,50,85,41,44
050,29,211,"Missouri","Sullivan County",2,51,83,41,42
050,29,211,"Missouri","Sullivan County",2,52,78,38,40
050,29,211,"Missouri","Sullivan County",2,53,87,38,49
050,29,211,"Missouri","Sullivan County",2,54,82,40,42
050,29,211,"Missouri","Sullivan County",2,55,82,46,36
050,29,211,"Missouri","Sullivan County",2,56,88,47,41
050,29,211,"Missouri","Sullivan County",2,57,92,43,49
050,29,211,"Missouri","Sullivan County",2,58,92,47,45
050,29,211,"Missouri","Sullivan County",2,59,83,44,39
050,29,211,"Missouri","Sullivan County",2,60,98,57,41
050,29,211,"Missouri","Sullivan County",2,61,96,58,38
050,29,211,"Missouri","Sullivan County",2,62,88,54,34
050,29,211,"Missouri","Sullivan County",2,63,77,49,28
050,29,211,"Missouri","Sullivan County",2,64,67,39,28
050,29,211,"Missouri","Sullivan County",2,65,71,35,36
050,29,211,"Missouri","Sullivan County",2,66,74,38,36
050,29,211,"Missouri","Sullivan County",2,67,78,42,36
050,29,211,"Missouri","Sullivan County",2,68,77,43,34
050,29,211,"Missouri","Sullivan County",2,69,73,36,37
050,29,211,"Missouri","Sullivan County",2,70,71,32,39
050,29,211,"Missouri","Sullivan County",2,71,63,27,36
050,29,211,"Missouri","Sullivan County",2,72,69,33,36
050,29,211,"Missouri","Sullivan County",2,73,72,37,35
050,29,211,"Missouri","Sullivan County",2,74,53,30,23
050,29,211,"Missouri","Sullivan County",2,75,46,28,18
050,29,211,"Missouri","Sullivan County",2,76,45,20,25
050,29,211,"Missouri","Sullivan County",2,77,47,22,25
050,29,211,"Missouri","Sullivan County",2,78,41,19,22
050,29,211,"Missouri","Sullivan County",2,79,35,15,20
050,29,211,"Missouri","Sullivan County",2,80,31,11,20
050,29,211,"Missouri","Sullivan County",2,81,39,19,20
050,29,211,"Missouri","Sullivan County",2,82,30,16,14
050,29,211,"Missouri","Sullivan County",2,83,38,21,17
050,29,211,"Missouri","Sullivan County",2,84,29,17,12
050,29,211,"Missouri","Sullivan County",2,85,139,37,102
050,29,211,"Missouri","Sullivan County",3,0,63,35,28
050,29,211,"Missouri","Sullivan County",3,1,80,39,41
050,29,211,"Missouri","Sullivan County",3,2,77,39,38
050,29,211,"Missouri","Sullivan County",3,3,74,42,32
050,29,211,"Missouri","Sullivan County",3,4,75,43,32
050,29,211,"Missouri","Sullivan County",3,5,76,37,39
050,29,211,"Missouri","Sullivan County",3,6,81,41,40
050,29,211,"Missouri","Sullivan County",3,7,84,42,42
050,29,211,"Missouri","Sullivan County",3,8,71,43,28
050,29,211,"Missouri","Sullivan County",3,9,76,43,33
050,29,211,"Missouri","Sullivan County",3,10,74,39,35
050,29,211,"Missouri","Sullivan County",3,11,70,36,34
050,29,211,"Missouri","Sullivan County",3,12,65,37,28
050,29,211,"Missouri","Sullivan County",3,13,60,32,28
050,29,211,"Missouri","Sullivan County",3,14,81,44,37
050,29,211,"Missouri","Sullivan County",3,15,83,47,36
050,29,211,"Missouri","Sullivan County",3,16,79,41,38
050,29,211,"Missouri","Sullivan County",3,17,75,34,41
050,29,211,"Missouri","Sullivan County",3,18,64,30,34
050,29,211,"Missouri","Sullivan County",3,19,59,35,24
050,29,211,"Missouri","Sullivan County",3,20,66,40,26
050,29,211,"Missouri","Sullivan County",3,21,66,36,30
050,29,211,"Missouri","Sullivan County",3,22,66,31,35
050,29,211,"Missouri","Sullivan County",3,23,61,33,28
050,29,211,"Missouri","Sullivan County",3,24,63,33,30
050,29,211,"Missouri","Sullivan County",3,25,72,33,39
050,29,211,"Missouri","Sullivan County",3,26,69,27,42
050,29,211,"Missouri","Sullivan County",3,27,74,32,42
050,29,211,"Missouri","Sullivan County",3,28,63,32,31
050,29,211,"Missouri","Sullivan County",3,29,65,37,28
050,29,211,"Missouri","Sullivan County",3,30,59,31,28
050,29,211,"Missouri","Sullivan County",3,31,69,37,32
050,29,211,"Missouri","Sullivan County",3,32,63,32,31
050,29,211,"Missouri","Sullivan County",3,33,57,29,28
050,29,211,"Missouri","Sullivan County",3,34,49,23,26
050,29,211,"Missouri","Sullivan County",3,35,53,29,24
050,29,211,"Missouri","Sullivan County",3,36,61,32,29
050,29,211,"Missouri","Sullivan County",3,37,57,32,25
050,29,211,"Missouri","Sullivan County",3,38,52,23,29
050,29,211,"Missouri","Sullivan County",3,39,58,27,31
050,29,211,"Missouri","Sullivan County",3,40,60,30,30
050,29,211,"Missouri","Sullivan County",3,41,71,39,32
050,29,211,"Missouri","Sullivan County",3,42,72,40,32
050,29,211,"Missouri","Sullivan County",3,43,66,31,35
050,29,211,"Missouri","Sullivan County",3,44,69,34,35
050,29,211,"Missouri","Sullivan County",3,45,76,42,34
050,29,211,"Missouri","Sullivan County",3,46,76,39,37
050,29,211,"Missouri","Sullivan County",3,47,62,31,31
050,29,211,"Missouri","Sullivan County",3,48,69,33,36
050,29,211,"Missouri","Sullivan County",3,49,82,43,39
050,29,211,"Missouri","Sullivan County",3,50,83,45,38
050,29,211,"Missouri","Sullivan County",3,51,80,37,43
050,29,211,"Missouri","Sullivan County",3,52,82,41,41
050,29,211,"Missouri","Sullivan County",3,53,78,38,40
050,29,211,"Missouri","Sullivan County",3,54,88,39,49
050,29,211,"Missouri","Sullivan County",3,55,75,38,37
050,29,211,"Missouri","Sullivan County",3,56,84,46,38
050,29,211,"Missouri","Sullivan County",3,57,87,45,42
050,29,211,"Missouri","Sullivan County",3,58,88,44,44
050,29,211,"Missouri","Sullivan County",3,59,92,44,48
050,29,211,"Missouri","Sullivan County",3,60,78,42,36
050,29,211,"Missouri","Sullivan County",3,61,96,57,39
050,29,211,"Missouri","Sullivan County",3,62,93,58,35
050,29,211,"Missouri","Sullivan County",3,63,87,50,37
050,29,211,"Missouri","Sullivan County",3,64,80,52,28
050,29,211,"Missouri","Sullivan County",3,65,69,40,29
050,29,211,"Missouri","Sullivan County",3,66,68,35,33
050,29,211,"Missouri","Sullivan County",3,67,71,35,36
050,29,211,"Missouri","Sullivan County",3,68,80,42,38
050,29,211,"Missouri","Sullivan County",3,69,71,40,31
050,29,211,"Missouri","Sullivan County",3,70,68,35,33
050,29,211,"Missouri","Sullivan County",3,71,68,30,38
050,29,211,"Missouri","Sullivan County",3,72,66,27,39
050,29,211,"Missouri","Sullivan County",3,73,66,30,36
050,29,211,"Missouri","Sullivan County",3,74,69,36,33
050,29,211,"Missouri","Sullivan County",3,75,49,29,20
050,29,211,"Missouri","Sullivan County",3,76,36,25,11
050,29,211,"Missouri","Sullivan County",3,77,44,20,24
050,29,211,"Missouri","Sullivan County",3,78,46,20,26
050,29,211,"Missouri","Sullivan County",3,79,36,18,18
050,29,211,"Missouri","Sullivan County",3,80,30,12,18
050,29,211,"Missouri","Sullivan County",3,81,38,16,22
050,29,211,"Missouri","Sullivan County",3,82,33,16,17
050,29,211,"Missouri","Sullivan County",3,83,30,13,17
050,29,211,"Missouri","Sullivan County",3,84,30,18,12
050,29,211,"Missouri","Sullivan County",3,85,146,44,102
050,29,211,"Missouri","Sullivan County",4,0,62,27,35
050,29,211,"Missouri","Sullivan County",4,1,62,32,30
050,29,211,"Missouri","Sullivan County",4,2,74,35,39
050,29,211,"Missouri","Sullivan County",4,3,73,38,35
050,29,211,"Missouri","Sullivan County",4,4,79,45,34
050,29,211,"Missouri","Sullivan County",4,5,71,41,30
050,29,211,"Missouri","Sullivan County",4,6,76,39,37
050,29,211,"Missouri","Sullivan County",4,7,75,41,34
050,29,211,"Missouri","Sullivan County",4,8,87,44,43
050,29,211,"Missouri","Sullivan County",4,9,70,40,30
050,29,211,"Missouri","Sullivan County",4,10,72,40,32
050,29,211,"Missouri","Sullivan County",4,11,75,40,35
050,29,211,"Missouri","Sullivan County",4,12,70,35,35
050,29,211,"Missouri","Sullivan County",4,13,61,33,28
050,29,211,"Missouri","Sullivan County",4,14,61,33,28
050,29,211,"Missouri","Sullivan County",4,15,84,47,37
050,29,211,"Missouri","Sullivan County",4,16,78,47,31
050,29,211,"Missouri","Sullivan County",4,17,79,40,39
050,29,211,"Missouri","Sullivan County",4,18,66,34,32
050,29,211,"Missouri","Sullivan County",4,19,53,22,31
050,29,211,"Missouri","Sullivan County",4,20,57,34,23
050,29,211,"Missouri","Sullivan County",4,21,67,42,25
050,29,211,"Missouri","Sullivan County",4,22,63,29,34
050,29,211,"Missouri","Sullivan County",4,23,65,28,37
050,29,211,"Missouri","Sullivan County",4,24,57,31,26
050,29,211,"Missouri","Sullivan County",4,25,59,34,25
050,29,211,"Missouri","Sullivan County",4,26,69,30,39
050,29,211,"Missouri","Sullivan County",4,27,69,29,40
050,29,211,"Missouri","Sullivan County",4,28,80,31,49
050,29,211,"Missouri","Sullivan County",4,29,65,35,30
050,29,211,"Missouri","Sullivan County",4,30,67,40,27
050,29,211,"Missouri","Sullivan County",4,31,64,33,31
050,29,211,"Missouri","Sullivan County",4,32,65,32,33
050,29,211,"Missouri","Sullivan County",4,33,61,29,32
050,29,211,"Missouri","Sullivan County",4,34,60,32,28
050,29,211,"Missouri","Sullivan County",4,35,48,25,23
050,29,211,"Missouri","Sullivan County",4,36,62,31,31
050,29,211,"Missouri","Sullivan County",4,37,64,36,28
050,29,211,"Missouri","Sullivan County",4,38,52,27,25
050,29,211,"Missouri","Sullivan County",4,39,54,26,28
050,29,211,"Missouri","Sullivan County",4,40,59,28,31
050,29,211,"Missouri","Sullivan County",4,41,58,29,29
050,29,211,"Missouri","Sullivan County",4,42,56,32,24
050,29,211,"Missouri","Sullivan County",4,43,72,39,33
050,29,211,"Missouri","Sullivan County",4,44,67,31,36
050,29,211,"Missouri","Sullivan County",4,45,74,38,36
050,29,211,"Missouri","Sullivan County",4,46,77,43,34
050,29,211,"Missouri","Sullivan County",4,47,75,41,34
050,29,211,"Missouri","Sullivan County",4,48,61,28,33
050,29,211,"Missouri","Sullivan County",4,49,64,33,31
050,29,211,"Missouri","Sullivan County",4,50,72,40,32
050,29,211,"Missouri","Sullivan County",4,51,81,43,38
050,29,211,"Missouri","Sullivan County",4,52,85,42,43
050,29,211,"Missouri","Sullivan County",4,53,83,41,42
050,29,211,"Missouri","Sullivan County",4,54,80,40,40
050,29,211,"Missouri","Sullivan County",4,55,83,34,49
050,29,211,"Missouri","Sullivan County",4,56,78,41,37
050,29,211,"Missouri","Sullivan County",4,57,83,42,41
050,29,211,"Missouri","Sullivan County",4,58,84,45,39
050,29,211,"Missouri","Sullivan County",4,59,86,42,44
050,29,211,"Missouri","Sullivan County",4,60,87,42,45
050,29,211,"Missouri","Sullivan County",4,61,78,40,38
050,29,211,"Missouri","Sullivan County",4,62,93,59,34
050,29,211,"Missouri","Sullivan County",4,63,92,56,36
050,29,211,"Missouri","Sullivan County",4,64,84,49,35
050,29,211,"Missouri","Sullivan County",4,65,79,51,28
050,29,211,"Missouri","Sullivan County",4,66,66,36,30
050,29,211,"Missouri","Sullivan County",4,67,66,33,33
050,29,211,"Missouri","Sullivan County",4,68,66,34,32
050,29,211,"Missouri","Sullivan County",4,69,71,38,33
050,29,211,"Missouri","Sullivan County",4,70,67,40,27
050,29,211,"Missouri","Sullivan County",4,71,66,34,32
050,29,211,"Missouri","Sullivan County",4,72,70,30,40
050,29,211,"Missouri","Sullivan County",4,73,64,25,39
050,29,211,"Missouri","Sullivan County",4,74,69,34,35
050,29,211,"Missouri","Sullivan County",4,75,62,34,28
050,29,211,"Missouri","Sullivan County",4,76,44,26,18
050,29,211,"Missouri","Sullivan County",4,77,37,26,11
050,29,211,"Missouri","Sullivan County",4,78,45,17,28
050,29,211,"Missouri","Sullivan County",4,79,41,20,21
050,29,211,"Missouri","Sullivan County",4,80,32,16,16
050,29,211,"Missouri","Sullivan County",4,81,38,17,21
050,29,211,"Missouri","Sullivan County",4,82,33,15,18
050,29,211,"Missouri","Sullivan County",4,83,36,13,23
050,29,211,"Missouri","Sullivan County",4,84,23,12,11
050,29,211,"Missouri","Sullivan County",4,85,153,47,106
050,29,211,"Missouri","Sullivan County",5,0,66,27,39
050,29,211,"Missouri","Sullivan County",5,1,60,27,33
050,29,211,"Missouri","Sullivan County",5,2,64,28,36
050,29,211,"Missouri","Sullivan County",5,3,84,36,48
050,29,211,"Missouri","Sullivan County",5,4,76,39,37
050,29,211,"Missouri","Sullivan County",5,5,75,44,31
050,29,211,"Missouri","Sullivan County",5,6,73,43,30
050,29,211,"Missouri","Sullivan County",5,7,81,42,39
050,29,211,"Missouri","Sullivan County",5,8,81,44,37
050,29,211,"Missouri","Sullivan County",5,9,82,39,43
050,29,211,"Missouri","Sullivan County",5,10,65,37,28
050,29,211,"Missouri","Sullivan County",5,11,67,37,30
050,29,211,"Missouri","Sullivan County",5,12,67,37,30
050,29,211,"Missouri","Sullivan County",5,13,64,31,33
050,29,211,"Missouri","Sullivan County",5,14,61,32,29
050,29,211,"Missouri","Sullivan County",5,15,57,32,25
050,29,211,"Missouri","Sullivan County",5,16,84,46,38
050,29,211,"Missouri","Sullivan County",5,17,76,44,32
050,29,211,"Missouri","Sullivan County",5,18,68,39,29
050,29,211,"Missouri","Sullivan County",5,19,52,27,25
050,29,211,"Missouri","Sullivan County",5,20,56,23,33
050,29,211,"Missouri","Sullivan County",5,21,59,36,23
050,29,211,"Missouri","Sullivan County",5,22,67,43,24
050,29,211,"Missouri","Sullivan County",5,23,69,31,38
050,29,211,"Missouri","Sullivan County",5,24,71,32,39
050,29,211,"Missouri","Sullivan County",5,25,65,33,32
050,29,211,"Missouri","Sullivan County",5,26,61,28,33
050,29,211,"Missouri","Sullivan County",5,27,72,29,43
050,29,211,"Missouri","Sullivan County",5,28,68,30,38
050,29,211,"Missouri","Sullivan County",5,29,70,32,38
050,29,211,"Missouri","Sullivan County",5,30,68,39,29
050,29,211,"Missouri","Sullivan County",5,31,68,37,31
050,29,211,"Missouri","Sullivan County",5,32,71,38,33
050,29,211,"Missouri","Sullivan County",5,33,68,34,34
050,29,211,"Missouri","Sullivan County",5,34,63,29,34
050,29,211,"Missouri","Sullivan County",5,35,54,29,25
050,29,211,"Missouri","Sullivan County",5,36,48,25,23
050,29,211,"Missouri","Sullivan County",5,37,63,33,30
050,29,211,"Missouri","Sullivan County",5,38,63,35,28
050,29,211,"Missouri","Sullivan County",5,39,57,32,25
050,29,211,"Missouri","Sullivan County",5,40,50,25,25
050,29,211,"Missouri","Sullivan County",5,41,59,28,31
050,29,211,"Missouri","Sullivan County",5,42,55,25,30
050,29,211,"Missouri","Sullivan County",5,43,56,31,25
050,29,211,"Missouri","Sullivan County",5,44,70,39,31
050,29,211,"Missouri","Sullivan County",5,45,63,29,34
050,29,211,"Missouri","Sullivan County",5,46,77,40,37
050,29,211,"Missouri","Sullivan County",5,47,79,42,37
050,29,211,"Missouri","Sullivan County",5,48,83,46,37
050,29,211,"Missouri","Sullivan County",5,49,63,33,30
050,29,211,"Missouri","Sullivan County",5,50,65,31,34
050,29,211,"Missouri","Sullivan County",5,51,72,40,32
050,29,211,"Missouri","Sullivan County",5,52,82,44,38
050,29,211,"Missouri","Sullivan County",5,53,82,41,41
050,29,211,"Missouri","Sullivan County",5,54,81,39,42
050,29,211,"Missouri","Sullivan County",5,55,82,40,42
050,29,211,"Missouri","Sullivan County",5,56,85,35,50
050,29,211,"Missouri","Sullivan County",5,57,78,38,40
050,29,211,"Missouri","Sullivan County",5,58,82,42,40
050,29,211,"Missouri","Sullivan County",5,59,85,44,41
050,29,211,"Missouri","Sullivan County",5,60,79,41,38
050,29,211,"Missouri","Sullivan County",5,61,89,40,49
050,29,211,"Missouri","Sullivan County",5,62,77,42,35
050,29,211,"Missouri","Sullivan County",5,63,90,56,34
050,29,211,"Missouri","Sullivan County",5,64,93,56,37
050,29,211,"Missouri","Sullivan County",5,65,87,52,35
050,29,211,"Missouri","Sullivan County",5,66,76,49,27
050,29,211,"Missouri","Sullivan County",5,67,66,36,30
050,29,211,"Missouri","Sullivan County",5,68,63,31,32
050,29,211,"Missouri","Sullivan County",5,69,56,28,28
050,29,211,"Missouri","Sullivan County",5,70,68,38,30
050,29,211,"Missouri","Sullivan County",5,71,64,36,28
050,29,211,"Missouri","Sullivan County",5,72,64,32,32
050,29,211,"Missouri","Sullivan County",5,73,66,28,38
050,29,211,"Missouri","Sullivan County",5,74,64,28,36
050,29,211,"Missouri","Sullivan County",5,75,66,35,31
050,29,211,"Missouri","Sullivan County",5,76,54,30,24
050,29,211,"Missouri","Sullivan County",5,77,41,25,16
050,29,211,"Missouri","Sullivan County",5,78,37,22,15
050,29,211,"Missouri","Sullivan County",5,79,38,18,20
050,29,211,"Missouri","Sullivan County",5,80,37,19,18
050,29,211,"Missouri","Sullivan County",5,81,39,20,19
050,29,211,"Missouri","Sullivan County",5,82,33,15,18
050,29,211,"Missouri","Sullivan County",5,83,34,12,22
050,29,211,"Missouri","Sullivan County",5,84,29,12,17
050,29,211,"Missouri","Sullivan County",5,85,154,48,106
050,29,213,"Missouri","Taney County",1,0,630,319,311
050,29,213,"Missouri","Taney County",1,1,624,313,311
050,29,213,"Missouri","Taney County",1,2,579,306,273
050,29,213,"Missouri","Taney County",1,3,606,310,296
050,29,213,"Missouri","Taney County",1,4,667,337,330
050,29,213,"Missouri","Taney County",1,5,649,320,329
050,29,213,"Missouri","Taney County",1,6,625,321,304
050,29,213,"Missouri","Taney County",1,7,612,324,288
050,29,213,"Missouri","Taney County",1,8,638,341,297
050,29,213,"Missouri","Taney County",1,9,648,352,296
050,29,213,"Missouri","Taney County",1,10,684,359,325
050,29,213,"Missouri","Taney County",1,11,702,371,331
050,29,213,"Missouri","Taney County",1,12,706,351,355
050,29,213,"Missouri","Taney County",1,13,717,367,350
050,29,213,"Missouri","Taney County",1,14,704,370,334
050,29,213,"Missouri","Taney County",1,15,694,353,341
050,29,213,"Missouri","Taney County",1,16,726,368,358
050,29,213,"Missouri","Taney County",1,17,683,349,334
050,29,213,"Missouri","Taney County",1,18,785,404,381
050,29,213,"Missouri","Taney County",1,19,1012,483,529
050,29,213,"Missouri","Taney County",1,20,962,481,481
050,29,213,"Missouri","Taney County",1,21,914,440,474
050,29,213,"Missouri","Taney County",1,22,818,408,410
050,29,213,"Missouri","Taney County",1,23,651,326,325
050,29,213,"Missouri","Taney County",1,24,667,330,337
050,29,213,"Missouri","Taney County",1,25,647,338,309
050,29,213,"Missouri","Taney County",1,26,623,301,322
050,29,213,"Missouri","Taney County",1,27,636,325,311
050,29,213,"Missouri","Taney County",1,28,662,311,351
050,29,213,"Missouri","Taney County",1,29,622,312,310
050,29,213,"Missouri","Taney County",1,30,578,291,287
050,29,213,"Missouri","Taney County",1,31,571,285,286
050,29,213,"Missouri","Taney County",1,32,556,269,287
050,29,213,"Missouri","Taney County",1,33,595,289,306
050,29,213,"Missouri","Taney County",1,34,564,263,301
050,29,213,"Missouri","Taney County",1,35,571,273,298
050,29,213,"Missouri","Taney County",1,36,625,288,337
050,29,213,"Missouri","Taney County",1,37,626,306,320
050,29,213,"Missouri","Taney County",1,38,604,296,308
050,29,213,"Missouri","Taney County",1,39,657,319,338
050,29,213,"Missouri","Taney County",1,40,697,332,365
050,29,213,"Missouri","Taney County",1,41,655,313,342
050,29,213,"Missouri","Taney County",1,42,610,281,329
050,29,213,"Missouri","Taney County",1,43,612,296,316
050,29,213,"Missouri","Taney County",1,44,577,264,313
050,29,213,"Missouri","Taney County",1,45,603,291,312
050,29,213,"Missouri","Taney County",1,46,591,302,289
050,29,213,"Missouri","Taney County",1,47,629,323,306
050,29,213,"Missouri","Taney County",1,48,682,333,349
050,29,213,"Missouri","Taney County",1,49,657,317,340
050,29,213,"Missouri","Taney County",1,50,608,285,323
050,29,213,"Missouri","Taney County",1,51,661,342,319
050,29,213,"Missouri","Taney County",1,52,648,319,329
050,29,213,"Missouri","Taney County",1,53,620,274,346
050,29,213,"Missouri","Taney County",1,54,709,355,354
050,29,213,"Missouri","Taney County",1,55,707,349,358
050,29,213,"Missouri","Taney County",1,56,743,340,403
050,29,213,"Missouri","Taney County",1,57,736,366,370
050,29,213,"Missouri","Taney County",1,58,796,403,393
050,29,213,"Missouri","Taney County",1,59,773,389,384
050,29,213,"Missouri","Taney County",1,60,754,349,405
050,29,213,"Missouri","Taney County",1,61,768,374,394
050,29,213,"Missouri","Taney County",1,62,801,374,427
050,29,213,"Missouri","Taney County",1,63,733,340,393
050,29,213,"Missouri","Taney County",1,64,728,336,392
050,29,213,"Missouri","Taney County",1,65,750,361,389
050,29,213,"Missouri","Taney County",1,66,724,347,377
050,29,213,"Missouri","Taney County",1,67,763,365,398
050,29,213,"Missouri","Taney County",1,68,779,364,415
050,29,213,"Missouri","Taney County",1,69,739,320,419
050,29,213,"Missouri","Taney County",1,70,737,351,386
050,29,213,"Missouri","Taney County",1,71,712,346,366
050,29,213,"Missouri","Taney County",1,72,709,332,377
050,29,213,"Missouri","Taney County",1,73,692,322,370
050,29,213,"Missouri","Taney County",1,74,496,218,278
050,29,213,"Missouri","Taney County",1,75,528,259,269
050,29,213,"Missouri","Taney County",1,76,516,249,267
050,29,213,"Missouri","Taney County",1,77,493,225,268
050,29,213,"Missouri","Taney County",1,78,427,200,227
050,29,213,"Missouri","Taney County",1,79,406,194,212
050,29,213,"Missouri","Taney County",1,80,372,181,191
050,29,213,"Missouri","Taney County",1,81,334,149,185
050,29,213,"Missouri","Taney County",1,82,293,127,166
050,29,213,"Missouri","Taney County",1,83,262,123,139
050,29,213,"Missouri","Taney County",1,84,230,107,123
050,29,213,"Missouri","Taney County",1,85,1158,475,683
050,29,213,"Missouri","Taney County",2,0,612,317,295
050,29,213,"Missouri","Taney County",2,1,621,313,308
050,29,213,"Missouri","Taney County",2,2,591,308,283
050,29,213,"Missouri","Taney County",2,3,605,310,295
050,29,213,"Missouri","Taney County",2,4,657,333,324
050,29,213,"Missouri","Taney County",2,5,657,328,329
050,29,213,"Missouri","Taney County",2,6,628,322,306
050,29,213,"Missouri","Taney County",2,7,620,326,294
050,29,213,"Missouri","Taney County",2,8,636,340,296
050,29,213,"Missouri","Taney County",2,9,650,351,299
050,29,213,"Missouri","Taney County",2,10,679,360,319
050,29,213,"Missouri","Taney County",2,11,695,367,328
050,29,213,"Missouri","Taney County",2,12,709,358,351
050,29,213,"Missouri","Taney County",2,13,719,367,352
050,29,213,"Missouri","Taney County",2,14,708,370,338
050,29,213,"Missouri","Taney County",2,15,698,359,339
050,29,213,"Missouri","Taney County",2,16,719,368,351
050,29,213,"Missouri","Taney County",2,17,696,357,339
050,29,213,"Missouri","Taney County",2,18,771,396,375
050,29,213,"Missouri","Taney County",2,19,1009,481,528
050,29,213,"Missouri","Taney County",2,20,968,483,485
050,29,213,"Missouri","Taney County",2,21,919,447,472
050,29,213,"Missouri","Taney County",2,22,813,403,410
050,29,213,"Missouri","Taney County",2,23,654,324,330
050,29,213,"Missouri","Taney County",2,24,657,330,327
050,29,213,"Missouri","Taney County",2,25,641,327,314
050,29,213,"Missouri","Taney County",2,26,620,303,317
050,29,213,"Missouri","Taney County",2,27,628,316,312
050,29,213,"Missouri","Taney County",2,28,651,314,337
050,29,213,"Missouri","Taney County",2,29,630,312,318
050,29,213,"Missouri","Taney County",2,30,594,296,298
050,29,213,"Missouri","Taney County",2,31,568,285,283
050,29,213,"Missouri","Taney County",2,32,558,274,284
050,29,213,"Missouri","Taney County",2,33,581,282,299
050,29,213,"Missouri","Taney County",2,34,566,268,298
050,29,213,"Missouri","Taney County",2,35,571,268,303
050,29,213,"Missouri","Taney County",2,36,605,284,321
050,29,213,"Missouri","Taney County",2,37,630,303,327
050,29,213,"Missouri","Taney County",2,38,614,298,316
050,29,213,"Missouri","Taney County",2,39,642,313,329
050,29,213,"Missouri","Taney County",2,40,696,334,362
050,29,213,"Missouri","Taney County",2,41,666,315,351
050,29,213,"Missouri","Taney County",2,42,617,291,326
050,29,213,"Missouri","Taney County",2,43,620,297,323
050,29,213,"Missouri","Taney County",2,44,577,270,307
050,29,213,"Missouri","Taney County",2,45,600,288,312
050,29,213,"Missouri","Taney County",2,46,595,301,294
050,29,213,"Missouri","Taney County",2,47,618,315,303
050,29,213,"Missouri","Taney County",2,48,666,331,335
050,29,213,"Missouri","Taney County",2,49,661,320,341
050,29,213,"Missouri","Taney County",2,50,619,292,327
050,29,213,"Missouri","Taney County",2,51,645,325,320
050,29,213,"Missouri","Taney County",2,52,644,319,325
050,29,213,"Missouri","Taney County",2,53,628,287,341
050,29,213,"Missouri","Taney County",2,54,683,335,348
050,29,213,"Missouri","Taney County",2,55,712,353,359
050,29,213,"Missouri","Taney County",2,56,736,343,393
050,29,213,"Missouri","Taney County",2,57,740,360,380
050,29,213,"Missouri","Taney County",2,58,775,391,384
050,29,213,"Missouri","Taney County",2,59,782,393,389
050,29,213,"Missouri","Taney County",2,60,758,357,401
050,29,213,"Missouri","Taney County",2,61,767,369,398
050,29,213,"Missouri","Taney County",2,62,795,375,420
050,29,213,"Missouri","Taney County",2,63,762,354,408
050,29,213,"Missouri","Taney County",2,64,726,335,391
050,29,213,"Missouri","Taney County",2,65,746,357,389
050,29,213,"Missouri","Taney County",2,66,737,352,385
050,29,213,"Missouri","Taney County",2,67,751,361,390
050,29,213,"Missouri","Taney County",2,68,775,364,411
050,29,213,"Missouri","Taney County",2,69,751,331,420
050,29,213,"Missouri","Taney County",2,70,732,339,393
050,29,213,"Missouri","Taney County",2,71,718,347,371
050,29,213,"Missouri","Taney County",2,72,697,332,365
050,29,213,"Missouri","Taney County",2,73,728,337,391
050,29,213,"Missouri","Taney County",2,74,500,224,276
050,29,213,"Missouri","Taney County",2,75,516,244,272
050,29,213,"Missouri","Taney County",2,76,510,245,265
050,29,213,"Missouri","Taney County",2,77,504,232,272
050,29,213,"Missouri","Taney County",2,78,430,200,230
050,29,213,"Missouri","Taney County",2,79,400,190,210
050,29,213,"Missouri","Taney County",2,80,376,182,194
050,29,213,"Missouri","Taney County",2,81,338,153,185
050,29,213,"Missouri","Taney County",2,82,300,129,171
050,29,213,"Missouri","Taney County",2,83,264,121,143
050,29,213,"Missouri","Taney County",2,84,233,109,124
050,29,213,"Missouri","Taney County",2,85,1178,484,694
050,29,213,"Missouri","Taney County",3,0,571,293,278
050,29,213,"Missouri","Taney County",3,1,638,317,321
050,29,213,"Missouri","Taney County",3,2,600,303,297
050,29,213,"Missouri","Taney County",3,3,597,306,291
050,29,213,"Missouri","Taney County",3,4,602,319,283
050,29,213,"Missouri","Taney County",3,5,633,322,311
050,29,213,"Missouri","Taney County",3,6,665,333,332
050,29,213,"Missouri","Taney County",3,7,619,311,308
050,29,213,"Missouri","Taney County",3,8,636,328,308
050,29,213,"Missouri","Taney County",3,9,635,340,295
050,29,213,"Missouri","Taney County",3,10,635,345,290
050,29,213,"Missouri","Taney County",3,11,681,345,336
050,29,213,"Missouri","Taney County",3,12,695,363,332
050,29,213,"Missouri","Taney County",3,13,721,366,355
050,29,213,"Missouri","Taney County",3,14,721,375,346
050,29,213,"Missouri","Taney County",3,15,719,374,345
050,29,213,"Missouri","Taney County",3,16,717,370,347
050,29,213,"Missouri","Taney County",3,17,727,376,351
050,29,213,"Missouri","Taney County",3,18,775,390,385
050,29,213,"Missouri","Taney County",3,19,975,452,523
050,29,213,"Missouri","Taney County",3,20,996,496,500
050,29,213,"Missouri","Taney County",3,21,927,465,462
050,29,213,"Missouri","Taney County",3,22,797,391,406
050,29,213,"Missouri","Taney County",3,23,662,320,342
050,29,213,"Missouri","Taney County",3,24,648,330,318
050,29,213,"Missouri","Taney County",3,25,603,310,293
050,29,213,"Missouri","Taney County",3,26,629,322,307
050,29,213,"Missouri","Taney County",3,27,619,321,298
050,29,213,"Missouri","Taney County",3,28,645,319,326
050,29,213,"Missouri","Taney County",3,29,644,307,337
050,29,213,"Missouri","Taney County",3,30,623,314,309
050,29,213,"Missouri","Taney County",3,31,577,278,299
050,29,213,"Missouri","Taney County",3,32,544,268,276
050,29,213,"Missouri","Taney County",3,33,563,273,290
050,29,213,"Missouri","Taney County",3,34,580,281,299
050,29,213,"Missouri","Taney County",3,35,568,266,302
050,29,213,"Missouri","Taney County",3,36,572,262,310
050,29,213,"Missouri","Taney County",3,37,609,297,312
050,29,213,"Missouri","Taney County",3,38,651,302,349
050,29,213,"Missouri","Taney County",3,39,603,284,319
050,29,213,"Missouri","Taney County",3,40,652,320,332
050,29,213,"Missouri","Taney County",3,41,698,335,363
050,29,213,"Missouri","Taney County",3,42,653,315,338
050,29,213,"Missouri","Taney County",3,43,600,280,320
050,29,213,"Missouri","Taney County",3,44,603,295,308
050,29,213,"Missouri","Taney County",3,45,564,265,299
050,29,213,"Missouri","Taney County",3,46,619,299,320
050,29,213,"Missouri","Taney County",3,47,587,299,288
050,29,213,"Missouri","Taney County",3,48,627,321,306
050,29,213,"Missouri","Taney County",3,49,674,326,348
050,29,213,"Missouri","Taney County",3,50,671,328,343
050,29,213,"Missouri","Taney County",3,51,658,323,335
050,29,213,"Missouri","Taney County",3,52,641,322,319
050,29,213,"Missouri","Taney County",3,53,619,307,312
050,29,213,"Missouri","Taney County",3,54,656,292,364
050,29,213,"Missouri","Taney County",3,55,687,331,356
050,29,213,"Missouri","Taney County",3,56,746,363,383
050,29,213,"Missouri","Taney County",3,57,756,348,408
050,29,213,"Missouri","Taney County",3,58,724,361,363
050,29,213,"Missouri","Taney County",3,59,793,408,385
050,29,213,"Missouri","Taney County",3,60,790,392,398
050,29,213,"Missouri","Taney County",3,61,784,364,420
050,29,213,"Missouri","Taney County",3,62,792,373,419
050,29,213,"Missouri","Taney County",3,63,815,392,423
050,29,213,"Missouri","Taney County",3,64,777,367,410
050,29,213,"Missouri","Taney County",3,65,750,350,400
050,29,213,"Missouri","Taney County",3,66,762,364,398
050,29,213,"Missouri","Taney County",3,67,766,370,396
050,29,213,"Missouri","Taney County",3,68,777,369,408
050,29,213,"Missouri","Taney County",3,69,778,368,410
050,29,213,"Missouri","Taney County",3,70,759,339,420
050,29,213,"Missouri","Taney County",3,71,707,331,376
050,29,213,"Missouri","Taney County",3,72,698,337,361
050,29,213,"Missouri","Taney County",3,73,696,323,373
050,29,213,"Missouri","Taney County",3,74,700,331,369
050,29,213,"Missouri","Taney County",3,75,484,210,274
050,29,213,"Missouri","Taney County",3,76,497,231,266
050,29,213,"Missouri","Taney County",3,77,491,235,256
050,29,213,"Missouri","Taney County",3,78,469,216,253
050,29,213,"Missouri","Taney County",3,79,396,178,218
050,29,213,"Missouri","Taney County",3,80,361,162,199
050,29,213,"Missouri","Taney County",3,81,375,178,197
050,29,213,"Missouri","Taney County",3,82,306,137,169
050,29,213,"Missouri","Taney County",3,83,278,119,159
050,29,213,"Missouri","Taney County",3,84,231,106,125
050,29,213,"Missouri","Taney County",3,85,1215,506,709
050,29,213,"Missouri","Taney County",4,0,578,286,292
050,29,213,"Missouri","Taney County",4,1,555,282,273
050,29,213,"Missouri","Taney County",4,2,635,318,317
050,29,213,"Missouri","Taney County",4,3,631,315,316
050,29,213,"Missouri","Taney County",4,4,615,320,295
050,29,213,"Missouri","Taney County",4,5,601,315,286
050,29,213,"Missouri","Taney County",4,6,651,324,327
050,29,213,"Missouri","Taney County",4,7,688,341,347
050,29,213,"Missouri","Taney County",4,8,620,308,312
050,29,213,"Missouri","Taney County",4,9,648,333,315
050,29,213,"Missouri","Taney County",4,10,644,349,295
050,29,213,"Missouri","Taney County",4,11,653,346,307
050,29,213,"Missouri","Taney County",4,12,698,360,338
050,29,213,"Missouri","Taney County",4,13,707,365,342
050,29,213,"Missouri","Taney County",4,14,743,373,370
050,29,213,"Missouri","Taney County",4,15,730,377,353
050,29,213,"Missouri","Taney County",4,16,726,392,334
050,29,213,"Missouri","Taney County",4,17,738,383,355
050,29,213,"Missouri","Taney County",4,18,789,403,386
050,29,213,"Missouri","Taney County",4,19,980,450,530
050,29,213,"Missouri","Taney County",4,20,929,458,471
050,29,213,"Missouri","Taney County",4,21,943,475,468
050,29,213,"Missouri","Taney County",4,22,850,430,420
050,29,213,"Missouri","Taney County",4,23,659,327,332
050,29,213,"Missouri","Taney County",4,24,658,319,339
050,29,213,"Missouri","Taney County",4,25,618,321,297
050,29,213,"Missouri","Taney County",4,26,617,316,301
050,29,213,"Missouri","Taney County",4,27,627,308,319
050,29,213,"Missouri","Taney County",4,28,620,317,303
050,29,213,"Missouri","Taney County",4,29,650,323,327
050,29,213,"Missouri","Taney County",4,30,643,318,325
050,29,213,"Missouri","Taney County",4,31,623,301,322
050,29,213,"Missouri","Taney County",4,32,571,272,299
050,29,213,"Missouri","Taney County",4,33,554,282,272
050,29,213,"Missouri","Taney County",4,34,575,281,294
050,29,213,"Missouri","Taney County",4,35,575,274,301
050,29,213,"Missouri","Taney County",4,36,575,264,311
050,29,213,"Missouri","Taney County",4,37,590,270,320
050,29,213,"Missouri","Taney County",4,38,603,287,316
050,29,213,"Missouri","Taney County",4,39,641,294,347
050,29,213,"Missouri","Taney County",4,40,599,289,310
050,29,213,"Missouri","Taney County",4,41,660,319,341
050,29,213,"Missouri","Taney County",4,42,693,330,363
050,29,213,"Missouri","Taney County",4,43,661,330,331
050,29,213,"Missouri","Taney County",4,44,596,291,305
050,29,213,"Missouri","Taney County",4,45,625,313,312
050,29,213,"Missouri","Taney County",4,46,582,270,312
050,29,213,"Missouri","Taney County",4,47,614,301,313
050,29,213,"Missouri","Taney County",4,48,597,293,304
050,29,213,"Missouri","Taney County",4,49,633,322,311
050,29,213,"Missouri","Taney County",4,50,660,314,346
050,29,213,"Missouri","Taney County",4,51,714,348,366
050,29,213,"Missouri","Taney County",4,52,654,312,342
050,29,213,"Missouri","Taney County",4,53,677,344,333
050,29,213,"Missouri","Taney County",4,54,638,316,322
050,29,213,"Missouri","Taney County",4,55,667,301,366
050,29,213,"Missouri","Taney County",4,56,705,342,363
050,29,213,"Missouri","Taney County",4,57,718,354,364
050,29,213,"Missouri","Taney County",4,58,748,347,401
050,29,213,"Missouri","Taney County",4,59,749,375,374
050,29,213,"Missouri","Taney County",4,60,805,409,396
050,29,213,"Missouri","Taney County",4,61,809,399,410
050,29,213,"Missouri","Taney County",4,62,799,359,440
050,29,213,"Missouri","Taney County",4,63,814,385,429
050,29,213,"Missouri","Taney County",4,64,820,384,436
050,29,213,"Missouri","Taney County",4,65,815,386,429
050,29,213,"Missouri","Taney County",4,66,743,347,396
050,29,213,"Missouri","Taney County",4,67,774,373,401
050,29,213,"Missouri","Taney County",4,68,782,386,396
050,29,213,"Missouri","Taney County",4,69,761,365,396
050,29,213,"Missouri","Taney County",4,70,751,363,388
050,29,213,"Missouri","Taney County",4,71,751,334,417
050,29,213,"Missouri","Taney County",4,72,697,323,374
050,29,213,"Missouri","Taney County",4,73,674,321,353
050,29,213,"Missouri","Taney County",4,74,671,312,359
050,29,213,"Missouri","Taney County",4,75,689,319,370
050,29,213,"Missouri","Taney County",4,76,474,200,274
050,29,213,"Missouri","Taney County",4,77,477,229,248
050,29,213,"Missouri","Taney County",4,78,468,221,247
050,29,213,"Missouri","Taney County",4,79,457,212,245
050,29,213,"Missouri","Taney County",4,80,359,157,202
050,29,213,"Missouri","Taney County",4,81,344,150,194
050,29,213,"Missouri","Taney County",4,82,330,160,170
050,29,213,"Missouri","Taney County",4,83,272,124,148
050,29,213,"Missouri","Taney County",4,84,265,105,160
050,29,213,"Missouri","Taney County",4,85,1207,494,713
050,29,213,"Missouri","Taney County",5,0,575,284,291
050,29,213,"Missouri","Taney County",5,1,576,279,297
050,29,213,"Missouri","Taney County",5,2,552,284,268
050,29,213,"Missouri","Taney County",5,3,606,307,299
050,29,213,"Missouri","Taney County",5,4,645,319,326
050,29,213,"Missouri","Taney County",5,5,621,318,303
050,29,213,"Missouri","Taney County",5,6,612,325,287
050,29,213,"Missouri","Taney County",5,7,634,324,310
050,29,213,"Missouri","Taney County",5,8,673,334,339
050,29,213,"Missouri","Taney County",5,9,646,319,327
050,29,213,"Missouri","Taney County",5,10,660,339,321
050,29,213,"Missouri","Taney County",5,11,647,345,302
050,29,213,"Missouri","Taney County",5,12,652,345,307
050,29,213,"Missouri","Taney County",5,13,692,355,337
050,29,213,"Missouri","Taney County",5,14,710,363,347
050,29,213,"Missouri","Taney County",5,15,745,370,375
050,29,213,"Missouri","Taney County",5,16,732,385,347
050,29,213,"Missouri","Taney County",5,17,728,385,343
050,29,213,"Missouri","Taney County",5,18,766,389,377
050,29,213,"Missouri","Taney County",5,19,985,462,523
050,29,213,"Missouri","Taney County",5,20,929,451,478
050,29,213,"Missouri","Taney County",5,21,916,452,464
050,29,213,"Missouri","Taney County",5,22,842,436,406
050,29,213,"Missouri","Taney County",5,23,724,357,367
050,29,213,"Missouri","Taney County",5,24,675,343,332
050,29,213,"Missouri","Taney County",5,25,641,313,328
050,29,213,"Missouri","Taney County",5,26,613,319,294
050,29,213,"Missouri","Taney County",5,27,610,313,297
050,29,213,"Missouri","Taney County",5,28,604,287,317
050,29,213,"Missouri","Taney County",5,29,623,310,313
050,29,213,"Missouri","Taney County",5,30,652,337,315
050,29,213,"Missouri","Taney County",5,31,624,304,320
050,29,213,"Missouri","Taney County",5,32,623,307,316
050,29,213,"Missouri","Taney County",5,33,582,281,301
050,29,213,"Missouri","Taney County",5,34,555,285,270
050,29,213,"Missouri","Taney County",5,35,571,282,289
050,29,213,"Missouri","Taney County",5,36,572,270,302
050,29,213,"Missouri","Taney County",5,37,595,279,316
050,29,213,"Missouri","Taney County",5,38,568,255,313
050,29,213,"Missouri","Taney County",5,39,598,294,304
050,29,213,"Missouri","Taney County",5,40,632,292,340
050,29,213,"Missouri","Taney County",5,41,607,293,314
050,29,213,"Missouri","Taney County",5,42,665,323,342
050,29,213,"Missouri","Taney County",5,43,700,335,365
050,29,213,"Missouri","Taney County",5,44,644,303,341
050,29,213,"Missouri","Taney County",5,45,606,296,310
050,29,213,"Missouri","Taney County",5,46,629,319,310
050,29,213,"Missouri","Taney County",5,47,582,265,317
050,29,213,"Missouri","Taney County",5,48,622,316,306
050,29,213,"Missouri","Taney County",5,49,591,291,300
050,29,213,"Missouri","Taney County",5,50,643,324,319
050,29,213,"Missouri","Taney County",5,51,663,319,344
050,29,213,"Missouri","Taney County",5,52,717,345,372
050,29,213,"Missouri","Taney County",5,53,661,315,346
050,29,213,"Missouri","Taney County",5,54,681,340,341
050,29,213,"Missouri","Taney County",5,55,645,312,333
050,29,213,"Missouri","Taney County",5,56,685,308,377
050,29,213,"Missouri","Taney County",5,57,724,354,370
050,29,213,"Missouri","Taney County",5,58,712,345,367
050,29,213,"Missouri","Taney County",5,59,739,340,399
050,29,213,"Missouri","Taney County",5,60,767,376,391
050,29,213,"Missouri","Taney County",5,61,822,425,397
050,29,213,"Missouri","Taney County",5,62,797,388,409
050,29,213,"Missouri","Taney County",5,63,823,374,449
050,29,213,"Missouri","Taney County",5,64,826,396,430
050,29,213,"Missouri","Taney County",5,65,810,384,426
050,29,213,"Missouri","Taney County",5,66,798,371,427
050,29,213,"Missouri","Taney County",5,67,758,352,406
050,29,213,"Missouri","Taney County",5,68,816,393,423
050,29,213,"Missouri","Taney County",5,69,754,370,384
050,29,213,"Missouri","Taney County",5,70,746,356,390
050,29,213,"Missouri","Taney County",5,71,716,344,372
050,29,213,"Missouri","Taney County",5,72,735,333,402
050,29,213,"Missouri","Taney County",5,73,686,310,376
050,29,213,"Missouri","Taney County",5,74,657,312,345
050,29,213,"Missouri","Taney County",5,75,648,295,353
050,29,213,"Missouri","Taney County",5,76,674,308,366
050,29,213,"Missouri","Taney County",5,77,438,181,257
050,29,213,"Missouri","Taney County",5,78,455,222,233
050,29,213,"Missouri","Taney County",5,79,457,212,245
050,29,213,"Missouri","Taney County",5,80,415,182,233
050,29,213,"Missouri","Taney County",5,81,332,136,196
050,29,213,"Missouri","Taney County",5,82,307,137,170
050,29,213,"Missouri","Taney County",5,83,301,145,156
050,29,213,"Missouri","Taney County",5,84,258,117,141
050,29,213,"Missouri","Taney County",5,85,1257,503,754
050,29,215,"Missouri","Texas County",1,0,250,130,120
050,29,215,"Missouri","Texas County",1,1,263,137,126
050,29,215,"Missouri","Texas County",1,2,293,148,145
050,29,215,"Missouri","Texas County",1,3,277,147,130
050,29,215,"Missouri","Texas County",1,4,268,140,128
050,29,215,"Missouri","Texas County",1,5,275,135,140
050,29,215,"Missouri","Texas County",1,6,266,131,135
050,29,215,"Missouri","Texas County",1,7,280,135,145
050,29,215,"Missouri","Texas County",1,8,262,125,137
050,29,215,"Missouri","Texas County",1,9,285,144,141
050,29,215,"Missouri","Texas County",1,10,306,161,145
050,29,215,"Missouri","Texas County",1,11,338,172,166
050,29,215,"Missouri","Texas County",1,12,338,166,172
050,29,215,"Missouri","Texas County",1,13,325,176,149
050,29,215,"Missouri","Texas County",1,14,317,178,139
050,29,215,"Missouri","Texas County",1,15,283,163,120
050,29,215,"Missouri","Texas County",1,16,292,155,137
050,29,215,"Missouri","Texas County",1,17,322,156,166
050,29,215,"Missouri","Texas County",1,18,265,146,119
050,29,215,"Missouri","Texas County",1,19,249,158,91
050,29,215,"Missouri","Texas County",1,20,250,159,91
050,29,215,"Missouri","Texas County",1,21,273,174,99
050,29,215,"Missouri","Texas County",1,22,268,162,106
050,29,215,"Missouri","Texas County",1,23,249,134,115
050,29,215,"Missouri","Texas County",1,24,255,152,103
050,29,215,"Missouri","Texas County",1,25,289,177,112
050,29,215,"Missouri","Texas County",1,26,283,169,114
050,29,215,"Missouri","Texas County",1,27,270,158,112
050,29,215,"Missouri","Texas County",1,28,277,158,119
050,29,215,"Missouri","Texas County",1,29,301,172,129
050,29,215,"Missouri","Texas County",1,30,273,156,117
050,29,215,"Missouri","Texas County",1,31,265,145,120
050,29,215,"Missouri","Texas County",1,32,276,158,118
050,29,215,"Missouri","Texas County",1,33,263,148,115
050,29,215,"Missouri","Texas County",1,34,301,168,133
050,29,215,"Missouri","Texas County",1,35,282,149,133
050,29,215,"Missouri","Texas County",1,36,274,155,119
050,29,215,"Missouri","Texas County",1,37,308,180,128
050,29,215,"Missouri","Texas County",1,38,304,180,124
050,29,215,"Missouri","Texas County",1,39,301,162,139
050,29,215,"Missouri","Texas County",1,40,292,154,138
050,29,215,"Missouri","Texas County",1,41,294,153,141
050,29,215,"Missouri","Texas County",1,42,282,162,120
050,29,215,"Missouri","Texas County",1,43,303,165,138
050,29,215,"Missouri","Texas County",1,44,274,155,119
050,29,215,"Missouri","Texas County",1,45,294,162,132
050,29,215,"Missouri","Texas County",1,46,248,144,104
050,29,215,"Missouri","Texas County",1,47,265,159,106
050,29,215,"Missouri","Texas County",1,48,294,159,135
050,29,215,"Missouri","Texas County",1,49,300,158,142
050,29,215,"Missouri","Texas County",1,50,290,162,128
050,29,215,"Missouri","Texas County",1,51,317,167,150
050,29,215,"Missouri","Texas County",1,52,301,173,128
050,29,215,"Missouri","Texas County",1,53,289,158,131
050,29,215,"Missouri","Texas County",1,54,290,150,140
050,29,215,"Missouri","Texas County",1,55,340,176,164
050,29,215,"Missouri","Texas County",1,56,370,205,165
050,29,215,"Missouri","Texas County",1,57,367,194,173
050,29,215,"Missouri","Texas County",1,58,401,197,204
050,29,215,"Missouri","Texas County",1,59,387,195,192
050,29,215,"Missouri","Texas County",1,60,380,202,178
050,29,215,"Missouri","Texas County",1,61,351,182,169
050,29,215,"Missouri","Texas County",1,62,342,179,163
050,29,215,"Missouri","Texas County",1,63,355,182,173
050,29,215,"Missouri","Texas County",1,64,341,180,161
050,29,215,"Missouri","Texas County",1,65,349,174,175
050,29,215,"Missouri","Texas County",1,66,323,171,152
050,29,215,"Missouri","Texas County",1,67,327,151,176
050,29,215,"Missouri","Texas County",1,68,301,145,156
050,29,215,"Missouri","Texas County",1,69,303,140,163
050,29,215,"Missouri","Texas County",1,70,283,131,152
050,29,215,"Missouri","Texas County",1,71,292,143,149
050,29,215,"Missouri","Texas County",1,72,289,135,154
050,29,215,"Missouri","Texas County",1,73,285,139,146
050,29,215,"Missouri","Texas County",1,74,183,82,101
050,29,215,"Missouri","Texas County",1,75,192,95,97
050,29,215,"Missouri","Texas County",1,76,225,108,117
050,29,215,"Missouri","Texas County",1,77,220,106,114
050,29,215,"Missouri","Texas County",1,78,179,92,87
050,29,215,"Missouri","Texas County",1,79,154,70,84
050,29,215,"Missouri","Texas County",1,80,146,66,80
050,29,215,"Missouri","Texas County",1,81,157,73,84
050,29,215,"Missouri","Texas County",1,82,144,76,68
050,29,215,"Missouri","Texas County",1,83,112,52,60
050,29,215,"Missouri","Texas County",1,84,101,44,57
050,29,215,"Missouri","Texas County",1,85,644,240,404
050,29,215,"Missouri","Texas County",2,0,261,134,127
050,29,215,"Missouri","Texas County",2,1,261,136,125
050,29,215,"Missouri","Texas County",2,2,286,146,140
050,29,215,"Missouri","Texas County",2,3,275,144,131
050,29,215,"Missouri","Texas County",2,4,269,142,127
050,29,215,"Missouri","Texas County",2,5,273,137,136
050,29,215,"Missouri","Texas County",2,6,268,131,137
050,29,215,"Missouri","Texas County",2,7,274,133,141
050,29,215,"Missouri","Texas County",2,8,266,128,138
050,29,215,"Missouri","Texas County",2,9,279,138,141
050,29,215,"Missouri","Texas County",2,10,302,157,145
050,29,215,"Missouri","Texas County",2,11,329,169,160
050,29,215,"Missouri","Texas County",2,12,337,166,171
050,29,215,"Missouri","Texas County",2,13,326,173,153
050,29,215,"Missouri","Texas County",2,14,317,177,140
050,29,215,"Missouri","Texas County",2,15,289,166,123
050,29,215,"Missouri","Texas County",2,16,292,159,133
050,29,215,"Missouri","Texas County",2,17,315,158,157
050,29,215,"Missouri","Texas County",2,18,266,144,122
050,29,215,"Missouri","Texas County",2,19,245,154,91
050,29,215,"Missouri","Texas County",2,20,255,160,95
050,29,215,"Missouri","Texas County",2,21,268,170,98
050,29,215,"Missouri","Texas County",2,22,266,159,107
050,29,215,"Missouri","Texas County",2,23,246,133,113
050,29,215,"Missouri","Texas County",2,24,249,144,105
050,29,215,"Missouri","Texas County",2,25,277,169,108
050,29,215,"Missouri","Texas County",2,26,277,165,112
050,29,215,"Missouri","Texas County",2,27,267,155,112
050,29,215,"Missouri","Texas County",2,28,271,153,118
050,29,215,"Missouri","Texas County",2,29,289,164,125
050,29,215,"Missouri","Texas County",2,30,275,155,120
050,29,215,"Missouri","Texas County",2,31,259,140,119
050,29,215,"Missouri","Texas County",2,32,269,152,117
050,29,215,"Missouri","Texas County",2,33,261,146,115
050,29,215,"Missouri","Texas County",2,34,289,160,129
050,29,215,"Missouri","Texas County",2,35,281,148,133
050,29,215,"Missouri","Texas County",2,36,274,151,123
050,29,215,"Missouri","Texas County",2,37,296,170,126
050,29,215,"Missouri","Texas County",2,38,301,177,124
050,29,215,"Missouri","Texas County",2,39,294,160,134
050,29,215,"Missouri","Texas County",2,40,292,152,140
050,29,215,"Missouri","Texas County",2,41,291,150,141
050,29,215,"Missouri","Texas County",2,42,282,157,125
050,29,215,"Missouri","Texas County",2,43,301,166,135
050,29,215,"Missouri","Texas County",2,44,274,151,123
050,29,215,"Missouri","Texas County",2,45,289,159,130
050,29,215,"Missouri","Texas County",2,46,257,146,111
050,29,215,"Missouri","Texas County",2,47,259,153,106
050,29,215,"Missouri","Texas County",2,48,279,151,128
050,29,215,"Missouri","Texas County",2,49,298,157,141
050,29,215,"Missouri","Texas County",2,50,291,159,132
050,29,215,"Missouri","Texas County",2,51,310,166,144
050,29,215,"Missouri","Texas County",2,52,301,168,133
050,29,215,"Missouri","Texas County",2,53,288,158,130
050,29,215,"Missouri","Texas County",2,54,288,151,137
050,29,215,"Missouri","Texas County",2,55,325,167,158
050,29,215,"Missouri","Texas County",2,56,363,198,165
050,29,215,"Missouri","Texas County",2,57,362,193,169
050,29,215,"Missouri","Texas County",2,58,390,195,195
050,29,215,"Missouri","Texas County",2,59,395,197,198
050,29,215,"Missouri","Texas County",2,60,377,197,180
050,29,215,"Missouri","Texas County",2,61,354,185,169
050,29,215,"Missouri","Texas County",2,62,344,179,165
050,29,215,"Missouri","Texas County",2,63,352,181,171
050,29,215,"Missouri","Texas County",2,64,342,178,164
050,29,215,"Missouri","Texas County",2,65,345,174,171
050,29,215,"Missouri","Texas County",2,66,332,174,158
050,29,215,"Missouri","Texas County",2,67,322,156,166
050,29,215,"Missouri","Texas County",2,68,303,144,159
050,29,215,"Missouri","Texas County",2,69,304,140,164
050,29,215,"Missouri","Texas County",2,70,286,133,153
050,29,215,"Missouri","Texas County",2,71,288,138,150
050,29,215,"Missouri","Texas County",2,72,284,135,149
050,29,215,"Missouri","Texas County",2,73,297,146,151
050,29,215,"Missouri","Texas County",2,74,191,88,103
050,29,215,"Missouri","Texas County",2,75,191,92,99
050,29,215,"Missouri","Texas County",2,76,215,103,112
050,29,215,"Missouri","Texas County",2,77,222,107,115
050,29,215,"Missouri","Texas County",2,78,181,92,89
050,29,215,"Missouri","Texas County",2,79,157,73,84
050,29,215,"Missouri","Texas County",2,80,147,67,80
050,29,215,"Missouri","Texas County",2,81,151,68,83
050,29,215,"Missouri","Texas County",2,82,146,74,72
050,29,215,"Missouri","Texas County",2,83,114,55,59
050,29,215,"Missouri","Texas County",2,84,101,44,57
050,29,215,"Missouri","Texas County",2,85,649,243,406
050,29,215,"Missouri","Texas County",3,0,269,133,136
050,29,215,"Missouri","Texas County",3,1,266,137,129
050,29,215,"Missouri","Texas County",3,2,270,139,131
050,29,215,"Missouri","Texas County",3,3,291,151,140
050,29,215,"Missouri","Texas County",3,4,296,156,140
050,29,215,"Missouri","Texas County",3,5,288,146,142
050,29,215,"Missouri","Texas County",3,6,290,156,134
050,29,215,"Missouri","Texas County",3,7,281,140,141
050,29,215,"Missouri","Texas County",3,8,291,143,148
050,29,215,"Missouri","Texas County",3,9,256,126,130
050,29,215,"Missouri","Texas County",3,10,293,139,154
050,29,215,"Missouri","Texas County",3,11,311,169,142
050,29,215,"Missouri","Texas County",3,12,347,173,174
050,29,215,"Missouri","Texas County",3,13,352,172,180
050,29,215,"Missouri","Texas County",3,14,338,185,153
050,29,215,"Missouri","Texas County",3,15,316,172,144
050,29,215,"Missouri","Texas County",3,16,311,170,141
050,29,215,"Missouri","Texas County",3,17,317,178,139
050,29,215,"Missouri","Texas County",3,18,280,144,136
050,29,215,"Missouri","Texas County",3,19,232,141,91
050,29,215,"Missouri","Texas County",3,20,261,166,95
050,29,215,"Missouri","Texas County",3,21,291,181,110
050,29,215,"Missouri","Texas County",3,22,284,174,110
050,29,215,"Missouri","Texas County",3,23,274,165,109
050,29,215,"Missouri","Texas County",3,24,274,156,118
050,29,215,"Missouri","Texas County",3,25,259,154,105
050,29,215,"Missouri","Texas County",3,26,289,176,113
050,29,215,"Missouri","Texas County",3,27,298,170,128
050,29,215,"Missouri","Texas County",3,28,270,154,116
050,29,215,"Missouri","Texas County",3,29,294,172,122
050,29,215,"Missouri","Texas County",3,30,315,183,132
050,29,215,"Missouri","Texas County",3,31,281,148,133
050,29,215,"Missouri","Texas County",3,32,281,160,121
050,29,215,"Missouri","Texas County",3,33,278,166,112
050,29,215,"Missouri","Texas County",3,34,291,166,125
050,29,215,"Missouri","Texas County",3,35,293,162,131
050,29,215,"Missouri","Texas County",3,36,306,162,144
050,29,215,"Missouri","Texas County",3,37,281,156,125
050,29,215,"Missouri","Texas County",3,38,293,179,114
050,29,215,"Missouri","Texas County",3,39,333,196,137
050,29,215,"Missouri","Texas County",3,40,305,167,138
050,29,215,"Missouri","Texas County",3,41,298,155,143
050,29,215,"Missouri","Texas County",3,42,299,160,139
050,29,215,"Missouri","Texas County",3,43,296,170,126
050,29,215,"Missouri","Texas County",3,44,294,154,140
050,29,215,"Missouri","Texas County",3,45,294,166,128
050,29,215,"Missouri","Texas County",3,46,295,162,133
050,29,215,"Missouri","Texas County",3,47,271,155,116
050,29,215,"Missouri","Texas County",3,48,242,143,99
050,29,215,"Missouri","Texas County",3,49,273,149,124
050,29,215,"Missouri","Texas County",3,50,308,160,148
050,29,215,"Missouri","Texas County",3,51,317,179,138
050,29,215,"Missouri","Texas County",3,52,306,166,140
050,29,215,"Missouri","Texas County",3,53,291,157,134
050,29,215,"Missouri","Texas County",3,54,291,158,133
050,29,215,"Missouri","Texas County",3,55,300,155,145
050,29,215,"Missouri","Texas County",3,56,338,171,167
050,29,215,"Missouri","Texas County",3,57,347,181,166
050,29,215,"Missouri","Texas County",3,58,361,188,173
050,29,215,"Missouri","Texas County",3,59,404,212,192
050,29,215,"Missouri","Texas County",3,60,402,193,209
050,29,215,"Missouri","Texas County",3,61,371,193,178
050,29,215,"Missouri","Texas County",3,62,362,190,172
050,29,215,"Missouri","Texas County",3,63,332,170,162
050,29,215,"Missouri","Texas County",3,64,347,179,168
050,29,215,"Missouri","Texas County",3,65,332,165,167
050,29,215,"Missouri","Texas County",3,66,351,178,173
050,29,215,"Missouri","Texas County",3,67,324,170,154
050,29,215,"Missouri","Texas County",3,68,321,149,172
050,29,215,"Missouri","Texas County",3,69,295,141,154
050,29,215,"Missouri","Texas County",3,70,297,130,167
050,29,215,"Missouri","Texas County",3,71,272,128,144
050,29,215,"Missouri","Texas County",3,72,277,127,150
050,29,215,"Missouri","Texas County",3,73,283,136,147
050,29,215,"Missouri","Texas County",3,74,280,136,144
050,29,215,"Missouri","Texas County",3,75,179,83,96
050,29,215,"Missouri","Texas County",3,76,193,91,102
050,29,215,"Missouri","Texas County",3,77,196,91,105
050,29,215,"Missouri","Texas County",3,78,211,107,104
050,29,215,"Missouri","Texas County",3,79,169,89,80
050,29,215,"Missouri","Texas County",3,80,146,67,79
050,29,215,"Missouri","Texas County",3,81,140,60,80
050,29,215,"Missouri","Texas County",3,82,140,65,75
050,29,215,"Missouri","Texas County",3,83,136,64,72
050,29,215,"Missouri","Texas County",3,84,103,48,55
050,29,215,"Missouri","Texas County",3,85,638,247,391
050,29,215,"Missouri","Texas County",4,0,281,152,129
050,29,215,"Missouri","Texas County",4,1,267,115,152
050,29,215,"Missouri","Texas County",4,2,265,135,130
050,29,215,"Missouri","Texas County",4,3,279,143,136
050,29,215,"Missouri","Texas County",4,4,306,156,150
050,29,215,"Missouri","Texas County",4,5,298,156,142
050,29,215,"Missouri","Texas County",4,6,300,158,142
050,29,215,"Missouri","Texas County",4,7,290,151,139
050,29,215,"Missouri","Texas County",4,8,297,155,142
050,29,215,"Missouri","Texas County",4,9,298,147,151
050,29,215,"Missouri","Texas County",4,10,270,139,131
050,29,215,"Missouri","Texas County",4,11,307,148,159
050,29,215,"Missouri","Texas County",4,12,317,168,149
050,29,215,"Missouri","Texas County",4,13,356,184,172
050,29,215,"Missouri","Texas County",4,14,368,186,182
050,29,215,"Missouri","Texas County",4,15,344,190,154
050,29,215,"Missouri","Texas County",4,16,330,180,150
050,29,215,"Missouri","Texas County",4,17,327,184,143
050,29,215,"Missouri","Texas County",4,18,275,168,107
050,29,215,"Missouri","Texas County",4,19,237,141,96
050,29,215,"Missouri","Texas County",4,20,255,155,100
050,29,215,"Missouri","Texas County",4,21,277,180,97
050,29,215,"Missouri","Texas County",4,22,278,178,100
050,29,215,"Missouri","Texas County",4,23,285,168,117
050,29,215,"Missouri","Texas County",4,24,288,176,112
050,29,215,"Missouri","Texas County",4,25,284,171,113
050,29,215,"Missouri","Texas County",4,26,260,152,108
050,29,215,"Missouri","Texas County",4,27,292,175,117
050,29,215,"Missouri","Texas County",4,28,304,174,130
050,29,215,"Missouri","Texas County",4,29,286,160,126
050,29,215,"Missouri","Texas County",4,30,302,176,126
050,29,215,"Missouri","Texas County",4,31,314,187,127
050,29,215,"Missouri","Texas County",4,32,308,171,137
050,29,215,"Missouri","Texas County",4,33,273,154,119
050,29,215,"Missouri","Texas County",4,34,287,168,119
050,29,215,"Missouri","Texas County",4,35,296,174,122
050,29,215,"Missouri","Texas County",4,36,312,171,141
050,29,215,"Missouri","Texas County",4,37,321,170,151
050,29,215,"Missouri","Texas County",4,38,305,175,130
050,29,215,"Missouri","Texas County",4,39,307,184,123
050,29,215,"Missouri","Texas County",4,40,336,196,140
050,29,215,"Missouri","Texas County",4,41,317,175,142
050,29,215,"Missouri","Texas County",4,42,297,155,142
050,29,215,"Missouri","Texas County",4,43,329,181,148
050,29,215,"Missouri","Texas County",4,44,298,165,133
050,29,215,"Missouri","Texas County",4,45,310,164,146
050,29,215,"Missouri","Texas County",4,46,295,167,128
050,29,215,"Missouri","Texas County",4,47,306,171,135
050,29,215,"Missouri","Texas County",4,48,259,141,118
050,29,215,"Missouri","Texas County",4,49,246,149,97
050,29,215,"Missouri","Texas County",4,50,279,155,124
050,29,215,"Missouri","Texas County",4,51,315,173,142
050,29,215,"Missouri","Texas County",4,52,323,177,146
050,29,215,"Missouri","Texas County",4,53,312,167,145
050,29,215,"Missouri","Texas County",4,54,305,169,136
050,29,215,"Missouri","Texas County",4,55,290,153,137
050,29,215,"Missouri","Texas County",4,56,320,176,144
050,29,215,"Missouri","Texas County",4,57,340,168,172
050,29,215,"Missouri","Texas County",4,58,358,186,172
050,29,215,"Missouri","Texas County",4,59,378,198,180
050,29,215,"Missouri","Texas County",4,60,403,210,193
050,29,215,"Missouri","Texas County",4,61,403,193,210
050,29,215,"Missouri","Texas County",4,62,369,189,180
050,29,215,"Missouri","Texas County",4,63,371,192,179
050,29,215,"Missouri","Texas County",4,64,340,171,169
050,29,215,"Missouri","Texas County",4,65,357,184,173
050,29,215,"Missouri","Texas County",4,66,339,178,161
050,29,215,"Missouri","Texas County",4,67,354,179,175
050,29,215,"Missouri","Texas County",4,68,317,167,150
050,29,215,"Missouri","Texas County",4,69,319,149,170
050,29,215,"Missouri","Texas County",4,70,296,144,152
050,29,215,"Missouri","Texas County",4,71,288,125,163
050,29,215,"Missouri","Texas County",4,72,262,122,140
050,29,215,"Missouri","Texas County",4,73,266,124,142
050,29,215,"Missouri","Texas County",4,74,272,133,139
050,29,215,"Missouri","Texas County",4,75,265,127,138
050,29,215,"Missouri","Texas County",4,76,177,82,95
050,29,215,"Missouri","Texas County",4,77,178,81,97
050,29,215,"Missouri","Texas County",4,78,183,85,98
050,29,215,"Missouri","Texas County",4,79,192,94,98
050,29,215,"Missouri","Texas County",4,80,156,80,76
050,29,215,"Missouri","Texas County",4,81,141,67,74
050,29,215,"Missouri","Texas County",4,82,126,56,70
050,29,215,"Missouri","Texas County",4,83,124,55,69
050,29,215,"Missouri","Texas County",4,84,125,53,72
050,29,215,"Missouri","Texas County",4,85,622,248,374
050,29,215,"Missouri","Texas County",5,0,274,148,126
050,29,215,"Missouri","Texas County",5,1,289,156,133
050,29,215,"Missouri","Texas County",5,2,280,126,154
050,29,215,"Missouri","Texas County",5,3,264,126,138
050,29,215,"Missouri","Texas County",5,4,274,145,129
050,29,215,"Missouri","Texas County",5,5,314,164,150
050,29,215,"Missouri","Texas County",5,6,299,152,147
050,29,215,"Missouri","Texas County",5,7,307,161,146
050,29,215,"Missouri","Texas County",5,8,300,153,147
050,29,215,"Missouri","Texas County",5,9,312,158,154
050,29,215,"Missouri","Texas County",5,10,310,157,153
050,29,215,"Missouri","Texas County",5,11,263,135,128
050,29,215,"Missouri","Texas County",5,12,310,150,160
050,29,215,"Missouri","Texas County",5,13,332,171,161
050,29,215,"Missouri","Texas County",5,14,353,184,169
050,29,215,"Missouri","Texas County",5,15,381,185,196
050,29,215,"Missouri","Texas County",5,16,343,189,154
050,29,215,"Missouri","Texas County",5,17,347,181,166
050,29,215,"Missouri","Texas County",5,18,286,172,114
050,29,215,"Missouri","Texas County",5,19,253,158,95
050,29,215,"Missouri","Texas County",5,20,262,161,101
050,29,215,"Missouri","Texas County",5,21,280,175,105
050,29,215,"Missouri","Texas County",5,22,289,180,109
050,29,215,"Missouri","Texas County",5,23,269,169,100
050,29,215,"Missouri","Texas County",5,24,291,175,116
050,29,215,"Missouri","Texas County",5,25,312,191,121
050,29,215,"Missouri","Texas County",5,26,283,161,122
050,29,215,"Missouri","Texas County",5,27,248,137,111
050,29,215,"Missouri","Texas County",5,28,293,176,117
050,29,215,"Missouri","Texas County",5,29,311,182,129
050,29,215,"Missouri","Texas County",5,30,301,170,131
050,29,215,"Missouri","Texas County",5,31,300,167,133
050,29,215,"Missouri","Texas County",5,32,329,195,134
050,29,215,"Missouri","Texas County",5,33,312,173,139
050,29,215,"Missouri","Texas County",5,34,290,167,123
050,29,215,"Missouri","Texas County",5,35,290,166,124
050,29,215,"Missouri","Texas County",5,36,300,179,121
050,29,215,"Missouri","Texas County",5,37,319,178,141
050,29,215,"Missouri","Texas County",5,38,338,179,159
050,29,215,"Missouri","Texas County",5,39,308,173,135
050,29,215,"Missouri","Texas County",5,40,298,182,116
050,29,215,"Missouri","Texas County",5,41,342,195,147
050,29,215,"Missouri","Texas County",5,42,335,186,149
050,29,215,"Missouri","Texas County",5,43,309,165,144
050,29,215,"Missouri","Texas County",5,44,319,178,141
050,29,215,"Missouri","Texas County",5,45,312,174,138
050,29,215,"Missouri","Texas County",5,46,309,163,146
050,29,215,"Missouri","Texas County",5,47,311,189,122
050,29,215,"Missouri","Texas County",5,48,293,152,141
050,29,215,"Missouri","Texas County",5,49,265,146,119
050,29,215,"Missouri","Texas County",5,50,254,152,102
050,29,215,"Missouri","Texas County",5,51,306,179,127
050,29,215,"Missouri","Texas County",5,52,322,171,151
050,29,215,"Missouri","Texas County",5,53,314,163,151
050,29,215,"Missouri","Texas County",5,54,315,165,150
050,29,215,"Missouri","Texas County",5,55,290,160,130
050,29,215,"Missouri","Texas County",5,56,305,164,141
050,29,215,"Missouri","Texas County",5,57,321,171,150
050,29,215,"Missouri","Texas County",5,58,349,175,174
050,29,215,"Missouri","Texas County",5,59,376,202,174
050,29,215,"Missouri","Texas County",5,60,382,197,185
050,29,215,"Missouri","Texas County",5,61,413,211,202
050,29,215,"Missouri","Texas County",5,62,397,193,204
050,29,215,"Missouri","Texas County",5,63,367,186,181
050,29,215,"Missouri","Texas County",5,64,375,202,173
050,29,215,"Missouri","Texas County",5,65,333,163,170
050,29,215,"Missouri","Texas County",5,66,353,182,171
050,29,215,"Missouri","Texas County",5,67,333,176,157
050,29,215,"Missouri","Texas County",5,68,351,177,174
050,29,215,"Missouri","Texas County",5,69,318,167,151
050,29,215,"Missouri","Texas County",5,70,311,147,164
050,29,215,"Missouri","Texas County",5,71,284,134,150
050,29,215,"Missouri","Texas County",5,72,282,120,162
050,29,215,"Missouri","Texas County",5,73,249,118,131
050,29,215,"Missouri","Texas County",5,74,260,124,136
050,29,215,"Missouri","Texas County",5,75,259,128,131
050,29,215,"Missouri","Texas County",5,76,259,118,141
050,29,215,"Missouri","Texas County",5,77,174,78,96
050,29,215,"Missouri","Texas County",5,78,170,76,94
050,29,215,"Missouri","Texas County",5,79,172,77,95
050,29,215,"Missouri","Texas County",5,80,179,88,91
050,29,215,"Missouri","Texas County",5,81,149,77,72
050,29,215,"Missouri","Texas County",5,82,125,59,66
050,29,215,"Missouri","Texas County",5,83,107,46,61
050,29,215,"Missouri","Texas County",5,84,110,46,64
050,29,215,"Missouri","Texas County",5,85,646,269,377
050,29,217,"Missouri","Vernon County",1,0,236,117,119
050,29,217,"Missouri","Vernon County",1,1,238,112,126
050,29,217,"Missouri","Vernon County",1,2,231,138,93
050,29,217,"Missouri","Vernon County",1,3,251,135,116
050,29,217,"Missouri","Vernon County",1,4,259,131,128
050,29,217,"Missouri","Vernon County",1,5,245,128,117
050,29,217,"Missouri","Vernon County",1,6,255,125,130
050,29,217,"Missouri","Vernon County",1,7,239,119,120
050,29,217,"Missouri","Vernon County",1,8,245,133,112
050,29,217,"Missouri","Vernon County",1,9,243,138,105
050,29,217,"Missouri","Vernon County",1,10,252,127,125
050,29,217,"Missouri","Vernon County",1,11,255,132,123
050,29,217,"Missouri","Vernon County",1,12,295,160,135
050,29,217,"Missouri","Vernon County",1,13,297,161,136
050,29,217,"Missouri","Vernon County",1,14,282,147,135
050,29,217,"Missouri","Vernon County",1,15,257,133,124
050,29,217,"Missouri","Vernon County",1,16,265,140,125
050,29,217,"Missouri","Vernon County",1,17,270,136,134
050,29,217,"Missouri","Vernon County",1,18,278,120,158
050,29,217,"Missouri","Vernon County",1,19,309,106,203
050,29,217,"Missouri","Vernon County",1,20,264,106,158
050,29,217,"Missouri","Vernon County",1,21,211,102,109
050,29,217,"Missouri","Vernon County",1,22,214,94,120
050,29,217,"Missouri","Vernon County",1,23,209,103,106
050,29,217,"Missouri","Vernon County",1,24,201,109,92
050,29,217,"Missouri","Vernon County",1,25,212,100,112
050,29,217,"Missouri","Vernon County",1,26,227,115,112
050,29,217,"Missouri","Vernon County",1,27,231,113,118
050,29,217,"Missouri","Vernon County",1,28,210,115,95
050,29,217,"Missouri","Vernon County",1,29,216,107,109
050,29,217,"Missouri","Vernon County",1,30,217,106,111
050,29,217,"Missouri","Vernon County",1,31,229,112,117
050,29,217,"Missouri","Vernon County",1,32,212,111,101
050,29,217,"Missouri","Vernon County",1,33,199,111,88
050,29,217,"Missouri","Vernon County",1,34,195,95,100
050,29,217,"Missouri","Vernon County",1,35,210,87,123
050,29,217,"Missouri","Vernon County",1,36,201,98,103
050,29,217,"Missouri","Vernon County",1,37,207,103,104
050,29,217,"Missouri","Vernon County",1,38,218,109,109
050,29,217,"Missouri","Vernon County",1,39,221,108,113
050,29,217,"Missouri","Vernon County",1,40,230,116,114
050,29,217,"Missouri","Vernon County",1,41,245,137,108
050,29,217,"Missouri","Vernon County",1,42,228,120,108
050,29,217,"Missouri","Vernon County",1,43,212,99,113
050,29,217,"Missouri","Vernon County",1,44,225,111,114
050,29,217,"Missouri","Vernon County",1,45,192,89,103
050,29,217,"Missouri","Vernon County",1,46,208,99,109
050,29,217,"Missouri","Vernon County",1,47,217,107,110
050,29,217,"Missouri","Vernon County",1,48,236,117,119
050,29,217,"Missouri","Vernon County",1,49,252,125,127
050,29,217,"Missouri","Vernon County",1,50,226,121,105
050,29,217,"Missouri","Vernon County",1,51,231,123,108
050,29,217,"Missouri","Vernon County",1,52,248,127,121
050,29,217,"Missouri","Vernon County",1,53,254,118,136
050,29,217,"Missouri","Vernon County",1,54,258,116,142
050,29,217,"Missouri","Vernon County",1,55,267,145,122
050,29,217,"Missouri","Vernon County",1,56,285,159,126
050,29,217,"Missouri","Vernon County",1,57,307,164,143
050,29,217,"Missouri","Vernon County",1,58,295,146,149
050,29,217,"Missouri","Vernon County",1,59,251,111,140
050,29,217,"Missouri","Vernon County",1,60,266,128,138
050,29,217,"Missouri","Vernon County",1,61,270,128,142
050,29,217,"Missouri","Vernon County",1,62,301,148,153
050,29,217,"Missouri","Vernon County",1,63,274,131,143
050,29,217,"Missouri","Vernon County",1,64,250,120,130
050,29,217,"Missouri","Vernon County",1,65,259,120,139
050,29,217,"Missouri","Vernon County",1,66,267,128,139
050,29,217,"Missouri","Vernon County",1,67,237,111,126
050,29,217,"Missouri","Vernon County",1,68,244,120,124
050,29,217,"Missouri","Vernon County",1,69,215,104,111
050,29,217,"Missouri","Vernon County",1,70,218,110,108
050,29,217,"Missouri","Vernon County",1,71,229,113,116
050,29,217,"Missouri","Vernon County",1,72,226,110,116
050,29,217,"Missouri","Vernon County",1,73,212,96,116
050,29,217,"Missouri","Vernon County",1,74,159,68,91
050,29,217,"Missouri","Vernon County",1,75,158,78,80
050,29,217,"Missouri","Vernon County",1,76,149,75,74
050,29,217,"Missouri","Vernon County",1,77,139,70,69
050,29,217,"Missouri","Vernon County",1,78,133,57,76
050,29,217,"Missouri","Vernon County",1,79,124,57,67
050,29,217,"Missouri","Vernon County",1,80,113,54,59
050,29,217,"Missouri","Vernon County",1,81,112,50,62
050,29,217,"Missouri","Vernon County",1,82,100,46,54
050,29,217,"Missouri","Vernon County",1,83,81,38,43
050,29,217,"Missouri","Vernon County",1,84,67,25,42
050,29,217,"Missouri","Vernon County",1,85,533,199,334
050,29,217,"Missouri","Vernon County",2,0,254,123,131
050,29,217,"Missouri","Vernon County",2,1,235,112,123
050,29,217,"Missouri","Vernon County",2,2,230,130,100
050,29,217,"Missouri","Vernon County",2,3,244,134,110
050,29,217,"Missouri","Vernon County",2,4,256,131,125
050,29,217,"Missouri","Vernon County",2,5,247,128,119
050,29,217,"Missouri","Vernon County",2,6,252,125,127
050,29,217,"Missouri","Vernon County",2,7,242,121,121
050,29,217,"Missouri","Vernon County",2,8,242,129,113
050,29,217,"Missouri","Vernon County",2,9,244,137,107
050,29,217,"Missouri","Vernon County",2,10,250,129,121
050,29,217,"Missouri","Vernon County",2,11,254,130,124
050,29,217,"Missouri","Vernon County",2,12,286,153,133
050,29,217,"Missouri","Vernon County",2,13,290,157,133
050,29,217,"Missouri","Vernon County",2,14,283,149,134
050,29,217,"Missouri","Vernon County",2,15,261,135,126
050,29,217,"Missouri","Vernon County",2,16,264,139,125
050,29,217,"Missouri","Vernon County",2,17,269,137,132
050,29,217,"Missouri","Vernon County",2,18,277,121,156
050,29,217,"Missouri","Vernon County",2,19,305,102,203
050,29,217,"Missouri","Vernon County",2,20,266,107,159
050,29,217,"Missouri","Vernon County",2,21,211,103,108
050,29,217,"Missouri","Vernon County",2,22,214,95,119
050,29,217,"Missouri","Vernon County",2,23,208,99,109
050,29,217,"Missouri","Vernon County",2,24,201,108,93
050,29,217,"Missouri","Vernon County",2,25,207,102,105
050,29,217,"Missouri","Vernon County",2,26,225,112,113
050,29,217,"Missouri","Vernon County",2,27,225,112,113
050,29,217,"Missouri","Vernon County",2,28,216,115,101
050,29,217,"Missouri","Vernon County",2,29,212,107,105
050,29,217,"Missouri","Vernon County",2,30,217,107,110
050,29,217,"Missouri","Vernon County",2,31,224,108,116
050,29,217,"Missouri","Vernon County",2,32,213,110,103
050,29,217,"Missouri","Vernon County",2,33,202,111,91
050,29,217,"Missouri","Vernon County",2,34,194,97,97
050,29,217,"Missouri","Vernon County",2,35,206,89,117
050,29,217,"Missouri","Vernon County",2,36,199,92,107
050,29,217,"Missouri","Vernon County",2,37,205,101,104
050,29,217,"Missouri","Vernon County",2,38,218,110,108
050,29,217,"Missouri","Vernon County",2,39,220,109,111
050,29,217,"Missouri","Vernon County",2,40,228,114,114
050,29,217,"Missouri","Vernon County",2,41,242,133,109
050,29,217,"Missouri","Vernon County",2,42,228,122,106
050,29,217,"Missouri","Vernon County",2,43,221,107,114
050,29,217,"Missouri","Vernon County",2,44,220,106,114
050,29,217,"Missouri","Vernon County",2,45,200,94,106
050,29,217,"Missouri","Vernon County",2,46,202,96,106
050,29,217,"Missouri","Vernon County",2,47,213,104,109
050,29,217,"Missouri","Vernon County",2,48,232,116,116
050,29,217,"Missouri","Vernon County",2,49,250,123,127
050,29,217,"Missouri","Vernon County",2,50,234,122,112
050,29,217,"Missouri","Vernon County",2,51,226,121,105
050,29,217,"Missouri","Vernon County",2,52,242,125,117
050,29,217,"Missouri","Vernon County",2,53,251,118,133
050,29,217,"Missouri","Vernon County",2,54,257,117,140
050,29,217,"Missouri","Vernon County",2,55,265,139,126
050,29,217,"Missouri","Vernon County",2,56,280,157,123
050,29,217,"Missouri","Vernon County",2,57,300,162,138
050,29,217,"Missouri","Vernon County",2,58,296,151,145
050,29,217,"Missouri","Vernon County",2,59,259,117,142
050,29,217,"Missouri","Vernon County",2,60,261,124,137
050,29,217,"Missouri","Vernon County",2,61,266,126,140
050,29,217,"Missouri","Vernon County",2,62,294,144,150
050,29,217,"Missouri","Vernon County",2,63,284,137,147
050,29,217,"Missouri","Vernon County",2,64,254,122,132
050,29,217,"Missouri","Vernon County",2,65,255,119,136
050,29,217,"Missouri","Vernon County",2,66,267,128,139
050,29,217,"Missouri","Vernon County",2,67,246,116,130
050,29,217,"Missouri","Vernon County",2,68,239,117,122
050,29,217,"Missouri","Vernon County",2,69,225,110,115
050,29,217,"Missouri","Vernon County",2,70,218,109,109
050,29,217,"Missouri","Vernon County",2,71,225,111,114
050,29,217,"Missouri","Vernon County",2,72,221,108,113
050,29,217,"Missouri","Vernon County",2,73,223,103,120
050,29,217,"Missouri","Vernon County",2,74,161,70,91
050,29,217,"Missouri","Vernon County",2,75,158,76,82
050,29,217,"Missouri","Vernon County",2,76,150,75,75
050,29,217,"Missouri","Vernon County",2,77,144,72,72
050,29,217,"Missouri","Vernon County",2,78,131,60,71
050,29,217,"Missouri","Vernon County",2,79,120,52,68
050,29,217,"Missouri","Vernon County",2,80,116,55,61
050,29,217,"Missouri","Vernon County",2,81,111,52,59
050,29,217,"Missouri","Vernon County",2,82,104,46,58
050,29,217,"Missouri","Vernon County",2,83,84,40,44
050,29,217,"Missouri","Vernon County",2,84,70,28,42
050,29,217,"Missouri","Vernon County",2,85,529,198,331
050,29,217,"Missouri","Vernon County",3,0,231,112,119
050,29,217,"Missouri","Vernon County",3,1,250,125,125
050,29,217,"Missouri","Vernon County",3,2,239,112,127
050,29,217,"Missouri","Vernon County",3,3,234,132,102
050,29,217,"Missouri","Vernon County",3,4,241,133,108
050,29,217,"Missouri","Vernon County",3,5,263,135,128
050,29,217,"Missouri","Vernon County",3,6,252,135,117
050,29,217,"Missouri","Vernon County",3,7,248,125,123
050,29,217,"Missouri","Vernon County",3,8,232,111,121
050,29,217,"Missouri","Vernon County",3,9,241,126,115
050,29,217,"Missouri","Vernon County",3,10,246,137,109
050,29,217,"Missouri","Vernon County",3,11,259,133,126
050,29,217,"Missouri","Vernon County",3,12,257,131,126
050,29,217,"Missouri","Vernon County",3,13,287,153,134
050,29,217,"Missouri","Vernon County",3,14,292,154,138
050,29,217,"Missouri","Vernon County",3,15,285,147,138
050,29,217,"Missouri","Vernon County",3,16,253,130,123
050,29,217,"Missouri","Vernon County",3,17,281,149,132
050,29,217,"Missouri","Vernon County",3,18,278,129,149
050,29,217,"Missouri","Vernon County",3,19,280,85,195
050,29,217,"Missouri","Vernon County",3,20,255,98,157
050,29,217,"Missouri","Vernon County",3,21,203,103,100
050,29,217,"Missouri","Vernon County",3,22,230,111,119
050,29,217,"Missouri","Vernon County",3,23,224,110,114
050,29,217,"Missouri","Vernon County",3,24,200,97,103
050,29,217,"Missouri","Vernon County",3,25,207,105,102
050,29,217,"Missouri","Vernon County",3,26,233,121,112
050,29,217,"Missouri","Vernon County",3,27,225,117,108
050,29,217,"Missouri","Vernon County",3,28,221,109,112
050,29,217,"Missouri","Vernon County",3,29,222,111,111
050,29,217,"Missouri","Vernon County",3,30,221,110,111
050,29,217,"Missouri","Vernon County",3,31,222,115,107
050,29,217,"Missouri","Vernon County",3,32,215,109,106
050,29,217,"Missouri","Vernon County",3,33,220,120,100
050,29,217,"Missouri","Vernon County",3,34,210,112,98
050,29,217,"Missouri","Vernon County",3,35,201,102,99
050,29,217,"Missouri","Vernon County",3,36,214,95,119
050,29,217,"Missouri","Vernon County",3,37,188,84,104
050,29,217,"Missouri","Vernon County",3,38,211,109,102
050,29,217,"Missouri","Vernon County",3,39,220,116,104
050,29,217,"Missouri","Vernon County",3,40,219,106,113
050,29,217,"Missouri","Vernon County",3,41,228,115,113
050,29,217,"Missouri","Vernon County",3,42,236,130,106
050,29,217,"Missouri","Vernon County",3,43,223,117,106
050,29,217,"Missouri","Vernon County",3,44,216,107,109
050,29,217,"Missouri","Vernon County",3,45,215,104,111
050,29,217,"Missouri","Vernon County",3,46,197,89,108
050,29,217,"Missouri","Vernon County",3,47,203,97,106
050,29,217,"Missouri","Vernon County",3,48,217,102,115
050,29,217,"Missouri","Vernon County",3,49,234,116,118
050,29,217,"Missouri","Vernon County",3,50,242,121,121
050,29,217,"Missouri","Vernon County",3,51,223,121,102
050,29,217,"Missouri","Vernon County",3,52,222,119,103
050,29,217,"Missouri","Vernon County",3,53,243,124,119
050,29,217,"Missouri","Vernon County",3,54,249,116,133
050,29,217,"Missouri","Vernon County",3,55,262,124,138
050,29,217,"Missouri","Vernon County",3,56,253,130,123
050,29,217,"Missouri","Vernon County",3,57,271,151,120
050,29,217,"Missouri","Vernon County",3,58,292,159,133
050,29,217,"Missouri","Vernon County",3,59,289,146,143
050,29,217,"Missouri","Vernon County",3,60,259,113,146
050,29,217,"Missouri","Vernon County",3,61,244,115,129
050,29,217,"Missouri","Vernon County",3,62,270,127,143
050,29,217,"Missouri","Vernon County",3,63,283,134,149
050,29,217,"Missouri","Vernon County",3,64,286,140,146
050,29,217,"Missouri","Vernon County",3,65,247,118,129
050,29,217,"Missouri","Vernon County",3,66,254,118,136
050,29,217,"Missouri","Vernon County",3,67,263,125,138
050,29,217,"Missouri","Vernon County",3,68,238,114,124
050,29,217,"Missouri","Vernon County",3,69,234,113,121
050,29,217,"Missouri","Vernon County",3,70,213,102,111
050,29,217,"Missouri","Vernon County",3,71,211,106,105
050,29,217,"Missouri","Vernon County",3,72,224,108,116
050,29,217,"Missouri","Vernon County",3,73,221,106,115
050,29,217,"Missouri","Vernon County",3,74,213,91,122
050,29,217,"Missouri","Vernon County",3,75,151,70,81
050,29,217,"Missouri","Vernon County",3,76,147,71,76
050,29,217,"Missouri","Vernon County",3,77,139,70,69
050,29,217,"Missouri","Vernon County",3,78,143,70,73
050,29,217,"Missouri","Vernon County",3,79,120,51,69
050,29,217,"Missouri","Vernon County",3,80,114,48,66
050,29,217,"Missouri","Vernon County",3,81,103,52,51
050,29,217,"Missouri","Vernon County",3,82,103,41,62
050,29,217,"Missouri","Vernon County",3,83,94,41,53
050,29,217,"Missouri","Vernon County",3,84,73,30,43
050,29,217,"Missouri","Vernon County",3,85,516,187,329
050,29,217,"Missouri","Vernon County",4,0,236,121,115
050,29,217,"Missouri","Vernon County",4,1,233,118,115
050,29,217,"Missouri","Vernon County",4,2,261,129,132
050,29,217,"Missouri","Vernon County",4,3,244,111,133
050,29,217,"Missouri","Vernon County",4,4,239,136,103
050,29,217,"Missouri","Vernon County",4,5,252,146,106
050,29,217,"Missouri","Vernon County",4,6,260,131,129
050,29,217,"Missouri","Vernon County",4,7,253,134,119
050,29,217,"Missouri","Vernon County",4,8,248,123,125
050,29,217,"Missouri","Vernon County",4,9,242,119,123
050,29,217,"Missouri","Vernon County",4,10,256,133,123
050,29,217,"Missouri","Vernon County",4,11,261,141,120
050,29,217,"Missouri","Vernon County",4,12,253,131,122
050,29,217,"Missouri","Vernon County",4,13,266,133,133
050,29,217,"Missouri","Vernon County",4,14,300,165,135
050,29,217,"Missouri","Vernon County",4,15,305,162,143
050,29,217,"Missouri","Vernon County",4,16,290,151,139
050,29,217,"Missouri","Vernon County",4,17,267,139,128
050,29,217,"Missouri","Vernon County",4,18,279,135,144
050,29,217,"Missouri","Vernon County",4,19,280,93,187
050,29,217,"Missouri","Vernon County",4,20,237,85,152
050,29,217,"Missouri","Vernon County",4,21,201,98,103
050,29,217,"Missouri","Vernon County",4,22,207,109,98
050,29,217,"Missouri","Vernon County",4,23,226,107,119
050,29,217,"Missouri","Vernon County",4,24,226,107,119
050,29,217,"Missouri","Vernon County",4,25,204,101,103
050,29,217,"Missouri","Vernon County",4,26,214,110,104
050,29,217,"Missouri","Vernon County",4,27,226,115,111
050,29,217,"Missouri","Vernon County",4,28,231,118,113
050,29,217,"Missouri","Vernon County",4,29,222,110,112
050,29,217,"Missouri","Vernon County",4,30,216,110,106
050,29,217,"Missouri","Vernon County",4,31,219,105,114
050,29,217,"Missouri","Vernon County",4,32,219,114,105
050,29,217,"Missouri","Vernon County",4,33,224,113,111
050,29,217,"Missouri","Vernon County",4,34,225,120,105
050,29,217,"Missouri","Vernon County",4,35,207,104,103
050,29,217,"Missouri","Vernon County",4,36,203,102,101
050,29,217,"Missouri","Vernon County",4,37,218,96,122
050,29,217,"Missouri","Vernon County",4,38,200,93,107
050,29,217,"Missouri","Vernon County",4,39,217,112,105
050,29,217,"Missouri","Vernon County",4,40,228,118,110
050,29,217,"Missouri","Vernon County",4,41,221,109,112
050,29,217,"Missouri","Vernon County",4,42,226,112,114
050,29,217,"Missouri","Vernon County",4,43,239,136,103
050,29,217,"Missouri","Vernon County",4,44,223,112,111
050,29,217,"Missouri","Vernon County",4,45,211,103,108
050,29,217,"Missouri","Vernon County",4,46,214,102,112
050,29,217,"Missouri","Vernon County",4,47,195,88,107
050,29,217,"Missouri","Vernon County",4,48,203,100,103
050,29,217,"Missouri","Vernon County",4,49,203,93,110
050,29,217,"Missouri","Vernon County",4,50,238,117,121
050,29,217,"Missouri","Vernon County",4,51,240,123,117
050,29,217,"Missouri","Vernon County",4,52,224,119,105
050,29,217,"Missouri","Vernon County",4,53,227,118,109
050,29,217,"Missouri","Vernon County",4,54,241,125,116
050,29,217,"Missouri","Vernon County",4,55,245,116,129
050,29,217,"Missouri","Vernon County",4,56,262,128,134
050,29,217,"Missouri","Vernon County",4,57,249,126,123
050,29,217,"Missouri","Vernon County",4,58,272,151,121
050,29,217,"Missouri","Vernon County",4,59,295,163,132
050,29,217,"Missouri","Vernon County",4,60,300,152,148
050,29,217,"Missouri","Vernon County",4,61,246,108,138
050,29,217,"Missouri","Vernon County",4,62,254,122,132
050,29,217,"Missouri","Vernon County",4,63,268,126,142
050,29,217,"Missouri","Vernon County",4,64,278,130,148
050,29,217,"Missouri","Vernon County",4,65,284,135,149
050,29,217,"Missouri","Vernon County",4,66,241,114,127
050,29,217,"Missouri","Vernon County",4,67,247,118,129
050,29,217,"Missouri","Vernon County",4,68,244,118,126
050,29,217,"Missouri","Vernon County",4,69,228,114,114
050,29,217,"Missouri","Vernon County",4,70,230,107,123
050,29,217,"Missouri","Vernon County",4,71,207,100,107
050,29,217,"Missouri","Vernon County",4,72,198,97,101
050,29,217,"Missouri","Vernon County",4,73,222,107,115
050,29,217,"Missouri","Vernon County",4,74,214,98,116
050,29,217,"Missouri","Vernon County",4,75,204,92,112
050,29,217,"Missouri","Vernon County",4,76,142,66,76
050,29,217,"Missouri","Vernon County",4,77,136,67,69
050,29,217,"Missouri","Vernon County",4,78,133,70,63
050,29,217,"Missouri","Vernon County",4,79,126,59,67
050,29,217,"Missouri","Vernon County",4,80,115,48,67
050,29,217,"Missouri","Vernon County",4,81,102,46,56
050,29,217,"Missouri","Vernon County",4,82,95,43,52
050,29,217,"Missouri","Vernon County",4,83,93,40,53
050,29,217,"Missouri","Vernon County",4,84,78,31,47
050,29,217,"Missouri","Vernon County",4,85,491,181,310
050,29,217,"Missouri","Vernon County",5,0,231,118,113
050,29,217,"Missouri","Vernon County",5,1,234,118,116
050,29,217,"Missouri","Vernon County",5,2,246,128,118
050,29,217,"Missouri","Vernon County",5,3,272,140,132
050,29,217,"Missouri","Vernon County",5,4,253,114,139
050,29,217,"Missouri","Vernon County",5,5,241,141,100
050,29,217,"Missouri","Vernon County",5,6,267,154,113
050,29,217,"Missouri","Vernon County",5,7,261,130,131
050,29,217,"Missouri","Vernon County",5,8,249,128,121
050,29,217,"Missouri","Vernon County",5,9,255,126,129
050,29,217,"Missouri","Vernon County",5,10,243,122,121
050,29,217,"Missouri","Vernon County",5,11,259,136,123
050,29,217,"Missouri","Vernon County",5,12,257,137,120
050,29,217,"Missouri","Vernon County",5,13,257,136,121
050,29,217,"Missouri","Vernon County",5,14,269,146,123
050,29,217,"Missouri","Vernon County",5,15,303,164,139
050,29,217,"Missouri","Vernon County",5,16,301,161,140
050,29,217,"Missouri","Vernon County",5,17,293,158,135
050,29,217,"Missouri","Vernon County",5,18,266,122,144
050,29,217,"Missouri","Vernon County",5,19,288,99,189
050,29,217,"Missouri","Vernon County",5,20,246,95,151
050,29,217,"Missouri","Vernon County",5,21,187,86,101
050,29,217,"Missouri","Vernon County",5,22,215,111,104
050,29,217,"Missouri","Vernon County",5,23,218,117,101
050,29,217,"Missouri","Vernon County",5,24,230,106,124
050,29,217,"Missouri","Vernon County",5,25,221,109,112
050,29,217,"Missouri","Vernon County",5,26,214,111,103
050,29,217,"Missouri","Vernon County",5,27,208,109,99
050,29,217,"Missouri","Vernon County",5,28,234,119,115
050,29,217,"Missouri","Vernon County",5,29,235,121,114
050,29,217,"Missouri","Vernon County",5,30,235,117,118
050,29,217,"Missouri","Vernon County",5,31,223,116,107
050,29,217,"Missouri","Vernon County",5,32,216,103,113
050,29,217,"Missouri","Vernon County",5,33,227,123,104
050,29,217,"Missouri","Vernon County",5,34,221,112,109
050,29,217,"Missouri","Vernon County",5,35,225,120,105
050,29,217,"Missouri","Vernon County",5,36,215,106,109
050,29,217,"Missouri","Vernon County",5,37,207,105,102
050,29,217,"Missouri","Vernon County",5,38,228,103,125
050,29,217,"Missouri","Vernon County",5,39,210,98,112
050,29,217,"Missouri","Vernon County",5,40,218,112,106
050,29,217,"Missouri","Vernon County",5,41,233,119,114
050,29,217,"Missouri","Vernon County",5,42,225,108,117
050,29,217,"Missouri","Vernon County",5,43,226,113,113
050,29,217,"Missouri","Vernon County",5,44,239,128,111
050,29,217,"Missouri","Vernon County",5,45,230,119,111
050,29,217,"Missouri","Vernon County",5,46,215,107,108
050,29,217,"Missouri","Vernon County",5,47,218,97,121
050,29,217,"Missouri","Vernon County",5,48,194,86,108
050,29,217,"Missouri","Vernon County",5,49,200,95,105
050,29,217,"Missouri","Vernon County",5,50,208,96,112
050,29,217,"Missouri","Vernon County",5,51,236,117,119
050,29,217,"Missouri","Vernon County",5,52,242,127,115
050,29,217,"Missouri","Vernon County",5,53,219,112,107
050,29,217,"Missouri","Vernon County",5,54,234,119,115
050,29,217,"Missouri","Vernon County",5,55,244,128,116
050,29,217,"Missouri","Vernon County",5,56,257,123,134
050,29,217,"Missouri","Vernon County",5,57,256,123,133
050,29,217,"Missouri","Vernon County",5,58,253,126,127
050,29,217,"Missouri","Vernon County",5,59,260,146,114
050,29,217,"Missouri","Vernon County",5,60,301,162,139
050,29,217,"Missouri","Vernon County",5,61,287,146,141
050,29,217,"Missouri","Vernon County",5,62,250,114,136
050,29,217,"Missouri","Vernon County",5,63,254,118,136
050,29,217,"Missouri","Vernon County",5,64,269,124,145
050,29,217,"Missouri","Vernon County",5,65,275,128,147
050,29,217,"Missouri","Vernon County",5,66,275,131,144
050,29,217,"Missouri","Vernon County",5,67,240,111,129
050,29,217,"Missouri","Vernon County",5,68,234,110,124
050,29,217,"Missouri","Vernon County",5,69,242,116,126
050,29,217,"Missouri","Vernon County",5,70,221,109,112
050,29,217,"Missouri","Vernon County",5,71,227,105,122
050,29,217,"Missouri","Vernon County",5,72,195,94,101
050,29,217,"Missouri","Vernon County",5,73,188,94,94
050,29,217,"Missouri","Vernon County",5,74,216,99,117
050,29,217,"Missouri","Vernon County",5,75,206,100,106
050,29,217,"Missouri","Vernon County",5,76,198,87,111
050,29,217,"Missouri","Vernon County",5,77,131,62,69
050,29,217,"Missouri","Vernon County",5,78,133,66,67
050,29,217,"Missouri","Vernon County",5,79,124,61,63
050,29,217,"Missouri","Vernon County",5,80,123,55,68
050,29,217,"Missouri","Vernon County",5,81,102,48,54
050,29,217,"Missouri","Vernon County",5,82,97,38,59
050,29,217,"Missouri","Vernon County",5,83,86,41,45
050,29,217,"Missouri","Vernon County",5,84,79,28,51
050,29,217,"Missouri","Vernon County",5,85,490,186,304
050,29,219,"Missouri","Warren County",1,0,430,221,209
050,29,219,"Missouri","Warren County",1,1,436,234,202
050,29,219,"Missouri","Warren County",1,2,426,219,207
050,29,219,"Missouri","Warren County",1,3,466,240,226
050,29,219,"Missouri","Warren County",1,4,491,253,238
050,29,219,"Missouri","Warren County",1,5,466,255,211
050,29,219,"Missouri","Warren County",1,6,441,235,206
050,29,219,"Missouri","Warren County",1,7,450,238,212
050,29,219,"Missouri","Warren County",1,8,435,224,211
050,29,219,"Missouri","Warren County",1,9,449,227,222
050,29,219,"Missouri","Warren County",1,10,459,241,218
050,29,219,"Missouri","Warren County",1,11,503,250,253
050,29,219,"Missouri","Warren County",1,12,522,256,266
050,29,219,"Missouri","Warren County",1,13,528,259,269
050,29,219,"Missouri","Warren County",1,14,513,268,245
050,29,219,"Missouri","Warren County",1,15,495,254,241
050,29,219,"Missouri","Warren County",1,16,491,233,258
050,29,219,"Missouri","Warren County",1,17,496,249,247
050,29,219,"Missouri","Warren County",1,18,398,210,188
050,29,219,"Missouri","Warren County",1,19,338,169,169
050,29,219,"Missouri","Warren County",1,20,351,188,163
050,29,219,"Missouri","Warren County",1,21,351,183,168
050,29,219,"Missouri","Warren County",1,22,364,183,181
050,29,219,"Missouri","Warren County",1,23,395,207,188
050,29,219,"Missouri","Warren County",1,24,395,189,206
050,29,219,"Missouri","Warren County",1,25,421,206,215
050,29,219,"Missouri","Warren County",1,26,409,205,204
050,29,219,"Missouri","Warren County",1,27,415,206,209
050,29,219,"Missouri","Warren County",1,28,447,227,220
050,29,219,"Missouri","Warren County",1,29,458,231,227
050,29,219,"Missouri","Warren County",1,30,471,248,223
050,29,219,"Missouri","Warren County",1,31,438,238,200
050,29,219,"Missouri","Warren County",1,32,427,225,202
050,29,219,"Missouri","Warren County",1,33,458,235,223
050,29,219,"Missouri","Warren County",1,34,453,236,217
050,29,219,"Missouri","Warren County",1,35,407,201,206
050,29,219,"Missouri","Warren County",1,36,412,213,199
050,29,219,"Missouri","Warren County",1,37,433,219,214
050,29,219,"Missouri","Warren County",1,38,440,204,236
050,29,219,"Missouri","Warren County",1,39,415,197,218
050,29,219,"Missouri","Warren County",1,40,427,214,213
050,29,219,"Missouri","Warren County",1,41,389,191,198
050,29,219,"Missouri","Warren County",1,42,426,220,206
050,29,219,"Missouri","Warren County",1,43,389,182,207
050,29,219,"Missouri","Warren County",1,44,369,193,176
050,29,219,"Missouri","Warren County",1,45,365,191,174
050,29,219,"Missouri","Warren County",1,46,359,183,176
050,29,219,"Missouri","Warren County",1,47,368,187,181
050,29,219,"Missouri","Warren County",1,48,430,232,198
050,29,219,"Missouri","Warren County",1,49,459,232,227
050,29,219,"Missouri","Warren County",1,50,423,210,213
050,29,219,"Missouri","Warren County",1,51,417,200,217
050,29,219,"Missouri","Warren County",1,52,443,217,226
050,29,219,"Missouri","Warren County",1,53,461,229,232
050,29,219,"Missouri","Warren County",1,54,470,248,222
050,29,219,"Missouri","Warren County",1,55,543,251,292
050,29,219,"Missouri","Warren County",1,56,548,282,266
050,29,219,"Missouri","Warren County",1,57,586,303,283
050,29,219,"Missouri","Warren County",1,58,603,295,308
050,29,219,"Missouri","Warren County",1,59,585,302,283
050,29,219,"Missouri","Warren County",1,60,582,292,290
050,29,219,"Missouri","Warren County",1,61,541,279,262
050,29,219,"Missouri","Warren County",1,62,541,261,280
050,29,219,"Missouri","Warren County",1,63,504,250,254
050,29,219,"Missouri","Warren County",1,64,486,253,233
050,29,219,"Missouri","Warren County",1,65,468,241,227
050,29,219,"Missouri","Warren County",1,66,420,221,199
050,29,219,"Missouri","Warren County",1,67,384,187,197
050,29,219,"Missouri","Warren County",1,68,410,203,207
050,29,219,"Missouri","Warren County",1,69,387,188,199
050,29,219,"Missouri","Warren County",1,70,347,166,181
050,29,219,"Missouri","Warren County",1,71,330,149,181
050,29,219,"Missouri","Warren County",1,72,348,160,188
050,29,219,"Missouri","Warren County",1,73,352,179,173
050,29,219,"Missouri","Warren County",1,74,239,115,124
050,29,219,"Missouri","Warren County",1,75,255,121,134
050,29,219,"Missouri","Warren County",1,76,268,139,129
050,29,219,"Missouri","Warren County",1,77,265,126,139
050,29,219,"Missouri","Warren County",1,78,225,111,114
050,29,219,"Missouri","Warren County",1,79,206,98,108
050,29,219,"Missouri","Warren County",1,80,187,89,98
050,29,219,"Missouri","Warren County",1,81,169,82,87
050,29,219,"Missouri","Warren County",1,82,133,66,67
050,29,219,"Missouri","Warren County",1,83,111,59,52
050,29,219,"Missouri","Warren County",1,84,121,54,67
050,29,219,"Missouri","Warren County",1,85,596,247,349
050,29,219,"Missouri","Warren County",2,0,417,216,201
050,29,219,"Missouri","Warren County",2,1,434,231,203
050,29,219,"Missouri","Warren County",2,2,430,223,207
050,29,219,"Missouri","Warren County",2,3,455,235,220
050,29,219,"Missouri","Warren County",2,4,489,254,235
050,29,219,"Missouri","Warren County",2,5,470,255,215
050,29,219,"Missouri","Warren County",2,6,450,240,210
050,29,219,"Missouri","Warren County",2,7,452,239,213
050,29,219,"Missouri","Warren County",2,8,441,227,214
050,29,219,"Missouri","Warren County",2,9,448,229,219
050,29,219,"Missouri","Warren County",2,10,460,238,222
050,29,219,"Missouri","Warren County",2,11,494,248,246
050,29,219,"Missouri","Warren County",2,12,522,255,267
050,29,219,"Missouri","Warren County",2,13,529,260,269
050,29,219,"Missouri","Warren County",2,14,517,267,250
050,29,219,"Missouri","Warren County",2,15,502,258,244
050,29,219,"Missouri","Warren County",2,16,494,240,254
050,29,219,"Missouri","Warren County",2,17,497,249,248
050,29,219,"Missouri","Warren County",2,18,405,213,192
050,29,219,"Missouri","Warren County",2,19,337,171,166
050,29,219,"Missouri","Warren County",2,20,359,188,171
050,29,219,"Missouri","Warren County",2,21,359,189,170
050,29,219,"Missouri","Warren County",2,22,376,192,184
050,29,219,"Missouri","Warren County",2,23,397,203,194
050,29,219,"Missouri","Warren County",2,24,404,194,210
050,29,219,"Missouri","Warren County",2,25,419,205,214
050,29,219,"Missouri","Warren County",2,26,418,211,207
050,29,219,"Missouri","Warren County",2,27,416,208,208
050,29,219,"Missouri","Warren County",2,28,444,225,219
050,29,219,"Missouri","Warren County",2,29,462,235,227
050,29,219,"Missouri","Warren County",2,30,477,250,227
050,29,219,"Missouri","Warren County",2,31,445,241,204
050,29,219,"Missouri","Warren County",2,32,432,228,204
050,29,219,"Missouri","Warren County",2,33,454,235,219
050,29,219,"Missouri","Warren County",2,34,457,237,220
050,29,219,"Missouri","Warren County",2,35,420,210,210
050,29,219,"Missouri","Warren County",2,36,411,211,200
050,29,219,"Missouri","Warren County",2,37,436,221,215
050,29,219,"Missouri","Warren County",2,38,442,209,233
050,29,219,"Missouri","Warren County",2,39,424,200,224
050,29,219,"Missouri","Warren County",2,40,428,213,215
050,29,219,"Missouri","Warren County",2,41,400,197,203
050,29,219,"Missouri","Warren County",2,42,417,214,203
050,29,219,"Missouri","Warren County",2,43,403,195,208
050,29,219,"Missouri","Warren County",2,44,373,191,182
050,29,219,"Missouri","Warren County",2,45,368,195,173
050,29,219,"Missouri","Warren County",2,46,357,184,173
050,29,219,"Missouri","Warren County",2,47,367,188,179
050,29,219,"Missouri","Warren County",2,48,415,219,196
050,29,219,"Missouri","Warren County",2,49,456,234,222
050,29,219,"Missouri","Warren County",2,50,435,218,217
050,29,219,"Missouri","Warren County",2,51,419,202,217
050,29,219,"Missouri","Warren County",2,52,440,214,226
050,29,219,"Missouri","Warren County",2,53,460,229,231
050,29,219,"Missouri","Warren County",2,54,470,243,227
050,29,219,"Missouri","Warren County",2,55,526,252,274
050,29,219,"Missouri","Warren County",2,56,552,278,274
050,29,219,"Missouri","Warren County",2,57,580,301,279
050,29,219,"Missouri","Warren County",2,58,597,294,303
050,29,219,"Missouri","Warren County",2,59,597,303,294
050,29,219,"Missouri","Warren County",2,60,581,294,287
050,29,219,"Missouri","Warren County",2,61,546,281,265
050,29,219,"Missouri","Warren County",2,62,540,267,273
050,29,219,"Missouri","Warren County",2,63,521,257,264
050,29,219,"Missouri","Warren County",2,64,488,251,237
050,29,219,"Missouri","Warren County",2,65,471,243,228
050,29,219,"Missouri","Warren County",2,66,437,228,209
050,29,219,"Missouri","Warren County",2,67,395,196,199
050,29,219,"Missouri","Warren County",2,68,404,198,206
050,29,219,"Missouri","Warren County",2,69,398,195,203
050,29,219,"Missouri","Warren County",2,70,358,174,184
050,29,219,"Missouri","Warren County",2,71,333,155,178
050,29,219,"Missouri","Warren County",2,72,338,154,184
050,29,219,"Missouri","Warren County",2,73,370,185,185
050,29,219,"Missouri","Warren County",2,74,248,121,127
050,29,219,"Missouri","Warren County",2,75,247,117,130
050,29,219,"Missouri","Warren County",2,76,262,133,129
050,29,219,"Missouri","Warren County",2,77,269,130,139
050,29,219,"Missouri","Warren County",2,78,229,113,116
050,29,219,"Missouri","Warren County",2,79,208,99,109
050,29,219,"Missouri","Warren County",2,80,188,89,99
050,29,219,"Missouri","Warren County",2,81,170,84,86
050,29,219,"Missouri","Warren County",2,82,141,70,71
050,29,219,"Missouri","Warren County",2,83,113,58,55
050,29,219,"Missouri","Warren County",2,84,114,51,63
050,29,219,"Missouri","Warren County",2,85,608,253,355
050,29,219,"Missouri","Warren County",3,0,386,183,203
050,29,219,"Missouri","Warren County",3,1,447,232,215
050,29,219,"Missouri","Warren County",3,2,433,232,201
050,29,219,"Missouri","Warren County",3,3,440,220,220
050,29,219,"Missouri","Warren County",3,4,456,225,231
050,29,219,"Missouri","Warren County",3,5,485,255,230
050,29,219,"Missouri","Warren County",3,6,483,253,230
050,29,219,"Missouri","Warren County",3,7,457,241,216
050,29,219,"Missouri","Warren County",3,8,458,231,227
050,29,219,"Missouri","Warren County",3,9,464,239,225
050,29,219,"Missouri","Warren County",3,10,461,229,232
050,29,219,"Missouri","Warren County",3,11,474,241,233
050,29,219,"Missouri","Warren County",3,12,508,251,257
050,29,219,"Missouri","Warren County",3,13,540,265,275
050,29,219,"Missouri","Warren County",3,14,525,259,266
050,29,219,"Missouri","Warren County",3,15,519,269,250
050,29,219,"Missouri","Warren County",3,16,505,258,247
050,29,219,"Missouri","Warren County",3,17,500,241,259
050,29,219,"Missouri","Warren County",3,18,430,224,206
050,29,219,"Missouri","Warren County",3,19,336,177,159
050,29,219,"Missouri","Warren County",3,20,363,181,182
050,29,219,"Missouri","Warren County",3,21,398,211,187
050,29,219,"Missouri","Warren County",3,22,417,213,204
050,29,219,"Missouri","Warren County",3,23,404,208,196
050,29,219,"Missouri","Warren County",3,24,419,219,200
050,29,219,"Missouri","Warren County",3,25,438,233,205
050,29,219,"Missouri","Warren County",3,26,420,209,211
050,29,219,"Missouri","Warren County",3,27,400,197,203
050,29,219,"Missouri","Warren County",3,28,441,231,210
050,29,219,"Missouri","Warren County",3,29,469,229,240
050,29,219,"Missouri","Warren County",3,30,474,242,232
050,29,219,"Missouri","Warren County",3,31,486,248,238
050,29,219,"Missouri","Warren County",3,32,472,256,216
050,29,219,"Missouri","Warren County",3,33,486,259,227
050,29,219,"Missouri","Warren County",3,34,476,255,221
050,29,219,"Missouri","Warren County",3,35,468,239,229
050,29,219,"Missouri","Warren County",3,36,433,216,217
050,29,219,"Missouri","Warren County",3,37,438,225,213
050,29,219,"Missouri","Warren County",3,38,440,221,219
050,29,219,"Missouri","Warren County",3,39,428,204,224
050,29,219,"Missouri","Warren County",3,40,450,210,240
050,29,219,"Missouri","Warren County",3,41,449,227,222
050,29,219,"Missouri","Warren County",3,42,406,203,203
050,29,219,"Missouri","Warren County",3,43,417,220,197
050,29,219,"Missouri","Warren County",3,44,423,204,219
050,29,219,"Missouri","Warren County",3,45,381,192,189
050,29,219,"Missouri","Warren County",3,46,375,194,181
050,29,219,"Missouri","Warren County",3,47,365,191,174
050,29,219,"Missouri","Warren County",3,48,363,188,175
050,29,219,"Missouri","Warren County",3,49,440,235,205
050,29,219,"Missouri","Warren County",3,50,457,240,217
050,29,219,"Missouri","Warren County",3,51,441,218,223
050,29,219,"Missouri","Warren County",3,52,450,211,239
050,29,219,"Missouri","Warren County",3,53,452,225,227
050,29,219,"Missouri","Warren County",3,54,462,231,231
050,29,219,"Missouri","Warren County",3,55,476,247,229
050,29,219,"Missouri","Warren County",3,56,532,262,270
050,29,219,"Missouri","Warren County",3,57,568,282,286
050,29,219,"Missouri","Warren County",3,58,596,306,290
050,29,219,"Missouri","Warren County",3,59,606,302,304
050,29,219,"Missouri","Warren County",3,60,605,304,301
050,29,219,"Missouri","Warren County",3,61,578,290,288
050,29,219,"Missouri","Warren County",3,62,541,281,260
050,29,219,"Missouri","Warren County",3,63,540,264,276
050,29,219,"Missouri","Warren County",3,64,523,263,260
050,29,219,"Missouri","Warren County",3,65,503,255,248
050,29,219,"Missouri","Warren County",3,66,479,250,229
050,29,219,"Missouri","Warren County",3,67,429,227,202
050,29,219,"Missouri","Warren County",3,68,393,195,198
050,29,219,"Missouri","Warren County",3,69,398,193,205
050,29,219,"Missouri","Warren County",3,70,403,192,211
050,29,219,"Missouri","Warren County",3,71,354,171,183
050,29,219,"Missouri","Warren County",3,72,334,155,179
050,29,219,"Missouri","Warren County",3,73,333,148,185
050,29,219,"Missouri","Warren County",3,74,363,179,184
050,29,219,"Missouri","Warren County",3,75,249,119,130
050,29,219,"Missouri","Warren County",3,76,247,119,128
050,29,219,"Missouri","Warren County",3,77,258,129,129
050,29,219,"Missouri","Warren County",3,78,250,124,126
050,29,219,"Missouri","Warren County",3,79,219,105,114
050,29,219,"Missouri","Warren County",3,80,199,97,102
050,29,219,"Missouri","Warren County",3,81,177,86,91
050,29,219,"Missouri","Warren County",3,82,158,74,84
050,29,219,"Missouri","Warren County",3,83,130,59,71
050,29,219,"Missouri","Warren County",3,84,104,51,53
050,29,219,"Missouri","Warren County",3,85,598,236,362
050,29,219,"Missouri","Warren County",4,0,442,215,227
050,29,219,"Missouri","Warren County",4,1,391,180,211
050,29,219,"Missouri","Warren County",4,2,469,236,233
050,29,219,"Missouri","Warren County",4,3,443,231,212
050,29,219,"Missouri","Warren County",4,4,466,237,229
050,29,219,"Missouri","Warren County",4,5,479,234,245
050,29,219,"Missouri","Warren County",4,6,495,260,235
050,29,219,"Missouri","Warren County",4,7,491,269,222
050,29,219,"Missouri","Warren County",4,8,457,241,216
050,29,219,"Missouri","Warren County",4,9,457,231,226
050,29,219,"Missouri","Warren County",4,10,482,248,234
050,29,219,"Missouri","Warren County",4,11,478,240,238
050,29,219,"Missouri","Warren County",4,12,484,248,236
050,29,219,"Missouri","Warren County",4,13,538,261,277
050,29,219,"Missouri","Warren County",4,14,539,258,281
050,29,219,"Missouri","Warren County",4,15,546,271,275
050,29,219,"Missouri","Warren County",4,16,523,264,259
050,29,219,"Missouri","Warren County",4,17,513,261,252
050,29,219,"Missouri","Warren County",4,18,420,212,208
050,29,219,"Missouri","Warren County",4,19,327,170,157
050,29,219,"Missouri","Warren County",4,20,357,188,169
050,29,219,"Missouri","Warren County",4,21,369,187,182
050,29,219,"Missouri","Warren County",4,22,424,217,207
050,29,219,"Missouri","Warren County",4,23,459,246,213
050,29,219,"Missouri","Warren County",4,24,414,210,204
050,29,219,"Missouri","Warren County",4,25,445,239,206
050,29,219,"Missouri","Warren County",4,26,446,229,217
050,29,219,"Missouri","Warren County",4,27,451,228,223
050,29,219,"Missouri","Warren County",4,28,417,194,223
050,29,219,"Missouri","Warren County",4,29,451,240,211
050,29,219,"Missouri","Warren County",4,30,494,241,253
050,29,219,"Missouri","Warren County",4,31,480,238,242
050,29,219,"Missouri","Warren County",4,32,485,254,231
050,29,219,"Missouri","Warren County",4,33,487,264,223
050,29,219,"Missouri","Warren County",4,34,496,261,235
050,29,219,"Missouri","Warren County",4,35,483,256,227
050,29,219,"Missouri","Warren County",4,36,486,243,243
050,29,219,"Missouri","Warren County",4,37,439,217,222
050,29,219,"Missouri","Warren County",4,38,466,250,216
050,29,219,"Missouri","Warren County",4,39,445,218,227
050,29,219,"Missouri","Warren County",4,40,449,225,224
050,29,219,"Missouri","Warren County",4,41,458,213,245
050,29,219,"Missouri","Warren County",4,42,460,235,225
050,29,219,"Missouri","Warren County",4,43,402,203,199
050,29,219,"Missouri","Warren County",4,44,434,229,205
050,29,219,"Missouri","Warren County",4,45,439,209,230
050,29,219,"Missouri","Warren County",4,46,392,194,198
050,29,219,"Missouri","Warren County",4,47,379,195,184
050,29,219,"Missouri","Warren County",4,48,373,189,184
050,29,219,"Missouri","Warren County",4,49,362,190,172
050,29,219,"Missouri","Warren County",4,50,444,238,206
050,29,219,"Missouri","Warren County",4,51,477,247,230
050,29,219,"Missouri","Warren County",4,52,452,226,226
050,29,219,"Missouri","Warren County",4,53,468,227,241
050,29,219,"Missouri","Warren County",4,54,476,242,234
050,29,219,"Missouri","Warren County",4,55,469,238,231
050,29,219,"Missouri","Warren County",4,56,492,252,240
050,29,219,"Missouri","Warren County",4,57,546,269,277
050,29,219,"Missouri","Warren County",4,58,567,285,282
050,29,219,"Missouri","Warren County",4,59,601,308,293
050,29,219,"Missouri","Warren County",4,60,603,295,308
050,29,219,"Missouri","Warren County",4,61,607,301,306
050,29,219,"Missouri","Warren County",4,62,586,291,295
050,29,219,"Missouri","Warren County",4,63,528,270,258
050,29,219,"Missouri","Warren County",4,64,547,270,277
050,29,219,"Missouri","Warren County",4,65,538,274,264
050,29,219,"Missouri","Warren County",4,66,503,257,246
050,29,219,"Missouri","Warren County",4,67,487,258,229
050,29,219,"Missouri","Warren County",4,68,433,227,206
050,29,219,"Missouri","Warren County",4,69,399,195,204
050,29,219,"Missouri","Warren County",4,70,399,194,205
050,29,219,"Missouri","Warren County",4,71,396,189,207
050,29,219,"Missouri","Warren County",4,72,354,172,182
050,29,219,"Missouri","Warren County",4,73,321,147,174
050,29,219,"Missouri","Warren County",4,74,313,140,173
050,29,219,"Missouri","Warren County",4,75,349,169,180
050,29,219,"Missouri","Warren County",4,76,239,114,125
050,29,219,"Missouri","Warren County",4,77,231,110,121
050,29,219,"Missouri","Warren County",4,78,241,121,120
050,29,219,"Missouri","Warren County",4,79,241,120,121
050,29,219,"Missouri","Warren County",4,80,206,97,109
050,29,219,"Missouri","Warren County",4,81,181,86,95
050,29,219,"Missouri","Warren County",4,82,165,76,89
050,29,219,"Missouri","Warren County",4,83,145,65,80
050,29,219,"Missouri","Warren County",4,84,119,57,62
050,29,219,"Missouri","Warren County",4,85,585,229,356
050,29,219,"Missouri","Warren County",5,0,437,211,226
050,29,219,"Missouri","Warren County",5,1,456,232,224
050,29,219,"Missouri","Warren County",5,2,380,179,201
050,29,219,"Missouri","Warren County",5,3,479,247,232
050,29,219,"Missouri","Warren County",5,4,449,230,219
050,29,219,"Missouri","Warren County",5,5,470,233,237
050,29,219,"Missouri","Warren County",5,6,479,226,253
050,29,219,"Missouri","Warren County",5,7,477,255,222
050,29,219,"Missouri","Warren County",5,8,491,276,215
050,29,219,"Missouri","Warren County",5,9,475,249,226
050,29,219,"Missouri","Warren County",5,10,465,235,230
050,29,219,"Missouri","Warren County",5,11,470,238,232
050,29,219,"Missouri","Warren County",5,12,468,235,233
050,29,219,"Missouri","Warren County",5,13,486,240,246
050,29,219,"Missouri","Warren County",5,14,534,257,277
050,29,219,"Missouri","Warren County",5,15,527,250,277
050,29,219,"Missouri","Warren County",5,16,549,273,276
050,29,219,"Missouri","Warren County",5,17,514,266,248
050,29,219,"Missouri","Warren County",5,18,427,224,203
050,29,219,"Missouri","Warren County",5,19,335,173,162
050,29,219,"Missouri","Warren County",5,20,363,190,173
050,29,219,"Missouri","Warren County",5,21,384,201,183
050,29,219,"Missouri","Warren County",5,22,404,200,204
050,29,219,"Missouri","Warren County",5,23,443,234,209
050,29,219,"Missouri","Warren County",5,24,474,255,219
050,29,219,"Missouri","Warren County",5,25,443,231,212
050,29,219,"Missouri","Warren County",5,26,447,243,204
050,29,219,"Missouri","Warren County",5,27,469,230,239
050,29,219,"Missouri","Warren County",5,28,462,241,221
050,29,219,"Missouri","Warren County",5,29,440,206,234
050,29,219,"Missouri","Warren County",5,30,462,243,219
050,29,219,"Missouri","Warren County",5,31,507,248,259
050,29,219,"Missouri","Warren County",5,32,496,242,254
050,29,219,"Missouri","Warren County",5,33,495,269,226
050,29,219,"Missouri","Warren County",5,34,499,265,234
050,29,219,"Missouri","Warren County",5,35,496,258,238
050,29,219,"Missouri","Warren County",5,36,472,254,218
050,29,219,"Missouri","Warren County",5,37,513,248,265
050,29,219,"Missouri","Warren County",5,38,443,227,216
050,29,219,"Missouri","Warren County",5,39,465,244,221
050,29,219,"Missouri","Warren County",5,40,464,238,226
050,29,219,"Missouri","Warren County",5,41,445,219,226
050,29,219,"Missouri","Warren County",5,42,469,224,245
050,29,219,"Missouri","Warren County",5,43,473,241,232
050,29,219,"Missouri","Warren County",5,44,412,215,197
050,29,219,"Missouri","Warren County",5,45,444,234,210
050,29,219,"Missouri","Warren County",5,46,447,214,233
050,29,219,"Missouri","Warren County",5,47,391,192,199
050,29,219,"Missouri","Warren County",5,48,378,193,185
050,29,219,"Missouri","Warren County",5,49,391,200,191
050,29,219,"Missouri","Warren County",5,50,365,196,169
050,29,219,"Missouri","Warren County",5,51,455,241,214
050,29,219,"Missouri","Warren County",5,52,492,259,233
050,29,219,"Missouri","Warren County",5,53,473,234,239
050,29,219,"Missouri","Warren County",5,54,450,219,231
050,29,219,"Missouri","Warren County",5,55,466,233,233
050,29,219,"Missouri","Warren County",5,56,469,240,229
050,29,219,"Missouri","Warren County",5,57,511,261,250
050,29,219,"Missouri","Warren County",5,58,555,269,286
050,29,219,"Missouri","Warren County",5,59,571,285,286
050,29,219,"Missouri","Warren County",5,60,618,322,296
050,29,219,"Missouri","Warren County",5,61,597,292,305
050,29,219,"Missouri","Warren County",5,62,618,303,315
050,29,219,"Missouri","Warren County",5,63,580,280,300
050,29,219,"Missouri","Warren County",5,64,546,279,267
050,29,219,"Missouri","Warren County",5,65,575,288,287
050,29,219,"Missouri","Warren County",5,66,537,276,261
050,29,219,"Missouri","Warren County",5,67,511,264,247
050,29,219,"Missouri","Warren County",5,68,491,260,231
050,29,219,"Missouri","Warren County",5,69,435,229,206
050,29,219,"Missouri","Warren County",5,70,392,191,201
050,29,219,"Missouri","Warren County",5,71,400,194,206
050,29,219,"Missouri","Warren County",5,72,392,185,207
050,29,219,"Missouri","Warren County",5,73,345,163,182
050,29,219,"Missouri","Warren County",5,74,303,141,162
050,29,219,"Missouri","Warren County",5,75,310,142,168
050,29,219,"Missouri","Warren County",5,76,340,163,177
050,29,219,"Missouri","Warren County",5,77,217,101,116
050,29,219,"Missouri","Warren County",5,78,222,105,117
050,29,219,"Missouri","Warren County",5,79,224,111,113
050,29,219,"Missouri","Warren County",5,80,226,111,115
050,29,219,"Missouri","Warren County",5,81,192,91,101
050,29,219,"Missouri","Warren County",5,82,169,79,90
050,29,219,"Missouri","Warren County",5,83,150,69,81
050,29,219,"Missouri","Warren County",5,84,135,64,71
050,29,219,"Missouri","Warren County",5,85,615,237,378
050,29,221,"Missouri","Washington County",1,0,256,132,124
050,29,221,"Missouri","Washington County",1,1,261,138,123
050,29,221,"Missouri","Washington County",1,2,266,145,121
050,29,221,"Missouri","Washington County",1,3,276,139,137
050,29,221,"Missouri","Washington County",1,4,277,141,136
050,29,221,"Missouri","Washington County",1,5,272,139,133
050,29,221,"Missouri","Washington County",1,6,278,140,138
050,29,221,"Missouri","Washington County",1,7,288,141,147
050,29,221,"Missouri","Washington County",1,8,282,137,145
050,29,221,"Missouri","Washington County",1,9,271,134,137
050,29,221,"Missouri","Washington County",1,10,294,147,147
050,29,221,"Missouri","Washington County",1,11,340,165,175
050,29,221,"Missouri","Washington County",1,12,332,156,176
050,29,221,"Missouri","Washington County",1,13,332,161,171
050,29,221,"Missouri","Washington County",1,14,313,158,155
050,29,221,"Missouri","Washington County",1,15,337,183,154
050,29,221,"Missouri","Washington County",1,16,325,160,165
050,29,221,"Missouri","Washington County",1,17,337,172,165
050,29,221,"Missouri","Washington County",1,18,286,155,131
050,29,221,"Missouri","Washington County",1,19,198,111,87
050,29,221,"Missouri","Washington County",1,20,216,119,97
050,29,221,"Missouri","Washington County",1,21,237,128,109
050,29,221,"Missouri","Washington County",1,22,252,136,116
050,29,221,"Missouri","Washington County",1,23,257,137,120
050,29,221,"Missouri","Washington County",1,24,252,128,124
050,29,221,"Missouri","Washington County",1,25,258,141,117
050,29,221,"Missouri","Washington County",1,26,284,157,127
050,29,221,"Missouri","Washington County",1,27,282,143,139
050,29,221,"Missouri","Washington County",1,28,292,141,151
050,29,221,"Missouri","Washington County",1,29,295,159,136
050,29,221,"Missouri","Washington County",1,30,291,171,120
050,29,221,"Missouri","Washington County",1,31,274,156,118
050,29,221,"Missouri","Washington County",1,32,282,146,136
050,29,221,"Missouri","Washington County",1,33,285,154,131
050,29,221,"Missouri","Washington County",1,34,302,176,126
050,29,221,"Missouri","Washington County",1,35,277,161,116
050,29,221,"Missouri","Washington County",1,36,278,150,128
050,29,221,"Missouri","Washington County",1,37,302,161,141
050,29,221,"Missouri","Washington County",1,38,280,148,132
050,29,221,"Missouri","Washington County",1,39,307,166,141
050,29,221,"Missouri","Washington County",1,40,274,139,135
050,29,221,"Missouri","Washington County",1,41,281,157,124
050,29,221,"Missouri","Washington County",1,42,276,147,129
050,29,221,"Missouri","Washington County",1,43,286,155,131
050,29,221,"Missouri","Washington County",1,44,300,167,133
050,29,221,"Missouri","Washington County",1,45,307,166,141
050,29,221,"Missouri","Washington County",1,46,304,162,142
050,29,221,"Missouri","Washington County",1,47,340,191,149
050,29,221,"Missouri","Washington County",1,48,335,190,145
050,29,221,"Missouri","Washington County",1,49,335,180,155
050,29,221,"Missouri","Washington County",1,50,344,187,157
050,29,221,"Missouri","Washington County",1,51,337,186,151
050,29,221,"Missouri","Washington County",1,52,310,174,136
050,29,221,"Missouri","Washington County",1,53,314,173,141
050,29,221,"Missouri","Washington County",1,54,320,168,152
050,29,221,"Missouri","Washington County",1,55,368,189,179
050,29,221,"Missouri","Washington County",1,56,377,193,184
050,29,221,"Missouri","Washington County",1,57,358,198,160
050,29,221,"Missouri","Washington County",1,58,355,185,170
050,29,221,"Missouri","Washington County",1,59,349,181,168
050,29,221,"Missouri","Washington County",1,60,339,172,167
050,29,221,"Missouri","Washington County",1,61,326,165,161
050,29,221,"Missouri","Washington County",1,62,349,180,169
050,29,221,"Missouri","Washington County",1,63,359,187,172
050,29,221,"Missouri","Washington County",1,64,343,180,163
050,29,221,"Missouri","Washington County",1,65,319,167,152
050,29,221,"Missouri","Washington County",1,66,283,139,144
050,29,221,"Missouri","Washington County",1,67,254,116,138
050,29,221,"Missouri","Washington County",1,68,265,126,139
050,29,221,"Missouri","Washington County",1,69,267,127,140
050,29,221,"Missouri","Washington County",1,70,239,119,120
050,29,221,"Missouri","Washington County",1,71,224,107,117
050,29,221,"Missouri","Washington County",1,72,235,112,123
050,29,221,"Missouri","Washington County",1,73,229,114,115
050,29,221,"Missouri","Washington County",1,74,157,82,75
050,29,221,"Missouri","Washington County",1,75,168,88,80
050,29,221,"Missouri","Washington County",1,76,166,74,92
050,29,221,"Missouri","Washington County",1,77,148,72,76
050,29,221,"Missouri","Washington County",1,78,138,66,72
050,29,221,"Missouri","Washington County",1,79,136,65,71
050,29,221,"Missouri","Washington County",1,80,117,56,61
050,29,221,"Missouri","Washington County",1,81,106,49,57
050,29,221,"Missouri","Washington County",1,82,96,52,44
050,29,221,"Missouri","Washington County",1,83,70,31,39
050,29,221,"Missouri","Washington County",1,84,71,33,38
050,29,221,"Missouri","Washington County",1,85,317,143,174
050,29,221,"Missouri","Washington County",2,0,261,134,127
050,29,221,"Missouri","Washington County",2,1,259,137,122
050,29,221,"Missouri","Washington County",2,2,266,144,122
050,29,221,"Missouri","Washington County",2,3,275,141,134
050,29,221,"Missouri","Washington County",2,4,276,140,136
050,29,221,"Missouri","Washington County",2,5,271,138,133
050,29,221,"Missouri","Washington County",2,6,277,141,136
050,29,221,"Missouri","Washington County",2,7,282,141,141
050,29,221,"Missouri","Washington County",2,8,284,140,144
050,29,221,"Missouri","Washington County",2,9,273,135,138
050,29,221,"Missouri","Washington County",2,10,289,144,145
050,29,221,"Missouri","Washington County",2,11,329,160,169
050,29,221,"Missouri","Washington County",2,12,335,160,175
050,29,221,"Missouri","Washington County",2,13,332,160,172
050,29,221,"Missouri","Washington County",2,14,320,160,160
050,29,221,"Missouri","Washington County",2,15,332,177,155
050,29,221,"Missouri","Washington County",2,16,330,166,164
050,29,221,"Missouri","Washington County",2,17,335,170,165
050,29,221,"Missouri","Washington County",2,18,282,151,131
050,29,221,"Missouri","Washington County",2,19,205,113,92
050,29,221,"Missouri","Washington County",2,20,219,121,98
050,29,221,"Missouri","Washington County",2,21,236,128,108
050,29,221,"Missouri","Washington County",2,22,251,135,116
050,29,221,"Missouri","Washington County",2,23,256,136,120
050,29,221,"Missouri","Washington County",2,24,251,127,124
050,29,221,"Missouri","Washington County",2,25,257,138,119
050,29,221,"Missouri","Washington County",2,26,275,150,125
050,29,221,"Missouri","Washington County",2,27,280,143,137
050,29,221,"Missouri","Washington County",2,28,292,142,150
050,29,221,"Missouri","Washington County",2,29,292,152,140
050,29,221,"Missouri","Washington County",2,30,288,164,124
050,29,221,"Missouri","Washington County",2,31,276,157,119
050,29,221,"Missouri","Washington County",2,32,277,143,134
050,29,221,"Missouri","Washington County",2,33,287,154,133
050,29,221,"Missouri","Washington County",2,34,293,166,127
050,29,221,"Missouri","Washington County",2,35,282,164,118
050,29,221,"Missouri","Washington County",2,36,274,149,125
050,29,221,"Missouri","Washington County",2,37,292,155,137
050,29,221,"Missouri","Washington County",2,38,285,150,135
050,29,221,"Missouri","Washington County",2,39,299,160,139
050,29,221,"Missouri","Washington County",2,40,277,141,136
050,29,221,"Missouri","Washington County",2,41,279,151,128
050,29,221,"Missouri","Washington County",2,42,273,145,128
050,29,221,"Missouri","Washington County",2,43,284,153,131
050,29,221,"Missouri","Washington County",2,44,291,160,131
050,29,221,"Missouri","Washington County",2,45,301,164,137
050,29,221,"Missouri","Washington County",2,46,299,159,140
050,29,221,"Missouri","Washington County",2,47,328,182,146
050,29,221,"Missouri","Washington County",2,48,328,183,145
050,29,221,"Missouri","Washington County",2,49,334,180,154
050,29,221,"Missouri","Washington County",2,50,339,182,157
050,29,221,"Missouri","Washington County",2,51,332,183,149
050,29,221,"Missouri","Washington County",2,52,313,175,138
050,29,221,"Missouri","Washington County",2,53,308,169,139
050,29,221,"Missouri","Washington County",2,54,313,163,150
050,29,221,"Missouri","Washington County",2,55,359,185,174
050,29,221,"Missouri","Washington County",2,56,373,191,182
050,29,221,"Missouri","Washington County",2,57,360,195,165
050,29,221,"Missouri","Washington County",2,58,352,186,166
050,29,221,"Missouri","Washington County",2,59,353,182,171
050,29,221,"Missouri","Washington County",2,60,342,173,169
050,29,221,"Missouri","Washington County",2,61,328,165,163
050,29,221,"Missouri","Washington County",2,62,344,174,170
050,29,221,"Missouri","Washington County",2,63,355,184,171
050,29,221,"Missouri","Washington County",2,64,345,181,164
050,29,221,"Missouri","Washington County",2,65,322,170,152
050,29,221,"Missouri","Washington County",2,66,292,146,146
050,29,221,"Missouri","Washington County",2,67,258,121,137
050,29,221,"Missouri","Washington County",2,68,257,122,135
050,29,221,"Missouri","Washington County",2,69,267,125,142
050,29,221,"Missouri","Washington County",2,70,245,120,125
050,29,221,"Missouri","Washington County",2,71,226,108,118
050,29,221,"Missouri","Washington County",2,72,228,108,120
050,29,221,"Missouri","Washington County",2,73,240,119,121
050,29,221,"Missouri","Washington County",2,74,160,82,78
050,29,221,"Missouri","Washington County",2,75,163,86,77
050,29,221,"Missouri","Washington County",2,76,166,77,89
050,29,221,"Missouri","Washington County",2,77,155,74,81
050,29,221,"Missouri","Washington County",2,78,137,66,71
050,29,221,"Missouri","Washington County",2,79,134,64,70
050,29,221,"Missouri","Washington County",2,80,122,59,63
050,29,221,"Missouri","Washington County",2,81,107,51,56
050,29,221,"Missouri","Washington County",2,82,95,49,46
050,29,221,"Missouri","Washington County",2,83,75,36,39
050,29,221,"Missouri","Washington County",2,84,69,31,38
050,29,221,"Missouri","Washington County",2,85,321,146,175
050,29,221,"Missouri","Washington County",3,0,245,138,107
050,29,221,"Missouri","Washington County",3,1,260,126,134
050,29,221,"Missouri","Washington County",3,2,268,147,121
050,29,221,"Missouri","Washington County",3,3,272,145,127
050,29,221,"Missouri","Washington County",3,4,281,151,130
050,29,221,"Missouri","Washington County",3,5,281,143,138
050,29,221,"Missouri","Washington County",3,6,281,138,143
050,29,221,"Missouri","Washington County",3,7,288,142,146
050,29,221,"Missouri","Washington County",3,8,301,148,153
050,29,221,"Missouri","Washington County",3,9,283,141,142
050,29,221,"Missouri","Washington County",3,10,260,126,134
050,29,221,"Missouri","Washington County",3,11,293,150,143
050,29,221,"Missouri","Washington County",3,12,332,159,173
050,29,221,"Missouri","Washington County",3,13,339,162,177
050,29,221,"Missouri","Washington County",3,14,358,178,180
050,29,221,"Missouri","Washington County",3,15,328,157,171
050,29,221,"Missouri","Washington County",3,16,321,172,149
050,29,221,"Missouri","Washington County",3,17,316,154,162
050,29,221,"Missouri","Washington County",3,18,281,147,134
050,29,221,"Missouri","Washington County",3,19,217,116,101
050,29,221,"Missouri","Washington County",3,20,228,119,109
050,29,221,"Missouri","Washington County",3,21,232,132,100
050,29,221,"Missouri","Washington County",3,22,249,126,123
050,29,221,"Missouri","Washington County",3,23,263,144,119
050,29,221,"Missouri","Washington County",3,24,264,141,123
050,29,221,"Missouri","Washington County",3,25,248,133,115
050,29,221,"Missouri","Washington County",3,26,262,144,118
050,29,221,"Missouri","Washington County",3,27,267,144,123
050,29,221,"Missouri","Washington County",3,28,291,148,143
050,29,221,"Missouri","Washington County",3,29,311,154,157
050,29,221,"Missouri","Washington County",3,30,306,160,146
050,29,221,"Missouri","Washington County",3,31,285,162,123
050,29,221,"Missouri","Washington County",3,32,260,140,120
050,29,221,"Missouri","Washington County",3,33,304,159,145
050,29,221,"Missouri","Washington County",3,34,284,159,125
050,29,221,"Missouri","Washington County",3,35,304,174,130
050,29,221,"Missouri","Washington County",3,36,291,170,121
050,29,221,"Missouri","Washington County",3,37,274,146,128
050,29,221,"Missouri","Washington County",3,38,283,157,126
050,29,221,"Missouri","Washington County",3,39,292,154,138
050,29,221,"Missouri","Washington County",3,40,296,154,142
050,29,221,"Missouri","Washington County",3,41,295,151,144
050,29,221,"Missouri","Washington County",3,42,277,149,128
050,29,221,"Missouri","Washington County",3,43,276,149,127
050,29,221,"Missouri","Washington County",3,44,290,154,136
050,29,221,"Missouri","Washington County",3,45,297,164,133
050,29,221,"Missouri","Washington County",3,46,295,163,132
050,29,221,"Missouri","Washington County",3,47,318,173,145
050,29,221,"Missouri","Washington County",3,48,312,173,139
050,29,221,"Missouri","Washington County",3,49,323,175,148
050,29,221,"Missouri","Washington County",3,50,324,178,146
050,29,221,"Missouri","Washington County",3,51,333,184,149
050,29,221,"Missouri","Washington County",3,52,340,187,153
050,29,221,"Missouri","Washington County",3,53,298,167,131
050,29,221,"Missouri","Washington County",3,54,300,161,139
050,29,221,"Missouri","Washington County",3,55,319,175,144
050,29,221,"Missouri","Washington County",3,56,346,173,173
050,29,221,"Missouri","Washington County",3,57,380,198,182
050,29,221,"Missouri","Washington County",3,58,350,182,168
050,29,221,"Missouri","Washington County",3,59,355,189,166
050,29,221,"Missouri","Washington County",3,60,357,184,173
050,29,221,"Missouri","Washington County",3,61,326,157,169
050,29,221,"Missouri","Washington County",3,62,320,164,156
050,29,221,"Missouri","Washington County",3,63,329,165,164
050,29,221,"Missouri","Washington County",3,64,356,183,173
050,29,221,"Missouri","Washington County",3,65,337,176,161
050,29,221,"Missouri","Washington County",3,66,307,160,147
050,29,221,"Missouri","Washington County",3,67,282,138,144
050,29,221,"Missouri","Washington County",3,68,246,117,129
050,29,221,"Missouri","Washington County",3,69,241,111,130
050,29,221,"Missouri","Washington County",3,70,256,121,135
050,29,221,"Missouri","Washington County",3,71,232,111,121
050,29,221,"Missouri","Washington County",3,72,222,104,118
050,29,221,"Missouri","Washington County",3,73,209,101,108
050,29,221,"Missouri","Washington County",3,74,225,111,114
050,29,221,"Missouri","Washington County",3,75,148,78,70
050,29,221,"Missouri","Washington County",3,76,154,83,71
050,29,221,"Missouri","Washington County",3,77,153,70,83
050,29,221,"Missouri","Washington County",3,78,147,68,79
050,29,221,"Missouri","Washington County",3,79,121,54,67
050,29,221,"Missouri","Washington County",3,80,123,57,66
050,29,221,"Missouri","Washington County",3,81,119,58,61
050,29,221,"Missouri","Washington County",3,82,98,48,50
050,29,221,"Missouri","Washington County",3,83,75,39,36
050,29,221,"Missouri","Washington County",3,84,65,30,35
050,29,221,"Missouri","Washington County",3,85,317,146,171
050,29,221,"Missouri","Washington County",4,0,267,154,113
050,29,221,"Missouri","Washington County",4,1,253,146,107
050,29,221,"Missouri","Washington County",4,2,260,123,137
050,29,221,"Missouri","Washington County",4,3,281,152,129
050,29,221,"Missouri","Washington County",4,4,277,143,134
050,29,221,"Missouri","Washington County",4,5,284,147,137
050,29,221,"Missouri","Washington County",4,6,284,146,138
050,29,221,"Missouri","Washington County",4,7,289,139,150
050,29,221,"Missouri","Washington County",4,8,283,143,140
050,29,221,"Missouri","Washington County",4,9,305,147,158
050,29,221,"Missouri","Washington County",4,10,292,143,149
050,29,221,"Missouri","Washington County",4,11,279,138,141
050,29,221,"Missouri","Washington County",4,12,291,150,141
050,29,221,"Missouri","Washington County",4,13,338,173,165
050,29,221,"Missouri","Washington County",4,14,327,156,171
050,29,221,"Missouri","Washington County",4,15,358,169,189
050,29,221,"Missouri","Washington County",4,16,318,157,161
050,29,221,"Missouri","Washington County",4,17,317,169,148
050,29,221,"Missouri","Washington County",4,18,274,141,133
050,29,221,"Missouri","Washington County",4,19,212,115,97
050,29,221,"Missouri","Washington County",4,20,227,127,100
050,29,221,"Missouri","Washington County",4,21,233,123,110
050,29,221,"Missouri","Washington County",4,22,250,143,107
050,29,221,"Missouri","Washington County",4,23,257,134,123
050,29,221,"Missouri","Washington County",4,24,262,144,118
050,29,221,"Missouri","Washington County",4,25,272,150,122
050,29,221,"Missouri","Washington County",4,26,243,130,113
050,29,221,"Missouri","Washington County",4,27,240,133,107
050,29,221,"Missouri","Washington County",4,28,263,137,126
050,29,221,"Missouri","Washington County",4,29,291,146,145
050,29,221,"Missouri","Washington County",4,30,317,158,159
050,29,221,"Missouri","Washington County",4,31,311,165,146
050,29,221,"Missouri","Washington County",4,32,275,148,127
050,29,221,"Missouri","Washington County",4,33,267,148,119
050,29,221,"Missouri","Washington County",4,34,305,161,144
050,29,221,"Missouri","Washington County",4,35,277,148,129
050,29,221,"Missouri","Washington County",4,36,318,183,135
050,29,221,"Missouri","Washington County",4,37,283,165,118
050,29,221,"Missouri","Washington County",4,38,281,144,137
050,29,221,"Missouri","Washington County",4,39,298,169,129
050,29,221,"Missouri","Washington County",4,40,282,144,138
050,29,221,"Missouri","Washington County",4,41,305,158,147
050,29,221,"Missouri","Washington County",4,42,293,144,149
050,29,221,"Missouri","Washington County",4,43,283,157,126
050,29,221,"Missouri","Washington County",4,44,281,151,130
050,29,221,"Missouri","Washington County",4,45,295,155,140
050,29,221,"Missouri","Washington County",4,46,299,163,136
050,29,221,"Missouri","Washington County",4,47,307,173,134
050,29,221,"Missouri","Washington County",4,48,301,163,138
050,29,221,"Missouri","Washington County",4,49,297,165,132
050,29,221,"Missouri","Washington County",4,50,325,169,156
050,29,221,"Missouri","Washington County",4,51,332,183,149
050,29,221,"Missouri","Washington County",4,52,329,187,142
050,29,221,"Missouri","Washington County",4,53,336,191,145
050,29,221,"Missouri","Washington County",4,54,293,152,141
050,29,221,"Missouri","Washington County",4,55,309,172,137
050,29,221,"Missouri","Washington County",4,56,310,170,140
050,29,221,"Missouri","Washington County",4,57,358,178,180
050,29,221,"Missouri","Washington County",4,58,379,192,187
050,29,221,"Missouri","Washington County",4,59,350,187,163
050,29,221,"Missouri","Washington County",4,60,352,184,168
050,29,221,"Missouri","Washington County",4,61,345,176,169
050,29,221,"Missouri","Washington County",4,62,315,152,163
050,29,221,"Missouri","Washington County",4,63,299,150,149
050,29,221,"Missouri","Washington County",4,64,332,163,169
050,29,221,"Missouri","Washington County",4,65,352,179,173
050,29,221,"Missouri","Washington County",4,66,323,163,160
050,29,221,"Missouri","Washington County",4,67,319,165,154
050,29,221,"Missouri","Washington County",4,68,277,141,136
050,29,221,"Missouri","Washington County",4,69,240,114,126
050,29,221,"Missouri","Washington County",4,70,237,113,124
050,29,221,"Missouri","Washington County",4,71,252,117,135
050,29,221,"Missouri","Washington County",4,72,230,111,119
050,29,221,"Missouri","Washington County",4,73,217,102,115
050,29,221,"Missouri","Washington County",4,74,200,97,103
050,29,221,"Missouri","Washington County",4,75,212,104,108
050,29,221,"Missouri","Washington County",4,76,142,76,66
050,29,221,"Missouri","Washington County",4,77,146,80,66
050,29,221,"Missouri","Washington County",4,78,150,68,82
050,29,221,"Missouri","Washington County",4,79,135,58,77
050,29,221,"Missouri","Washington County",4,80,105,41,64
050,29,221,"Missouri","Washington County",4,81,115,53,62
050,29,221,"Missouri","Washington County",4,82,108,53,55
050,29,221,"Missouri","Washington County",4,83,83,40,43
050,29,221,"Missouri","Washington County",4,84,67,33,34
050,29,221,"Missouri","Washington County",4,85,316,151,165
050,29,221,"Missouri","Washington County",5,0,262,150,112
050,29,221,"Missouri","Washington County",5,1,277,156,121
050,29,221,"Missouri","Washington County",5,2,260,150,110
050,29,221,"Missouri","Washington County",5,3,267,122,145
050,29,221,"Missouri","Washington County",5,4,280,152,128
050,29,221,"Missouri","Washington County",5,5,288,149,139
050,29,221,"Missouri","Washington County",5,6,280,139,141
050,29,221,"Missouri","Washington County",5,7,299,154,145
050,29,221,"Missouri","Washington County",5,8,286,142,144
050,29,221,"Missouri","Washington County",5,9,288,146,142
050,29,221,"Missouri","Washington County",5,10,305,152,153
050,29,221,"Missouri","Washington County",5,11,292,139,153
050,29,221,"Missouri","Washington County",5,12,281,135,146
050,29,221,"Missouri","Washington County",5,13,308,161,147
050,29,221,"Missouri","Washington County",5,14,345,178,167
050,29,221,"Missouri","Washington County",5,15,344,162,182
050,29,221,"Missouri","Washington County",5,16,369,179,190
050,29,221,"Missouri","Washington County",5,17,320,157,163
050,29,221,"Missouri","Washington County",5,18,265,146,119
050,29,221,"Missouri","Washington County",5,19,209,107,102
050,29,221,"Missouri","Washington County",5,20,231,124,107
050,29,221,"Missouri","Washington County",5,21,242,137,105
050,29,221,"Missouri","Washington County",5,22,252,130,122
050,29,221,"Missouri","Washington County",5,23,265,156,109
050,29,221,"Missouri","Washington County",5,24,269,143,126
050,29,221,"Missouri","Washington County",5,25,283,156,127
050,29,221,"Missouri","Washington County",5,26,272,152,120
050,29,221,"Missouri","Washington County",5,27,228,123,105
050,29,221,"Missouri","Washington County",5,28,250,142,108
050,29,221,"Missouri","Washington County",5,29,255,138,117
050,29,221,"Missouri","Washington County",5,30,295,149,146
050,29,221,"Missouri","Washington County",5,31,321,158,163
050,29,221,"Missouri","Washington County",5,32,308,161,147
050,29,221,"Missouri","Washington County",5,33,299,164,135
050,29,221,"Missouri","Washington County",5,34,270,148,122
050,29,221,"Missouri","Washington County",5,35,309,159,150
050,29,221,"Missouri","Washington County",5,36,286,157,129
050,29,221,"Missouri","Washington County",5,37,327,183,144
050,29,221,"Missouri","Washington County",5,38,277,156,121
050,29,221,"Missouri","Washington County",5,39,293,158,135
050,29,221,"Missouri","Washington County",5,40,286,154,132
050,29,221,"Missouri","Washington County",5,41,300,157,143
050,29,221,"Missouri","Washington County",5,42,298,156,142
050,29,221,"Missouri","Washington County",5,43,293,148,145
050,29,221,"Missouri","Washington County",5,44,282,155,127
050,29,221,"Missouri","Washington County",5,45,285,150,135
050,29,221,"Missouri","Washington County",5,46,307,162,145
050,29,221,"Missouri","Washington County",5,47,303,167,136
050,29,221,"Missouri","Washington County",5,48,306,168,138
050,29,221,"Missouri","Washington County",5,49,293,161,132
050,29,221,"Missouri","Washington County",5,50,298,156,142
050,29,221,"Missouri","Washington County",5,51,322,170,152
050,29,221,"Missouri","Washington County",5,52,337,188,149
050,29,221,"Missouri","Washington County",5,53,336,191,145
050,29,221,"Missouri","Washington County",5,54,327,179,148
050,29,221,"Missouri","Washington County",5,55,308,163,145
050,29,221,"Missouri","Washington County",5,56,303,163,140
050,29,221,"Missouri","Washington County",5,57,318,178,140
050,29,221,"Missouri","Washington County",5,58,348,169,179
050,29,221,"Missouri","Washington County",5,59,377,191,186
050,29,221,"Missouri","Washington County",5,60,349,187,162
050,29,221,"Missouri","Washington County",5,61,341,172,169
050,29,221,"Missouri","Washington County",5,62,336,172,164
050,29,221,"Missouri","Washington County",5,63,298,147,151
050,29,221,"Missouri","Washington County",5,64,295,148,147
050,29,221,"Missouri","Washington County",5,65,321,156,165
050,29,221,"Missouri","Washington County",5,66,347,173,174
050,29,221,"Missouri","Washington County",5,67,325,164,161
050,29,221,"Missouri","Washington County",5,68,308,161,147
050,29,221,"Missouri","Washington County",5,69,279,141,138
050,29,221,"Missouri","Washington County",5,70,229,109,120
050,29,221,"Missouri","Washington County",5,71,229,106,123
050,29,221,"Missouri","Washington County",5,72,246,117,129
050,29,221,"Missouri","Washington County",5,73,225,110,115
050,29,221,"Missouri","Washington County",5,74,203,95,108
050,29,221,"Missouri","Washington County",5,75,187,88,99
050,29,221,"Missouri","Washington County",5,76,198,98,100
050,29,221,"Missouri","Washington County",5,77,132,72,60
050,29,221,"Missouri","Washington County",5,78,142,78,64
050,29,221,"Missouri","Washington County",5,79,135,57,78
050,29,221,"Missouri","Washington County",5,80,120,45,75
050,29,221,"Missouri","Washington County",5,81,100,40,60
050,29,221,"Missouri","Washington County",5,82,108,50,58
050,29,221,"Missouri","Washington County",5,83,96,44,52
050,29,221,"Missouri","Washington County",5,84,78,37,41
050,29,221,"Missouri","Washington County",5,85,323,161,162
050,29,223,"Missouri","Wayne County",1,0,104,53,51
050,29,223,"Missouri","Wayne County",1,1,100,50,50
050,29,223,"Missouri","Wayne County",1,2,107,53,54
050,29,223,"Missouri","Wayne County",1,3,105,47,58
050,29,223,"Missouri","Wayne County",1,4,105,52,53
050,29,223,"Missouri","Wayne County",1,5,122,56,66
050,29,223,"Missouri","Wayne County",1,6,131,69,62
050,29,223,"Missouri","Wayne County",1,7,137,71,66
050,29,223,"Missouri","Wayne County",1,8,113,57,56
050,29,223,"Missouri","Wayne County",1,9,144,77,67
050,29,223,"Missouri","Wayne County",1,10,140,66,74
050,29,223,"Missouri","Wayne County",1,11,126,56,70
050,29,223,"Missouri","Wayne County",1,12,122,63,59
050,29,223,"Missouri","Wayne County",1,13,121,66,55
050,29,223,"Missouri","Wayne County",1,14,140,72,68
050,29,223,"Missouri","Wayne County",1,15,141,76,65
050,29,223,"Missouri","Wayne County",1,16,132,65,67
050,29,223,"Missouri","Wayne County",1,17,124,68,56
050,29,223,"Missouri","Wayne County",1,18,110,60,50
050,29,223,"Missouri","Wayne County",1,19,81,38,43
050,29,223,"Missouri","Wayne County",1,20,86,45,41
050,29,223,"Missouri","Wayne County",1,21,90,50,40
050,29,223,"Missouri","Wayne County",1,22,92,46,46
050,29,223,"Missouri","Wayne County",1,23,100,51,49
050,29,223,"Missouri","Wayne County",1,24,93,50,43
050,29,223,"Missouri","Wayne County",1,25,89,49,40
050,29,223,"Missouri","Wayne County",1,26,100,55,45
050,29,223,"Missouri","Wayne County",1,27,95,51,44
050,29,223,"Missouri","Wayne County",1,28,111,53,58
050,29,223,"Missouri","Wayne County",1,29,105,48,57
050,29,223,"Missouri","Wayne County",1,30,118,57,61
050,29,223,"Missouri","Wayne County",1,31,103,49,54
050,29,223,"Missouri","Wayne County",1,32,104,55,49
050,29,223,"Missouri","Wayne County",1,33,115,58,57
050,29,223,"Missouri","Wayne County",1,34,134,57,77
050,29,223,"Missouri","Wayne County",1,35,113,49,64
050,29,223,"Missouri","Wayne County",1,36,112,58,54
050,29,223,"Missouri","Wayne County",1,37,124,63,61
050,29,223,"Missouri","Wayne County",1,38,117,62,55
050,29,223,"Missouri","Wayne County",1,39,119,69,50
050,29,223,"Missouri","Wayne County",1,40,108,67,41
050,29,223,"Missouri","Wayne County",1,41,116,65,51
050,29,223,"Missouri","Wayne County",1,42,115,60,55
050,29,223,"Missouri","Wayne County",1,43,116,57,59
050,29,223,"Missouri","Wayne County",1,44,106,55,51
050,29,223,"Missouri","Wayne County",1,45,112,59,53
050,29,223,"Missouri","Wayne County",1,46,107,51,56
050,29,223,"Missouri","Wayne County",1,47,131,66,65
050,29,223,"Missouri","Wayne County",1,48,134,63,71
050,29,223,"Missouri","Wayne County",1,49,132,68,64
050,29,223,"Missouri","Wayne County",1,50,144,71,73
050,29,223,"Missouri","Wayne County",1,51,142,64,78
050,29,223,"Missouri","Wayne County",1,52,133,61,72
050,29,223,"Missouri","Wayne County",1,53,161,90,71
050,29,223,"Missouri","Wayne County",1,54,180,92,88
050,29,223,"Missouri","Wayne County",1,55,191,89,102
050,29,223,"Missouri","Wayne County",1,56,182,91,91
050,29,223,"Missouri","Wayne County",1,57,194,93,101
050,29,223,"Missouri","Wayne County",1,58,203,112,91
050,29,223,"Missouri","Wayne County",1,59,197,99,98
050,29,223,"Missouri","Wayne County",1,60,177,80,97
050,29,223,"Missouri","Wayne County",1,61,189,91,98
050,29,223,"Missouri","Wayne County",1,62,176,82,94
050,29,223,"Missouri","Wayne County",1,63,164,80,84
050,29,223,"Missouri","Wayne County",1,64,177,100,77
050,29,223,"Missouri","Wayne County",1,65,177,90,87
050,29,223,"Missouri","Wayne County",1,66,164,78,86
050,29,223,"Missouri","Wayne County",1,67,176,81,95
050,29,223,"Missouri","Wayne County",1,68,163,80,83
050,29,223,"Missouri","Wayne County",1,69,133,64,69
050,29,223,"Missouri","Wayne County",1,70,128,59,69
050,29,223,"Missouri","Wayne County",1,71,145,68,77
050,29,223,"Missouri","Wayne County",1,72,141,69,72
050,29,223,"Missouri","Wayne County",1,73,138,60,78
050,29,223,"Missouri","Wayne County",1,74,116,55,61
050,29,223,"Missouri","Wayne County",1,75,116,55,61
050,29,223,"Missouri","Wayne County",1,76,127,60,67
050,29,223,"Missouri","Wayne County",1,77,119,56,63
050,29,223,"Missouri","Wayne County",1,78,105,58,47
050,29,223,"Missouri","Wayne County",1,79,103,51,52
050,29,223,"Missouri","Wayne County",1,80,82,38,44
050,29,223,"Missouri","Wayne County",1,81,67,38,29
050,29,223,"Missouri","Wayne County",1,82,61,30,31
050,29,223,"Missouri","Wayne County",1,83,63,27,36
050,29,223,"Missouri","Wayne County",1,84,58,26,32
050,29,223,"Missouri","Wayne County",1,85,280,122,158
050,29,223,"Missouri","Wayne County",2,0,105,52,53
050,29,223,"Missouri","Wayne County",2,1,99,50,49
050,29,223,"Missouri","Wayne County",2,2,106,53,53
050,29,223,"Missouri","Wayne County",2,3,103,48,55
050,29,223,"Missouri","Wayne County",2,4,104,51,53
050,29,223,"Missouri","Wayne County",2,5,117,55,62
050,29,223,"Missouri","Wayne County",2,6,128,66,62
050,29,223,"Missouri","Wayne County",2,7,136,71,65
050,29,223,"Missouri","Wayne County",2,8,122,62,60
050,29,223,"Missouri","Wayne County",2,9,136,71,65
050,29,223,"Missouri","Wayne County",2,10,139,67,72
050,29,223,"Missouri","Wayne County",2,11,128,59,69
050,29,223,"Missouri","Wayne County",2,12,122,62,60
050,29,223,"Missouri","Wayne County",2,13,120,64,56
050,29,223,"Missouri","Wayne County",2,14,136,72,64
050,29,223,"Missouri","Wayne County",2,15,143,76,67
050,29,223,"Missouri","Wayne County",2,16,136,68,68
050,29,223,"Missouri","Wayne County",2,17,127,69,58
050,29,223,"Missouri","Wayne County",2,18,105,58,47
050,29,223,"Missouri","Wayne County",2,19,81,40,41
050,29,223,"Missouri","Wayne County",2,20,87,45,42
050,29,223,"Missouri","Wayne County",2,21,89,48,41
050,29,223,"Missouri","Wayne County",2,22,94,48,46
050,29,223,"Missouri","Wayne County",2,23,100,51,49
050,29,223,"Missouri","Wayne County",2,24,95,50,45
050,29,223,"Missouri","Wayne County",2,25,93,51,42
050,29,223,"Missouri","Wayne County",2,26,98,53,45
050,29,223,"Missouri","Wayne County",2,27,96,52,44
050,29,223,"Missouri","Wayne County",2,28,107,53,54
050,29,223,"Missouri","Wayne County",2,29,105,49,56
050,29,223,"Missouri","Wayne County",2,30,114,54,60
050,29,223,"Missouri","Wayne County",2,31,107,52,55
050,29,223,"Missouri","Wayne County",2,32,105,53,52
050,29,223,"Missouri","Wayne County",2,33,113,57,56
050,29,223,"Missouri","Wayne County",2,34,128,56,72
050,29,223,"Missouri","Wayne County",2,35,119,51,68
050,29,223,"Missouri","Wayne County",2,36,111,55,56
050,29,223,"Missouri","Wayne County",2,37,120,62,58
050,29,223,"Missouri","Wayne County",2,38,119,63,56
050,29,223,"Missouri","Wayne County",2,39,120,69,51
050,29,223,"Missouri","Wayne County",2,40,112,68,44
050,29,223,"Missouri","Wayne County",2,41,112,63,49
050,29,223,"Missouri","Wayne County",2,42,114,60,54
050,29,223,"Missouri","Wayne County",2,43,117,58,59
050,29,223,"Missouri","Wayne County",2,44,106,54,52
050,29,223,"Missouri","Wayne County",2,45,113,59,54
050,29,223,"Missouri","Wayne County",2,46,109,53,56
050,29,223,"Missouri","Wayne County",2,47,123,61,62
050,29,223,"Missouri","Wayne County",2,48,132,63,69
050,29,223,"Missouri","Wayne County",2,49,135,68,67
050,29,223,"Missouri","Wayne County",2,50,143,71,72
050,29,223,"Missouri","Wayne County",2,51,143,66,77
050,29,223,"Missouri","Wayne County",2,52,134,62,72
050,29,223,"Missouri","Wayne County",2,53,153,83,70
050,29,223,"Missouri","Wayne County",2,54,176,92,84
050,29,223,"Missouri","Wayne County",2,55,186,88,98
050,29,223,"Missouri","Wayne County",2,56,183,91,92
050,29,223,"Missouri","Wayne County",2,57,187,93,94
050,29,223,"Missouri","Wayne County",2,58,202,109,93
050,29,223,"Missouri","Wayne County",2,59,196,99,97
050,29,223,"Missouri","Wayne County",2,60,180,82,98
050,29,223,"Missouri","Wayne County",2,61,186,89,97
050,29,223,"Missouri","Wayne County",2,62,177,82,95
050,29,223,"Missouri","Wayne County",2,63,170,82,88
050,29,223,"Missouri","Wayne County",2,64,172,95,77
050,29,223,"Missouri","Wayne County",2,65,177,93,84
050,29,223,"Missouri","Wayne County",2,66,166,79,87
050,29,223,"Missouri","Wayne County",2,67,172,80,92
050,29,223,"Missouri","Wayne County",2,68,162,79,83
050,29,223,"Missouri","Wayne County",2,69,142,69,73
050,29,223,"Missouri","Wayne County",2,70,130,61,69
050,29,223,"Missouri","Wayne County",2,71,139,65,74
050,29,223,"Missouri","Wayne County",2,72,139,67,72
050,29,223,"Missouri","Wayne County",2,73,147,66,81
050,29,223,"Missouri","Wayne County",2,74,114,54,60
050,29,223,"Missouri","Wayne County",2,75,115,54,61
050,29,223,"Missouri","Wayne County",2,76,122,57,65
050,29,223,"Missouri","Wayne County",2,77,123,57,66
050,29,223,"Missouri","Wayne County",2,78,103,54,49
050,29,223,"Missouri","Wayne County",2,79,99,51,48
050,29,223,"Missouri","Wayne County",2,80,87,40,47
050,29,223,"Missouri","Wayne County",2,81,69,39,30
050,29,223,"Missouri","Wayne County",2,82,60,31,29
050,29,223,"Missouri","Wayne County",2,83,63,27,36
050,29,223,"Missouri","Wayne County",2,84,54,24,30
050,29,223,"Missouri","Wayne County",2,85,279,121,158
050,29,223,"Missouri","Wayne County",3,0,109,60,49
050,29,223,"Missouri","Wayne County",3,1,99,50,49
050,29,223,"Missouri","Wayne County",3,2,92,48,44
050,29,223,"Missouri","Wayne County",3,3,116,57,59
050,29,223,"Missouri","Wayne County",3,4,104,49,55
050,29,223,"Missouri","Wayne County",3,5,106,55,51
050,29,223,"Missouri","Wayne County",3,6,116,56,60
050,29,223,"Missouri","Wayne County",3,7,124,62,62
050,29,223,"Missouri","Wayne County",3,8,136,68,68
050,29,223,"Missouri","Wayne County",3,9,125,61,64
050,29,223,"Missouri","Wayne County",3,10,126,63,63
050,29,223,"Missouri","Wayne County",3,11,136,68,68
050,29,223,"Missouri","Wayne County",3,12,144,69,75
050,29,223,"Missouri","Wayne County",3,13,122,64,58
050,29,223,"Missouri","Wayne County",3,14,120,64,56
050,29,223,"Missouri","Wayne County",3,15,140,74,66
050,29,223,"Missouri","Wayne County",3,16,131,74,57
050,29,223,"Missouri","Wayne County",3,17,138,65,73
050,29,223,"Missouri","Wayne County",3,18,108,60,48
050,29,223,"Missouri","Wayne County",3,19,82,44,38
050,29,223,"Missouri","Wayne County",3,20,96,47,49
050,29,223,"Missouri","Wayne County",3,21,98,47,51
050,29,223,"Missouri","Wayne County",3,22,104,56,48
050,29,223,"Missouri","Wayne County",3,23,96,55,41
050,29,223,"Missouri","Wayne County",3,24,110,54,56
050,29,223,"Missouri","Wayne County",3,25,100,57,43
050,29,223,"Missouri","Wayne County",3,26,99,51,48
050,29,223,"Missouri","Wayne County",3,27,98,50,48
050,29,223,"Missouri","Wayne County",3,28,94,52,42
050,29,223,"Missouri","Wayne County",3,29,103,51,52
050,29,223,"Missouri","Wayne County",3,30,108,49,59
050,29,223,"Missouri","Wayne County",3,31,111,47,64
050,29,223,"Missouri","Wayne County",3,32,115,60,55
050,29,223,"Missouri","Wayne County",3,33,113,58,55
050,29,223,"Missouri","Wayne County",3,34,111,56,55
050,29,223,"Missouri","Wayne County",3,35,120,52,68
050,29,223,"Missouri","Wayne County",3,36,116,53,63
050,29,223,"Missouri","Wayne County",3,37,116,58,58
050,29,223,"Missouri","Wayne County",3,38,125,63,62
050,29,223,"Missouri","Wayne County",3,39,119,62,57
050,29,223,"Missouri","Wayne County",3,40,120,68,52
050,29,223,"Missouri","Wayne County",3,41,122,73,49
050,29,223,"Missouri","Wayne County",3,42,115,65,50
050,29,223,"Missouri","Wayne County",3,43,113,60,53
050,29,223,"Missouri","Wayne County",3,44,117,57,60
050,29,223,"Missouri","Wayne County",3,45,110,57,53
050,29,223,"Missouri","Wayne County",3,46,109,60,49
050,29,223,"Missouri","Wayne County",3,47,118,53,65
050,29,223,"Missouri","Wayne County",3,48,119,59,60
050,29,223,"Missouri","Wayne County",3,49,133,67,66
050,29,223,"Missouri","Wayne County",3,50,128,60,68
050,29,223,"Missouri","Wayne County",3,51,145,72,73
050,29,223,"Missouri","Wayne County",3,52,140,66,74
050,29,223,"Missouri","Wayne County",3,53,133,63,70
050,29,223,"Missouri","Wayne County",3,54,157,85,72
050,29,223,"Missouri","Wayne County",3,55,173,92,81
050,29,223,"Missouri","Wayne County",3,56,194,97,97
050,29,223,"Missouri","Wayne County",3,57,179,87,92
050,29,223,"Missouri","Wayne County",3,58,190,93,97
050,29,223,"Missouri","Wayne County",3,59,208,107,101
050,29,223,"Missouri","Wayne County",3,60,197,98,99
050,29,223,"Missouri","Wayne County",3,61,183,86,97
050,29,223,"Missouri","Wayne County",3,62,179,87,92
050,29,223,"Missouri","Wayne County",3,63,182,80,102
050,29,223,"Missouri","Wayne County",3,64,172,83,89
050,29,223,"Missouri","Wayne County",3,65,179,100,79
050,29,223,"Missouri","Wayne County",3,66,178,94,84
050,29,223,"Missouri","Wayne County",3,67,168,79,89
050,29,223,"Missouri","Wayne County",3,68,170,80,90
050,29,223,"Missouri","Wayne County",3,69,158,79,79
050,29,223,"Missouri","Wayne County",3,70,137,66,71
050,29,223,"Missouri","Wayne County",3,71,128,64,64
050,29,223,"Missouri","Wayne County",3,72,130,60,70
050,29,223,"Missouri","Wayne County",3,73,132,61,71
050,29,223,"Missouri","Wayne County",3,74,141,68,73
050,29,223,"Missouri","Wayne County",3,75,104,49,55
050,29,223,"Missouri","Wayne County",3,76,108,52,56
050,29,223,"Missouri","Wayne County",3,77,118,53,65
050,29,223,"Missouri","Wayne County",3,78,111,54,57
050,29,223,"Missouri","Wayne County",3,79,85,43,42
050,29,223,"Missouri","Wayne County",3,80,87,38,49
050,29,223,"Missouri","Wayne County",3,81,73,34,39
050,29,223,"Missouri","Wayne County",3,82,65,38,27
050,29,223,"Missouri","Wayne County",3,83,62,27,35
050,29,223,"Missouri","Wayne County",3,84,47,20,27
050,29,223,"Missouri","Wayne County",3,85,279,122,157
050,29,223,"Missouri","Wayne County",4,0,117,69,48
050,29,223,"Missouri","Wayne County",4,1,108,65,43
050,29,223,"Missouri","Wayne County",4,2,98,48,50
050,29,223,"Missouri","Wayne County",4,3,89,52,37
050,29,223,"Missouri","Wayne County",4,4,115,56,59
050,29,223,"Missouri","Wayne County",4,5,110,57,53
050,29,223,"Missouri","Wayne County",4,6,113,56,57
050,29,223,"Missouri","Wayne County",4,7,121,60,61
050,29,223,"Missouri","Wayne County",4,8,123,65,58
050,29,223,"Missouri","Wayne County",4,9,135,66,69
050,29,223,"Missouri","Wayne County",4,10,129,64,65
050,29,223,"Missouri","Wayne County",4,11,132,71,61
050,29,223,"Missouri","Wayne County",4,12,142,72,70
050,29,223,"Missouri","Wayne County",4,13,147,73,74
050,29,223,"Missouri","Wayne County",4,14,125,62,63
050,29,223,"Missouri","Wayne County",4,15,115,59,56
050,29,223,"Missouri","Wayne County",4,16,146,80,66
050,29,223,"Missouri","Wayne County",4,17,141,77,64
050,29,223,"Missouri","Wayne County",4,18,120,64,56
050,29,223,"Missouri","Wayne County",4,19,84,48,36
050,29,223,"Missouri","Wayne County",4,20,82,42,40
050,29,223,"Missouri","Wayne County",4,21,94,48,46
050,29,223,"Missouri","Wayne County",4,22,97,48,49
050,29,223,"Missouri","Wayne County",4,23,99,53,46
050,29,223,"Missouri","Wayne County",4,24,97,50,47
050,29,223,"Missouri","Wayne County",4,25,101,54,47
050,29,223,"Missouri","Wayne County",4,26,97,56,41
050,29,223,"Missouri","Wayne County",4,27,99,52,47
050,29,223,"Missouri","Wayne County",4,28,94,49,45
050,29,223,"Missouri","Wayne County",4,29,92,49,43
050,29,223,"Missouri","Wayne County",4,30,100,47,53
050,29,223,"Missouri","Wayne County",4,31,100,47,53
050,29,223,"Missouri","Wayne County",4,32,115,49,66
050,29,223,"Missouri","Wayne County",4,33,120,61,59
050,29,223,"Missouri","Wayne County",4,34,107,54,53
050,29,223,"Missouri","Wayne County",4,35,107,50,57
050,29,223,"Missouri","Wayne County",4,36,121,50,71
050,29,223,"Missouri","Wayne County",4,37,116,52,64
050,29,223,"Missouri","Wayne County",4,38,124,63,61
050,29,223,"Missouri","Wayne County",4,39,131,67,64
050,29,223,"Missouri","Wayne County",4,40,121,64,57
050,29,223,"Missouri","Wayne County",4,41,128,72,56
050,29,223,"Missouri","Wayne County",4,42,116,67,49
050,29,223,"Missouri","Wayne County",4,43,113,64,49
050,29,223,"Missouri","Wayne County",4,44,115,61,54
050,29,223,"Missouri","Wayne County",4,45,118,55,63
050,29,223,"Missouri","Wayne County",4,46,105,56,49
050,29,223,"Missouri","Wayne County",4,47,111,64,47
050,29,223,"Missouri","Wayne County",4,48,116,56,60
050,29,223,"Missouri","Wayne County",4,49,123,62,61
050,29,223,"Missouri","Wayne County",4,50,125,64,61
050,29,223,"Missouri","Wayne County",4,51,126,60,66
050,29,223,"Missouri","Wayne County",4,52,135,64,71
050,29,223,"Missouri","Wayne County",4,53,142,68,74
050,29,223,"Missouri","Wayne County",4,54,142,66,76
050,29,223,"Missouri","Wayne County",4,55,142,71,71
050,29,223,"Missouri","Wayne County",4,56,173,94,79
050,29,223,"Missouri","Wayne County",4,57,191,96,95
050,29,223,"Missouri","Wayne County",4,58,176,85,91
050,29,223,"Missouri","Wayne County",4,59,183,88,95
050,29,223,"Missouri","Wayne County",4,60,216,113,103
050,29,223,"Missouri","Wayne County",4,61,182,91,91
050,29,223,"Missouri","Wayne County",4,62,179,83,96
050,29,223,"Missouri","Wayne County",4,63,177,87,90
050,29,223,"Missouri","Wayne County",4,64,186,79,107
050,29,223,"Missouri","Wayne County",4,65,171,86,85
050,29,223,"Missouri","Wayne County",4,66,176,98,78
050,29,223,"Missouri","Wayne County",4,67,178,93,85
050,29,223,"Missouri","Wayne County",4,68,159,75,84
050,29,223,"Missouri","Wayne County",4,69,172,83,89
050,29,223,"Missouri","Wayne County",4,70,158,82,76
050,29,223,"Missouri","Wayne County",4,71,134,66,68
050,29,223,"Missouri","Wayne County",4,72,123,61,62
050,29,223,"Missouri","Wayne County",4,73,122,57,65
050,29,223,"Missouri","Wayne County",4,74,126,63,63
050,29,223,"Missouri","Wayne County",4,75,127,61,66
050,29,223,"Missouri","Wayne County",4,76,97,45,52
050,29,223,"Missouri","Wayne County",4,77,108,50,58
050,29,223,"Missouri","Wayne County",4,78,107,49,58
050,29,223,"Missouri","Wayne County",4,79,97,44,53
050,29,223,"Missouri","Wayne County",4,80,81,39,42
050,29,223,"Missouri","Wayne County",4,81,73,32,41
050,29,223,"Missouri","Wayne County",4,82,65,27,38
050,29,223,"Missouri","Wayne County",4,83,69,33,36
050,29,223,"Missouri","Wayne County",4,84,49,23,26
050,29,223,"Missouri","Wayne County",4,85,281,125,156
050,29,223,"Missouri","Wayne County",5,0,116,68,48
050,29,223,"Missouri","Wayne County",5,1,115,63,52
050,29,223,"Missouri","Wayne County",5,2,105,65,40
050,29,223,"Missouri","Wayne County",5,3,98,51,47
050,29,223,"Missouri","Wayne County",5,4,86,47,39
050,29,223,"Missouri","Wayne County",5,5,117,61,56
050,29,223,"Missouri","Wayne County",5,6,108,57,51
050,29,223,"Missouri","Wayne County",5,7,116,60,56
050,29,223,"Missouri","Wayne County",5,8,116,56,60
050,29,223,"Missouri","Wayne County",5,9,122,68,54
050,29,223,"Missouri","Wayne County",5,10,130,63,67
050,29,223,"Missouri","Wayne County",5,11,124,67,57
050,29,223,"Missouri","Wayne County",5,12,130,70,60
050,29,223,"Missouri","Wayne County",5,13,147,71,76
050,29,223,"Missouri","Wayne County",5,14,144,73,71
050,29,223,"Missouri","Wayne County",5,15,126,66,60
050,29,223,"Missouri","Wayne County",5,16,122,66,56
050,29,223,"Missouri","Wayne County",5,17,161,90,71
050,29,223,"Missouri","Wayne County",5,18,112,65,47
050,29,223,"Missouri","Wayne County",5,19,93,49,44
050,29,223,"Missouri","Wayne County",5,20,98,59,39
050,29,223,"Missouri","Wayne County",5,21,84,44,40
050,29,223,"Missouri","Wayne County",5,22,100,51,49
050,29,223,"Missouri","Wayne County",5,23,105,50,55
050,29,223,"Missouri","Wayne County",5,24,97,50,47
050,29,223,"Missouri","Wayne County",5,25,106,54,52
050,29,223,"Missouri","Wayne County",5,26,92,48,44
050,29,223,"Missouri","Wayne County",5,27,107,57,50
050,29,223,"Missouri","Wayne County",5,28,103,59,44
050,29,223,"Missouri","Wayne County",5,29,97,50,47
050,29,223,"Missouri","Wayne County",5,30,92,48,44
050,29,223,"Missouri","Wayne County",5,31,102,48,54
050,29,223,"Missouri","Wayne County",5,32,99,51,48
050,29,223,"Missouri","Wayne County",5,33,117,49,68
050,29,223,"Missouri","Wayne County",5,34,123,63,60
050,29,223,"Missouri","Wayne County",5,35,111,57,54
050,29,223,"Missouri","Wayne County",5,36,104,49,55
050,29,223,"Missouri","Wayne County",5,37,113,49,64
050,29,223,"Missouri","Wayne County",5,38,115,52,63
050,29,223,"Missouri","Wayne County",5,39,118,61,57
050,29,223,"Missouri","Wayne County",5,40,128,65,63
050,29,223,"Missouri","Wayne County",5,41,126,67,59
050,29,223,"Missouri","Wayne County",5,42,121,70,51
050,29,223,"Missouri","Wayne County",5,43,120,71,49
050,29,223,"Missouri","Wayne County",5,44,117,65,52
050,29,223,"Missouri","Wayne County",5,45,128,68,60
050,29,223,"Missouri","Wayne County",5,46,114,53,61
050,29,223,"Missouri","Wayne County",5,47,111,59,52
050,29,223,"Missouri","Wayne County",5,48,115,67,48
050,29,223,"Missouri","Wayne County",5,49,108,52,56
050,29,223,"Missouri","Wayne County",5,50,128,63,65
050,29,223,"Missouri","Wayne County",5,51,133,65,68
050,29,223,"Missouri","Wayne County",5,52,133,67,66
050,29,223,"Missouri","Wayne County",5,53,138,70,68
050,29,223,"Missouri","Wayne County",5,54,142,70,72
050,29,223,"Missouri","Wayne County",5,55,139,63,76
050,29,223,"Missouri","Wayne County",5,56,144,73,71
050,29,223,"Missouri","Wayne County",5,57,174,90,84
050,29,223,"Missouri","Wayne County",5,58,196,96,100
050,29,223,"Missouri","Wayne County",5,59,180,88,92
050,29,223,"Missouri","Wayne County",5,60,182,90,92
050,29,223,"Missouri","Wayne County",5,61,211,111,100
050,29,223,"Missouri","Wayne County",5,62,180,89,91
050,29,223,"Missouri","Wayne County",5,63,194,92,102
050,29,223,"Missouri","Wayne County",5,64,179,88,91
050,29,223,"Missouri","Wayne County",5,65,181,76,105
050,29,223,"Missouri","Wayne County",5,66,170,83,87
050,29,223,"Missouri","Wayne County",5,67,174,96,78
050,29,223,"Missouri","Wayne County",5,68,175,92,83
050,29,223,"Missouri","Wayne County",5,69,162,76,86
050,29,223,"Missouri","Wayne County",5,70,165,77,88
050,29,223,"Missouri","Wayne County",5,71,155,83,72
050,29,223,"Missouri","Wayne County",5,72,128,63,65
050,29,223,"Missouri","Wayne County",5,73,118,56,62
050,29,223,"Missouri","Wayne County",5,74,118,60,58
050,29,223,"Missouri","Wayne County",5,75,120,60,60
050,29,223,"Missouri","Wayne County",5,76,118,58,60
050,29,223,"Missouri","Wayne County",5,77,90,41,49
050,29,223,"Missouri","Wayne County",5,78,100,50,50
050,29,223,"Missouri","Wayne County",5,79,97,41,56
050,29,223,"Missouri","Wayne County",5,80,94,41,53
050,29,223,"Missouri","Wayne County",5,81,65,31,34
050,29,223,"Missouri","Wayne County",5,82,63,24,39
050,29,223,"Missouri","Wayne County",5,83,67,21,46
050,29,223,"Missouri","Wayne County",5,84,55,29,26
050,29,223,"Missouri","Wayne County",5,85,284,128,156
050,29,225,"Missouri","Webster County",1,0,598,306,292
050,29,225,"Missouri","Webster County",1,1,583,304,279
050,29,225,"Missouri","Webster County",1,2,587,303,284
050,29,225,"Missouri","Webster County",1,3,575,288,287
050,29,225,"Missouri","Webster County",1,4,583,297,286
050,29,225,"Missouri","Webster County",1,5,594,283,311
050,29,225,"Missouri","Webster County",1,6,588,293,295
050,29,225,"Missouri","Webster County",1,7,561,298,263
050,29,225,"Missouri","Webster County",1,8,590,300,290
050,29,225,"Missouri","Webster County",1,9,563,303,260
050,29,225,"Missouri","Webster County",1,10,588,330,258
050,29,225,"Missouri","Webster County",1,11,634,337,297
050,29,225,"Missouri","Webster County",1,12,648,325,323
050,29,225,"Missouri","Webster County",1,13,615,314,301
050,29,225,"Missouri","Webster County",1,14,616,321,295
050,29,225,"Missouri","Webster County",1,15,602,328,274
050,29,225,"Missouri","Webster County",1,16,609,314,295
050,29,225,"Missouri","Webster County",1,17,585,298,287
050,29,225,"Missouri","Webster County",1,18,477,257,220
050,29,225,"Missouri","Webster County",1,19,389,212,177
050,29,225,"Missouri","Webster County",1,20,419,230,189
050,29,225,"Missouri","Webster County",1,21,401,217,184
050,29,225,"Missouri","Webster County",1,22,446,241,205
050,29,225,"Missouri","Webster County",1,23,445,237,208
050,29,225,"Missouri","Webster County",1,24,432,219,213
050,29,225,"Missouri","Webster County",1,25,430,205,225
050,29,225,"Missouri","Webster County",1,26,459,252,207
050,29,225,"Missouri","Webster County",1,27,489,273,216
050,29,225,"Missouri","Webster County",1,28,485,254,231
050,29,225,"Missouri","Webster County",1,29,484,263,221
050,29,225,"Missouri","Webster County",1,30,501,269,232
050,29,225,"Missouri","Webster County",1,31,466,240,226
050,29,225,"Missouri","Webster County",1,32,458,244,214
050,29,225,"Missouri","Webster County",1,33,480,255,225
050,29,225,"Missouri","Webster County",1,34,460,241,219
050,29,225,"Missouri","Webster County",1,35,478,251,227
050,29,225,"Missouri","Webster County",1,36,500,247,253
050,29,225,"Missouri","Webster County",1,37,484,245,239
050,29,225,"Missouri","Webster County",1,38,510,258,252
050,29,225,"Missouri","Webster County",1,39,495,258,237
050,29,225,"Missouri","Webster County",1,40,492,269,223
050,29,225,"Missouri","Webster County",1,41,451,233,218
050,29,225,"Missouri","Webster County",1,42,421,234,187
050,29,225,"Missouri","Webster County",1,43,478,249,229
050,29,225,"Missouri","Webster County",1,44,485,240,245
050,29,225,"Missouri","Webster County",1,45,444,235,209
050,29,225,"Missouri","Webster County",1,46,444,243,201
050,29,225,"Missouri","Webster County",1,47,443,229,214
050,29,225,"Missouri","Webster County",1,48,483,260,223
050,29,225,"Missouri","Webster County",1,49,542,262,280
050,29,225,"Missouri","Webster County",1,50,512,244,268
050,29,225,"Missouri","Webster County",1,51,495,246,249
050,29,225,"Missouri","Webster County",1,52,474,252,222
050,29,225,"Missouri","Webster County",1,53,502,275,227
050,29,225,"Missouri","Webster County",1,54,498,267,231
050,29,225,"Missouri","Webster County",1,55,500,256,244
050,29,225,"Missouri","Webster County",1,56,542,286,256
050,29,225,"Missouri","Webster County",1,57,535,261,274
050,29,225,"Missouri","Webster County",1,58,496,245,251
050,29,225,"Missouri","Webster County",1,59,515,262,253
050,29,225,"Missouri","Webster County",1,60,488,246,242
050,29,225,"Missouri","Webster County",1,61,496,243,253
050,29,225,"Missouri","Webster County",1,62,507,260,247
050,29,225,"Missouri","Webster County",1,63,511,263,248
050,29,225,"Missouri","Webster County",1,64,460,236,224
050,29,225,"Missouri","Webster County",1,65,428,213,215
050,29,225,"Missouri","Webster County",1,66,411,199,212
050,29,225,"Missouri","Webster County",1,67,391,192,199
050,29,225,"Missouri","Webster County",1,68,356,179,177
050,29,225,"Missouri","Webster County",1,69,340,164,176
050,29,225,"Missouri","Webster County",1,70,340,171,169
050,29,225,"Missouri","Webster County",1,71,335,156,179
050,29,225,"Missouri","Webster County",1,72,322,156,166
050,29,225,"Missouri","Webster County",1,73,348,173,175
050,29,225,"Missouri","Webster County",1,74,258,133,125
050,29,225,"Missouri","Webster County",1,75,255,136,119
050,29,225,"Missouri","Webster County",1,76,262,132,130
050,29,225,"Missouri","Webster County",1,77,244,109,135
050,29,225,"Missouri","Webster County",1,78,204,92,112
050,29,225,"Missouri","Webster County",1,79,188,92,96
050,29,225,"Missouri","Webster County",1,80,169,81,88
050,29,225,"Missouri","Webster County",1,81,150,66,84
050,29,225,"Missouri","Webster County",1,82,136,64,72
050,29,225,"Missouri","Webster County",1,83,138,59,79
050,29,225,"Missouri","Webster County",1,84,118,55,63
050,29,225,"Missouri","Webster County",1,85,575,213,362
050,29,225,"Missouri","Webster County",2,0,596,315,281
050,29,225,"Missouri","Webster County",2,1,584,302,282
050,29,225,"Missouri","Webster County",2,2,586,303,283
050,29,225,"Missouri","Webster County",2,3,576,292,284
050,29,225,"Missouri","Webster County",2,4,585,295,290
050,29,225,"Missouri","Webster County",2,5,597,287,310
050,29,225,"Missouri","Webster County",2,6,593,294,299
050,29,225,"Missouri","Webster County",2,7,572,299,273
050,29,225,"Missouri","Webster County",2,8,586,301,285
050,29,225,"Missouri","Webster County",2,9,571,302,269
050,29,225,"Missouri","Webster County",2,10,587,325,262
050,29,225,"Missouri","Webster County",2,11,623,337,286
050,29,225,"Missouri","Webster County",2,12,644,330,314
050,29,225,"Missouri","Webster County",2,13,622,315,307
050,29,225,"Missouri","Webster County",2,14,615,319,296
050,29,225,"Missouri","Webster County",2,15,607,325,282
050,29,225,"Missouri","Webster County",2,16,604,315,289
050,29,225,"Missouri","Webster County",2,17,590,301,289
050,29,225,"Missouri","Webster County",2,18,474,255,219
050,29,225,"Missouri","Webster County",2,19,385,208,177
050,29,225,"Missouri","Webster County",2,20,423,229,194
050,29,225,"Missouri","Webster County",2,21,412,223,189
050,29,225,"Missouri","Webster County",2,22,440,237,203
050,29,225,"Missouri","Webster County",2,23,443,236,207
050,29,225,"Missouri","Webster County",2,24,429,219,210
050,29,225,"Missouri","Webster County",2,25,430,207,223
050,29,225,"Missouri","Webster County",2,26,451,238,213
050,29,225,"Missouri","Webster County",2,27,479,263,216
050,29,225,"Missouri","Webster County",2,28,481,253,228
050,29,225,"Missouri","Webster County",2,29,481,259,222
050,29,225,"Missouri","Webster County",2,30,493,260,233
050,29,225,"Missouri","Webster County",2,31,468,239,229
050,29,225,"Missouri","Webster County",2,32,457,239,218
050,29,225,"Missouri","Webster County",2,33,465,244,221
050,29,225,"Missouri","Webster County",2,34,460,239,221
050,29,225,"Missouri","Webster County",2,35,475,245,230
050,29,225,"Missouri","Webster County",2,36,483,238,245
050,29,225,"Missouri","Webster County",2,37,482,237,245
050,29,225,"Missouri","Webster County",2,38,499,250,249
050,29,225,"Missouri","Webster County",2,39,494,253,241
050,29,225,"Missouri","Webster County",2,40,493,264,229
050,29,225,"Missouri","Webster County",2,41,455,237,218
050,29,225,"Missouri","Webster County",2,42,421,227,194
050,29,225,"Missouri","Webster County",2,43,464,243,221
050,29,225,"Missouri","Webster County",2,44,473,234,239
050,29,225,"Missouri","Webster County",2,45,452,231,221
050,29,225,"Missouri","Webster County",2,46,438,234,204
050,29,225,"Missouri","Webster County",2,47,434,225,209
050,29,225,"Missouri","Webster County",2,48,467,246,221
050,29,225,"Missouri","Webster County",2,49,521,253,268
050,29,225,"Missouri","Webster County",2,50,513,243,270
050,29,225,"Missouri","Webster County",2,51,496,243,253
050,29,225,"Missouri","Webster County",2,52,474,248,226
050,29,225,"Missouri","Webster County",2,53,495,267,228
050,29,225,"Missouri","Webster County",2,54,496,266,230
050,29,225,"Missouri","Webster County",2,55,500,258,242
050,29,225,"Missouri","Webster County",2,56,534,279,255
050,29,225,"Missouri","Webster County",2,57,535,265,270
050,29,225,"Missouri","Webster County",2,58,503,247,256
050,29,225,"Missouri","Webster County",2,59,511,257,254
050,29,225,"Missouri","Webster County",2,60,496,249,247
050,29,225,"Missouri","Webster County",2,61,491,242,249
050,29,225,"Missouri","Webster County",2,62,507,259,248
050,29,225,"Missouri","Webster County",2,63,517,266,251
050,29,225,"Missouri","Webster County",2,64,469,240,229
050,29,225,"Missouri","Webster County",2,65,435,219,216
050,29,225,"Missouri","Webster County",2,66,413,201,212
050,29,225,"Missouri","Webster County",2,67,392,191,201
050,29,225,"Missouri","Webster County",2,68,362,181,181
050,29,225,"Missouri","Webster County",2,69,346,169,177
050,29,225,"Missouri","Webster County",2,70,338,168,170
050,29,225,"Missouri","Webster County",2,71,335,157,178
050,29,225,"Missouri","Webster County",2,72,319,152,167
050,29,225,"Missouri","Webster County",2,73,355,174,181
050,29,225,"Missouri","Webster County",2,74,261,134,127
050,29,225,"Missouri","Webster County",2,75,252,133,119
050,29,225,"Missouri","Webster County",2,76,257,132,125
050,29,225,"Missouri","Webster County",2,77,250,115,135
050,29,225,"Missouri","Webster County",2,78,208,92,116
050,29,225,"Missouri","Webster County",2,79,188,89,99
050,29,225,"Missouri","Webster County",2,80,175,84,91
050,29,225,"Missouri","Webster County",2,81,151,66,85
050,29,225,"Missouri","Webster County",2,82,138,64,74
050,29,225,"Missouri","Webster County",2,83,136,60,76
050,29,225,"Missouri","Webster County",2,84,119,54,65
050,29,225,"Missouri","Webster County",2,85,586,217,369
050,29,225,"Missouri","Webster County",3,0,556,296,260
050,29,225,"Missouri","Webster County",3,1,564,288,276
050,29,225,"Missouri","Webster County",3,2,603,318,285
050,29,225,"Missouri","Webster County",3,3,594,314,280
050,29,225,"Missouri","Webster County",3,4,578,289,289
050,29,225,"Missouri","Webster County",3,5,608,311,297
050,29,225,"Missouri","Webster County",3,6,627,305,322
050,29,225,"Missouri","Webster County",3,7,614,299,315
050,29,225,"Missouri","Webster County",3,8,585,301,284
050,29,225,"Missouri","Webster County",3,9,580,299,281
050,29,225,"Missouri","Webster County",3,10,589,309,280
050,29,225,"Missouri","Webster County",3,11,610,330,280
050,29,225,"Missouri","Webster County",3,12,635,350,285
050,29,225,"Missouri","Webster County",3,13,665,335,330
050,29,225,"Missouri","Webster County",3,14,649,327,322
050,29,225,"Missouri","Webster County",3,15,625,322,303
050,29,225,"Missouri","Webster County",3,16,621,331,290
050,29,225,"Missouri","Webster County",3,17,609,319,290
050,29,225,"Missouri","Webster County",3,18,496,268,228
050,29,225,"Missouri","Webster County",3,19,372,197,175
050,29,225,"Missouri","Webster County",3,20,410,221,189
050,29,225,"Missouri","Webster County",3,21,442,244,198
050,29,225,"Missouri","Webster County",3,22,425,232,193
050,29,225,"Missouri","Webster County",3,23,461,251,210
050,29,225,"Missouri","Webster County",3,24,457,240,217
050,29,225,"Missouri","Webster County",3,25,466,229,237
050,29,225,"Missouri","Webster County",3,26,446,218,228
050,29,225,"Missouri","Webster County",3,27,473,266,207
050,29,225,"Missouri","Webster County",3,28,465,246,219
050,29,225,"Missouri","Webster County",3,29,523,281,242
050,29,225,"Missouri","Webster County",3,30,488,257,231
050,29,225,"Missouri","Webster County",3,31,505,272,233
050,29,225,"Missouri","Webster County",3,32,508,255,253
050,29,225,"Missouri","Webster County",3,33,466,240,226
050,29,225,"Missouri","Webster County",3,34,471,243,228
050,29,225,"Missouri","Webster County",3,35,476,244,232
050,29,225,"Missouri","Webster County",3,36,486,249,237
050,29,225,"Missouri","Webster County",3,37,483,248,235
050,29,225,"Missouri","Webster County",3,38,484,241,243
050,29,225,"Missouri","Webster County",3,39,510,266,244
050,29,225,"Missouri","Webster County",3,40,489,253,236
050,29,225,"Missouri","Webster County",3,41,488,265,223
050,29,225,"Missouri","Webster County",3,42,469,241,228
050,29,225,"Missouri","Webster County",3,43,441,244,197
050,29,225,"Missouri","Webster County",3,44,468,240,228
050,29,225,"Missouri","Webster County",3,45,472,229,243
050,29,225,"Missouri","Webster County",3,46,447,234,213
050,29,225,"Missouri","Webster County",3,47,440,241,199
050,29,225,"Missouri","Webster County",3,48,440,231,209
050,29,225,"Missouri","Webster County",3,49,470,249,221
050,29,225,"Missouri","Webster County",3,50,500,239,261
050,29,225,"Missouri","Webster County",3,51,507,242,265
050,29,225,"Missouri","Webster County",3,52,502,247,255
050,29,225,"Missouri","Webster County",3,53,480,249,231
050,29,225,"Missouri","Webster County",3,54,490,269,221
050,29,225,"Missouri","Webster County",3,55,503,262,241
050,29,225,"Missouri","Webster County",3,56,489,257,232
050,29,225,"Missouri","Webster County",3,57,541,278,263
050,29,225,"Missouri","Webster County",3,58,537,266,271
050,29,225,"Missouri","Webster County",3,59,500,242,258
050,29,225,"Missouri","Webster County",3,60,519,263,256
050,29,225,"Missouri","Webster County",3,61,497,255,242
050,29,225,"Missouri","Webster County",3,62,486,234,252
050,29,225,"Missouri","Webster County",3,63,505,256,249
050,29,225,"Missouri","Webster County",3,64,525,269,256
050,29,225,"Missouri","Webster County",3,65,456,224,232
050,29,225,"Missouri","Webster County",3,66,429,213,216
050,29,225,"Missouri","Webster County",3,67,418,204,214
050,29,225,"Missouri","Webster County",3,68,385,194,191
050,29,225,"Missouri","Webster County",3,69,352,176,176
050,29,225,"Missouri","Webster County",3,70,338,160,178
050,29,225,"Missouri","Webster County",3,71,325,161,164
050,29,225,"Missouri","Webster County",3,72,328,151,177
050,29,225,"Missouri","Webster County",3,73,299,142,157
050,29,225,"Missouri","Webster County",3,74,340,167,173
050,29,225,"Missouri","Webster County",3,75,249,130,119
050,29,225,"Missouri","Webster County",3,76,240,126,114
050,29,225,"Missouri","Webster County",3,77,251,129,122
050,29,225,"Missouri","Webster County",3,78,244,110,134
050,29,225,"Missouri","Webster County",3,79,194,85,109
050,29,225,"Missouri","Webster County",3,80,183,84,99
050,29,225,"Missouri","Webster County",3,81,159,71,88
050,29,225,"Missouri","Webster County",3,82,144,66,78
050,29,225,"Missouri","Webster County",3,83,125,58,67
050,29,225,"Missouri","Webster County",3,84,117,53,64
050,29,225,"Missouri","Webster County",3,85,595,225,370
050,29,225,"Missouri","Webster County",4,0,610,320,290
050,29,225,"Missouri","Webster County",4,1,584,294,290
050,29,225,"Missouri","Webster County",4,2,579,297,282
050,29,225,"Missouri","Webster County",4,3,621,312,309
050,29,225,"Missouri","Webster County",4,4,624,330,294
050,29,225,"Missouri","Webster County",4,5,597,289,308
050,29,225,"Missouri","Webster County",4,6,630,316,314
050,29,225,"Missouri","Webster County",4,7,655,315,340
050,29,225,"Missouri","Webster County",4,8,626,300,326
050,29,225,"Missouri","Webster County",4,9,610,317,293
050,29,225,"Missouri","Webster County",4,10,613,310,303
050,29,225,"Missouri","Webster County",4,11,601,309,292
050,29,225,"Missouri","Webster County",4,12,643,338,305
050,29,225,"Missouri","Webster County",4,13,643,353,290
050,29,225,"Missouri","Webster County",4,14,682,343,339
050,29,225,"Missouri","Webster County",4,15,658,340,318
050,29,225,"Missouri","Webster County",4,16,637,325,312
050,29,225,"Missouri","Webster County",4,17,636,341,295
050,29,225,"Missouri","Webster County",4,18,508,274,234
050,29,225,"Missouri","Webster County",4,19,377,195,182
050,29,225,"Missouri","Webster County",4,20,388,208,180
050,29,225,"Missouri","Webster County",4,21,448,232,216
050,29,225,"Missouri","Webster County",4,22,459,249,210
050,29,225,"Missouri","Webster County",4,23,460,248,212
050,29,225,"Missouri","Webster County",4,24,478,256,222
050,29,225,"Missouri","Webster County",4,25,500,259,241
050,29,225,"Missouri","Webster County",4,26,506,245,261
050,29,225,"Missouri","Webster County",4,27,450,214,236
050,29,225,"Missouri","Webster County",4,28,470,255,215
050,29,225,"Missouri","Webster County",4,29,481,253,228
050,29,225,"Missouri","Webster County",4,30,540,284,256
050,29,225,"Missouri","Webster County",4,31,494,263,231
050,29,225,"Missouri","Webster County",4,32,523,274,249
050,29,225,"Missouri","Webster County",4,33,520,262,258
050,29,225,"Missouri","Webster County",4,34,484,244,240
050,29,225,"Missouri","Webster County",4,35,498,248,250
050,29,225,"Missouri","Webster County",4,36,501,249,252
050,29,225,"Missouri","Webster County",4,37,490,252,238
050,29,225,"Missouri","Webster County",4,38,476,249,227
050,29,225,"Missouri","Webster County",4,39,496,244,252
050,29,225,"Missouri","Webster County",4,40,500,258,242
050,29,225,"Missouri","Webster County",4,41,500,257,243
050,29,225,"Missouri","Webster County",4,42,501,273,228
050,29,225,"Missouri","Webster County",4,43,462,234,228
050,29,225,"Missouri","Webster County",4,44,447,238,209
050,29,225,"Missouri","Webster County",4,45,463,231,232
050,29,225,"Missouri","Webster County",4,46,480,237,243
050,29,225,"Missouri","Webster County",4,47,449,230,219
050,29,225,"Missouri","Webster County",4,48,453,244,209
050,29,225,"Missouri","Webster County",4,49,445,231,214
050,29,225,"Missouri","Webster County",4,50,462,232,230
050,29,225,"Missouri","Webster County",4,51,491,230,261
050,29,225,"Missouri","Webster County",4,52,511,238,273
050,29,225,"Missouri","Webster County",4,53,502,241,261
050,29,225,"Missouri","Webster County",4,54,480,242,238
050,29,225,"Missouri","Webster County",4,55,504,275,229
050,29,225,"Missouri","Webster County",4,56,515,268,247
050,29,225,"Missouri","Webster County",4,57,481,244,237
050,29,225,"Missouri","Webster County",4,58,538,273,265
050,29,225,"Missouri","Webster County",4,59,534,266,268
050,29,225,"Missouri","Webster County",4,60,504,239,265
050,29,225,"Missouri","Webster County",4,61,498,257,241
050,29,225,"Missouri","Webster County",4,62,494,260,234
050,29,225,"Missouri","Webster County",4,63,511,246,265
050,29,225,"Missouri","Webster County",4,64,508,257,251
050,29,225,"Missouri","Webster County",4,65,524,272,252
050,29,225,"Missouri","Webster County",4,66,435,214,221
050,29,225,"Missouri","Webster County",4,67,434,222,212
050,29,225,"Missouri","Webster County",4,68,408,200,208
050,29,225,"Missouri","Webster County",4,69,382,188,194
050,29,225,"Missouri","Webster County",4,70,346,173,173
050,29,225,"Missouri","Webster County",4,71,331,159,172
050,29,225,"Missouri","Webster County",4,72,307,152,155
050,29,225,"Missouri","Webster County",4,73,319,147,172
050,29,225,"Missouri","Webster County",4,74,286,135,151
050,29,225,"Missouri","Webster County",4,75,331,158,173
050,29,225,"Missouri","Webster County",4,76,236,122,114
050,29,225,"Missouri","Webster County",4,77,228,118,110
050,29,225,"Missouri","Webster County",4,78,240,120,120
050,29,225,"Missouri","Webster County",4,79,220,98,122
050,29,225,"Missouri","Webster County",4,80,180,77,103
050,29,225,"Missouri","Webster County",4,81,164,74,90
050,29,225,"Missouri","Webster County",4,82,141,67,74
050,29,225,"Missouri","Webster County",4,83,138,61,77
050,29,225,"Missouri","Webster County",4,84,108,52,56
050,29,225,"Missouri","Webster County",4,85,579,228,351
050,29,225,"Missouri","Webster County",5,0,608,319,289
050,29,225,"Missouri","Webster County",5,1,629,326,303
050,29,225,"Missouri","Webster County",5,2,598,302,296
050,29,225,"Missouri","Webster County",5,3,609,306,303
050,29,225,"Missouri","Webster County",5,4,618,300,318
050,29,225,"Missouri","Webster County",5,5,619,325,294
050,29,225,"Missouri","Webster County",5,6,603,300,303
050,29,225,"Missouri","Webster County",5,7,676,342,334
050,29,225,"Missouri","Webster County",5,8,670,329,341
050,29,225,"Missouri","Webster County",5,9,643,304,339
050,29,225,"Missouri","Webster County",5,10,637,330,307
050,29,225,"Missouri","Webster County",5,11,625,323,302
050,29,225,"Missouri","Webster County",5,12,599,300,299
050,29,225,"Missouri","Webster County",5,13,656,328,328
050,29,225,"Missouri","Webster County",5,14,666,351,315
050,29,225,"Missouri","Webster County",5,15,705,355,350
050,29,225,"Missouri","Webster County",5,16,670,346,324
050,29,225,"Missouri","Webster County",5,17,658,334,324
050,29,225,"Missouri","Webster County",5,18,530,289,241
050,29,225,"Missouri","Webster County",5,19,393,213,180
050,29,225,"Missouri","Webster County",5,20,403,200,203
050,29,225,"Missouri","Webster County",5,21,432,233,199
050,29,225,"Missouri","Webster County",5,22,456,230,226
050,29,225,"Missouri","Webster County",5,23,516,282,234
050,29,225,"Missouri","Webster County",5,24,517,278,239
050,29,225,"Missouri","Webster County",5,25,485,266,219
050,29,225,"Missouri","Webster County",5,26,531,281,250
050,29,225,"Missouri","Webster County",5,27,542,272,270
050,29,225,"Missouri","Webster County",5,28,478,238,240
050,29,225,"Missouri","Webster County",5,29,501,276,225
050,29,225,"Missouri","Webster County",5,30,517,268,249
050,29,225,"Missouri","Webster County",5,31,545,289,256
050,29,225,"Missouri","Webster County",5,32,516,277,239
050,29,225,"Missouri","Webster County",5,33,558,301,257
050,29,225,"Missouri","Webster County",5,34,541,271,270
050,29,225,"Missouri","Webster County",5,35,513,264,249
050,29,225,"Missouri","Webster County",5,36,519,262,257
050,29,225,"Missouri","Webster County",5,37,500,255,245
050,29,225,"Missouri","Webster County",5,38,502,262,240
050,29,225,"Missouri","Webster County",5,39,494,258,236
050,29,225,"Missouri","Webster County",5,40,529,263,266
050,29,225,"Missouri","Webster County",5,41,513,261,252
050,29,225,"Missouri","Webster County",5,42,542,282,260
050,29,225,"Missouri","Webster County",5,43,512,289,223
050,29,225,"Missouri","Webster County",5,44,487,252,235
050,29,225,"Missouri","Webster County",5,45,457,249,208
050,29,225,"Missouri","Webster County",5,46,488,252,236
050,29,225,"Missouri","Webster County",5,47,485,244,241
050,29,225,"Missouri","Webster County",5,48,455,240,215
050,29,225,"Missouri","Webster County",5,49,469,255,214
050,29,225,"Missouri","Webster County",5,50,448,239,209
050,29,225,"Missouri","Webster County",5,51,475,242,233
050,29,225,"Missouri","Webster County",5,52,507,238,269
050,29,225,"Missouri","Webster County",5,53,529,247,282
050,29,225,"Missouri","Webster County",5,54,514,242,272
050,29,225,"Missouri","Webster County",5,55,500,254,246
050,29,225,"Missouri","Webster County",5,56,524,284,240
050,29,225,"Missouri","Webster County",5,57,513,265,248
050,29,225,"Missouri","Webster County",5,58,485,245,240
050,29,225,"Missouri","Webster County",5,59,532,268,264
050,29,225,"Missouri","Webster County",5,60,534,267,267
050,29,225,"Missouri","Webster County",5,61,505,239,266
050,29,225,"Missouri","Webster County",5,62,507,266,241
050,29,225,"Missouri","Webster County",5,63,499,257,242
050,29,225,"Missouri","Webster County",5,64,513,248,265
050,29,225,"Missouri","Webster County",5,65,493,249,244
050,29,225,"Missouri","Webster County",5,66,512,265,247
050,29,225,"Missouri","Webster County",5,67,442,222,220
050,29,225,"Missouri","Webster County",5,68,422,220,202
050,29,225,"Missouri","Webster County",5,69,401,194,207
050,29,225,"Missouri","Webster County",5,70,371,186,185
050,29,225,"Missouri","Webster County",5,71,339,168,171
050,29,225,"Missouri","Webster County",5,72,312,149,163
050,29,225,"Missouri","Webster County",5,73,291,145,146
050,29,225,"Missouri","Webster County",5,74,294,131,163
050,29,225,"Missouri","Webster County",5,75,267,125,142
050,29,225,"Missouri","Webster County",5,76,313,146,167
050,29,225,"Missouri","Webster County",5,77,223,113,110
050,29,225,"Missouri","Webster County",5,78,222,114,108
050,29,225,"Missouri","Webster County",5,79,214,107,107
050,29,225,"Missouri","Webster County",5,80,207,91,116
050,29,225,"Missouri","Webster County",5,81,172,71,101
050,29,225,"Missouri","Webster County",5,82,156,73,83
050,29,225,"Missouri","Webster County",5,83,133,64,69
050,29,225,"Missouri","Webster County",5,84,120,55,65
050,29,225,"Missouri","Webster County",5,85,568,228,340
050,29,227,"Missouri","Worth County",1,0,21,11,10
050,29,227,"Missouri","Worth County",1,1,22,11,11
050,29,227,"Missouri","Worth County",1,2,21,9,12
050,29,227,"Missouri","Worth County",1,3,21,12,9
050,29,227,"Missouri","Worth County",1,4,16,8,8
050,29,227,"Missouri","Worth County",1,5,18,6,12
050,29,227,"Missouri","Worth County",1,6,15,9,6
050,29,227,"Missouri","Worth County",1,7,20,9,11
050,29,227,"Missouri","Worth County",1,8,27,14,13
050,29,227,"Missouri","Worth County",1,9,22,9,13
050,29,227,"Missouri","Worth County",1,10,19,7,12
050,29,227,"Missouri","Worth County",1,11,22,8,14
050,29,227,"Missouri","Worth County",1,12,27,15,12
050,29,227,"Missouri","Worth County",1,13,20,10,10
050,29,227,"Missouri","Worth County",1,14,23,12,11
050,29,227,"Missouri","Worth County",1,15,21,12,9
050,29,227,"Missouri","Worth County",1,16,23,13,10
050,29,227,"Missouri","Worth County",1,17,28,13,15
050,29,227,"Missouri","Worth County",1,18,24,13,11
050,29,227,"Missouri","Worth County",1,19,17,9,8
050,29,227,"Missouri","Worth County",1,20,19,11,8
050,29,227,"Missouri","Worth County",1,21,20,10,10
050,29,227,"Missouri","Worth County",1,22,19,14,5
050,29,227,"Missouri","Worth County",1,23,17,10,7
050,29,227,"Missouri","Worth County",1,24,21,12,9
050,29,227,"Missouri","Worth County",1,25,18,9,9
050,29,227,"Missouri","Worth County",1,26,24,11,13
050,29,227,"Missouri","Worth County",1,27,22,7,15
050,29,227,"Missouri","Worth County",1,28,19,6,13
050,29,227,"Missouri","Worth County",1,29,15,4,11
050,29,227,"Missouri","Worth County",1,30,20,7,13
050,29,227,"Missouri","Worth County",1,31,23,13,10
050,29,227,"Missouri","Worth County",1,32,24,12,12
050,29,227,"Missouri","Worth County",1,33,17,5,12
050,29,227,"Missouri","Worth County",1,34,14,6,8
050,29,227,"Missouri","Worth County",1,35,21,12,9
050,29,227,"Missouri","Worth County",1,36,28,16,12
050,29,227,"Missouri","Worth County",1,37,18,12,6
050,29,227,"Missouri","Worth County",1,38,15,9,6
050,29,227,"Missouri","Worth County",1,39,21,7,14
050,29,227,"Missouri","Worth County",1,40,20,10,10
050,29,227,"Missouri","Worth County",1,41,25,18,7
050,29,227,"Missouri","Worth County",1,42,26,17,9
050,29,227,"Missouri","Worth County",1,43,18,11,7
050,29,227,"Missouri","Worth County",1,44,18,9,9
050,29,227,"Missouri","Worth County",1,45,15,9,6
050,29,227,"Missouri","Worth County",1,46,11,8,3
050,29,227,"Missouri","Worth County",1,47,12,8,4
050,29,227,"Missouri","Worth County",1,48,21,11,10
050,29,227,"Missouri","Worth County",1,49,21,9,12
050,29,227,"Missouri","Worth County",1,50,24,12,12
050,29,227,"Missouri","Worth County",1,51,24,10,14
050,29,227,"Missouri","Worth County",1,52,25,11,14
050,29,227,"Missouri","Worth County",1,53,28,16,12
050,29,227,"Missouri","Worth County",1,54,25,14,11
050,29,227,"Missouri","Worth County",1,55,34,18,16
050,29,227,"Missouri","Worth County",1,56,34,19,15
050,29,227,"Missouri","Worth County",1,57,31,18,13
050,29,227,"Missouri","Worth County",1,58,31,16,15
050,29,227,"Missouri","Worth County",1,59,32,19,13
050,29,227,"Missouri","Worth County",1,60,33,16,17
050,29,227,"Missouri","Worth County",1,61,35,15,20
050,29,227,"Missouri","Worth County",1,62,35,17,18
050,29,227,"Missouri","Worth County",1,63,41,20,21
050,29,227,"Missouri","Worth County",1,64,33,17,16
050,29,227,"Missouri","Worth County",1,65,38,19,19
050,29,227,"Missouri","Worth County",1,66,37,21,16
050,29,227,"Missouri","Worth County",1,67,37,20,17
050,29,227,"Missouri","Worth County",1,68,23,13,10
050,29,227,"Missouri","Worth County",1,69,16,8,8
050,29,227,"Missouri","Worth County",1,70,25,17,8
050,29,227,"Missouri","Worth County",1,71,20,9,11
050,29,227,"Missouri","Worth County",1,72,19,9,10
050,29,227,"Missouri","Worth County",1,73,24,12,12
050,29,227,"Missouri","Worth County",1,74,25,11,14
050,29,227,"Missouri","Worth County",1,75,18,9,9
050,29,227,"Missouri","Worth County",1,76,13,8,5
050,29,227,"Missouri","Worth County",1,77,25,11,14
050,29,227,"Missouri","Worth County",1,78,18,8,10
050,29,227,"Missouri","Worth County",1,79,11,2,9
050,29,227,"Missouri","Worth County",1,80,20,7,13
050,29,227,"Missouri","Worth County",1,81,18,6,12
050,29,227,"Missouri","Worth County",1,82,10,5,5
050,29,227,"Missouri","Worth County",1,83,10,5,5
050,29,227,"Missouri","Worth County",1,84,11,4,7
050,29,227,"Missouri","Worth County",1,85,76,22,54
050,29,227,"Missouri","Worth County",2,0,24,11,13
050,29,227,"Missouri","Worth County",2,1,22,11,11
050,29,227,"Missouri","Worth County",2,2,21,10,11
050,29,227,"Missouri","Worth County",2,3,21,12,9
050,29,227,"Missouri","Worth County",2,4,17,9,8
050,29,227,"Missouri","Worth County",2,5,17,6,11
050,29,227,"Missouri","Worth County",2,6,15,8,7
050,29,227,"Missouri","Worth County",2,7,18,9,9
050,29,227,"Missouri","Worth County",2,8,25,13,12
050,29,227,"Missouri","Worth County",2,9,23,10,13
050,29,227,"Missouri","Worth County",2,10,19,7,12
050,29,227,"Missouri","Worth County",2,11,21,8,13
050,29,227,"Missouri","Worth County",2,12,25,13,12
050,29,227,"Missouri","Worth County",2,13,22,11,11
050,29,227,"Missouri","Worth County",2,14,22,11,11
050,29,227,"Missouri","Worth County",2,15,21,12,9
050,29,227,"Missouri","Worth County",2,16,23,13,10
050,29,227,"Missouri","Worth County",2,17,27,13,14
050,29,227,"Missouri","Worth County",2,18,23,13,10
050,29,227,"Missouri","Worth County",2,19,17,9,8
050,29,227,"Missouri","Worth County",2,20,19,11,8
050,29,227,"Missouri","Worth County",2,21,21,11,10
050,29,227,"Missouri","Worth County",2,22,19,13,6
050,29,227,"Missouri","Worth County",2,23,18,11,7
050,29,227,"Missouri","Worth County",2,24,20,11,9
050,29,227,"Missouri","Worth County",2,25,19,10,9
050,29,227,"Missouri","Worth County",2,26,22,10,12
050,29,227,"Missouri","Worth County",2,27,23,8,15
050,29,227,"Missouri","Worth County",2,28,19,6,13
050,29,227,"Missouri","Worth County",2,29,15,4,11
050,29,227,"Missouri","Worth County",2,30,19,7,12
050,29,227,"Missouri","Worth County",2,31,23,12,11
050,29,227,"Missouri","Worth County",2,32,24,12,12
050,29,227,"Missouri","Worth County",2,33,19,7,12
050,29,227,"Missouri","Worth County",2,34,15,6,9
050,29,227,"Missouri","Worth County",2,35,20,11,9
050,29,227,"Missouri","Worth County",2,36,26,15,11
050,29,227,"Missouri","Worth County",2,37,21,14,7
050,29,227,"Missouri","Worth County",2,38,16,10,6
050,29,227,"Missouri","Worth County",2,39,20,8,12
050,29,227,"Missouri","Worth County",2,40,20,9,11
050,29,227,"Missouri","Worth County",2,41,24,16,8
050,29,227,"Missouri","Worth County",2,42,25,17,8
050,29,227,"Missouri","Worth County",2,43,21,13,8
050,29,227,"Missouri","Worth County",2,44,18,9,9
050,29,227,"Missouri","Worth County",2,45,15,9,6
050,29,227,"Missouri","Worth County",2,46,11,8,3
050,29,227,"Missouri","Worth County",2,47,12,8,4
050,29,227,"Missouri","Worth County",2,48,18,10,8
050,29,227,"Missouri","Worth County",2,49,21,9,12
050,29,227,"Missouri","Worth County",2,50,24,12,12
050,29,227,"Missouri","Worth County",2,51,23,10,13
050,29,227,"Missouri","Worth County",2,52,25,11,14
050,29,227,"Missouri","Worth County",2,53,26,14,12
050,29,227,"Missouri","Worth County",2,54,26,15,11
050,29,227,"Missouri","Worth County",2,55,32,17,15
050,29,227,"Missouri","Worth County",2,56,33,19,14
050,29,227,"Missouri","Worth County",2,57,32,18,14
050,29,227,"Missouri","Worth County",2,58,30,16,14
050,29,227,"Missouri","Worth County",2,59,33,19,14
050,29,227,"Missouri","Worth County",2,60,33,17,16
050,29,227,"Missouri","Worth County",2,61,34,15,19
050,29,227,"Missouri","Worth County",2,62,35,17,18
050,29,227,"Missouri","Worth County",2,63,38,18,20
050,29,227,"Missouri","Worth County",2,64,35,18,17
050,29,227,"Missouri","Worth County",2,65,37,19,18
050,29,227,"Missouri","Worth County",2,66,38,21,17
050,29,227,"Missouri","Worth County",2,67,37,20,17
050,29,227,"Missouri","Worth County",2,68,26,15,11
050,29,227,"Missouri","Worth County",2,69,17,9,8
050,29,227,"Missouri","Worth County",2,70,24,16,8
050,29,227,"Missouri","Worth County",2,71,21,11,10
050,29,227,"Missouri","Worth County",2,72,19,9,10
050,29,227,"Missouri","Worth County",2,73,24,12,12
050,29,227,"Missouri","Worth County",2,74,22,10,12
050,29,227,"Missouri","Worth County",2,75,20,10,10
050,29,227,"Missouri","Worth County",2,76,14,8,6
050,29,227,"Missouri","Worth County",2,77,23,11,12
050,29,227,"Missouri","Worth County",2,78,18,8,10
050,29,227,"Missouri","Worth County",2,79,12,3,9
050,29,227,"Missouri","Worth County",2,80,18,6,12
050,29,227,"Missouri","Worth County",2,81,19,7,12
050,29,227,"Missouri","Worth County",2,82,12,5,7
050,29,227,"Missouri","Worth County",2,83,10,5,5
050,29,227,"Missouri","Worth County",2,84,10,4,6
050,29,227,"Missouri","Worth County",2,85,77,23,54
050,29,227,"Missouri","Worth County",3,0,17,8,9
050,29,227,"Missouri","Worth County",3,1,23,10,13
050,29,227,"Missouri","Worth County",3,2,23,12,11
050,29,227,"Missouri","Worth County",3,3,22,10,12
050,29,227,"Missouri","Worth County",3,4,22,12,10
050,29,227,"Missouri","Worth County",3,5,17,10,7
050,29,227,"Missouri","Worth County",3,6,16,3,13
050,29,227,"Missouri","Worth County",3,7,17,9,8
050,29,227,"Missouri","Worth County",3,8,17,8,9
050,29,227,"Missouri","Worth County",3,9,32,17,15
050,29,227,"Missouri","Worth County",3,10,25,11,14
050,29,227,"Missouri","Worth County",3,11,19,7,12
050,29,227,"Missouri","Worth County",3,12,25,11,14
050,29,227,"Missouri","Worth County",3,13,23,11,12
050,29,227,"Missouri","Worth County",3,14,15,8,7
050,29,227,"Missouri","Worth County",3,15,23,12,11
050,29,227,"Missouri","Worth County",3,16,21,12,9
050,29,227,"Missouri","Worth County",3,17,23,13,10
050,29,227,"Missouri","Worth County",3,18,23,12,11
050,29,227,"Missouri","Worth County",3,19,18,9,9
050,29,227,"Missouri","Worth County",3,20,18,10,8
050,29,227,"Missouri","Worth County",3,21,22,13,9
050,29,227,"Missouri","Worth County",3,22,20,11,9
050,29,227,"Missouri","Worth County",3,23,16,9,7
050,29,227,"Missouri","Worth County",3,24,19,12,7
050,29,227,"Missouri","Worth County",3,25,17,9,8
050,29,227,"Missouri","Worth County",3,26,20,10,10
050,29,227,"Missouri","Worth County",3,27,22,10,12
050,29,227,"Missouri","Worth County",3,28,25,9,16
050,29,227,"Missouri","Worth County",3,29,15,6,9
050,29,227,"Missouri","Worth County",3,30,17,5,12
050,29,227,"Missouri","Worth County",3,31,20,7,13
050,29,227,"Missouri","Worth County",3,32,23,12,11
050,29,227,"Missouri","Worth County",3,33,23,12,11
050,29,227,"Missouri","Worth County",3,34,18,5,13
050,29,227,"Missouri","Worth County",3,35,16,6,10
050,29,227,"Missouri","Worth County",3,36,23,14,9
050,29,227,"Missouri","Worth County",3,37,27,16,11
050,29,227,"Missouri","Worth County",3,38,20,13,7
050,29,227,"Missouri","Worth County",3,39,14,7,7
050,29,227,"Missouri","Worth County",3,40,21,9,12
050,29,227,"Missouri","Worth County",3,41,20,9,11
050,29,227,"Missouri","Worth County",3,42,24,16,8
050,29,227,"Missouri","Worth County",3,43,25,17,8
050,29,227,"Missouri","Worth County",3,44,21,13,8
050,29,227,"Missouri","Worth County",3,45,18,9,9
050,29,227,"Missouri","Worth County",3,46,16,9,7
050,29,227,"Missouri","Worth County",3,47,12,9,3
050,29,227,"Missouri","Worth County",3,48,13,9,4
050,29,227,"Missouri","Worth County",3,49,17,10,7
050,29,227,"Missouri","Worth County",3,50,18,9,9
050,29,227,"Missouri","Worth County",3,51,24,12,12
050,29,227,"Missouri","Worth County",3,52,23,10,13
050,29,227,"Missouri","Worth County",3,53,25,11,14
050,29,227,"Missouri","Worth County",3,54,29,16,13
050,29,227,"Missouri","Worth County",3,55,29,14,15
050,29,227,"Missouri","Worth County",3,56,32,19,13
050,29,227,"Missouri","Worth County",3,57,34,19,15
050,29,227,"Missouri","Worth County",3,58,32,18,14
050,29,227,"Missouri","Worth County",3,59,30,16,14
050,29,227,"Missouri","Worth County",3,60,35,21,14
050,29,227,"Missouri","Worth County",3,61,32,16,16
050,29,227,"Missouri","Worth County",3,62,36,16,20
050,29,227,"Missouri","Worth County",3,63,33,16,17
050,29,227,"Missouri","Worth County",3,64,38,18,20
050,29,227,"Missouri","Worth County",3,65,33,16,17
050,29,227,"Missouri","Worth County",3,66,36,19,17
050,29,227,"Missouri","Worth County",3,67,39,21,18
050,29,227,"Missouri","Worth County",3,68,35,20,15
050,29,227,"Missouri","Worth County",3,69,25,14,11
050,29,227,"Missouri","Worth County",3,70,19,10,9
050,29,227,"Missouri","Worth County",3,71,23,15,8
050,29,227,"Missouri","Worth County",3,72,23,12,11
050,29,227,"Missouri","Worth County",3,73,18,8,10
050,29,227,"Missouri","Worth County",3,74,23,12,11
050,29,227,"Missouri","Worth County",3,75,21,10,11
050,29,227,"Missouri","Worth County",3,76,21,10,11
050,29,227,"Missouri","Worth County",3,77,14,7,7
050,29,227,"Missouri","Worth County",3,78,20,10,10
050,29,227,"Missouri","Worth County",3,79,19,8,11
050,29,227,"Missouri","Worth County",3,80,14,3,11
050,29,227,"Missouri","Worth County",3,81,17,5,12
050,29,227,"Missouri","Worth County",3,82,13,3,10
050,29,227,"Missouri","Worth County",3,83,12,4,8
050,29,227,"Missouri","Worth County",3,84,8,5,3
050,29,227,"Missouri","Worth County",3,85,81,24,57
050,29,227,"Missouri","Worth County",4,0,17,12,5
050,29,227,"Missouri","Worth County",4,1,19,10,9
050,29,227,"Missouri","Worth County",4,2,21,8,13
050,29,227,"Missouri","Worth County",4,3,21,12,9
050,29,227,"Missouri","Worth County",4,4,22,12,10
050,29,227,"Missouri","Worth County",4,5,23,12,11
050,29,227,"Missouri","Worth County",4,6,16,9,7
050,29,227,"Missouri","Worth County",4,7,16,3,13
050,29,227,"Missouri","Worth County",4,8,17,9,8
050,29,227,"Missouri","Worth County",4,9,18,9,9
050,29,227,"Missouri","Worth County",4,10,30,15,15
050,29,227,"Missouri","Worth County",4,11,23,9,14
050,29,227,"Missouri","Worth County",4,12,19,7,12
050,29,227,"Missouri","Worth County",4,13,24,11,13
050,29,227,"Missouri","Worth County",4,14,24,12,12
050,29,227,"Missouri","Worth County",4,15,15,8,7
050,29,227,"Missouri","Worth County",4,16,21,12,9
050,29,227,"Missouri","Worth County",4,17,20,12,8
050,29,227,"Missouri","Worth County",4,18,18,11,7
050,29,227,"Missouri","Worth County",4,19,21,10,11
050,29,227,"Missouri","Worth County",4,20,21,12,9
050,29,227,"Missouri","Worth County",4,21,20,12,8
050,29,227,"Missouri","Worth County",4,22,24,14,10
050,29,227,"Missouri","Worth County",4,23,18,10,8
050,29,227,"Missouri","Worth County",4,24,15,10,5
050,29,227,"Missouri","Worth County",4,25,22,11,11
050,29,227,"Missouri","Worth County",4,26,18,9,9
050,29,227,"Missouri","Worth County",4,27,22,13,9
050,29,227,"Missouri","Worth County",4,28,22,9,13
050,29,227,"Missouri","Worth County",4,29,26,9,17
050,29,227,"Missouri","Worth County",4,30,15,7,8
050,29,227,"Missouri","Worth County",4,31,18,5,13
050,29,227,"Missouri","Worth County",4,32,18,6,12
050,29,227,"Missouri","Worth County",4,33,24,13,11
050,29,227,"Missouri","Worth County",4,34,24,12,12
050,29,227,"Missouri","Worth County",4,35,16,4,12
050,29,227,"Missouri","Worth County",4,36,17,6,11
050,29,227,"Missouri","Worth County",4,37,22,14,8
050,29,227,"Missouri","Worth County",4,38,26,15,11
050,29,227,"Missouri","Worth County",4,39,20,13,7
050,29,227,"Missouri","Worth County",4,40,13,7,6
050,29,227,"Missouri","Worth County",4,41,21,9,12
050,29,227,"Missouri","Worth County",4,42,17,8,9
050,29,227,"Missouri","Worth County",4,43,26,17,9
050,29,227,"Missouri","Worth County",4,44,21,14,7
050,29,227,"Missouri","Worth County",4,45,20,12,8
050,29,227,"Missouri","Worth County",4,46,17,9,8
050,29,227,"Missouri","Worth County",4,47,17,9,8
050,29,227,"Missouri","Worth County",4,48,12,9,3
050,29,227,"Missouri","Worth County",4,49,12,8,4
050,29,227,"Missouri","Worth County",4,50,19,12,7
050,29,227,"Missouri","Worth County",4,51,19,9,10
050,29,227,"Missouri","Worth County",4,52,24,12,12
050,29,227,"Missouri","Worth County",4,53,24,10,14
050,29,227,"Missouri","Worth County",4,54,26,13,13
050,29,227,"Missouri","Worth County",4,55,30,16,14
050,29,227,"Missouri","Worth County",4,56,27,13,14
050,29,227,"Missouri","Worth County",4,57,34,19,15
050,29,227,"Missouri","Worth County",4,58,32,18,14
050,29,227,"Missouri","Worth County",4,59,32,18,14
050,29,227,"Missouri","Worth County",4,60,30,16,14
050,29,227,"Missouri","Worth County",4,61,34,20,14
050,29,227,"Missouri","Worth County",4,62,34,17,17
050,29,227,"Missouri","Worth County",4,63,36,15,21
050,29,227,"Missouri","Worth County",4,64,32,15,17
050,29,227,"Missouri","Worth County",4,65,37,16,21
050,29,227,"Missouri","Worth County",4,66,33,16,17
050,29,227,"Missouri","Worth County",4,67,36,19,17
050,29,227,"Missouri","Worth County",4,68,33,17,16
050,29,227,"Missouri","Worth County",4,69,34,20,14
050,29,227,"Missouri","Worth County",4,70,25,15,10
050,29,227,"Missouri","Worth County",4,71,18,11,7
050,29,227,"Missouri","Worth County",4,72,22,14,8
050,29,227,"Missouri","Worth County",4,73,22,11,11
050,29,227,"Missouri","Worth County",4,74,18,8,10
050,29,227,"Missouri","Worth County",4,75,23,12,11
050,29,227,"Missouri","Worth County",4,76,19,9,10
050,29,227,"Missouri","Worth County",4,77,21,9,12
050,29,227,"Missouri","Worth County",4,78,11,5,6
050,29,227,"Missouri","Worth County",4,79,20,9,11
050,29,227,"Missouri","Worth County",4,80,20,8,12
050,29,227,"Missouri","Worth County",4,81,12,2,10
050,29,227,"Missouri","Worth County",4,82,13,2,11
050,29,227,"Missouri","Worth County",4,83,10,1,9
050,29,227,"Missouri","Worth County",4,84,13,6,7
050,29,227,"Missouri","Worth County",4,85,78,22,56
050,29,227,"Missouri","Worth County",5,0,23,16,7
050,29,227,"Missouri","Worth County",5,1,15,12,3
050,29,227,"Missouri","Worth County",5,2,19,10,9
050,29,227,"Missouri","Worth County",5,3,22,10,12
050,29,227,"Missouri","Worth County",5,4,20,10,10
050,29,227,"Missouri","Worth County",5,5,22,13,9
050,29,227,"Missouri","Worth County",5,6,22,11,11
050,29,227,"Missouri","Worth County",5,7,17,10,7
050,29,227,"Missouri","Worth County",5,8,16,3,13
050,29,227,"Missouri","Worth County",5,9,16,9,7
050,29,227,"Missouri","Worth County",5,10,18,8,10
050,29,227,"Missouri","Worth County",5,11,27,15,12
050,29,227,"Missouri","Worth County",5,12,26,13,13
050,29,227,"Missouri","Worth County",5,13,20,8,12
050,29,227,"Missouri","Worth County",5,14,23,11,12
050,29,227,"Missouri","Worth County",5,15,28,16,12
050,29,227,"Missouri","Worth County",5,16,17,9,8
050,29,227,"Missouri","Worth County",5,17,20,11,9
050,29,227,"Missouri","Worth County",5,18,15,9,6
050,29,227,"Missouri","Worth County",5,19,15,9,6
050,29,227,"Missouri","Worth County",5,20,21,11,10
050,29,227,"Missouri","Worth County",5,21,19,11,8
050,29,227,"Missouri","Worth County",5,22,18,8,10
050,29,227,"Missouri","Worth County",5,23,24,15,9
050,29,227,"Missouri","Worth County",5,24,15,8,7
050,29,227,"Missouri","Worth County",5,25,15,9,6
050,29,227,"Missouri","Worth County",5,26,21,12,9
050,29,227,"Missouri","Worth County",5,27,22,11,11
050,29,227,"Missouri","Worth County",5,28,20,13,7
050,29,227,"Missouri","Worth County",5,29,22,9,13
050,29,227,"Missouri","Worth County",5,30,26,10,16
050,29,227,"Missouri","Worth County",5,31,14,8,6
050,29,227,"Missouri","Worth County",5,32,18,5,13
050,29,227,"Missouri","Worth County",5,33,18,5,13
050,29,227,"Missouri","Worth County",5,34,26,14,12
050,29,227,"Missouri","Worth County",5,35,24,12,12
050,29,227,"Missouri","Worth County",5,36,17,4,13
050,29,227,"Missouri","Worth County",5,37,17,6,11
050,29,227,"Missouri","Worth County",5,38,22,14,8
050,29,227,"Missouri","Worth County",5,39,25,14,11
050,29,227,"Missouri","Worth County",5,40,20,13,7
050,29,227,"Missouri","Worth County",5,41,11,5,6
050,29,227,"Missouri","Worth County",5,42,22,9,13
050,29,227,"Missouri","Worth County",5,43,18,9,9
050,29,227,"Missouri","Worth County",5,44,26,17,9
050,29,227,"Missouri","Worth County",5,45,22,14,8
050,29,227,"Missouri","Worth County",5,46,20,12,8
050,29,227,"Missouri","Worth County",5,47,17,9,8
050,29,227,"Missouri","Worth County",5,48,17,10,7
050,29,227,"Missouri","Worth County",5,49,11,8,3
050,29,227,"Missouri","Worth County",5,50,11,8,3
050,29,227,"Missouri","Worth County",5,51,16,10,6
050,29,227,"Missouri","Worth County",5,52,17,7,10
050,29,227,"Missouri","Worth County",5,53,22,12,10
050,29,227,"Missouri","Worth County",5,54,24,10,14
050,29,227,"Missouri","Worth County",5,55,27,13,14
050,29,227,"Missouri","Worth County",5,56,30,16,14
050,29,227,"Missouri","Worth County",5,57,28,13,15
050,29,227,"Missouri","Worth County",5,58,32,17,15
050,29,227,"Missouri","Worth County",5,59,31,18,13
050,29,227,"Missouri","Worth County",5,60,30,18,12
050,29,227,"Missouri","Worth County",5,61,30,16,14
050,29,227,"Missouri","Worth County",5,62,35,19,16
050,29,227,"Missouri","Worth County",5,63,36,17,19
050,29,227,"Missouri","Worth County",5,64,35,14,21
050,29,227,"Missouri","Worth County",5,65,29,14,15
050,29,227,"Missouri","Worth County",5,66,34,16,18
050,29,227,"Missouri","Worth County",5,67,37,17,20
050,29,227,"Missouri","Worth County",5,68,33,18,15
050,29,227,"Missouri","Worth County",5,69,30,17,13
050,29,227,"Missouri","Worth County",5,70,36,21,15
050,29,227,"Missouri","Worth County",5,71,23,13,10
050,29,227,"Missouri","Worth County",5,72,18,11,7
050,29,227,"Missouri","Worth County",5,73,23,13,10
050,29,227,"Missouri","Worth County",5,74,21,11,10
050,29,227,"Missouri","Worth County",5,75,18,8,10
050,29,227,"Missouri","Worth County",5,76,21,12,9
050,29,227,"Missouri","Worth County",5,77,17,7,10
050,29,227,"Missouri","Worth County",5,78,18,7,11
050,29,227,"Missouri","Worth County",5,79,11,5,6
050,29,227,"Missouri","Worth County",5,80,19,9,10
050,29,227,"Missouri","Worth County",5,81,19,8,11
050,29,227,"Missouri","Worth County",5,82,8,0,8
050,29,227,"Missouri","Worth County",5,83,10,0,10
050,29,227,"Missouri","Worth County",5,84,9,1,8
050,29,227,"Missouri","Worth County",5,85,80,21,59
050,29,229,"Missouri","Wright County",1,0,237,122,115
050,29,229,"Missouri","Wright County",1,1,256,137,119
050,29,229,"Missouri","Wright County",1,2,251,134,117
050,29,229,"Missouri","Wright County",1,3,282,146,136
050,29,229,"Missouri","Wright County",1,4,266,139,127
050,29,229,"Missouri","Wright County",1,5,262,151,111
050,29,229,"Missouri","Wright County",1,6,258,142,116
050,29,229,"Missouri","Wright County",1,7,234,128,106
050,29,229,"Missouri","Wright County",1,8,237,127,110
050,29,229,"Missouri","Wright County",1,9,230,117,113
050,29,229,"Missouri","Wright County",1,10,255,133,122
050,29,229,"Missouri","Wright County",1,11,277,138,139
050,29,229,"Missouri","Wright County",1,12,262,136,126
050,29,229,"Missouri","Wright County",1,13,275,123,152
050,29,229,"Missouri","Wright County",1,14,296,128,168
050,29,229,"Missouri","Wright County",1,15,307,145,162
050,29,229,"Missouri","Wright County",1,16,288,140,148
050,29,229,"Missouri","Wright County",1,17,279,134,145
050,29,229,"Missouri","Wright County",1,18,235,122,113
050,29,229,"Missouri","Wright County",1,19,182,94,88
050,29,229,"Missouri","Wright County",1,20,171,94,77
050,29,229,"Missouri","Wright County",1,21,177,92,85
050,29,229,"Missouri","Wright County",1,22,160,79,81
050,29,229,"Missouri","Wright County",1,23,191,101,90
050,29,229,"Missouri","Wright County",1,24,188,107,81
050,29,229,"Missouri","Wright County",1,25,186,97,89
050,29,229,"Missouri","Wright County",1,26,187,92,95
050,29,229,"Missouri","Wright County",1,27,184,89,95
050,29,229,"Missouri","Wright County",1,28,195,97,98
050,29,229,"Missouri","Wright County",1,29,212,108,104
050,29,229,"Missouri","Wright County",1,30,203,106,97
050,29,229,"Missouri","Wright County",1,31,189,96,93
050,29,229,"Missouri","Wright County",1,32,191,95,96
050,29,229,"Missouri","Wright County",1,33,210,113,97
050,29,229,"Missouri","Wright County",1,34,197,96,101
050,29,229,"Missouri","Wright County",1,35,191,103,88
050,29,229,"Missouri","Wright County",1,36,198,108,90
050,29,229,"Missouri","Wright County",1,37,219,110,109
050,29,229,"Missouri","Wright County",1,38,222,112,110
050,29,229,"Missouri","Wright County",1,39,190,87,103
050,29,229,"Missouri","Wright County",1,40,209,94,115
050,29,229,"Missouri","Wright County",1,41,210,102,108
050,29,229,"Missouri","Wright County",1,42,200,97,103
050,29,229,"Missouri","Wright County",1,43,189,93,96
050,29,229,"Missouri","Wright County",1,44,171,86,85
050,29,229,"Missouri","Wright County",1,45,200,99,101
050,29,229,"Missouri","Wright County",1,46,183,89,94
050,29,229,"Missouri","Wright County",1,47,205,106,99
050,29,229,"Missouri","Wright County",1,48,219,108,111
050,29,229,"Missouri","Wright County",1,49,225,128,97
050,29,229,"Missouri","Wright County",1,50,203,103,100
050,29,229,"Missouri","Wright County",1,51,200,94,106
050,29,229,"Missouri","Wright County",1,52,213,104,109
050,29,229,"Missouri","Wright County",1,53,250,129,121
050,29,229,"Missouri","Wright County",1,54,227,123,104
050,29,229,"Missouri","Wright County",1,55,206,96,110
050,29,229,"Missouri","Wright County",1,56,244,119,125
050,29,229,"Missouri","Wright County",1,57,251,123,128
050,29,229,"Missouri","Wright County",1,58,263,128,135
050,29,229,"Missouri","Wright County",1,59,253,115,138
050,29,229,"Missouri","Wright County",1,60,275,125,150
050,29,229,"Missouri","Wright County",1,61,272,124,148
050,29,229,"Missouri","Wright County",1,62,247,129,118
050,29,229,"Missouri","Wright County",1,63,252,135,117
050,29,229,"Missouri","Wright County",1,64,256,142,114
050,29,229,"Missouri","Wright County",1,65,233,118,115
050,29,229,"Missouri","Wright County",1,66,245,111,134
050,29,229,"Missouri","Wright County",1,67,256,128,128
050,29,229,"Missouri","Wright County",1,68,232,118,114
050,29,229,"Missouri","Wright County",1,69,199,100,99
050,29,229,"Missouri","Wright County",1,70,186,92,94
050,29,229,"Missouri","Wright County",1,71,181,84,97
050,29,229,"Missouri","Wright County",1,72,172,76,96
050,29,229,"Missouri","Wright County",1,73,201,101,100
050,29,229,"Missouri","Wright County",1,74,143,67,76
050,29,229,"Missouri","Wright County",1,75,151,68,83
050,29,229,"Missouri","Wright County",1,76,150,67,83
050,29,229,"Missouri","Wright County",1,77,150,65,85
050,29,229,"Missouri","Wright County",1,78,122,52,70
050,29,229,"Missouri","Wright County",1,79,106,45,61
050,29,229,"Missouri","Wright County",1,80,113,53,60
050,29,229,"Missouri","Wright County",1,81,100,50,50
050,29,229,"Missouri","Wright County",1,82,89,38,51
050,29,229,"Missouri","Wright County",1,83,78,36,42
050,29,229,"Missouri","Wright County",1,84,59,28,31
050,29,229,"Missouri","Wright County",1,85,369,143,226
050,29,229,"Missouri","Wright County",2,0,241,124,117
050,29,229,"Missouri","Wright County",2,1,248,132,116
050,29,229,"Missouri","Wright County",2,2,253,135,118
050,29,229,"Missouri","Wright County",2,3,274,143,131
050,29,229,"Missouri","Wright County",2,4,268,139,129
050,29,229,"Missouri","Wright County",2,5,261,148,113
050,29,229,"Missouri","Wright County",2,6,264,147,117
050,29,229,"Missouri","Wright County",2,7,240,130,110
050,29,229,"Missouri","Wright County",2,8,234,126,108
050,29,229,"Missouri","Wright County",2,9,233,120,113
050,29,229,"Missouri","Wright County",2,10,252,130,122
050,29,229,"Missouri","Wright County",2,11,272,137,135
050,29,229,"Missouri","Wright County",2,12,268,137,131
050,29,229,"Missouri","Wright County",2,13,274,127,147
050,29,229,"Missouri","Wright County",2,14,295,128,167
050,29,229,"Missouri","Wright County",2,15,303,140,163
050,29,229,"Missouri","Wright County",2,16,294,141,153
050,29,229,"Missouri","Wright County",2,17,284,137,147
050,29,229,"Missouri","Wright County",2,18,234,119,115
050,29,229,"Missouri","Wright County",2,19,183,94,89
050,29,229,"Missouri","Wright County",2,20,178,96,82
050,29,229,"Missouri","Wright County",2,21,172,92,80
050,29,229,"Missouri","Wright County",2,22,164,83,81
050,29,229,"Missouri","Wright County",2,23,186,98,88
050,29,229,"Missouri","Wright County",2,24,188,105,83
050,29,229,"Missouri","Wright County",2,25,186,99,87
050,29,229,"Missouri","Wright County",2,26,185,92,93
050,29,229,"Missouri","Wright County",2,27,185,88,97
050,29,229,"Missouri","Wright County",2,28,195,96,99
050,29,229,"Missouri","Wright County",2,29,213,108,105
050,29,229,"Missouri","Wright County",2,30,206,108,98
050,29,229,"Missouri","Wright County",2,31,191,97,94
050,29,229,"Missouri","Wright County",2,32,192,97,95
050,29,229,"Missouri","Wright County",2,33,203,107,96
050,29,229,"Missouri","Wright County",2,34,200,100,100
050,29,229,"Missouri","Wright County",2,35,194,103,91
050,29,229,"Missouri","Wright County",2,36,195,106,89
050,29,229,"Missouri","Wright County",2,37,213,108,105
050,29,229,"Missouri","Wright County",2,38,223,112,111
050,29,229,"Missouri","Wright County",2,39,196,93,103
050,29,229,"Missouri","Wright County",2,40,207,93,114
050,29,229,"Missouri","Wright County",2,41,208,98,110
050,29,229,"Missouri","Wright County",2,42,200,96,104
050,29,229,"Missouri","Wright County",2,43,195,95,100
050,29,229,"Missouri","Wright County",2,44,176,88,88
050,29,229,"Missouri","Wright County",2,45,192,96,96
050,29,229,"Missouri","Wright County",2,46,187,92,95
050,29,229,"Missouri","Wright County",2,47,198,101,97
050,29,229,"Missouri","Wright County",2,48,214,106,108
050,29,229,"Missouri","Wright County",2,49,222,123,99
050,29,229,"Missouri","Wright County",2,50,208,110,98
050,29,229,"Missouri","Wright County",2,51,200,96,104
050,29,229,"Missouri","Wright County",2,52,210,102,108
050,29,229,"Missouri","Wright County",2,53,242,123,119
050,29,229,"Missouri","Wright County",2,54,233,126,107
050,29,229,"Missouri","Wright County",2,55,211,102,109
050,29,229,"Missouri","Wright County",2,56,235,114,121
050,29,229,"Missouri","Wright County",2,57,248,122,126
050,29,229,"Missouri","Wright County",2,58,259,127,132
050,29,229,"Missouri","Wright County",2,59,257,117,140
050,29,229,"Missouri","Wright County",2,60,268,122,146
050,29,229,"Missouri","Wright County",2,61,268,122,146
050,29,229,"Missouri","Wright County",2,62,252,128,124
050,29,229,"Missouri","Wright County",2,63,254,136,118
050,29,229,"Missouri","Wright County",2,64,254,140,114
050,29,229,"Missouri","Wright County",2,65,238,123,115
050,29,229,"Missouri","Wright County",2,66,243,114,129
050,29,229,"Missouri","Wright County",2,67,253,124,129
050,29,229,"Missouri","Wright County",2,68,237,118,119
050,29,229,"Missouri","Wright County",2,69,212,107,105
050,29,229,"Missouri","Wright County",2,70,190,95,95
050,29,229,"Missouri","Wright County",2,71,182,85,97
050,29,229,"Missouri","Wright County",2,72,171,77,94
050,29,229,"Missouri","Wright County",2,73,201,98,103
050,29,229,"Missouri","Wright County",2,74,148,71,77
050,29,229,"Missouri","Wright County",2,75,150,67,83
050,29,229,"Missouri","Wright County",2,76,147,66,81
050,29,229,"Missouri","Wright County",2,77,152,67,85
050,29,229,"Missouri","Wright County",2,78,125,55,70
050,29,229,"Missouri","Wright County",2,79,109,46,63
050,29,229,"Missouri","Wright County",2,80,107,49,58
050,29,229,"Missouri","Wright County",2,81,102,51,51
050,29,229,"Missouri","Wright County",2,82,93,41,52
050,29,229,"Missouri","Wright County",2,83,80,36,44
050,29,229,"Missouri","Wright County",2,84,62,30,32
050,29,229,"Missouri","Wright County",2,85,373,146,227
050,29,229,"Missouri","Wright County",3,0,231,120,111
050,29,229,"Missouri","Wright County",3,1,263,140,123
050,29,229,"Missouri","Wright County",3,2,251,135,116
050,29,229,"Missouri","Wright County",3,3,265,133,132
050,29,229,"Missouri","Wright County",3,4,251,132,119
050,29,229,"Missouri","Wright County",3,5,273,137,136
050,29,229,"Missouri","Wright County",3,6,272,146,126
050,29,229,"Missouri","Wright County",3,7,274,156,118
050,29,229,"Missouri","Wright County",3,8,252,132,120
050,29,229,"Missouri","Wright County",3,9,253,139,114
050,29,229,"Missouri","Wright County",3,10,247,130,117
050,29,229,"Missouri","Wright County",3,11,267,143,124
050,29,229,"Missouri","Wright County",3,12,287,151,136
050,29,229,"Missouri","Wright County",3,13,283,146,137
050,29,229,"Missouri","Wright County",3,14,275,130,145
050,29,229,"Missouri","Wright County",3,15,305,138,167
050,29,229,"Missouri","Wright County",3,16,310,151,159
050,29,229,"Missouri","Wright County",3,17,300,148,152
050,29,229,"Missouri","Wright County",3,18,233,118,115
050,29,229,"Missouri","Wright County",3,19,176,94,82
050,29,229,"Missouri","Wright County",3,20,199,109,90
050,29,229,"Missouri","Wright County",3,21,167,91,76
050,29,229,"Missouri","Wright County",3,22,182,94,88
050,29,229,"Missouri","Wright County",3,23,159,83,76
050,29,229,"Missouri","Wright County",3,24,189,101,88
050,29,229,"Missouri","Wright County",3,25,195,105,90
050,29,229,"Missouri","Wright County",3,26,188,94,94
050,29,229,"Missouri","Wright County",3,27,196,94,102
050,29,229,"Missouri","Wright County",3,28,188,93,95
050,29,229,"Missouri","Wright County",3,29,196,99,97
050,29,229,"Missouri","Wright County",3,30,230,117,113
050,29,229,"Missouri","Wright County",3,31,224,116,108
050,29,229,"Missouri","Wright County",3,32,205,107,98
050,29,229,"Missouri","Wright County",3,33,213,109,104
050,29,229,"Missouri","Wright County",3,34,211,112,99
050,29,229,"Missouri","Wright County",3,35,208,102,106
050,29,229,"Missouri","Wright County",3,36,203,107,96
050,29,229,"Missouri","Wright County",3,37,213,111,102
050,29,229,"Missouri","Wright County",3,38,233,120,113
050,29,229,"Missouri","Wright County",3,39,231,114,117
050,29,229,"Missouri","Wright County",3,40,204,98,106
050,29,229,"Missouri","Wright County",3,41,217,98,119
050,29,229,"Missouri","Wright County",3,42,222,106,116
050,29,229,"Missouri","Wright County",3,43,204,100,104
050,29,229,"Missouri","Wright County",3,44,194,95,99
050,29,229,"Missouri","Wright County",3,45,182,91,91
050,29,229,"Missouri","Wright County",3,46,204,102,102
050,29,229,"Missouri","Wright County",3,47,191,93,98
050,29,229,"Missouri","Wright County",3,48,206,102,104
050,29,229,"Missouri","Wright County",3,49,216,101,115
050,29,229,"Missouri","Wright County",3,50,229,125,104
050,29,229,"Missouri","Wright County",3,51,206,105,101
050,29,229,"Missouri","Wright County",3,52,192,94,98
050,29,229,"Missouri","Wright County",3,53,205,97,108
050,29,229,"Missouri","Wright County",3,54,248,125,123
050,29,229,"Missouri","Wright County",3,55,241,128,113
050,29,229,"Missouri","Wright County",3,56,202,95,107
050,29,229,"Missouri","Wright County",3,57,249,126,123
050,29,229,"Missouri","Wright County",3,58,246,122,124
050,29,229,"Missouri","Wright County",3,59,256,123,133
050,29,229,"Missouri","Wright County",3,60,263,119,144
050,29,229,"Missouri","Wright County",3,61,279,128,151
050,29,229,"Missouri","Wright County",3,62,270,123,147
050,29,229,"Missouri","Wright County",3,63,269,133,136
050,29,229,"Missouri","Wright County",3,64,265,145,120
050,29,229,"Missouri","Wright County",3,65,253,136,117
050,29,229,"Missouri","Wright County",3,66,237,125,112
050,29,229,"Missouri","Wright County",3,67,244,116,128
050,29,229,"Missouri","Wright County",3,68,248,123,125
050,29,229,"Missouri","Wright County",3,69,230,115,115
050,29,229,"Missouri","Wright County",3,70,217,106,111
050,29,229,"Missouri","Wright County",3,71,185,92,93
050,29,229,"Missouri","Wright County",3,72,182,84,98
050,29,229,"Missouri","Wright County",3,73,163,74,89
050,29,229,"Missouri","Wright County",3,74,194,95,99
050,29,229,"Missouri","Wright County",3,75,146,69,77
050,29,229,"Missouri","Wright County",3,76,139,60,79
050,29,229,"Missouri","Wright County",3,77,143,65,78
050,29,229,"Missouri","Wright County",3,78,141,63,78
050,29,229,"Missouri","Wright County",3,79,119,50,69
050,29,229,"Missouri","Wright County",3,80,109,47,62
050,29,229,"Missouri","Wright County",3,81,98,49,49
050,29,229,"Missouri","Wright County",3,82,95,45,50
050,29,229,"Missouri","Wright County",3,83,82,37,45
050,29,229,"Missouri","Wright County",3,84,73,34,39
050,29,229,"Missouri","Wright County",3,85,365,141,224
050,29,229,"Missouri","Wright County",4,0,247,134,113
050,29,229,"Missouri","Wright County",4,1,247,127,120
050,29,229,"Missouri","Wright County",4,2,292,150,142
050,29,229,"Missouri","Wright County",4,3,276,151,125
050,29,229,"Missouri","Wright County",4,4,274,138,136
050,29,229,"Missouri","Wright County",4,5,273,138,135
050,29,229,"Missouri","Wright County",4,6,284,142,142
050,29,229,"Missouri","Wright County",4,7,280,153,127
050,29,229,"Missouri","Wright County",4,8,296,161,135
050,29,229,"Missouri","Wright County",4,9,272,146,126
050,29,229,"Missouri","Wright County",4,10,273,148,125
050,29,229,"Missouri","Wright County",4,11,259,134,125
050,29,229,"Missouri","Wright County",4,12,288,152,136
050,29,229,"Missouri","Wright County",4,13,307,157,150
050,29,229,"Missouri","Wright County",4,14,301,153,148
050,29,229,"Missouri","Wright County",4,15,274,134,140
050,29,229,"Missouri","Wright County",4,16,312,146,166
050,29,229,"Missouri","Wright County",4,17,317,156,161
050,29,229,"Missouri","Wright County",4,18,251,129,122
050,29,229,"Missouri","Wright County",4,19,179,93,86
050,29,229,"Missouri","Wright County",4,20,185,97,88
050,29,229,"Missouri","Wright County",4,21,205,113,92
050,29,229,"Missouri","Wright County",4,22,178,102,76
050,29,229,"Missouri","Wright County",4,23,182,92,90
050,29,229,"Missouri","Wright County",4,24,166,81,85
050,29,229,"Missouri","Wright County",4,25,196,103,93
050,29,229,"Missouri","Wright County",4,26,201,110,91
050,29,229,"Missouri","Wright County",4,27,183,92,91
050,29,229,"Missouri","Wright County",4,28,223,107,116
050,29,229,"Missouri","Wright County",4,29,191,92,99
050,29,229,"Missouri","Wright County",4,30,217,106,111
050,29,229,"Missouri","Wright County",4,31,246,126,120
050,29,229,"Missouri","Wright County",4,32,233,122,111
050,29,229,"Missouri","Wright County",4,33,228,120,108
050,29,229,"Missouri","Wright County",4,34,235,121,114
050,29,229,"Missouri","Wright County",4,35,227,124,103
050,29,229,"Missouri","Wright County",4,36,238,117,121
050,29,229,"Missouri","Wright County",4,37,209,106,103
050,29,229,"Missouri","Wright County",4,38,225,120,105
050,29,229,"Missouri","Wright County",4,39,241,130,111
050,29,229,"Missouri","Wright County",4,40,236,117,119
050,29,229,"Missouri","Wright County",4,41,218,103,115
050,29,229,"Missouri","Wright County",4,42,220,94,126
050,29,229,"Missouri","Wright County",4,43,221,111,110
050,29,229,"Missouri","Wright County",4,44,216,101,115
050,29,229,"Missouri","Wright County",4,45,190,97,93
050,29,229,"Missouri","Wright County",4,46,187,89,98
050,29,229,"Missouri","Wright County",4,47,205,105,100
050,29,229,"Missouri","Wright County",4,48,203,106,97
050,29,229,"Missouri","Wright County",4,49,205,100,105
050,29,229,"Missouri","Wright County",4,50,218,103,115
050,29,229,"Missouri","Wright County",4,51,233,126,107
050,29,229,"Missouri","Wright County",4,52,201,103,98
050,29,229,"Missouri","Wright County",4,53,196,95,101
050,29,229,"Missouri","Wright County",4,54,201,96,105
050,29,229,"Missouri","Wright County",4,55,254,125,129
050,29,229,"Missouri","Wright County",4,56,240,127,113
050,29,229,"Missouri","Wright County",4,57,217,101,116
050,29,229,"Missouri","Wright County",4,58,255,126,129
050,29,229,"Missouri","Wright County",4,59,249,122,127
050,29,229,"Missouri","Wright County",4,60,243,120,123
050,29,229,"Missouri","Wright County",4,61,277,127,150
050,29,229,"Missouri","Wright County",4,62,274,120,154
050,29,229,"Missouri","Wright County",4,63,274,130,144
050,29,229,"Missouri","Wright County",4,64,262,130,132
050,29,229,"Missouri","Wright County",4,65,257,140,117
050,29,229,"Missouri","Wright County",4,66,254,138,116
050,29,229,"Missouri","Wright County",4,67,230,120,110
050,29,229,"Missouri","Wright County",4,68,233,113,120
050,29,229,"Missouri","Wright County",4,69,250,121,129
050,29,229,"Missouri","Wright County",4,70,230,111,119
050,29,229,"Missouri","Wright County",4,71,219,106,113
050,29,229,"Missouri","Wright County",4,72,183,87,96
050,29,229,"Missouri","Wright County",4,73,180,87,93
050,29,229,"Missouri","Wright County",4,74,157,66,91
050,29,229,"Missouri","Wright County",4,75,186,93,93
050,29,229,"Missouri","Wright County",4,76,135,66,69
050,29,229,"Missouri","Wright County",4,77,138,60,78
050,29,229,"Missouri","Wright County",4,78,132,61,71
050,29,229,"Missouri","Wright County",4,79,126,56,70
050,29,229,"Missouri","Wright County",4,80,119,48,71
050,29,229,"Missouri","Wright County",4,81,94,42,52
050,29,229,"Missouri","Wright County",4,82,91,39,52
050,29,229,"Missouri","Wright County",4,83,82,36,46
050,29,229,"Missouri","Wright County",4,84,74,34,40
050,29,229,"Missouri","Wright County",4,85,367,135,232
050,29,229,"Missouri","Wright County",5,0,247,136,111
050,29,229,"Missouri","Wright County",5,1,247,135,112
050,29,229,"Missouri","Wright County",5,2,249,126,123
050,29,229,"Missouri","Wright County",5,3,282,141,141
050,29,229,"Missouri","Wright County",5,4,273,152,121
050,29,229,"Missouri","Wright County",5,5,293,155,138
050,29,229,"Missouri","Wright County",5,6,281,145,136
050,29,229,"Missouri","Wright County",5,7,296,145,151
050,29,229,"Missouri","Wright County",5,8,291,152,139
050,29,229,"Missouri","Wright County",5,9,303,166,137
050,29,229,"Missouri","Wright County",5,10,273,143,130
050,29,229,"Missouri","Wright County",5,11,291,159,132
050,29,229,"Missouri","Wright County",5,12,270,136,134
050,29,229,"Missouri","Wright County",5,13,301,166,135
050,29,229,"Missouri","Wright County",5,14,308,157,151
050,29,229,"Missouri","Wright County",5,15,302,160,142
050,29,229,"Missouri","Wright County",5,16,288,139,149
050,29,229,"Missouri","Wright County",5,17,303,140,163
050,29,229,"Missouri","Wright County",5,18,258,127,131
050,29,229,"Missouri","Wright County",5,19,194,101,93
050,29,229,"Missouri","Wright County",5,20,197,104,93
050,29,229,"Missouri","Wright County",5,21,193,101,92
050,29,229,"Missouri","Wright County",5,22,203,106,97
050,29,229,"Missouri","Wright County",5,23,192,110,82
050,29,229,"Missouri","Wright County",5,24,193,102,91
050,29,229,"Missouri","Wright County",5,25,163,76,87
050,29,229,"Missouri","Wright County",5,26,194,96,98
050,29,229,"Missouri","Wright County",5,27,192,103,89
050,29,229,"Missouri","Wright County",5,28,202,98,104
050,29,229,"Missouri","Wright County",5,29,218,106,112
050,29,229,"Missouri","Wright County",5,30,206,101,105
050,29,229,"Missouri","Wright County",5,31,221,110,111
050,29,229,"Missouri","Wright County",5,32,251,126,125
050,29,229,"Missouri","Wright County",5,33,228,118,110
050,29,229,"Missouri","Wright County",5,34,237,127,110
050,29,229,"Missouri","Wright County",5,35,237,119,118
050,29,229,"Missouri","Wright County",5,36,240,132,108
050,29,229,"Missouri","Wright County",5,37,241,116,125
050,29,229,"Missouri","Wright County",5,38,211,113,98
050,29,229,"Missouri","Wright County",5,39,240,130,110
050,29,229,"Missouri","Wright County",5,40,254,137,117
050,29,229,"Missouri","Wright County",5,41,251,127,124
050,29,229,"Missouri","Wright County",5,42,224,107,117
050,29,229,"Missouri","Wright County",5,43,224,98,126
050,29,229,"Missouri","Wright County",5,44,222,110,112
050,29,229,"Missouri","Wright County",5,45,216,104,112
050,29,229,"Missouri","Wright County",5,46,187,99,88
050,29,229,"Missouri","Wright County",5,47,191,90,101
050,29,229,"Missouri","Wright County",5,48,218,116,102
050,29,229,"Missouri","Wright County",5,49,209,110,99
050,29,229,"Missouri","Wright County",5,50,201,100,101
050,29,229,"Missouri","Wright County",5,51,222,101,121
050,29,229,"Missouri","Wright County",5,52,233,124,109
050,29,229,"Missouri","Wright County",5,53,196,100,96
050,29,229,"Missouri","Wright County",5,54,194,90,104
050,29,229,"Missouri","Wright County",5,55,202,94,108
050,29,229,"Missouri","Wright County",5,56,256,126,130
050,29,229,"Missouri","Wright County",5,57,243,128,115
050,29,229,"Missouri","Wright County",5,58,232,107,125
050,29,229,"Missouri","Wright County",5,59,254,127,127
050,29,229,"Missouri","Wright County",5,60,254,126,128
050,29,229,"Missouri","Wright County",5,61,249,119,130
050,29,229,"Missouri","Wright County",5,62,279,127,152
050,29,229,"Missouri","Wright County",5,63,278,124,154
050,29,229,"Missouri","Wright County",5,64,269,129,140
050,29,229,"Missouri","Wright County",5,65,246,125,121
050,29,229,"Missouri","Wright County",5,66,258,139,119
050,29,229,"Missouri","Wright County",5,67,251,140,111
050,29,229,"Missouri","Wright County",5,68,233,121,112
050,29,229,"Missouri","Wright County",5,69,236,109,127
050,29,229,"Missouri","Wright County",5,70,246,116,130
050,29,229,"Missouri","Wright County",5,71,230,112,118
050,29,229,"Missouri","Wright County",5,72,210,102,108
050,29,229,"Missouri","Wright County",5,73,182,87,95
050,29,229,"Missouri","Wright County",5,74,174,83,91
050,29,229,"Missouri","Wright County",5,75,148,60,88
050,29,229,"Missouri","Wright County",5,76,181,89,92
050,29,229,"Missouri","Wright County",5,77,134,66,68
050,29,229,"Missouri","Wright County",5,78,129,58,71
050,29,229,"Missouri","Wright County",5,79,120,54,66
050,29,229,"Missouri","Wright County",5,80,124,55,69
050,29,229,"Missouri","Wright County",5,81,105,43,62
050,29,229,"Missouri","Wright County",5,82,88,34,54
050,29,229,"Missouri","Wright County",5,83,85,35,50
050,29,229,"Missouri","Wright County",5,84,76,34,42
050,29,229,"Missouri","Wright County",5,85,380,136,244
050,29,510,"Missouri","St. Louis city",1,0,4004,2047,1957
050,29,510,"Missouri","St. Louis city",1,1,3771,1951,1820
050,29,510,"Missouri","St. Louis city",1,2,3603,1830,1773
050,29,510,"Missouri","St. Louis city",1,3,3410,1731,1679
050,29,510,"Missouri","St. Louis city",1,4,3415,1745,1670
050,29,510,"Missouri","St. Louis city",1,5,3311,1677,1634
050,29,510,"Missouri","St. Louis city",1,6,3254,1687,1567
050,29,510,"Missouri","St. Louis city",1,7,3080,1590,1490
050,29,510,"Missouri","St. Louis city",1,8,3100,1576,1524
050,29,510,"Missouri","St. Louis city",1,9,3018,1520,1498
050,29,510,"Missouri","St. Louis city",1,10,3043,1618,1425
050,29,510,"Missouri","St. Louis city",1,11,3055,1575,1480
050,29,510,"Missouri","St. Louis city",1,12,3112,1578,1534
050,29,510,"Missouri","St. Louis city",1,13,3009,1538,1471
050,29,510,"Missouri","St. Louis city",1,14,2832,1469,1363
050,29,510,"Missouri","St. Louis city",1,15,2684,1364,1320
050,29,510,"Missouri","St. Louis city",1,16,2703,1350,1353
050,29,510,"Missouri","St. Louis city",1,17,2752,1344,1408
050,29,510,"Missouri","St. Louis city",1,18,3230,1552,1678
050,29,510,"Missouri","St. Louis city",1,19,4057,1957,2100
050,29,510,"Missouri","St. Louis city",1,20,3619,1714,1905
050,29,510,"Missouri","St. Louis city",1,21,3336,1593,1743
050,29,510,"Missouri","St. Louis city",1,22,3546,1693,1853
050,29,510,"Missouri","St. Louis city",1,23,4046,1908,2138
050,29,510,"Missouri","St. Louis city",1,24,4801,2262,2539
050,29,510,"Missouri","St. Louis city",1,25,5462,2529,2933
050,29,510,"Missouri","St. Louis city",1,26,5989,2886,3103
050,29,510,"Missouri","St. Louis city",1,27,6445,3141,3304
050,29,510,"Missouri","St. Louis city",1,28,6753,3234,3519
050,29,510,"Missouri","St. Louis city",1,29,6647,3249,3398
050,29,510,"Missouri","St. Louis city",1,30,6441,3158,3283
050,29,510,"Missouri","St. Louis city",1,31,6221,3102,3119
050,29,510,"Missouri","St. Louis city",1,32,5849,2879,2970
050,29,510,"Missouri","St. Louis city",1,33,5568,2825,2743
050,29,510,"Missouri","St. Louis city",1,34,5409,2726,2683
050,29,510,"Missouri","St. Louis city",1,35,5105,2566,2539
050,29,510,"Missouri","St. Louis city",1,36,4816,2408,2408
050,29,510,"Missouri","St. Louis city",1,37,4641,2309,2332
050,29,510,"Missouri","St. Louis city",1,38,4373,2211,2162
050,29,510,"Missouri","St. Louis city",1,39,4309,2178,2131
050,29,510,"Missouri","St. Louis city",1,40,4151,2072,2079
050,29,510,"Missouri","St. Louis city",1,41,3814,1898,1916
050,29,510,"Missouri","St. Louis city",1,42,3618,1827,1791
050,29,510,"Missouri","St. Louis city",1,43,3475,1671,1804
050,29,510,"Missouri","St. Louis city",1,44,3376,1676,1700
050,29,510,"Missouri","St. Louis city",1,45,3306,1615,1691
050,29,510,"Missouri","St. Louis city",1,46,3231,1591,1640
050,29,510,"Missouri","St. Louis city",1,47,3339,1624,1715
050,29,510,"Missouri","St. Louis city",1,48,3385,1652,1733
050,29,510,"Missouri","St. Louis city",1,49,3525,1760,1765
050,29,510,"Missouri","St. Louis city",1,50,3418,1671,1747
050,29,510,"Missouri","St. Louis city",1,51,3271,1607,1664
050,29,510,"Missouri","St. Louis city",1,52,3322,1673,1649
050,29,510,"Missouri","St. Louis city",1,53,3458,1732,1726
050,29,510,"Missouri","St. Louis city",1,54,3496,1730,1766
050,29,510,"Missouri","St. Louis city",1,55,3778,1916,1862
050,29,510,"Missouri","St. Louis city",1,56,3782,1936,1846
050,29,510,"Missouri","St. Louis city",1,57,3812,1914,1898
050,29,510,"Missouri","St. Louis city",1,58,3944,1968,1976
050,29,510,"Missouri","St. Louis city",1,59,3990,1984,2006
050,29,510,"Missouri","St. Louis city",1,60,4016,1993,2023
050,29,510,"Missouri","St. Louis city",1,61,4026,1949,2077
050,29,510,"Missouri","St. Louis city",1,62,4024,1919,2105
050,29,510,"Missouri","St. Louis city",1,63,3983,1874,2109
050,29,510,"Missouri","St. Louis city",1,64,3842,1828,2014
050,29,510,"Missouri","St. Louis city",1,65,3661,1720,1941
050,29,510,"Missouri","St. Louis city",1,66,3419,1636,1783
050,29,510,"Missouri","St. Louis city",1,67,3216,1540,1676
050,29,510,"Missouri","St. Louis city",1,68,3019,1471,1548
050,29,510,"Missouri","St. Louis city",1,69,2800,1335,1465
050,29,510,"Missouri","St. Louis city",1,70,2580,1159,1421
050,29,510,"Missouri","St. Louis city",1,71,2342,1054,1288
050,29,510,"Missouri","St. Louis city",1,72,2268,1004,1264
050,29,510,"Missouri","St. Louis city",1,73,2082,948,1134
050,29,510,"Missouri","St. Louis city",1,74,1541,683,858
050,29,510,"Missouri","St. Louis city",1,75,1522,686,836
050,29,510,"Missouri","St. Louis city",1,76,1410,614,796
050,29,510,"Missouri","St. Louis city",1,77,1362,583,779
050,29,510,"Missouri","St. Louis city",1,78,1212,507,705
050,29,510,"Missouri","St. Louis city",1,79,1070,451,619
050,29,510,"Missouri","St. Louis city",1,80,964,396,568
050,29,510,"Missouri","St. Louis city",1,81,928,364,564
050,29,510,"Missouri","St. Louis city",1,82,848,316,532
050,29,510,"Missouri","St. Louis city",1,83,737,269,468
050,29,510,"Missouri","St. Louis city",1,84,712,276,436
050,29,510,"Missouri","St. Louis city",1,85,4671,1440,3231
050,29,510,"Missouri","St. Louis city",2,0,3857,1989,1868
050,29,510,"Missouri","St. Louis city",2,1,3758,1938,1820
050,29,510,"Missouri","St. Louis city",2,2,3587,1832,1755
050,29,510,"Missouri","St. Louis city",2,3,3404,1733,1671
050,29,510,"Missouri","St. Louis city",2,4,3364,1713,1651
050,29,510,"Missouri","St. Louis city",2,5,3315,1687,1628
050,29,510,"Missouri","St. Louis city",2,6,3234,1667,1567
050,29,510,"Missouri","St. Louis city",2,7,3083,1591,1492
050,29,510,"Missouri","St. Louis city",2,8,3058,1563,1495
050,29,510,"Missouri","St. Louis city",2,9,3007,1528,1479
050,29,510,"Missouri","St. Louis city",2,10,2999,1577,1422
050,29,510,"Missouri","St. Louis city",2,11,3018,1567,1451
050,29,510,"Missouri","St. Louis city",2,12,3085,1572,1513
050,29,510,"Missouri","St. Louis city",2,13,3001,1536,1465
050,29,510,"Missouri","St. Louis city",2,14,2845,1470,1375
050,29,510,"Missouri","St. Louis city",2,15,2699,1378,1321
050,29,510,"Missouri","St. Louis city",2,16,2691,1348,1343
050,29,510,"Missouri","St. Louis city",2,17,2727,1340,1387
050,29,510,"Missouri","St. Louis city",2,18,3231,1547,1684
050,29,510,"Missouri","St. Louis city",2,19,4042,1938,2104
050,29,510,"Missouri","St. Louis city",2,20,3629,1720,1909
050,29,510,"Missouri","St. Louis city",2,21,3351,1597,1754
050,29,510,"Missouri","St. Louis city",2,22,3575,1699,1876
050,29,510,"Missouri","St. Louis city",2,23,4024,1906,2118
050,29,510,"Missouri","St. Louis city",2,24,4713,2208,2505
050,29,510,"Missouri","St. Louis city",2,25,5381,2510,2871
050,29,510,"Missouri","St. Louis city",2,26,5918,2836,3082
050,29,510,"Missouri","St. Louis city",2,27,6347,3090,3257
050,29,510,"Missouri","St. Louis city",2,28,6671,3223,3448
050,29,510,"Missouri","St. Louis city",2,29,6652,3231,3421
050,29,510,"Missouri","St. Louis city",2,30,6484,3177,3307
050,29,510,"Missouri","St. Louis city",2,31,6204,3076,3128
050,29,510,"Missouri","St. Louis city",2,32,5873,2903,2970
050,29,510,"Missouri","St. Louis city",2,33,5575,2814,2761
050,29,510,"Missouri","St. Louis city",2,34,5398,2726,2672
050,29,510,"Missouri","St. Louis city",2,35,5153,2596,2557
050,29,510,"Missouri","St. Louis city",2,36,4800,2400,2400
050,29,510,"Missouri","St. Louis city",2,37,4636,2303,2333
050,29,510,"Missouri","St. Louis city",2,38,4417,2223,2194
050,29,510,"Missouri","St. Louis city",2,39,4269,2158,2111
050,29,510,"Missouri","St. Louis city",2,40,4183,2093,2090
050,29,510,"Missouri","St. Louis city",2,41,3861,1920,1941
050,29,510,"Missouri","St. Louis city",2,42,3623,1819,1804
050,29,510,"Missouri","St. Louis city",2,43,3518,1709,1809
050,29,510,"Missouri","St. Louis city",2,44,3357,1661,1696
050,29,510,"Missouri","St. Louis city",2,45,3318,1622,1696
050,29,510,"Missouri","St. Louis city",2,46,3210,1579,1631
050,29,510,"Missouri","St. Louis city",2,47,3289,1603,1686
050,29,510,"Missouri","St. Louis city",2,48,3360,1645,1715
050,29,510,"Missouri","St. Louis city",2,49,3477,1721,1756
050,29,510,"Missouri","St. Louis city",2,50,3431,1686,1745
050,29,510,"Missouri","St. Louis city",2,51,3271,1599,1672
050,29,510,"Missouri","St. Louis city",2,52,3304,1653,1651
050,29,510,"Missouri","St. Louis city",2,53,3394,1701,1693
050,29,510,"Missouri","St. Louis city",2,54,3464,1715,1749
050,29,510,"Missouri","St. Louis city",2,55,3678,1853,1825
050,29,510,"Missouri","St. Louis city",2,56,3775,1927,1848
050,29,510,"Missouri","St. Louis city",2,57,3784,1909,1875
050,29,510,"Missouri","St. Louis city",2,58,3885,1939,1946
050,29,510,"Missouri","St. Louis city",2,59,3954,1964,1990
050,29,510,"Missouri","St. Louis city",2,60,3976,1970,2006
050,29,510,"Missouri","St. Louis city",2,61,4000,1949,2051
050,29,510,"Missouri","St. Louis city",2,62,3976,1897,2079
050,29,510,"Missouri","St. Louis city",2,63,3993,1886,2107
050,29,510,"Missouri","St. Louis city",2,64,3831,1816,2015
050,29,510,"Missouri","St. Louis city",2,65,3668,1729,1939
050,29,510,"Missouri","St. Louis city",2,66,3453,1640,1813
050,29,510,"Missouri","St. Louis city",2,67,3226,1544,1682
050,29,510,"Missouri","St. Louis city",2,68,3008,1458,1550
050,29,510,"Missouri","St. Louis city",2,69,2840,1358,1482
050,29,510,"Missouri","St. Louis city",2,70,2604,1186,1418
050,29,510,"Missouri","St. Louis city",2,71,2381,1073,1308
050,29,510,"Missouri","St. Louis city",2,72,2231,986,1245
050,29,510,"Missouri","St. Louis city",2,73,2175,979,1196
050,29,510,"Missouri","St. Louis city",2,74,1562,692,870
050,29,510,"Missouri","St. Louis city",2,75,1518,680,838
050,29,510,"Missouri","St. Louis city",2,76,1399,609,790
050,29,510,"Missouri","St. Louis city",2,77,1379,591,788
050,29,510,"Missouri","St. Louis city",2,78,1202,504,698
050,29,510,"Missouri","St. Louis city",2,79,1080,452,628
050,29,510,"Missouri","St. Louis city",2,80,975,403,572
050,29,510,"Missouri","St. Louis city",2,81,907,363,544
050,29,510,"Missouri","St. Louis city",2,82,849,316,533
050,29,510,"Missouri","St. Louis city",2,83,749,273,476
050,29,510,"Missouri","St. Louis city",2,84,700,265,435
050,29,510,"Missouri","St. Louis city",2,85,4603,1436,3167
050,29,510,"Missouri","St. Louis city",3,0,3788,1957,1831
050,29,510,"Missouri","St. Louis city",3,1,3468,1772,1696
050,29,510,"Missouri","St. Louis city",3,2,3374,1734,1640
050,29,510,"Missouri","St. Louis city",3,3,3327,1718,1609
050,29,510,"Missouri","St. Louis city",3,4,3154,1624,1530
050,29,510,"Missouri","St. Louis city",3,5,3173,1578,1595
050,29,510,"Missouri","St. Louis city",3,6,3080,1555,1525
050,29,510,"Missouri","St. Louis city",3,7,2993,1526,1467
050,29,510,"Missouri","St. Louis city",3,8,2900,1473,1427
050,29,510,"Missouri","St. Louis city",3,9,2865,1466,1399
050,29,510,"Missouri","St. Louis city",3,10,2860,1460,1400
050,29,510,"Missouri","St. Louis city",3,11,2863,1490,1373
050,29,510,"Missouri","St. Louis city",3,12,2878,1475,1403
050,29,510,"Missouri","St. Louis city",3,13,2914,1489,1425
050,29,510,"Missouri","St. Louis city",3,14,2895,1482,1413
050,29,510,"Missouri","St. Louis city",3,15,2711,1393,1318
050,29,510,"Missouri","St. Louis city",3,16,2613,1330,1283
050,29,510,"Missouri","St. Louis city",3,17,2664,1322,1342
050,29,510,"Missouri","St. Louis city",3,18,3203,1542,1661
050,29,510,"Missouri","St. Louis city",3,19,3932,1846,2086
050,29,510,"Missouri","St. Louis city",3,20,3476,1627,1849
050,29,510,"Missouri","St. Louis city",3,21,3250,1534,1716
050,29,510,"Missouri","St. Louis city",3,22,3343,1524,1819
050,29,510,"Missouri","St. Louis city",3,23,3865,1791,2074
050,29,510,"Missouri","St. Louis city",3,24,4568,2137,2431
050,29,510,"Missouri","St. Louis city",3,25,5089,2383,2706
050,29,510,"Missouri","St. Louis city",3,26,5431,2556,2875
050,29,510,"Missouri","St. Louis city",3,27,6012,2925,3087
050,29,510,"Missouri","St. Louis city",3,28,6247,3073,3174
050,29,510,"Missouri","St. Louis city",3,29,6430,3126,3304
050,29,510,"Missouri","St. Louis city",3,30,6420,3083,3337
050,29,510,"Missouri","St. Louis city",3,31,6122,3012,3110
050,29,510,"Missouri","St. Louis city",3,32,5867,2902,2965
050,29,510,"Missouri","St. Louis city",3,33,5468,2707,2761
050,29,510,"Missouri","St. Louis city",3,34,5241,2662,2579
050,29,510,"Missouri","St. Louis city",3,35,5102,2611,2491
050,29,510,"Missouri","St. Louis city",3,36,4872,2434,2438
050,29,510,"Missouri","St. Louis city",3,37,4507,2254,2253
050,29,510,"Missouri","St. Louis city",3,38,4414,2199,2215
050,29,510,"Missouri","St. Louis city",3,39,4242,2137,2105
050,29,510,"Missouri","St. Louis city",3,40,4156,2092,2064
050,29,510,"Missouri","St. Louis city",3,41,3994,1975,2019
050,29,510,"Missouri","St. Louis city",3,42,3724,1864,1860
050,29,510,"Missouri","St. Louis city",3,43,3507,1725,1782
050,29,510,"Missouri","St. Louis city",3,44,3444,1669,1775
050,29,510,"Missouri","St. Louis city",3,45,3249,1579,1670
050,29,510,"Missouri","St. Louis city",3,46,3189,1574,1615
050,29,510,"Missouri","St. Louis city",3,47,3123,1536,1587
050,29,510,"Missouri","St. Louis city",3,48,3203,1567,1636
050,29,510,"Missouri","St. Louis city",3,49,3229,1552,1677
050,29,510,"Missouri","St. Louis city",3,50,3329,1650,1679
050,29,510,"Missouri","St. Louis city",3,51,3327,1651,1676
050,29,510,"Missouri","St. Louis city",3,52,3197,1568,1629
050,29,510,"Missouri","St. Louis city",3,53,3184,1587,1597
050,29,510,"Missouri","St. Louis city",3,54,3273,1646,1627
050,29,510,"Missouri","St. Louis city",3,55,3348,1628,1720
050,29,510,"Missouri","St. Louis city",3,56,3584,1799,1785
050,29,510,"Missouri","St. Louis city",3,57,3633,1846,1787
050,29,510,"Missouri","St. Louis city",3,58,3671,1826,1845
050,29,510,"Missouri","St. Louis city",3,59,3840,1920,1920
050,29,510,"Missouri","St. Louis city",3,60,3824,1872,1952
050,29,510,"Missouri","St. Louis city",3,61,3894,1922,1972
050,29,510,"Missouri","St. Louis city",3,62,3878,1855,2023
050,29,510,"Missouri","St. Louis city",3,63,3789,1792,1997
050,29,510,"Missouri","St. Louis city",3,64,3849,1808,2041
050,29,510,"Missouri","St. Louis city",3,65,3673,1743,1930
050,29,510,"Missouri","St. Louis city",3,66,3551,1672,1879
050,29,510,"Missouri","St. Louis city",3,67,3350,1585,1765
050,29,510,"Missouri","St. Louis city",3,68,3077,1467,1610
050,29,510,"Missouri","St. Louis city",3,69,2878,1391,1487
050,29,510,"Missouri","St. Louis city",3,70,2736,1300,1436
050,29,510,"Missouri","St. Louis city",3,71,2497,1121,1376
050,29,510,"Missouri","St. Louis city",3,72,2279,1027,1252
050,29,510,"Missouri","St. Louis city",3,73,2124,944,1180
050,29,510,"Missouri","St. Louis city",3,74,2078,920,1158
050,29,510,"Missouri","St. Louis city",3,75,1465,650,815
050,29,510,"Missouri","St. Louis city",3,76,1405,615,790
050,29,510,"Missouri","St. Louis city",3,77,1321,577,744
050,29,510,"Missouri","St. Louis city",3,78,1297,537,760
050,29,510,"Missouri","St. Louis city",3,79,1129,478,651
050,29,510,"Missouri","St. Louis city",3,80,1005,417,588
050,29,510,"Missouri","St. Louis city",3,81,902,367,535
050,29,510,"Missouri","St. Louis city",3,82,857,342,515
050,29,510,"Missouri","St. Louis city",3,83,769,283,486
050,29,510,"Missouri","St. Louis city",3,84,678,231,447
050,29,510,"Missouri","St. Louis city",3,85,4492,1431,3061
050,29,510,"Missouri","St. Louis city",4,0,3498,1775,1723
050,29,510,"Missouri","St. Louis city",4,1,3462,1754,1708
050,29,510,"Missouri","St. Louis city",4,2,3175,1614,1561
050,29,510,"Missouri","St. Louis city",4,3,3158,1645,1513
050,29,510,"Missouri","St. Louis city",4,4,3092,1627,1465
050,29,510,"Missouri","St. Louis city",4,5,2929,1515,1414
050,29,510,"Missouri","St. Louis city",4,6,2878,1416,1462
050,29,510,"Missouri","St. Louis city",4,7,2860,1440,1420
050,29,510,"Missouri","St. Louis city",4,8,2854,1437,1417
050,29,510,"Missouri","St. Louis city",4,9,2693,1378,1315
050,29,510,"Missouri","St. Louis city",4,10,2701,1375,1326
050,29,510,"Missouri","St. Louis city",4,11,2707,1365,1342
050,29,510,"Missouri","St. Louis city",4,12,2703,1420,1283
050,29,510,"Missouri","St. Louis city",4,13,2725,1406,1319
050,29,510,"Missouri","St. Louis city",4,14,2780,1418,1362
050,29,510,"Missouri","St. Louis city",4,15,2771,1443,1328
050,29,510,"Missouri","St. Louis city",4,16,2621,1343,1278
050,29,510,"Missouri","St. Louis city",4,17,2572,1279,1293
050,29,510,"Missouri","St. Louis city",4,18,3131,1505,1626
050,29,510,"Missouri","St. Louis city",4,19,3865,1829,2036
050,29,510,"Missouri","St. Louis city",4,20,3351,1557,1794
050,29,510,"Missouri","St. Louis city",4,21,3183,1503,1680
050,29,510,"Missouri","St. Louis city",4,22,3261,1522,1739
050,29,510,"Missouri","St. Louis city",4,23,3646,1659,1987
050,29,510,"Missouri","St. Louis city",4,24,4414,2065,2349
050,29,510,"Missouri","St. Louis city",4,25,4823,2322,2501
050,29,510,"Missouri","St. Louis city",4,26,5102,2418,2684
050,29,510,"Missouri","St. Louis city",4,27,5479,2617,2862
050,29,510,"Missouri","St. Louis city",4,28,5966,2914,3052
050,29,510,"Missouri","St. Louis city",4,29,6054,2983,3071
050,29,510,"Missouri","St. Louis city",4,30,6185,2991,3194
050,29,510,"Missouri","St. Louis city",4,31,6116,2948,3168
050,29,510,"Missouri","St. Louis city",4,32,5795,2810,2985
050,29,510,"Missouri","St. Louis city",4,33,5535,2785,2750
050,29,510,"Missouri","St. Louis city",4,34,5163,2513,2650
050,29,510,"Missouri","St. Louis city",4,35,4975,2532,2443
050,29,510,"Missouri","St. Louis city",4,36,4789,2419,2370
050,29,510,"Missouri","St. Louis city",4,37,4553,2242,2311
050,29,510,"Missouri","St. Louis city",4,38,4234,2128,2106
050,29,510,"Missouri","St. Louis city",4,39,4175,2075,2100
050,29,510,"Missouri","St. Louis city",4,40,4075,2057,2018
050,29,510,"Missouri","St. Louis city",4,41,3983,1989,1994
050,29,510,"Missouri","St. Louis city",4,42,3840,1878,1962
050,29,510,"Missouri","St. Louis city",4,43,3540,1740,1800
050,29,510,"Missouri","St. Louis city",4,44,3368,1662,1706
050,29,510,"Missouri","St. Louis city",4,45,3339,1606,1733
050,29,510,"Missouri","St. Louis city",4,46,3132,1538,1594
050,29,510,"Missouri","St. Louis city",4,47,3108,1504,1604
050,29,510,"Missouri","St. Louis city",4,48,3031,1491,1540
050,29,510,"Missouri","St. Louis city",4,49,3130,1496,1634
050,29,510,"Missouri","St. Louis city",4,50,3101,1506,1595
050,29,510,"Missouri","St. Louis city",4,51,3284,1611,1673
050,29,510,"Missouri","St. Louis city",4,52,3259,1621,1638
050,29,510,"Missouri","St. Louis city",4,53,3099,1527,1572
050,29,510,"Missouri","St. Louis city",4,54,3105,1525,1580
050,29,510,"Missouri","St. Louis city",4,55,3111,1547,1564
050,29,510,"Missouri","St. Louis city",4,56,3223,1535,1688
050,29,510,"Missouri","St. Louis city",4,57,3426,1711,1715
050,29,510,"Missouri","St. Louis city",4,58,3513,1780,1733
050,29,510,"Missouri","St. Louis city",4,59,3529,1759,1770
050,29,510,"Missouri","St. Louis city",4,60,3676,1829,1847
050,29,510,"Missouri","St. Louis city",4,61,3687,1800,1887
050,29,510,"Missouri","St. Louis city",4,62,3697,1814,1883
050,29,510,"Missouri","St. Louis city",4,63,3732,1765,1967
050,29,510,"Missouri","St. Louis city",4,64,3657,1724,1933
050,29,510,"Missouri","St. Louis city",4,65,3656,1686,1970
050,29,510,"Missouri","St. Louis city",4,66,3515,1662,1853
050,29,510,"Missouri","St. Louis city",4,67,3401,1611,1790
050,29,510,"Missouri","St. Louis city",4,68,3205,1512,1693
050,29,510,"Missouri","St. Louis city",4,69,2945,1385,1560
050,29,510,"Missouri","St. Louis city",4,70,2748,1311,1437
050,29,510,"Missouri","St. Louis city",4,71,2640,1242,1398
050,29,510,"Missouri","St. Louis city",4,72,2405,1068,1337
050,29,510,"Missouri","St. Louis city",4,73,2146,962,1184
050,29,510,"Missouri","St. Louis city",4,74,2048,905,1143
050,29,510,"Missouri","St. Louis city",4,75,2012,898,1114
050,29,510,"Missouri","St. Louis city",4,76,1384,610,774
050,29,510,"Missouri","St. Louis city",4,77,1340,590,750
050,29,510,"Missouri","St. Louis city",4,78,1251,534,717
050,29,510,"Missouri","St. Louis city",4,79,1199,493,706
050,29,510,"Missouri","St. Louis city",4,80,1059,434,625
050,29,510,"Missouri","St. Louis city",4,81,933,383,550
050,29,510,"Missouri","St. Louis city",4,82,833,346,487
050,29,510,"Missouri","St. Louis city",4,83,768,301,467
050,29,510,"Missouri","St. Louis city",4,84,695,241,454
050,29,510,"Missouri","St. Louis city",4,85,4391,1427,2964
050,29,510,"Missouri","St. Louis city",5,0,3396,1727,1669
050,29,510,"Missouri","St. Louis city",5,1,3185,1637,1548
050,29,510,"Missouri","St. Louis city",5,2,3161,1609,1552
050,29,510,"Missouri","St. Louis city",5,3,2943,1523,1420
050,29,510,"Missouri","St. Louis city",5,4,2964,1505,1459
050,29,510,"Missouri","St. Louis city",5,5,2963,1535,1428
050,29,510,"Missouri","St. Louis city",5,6,2835,1473,1362
050,29,510,"Missouri","St. Louis city",5,7,2771,1378,1393
050,29,510,"Missouri","St. Louis city",5,8,2792,1397,1395
050,29,510,"Missouri","St. Louis city",5,9,2695,1346,1349
050,29,510,"Missouri","St. Louis city",5,10,2616,1325,1291
050,29,510,"Missouri","St. Louis city",5,11,2615,1325,1290
050,29,510,"Missouri","St. Louis city",5,12,2583,1314,1269
050,29,510,"Missouri","St. Louis city",5,13,2568,1341,1227
050,29,510,"Missouri","St. Louis city",5,14,2642,1382,1260
050,29,510,"Missouri","St. Louis city",5,15,2718,1377,1341
050,29,510,"Missouri","St. Louis city",5,16,2743,1428,1315
050,29,510,"Missouri","St. Louis city",5,17,2659,1358,1301
050,29,510,"Missouri","St. Louis city",5,18,3095,1485,1610
050,29,510,"Missouri","St. Louis city",5,19,3830,1837,1993
050,29,510,"Missouri","St. Louis city",5,20,3326,1569,1757
050,29,510,"Missouri","St. Louis city",5,21,3100,1439,1661
050,29,510,"Missouri","St. Louis city",5,22,3173,1468,1705
050,29,510,"Missouri","St. Louis city",5,23,3627,1695,1932
050,29,510,"Missouri","St. Louis city",5,24,4242,1914,2328
050,29,510,"Missouri","St. Louis city",5,25,4633,2146,2487
050,29,510,"Missouri","St. Louis city",5,26,4965,2311,2654
050,29,510,"Missouri","St. Louis city",5,27,5136,2477,2659
050,29,510,"Missouri","St. Louis city",5,28,5452,2650,2802
050,29,510,"Missouri","St. Louis city",5,29,5827,2834,2993
050,29,510,"Missouri","St. Louis city",5,30,5807,2901,2906
050,29,510,"Missouri","St. Louis city",5,31,5946,2857,3089
050,29,510,"Missouri","St. Louis city",5,32,5881,2835,3046
050,29,510,"Missouri","St. Louis city",5,33,5476,2680,2796
050,29,510,"Missouri","St. Louis city",5,34,5172,2564,2608
050,29,510,"Missouri","St. Louis city",5,35,4964,2398,2566
050,29,510,"Missouri","St. Louis city",5,36,4699,2386,2313
050,29,510,"Missouri","St. Louis city",5,37,4611,2347,2264
050,29,510,"Missouri","St. Louis city",5,38,4372,2171,2201
050,29,510,"Missouri","St. Louis city",5,39,4050,2015,2035
050,29,510,"Missouri","St. Louis city",5,40,4074,2067,2007
050,29,510,"Missouri","St. Louis city",5,41,3928,1960,1968
050,29,510,"Missouri","St. Louis city",5,42,3851,1894,1957
050,29,510,"Missouri","St. Louis city",5,43,3739,1811,1928
050,29,510,"Missouri","St. Louis city",5,44,3466,1700,1766
050,29,510,"Missouri","St. Louis city",5,45,3304,1626,1678
050,29,510,"Missouri","St. Louis city",5,46,3207,1523,1684
050,29,510,"Missouri","St. Louis city",5,47,3013,1465,1548
050,29,510,"Missouri","St. Louis city",5,48,3017,1489,1528
050,29,510,"Missouri","St. Louis city",5,49,2938,1435,1503
050,29,510,"Missouri","St. Louis city",5,50,3005,1426,1579
050,29,510,"Missouri","St. Louis city",5,51,3055,1485,1570
050,29,510,"Missouri","St. Louis city",5,52,3248,1598,1650
050,29,510,"Missouri","St. Louis city",5,53,3224,1612,1612
050,29,510,"Missouri","St. Louis city",5,54,2973,1472,1501
050,29,510,"Missouri","St. Louis city",5,55,2995,1445,1550
050,29,510,"Missouri","St. Louis city",5,56,3018,1502,1516
050,29,510,"Missouri","St. Louis city",5,57,3154,1477,1677
050,29,510,"Missouri","St. Louis city",5,58,3346,1648,1698
050,29,510,"Missouri","St. Louis city",5,59,3400,1718,1682
050,29,510,"Missouri","St. Louis city",5,60,3405,1677,1728
050,29,510,"Missouri","St. Louis city",5,61,3578,1794,1784
050,29,510,"Missouri","St. Louis city",5,62,3586,1746,1840
050,29,510,"Missouri","St. Louis city",5,63,3597,1760,1837
050,29,510,"Missouri","St. Louis city",5,64,3616,1699,1917
050,29,510,"Missouri","St. Louis city",5,65,3497,1597,1900
050,29,510,"Missouri","St. Louis city",5,66,3506,1611,1895
050,29,510,"Missouri","St. Louis city",5,67,3424,1631,1793
050,29,510,"Missouri","St. Louis city",5,68,3304,1563,1741
050,29,510,"Missouri","St. Louis city",5,69,3104,1464,1640
050,29,510,"Missouri","St. Louis city",5,70,2843,1324,1519
050,29,510,"Missouri","St. Louis city",5,71,2669,1257,1412
050,29,510,"Missouri","St. Louis city",5,72,2553,1197,1356
050,29,510,"Missouri","St. Louis city",5,73,2292,1016,1276
050,29,510,"Missouri","St. Louis city",5,74,2079,927,1152
050,29,510,"Missouri","St. Louis city",5,75,1965,876,1089
050,29,510,"Missouri","St. Louis city",5,76,1909,831,1078
050,29,510,"Missouri","St. Louis city",5,77,1321,580,741
050,29,510,"Missouri","St. Louis city",5,78,1290,550,740
050,29,510,"Missouri","St. Louis city",5,79,1187,506,681
050,29,510,"Missouri","St. Louis city",5,80,1109,445,664
050,29,510,"Missouri","St. Louis city",5,81,996,413,583
050,29,510,"Missouri","St. Louis city",5,82,862,355,507
050,29,510,"Missouri","St. Louis city",5,83,754,312,442
050,29,510,"Missouri","St. Louis city",5,84,700,262,438
050,29,510,"Missouri","St. Louis city",5,85,4420,1439,2981

