"SUMLEV","STATE","COUNTY","STNAME","CTYNAME","YEAR","AGE","TOT_POP","TOT_MALE","TOT_FEMALE"
050,17,001,"Illinois","Adams County",1,0,746,374,372
050,17,001,"Illinois","Adams County",1,1,784,374,410
050,17,001,"Illinois","Adams County",1,2,810,417,393
050,17,001,"Illinois","Adams County",1,3,859,463,396
050,17,001,"Illinois","Adams County",1,4,856,453,403
050,17,001,"Illinois","Adams County",1,5,843,410,433
050,17,001,"Illinois","Adams County",1,6,842,439,403
050,17,001,"Illinois","Adams County",1,7,800,423,377
050,17,001,"Illinois","Adams County",1,8,793,425,368
050,17,001,"Illinois","Adams County",1,9,840,455,385
050,17,001,"Illinois","Adams County",1,10,849,437,412
050,17,001,"Illinois","Adams County",1,11,855,432,423
050,17,001,"Illinois","Adams County",1,12,861,432,429
050,17,001,"Illinois","Adams County",1,13,903,467,436
050,17,001,"Illinois","Adams County",1,14,892,450,442
050,17,001,"Illinois","Adams County",1,15,847,448,399
050,17,001,"Illinois","Adams County",1,16,842,459,383
050,17,001,"Illinois","Adams County",1,17,841,407,434
050,17,001,"Illinois","Adams County",1,18,770,391,379
050,17,001,"Illinois","Adams County",1,19,759,392,367
050,17,001,"Illinois","Adams County",1,20,727,381,346
050,17,001,"Illinois","Adams County",1,21,762,393,369
050,17,001,"Illinois","Adams County",1,22,733,362,371
050,17,001,"Illinois","Adams County",1,23,695,349,346
050,17,001,"Illinois","Adams County",1,24,711,357,354
050,17,001,"Illinois","Adams County",1,25,732,354,378
050,17,001,"Illinois","Adams County",1,26,749,369,380
050,17,001,"Illinois","Adams County",1,27,770,390,380
050,17,001,"Illinois","Adams County",1,28,794,396,398
050,17,001,"Illinois","Adams County",1,29,822,394,428
050,17,001,"Illinois","Adams County",1,30,776,380,396
050,17,001,"Illinois","Adams County",1,31,777,395,382
050,17,001,"Illinois","Adams County",1,32,803,399,404
050,17,001,"Illinois","Adams County",1,33,799,397,402
050,17,001,"Illinois","Adams County",1,34,795,407,388
050,17,001,"Illinois","Adams County",1,35,807,406,401
050,17,001,"Illinois","Adams County",1,36,799,391,408
050,17,001,"Illinois","Adams County",1,37,806,410,396
050,17,001,"Illinois","Adams County",1,38,839,417,422
050,17,001,"Illinois","Adams County",1,39,825,419,406
050,17,001,"Illinois","Adams County",1,40,800,414,386
050,17,001,"Illinois","Adams County",1,41,781,420,361
050,17,001,"Illinois","Adams County",1,42,746,381,365
050,17,001,"Illinois","Adams County",1,43,681,330,351
050,17,001,"Illinois","Adams County",1,44,696,352,344
050,17,001,"Illinois","Adams County",1,45,718,374,344
050,17,001,"Illinois","Adams County",1,46,673,348,325
050,17,001,"Illinois","Adams County",1,47,695,358,337
050,17,001,"Illinois","Adams County",1,48,754,366,388
050,17,001,"Illinois","Adams County",1,49,793,391,402
050,17,001,"Illinois","Adams County",1,50,726,357,369
050,17,001,"Illinois","Adams County",1,51,789,391,398
050,17,001,"Illinois","Adams County",1,52,774,376,398
050,17,001,"Illinois","Adams County",1,53,812,392,420
050,17,001,"Illinois","Adams County",1,54,839,421,418
050,17,001,"Illinois","Adams County",1,55,864,425,439
050,17,001,"Illinois","Adams County",1,56,916,463,453
050,17,001,"Illinois","Adams County",1,57,914,469,445
050,17,001,"Illinois","Adams County",1,58,998,494,504
050,17,001,"Illinois","Adams County",1,59,1006,489,517
050,17,001,"Illinois","Adams County",1,60,947,454,493
050,17,001,"Illinois","Adams County",1,61,925,474,451
050,17,001,"Illinois","Adams County",1,62,898,464,434
050,17,001,"Illinois","Adams County",1,63,888,457,431
050,17,001,"Illinois","Adams County",1,64,904,421,483
050,17,001,"Illinois","Adams County",1,65,875,414,461
050,17,001,"Illinois","Adams County",1,66,822,390,432
050,17,001,"Illinois","Adams County",1,67,771,367,404
050,17,001,"Illinois","Adams County",1,68,778,387,391
050,17,001,"Illinois","Adams County",1,69,721,364,357
050,17,001,"Illinois","Adams County",1,70,708,357,351
050,17,001,"Illinois","Adams County",1,71,692,333,359
050,17,001,"Illinois","Adams County",1,72,687,323,364
050,17,001,"Illinois","Adams County",1,73,662,302,360
050,17,001,"Illinois","Adams County",1,74,447,185,262
050,17,001,"Illinois","Adams County",1,75,472,218,254
050,17,001,"Illinois","Adams County",1,76,503,238,265
050,17,001,"Illinois","Adams County",1,77,510,234,276
050,17,001,"Illinois","Adams County",1,78,442,201,241
050,17,001,"Illinois","Adams County",1,79,387,167,220
050,17,001,"Illinois","Adams County",1,80,361,155,206
050,17,001,"Illinois","Adams County",1,81,348,150,198
050,17,001,"Illinois","Adams County",1,82,335,147,188
050,17,001,"Illinois","Adams County",1,83,307,141,166
050,17,001,"Illinois","Adams County",1,84,297,138,159
050,17,001,"Illinois","Adams County",1,85,1954,785,1169
050,17,001,"Illinois","Adams County",2,0,731,372,359
050,17,001,"Illinois","Adams County",2,1,768,369,399
050,17,001,"Illinois","Adams County",2,2,806,408,398
050,17,001,"Illinois","Adams County",2,3,840,447,393
050,17,001,"Illinois","Adams County",2,4,853,452,401
050,17,001,"Illinois","Adams County",2,5,845,421,424
050,17,001,"Illinois","Adams County",2,6,846,433,413
050,17,001,"Illinois","Adams County",2,7,808,427,381
050,17,001,"Illinois","Adams County",2,8,789,422,367
050,17,001,"Illinois","Adams County",2,9,823,444,379
050,17,001,"Illinois","Adams County",2,10,843,439,404
050,17,001,"Illinois","Adams County",2,11,846,430,416
050,17,001,"Illinois","Adams County",2,12,864,435,429
050,17,001,"Illinois","Adams County",2,13,890,456,434
050,17,001,"Illinois","Adams County",2,14,892,451,441
050,17,001,"Illinois","Adams County",2,15,856,447,409
050,17,001,"Illinois","Adams County",2,16,848,458,390
050,17,001,"Illinois","Adams County",2,17,843,420,423
050,17,001,"Illinois","Adams County",2,18,768,388,380
050,17,001,"Illinois","Adams County",2,19,760,391,369
050,17,001,"Illinois","Adams County",2,20,733,382,351
050,17,001,"Illinois","Adams County",2,21,759,391,368
050,17,001,"Illinois","Adams County",2,22,735,364,371
050,17,001,"Illinois","Adams County",2,23,702,352,350
050,17,001,"Illinois","Adams County",2,24,702,353,349
050,17,001,"Illinois","Adams County",2,25,723,353,370
050,17,001,"Illinois","Adams County",2,26,742,364,378
050,17,001,"Illinois","Adams County",2,27,764,386,378
050,17,001,"Illinois","Adams County",2,28,792,397,395
050,17,001,"Illinois","Adams County",2,29,812,393,419
050,17,001,"Illinois","Adams County",2,30,793,387,406
050,17,001,"Illinois","Adams County",2,31,774,391,383
050,17,001,"Illinois","Adams County",2,32,797,398,399
050,17,001,"Illinois","Adams County",2,33,796,396,400
050,17,001,"Illinois","Adams County",2,34,791,402,389
050,17,001,"Illinois","Adams County",2,35,806,407,399
050,17,001,"Illinois","Adams County",2,36,794,392,402
050,17,001,"Illinois","Adams County",2,37,806,407,399
050,17,001,"Illinois","Adams County",2,38,831,417,414
050,17,001,"Illinois","Adams County",2,39,825,419,406
050,17,001,"Illinois","Adams County",2,40,811,416,395
050,17,001,"Illinois","Adams County",2,41,787,420,367
050,17,001,"Illinois","Adams County",2,42,746,386,360
050,17,001,"Illinois","Adams County",2,43,702,344,358
050,17,001,"Illinois","Adams County",2,44,681,342,339
050,17,001,"Illinois","Adams County",2,45,715,369,346
050,17,001,"Illinois","Adams County",2,46,680,352,328
050,17,001,"Illinois","Adams County",2,47,686,352,334
050,17,001,"Illinois","Adams County",2,48,736,363,373
050,17,001,"Illinois","Adams County",2,49,791,390,401
050,17,001,"Illinois","Adams County",2,50,745,365,380
050,17,001,"Illinois","Adams County",2,51,771,381,390
050,17,001,"Illinois","Adams County",2,52,776,379,397
050,17,001,"Illinois","Adams County",2,53,804,389,415
050,17,001,"Illinois","Adams County",2,54,829,412,417
050,17,001,"Illinois","Adams County",2,55,856,424,432
050,17,001,"Illinois","Adams County",2,56,904,455,449
050,17,001,"Illinois","Adams County",2,57,916,468,448
050,17,001,"Illinois","Adams County",2,58,975,484,491
050,17,001,"Illinois","Adams County",2,59,1006,489,517
050,17,001,"Illinois","Adams County",2,60,955,459,496
050,17,001,"Illinois","Adams County",2,61,922,464,458
050,17,001,"Illinois","Adams County",2,62,897,462,435
050,17,001,"Illinois","Adams County",2,63,893,462,431
050,17,001,"Illinois","Adams County",2,64,887,421,466
050,17,001,"Illinois","Adams County",2,65,878,416,462
050,17,001,"Illinois","Adams County",2,66,836,395,441
050,17,001,"Illinois","Adams County",2,67,776,368,408
050,17,001,"Illinois","Adams County",2,68,767,378,389
050,17,001,"Illinois","Adams County",2,69,738,373,365
050,17,001,"Illinois","Adams County",2,70,707,357,350
050,17,001,"Illinois","Adams County",2,71,696,337,359
050,17,001,"Illinois","Adams County",2,72,677,321,356
050,17,001,"Illinois","Adams County",2,73,694,319,375
050,17,001,"Illinois","Adams County",2,74,463,196,267
050,17,001,"Illinois","Adams County",2,75,464,209,255
050,17,001,"Illinois","Adams County",2,76,489,230,259
050,17,001,"Illinois","Adams County",2,77,510,235,275
050,17,001,"Illinois","Adams County",2,78,447,203,244
050,17,001,"Illinois","Adams County",2,79,397,174,223
050,17,001,"Illinois","Adams County",2,80,362,156,206
050,17,001,"Illinois","Adams County",2,81,347,150,197
050,17,001,"Illinois","Adams County",2,82,335,146,189
050,17,001,"Illinois","Adams County",2,83,310,143,167
050,17,001,"Illinois","Adams County",2,84,294,138,156
050,17,001,"Illinois","Adams County",2,85,1960,793,1167
050,17,001,"Illinois","Adams County",3,0,735,368,367
050,17,001,"Illinois","Adams County",3,1,723,368,355
050,17,001,"Illinois","Adams County",3,2,766,364,402
050,17,001,"Illinois","Adams County",3,3,803,416,387
050,17,001,"Illinois","Adams County",3,4,812,431,381
050,17,001,"Illinois","Adams County",3,5,846,450,396
050,17,001,"Illinois","Adams County",3,6,837,422,415
050,17,001,"Illinois","Adams County",3,7,847,429,418
050,17,001,"Illinois","Adams County",3,8,798,425,373
050,17,001,"Illinois","Adams County",3,9,791,426,365
050,17,001,"Illinois","Adams County",3,10,816,440,376
050,17,001,"Illinois","Adams County",3,11,840,439,401
050,17,001,"Illinois","Adams County",3,12,833,424,409
050,17,001,"Illinois","Adams County",3,13,856,429,427
050,17,001,"Illinois","Adams County",3,14,873,442,431
050,17,001,"Illinois","Adams County",3,15,900,452,448
050,17,001,"Illinois","Adams County",3,16,848,450,398
050,17,001,"Illinois","Adams County",3,17,830,445,385
050,17,001,"Illinois","Adams County",3,18,760,395,365
050,17,001,"Illinois","Adams County",3,19,734,367,367
050,17,001,"Illinois","Adams County",3,20,745,383,362
050,17,001,"Illinois","Adams County",3,21,750,389,361
050,17,001,"Illinois","Adams County",3,22,752,373,379
050,17,001,"Illinois","Adams County",3,23,725,373,352
050,17,001,"Illinois","Adams County",3,24,693,354,339
050,17,001,"Illinois","Adams County",3,25,704,349,355
050,17,001,"Illinois","Adams County",3,26,723,362,361
050,17,001,"Illinois","Adams County",3,27,740,374,366
050,17,001,"Illinois","Adams County",3,28,773,382,391
050,17,001,"Illinois","Adams County",3,29,780,394,386
050,17,001,"Illinois","Adams County",3,30,820,401,419
050,17,001,"Illinois","Adams County",3,31,819,407,412
050,17,001,"Illinois","Adams County",3,32,795,404,391
050,17,001,"Illinois","Adams County",3,33,789,398,391
050,17,001,"Illinois","Adams County",3,34,780,383,397
050,17,001,"Illinois","Adams County",3,35,800,404,396
050,17,001,"Illinois","Adams County",3,36,787,394,393
050,17,001,"Illinois","Adams County",3,37,787,389,398
050,17,001,"Illinois","Adams County",3,38,802,402,400
050,17,001,"Illinois","Adams County",3,39,835,421,414
050,17,001,"Illinois","Adams County",3,40,815,409,406
050,17,001,"Illinois","Adams County",3,41,831,431,400
050,17,001,"Illinois","Adams County",3,42,769,407,362
050,17,001,"Illinois","Adams County",3,43,733,380,353
050,17,001,"Illinois","Adams County",3,44,680,337,343
050,17,001,"Illinois","Adams County",3,45,669,328,341
050,17,001,"Illinois","Adams County",3,46,707,366,341
050,17,001,"Illinois","Adams County",3,47,666,338,328
050,17,001,"Illinois","Adams County",3,48,687,355,332
050,17,001,"Illinois","Adams County",3,49,735,369,366
050,17,001,"Illinois","Adams County",3,50,777,377,400
050,17,001,"Illinois","Adams County",3,51,750,363,387
050,17,001,"Illinois","Adams County",3,52,768,380,388
050,17,001,"Illinois","Adams County",3,53,776,384,392
050,17,001,"Illinois","Adams County",3,54,791,383,408
050,17,001,"Illinois","Adams County",3,55,819,406,413
050,17,001,"Illinois","Adams County",3,56,846,415,431
050,17,001,"Illinois","Adams County",3,57,896,457,439
050,17,001,"Illinois","Adams County",3,58,892,453,439
050,17,001,"Illinois","Adams County",3,59,950,469,481
050,17,001,"Illinois","Adams County",3,60,984,475,509
050,17,001,"Illinois","Adams County",3,61,940,453,487
050,17,001,"Illinois","Adams County",3,62,914,458,456
050,17,001,"Illinois","Adams County",3,63,881,453,428
050,17,001,"Illinois","Adams County",3,64,867,444,423
050,17,001,"Illinois","Adams County",3,65,874,419,455
050,17,001,"Illinois","Adams County",3,66,863,406,457
050,17,001,"Illinois","Adams County",3,67,804,387,417
050,17,001,"Illinois","Adams County",3,68,762,361,401
050,17,001,"Illinois","Adams County",3,69,744,358,386
050,17,001,"Illinois","Adams County",3,70,711,362,349
050,17,001,"Illinois","Adams County",3,71,690,343,347
050,17,001,"Illinois","Adams County",3,72,682,328,354
050,17,001,"Illinois","Adams County",3,73,653,309,344
050,17,001,"Illinois","Adams County",3,74,671,305,366
050,17,001,"Illinois","Adams County",3,75,440,186,254
050,17,001,"Illinois","Adams County",3,76,445,202,243
050,17,001,"Illinois","Adams County",3,77,447,211,236
050,17,001,"Illinois","Adams County",3,78,495,224,271
050,17,001,"Illinois","Adams County",3,79,443,205,238
050,17,001,"Illinois","Adams County",3,80,363,157,206
050,17,001,"Illinois","Adams County",3,81,341,148,193
050,17,001,"Illinois","Adams County",3,82,330,144,186
050,17,001,"Illinois","Adams County",3,83,314,135,179
050,17,001,"Illinois","Adams County",3,84,287,134,153
050,17,001,"Illinois","Adams County",3,85,1915,776,1139
050,17,001,"Illinois","Adams County",4,0,702,353,349
050,17,001,"Illinois","Adams County",4,1,758,375,383
050,17,001,"Illinois","Adams County",4,2,727,384,343
050,17,001,"Illinois","Adams County",4,3,765,366,399
050,17,001,"Illinois","Adams County",4,4,796,414,382
050,17,001,"Illinois","Adams County",4,5,815,438,377
050,17,001,"Illinois","Adams County",4,6,839,443,396
050,17,001,"Illinois","Adams County",4,7,835,420,415
050,17,001,"Illinois","Adams County",4,8,839,417,422
050,17,001,"Illinois","Adams County",4,9,791,420,371
050,17,001,"Illinois","Adams County",4,10,786,416,370
050,17,001,"Illinois","Adams County",4,11,805,435,370
050,17,001,"Illinois","Adams County",4,12,827,428,399
050,17,001,"Illinois","Adams County",4,13,851,436,415
050,17,001,"Illinois","Adams County",4,14,862,427,435
050,17,001,"Illinois","Adams County",4,15,847,434,413
050,17,001,"Illinois","Adams County",4,16,886,445,441
050,17,001,"Illinois","Adams County",4,17,859,455,404
050,17,001,"Illinois","Adams County",4,18,756,414,342
050,17,001,"Illinois","Adams County",4,19,722,375,347
050,17,001,"Illinois","Adams County",4,20,710,362,348
050,17,001,"Illinois","Adams County",4,21,756,391,365
050,17,001,"Illinois","Adams County",4,22,749,372,377
050,17,001,"Illinois","Adams County",4,23,738,379,359
050,17,001,"Illinois","Adams County",4,24,740,371,369
050,17,001,"Illinois","Adams County",4,25,682,349,333
050,17,001,"Illinois","Adams County",4,26,671,344,327
050,17,001,"Illinois","Adams County",4,27,715,350,365
050,17,001,"Illinois","Adams County",4,28,726,360,366
050,17,001,"Illinois","Adams County",4,29,751,360,391
050,17,001,"Illinois","Adams County",4,30,778,385,393
050,17,001,"Illinois","Adams County",4,31,813,392,421
050,17,001,"Illinois","Adams County",4,32,812,402,410
050,17,001,"Illinois","Adams County",4,33,794,398,396
050,17,001,"Illinois","Adams County",4,34,785,400,385
050,17,001,"Illinois","Adams County",4,35,775,384,391
050,17,001,"Illinois","Adams County",4,36,802,402,400
050,17,001,"Illinois","Adams County",4,37,776,386,390
050,17,001,"Illinois","Adams County",4,38,783,392,391
050,17,001,"Illinois","Adams County",4,39,800,409,391
050,17,001,"Illinois","Adams County",4,40,826,420,406
050,17,001,"Illinois","Adams County",4,41,814,412,402
050,17,001,"Illinois","Adams County",4,42,798,403,395
050,17,001,"Illinois","Adams County",4,43,777,407,370
050,17,001,"Illinois","Adams County",4,44,727,373,354
050,17,001,"Illinois","Adams County",4,45,684,337,347
050,17,001,"Illinois","Adams County",4,46,654,326,328
050,17,001,"Illinois","Adams County",4,47,700,362,338
050,17,001,"Illinois","Adams County",4,48,671,342,329
050,17,001,"Illinois","Adams County",4,49,680,357,323
050,17,001,"Illinois","Adams County",4,50,731,364,367
050,17,001,"Illinois","Adams County",4,51,776,379,397
050,17,001,"Illinois","Adams County",4,52,745,356,389
050,17,001,"Illinois","Adams County",4,53,775,389,386
050,17,001,"Illinois","Adams County",4,54,756,374,382
050,17,001,"Illinois","Adams County",4,55,797,386,411
050,17,001,"Illinois","Adams County",4,56,815,409,406
050,17,001,"Illinois","Adams County",4,57,845,421,424
050,17,001,"Illinois","Adams County",4,58,882,448,434
050,17,001,"Illinois","Adams County",4,59,886,451,435
050,17,001,"Illinois","Adams County",4,60,940,466,474
050,17,001,"Illinois","Adams County",4,61,963,466,497
050,17,001,"Illinois","Adams County",4,62,922,444,478
050,17,001,"Illinois","Adams County",4,63,903,453,450
050,17,001,"Illinois","Adams County",4,64,856,433,423
050,17,001,"Illinois","Adams County",4,65,848,433,415
050,17,001,"Illinois","Adams County",4,66,857,401,456
050,17,001,"Illinois","Adams County",4,67,827,385,442
050,17,001,"Illinois","Adams County",4,68,785,376,409
050,17,001,"Illinois","Adams County",4,69,740,347,393
050,17,001,"Illinois","Adams County",4,70,713,343,370
050,17,001,"Illinois","Adams County",4,71,696,348,348
050,17,001,"Illinois","Adams County",4,72,671,336,335
050,17,001,"Illinois","Adams County",4,73,663,323,340
050,17,001,"Illinois","Adams County",4,74,635,293,342
050,17,001,"Illinois","Adams County",4,75,648,298,350
050,17,001,"Illinois","Adams County",4,76,432,183,249
050,17,001,"Illinois","Adams County",4,77,411,184,227
050,17,001,"Illinois","Adams County",4,78,443,206,237
050,17,001,"Illinois","Adams County",4,79,485,218,267
050,17,001,"Illinois","Adams County",4,80,407,187,220
050,17,001,"Illinois","Adams County",4,81,339,150,189
050,17,001,"Illinois","Adams County",4,82,324,144,180
050,17,001,"Illinois","Adams County",4,83,319,139,180
050,17,001,"Illinois","Adams County",4,84,287,123,164
050,17,001,"Illinois","Adams County",4,85,1879,776,1103
050,17,001,"Illinois","Adams County",5,0,695,353,342
050,17,001,"Illinois","Adams County",5,1,711,361,350
050,17,001,"Illinois","Adams County",5,2,749,371,378
050,17,001,"Illinois","Adams County",5,3,747,395,352
050,17,001,"Illinois","Adams County",5,4,777,370,407
050,17,001,"Illinois","Adams County",5,5,807,424,383
050,17,001,"Illinois","Adams County",5,6,813,437,376
050,17,001,"Illinois","Adams County",5,7,829,442,387
050,17,001,"Illinois","Adams County",5,8,857,438,419
050,17,001,"Illinois","Adams County",5,9,843,418,425
050,17,001,"Illinois","Adams County",5,10,789,419,370
050,17,001,"Illinois","Adams County",5,11,789,414,375
050,17,001,"Illinois","Adams County",5,12,809,436,373
050,17,001,"Illinois","Adams County",5,13,828,427,401
050,17,001,"Illinois","Adams County",5,14,853,428,425
050,17,001,"Illinois","Adams County",5,15,848,414,434
050,17,001,"Illinois","Adams County",5,16,849,438,411
050,17,001,"Illinois","Adams County",5,17,876,438,438
050,17,001,"Illinois","Adams County",5,18,769,417,352
050,17,001,"Illinois","Adams County",5,19,722,388,334
050,17,001,"Illinois","Adams County",5,20,713,376,337
050,17,001,"Illinois","Adams County",5,21,746,375,371
050,17,001,"Illinois","Adams County",5,22,751,386,365
050,17,001,"Illinois","Adams County",5,23,735,361,374
050,17,001,"Illinois","Adams County",5,24,735,390,345
050,17,001,"Illinois","Adams County",5,25,728,351,377
050,17,001,"Illinois","Adams County",5,26,680,356,324
050,17,001,"Illinois","Adams County",5,27,683,335,348
050,17,001,"Illinois","Adams County",5,28,702,350,352
050,17,001,"Illinois","Adams County",5,29,735,369,366
050,17,001,"Illinois","Adams County",5,30,772,376,396
050,17,001,"Illinois","Adams County",5,31,809,404,405
050,17,001,"Illinois","Adams County",5,32,822,402,420
050,17,001,"Illinois","Adams County",5,33,805,400,405
050,17,001,"Illinois","Adams County",5,34,795,389,406
050,17,001,"Illinois","Adams County",5,35,786,398,388
050,17,001,"Illinois","Adams County",5,36,777,387,390
050,17,001,"Illinois","Adams County",5,37,797,400,397
050,17,001,"Illinois","Adams County",5,38,773,381,392
050,17,001,"Illinois","Adams County",5,39,775,392,383
050,17,001,"Illinois","Adams County",5,40,800,409,391
050,17,001,"Illinois","Adams County",5,41,843,433,410
050,17,001,"Illinois","Adams County",5,42,787,403,384
050,17,001,"Illinois","Adams County",5,43,807,408,399
050,17,001,"Illinois","Adams County",5,44,753,399,354
050,17,001,"Illinois","Adams County",5,45,719,368,351
050,17,001,"Illinois","Adams County",5,46,684,339,345
050,17,001,"Illinois","Adams County",5,47,650,322,328
050,17,001,"Illinois","Adams County",5,48,703,362,341
050,17,001,"Illinois","Adams County",5,49,682,348,334
050,17,001,"Illinois","Adams County",5,50,685,356,329
050,17,001,"Illinois","Adams County",5,51,734,364,370
050,17,001,"Illinois","Adams County",5,52,762,369,393
050,17,001,"Illinois","Adams County",5,53,739,356,383
050,17,001,"Illinois","Adams County",5,54,752,382,370
050,17,001,"Illinois","Adams County",5,55,746,366,380
050,17,001,"Illinois","Adams County",5,56,798,384,414
050,17,001,"Illinois","Adams County",5,57,810,406,404
050,17,001,"Illinois","Adams County",5,58,828,407,421
050,17,001,"Illinois","Adams County",5,59,873,447,426
050,17,001,"Illinois","Adams County",5,60,887,455,432
050,17,001,"Illinois","Adams County",5,61,930,464,466
050,17,001,"Illinois","Adams County",5,62,950,453,497
050,17,001,"Illinois","Adams County",5,63,915,438,477
050,17,001,"Illinois","Adams County",5,64,890,437,453
050,17,001,"Illinois","Adams County",5,65,860,445,415
050,17,001,"Illinois","Adams County",5,66,844,428,416
050,17,001,"Illinois","Adams County",5,67,820,382,438
050,17,001,"Illinois","Adams County",5,68,814,376,438
050,17,001,"Illinois","Adams County",5,69,775,372,403
050,17,001,"Illinois","Adams County",5,70,706,330,376
050,17,001,"Illinois","Adams County",5,71,695,333,362
050,17,001,"Illinois","Adams County",5,72,679,342,337
050,17,001,"Illinois","Adams County",5,73,642,326,316
050,17,001,"Illinois","Adams County",5,74,649,313,336
050,17,001,"Illinois","Adams County",5,75,620,285,335
050,17,001,"Illinois","Adams County",5,76,638,298,340
050,17,001,"Illinois","Adams County",5,77,401,170,231
050,17,001,"Illinois","Adams County",5,78,404,178,226
050,17,001,"Illinois","Adams County",5,79,444,206,238
050,17,001,"Illinois","Adams County",5,80,449,203,246
050,17,001,"Illinois","Adams County",5,81,379,180,199
050,17,001,"Illinois","Adams County",5,82,328,148,180
050,17,001,"Illinois","Adams County",5,83,313,139,174
050,17,001,"Illinois","Adams County",5,84,295,130,165
050,17,001,"Illinois","Adams County",5,85,1880,776,1104
050,17,003,"Illinois","Alexander County",1,0,42,21,21
050,17,003,"Illinois","Alexander County",1,1,47,21,26
050,17,003,"Illinois","Alexander County",1,2,57,22,35
050,17,003,"Illinois","Alexander County",1,3,62,29,33
050,17,003,"Illinois","Alexander County",1,4,50,28,22
050,17,003,"Illinois","Alexander County",1,5,73,39,34
050,17,003,"Illinois","Alexander County",1,6,75,45,30
050,17,003,"Illinois","Alexander County",1,7,71,40,31
050,17,003,"Illinois","Alexander County",1,8,72,41,31
050,17,003,"Illinois","Alexander County",1,9,65,28,37
050,17,003,"Illinois","Alexander County",1,10,58,26,32
050,17,003,"Illinois","Alexander County",1,11,52,24,28
050,17,003,"Illinois","Alexander County",1,12,65,34,31
050,17,003,"Illinois","Alexander County",1,13,67,33,34
050,17,003,"Illinois","Alexander County",1,14,72,36,36
050,17,003,"Illinois","Alexander County",1,15,69,38,31
050,17,003,"Illinois","Alexander County",1,16,64,34,30
050,17,003,"Illinois","Alexander County",1,17,66,36,30
050,17,003,"Illinois","Alexander County",1,18,64,29,35
050,17,003,"Illinois","Alexander County",1,19,41,24,17
050,17,003,"Illinois","Alexander County",1,20,41,21,20
050,17,003,"Illinois","Alexander County",1,21,38,20,18
050,17,003,"Illinois","Alexander County",1,22,44,21,23
050,17,003,"Illinois","Alexander County",1,23,36,16,20
050,17,003,"Illinois","Alexander County",1,24,43,21,22
050,17,003,"Illinois","Alexander County",1,25,44,22,22
050,17,003,"Illinois","Alexander County",1,26,50,23,27
050,17,003,"Illinois","Alexander County",1,27,63,34,29
050,17,003,"Illinois","Alexander County",1,28,57,33,24
050,17,003,"Illinois","Alexander County",1,29,49,27,22
050,17,003,"Illinois","Alexander County",1,30,54,22,32
050,17,003,"Illinois","Alexander County",1,31,52,23,29
050,17,003,"Illinois","Alexander County",1,32,41,21,20
050,17,003,"Illinois","Alexander County",1,33,50,29,21
050,17,003,"Illinois","Alexander County",1,34,46,26,20
050,17,003,"Illinois","Alexander County",1,35,51,27,24
050,17,003,"Illinois","Alexander County",1,36,55,30,25
050,17,003,"Illinois","Alexander County",1,37,40,21,19
050,17,003,"Illinois","Alexander County",1,38,52,27,25
050,17,003,"Illinois","Alexander County",1,39,62,32,30
050,17,003,"Illinois","Alexander County",1,40,56,29,27
050,17,003,"Illinois","Alexander County",1,41,58,29,29
050,17,003,"Illinois","Alexander County",1,42,49,27,22
050,17,003,"Illinois","Alexander County",1,43,48,21,27
050,17,003,"Illinois","Alexander County",1,44,65,27,38
050,17,003,"Illinois","Alexander County",1,45,57,25,32
050,17,003,"Illinois","Alexander County",1,46,45,22,23
050,17,003,"Illinois","Alexander County",1,47,56,27,29
050,17,003,"Illinois","Alexander County",1,48,63,30,33
050,17,003,"Illinois","Alexander County",1,49,70,30,40
050,17,003,"Illinois","Alexander County",1,50,57,25,32
050,17,003,"Illinois","Alexander County",1,51,59,29,30
050,17,003,"Illinois","Alexander County",1,52,63,37,26
050,17,003,"Illinois","Alexander County",1,53,82,44,38
050,17,003,"Illinois","Alexander County",1,54,78,40,38
050,17,003,"Illinois","Alexander County",1,55,91,43,48
050,17,003,"Illinois","Alexander County",1,56,93,47,46
050,17,003,"Illinois","Alexander County",1,57,84,38,46
050,17,003,"Illinois","Alexander County",1,58,93,47,46
050,17,003,"Illinois","Alexander County",1,59,85,48,37
050,17,003,"Illinois","Alexander County",1,60,88,43,45
050,17,003,"Illinois","Alexander County",1,61,88,37,51
050,17,003,"Illinois","Alexander County",1,62,87,45,42
050,17,003,"Illinois","Alexander County",1,63,83,42,41
050,17,003,"Illinois","Alexander County",1,64,75,37,38
050,17,003,"Illinois","Alexander County",1,65,88,42,46
050,17,003,"Illinois","Alexander County",1,66,94,50,44
050,17,003,"Illinois","Alexander County",1,67,95,47,48
050,17,003,"Illinois","Alexander County",1,68,91,41,50
050,17,003,"Illinois","Alexander County",1,69,81,36,45
050,17,003,"Illinois","Alexander County",1,70,65,30,35
050,17,003,"Illinois","Alexander County",1,71,66,29,37
050,17,003,"Illinois","Alexander County",1,72,69,37,32
050,17,003,"Illinois","Alexander County",1,73,66,30,36
050,17,003,"Illinois","Alexander County",1,74,35,16,19
050,17,003,"Illinois","Alexander County",1,75,42,20,22
050,17,003,"Illinois","Alexander County",1,76,36,14,22
050,17,003,"Illinois","Alexander County",1,77,48,23,25
050,17,003,"Illinois","Alexander County",1,78,47,17,30
050,17,003,"Illinois","Alexander County",1,79,38,14,24
050,17,003,"Illinois","Alexander County",1,80,37,22,15
050,17,003,"Illinois","Alexander County",1,81,33,16,17
050,17,003,"Illinois","Alexander County",1,82,32,14,18
050,17,003,"Illinois","Alexander County",1,83,25,8,17
050,17,003,"Illinois","Alexander County",1,84,30,16,14
050,17,003,"Illinois","Alexander County",1,85,148,55,93
050,17,003,"Illinois","Alexander County",2,0,41,22,19
050,17,003,"Illinois","Alexander County",2,1,44,20,24
050,17,003,"Illinois","Alexander County",2,2,52,21,31
050,17,003,"Illinois","Alexander County",2,3,60,28,32
050,17,003,"Illinois","Alexander County",2,4,53,29,24
050,17,003,"Illinois","Alexander County",2,5,67,36,31
050,17,003,"Illinois","Alexander County",2,6,71,41,30
050,17,003,"Illinois","Alexander County",2,7,71,41,30
050,17,003,"Illinois","Alexander County",2,8,71,40,31
050,17,003,"Illinois","Alexander County",2,9,65,31,34
050,17,003,"Illinois","Alexander County",2,10,57,26,31
050,17,003,"Illinois","Alexander County",2,11,53,24,29
050,17,003,"Illinois","Alexander County",2,12,61,31,30
050,17,003,"Illinois","Alexander County",2,13,65,33,32
050,17,003,"Illinois","Alexander County",2,14,70,35,35
050,17,003,"Illinois","Alexander County",2,15,68,37,31
050,17,003,"Illinois","Alexander County",2,16,63,34,29
050,17,003,"Illinois","Alexander County",2,17,65,36,29
050,17,003,"Illinois","Alexander County",2,18,60,30,30
050,17,003,"Illinois","Alexander County",2,19,45,25,20
050,17,003,"Illinois","Alexander County",2,20,41,22,19
050,17,003,"Illinois","Alexander County",2,21,39,21,18
050,17,003,"Illinois","Alexander County",2,22,43,21,22
050,17,003,"Illinois","Alexander County",2,23,38,17,21
050,17,003,"Illinois","Alexander County",2,24,40,20,20
050,17,003,"Illinois","Alexander County",2,25,44,23,21
050,17,003,"Illinois","Alexander County",2,26,50,24,26
050,17,003,"Illinois","Alexander County",2,27,59,31,28
050,17,003,"Illinois","Alexander County",2,28,57,32,25
050,17,003,"Illinois","Alexander County",2,29,51,28,23
050,17,003,"Illinois","Alexander County",2,30,54,23,31
050,17,003,"Illinois","Alexander County",2,31,53,24,29
050,17,003,"Illinois","Alexander County",2,32,42,20,22
050,17,003,"Illinois","Alexander County",2,33,46,27,19
050,17,003,"Illinois","Alexander County",2,34,48,28,20
050,17,003,"Illinois","Alexander County",2,35,50,27,23
050,17,003,"Illinois","Alexander County",2,36,54,30,24
050,17,003,"Illinois","Alexander County",2,37,42,23,19
050,17,003,"Illinois","Alexander County",2,38,49,25,24
050,17,003,"Illinois","Alexander County",2,39,60,31,29
050,17,003,"Illinois","Alexander County",2,40,54,27,27
050,17,003,"Illinois","Alexander County",2,41,56,28,28
050,17,003,"Illinois","Alexander County",2,42,50,27,23
050,17,003,"Illinois","Alexander County",2,43,49,23,26
050,17,003,"Illinois","Alexander County",2,44,61,25,36
050,17,003,"Illinois","Alexander County",2,45,57,24,33
050,17,003,"Illinois","Alexander County",2,46,46,22,24
050,17,003,"Illinois","Alexander County",2,47,53,26,27
050,17,003,"Illinois","Alexander County",2,48,62,30,32
050,17,003,"Illinois","Alexander County",2,49,68,30,38
050,17,003,"Illinois","Alexander County",2,50,60,26,34
050,17,003,"Illinois","Alexander County",2,51,58,28,30
050,17,003,"Illinois","Alexander County",2,52,62,35,27
050,17,003,"Illinois","Alexander County",2,53,77,42,35
050,17,003,"Illinois","Alexander County",2,54,77,40,37
050,17,003,"Illinois","Alexander County",2,55,89,43,46
050,17,003,"Illinois","Alexander County",2,56,91,46,45
050,17,003,"Illinois","Alexander County",2,57,86,41,45
050,17,003,"Illinois","Alexander County",2,58,91,45,46
050,17,003,"Illinois","Alexander County",2,59,86,48,38
050,17,003,"Illinois","Alexander County",2,60,86,44,42
050,17,003,"Illinois","Alexander County",2,61,85,37,48
050,17,003,"Illinois","Alexander County",2,62,85,41,44
050,17,003,"Illinois","Alexander County",2,63,83,41,42
050,17,003,"Illinois","Alexander County",2,64,75,37,38
050,17,003,"Illinois","Alexander County",2,65,84,40,44
050,17,003,"Illinois","Alexander County",2,66,94,50,44
050,17,003,"Illinois","Alexander County",2,67,93,47,46
050,17,003,"Illinois","Alexander County",2,68,90,41,49
050,17,003,"Illinois","Alexander County",2,69,83,37,46
050,17,003,"Illinois","Alexander County",2,70,68,31,37
050,17,003,"Illinois","Alexander County",2,71,66,30,36
050,17,003,"Illinois","Alexander County",2,72,64,32,32
050,17,003,"Illinois","Alexander County",2,73,71,34,37
050,17,003,"Illinois","Alexander County",2,74,39,18,21
050,17,003,"Illinois","Alexander County",2,75,38,18,20
050,17,003,"Illinois","Alexander County",2,76,37,16,21
050,17,003,"Illinois","Alexander County",2,77,46,21,25
050,17,003,"Illinois","Alexander County",2,78,46,18,28
050,17,003,"Illinois","Alexander County",2,79,39,14,25
050,17,003,"Illinois","Alexander County",2,80,37,20,17
050,17,003,"Illinois","Alexander County",2,81,34,18,16
050,17,003,"Illinois","Alexander County",2,82,32,14,18
050,17,003,"Illinois","Alexander County",2,83,25,8,17
050,17,003,"Illinois","Alexander County",2,84,28,13,15
050,17,003,"Illinois","Alexander County",2,85,146,54,92
050,17,003,"Illinois","Alexander County",3,0,53,28,25
050,17,003,"Illinois","Alexander County",3,1,38,19,19
050,17,003,"Illinois","Alexander County",3,2,49,23,26
050,17,003,"Illinois","Alexander County",3,3,51,18,33
050,17,003,"Illinois","Alexander County",3,4,61,31,30
050,17,003,"Illinois","Alexander County",3,5,50,25,25
050,17,003,"Illinois","Alexander County",3,6,66,36,30
050,17,003,"Illinois","Alexander County",3,7,72,38,34
050,17,003,"Illinois","Alexander County",3,8,73,42,31
050,17,003,"Illinois","Alexander County",3,9,67,37,30
050,17,003,"Illinois","Alexander County",3,10,64,30,34
050,17,003,"Illinois","Alexander County",3,11,56,27,29
050,17,003,"Illinois","Alexander County",3,12,59,28,31
050,17,003,"Illinois","Alexander County",3,13,61,29,32
050,17,003,"Illinois","Alexander County",3,14,69,39,30
050,17,003,"Illinois","Alexander County",3,15,72,37,35
050,17,003,"Illinois","Alexander County",3,16,64,35,29
050,17,003,"Illinois","Alexander County",3,17,64,33,31
050,17,003,"Illinois","Alexander County",3,18,57,33,24
050,17,003,"Illinois","Alexander County",3,19,49,26,23
050,17,003,"Illinois","Alexander County",3,20,43,21,22
050,17,003,"Illinois","Alexander County",3,21,38,23,15
050,17,003,"Illinois","Alexander County",3,22,32,16,16
050,17,003,"Illinois","Alexander County",3,23,45,22,23
050,17,003,"Illinois","Alexander County",3,24,41,18,23
050,17,003,"Illinois","Alexander County",3,25,36,22,14
050,17,003,"Illinois","Alexander County",3,26,44,22,22
050,17,003,"Illinois","Alexander County",3,27,39,20,19
050,17,003,"Illinois","Alexander County",3,28,53,30,23
050,17,003,"Illinois","Alexander County",3,29,59,35,24
050,17,003,"Illinois","Alexander County",3,30,52,26,26
050,17,003,"Illinois","Alexander County",3,31,54,22,32
050,17,003,"Illinois","Alexander County",3,32,57,28,29
050,17,003,"Illinois","Alexander County",3,33,39,17,22
050,17,003,"Illinois","Alexander County",3,34,49,29,20
050,17,003,"Illinois","Alexander County",3,35,49,30,19
050,17,003,"Illinois","Alexander County",3,36,47,25,22
050,17,003,"Illinois","Alexander County",3,37,55,28,27
050,17,003,"Illinois","Alexander County",3,38,39,22,17
050,17,003,"Illinois","Alexander County",3,39,49,25,24
050,17,003,"Illinois","Alexander County",3,40,60,30,30
050,17,003,"Illinois","Alexander County",3,41,55,24,31
050,17,003,"Illinois","Alexander County",3,42,57,29,28
050,17,003,"Illinois","Alexander County",3,43,54,28,26
050,17,003,"Illinois","Alexander County",3,44,46,22,24
050,17,003,"Illinois","Alexander County",3,45,56,24,32
050,17,003,"Illinois","Alexander County",3,46,55,23,32
050,17,003,"Illinois","Alexander County",3,47,46,22,24
050,17,003,"Illinois","Alexander County",3,48,53,26,27
050,17,003,"Illinois","Alexander County",3,49,55,27,28
050,17,003,"Illinois","Alexander County",3,50,65,26,39
050,17,003,"Illinois","Alexander County",3,51,56,23,33
050,17,003,"Illinois","Alexander County",3,52,60,31,29
050,17,003,"Illinois","Alexander County",3,53,61,35,26
050,17,003,"Illinois","Alexander County",3,54,77,42,35
050,17,003,"Illinois","Alexander County",3,55,74,37,37
050,17,003,"Illinois","Alexander County",3,56,87,43,44
050,17,003,"Illinois","Alexander County",3,57,87,44,43
050,17,003,"Illinois","Alexander County",3,58,83,38,45
050,17,003,"Illinois","Alexander County",3,59,84,40,44
050,17,003,"Illinois","Alexander County",3,60,89,53,36
050,17,003,"Illinois","Alexander County",3,61,80,40,40
050,17,003,"Illinois","Alexander County",3,62,82,35,47
050,17,003,"Illinois","Alexander County",3,63,81,40,41
050,17,003,"Illinois","Alexander County",3,64,83,42,41
050,17,003,"Illinois","Alexander County",3,65,70,32,38
050,17,003,"Illinois","Alexander County",3,66,85,41,44
050,17,003,"Illinois","Alexander County",3,67,87,48,39
050,17,003,"Illinois","Alexander County",3,68,89,43,46
050,17,003,"Illinois","Alexander County",3,69,86,37,49
050,17,003,"Illinois","Alexander County",3,70,76,35,41
050,17,003,"Illinois","Alexander County",3,71,62,29,33
050,17,003,"Illinois","Alexander County",3,72,65,30,35
050,17,003,"Illinois","Alexander County",3,73,59,30,29
050,17,003,"Illinois","Alexander County",3,74,58,27,31
050,17,003,"Illinois","Alexander County",3,75,36,15,21
050,17,003,"Illinois","Alexander County",3,76,37,18,19
050,17,003,"Illinois","Alexander County",3,77,35,14,21
050,17,003,"Illinois","Alexander County",3,78,38,16,22
050,17,003,"Illinois","Alexander County",3,79,45,18,27
050,17,003,"Illinois","Alexander County",3,80,35,11,24
050,17,003,"Illinois","Alexander County",3,81,29,15,14
050,17,003,"Illinois","Alexander County",3,82,34,17,17
050,17,003,"Illinois","Alexander County",3,83,29,14,15
050,17,003,"Illinois","Alexander County",3,84,23,7,16
050,17,003,"Illinois","Alexander County",3,85,146,56,90
050,17,003,"Illinois","Alexander County",4,0,36,19,17
050,17,003,"Illinois","Alexander County",4,1,49,27,22
050,17,003,"Illinois","Alexander County",4,2,43,20,23
050,17,003,"Illinois","Alexander County",4,3,46,23,23
050,17,003,"Illinois","Alexander County",4,4,48,19,29
050,17,003,"Illinois","Alexander County",4,5,57,28,29
050,17,003,"Illinois","Alexander County",4,6,49,21,28
050,17,003,"Illinois","Alexander County",4,7,71,38,33
050,17,003,"Illinois","Alexander County",4,8,65,34,31
050,17,003,"Illinois","Alexander County",4,9,66,33,33
050,17,003,"Illinois","Alexander County",4,10,69,36,33
050,17,003,"Illinois","Alexander County",4,11,63,29,34
050,17,003,"Illinois","Alexander County",4,12,53,25,28
050,17,003,"Illinois","Alexander County",4,13,58,24,34
050,17,003,"Illinois","Alexander County",4,14,57,28,29
050,17,003,"Illinois","Alexander County",4,15,67,36,31
050,17,003,"Illinois","Alexander County",4,16,67,35,32
050,17,003,"Illinois","Alexander County",4,17,67,36,31
050,17,003,"Illinois","Alexander County",4,18,60,31,29
050,17,003,"Illinois","Alexander County",4,19,42,26,16
050,17,003,"Illinois","Alexander County",4,20,45,21,24
050,17,003,"Illinois","Alexander County",4,21,42,20,22
050,17,003,"Illinois","Alexander County",4,22,33,18,15
050,17,003,"Illinois","Alexander County",4,23,35,15,20
050,17,003,"Illinois","Alexander County",4,24,46,23,23
050,17,003,"Illinois","Alexander County",4,25,41,16,25
050,17,003,"Illinois","Alexander County",4,26,30,17,13
050,17,003,"Illinois","Alexander County",4,27,41,21,20
050,17,003,"Illinois","Alexander County",4,28,40,20,20
050,17,003,"Illinois","Alexander County",4,29,52,28,24
050,17,003,"Illinois","Alexander County",4,30,62,35,27
050,17,003,"Illinois","Alexander County",4,31,51,25,26
050,17,003,"Illinois","Alexander County",4,32,46,22,24
050,17,003,"Illinois","Alexander County",4,33,52,23,29
050,17,003,"Illinois","Alexander County",4,34,40,19,21
050,17,003,"Illinois","Alexander County",4,35,48,28,20
050,17,003,"Illinois","Alexander County",4,36,50,28,22
050,17,003,"Illinois","Alexander County",4,37,45,23,22
050,17,003,"Illinois","Alexander County",4,38,54,27,27
050,17,003,"Illinois","Alexander County",4,39,35,20,15
050,17,003,"Illinois","Alexander County",4,40,41,23,18
050,17,003,"Illinois","Alexander County",4,41,60,31,29
050,17,003,"Illinois","Alexander County",4,42,57,27,30
050,17,003,"Illinois","Alexander County",4,43,57,29,28
050,17,003,"Illinois","Alexander County",4,44,49,25,24
050,17,003,"Illinois","Alexander County",4,45,41,17,24
050,17,003,"Illinois","Alexander County",4,46,57,25,32
050,17,003,"Illinois","Alexander County",4,47,57,26,31
050,17,003,"Illinois","Alexander County",4,48,49,26,23
050,17,003,"Illinois","Alexander County",4,49,48,23,25
050,17,003,"Illinois","Alexander County",4,50,50,22,28
050,17,003,"Illinois","Alexander County",4,51,61,25,36
050,17,003,"Illinois","Alexander County",4,52,55,23,32
050,17,003,"Illinois","Alexander County",4,53,63,31,32
050,17,003,"Illinois","Alexander County",4,54,60,35,25
050,17,003,"Illinois","Alexander County",4,55,79,43,36
050,17,003,"Illinois","Alexander County",4,56,76,38,38
050,17,003,"Illinois","Alexander County",4,57,84,44,40
050,17,003,"Illinois","Alexander County",4,58,86,42,44
050,17,003,"Illinois","Alexander County",4,59,82,37,45
050,17,003,"Illinois","Alexander County",4,60,80,40,40
050,17,003,"Illinois","Alexander County",4,61,81,47,34
050,17,003,"Illinois","Alexander County",4,62,78,38,40
050,17,003,"Illinois","Alexander County",4,63,79,32,47
050,17,003,"Illinois","Alexander County",4,64,81,39,42
050,17,003,"Illinois","Alexander County",4,65,79,40,39
050,17,003,"Illinois","Alexander County",4,66,74,33,41
050,17,003,"Illinois","Alexander County",4,67,79,38,41
050,17,003,"Illinois","Alexander County",4,68,89,47,42
050,17,003,"Illinois","Alexander County",4,69,88,42,46
050,17,003,"Illinois","Alexander County",4,70,74,34,40
050,17,003,"Illinois","Alexander County",4,71,75,36,39
050,17,003,"Illinois","Alexander County",4,72,58,27,31
050,17,003,"Illinois","Alexander County",4,73,62,30,32
050,17,003,"Illinois","Alexander County",4,74,51,26,25
050,17,003,"Illinois","Alexander County",4,75,54,24,30
050,17,003,"Illinois","Alexander County",4,76,34,15,19
050,17,003,"Illinois","Alexander County",4,77,35,17,18
050,17,003,"Illinois","Alexander County",4,78,30,12,18
050,17,003,"Illinois","Alexander County",4,79,33,15,18
050,17,003,"Illinois","Alexander County",4,80,40,16,24
050,17,003,"Illinois","Alexander County",4,81,30,9,21
050,17,003,"Illinois","Alexander County",4,82,25,11,14
050,17,003,"Illinois","Alexander County",4,83,31,15,16
050,17,003,"Illinois","Alexander County",4,84,25,13,12
050,17,003,"Illinois","Alexander County",4,85,143,57,86
050,17,003,"Illinois","Alexander County",5,0,30,16,14
050,17,003,"Illinois","Alexander County",5,1,33,14,19
050,17,003,"Illinois","Alexander County",5,2,53,29,24
050,17,003,"Illinois","Alexander County",5,3,43,22,21
050,17,003,"Illinois","Alexander County",5,4,57,28,29
050,17,003,"Illinois","Alexander County",5,5,47,20,27
050,17,003,"Illinois","Alexander County",5,6,55,23,32
050,17,003,"Illinois","Alexander County",5,7,49,21,28
050,17,003,"Illinois","Alexander County",5,8,66,35,31
050,17,003,"Illinois","Alexander County",5,9,64,34,30
050,17,003,"Illinois","Alexander County",5,10,63,30,33
050,17,003,"Illinois","Alexander County",5,11,68,36,32
050,17,003,"Illinois","Alexander County",5,12,69,30,39
050,17,003,"Illinois","Alexander County",5,13,52,23,29
050,17,003,"Illinois","Alexander County",5,14,57,22,35
050,17,003,"Illinois","Alexander County",5,15,59,31,28
050,17,003,"Illinois","Alexander County",5,16,73,40,33
050,17,003,"Illinois","Alexander County",5,17,67,36,31
050,17,003,"Illinois","Alexander County",5,18,60,30,30
050,17,003,"Illinois","Alexander County",5,19,39,20,19
050,17,003,"Illinois","Alexander County",5,20,44,25,19
050,17,003,"Illinois","Alexander County",5,21,46,22,24
050,17,003,"Illinois","Alexander County",5,22,36,16,20
050,17,003,"Illinois","Alexander County",5,23,35,22,13
050,17,003,"Illinois","Alexander County",5,24,33,13,20
050,17,003,"Illinois","Alexander County",5,25,40,18,22
050,17,003,"Illinois","Alexander County",5,26,39,16,23
050,17,003,"Illinois","Alexander County",5,27,31,17,14
050,17,003,"Illinois","Alexander County",5,28,39,22,17
050,17,003,"Illinois","Alexander County",5,29,43,23,20
050,17,003,"Illinois","Alexander County",5,30,43,23,20
050,17,003,"Illinois","Alexander County",5,31,60,34,26
050,17,003,"Illinois","Alexander County",5,32,51,28,23
050,17,003,"Illinois","Alexander County",5,33,42,21,21
050,17,003,"Illinois","Alexander County",5,34,52,25,27
050,17,003,"Illinois","Alexander County",5,35,38,16,22
050,17,003,"Illinois","Alexander County",5,36,49,29,20
050,17,003,"Illinois","Alexander County",5,37,50,26,24
050,17,003,"Illinois","Alexander County",5,38,47,21,26
050,17,003,"Illinois","Alexander County",5,39,58,28,30
050,17,003,"Illinois","Alexander County",5,40,31,18,13
050,17,003,"Illinois","Alexander County",5,41,43,22,21
050,17,003,"Illinois","Alexander County",5,42,58,30,28
050,17,003,"Illinois","Alexander County",5,43,66,31,35
050,17,003,"Illinois","Alexander County",5,44,59,28,31
050,17,003,"Illinois","Alexander County",5,45,45,23,22
050,17,003,"Illinois","Alexander County",5,46,39,15,24
050,17,003,"Illinois","Alexander County",5,47,50,20,30
050,17,003,"Illinois","Alexander County",5,48,52,27,25
050,17,003,"Illinois","Alexander County",5,49,48,24,24
050,17,003,"Illinois","Alexander County",5,50,45,19,26
050,17,003,"Illinois","Alexander County",5,51,50,22,28
050,17,003,"Illinois","Alexander County",5,52,58,24,34
050,17,003,"Illinois","Alexander County",5,53,55,24,31
050,17,003,"Illinois","Alexander County",5,54,65,33,32
050,17,003,"Illinois","Alexander County",5,55,60,35,25
050,17,003,"Illinois","Alexander County",5,56,78,42,36
050,17,003,"Illinois","Alexander County",5,57,66,38,28
050,17,003,"Illinois","Alexander County",5,58,83,45,38
050,17,003,"Illinois","Alexander County",5,59,86,40,46
050,17,003,"Illinois","Alexander County",5,60,83,37,46
050,17,003,"Illinois","Alexander County",5,61,77,37,40
050,17,003,"Illinois","Alexander County",5,62,80,46,34
050,17,003,"Illinois","Alexander County",5,63,71,35,36
050,17,003,"Illinois","Alexander County",5,64,79,32,47
050,17,003,"Illinois","Alexander County",5,65,76,34,42
050,17,003,"Illinois","Alexander County",5,66,80,40,40
050,17,003,"Illinois","Alexander County",5,67,67,31,36
050,17,003,"Illinois","Alexander County",5,68,76,35,41
050,17,003,"Illinois","Alexander County",5,69,91,47,44
050,17,003,"Illinois","Alexander County",5,70,79,39,40
050,17,003,"Illinois","Alexander County",5,71,70,32,38
050,17,003,"Illinois","Alexander County",5,72,73,34,39
050,17,003,"Illinois","Alexander County",5,73,54,27,27
050,17,003,"Illinois","Alexander County",5,74,49,24,25
050,17,003,"Illinois","Alexander County",5,75,49,24,25
050,17,003,"Illinois","Alexander County",5,76,51,24,27
050,17,003,"Illinois","Alexander County",5,77,34,13,21
050,17,003,"Illinois","Alexander County",5,78,31,15,16
050,17,003,"Illinois","Alexander County",5,79,27,12,15
050,17,003,"Illinois","Alexander County",5,80,29,13,16
050,17,003,"Illinois","Alexander County",5,81,37,14,23
050,17,003,"Illinois","Alexander County",5,82,25,5,20
050,17,003,"Illinois","Alexander County",5,83,23,8,15
050,17,003,"Illinois","Alexander County",5,84,28,13,15
050,17,003,"Illinois","Alexander County",5,85,139,62,77
050,17,005,"Illinois","Bond County",1,0,143,72,71
050,17,005,"Illinois","Bond County",1,1,135,69,66
050,17,005,"Illinois","Bond County",1,2,133,74,59
050,17,005,"Illinois","Bond County",1,3,149,73,76
050,17,005,"Illinois","Bond County",1,4,165,84,81
050,17,005,"Illinois","Bond County",1,5,179,94,85
050,17,005,"Illinois","Bond County",1,6,153,77,76
050,17,005,"Illinois","Bond County",1,7,170,79,91
050,17,005,"Illinois","Bond County",1,8,166,88,78
050,17,005,"Illinois","Bond County",1,9,155,79,76
050,17,005,"Illinois","Bond County",1,10,167,95,72
050,17,005,"Illinois","Bond County",1,11,173,96,77
050,17,005,"Illinois","Bond County",1,12,182,91,91
050,17,005,"Illinois","Bond County",1,13,197,100,97
050,17,005,"Illinois","Bond County",1,14,198,98,100
050,17,005,"Illinois","Bond County",1,15,188,97,91
050,17,005,"Illinois","Bond County",1,16,205,105,100
050,17,005,"Illinois","Bond County",1,17,202,107,95
050,17,005,"Illinois","Bond County",1,18,266,127,139
050,17,005,"Illinois","Bond County",1,19,450,245,205
050,17,005,"Illinois","Bond County",1,20,394,204,190
050,17,005,"Illinois","Bond County",1,21,292,161,131
050,17,005,"Illinois","Bond County",1,22,223,122,101
050,17,005,"Illinois","Bond County",1,23,190,112,78
050,17,005,"Illinois","Bond County",1,24,167,92,75
050,17,005,"Illinois","Bond County",1,25,190,109,81
050,17,005,"Illinois","Bond County",1,26,188,110,78
050,17,005,"Illinois","Bond County",1,27,209,124,85
050,17,005,"Illinois","Bond County",1,28,216,115,101
050,17,005,"Illinois","Bond County",1,29,225,122,103
050,17,005,"Illinois","Bond County",1,30,230,132,98
050,17,005,"Illinois","Bond County",1,31,236,148,88
050,17,005,"Illinois","Bond County",1,32,240,152,88
050,17,005,"Illinois","Bond County",1,33,245,152,93
050,17,005,"Illinois","Bond County",1,34,222,129,93
050,17,005,"Illinois","Bond County",1,35,234,138,96
050,17,005,"Illinois","Bond County",1,36,224,128,96
050,17,005,"Illinois","Bond County",1,37,209,117,92
050,17,005,"Illinois","Bond County",1,38,213,133,80
050,17,005,"Illinois","Bond County",1,39,209,129,80
050,17,005,"Illinois","Bond County",1,40,221,124,97
050,17,005,"Illinois","Bond County",1,41,211,112,99
050,17,005,"Illinois","Bond County",1,42,226,113,113
050,17,005,"Illinois","Bond County",1,43,204,110,94
050,17,005,"Illinois","Bond County",1,44,201,109,92
050,17,005,"Illinois","Bond County",1,45,191,105,86
050,17,005,"Illinois","Bond County",1,46,187,109,78
050,17,005,"Illinois","Bond County",1,47,180,110,70
050,17,005,"Illinois","Bond County",1,48,182,101,81
050,17,005,"Illinois","Bond County",1,49,200,105,95
050,17,005,"Illinois","Bond County",1,50,205,109,96
050,17,005,"Illinois","Bond County",1,51,195,105,90
050,17,005,"Illinois","Bond County",1,52,196,105,91
050,17,005,"Illinois","Bond County",1,53,202,115,87
050,17,005,"Illinois","Bond County",1,54,205,116,89
050,17,005,"Illinois","Bond County",1,55,223,116,107
050,17,005,"Illinois","Bond County",1,56,233,111,122
050,17,005,"Illinois","Bond County",1,57,241,120,121
050,17,005,"Illinois","Bond County",1,58,259,128,131
050,17,005,"Illinois","Bond County",1,59,249,129,120
050,17,005,"Illinois","Bond County",1,60,242,120,122
050,17,005,"Illinois","Bond County",1,61,247,123,124
050,17,005,"Illinois","Bond County",1,62,219,112,107
050,17,005,"Illinois","Bond County",1,63,226,115,111
050,17,005,"Illinois","Bond County",1,64,209,111,98
050,17,005,"Illinois","Bond County",1,65,217,109,108
050,17,005,"Illinois","Bond County",1,66,206,89,117
050,17,005,"Illinois","Bond County",1,67,198,94,104
050,17,005,"Illinois","Bond County",1,68,209,105,104
050,17,005,"Illinois","Bond County",1,69,196,96,100
050,17,005,"Illinois","Bond County",1,70,183,89,94
050,17,005,"Illinois","Bond County",1,71,172,86,86
050,17,005,"Illinois","Bond County",1,72,164,85,79
050,17,005,"Illinois","Bond County",1,73,158,81,77
050,17,005,"Illinois","Bond County",1,74,109,51,58
050,17,005,"Illinois","Bond County",1,75,96,43,53
050,17,005,"Illinois","Bond County",1,76,101,45,56
050,17,005,"Illinois","Bond County",1,77,119,55,64
050,17,005,"Illinois","Bond County",1,78,98,50,48
050,17,005,"Illinois","Bond County",1,79,85,43,42
050,17,005,"Illinois","Bond County",1,80,86,37,49
050,17,005,"Illinois","Bond County",1,81,75,25,50
050,17,005,"Illinois","Bond County",1,82,65,20,45
050,17,005,"Illinois","Bond County",1,83,61,30,31
050,17,005,"Illinois","Bond County",1,84,61,28,33
050,17,005,"Illinois","Bond County",1,85,380,131,249
050,17,005,"Illinois","Bond County",2,0,152,79,73
050,17,005,"Illinois","Bond County",2,1,135,69,66
050,17,005,"Illinois","Bond County",2,2,136,75,61
050,17,005,"Illinois","Bond County",2,3,144,72,72
050,17,005,"Illinois","Bond County",2,4,160,81,79
050,17,005,"Illinois","Bond County",2,5,173,92,81
050,17,005,"Illinois","Bond County",2,6,160,82,78
050,17,005,"Illinois","Bond County",2,7,166,79,87
050,17,005,"Illinois","Bond County",2,8,167,85,82
050,17,005,"Illinois","Bond County",2,9,158,83,75
050,17,005,"Illinois","Bond County",2,10,165,92,73
050,17,005,"Illinois","Bond County",2,11,172,97,75
050,17,005,"Illinois","Bond County",2,12,181,94,87
050,17,005,"Illinois","Bond County",2,13,191,96,95
050,17,005,"Illinois","Bond County",2,14,197,98,99
050,17,005,"Illinois","Bond County",2,15,188,95,93
050,17,005,"Illinois","Bond County",2,16,201,103,98
050,17,005,"Illinois","Bond County",2,17,202,106,96
050,17,005,"Illinois","Bond County",2,18,265,126,139
050,17,005,"Illinois","Bond County",2,19,448,244,204
050,17,005,"Illinois","Bond County",2,20,396,204,192
050,17,005,"Illinois","Bond County",2,21,290,162,128
050,17,005,"Illinois","Bond County",2,22,225,123,102
050,17,005,"Illinois","Bond County",2,23,187,110,77
050,17,005,"Illinois","Bond County",2,24,167,92,75
050,17,005,"Illinois","Bond County",2,25,188,109,79
050,17,005,"Illinois","Bond County",2,26,187,109,78
050,17,005,"Illinois","Bond County",2,27,206,123,83
050,17,005,"Illinois","Bond County",2,28,215,118,97
050,17,005,"Illinois","Bond County",2,29,228,123,105
050,17,005,"Illinois","Bond County",2,30,228,129,99
050,17,005,"Illinois","Bond County",2,31,236,150,86
050,17,005,"Illinois","Bond County",2,32,240,151,89
050,17,005,"Illinois","Bond County",2,33,246,153,93
050,17,005,"Illinois","Bond County",2,34,225,132,93
050,17,005,"Illinois","Bond County",2,35,230,136,94
050,17,005,"Illinois","Bond County",2,36,226,128,98
050,17,005,"Illinois","Bond County",2,37,210,118,92
050,17,005,"Illinois","Bond County",2,38,217,133,84
050,17,005,"Illinois","Bond County",2,39,204,124,80
050,17,005,"Illinois","Bond County",2,40,219,127,92
050,17,005,"Illinois","Bond County",2,41,211,112,99
050,17,005,"Illinois","Bond County",2,42,220,113,107
050,17,005,"Illinois","Bond County",2,43,209,111,98
050,17,005,"Illinois","Bond County",2,44,199,106,93
050,17,005,"Illinois","Bond County",2,45,192,105,87
050,17,005,"Illinois","Bond County",2,46,187,108,79
050,17,005,"Illinois","Bond County",2,47,180,109,71
050,17,005,"Illinois","Bond County",2,48,181,102,79
050,17,005,"Illinois","Bond County",2,49,195,103,92
050,17,005,"Illinois","Bond County",2,50,203,108,95
050,17,005,"Illinois","Bond County",2,51,196,105,91
050,17,005,"Illinois","Bond County",2,52,196,106,90
050,17,005,"Illinois","Bond County",2,53,198,112,86
050,17,005,"Illinois","Bond County",2,54,205,115,90
050,17,005,"Illinois","Bond County",2,55,216,114,102
050,17,005,"Illinois","Bond County",2,56,231,113,118
050,17,005,"Illinois","Bond County",2,57,241,120,121
050,17,005,"Illinois","Bond County",2,58,251,123,128
050,17,005,"Illinois","Bond County",2,59,252,130,122
050,17,005,"Illinois","Bond County",2,60,242,120,122
050,17,005,"Illinois","Bond County",2,61,245,124,121
050,17,005,"Illinois","Bond County",2,62,223,113,110
050,17,005,"Illinois","Bond County",2,63,227,116,111
050,17,005,"Illinois","Bond County",2,64,209,110,99
050,17,005,"Illinois","Bond County",2,65,214,109,105
050,17,005,"Illinois","Bond County",2,66,208,93,115
050,17,005,"Illinois","Bond County",2,67,198,92,106
050,17,005,"Illinois","Bond County",2,68,202,100,102
050,17,005,"Illinois","Bond County",2,69,197,98,99
050,17,005,"Illinois","Bond County",2,70,188,92,96
050,17,005,"Illinois","Bond County",2,71,172,86,86
050,17,005,"Illinois","Bond County",2,72,160,83,77
050,17,005,"Illinois","Bond County",2,73,167,84,83
050,17,005,"Illinois","Bond County",2,74,109,53,56
050,17,005,"Illinois","Bond County",2,75,100,45,55
050,17,005,"Illinois","Bond County",2,76,97,43,54
050,17,005,"Illinois","Bond County",2,77,114,53,61
050,17,005,"Illinois","Bond County",2,78,101,50,51
050,17,005,"Illinois","Bond County",2,79,87,44,43
050,17,005,"Illinois","Bond County",2,80,85,38,47
050,17,005,"Illinois","Bond County",2,81,78,28,50
050,17,005,"Illinois","Bond County",2,82,69,22,47
050,17,005,"Illinois","Bond County",2,83,60,26,34
050,17,005,"Illinois","Bond County",2,84,59,27,32
050,17,005,"Illinois","Bond County",2,85,379,131,248
050,17,005,"Illinois","Bond County",3,0,150,68,82
050,17,005,"Illinois","Bond County",3,1,151,81,70
050,17,005,"Illinois","Bond County",3,2,138,70,68
050,17,005,"Illinois","Bond County",3,3,134,71,63
050,17,005,"Illinois","Bond County",3,4,140,71,69
050,17,005,"Illinois","Bond County",3,5,162,90,72
050,17,005,"Illinois","Bond County",3,6,160,81,79
050,17,005,"Illinois","Bond County",3,7,154,76,78
050,17,005,"Illinois","Bond County",3,8,160,72,88
050,17,005,"Illinois","Bond County",3,9,170,89,81
050,17,005,"Illinois","Bond County",3,10,167,91,76
050,17,005,"Illinois","Bond County",3,11,161,91,70
050,17,005,"Illinois","Bond County",3,12,184,104,80
050,17,005,"Illinois","Bond County",3,13,182,95,87
050,17,005,"Illinois","Bond County",3,14,200,105,95
050,17,005,"Illinois","Bond County",3,15,200,101,99
050,17,005,"Illinois","Bond County",3,16,190,98,92
050,17,005,"Illinois","Bond County",3,17,208,99,109
050,17,005,"Illinois","Bond County",3,18,276,137,139
050,17,005,"Illinois","Bond County",3,19,448,245,203
050,17,005,"Illinois","Bond County",3,20,393,197,196
050,17,005,"Illinois","Bond County",3,21,287,164,123
050,17,005,"Illinois","Bond County",3,22,227,123,104
050,17,005,"Illinois","Bond County",3,23,177,104,73
050,17,005,"Illinois","Bond County",3,24,179,97,82
050,17,005,"Illinois","Bond County",3,25,175,109,66
050,17,005,"Illinois","Bond County",3,26,174,98,76
050,17,005,"Illinois","Bond County",3,27,199,128,71
050,17,005,"Illinois","Bond County",3,28,200,124,76
050,17,005,"Illinois","Bond County",3,29,207,111,96
050,17,005,"Illinois","Bond County",3,30,213,115,98
050,17,005,"Illinois","Bond County",3,31,245,154,91
050,17,005,"Illinois","Bond County",3,32,237,151,86
050,17,005,"Illinois","Bond County",3,33,251,154,97
050,17,005,"Illinois","Bond County",3,34,233,139,94
050,17,005,"Illinois","Bond County",3,35,236,141,95
050,17,005,"Illinois","Bond County",3,36,235,127,108
050,17,005,"Illinois","Bond County",3,37,221,121,100
050,17,005,"Illinois","Bond County",3,38,238,143,95
050,17,005,"Illinois","Bond County",3,39,202,112,90
050,17,005,"Illinois","Bond County",3,40,209,128,81
050,17,005,"Illinois","Bond County",3,41,213,123,90
050,17,005,"Illinois","Bond County",3,42,223,120,103
050,17,005,"Illinois","Bond County",3,43,215,109,106
050,17,005,"Illinois","Bond County",3,44,221,113,108
050,17,005,"Illinois","Bond County",3,45,187,97,90
050,17,005,"Illinois","Bond County",3,46,203,114,89
050,17,005,"Illinois","Bond County",3,47,189,109,80
050,17,005,"Illinois","Bond County",3,48,182,108,74
050,17,005,"Illinois","Bond County",3,49,174,97,77
050,17,005,"Illinois","Bond County",3,50,189,103,86
050,17,005,"Illinois","Bond County",3,51,203,109,94
050,17,005,"Illinois","Bond County",3,52,206,111,95
050,17,005,"Illinois","Bond County",3,53,198,107,91
050,17,005,"Illinois","Bond County",3,54,193,107,86
050,17,005,"Illinois","Bond County",3,55,195,108,87
050,17,005,"Illinois","Bond County",3,56,209,111,98
050,17,005,"Illinois","Bond County",3,57,226,113,113
050,17,005,"Illinois","Bond County",3,58,226,112,114
050,17,005,"Illinois","Bond County",3,59,253,128,125
050,17,005,"Illinois","Bond County",3,60,246,123,123
050,17,005,"Illinois","Bond County",3,61,246,122,124
050,17,005,"Illinois","Bond County",3,62,239,116,123
050,17,005,"Illinois","Bond County",3,63,221,112,109
050,17,005,"Illinois","Bond County",3,64,222,113,109
050,17,005,"Illinois","Bond County",3,65,204,107,97
050,17,005,"Illinois","Bond County",3,66,209,105,104
050,17,005,"Illinois","Bond County",3,67,206,87,119
050,17,005,"Illinois","Bond County",3,68,193,91,102
050,17,005,"Illinois","Bond County",3,69,196,96,100
050,17,005,"Illinois","Bond County",3,70,194,99,95
050,17,005,"Illinois","Bond County",3,71,183,87,96
050,17,005,"Illinois","Bond County",3,72,168,84,84
050,17,005,"Illinois","Bond County",3,73,153,80,73
050,17,005,"Illinois","Bond County",3,74,159,84,75
050,17,005,"Illinois","Bond County",3,75,98,44,54
050,17,005,"Illinois","Bond County",3,76,96,43,53
050,17,005,"Illinois","Bond County",3,77,84,36,48
050,17,005,"Illinois","Bond County",3,78,111,51,60
050,17,005,"Illinois","Bond County",3,79,92,44,48
050,17,005,"Illinois","Bond County",3,80,81,42,39
050,17,005,"Illinois","Bond County",3,81,80,37,43
050,17,005,"Illinois","Bond County",3,82,79,27,52
050,17,005,"Illinois","Bond County",3,83,66,19,47
050,17,005,"Illinois","Bond County",3,84,57,25,32
050,17,005,"Illinois","Bond County",3,85,362,133,229
050,17,005,"Illinois","Bond County",4,0,137,75,62
050,17,005,"Illinois","Bond County",4,1,136,64,72
050,17,005,"Illinois","Bond County",4,2,163,86,77
050,17,005,"Illinois","Bond County",4,3,136,71,65
050,17,005,"Illinois","Bond County",4,4,149,78,71
050,17,005,"Illinois","Bond County",4,5,142,69,73
050,17,005,"Illinois","Bond County",4,6,170,96,74
050,17,005,"Illinois","Bond County",4,7,164,82,82
050,17,005,"Illinois","Bond County",4,8,163,84,79
050,17,005,"Illinois","Bond County",4,9,157,77,80
050,17,005,"Illinois","Bond County",4,10,186,98,88
050,17,005,"Illinois","Bond County",4,11,165,85,80
050,17,005,"Illinois","Bond County",4,12,173,95,78
050,17,005,"Illinois","Bond County",4,13,188,107,81
050,17,005,"Illinois","Bond County",4,14,184,97,87
050,17,005,"Illinois","Bond County",4,15,197,100,97
050,17,005,"Illinois","Bond County",4,16,208,103,105
050,17,005,"Illinois","Bond County",4,17,189,96,93
050,17,005,"Illinois","Bond County",4,18,282,131,151
050,17,005,"Illinois","Bond County",4,19,455,246,209
050,17,005,"Illinois","Bond County",4,20,406,204,202
050,17,005,"Illinois","Bond County",4,21,291,158,133
050,17,005,"Illinois","Bond County",4,22,227,131,96
050,17,005,"Illinois","Bond County",4,23,185,106,79
050,17,005,"Illinois","Bond County",4,24,175,104,71
050,17,005,"Illinois","Bond County",4,25,181,102,79
050,17,005,"Illinois","Bond County",4,26,179,104,75
050,17,005,"Illinois","Bond County",4,27,186,110,76
050,17,005,"Illinois","Bond County",4,28,207,134,73
050,17,005,"Illinois","Bond County",4,29,213,128,85
050,17,005,"Illinois","Bond County",4,30,204,109,95
050,17,005,"Illinois","Bond County",4,31,235,137,98
050,17,005,"Illinois","Bond County",4,32,229,152,77
050,17,005,"Illinois","Bond County",4,33,242,155,87
050,17,005,"Illinois","Bond County",4,34,239,145,94
050,17,005,"Illinois","Bond County",4,35,223,137,86
050,17,005,"Illinois","Bond County",4,36,235,131,104
050,17,005,"Illinois","Bond County",4,37,230,125,105
050,17,005,"Illinois","Bond County",4,38,239,138,101
050,17,005,"Illinois","Bond County",4,39,213,120,93
050,17,005,"Illinois","Bond County",4,40,215,116,99
050,17,005,"Illinois","Bond County",4,41,198,120,78
050,17,005,"Illinois","Bond County",4,42,223,129,94
050,17,005,"Illinois","Bond County",4,43,211,112,99
050,17,005,"Illinois","Bond County",4,44,217,105,112
050,17,005,"Illinois","Bond County",4,45,209,105,104
050,17,005,"Illinois","Bond County",4,46,175,97,78
050,17,005,"Illinois","Bond County",4,47,194,110,84
050,17,005,"Illinois","Bond County",4,48,186,110,76
050,17,005,"Illinois","Bond County",4,49,174,98,76
050,17,005,"Illinois","Bond County",4,50,164,93,71
050,17,005,"Illinois","Bond County",4,51,194,107,87
050,17,005,"Illinois","Bond County",4,52,202,116,86
050,17,005,"Illinois","Bond County",4,53,200,107,93
050,17,005,"Illinois","Bond County",4,54,191,99,92
050,17,005,"Illinois","Bond County",4,55,181,98,83
050,17,005,"Illinois","Bond County",4,56,191,103,88
050,17,005,"Illinois","Bond County",4,57,202,109,93
050,17,005,"Illinois","Bond County",4,58,216,105,111
050,17,005,"Illinois","Bond County",4,59,226,112,114
050,17,005,"Illinois","Bond County",4,60,247,122,125
050,17,005,"Illinois","Bond County",4,61,240,122,118
050,17,005,"Illinois","Bond County",4,62,245,119,126
050,17,005,"Illinois","Bond County",4,63,236,115,121
050,17,005,"Illinois","Bond County",4,64,215,108,107
050,17,005,"Illinois","Bond County",4,65,221,116,105
050,17,005,"Illinois","Bond County",4,66,207,106,101
050,17,005,"Illinois","Bond County",4,67,206,103,103
050,17,005,"Illinois","Bond County",4,68,197,84,113
050,17,005,"Illinois","Bond County",4,69,187,90,97
050,17,005,"Illinois","Bond County",4,70,191,92,99
050,17,005,"Illinois","Bond County",4,71,189,94,95
050,17,005,"Illinois","Bond County",4,72,174,83,91
050,17,005,"Illinois","Bond County",4,73,159,77,82
050,17,005,"Illinois","Bond County",4,74,139,78,61
050,17,005,"Illinois","Bond County",4,75,149,80,69
050,17,005,"Illinois","Bond County",4,76,89,40,49
050,17,005,"Illinois","Bond County",4,77,89,41,48
050,17,005,"Illinois","Bond County",4,78,80,34,46
050,17,005,"Illinois","Bond County",4,79,102,47,55
050,17,005,"Illinois","Bond County",4,80,86,41,45
050,17,005,"Illinois","Bond County",4,81,78,39,39
050,17,005,"Illinois","Bond County",4,82,82,39,43
050,17,005,"Illinois","Bond County",4,83,75,26,49
050,17,005,"Illinois","Bond County",4,84,59,16,43
050,17,005,"Illinois","Bond County",4,85,342,119,223
050,17,005,"Illinois","Bond County",5,0,130,74,56
050,17,005,"Illinois","Bond County",5,1,137,70,67
050,17,005,"Illinois","Bond County",5,2,139,60,79
050,17,005,"Illinois","Bond County",5,3,159,84,75
050,17,005,"Illinois","Bond County",5,4,144,74,70
050,17,005,"Illinois","Bond County",5,5,147,76,71
050,17,005,"Illinois","Bond County",5,6,138,66,72
050,17,005,"Illinois","Bond County",5,7,169,91,78
050,17,005,"Illinois","Bond County",5,8,170,87,83
050,17,005,"Illinois","Bond County",5,9,157,77,80
050,17,005,"Illinois","Bond County",5,10,164,77,87
050,17,005,"Illinois","Bond County",5,11,183,95,88
050,17,005,"Illinois","Bond County",5,12,163,81,82
050,17,005,"Illinois","Bond County",5,13,170,91,79
050,17,005,"Illinois","Bond County",5,14,190,108,82
050,17,005,"Illinois","Bond County",5,15,179,93,86
050,17,005,"Illinois","Bond County",5,16,204,101,103
050,17,005,"Illinois","Bond County",5,17,201,101,100
050,17,005,"Illinois","Bond County",5,18,260,122,138
050,17,005,"Illinois","Bond County",5,19,466,247,219
050,17,005,"Illinois","Bond County",5,20,403,201,202
050,17,005,"Illinois","Bond County",5,21,293,167,126
050,17,005,"Illinois","Bond County",5,22,221,124,97
050,17,005,"Illinois","Bond County",5,23,179,109,70
050,17,005,"Illinois","Bond County",5,24,176,91,85
050,17,005,"Illinois","Bond County",5,25,200,116,84
050,17,005,"Illinois","Bond County",5,26,179,105,74
050,17,005,"Illinois","Bond County",5,27,194,118,76
050,17,005,"Illinois","Bond County",5,28,189,110,79
050,17,005,"Illinois","Bond County",5,29,226,137,89
050,17,005,"Illinois","Bond County",5,30,207,127,80
050,17,005,"Illinois","Bond County",5,31,218,132,86
050,17,005,"Illinois","Bond County",5,32,230,136,94
050,17,005,"Illinois","Bond County",5,33,231,154,77
050,17,005,"Illinois","Bond County",5,34,229,147,82
050,17,005,"Illinois","Bond County",5,35,237,146,91
050,17,005,"Illinois","Bond County",5,36,222,130,92
050,17,005,"Illinois","Bond County",5,37,227,130,97
050,17,005,"Illinois","Bond County",5,38,239,138,101
050,17,005,"Illinois","Bond County",5,39,208,111,97
050,17,005,"Illinois","Bond County",5,40,226,132,94
050,17,005,"Illinois","Bond County",5,41,204,101,103
050,17,005,"Illinois","Bond County",5,42,205,124,81
050,17,005,"Illinois","Bond County",5,43,222,131,91
050,17,005,"Illinois","Bond County",5,44,207,105,102
050,17,005,"Illinois","Bond County",5,45,210,100,110
050,17,005,"Illinois","Bond County",5,46,209,109,100
050,17,005,"Illinois","Bond County",5,47,177,101,76
050,17,005,"Illinois","Bond County",5,48,196,112,84
050,17,005,"Illinois","Bond County",5,49,189,104,85
050,17,005,"Illinois","Bond County",5,50,170,99,71
050,17,005,"Illinois","Bond County",5,51,162,91,71
050,17,005,"Illinois","Bond County",5,52,201,114,87
050,17,005,"Illinois","Bond County",5,53,191,110,81
050,17,005,"Illinois","Bond County",5,54,201,104,97
050,17,005,"Illinois","Bond County",5,55,185,94,91
050,17,005,"Illinois","Bond County",5,56,180,94,86
050,17,005,"Illinois","Bond County",5,57,185,104,81
050,17,005,"Illinois","Bond County",5,58,194,99,95
050,17,005,"Illinois","Bond County",5,59,218,111,107
050,17,005,"Illinois","Bond County",5,60,219,108,111
050,17,005,"Illinois","Bond County",5,61,251,128,123
050,17,005,"Illinois","Bond County",5,62,235,119,116
050,17,005,"Illinois","Bond County",5,63,238,117,121
050,17,005,"Illinois","Bond County",5,64,230,113,117
050,17,005,"Illinois","Bond County",5,65,206,103,103
050,17,005,"Illinois","Bond County",5,66,222,116,106
050,17,005,"Illinois","Bond County",5,67,204,103,101
050,17,005,"Illinois","Bond County",5,68,199,102,97
050,17,005,"Illinois","Bond County",5,69,196,85,111
050,17,005,"Illinois","Bond County",5,70,183,88,95
050,17,005,"Illinois","Bond County",5,71,185,87,98
050,17,005,"Illinois","Bond County",5,72,184,90,94
050,17,005,"Illinois","Bond County",5,73,168,80,88
050,17,005,"Illinois","Bond County",5,74,149,77,72
050,17,005,"Illinois","Bond County",5,75,131,71,60
050,17,005,"Illinois","Bond County",5,76,144,78,66
050,17,005,"Illinois","Bond County",5,77,85,40,45
050,17,005,"Illinois","Bond County",5,78,83,38,45
050,17,005,"Illinois","Bond County",5,79,76,33,43
050,17,005,"Illinois","Bond County",5,80,99,44,55
050,17,005,"Illinois","Bond County",5,81,86,39,47
050,17,005,"Illinois","Bond County",5,82,81,41,40
050,17,005,"Illinois","Bond County",5,83,76,37,39
050,17,005,"Illinois","Bond County",5,84,66,21,45
050,17,005,"Illinois","Bond County",5,85,344,110,234
050,17,007,"Illinois","Boone County",1,0,498,253,245
050,17,007,"Illinois","Boone County",1,1,525,256,269
050,17,007,"Illinois","Boone County",1,2,605,306,299
050,17,007,"Illinois","Boone County",1,3,642,354,288
050,17,007,"Illinois","Boone County",1,4,627,352,275
050,17,007,"Illinois","Boone County",1,5,645,337,308
050,17,007,"Illinois","Boone County",1,6,651,323,328
050,17,007,"Illinois","Boone County",1,7,648,326,322
050,17,007,"Illinois","Boone County",1,8,703,375,328
050,17,007,"Illinois","Boone County",1,9,702,362,340
050,17,007,"Illinois","Boone County",1,10,733,390,343
050,17,007,"Illinois","Boone County",1,11,799,427,372
050,17,007,"Illinois","Boone County",1,12,856,450,406
050,17,007,"Illinois","Boone County",1,13,912,465,447
050,17,007,"Illinois","Boone County",1,14,927,483,444
050,17,007,"Illinois","Boone County",1,15,878,429,449
050,17,007,"Illinois","Boone County",1,16,909,475,434
050,17,007,"Illinois","Boone County",1,17,875,455,420
050,17,007,"Illinois","Boone County",1,18,815,417,398
050,17,007,"Illinois","Boone County",1,19,694,356,338
050,17,007,"Illinois","Boone County",1,20,701,358,343
050,17,007,"Illinois","Boone County",1,21,665,349,316
050,17,007,"Illinois","Boone County",1,22,645,345,300
050,17,007,"Illinois","Boone County",1,23,640,329,311
050,17,007,"Illinois","Boone County",1,24,646,339,307
050,17,007,"Illinois","Boone County",1,25,650,316,334
050,17,007,"Illinois","Boone County",1,26,620,314,306
050,17,007,"Illinois","Boone County",1,27,584,323,261
050,17,007,"Illinois","Boone County",1,28,593,325,268
050,17,007,"Illinois","Boone County",1,29,569,294,275
050,17,007,"Illinois","Boone County",1,30,570,275,295
050,17,007,"Illinois","Boone County",1,31,590,293,297
050,17,007,"Illinois","Boone County",1,32,548,260,288
050,17,007,"Illinois","Boone County",1,33,542,257,285
050,17,007,"Illinois","Boone County",1,34,604,304,300
050,17,007,"Illinois","Boone County",1,35,617,299,318
050,17,007,"Illinois","Boone County",1,36,642,312,330
050,17,007,"Illinois","Boone County",1,37,653,327,326
050,17,007,"Illinois","Boone County",1,38,654,311,343
050,17,007,"Illinois","Boone County",1,39,633,312,321
050,17,007,"Illinois","Boone County",1,40,711,349,362
050,17,007,"Illinois","Boone County",1,41,652,315,337
050,17,007,"Illinois","Boone County",1,42,651,324,327
050,17,007,"Illinois","Boone County",1,43,633,312,321
050,17,007,"Illinois","Boone County",1,44,657,323,334
050,17,007,"Illinois","Boone County",1,45,672,358,314
050,17,007,"Illinois","Boone County",1,46,696,359,337
050,17,007,"Illinois","Boone County",1,47,717,357,360
050,17,007,"Illinois","Boone County",1,48,795,403,392
050,17,007,"Illinois","Boone County",1,49,847,427,420
050,17,007,"Illinois","Boone County",1,50,815,388,427
050,17,007,"Illinois","Boone County",1,51,752,377,375
050,17,007,"Illinois","Boone County",1,52,731,381,350
050,17,007,"Illinois","Boone County",1,53,717,383,334
050,17,007,"Illinois","Boone County",1,54,764,392,372
050,17,007,"Illinois","Boone County",1,55,832,417,415
050,17,007,"Illinois","Boone County",1,56,769,392,377
050,17,007,"Illinois","Boone County",1,57,735,386,349
050,17,007,"Illinois","Boone County",1,58,735,383,352
050,17,007,"Illinois","Boone County",1,59,734,384,350
050,17,007,"Illinois","Boone County",1,60,703,345,358
050,17,007,"Illinois","Boone County",1,61,693,335,358
050,17,007,"Illinois","Boone County",1,62,671,345,326
050,17,007,"Illinois","Boone County",1,63,640,329,311
050,17,007,"Illinois","Boone County",1,64,624,312,312
050,17,007,"Illinois","Boone County",1,65,598,311,287
050,17,007,"Illinois","Boone County",1,66,560,287,273
050,17,007,"Illinois","Boone County",1,67,552,279,273
050,17,007,"Illinois","Boone County",1,68,530,259,271
050,17,007,"Illinois","Boone County",1,69,502,234,268
050,17,007,"Illinois","Boone County",1,70,483,229,254
050,17,007,"Illinois","Boone County",1,71,488,234,254
050,17,007,"Illinois","Boone County",1,72,471,218,253
050,17,007,"Illinois","Boone County",1,73,473,225,248
050,17,007,"Illinois","Boone County",1,74,356,165,191
050,17,007,"Illinois","Boone County",1,75,359,170,189
050,17,007,"Illinois","Boone County",1,76,370,172,198
050,17,007,"Illinois","Boone County",1,77,389,189,200
050,17,007,"Illinois","Boone County",1,78,320,158,162
050,17,007,"Illinois","Boone County",1,79,266,121,145
050,17,007,"Illinois","Boone County",1,80,237,109,128
050,17,007,"Illinois","Boone County",1,81,211,98,113
050,17,007,"Illinois","Boone County",1,82,195,88,107
050,17,007,"Illinois","Boone County",1,83,162,76,86
050,17,007,"Illinois","Boone County",1,84,155,69,86
050,17,007,"Illinois","Boone County",1,85,818,292,526
050,17,007,"Illinois","Boone County",2,0,515,267,248
050,17,007,"Illinois","Boone County",2,1,522,258,264
050,17,007,"Illinois","Boone County",2,2,590,298,292
050,17,007,"Illinois","Boone County",2,3,631,344,287
050,17,007,"Illinois","Boone County",2,4,635,354,281
050,17,007,"Illinois","Boone County",2,5,645,341,304
050,17,007,"Illinois","Boone County",2,6,650,325,325
050,17,007,"Illinois","Boone County",2,7,645,324,321
050,17,007,"Illinois","Boone County",2,8,689,361,328
050,17,007,"Illinois","Boone County",2,9,700,365,335
050,17,007,"Illinois","Boone County",2,10,730,385,345
050,17,007,"Illinois","Boone County",2,11,778,416,362
050,17,007,"Illinois","Boone County",2,12,844,446,398
050,17,007,"Illinois","Boone County",2,13,898,463,435
050,17,007,"Illinois","Boone County",2,14,922,479,443
050,17,007,"Illinois","Boone County",2,15,888,442,446
050,17,007,"Illinois","Boone County",2,16,897,463,434
050,17,007,"Illinois","Boone County",2,17,876,456,420
050,17,007,"Illinois","Boone County",2,18,795,412,383
050,17,007,"Illinois","Boone County",2,19,691,355,336
050,17,007,"Illinois","Boone County",2,20,706,361,345
050,17,007,"Illinois","Boone County",2,21,670,350,320
050,17,007,"Illinois","Boone County",2,22,646,340,306
050,17,007,"Illinois","Boone County",2,23,643,332,311
050,17,007,"Illinois","Boone County",2,24,642,335,307
050,17,007,"Illinois","Boone County",2,25,643,319,324
050,17,007,"Illinois","Boone County",2,26,623,314,309
050,17,007,"Illinois","Boone County",2,27,593,321,272
050,17,007,"Illinois","Boone County",2,28,589,325,264
050,17,007,"Illinois","Boone County",2,29,574,300,274
050,17,007,"Illinois","Boone County",2,30,576,282,294
050,17,007,"Illinois","Boone County",2,31,587,290,297
050,17,007,"Illinois","Boone County",2,32,563,270,293
050,17,007,"Illinois","Boone County",2,33,544,259,285
050,17,007,"Illinois","Boone County",2,34,593,294,299
050,17,007,"Illinois","Boone County",2,35,619,302,317
050,17,007,"Illinois","Boone County",2,36,632,306,326
050,17,007,"Illinois","Boone County",2,37,652,324,328
050,17,007,"Illinois","Boone County",2,38,652,314,338
050,17,007,"Illinois","Boone County",2,39,637,313,324
050,17,007,"Illinois","Boone County",2,40,698,344,354
050,17,007,"Illinois","Boone County",2,41,663,322,341
050,17,007,"Illinois","Boone County",2,42,647,320,327
050,17,007,"Illinois","Boone County",2,43,641,315,326
050,17,007,"Illinois","Boone County",2,44,642,317,325
050,17,007,"Illinois","Boone County",2,45,668,349,319
050,17,007,"Illinois","Boone County",2,46,686,356,330
050,17,007,"Illinois","Boone County",2,47,709,356,353
050,17,007,"Illinois","Boone County",2,48,772,390,382
050,17,007,"Illinois","Boone County",2,49,835,421,414
050,17,007,"Illinois","Boone County",2,50,820,396,424
050,17,007,"Illinois","Boone County",2,51,765,380,385
050,17,007,"Illinois","Boone County",2,52,731,377,354
050,17,007,"Illinois","Boone County",2,53,715,379,336
050,17,007,"Illinois","Boone County",2,54,750,388,362
050,17,007,"Illinois","Boone County",2,55,811,409,402
050,17,007,"Illinois","Boone County",2,56,779,397,382
050,17,007,"Illinois","Boone County",2,57,740,387,353
050,17,007,"Illinois","Boone County",2,58,730,380,350
050,17,007,"Illinois","Boone County",2,59,736,384,352
050,17,007,"Illinois","Boone County",2,60,706,354,352
050,17,007,"Illinois","Boone County",2,61,686,329,357
050,17,007,"Illinois","Boone County",2,62,670,341,329
050,17,007,"Illinois","Boone County",2,63,652,334,318
050,17,007,"Illinois","Boone County",2,64,620,312,308
050,17,007,"Illinois","Boone County",2,65,602,308,294
050,17,007,"Illinois","Boone County",2,66,567,292,275
050,17,007,"Illinois","Boone County",2,67,550,278,272
050,17,007,"Illinois","Boone County",2,68,532,262,270
050,17,007,"Illinois","Boone County",2,69,510,240,270
050,17,007,"Illinois","Boone County",2,70,483,228,255
050,17,007,"Illinois","Boone County",2,71,485,232,253
050,17,007,"Illinois","Boone County",2,72,468,219,249
050,17,007,"Illinois","Boone County",2,73,492,232,260
050,17,007,"Illinois","Boone County",2,74,363,170,193
050,17,007,"Illinois","Boone County",2,75,355,167,188
050,17,007,"Illinois","Boone County",2,76,362,170,192
050,17,007,"Illinois","Boone County",2,77,390,188,202
050,17,007,"Illinois","Boone County",2,78,321,157,164
050,17,007,"Illinois","Boone County",2,79,275,128,147
050,17,007,"Illinois","Boone County",2,80,243,111,132
050,17,007,"Illinois","Boone County",2,81,213,99,114
050,17,007,"Illinois","Boone County",2,82,201,91,110
050,17,007,"Illinois","Boone County",2,83,167,77,90
050,17,007,"Illinois","Boone County",2,84,151,68,83
050,17,007,"Illinois","Boone County",2,85,816,295,521
050,17,007,"Illinois","Boone County",3,0,507,250,257
050,17,007,"Illinois","Boone County",3,1,516,269,247
050,17,007,"Illinois","Boone County",3,2,533,268,265
050,17,007,"Illinois","Boone County",3,3,584,299,285
050,17,007,"Illinois","Boone County",3,4,648,347,301
050,17,007,"Illinois","Boone County",3,5,661,364,297
050,17,007,"Illinois","Boone County",3,6,665,352,313
050,17,007,"Illinois","Boone County",3,7,665,345,320
050,17,007,"Illinois","Boone County",3,8,651,337,314
050,17,007,"Illinois","Boone County",3,9,687,352,335
050,17,007,"Illinois","Boone County",3,10,715,380,335
050,17,007,"Illinois","Boone County",3,11,739,388,351
050,17,007,"Illinois","Boone County",3,12,772,417,355
050,17,007,"Illinois","Boone County",3,13,859,443,416
050,17,007,"Illinois","Boone County",3,14,886,449,437
050,17,007,"Illinois","Boone County",3,15,919,477,442
050,17,007,"Illinois","Boone County",3,16,899,440,459
050,17,007,"Illinois","Boone County",3,17,890,457,433
050,17,007,"Illinois","Boone County",3,18,761,410,351
050,17,007,"Illinois","Boone County",3,19,681,354,327
050,17,007,"Illinois","Boone County",3,20,710,367,343
050,17,007,"Illinois","Boone County",3,21,721,373,348
050,17,007,"Illinois","Boone County",3,22,667,337,330
050,17,007,"Illinois","Boone County",3,23,598,312,286
050,17,007,"Illinois","Boone County",3,24,626,329,297
050,17,007,"Illinois","Boone County",3,25,594,317,277
050,17,007,"Illinois","Boone County",3,26,654,331,323
050,17,007,"Illinois","Boone County",3,27,629,317,312
050,17,007,"Illinois","Boone County",3,28,605,313,292
050,17,007,"Illinois","Boone County",3,29,583,309,274
050,17,007,"Illinois","Boone County",3,30,570,300,270
050,17,007,"Illinois","Boone County",3,31,620,320,300
050,17,007,"Illinois","Boone County",3,32,593,296,297
050,17,007,"Illinois","Boone County",3,33,569,270,299
050,17,007,"Illinois","Boone County",3,34,549,254,295
050,17,007,"Illinois","Boone County",3,35,587,292,295
050,17,007,"Illinois","Boone County",3,36,643,317,326
050,17,007,"Illinois","Boone County",3,37,629,305,324
050,17,007,"Illinois","Boone County",3,38,635,320,315
050,17,007,"Illinois","Boone County",3,39,672,310,362
050,17,007,"Illinois","Boone County",3,40,651,330,321
050,17,007,"Illinois","Boone County",3,41,702,352,350
050,17,007,"Illinois","Boone County",3,42,651,313,338
050,17,007,"Illinois","Boone County",3,43,656,332,324
050,17,007,"Illinois","Boone County",3,44,647,324,323
050,17,007,"Illinois","Boone County",3,45,632,314,318
050,17,007,"Illinois","Boone County",3,46,668,353,315
050,17,007,"Illinois","Boone County",3,47,679,352,327
050,17,007,"Illinois","Boone County",3,48,711,359,352
050,17,007,"Illinois","Boone County",3,49,766,387,379
050,17,007,"Illinois","Boone County",3,50,827,424,403
050,17,007,"Illinois","Boone County",3,51,830,401,429
050,17,007,"Illinois","Boone County",3,52,772,383,389
050,17,007,"Illinois","Boone County",3,53,730,377,353
050,17,007,"Illinois","Boone County",3,54,711,375,336
050,17,007,"Illinois","Boone County",3,55,724,382,342
050,17,007,"Illinois","Boone County",3,56,811,420,391
050,17,007,"Illinois","Boone County",3,57,756,380,376
050,17,007,"Illinois","Boone County",3,58,706,371,335
050,17,007,"Illinois","Boone County",3,59,724,373,351
050,17,007,"Illinois","Boone County",3,60,729,384,345
050,17,007,"Illinois","Boone County",3,61,671,329,342
050,17,007,"Illinois","Boone County",3,62,684,320,364
050,17,007,"Illinois","Boone County",3,63,638,328,310
050,17,007,"Illinois","Boone County",3,64,654,336,318
050,17,007,"Illinois","Boone County",3,65,617,312,305
050,17,007,"Illinois","Boone County",3,66,584,294,290
050,17,007,"Illinois","Boone County",3,67,561,282,279
050,17,007,"Illinois","Boone County",3,68,538,270,268
050,17,007,"Illinois","Boone County",3,69,529,260,269
050,17,007,"Illinois","Boone County",3,70,492,230,262
050,17,007,"Illinois","Boone County",3,71,473,224,249
050,17,007,"Illinois","Boone County",3,72,469,226,243
050,17,007,"Illinois","Boone County",3,73,445,211,234
050,17,007,"Illinois","Boone County",3,74,477,224,253
050,17,007,"Illinois","Boone County",3,75,359,165,194
050,17,007,"Illinois","Boone County",3,76,337,159,178
050,17,007,"Illinois","Boone County",3,77,359,168,191
050,17,007,"Illinois","Boone County",3,78,376,180,196
050,17,007,"Illinois","Boone County",3,79,304,148,156
050,17,007,"Illinois","Boone County",3,80,264,118,146
050,17,007,"Illinois","Boone County",3,81,217,97,120
050,17,007,"Illinois","Boone County",3,82,202,98,104
050,17,007,"Illinois","Boone County",3,83,188,83,105
050,17,007,"Illinois","Boone County",3,84,159,72,87
050,17,007,"Illinois","Boone County",3,85,801,292,509
050,17,007,"Illinois","Boone County",4,0,508,255,253
050,17,007,"Illinois","Boone County",4,1,534,262,272
050,17,007,"Illinois","Boone County",4,2,529,272,257
050,17,007,"Illinois","Boone County",4,3,550,293,257
050,17,007,"Illinois","Boone County",4,4,595,310,285
050,17,007,"Illinois","Boone County",4,5,672,359,313
050,17,007,"Illinois","Boone County",4,6,665,374,291
050,17,007,"Illinois","Boone County",4,7,689,366,323
050,17,007,"Illinois","Boone County",4,8,677,355,322
050,17,007,"Illinois","Boone County",4,9,668,348,320
050,17,007,"Illinois","Boone County",4,10,683,344,339
050,17,007,"Illinois","Boone County",4,11,733,381,352
050,17,007,"Illinois","Boone County",4,12,746,386,360
050,17,007,"Illinois","Boone County",4,13,776,410,366
050,17,007,"Illinois","Boone County",4,14,878,455,423
050,17,007,"Illinois","Boone County",4,15,891,466,425
050,17,007,"Illinois","Boone County",4,16,912,472,440
050,17,007,"Illinois","Boone County",4,17,888,440,448
050,17,007,"Illinois","Boone County",4,18,790,426,364
050,17,007,"Illinois","Boone County",4,19,638,347,291
050,17,007,"Illinois","Boone County",4,20,684,355,329
050,17,007,"Illinois","Boone County",4,21,723,374,349
050,17,007,"Illinois","Boone County",4,22,710,362,348
050,17,007,"Illinois","Boone County",4,23,659,327,332
050,17,007,"Illinois","Boone County",4,24,592,315,277
050,17,007,"Illinois","Boone County",4,25,613,322,291
050,17,007,"Illinois","Boone County",4,26,564,288,276
050,17,007,"Illinois","Boone County",4,27,614,290,324
050,17,007,"Illinois","Boone County",4,28,597,295,302
050,17,007,"Illinois","Boone County",4,29,582,298,284
050,17,007,"Illinois","Boone County",4,30,585,298,287
050,17,007,"Illinois","Boone County",4,31,574,302,272
050,17,007,"Illinois","Boone County",4,32,649,333,316
050,17,007,"Illinois","Boone County",4,33,594,308,286
050,17,007,"Illinois","Boone County",4,34,592,281,311
050,17,007,"Illinois","Boone County",4,35,557,263,294
050,17,007,"Illinois","Boone County",4,36,582,300,282
050,17,007,"Illinois","Boone County",4,37,644,316,328
050,17,007,"Illinois","Boone County",4,38,634,300,334
050,17,007,"Illinois","Boone County",4,39,687,339,348
050,17,007,"Illinois","Boone County",4,40,701,332,369
050,17,007,"Illinois","Boone County",4,41,662,336,326
050,17,007,"Illinois","Boone County",4,42,682,343,339
050,17,007,"Illinois","Boone County",4,43,654,313,341
050,17,007,"Illinois","Boone County",4,44,635,326,309
050,17,007,"Illinois","Boone County",4,45,656,322,334
050,17,007,"Illinois","Boone County",4,46,620,303,317
050,17,007,"Illinois","Boone County",4,47,669,354,315
050,17,007,"Illinois","Boone County",4,48,691,368,323
050,17,007,"Illinois","Boone County",4,49,701,361,340
050,17,007,"Illinois","Boone County",4,50,763,394,369
050,17,007,"Illinois","Boone County",4,51,811,419,392
050,17,007,"Illinois","Boone County",4,52,835,400,435
050,17,007,"Illinois","Boone County",4,53,757,381,376
050,17,007,"Illinois","Boone County",4,54,723,368,355
050,17,007,"Illinois","Boone County",4,55,704,370,334
050,17,007,"Illinois","Boone County",4,56,735,390,345
050,17,007,"Illinois","Boone County",4,57,796,412,384
050,17,007,"Illinois","Boone County",4,58,750,377,373
050,17,007,"Illinois","Boone County",4,59,684,363,321
050,17,007,"Illinois","Boone County",4,60,707,364,343
050,17,007,"Illinois","Boone County",4,61,722,378,344
050,17,007,"Illinois","Boone County",4,62,661,323,338
050,17,007,"Illinois","Boone County",4,63,668,311,357
050,17,007,"Illinois","Boone County",4,64,625,321,304
050,17,007,"Illinois","Boone County",4,65,649,331,318
050,17,007,"Illinois","Boone County",4,66,610,308,302
050,17,007,"Illinois","Boone County",4,67,578,290,288
050,17,007,"Illinois","Boone County",4,68,551,272,279
050,17,007,"Illinois","Boone County",4,69,527,271,256
050,17,007,"Illinois","Boone County",4,70,510,247,263
050,17,007,"Illinois","Boone County",4,71,488,222,266
050,17,007,"Illinois","Boone County",4,72,457,212,245
050,17,007,"Illinois","Boone County",4,73,457,215,242
050,17,007,"Illinois","Boone County",4,74,440,211,229
050,17,007,"Illinois","Boone County",4,75,462,218,244
050,17,007,"Illinois","Boone County",4,76,337,153,184
050,17,007,"Illinois","Boone County",4,77,325,152,173
050,17,007,"Illinois","Boone County",4,78,334,154,180
050,17,007,"Illinois","Boone County",4,79,356,165,191
050,17,007,"Illinois","Boone County",4,80,285,138,147
050,17,007,"Illinois","Boone County",4,81,240,105,135
050,17,007,"Illinois","Boone County",4,82,206,92,114
050,17,007,"Illinois","Boone County",4,83,183,87,96
050,17,007,"Illinois","Boone County",4,84,175,74,101
050,17,007,"Illinois","Boone County",4,85,828,299,529
050,17,007,"Illinois","Boone County",5,0,505,253,252
050,17,007,"Illinois","Boone County",5,1,505,248,257
050,17,007,"Illinois","Boone County",5,2,577,286,291
050,17,007,"Illinois","Boone County",5,3,552,297,255
050,17,007,"Illinois","Boone County",5,4,600,320,280
050,17,007,"Illinois","Boone County",5,5,603,315,288
050,17,007,"Illinois","Boone County",5,6,686,366,320
050,17,007,"Illinois","Boone County",5,7,710,385,325
050,17,007,"Illinois","Boone County",5,8,706,373,333
050,17,007,"Illinois","Boone County",5,9,683,351,332
050,17,007,"Illinois","Boone County",5,10,694,356,338
050,17,007,"Illinois","Boone County",5,11,678,344,334
050,17,007,"Illinois","Boone County",5,12,733,379,354
050,17,007,"Illinois","Boone County",5,13,757,388,369
050,17,007,"Illinois","Boone County",5,14,782,416,366
050,17,007,"Illinois","Boone County",5,15,880,455,425
050,17,007,"Illinois","Boone County",5,16,903,464,439
050,17,007,"Illinois","Boone County",5,17,913,473,440
050,17,007,"Illinois","Boone County",5,18,778,390,388
050,17,007,"Illinois","Boone County",5,19,672,369,303
050,17,007,"Illinois","Boone County",5,20,675,366,309
050,17,007,"Illinois","Boone County",5,21,699,350,349
050,17,007,"Illinois","Boone County",5,22,702,352,350
050,17,007,"Illinois","Boone County",5,23,697,352,345
050,17,007,"Illinois","Boone County",5,24,644,325,319
050,17,007,"Illinois","Boone County",5,25,564,298,266
050,17,007,"Illinois","Boone County",5,26,605,312,293
050,17,007,"Illinois","Boone County",5,27,585,305,280
050,17,007,"Illinois","Boone County",5,28,618,290,328
050,17,007,"Illinois","Boone County",5,29,587,283,304
050,17,007,"Illinois","Boone County",5,30,587,291,296
050,17,007,"Illinois","Boone County",5,31,579,298,281
050,17,007,"Illinois","Boone County",5,32,600,309,291
050,17,007,"Illinois","Boone County",5,33,653,328,325
050,17,007,"Illinois","Boone County",5,34,598,303,295
050,17,007,"Illinois","Boone County",5,35,601,294,307
050,17,007,"Illinois","Boone County",5,36,584,279,305
050,17,007,"Illinois","Boone County",5,37,593,311,282
050,17,007,"Illinois","Boone County",5,38,648,307,341
050,17,007,"Illinois","Boone County",5,39,638,298,340
050,17,007,"Illinois","Boone County",5,40,682,335,347
050,17,007,"Illinois","Boone County",5,41,701,332,369
050,17,007,"Illinois","Boone County",5,42,654,330,324
050,17,007,"Illinois","Boone County",5,43,685,345,340
050,17,007,"Illinois","Boone County",5,44,667,324,343
050,17,007,"Illinois","Boone County",5,45,636,316,320
050,17,007,"Illinois","Boone County",5,46,652,324,328
050,17,007,"Illinois","Boone County",5,47,626,310,316
050,17,007,"Illinois","Boone County",5,48,673,349,324
050,17,007,"Illinois","Boone County",5,49,684,365,319
050,17,007,"Illinois","Boone County",5,50,690,353,337
050,17,007,"Illinois","Boone County",5,51,757,388,369
050,17,007,"Illinois","Boone County",5,52,824,425,399
050,17,007,"Illinois","Boone County",5,53,823,393,430
050,17,007,"Illinois","Boone County",5,54,748,377,371
050,17,007,"Illinois","Boone County",5,55,720,371,349
050,17,007,"Illinois","Boone County",5,56,718,376,342
050,17,007,"Illinois","Boone County",5,57,711,382,329
050,17,007,"Illinois","Boone County",5,58,782,405,377
050,17,007,"Illinois","Boone County",5,59,737,366,371
050,17,007,"Illinois","Boone County",5,60,679,358,321
050,17,007,"Illinois","Boone County",5,61,692,357,335
050,17,007,"Illinois","Boone County",5,62,710,373,337
050,17,007,"Illinois","Boone County",5,63,644,310,334
050,17,007,"Illinois","Boone County",5,64,670,309,361
050,17,007,"Illinois","Boone County",5,65,620,319,301
050,17,007,"Illinois","Boone County",5,66,645,327,318
050,17,007,"Illinois","Boone County",5,67,601,299,302
050,17,007,"Illinois","Boone County",5,68,566,282,284
050,17,007,"Illinois","Boone County",5,69,546,267,279
050,17,007,"Illinois","Boone County",5,70,525,267,258
050,17,007,"Illinois","Boone County",5,71,501,240,261
050,17,007,"Illinois","Boone County",5,72,477,215,262
050,17,007,"Illinois","Boone County",5,73,437,202,235
050,17,007,"Illinois","Boone County",5,74,458,221,237
050,17,007,"Illinois","Boone County",5,75,430,205,225
050,17,007,"Illinois","Boone County",5,76,433,205,228
050,17,007,"Illinois","Boone County",5,77,335,149,186
050,17,007,"Illinois","Boone County",5,78,307,140,167
050,17,007,"Illinois","Boone County",5,79,317,148,169
050,17,007,"Illinois","Boone County",5,80,337,157,180
050,17,007,"Illinois","Boone County",5,81,252,122,130
050,17,007,"Illinois","Boone County",5,82,235,103,132
050,17,007,"Illinois","Boone County",5,83,190,81,109
050,17,007,"Illinois","Boone County",5,84,174,79,95
050,17,007,"Illinois","Boone County",5,85,877,324,553
050,17,009,"Illinois","Brown County",1,0,64,33,31
050,17,009,"Illinois","Brown County",1,1,62,33,29
050,17,009,"Illinois","Brown County",1,2,65,33,32
050,17,009,"Illinois","Brown County",1,3,59,31,28
050,17,009,"Illinois","Brown County",1,4,65,34,31
050,17,009,"Illinois","Brown County",1,5,49,28,21
050,17,009,"Illinois","Brown County",1,6,55,32,23
050,17,009,"Illinois","Brown County",1,7,58,34,24
050,17,009,"Illinois","Brown County",1,8,58,31,27
050,17,009,"Illinois","Brown County",1,9,51,26,25
050,17,009,"Illinois","Brown County",1,10,61,33,28
050,17,009,"Illinois","Brown County",1,11,62,27,35
050,17,009,"Illinois","Brown County",1,12,57,26,31
050,17,009,"Illinois","Brown County",1,13,54,22,32
050,17,009,"Illinois","Brown County",1,14,57,27,30
050,17,009,"Illinois","Brown County",1,15,63,34,29
050,17,009,"Illinois","Brown County",1,16,61,32,29
050,17,009,"Illinois","Brown County",1,17,61,27,34
050,17,009,"Illinois","Brown County",1,18,60,42,18
050,17,009,"Illinois","Brown County",1,19,64,49,15
050,17,009,"Illinois","Brown County",1,20,90,69,21
050,17,009,"Illinois","Brown County",1,21,90,70,20
050,17,009,"Illinois","Brown County",1,22,108,83,25
050,17,009,"Illinois","Brown County",1,23,101,77,24
050,17,009,"Illinois","Brown County",1,24,112,87,25
050,17,009,"Illinois","Brown County",1,25,102,79,23
050,17,009,"Illinois","Brown County",1,26,115,94,21
050,17,009,"Illinois","Brown County",1,27,116,93,23
050,17,009,"Illinois","Brown County",1,28,119,86,33
050,17,009,"Illinois","Brown County",1,29,125,88,37
050,17,009,"Illinois","Brown County",1,30,119,95,24
050,17,009,"Illinois","Brown County",1,31,100,83,17
050,17,009,"Illinois","Brown County",1,32,99,77,22
050,17,009,"Illinois","Brown County",1,33,104,71,33
050,17,009,"Illinois","Brown County",1,34,107,73,34
050,17,009,"Illinois","Brown County",1,35,112,80,32
050,17,009,"Illinois","Brown County",1,36,99,70,29
050,17,009,"Illinois","Brown County",1,37,91,64,27
050,17,009,"Illinois","Brown County",1,38,97,75,22
050,17,009,"Illinois","Brown County",1,39,103,76,27
050,17,009,"Illinois","Brown County",1,40,90,66,24
050,17,009,"Illinois","Brown County",1,41,95,68,27
050,17,009,"Illinois","Brown County",1,42,89,62,27
050,17,009,"Illinois","Brown County",1,43,94,66,28
050,17,009,"Illinois","Brown County",1,44,84,62,22
050,17,009,"Illinois","Brown County",1,45,76,54,22
050,17,009,"Illinois","Brown County",1,46,82,58,24
050,17,009,"Illinois","Brown County",1,47,81,59,22
050,17,009,"Illinois","Brown County",1,48,98,59,39
050,17,009,"Illinois","Brown County",1,49,98,63,35
050,17,009,"Illinois","Brown County",1,50,77,52,25
050,17,009,"Illinois","Brown County",1,51,75,53,22
050,17,009,"Illinois","Brown County",1,52,82,54,28
050,17,009,"Illinois","Brown County",1,53,78,54,24
050,17,009,"Illinois","Brown County",1,54,68,42,26
050,17,009,"Illinois","Brown County",1,55,89,54,35
050,17,009,"Illinois","Brown County",1,56,79,46,33
050,17,009,"Illinois","Brown County",1,57,73,41,32
050,17,009,"Illinois","Brown County",1,58,74,41,33
050,17,009,"Illinois","Brown County",1,59,84,53,31
050,17,009,"Illinois","Brown County",1,60,79,44,35
050,17,009,"Illinois","Brown County",1,61,82,47,35
050,17,009,"Illinois","Brown County",1,62,70,37,33
050,17,009,"Illinois","Brown County",1,63,68,39,29
050,17,009,"Illinois","Brown County",1,64,64,36,28
050,17,009,"Illinois","Brown County",1,65,64,29,35
050,17,009,"Illinois","Brown County",1,66,63,32,31
050,17,009,"Illinois","Brown County",1,67,65,31,34
050,17,009,"Illinois","Brown County",1,68,58,25,33
050,17,009,"Illinois","Brown County",1,69,47,22,25
050,17,009,"Illinois","Brown County",1,70,48,22,26
050,17,009,"Illinois","Brown County",1,71,51,29,22
050,17,009,"Illinois","Brown County",1,72,47,29,18
050,17,009,"Illinois","Brown County",1,73,44,18,26
050,17,009,"Illinois","Brown County",1,74,32,9,23
050,17,009,"Illinois","Brown County",1,75,32,9,23
050,17,009,"Illinois","Brown County",1,76,36,16,20
050,17,009,"Illinois","Brown County",1,77,34,13,21
050,17,009,"Illinois","Brown County",1,78,28,14,14
050,17,009,"Illinois","Brown County",1,79,32,14,18
050,17,009,"Illinois","Brown County",1,80,28,14,14
050,17,009,"Illinois","Brown County",1,81,28,14,14
050,17,009,"Illinois","Brown County",1,82,19,12,7
050,17,009,"Illinois","Brown County",1,83,18,7,11
050,17,009,"Illinois","Brown County",1,84,26,8,18
050,17,009,"Illinois","Brown County",1,85,116,49,67
050,17,009,"Illinois","Brown County",2,0,62,29,33
050,17,009,"Illinois","Brown County",2,1,62,33,29
050,17,009,"Illinois","Brown County",2,2,65,34,31
050,17,009,"Illinois","Brown County",2,3,61,32,29
050,17,009,"Illinois","Brown County",2,4,62,33,29
050,17,009,"Illinois","Brown County",2,5,53,30,23
050,17,009,"Illinois","Brown County",2,6,53,31,22
050,17,009,"Illinois","Brown County",2,7,56,33,23
050,17,009,"Illinois","Brown County",2,8,58,32,26
050,17,009,"Illinois","Brown County",2,9,53,28,25
050,17,009,"Illinois","Brown County",2,10,60,31,29
050,17,009,"Illinois","Brown County",2,11,62,29,33
050,17,009,"Illinois","Brown County",2,12,58,26,32
050,17,009,"Illinois","Brown County",2,13,54,23,31
050,17,009,"Illinois","Brown County",2,14,55,26,29
050,17,009,"Illinois","Brown County",2,15,61,32,29
050,17,009,"Illinois","Brown County",2,16,61,32,29
050,17,009,"Illinois","Brown County",2,17,60,28,32
050,17,009,"Illinois","Brown County",2,18,61,41,20
050,17,009,"Illinois","Brown County",2,19,63,48,15
050,17,009,"Illinois","Brown County",2,20,89,69,20
050,17,009,"Illinois","Brown County",2,21,92,71,21
050,17,009,"Illinois","Brown County",2,22,108,84,24
050,17,009,"Illinois","Brown County",2,23,101,77,24
050,17,009,"Illinois","Brown County",2,24,113,88,25
050,17,009,"Illinois","Brown County",2,25,103,80,23
050,17,009,"Illinois","Brown County",2,26,114,93,21
050,17,009,"Illinois","Brown County",2,27,115,93,22
050,17,009,"Illinois","Brown County",2,28,118,87,31
050,17,009,"Illinois","Brown County",2,29,122,87,35
050,17,009,"Illinois","Brown County",2,30,122,95,27
050,17,009,"Illinois","Brown County",2,31,102,84,18
050,17,009,"Illinois","Brown County",2,32,97,76,21
050,17,009,"Illinois","Brown County",2,33,100,70,30
050,17,009,"Illinois","Brown County",2,34,106,73,33
050,17,009,"Illinois","Brown County",2,35,113,80,33
050,17,009,"Illinois","Brown County",2,36,99,70,29
050,17,009,"Illinois","Brown County",2,37,91,64,27
050,17,009,"Illinois","Brown County",2,38,101,77,24
050,17,009,"Illinois","Brown County",2,39,101,75,26
050,17,009,"Illinois","Brown County",2,40,89,65,24
050,17,009,"Illinois","Brown County",2,41,94,68,26
050,17,009,"Illinois","Brown County",2,42,88,62,26
050,17,009,"Illinois","Brown County",2,43,91,63,28
050,17,009,"Illinois","Brown County",2,44,86,63,23
050,17,009,"Illinois","Brown County",2,45,77,55,22
050,17,009,"Illinois","Brown County",2,46,80,57,23
050,17,009,"Illinois","Brown County",2,47,80,58,22
050,17,009,"Illinois","Brown County",2,48,92,57,35
050,17,009,"Illinois","Brown County",2,49,99,63,36
050,17,009,"Illinois","Brown County",2,50,82,55,27
050,17,009,"Illinois","Brown County",2,51,76,53,23
050,17,009,"Illinois","Brown County",2,52,80,53,27
050,17,009,"Illinois","Brown County",2,53,77,52,25
050,17,009,"Illinois","Brown County",2,54,70,45,25
050,17,009,"Illinois","Brown County",2,55,84,51,33
050,17,009,"Illinois","Brown County",2,56,80,46,34
050,17,009,"Illinois","Brown County",2,57,76,44,32
050,17,009,"Illinois","Brown County",2,58,71,39,32
050,17,009,"Illinois","Brown County",2,59,84,52,32
050,17,009,"Illinois","Brown County",2,60,79,45,34
050,17,009,"Illinois","Brown County",2,61,80,45,35
050,17,009,"Illinois","Brown County",2,62,71,39,32
050,17,009,"Illinois","Brown County",2,63,69,38,31
050,17,009,"Illinois","Brown County",2,64,65,37,28
050,17,009,"Illinois","Brown County",2,65,64,31,33
050,17,009,"Illinois","Brown County",2,66,63,31,32
050,17,009,"Illinois","Brown County",2,67,64,32,32
050,17,009,"Illinois","Brown County",2,68,59,26,33
050,17,009,"Illinois","Brown County",2,69,49,22,27
050,17,009,"Illinois","Brown County",2,70,48,22,26
050,17,009,"Illinois","Brown County",2,71,50,27,23
050,17,009,"Illinois","Brown County",2,72,48,29,19
050,17,009,"Illinois","Brown County",2,73,45,21,24
050,17,009,"Illinois","Brown County",2,74,31,10,21
050,17,009,"Illinois","Brown County",2,75,31,9,22
050,17,009,"Illinois","Brown County",2,76,34,14,20
050,17,009,"Illinois","Brown County",2,77,35,14,21
050,17,009,"Illinois","Brown County",2,78,29,13,16
050,17,009,"Illinois","Brown County",2,79,32,15,17
050,17,009,"Illinois","Brown County",2,80,29,14,15
050,17,009,"Illinois","Brown County",2,81,28,14,14
050,17,009,"Illinois","Brown County",2,82,21,12,9
050,17,009,"Illinois","Brown County",2,83,17,8,9
050,17,009,"Illinois","Brown County",2,84,24,8,16
050,17,009,"Illinois","Brown County",2,85,119,50,69
050,17,009,"Illinois","Brown County",3,0,52,27,25
050,17,009,"Illinois","Brown County",3,1,71,42,29
050,17,009,"Illinois","Brown County",3,2,64,36,28
050,17,009,"Illinois","Brown County",3,3,63,32,31
050,17,009,"Illinois","Brown County",3,4,61,34,27
050,17,009,"Illinois","Brown County",3,5,62,35,27
050,17,009,"Illinois","Brown County",3,6,52,28,24
050,17,009,"Illinois","Brown County",3,7,52,30,22
050,17,009,"Illinois","Brown County",3,8,60,36,24
050,17,009,"Illinois","Brown County",3,9,59,34,25
050,17,009,"Illinois","Brown County",3,10,54,27,27
050,17,009,"Illinois","Brown County",3,11,58,31,27
050,17,009,"Illinois","Brown County",3,12,63,29,34
050,17,009,"Illinois","Brown County",3,13,70,30,40
050,17,009,"Illinois","Brown County",3,14,53,21,32
050,17,009,"Illinois","Brown County",3,15,61,32,29
050,17,009,"Illinois","Brown County",3,16,64,33,31
050,17,009,"Illinois","Brown County",3,17,58,31,27
050,17,009,"Illinois","Brown County",3,18,63,39,24
050,17,009,"Illinois","Brown County",3,19,57,44,13
050,17,009,"Illinois","Brown County",3,20,90,73,17
050,17,009,"Illinois","Brown County",3,21,93,72,21
050,17,009,"Illinois","Brown County",3,22,116,96,20
050,17,009,"Illinois","Brown County",3,23,99,76,23
050,17,009,"Illinois","Brown County",3,24,123,102,21
050,17,009,"Illinois","Brown County",3,25,111,90,21
050,17,009,"Illinois","Brown County",3,26,119,95,24
050,17,009,"Illinois","Brown County",3,27,119,99,20
050,17,009,"Illinois","Brown County",3,28,122,100,22
050,17,009,"Illinois","Brown County",3,29,116,84,32
050,17,009,"Illinois","Brown County",3,30,128,97,31
050,17,009,"Illinois","Brown County",3,31,118,93,25
050,17,009,"Illinois","Brown County",3,32,112,94,18
050,17,009,"Illinois","Brown County",3,33,100,78,22
050,17,009,"Illinois","Brown County",3,34,109,80,29
050,17,009,"Illinois","Brown County",3,35,121,88,33
050,17,009,"Illinois","Brown County",3,36,114,80,34
050,17,009,"Illinois","Brown County",3,37,102,75,27
050,17,009,"Illinois","Brown County",3,38,122,95,27
050,17,009,"Illinois","Brown County",3,39,103,80,23
050,17,009,"Illinois","Brown County",3,40,92,69,23
050,17,009,"Illinois","Brown County",3,41,100,77,23
050,17,009,"Illinois","Brown County",3,42,97,71,26
050,17,009,"Illinois","Brown County",3,43,91,68,23
050,17,009,"Illinois","Brown County",3,44,102,74,28
050,17,009,"Illinois","Brown County",3,45,86,61,25
050,17,009,"Illinois","Brown County",3,46,85,62,23
050,17,009,"Illinois","Brown County",3,47,86,65,21
050,17,009,"Illinois","Brown County",3,48,84,61,23
050,17,009,"Illinois","Brown County",3,49,99,62,37
050,17,009,"Illinois","Brown County",3,50,98,64,34
050,17,009,"Illinois","Brown County",3,51,91,62,29
050,17,009,"Illinois","Brown County",3,52,70,50,20
050,17,009,"Illinois","Brown County",3,53,68,44,24
050,17,009,"Illinois","Brown County",3,54,74,49,25
050,17,009,"Illinois","Brown County",3,55,79,53,26
050,17,009,"Illinois","Brown County",3,56,74,42,32
050,17,009,"Illinois","Brown County",3,57,82,51,31
050,17,009,"Illinois","Brown County",3,58,68,36,32
050,17,009,"Illinois","Brown County",3,59,74,46,28
050,17,009,"Illinois","Brown County",3,60,80,49,31
050,17,009,"Illinois","Brown County",3,61,71,41,30
050,17,009,"Illinois","Brown County",3,62,76,42,34
050,17,009,"Illinois","Brown County",3,63,69,37,32
050,17,009,"Illinois","Brown County",3,64,67,37,30
050,17,009,"Illinois","Brown County",3,65,65,37,28
050,17,009,"Illinois","Brown County",3,66,59,27,32
050,17,009,"Illinois","Brown County",3,67,64,33,31
050,17,009,"Illinois","Brown County",3,68,58,28,30
050,17,009,"Illinois","Brown County",3,69,56,24,32
050,17,009,"Illinois","Brown County",3,70,52,24,28
050,17,009,"Illinois","Brown County",3,71,46,20,26
050,17,009,"Illinois","Brown County",3,72,51,27,24
050,17,009,"Illinois","Brown County",3,73,45,26,19
050,17,009,"Illinois","Brown County",3,74,46,20,26
050,17,009,"Illinois","Brown County",3,75,28,9,19
050,17,009,"Illinois","Brown County",3,76,27,7,20
050,17,009,"Illinois","Brown County",3,77,35,13,22
050,17,009,"Illinois","Brown County",3,78,32,11,21
050,17,009,"Illinois","Brown County",3,79,25,10,15
050,17,009,"Illinois","Brown County",3,80,29,13,16
050,17,009,"Illinois","Brown County",3,81,25,12,13
050,17,009,"Illinois","Brown County",3,82,32,15,17
050,17,009,"Illinois","Brown County",3,83,20,11,9
050,17,009,"Illinois","Brown County",3,84,19,9,10
050,17,009,"Illinois","Brown County",3,85,121,47,74
050,17,009,"Illinois","Brown County",4,0,56,29,27
050,17,009,"Illinois","Brown County",4,1,49,24,25
050,17,009,"Illinois","Brown County",4,2,71,41,30
050,17,009,"Illinois","Brown County",4,3,65,36,29
050,17,009,"Illinois","Brown County",4,4,63,31,32
050,17,009,"Illinois","Brown County",4,5,55,31,24
050,17,009,"Illinois","Brown County",4,6,62,34,28
050,17,009,"Illinois","Brown County",4,7,52,29,23
050,17,009,"Illinois","Brown County",4,8,45,26,19
050,17,009,"Illinois","Brown County",4,9,62,38,24
050,17,009,"Illinois","Brown County",4,10,62,34,28
050,17,009,"Illinois","Brown County",4,11,58,31,27
050,17,009,"Illinois","Brown County",4,12,61,33,28
050,17,009,"Illinois","Brown County",4,13,67,30,37
050,17,009,"Illinois","Brown County",4,14,69,31,38
050,17,009,"Illinois","Brown County",4,15,60,25,35
050,17,009,"Illinois","Brown County",4,16,57,31,26
050,17,009,"Illinois","Brown County",4,17,65,36,29
050,17,009,"Illinois","Brown County",4,18,62,42,20
050,17,009,"Illinois","Brown County",4,19,67,46,21
050,17,009,"Illinois","Brown County",4,20,77,63,14
050,17,009,"Illinois","Brown County",4,21,91,74,17
050,17,009,"Illinois","Brown County",4,22,112,89,23
050,17,009,"Illinois","Brown County",4,23,86,73,13
050,17,009,"Illinois","Brown County",4,24,122,92,30
050,17,009,"Illinois","Brown County",4,25,107,87,20
050,17,009,"Illinois","Brown County",4,26,104,82,22
050,17,009,"Illinois","Brown County",4,27,112,86,26
050,17,009,"Illinois","Brown County",4,28,113,89,24
050,17,009,"Illinois","Brown County",4,29,111,90,21
050,17,009,"Illinois","Brown County",4,30,117,85,32
050,17,009,"Illinois","Brown County",4,31,125,91,34
050,17,009,"Illinois","Brown County",4,32,111,82,29
050,17,009,"Illinois","Brown County",4,33,88,70,18
050,17,009,"Illinois","Brown County",4,34,100,80,20
050,17,009,"Illinois","Brown County",4,35,112,79,33
050,17,009,"Illinois","Brown County",4,36,94,62,32
050,17,009,"Illinois","Brown County",4,37,110,74,36
050,17,009,"Illinois","Brown County",4,38,117,90,27
050,17,009,"Illinois","Brown County",4,39,108,78,30
050,17,009,"Illinois","Brown County",4,40,87,65,22
050,17,009,"Illinois","Brown County",4,41,97,72,25
050,17,009,"Illinois","Brown County",4,42,96,71,25
050,17,009,"Illinois","Brown County",4,43,93,68,25
050,17,009,"Illinois","Brown County",4,44,87,66,21
050,17,009,"Illinois","Brown County",4,45,99,70,29
050,17,009,"Illinois","Brown County",4,46,90,62,28
050,17,009,"Illinois","Brown County",4,47,83,59,24
050,17,009,"Illinois","Brown County",4,48,78,57,21
050,17,009,"Illinois","Brown County",4,49,77,55,22
050,17,009,"Illinois","Brown County",4,50,99,62,37
050,17,009,"Illinois","Brown County",4,51,99,63,36
050,17,009,"Illinois","Brown County",4,52,91,61,30
050,17,009,"Illinois","Brown County",4,53,61,38,23
050,17,009,"Illinois","Brown County",4,54,64,41,23
050,17,009,"Illinois","Brown County",4,55,83,53,30
050,17,009,"Illinois","Brown County",4,56,69,41,28
050,17,009,"Illinois","Brown County",4,57,83,49,34
050,17,009,"Illinois","Brown County",4,58,72,40,32
050,17,009,"Illinois","Brown County",4,59,73,40,33
050,17,009,"Illinois","Brown County",4,60,70,42,28
050,17,009,"Illinois","Brown County",4,61,83,51,32
050,17,009,"Illinois","Brown County",4,62,69,37,32
050,17,009,"Illinois","Brown County",4,63,77,42,35
050,17,009,"Illinois","Brown County",4,64,68,36,32
050,17,009,"Illinois","Brown County",4,65,70,39,31
050,17,009,"Illinois","Brown County",4,66,61,34,27
050,17,009,"Illinois","Brown County",4,67,59,28,31
050,17,009,"Illinois","Brown County",4,68,58,31,27
050,17,009,"Illinois","Brown County",4,69,57,26,31
050,17,009,"Illinois","Brown County",4,70,58,26,32
050,17,009,"Illinois","Brown County",4,71,49,22,27
050,17,009,"Illinois","Brown County",4,72,47,20,27
050,17,009,"Illinois","Brown County",4,73,49,23,26
050,17,009,"Illinois","Brown County",4,74,42,24,18
050,17,009,"Illinois","Brown County",4,75,39,16,23
050,17,009,"Illinois","Brown County",4,76,26,8,18
050,17,009,"Illinois","Brown County",4,77,28,6,22
050,17,009,"Illinois","Brown County",4,78,31,10,21
050,17,009,"Illinois","Brown County",4,79,27,10,17
050,17,009,"Illinois","Brown County",4,80,22,8,14
050,17,009,"Illinois","Brown County",4,81,27,13,14
050,17,009,"Illinois","Brown County",4,82,27,12,15
050,17,009,"Illinois","Brown County",4,83,27,10,17
050,17,009,"Illinois","Brown County",4,84,21,12,9
050,17,009,"Illinois","Brown County",4,85,118,50,68
050,17,009,"Illinois","Brown County",5,0,55,29,26
050,17,009,"Illinois","Brown County",5,1,56,27,29
050,17,009,"Illinois","Brown County",5,2,49,23,26
050,17,009,"Illinois","Brown County",5,3,65,37,28
050,17,009,"Illinois","Brown County",5,4,63,34,29
050,17,009,"Illinois","Brown County",5,5,61,30,31
050,17,009,"Illinois","Brown County",5,6,58,31,27
050,17,009,"Illinois","Brown County",5,7,61,34,27
050,17,009,"Illinois","Brown County",5,8,50,27,23
050,17,009,"Illinois","Brown County",5,9,48,25,23
050,17,009,"Illinois","Brown County",5,10,61,34,27
050,17,009,"Illinois","Brown County",5,11,58,34,24
050,17,009,"Illinois","Brown County",5,12,60,32,28
050,17,009,"Illinois","Brown County",5,13,58,31,27
050,17,009,"Illinois","Brown County",5,14,70,29,41
050,17,009,"Illinois","Brown County",5,15,71,32,39
050,17,009,"Illinois","Brown County",5,16,58,24,34
050,17,009,"Illinois","Brown County",5,17,64,34,30
050,17,009,"Illinois","Brown County",5,18,70,48,22
050,17,009,"Illinois","Brown County",5,19,66,47,19
050,17,009,"Illinois","Brown County",5,20,88,67,21
050,17,009,"Illinois","Brown County",5,21,88,69,19
050,17,009,"Illinois","Brown County",5,22,110,89,21
050,17,009,"Illinois","Brown County",5,23,102,75,27
050,17,009,"Illinois","Brown County",5,24,106,90,16
050,17,009,"Illinois","Brown County",5,25,112,84,28
050,17,009,"Illinois","Brown County",5,26,112,94,18
050,17,009,"Illinois","Brown County",5,27,97,79,18
050,17,009,"Illinois","Brown County",5,28,104,85,19
050,17,009,"Illinois","Brown County",5,29,108,83,25
050,17,009,"Illinois","Brown County",5,30,118,96,22
050,17,009,"Illinois","Brown County",5,31,114,83,31
050,17,009,"Illinois","Brown County",5,32,110,79,31
050,17,009,"Illinois","Brown County",5,33,105,76,29
050,17,009,"Illinois","Brown County",5,34,94,77,17
050,17,009,"Illinois","Brown County",5,35,110,91,19
050,17,009,"Illinois","Brown County",5,36,97,65,32
050,17,009,"Illinois","Brown County",5,37,86,55,31
050,17,009,"Illinois","Brown County",5,38,130,91,39
050,17,009,"Illinois","Brown County",5,39,117,89,28
050,17,009,"Illinois","Brown County",5,40,95,68,27
050,17,009,"Illinois","Brown County",5,41,89,68,21
050,17,009,"Illinois","Brown County",5,42,95,66,29
050,17,009,"Illinois","Brown County",5,43,94,70,24
050,17,009,"Illinois","Brown County",5,44,94,71,23
050,17,009,"Illinois","Brown County",5,45,81,60,21
050,17,009,"Illinois","Brown County",5,46,101,72,29
050,17,009,"Illinois","Brown County",5,47,88,61,27
050,17,009,"Illinois","Brown County",5,48,76,51,25
050,17,009,"Illinois","Brown County",5,49,72,52,20
050,17,009,"Illinois","Brown County",5,50,77,55,22
050,17,009,"Illinois","Brown County",5,51,100,65,35
050,17,009,"Illinois","Brown County",5,52,102,65,37
050,17,009,"Illinois","Brown County",5,53,78,51,27
050,17,009,"Illinois","Brown County",5,54,61,38,23
050,17,009,"Illinois","Brown County",5,55,65,43,22
050,17,009,"Illinois","Brown County",5,56,72,42,30
050,17,009,"Illinois","Brown County",5,57,74,47,27
050,17,009,"Illinois","Brown County",5,58,70,37,33
050,17,009,"Illinois","Brown County",5,59,79,45,34
050,17,009,"Illinois","Brown County",5,60,67,35,32
050,17,009,"Illinois","Brown County",5,61,71,43,28
050,17,009,"Illinois","Brown County",5,62,79,46,33
050,17,009,"Illinois","Brown County",5,63,70,38,32
050,17,009,"Illinois","Brown County",5,64,71,38,33
050,17,009,"Illinois","Brown County",5,65,70,37,33
050,17,009,"Illinois","Brown County",5,66,66,36,30
050,17,009,"Illinois","Brown County",5,67,61,35,26
050,17,009,"Illinois","Brown County",5,68,57,27,30
050,17,009,"Illinois","Brown County",5,69,56,29,27
050,17,009,"Illinois","Brown County",5,70,58,27,31
050,17,009,"Illinois","Brown County",5,71,56,25,31
050,17,009,"Illinois","Brown County",5,72,49,22,27
050,17,009,"Illinois","Brown County",5,73,45,19,26
050,17,009,"Illinois","Brown County",5,74,45,20,25
050,17,009,"Illinois","Brown County",5,75,36,22,14
050,17,009,"Illinois","Brown County",5,76,38,16,22
050,17,009,"Illinois","Brown County",5,77,27,7,20
050,17,009,"Illinois","Brown County",5,78,24,3,21
050,17,009,"Illinois","Brown County",5,79,31,11,20
050,17,009,"Illinois","Brown County",5,80,27,10,17
050,17,009,"Illinois","Brown County",5,81,19,7,12
050,17,009,"Illinois","Brown County",5,82,29,14,15
050,17,009,"Illinois","Brown County",5,83,22,8,14
050,17,009,"Illinois","Brown County",5,84,27,12,15
050,17,009,"Illinois","Brown County",5,85,120,55,65
050,17,011,"Illinois","Bureau County",1,0,303,154,149
050,17,011,"Illinois","Bureau County",1,1,313,162,151
050,17,011,"Illinois","Bureau County",1,2,346,169,177
050,17,011,"Illinois","Bureau County",1,3,355,181,174
050,17,011,"Illinois","Bureau County",1,4,376,192,184
050,17,011,"Illinois","Bureau County",1,5,383,202,181
050,17,011,"Illinois","Bureau County",1,6,365,189,176
050,17,011,"Illinois","Bureau County",1,7,373,196,177
050,17,011,"Illinois","Bureau County",1,8,379,191,188
050,17,011,"Illinois","Bureau County",1,9,366,191,175
050,17,011,"Illinois","Bureau County",1,10,404,202,202
050,17,011,"Illinois","Bureau County",1,11,419,218,201
050,17,011,"Illinois","Bureau County",1,12,423,209,214
050,17,011,"Illinois","Bureau County",1,13,435,212,223
050,17,011,"Illinois","Bureau County",1,14,453,229,224
050,17,011,"Illinois","Bureau County",1,15,438,231,207
050,17,011,"Illinois","Bureau County",1,16,476,248,228
050,17,011,"Illinois","Bureau County",1,17,474,243,231
050,17,011,"Illinois","Bureau County",1,18,406,203,203
050,17,011,"Illinois","Bureau County",1,19,338,171,167
050,17,011,"Illinois","Bureau County",1,20,322,173,149
050,17,011,"Illinois","Bureau County",1,21,348,176,172
050,17,011,"Illinois","Bureau County",1,22,345,176,169
050,17,011,"Illinois","Bureau County",1,23,348,176,172
050,17,011,"Illinois","Bureau County",1,24,352,188,164
050,17,011,"Illinois","Bureau County",1,25,326,154,172
050,17,011,"Illinois","Bureau County",1,26,330,175,155
050,17,011,"Illinois","Bureau County",1,27,370,193,177
050,17,011,"Illinois","Bureau County",1,28,374,183,191
050,17,011,"Illinois","Bureau County",1,29,367,186,181
050,17,011,"Illinois","Bureau County",1,30,354,176,178
050,17,011,"Illinois","Bureau County",1,31,357,187,170
050,17,011,"Illinois","Bureau County",1,32,336,159,177
050,17,011,"Illinois","Bureau County",1,33,346,161,185
050,17,011,"Illinois","Bureau County",1,34,347,190,157
050,17,011,"Illinois","Bureau County",1,35,337,181,156
050,17,011,"Illinois","Bureau County",1,36,383,198,185
050,17,011,"Illinois","Bureau County",1,37,428,224,204
050,17,011,"Illinois","Bureau County",1,38,414,214,200
050,17,011,"Illinois","Bureau County",1,39,391,207,184
050,17,011,"Illinois","Bureau County",1,40,372,186,186
050,17,011,"Illinois","Bureau County",1,41,373,185,188
050,17,011,"Illinois","Bureau County",1,42,368,184,184
050,17,011,"Illinois","Bureau County",1,43,356,198,158
050,17,011,"Illinois","Bureau County",1,44,373,192,181
050,17,011,"Illinois","Bureau County",1,45,368,181,187
050,17,011,"Illinois","Bureau County",1,46,362,183,179
050,17,011,"Illinois","Bureau County",1,47,372,182,190
050,17,011,"Illinois","Bureau County",1,48,390,196,194
050,17,011,"Illinois","Bureau County",1,49,411,216,195
050,17,011,"Illinois","Bureau County",1,50,433,210,223
050,17,011,"Illinois","Bureau County",1,51,446,209,237
050,17,011,"Illinois","Bureau County",1,52,424,219,205
050,17,011,"Illinois","Bureau County",1,53,429,218,211
050,17,011,"Illinois","Bureau County",1,54,451,238,213
050,17,011,"Illinois","Bureau County",1,55,470,237,233
050,17,011,"Illinois","Bureau County",1,56,482,239,243
050,17,011,"Illinois","Bureau County",1,57,488,250,238
050,17,011,"Illinois","Bureau County",1,58,485,243,242
050,17,011,"Illinois","Bureau County",1,59,482,240,242
050,17,011,"Illinois","Bureau County",1,60,511,236,275
050,17,011,"Illinois","Bureau County",1,61,532,266,266
050,17,011,"Illinois","Bureau County",1,62,525,249,276
050,17,011,"Illinois","Bureau County",1,63,483,236,247
050,17,011,"Illinois","Bureau County",1,64,478,234,244
050,17,011,"Illinois","Bureau County",1,65,483,233,250
050,17,011,"Illinois","Bureau County",1,66,468,232,236
050,17,011,"Illinois","Bureau County",1,67,477,237,240
050,17,011,"Illinois","Bureau County",1,68,444,219,225
050,17,011,"Illinois","Bureau County",1,69,423,212,211
050,17,011,"Illinois","Bureau County",1,70,392,198,194
050,17,011,"Illinois","Bureau County",1,71,372,187,185
050,17,011,"Illinois","Bureau County",1,72,386,191,195
050,17,011,"Illinois","Bureau County",1,73,409,197,212
050,17,011,"Illinois","Bureau County",1,74,281,129,152
050,17,011,"Illinois","Bureau County",1,75,259,113,146
050,17,011,"Illinois","Bureau County",1,76,283,128,155
050,17,011,"Illinois","Bureau County",1,77,272,121,151
050,17,011,"Illinois","Bureau County",1,78,218,100,118
050,17,011,"Illinois","Bureau County",1,79,231,108,123
050,17,011,"Illinois","Bureau County",1,80,224,99,125
050,17,011,"Illinois","Bureau County",1,81,230,98,132
050,17,011,"Illinois","Bureau County",1,82,198,80,118
050,17,011,"Illinois","Bureau County",1,83,190,80,110
050,17,011,"Illinois","Bureau County",1,84,140,60,80
050,17,011,"Illinois","Bureau County",1,85,999,339,660
050,17,011,"Illinois","Bureau County",2,0,311,155,156
050,17,011,"Illinois","Bureau County",2,1,310,159,151
050,17,011,"Illinois","Bureau County",2,2,340,168,172
050,17,011,"Illinois","Bureau County",2,3,352,177,175
050,17,011,"Illinois","Bureau County",2,4,373,191,182
050,17,011,"Illinois","Bureau County",2,5,386,202,184
050,17,011,"Illinois","Bureau County",2,6,370,191,179
050,17,011,"Illinois","Bureau County",2,7,374,196,178
050,17,011,"Illinois","Bureau County",2,8,377,191,186
050,17,011,"Illinois","Bureau County",2,9,369,191,178
050,17,011,"Illinois","Bureau County",2,10,390,198,192
050,17,011,"Illinois","Bureau County",2,11,413,215,198
050,17,011,"Illinois","Bureau County",2,12,426,213,213
050,17,011,"Illinois","Bureau County",2,13,430,209,221
050,17,011,"Illinois","Bureau County",2,14,448,224,224
050,17,011,"Illinois","Bureau County",2,15,442,229,213
050,17,011,"Illinois","Bureau County",2,16,466,245,221
050,17,011,"Illinois","Bureau County",2,17,478,246,232
050,17,011,"Illinois","Bureau County",2,18,406,206,200
050,17,011,"Illinois","Bureau County",2,19,339,171,168
050,17,011,"Illinois","Bureau County",2,20,333,174,159
050,17,011,"Illinois","Bureau County",2,21,343,176,167
050,17,011,"Illinois","Bureau County",2,22,350,176,174
050,17,011,"Illinois","Bureau County",2,23,345,175,170
050,17,011,"Illinois","Bureau County",2,24,345,182,163
050,17,011,"Illinois","Bureau County",2,25,330,161,169
050,17,011,"Illinois","Bureau County",2,26,327,167,160
050,17,011,"Illinois","Bureau County",2,27,358,186,172
050,17,011,"Illinois","Bureau County",2,28,372,184,188
050,17,011,"Illinois","Bureau County",2,29,366,182,184
050,17,011,"Illinois","Bureau County",2,30,359,180,179
050,17,011,"Illinois","Bureau County",2,31,356,184,172
050,17,011,"Illinois","Bureau County",2,32,337,162,175
050,17,011,"Illinois","Bureau County",2,33,340,160,180
050,17,011,"Illinois","Bureau County",2,34,343,181,162
050,17,011,"Illinois","Bureau County",2,35,345,186,159
050,17,011,"Illinois","Bureau County",2,36,373,196,177
050,17,011,"Illinois","Bureau County",2,37,417,218,199
050,17,011,"Illinois","Bureau County",2,38,420,218,202
050,17,011,"Illinois","Bureau County",2,39,397,209,188
050,17,011,"Illinois","Bureau County",2,40,381,194,187
050,17,011,"Illinois","Bureau County",2,41,369,184,185
050,17,011,"Illinois","Bureau County",2,42,366,182,184
050,17,011,"Illinois","Bureau County",2,43,362,196,166
050,17,011,"Illinois","Bureau County",2,44,363,191,172
050,17,011,"Illinois","Bureau County",2,45,371,185,186
050,17,011,"Illinois","Bureau County",2,46,362,181,181
050,17,011,"Illinois","Bureau County",2,47,368,183,185
050,17,011,"Illinois","Bureau County",2,48,387,193,194
050,17,011,"Illinois","Bureau County",2,49,408,212,196
050,17,011,"Illinois","Bureau County",2,50,429,212,217
050,17,011,"Illinois","Bureau County",2,51,439,209,230
050,17,011,"Illinois","Bureau County",2,52,428,216,212
050,17,011,"Illinois","Bureau County",2,53,430,220,210
050,17,011,"Illinois","Bureau County",2,54,444,232,212
050,17,011,"Illinois","Bureau County",2,55,463,236,227
050,17,011,"Illinois","Bureau County",2,56,479,238,241
050,17,011,"Illinois","Bureau County",2,57,489,249,240
050,17,011,"Illinois","Bureau County",2,58,482,242,240
050,17,011,"Illinois","Bureau County",2,59,486,242,244
050,17,011,"Illinois","Bureau County",2,60,504,237,267
050,17,011,"Illinois","Bureau County",2,61,525,258,267
050,17,011,"Illinois","Bureau County",2,62,524,251,273
050,17,011,"Illinois","Bureau County",2,63,496,240,256
050,17,011,"Illinois","Bureau County",2,64,476,233,243
050,17,011,"Illinois","Bureau County",2,65,477,231,246
050,17,011,"Illinois","Bureau County",2,66,473,234,239
050,17,011,"Illinois","Bureau County",2,67,472,234,238
050,17,011,"Illinois","Bureau County",2,68,450,222,228
050,17,011,"Illinois","Bureau County",2,69,429,213,216
050,17,011,"Illinois","Bureau County",2,70,399,201,198
050,17,011,"Illinois","Bureau County",2,71,375,189,186
050,17,011,"Illinois","Bureau County",2,72,374,186,188
050,17,011,"Illinois","Bureau County",2,73,423,206,217
050,17,011,"Illinois","Bureau County",2,74,290,135,155
050,17,011,"Illinois","Bureau County",2,75,265,117,148
050,17,011,"Illinois","Bureau County",2,76,273,121,152
050,17,011,"Illinois","Bureau County",2,77,277,123,154
050,17,011,"Illinois","Bureau County",2,78,225,102,123
050,17,011,"Illinois","Bureau County",2,79,225,106,119
050,17,011,"Illinois","Bureau County",2,80,222,100,122
050,17,011,"Illinois","Bureau County",2,81,224,97,127
050,17,011,"Illinois","Bureau County",2,82,206,82,124
050,17,011,"Illinois","Bureau County",2,83,187,79,108
050,17,011,"Illinois","Bureau County",2,84,146,63,83
050,17,011,"Illinois","Bureau County",2,85,992,338,654
050,17,011,"Illinois","Bureau County",3,0,332,165,167
050,17,011,"Illinois","Bureau County",3,1,318,156,162
050,17,011,"Illinois","Bureau County",3,2,312,160,152
050,17,011,"Illinois","Bureau County",3,3,351,176,175
050,17,011,"Illinois","Bureau County",3,4,374,183,191
050,17,011,"Illinois","Bureau County",3,5,378,203,175
050,17,011,"Illinois","Bureau County",3,6,391,203,188
050,17,011,"Illinois","Bureau County",3,7,360,199,161
050,17,011,"Illinois","Bureau County",3,8,366,191,175
050,17,011,"Illinois","Bureau County",3,9,375,194,181
050,17,011,"Illinois","Bureau County",3,10,370,197,173
050,17,011,"Illinois","Bureau County",3,11,383,201,182
050,17,011,"Illinois","Bureau County",3,12,412,214,198
050,17,011,"Illinois","Bureau County",3,13,426,219,207
050,17,011,"Illinois","Bureau County",3,14,418,212,206
050,17,011,"Illinois","Bureau County",3,15,438,217,221
050,17,011,"Illinois","Bureau County",3,16,432,226,206
050,17,011,"Illinois","Bureau County",3,17,467,246,221
050,17,011,"Illinois","Bureau County",3,18,426,224,202
050,17,011,"Illinois","Bureau County",3,19,336,173,163
050,17,011,"Illinois","Bureau County",3,20,340,179,161
050,17,011,"Illinois","Bureau County",3,21,351,187,164
050,17,011,"Illinois","Bureau County",3,22,357,178,179
050,17,011,"Illinois","Bureau County",3,23,337,176,161
050,17,011,"Illinois","Bureau County",3,24,331,174,157
050,17,011,"Illinois","Bureau County",3,25,350,180,170
050,17,011,"Illinois","Bureau County",3,26,340,168,172
050,17,011,"Illinois","Bureau County",3,27,336,168,168
050,17,011,"Illinois","Bureau County",3,28,352,180,172
050,17,011,"Illinois","Bureau County",3,29,361,183,178
050,17,011,"Illinois","Bureau County",3,30,359,176,183
050,17,011,"Illinois","Bureau County",3,31,353,180,173
050,17,011,"Illinois","Bureau County",3,32,371,189,182
050,17,011,"Illinois","Bureau County",3,33,341,169,172
050,17,011,"Illinois","Bureau County",3,34,352,168,184
050,17,011,"Illinois","Bureau County",3,35,346,180,166
050,17,011,"Illinois","Bureau County",3,36,354,189,165
050,17,011,"Illinois","Bureau County",3,37,372,197,175
050,17,011,"Illinois","Bureau County",3,38,416,216,200
050,17,011,"Illinois","Bureau County",3,39,414,216,198
050,17,011,"Illinois","Bureau County",3,40,395,205,190
050,17,011,"Illinois","Bureau County",3,41,390,207,183
050,17,011,"Illinois","Bureau County",3,42,366,181,185
050,17,011,"Illinois","Bureau County",3,43,369,178,191
050,17,011,"Illinois","Bureau County",3,44,366,203,163
050,17,011,"Illinois","Bureau County",3,45,364,188,176
050,17,011,"Illinois","Bureau County",3,46,383,191,192
050,17,011,"Illinois","Bureau County",3,47,361,179,182
050,17,011,"Illinois","Bureau County",3,48,371,185,186
050,17,011,"Illinois","Bureau County",3,49,392,195,197
050,17,011,"Illinois","Bureau County",3,50,412,207,205
050,17,011,"Illinois","Bureau County",3,51,431,211,220
050,17,011,"Illinois","Bureau County",3,52,422,202,220
050,17,011,"Illinois","Bureau County",3,53,423,213,210
050,17,011,"Illinois","Bureau County",3,54,423,218,205
050,17,011,"Illinois","Bureau County",3,55,440,230,210
050,17,011,"Illinois","Bureau County",3,56,468,240,228
050,17,011,"Illinois","Bureau County",3,57,461,232,229
050,17,011,"Illinois","Bureau County",3,58,491,251,240
050,17,011,"Illinois","Bureau County",3,59,472,238,234
050,17,011,"Illinois","Bureau County",3,60,488,240,248
050,17,011,"Illinois","Bureau County",3,61,499,239,260
050,17,011,"Illinois","Bureau County",3,62,511,252,259
050,17,011,"Illinois","Bureau County",3,63,520,247,273
050,17,011,"Illinois","Bureau County",3,64,484,230,254
050,17,011,"Illinois","Bureau County",3,65,470,227,243
050,17,011,"Illinois","Bureau County",3,66,474,227,247
050,17,011,"Illinois","Bureau County",3,67,460,229,231
050,17,011,"Illinois","Bureau County",3,68,458,224,234
050,17,011,"Illinois","Bureau County",3,69,444,213,231
050,17,011,"Illinois","Bureau County",3,70,426,214,212
050,17,011,"Illinois","Bureau County",3,71,386,195,191
050,17,011,"Illinois","Bureau County",3,72,362,179,183
050,17,011,"Illinois","Bureau County",3,73,363,180,183
050,17,011,"Illinois","Bureau County",3,74,405,199,206
050,17,011,"Illinois","Bureau County",3,75,279,131,148
050,17,011,"Illinois","Bureau County",3,76,257,111,146
050,17,011,"Illinois","Bureau County",3,77,257,115,142
050,17,011,"Illinois","Bureau County",3,78,268,116,152
050,17,011,"Illinois","Bureau County",3,79,213,94,119
050,17,011,"Illinois","Bureau County",3,80,208,92,116
050,17,011,"Illinois","Bureau County",3,81,196,87,109
050,17,011,"Illinois","Bureau County",3,82,209,84,125
050,17,011,"Illinois","Bureau County",3,83,197,84,113
050,17,011,"Illinois","Bureau County",3,84,157,68,89
050,17,011,"Illinois","Bureau County",3,85,970,333,637
050,17,011,"Illinois","Bureau County",4,0,323,153,170
050,17,011,"Illinois","Bureau County",4,1,326,168,158
050,17,011,"Illinois","Bureau County",4,2,343,167,176
050,17,011,"Illinois","Bureau County",4,3,327,164,163
050,17,011,"Illinois","Bureau County",4,4,351,177,174
050,17,011,"Illinois","Bureau County",4,5,381,194,187
050,17,011,"Illinois","Bureau County",4,6,391,212,179
050,17,011,"Illinois","Bureau County",4,7,391,201,190
050,17,011,"Illinois","Bureau County",4,8,366,202,164
050,17,011,"Illinois","Bureau County",4,9,362,184,178
050,17,011,"Illinois","Bureau County",4,10,372,192,180
050,17,011,"Illinois","Bureau County",4,11,370,190,180
050,17,011,"Illinois","Bureau County",4,12,385,200,185
050,17,011,"Illinois","Bureau County",4,13,419,219,200
050,17,011,"Illinois","Bureau County",4,14,432,217,215
050,17,011,"Illinois","Bureau County",4,15,424,211,213
050,17,011,"Illinois","Bureau County",4,16,436,211,225
050,17,011,"Illinois","Bureau County",4,17,433,230,203
050,17,011,"Illinois","Bureau County",4,18,387,210,177
050,17,011,"Illinois","Bureau County",4,19,351,180,171
050,17,011,"Illinois","Bureau County",4,20,350,184,166
050,17,011,"Illinois","Bureau County",4,21,341,177,164
050,17,011,"Illinois","Bureau County",4,22,362,192,170
050,17,011,"Illinois","Bureau County",4,23,371,188,183
050,17,011,"Illinois","Bureau County",4,24,329,172,157
050,17,011,"Illinois","Bureau County",4,25,342,181,161
050,17,011,"Illinois","Bureau County",4,26,338,179,159
050,17,011,"Illinois","Bureau County",4,27,330,162,168
050,17,011,"Illinois","Bureau County",4,28,341,175,166
050,17,011,"Illinois","Bureau County",4,29,350,180,170
050,17,011,"Illinois","Bureau County",4,30,364,187,177
050,17,011,"Illinois","Bureau County",4,31,373,185,188
050,17,011,"Illinois","Bureau County",4,32,365,190,175
050,17,011,"Illinois","Bureau County",4,33,371,190,181
050,17,011,"Illinois","Bureau County",4,34,343,175,168
050,17,011,"Illinois","Bureau County",4,35,343,162,181
050,17,011,"Illinois","Bureau County",4,36,370,191,179
050,17,011,"Illinois","Bureau County",4,37,346,179,167
050,17,011,"Illinois","Bureau County",4,38,372,199,173
050,17,011,"Illinois","Bureau County",4,39,411,213,198
050,17,011,"Illinois","Bureau County",4,40,415,220,195
050,17,011,"Illinois","Bureau County",4,41,400,206,194
050,17,011,"Illinois","Bureau County",4,42,388,207,181
050,17,011,"Illinois","Bureau County",4,43,378,186,192
050,17,011,"Illinois","Bureau County",4,44,373,179,194
050,17,011,"Illinois","Bureau County",4,45,371,201,170
050,17,011,"Illinois","Bureau County",4,46,363,187,176
050,17,011,"Illinois","Bureau County",4,47,378,184,194
050,17,011,"Illinois","Bureau County",4,48,352,171,181
050,17,011,"Illinois","Bureau County",4,49,373,184,189
050,17,011,"Illinois","Bureau County",4,50,385,194,191
050,17,011,"Illinois","Bureau County",4,51,409,200,209
050,17,011,"Illinois","Bureau County",4,52,424,211,213
050,17,011,"Illinois","Bureau County",4,53,422,203,219
050,17,011,"Illinois","Bureau County",4,54,416,208,208
050,17,011,"Illinois","Bureau County",4,55,421,216,205
050,17,011,"Illinois","Bureau County",4,56,443,229,214
050,17,011,"Illinois","Bureau County",4,57,452,232,220
050,17,011,"Illinois","Bureau County",4,58,463,232,231
050,17,011,"Illinois","Bureau County",4,59,481,244,237
050,17,011,"Illinois","Bureau County",4,60,463,231,232
050,17,011,"Illinois","Bureau County",4,61,495,243,252
050,17,011,"Illinois","Bureau County",4,62,493,236,257
050,17,011,"Illinois","Bureau County",4,63,505,252,253
050,17,011,"Illinois","Bureau County",4,64,506,240,266
050,17,011,"Illinois","Bureau County",4,65,480,223,257
050,17,011,"Illinois","Bureau County",4,66,469,228,241
050,17,011,"Illinois","Bureau County",4,67,458,220,238
050,17,011,"Illinois","Bureau County",4,68,449,221,228
050,17,011,"Illinois","Bureau County",4,69,447,218,229
050,17,011,"Illinois","Bureau County",4,70,434,208,226
050,17,011,"Illinois","Bureau County",4,71,415,210,205
050,17,011,"Illinois","Bureau County",4,72,379,188,191
050,17,011,"Illinois","Bureau County",4,73,359,177,182
050,17,011,"Illinois","Bureau County",4,74,351,172,179
050,17,011,"Illinois","Bureau County",4,75,391,195,196
050,17,011,"Illinois","Bureau County",4,76,268,125,143
050,17,011,"Illinois","Bureau County",4,77,244,106,138
050,17,011,"Illinois","Bureau County",4,78,246,109,137
050,17,011,"Illinois","Bureau County",4,79,253,108,145
050,17,011,"Illinois","Bureau County",4,80,200,86,114
050,17,011,"Illinois","Bureau County",4,81,187,82,105
050,17,011,"Illinois","Bureau County",4,82,183,76,107
050,17,011,"Illinois","Bureau County",4,83,198,80,118
050,17,011,"Illinois","Bureau County",4,84,167,70,97
050,17,011,"Illinois","Bureau County",4,85,998,347,651
050,17,011,"Illinois","Bureau County",5,0,318,151,167
050,17,011,"Illinois","Bureau County",5,1,328,150,178
050,17,011,"Illinois","Bureau County",5,2,344,185,159
050,17,011,"Illinois","Bureau County",5,3,336,163,173
050,17,011,"Illinois","Bureau County",5,4,321,156,165
050,17,011,"Illinois","Bureau County",5,5,363,178,185
050,17,011,"Illinois","Bureau County",5,6,368,181,187
050,17,011,"Illinois","Bureau County",5,7,389,210,179
050,17,011,"Illinois","Bureau County",5,8,388,195,193
050,17,011,"Illinois","Bureau County",5,9,355,195,160
050,17,011,"Illinois","Bureau County",5,10,358,182,176
050,17,011,"Illinois","Bureau County",5,11,371,189,182
050,17,011,"Illinois","Bureau County",5,12,365,183,182
050,17,011,"Illinois","Bureau County",5,13,381,195,186
050,17,011,"Illinois","Bureau County",5,14,423,220,203
050,17,011,"Illinois","Bureau County",5,15,439,223,216
050,17,011,"Illinois","Bureau County",5,16,433,220,213
050,17,011,"Illinois","Bureau County",5,17,432,212,220
050,17,011,"Illinois","Bureau County",5,18,378,201,177
050,17,011,"Illinois","Bureau County",5,19,316,168,148
050,17,011,"Illinois","Bureau County",5,20,367,191,176
050,17,011,"Illinois","Bureau County",5,21,364,192,172
050,17,011,"Illinois","Bureau County",5,22,340,177,163
050,17,011,"Illinois","Bureau County",5,23,371,200,171
050,17,011,"Illinois","Bureau County",5,24,377,198,179
050,17,011,"Illinois","Bureau County",5,25,331,183,148
050,17,011,"Illinois","Bureau County",5,26,345,177,168
050,17,011,"Illinois","Bureau County",5,27,336,181,155
050,17,011,"Illinois","Bureau County",5,28,330,165,165
050,17,011,"Illinois","Bureau County",5,29,337,179,158
050,17,011,"Illinois","Bureau County",5,30,330,167,163
050,17,011,"Illinois","Bureau County",5,31,382,186,196
050,17,011,"Illinois","Bureau County",5,32,370,181,189
050,17,011,"Illinois","Bureau County",5,33,360,185,175
050,17,011,"Illinois","Bureau County",5,34,374,186,188
050,17,011,"Illinois","Bureau County",5,35,357,182,175
050,17,011,"Illinois","Bureau County",5,36,357,173,184
050,17,011,"Illinois","Bureau County",5,37,375,194,181
050,17,011,"Illinois","Bureau County",5,38,350,185,165
050,17,011,"Illinois","Bureau County",5,39,367,193,174
050,17,011,"Illinois","Bureau County",5,40,409,208,201
050,17,011,"Illinois","Bureau County",5,41,405,215,190
050,17,011,"Illinois","Bureau County",5,42,393,199,194
050,17,011,"Illinois","Bureau County",5,43,384,203,181
050,17,011,"Illinois","Bureau County",5,44,381,191,190
050,17,011,"Illinois","Bureau County",5,45,368,177,191
050,17,011,"Illinois","Bureau County",5,46,370,201,169
050,17,011,"Illinois","Bureau County",5,47,360,187,173
050,17,011,"Illinois","Bureau County",5,48,381,188,193
050,17,011,"Illinois","Bureau County",5,49,362,175,187
050,17,011,"Illinois","Bureau County",5,50,382,188,194
050,17,011,"Illinois","Bureau County",5,51,376,185,191
050,17,011,"Illinois","Bureau County",5,52,409,207,202
050,17,011,"Illinois","Bureau County",5,53,417,202,215
050,17,011,"Illinois","Bureau County",5,54,420,201,219
050,17,011,"Illinois","Bureau County",5,55,404,201,203
050,17,011,"Illinois","Bureau County",5,56,430,215,215
050,17,011,"Illinois","Bureau County",5,57,437,226,211
050,17,011,"Illinois","Bureau County",5,58,452,227,225
050,17,011,"Illinois","Bureau County",5,59,460,229,231
050,17,011,"Illinois","Bureau County",5,60,502,259,243
050,17,011,"Illinois","Bureau County",5,61,464,233,231
050,17,011,"Illinois","Bureau County",5,62,483,238,245
050,17,011,"Illinois","Bureau County",5,63,490,236,254
050,17,011,"Illinois","Bureau County",5,64,499,243,256
050,17,011,"Illinois","Bureau County",5,65,504,237,267
050,17,011,"Illinois","Bureau County",5,66,481,227,254
050,17,011,"Illinois","Bureau County",5,67,467,226,241
050,17,011,"Illinois","Bureau County",5,68,460,218,242
050,17,011,"Illinois","Bureau County",5,69,441,219,222
050,17,011,"Illinois","Bureau County",5,70,445,220,225
050,17,011,"Illinois","Bureau County",5,71,422,205,217
050,17,011,"Illinois","Bureau County",5,72,404,206,198
050,17,011,"Illinois","Bureau County",5,73,376,189,187
050,17,011,"Illinois","Bureau County",5,74,341,166,175
050,17,011,"Illinois","Bureau County",5,75,335,167,168
050,17,011,"Illinois","Bureau County",5,76,385,189,196
050,17,011,"Illinois","Bureau County",5,77,250,116,134
050,17,011,"Illinois","Bureau County",5,78,234,101,133
050,17,011,"Illinois","Bureau County",5,79,235,103,132
050,17,011,"Illinois","Bureau County",5,80,242,99,143
050,17,011,"Illinois","Bureau County",5,81,183,78,105
050,17,011,"Illinois","Bureau County",5,82,176,74,102
050,17,011,"Illinois","Bureau County",5,83,173,75,98
050,17,011,"Illinois","Bureau County",5,84,168,69,99
050,17,011,"Illinois","Bureau County",5,85,1043,365,678
050,17,013,"Illinois","Calhoun County",1,0,34,17,17
050,17,013,"Illinois","Calhoun County",1,1,32,14,18
050,17,013,"Illinois","Calhoun County",1,2,44,24,20
050,17,013,"Illinois","Calhoun County",1,3,43,19,24
050,17,013,"Illinois","Calhoun County",1,4,46,25,21
050,17,013,"Illinois","Calhoun County",1,5,48,24,24
050,17,013,"Illinois","Calhoun County",1,6,55,23,32
050,17,013,"Illinois","Calhoun County",1,7,42,15,27
050,17,013,"Illinois","Calhoun County",1,8,50,23,27
050,17,013,"Illinois","Calhoun County",1,9,60,34,26
050,17,013,"Illinois","Calhoun County",1,10,53,26,27
050,17,013,"Illinois","Calhoun County",1,11,55,30,25
050,17,013,"Illinois","Calhoun County",1,12,54,27,27
050,17,013,"Illinois","Calhoun County",1,13,64,39,25
050,17,013,"Illinois","Calhoun County",1,14,66,37,29
050,17,013,"Illinois","Calhoun County",1,15,45,24,21
050,17,013,"Illinois","Calhoun County",1,16,52,24,28
050,17,013,"Illinois","Calhoun County",1,17,51,23,28
050,17,013,"Illinois","Calhoun County",1,18,43,24,19
050,17,013,"Illinois","Calhoun County",1,19,35,20,15
050,17,013,"Illinois","Calhoun County",1,20,35,21,14
050,17,013,"Illinois","Calhoun County",1,21,45,24,21
050,17,013,"Illinois","Calhoun County",1,22,37,19,18
050,17,013,"Illinois","Calhoun County",1,23,42,22,20
050,17,013,"Illinois","Calhoun County",1,24,42,20,22
050,17,013,"Illinois","Calhoun County",1,25,34,13,21
050,17,013,"Illinois","Calhoun County",1,26,42,22,20
050,17,013,"Illinois","Calhoun County",1,27,48,24,24
050,17,013,"Illinois","Calhoun County",1,28,44,24,20
050,17,013,"Illinois","Calhoun County",1,29,32,19,13
050,17,013,"Illinois","Calhoun County",1,30,35,21,14
050,17,013,"Illinois","Calhoun County",1,31,39,22,17
050,17,013,"Illinois","Calhoun County",1,32,43,23,20
050,17,013,"Illinois","Calhoun County",1,33,40,22,18
050,17,013,"Illinois","Calhoun County",1,34,43,25,18
050,17,013,"Illinois","Calhoun County",1,35,49,26,23
050,17,013,"Illinois","Calhoun County",1,36,44,22,22
050,17,013,"Illinois","Calhoun County",1,37,47,22,25
050,17,013,"Illinois","Calhoun County",1,38,42,19,23
050,17,013,"Illinois","Calhoun County",1,39,41,19,22
050,17,013,"Illinois","Calhoun County",1,40,49,23,26
050,17,013,"Illinois","Calhoun County",1,41,50,29,21
050,17,013,"Illinois","Calhoun County",1,42,56,28,28
050,17,013,"Illinois","Calhoun County",1,43,38,22,16
050,17,013,"Illinois","Calhoun County",1,44,51,31,20
050,17,013,"Illinois","Calhoun County",1,45,58,32,26
050,17,013,"Illinois","Calhoun County",1,46,54,27,27
050,17,013,"Illinois","Calhoun County",1,47,55,31,24
050,17,013,"Illinois","Calhoun County",1,48,50,27,23
050,17,013,"Illinois","Calhoun County",1,49,59,30,29
050,17,013,"Illinois","Calhoun County",1,50,62,31,31
050,17,013,"Illinois","Calhoun County",1,51,62,32,30
050,17,013,"Illinois","Calhoun County",1,52,60,29,31
050,17,013,"Illinois","Calhoun County",1,53,73,37,36
050,17,013,"Illinois","Calhoun County",1,54,68,34,34
050,17,013,"Illinois","Calhoun County",1,55,69,35,34
050,17,013,"Illinois","Calhoun County",1,56,67,35,32
050,17,013,"Illinois","Calhoun County",1,57,70,39,31
050,17,013,"Illinois","Calhoun County",1,58,75,35,40
050,17,013,"Illinois","Calhoun County",1,59,78,40,38
050,17,013,"Illinois","Calhoun County",1,60,81,48,33
050,17,013,"Illinois","Calhoun County",1,61,76,44,32
050,17,013,"Illinois","Calhoun County",1,62,72,39,33
050,17,013,"Illinois","Calhoun County",1,63,71,34,37
050,17,013,"Illinois","Calhoun County",1,64,71,33,38
050,17,013,"Illinois","Calhoun County",1,65,66,34,32
050,17,013,"Illinois","Calhoun County",1,66,66,33,33
050,17,013,"Illinois","Calhoun County",1,67,68,37,31
050,17,013,"Illinois","Calhoun County",1,68,58,36,22
050,17,013,"Illinois","Calhoun County",1,69,51,29,22
050,17,013,"Illinois","Calhoun County",1,70,51,27,24
050,17,013,"Illinois","Calhoun County",1,71,57,28,29
050,17,013,"Illinois","Calhoun County",1,72,61,28,33
050,17,013,"Illinois","Calhoun County",1,73,62,29,33
050,17,013,"Illinois","Calhoun County",1,74,44,20,24
050,17,013,"Illinois","Calhoun County",1,75,40,18,22
050,17,013,"Illinois","Calhoun County",1,76,45,23,22
050,17,013,"Illinois","Calhoun County",1,77,42,20,22
050,17,013,"Illinois","Calhoun County",1,78,39,19,20
050,17,013,"Illinois","Calhoun County",1,79,36,17,19
050,17,013,"Illinois","Calhoun County",1,80,33,16,17
050,17,013,"Illinois","Calhoun County",1,81,32,14,18
050,17,013,"Illinois","Calhoun County",1,82,33,17,16
050,17,013,"Illinois","Calhoun County",1,83,27,10,17
050,17,013,"Illinois","Calhoun County",1,84,26,9,17
050,17,013,"Illinois","Calhoun County",1,85,130,41,89
050,17,013,"Illinois","Calhoun County",2,0,31,14,17
050,17,013,"Illinois","Calhoun County",2,1,33,15,18
050,17,013,"Illinois","Calhoun County",2,2,42,22,20
050,17,013,"Illinois","Calhoun County",2,3,43,20,23
050,17,013,"Illinois","Calhoun County",2,4,45,23,22
050,17,013,"Illinois","Calhoun County",2,5,47,23,24
050,17,013,"Illinois","Calhoun County",2,6,53,23,30
050,17,013,"Illinois","Calhoun County",2,7,45,17,28
050,17,013,"Illinois","Calhoun County",2,8,49,21,28
050,17,013,"Illinois","Calhoun County",2,9,58,31,27
050,17,013,"Illinois","Calhoun County",2,10,54,28,26
050,17,013,"Illinois","Calhoun County",2,11,54,29,25
050,17,013,"Illinois","Calhoun County",2,12,55,28,27
050,17,013,"Illinois","Calhoun County",2,13,61,36,25
050,17,013,"Illinois","Calhoun County",2,14,64,37,27
050,17,013,"Illinois","Calhoun County",2,15,48,26,22
050,17,013,"Illinois","Calhoun County",2,16,49,23,26
050,17,013,"Illinois","Calhoun County",2,17,51,23,28
050,17,013,"Illinois","Calhoun County",2,18,43,23,20
050,17,013,"Illinois","Calhoun County",2,19,33,19,14
050,17,013,"Illinois","Calhoun County",2,20,36,21,15
050,17,013,"Illinois","Calhoun County",2,21,43,24,19
050,17,013,"Illinois","Calhoun County",2,22,38,19,19
050,17,013,"Illinois","Calhoun County",2,23,41,22,19
050,17,013,"Illinois","Calhoun County",2,24,40,19,21
050,17,013,"Illinois","Calhoun County",2,25,35,14,21
050,17,013,"Illinois","Calhoun County",2,26,40,19,21
050,17,013,"Illinois","Calhoun County",2,27,46,23,23
050,17,013,"Illinois","Calhoun County",2,28,45,24,21
050,17,013,"Illinois","Calhoun County",2,29,34,20,14
050,17,013,"Illinois","Calhoun County",2,30,34,21,13
050,17,013,"Illinois","Calhoun County",2,31,37,21,16
050,17,013,"Illinois","Calhoun County",2,32,43,23,20
050,17,013,"Illinois","Calhoun County",2,33,41,23,18
050,17,013,"Illinois","Calhoun County",2,34,41,23,18
050,17,013,"Illinois","Calhoun County",2,35,48,26,22
050,17,013,"Illinois","Calhoun County",2,36,45,23,22
050,17,013,"Illinois","Calhoun County",2,37,46,22,24
050,17,013,"Illinois","Calhoun County",2,38,43,20,23
050,17,013,"Illinois","Calhoun County",2,39,41,19,22
050,17,013,"Illinois","Calhoun County",2,40,48,22,26
050,17,013,"Illinois","Calhoun County",2,41,49,28,21
050,17,013,"Illinois","Calhoun County",2,42,54,28,26
050,17,013,"Illinois","Calhoun County",2,43,43,24,19
050,17,013,"Illinois","Calhoun County",2,44,48,29,19
050,17,013,"Illinois","Calhoun County",2,45,57,32,25
050,17,013,"Illinois","Calhoun County",2,46,54,28,26
050,17,013,"Illinois","Calhoun County",2,47,54,30,24
050,17,013,"Illinois","Calhoun County",2,48,50,27,23
050,17,013,"Illinois","Calhoun County",2,49,58,30,28
050,17,013,"Illinois","Calhoun County",2,50,62,31,31
050,17,013,"Illinois","Calhoun County",2,51,60,31,29
050,17,013,"Illinois","Calhoun County",2,52,61,30,31
050,17,013,"Illinois","Calhoun County",2,53,70,35,35
050,17,013,"Illinois","Calhoun County",2,54,69,34,35
050,17,013,"Illinois","Calhoun County",2,55,69,35,34
050,17,013,"Illinois","Calhoun County",2,56,68,36,32
050,17,013,"Illinois","Calhoun County",2,57,69,37,32
050,17,013,"Illinois","Calhoun County",2,58,74,36,38
050,17,013,"Illinois","Calhoun County",2,59,78,39,39
050,17,013,"Illinois","Calhoun County",2,60,79,46,33
050,17,013,"Illinois","Calhoun County",2,61,78,45,33
050,17,013,"Illinois","Calhoun County",2,62,73,40,33
050,17,013,"Illinois","Calhoun County",2,63,72,36,36
050,17,013,"Illinois","Calhoun County",2,64,71,33,38
050,17,013,"Illinois","Calhoun County",2,65,67,34,33
050,17,013,"Illinois","Calhoun County",2,66,65,33,32
050,17,013,"Illinois","Calhoun County",2,67,66,35,31
050,17,013,"Illinois","Calhoun County",2,68,60,36,24
050,17,013,"Illinois","Calhoun County",2,69,53,31,22
050,17,013,"Illinois","Calhoun County",2,70,52,28,24
050,17,013,"Illinois","Calhoun County",2,71,56,28,28
050,17,013,"Illinois","Calhoun County",2,72,57,27,30
050,17,013,"Illinois","Calhoun County",2,73,66,31,35
050,17,013,"Illinois","Calhoun County",2,74,45,21,24
050,17,013,"Illinois","Calhoun County",2,75,39,17,22
050,17,013,"Illinois","Calhoun County",2,76,44,22,22
050,17,013,"Illinois","Calhoun County",2,77,44,21,23
050,17,013,"Illinois","Calhoun County",2,78,39,19,20
050,17,013,"Illinois","Calhoun County",2,79,35,16,19
050,17,013,"Illinois","Calhoun County",2,80,33,16,17
050,17,013,"Illinois","Calhoun County",2,81,31,13,18
050,17,013,"Illinois","Calhoun County",2,82,32,16,16
050,17,013,"Illinois","Calhoun County",2,83,27,11,16
050,17,013,"Illinois","Calhoun County",2,84,25,7,18
050,17,013,"Illinois","Calhoun County",2,85,128,39,89
050,17,013,"Illinois","Calhoun County",3,0,47,30,17
050,17,013,"Illinois","Calhoun County",3,1,35,14,21
050,17,013,"Illinois","Calhoun County",3,2,36,19,17
050,17,013,"Illinois","Calhoun County",3,3,42,22,20
050,17,013,"Illinois","Calhoun County",3,4,46,22,24
050,17,013,"Illinois","Calhoun County",3,5,45,22,23
050,17,013,"Illinois","Calhoun County",3,6,48,25,23
050,17,013,"Illinois","Calhoun County",3,7,59,25,34
050,17,013,"Illinois","Calhoun County",3,8,43,15,28
050,17,013,"Illinois","Calhoun County",3,9,49,23,26
050,17,013,"Illinois","Calhoun County",3,10,57,30,27
050,17,013,"Illinois","Calhoun County",3,11,54,28,26
050,17,013,"Illinois","Calhoun County",3,12,51,28,23
050,17,013,"Illinois","Calhoun County",3,13,54,28,26
050,17,013,"Illinois","Calhoun County",3,14,60,35,25
050,17,013,"Illinois","Calhoun County",3,15,65,37,28
050,17,013,"Illinois","Calhoun County",3,16,47,25,22
050,17,013,"Illinois","Calhoun County",3,17,49,23,26
050,17,013,"Illinois","Calhoun County",3,18,47,23,24
050,17,013,"Illinois","Calhoun County",3,19,35,19,16
050,17,013,"Illinois","Calhoun County",3,20,34,19,15
050,17,013,"Illinois","Calhoun County",3,21,39,22,17
050,17,013,"Illinois","Calhoun County",3,22,49,26,23
050,17,013,"Illinois","Calhoun County",3,23,35,19,16
050,17,013,"Illinois","Calhoun County",3,24,33,20,13
050,17,013,"Illinois","Calhoun County",3,25,34,16,18
050,17,013,"Illinois","Calhoun County",3,26,35,16,19
050,17,013,"Illinois","Calhoun County",3,27,42,22,20
050,17,013,"Illinois","Calhoun County",3,28,45,20,25
050,17,013,"Illinois","Calhoun County",3,29,41,20,21
050,17,013,"Illinois","Calhoun County",3,30,36,21,15
050,17,013,"Illinois","Calhoun County",3,31,35,21,14
050,17,013,"Illinois","Calhoun County",3,32,39,22,17
050,17,013,"Illinois","Calhoun County",3,33,44,24,20
050,17,013,"Illinois","Calhoun County",3,34,40,22,18
050,17,013,"Illinois","Calhoun County",3,35,43,25,18
050,17,013,"Illinois","Calhoun County",3,36,48,25,23
050,17,013,"Illinois","Calhoun County",3,37,47,23,24
050,17,013,"Illinois","Calhoun County",3,38,46,22,24
050,17,013,"Illinois","Calhoun County",3,39,41,18,23
050,17,013,"Illinois","Calhoun County",3,40,43,19,24
050,17,013,"Illinois","Calhoun County",3,41,52,24,28
050,17,013,"Illinois","Calhoun County",3,42,49,27,22
050,17,013,"Illinois","Calhoun County",3,43,53,25,28
050,17,013,"Illinois","Calhoun County",3,44,40,21,19
050,17,013,"Illinois","Calhoun County",3,45,49,30,19
050,17,013,"Illinois","Calhoun County",3,46,56,32,24
050,17,013,"Illinois","Calhoun County",3,47,57,29,28
050,17,013,"Illinois","Calhoun County",3,48,53,29,24
050,17,013,"Illinois","Calhoun County",3,49,49,26,23
050,17,013,"Illinois","Calhoun County",3,50,60,33,27
050,17,013,"Illinois","Calhoun County",3,51,60,29,31
050,17,013,"Illinois","Calhoun County",3,52,60,32,28
050,17,013,"Illinois","Calhoun County",3,53,62,30,32
050,17,013,"Illinois","Calhoun County",3,54,70,34,36
050,17,013,"Illinois","Calhoun County",3,55,68,34,34
050,17,013,"Illinois","Calhoun County",3,56,68,35,33
050,17,013,"Illinois","Calhoun County",3,57,65,32,33
050,17,013,"Illinois","Calhoun County",3,58,68,37,31
050,17,013,"Illinois","Calhoun County",3,59,74,37,37
050,17,013,"Illinois","Calhoun County",3,60,79,39,40
050,17,013,"Illinois","Calhoun County",3,61,81,46,35
050,17,013,"Illinois","Calhoun County",3,62,79,46,33
050,17,013,"Illinois","Calhoun County",3,63,72,38,34
050,17,013,"Illinois","Calhoun County",3,64,75,39,36
050,17,013,"Illinois","Calhoun County",3,65,71,33,38
050,17,013,"Illinois","Calhoun County",3,66,63,31,32
050,17,013,"Illinois","Calhoun County",3,67,61,31,30
050,17,013,"Illinois","Calhoun County",3,68,64,34,30
050,17,013,"Illinois","Calhoun County",3,69,59,35,24
050,17,013,"Illinois","Calhoun County",3,70,51,29,22
050,17,013,"Illinois","Calhoun County",3,71,48,25,23
050,17,013,"Illinois","Calhoun County",3,72,56,28,28
050,17,013,"Illinois","Calhoun County",3,73,58,28,30
050,17,013,"Illinois","Calhoun County",3,74,63,30,33
050,17,013,"Illinois","Calhoun County",3,75,43,20,23
050,17,013,"Illinois","Calhoun County",3,76,39,17,22
050,17,013,"Illinois","Calhoun County",3,77,45,21,24
050,17,013,"Illinois","Calhoun County",3,78,38,18,20
050,17,013,"Illinois","Calhoun County",3,79,36,17,19
050,17,013,"Illinois","Calhoun County",3,80,32,15,17
050,17,013,"Illinois","Calhoun County",3,81,33,14,19
050,17,013,"Illinois","Calhoun County",3,82,28,13,15
050,17,013,"Illinois","Calhoun County",3,83,32,15,17
050,17,013,"Illinois","Calhoun County",3,84,27,11,16
050,17,013,"Illinois","Calhoun County",3,85,131,41,90
050,17,013,"Illinois","Calhoun County",4,0,34,18,16
050,17,013,"Illinois","Calhoun County",4,1,44,28,16
050,17,013,"Illinois","Calhoun County",4,2,36,15,21
050,17,013,"Illinois","Calhoun County",4,3,37,20,17
050,17,013,"Illinois","Calhoun County",4,4,43,24,19
050,17,013,"Illinois","Calhoun County",4,5,48,23,25
050,17,013,"Illinois","Calhoun County",4,6,48,21,27
050,17,013,"Illinois","Calhoun County",4,7,46,23,23
050,17,013,"Illinois","Calhoun County",4,8,57,25,32
050,17,013,"Illinois","Calhoun County",4,9,45,17,28
050,17,013,"Illinois","Calhoun County",4,10,48,22,26
050,17,013,"Illinois","Calhoun County",4,11,57,30,27
050,17,013,"Illinois","Calhoun County",4,12,55,29,26
050,17,013,"Illinois","Calhoun County",4,13,51,27,24
050,17,013,"Illinois","Calhoun County",4,14,56,29,27
050,17,013,"Illinois","Calhoun County",4,15,54,29,25
050,17,013,"Illinois","Calhoun County",4,16,66,37,29
050,17,013,"Illinois","Calhoun County",4,17,48,26,22
050,17,013,"Illinois","Calhoun County",4,18,44,20,24
050,17,013,"Illinois","Calhoun County",4,19,36,17,19
050,17,013,"Illinois","Calhoun County",4,20,32,19,13
050,17,013,"Illinois","Calhoun County",4,21,36,19,17
050,17,013,"Illinois","Calhoun County",4,22,42,22,20
050,17,013,"Illinois","Calhoun County",4,23,50,27,23
050,17,013,"Illinois","Calhoun County",4,24,38,22,16
050,17,013,"Illinois","Calhoun County",4,25,31,18,13
050,17,013,"Illinois","Calhoun County",4,26,31,13,18
050,17,013,"Illinois","Calhoun County",4,27,39,18,21
050,17,013,"Illinois","Calhoun County",4,28,38,20,18
050,17,013,"Illinois","Calhoun County",4,29,47,19,28
050,17,013,"Illinois","Calhoun County",4,30,41,20,21
050,17,013,"Illinois","Calhoun County",4,31,37,22,15
050,17,013,"Illinois","Calhoun County",4,32,36,21,15
050,17,013,"Illinois","Calhoun County",4,33,42,25,17
050,17,013,"Illinois","Calhoun County",4,34,43,23,20
050,17,013,"Illinois","Calhoun County",4,35,42,24,18
050,17,013,"Illinois","Calhoun County",4,36,40,23,17
050,17,013,"Illinois","Calhoun County",4,37,51,26,25
050,17,013,"Illinois","Calhoun County",4,38,47,23,24
050,17,013,"Illinois","Calhoun County",4,39,46,22,24
050,17,013,"Illinois","Calhoun County",4,40,41,18,23
050,17,013,"Illinois","Calhoun County",4,41,44,20,24
050,17,013,"Illinois","Calhoun County",4,42,50,23,27
050,17,013,"Illinois","Calhoun County",4,43,48,26,22
050,17,013,"Illinois","Calhoun County",4,44,53,25,28
050,17,013,"Illinois","Calhoun County",4,45,41,23,18
050,17,013,"Illinois","Calhoun County",4,46,50,31,19
050,17,013,"Illinois","Calhoun County",4,47,58,33,25
050,17,013,"Illinois","Calhoun County",4,48,56,29,27
050,17,013,"Illinois","Calhoun County",4,49,52,29,23
050,17,013,"Illinois","Calhoun County",4,50,48,25,23
050,17,013,"Illinois","Calhoun County",4,51,60,33,27
050,17,013,"Illinois","Calhoun County",4,52,60,29,31
050,17,013,"Illinois","Calhoun County",4,53,56,30,26
050,17,013,"Illinois","Calhoun County",4,54,61,30,31
050,17,013,"Illinois","Calhoun County",4,55,67,33,34
050,17,013,"Illinois","Calhoun County",4,56,65,31,34
050,17,013,"Illinois","Calhoun County",4,57,66,32,34
050,17,013,"Illinois","Calhoun County",4,58,64,31,33
050,17,013,"Illinois","Calhoun County",4,59,69,38,31
050,17,013,"Illinois","Calhoun County",4,60,78,38,40
050,17,013,"Illinois","Calhoun County",4,61,81,40,41
050,17,013,"Illinois","Calhoun County",4,62,81,47,34
050,17,013,"Illinois","Calhoun County",4,63,78,45,33
050,17,013,"Illinois","Calhoun County",4,64,73,38,35
050,17,013,"Illinois","Calhoun County",4,65,73,38,35
050,17,013,"Illinois","Calhoun County",4,66,72,34,38
050,17,013,"Illinois","Calhoun County",4,67,65,31,34
050,17,013,"Illinois","Calhoun County",4,68,62,31,31
050,17,013,"Illinois","Calhoun County",4,69,59,31,28
050,17,013,"Illinois","Calhoun County",4,70,60,33,27
050,17,013,"Illinois","Calhoun County",4,71,50,29,21
050,17,013,"Illinois","Calhoun County",4,72,49,26,23
050,17,013,"Illinois","Calhoun County",4,73,56,28,28
050,17,013,"Illinois","Calhoun County",4,74,56,27,29
050,17,013,"Illinois","Calhoun County",4,75,57,30,27
050,17,013,"Illinois","Calhoun County",4,76,46,23,23
050,17,013,"Illinois","Calhoun County",4,77,32,10,22
050,17,013,"Illinois","Calhoun County",4,78,40,18,22
050,17,013,"Illinois","Calhoun County",4,79,32,15,17
050,17,013,"Illinois","Calhoun County",4,80,34,17,17
050,17,013,"Illinois","Calhoun County",4,81,30,13,17
050,17,013,"Illinois","Calhoun County",4,82,30,14,16
050,17,013,"Illinois","Calhoun County",4,83,26,12,14
050,17,013,"Illinois","Calhoun County",4,84,33,15,18
050,17,013,"Illinois","Calhoun County",4,85,129,47,82
050,17,013,"Illinois","Calhoun County",5,0,27,15,12
050,17,013,"Illinois","Calhoun County",5,1,34,18,16
050,17,013,"Illinois","Calhoun County",5,2,45,28,17
050,17,013,"Illinois","Calhoun County",5,3,34,13,21
050,17,013,"Illinois","Calhoun County",5,4,37,19,18
050,17,013,"Illinois","Calhoun County",5,5,45,23,22
050,17,013,"Illinois","Calhoun County",5,6,42,19,23
050,17,013,"Illinois","Calhoun County",5,7,49,21,28
050,17,013,"Illinois","Calhoun County",5,8,49,23,26
050,17,013,"Illinois","Calhoun County",5,9,55,24,31
050,17,013,"Illinois","Calhoun County",5,10,46,17,29
050,17,013,"Illinois","Calhoun County",5,11,55,25,30
050,17,013,"Illinois","Calhoun County",5,12,58,31,27
050,17,013,"Illinois","Calhoun County",5,13,55,30,25
050,17,013,"Illinois","Calhoun County",5,14,53,29,24
050,17,013,"Illinois","Calhoun County",5,15,58,30,28
050,17,013,"Illinois","Calhoun County",5,16,56,31,25
050,17,013,"Illinois","Calhoun County",5,17,67,39,28
050,17,013,"Illinois","Calhoun County",5,18,39,22,17
050,17,013,"Illinois","Calhoun County",5,19,34,15,19
050,17,013,"Illinois","Calhoun County",5,20,37,19,18
050,17,013,"Illinois","Calhoun County",5,21,31,18,13
050,17,013,"Illinois","Calhoun County",5,22,37,21,16
050,17,013,"Illinois","Calhoun County",5,23,41,22,19
050,17,013,"Illinois","Calhoun County",5,24,54,30,24
050,17,013,"Illinois","Calhoun County",5,25,38,21,17
050,17,013,"Illinois","Calhoun County",5,26,30,16,14
050,17,013,"Illinois","Calhoun County",5,27,28,11,17
050,17,013,"Illinois","Calhoun County",5,28,38,18,20
050,17,013,"Illinois","Calhoun County",5,29,40,21,19
050,17,013,"Illinois","Calhoun County",5,30,47,21,26
050,17,013,"Illinois","Calhoun County",5,31,40,19,21
050,17,013,"Illinois","Calhoun County",5,32,39,22,17
050,17,013,"Illinois","Calhoun County",5,33,37,22,15
050,17,013,"Illinois","Calhoun County",5,34,43,25,18
050,17,013,"Illinois","Calhoun County",5,35,43,23,20
050,17,013,"Illinois","Calhoun County",5,36,39,21,18
050,17,013,"Illinois","Calhoun County",5,37,40,24,16
050,17,013,"Illinois","Calhoun County",5,38,53,26,27
050,17,013,"Illinois","Calhoun County",5,39,48,23,25
050,17,013,"Illinois","Calhoun County",5,40,48,24,24
050,17,013,"Illinois","Calhoun County",5,41,43,19,24
050,17,013,"Illinois","Calhoun County",5,42,42,21,21
050,17,013,"Illinois","Calhoun County",5,43,49,22,27
050,17,013,"Illinois","Calhoun County",5,44,51,28,23
050,17,013,"Illinois","Calhoun County",5,45,56,27,29
050,17,013,"Illinois","Calhoun County",5,46,39,19,20
050,17,013,"Illinois","Calhoun County",5,47,49,30,19
050,17,013,"Illinois","Calhoun County",5,48,59,33,26
050,17,013,"Illinois","Calhoun County",5,49,57,30,27
050,17,013,"Illinois","Calhoun County",5,50,54,28,26
050,17,013,"Illinois","Calhoun County",5,51,46,24,22
050,17,013,"Illinois","Calhoun County",5,52,62,33,29
050,17,013,"Illinois","Calhoun County",5,53,62,32,30
050,17,013,"Illinois","Calhoun County",5,54,56,29,27
050,17,013,"Illinois","Calhoun County",5,55,64,32,32
050,17,013,"Illinois","Calhoun County",5,56,65,31,34
050,17,013,"Illinois","Calhoun County",5,57,62,28,34
050,17,013,"Illinois","Calhoun County",5,58,65,30,35
050,17,013,"Illinois","Calhoun County",5,59,69,36,33
050,17,013,"Illinois","Calhoun County",5,60,70,39,31
050,17,013,"Illinois","Calhoun County",5,61,74,35,39
050,17,013,"Illinois","Calhoun County",5,62,81,40,41
050,17,013,"Illinois","Calhoun County",5,63,83,49,34
050,17,013,"Illinois","Calhoun County",5,64,81,48,33
050,17,013,"Illinois","Calhoun County",5,65,73,39,34
050,17,013,"Illinois","Calhoun County",5,66,68,37,31
050,17,013,"Illinois","Calhoun County",5,67,71,34,37
050,17,013,"Illinois","Calhoun County",5,68,66,31,35
050,17,013,"Illinois","Calhoun County",5,69,58,27,31
050,17,013,"Illinois","Calhoun County",5,70,59,30,29
050,17,013,"Illinois","Calhoun County",5,71,56,31,25
050,17,013,"Illinois","Calhoun County",5,72,50,30,20
050,17,013,"Illinois","Calhoun County",5,73,49,26,23
050,17,013,"Illinois","Calhoun County",5,74,53,27,26
050,17,013,"Illinois","Calhoun County",5,75,47,24,23
050,17,013,"Illinois","Calhoun County",5,76,56,30,26
050,17,013,"Illinois","Calhoun County",5,77,39,15,24
050,17,013,"Illinois","Calhoun County",5,78,29,7,22
050,17,013,"Illinois","Calhoun County",5,79,37,15,22
050,17,013,"Illinois","Calhoun County",5,80,28,14,14
050,17,013,"Illinois","Calhoun County",5,81,34,16,18
050,17,013,"Illinois","Calhoun County",5,82,26,12,14
050,17,013,"Illinois","Calhoun County",5,83,31,13,18
050,17,013,"Illinois","Calhoun County",5,84,27,12,15
050,17,013,"Illinois","Calhoun County",5,85,132,54,78
050,17,015,"Illinois","Carroll County",1,0,127,65,62
050,17,015,"Illinois","Carroll County",1,1,140,72,68
050,17,015,"Illinois","Carroll County",1,2,147,70,77
050,17,015,"Illinois","Carroll County",1,3,143,64,79
050,17,015,"Illinois","Carroll County",1,4,174,89,85
050,17,015,"Illinois","Carroll County",1,5,169,93,76
050,17,015,"Illinois","Carroll County",1,6,156,71,85
050,17,015,"Illinois","Carroll County",1,7,162,77,85
050,17,015,"Illinois","Carroll County",1,8,158,74,84
050,17,015,"Illinois","Carroll County",1,9,161,72,89
050,17,015,"Illinois","Carroll County",1,10,159,80,79
050,17,015,"Illinois","Carroll County",1,11,141,83,58
050,17,015,"Illinois","Carroll County",1,12,177,90,87
050,17,015,"Illinois","Carroll County",1,13,170,77,93
050,17,015,"Illinois","Carroll County",1,14,179,93,86
050,17,015,"Illinois","Carroll County",1,15,175,93,82
050,17,015,"Illinois","Carroll County",1,16,194,101,93
050,17,015,"Illinois","Carroll County",1,17,177,93,84
050,17,015,"Illinois","Carroll County",1,18,158,95,63
050,17,015,"Illinois","Carroll County",1,19,132,84,48
050,17,015,"Illinois","Carroll County",1,20,203,142,61
050,17,015,"Illinois","Carroll County",1,21,279,224,55
050,17,015,"Illinois","Carroll County",1,22,155,88,67
050,17,015,"Illinois","Carroll County",1,23,171,100,71
050,17,015,"Illinois","Carroll County",1,24,210,149,61
050,17,015,"Illinois","Carroll County",1,25,129,64,65
050,17,015,"Illinois","Carroll County",1,26,171,95,76
050,17,015,"Illinois","Carroll County",1,27,190,112,78
050,17,015,"Illinois","Carroll County",1,28,211,142,69
050,17,015,"Illinois","Carroll County",1,29,145,71,74
050,17,015,"Illinois","Carroll County",1,30,204,146,58
050,17,015,"Illinois","Carroll County",1,31,202,128,74
050,17,015,"Illinois","Carroll County",1,32,204,132,72
050,17,015,"Illinois","Carroll County",1,33,143,75,68
050,17,015,"Illinois","Carroll County",1,34,172,98,74
050,17,015,"Illinois","Carroll County",1,35,170,101,69
050,17,015,"Illinois","Carroll County",1,36,189,101,88
050,17,015,"Illinois","Carroll County",1,37,174,87,87
050,17,015,"Illinois","Carroll County",1,38,242,168,74
050,17,015,"Illinois","Carroll County",1,39,207,126,81
050,17,015,"Illinois","Carroll County",1,40,167,89,78
050,17,015,"Illinois","Carroll County",1,41,164,92,72
050,17,015,"Illinois","Carroll County",1,42,179,104,75
050,17,015,"Illinois","Carroll County",1,43,159,82,77
050,17,015,"Illinois","Carroll County",1,44,150,66,84
050,17,015,"Illinois","Carroll County",1,45,156,79,77
050,17,015,"Illinois","Carroll County",1,46,196,108,88
050,17,015,"Illinois","Carroll County",1,47,201,127,74
050,17,015,"Illinois","Carroll County",1,48,194,116,78
050,17,015,"Illinois","Carroll County",1,49,202,114,88
050,17,015,"Illinois","Carroll County",1,50,206,115,91
050,17,015,"Illinois","Carroll County",1,51,177,89,88
050,17,015,"Illinois","Carroll County",1,52,152,75,77
050,17,015,"Illinois","Carroll County",1,53,160,83,77
050,17,015,"Illinois","Carroll County",1,54,210,123,87
050,17,015,"Illinois","Carroll County",1,55,204,95,109
050,17,015,"Illinois","Carroll County",1,56,196,106,90
050,17,015,"Illinois","Carroll County",1,57,213,110,103
050,17,015,"Illinois","Carroll County",1,58,263,152,111
050,17,015,"Illinois","Carroll County",1,59,269,142,127
050,17,015,"Illinois","Carroll County",1,60,240,116,124
050,17,015,"Illinois","Carroll County",1,61,226,107,119
050,17,015,"Illinois","Carroll County",1,62,220,106,114
050,17,015,"Illinois","Carroll County",1,63,246,118,128
050,17,015,"Illinois","Carroll County",1,64,231,114,117
050,17,015,"Illinois","Carroll County",1,65,246,128,118
050,17,015,"Illinois","Carroll County",1,66,254,130,124
050,17,015,"Illinois","Carroll County",1,67,222,117,105
050,17,015,"Illinois","Carroll County",1,68,218,118,100
050,17,015,"Illinois","Carroll County",1,69,217,107,110
050,17,015,"Illinois","Carroll County",1,70,226,106,120
050,17,015,"Illinois","Carroll County",1,71,199,93,106
050,17,015,"Illinois","Carroll County",1,72,214,112,102
050,17,015,"Illinois","Carroll County",1,73,220,112,108
050,17,015,"Illinois","Carroll County",1,74,150,81,69
050,17,015,"Illinois","Carroll County",1,75,148,75,73
050,17,015,"Illinois","Carroll County",1,76,138,64,74
050,17,015,"Illinois","Carroll County",1,77,146,66,80
050,17,015,"Illinois","Carroll County",1,78,135,60,75
050,17,015,"Illinois","Carroll County",1,79,127,68,59
050,17,015,"Illinois","Carroll County",1,80,100,53,47
050,17,015,"Illinois","Carroll County",1,81,100,51,49
050,17,015,"Illinois","Carroll County",1,82,91,43,48
050,17,015,"Illinois","Carroll County",1,83,76,33,43
050,17,015,"Illinois","Carroll County",1,84,61,23,38
050,17,015,"Illinois","Carroll County",1,85,468,177,291
050,17,015,"Illinois","Carroll County",2,0,136,67,69
050,17,015,"Illinois","Carroll County",2,1,136,70,66
050,17,015,"Illinois","Carroll County",2,2,144,70,74
050,17,015,"Illinois","Carroll County",2,3,147,67,80
050,17,015,"Illinois","Carroll County",2,4,165,83,82
050,17,015,"Illinois","Carroll County",2,5,169,91,78
050,17,015,"Illinois","Carroll County",2,6,161,77,84
050,17,015,"Illinois","Carroll County",2,7,158,74,84
050,17,015,"Illinois","Carroll County",2,8,158,73,85
050,17,015,"Illinois","Carroll County",2,9,162,75,87
050,17,015,"Illinois","Carroll County",2,10,161,80,81
050,17,015,"Illinois","Carroll County",2,11,146,82,64
050,17,015,"Illinois","Carroll County",2,12,168,88,80
050,17,015,"Illinois","Carroll County",2,13,173,82,91
050,17,015,"Illinois","Carroll County",2,14,178,90,88
050,17,015,"Illinois","Carroll County",2,15,180,95,85
050,17,015,"Illinois","Carroll County",2,16,189,100,89
050,17,015,"Illinois","Carroll County",2,17,184,97,87
050,17,015,"Illinois","Carroll County",2,18,155,91,64
050,17,015,"Illinois","Carroll County",2,19,130,83,47
050,17,015,"Illinois","Carroll County",2,20,203,145,58
050,17,015,"Illinois","Carroll County",2,21,281,225,56
050,17,015,"Illinois","Carroll County",2,22,154,90,64
050,17,015,"Illinois","Carroll County",2,23,172,102,70
050,17,015,"Illinois","Carroll County",2,24,209,147,62
050,17,015,"Illinois","Carroll County",2,25,130,66,64
050,17,015,"Illinois","Carroll County",2,26,167,93,74
050,17,015,"Illinois","Carroll County",2,27,189,113,76
050,17,015,"Illinois","Carroll County",2,28,210,140,70
050,17,015,"Illinois","Carroll County",2,29,142,71,71
050,17,015,"Illinois","Carroll County",2,30,211,149,62
050,17,015,"Illinois","Carroll County",2,31,195,124,71
050,17,015,"Illinois","Carroll County",2,32,202,129,73
050,17,015,"Illinois","Carroll County",2,33,147,79,68
050,17,015,"Illinois","Carroll County",2,34,171,98,73
050,17,015,"Illinois","Carroll County",2,35,169,100,69
050,17,015,"Illinois","Carroll County",2,36,185,101,84
050,17,015,"Illinois","Carroll County",2,37,172,85,87
050,17,015,"Illinois","Carroll County",2,38,247,169,78
050,17,015,"Illinois","Carroll County",2,39,205,126,79
050,17,015,"Illinois","Carroll County",2,40,173,94,79
050,17,015,"Illinois","Carroll County",2,41,164,91,73
050,17,015,"Illinois","Carroll County",2,42,174,102,72
050,17,015,"Illinois","Carroll County",2,43,158,81,77
050,17,015,"Illinois","Carroll County",2,44,153,70,83
050,17,015,"Illinois","Carroll County",2,45,156,77,79
050,17,015,"Illinois","Carroll County",2,46,190,106,84
050,17,015,"Illinois","Carroll County",2,47,204,127,77
050,17,015,"Illinois","Carroll County",2,48,191,114,77
050,17,015,"Illinois","Carroll County",2,49,201,115,86
050,17,015,"Illinois","Carroll County",2,50,205,114,91
050,17,015,"Illinois","Carroll County",2,51,177,89,88
050,17,015,"Illinois","Carroll County",2,52,157,78,79
050,17,015,"Illinois","Carroll County",2,53,158,82,76
050,17,015,"Illinois","Carroll County",2,54,201,118,83
050,17,015,"Illinois","Carroll County",2,55,200,96,104
050,17,015,"Illinois","Carroll County",2,56,199,104,95
050,17,015,"Illinois","Carroll County",2,57,210,109,101
050,17,015,"Illinois","Carroll County",2,58,256,146,110
050,17,015,"Illinois","Carroll County",2,59,269,146,123
050,17,015,"Illinois","Carroll County",2,60,239,115,124
050,17,015,"Illinois","Carroll County",2,61,230,109,121
050,17,015,"Illinois","Carroll County",2,62,221,107,114
050,17,015,"Illinois","Carroll County",2,63,242,115,127
050,17,015,"Illinois","Carroll County",2,64,234,115,119
050,17,015,"Illinois","Carroll County",2,65,241,124,117
050,17,015,"Illinois","Carroll County",2,66,248,126,122
050,17,015,"Illinois","Carroll County",2,67,228,119,109
050,17,015,"Illinois","Carroll County",2,68,215,114,101
050,17,015,"Illinois","Carroll County",2,69,218,110,108
050,17,015,"Illinois","Carroll County",2,70,225,108,117
050,17,015,"Illinois","Carroll County",2,71,205,96,109
050,17,015,"Illinois","Carroll County",2,72,207,104,103
050,17,015,"Illinois","Carroll County",2,73,229,117,112
050,17,015,"Illinois","Carroll County",2,74,151,79,72
050,17,015,"Illinois","Carroll County",2,75,148,77,71
050,17,015,"Illinois","Carroll County",2,76,137,66,71
050,17,015,"Illinois","Carroll County",2,77,145,65,80
050,17,015,"Illinois","Carroll County",2,78,132,60,72
050,17,015,"Illinois","Carroll County",2,79,127,66,61
050,17,015,"Illinois","Carroll County",2,80,103,55,48
050,17,015,"Illinois","Carroll County",2,81,98,51,47
050,17,015,"Illinois","Carroll County",2,82,92,43,49
050,17,015,"Illinois","Carroll County",2,83,77,34,43
050,17,015,"Illinois","Carroll County",2,84,64,24,40
050,17,015,"Illinois","Carroll County",2,85,459,174,285
050,17,015,"Illinois","Carroll County",3,0,117,65,52
050,17,015,"Illinois","Carroll County",3,1,123,61,62
050,17,015,"Illinois","Carroll County",3,2,134,64,70
050,17,015,"Illinois","Carroll County",3,3,152,73,79
050,17,015,"Illinois","Carroll County",3,4,141,67,74
050,17,015,"Illinois","Carroll County",3,5,165,84,81
050,17,015,"Illinois","Carroll County",3,6,171,93,78
050,17,015,"Illinois","Carroll County",3,7,171,83,88
050,17,015,"Illinois","Carroll County",3,8,147,69,78
050,17,015,"Illinois","Carroll County",3,9,160,75,85
050,17,015,"Illinois","Carroll County",3,10,164,77,87
050,17,015,"Illinois","Carroll County",3,11,159,78,81
050,17,015,"Illinois","Carroll County",3,12,146,82,64
050,17,015,"Illinois","Carroll County",3,13,166,92,74
050,17,015,"Illinois","Carroll County",3,14,191,95,96
050,17,015,"Illinois","Carroll County",3,15,187,96,91
050,17,015,"Illinois","Carroll County",3,16,181,96,85
050,17,015,"Illinois","Carroll County",3,17,194,100,94
050,17,015,"Illinois","Carroll County",3,18,151,79,72
050,17,015,"Illinois","Carroll County",3,19,128,77,51
050,17,015,"Illinois","Carroll County",3,20,206,150,56
050,17,015,"Illinois","Carroll County",3,21,285,227,58
050,17,015,"Illinois","Carroll County",3,22,164,105,59
050,17,015,"Illinois","Carroll County",3,23,180,110,70
050,17,015,"Illinois","Carroll County",3,24,215,145,70
050,17,015,"Illinois","Carroll County",3,25,146,69,77
050,17,015,"Illinois","Carroll County",3,26,149,86,63
050,17,015,"Illinois","Carroll County",3,27,182,118,64
050,17,015,"Illinois","Carroll County",3,28,198,129,69
050,17,015,"Illinois","Carroll County",3,29,154,83,71
050,17,015,"Illinois","Carroll County",3,30,225,154,71
050,17,015,"Illinois","Carroll County",3,31,169,110,59
050,17,015,"Illinois","Carroll County",3,32,189,123,66
050,17,015,"Illinois","Carroll County",3,33,158,87,71
050,17,015,"Illinois","Carroll County",3,34,177,104,73
050,17,015,"Illinois","Carroll County",3,35,161,88,73
050,17,015,"Illinois","Carroll County",3,36,174,106,68
050,17,015,"Illinois","Carroll County",3,37,169,86,83
050,17,015,"Illinois","Carroll County",3,38,261,175,86
050,17,015,"Illinois","Carroll County",3,39,211,125,86
050,17,015,"Illinois","Carroll County",3,40,189,110,79
050,17,015,"Illinois","Carroll County",3,41,177,94,83
050,17,015,"Illinois","Carroll County",3,42,178,100,78
050,17,015,"Illinois","Carroll County",3,43,157,80,77
050,17,015,"Illinois","Carroll County",3,44,157,82,75
050,17,015,"Illinois","Carroll County",3,45,155,72,83
050,17,015,"Illinois","Carroll County",3,46,184,101,83
050,17,015,"Illinois","Carroll County",3,47,207,125,82
050,17,015,"Illinois","Carroll County",3,48,194,113,81
050,17,015,"Illinois","Carroll County",3,49,197,118,79
050,17,015,"Illinois","Carroll County",3,50,203,114,89
050,17,015,"Illinois","Carroll County",3,51,186,96,90
050,17,015,"Illinois","Carroll County",3,52,184,88,96
050,17,015,"Illinois","Carroll County",3,53,157,76,81
050,17,015,"Illinois","Carroll County",3,54,184,105,79
050,17,015,"Illinois","Carroll County",3,55,182,96,86
050,17,015,"Illinois","Carroll County",3,56,199,96,103
050,17,015,"Illinois","Carroll County",3,57,198,103,95
050,17,015,"Illinois","Carroll County",3,58,239,135,104
050,17,015,"Illinois","Carroll County",3,59,252,144,108
050,17,015,"Illinois","Carroll County",3,60,248,123,125
050,17,015,"Illinois","Carroll County",3,61,239,113,126
050,17,015,"Illinois","Carroll County",3,62,239,115,124
050,17,015,"Illinois","Carroll County",3,63,224,113,111
050,17,015,"Illinois","Carroll County",3,64,253,122,131
050,17,015,"Illinois","Carroll County",3,65,233,114,119
050,17,015,"Illinois","Carroll County",3,66,239,123,116
050,17,015,"Illinois","Carroll County",3,67,242,121,121
050,17,015,"Illinois","Carroll County",3,68,229,119,110
050,17,015,"Illinois","Carroll County",3,69,206,110,96
050,17,015,"Illinois","Carroll County",3,70,215,108,107
050,17,015,"Illinois","Carroll County",3,71,214,101,113
050,17,015,"Illinois","Carroll County",3,72,204,94,110
050,17,015,"Illinois","Carroll County",3,73,200,100,100
050,17,015,"Illinois","Carroll County",3,74,219,111,108
050,17,015,"Illinois","Carroll County",3,75,150,80,70
050,17,015,"Illinois","Carroll County",3,76,137,74,63
050,17,015,"Illinois","Carroll County",3,77,132,63,69
050,17,015,"Illinois","Carroll County",3,78,135,61,74
050,17,015,"Illinois","Carroll County",3,79,124,57,67
050,17,015,"Illinois","Carroll County",3,80,124,65,59
050,17,015,"Illinois","Carroll County",3,81,99,52,47
050,17,015,"Illinois","Carroll County",3,82,88,45,43
050,17,015,"Illinois","Carroll County",3,83,84,37,47
050,17,015,"Illinois","Carroll County",3,84,67,31,36
050,17,015,"Illinois","Carroll County",3,85,458,168,290
050,17,015,"Illinois","Carroll County",4,0,128,74,54
050,17,015,"Illinois","Carroll County",4,1,139,74,65
050,17,015,"Illinois","Carroll County",4,2,120,63,57
050,17,015,"Illinois","Carroll County",4,3,143,72,71
050,17,015,"Illinois","Carroll County",4,4,150,73,77
050,17,015,"Illinois","Carroll County",4,5,142,71,71
050,17,015,"Illinois","Carroll County",4,6,162,90,72
050,17,015,"Illinois","Carroll County",4,7,173,95,78
050,17,015,"Illinois","Carroll County",4,8,171,87,84
050,17,015,"Illinois","Carroll County",4,9,152,72,80
050,17,015,"Illinois","Carroll County",4,10,159,82,77
050,17,015,"Illinois","Carroll County",4,11,166,76,90
050,17,015,"Illinois","Carroll County",4,12,161,77,84
050,17,015,"Illinois","Carroll County",4,13,152,85,67
050,17,015,"Illinois","Carroll County",4,14,174,94,80
050,17,015,"Illinois","Carroll County",4,15,179,86,93
050,17,015,"Illinois","Carroll County",4,16,180,88,92
050,17,015,"Illinois","Carroll County",4,17,175,91,84
050,17,015,"Illinois","Carroll County",4,18,166,92,74
050,17,015,"Illinois","Carroll County",4,19,120,63,57
050,17,015,"Illinois","Carroll County",4,20,195,136,59
050,17,015,"Illinois","Carroll County",4,21,306,244,62
050,17,015,"Illinois","Carroll County",4,22,162,97,65
050,17,015,"Illinois","Carroll County",4,23,171,119,52
050,17,015,"Illinois","Carroll County",4,24,225,153,72
050,17,015,"Illinois","Carroll County",4,25,131,62,69
050,17,015,"Illinois","Carroll County",4,26,146,83,63
050,17,015,"Illinois","Carroll County",4,27,166,105,61
050,17,015,"Illinois","Carroll County",4,28,206,140,66
050,17,015,"Illinois","Carroll County",4,29,133,66,67
050,17,015,"Illinois","Carroll County",4,30,236,163,73
050,17,015,"Illinois","Carroll County",4,31,178,112,66
050,17,015,"Illinois","Carroll County",4,32,171,107,64
050,17,015,"Illinois","Carroll County",4,33,142,78,64
050,17,015,"Illinois","Carroll County",4,34,181,106,75
050,17,015,"Illinois","Carroll County",4,35,176,108,68
050,17,015,"Illinois","Carroll County",4,36,170,95,75
050,17,015,"Illinois","Carroll County",4,37,150,85,65
050,17,015,"Illinois","Carroll County",4,38,252,171,81
050,17,015,"Illinois","Carroll County",4,39,218,131,87
050,17,015,"Illinois","Carroll County",4,40,196,109,87
050,17,015,"Illinois","Carroll County",4,41,191,112,79
050,17,015,"Illinois","Carroll County",4,42,177,93,84
050,17,015,"Illinois","Carroll County",4,43,154,76,78
050,17,015,"Illinois","Carroll County",4,44,153,79,74
050,17,015,"Illinois","Carroll County",4,45,155,83,72
050,17,015,"Illinois","Carroll County",4,46,179,96,83
050,17,015,"Illinois","Carroll County",4,47,204,120,84
050,17,015,"Illinois","Carroll County",4,48,185,104,81
050,17,015,"Illinois","Carroll County",4,49,195,113,82
050,17,015,"Illinois","Carroll County",4,50,201,120,81
050,17,015,"Illinois","Carroll County",4,51,174,87,87
050,17,015,"Illinois","Carroll County",4,52,184,96,88
050,17,015,"Illinois","Carroll County",4,53,183,88,95
050,17,015,"Illinois","Carroll County",4,54,179,99,80
050,17,015,"Illinois","Carroll County",4,55,158,84,74
050,17,015,"Illinois","Carroll County",4,56,182,95,87
050,17,015,"Illinois","Carroll County",4,57,198,98,100
050,17,015,"Illinois","Carroll County",4,58,227,127,100
050,17,015,"Illinois","Carroll County",4,59,236,132,104
050,17,015,"Illinois","Carroll County",4,60,239,132,107
050,17,015,"Illinois","Carroll County",4,61,251,126,125
050,17,015,"Illinois","Carroll County",4,62,252,120,132
050,17,015,"Illinois","Carroll County",4,63,233,109,124
050,17,015,"Illinois","Carroll County",4,64,226,115,111
050,17,015,"Illinois","Carroll County",4,65,252,122,130
050,17,015,"Illinois","Carroll County",4,66,230,109,121
050,17,015,"Illinois","Carroll County",4,67,238,123,115
050,17,015,"Illinois","Carroll County",4,68,238,118,120
050,17,015,"Illinois","Carroll County",4,69,223,116,107
050,17,015,"Illinois","Carroll County",4,70,201,106,95
050,17,015,"Illinois","Carroll County",4,71,213,108,105
050,17,015,"Illinois","Carroll County",4,72,210,98,112
050,17,015,"Illinois","Carroll County",4,73,196,88,108
050,17,015,"Illinois","Carroll County",4,74,190,97,93
050,17,015,"Illinois","Carroll County",4,75,204,105,99
050,17,015,"Illinois","Carroll County",4,76,142,77,65
050,17,015,"Illinois","Carroll County",4,77,130,70,60
050,17,015,"Illinois","Carroll County",4,78,127,59,68
050,17,015,"Illinois","Carroll County",4,79,121,57,64
050,17,015,"Illinois","Carroll County",4,80,107,51,56
050,17,015,"Illinois","Carroll County",4,81,121,62,59
050,17,015,"Illinois","Carroll County",4,82,95,50,45
050,17,015,"Illinois","Carroll County",4,83,82,39,43
050,17,015,"Illinois","Carroll County",4,84,67,32,35
050,17,015,"Illinois","Carroll County",4,85,453,167,286
050,17,015,"Illinois","Carroll County",5,0,123,76,47
050,17,015,"Illinois","Carroll County",5,1,133,75,58
050,17,015,"Illinois","Carroll County",5,2,138,74,64
050,17,015,"Illinois","Carroll County",5,3,117,61,56
050,17,015,"Illinois","Carroll County",5,4,144,74,70
050,17,015,"Illinois","Carroll County",5,5,150,71,79
050,17,015,"Illinois","Carroll County",5,6,156,74,82
050,17,015,"Illinois","Carroll County",5,7,160,86,74
050,17,015,"Illinois","Carroll County",5,8,178,95,83
050,17,015,"Illinois","Carroll County",5,9,168,82,86
050,17,015,"Illinois","Carroll County",5,10,156,74,82
050,17,015,"Illinois","Carroll County",5,11,160,84,76
050,17,015,"Illinois","Carroll County",5,12,173,80,93
050,17,015,"Illinois","Carroll County",5,13,163,80,83
050,17,015,"Illinois","Carroll County",5,14,154,88,66
050,17,015,"Illinois","Carroll County",5,15,177,97,80
050,17,015,"Illinois","Carroll County",5,16,185,93,92
050,17,015,"Illinois","Carroll County",5,17,183,92,91
050,17,015,"Illinois","Carroll County",5,18,145,74,71
050,17,015,"Illinois","Carroll County",5,19,126,73,53
050,17,015,"Illinois","Carroll County",5,20,185,124,61
050,17,015,"Illinois","Carroll County",5,21,288,224,64
050,17,015,"Illinois","Carroll County",5,22,190,122,68
050,17,015,"Illinois","Carroll County",5,23,189,126,63
050,17,015,"Illinois","Carroll County",5,24,212,161,51
050,17,015,"Illinois","Carroll County",5,25,146,72,74
050,17,015,"Illinois","Carroll County",5,26,148,83,65
050,17,015,"Illinois","Carroll County",5,27,166,105,61
050,17,015,"Illinois","Carroll County",5,28,186,126,60
050,17,015,"Illinois","Carroll County",5,29,143,79,64
050,17,015,"Illinois","Carroll County",5,30,214,149,65
050,17,015,"Illinois","Carroll County",5,31,197,125,72
050,17,015,"Illinois","Carroll County",5,32,186,114,72
050,17,015,"Illinois","Carroll County",5,33,132,65,67
050,17,015,"Illinois","Carroll County",5,34,172,103,69
050,17,015,"Illinois","Carroll County",5,35,177,104,73
050,17,015,"Illinois","Carroll County",5,36,181,106,75
050,17,015,"Illinois","Carroll County",5,37,144,69,75
050,17,015,"Illinois","Carroll County",5,38,237,172,65
050,17,015,"Illinois","Carroll County",5,39,206,127,79
050,17,015,"Illinois","Carroll County",5,40,201,111,90
050,17,015,"Illinois","Carroll County",5,41,191,103,88
050,17,015,"Illinois","Carroll County",5,42,193,115,78
050,17,015,"Illinois","Carroll County",5,43,152,69,83
050,17,015,"Illinois","Carroll County",5,44,153,82,71
050,17,015,"Illinois","Carroll County",5,45,148,80,68
050,17,015,"Illinois","Carroll County",5,46,179,105,74
050,17,015,"Illinois","Carroll County",5,47,196,114,82
050,17,015,"Illinois","Carroll County",5,48,187,101,86
050,17,015,"Illinois","Carroll County",5,49,189,105,84
050,17,015,"Illinois","Carroll County",5,50,200,114,86
050,17,015,"Illinois","Carroll County",5,51,172,95,77
050,17,015,"Illinois","Carroll County",5,52,169,86,83
050,17,015,"Illinois","Carroll County",5,53,181,96,85
050,17,015,"Illinois","Carroll County",5,54,206,109,97
050,17,015,"Illinois","Carroll County",5,55,163,80,83
050,17,015,"Illinois","Carroll County",5,56,162,89,73
050,17,015,"Illinois","Carroll County",5,57,181,96,85
050,17,015,"Illinois","Carroll County",5,58,223,120,103
050,17,015,"Illinois","Carroll County",5,59,229,129,100
050,17,015,"Illinois","Carroll County",5,60,220,112,108
050,17,015,"Illinois","Carroll County",5,61,236,131,105
050,17,015,"Illinois","Carroll County",5,62,255,129,126
050,17,015,"Illinois","Carroll County",5,63,249,120,129
050,17,015,"Illinois","Carroll County",5,64,230,106,124
050,17,015,"Illinois","Carroll County",5,65,230,115,115
050,17,015,"Illinois","Carroll County",5,66,253,122,131
050,17,015,"Illinois","Carroll County",5,67,227,108,119
050,17,015,"Illinois","Carroll County",5,68,239,120,119
050,17,015,"Illinois","Carroll County",5,69,231,116,115
050,17,015,"Illinois","Carroll County",5,70,220,115,105
050,17,015,"Illinois","Carroll County",5,71,196,102,94
050,17,015,"Illinois","Carroll County",5,72,212,107,105
050,17,015,"Illinois","Carroll County",5,73,205,93,112
050,17,015,"Illinois","Carroll County",5,74,188,86,102
050,17,015,"Illinois","Carroll County",5,75,181,91,90
050,17,015,"Illinois","Carroll County",5,76,193,98,95
050,17,015,"Illinois","Carroll County",5,77,133,69,64
050,17,015,"Illinois","Carroll County",5,78,126,67,59
050,17,015,"Illinois","Carroll County",5,79,116,56,60
050,17,015,"Illinois","Carroll County",5,80,104,52,52
050,17,015,"Illinois","Carroll County",5,81,101,50,51
050,17,015,"Illinois","Carroll County",5,82,115,57,58
050,17,015,"Illinois","Carroll County",5,83,89,45,44
050,17,015,"Illinois","Carroll County",5,84,69,36,33
050,17,015,"Illinois","Carroll County",5,85,445,169,276
050,17,017,"Illinois","Cass County",1,0,174,87,87
050,17,017,"Illinois","Cass County",1,1,187,88,99
050,17,017,"Illinois","Cass County",1,2,184,89,95
050,17,017,"Illinois","Cass County",1,3,179,89,90
050,17,017,"Illinois","Cass County",1,4,188,95,93
050,17,017,"Illinois","Cass County",1,5,192,89,103
050,17,017,"Illinois","Cass County",1,6,163,78,85
050,17,017,"Illinois","Cass County",1,7,171,92,79
050,17,017,"Illinois","Cass County",1,8,168,90,78
050,17,017,"Illinois","Cass County",1,9,165,99,66
050,17,017,"Illinois","Cass County",1,10,151,87,64
050,17,017,"Illinois","Cass County",1,11,187,101,86
050,17,017,"Illinois","Cass County",1,12,204,104,100
050,17,017,"Illinois","Cass County",1,13,196,100,96
050,17,017,"Illinois","Cass County",1,14,190,100,90
050,17,017,"Illinois","Cass County",1,15,196,102,94
050,17,017,"Illinois","Cass County",1,16,197,99,98
050,17,017,"Illinois","Cass County",1,17,181,100,81
050,17,017,"Illinois","Cass County",1,18,168,93,75
050,17,017,"Illinois","Cass County",1,19,133,72,61
050,17,017,"Illinois","Cass County",1,20,125,68,57
050,17,017,"Illinois","Cass County",1,21,135,75,60
050,17,017,"Illinois","Cass County",1,22,153,83,70
050,17,017,"Illinois","Cass County",1,23,150,80,70
050,17,017,"Illinois","Cass County",1,24,151,74,77
050,17,017,"Illinois","Cass County",1,25,147,68,79
050,17,017,"Illinois","Cass County",1,26,136,63,73
050,17,017,"Illinois","Cass County",1,27,156,68,88
050,17,017,"Illinois","Cass County",1,28,155,91,64
050,17,017,"Illinois","Cass County",1,29,160,82,78
050,17,017,"Illinois","Cass County",1,30,126,60,66
050,17,017,"Illinois","Cass County",1,31,125,60,65
050,17,017,"Illinois","Cass County",1,32,160,81,79
050,17,017,"Illinois","Cass County",1,33,142,71,71
050,17,017,"Illinois","Cass County",1,34,143,82,61
050,17,017,"Illinois","Cass County",1,35,160,84,76
050,17,017,"Illinois","Cass County",1,36,166,93,73
050,17,017,"Illinois","Cass County",1,37,176,85,91
050,17,017,"Illinois","Cass County",1,38,162,85,77
050,17,017,"Illinois","Cass County",1,39,166,93,73
050,17,017,"Illinois","Cass County",1,40,198,113,85
050,17,017,"Illinois","Cass County",1,41,167,89,78
050,17,017,"Illinois","Cass County",1,42,164,81,83
050,17,017,"Illinois","Cass County",1,43,161,81,80
050,17,017,"Illinois","Cass County",1,44,176,87,89
050,17,017,"Illinois","Cass County",1,45,160,85,75
050,17,017,"Illinois","Cass County",1,46,157,82,75
050,17,017,"Illinois","Cass County",1,47,163,86,77
050,17,017,"Illinois","Cass County",1,48,153,81,72
050,17,017,"Illinois","Cass County",1,49,165,84,81
050,17,017,"Illinois","Cass County",1,50,166,75,91
050,17,017,"Illinois","Cass County",1,51,155,68,87
050,17,017,"Illinois","Cass County",1,52,165,83,82
050,17,017,"Illinois","Cass County",1,53,160,75,85
050,17,017,"Illinois","Cass County",1,54,179,92,87
050,17,017,"Illinois","Cass County",1,55,179,94,85
050,17,017,"Illinois","Cass County",1,56,168,79,89
050,17,017,"Illinois","Cass County",1,57,180,91,89
050,17,017,"Illinois","Cass County",1,58,179,99,80
050,17,017,"Illinois","Cass County",1,59,197,109,88
050,17,017,"Illinois","Cass County",1,60,176,97,79
050,17,017,"Illinois","Cass County",1,61,169,80,89
050,17,017,"Illinois","Cass County",1,62,175,82,93
050,17,017,"Illinois","Cass County",1,63,165,82,83
050,17,017,"Illinois","Cass County",1,64,160,84,76
050,17,017,"Illinois","Cass County",1,65,166,77,89
050,17,017,"Illinois","Cass County",1,66,144,71,73
050,17,017,"Illinois","Cass County",1,67,149,78,71
050,17,017,"Illinois","Cass County",1,68,147,78,69
050,17,017,"Illinois","Cass County",1,69,140,73,67
050,17,017,"Illinois","Cass County",1,70,131,59,72
050,17,017,"Illinois","Cass County",1,71,125,61,64
050,17,017,"Illinois","Cass County",1,72,125,67,58
050,17,017,"Illinois","Cass County",1,73,117,54,63
050,17,017,"Illinois","Cass County",1,74,87,40,47
050,17,017,"Illinois","Cass County",1,75,80,34,46
050,17,017,"Illinois","Cass County",1,76,75,35,40
050,17,017,"Illinois","Cass County",1,77,80,40,40
050,17,017,"Illinois","Cass County",1,78,76,38,38
050,17,017,"Illinois","Cass County",1,79,67,29,38
050,17,017,"Illinois","Cass County",1,80,62,24,38
050,17,017,"Illinois","Cass County",1,81,58,21,37
050,17,017,"Illinois","Cass County",1,82,63,24,39
050,17,017,"Illinois","Cass County",1,83,49,20,29
050,17,017,"Illinois","Cass County",1,84,39,13,26
050,17,017,"Illinois","Cass County",1,85,264,90,174
050,17,017,"Illinois","Cass County",2,0,172,83,89
050,17,017,"Illinois","Cass County",2,1,182,87,95
050,17,017,"Illinois","Cass County",2,2,180,87,93
050,17,017,"Illinois","Cass County",2,3,178,89,89
050,17,017,"Illinois","Cass County",2,4,186,93,93
050,17,017,"Illinois","Cass County",2,5,191,90,101
050,17,017,"Illinois","Cass County",2,6,168,80,88
050,17,017,"Illinois","Cass County",2,7,168,88,80
050,17,017,"Illinois","Cass County",2,8,167,91,76
050,17,017,"Illinois","Cass County",2,9,167,99,68
050,17,017,"Illinois","Cass County",2,10,155,89,66
050,17,017,"Illinois","Cass County",2,11,176,95,81
050,17,017,"Illinois","Cass County",2,12,203,105,98
050,17,017,"Illinois","Cass County",2,13,195,101,94
050,17,017,"Illinois","Cass County",2,14,188,99,89
050,17,017,"Illinois","Cass County",2,15,194,101,93
050,17,017,"Illinois","Cass County",2,16,196,99,97
050,17,017,"Illinois","Cass County",2,17,184,99,85
050,17,017,"Illinois","Cass County",2,18,166,93,73
050,17,017,"Illinois","Cass County",2,19,135,74,61
050,17,017,"Illinois","Cass County",2,20,128,69,59
050,17,017,"Illinois","Cass County",2,21,135,73,62
050,17,017,"Illinois","Cass County",2,22,152,82,70
050,17,017,"Illinois","Cass County",2,23,148,79,69
050,17,017,"Illinois","Cass County",2,24,148,75,73
050,17,017,"Illinois","Cass County",2,25,148,70,78
050,17,017,"Illinois","Cass County",2,26,139,64,75
050,17,017,"Illinois","Cass County",2,27,153,71,82
050,17,017,"Illinois","Cass County",2,28,154,86,68
050,17,017,"Illinois","Cass County",2,29,159,84,75
050,17,017,"Illinois","Cass County",2,30,134,64,70
050,17,017,"Illinois","Cass County",2,31,128,61,67
050,17,017,"Illinois","Cass County",2,32,149,75,74
050,17,017,"Illinois","Cass County",2,33,142,72,70
050,17,017,"Illinois","Cass County",2,34,141,77,64
050,17,017,"Illinois","Cass County",2,35,154,82,72
050,17,017,"Illinois","Cass County",2,36,163,89,74
050,17,017,"Illinois","Cass County",2,37,173,86,87
050,17,017,"Illinois","Cass County",2,38,167,85,82
050,17,017,"Illinois","Cass County",2,39,163,91,72
050,17,017,"Illinois","Cass County",2,40,191,108,83
050,17,017,"Illinois","Cass County",2,41,171,93,78
050,17,017,"Illinois","Cass County",2,42,163,83,80
050,17,017,"Illinois","Cass County",2,43,163,82,81
050,17,017,"Illinois","Cass County",2,44,168,84,84
050,17,017,"Illinois","Cass County",2,45,164,85,79
050,17,017,"Illinois","Cass County",2,46,156,82,74
050,17,017,"Illinois","Cass County",2,47,160,85,75
050,17,017,"Illinois","Cass County",2,48,153,81,72
050,17,017,"Illinois","Cass County",2,49,162,83,79
050,17,017,"Illinois","Cass County",2,50,167,78,89
050,17,017,"Illinois","Cass County",2,51,156,68,88
050,17,017,"Illinois","Cass County",2,52,163,79,84
050,17,017,"Illinois","Cass County",2,53,159,77,82
050,17,017,"Illinois","Cass County",2,54,173,88,85
050,17,017,"Illinois","Cass County",2,55,177,92,85
050,17,017,"Illinois","Cass County",2,56,171,83,88
050,17,017,"Illinois","Cass County",2,57,176,88,88
050,17,017,"Illinois","Cass County",2,58,179,97,82
050,17,017,"Illinois","Cass County",2,59,193,108,85
050,17,017,"Illinois","Cass County",2,60,181,101,80
050,17,017,"Illinois","Cass County",2,61,168,84,84
050,17,017,"Illinois","Cass County",2,62,171,80,91
050,17,017,"Illinois","Cass County",2,63,169,82,87
050,17,017,"Illinois","Cass County",2,64,158,82,76
050,17,017,"Illinois","Cass County",2,65,165,79,86
050,17,017,"Illinois","Cass County",2,66,147,72,75
050,17,017,"Illinois","Cass County",2,67,146,75,71
050,17,017,"Illinois","Cass County",2,68,148,78,70
050,17,017,"Illinois","Cass County",2,69,143,75,68
050,17,017,"Illinois","Cass County",2,70,133,62,71
050,17,017,"Illinois","Cass County",2,71,126,60,66
050,17,017,"Illinois","Cass County",2,72,122,63,59
050,17,017,"Illinois","Cass County",2,73,126,61,65
050,17,017,"Illinois","Cass County",2,74,87,41,46
050,17,017,"Illinois","Cass County",2,75,79,35,44
050,17,017,"Illinois","Cass County",2,76,75,34,41
050,17,017,"Illinois","Cass County",2,77,82,40,42
050,17,017,"Illinois","Cass County",2,78,74,36,38
050,17,017,"Illinois","Cass County",2,79,68,31,37
050,17,017,"Illinois","Cass County",2,80,59,22,37
050,17,017,"Illinois","Cass County",2,81,57,21,36
050,17,017,"Illinois","Cass County",2,82,62,23,39
050,17,017,"Illinois","Cass County",2,83,49,20,29
050,17,017,"Illinois","Cass County",2,84,41,15,26
050,17,017,"Illinois","Cass County",2,85,261,88,173
050,17,017,"Illinois","Cass County",3,0,150,87,63
050,17,017,"Illinois","Cass County",3,1,169,87,82
050,17,017,"Illinois","Cass County",3,2,190,92,98
050,17,017,"Illinois","Cass County",3,3,174,84,90
050,17,017,"Illinois","Cass County",3,4,174,87,87
050,17,017,"Illinois","Cass County",3,5,183,88,95
050,17,017,"Illinois","Cass County",3,6,192,95,97
050,17,017,"Illinois","Cass County",3,7,172,82,90
050,17,017,"Illinois","Cass County",3,8,169,88,81
050,17,017,"Illinois","Cass County",3,9,164,94,70
050,17,017,"Illinois","Cass County",3,10,156,93,63
050,17,017,"Illinois","Cass County",3,11,157,93,64
050,17,017,"Illinois","Cass County",3,12,176,95,81
050,17,017,"Illinois","Cass County",3,13,202,102,100
050,17,017,"Illinois","Cass County",3,14,196,108,88
050,17,017,"Illinois","Cass County",3,15,188,96,92
050,17,017,"Illinois","Cass County",3,16,193,97,96
050,17,017,"Illinois","Cass County",3,17,193,97,96
050,17,017,"Illinois","Cass County",3,18,157,83,74
050,17,017,"Illinois","Cass County",3,19,140,73,67
050,17,017,"Illinois","Cass County",3,20,134,75,59
050,17,017,"Illinois","Cass County",3,21,143,79,64
050,17,017,"Illinois","Cass County",3,22,140,75,65
050,17,017,"Illinois","Cass County",3,23,145,77,68
050,17,017,"Illinois","Cass County",3,24,144,78,66
050,17,017,"Illinois","Cass County",3,25,151,78,73
050,17,017,"Illinois","Cass County",3,26,143,65,78
050,17,017,"Illinois","Cass County",3,27,132,62,70
050,17,017,"Illinois","Cass County",3,28,149,71,78
050,17,017,"Illinois","Cass County",3,29,151,83,68
050,17,017,"Illinois","Cass County",3,30,136,70,66
050,17,017,"Illinois","Cass County",3,31,139,68,71
050,17,017,"Illinois","Cass County",3,32,134,65,69
050,17,017,"Illinois","Cass County",3,33,143,64,79
050,17,017,"Illinois","Cass County",3,34,137,70,67
050,17,017,"Illinois","Cass County",3,35,145,80,65
050,17,017,"Illinois","Cass County",3,36,148,79,69
050,17,017,"Illinois","Cass County",3,37,151,82,69
050,17,017,"Illinois","Cass County",3,38,175,89,86
050,17,017,"Illinois","Cass County",3,39,167,83,84
050,17,017,"Illinois","Cass County",3,40,160,94,66
050,17,017,"Illinois","Cass County",3,41,188,107,81
050,17,017,"Illinois","Cass County",3,42,158,86,72
050,17,017,"Illinois","Cass County",3,43,158,82,76
050,17,017,"Illinois","Cass County",3,44,173,90,83
050,17,017,"Illinois","Cass County",3,45,170,86,84
050,17,017,"Illinois","Cass County",3,46,158,82,76
050,17,017,"Illinois","Cass County",3,47,150,78,72
050,17,017,"Illinois","Cass County",3,48,158,85,73
050,17,017,"Illinois","Cass County",3,49,146,75,71
050,17,017,"Illinois","Cass County",3,50,157,80,77
050,17,017,"Illinois","Cass County",3,51,170,80,90
050,17,017,"Illinois","Cass County",3,52,150,64,86
050,17,017,"Illinois","Cass County",3,53,157,75,82
050,17,017,"Illinois","Cass County",3,54,157,77,80
050,17,017,"Illinois","Cass County",3,55,173,91,82
050,17,017,"Illinois","Cass County",3,56,176,92,84
050,17,017,"Illinois","Cass County",3,57,162,77,85
050,17,017,"Illinois","Cass County",3,58,176,87,89
050,17,017,"Illinois","Cass County",3,59,173,96,77
050,17,017,"Illinois","Cass County",3,60,189,106,83
050,17,017,"Illinois","Cass County",3,61,175,95,80
050,17,017,"Illinois","Cass County",3,62,169,83,86
050,17,017,"Illinois","Cass County",3,63,166,78,88
050,17,017,"Illinois","Cass County",3,64,159,79,80
050,17,017,"Illinois","Cass County",3,65,162,82,80
050,17,017,"Illinois","Cass County",3,66,160,77,83
050,17,017,"Illinois","Cass County",3,67,141,68,73
050,17,017,"Illinois","Cass County",3,68,145,74,71
050,17,017,"Illinois","Cass County",3,69,138,77,61
050,17,017,"Illinois","Cass County",3,70,144,73,71
050,17,017,"Illinois","Cass County",3,71,126,60,66
050,17,017,"Illinois","Cass County",3,72,117,55,62
050,17,017,"Illinois","Cass County",3,73,117,62,55
050,17,017,"Illinois","Cass County",3,74,119,59,60
050,17,017,"Illinois","Cass County",3,75,84,39,45
050,17,017,"Illinois","Cass County",3,76,73,33,40
050,17,017,"Illinois","Cass County",3,77,66,31,35
050,17,017,"Illinois","Cass County",3,78,80,39,41
050,17,017,"Illinois","Cass County",3,79,61,28,33
050,17,017,"Illinois","Cass County",3,80,60,27,33
050,17,017,"Illinois","Cass County",3,81,61,20,41
050,17,017,"Illinois","Cass County",3,82,54,19,35
050,17,017,"Illinois","Cass County",3,83,57,23,34
050,17,017,"Illinois","Cass County",3,84,47,19,28
050,17,017,"Illinois","Cass County",3,85,248,84,164
050,17,017,"Illinois","Cass County",4,0,162,81,81
050,17,017,"Illinois","Cass County",4,1,145,85,60
050,17,017,"Illinois","Cass County",4,2,166,88,78
050,17,017,"Illinois","Cass County",4,3,190,93,97
050,17,017,"Illinois","Cass County",4,4,172,81,91
050,17,017,"Illinois","Cass County",4,5,178,87,91
050,17,017,"Illinois","Cass County",4,6,179,87,92
050,17,017,"Illinois","Cass County",4,7,180,91,89
050,17,017,"Illinois","Cass County",4,8,157,77,80
050,17,017,"Illinois","Cass County",4,9,159,78,81
050,17,017,"Illinois","Cass County",4,10,168,99,69
050,17,017,"Illinois","Cass County",4,11,155,94,61
050,17,017,"Illinois","Cass County",4,12,164,94,70
050,17,017,"Illinois","Cass County",4,13,171,92,79
050,17,017,"Illinois","Cass County",4,14,195,101,94
050,17,017,"Illinois","Cass County",4,15,193,108,85
050,17,017,"Illinois","Cass County",4,16,183,93,90
050,17,017,"Illinois","Cass County",4,17,181,93,88
050,17,017,"Illinois","Cass County",4,18,174,88,86
050,17,017,"Illinois","Cass County",4,19,134,72,62
050,17,017,"Illinois","Cass County",4,20,138,70,68
050,17,017,"Illinois","Cass County",4,21,129,75,54
050,17,017,"Illinois","Cass County",4,22,140,78,62
050,17,017,"Illinois","Cass County",4,23,145,72,73
050,17,017,"Illinois","Cass County",4,24,146,71,75
050,17,017,"Illinois","Cass County",4,25,142,79,63
050,17,017,"Illinois","Cass County",4,26,143,77,66
050,17,017,"Illinois","Cass County",4,27,153,69,84
050,17,017,"Illinois","Cass County",4,28,129,54,75
050,17,017,"Illinois","Cass County",4,29,151,73,78
050,17,017,"Illinois","Cass County",4,30,148,79,69
050,17,017,"Illinois","Cass County",4,31,146,75,71
050,17,017,"Illinois","Cass County",4,32,136,69,67
050,17,017,"Illinois","Cass County",4,33,123,56,67
050,17,017,"Illinois","Cass County",4,34,147,69,78
050,17,017,"Illinois","Cass County",4,35,140,74,66
050,17,017,"Illinois","Cass County",4,36,142,82,60
050,17,017,"Illinois","Cass County",4,37,145,77,68
050,17,017,"Illinois","Cass County",4,38,161,89,72
050,17,017,"Illinois","Cass County",4,39,178,94,84
050,17,017,"Illinois","Cass County",4,40,176,86,90
050,17,017,"Illinois","Cass County",4,41,163,98,65
050,17,017,"Illinois","Cass County",4,42,186,105,81
050,17,017,"Illinois","Cass County",4,43,147,86,61
050,17,017,"Illinois","Cass County",4,44,152,72,80
050,17,017,"Illinois","Cass County",4,45,164,84,80
050,17,017,"Illinois","Cass County",4,46,166,83,83
050,17,017,"Illinois","Cass County",4,47,147,79,68
050,17,017,"Illinois","Cass County",4,48,148,78,70
050,17,017,"Illinois","Cass County",4,49,152,77,75
050,17,017,"Illinois","Cass County",4,50,143,72,71
050,17,017,"Illinois","Cass County",4,51,155,78,77
050,17,017,"Illinois","Cass County",4,52,160,79,81
050,17,017,"Illinois","Cass County",4,53,146,64,82
050,17,017,"Illinois","Cass County",4,54,160,79,81
050,17,017,"Illinois","Cass County",4,55,158,80,78
050,17,017,"Illinois","Cass County",4,56,170,87,83
050,17,017,"Illinois","Cass County",4,57,163,88,75
050,17,017,"Illinois","Cass County",4,58,161,82,79
050,17,017,"Illinois","Cass County",4,59,182,89,93
050,17,017,"Illinois","Cass County",4,60,170,95,75
050,17,017,"Illinois","Cass County",4,61,187,102,85
050,17,017,"Illinois","Cass County",4,62,167,91,76
050,17,017,"Illinois","Cass County",4,63,163,81,82
050,17,017,"Illinois","Cass County",4,64,158,78,80
050,17,017,"Illinois","Cass County",4,65,161,80,81
050,17,017,"Illinois","Cass County",4,66,164,86,78
050,17,017,"Illinois","Cass County",4,67,159,77,82
050,17,017,"Illinois","Cass County",4,68,137,65,72
050,17,017,"Illinois","Cass County",4,69,135,71,64
050,17,017,"Illinois","Cass County",4,70,139,77,62
050,17,017,"Illinois","Cass County",4,71,133,71,62
050,17,017,"Illinois","Cass County",4,72,122,55,67
050,17,017,"Illinois","Cass County",4,73,111,54,57
050,17,017,"Illinois","Cass County",4,74,118,63,55
050,17,017,"Illinois","Cass County",4,75,113,54,59
050,17,017,"Illinois","Cass County",4,76,74,34,40
050,17,017,"Illinois","Cass County",4,77,70,31,39
050,17,017,"Illinois","Cass County",4,78,61,28,33
050,17,017,"Illinois","Cass County",4,79,76,37,39
050,17,017,"Illinois","Cass County",4,80,58,28,30
050,17,017,"Illinois","Cass County",4,81,61,26,35
050,17,017,"Illinois","Cass County",4,82,58,19,39
050,17,017,"Illinois","Cass County",4,83,52,20,32
050,17,017,"Illinois","Cass County",4,84,52,22,30
050,17,017,"Illinois","Cass County",4,85,252,87,165
050,17,017,"Illinois","Cass County",5,0,158,80,78
050,17,017,"Illinois","Cass County",5,1,167,82,85
050,17,017,"Illinois","Cass County",5,2,154,90,64
050,17,017,"Illinois","Cass County",5,3,170,89,81
050,17,017,"Illinois","Cass County",5,4,193,89,104
050,17,017,"Illinois","Cass County",5,5,168,74,94
050,17,017,"Illinois","Cass County",5,6,168,83,85
050,17,017,"Illinois","Cass County",5,7,175,88,87
050,17,017,"Illinois","Cass County",5,8,182,94,88
050,17,017,"Illinois","Cass County",5,9,157,74,83
050,17,017,"Illinois","Cass County",5,10,171,89,82
050,17,017,"Illinois","Cass County",5,11,163,94,69
050,17,017,"Illinois","Cass County",5,12,150,92,58
050,17,017,"Illinois","Cass County",5,13,159,95,64
050,17,017,"Illinois","Cass County",5,14,169,90,79
050,17,017,"Illinois","Cass County",5,15,188,102,86
050,17,017,"Illinois","Cass County",5,16,189,107,82
050,17,017,"Illinois","Cass County",5,17,173,90,83
050,17,017,"Illinois","Cass County",5,18,156,82,74
050,17,017,"Illinois","Cass County",5,19,140,71,69
050,17,017,"Illinois","Cass County",5,20,126,69,57
050,17,017,"Illinois","Cass County",5,21,147,75,72
050,17,017,"Illinois","Cass County",5,22,145,79,66
050,17,017,"Illinois","Cass County",5,23,151,75,76
050,17,017,"Illinois","Cass County",5,24,154,74,80
050,17,017,"Illinois","Cass County",5,25,143,69,74
050,17,017,"Illinois","Cass County",5,26,143,79,64
050,17,017,"Illinois","Cass County",5,27,141,73,68
050,17,017,"Illinois","Cass County",5,28,157,75,82
050,17,017,"Illinois","Cass County",5,29,136,61,75
050,17,017,"Illinois","Cass County",5,30,150,69,81
050,17,017,"Illinois","Cass County",5,31,157,76,81
050,17,017,"Illinois","Cass County",5,32,139,70,69
050,17,017,"Illinois","Cass County",5,33,125,63,62
050,17,017,"Illinois","Cass County",5,34,126,57,69
050,17,017,"Illinois","Cass County",5,35,151,75,76
050,17,017,"Illinois","Cass County",5,36,144,74,70
050,17,017,"Illinois","Cass County",5,37,140,85,55
050,17,017,"Illinois","Cass County",5,38,147,78,69
050,17,017,"Illinois","Cass County",5,39,158,87,71
050,17,017,"Illinois","Cass County",5,40,186,93,93
050,17,017,"Illinois","Cass County",5,41,169,81,88
050,17,017,"Illinois","Cass County",5,42,166,97,69
050,17,017,"Illinois","Cass County",5,43,187,103,84
050,17,017,"Illinois","Cass County",5,44,137,75,62
050,17,017,"Illinois","Cass County",5,45,160,78,82
050,17,017,"Illinois","Cass County",5,46,176,91,85
050,17,017,"Illinois","Cass County",5,47,170,84,86
050,17,017,"Illinois","Cass County",5,48,154,86,68
050,17,017,"Illinois","Cass County",5,49,146,71,75
050,17,017,"Illinois","Cass County",5,50,151,77,74
050,17,017,"Illinois","Cass County",5,51,145,71,74
050,17,017,"Illinois","Cass County",5,52,148,78,70
050,17,017,"Illinois","Cass County",5,53,157,78,79
050,17,017,"Illinois","Cass County",5,54,141,61,80
050,17,017,"Illinois","Cass County",5,55,160,77,83
050,17,017,"Illinois","Cass County",5,56,157,79,78
050,17,017,"Illinois","Cass County",5,57,160,81,79
050,17,017,"Illinois","Cass County",5,58,159,87,72
050,17,017,"Illinois","Cass County",5,59,161,79,82
050,17,017,"Illinois","Cass County",5,60,188,92,96
050,17,017,"Illinois","Cass County",5,61,162,86,76
050,17,017,"Illinois","Cass County",5,62,182,101,81
050,17,017,"Illinois","Cass County",5,63,159,87,72
050,17,017,"Illinois","Cass County",5,64,154,79,75
050,17,017,"Illinois","Cass County",5,65,156,78,78
050,17,017,"Illinois","Cass County",5,66,164,83,81
050,17,017,"Illinois","Cass County",5,67,152,79,73
050,17,017,"Illinois","Cass County",5,68,156,74,82
050,17,017,"Illinois","Cass County",5,69,132,63,69
050,17,017,"Illinois","Cass County",5,70,133,69,64
050,17,017,"Illinois","Cass County",5,71,132,75,57
050,17,017,"Illinois","Cass County",5,72,124,64,60
050,17,017,"Illinois","Cass County",5,73,117,52,65
050,17,017,"Illinois","Cass County",5,74,108,54,54
050,17,017,"Illinois","Cass County",5,75,110,58,52
050,17,017,"Illinois","Cass County",5,76,105,48,57
050,17,017,"Illinois","Cass County",5,77,70,33,37
050,17,017,"Illinois","Cass County",5,78,66,29,37
050,17,017,"Illinois","Cass County",5,79,56,25,31
050,17,017,"Illinois","Cass County",5,80,72,36,36
050,17,017,"Illinois","Cass County",5,81,55,24,31
050,17,017,"Illinois","Cass County",5,82,58,24,34
050,17,017,"Illinois","Cass County",5,83,55,20,35
050,17,017,"Illinois","Cass County",5,84,44,18,26
050,17,017,"Illinois","Cass County",5,85,266,93,173
050,17,019,"Illinois","Champaign County",1,0,2189,1124,1065
050,17,019,"Illinois","Champaign County",1,1,2154,1135,1019
050,17,019,"Illinois","Champaign County",1,2,2199,1138,1061
050,17,019,"Illinois","Champaign County",1,3,2303,1175,1128
050,17,019,"Illinois","Champaign County",1,4,2296,1158,1138
050,17,019,"Illinois","Champaign County",1,5,2267,1164,1103
050,17,019,"Illinois","Champaign County",1,6,2303,1187,1116
050,17,019,"Illinois","Champaign County",1,7,2212,1141,1071
050,17,019,"Illinois","Champaign County",1,8,2174,1154,1020
050,17,019,"Illinois","Champaign County",1,9,2120,1085,1035
050,17,019,"Illinois","Champaign County",1,10,2166,1093,1073
050,17,019,"Illinois","Champaign County",1,11,2228,1102,1126
050,17,019,"Illinois","Champaign County",1,12,2268,1135,1133
050,17,019,"Illinois","Champaign County",1,13,2290,1171,1119
050,17,019,"Illinois","Champaign County",1,14,2193,1076,1117
050,17,019,"Illinois","Champaign County",1,15,2133,1085,1048
050,17,019,"Illinois","Champaign County",1,16,2264,1165,1099
050,17,019,"Illinois","Champaign County",1,17,2265,1159,1106
050,17,019,"Illinois","Champaign County",1,18,4893,2483,2410
050,17,019,"Illinois","Champaign County",1,19,8713,4485,4228
050,17,019,"Illinois","Champaign County",1,20,8836,4434,4402
050,17,019,"Illinois","Champaign County",1,21,7852,4013,3839
050,17,019,"Illinois","Champaign County",1,22,6702,3718,2984
050,17,019,"Illinois","Champaign County",1,23,4885,2734,2151
050,17,019,"Illinois","Champaign County",1,24,3785,1986,1799
050,17,019,"Illinois","Champaign County",1,25,3359,1758,1601
050,17,019,"Illinois","Champaign County",1,26,3129,1538,1591
050,17,019,"Illinois","Champaign County",1,27,2869,1445,1424
050,17,019,"Illinois","Champaign County",1,28,2881,1487,1394
050,17,019,"Illinois","Champaign County",1,29,2820,1476,1344
050,17,019,"Illinois","Champaign County",1,30,2734,1393,1341
050,17,019,"Illinois","Champaign County",1,31,2822,1425,1397
050,17,019,"Illinois","Champaign County",1,32,2696,1353,1343
050,17,019,"Illinois","Champaign County",1,33,2613,1345,1268
050,17,019,"Illinois","Champaign County",1,34,2576,1312,1264
050,17,019,"Illinois","Champaign County",1,35,2552,1287,1265
050,17,019,"Illinois","Champaign County",1,36,2545,1230,1315
050,17,019,"Illinois","Champaign County",1,37,2594,1306,1288
050,17,019,"Illinois","Champaign County",1,38,2423,1222,1201
050,17,019,"Illinois","Champaign County",1,39,2416,1194,1222
050,17,019,"Illinois","Champaign County",1,40,2448,1221,1227
050,17,019,"Illinois","Champaign County",1,41,2309,1150,1159
050,17,019,"Illinois","Champaign County",1,42,2261,1134,1127
050,17,019,"Illinois","Champaign County",1,43,2075,1026,1049
050,17,019,"Illinois","Champaign County",1,44,2030,1026,1004
050,17,019,"Illinois","Champaign County",1,45,2035,1008,1027
050,17,019,"Illinois","Champaign County",1,46,1957,965,992
050,17,019,"Illinois","Champaign County",1,47,2034,1008,1026
050,17,019,"Illinois","Champaign County",1,48,2062,1008,1054
050,17,019,"Illinois","Champaign County",1,49,2180,1093,1087
050,17,019,"Illinois","Champaign County",1,50,2037,1034,1003
050,17,019,"Illinois","Champaign County",1,51,1949,978,971
050,17,019,"Illinois","Champaign County",1,52,1877,941,936
050,17,019,"Illinois","Champaign County",1,53,1840,911,929
050,17,019,"Illinois","Champaign County",1,54,1832,889,943
050,17,019,"Illinois","Champaign County",1,55,1977,950,1027
050,17,019,"Illinois","Champaign County",1,56,2094,1014,1080
050,17,019,"Illinois","Champaign County",1,57,2071,1006,1065
050,17,019,"Illinois","Champaign County",1,58,2130,1025,1105
050,17,019,"Illinois","Champaign County",1,59,2192,1052,1140
050,17,019,"Illinois","Champaign County",1,60,2168,1054,1114
050,17,019,"Illinois","Champaign County",1,61,2136,1050,1086
050,17,019,"Illinois","Champaign County",1,62,2173,1032,1141
050,17,019,"Illinois","Champaign County",1,63,2156,1002,1154
050,17,019,"Illinois","Champaign County",1,64,2159,993,1166
050,17,019,"Illinois","Champaign County",1,65,2020,958,1062
050,17,019,"Illinois","Champaign County",1,66,1966,922,1044
050,17,019,"Illinois","Champaign County",1,67,1911,903,1008
050,17,019,"Illinois","Champaign County",1,68,1841,876,965
050,17,019,"Illinois","Champaign County",1,69,1739,819,920
050,17,019,"Illinois","Champaign County",1,70,1564,753,811
050,17,019,"Illinois","Champaign County",1,71,1494,708,786
050,17,019,"Illinois","Champaign County",1,72,1411,666,745
050,17,019,"Illinois","Champaign County",1,73,1418,652,766
050,17,019,"Illinois","Champaign County",1,74,1039,488,551
050,17,019,"Illinois","Champaign County",1,75,952,444,508
050,17,019,"Illinois","Champaign County",1,76,938,428,510
050,17,019,"Illinois","Champaign County",1,77,920,417,503
050,17,019,"Illinois","Champaign County",1,78,792,350,442
050,17,019,"Illinois","Champaign County",1,79,703,287,416
050,17,019,"Illinois","Champaign County",1,80,664,271,393
050,17,019,"Illinois","Champaign County",1,81,654,273,381
050,17,019,"Illinois","Champaign County",1,82,596,271,325
050,17,019,"Illinois","Champaign County",1,83,539,212,327
050,17,019,"Illinois","Champaign County",1,84,478,196,282
050,17,019,"Illinois","Champaign County",1,85,3333,1195,2138
050,17,019,"Illinois","Champaign County",2,0,2159,1115,1044
050,17,019,"Illinois","Champaign County",2,1,2147,1125,1022
050,17,019,"Illinois","Champaign County",2,2,2190,1139,1051
050,17,019,"Illinois","Champaign County",2,3,2267,1160,1107
050,17,019,"Illinois","Champaign County",2,4,2296,1162,1134
050,17,019,"Illinois","Champaign County",2,5,2277,1161,1116
050,17,019,"Illinois","Champaign County",2,6,2294,1181,1113
050,17,019,"Illinois","Champaign County",2,7,2234,1150,1084
050,17,019,"Illinois","Champaign County",2,8,2170,1138,1032
050,17,019,"Illinois","Champaign County",2,9,2128,1097,1031
050,17,019,"Illinois","Champaign County",2,10,2153,1090,1063
050,17,019,"Illinois","Champaign County",2,11,2198,1090,1108
050,17,019,"Illinois","Champaign County",2,12,2267,1132,1135
050,17,019,"Illinois","Champaign County",2,13,2284,1162,1122
050,17,019,"Illinois","Champaign County",2,14,2207,1095,1112
050,17,019,"Illinois","Champaign County",2,15,2145,1081,1064
050,17,019,"Illinois","Champaign County",2,16,2259,1163,1096
050,17,019,"Illinois","Champaign County",2,17,2265,1164,1101
050,17,019,"Illinois","Champaign County",2,18,4836,2434,2402
050,17,019,"Illinois","Champaign County",2,19,8691,4476,4215
050,17,019,"Illinois","Champaign County",2,20,8906,4460,4446
050,17,019,"Illinois","Champaign County",2,21,7815,4000,3815
050,17,019,"Illinois","Champaign County",2,22,6672,3690,2982
050,17,019,"Illinois","Champaign County",2,23,4872,2717,2155
050,17,019,"Illinois","Champaign County",2,24,3752,1975,1777
050,17,019,"Illinois","Champaign County",2,25,3338,1737,1601
050,17,019,"Illinois","Champaign County",2,26,3079,1529,1550
050,17,019,"Illinois","Champaign County",2,27,2848,1425,1423
050,17,019,"Illinois","Champaign County",2,28,2856,1464,1392
050,17,019,"Illinois","Champaign County",2,29,2806,1463,1343
050,17,019,"Illinois","Champaign County",2,30,2746,1406,1340
050,17,019,"Illinois","Champaign County",2,31,2772,1400,1372
050,17,019,"Illinois","Champaign County",2,32,2702,1358,1344
050,17,019,"Illinois","Champaign County",2,33,2621,1341,1280
050,17,019,"Illinois","Champaign County",2,34,2569,1313,1256
050,17,019,"Illinois","Champaign County",2,35,2551,1287,1264
050,17,019,"Illinois","Champaign County",2,36,2532,1235,1297
050,17,019,"Illinois","Champaign County",2,37,2577,1285,1292
050,17,019,"Illinois","Champaign County",2,38,2462,1237,1225
050,17,019,"Illinois","Champaign County",2,39,2405,1192,1213
050,17,019,"Illinois","Champaign County",2,40,2454,1221,1233
050,17,019,"Illinois","Champaign County",2,41,2333,1162,1171
050,17,019,"Illinois","Champaign County",2,42,2247,1123,1124
050,17,019,"Illinois","Champaign County",2,43,2124,1054,1070
050,17,019,"Illinois","Champaign County",2,44,2021,1018,1003
050,17,019,"Illinois","Champaign County",2,45,2042,1018,1024
050,17,019,"Illinois","Champaign County",2,46,1966,970,996
050,17,019,"Illinois","Champaign County",2,47,2010,998,1012
050,17,019,"Illinois","Champaign County",2,48,2044,1000,1044
050,17,019,"Illinois","Champaign County",2,49,2165,1080,1085
050,17,019,"Illinois","Champaign County",2,50,2072,1048,1024
050,17,019,"Illinois","Champaign County",2,51,1954,982,972
050,17,019,"Illinois","Champaign County",2,52,1888,947,941
050,17,019,"Illinois","Champaign County",2,53,1846,919,927
050,17,019,"Illinois","Champaign County",2,54,1819,886,933
050,17,019,"Illinois","Champaign County",2,55,1937,932,1005
050,17,019,"Illinois","Champaign County",2,56,2072,1002,1070
050,17,019,"Illinois","Champaign County",2,57,2078,1009,1069
050,17,019,"Illinois","Champaign County",2,58,2103,1014,1089
050,17,019,"Illinois","Champaign County",2,59,2178,1045,1133
050,17,019,"Illinois","Champaign County",2,60,2156,1043,1113
050,17,019,"Illinois","Champaign County",2,61,2131,1043,1088
050,17,019,"Illinois","Champaign County",2,62,2151,1030,1121
050,17,019,"Illinois","Champaign County",2,63,2169,1011,1158
050,17,019,"Illinois","Champaign County",2,64,2141,983,1158
050,17,019,"Illinois","Champaign County",2,65,2047,963,1084
050,17,019,"Illinois","Champaign County",2,66,1975,929,1046
050,17,019,"Illinois","Champaign County",2,67,1914,900,1014
050,17,019,"Illinois","Champaign County",2,68,1841,872,969
050,17,019,"Illinois","Champaign County",2,69,1771,835,936
050,17,019,"Illinois","Champaign County",2,70,1597,763,834
050,17,019,"Illinois","Champaign County",2,71,1506,714,792
050,17,019,"Illinois","Champaign County",2,72,1402,658,744
050,17,019,"Illinois","Champaign County",2,73,1478,684,794
050,17,019,"Illinois","Champaign County",2,74,1061,494,567
050,17,019,"Illinois","Champaign County",2,75,971,455,516
050,17,019,"Illinois","Champaign County",2,76,927,423,504
050,17,019,"Illinois","Champaign County",2,77,944,429,515
050,17,019,"Illinois","Champaign County",2,78,802,356,446
050,17,019,"Illinois","Champaign County",2,79,717,297,420
050,17,019,"Illinois","Champaign County",2,80,663,272,391
050,17,019,"Illinois","Champaign County",2,81,644,269,375
050,17,019,"Illinois","Champaign County",2,82,606,270,336
050,17,019,"Illinois","Champaign County",2,83,534,218,316
050,17,019,"Illinois","Champaign County",2,84,479,192,287
050,17,019,"Illinois","Champaign County",2,85,3326,1194,2132
050,17,019,"Illinois","Champaign County",3,0,2086,1053,1033
050,17,019,"Illinois","Champaign County",3,1,2180,1112,1068
050,17,019,"Illinois","Champaign County",3,2,2156,1112,1044
050,17,019,"Illinois","Champaign County",3,3,2186,1143,1043
050,17,019,"Illinois","Champaign County",3,4,2282,1158,1124
050,17,019,"Illinois","Champaign County",3,5,2277,1153,1124
050,17,019,"Illinois","Champaign County",3,6,2270,1169,1101
050,17,019,"Illinois","Champaign County",3,7,2285,1171,1114
050,17,019,"Illinois","Champaign County",3,8,2216,1145,1071
050,17,019,"Illinois","Champaign County",3,9,2160,1115,1045
050,17,019,"Illinois","Champaign County",3,10,2140,1101,1039
050,17,019,"Illinois","Champaign County",3,11,2196,1114,1082
050,17,019,"Illinois","Champaign County",3,12,2197,1101,1096
050,17,019,"Illinois","Champaign County",3,13,2241,1126,1115
050,17,019,"Illinois","Champaign County",3,14,2276,1140,1136
050,17,019,"Illinois","Champaign County",3,15,2195,1090,1105
050,17,019,"Illinois","Champaign County",3,16,2269,1160,1109
050,17,019,"Illinois","Champaign County",3,17,2298,1177,1121
050,17,019,"Illinois","Champaign County",3,18,4877,2422,2455
050,17,019,"Illinois","Champaign County",3,19,8673,4481,4192
050,17,019,"Illinois","Champaign County",3,20,8986,4501,4485
050,17,019,"Illinois","Champaign County",3,21,7916,4077,3839
050,17,019,"Illinois","Champaign County",3,22,6754,3701,3053
050,17,019,"Illinois","Champaign County",3,23,4834,2669,2165
050,17,019,"Illinois","Champaign County",3,24,3821,2042,1779
050,17,019,"Illinois","Champaign County",3,25,3313,1745,1568
050,17,019,"Illinois","Champaign County",3,26,3037,1525,1512
050,17,019,"Illinois","Champaign County",3,27,2755,1360,1395
050,17,019,"Illinois","Champaign County",3,28,2813,1417,1396
050,17,019,"Illinois","Champaign County",3,29,2802,1455,1347
050,17,019,"Illinois","Champaign County",3,30,2759,1428,1331
050,17,019,"Illinois","Champaign County",3,31,2753,1394,1359
050,17,019,"Illinois","Champaign County",3,32,2696,1337,1359
050,17,019,"Illinois","Champaign County",3,33,2672,1356,1316
050,17,019,"Illinois","Champaign County",3,34,2587,1327,1260
050,17,019,"Illinois","Champaign County",3,35,2521,1301,1220
050,17,019,"Illinois","Champaign County",3,36,2596,1295,1301
050,17,019,"Illinois","Champaign County",3,37,2528,1208,1320
050,17,019,"Illinois","Champaign County",3,38,2539,1274,1265
050,17,019,"Illinois","Champaign County",3,39,2456,1238,1218
050,17,019,"Illinois","Champaign County",3,40,2405,1188,1217
050,17,019,"Illinois","Champaign County",3,41,2442,1210,1232
050,17,019,"Illinois","Champaign County",3,42,2300,1137,1163
050,17,019,"Illinois","Champaign County",3,43,2243,1108,1135
050,17,019,"Illinois","Champaign County",3,44,2128,1048,1080
050,17,019,"Illinois","Champaign County",3,45,2034,1032,1002
050,17,019,"Illinois","Champaign County",3,46,2008,993,1015
050,17,019,"Illinois","Champaign County",3,47,1987,972,1015
050,17,019,"Illinois","Champaign County",3,48,1997,986,1011
050,17,019,"Illinois","Champaign County",3,49,2062,1003,1059
050,17,019,"Illinois","Champaign County",3,50,2167,1089,1078
050,17,019,"Illinois","Champaign County",3,51,2044,1032,1012
050,17,019,"Illinois","Champaign County",3,52,1947,985,962
050,17,019,"Illinois","Champaign County",3,53,1902,948,954
050,17,019,"Illinois","Champaign County",3,54,1825,907,918
050,17,019,"Illinois","Champaign County",3,55,1784,863,921
050,17,019,"Illinois","Champaign County",3,56,1894,908,986
050,17,019,"Illinois","Champaign County",3,57,2049,987,1062
050,17,019,"Illinois","Champaign County",3,58,2052,990,1062
050,17,019,"Illinois","Champaign County",3,59,2065,991,1074
050,17,019,"Illinois","Champaign County",3,60,2141,1025,1116
050,17,019,"Illinois","Champaign County",3,61,2129,1030,1099
050,17,019,"Illinois","Champaign County",3,62,2095,1019,1076
050,17,019,"Illinois","Champaign County",3,63,2083,991,1092
050,17,019,"Illinois","Champaign County",3,64,2140,1003,1137
050,17,019,"Illinois","Champaign County",3,65,2081,957,1124
050,17,019,"Illinois","Champaign County",3,66,1996,924,1072
050,17,019,"Illinois","Champaign County",3,67,1948,914,1034
050,17,019,"Illinois","Champaign County",3,68,1868,869,999
050,17,019,"Illinois","Champaign County",3,69,1804,850,954
050,17,019,"Illinois","Champaign County",3,70,1719,816,903
050,17,019,"Illinois","Champaign County",3,71,1566,744,822
050,17,019,"Illinois","Champaign County",3,72,1473,701,772
050,17,019,"Illinois","Champaign County",3,73,1358,632,726
050,17,019,"Illinois","Champaign County",3,74,1443,669,774
050,17,019,"Illinois","Champaign County",3,75,1026,473,553
050,17,019,"Illinois","Champaign County",3,76,960,449,511
050,17,019,"Illinois","Champaign County",3,77,906,416,490
050,17,019,"Illinois","Champaign County",3,78,913,416,497
050,17,019,"Illinois","Champaign County",3,79,782,341,441
050,17,019,"Illinois","Champaign County",3,80,680,278,402
050,17,019,"Illinois","Champaign County",3,81,625,253,372
050,17,019,"Illinois","Champaign County",3,82,595,247,348
050,17,019,"Illinois","Champaign County",3,83,585,244,341
050,17,019,"Illinois","Champaign County",3,84,472,185,287
050,17,019,"Illinois","Champaign County",3,85,3284,1161,2123
050,17,019,"Illinois","Champaign County",4,0,2079,1033,1046
050,17,019,"Illinois","Champaign County",4,1,2023,1024,999
050,17,019,"Illinois","Champaign County",4,2,2169,1100,1069
050,17,019,"Illinois","Champaign County",4,3,2131,1112,1019
050,17,019,"Illinois","Champaign County",4,4,2226,1166,1060
050,17,019,"Illinois","Champaign County",4,5,2265,1146,1119
050,17,019,"Illinois","Champaign County",4,6,2222,1128,1094
050,17,019,"Illinois","Champaign County",4,7,2249,1154,1095
050,17,019,"Illinois","Champaign County",4,8,2265,1151,1114
050,17,019,"Illinois","Champaign County",4,9,2174,1108,1066
050,17,019,"Illinois","Champaign County",4,10,2152,1119,1033
050,17,019,"Illinois","Champaign County",4,11,2130,1087,1043
050,17,019,"Illinois","Champaign County",4,12,2161,1103,1058
050,17,019,"Illinois","Champaign County",4,13,2178,1099,1079
050,17,019,"Illinois","Champaign County",4,14,2236,1111,1125
050,17,019,"Illinois","Champaign County",4,15,2273,1135,1138
050,17,019,"Illinois","Champaign County",4,16,2326,1182,1144
050,17,019,"Illinois","Champaign County",4,17,2321,1194,1127
050,17,019,"Illinois","Champaign County",4,18,4840,2398,2442
050,17,019,"Illinois","Champaign County",4,19,8548,4398,4150
050,17,019,"Illinois","Champaign County",4,20,8865,4472,4393
050,17,019,"Illinois","Champaign County",4,21,8191,4192,3999
050,17,019,"Illinois","Champaign County",4,22,6871,3792,3079
050,17,019,"Illinois","Champaign County",4,23,4973,2729,2244
050,17,019,"Illinois","Champaign County",4,24,3778,1963,1815
050,17,019,"Illinois","Champaign County",4,25,3358,1760,1598
050,17,019,"Illinois","Champaign County",4,26,2949,1514,1435
050,17,019,"Illinois","Champaign County",4,27,2711,1374,1337
050,17,019,"Illinois","Champaign County",4,28,2704,1329,1375
050,17,019,"Illinois","Champaign County",4,29,2688,1366,1322
050,17,019,"Illinois","Champaign County",4,30,2704,1387,1317
050,17,019,"Illinois","Champaign County",4,31,2712,1373,1339
050,17,019,"Illinois","Champaign County",4,32,2662,1333,1329
050,17,019,"Illinois","Champaign County",4,33,2648,1314,1334
050,17,019,"Illinois","Champaign County",4,34,2552,1264,1288
050,17,019,"Illinois","Champaign County",4,35,2566,1317,1249
050,17,019,"Illinois","Champaign County",4,36,2467,1268,1199
050,17,019,"Illinois","Champaign County",4,37,2531,1236,1295
050,17,019,"Illinois","Champaign County",4,38,2465,1162,1303
050,17,019,"Illinois","Champaign County",4,39,2534,1264,1270
050,17,019,"Illinois","Champaign County",4,40,2422,1202,1220
050,17,019,"Illinois","Champaign County",4,41,2375,1183,1192
050,17,019,"Illinois","Champaign County",4,42,2391,1187,1204
050,17,019,"Illinois","Champaign County",4,43,2279,1123,1156
050,17,019,"Illinois","Champaign County",4,44,2214,1087,1127
050,17,019,"Illinois","Champaign County",4,45,2087,1037,1050
050,17,019,"Illinois","Champaign County",4,46,2007,1013,994
050,17,019,"Illinois","Champaign County",4,47,1968,985,983
050,17,019,"Illinois","Champaign County",4,48,1983,951,1032
050,17,019,"Illinois","Champaign County",4,49,1993,986,1007
050,17,019,"Illinois","Champaign County",4,50,1994,958,1036
050,17,019,"Illinois","Champaign County",4,51,2134,1064,1070
050,17,019,"Illinois","Champaign County",4,52,2019,1024,995
050,17,019,"Illinois","Champaign County",4,53,1908,972,936
050,17,019,"Illinois","Champaign County",4,54,1822,898,924
050,17,019,"Illinois","Champaign County",4,55,1791,874,917
050,17,019,"Illinois","Champaign County",4,56,1753,838,915
050,17,019,"Illinois","Champaign County",4,57,1865,905,960
050,17,019,"Illinois","Champaign County",4,58,1995,960,1035
050,17,019,"Illinois","Champaign County",4,59,2025,977,1048
050,17,019,"Illinois","Champaign County",4,60,2029,972,1057
050,17,019,"Illinois","Champaign County",4,61,2095,996,1099
050,17,019,"Illinois","Champaign County",4,62,2061,1001,1060
050,17,019,"Illinois","Champaign County",4,63,2048,988,1060
050,17,019,"Illinois","Champaign County",4,64,2045,966,1079
050,17,019,"Illinois","Champaign County",4,65,2085,975,1110
050,17,019,"Illinois","Champaign County",4,66,2043,938,1105
050,17,019,"Illinois","Champaign County",4,67,1971,895,1076
050,17,019,"Illinois","Champaign County",4,68,1913,887,1026
050,17,019,"Illinois","Champaign County",4,69,1837,861,976
050,17,019,"Illinois","Champaign County",4,70,1770,845,925
050,17,019,"Illinois","Champaign County",4,71,1683,791,892
050,17,019,"Illinois","Champaign County",4,72,1515,717,798
050,17,019,"Illinois","Champaign County",4,73,1455,685,770
050,17,019,"Illinois","Champaign County",4,74,1321,611,710
050,17,019,"Illinois","Champaign County",4,75,1395,655,740
050,17,019,"Illinois","Champaign County",4,76,985,453,532
050,17,019,"Illinois","Champaign County",4,77,922,432,490
050,17,019,"Illinois","Champaign County",4,78,865,400,465
050,17,019,"Illinois","Champaign County",4,79,881,392,489
050,17,019,"Illinois","Champaign County",4,80,750,315,435
050,17,019,"Illinois","Champaign County",4,81,640,254,386
050,17,019,"Illinois","Champaign County",4,82,574,236,338
050,17,019,"Illinois","Champaign County",4,83,573,220,353
050,17,019,"Illinois","Champaign County",4,84,532,213,319
050,17,019,"Illinois","Champaign County",4,85,3259,1156,2103
050,17,019,"Illinois","Champaign County",5,0,2079,1029,1050
050,17,019,"Illinois","Champaign County",5,1,1974,981,993
050,17,019,"Illinois","Champaign County",5,2,1993,996,997
050,17,019,"Illinois","Champaign County",5,3,2120,1086,1034
050,17,019,"Illinois","Champaign County",5,4,2132,1091,1041
050,17,019,"Illinois","Champaign County",5,5,2181,1155,1026
050,17,019,"Illinois","Champaign County",5,6,2224,1139,1085
050,17,019,"Illinois","Champaign County",5,7,2194,1094,1100
050,17,019,"Illinois","Champaign County",5,8,2212,1118,1094
050,17,019,"Illinois","Champaign County",5,9,2237,1123,1114
050,17,019,"Illinois","Champaign County",5,10,2156,1085,1071
050,17,019,"Illinois","Champaign County",5,11,2120,1101,1019
050,17,019,"Illinois","Champaign County",5,12,2105,1077,1028
050,17,019,"Illinois","Champaign County",5,13,2159,1113,1046
050,17,019,"Illinois","Champaign County",5,14,2160,1080,1080
050,17,019,"Illinois","Champaign County",5,15,2201,1096,1105
050,17,019,"Illinois","Champaign County",5,16,2419,1232,1187
050,17,019,"Illinois","Champaign County",5,17,2429,1244,1185
050,17,019,"Illinois","Champaign County",5,18,4885,2426,2459
050,17,019,"Illinois","Champaign County",5,19,8601,4429,4172
050,17,019,"Illinois","Champaign County",5,20,8858,4444,4414
050,17,019,"Illinois","Champaign County",5,21,8004,4128,3876
050,17,019,"Illinois","Champaign County",5,22,7113,3909,3204
050,17,019,"Illinois","Champaign County",5,23,4965,2734,2231
050,17,019,"Illinois","Champaign County",5,24,3880,2027,1853
050,17,019,"Illinois","Champaign County",5,25,3328,1678,1650
050,17,019,"Illinois","Champaign County",5,26,2999,1520,1479
050,17,019,"Illinois","Champaign County",5,27,2623,1360,1263
050,17,019,"Illinois","Champaign County",5,28,2584,1295,1289
050,17,019,"Illinois","Champaign County",5,29,2557,1261,1296
050,17,019,"Illinois","Champaign County",5,30,2539,1263,1276
050,17,019,"Illinois","Champaign County",5,31,2650,1336,1314
050,17,019,"Illinois","Champaign County",5,32,2617,1330,1287
050,17,019,"Illinois","Champaign County",5,33,2593,1293,1300
050,17,019,"Illinois","Champaign County",5,34,2582,1263,1319
050,17,019,"Illinois","Champaign County",5,35,2474,1225,1249
050,17,019,"Illinois","Champaign County",5,36,2486,1255,1231
050,17,019,"Illinois","Champaign County",5,37,2419,1240,1179
050,17,019,"Illinois","Champaign County",5,38,2438,1177,1261
050,17,019,"Illinois","Champaign County",5,39,2394,1126,1268
050,17,019,"Illinois","Champaign County",5,40,2473,1233,1240
050,17,019,"Illinois","Champaign County",5,41,2388,1199,1189
050,17,019,"Illinois","Champaign County",5,42,2339,1168,1171
050,17,019,"Illinois","Champaign County",5,43,2364,1168,1196
050,17,019,"Illinois","Champaign County",5,44,2225,1095,1130
050,17,019,"Illinois","Champaign County",5,45,2155,1049,1106
050,17,019,"Illinois","Champaign County",5,46,2063,1012,1051
050,17,019,"Illinois","Champaign County",5,47,1976,1017,959
050,17,019,"Illinois","Champaign County",5,48,1939,953,986
050,17,019,"Illinois","Champaign County",5,49,1999,967,1032
050,17,019,"Illinois","Champaign County",5,50,1976,979,997
050,17,019,"Illinois","Champaign County",5,51,1962,934,1028
050,17,019,"Illinois","Champaign County",5,52,2117,1053,1064
050,17,019,"Illinois","Champaign County",5,53,1994,1021,973
050,17,019,"Illinois","Champaign County",5,54,1877,951,926
050,17,019,"Illinois","Champaign County",5,55,1823,903,920
050,17,019,"Illinois","Champaign County",5,56,1782,872,910
050,17,019,"Illinois","Champaign County",5,57,1749,834,915
050,17,019,"Illinois","Champaign County",5,58,1868,910,958
050,17,019,"Illinois","Champaign County",5,59,1996,961,1035
050,17,019,"Illinois","Champaign County",5,60,1993,965,1028
050,17,019,"Illinois","Champaign County",5,61,1990,956,1034
050,17,019,"Illinois","Champaign County",5,62,2030,955,1075
050,17,019,"Illinois","Champaign County",5,63,2019,972,1047
050,17,019,"Illinois","Champaign County",5,64,2011,968,1043
050,17,019,"Illinois","Champaign County",5,65,2023,963,1060
050,17,019,"Illinois","Champaign County",5,66,2041,950,1091
050,17,019,"Illinois","Champaign County",5,67,2014,909,1105
050,17,019,"Illinois","Champaign County",5,68,1942,868,1074
050,17,019,"Illinois","Champaign County",5,69,1883,869,1014
050,17,019,"Illinois","Champaign County",5,70,1796,846,950
050,17,019,"Illinois","Champaign County",5,71,1747,831,916
050,17,019,"Illinois","Champaign County",5,72,1644,761,883
050,17,019,"Illinois","Champaign County",5,73,1485,697,788
050,17,019,"Illinois","Champaign County",5,74,1408,658,750
050,17,019,"Illinois","Champaign County",5,75,1286,586,700
050,17,019,"Illinois","Champaign County",5,76,1346,628,718
050,17,019,"Illinois","Champaign County",5,77,962,446,516
050,17,019,"Illinois","Champaign County",5,78,889,418,471
050,17,019,"Illinois","Champaign County",5,79,834,386,448
050,17,019,"Illinois","Champaign County",5,80,853,374,479
050,17,019,"Illinois","Champaign County",5,81,718,293,425
050,17,019,"Illinois","Champaign County",5,82,589,239,350
050,17,019,"Illinois","Champaign County",5,83,557,213,344
050,17,019,"Illinois","Champaign County",5,84,519,199,320
050,17,019,"Illinois","Champaign County",5,85,3316,1182,2134
050,17,021,"Illinois","Christian County",1,0,341,173,168
050,17,021,"Illinois","Christian County",1,1,332,151,181
050,17,021,"Illinois","Christian County",1,2,324,148,176
050,17,021,"Illinois","Christian County",1,3,339,180,159
050,17,021,"Illinois","Christian County",1,4,352,181,171
050,17,021,"Illinois","Christian County",1,5,339,178,161
050,17,021,"Illinois","Christian County",1,6,330,176,154
050,17,021,"Illinois","Christian County",1,7,343,168,175
050,17,021,"Illinois","Christian County",1,8,358,175,183
050,17,021,"Illinois","Christian County",1,9,344,184,160
050,17,021,"Illinois","Christian County",1,10,380,187,193
050,17,021,"Illinois","Christian County",1,11,414,199,215
050,17,021,"Illinois","Christian County",1,12,438,229,209
050,17,021,"Illinois","Christian County",1,13,403,195,208
050,17,021,"Illinois","Christian County",1,14,423,213,210
050,17,021,"Illinois","Christian County",1,15,430,228,202
050,17,021,"Illinois","Christian County",1,16,393,207,186
050,17,021,"Illinois","Christian County",1,17,408,219,189
050,17,021,"Illinois","Christian County",1,18,342,187,155
050,17,021,"Illinois","Christian County",1,19,313,181,132
050,17,021,"Illinois","Christian County",1,20,355,219,136
050,17,021,"Illinois","Christian County",1,21,364,227,137
050,17,021,"Illinois","Christian County",1,22,395,230,165
050,17,021,"Illinois","Christian County",1,23,451,268,183
050,17,021,"Illinois","Christian County",1,24,419,244,175
050,17,021,"Illinois","Christian County",1,25,434,245,189
050,17,021,"Illinois","Christian County",1,26,411,233,178
050,17,021,"Illinois","Christian County",1,27,438,268,170
050,17,021,"Illinois","Christian County",1,28,452,268,184
050,17,021,"Illinois","Christian County",1,29,457,282,175
050,17,021,"Illinois","Christian County",1,30,414,245,169
050,17,021,"Illinois","Christian County",1,31,451,255,196
050,17,021,"Illinois","Christian County",1,32,445,259,186
050,17,021,"Illinois","Christian County",1,33,410,235,175
050,17,021,"Illinois","Christian County",1,34,397,232,165
050,17,021,"Illinois","Christian County",1,35,455,281,174
050,17,021,"Illinois","Christian County",1,36,439,267,172
050,17,021,"Illinois","Christian County",1,37,446,264,182
050,17,021,"Illinois","Christian County",1,38,439,254,185
050,17,021,"Illinois","Christian County",1,39,455,262,193
050,17,021,"Illinois","Christian County",1,40,445,254,191
050,17,021,"Illinois","Christian County",1,41,452,257,195
050,17,021,"Illinois","Christian County",1,42,419,241,178
050,17,021,"Illinois","Christian County",1,43,406,243,163
050,17,021,"Illinois","Christian County",1,44,411,246,165
050,17,021,"Illinois","Christian County",1,45,423,252,171
050,17,021,"Illinois","Christian County",1,46,426,256,170
050,17,021,"Illinois","Christian County",1,47,423,249,174
050,17,021,"Illinois","Christian County",1,48,484,268,216
050,17,021,"Illinois","Christian County",1,49,514,285,229
050,17,021,"Illinois","Christian County",1,50,446,245,201
050,17,021,"Illinois","Christian County",1,51,439,243,196
050,17,021,"Illinois","Christian County",1,52,467,259,208
050,17,021,"Illinois","Christian County",1,53,453,241,212
050,17,021,"Illinois","Christian County",1,54,448,240,208
050,17,021,"Illinois","Christian County",1,55,501,262,239
050,17,021,"Illinois","Christian County",1,56,525,284,241
050,17,021,"Illinois","Christian County",1,57,510,264,246
050,17,021,"Illinois","Christian County",1,58,519,267,252
050,17,021,"Illinois","Christian County",1,59,487,256,231
050,17,021,"Illinois","Christian County",1,60,487,266,221
050,17,021,"Illinois","Christian County",1,61,505,266,239
050,17,021,"Illinois","Christian County",1,62,498,260,238
050,17,021,"Illinois","Christian County",1,63,477,256,221
050,17,021,"Illinois","Christian County",1,64,446,227,219
050,17,021,"Illinois","Christian County",1,65,457,219,238
050,17,021,"Illinois","Christian County",1,66,436,223,213
050,17,021,"Illinois","Christian County",1,67,417,206,211
050,17,021,"Illinois","Christian County",1,68,408,193,215
050,17,021,"Illinois","Christian County",1,69,349,166,183
050,17,021,"Illinois","Christian County",1,70,333,163,170
050,17,021,"Illinois","Christian County",1,71,322,147,175
050,17,021,"Illinois","Christian County",1,72,333,141,192
050,17,021,"Illinois","Christian County",1,73,340,155,185
050,17,021,"Illinois","Christian County",1,74,248,121,127
050,17,021,"Illinois","Christian County",1,75,244,115,129
050,17,021,"Illinois","Christian County",1,76,260,113,147
050,17,021,"Illinois","Christian County",1,77,253,105,148
050,17,021,"Illinois","Christian County",1,78,219,90,129
050,17,021,"Illinois","Christian County",1,79,211,93,118
050,17,021,"Illinois","Christian County",1,80,190,87,103
050,17,021,"Illinois","Christian County",1,81,187,84,103
050,17,021,"Illinois","Christian County",1,82,172,78,94
050,17,021,"Illinois","Christian County",1,83,168,70,98
050,17,021,"Illinois","Christian County",1,84,145,63,82
050,17,021,"Illinois","Christian County",1,85,863,299,564
050,17,021,"Illinois","Christian County",2,0,338,179,159
050,17,021,"Illinois","Christian County",2,1,334,155,179
050,17,021,"Illinois","Christian County",2,2,323,149,174
050,17,021,"Illinois","Christian County",2,3,330,170,160
050,17,021,"Illinois","Christian County",2,4,346,180,166
050,17,021,"Illinois","Christian County",2,5,340,176,164
050,17,021,"Illinois","Christian County",2,6,328,173,155
050,17,021,"Illinois","Christian County",2,7,338,169,169
050,17,021,"Illinois","Christian County",2,8,352,172,180
050,17,021,"Illinois","Christian County",2,9,343,179,164
050,17,021,"Illinois","Christian County",2,10,370,186,184
050,17,021,"Illinois","Christian County",2,11,403,196,207
050,17,021,"Illinois","Christian County",2,12,436,223,213
050,17,021,"Illinois","Christian County",2,13,413,204,209
050,17,021,"Illinois","Christian County",2,14,420,209,211
050,17,021,"Illinois","Christian County",2,15,432,226,206
050,17,021,"Illinois","Christian County",2,16,405,213,192
050,17,021,"Illinois","Christian County",2,17,407,219,188
050,17,021,"Illinois","Christian County",2,18,341,187,154
050,17,021,"Illinois","Christian County",2,19,312,183,129
050,17,021,"Illinois","Christian County",2,20,354,215,139
050,17,021,"Illinois","Christian County",2,21,370,231,139
050,17,021,"Illinois","Christian County",2,22,390,228,162
050,17,021,"Illinois","Christian County",2,23,451,269,182
050,17,021,"Illinois","Christian County",2,24,421,245,176
050,17,021,"Illinois","Christian County",2,25,424,242,182
050,17,021,"Illinois","Christian County",2,26,416,235,181
050,17,021,"Illinois","Christian County",2,27,433,262,171
050,17,021,"Illinois","Christian County",2,28,444,266,178
050,17,021,"Illinois","Christian County",2,29,459,282,177
050,17,021,"Illinois","Christian County",2,30,420,248,172
050,17,021,"Illinois","Christian County",2,31,447,256,191
050,17,021,"Illinois","Christian County",2,32,449,261,188
050,17,021,"Illinois","Christian County",2,33,405,229,176
050,17,021,"Illinois","Christian County",2,34,394,228,166
050,17,021,"Illinois","Christian County",2,35,452,282,170
050,17,021,"Illinois","Christian County",2,36,437,265,172
050,17,021,"Illinois","Christian County",2,37,445,264,181
050,17,021,"Illinois","Christian County",2,38,438,252,186
050,17,021,"Illinois","Christian County",2,39,449,259,190
050,17,021,"Illinois","Christian County",2,40,455,262,193
050,17,021,"Illinois","Christian County",2,41,449,257,192
050,17,021,"Illinois","Christian County",2,42,419,240,179
050,17,021,"Illinois","Christian County",2,43,414,245,169
050,17,021,"Illinois","Christian County",2,44,411,247,164
050,17,021,"Illinois","Christian County",2,45,421,253,168
050,17,021,"Illinois","Christian County",2,46,424,255,169
050,17,021,"Illinois","Christian County",2,47,422,248,174
050,17,021,"Illinois","Christian County",2,48,472,267,205
050,17,021,"Illinois","Christian County",2,49,511,282,229
050,17,021,"Illinois","Christian County",2,50,455,248,207
050,17,021,"Illinois","Christian County",2,51,440,245,195
050,17,021,"Illinois","Christian County",2,52,459,255,204
050,17,021,"Illinois","Christian County",2,53,453,244,209
050,17,021,"Illinois","Christian County",2,54,444,233,211
050,17,021,"Illinois","Christian County",2,55,489,256,233
050,17,021,"Illinois","Christian County",2,56,518,279,239
050,17,021,"Illinois","Christian County",2,57,511,266,245
050,17,021,"Illinois","Christian County",2,58,515,265,250
050,17,021,"Illinois","Christian County",2,59,489,255,234
050,17,021,"Illinois","Christian County",2,60,486,265,221
050,17,021,"Illinois","Christian County",2,61,491,258,233
050,17,021,"Illinois","Christian County",2,62,495,258,237
050,17,021,"Illinois","Christian County",2,63,484,258,226
050,17,021,"Illinois","Christian County",2,64,445,229,216
050,17,021,"Illinois","Christian County",2,65,452,220,232
050,17,021,"Illinois","Christian County",2,66,443,223,220
050,17,021,"Illinois","Christian County",2,67,415,206,209
050,17,021,"Illinois","Christian County",2,68,406,195,211
050,17,021,"Illinois","Christian County",2,69,366,173,193
050,17,021,"Illinois","Christian County",2,70,334,162,172
050,17,021,"Illinois","Christian County",2,71,322,149,173
050,17,021,"Illinois","Christian County",2,72,323,138,185
050,17,021,"Illinois","Christian County",2,73,354,158,196
050,17,021,"Illinois","Christian County",2,74,250,119,131
050,17,021,"Illinois","Christian County",2,75,245,117,128
050,17,021,"Illinois","Christian County",2,76,253,110,143
050,17,021,"Illinois","Christian County",2,77,260,109,151
050,17,021,"Illinois","Christian County",2,78,220,91,129
050,17,021,"Illinois","Christian County",2,79,211,91,120
050,17,021,"Illinois","Christian County",2,80,195,89,106
050,17,021,"Illinois","Christian County",2,81,186,84,102
050,17,021,"Illinois","Christian County",2,82,172,76,96
050,17,021,"Illinois","Christian County",2,83,164,69,95
050,17,021,"Illinois","Christian County",2,84,148,63,85
050,17,021,"Illinois","Christian County",2,85,860,297,563
050,17,021,"Illinois","Christian County",3,0,292,148,144
050,17,021,"Illinois","Christian County",3,1,326,168,158
050,17,021,"Illinois","Christian County",3,2,322,154,168
050,17,021,"Illinois","Christian County",3,3,333,154,179
050,17,021,"Illinois","Christian County",3,4,327,157,170
050,17,021,"Illinois","Christian County",3,5,353,181,172
050,17,021,"Illinois","Christian County",3,6,347,181,166
050,17,021,"Illinois","Christian County",3,7,328,177,151
050,17,021,"Illinois","Christian County",3,8,340,171,169
050,17,021,"Illinois","Christian County",3,9,352,178,174
050,17,021,"Illinois","Christian County",3,10,348,182,166
050,17,021,"Illinois","Christian County",3,11,379,186,193
050,17,021,"Illinois","Christian County",3,12,405,199,206
050,17,021,"Illinois","Christian County",3,13,419,219,200
050,17,021,"Illinois","Christian County",3,14,410,201,209
050,17,021,"Illinois","Christian County",3,15,403,207,196
050,17,021,"Illinois","Christian County",3,16,426,213,213
050,17,021,"Illinois","Christian County",3,17,404,217,187
050,17,021,"Illinois","Christian County",3,18,356,199,157
050,17,021,"Illinois","Christian County",3,19,298,184,114
050,17,021,"Illinois","Christian County",3,20,346,205,141
050,17,021,"Illinois","Christian County",3,21,374,230,144
050,17,021,"Illinois","Christian County",3,22,384,232,152
050,17,021,"Illinois","Christian County",3,23,437,264,173
050,17,021,"Illinois","Christian County",3,24,438,253,185
050,17,021,"Illinois","Christian County",3,25,417,250,167
050,17,021,"Illinois","Christian County",3,26,425,244,181
050,17,021,"Illinois","Christian County",3,27,428,254,174
050,17,021,"Illinois","Christian County",3,28,425,257,168
050,17,021,"Illinois","Christian County",3,29,458,275,183
050,17,021,"Illinois","Christian County",3,30,420,249,171
050,17,021,"Illinois","Christian County",3,31,444,266,178
050,17,021,"Illinois","Christian County",3,32,466,280,186
050,17,021,"Illinois","Christian County",3,33,422,232,190
050,17,021,"Illinois","Christian County",3,34,399,222,177
050,17,021,"Illinois","Christian County",3,35,445,273,172
050,17,021,"Illinois","Christian County",3,36,434,256,178
050,17,021,"Illinois","Christian County",3,37,423,258,165
050,17,021,"Illinois","Christian County",3,38,431,249,182
050,17,021,"Illinois","Christian County",3,39,441,256,185
050,17,021,"Illinois","Christian County",3,40,463,272,191
050,17,021,"Illinois","Christian County",3,41,454,265,189
050,17,021,"Illinois","Christian County",3,42,428,241,187
050,17,021,"Illinois","Christian County",3,43,427,249,178
050,17,021,"Illinois","Christian County",3,44,417,245,172
050,17,021,"Illinois","Christian County",3,45,408,251,157
050,17,021,"Illinois","Christian County",3,46,425,258,167
050,17,021,"Illinois","Christian County",3,47,412,246,166
050,17,021,"Illinois","Christian County",3,48,428,266,162
050,17,021,"Illinois","Christian County",3,49,470,266,204
050,17,021,"Illinois","Christian County",3,50,473,253,220
050,17,021,"Illinois","Christian County",3,51,455,254,201
050,17,021,"Illinois","Christian County",3,52,438,245,193
050,17,021,"Illinois","Christian County",3,53,447,241,206
050,17,021,"Illinois","Christian County",3,54,427,222,205
050,17,021,"Illinois","Christian County",3,55,439,229,210
050,17,021,"Illinois","Christian County",3,56,492,263,229
050,17,021,"Illinois","Christian County",3,57,513,274,239
050,17,021,"Illinois","Christian County",3,58,516,266,250
050,17,021,"Illinois","Christian County",3,59,494,246,248
050,17,021,"Illinois","Christian County",3,60,506,270,236
050,17,021,"Illinois","Christian County",3,61,472,256,216
050,17,021,"Illinois","Christian County",3,62,480,253,227
050,17,021,"Illinois","Christian County",3,63,492,253,239
050,17,021,"Illinois","Christian County",3,64,473,249,224
050,17,021,"Illinois","Christian County",3,65,437,219,218
050,17,021,"Illinois","Christian County",3,66,453,224,229
050,17,021,"Illinois","Christian County",3,67,423,208,215
050,17,021,"Illinois","Christian County",3,68,416,204,212
050,17,021,"Illinois","Christian County",3,69,385,184,201
050,17,021,"Illinois","Christian County",3,70,354,165,189
050,17,021,"Illinois","Christian County",3,71,332,163,169
050,17,021,"Illinois","Christian County",3,72,314,142,172
050,17,021,"Illinois","Christian County",3,73,315,135,180
050,17,021,"Illinois","Christian County",3,74,342,150,192
050,17,021,"Illinois","Christian County",3,75,233,114,119
050,17,021,"Illinois","Christian County",3,76,240,111,129
050,17,021,"Illinois","Christian County",3,77,238,100,138
050,17,021,"Illinois","Christian County",3,78,241,103,138
050,17,021,"Illinois","Christian County",3,79,211,86,125
050,17,021,"Illinois","Christian County",3,80,195,86,109
050,17,021,"Illinois","Christian County",3,81,183,83,100
050,17,021,"Illinois","Christian County",3,82,179,79,100
050,17,021,"Illinois","Christian County",3,83,160,68,92
050,17,021,"Illinois","Christian County",3,84,146,58,88
050,17,021,"Illinois","Christian County",3,85,832,292,540
050,17,021,"Illinois","Christian County",4,0,287,148,139
050,17,021,"Illinois","Christian County",4,1,295,150,145
050,17,021,"Illinois","Christian County",4,2,337,172,165
050,17,021,"Illinois","Christian County",4,3,320,153,167
050,17,021,"Illinois","Christian County",4,4,326,152,174
050,17,021,"Illinois","Christian County",4,5,322,155,167
050,17,021,"Illinois","Christian County",4,6,354,184,170
050,17,021,"Illinois","Christian County",4,7,352,186,166
050,17,021,"Illinois","Christian County",4,8,331,180,151
050,17,021,"Illinois","Christian County",4,9,334,170,164
050,17,021,"Illinois","Christian County",4,10,353,179,174
050,17,021,"Illinois","Christian County",4,11,354,186,168
050,17,021,"Illinois","Christian County",4,12,376,186,190
050,17,021,"Illinois","Christian County",4,13,406,197,209
050,17,021,"Illinois","Christian County",4,14,418,207,211
050,17,021,"Illinois","Christian County",4,15,415,204,211
050,17,021,"Illinois","Christian County",4,16,410,201,209
050,17,021,"Illinois","Christian County",4,17,421,215,206
050,17,021,"Illinois","Christian County",4,18,348,193,155
050,17,021,"Illinois","Christian County",4,19,300,183,117
050,17,021,"Illinois","Christian County",4,20,320,200,120
050,17,021,"Illinois","Christian County",4,21,375,226,149
050,17,021,"Illinois","Christian County",4,22,374,223,151
050,17,021,"Illinois","Christian County",4,23,428,265,163
050,17,021,"Illinois","Christian County",4,24,428,254,174
050,17,021,"Illinois","Christian County",4,25,415,244,171
050,17,021,"Illinois","Christian County",4,26,416,242,174
050,17,021,"Illinois","Christian County",4,27,432,257,175
050,17,021,"Illinois","Christian County",4,28,416,243,173
050,17,021,"Illinois","Christian County",4,29,426,254,172
050,17,021,"Illinois","Christian County",4,30,436,253,183
050,17,021,"Illinois","Christian County",4,31,446,268,178
050,17,021,"Illinois","Christian County",4,32,455,287,168
050,17,021,"Illinois","Christian County",4,33,423,243,180
050,17,021,"Illinois","Christian County",4,34,413,217,196
050,17,021,"Illinois","Christian County",4,35,452,271,181
050,17,021,"Illinois","Christian County",4,36,421,254,167
050,17,021,"Illinois","Christian County",4,37,423,249,174
050,17,021,"Illinois","Christian County",4,38,416,242,174
050,17,021,"Illinois","Christian County",4,39,432,251,181
050,17,021,"Illinois","Christian County",4,40,448,274,174
050,17,021,"Illinois","Christian County",4,41,466,270,196
050,17,021,"Illinois","Christian County",4,42,436,248,188
050,17,021,"Illinois","Christian County",4,43,437,242,195
050,17,021,"Illinois","Christian County",4,44,426,251,175
050,17,021,"Illinois","Christian County",4,45,424,252,172
050,17,021,"Illinois","Christian County",4,46,407,249,158
050,17,021,"Illinois","Christian County",4,47,408,246,162
050,17,021,"Illinois","Christian County",4,48,420,258,162
050,17,021,"Illinois","Christian County",4,49,429,263,166
050,17,021,"Illinois","Christian County",4,50,441,240,201
050,17,021,"Illinois","Christian County",4,51,461,250,211
050,17,021,"Illinois","Christian County",4,52,459,257,202
050,17,021,"Illinois","Christian County",4,53,442,242,200
050,17,021,"Illinois","Christian County",4,54,415,215,200
050,17,021,"Illinois","Christian County",4,55,427,219,208
050,17,021,"Illinois","Christian County",4,56,447,239,208
050,17,021,"Illinois","Christian County",4,57,481,257,224
050,17,021,"Illinois","Christian County",4,58,508,272,236
050,17,021,"Illinois","Christian County",4,59,496,248,248
050,17,021,"Illinois","Christian County",4,60,500,259,241
050,17,021,"Illinois","Christian County",4,61,492,256,236
050,17,021,"Illinois","Christian County",4,62,459,246,213
050,17,021,"Illinois","Christian County",4,63,475,244,231
050,17,021,"Illinois","Christian County",4,64,477,245,232
050,17,021,"Illinois","Christian County",4,65,465,250,215
050,17,021,"Illinois","Christian County",4,66,420,209,211
050,17,021,"Illinois","Christian County",4,67,434,211,223
050,17,021,"Illinois","Christian County",4,68,425,213,212
050,17,021,"Illinois","Christian County",4,69,401,197,204
050,17,021,"Illinois","Christian County",4,70,363,167,196
050,17,021,"Illinois","Christian County",4,71,347,165,182
050,17,021,"Illinois","Christian County",4,72,318,153,165
050,17,021,"Illinois","Christian County",4,73,302,138,164
050,17,021,"Illinois","Christian County",4,74,297,125,172
050,17,021,"Illinois","Christian County",4,75,330,143,187
050,17,021,"Illinois","Christian County",4,76,231,109,122
050,17,021,"Illinois","Christian County",4,77,224,102,122
050,17,021,"Illinois","Christian County",4,78,221,97,124
050,17,021,"Illinois","Christian County",4,79,235,97,138
050,17,021,"Illinois","Christian County",4,80,195,79,116
050,17,021,"Illinois","Christian County",4,81,183,79,104
050,17,021,"Illinois","Christian County",4,82,173,78,95
050,17,021,"Illinois","Christian County",4,83,166,71,95
050,17,021,"Illinois","Christian County",4,84,143,58,85
050,17,021,"Illinois","Christian County",4,85,830,295,535
050,17,021,"Illinois","Christian County",5,0,280,144,136
050,17,021,"Illinois","Christian County",5,1,300,163,137
050,17,021,"Illinois","Christian County",5,2,279,144,135
050,17,021,"Illinois","Christian County",5,3,329,168,161
050,17,021,"Illinois","Christian County",5,4,304,147,157
050,17,021,"Illinois","Christian County",5,5,326,156,170
050,17,021,"Illinois","Christian County",5,6,326,154,172
050,17,021,"Illinois","Christian County",5,7,353,184,169
050,17,021,"Illinois","Christian County",5,8,345,180,165
050,17,021,"Illinois","Christian County",5,9,333,179,154
050,17,021,"Illinois","Christian County",5,10,335,168,167
050,17,021,"Illinois","Christian County",5,11,345,174,171
050,17,021,"Illinois","Christian County",5,12,353,181,172
050,17,021,"Illinois","Christian County",5,13,383,188,195
050,17,021,"Illinois","Christian County",5,14,410,196,214
050,17,021,"Illinois","Christian County",5,15,412,209,203
050,17,021,"Illinois","Christian County",5,16,411,197,214
050,17,021,"Illinois","Christian County",5,17,422,218,204
050,17,021,"Illinois","Christian County",5,18,362,199,163
050,17,021,"Illinois","Christian County",5,19,303,189,114
050,17,021,"Illinois","Christian County",5,20,334,202,132
050,17,021,"Illinois","Christian County",5,21,358,221,137
050,17,021,"Illinois","Christian County",5,22,386,223,163
050,17,021,"Illinois","Christian County",5,23,417,276,141
050,17,021,"Illinois","Christian County",5,24,403,243,160
050,17,021,"Illinois","Christian County",5,25,407,241,166
050,17,021,"Illinois","Christian County",5,26,426,249,177
050,17,021,"Illinois","Christian County",5,27,423,253,170
050,17,021,"Illinois","Christian County",5,28,440,260,180
050,17,021,"Illinois","Christian County",5,29,415,249,166
050,17,021,"Illinois","Christian County",5,30,395,223,172
050,17,021,"Illinois","Christian County",5,31,464,273,191
050,17,021,"Illinois","Christian County",5,32,455,279,176
050,17,021,"Illinois","Christian County",5,33,429,256,173
050,17,021,"Illinois","Christian County",5,34,414,232,182
050,17,021,"Illinois","Christian County",5,35,458,267,191
050,17,021,"Illinois","Christian County",5,36,438,258,180
050,17,021,"Illinois","Christian County",5,37,416,250,166
050,17,021,"Illinois","Christian County",5,38,401,230,171
050,17,021,"Illinois","Christian County",5,39,421,246,175
050,17,021,"Illinois","Christian County",5,40,452,266,186
050,17,021,"Illinois","Christian County",5,41,445,269,176
050,17,021,"Illinois","Christian County",5,42,461,262,199
050,17,021,"Illinois","Christian County",5,43,436,251,185
050,17,021,"Illinois","Christian County",5,44,441,247,194
050,17,021,"Illinois","Christian County",5,45,433,259,174
050,17,021,"Illinois","Christian County",5,46,421,252,169
050,17,021,"Illinois","Christian County",5,47,391,231,160
050,17,021,"Illinois","Christian County",5,48,416,256,160
050,17,021,"Illinois","Christian County",5,49,417,253,164
050,17,021,"Illinois","Christian County",5,50,401,235,166
050,17,021,"Illinois","Christian County",5,51,441,241,200
050,17,021,"Illinois","Christian County",5,52,469,253,216
050,17,021,"Illinois","Christian County",5,53,444,242,202
050,17,021,"Illinois","Christian County",5,54,415,218,197
050,17,021,"Illinois","Christian County",5,55,422,217,205
050,17,021,"Illinois","Christian County",5,56,439,231,208
050,17,021,"Illinois","Christian County",5,57,432,232,200
050,17,021,"Illinois","Christian County",5,58,495,259,236
050,17,021,"Illinois","Christian County",5,59,488,252,236
050,17,021,"Illinois","Christian County",5,60,507,262,245
050,17,021,"Illinois","Christian County",5,61,484,248,236
050,17,021,"Illinois","Christian County",5,62,490,250,240
050,17,021,"Illinois","Christian County",5,63,455,243,212
050,17,021,"Illinois","Christian County",5,64,468,235,233
050,17,021,"Illinois","Christian County",5,65,472,239,233
050,17,021,"Illinois","Christian County",5,66,456,246,210
050,17,021,"Illinois","Christian County",5,67,407,201,206
050,17,021,"Illinois","Christian County",5,68,435,216,219
050,17,021,"Illinois","Christian County",5,69,412,202,210
050,17,021,"Illinois","Christian County",5,70,390,187,203
050,17,021,"Illinois","Christian County",5,71,355,166,189
050,17,021,"Illinois","Christian County",5,72,337,158,179
050,17,021,"Illinois","Christian County",5,73,312,149,163
050,17,021,"Illinois","Christian County",5,74,294,137,157
050,17,021,"Illinois","Christian County",5,75,288,121,167
050,17,021,"Illinois","Christian County",5,76,320,135,185
050,17,021,"Illinois","Christian County",5,77,224,102,122
050,17,021,"Illinois","Christian County",5,78,206,97,109
050,17,021,"Illinois","Christian County",5,79,213,88,125
050,17,021,"Illinois","Christian County",5,80,216,90,126
050,17,021,"Illinois","Christian County",5,81,188,72,116
050,17,021,"Illinois","Christian County",5,82,174,76,98
050,17,021,"Illinois","Christian County",5,83,160,71,89
050,17,021,"Illinois","Christian County",5,84,155,63,92
050,17,021,"Illinois","Christian County",5,85,840,298,542
050,17,023,"Illinois","Clark County",1,0,185,95,90
050,17,023,"Illinois","Clark County",1,1,187,88,99
050,17,023,"Illinois","Clark County",1,2,173,94,79
050,17,023,"Illinois","Clark County",1,3,185,97,88
050,17,023,"Illinois","Clark County",1,4,167,88,79
050,17,023,"Illinois","Clark County",1,5,183,101,82
050,17,023,"Illinois","Clark County",1,6,198,108,90
050,17,023,"Illinois","Clark County",1,7,194,107,87
050,17,023,"Illinois","Clark County",1,8,191,99,92
050,17,023,"Illinois","Clark County",1,9,205,108,97
050,17,023,"Illinois","Clark County",1,10,200,99,101
050,17,023,"Illinois","Clark County",1,11,205,109,96
050,17,023,"Illinois","Clark County",1,12,202,103,99
050,17,023,"Illinois","Clark County",1,13,206,105,101
050,17,023,"Illinois","Clark County",1,14,213,109,104
050,17,023,"Illinois","Clark County",1,15,215,105,110
050,17,023,"Illinois","Clark County",1,16,188,93,95
050,17,023,"Illinois","Clark County",1,17,201,107,94
050,17,023,"Illinois","Clark County",1,18,178,104,74
050,17,023,"Illinois","Clark County",1,19,145,78,67
050,17,023,"Illinois","Clark County",1,20,158,73,85
050,17,023,"Illinois","Clark County",1,21,153,75,78
050,17,023,"Illinois","Clark County",1,22,164,78,86
050,17,023,"Illinois","Clark County",1,23,169,82,87
050,17,023,"Illinois","Clark County",1,24,175,92,83
050,17,023,"Illinois","Clark County",1,25,158,86,72
050,17,023,"Illinois","Clark County",1,26,166,90,76
050,17,023,"Illinois","Clark County",1,27,169,102,67
050,17,023,"Illinois","Clark County",1,28,175,93,82
050,17,023,"Illinois","Clark County",1,29,177,81,96
050,17,023,"Illinois","Clark County",1,30,176,84,92
050,17,023,"Illinois","Clark County",1,31,157,72,85
050,17,023,"Illinois","Clark County",1,32,188,98,90
050,17,023,"Illinois","Clark County",1,33,168,82,86
050,17,023,"Illinois","Clark County",1,34,188,101,87
050,17,023,"Illinois","Clark County",1,35,188,103,85
050,17,023,"Illinois","Clark County",1,36,176,80,96
050,17,023,"Illinois","Clark County",1,37,190,95,95
050,17,023,"Illinois","Clark County",1,38,188,93,95
050,17,023,"Illinois","Clark County",1,39,198,101,97
050,17,023,"Illinois","Clark County",1,40,197,100,97
050,17,023,"Illinois","Clark County",1,41,191,94,97
050,17,023,"Illinois","Clark County",1,42,195,101,94
050,17,023,"Illinois","Clark County",1,43,159,84,75
050,17,023,"Illinois","Clark County",1,44,148,78,70
050,17,023,"Illinois","Clark County",1,45,177,97,80
050,17,023,"Illinois","Clark County",1,46,178,90,88
050,17,023,"Illinois","Clark County",1,47,171,85,86
050,17,023,"Illinois","Clark County",1,48,200,111,89
050,17,023,"Illinois","Clark County",1,49,214,118,96
050,17,023,"Illinois","Clark County",1,50,202,108,94
050,17,023,"Illinois","Clark County",1,51,203,111,92
050,17,023,"Illinois","Clark County",1,52,188,92,96
050,17,023,"Illinois","Clark County",1,53,192,87,105
050,17,023,"Illinois","Clark County",1,54,230,119,111
050,17,023,"Illinois","Clark County",1,55,233,115,118
050,17,023,"Illinois","Clark County",1,56,217,112,105
050,17,023,"Illinois","Clark County",1,57,243,126,117
050,17,023,"Illinois","Clark County",1,58,251,118,133
050,17,023,"Illinois","Clark County",1,59,247,118,129
050,17,023,"Illinois","Clark County",1,60,225,115,110
050,17,023,"Illinois","Clark County",1,61,228,121,107
050,17,023,"Illinois","Clark County",1,62,237,129,108
050,17,023,"Illinois","Clark County",1,63,223,120,103
050,17,023,"Illinois","Clark County",1,64,214,106,108
050,17,023,"Illinois","Clark County",1,65,198,106,92
050,17,023,"Illinois","Clark County",1,66,196,105,91
050,17,023,"Illinois","Clark County",1,67,198,106,92
050,17,023,"Illinois","Clark County",1,68,188,94,94
050,17,023,"Illinois","Clark County",1,69,185,87,98
050,17,023,"Illinois","Clark County",1,70,171,84,87
050,17,023,"Illinois","Clark County",1,71,163,77,86
050,17,023,"Illinois","Clark County",1,72,155,68,87
050,17,023,"Illinois","Clark County",1,73,148,64,84
050,17,023,"Illinois","Clark County",1,74,113,51,62
050,17,023,"Illinois","Clark County",1,75,117,53,64
050,17,023,"Illinois","Clark County",1,76,125,55,70
050,17,023,"Illinois","Clark County",1,77,126,56,70
050,17,023,"Illinois","Clark County",1,78,112,53,59
050,17,023,"Illinois","Clark County",1,79,90,41,49
050,17,023,"Illinois","Clark County",1,80,97,45,52
050,17,023,"Illinois","Clark County",1,81,86,44,42
050,17,023,"Illinois","Clark County",1,82,60,32,28
050,17,023,"Illinois","Clark County",1,83,59,27,32
050,17,023,"Illinois","Clark County",1,84,57,20,37
050,17,023,"Illinois","Clark County",1,85,354,97,257
050,17,023,"Illinois","Clark County",2,0,192,95,97
050,17,023,"Illinois","Clark County",2,1,184,90,94
050,17,023,"Illinois","Clark County",2,2,176,92,84
050,17,023,"Illinois","Clark County",2,3,180,96,84
050,17,023,"Illinois","Clark County",2,4,173,91,82
050,17,023,"Illinois","Clark County",2,5,178,97,81
050,17,023,"Illinois","Clark County",2,6,195,107,88
050,17,023,"Illinois","Clark County",2,7,194,106,88
050,17,023,"Illinois","Clark County",2,8,189,99,90
050,17,023,"Illinois","Clark County",2,9,201,106,95
050,17,023,"Illinois","Clark County",2,10,201,101,100
050,17,023,"Illinois","Clark County",2,11,204,106,98
050,17,023,"Illinois","Clark County",2,12,204,105,99
050,17,023,"Illinois","Clark County",2,13,203,103,100
050,17,023,"Illinois","Clark County",2,14,211,108,103
050,17,023,"Illinois","Clark County",2,15,214,106,108
050,17,023,"Illinois","Clark County",2,16,193,95,98
050,17,023,"Illinois","Clark County",2,17,195,102,93
050,17,023,"Illinois","Clark County",2,18,171,98,73
050,17,023,"Illinois","Clark County",2,19,146,79,67
050,17,023,"Illinois","Clark County",2,20,158,75,83
050,17,023,"Illinois","Clark County",2,21,157,76,81
050,17,023,"Illinois","Clark County",2,22,164,78,86
050,17,023,"Illinois","Clark County",2,23,168,81,87
050,17,023,"Illinois","Clark County",2,24,171,89,82
050,17,023,"Illinois","Clark County",2,25,159,85,74
050,17,023,"Illinois","Clark County",2,26,164,89,75
050,17,023,"Illinois","Clark County",2,27,166,98,68
050,17,023,"Illinois","Clark County",2,28,173,94,79
050,17,023,"Illinois","Clark County",2,29,176,85,91
050,17,023,"Illinois","Clark County",2,30,176,82,94
050,17,023,"Illinois","Clark County",2,31,160,75,85
050,17,023,"Illinois","Clark County",2,32,180,91,89
050,17,023,"Illinois","Clark County",2,33,170,84,86
050,17,023,"Illinois","Clark County",2,34,182,95,87
050,17,023,"Illinois","Clark County",2,35,190,103,87
050,17,023,"Illinois","Clark County",2,36,178,84,94
050,17,023,"Illinois","Clark County",2,37,184,90,94
050,17,023,"Illinois","Clark County",2,38,192,95,97
050,17,023,"Illinois","Clark County",2,39,197,100,97
050,17,023,"Illinois","Clark County",2,40,200,102,98
050,17,023,"Illinois","Clark County",2,41,191,96,95
050,17,023,"Illinois","Clark County",2,42,192,99,93
050,17,023,"Illinois","Clark County",2,43,168,88,80
050,17,023,"Illinois","Clark County",2,44,149,79,70
050,17,023,"Illinois","Clark County",2,45,170,92,78
050,17,023,"Illinois","Clark County",2,46,176,90,86
050,17,023,"Illinois","Clark County",2,47,172,86,86
050,17,023,"Illinois","Clark County",2,48,192,104,88
050,17,023,"Illinois","Clark County",2,49,211,117,94
050,17,023,"Illinois","Clark County",2,50,205,110,95
050,17,023,"Illinois","Clark County",2,51,199,108,91
050,17,023,"Illinois","Clark County",2,52,191,97,94
050,17,023,"Illinois","Clark County",2,53,193,89,104
050,17,023,"Illinois","Clark County",2,54,221,111,110
050,17,023,"Illinois","Clark County",2,55,233,117,116
050,17,023,"Illinois","Clark County",2,56,221,113,108
050,17,023,"Illinois","Clark County",2,57,237,122,115
050,17,023,"Illinois","Clark County",2,58,248,119,129
050,17,023,"Illinois","Clark County",2,59,252,120,132
050,17,023,"Illinois","Clark County",2,60,227,114,113
050,17,023,"Illinois","Clark County",2,61,225,117,108
050,17,023,"Illinois","Clark County",2,62,234,127,107
050,17,023,"Illinois","Clark County",2,63,227,122,105
050,17,023,"Illinois","Clark County",2,64,213,108,105
050,17,023,"Illinois","Clark County",2,65,200,106,94
050,17,023,"Illinois","Clark County",2,66,196,104,92
050,17,023,"Illinois","Clark County",2,67,197,106,91
050,17,023,"Illinois","Clark County",2,68,189,96,93
050,17,023,"Illinois","Clark County",2,69,187,90,97
050,17,023,"Illinois","Clark County",2,70,170,82,88
050,17,023,"Illinois","Clark County",2,71,165,78,87
050,17,023,"Illinois","Clark County",2,72,153,68,85
050,17,023,"Illinois","Clark County",2,73,158,69,89
050,17,023,"Illinois","Clark County",2,74,111,50,61
050,17,023,"Illinois","Clark County",2,75,116,53,63
050,17,023,"Illinois","Clark County",2,76,123,54,69
050,17,023,"Illinois","Clark County",2,77,126,57,69
050,17,023,"Illinois","Clark County",2,78,111,51,60
050,17,023,"Illinois","Clark County",2,79,95,43,52
050,17,023,"Illinois","Clark County",2,80,96,45,51
050,17,023,"Illinois","Clark County",2,81,83,43,40
050,17,023,"Illinois","Clark County",2,82,66,35,31
050,17,023,"Illinois","Clark County",2,83,60,29,31
050,17,023,"Illinois","Clark County",2,84,55,20,35
050,17,023,"Illinois","Clark County",2,85,356,98,258
050,17,023,"Illinois","Clark County",3,0,178,91,87
050,17,023,"Illinois","Clark County",3,1,189,93,96
050,17,023,"Illinois","Clark County",3,2,184,89,95
050,17,023,"Illinois","Clark County",3,3,181,90,91
050,17,023,"Illinois","Clark County",3,4,178,94,84
050,17,023,"Illinois","Clark County",3,5,183,99,84
050,17,023,"Illinois","Clark County",3,6,178,96,82
050,17,023,"Illinois","Clark County",3,7,206,114,92
050,17,023,"Illinois","Clark County",3,8,193,104,89
050,17,023,"Illinois","Clark County",3,9,197,109,88
050,17,023,"Illinois","Clark County",3,10,199,107,92
050,17,023,"Illinois","Clark County",3,11,190,90,100
050,17,023,"Illinois","Clark County",3,12,204,105,99
050,17,023,"Illinois","Clark County",3,13,205,106,99
050,17,023,"Illinois","Clark County",3,14,214,112,102
050,17,023,"Illinois","Clark County",3,15,208,104,104
050,17,023,"Illinois","Clark County",3,16,219,109,110
050,17,023,"Illinois","Clark County",3,17,189,93,96
050,17,023,"Illinois","Clark County",3,18,167,88,79
050,17,023,"Illinois","Clark County",3,19,127,73,54
050,17,023,"Illinois","Clark County",3,20,162,86,76
050,17,023,"Illinois","Clark County",3,21,177,84,93
050,17,023,"Illinois","Clark County",3,22,163,78,85
050,17,023,"Illinois","Clark County",3,23,152,74,78
050,17,023,"Illinois","Clark County",3,24,169,84,85
050,17,023,"Illinois","Clark County",3,25,180,95,85
050,17,023,"Illinois","Clark County",3,26,169,86,83
050,17,023,"Illinois","Clark County",3,27,165,91,74
050,17,023,"Illinois","Clark County",3,28,166,95,71
050,17,023,"Illinois","Clark County",3,29,173,98,75
050,17,023,"Illinois","Clark County",3,30,166,82,84
050,17,023,"Illinois","Clark County",3,31,170,77,93
050,17,023,"Illinois","Clark County",3,32,164,77,87
050,17,023,"Illinois","Clark County",3,33,185,95,90
050,17,023,"Illinois","Clark County",3,34,174,86,88
050,17,023,"Illinois","Clark County",3,35,185,98,87
050,17,023,"Illinois","Clark County",3,36,191,102,89
050,17,023,"Illinois","Clark County",3,37,179,89,90
050,17,023,"Illinois","Clark County",3,38,182,87,95
050,17,023,"Illinois","Clark County",3,39,189,91,98
050,17,023,"Illinois","Clark County",3,40,195,99,96
050,17,023,"Illinois","Clark County",3,41,191,96,95
050,17,023,"Illinois","Clark County",3,42,189,95,94
050,17,023,"Illinois","Clark County",3,43,192,98,94
050,17,023,"Illinois","Clark County",3,44,170,89,81
050,17,023,"Illinois","Clark County",3,45,155,81,74
050,17,023,"Illinois","Clark County",3,46,169,92,77
050,17,023,"Illinois","Clark County",3,47,178,95,83
050,17,023,"Illinois","Clark County",3,48,168,84,84
050,17,023,"Illinois","Clark County",3,49,190,100,90
050,17,023,"Illinois","Clark County",3,50,211,116,95
050,17,023,"Illinois","Clark County",3,51,202,110,92
050,17,023,"Illinois","Clark County",3,52,197,105,92
050,17,023,"Illinois","Clark County",3,53,189,94,95
050,17,023,"Illinois","Clark County",3,54,194,91,103
050,17,023,"Illinois","Clark County",3,55,226,115,111
050,17,023,"Illinois","Clark County",3,56,233,119,114
050,17,023,"Illinois","Clark County",3,57,216,109,107
050,17,023,"Illinois","Clark County",3,58,236,123,113
050,17,023,"Illinois","Clark County",3,59,239,119,120
050,17,023,"Illinois","Clark County",3,60,251,119,132
050,17,023,"Illinois","Clark County",3,61,231,111,120
050,17,023,"Illinois","Clark County",3,62,223,118,105
050,17,023,"Illinois","Clark County",3,63,224,123,101
050,17,023,"Illinois","Clark County",3,64,222,118,104
050,17,023,"Illinois","Clark County",3,65,203,102,101
050,17,023,"Illinois","Clark County",3,66,195,103,92
050,17,023,"Illinois","Clark County",3,67,195,104,91
050,17,023,"Illinois","Clark County",3,68,190,103,87
050,17,023,"Illinois","Clark County",3,69,185,91,94
050,17,023,"Illinois","Clark County",3,70,182,90,92
050,17,023,"Illinois","Clark County",3,71,157,75,82
050,17,023,"Illinois","Clark County",3,72,160,74,86
050,17,023,"Illinois","Clark County",3,73,146,65,81
050,17,023,"Illinois","Clark County",3,74,150,63,87
050,17,023,"Illinois","Clark County",3,75,108,50,58
050,17,023,"Illinois","Clark County",3,76,113,49,64
050,17,023,"Illinois","Clark County",3,77,119,55,64
050,17,023,"Illinois","Clark County",3,78,113,53,60
050,17,023,"Illinois","Clark County",3,79,107,46,61
050,17,023,"Illinois","Clark County",3,80,90,40,50
050,17,023,"Illinois","Clark County",3,81,84,36,48
050,17,023,"Illinois","Clark County",3,82,76,40,36
050,17,023,"Illinois","Clark County",3,83,57,33,24
050,17,023,"Illinois","Clark County",3,84,58,25,33
050,17,023,"Illinois","Clark County",3,85,323,92,231
050,17,023,"Illinois","Clark County",4,0,122,63,59
050,17,023,"Illinois","Clark County",4,1,188,96,92
050,17,023,"Illinois","Clark County",4,2,180,84,96
050,17,023,"Illinois","Clark County",4,3,179,83,96
050,17,023,"Illinois","Clark County",4,4,186,92,94
050,17,023,"Illinois","Clark County",4,5,184,97,87
050,17,023,"Illinois","Clark County",4,6,178,94,84
050,17,023,"Illinois","Clark County",4,7,170,94,76
050,17,023,"Illinois","Clark County",4,8,209,118,91
050,17,023,"Illinois","Clark County",4,9,197,105,92
050,17,023,"Illinois","Clark County",4,10,193,103,90
050,17,023,"Illinois","Clark County",4,11,196,105,91
050,17,023,"Illinois","Clark County",4,12,193,90,103
050,17,023,"Illinois","Clark County",4,13,204,102,102
050,17,023,"Illinois","Clark County",4,14,198,99,99
050,17,023,"Illinois","Clark County",4,15,203,107,96
050,17,023,"Illinois","Clark County",4,16,204,103,101
050,17,023,"Illinois","Clark County",4,17,216,109,107
050,17,023,"Illinois","Clark County",4,18,151,77,74
050,17,023,"Illinois","Clark County",4,19,116,62,54
050,17,023,"Illinois","Clark County",4,20,134,79,55
050,17,023,"Illinois","Clark County",4,21,168,92,76
050,17,023,"Illinois","Clark County",4,22,175,85,90
050,17,023,"Illinois","Clark County",4,23,170,83,87
050,17,023,"Illinois","Clark County",4,24,166,76,90
050,17,023,"Illinois","Clark County",4,25,169,89,80
050,17,023,"Illinois","Clark County",4,26,176,94,82
050,17,023,"Illinois","Clark County",4,27,173,93,80
050,17,023,"Illinois","Clark County",4,28,173,96,77
050,17,023,"Illinois","Clark County",4,29,161,92,69
050,17,023,"Illinois","Clark County",4,30,180,99,81
050,17,023,"Illinois","Clark County",4,31,181,93,88
050,17,023,"Illinois","Clark County",4,32,165,75,90
050,17,023,"Illinois","Clark County",4,33,160,71,89
050,17,023,"Illinois","Clark County",4,34,183,95,88
050,17,023,"Illinois","Clark County",4,35,167,84,83
050,17,023,"Illinois","Clark County",4,36,185,99,86
050,17,023,"Illinois","Clark County",4,37,182,94,88
050,17,023,"Illinois","Clark County",4,38,188,98,90
050,17,023,"Illinois","Clark County",4,39,181,88,93
050,17,023,"Illinois","Clark County",4,40,193,96,97
050,17,023,"Illinois","Clark County",4,41,193,96,97
050,17,023,"Illinois","Clark County",4,42,185,96,89
050,17,023,"Illinois","Clark County",4,43,190,94,96
050,17,023,"Illinois","Clark County",4,44,193,101,92
050,17,023,"Illinois","Clark County",4,45,171,92,79
050,17,023,"Illinois","Clark County",4,46,160,83,77
050,17,023,"Illinois","Clark County",4,47,168,87,81
050,17,023,"Illinois","Clark County",4,48,174,90,84
050,17,023,"Illinois","Clark County",4,49,165,80,85
050,17,023,"Illinois","Clark County",4,50,190,101,89
050,17,023,"Illinois","Clark County",4,51,208,114,94
050,17,023,"Illinois","Clark County",4,52,196,105,91
050,17,023,"Illinois","Clark County",4,53,189,103,86
050,17,023,"Illinois","Clark County",4,54,189,95,94
050,17,023,"Illinois","Clark County",4,55,189,87,102
050,17,023,"Illinois","Clark County",4,56,220,109,111
050,17,023,"Illinois","Clark County",4,57,235,117,118
050,17,023,"Illinois","Clark County",4,58,209,108,101
050,17,023,"Illinois","Clark County",4,59,228,120,108
050,17,023,"Illinois","Clark County",4,60,245,122,123
050,17,023,"Illinois","Clark County",4,61,252,119,133
050,17,023,"Illinois","Clark County",4,62,226,109,117
050,17,023,"Illinois","Clark County",4,63,219,117,102
050,17,023,"Illinois","Clark County",4,64,228,128,100
050,17,023,"Illinois","Clark County",4,65,220,116,104
050,17,023,"Illinois","Clark County",4,66,193,98,95
050,17,023,"Illinois","Clark County",4,67,187,99,88
050,17,023,"Illinois","Clark County",4,68,191,98,93
050,17,023,"Illinois","Clark County",4,69,189,101,88
050,17,023,"Illinois","Clark County",4,70,179,92,87
050,17,023,"Illinois","Clark County",4,71,171,81,90
050,17,023,"Illinois","Clark County",4,72,151,71,80
050,17,023,"Illinois","Clark County",4,73,154,72,82
050,17,023,"Illinois","Clark County",4,74,146,63,83
050,17,023,"Illinois","Clark County",4,75,142,60,82
050,17,023,"Illinois","Clark County",4,76,100,45,55
050,17,023,"Illinois","Clark County",4,77,107,47,60
050,17,023,"Illinois","Clark County",4,78,109,50,59
050,17,023,"Illinois","Clark County",4,79,107,44,63
050,17,023,"Illinois","Clark County",4,80,100,42,58
050,17,023,"Illinois","Clark County",4,81,78,32,46
050,17,023,"Illinois","Clark County",4,82,74,31,43
050,17,023,"Illinois","Clark County",4,83,70,40,30
050,17,023,"Illinois","Clark County",4,84,51,27,24
050,17,023,"Illinois","Clark County",4,85,322,103,219
050,17,023,"Illinois","Clark County",5,0,86,44,42
050,17,023,"Illinois","Clark County",5,1,129,68,61
050,17,023,"Illinois","Clark County",5,2,189,96,93
050,17,023,"Illinois","Clark County",5,3,195,95,100
050,17,023,"Illinois","Clark County",5,4,181,86,95
050,17,023,"Illinois","Clark County",5,5,188,94,94
050,17,023,"Illinois","Clark County",5,6,183,95,88
050,17,023,"Illinois","Clark County",5,7,178,92,86
050,17,023,"Illinois","Clark County",5,8,176,94,82
050,17,023,"Illinois","Clark County",5,9,210,115,95
050,17,023,"Illinois","Clark County",5,10,202,112,90
050,17,023,"Illinois","Clark County",5,11,198,112,86
050,17,023,"Illinois","Clark County",5,12,200,105,95
050,17,023,"Illinois","Clark County",5,13,204,94,110
050,17,023,"Illinois","Clark County",5,14,204,99,105
050,17,023,"Illinois","Clark County",5,15,196,99,97
050,17,023,"Illinois","Clark County",5,16,196,104,92
050,17,023,"Illinois","Clark County",5,17,202,100,102
050,17,023,"Illinois","Clark County",5,18,178,92,86
050,17,023,"Illinois","Clark County",5,19,109,56,53
050,17,023,"Illinois","Clark County",5,20,134,76,58
050,17,023,"Illinois","Clark County",5,21,142,81,61
050,17,023,"Illinois","Clark County",5,22,179,97,82
050,17,023,"Illinois","Clark County",5,23,174,91,83
050,17,023,"Illinois","Clark County",5,24,160,83,77
050,17,023,"Illinois","Clark County",5,25,165,79,86
050,17,023,"Illinois","Clark County",5,26,176,96,80
050,17,023,"Illinois","Clark County",5,27,179,93,86
050,17,023,"Illinois","Clark County",5,28,165,84,81
050,17,023,"Illinois","Clark County",5,29,170,93,77
050,17,023,"Illinois","Clark County",5,30,167,98,69
050,17,023,"Illinois","Clark County",5,31,185,103,82
050,17,023,"Illinois","Clark County",5,32,177,91,86
050,17,023,"Illinois","Clark County",5,33,163,79,84
050,17,023,"Illinois","Clark County",5,34,161,74,87
050,17,023,"Illinois","Clark County",5,35,176,90,86
050,17,023,"Illinois","Clark County",5,36,165,87,78
050,17,023,"Illinois","Clark County",5,37,185,94,91
050,17,023,"Illinois","Clark County",5,38,185,95,90
050,17,023,"Illinois","Clark County",5,39,195,101,94
050,17,023,"Illinois","Clark County",5,40,183,92,91
050,17,023,"Illinois","Clark County",5,41,195,96,99
050,17,023,"Illinois","Clark County",5,42,192,94,98
050,17,023,"Illinois","Clark County",5,43,191,99,92
050,17,023,"Illinois","Clark County",5,44,196,96,100
050,17,023,"Illinois","Clark County",5,45,193,104,89
050,17,023,"Illinois","Clark County",5,46,173,92,81
050,17,023,"Illinois","Clark County",5,47,163,81,82
050,17,023,"Illinois","Clark County",5,48,163,87,76
050,17,023,"Illinois","Clark County",5,49,178,96,82
050,17,023,"Illinois","Clark County",5,50,165,79,86
050,17,023,"Illinois","Clark County",5,51,187,98,89
050,17,023,"Illinois","Clark County",5,52,213,118,95
050,17,023,"Illinois","Clark County",5,53,190,101,89
050,17,023,"Illinois","Clark County",5,54,188,101,87
050,17,023,"Illinois","Clark County",5,55,192,95,97
050,17,023,"Illinois","Clark County",5,56,182,83,99
050,17,023,"Illinois","Clark County",5,57,220,111,109
050,17,023,"Illinois","Clark County",5,58,231,116,115
050,17,023,"Illinois","Clark County",5,59,207,106,101
050,17,023,"Illinois","Clark County",5,60,224,117,107
050,17,023,"Illinois","Clark County",5,61,243,120,123
050,17,023,"Illinois","Clark County",5,62,249,117,132
050,17,023,"Illinois","Clark County",5,63,227,114,113
050,17,023,"Illinois","Clark County",5,64,219,118,101
050,17,023,"Illinois","Clark County",5,65,221,123,98
050,17,023,"Illinois","Clark County",5,66,222,117,105
050,17,023,"Illinois","Clark County",5,67,193,96,97
050,17,023,"Illinois","Clark County",5,68,186,99,87
050,17,023,"Illinois","Clark County",5,69,192,98,94
050,17,023,"Illinois","Clark County",5,70,185,99,86
050,17,023,"Illinois","Clark County",5,71,169,82,87
050,17,023,"Illinois","Clark County",5,72,166,77,89
050,17,023,"Illinois","Clark County",5,73,145,68,77
050,17,023,"Illinois","Clark County",5,74,151,70,81
050,17,023,"Illinois","Clark County",5,75,143,64,79
050,17,023,"Illinois","Clark County",5,76,135,52,83
050,17,023,"Illinois","Clark County",5,77,96,45,51
050,17,023,"Illinois","Clark County",5,78,97,42,55
050,17,023,"Illinois","Clark County",5,79,100,42,58
050,17,023,"Illinois","Clark County",5,80,103,42,61
050,17,023,"Illinois","Clark County",5,81,89,36,53
050,17,023,"Illinois","Clark County",5,82,68,26,42
050,17,023,"Illinois","Clark County",5,83,64,28,36
050,17,023,"Illinois","Clark County",5,84,64,35,29
050,17,023,"Illinois","Clark County",5,85,328,117,211
050,17,025,"Illinois","Clay County",1,0,150,77,73
050,17,025,"Illinois","Clay County",1,1,136,64,72
050,17,025,"Illinois","Clay County",1,2,178,92,86
050,17,025,"Illinois","Clay County",1,3,158,80,78
050,17,025,"Illinois","Clay County",1,4,175,91,84
050,17,025,"Illinois","Clay County",1,5,171,96,75
050,17,025,"Illinois","Clay County",1,6,151,83,68
050,17,025,"Illinois","Clay County",1,7,178,95,83
050,17,025,"Illinois","Clay County",1,8,165,78,87
050,17,025,"Illinois","Clay County",1,9,176,85,91
050,17,025,"Illinois","Clay County",1,10,183,87,96
050,17,025,"Illinois","Clay County",1,11,177,87,90
050,17,025,"Illinois","Clay County",1,12,180,90,90
050,17,025,"Illinois","Clay County",1,13,173,89,84
050,17,025,"Illinois","Clay County",1,14,190,96,94
050,17,025,"Illinois","Clay County",1,15,182,91,91
050,17,025,"Illinois","Clay County",1,16,183,92,91
050,17,025,"Illinois","Clay County",1,17,168,89,79
050,17,025,"Illinois","Clay County",1,18,151,81,70
050,17,025,"Illinois","Clay County",1,19,113,52,61
050,17,025,"Illinois","Clay County",1,20,123,63,60
050,17,025,"Illinois","Clay County",1,21,133,70,63
050,17,025,"Illinois","Clay County",1,22,135,66,69
050,17,025,"Illinois","Clay County",1,23,136,63,73
050,17,025,"Illinois","Clay County",1,24,155,74,81
050,17,025,"Illinois","Clay County",1,25,143,76,67
050,17,025,"Illinois","Clay County",1,26,150,87,63
050,17,025,"Illinois","Clay County",1,27,171,93,78
050,17,025,"Illinois","Clay County",1,28,175,88,87
050,17,025,"Illinois","Clay County",1,29,178,88,90
050,17,025,"Illinois","Clay County",1,30,166,76,90
050,17,025,"Illinois","Clay County",1,31,139,72,67
050,17,025,"Illinois","Clay County",1,32,140,67,73
050,17,025,"Illinois","Clay County",1,33,136,70,66
050,17,025,"Illinois","Clay County",1,34,144,71,73
050,17,025,"Illinois","Clay County",1,35,141,68,73
050,17,025,"Illinois","Clay County",1,36,160,80,80
050,17,025,"Illinois","Clay County",1,37,155,83,72
050,17,025,"Illinois","Clay County",1,38,168,89,79
050,17,025,"Illinois","Clay County",1,39,157,76,81
050,17,025,"Illinois","Clay County",1,40,154,76,78
050,17,025,"Illinois","Clay County",1,41,157,89,68
050,17,025,"Illinois","Clay County",1,42,148,84,64
050,17,025,"Illinois","Clay County",1,43,138,63,75
050,17,025,"Illinois","Clay County",1,44,133,61,72
050,17,025,"Illinois","Clay County",1,45,150,73,77
050,17,025,"Illinois","Clay County",1,46,146,72,74
050,17,025,"Illinois","Clay County",1,47,152,76,76
050,17,025,"Illinois","Clay County",1,48,157,83,74
050,17,025,"Illinois","Clay County",1,49,176,95,81
050,17,025,"Illinois","Clay County",1,50,168,99,69
050,17,025,"Illinois","Clay County",1,51,153,83,70
050,17,025,"Illinois","Clay County",1,52,169,87,82
050,17,025,"Illinois","Clay County",1,53,181,93,88
050,17,025,"Illinois","Clay County",1,54,167,81,86
050,17,025,"Illinois","Clay County",1,55,165,81,84
050,17,025,"Illinois","Clay County",1,56,186,95,91
050,17,025,"Illinois","Clay County",1,57,202,104,98
050,17,025,"Illinois","Clay County",1,58,203,99,104
050,17,025,"Illinois","Clay County",1,59,198,91,107
050,17,025,"Illinois","Clay County",1,60,183,92,91
050,17,025,"Illinois","Clay County",1,61,200,108,92
050,17,025,"Illinois","Clay County",1,62,196,97,99
050,17,025,"Illinois","Clay County",1,63,182,87,95
050,17,025,"Illinois","Clay County",1,64,182,87,95
050,17,025,"Illinois","Clay County",1,65,175,84,91
050,17,025,"Illinois","Clay County",1,66,178,91,87
050,17,025,"Illinois","Clay County",1,67,184,89,95
050,17,025,"Illinois","Clay County",1,68,174,88,86
050,17,025,"Illinois","Clay County",1,69,160,84,76
050,17,025,"Illinois","Clay County",1,70,147,74,73
050,17,025,"Illinois","Clay County",1,71,151,78,73
050,17,025,"Illinois","Clay County",1,72,156,77,79
050,17,025,"Illinois","Clay County",1,73,159,82,77
050,17,025,"Illinois","Clay County",1,74,101,47,54
050,17,025,"Illinois","Clay County",1,75,108,48,60
050,17,025,"Illinois","Clay County",1,76,112,48,64
050,17,025,"Illinois","Clay County",1,77,99,38,61
050,17,025,"Illinois","Clay County",1,78,86,42,44
050,17,025,"Illinois","Clay County",1,79,76,35,41
050,17,025,"Illinois","Clay County",1,80,71,30,41
050,17,025,"Illinois","Clay County",1,81,70,27,43
050,17,025,"Illinois","Clay County",1,82,68,24,44
050,17,025,"Illinois","Clay County",1,83,56,21,35
050,17,025,"Illinois","Clay County",1,84,51,21,30
050,17,025,"Illinois","Clay County",1,85,318,106,212
050,17,025,"Illinois","Clay County",2,0,144,77,67
050,17,025,"Illinois","Clay County",2,1,139,66,73
050,17,025,"Illinois","Clay County",2,2,169,85,84
050,17,025,"Illinois","Clay County",2,3,163,84,79
050,17,025,"Illinois","Clay County",2,4,174,90,84
050,17,025,"Illinois","Clay County",2,5,170,93,77
050,17,025,"Illinois","Clay County",2,6,158,88,70
050,17,025,"Illinois","Clay County",2,7,171,91,80
050,17,025,"Illinois","Clay County",2,8,166,81,85
050,17,025,"Illinois","Clay County",2,9,173,83,90
050,17,025,"Illinois","Clay County",2,10,183,86,97
050,17,025,"Illinois","Clay County",2,11,177,87,90
050,17,025,"Illinois","Clay County",2,12,179,90,89
050,17,025,"Illinois","Clay County",2,13,175,89,86
050,17,025,"Illinois","Clay County",2,14,185,94,91
050,17,025,"Illinois","Clay County",2,15,184,92,92
050,17,025,"Illinois","Clay County",2,16,185,92,93
050,17,025,"Illinois","Clay County",2,17,172,91,81
050,17,025,"Illinois","Clay County",2,18,146,78,68
050,17,025,"Illinois","Clay County",2,19,114,56,58
050,17,025,"Illinois","Clay County",2,20,125,63,62
050,17,025,"Illinois","Clay County",2,21,132,69,63
050,17,025,"Illinois","Clay County",2,22,136,67,69
050,17,025,"Illinois","Clay County",2,23,139,64,75
050,17,025,"Illinois","Clay County",2,24,150,72,78
050,17,025,"Illinois","Clay County",2,25,145,76,69
050,17,025,"Illinois","Clay County",2,26,149,85,64
050,17,025,"Illinois","Clay County",2,27,169,93,76
050,17,025,"Illinois","Clay County",2,28,176,90,86
050,17,025,"Illinois","Clay County",2,29,177,87,90
050,17,025,"Illinois","Clay County",2,30,169,78,91
050,17,025,"Illinois","Clay County",2,31,146,72,74
050,17,025,"Illinois","Clay County",2,32,139,68,71
050,17,025,"Illinois","Clay County",2,33,137,70,67
050,17,025,"Illinois","Clay County",2,34,142,70,72
050,17,025,"Illinois","Clay County",2,35,143,69,74
050,17,025,"Illinois","Clay County",2,36,153,76,77
050,17,025,"Illinois","Clay County",2,37,156,82,74
050,17,025,"Illinois","Clay County",2,38,163,87,76
050,17,025,"Illinois","Clay County",2,39,159,78,81
050,17,025,"Illinois","Clay County",2,40,158,78,80
050,17,025,"Illinois","Clay County",2,41,156,86,70
050,17,025,"Illinois","Clay County",2,42,148,83,65
050,17,025,"Illinois","Clay County",2,43,140,68,72
050,17,025,"Illinois","Clay County",2,44,133,61,72
050,17,025,"Illinois","Clay County",2,45,147,71,76
050,17,025,"Illinois","Clay County",2,46,145,72,73
050,17,025,"Illinois","Clay County",2,47,151,75,76
050,17,025,"Illinois","Clay County",2,48,155,82,73
050,17,025,"Illinois","Clay County",2,49,171,92,79
050,17,025,"Illinois","Clay County",2,50,172,99,73
050,17,025,"Illinois","Clay County",2,51,155,86,69
050,17,025,"Illinois","Clay County",2,52,166,87,79
050,17,025,"Illinois","Clay County",2,53,176,91,85
050,17,025,"Illinois","Clay County",2,54,170,85,85
050,17,025,"Illinois","Clay County",2,55,166,81,85
050,17,025,"Illinois","Clay County",2,56,181,91,90
050,17,025,"Illinois","Clay County",2,57,199,103,96
050,17,025,"Illinois","Clay County",2,58,202,99,103
050,17,025,"Illinois","Clay County",2,59,199,93,106
050,17,025,"Illinois","Clay County",2,60,184,91,93
050,17,025,"Illinois","Clay County",2,61,195,104,91
050,17,025,"Illinois","Clay County",2,62,197,100,97
050,17,025,"Illinois","Clay County",2,63,185,89,96
050,17,025,"Illinois","Clay County",2,64,179,85,94
050,17,025,"Illinois","Clay County",2,65,176,85,91
050,17,025,"Illinois","Clay County",2,66,178,89,89
050,17,025,"Illinois","Clay County",2,67,182,89,93
050,17,025,"Illinois","Clay County",2,68,175,88,87
050,17,025,"Illinois","Clay County",2,69,164,84,80
050,17,025,"Illinois","Clay County",2,70,150,77,73
050,17,025,"Illinois","Clay County",2,71,148,76,72
050,17,025,"Illinois","Clay County",2,72,153,77,76
050,17,025,"Illinois","Clay County",2,73,164,83,81
050,17,025,"Illinois","Clay County",2,74,106,51,55
050,17,025,"Illinois","Clay County",2,75,106,47,59
050,17,025,"Illinois","Clay County",2,76,107,46,61
050,17,025,"Illinois","Clay County",2,77,102,40,62
050,17,025,"Illinois","Clay County",2,78,86,39,47
050,17,025,"Illinois","Clay County",2,79,75,36,39
050,17,025,"Illinois","Clay County",2,80,73,31,42
050,17,025,"Illinois","Clay County",2,81,67,25,42
050,17,025,"Illinois","Clay County",2,82,69,25,44
050,17,025,"Illinois","Clay County",2,83,58,21,37
050,17,025,"Illinois","Clay County",2,84,52,20,32
050,17,025,"Illinois","Clay County",2,85,320,107,213
050,17,025,"Illinois","Clay County",3,0,167,96,71
050,17,025,"Illinois","Clay County",3,1,150,79,71
050,17,025,"Illinois","Clay County",3,2,138,70,68
050,17,025,"Illinois","Clay County",3,3,162,85,77
050,17,025,"Illinois","Clay County",3,4,154,79,75
050,17,025,"Illinois","Clay County",3,5,169,86,83
050,17,025,"Illinois","Clay County",3,6,165,90,75
050,17,025,"Illinois","Clay County",3,7,154,85,69
050,17,025,"Illinois","Clay County",3,8,175,93,82
050,17,025,"Illinois","Clay County",3,9,171,84,87
050,17,025,"Illinois","Clay County",3,10,172,80,92
050,17,025,"Illinois","Clay County",3,11,186,91,95
050,17,025,"Illinois","Clay County",3,12,171,85,86
050,17,025,"Illinois","Clay County",3,13,173,88,85
050,17,025,"Illinois","Clay County",3,14,175,86,89
050,17,025,"Illinois","Clay County",3,15,188,96,92
050,17,025,"Illinois","Clay County",3,16,183,94,89
050,17,025,"Illinois","Clay County",3,17,177,87,90
050,17,025,"Illinois","Clay County",3,18,147,78,69
050,17,025,"Illinois","Clay County",3,19,113,60,53
050,17,025,"Illinois","Clay County",3,20,119,62,57
050,17,025,"Illinois","Clay County",3,21,133,66,67
050,17,025,"Illinois","Clay County",3,22,134,69,65
050,17,025,"Illinois","Clay County",3,23,149,74,75
050,17,025,"Illinois","Clay County",3,24,135,63,72
050,17,025,"Illinois","Clay County",3,25,143,73,70
050,17,025,"Illinois","Clay County",3,26,137,72,65
050,17,025,"Illinois","Clay County",3,27,152,91,61
050,17,025,"Illinois","Clay County",3,28,169,90,79
050,17,025,"Illinois","Clay County",3,29,173,89,84
050,17,025,"Illinois","Clay County",3,30,177,83,94
050,17,025,"Illinois","Clay County",3,31,173,82,91
050,17,025,"Illinois","Clay County",3,32,143,68,75
050,17,025,"Illinois","Clay County",3,33,142,72,70
050,17,025,"Illinois","Clay County",3,34,139,74,65
050,17,025,"Illinois","Clay County",3,35,134,62,72
050,17,025,"Illinois","Clay County",3,36,143,70,73
050,17,025,"Illinois","Clay County",3,37,154,76,78
050,17,025,"Illinois","Clay County",3,38,159,82,77
050,17,025,"Illinois","Clay County",3,39,156,81,75
050,17,025,"Illinois","Clay County",3,40,161,75,86
050,17,025,"Illinois","Clay County",3,41,159,80,79
050,17,025,"Illinois","Clay County",3,42,156,84,72
050,17,025,"Illinois","Clay County",3,43,150,83,67
050,17,025,"Illinois","Clay County",3,44,141,71,70
050,17,025,"Illinois","Clay County",3,45,130,61,69
050,17,025,"Illinois","Clay County",3,46,144,72,72
050,17,025,"Illinois","Clay County",3,47,152,73,79
050,17,025,"Illinois","Clay County",3,48,153,79,74
050,17,025,"Illinois","Clay County",3,49,154,81,73
050,17,025,"Illinois","Clay County",3,50,174,95,79
050,17,025,"Illinois","Clay County",3,51,174,103,71
050,17,025,"Illinois","Clay County",3,52,160,92,68
050,17,025,"Illinois","Clay County",3,53,163,85,78
050,17,025,"Illinois","Clay County",3,54,176,94,82
050,17,025,"Illinois","Clay County",3,55,164,81,83
050,17,025,"Illinois","Clay County",3,56,163,76,87
050,17,025,"Illinois","Clay County",3,57,173,84,89
050,17,025,"Illinois","Clay County",3,58,194,104,90
050,17,025,"Illinois","Clay County",3,59,202,99,103
050,17,025,"Illinois","Clay County",3,60,187,88,99
050,17,025,"Illinois","Clay County",3,61,189,96,93
050,17,025,"Illinois","Clay County",3,62,187,100,87
050,17,025,"Illinois","Clay County",3,63,194,101,93
050,17,025,"Illinois","Clay County",3,64,183,83,100
050,17,025,"Illinois","Clay County",3,65,171,86,85
050,17,025,"Illinois","Clay County",3,66,163,77,86
050,17,025,"Illinois","Clay County",3,67,175,84,91
050,17,025,"Illinois","Clay County",3,68,178,87,91
050,17,025,"Illinois","Clay County",3,69,167,81,86
050,17,025,"Illinois","Clay County",3,70,155,76,79
050,17,025,"Illinois","Clay County",3,71,146,74,72
050,17,025,"Illinois","Clay County",3,72,147,75,72
050,17,025,"Illinois","Clay County",3,73,148,78,70
050,17,025,"Illinois","Clay County",3,74,158,82,76
050,17,025,"Illinois","Clay County",3,75,101,46,55
050,17,025,"Illinois","Clay County",3,76,105,47,58
050,17,025,"Illinois","Clay County",3,77,95,42,53
050,17,025,"Illinois","Clay County",3,78,93,34,59
050,17,025,"Illinois","Clay County",3,79,75,32,43
050,17,025,"Illinois","Clay County",3,80,75,31,44
050,17,025,"Illinois","Clay County",3,81,70,31,39
050,17,025,"Illinois","Clay County",3,82,67,25,42
050,17,025,"Illinois","Clay County",3,83,64,23,41
050,17,025,"Illinois","Clay County",3,84,53,17,36
050,17,025,"Illinois","Clay County",3,85,320,111,209
050,17,025,"Illinois","Clay County",4,0,170,93,77
050,17,025,"Illinois","Clay County",4,1,175,97,78
050,17,025,"Illinois","Clay County",4,2,146,76,70
050,17,025,"Illinois","Clay County",4,3,139,73,66
050,17,025,"Illinois","Clay County",4,4,156,82,74
050,17,025,"Illinois","Clay County",4,5,154,78,76
050,17,025,"Illinois","Clay County",4,6,165,86,79
050,17,025,"Illinois","Clay County",4,7,162,87,75
050,17,025,"Illinois","Clay County",4,8,151,83,68
050,17,025,"Illinois","Clay County",4,9,170,90,80
050,17,025,"Illinois","Clay County",4,10,173,86,87
050,17,025,"Illinois","Clay County",4,11,174,85,89
050,17,025,"Illinois","Clay County",4,12,182,87,95
050,17,025,"Illinois","Clay County",4,13,174,92,82
050,17,025,"Illinois","Clay County",4,14,174,88,86
050,17,025,"Illinois","Clay County",4,15,175,86,89
050,17,025,"Illinois","Clay County",4,16,199,95,104
050,17,025,"Illinois","Clay County",4,17,183,93,90
050,17,025,"Illinois","Clay County",4,18,152,78,74
050,17,025,"Illinois","Clay County",4,19,115,62,53
050,17,025,"Illinois","Clay County",4,20,126,66,60
050,17,025,"Illinois","Clay County",4,21,122,61,61
050,17,025,"Illinois","Clay County",4,22,137,62,75
050,17,025,"Illinois","Clay County",4,23,137,73,64
050,17,025,"Illinois","Clay County",4,24,138,68,70
050,17,025,"Illinois","Clay County",4,25,135,70,65
050,17,025,"Illinois","Clay County",4,26,140,70,70
050,17,025,"Illinois","Clay County",4,27,141,76,65
050,17,025,"Illinois","Clay County",4,28,154,90,64
050,17,025,"Illinois","Clay County",4,29,159,86,73
050,17,025,"Illinois","Clay County",4,30,169,90,79
050,17,025,"Illinois","Clay County",4,31,179,85,94
050,17,025,"Illinois","Clay County",4,32,167,80,87
050,17,025,"Illinois","Clay County",4,33,141,70,71
050,17,025,"Illinois","Clay County",4,34,132,64,68
050,17,025,"Illinois","Clay County",4,35,132,68,64
050,17,025,"Illinois","Clay County",4,36,134,65,69
050,17,025,"Illinois","Clay County",4,37,144,70,74
050,17,025,"Illinois","Clay County",4,38,150,76,74
050,17,025,"Illinois","Clay County",4,39,157,80,77
050,17,025,"Illinois","Clay County",4,40,157,82,75
050,17,025,"Illinois","Clay County",4,41,164,79,85
050,17,025,"Illinois","Clay County",4,42,157,77,80
050,17,025,"Illinois","Clay County",4,43,160,85,75
050,17,025,"Illinois","Clay County",4,44,145,85,60
050,17,025,"Illinois","Clay County",4,45,131,68,63
050,17,025,"Illinois","Clay County",4,46,136,64,72
050,17,025,"Illinois","Clay County",4,47,152,76,76
050,17,025,"Illinois","Clay County",4,48,149,71,78
050,17,025,"Illinois","Clay County",4,49,157,79,78
050,17,025,"Illinois","Clay County",4,50,156,82,74
050,17,025,"Illinois","Clay County",4,51,180,97,83
050,17,025,"Illinois","Clay County",4,52,175,101,74
050,17,025,"Illinois","Clay County",4,53,156,87,69
050,17,025,"Illinois","Clay County",4,54,171,92,79
050,17,025,"Illinois","Clay County",4,55,173,93,80
050,17,025,"Illinois","Clay County",4,56,155,77,78
050,17,025,"Illinois","Clay County",4,57,165,80,85
050,17,025,"Illinois","Clay County",4,58,166,79,87
050,17,025,"Illinois","Clay County",4,59,196,104,92
050,17,025,"Illinois","Clay County",4,60,188,94,94
050,17,025,"Illinois","Clay County",4,61,189,92,97
050,17,025,"Illinois","Clay County",4,62,184,92,92
050,17,025,"Illinois","Clay County",4,63,183,97,86
050,17,025,"Illinois","Clay County",4,64,189,93,96
050,17,025,"Illinois","Clay County",4,65,178,84,94
050,17,025,"Illinois","Clay County",4,66,164,77,87
050,17,025,"Illinois","Clay County",4,67,159,75,84
050,17,025,"Illinois","Clay County",4,68,175,83,92
050,17,025,"Illinois","Clay County",4,69,171,80,91
050,17,025,"Illinois","Clay County",4,70,162,79,83
050,17,025,"Illinois","Clay County",4,71,159,75,84
050,17,025,"Illinois","Clay County",4,72,143,72,71
050,17,025,"Illinois","Clay County",4,73,141,71,70
050,17,025,"Illinois","Clay County",4,74,140,73,67
050,17,025,"Illinois","Clay County",4,75,152,79,73
050,17,025,"Illinois","Clay County",4,76,98,46,52
050,17,025,"Illinois","Clay County",4,77,95,42,53
050,17,025,"Illinois","Clay County",4,78,92,40,52
050,17,025,"Illinois","Clay County",4,79,91,33,58
050,17,025,"Illinois","Clay County",4,80,69,23,46
050,17,025,"Illinois","Clay County",4,81,67,30,37
050,17,025,"Illinois","Clay County",4,82,64,27,37
050,17,025,"Illinois","Clay County",4,83,59,23,36
050,17,025,"Illinois","Clay County",4,84,57,17,40
050,17,025,"Illinois","Clay County",4,85,324,113,211
050,17,025,"Illinois","Clay County",5,0,163,91,72
050,17,025,"Illinois","Clay County",5,1,162,83,79
050,17,025,"Illinois","Clay County",5,2,175,95,80
050,17,025,"Illinois","Clay County",5,3,142,75,67
050,17,025,"Illinois","Clay County",5,4,139,69,70
050,17,025,"Illinois","Clay County",5,5,158,80,78
050,17,025,"Illinois","Clay County",5,6,149,76,73
050,17,025,"Illinois","Clay County",5,7,159,81,78
050,17,025,"Illinois","Clay County",5,8,166,87,79
050,17,025,"Illinois","Clay County",5,9,158,87,71
050,17,025,"Illinois","Clay County",5,10,173,89,84
050,17,025,"Illinois","Clay County",5,11,180,88,92
050,17,025,"Illinois","Clay County",5,12,163,80,83
050,17,025,"Illinois","Clay County",5,13,187,92,95
050,17,025,"Illinois","Clay County",5,14,171,92,79
050,17,025,"Illinois","Clay County",5,15,178,89,89
050,17,025,"Illinois","Clay County",5,16,177,81,96
050,17,025,"Illinois","Clay County",5,17,193,98,95
050,17,025,"Illinois","Clay County",5,18,153,80,73
050,17,025,"Illinois","Clay County",5,19,113,55,58
050,17,025,"Illinois","Clay County",5,20,126,70,56
050,17,025,"Illinois","Clay County",5,21,132,70,62
050,17,025,"Illinois","Clay County",5,22,122,63,59
050,17,025,"Illinois","Clay County",5,23,140,62,78
050,17,025,"Illinois","Clay County",5,24,140,72,68
050,17,025,"Illinois","Clay County",5,25,136,65,71
050,17,025,"Illinois","Clay County",5,26,128,63,65
050,17,025,"Illinois","Clay County",5,27,131,67,64
050,17,025,"Illinois","Clay County",5,28,142,80,62
050,17,025,"Illinois","Clay County",5,29,144,78,66
050,17,025,"Illinois","Clay County",5,30,161,86,75
050,17,025,"Illinois","Clay County",5,31,176,93,83
050,17,025,"Illinois","Clay County",5,32,176,80,96
050,17,025,"Illinois","Clay County",5,33,169,81,88
050,17,025,"Illinois","Clay County",5,34,139,66,73
050,17,025,"Illinois","Clay County",5,35,133,64,69
050,17,025,"Illinois","Clay County",5,36,131,70,61
050,17,025,"Illinois","Clay County",5,37,132,63,69
050,17,025,"Illinois","Clay County",5,38,147,70,77
050,17,025,"Illinois","Clay County",5,39,147,73,74
050,17,025,"Illinois","Clay County",5,40,166,81,85
050,17,025,"Illinois","Clay County",5,41,151,78,73
050,17,025,"Illinois","Clay County",5,42,167,78,89
050,17,025,"Illinois","Clay County",5,43,158,79,79
050,17,025,"Illinois","Clay County",5,44,163,87,76
050,17,025,"Illinois","Clay County",5,45,143,84,59
050,17,025,"Illinois","Clay County",5,46,138,69,69
050,17,025,"Illinois","Clay County",5,47,142,67,75
050,17,025,"Illinois","Clay County",5,48,146,77,69
050,17,025,"Illinois","Clay County",5,49,148,70,78
050,17,025,"Illinois","Clay County",5,50,160,81,79
050,17,025,"Illinois","Clay County",5,51,161,83,78
050,17,025,"Illinois","Clay County",5,52,179,97,82
050,17,025,"Illinois","Clay County",5,53,180,104,76
050,17,025,"Illinois","Clay County",5,54,155,91,64
050,17,025,"Illinois","Clay County",5,55,167,89,78
050,17,025,"Illinois","Clay County",5,56,170,91,79
050,17,025,"Illinois","Clay County",5,57,155,77,78
050,17,025,"Illinois","Clay County",5,58,158,77,81
050,17,025,"Illinois","Clay County",5,59,167,78,89
050,17,025,"Illinois","Clay County",5,60,188,100,88
050,17,025,"Illinois","Clay County",5,61,190,93,97
050,17,025,"Illinois","Clay County",5,62,181,86,95
050,17,025,"Illinois","Clay County",5,63,176,88,88
050,17,025,"Illinois","Clay County",5,64,175,87,88
050,17,025,"Illinois","Clay County",5,65,182,93,89
050,17,025,"Illinois","Clay County",5,66,172,78,94
050,17,025,"Illinois","Clay County",5,67,161,76,85
050,17,025,"Illinois","Clay County",5,68,156,73,83
050,17,025,"Illinois","Clay County",5,69,168,75,93
050,17,025,"Illinois","Clay County",5,70,167,78,89
050,17,025,"Illinois","Clay County",5,71,161,77,84
050,17,025,"Illinois","Clay County",5,72,155,72,83
050,17,025,"Illinois","Clay County",5,73,139,68,71
050,17,025,"Illinois","Clay County",5,74,135,68,67
050,17,025,"Illinois","Clay County",5,75,132,67,65
050,17,025,"Illinois","Clay County",5,76,155,81,74
050,17,025,"Illinois","Clay County",5,77,93,44,49
050,17,025,"Illinois","Clay County",5,78,93,40,53
050,17,025,"Illinois","Clay County",5,79,85,36,49
050,17,025,"Illinois","Clay County",5,80,85,25,60
050,17,025,"Illinois","Clay County",5,81,59,22,37
050,17,025,"Illinois","Clay County",5,82,62,26,36
050,17,025,"Illinois","Clay County",5,83,56,24,32
050,17,025,"Illinois","Clay County",5,84,52,16,36
050,17,025,"Illinois","Clay County",5,85,336,116,220
050,17,027,"Illinois","Clinton County",1,0,383,193,190
050,17,027,"Illinois","Clinton County",1,1,419,204,215
050,17,027,"Illinois","Clinton County",1,2,432,230,202
050,17,027,"Illinois","Clinton County",1,3,435,235,200
050,17,027,"Illinois","Clinton County",1,4,450,234,216
050,17,027,"Illinois","Clinton County",1,5,472,229,243
050,17,027,"Illinois","Clinton County",1,6,433,235,198
050,17,027,"Illinois","Clinton County",1,7,426,217,209
050,17,027,"Illinois","Clinton County",1,8,444,227,217
050,17,027,"Illinois","Clinton County",1,9,408,217,191
050,17,027,"Illinois","Clinton County",1,10,434,218,216
050,17,027,"Illinois","Clinton County",1,11,462,235,227
050,17,027,"Illinois","Clinton County",1,12,472,241,231
050,17,027,"Illinois","Clinton County",1,13,479,254,225
050,17,027,"Illinois","Clinton County",1,14,469,249,220
050,17,027,"Illinois","Clinton County",1,15,456,240,216
050,17,027,"Illinois","Clinton County",1,16,470,252,218
050,17,027,"Illinois","Clinton County",1,17,473,241,232
050,17,027,"Illinois","Clinton County",1,18,406,204,202
050,17,027,"Illinois","Clinton County",1,19,330,182,148
050,17,027,"Illinois","Clinton County",1,20,373,212,161
050,17,027,"Illinois","Clinton County",1,21,389,219,170
050,17,027,"Illinois","Clinton County",1,22,396,213,183
050,17,027,"Illinois","Clinton County",1,23,399,225,174
050,17,027,"Illinois","Clinton County",1,24,403,229,174
050,17,027,"Illinois","Clinton County",1,25,461,265,196
050,17,027,"Illinois","Clinton County",1,26,454,251,203
050,17,027,"Illinois","Clinton County",1,27,464,251,213
050,17,027,"Illinois","Clinton County",1,28,489,257,232
050,17,027,"Illinois","Clinton County",1,29,449,222,227
050,17,027,"Illinois","Clinton County",1,30,451,245,206
050,17,027,"Illinois","Clinton County",1,31,469,254,215
050,17,027,"Illinois","Clinton County",1,32,496,267,229
050,17,027,"Illinois","Clinton County",1,33,480,269,211
050,17,027,"Illinois","Clinton County",1,34,503,268,235
050,17,027,"Illinois","Clinton County",1,35,537,290,247
050,17,027,"Illinois","Clinton County",1,36,525,296,229
050,17,027,"Illinois","Clinton County",1,37,516,291,225
050,17,027,"Illinois","Clinton County",1,38,504,278,226
050,17,027,"Illinois","Clinton County",1,39,488,276,212
050,17,027,"Illinois","Clinton County",1,40,493,272,221
050,17,027,"Illinois","Clinton County",1,41,477,266,211
050,17,027,"Illinois","Clinton County",1,42,483,273,210
050,17,027,"Illinois","Clinton County",1,43,442,247,195
050,17,027,"Illinois","Clinton County",1,44,410,227,183
050,17,027,"Illinois","Clinton County",1,45,428,229,199
050,17,027,"Illinois","Clinton County",1,46,427,223,204
050,17,027,"Illinois","Clinton County",1,47,433,225,208
050,17,027,"Illinois","Clinton County",1,48,443,228,215
050,17,027,"Illinois","Clinton County",1,49,460,248,212
050,17,027,"Illinois","Clinton County",1,50,463,233,230
050,17,027,"Illinois","Clinton County",1,51,484,255,229
050,17,027,"Illinois","Clinton County",1,52,501,274,227
050,17,027,"Illinois","Clinton County",1,53,502,269,233
050,17,027,"Illinois","Clinton County",1,54,529,267,262
050,17,027,"Illinois","Clinton County",1,55,542,263,279
050,17,027,"Illinois","Clinton County",1,56,563,295,268
050,17,027,"Illinois","Clinton County",1,57,553,272,281
050,17,027,"Illinois","Clinton County",1,58,589,294,295
050,17,027,"Illinois","Clinton County",1,59,594,308,286
050,17,027,"Illinois","Clinton County",1,60,570,288,282
050,17,027,"Illinois","Clinton County",1,61,545,283,262
050,17,027,"Illinois","Clinton County",1,62,523,265,258
050,17,027,"Illinois","Clinton County",1,63,511,268,243
050,17,027,"Illinois","Clinton County",1,64,499,246,253
050,17,027,"Illinois","Clinton County",1,65,493,234,259
050,17,027,"Illinois","Clinton County",1,66,481,247,234
050,17,027,"Illinois","Clinton County",1,67,453,225,228
050,17,027,"Illinois","Clinton County",1,68,374,184,190
050,17,027,"Illinois","Clinton County",1,69,354,171,183
050,17,027,"Illinois","Clinton County",1,70,357,175,182
050,17,027,"Illinois","Clinton County",1,71,347,163,184
050,17,027,"Illinois","Clinton County",1,72,336,155,181
050,17,027,"Illinois","Clinton County",1,73,313,158,155
050,17,027,"Illinois","Clinton County",1,74,240,117,123
050,17,027,"Illinois","Clinton County",1,75,233,101,132
050,17,027,"Illinois","Clinton County",1,76,251,114,137
050,17,027,"Illinois","Clinton County",1,77,241,113,128
050,17,027,"Illinois","Clinton County",1,78,194,90,104
050,17,027,"Illinois","Clinton County",1,79,191,92,99
050,17,027,"Illinois","Clinton County",1,80,173,80,93
050,17,027,"Illinois","Clinton County",1,81,169,88,81
050,17,027,"Illinois","Clinton County",1,82,152,72,80
050,17,027,"Illinois","Clinton County",1,83,139,63,76
050,17,027,"Illinois","Clinton County",1,84,133,53,80
050,17,027,"Illinois","Clinton County",1,85,806,301,505
050,17,027,"Illinois","Clinton County",2,0,387,207,180
050,17,027,"Illinois","Clinton County",2,1,411,200,211
050,17,027,"Illinois","Clinton County",2,2,428,222,206
050,17,027,"Illinois","Clinton County",2,3,432,232,200
050,17,027,"Illinois","Clinton County",2,4,450,236,214
050,17,027,"Illinois","Clinton County",2,5,467,230,237
050,17,027,"Illinois","Clinton County",2,6,444,234,210
050,17,027,"Illinois","Clinton County",2,7,430,223,207
050,17,027,"Illinois","Clinton County",2,8,435,223,212
050,17,027,"Illinois","Clinton County",2,9,418,220,198
050,17,027,"Illinois","Clinton County",2,10,431,219,212
050,17,027,"Illinois","Clinton County",2,11,451,227,224
050,17,027,"Illinois","Clinton County",2,12,472,240,232
050,17,027,"Illinois","Clinton County",2,13,481,252,229
050,17,027,"Illinois","Clinton County",2,14,476,253,223
050,17,027,"Illinois","Clinton County",2,15,462,243,219
050,17,027,"Illinois","Clinton County",2,16,470,250,220
050,17,027,"Illinois","Clinton County",2,17,475,245,230
050,17,027,"Illinois","Clinton County",2,18,404,207,197
050,17,027,"Illinois","Clinton County",2,19,333,181,152
050,17,027,"Illinois","Clinton County",2,20,376,213,163
050,17,027,"Illinois","Clinton County",2,21,392,221,171
050,17,027,"Illinois","Clinton County",2,22,396,215,181
050,17,027,"Illinois","Clinton County",2,23,404,228,176
050,17,027,"Illinois","Clinton County",2,24,400,227,173
050,17,027,"Illinois","Clinton County",2,25,449,259,190
050,17,027,"Illinois","Clinton County",2,26,456,254,202
050,17,027,"Illinois","Clinton County",2,27,462,251,211
050,17,027,"Illinois","Clinton County",2,28,483,257,226
050,17,027,"Illinois","Clinton County",2,29,452,227,225
050,17,027,"Illinois","Clinton County",2,30,455,242,213
050,17,027,"Illinois","Clinton County",2,31,465,253,212
050,17,027,"Illinois","Clinton County",2,32,488,263,225
050,17,027,"Illinois","Clinton County",2,33,485,269,216
050,17,027,"Illinois","Clinton County",2,34,498,265,233
050,17,027,"Illinois","Clinton County",2,35,536,288,248
050,17,027,"Illinois","Clinton County",2,36,523,292,231
050,17,027,"Illinois","Clinton County",2,37,525,299,226
050,17,027,"Illinois","Clinton County",2,38,507,281,226
050,17,027,"Illinois","Clinton County",2,39,489,273,216
050,17,027,"Illinois","Clinton County",2,40,496,275,221
050,17,027,"Illinois","Clinton County",2,41,478,267,211
050,17,027,"Illinois","Clinton County",2,42,477,269,208
050,17,027,"Illinois","Clinton County",2,43,452,252,200
050,17,027,"Illinois","Clinton County",2,44,413,229,184
050,17,027,"Illinois","Clinton County",2,45,429,232,197
050,17,027,"Illinois","Clinton County",2,46,425,223,202
050,17,027,"Illinois","Clinton County",2,47,428,222,206
050,17,027,"Illinois","Clinton County",2,48,442,228,214
050,17,027,"Illinois","Clinton County",2,49,457,244,213
050,17,027,"Illinois","Clinton County",2,50,463,236,227
050,17,027,"Illinois","Clinton County",2,51,480,252,228
050,17,027,"Illinois","Clinton County",2,52,499,271,228
050,17,027,"Illinois","Clinton County",2,53,500,268,232
050,17,027,"Illinois","Clinton County",2,54,516,263,253
050,17,027,"Illinois","Clinton County",2,55,537,263,274
050,17,027,"Illinois","Clinton County",2,56,561,289,272
050,17,027,"Illinois","Clinton County",2,57,554,277,277
050,17,027,"Illinois","Clinton County",2,58,579,288,291
050,17,027,"Illinois","Clinton County",2,59,596,306,290
050,17,027,"Illinois","Clinton County",2,60,571,289,282
050,17,027,"Illinois","Clinton County",2,61,544,278,266
050,17,027,"Illinois","Clinton County",2,62,529,270,259
050,17,027,"Illinois","Clinton County",2,63,513,267,246
050,17,027,"Illinois","Clinton County",2,64,499,249,250
050,17,027,"Illinois","Clinton County",2,65,487,233,254
050,17,027,"Illinois","Clinton County",2,66,485,243,242
050,17,027,"Illinois","Clinton County",2,67,456,227,229
050,17,027,"Illinois","Clinton County",2,68,387,192,195
050,17,027,"Illinois","Clinton County",2,69,359,175,184
050,17,027,"Illinois","Clinton County",2,70,358,175,183
050,17,027,"Illinois","Clinton County",2,71,348,165,183
050,17,027,"Illinois","Clinton County",2,72,333,154,179
050,17,027,"Illinois","Clinton County",2,73,333,163,170
050,17,027,"Illinois","Clinton County",2,74,239,117,122
050,17,027,"Illinois","Clinton County",2,75,236,106,130
050,17,027,"Illinois","Clinton County",2,76,243,110,133
050,17,027,"Illinois","Clinton County",2,77,244,112,132
050,17,027,"Illinois","Clinton County",2,78,199,92,107
050,17,027,"Illinois","Clinton County",2,79,191,92,99
050,17,027,"Illinois","Clinton County",2,80,176,82,94
050,17,027,"Illinois","Clinton County",2,81,166,85,81
050,17,027,"Illinois","Clinton County",2,82,153,73,80
050,17,027,"Illinois","Clinton County",2,83,138,64,74
050,17,027,"Illinois","Clinton County",2,84,130,53,77
050,17,027,"Illinois","Clinton County",2,85,804,301,503
050,17,027,"Illinois","Clinton County",3,0,392,200,192
050,17,027,"Illinois","Clinton County",3,1,404,217,187
050,17,027,"Illinois","Clinton County",3,2,433,210,223
050,17,027,"Illinois","Clinton County",3,3,445,231,214
050,17,027,"Illinois","Clinton County",3,4,437,235,202
050,17,027,"Illinois","Clinton County",3,5,455,235,220
050,17,027,"Illinois","Clinton County",3,6,476,231,245
050,17,027,"Illinois","Clinton County",3,7,441,232,209
050,17,027,"Illinois","Clinton County",3,8,422,220,202
050,17,027,"Illinois","Clinton County",3,9,439,227,212
050,17,027,"Illinois","Clinton County",3,10,411,219,192
050,17,027,"Illinois","Clinton County",3,11,434,218,216
050,17,027,"Illinois","Clinton County",3,12,441,225,216
050,17,027,"Illinois","Clinton County",3,13,459,231,228
050,17,027,"Illinois","Clinton County",3,14,479,258,221
050,17,027,"Illinois","Clinton County",3,15,463,241,222
050,17,027,"Illinois","Clinton County",3,16,455,236,219
050,17,027,"Illinois","Clinton County",3,17,451,248,203
050,17,027,"Illinois","Clinton County",3,18,409,225,184
050,17,027,"Illinois","Clinton County",3,19,336,182,154
050,17,027,"Illinois","Clinton County",3,20,369,194,175
050,17,027,"Illinois","Clinton County",3,21,403,225,178
050,17,027,"Illinois","Clinton County",3,22,421,231,190
050,17,027,"Illinois","Clinton County",3,23,421,235,186
050,17,027,"Illinois","Clinton County",3,24,408,226,182
050,17,027,"Illinois","Clinton County",3,25,416,237,179
050,17,027,"Illinois","Clinton County",3,26,452,271,181
050,17,027,"Illinois","Clinton County",3,27,457,260,197
050,17,027,"Illinois","Clinton County",3,28,483,263,220
050,17,027,"Illinois","Clinton County",3,29,475,256,219
050,17,027,"Illinois","Clinton County",3,30,469,240,229
050,17,027,"Illinois","Clinton County",3,31,473,256,217
050,17,027,"Illinois","Clinton County",3,32,456,248,208
050,17,027,"Illinois","Clinton County",3,33,485,263,222
050,17,027,"Illinois","Clinton County",3,34,476,256,220
050,17,027,"Illinois","Clinton County",3,35,505,269,236
050,17,027,"Illinois","Clinton County",3,36,539,293,246
050,17,027,"Illinois","Clinton County",3,37,533,301,232
050,17,027,"Illinois","Clinton County",3,38,522,293,229
050,17,027,"Illinois","Clinton County",3,39,504,275,229
050,17,027,"Illinois","Clinton County",3,40,502,279,223
050,17,027,"Illinois","Clinton County",3,41,497,282,215
050,17,027,"Illinois","Clinton County",3,42,471,259,212
050,17,027,"Illinois","Clinton County",3,43,469,263,206
050,17,027,"Illinois","Clinton County",3,44,445,253,192
050,17,027,"Illinois","Clinton County",3,45,425,234,191
050,17,027,"Illinois","Clinton County",3,46,424,228,196
050,17,027,"Illinois","Clinton County",3,47,407,207,200
050,17,027,"Illinois","Clinton County",3,48,423,218,205
050,17,027,"Illinois","Clinton County",3,49,435,223,212
050,17,027,"Illinois","Clinton County",3,50,447,241,206
050,17,027,"Illinois","Clinton County",3,51,463,242,221
050,17,027,"Illinois","Clinton County",3,52,489,257,232
050,17,027,"Illinois","Clinton County",3,53,485,260,225
050,17,027,"Illinois","Clinton County",3,54,486,257,229
050,17,027,"Illinois","Clinton County",3,55,510,259,251
050,17,027,"Illinois","Clinton County",3,56,538,263,275
050,17,027,"Illinois","Clinton County",3,57,546,274,272
050,17,027,"Illinois","Clinton County",3,58,547,277,270
050,17,027,"Illinois","Clinton County",3,59,571,282,289
050,17,027,"Illinois","Clinton County",3,60,587,301,286
050,17,027,"Illinois","Clinton County",3,61,559,284,275
050,17,027,"Illinois","Clinton County",3,62,528,274,254
050,17,027,"Illinois","Clinton County",3,63,519,268,251
050,17,027,"Illinois","Clinton County",3,64,510,266,244
050,17,027,"Illinois","Clinton County",3,65,491,248,243
050,17,027,"Illinois","Clinton County",3,66,485,231,254
050,17,027,"Illinois","Clinton County",3,67,478,241,237
050,17,027,"Illinois","Clinton County",3,68,439,224,215
050,17,027,"Illinois","Clinton County",3,69,375,183,192
050,17,027,"Illinois","Clinton County",3,70,355,172,183
050,17,027,"Illinois","Clinton County",3,71,358,174,184
050,17,027,"Illinois","Clinton County",3,72,343,165,178
050,17,027,"Illinois","Clinton County",3,73,320,146,174
050,17,027,"Illinois","Clinton County",3,74,327,163,164
050,17,027,"Illinois","Clinton County",3,75,232,110,122
050,17,027,"Illinois","Clinton County",3,76,232,105,127
050,17,027,"Illinois","Clinton County",3,77,239,107,132
050,17,027,"Illinois","Clinton County",3,78,222,94,128
050,17,027,"Illinois","Clinton County",3,79,194,90,104
050,17,027,"Illinois","Clinton County",3,80,180,87,93
050,17,027,"Illinois","Clinton County",3,81,168,78,90
050,17,027,"Illinois","Clinton County",3,82,141,69,72
050,17,027,"Illinois","Clinton County",3,83,143,70,73
050,17,027,"Illinois","Clinton County",3,84,131,61,70
050,17,027,"Illinois","Clinton County",3,85,797,301,496
050,17,027,"Illinois","Clinton County",4,0,392,192,200
050,17,027,"Illinois","Clinton County",4,1,389,191,198
050,17,027,"Illinois","Clinton County",4,2,410,218,192
050,17,027,"Illinois","Clinton County",4,3,444,217,227
050,17,027,"Illinois","Clinton County",4,4,445,234,211
050,17,027,"Illinois","Clinton County",4,5,448,247,201
050,17,027,"Illinois","Clinton County",4,6,454,236,218
050,17,027,"Illinois","Clinton County",4,7,474,238,236
050,17,027,"Illinois","Clinton County",4,8,438,230,208
050,17,027,"Illinois","Clinton County",4,9,428,219,209
050,17,027,"Illinois","Clinton County",4,10,435,228,207
050,17,027,"Illinois","Clinton County",4,11,417,219,198
050,17,027,"Illinois","Clinton County",4,12,432,227,205
050,17,027,"Illinois","Clinton County",4,13,436,217,219
050,17,027,"Illinois","Clinton County",4,14,473,240,233
050,17,027,"Illinois","Clinton County",4,15,491,258,233
050,17,027,"Illinois","Clinton County",4,16,470,243,227
050,17,027,"Illinois","Clinton County",4,17,475,250,225
050,17,027,"Illinois","Clinton County",4,18,386,224,162
050,17,027,"Illinois","Clinton County",4,19,323,179,144
050,17,027,"Illinois","Clinton County",4,20,363,194,169
050,17,027,"Illinois","Clinton County",4,21,379,202,177
050,17,027,"Illinois","Clinton County",4,22,427,237,190
050,17,027,"Illinois","Clinton County",4,23,443,253,190
050,17,027,"Illinois","Clinton County",4,24,428,233,195
050,17,027,"Illinois","Clinton County",4,25,410,225,185
050,17,027,"Illinois","Clinton County",4,26,406,235,171
050,17,027,"Illinois","Clinton County",4,27,462,269,193
050,17,027,"Illinois","Clinton County",4,28,452,259,193
050,17,027,"Illinois","Clinton County",4,29,472,251,221
050,17,027,"Illinois","Clinton County",4,30,488,267,221
050,17,027,"Illinois","Clinton County",4,31,479,246,233
050,17,027,"Illinois","Clinton County",4,32,477,251,226
050,17,027,"Illinois","Clinton County",4,33,475,267,208
050,17,027,"Illinois","Clinton County",4,34,471,247,224
050,17,027,"Illinois","Clinton County",4,35,481,257,224
050,17,027,"Illinois","Clinton County",4,36,504,268,236
050,17,027,"Illinois","Clinton County",4,37,556,310,246
050,17,027,"Illinois","Clinton County",4,38,525,293,232
050,17,027,"Illinois","Clinton County",4,39,508,286,222
050,17,027,"Illinois","Clinton County",4,40,502,275,227
050,17,027,"Illinois","Clinton County",4,41,506,285,221
050,17,027,"Illinois","Clinton County",4,42,509,282,227
050,17,027,"Illinois","Clinton County",4,43,480,265,215
050,17,027,"Illinois","Clinton County",4,44,466,259,207
050,17,027,"Illinois","Clinton County",4,45,455,259,196
050,17,027,"Illinois","Clinton County",4,46,428,231,197
050,17,027,"Illinois","Clinton County",4,47,415,218,197
050,17,027,"Illinois","Clinton County",4,48,406,206,200
050,17,027,"Illinois","Clinton County",4,49,420,210,210
050,17,027,"Illinois","Clinton County",4,50,431,222,209
050,17,027,"Illinois","Clinton County",4,51,444,244,200
050,17,027,"Illinois","Clinton County",4,52,472,251,221
050,17,027,"Illinois","Clinton County",4,53,471,243,228
050,17,027,"Illinois","Clinton County",4,54,482,253,229
050,17,027,"Illinois","Clinton County",4,55,459,237,222
050,17,027,"Illinois","Clinton County",4,56,510,264,246
050,17,027,"Illinois","Clinton County",4,57,519,248,271
050,17,027,"Illinois","Clinton County",4,58,551,277,274
050,17,027,"Illinois","Clinton County",4,59,547,279,268
050,17,027,"Illinois","Clinton County",4,60,568,274,294
050,17,027,"Illinois","Clinton County",4,61,580,298,282
050,17,027,"Illinois","Clinton County",4,62,556,281,275
050,17,027,"Illinois","Clinton County",4,63,516,270,246
050,17,027,"Illinois","Clinton County",4,64,504,256,248
050,17,027,"Illinois","Clinton County",4,65,511,265,246
050,17,027,"Illinois","Clinton County",4,66,485,240,245
050,17,027,"Illinois","Clinton County",4,67,478,231,247
050,17,027,"Illinois","Clinton County",4,68,466,235,231
050,17,027,"Illinois","Clinton County",4,69,430,217,213
050,17,027,"Illinois","Clinton County",4,70,370,176,194
050,17,027,"Illinois","Clinton County",4,71,352,171,181
050,17,027,"Illinois","Clinton County",4,72,355,175,180
050,17,027,"Illinois","Clinton County",4,73,327,156,171
050,17,027,"Illinois","Clinton County",4,74,308,139,169
050,17,027,"Illinois","Clinton County",4,75,315,153,162
050,17,027,"Illinois","Clinton County",4,76,226,110,116
050,17,027,"Illinois","Clinton County",4,77,219,99,120
050,17,027,"Illinois","Clinton County",4,78,224,96,128
050,17,027,"Illinois","Clinton County",4,79,227,93,134
050,17,027,"Illinois","Clinton County",4,80,180,81,99
050,17,027,"Illinois","Clinton County",4,81,171,86,85
050,17,027,"Illinois","Clinton County",4,82,155,64,91
050,17,027,"Illinois","Clinton County",4,83,139,67,72
050,17,027,"Illinois","Clinton County",4,84,129,60,69
050,17,027,"Illinois","Clinton County",4,85,807,303,504
050,17,027,"Illinois","Clinton County",5,0,372,183,189
050,17,027,"Illinois","Clinton County",5,1,379,183,196
050,17,027,"Illinois","Clinton County",5,2,393,196,197
050,17,027,"Illinois","Clinton County",5,3,404,210,194
050,17,027,"Illinois","Clinton County",5,4,446,222,224
050,17,027,"Illinois","Clinton County",5,5,451,239,212
050,17,027,"Illinois","Clinton County",5,6,455,254,201
050,17,027,"Illinois","Clinton County",5,7,453,239,214
050,17,027,"Illinois","Clinton County",5,8,469,237,232
050,17,027,"Illinois","Clinton County",5,9,435,229,206
050,17,027,"Illinois","Clinton County",5,10,431,226,205
050,17,027,"Illinois","Clinton County",5,11,435,231,204
050,17,027,"Illinois","Clinton County",5,12,421,222,199
050,17,027,"Illinois","Clinton County",5,13,441,227,214
050,17,027,"Illinois","Clinton County",5,14,453,238,215
050,17,027,"Illinois","Clinton County",5,15,463,229,234
050,17,027,"Illinois","Clinton County",5,16,478,251,227
050,17,027,"Illinois","Clinton County",5,17,474,249,225
050,17,027,"Illinois","Clinton County",5,18,405,226,179
050,17,027,"Illinois","Clinton County",5,19,307,184,123
050,17,027,"Illinois","Clinton County",5,20,346,190,156
050,17,027,"Illinois","Clinton County",5,21,379,202,177
050,17,027,"Illinois","Clinton County",5,22,404,213,191
050,17,027,"Illinois","Clinton County",5,23,463,265,198
050,17,027,"Illinois","Clinton County",5,24,422,239,183
050,17,027,"Illinois","Clinton County",5,25,446,245,201
050,17,027,"Illinois","Clinton County",5,26,399,223,176
050,17,027,"Illinois","Clinton County",5,27,401,235,166
050,17,027,"Illinois","Clinton County",5,28,445,265,180
050,17,027,"Illinois","Clinton County",5,29,418,235,183
050,17,027,"Illinois","Clinton County",5,30,451,243,208
050,17,027,"Illinois","Clinton County",5,31,488,261,227
050,17,027,"Illinois","Clinton County",5,32,473,238,235
050,17,027,"Illinois","Clinton County",5,33,479,256,223
050,17,027,"Illinois","Clinton County",5,34,457,252,205
050,17,027,"Illinois","Clinton County",5,35,484,253,231
050,17,027,"Illinois","Clinton County",5,36,478,254,224
050,17,027,"Illinois","Clinton County",5,37,517,278,239
050,17,027,"Illinois","Clinton County",5,38,560,306,254
050,17,027,"Illinois","Clinton County",5,39,527,292,235
050,17,027,"Illinois","Clinton County",5,40,509,277,232
050,17,027,"Illinois","Clinton County",5,41,510,284,226
050,17,027,"Illinois","Clinton County",5,42,514,288,226
050,17,027,"Illinois","Clinton County",5,43,500,282,218
050,17,027,"Illinois","Clinton County",5,44,474,264,210
050,17,027,"Illinois","Clinton County",5,45,477,266,211
050,17,027,"Illinois","Clinton County",5,46,449,249,200
050,17,027,"Illinois","Clinton County",5,47,419,230,189
050,17,027,"Illinois","Clinton County",5,48,409,215,194
050,17,027,"Illinois","Clinton County",5,49,411,206,205
050,17,027,"Illinois","Clinton County",5,50,417,206,211
050,17,027,"Illinois","Clinton County",5,51,424,219,205
050,17,027,"Illinois","Clinton County",5,52,456,252,204
050,17,027,"Illinois","Clinton County",5,53,454,238,216
050,17,027,"Illinois","Clinton County",5,54,457,230,227
050,17,027,"Illinois","Clinton County",5,55,485,250,235
050,17,027,"Illinois","Clinton County",5,56,455,240,215
050,17,027,"Illinois","Clinton County",5,57,496,252,244
050,17,027,"Illinois","Clinton County",5,58,521,250,271
050,17,027,"Illinois","Clinton County",5,59,541,269,272
050,17,027,"Illinois","Clinton County",5,60,541,269,272
050,17,027,"Illinois","Clinton County",5,61,559,267,292
050,17,027,"Illinois","Clinton County",5,62,572,294,278
050,17,027,"Illinois","Clinton County",5,63,543,275,268
050,17,027,"Illinois","Clinton County",5,64,508,265,243
050,17,027,"Illinois","Clinton County",5,65,500,254,246
050,17,027,"Illinois","Clinton County",5,66,504,262,242
050,17,027,"Illinois","Clinton County",5,67,482,238,244
050,17,027,"Illinois","Clinton County",5,68,468,227,241
050,17,027,"Illinois","Clinton County",5,69,462,229,233
050,17,027,"Illinois","Clinton County",5,70,418,206,212
050,17,027,"Illinois","Clinton County",5,71,359,170,189
050,17,027,"Illinois","Clinton County",5,72,348,169,179
050,17,027,"Illinois","Clinton County",5,73,340,166,174
050,17,027,"Illinois","Clinton County",5,74,316,149,167
050,17,027,"Illinois","Clinton County",5,75,300,133,167
050,17,027,"Illinois","Clinton County",5,76,305,150,155
050,17,027,"Illinois","Clinton County",5,77,213,102,111
050,17,027,"Illinois","Clinton County",5,78,203,88,115
050,17,027,"Illinois","Clinton County",5,79,226,95,131
050,17,027,"Illinois","Clinton County",5,80,209,85,124
050,17,027,"Illinois","Clinton County",5,81,169,79,90
050,17,027,"Illinois","Clinton County",5,82,154,70,84
050,17,027,"Illinois","Clinton County",5,83,149,60,89
050,17,027,"Illinois","Clinton County",5,84,129,60,69
050,17,027,"Illinois","Clinton County",5,85,828,316,512
050,17,029,"Illinois","Coles County",1,0,427,218,209
050,17,029,"Illinois","Coles County",1,1,445,245,200
050,17,029,"Illinois","Coles County",1,2,464,241,223
050,17,029,"Illinois","Coles County",1,3,489,262,227
050,17,029,"Illinois","Coles County",1,4,470,244,226
050,17,029,"Illinois","Coles County",1,5,481,233,248
050,17,029,"Illinois","Coles County",1,6,445,220,225
050,17,029,"Illinois","Coles County",1,7,444,231,213
050,17,029,"Illinois","Coles County",1,8,462,244,218
050,17,029,"Illinois","Coles County",1,9,480,244,236
050,17,029,"Illinois","Coles County",1,10,485,249,236
050,17,029,"Illinois","Coles County",1,11,502,255,247
050,17,029,"Illinois","Coles County",1,12,510,259,251
050,17,029,"Illinois","Coles County",1,13,498,253,245
050,17,029,"Illinois","Coles County",1,14,473,249,224
050,17,029,"Illinois","Coles County",1,15,492,252,240
050,17,029,"Illinois","Coles County",1,16,523,270,253
050,17,029,"Illinois","Coles County",1,17,497,256,241
050,17,029,"Illinois","Coles County",1,18,724,357,367
050,17,029,"Illinois","Coles County",1,19,1169,526,643
050,17,029,"Illinois","Coles County",1,20,1368,644,724
050,17,029,"Illinois","Coles County",1,21,1297,601,696
050,17,029,"Illinois","Coles County",1,22,1126,560,566
050,17,029,"Illinois","Coles County",1,23,879,471,408
050,17,029,"Illinois","Coles County",1,24,728,377,351
050,17,029,"Illinois","Coles County",1,25,619,321,298
050,17,029,"Illinois","Coles County",1,26,579,291,288
050,17,029,"Illinois","Coles County",1,27,599,317,282
050,17,029,"Illinois","Coles County",1,28,609,310,299
050,17,029,"Illinois","Coles County",1,29,575,282,293
050,17,029,"Illinois","Coles County",1,30,617,296,321
050,17,029,"Illinois","Coles County",1,31,623,300,323
050,17,029,"Illinois","Coles County",1,32,658,328,330
050,17,029,"Illinois","Coles County",1,33,583,309,274
050,17,029,"Illinois","Coles County",1,34,580,317,263
050,17,029,"Illinois","Coles County",1,35,553,290,263
050,17,029,"Illinois","Coles County",1,36,520,250,270
050,17,029,"Illinois","Coles County",1,37,580,297,283
050,17,029,"Illinois","Coles County",1,38,549,280,269
050,17,029,"Illinois","Coles County",1,39,566,294,272
050,17,029,"Illinois","Coles County",1,40,539,280,259
050,17,029,"Illinois","Coles County",1,41,522,266,256
050,17,029,"Illinois","Coles County",1,42,508,250,258
050,17,029,"Illinois","Coles County",1,43,523,249,274
050,17,029,"Illinois","Coles County",1,44,493,250,243
050,17,029,"Illinois","Coles County",1,45,484,249,235
050,17,029,"Illinois","Coles County",1,46,465,256,209
050,17,029,"Illinois","Coles County",1,47,526,280,246
050,17,029,"Illinois","Coles County",1,48,548,287,261
050,17,029,"Illinois","Coles County",1,49,562,286,276
050,17,029,"Illinois","Coles County",1,50,512,258,254
050,17,029,"Illinois","Coles County",1,51,512,260,252
050,17,029,"Illinois","Coles County",1,52,508,264,244
050,17,029,"Illinois","Coles County",1,53,499,245,254
050,17,029,"Illinois","Coles County",1,54,502,243,259
050,17,029,"Illinois","Coles County",1,55,547,281,266
050,17,029,"Illinois","Coles County",1,56,555,260,295
050,17,029,"Illinois","Coles County",1,57,593,285,308
050,17,029,"Illinois","Coles County",1,58,608,290,318
050,17,029,"Illinois","Coles County",1,59,643,311,332
050,17,029,"Illinois","Coles County",1,60,665,328,337
050,17,029,"Illinois","Coles County",1,61,644,330,314
050,17,029,"Illinois","Coles County",1,62,634,313,321
050,17,029,"Illinois","Coles County",1,63,643,318,325
050,17,029,"Illinois","Coles County",1,64,616,288,328
050,17,029,"Illinois","Coles County",1,65,615,295,320
050,17,029,"Illinois","Coles County",1,66,574,275,299
050,17,029,"Illinois","Coles County",1,67,543,261,282
050,17,029,"Illinois","Coles County",1,68,529,262,267
050,17,029,"Illinois","Coles County",1,69,457,220,237
050,17,029,"Illinois","Coles County",1,70,432,183,249
050,17,029,"Illinois","Coles County",1,71,434,193,241
050,17,029,"Illinois","Coles County",1,72,452,207,245
050,17,029,"Illinois","Coles County",1,73,453,221,232
050,17,029,"Illinois","Coles County",1,74,285,136,149
050,17,029,"Illinois","Coles County",1,75,305,148,157
050,17,029,"Illinois","Coles County",1,76,323,148,175
050,17,029,"Illinois","Coles County",1,77,304,124,180
050,17,029,"Illinois","Coles County",1,78,270,114,156
050,17,029,"Illinois","Coles County",1,79,235,104,131
050,17,029,"Illinois","Coles County",1,80,217,93,124
050,17,029,"Illinois","Coles County",1,81,234,96,138
050,17,029,"Illinois","Coles County",1,82,189,80,109
050,17,029,"Illinois","Coles County",1,83,191,79,112
050,17,029,"Illinois","Coles County",1,84,174,66,108
050,17,029,"Illinois","Coles County",1,85,1109,350,759
050,17,029,"Illinois","Coles County",2,0,439,221,218
050,17,029,"Illinois","Coles County",2,1,435,235,200
050,17,029,"Illinois","Coles County",2,2,460,243,217
050,17,029,"Illinois","Coles County",2,3,478,255,223
050,17,029,"Illinois","Coles County",2,4,476,248,228
050,17,029,"Illinois","Coles County",2,5,472,232,240
050,17,029,"Illinois","Coles County",2,6,457,224,233
050,17,029,"Illinois","Coles County",2,7,443,226,217
050,17,029,"Illinois","Coles County",2,8,456,240,216
050,17,029,"Illinois","Coles County",2,9,477,244,233
050,17,029,"Illinois","Coles County",2,10,482,248,234
050,17,029,"Illinois","Coles County",2,11,491,250,241
050,17,029,"Illinois","Coles County",2,12,509,258,251
050,17,029,"Illinois","Coles County",2,13,500,255,245
050,17,029,"Illinois","Coles County",2,14,477,248,229
050,17,029,"Illinois","Coles County",2,15,487,251,236
050,17,029,"Illinois","Coles County",2,16,515,262,253
050,17,029,"Illinois","Coles County",2,17,506,261,245
050,17,029,"Illinois","Coles County",2,18,728,355,373
050,17,029,"Illinois","Coles County",2,19,1170,528,642
050,17,029,"Illinois","Coles County",2,20,1391,656,735
050,17,029,"Illinois","Coles County",2,21,1293,599,694
050,17,029,"Illinois","Coles County",2,22,1126,566,560
050,17,029,"Illinois","Coles County",2,23,872,461,411
050,17,029,"Illinois","Coles County",2,24,717,371,346
050,17,029,"Illinois","Coles County",2,25,616,323,293
050,17,029,"Illinois","Coles County",2,26,577,290,287
050,17,029,"Illinois","Coles County",2,27,589,308,281
050,17,029,"Illinois","Coles County",2,28,601,308,293
050,17,029,"Illinois","Coles County",2,29,580,286,294
050,17,029,"Illinois","Coles County",2,30,606,294,312
050,17,029,"Illinois","Coles County",2,31,616,297,319
050,17,029,"Illinois","Coles County",2,32,640,316,324
050,17,029,"Illinois","Coles County",2,33,601,316,285
050,17,029,"Illinois","Coles County",2,34,580,314,266
050,17,029,"Illinois","Coles County",2,35,557,294,263
050,17,029,"Illinois","Coles County",2,36,528,262,266
050,17,029,"Illinois","Coles County",2,37,562,282,280
050,17,029,"Illinois","Coles County",2,38,558,286,272
050,17,029,"Illinois","Coles County",2,39,562,290,272
050,17,029,"Illinois","Coles County",2,40,542,281,261
050,17,029,"Illinois","Coles County",2,41,524,269,255
050,17,029,"Illinois","Coles County",2,42,506,254,252
050,17,029,"Illinois","Coles County",2,43,519,246,273
050,17,029,"Illinois","Coles County",2,44,496,246,250
050,17,029,"Illinois","Coles County",2,45,486,250,236
050,17,029,"Illinois","Coles County",2,46,467,253,214
050,17,029,"Illinois","Coles County",2,47,512,275,237
050,17,029,"Illinois","Coles County",2,48,540,283,257
050,17,029,"Illinois","Coles County",2,49,558,286,272
050,17,029,"Illinois","Coles County",2,50,525,265,260
050,17,029,"Illinois","Coles County",2,51,510,259,251
050,17,029,"Illinois","Coles County",2,52,502,261,241
050,17,029,"Illinois","Coles County",2,53,502,249,253
050,17,029,"Illinois","Coles County",2,54,499,245,254
050,17,029,"Illinois","Coles County",2,55,533,272,261
050,17,029,"Illinois","Coles County",2,56,551,263,288
050,17,029,"Illinois","Coles County",2,57,583,276,307
050,17,029,"Illinois","Coles County",2,58,601,289,312
050,17,029,"Illinois","Coles County",2,59,635,305,330
050,17,029,"Illinois","Coles County",2,60,656,320,336
050,17,029,"Illinois","Coles County",2,61,643,326,317
050,17,029,"Illinois","Coles County",2,62,629,313,316
050,17,029,"Illinois","Coles County",2,63,644,321,323
050,17,029,"Illinois","Coles County",2,64,619,293,326
050,17,029,"Illinois","Coles County",2,65,609,290,319
050,17,029,"Illinois","Coles County",2,66,584,279,305
050,17,029,"Illinois","Coles County",2,67,550,266,284
050,17,029,"Illinois","Coles County",2,68,525,257,268
050,17,029,"Illinois","Coles County",2,69,474,228,246
050,17,029,"Illinois","Coles County",2,70,431,189,242
050,17,029,"Illinois","Coles County",2,71,428,188,240
050,17,029,"Illinois","Coles County",2,72,438,197,241
050,17,029,"Illinois","Coles County",2,73,477,230,247
050,17,029,"Illinois","Coles County",2,74,305,147,158
050,17,029,"Illinois","Coles County",2,75,302,144,158
050,17,029,"Illinois","Coles County",2,76,315,147,168
050,17,029,"Illinois","Coles County",2,77,312,134,178
050,17,029,"Illinois","Coles County",2,78,269,113,156
050,17,029,"Illinois","Coles County",2,79,238,102,136
050,17,029,"Illinois","Coles County",2,80,217,95,122
050,17,029,"Illinois","Coles County",2,81,230,94,136
050,17,029,"Illinois","Coles County",2,82,196,83,113
050,17,029,"Illinois","Coles County",2,83,183,75,108
050,17,029,"Illinois","Coles County",2,84,173,67,106
050,17,029,"Illinois","Coles County",2,85,1092,347,745
050,17,029,"Illinois","Coles County",3,0,457,233,224
050,17,029,"Illinois","Coles County",3,1,450,223,227
050,17,029,"Illinois","Coles County",3,2,449,240,209
050,17,029,"Illinois","Coles County",3,3,476,254,222
050,17,029,"Illinois","Coles County",3,4,482,256,226
050,17,029,"Illinois","Coles County",3,5,491,250,241
050,17,029,"Illinois","Coles County",3,6,469,236,233
050,17,029,"Illinois","Coles County",3,7,459,225,234
050,17,029,"Illinois","Coles County",3,8,432,223,209
050,17,029,"Illinois","Coles County",3,9,472,242,230
050,17,029,"Illinois","Coles County",3,10,470,246,224
050,17,029,"Illinois","Coles County",3,11,461,231,230
050,17,029,"Illinois","Coles County",3,12,485,238,247
050,17,029,"Illinois","Coles County",3,13,515,257,258
050,17,029,"Illinois","Coles County",3,14,501,264,237
050,17,029,"Illinois","Coles County",3,15,478,246,232
050,17,029,"Illinois","Coles County",3,16,492,251,241
050,17,029,"Illinois","Coles County",3,17,536,285,251
050,17,029,"Illinois","Coles County",3,18,715,347,368
050,17,029,"Illinois","Coles County",3,19,1190,534,656
050,17,029,"Illinois","Coles County",3,20,1433,669,764
050,17,029,"Illinois","Coles County",3,21,1333,611,722
050,17,029,"Illinois","Coles County",3,22,1148,574,574
050,17,029,"Illinois","Coles County",3,23,858,449,409
050,17,029,"Illinois","Coles County",3,24,696,370,326
050,17,029,"Illinois","Coles County",3,25,617,329,288
050,17,029,"Illinois","Coles County",3,26,587,307,280
050,17,029,"Illinois","Coles County",3,27,580,281,299
050,17,029,"Illinois","Coles County",3,28,568,293,275
050,17,029,"Illinois","Coles County",3,29,603,300,303
050,17,029,"Illinois","Coles County",3,30,573,285,288
050,17,029,"Illinois","Coles County",3,31,601,302,299
050,17,029,"Illinois","Coles County",3,32,611,288,323
050,17,029,"Illinois","Coles County",3,33,648,321,327
050,17,029,"Illinois","Coles County",3,34,607,306,301
050,17,029,"Illinois","Coles County",3,35,568,303,265
050,17,029,"Illinois","Coles County",3,36,567,297,270
050,17,029,"Illinois","Coles County",3,37,512,244,268
050,17,029,"Illinois","Coles County",3,38,560,283,277
050,17,029,"Illinois","Coles County",3,39,557,277,280
050,17,029,"Illinois","Coles County",3,40,560,290,270
050,17,029,"Illinois","Coles County",3,41,534,277,257
050,17,029,"Illinois","Coles County",3,42,521,278,243
050,17,029,"Illinois","Coles County",3,43,507,251,256
050,17,029,"Illinois","Coles County",3,44,522,252,270
050,17,029,"Illinois","Coles County",3,45,496,245,251
050,17,029,"Illinois","Coles County",3,46,483,244,239
050,17,029,"Illinois","Coles County",3,47,468,253,215
050,17,029,"Illinois","Coles County",3,48,505,271,234
050,17,029,"Illinois","Coles County",3,49,554,291,263
050,17,029,"Illinois","Coles County",3,50,569,295,274
050,17,029,"Illinois","Coles County",3,51,511,255,256
050,17,029,"Illinois","Coles County",3,52,514,263,251
050,17,029,"Illinois","Coles County",3,53,502,252,250
050,17,029,"Illinois","Coles County",3,54,508,246,262
050,17,029,"Illinois","Coles County",3,55,497,253,244
050,17,029,"Illinois","Coles County",3,56,523,261,262
050,17,029,"Illinois","Coles County",3,57,554,262,292
050,17,029,"Illinois","Coles County",3,58,574,272,302
050,17,029,"Illinois","Coles County",3,59,594,284,310
050,17,029,"Illinois","Coles County",3,60,619,294,325
050,17,029,"Illinois","Coles County",3,61,643,317,326
050,17,029,"Illinois","Coles County",3,62,623,312,311
050,17,029,"Illinois","Coles County",3,63,619,312,307
050,17,029,"Illinois","Coles County",3,64,634,310,324
050,17,029,"Illinois","Coles County",3,65,602,287,315
050,17,029,"Illinois","Coles County",3,66,591,279,312
050,17,029,"Illinois","Coles County",3,67,573,282,291
050,17,029,"Illinois","Coles County",3,68,530,251,279
050,17,029,"Illinois","Coles County",3,69,516,251,265
050,17,029,"Illinois","Coles County",3,70,455,217,238
050,17,029,"Illinois","Coles County",3,71,425,192,233
050,17,029,"Illinois","Coles County",3,72,423,180,243
050,17,029,"Illinois","Coles County",3,73,423,189,234
050,17,029,"Illinois","Coles County",3,74,451,219,232
050,17,029,"Illinois","Coles County",3,75,296,137,159
050,17,029,"Illinois","Coles County",3,76,294,137,157
050,17,029,"Illinois","Coles County",3,77,297,137,160
050,17,029,"Illinois","Coles County",3,78,296,129,167
050,17,029,"Illinois","Coles County",3,79,251,95,156
050,17,029,"Illinois","Coles County",3,80,218,94,124
050,17,029,"Illinois","Coles County",3,81,211,94,117
050,17,029,"Illinois","Coles County",3,82,206,85,121
050,17,029,"Illinois","Coles County",3,83,180,79,101
050,17,029,"Illinois","Coles County",3,84,167,63,104
050,17,029,"Illinois","Coles County",3,85,1056,334,722
050,17,029,"Illinois","Coles County",4,0,447,241,206
050,17,029,"Illinois","Coles County",4,1,454,237,217
050,17,029,"Illinois","Coles County",4,2,461,236,225
050,17,029,"Illinois","Coles County",4,3,449,247,202
050,17,029,"Illinois","Coles County",4,4,472,243,229
050,17,029,"Illinois","Coles County",4,5,489,255,234
050,17,029,"Illinois","Coles County",4,6,503,261,242
050,17,029,"Illinois","Coles County",4,7,466,238,228
050,17,029,"Illinois","Coles County",4,8,453,223,230
050,17,029,"Illinois","Coles County",4,9,430,223,207
050,17,029,"Illinois","Coles County",4,10,477,253,224
050,17,029,"Illinois","Coles County",4,11,484,257,227
050,17,029,"Illinois","Coles County",4,12,461,231,230
050,17,029,"Illinois","Coles County",4,13,471,236,235
050,17,029,"Illinois","Coles County",4,14,503,251,252
050,17,029,"Illinois","Coles County",4,15,506,265,241
050,17,029,"Illinois","Coles County",4,16,483,246,237
050,17,029,"Illinois","Coles County",4,17,506,267,239
050,17,029,"Illinois","Coles County",4,18,752,361,391
050,17,029,"Illinois","Coles County",4,19,1155,517,638
050,17,029,"Illinois","Coles County",4,20,1424,658,766
050,17,029,"Illinois","Coles County",4,21,1320,602,718
050,17,029,"Illinois","Coles County",4,22,1162,588,574
050,17,029,"Illinois","Coles County",4,23,861,451,410
050,17,029,"Illinois","Coles County",4,24,674,350,324
050,17,029,"Illinois","Coles County",4,25,588,328,260
050,17,029,"Illinois","Coles County",4,26,573,298,275
050,17,029,"Illinois","Coles County",4,27,571,298,273
050,17,029,"Illinois","Coles County",4,28,541,256,285
050,17,029,"Illinois","Coles County",4,29,541,285,256
050,17,029,"Illinois","Coles County",4,30,581,302,279
050,17,029,"Illinois","Coles County",4,31,559,271,288
050,17,029,"Illinois","Coles County",4,32,585,279,306
050,17,029,"Illinois","Coles County",4,33,588,292,296
050,17,029,"Illinois","Coles County",4,34,632,305,327
050,17,029,"Illinois","Coles County",4,35,585,300,285
050,17,029,"Illinois","Coles County",4,36,564,307,257
050,17,029,"Illinois","Coles County",4,37,541,274,267
050,17,029,"Illinois","Coles County",4,38,518,251,267
050,17,029,"Illinois","Coles County",4,39,545,274,271
050,17,029,"Illinois","Coles County",4,40,557,275,282
050,17,029,"Illinois","Coles County",4,41,572,292,280
050,17,029,"Illinois","Coles County",4,42,533,283,250
050,17,029,"Illinois","Coles County",4,43,507,275,232
050,17,029,"Illinois","Coles County",4,44,497,248,249
050,17,029,"Illinois","Coles County",4,45,508,239,269
050,17,029,"Illinois","Coles County",4,46,481,240,241
050,17,029,"Illinois","Coles County",4,47,487,252,235
050,17,029,"Illinois","Coles County",4,48,460,252,208
050,17,029,"Illinois","Coles County",4,49,490,262,228
050,17,029,"Illinois","Coles County",4,50,553,295,258
050,17,029,"Illinois","Coles County",4,51,552,287,265
050,17,029,"Illinois","Coles County",4,52,483,239,244
050,17,029,"Illinois","Coles County",4,53,514,260,254
050,17,029,"Illinois","Coles County",4,54,507,255,252
050,17,029,"Illinois","Coles County",4,55,509,252,257
050,17,029,"Illinois","Coles County",4,56,467,235,232
050,17,029,"Illinois","Coles County",4,57,510,251,259
050,17,029,"Illinois","Coles County",4,58,560,267,293
050,17,029,"Illinois","Coles County",4,59,565,265,300
050,17,029,"Illinois","Coles County",4,60,586,273,313
050,17,029,"Illinois","Coles County",4,61,615,299,316
050,17,029,"Illinois","Coles County",4,62,627,300,327
050,17,029,"Illinois","Coles County",4,63,609,307,302
050,17,029,"Illinois","Coles County",4,64,605,299,306
050,17,029,"Illinois","Coles County",4,65,615,301,314
050,17,029,"Illinois","Coles County",4,66,597,271,326
050,17,029,"Illinois","Coles County",4,67,580,282,298
050,17,029,"Illinois","Coles County",4,68,554,267,287
050,17,029,"Illinois","Coles County",4,69,517,243,274
050,17,029,"Illinois","Coles County",4,70,489,236,253
050,17,029,"Illinois","Coles County",4,71,446,217,229
050,17,029,"Illinois","Coles County",4,72,420,180,240
050,17,029,"Illinois","Coles County",4,73,403,168,235
050,17,029,"Illinois","Coles County",4,74,395,175,220
050,17,029,"Illinois","Coles County",4,75,446,210,236
050,17,029,"Illinois","Coles County",4,76,290,130,160
050,17,029,"Illinois","Coles County",4,77,278,133,145
050,17,029,"Illinois","Coles County",4,78,280,129,151
050,17,029,"Illinois","Coles County",4,79,274,113,161
050,17,029,"Illinois","Coles County",4,80,244,91,153
050,17,029,"Illinois","Coles County",4,81,205,87,118
050,17,029,"Illinois","Coles County",4,82,189,84,105
050,17,029,"Illinois","Coles County",4,83,197,79,118
050,17,029,"Illinois","Coles County",4,84,161,65,96
050,17,029,"Illinois","Coles County",4,85,1037,331,706
050,17,029,"Illinois","Coles County",5,0,441,236,205
050,17,029,"Illinois","Coles County",5,1,442,241,201
050,17,029,"Illinois","Coles County",5,2,455,229,226
050,17,029,"Illinois","Coles County",5,3,468,236,232
050,17,029,"Illinois","Coles County",5,4,450,247,203
050,17,029,"Illinois","Coles County",5,5,471,247,224
050,17,029,"Illinois","Coles County",5,6,488,250,238
050,17,029,"Illinois","Coles County",5,7,498,263,235
050,17,029,"Illinois","Coles County",5,8,461,239,222
050,17,029,"Illinois","Coles County",5,9,448,225,223
050,17,029,"Illinois","Coles County",5,10,438,227,211
050,17,029,"Illinois","Coles County",5,11,470,244,226
050,17,029,"Illinois","Coles County",5,12,482,261,221
050,17,029,"Illinois","Coles County",5,13,449,221,228
050,17,029,"Illinois","Coles County",5,14,482,237,245
050,17,029,"Illinois","Coles County",5,15,510,256,254
050,17,029,"Illinois","Coles County",5,16,524,271,253
050,17,029,"Illinois","Coles County",5,17,504,249,255
050,17,029,"Illinois","Coles County",5,18,715,343,372
050,17,029,"Illinois","Coles County",5,19,1177,527,650
050,17,029,"Illinois","Coles County",5,20,1383,645,738
050,17,029,"Illinois","Coles County",5,21,1333,612,721
050,17,029,"Illinois","Coles County",5,22,1171,590,581
050,17,029,"Illinois","Coles County",5,23,904,471,433
050,17,029,"Illinois","Coles County",5,24,684,352,332
050,17,029,"Illinois","Coles County",5,25,543,303,240
050,17,029,"Illinois","Coles County",5,26,549,299,250
050,17,029,"Illinois","Coles County",5,27,570,307,263
050,17,029,"Illinois","Coles County",5,28,571,280,291
050,17,029,"Illinois","Coles County",5,29,529,261,268
050,17,029,"Illinois","Coles County",5,30,547,294,253
050,17,029,"Illinois","Coles County",5,31,567,296,271
050,17,029,"Illinois","Coles County",5,32,539,253,286
050,17,029,"Illinois","Coles County",5,33,578,287,291
050,17,029,"Illinois","Coles County",5,34,584,280,304
050,17,029,"Illinois","Coles County",5,35,616,295,321
050,17,029,"Illinois","Coles County",5,36,587,302,285
050,17,029,"Illinois","Coles County",5,37,562,298,264
050,17,029,"Illinois","Coles County",5,38,538,276,262
050,17,029,"Illinois","Coles County",5,39,513,248,265
050,17,029,"Illinois","Coles County",5,40,524,266,258
050,17,029,"Illinois","Coles County",5,41,557,276,281
050,17,029,"Illinois","Coles County",5,42,557,286,271
050,17,029,"Illinois","Coles County",5,43,511,262,249
050,17,029,"Illinois","Coles County",5,44,501,264,237
050,17,029,"Illinois","Coles County",5,45,493,244,249
050,17,029,"Illinois","Coles County",5,46,497,230,267
050,17,029,"Illinois","Coles County",5,47,491,247,244
050,17,029,"Illinois","Coles County",5,48,482,249,233
050,17,029,"Illinois","Coles County",5,49,459,256,203
050,17,029,"Illinois","Coles County",5,50,477,253,224
050,17,029,"Illinois","Coles County",5,51,553,296,257
050,17,029,"Illinois","Coles County",5,52,536,277,259
050,17,029,"Illinois","Coles County",5,53,477,228,249
050,17,029,"Illinois","Coles County",5,54,510,258,252
050,17,029,"Illinois","Coles County",5,55,502,260,242
050,17,029,"Illinois","Coles County",5,56,486,236,250
050,17,029,"Illinois","Coles County",5,57,452,225,227
050,17,029,"Illinois","Coles County",5,58,504,254,250
050,17,029,"Illinois","Coles County",5,59,541,259,282
050,17,029,"Illinois","Coles County",5,60,548,252,296
050,17,029,"Illinois","Coles County",5,61,584,279,305
050,17,029,"Illinois","Coles County",5,62,597,280,317
050,17,029,"Illinois","Coles County",5,63,615,292,323
050,17,029,"Illinois","Coles County",5,64,592,294,298
050,17,029,"Illinois","Coles County",5,65,584,291,293
050,17,029,"Illinois","Coles County",5,66,599,281,318
050,17,029,"Illinois","Coles County",5,67,589,272,317
050,17,029,"Illinois","Coles County",5,68,559,260,299
050,17,029,"Illinois","Coles County",5,69,534,253,281
050,17,029,"Illinois","Coles County",5,70,493,227,266
050,17,029,"Illinois","Coles County",5,71,493,247,246
050,17,029,"Illinois","Coles County",5,72,440,206,234
050,17,029,"Illinois","Coles County",5,73,406,176,230
050,17,029,"Illinois","Coles County",5,74,373,156,217
050,17,029,"Illinois","Coles County",5,75,392,171,221
050,17,029,"Illinois","Coles County",5,76,439,203,236
050,17,029,"Illinois","Coles County",5,77,265,120,145
050,17,029,"Illinois","Coles County",5,78,270,128,142
050,17,029,"Illinois","Coles County",5,79,259,114,145
050,17,029,"Illinois","Coles County",5,80,267,108,159
050,17,029,"Illinois","Coles County",5,81,231,84,147
050,17,029,"Illinois","Coles County",5,82,183,77,106
050,17,029,"Illinois","Coles County",5,83,181,79,102
050,17,029,"Illinois","Coles County",5,84,180,66,114
050,17,029,"Illinois","Coles County",5,85,1036,336,700
050,17,031,"Illinois","Cook County",1,0,61491,31382,30109
050,17,031,"Illinois","Cook County",1,1,60772,31068,29704
050,17,031,"Illinois","Cook County",1,2,62233,31690,30543
050,17,031,"Illinois","Cook County",1,3,62793,32106,30687
050,17,031,"Illinois","Cook County",1,4,63618,32517,31101
050,17,031,"Illinois","Cook County",1,5,63539,32380,31159
050,17,031,"Illinois","Cook County",1,6,62009,31753,30256
050,17,031,"Illinois","Cook County",1,7,62231,31610,30621
050,17,031,"Illinois","Cook County",1,8,62855,31981,30874
050,17,031,"Illinois","Cook County",1,9,63547,32666,30881
050,17,031,"Illinois","Cook County",1,10,64717,33118,31599
050,17,031,"Illinois","Cook County",1,11,65828,33587,32241
050,17,031,"Illinois","Cook County",1,12,67792,34459,33333
050,17,031,"Illinois","Cook County",1,13,67370,34215,33155
050,17,031,"Illinois","Cook County",1,14,65843,33573,32270
050,17,031,"Illinois","Cook County",1,15,65491,33353,32138
050,17,031,"Illinois","Cook County",1,16,66000,33535,32465
050,17,031,"Illinois","Cook County",1,17,65002,32943,32059
050,17,031,"Illinois","Cook County",1,18,62053,31418,30635
050,17,031,"Illinois","Cook County",1,19,60625,30129,30496
050,17,031,"Illinois","Cook County",1,20,59542,29493,30049
050,17,031,"Illinois","Cook County",1,21,59348,29274,30074
050,17,031,"Illinois","Cook County",1,22,62295,30585,31710
050,17,031,"Illinois","Cook County",1,23,69359,33839,35520
050,17,031,"Illinois","Cook County",1,24,75618,37073,38545
050,17,031,"Illinois","Cook County",1,25,80435,39600,40835
050,17,031,"Illinois","Cook County",1,26,84190,41665,42525
050,17,031,"Illinois","Cook County",1,27,86716,42811,43905
050,17,031,"Illinois","Cook County",1,28,87784,43088,44696
050,17,031,"Illinois","Cook County",1,29,88596,43861,44735
050,17,031,"Illinois","Cook County",1,30,87814,44062,43752
050,17,031,"Illinois","Cook County",1,31,85220,42916,42304
050,17,031,"Illinois","Cook County",1,32,83776,42052,41724
050,17,031,"Illinois","Cook County",1,33,82163,41264,40899
050,17,031,"Illinois","Cook County",1,34,81514,41110,40404
050,17,031,"Illinois","Cook County",1,35,79906,40130,39776
050,17,031,"Illinois","Cook County",1,36,77438,38936,38502
050,17,031,"Illinois","Cook County",1,37,77358,38734,38624
050,17,031,"Illinois","Cook County",1,38,75571,37819,37752
050,17,031,"Illinois","Cook County",1,39,74648,37145,37503
050,17,031,"Illinois","Cook County",1,40,73410,36657,36753
050,17,031,"Illinois","Cook County",1,41,69863,34827,35036
050,17,031,"Illinois","Cook County",1,42,69026,34569,34457
050,17,031,"Illinois","Cook County",1,43,67216,33610,33606
050,17,031,"Illinois","Cook County",1,44,65341,32686,32655
050,17,031,"Illinois","Cook County",1,45,64763,32153,32610
050,17,031,"Illinois","Cook County",1,46,63739,31572,32167
050,17,031,"Illinois","Cook County",1,47,64737,31971,32766
050,17,031,"Illinois","Cook County",1,48,67412,33338,34074
050,17,031,"Illinois","Cook County",1,49,69848,34647,35201
050,17,031,"Illinois","Cook County",1,50,67241,33214,34027
050,17,031,"Illinois","Cook County",1,51,64892,32195,32697
050,17,031,"Illinois","Cook County",1,52,63862,31715,32147
050,17,031,"Illinois","Cook County",1,53,64019,31660,32359
050,17,031,"Illinois","Cook County",1,54,64736,32127,32609
050,17,031,"Illinois","Cook County",1,55,66381,32682,33699
050,17,031,"Illinois","Cook County",1,56,66402,32664,33738
050,17,031,"Illinois","Cook County",1,57,66343,32445,33898
050,17,031,"Illinois","Cook County",1,58,66979,32632,34347
050,17,031,"Illinois","Cook County",1,59,67212,32702,34510
050,17,031,"Illinois","Cook County",1,60,66825,32326,34499
050,17,031,"Illinois","Cook County",1,61,65450,31397,34053
050,17,031,"Illinois","Cook County",1,62,65036,31234,33802
050,17,031,"Illinois","Cook County",1,63,62302,29819,32483
050,17,031,"Illinois","Cook County",1,64,60296,28465,31831
050,17,031,"Illinois","Cook County",1,65,58560,27519,31041
050,17,031,"Illinois","Cook County",1,66,54789,25572,29217
050,17,031,"Illinois","Cook County",1,67,51997,24145,27852
050,17,031,"Illinois","Cook County",1,68,50106,23071,27035
050,17,031,"Illinois","Cook County",1,69,47200,21509,25691
050,17,031,"Illinois","Cook County",1,70,45635,20692,24943
050,17,031,"Illinois","Cook County",1,71,43448,19675,23773
050,17,031,"Illinois","Cook County",1,72,42622,19180,23442
050,17,031,"Illinois","Cook County",1,73,41689,18731,22958
050,17,031,"Illinois","Cook County",1,74,30668,13520,17148
050,17,031,"Illinois","Cook County",1,75,29715,12993,16722
050,17,031,"Illinois","Cook County",1,76,28905,12496,16409
050,17,031,"Illinois","Cook County",1,77,28830,12159,16671
050,17,031,"Illinois","Cook County",1,78,25188,10468,14720
050,17,031,"Illinois","Cook County",1,79,22419,9226,13193
050,17,031,"Illinois","Cook County",1,80,20647,8372,12275
050,17,031,"Illinois","Cook County",1,81,19447,7831,11616
050,17,031,"Illinois","Cook County",1,82,18250,7234,11016
050,17,031,"Illinois","Cook County",1,83,16284,6399,9885
050,17,031,"Illinois","Cook County",1,84,15230,5895,9335
050,17,031,"Illinois","Cook County",1,85,95495,32039,63456
050,17,031,"Illinois","Cook County",2,0,59957,30578,29379
050,17,031,"Illinois","Cook County",2,1,60540,30928,29612
050,17,031,"Illinois","Cook County",2,2,61564,31374,30190
050,17,031,"Illinois","Cook County",2,3,62165,31747,30418
050,17,031,"Illinois","Cook County",2,4,63212,32301,30911
050,17,031,"Illinois","Cook County",2,5,63346,32320,31026
050,17,031,"Illinois","Cook County",2,6,62210,31830,30380
050,17,031,"Illinois","Cook County",2,7,61894,31499,30395
050,17,031,"Illinois","Cook County",2,8,62319,31680,30639
050,17,031,"Illinois","Cook County",2,9,63169,32392,30777
050,17,031,"Illinois","Cook County",2,10,64231,32914,31317
050,17,031,"Illinois","Cook County",2,11,65114,33247,31867
050,17,031,"Illinois","Cook County",2,12,67489,34346,33143
050,17,031,"Illinois","Cook County",2,13,67260,34169,33091
050,17,031,"Illinois","Cook County",2,14,66025,33621,32404
050,17,031,"Illinois","Cook County",2,15,65462,33343,32119
050,17,031,"Illinois","Cook County",2,16,65798,33442,32356
050,17,031,"Illinois","Cook County",2,17,65063,32983,32080
050,17,031,"Illinois","Cook County",2,18,61896,31361,30535
050,17,031,"Illinois","Cook County",2,19,60828,30223,30605
050,17,031,"Illinois","Cook County",2,20,60250,29837,30413
050,17,031,"Illinois","Cook County",2,21,59342,29270,30072
050,17,031,"Illinois","Cook County",2,22,62741,30758,31983
050,17,031,"Illinois","Cook County",2,23,68915,33652,35263
050,17,031,"Illinois","Cook County",2,24,74636,36566,38070
050,17,031,"Illinois","Cook County",2,25,79761,39253,40508
050,17,031,"Illinois","Cook County",2,26,83729,41450,42279
050,17,031,"Illinois","Cook County",2,27,86031,42535,43496
050,17,031,"Illinois","Cook County",2,28,87473,43036,44437
050,17,031,"Illinois","Cook County",2,29,88084,43541,44543
050,17,031,"Illinois","Cook County",2,30,87999,44026,43973
050,17,031,"Illinois","Cook County",2,31,85100,42831,42269
050,17,031,"Illinois","Cook County",2,32,83427,41924,41503
050,17,031,"Illinois","Cook County",2,33,81878,41121,40757
050,17,031,"Illinois","Cook County",2,34,81137,40881,40256
050,17,031,"Illinois","Cook County",2,35,80167,40324,39843
050,17,031,"Illinois","Cook County",2,36,77156,38763,38393
050,17,031,"Illinois","Cook County",2,37,77035,38613,38422
050,17,031,"Illinois","Cook County",2,38,75956,38017,37939
050,17,031,"Illinois","Cook County",2,39,74196,36967,37229
050,17,031,"Illinois","Cook County",2,40,73904,36885,37019
050,17,031,"Illinois","Cook County",2,41,70289,35030,35259
050,17,031,"Illinois","Cook County",2,42,68663,34366,34297
050,17,031,"Illinois","Cook County",2,43,67789,33895,33894
050,17,031,"Illinois","Cook County",2,44,65140,32603,32537
050,17,031,"Illinois","Cook County",2,45,64967,32283,32684
050,17,031,"Illinois","Cook County",2,46,63679,31553,32126
050,17,031,"Illinois","Cook County",2,47,64230,31735,32495
050,17,031,"Illinois","Cook County",2,48,66661,32964,33697
050,17,031,"Illinois","Cook County",2,49,69317,34356,34961
050,17,031,"Illinois","Cook County",2,50,67696,33471,34225
050,17,031,"Illinois","Cook County",2,51,65015,32237,32778
050,17,031,"Illinois","Cook County",2,52,63958,31745,32213
050,17,031,"Illinois","Cook County",2,53,63645,31491,32154
050,17,031,"Illinois","Cook County",2,54,64280,31886,32394
050,17,031,"Illinois","Cook County",2,55,65787,32456,33331
050,17,031,"Illinois","Cook County",2,56,66315,32614,33701
050,17,031,"Illinois","Cook County",2,57,66139,32376,33763
050,17,031,"Illinois","Cook County",2,58,66565,32449,34116
050,17,031,"Illinois","Cook County",2,59,66868,32535,34333
050,17,031,"Illinois","Cook County",2,60,66660,32284,34376
050,17,031,"Illinois","Cook County",2,61,65299,31360,33939
050,17,031,"Illinois","Cook County",2,62,64483,30918,33565
050,17,031,"Illinois","Cook County",2,63,62950,30102,32848
050,17,031,"Illinois","Cook County",2,64,60055,28399,31656
050,17,031,"Illinois","Cook County",2,65,58476,27467,31009
050,17,031,"Illinois","Cook County",2,66,55396,25831,29565
050,17,031,"Illinois","Cook County",2,67,52110,24209,27901
050,17,031,"Illinois","Cook County",2,68,49891,22975,26916
050,17,031,"Illinois","Cook County",2,69,47723,21761,25962
050,17,031,"Illinois","Cook County",2,70,45608,20667,24941
050,17,031,"Illinois","Cook County",2,71,43541,19679,23862
050,17,031,"Illinois","Cook County",2,72,42014,18889,23125
050,17,031,"Illinois","Cook County",2,73,43038,19314,23724
050,17,031,"Illinois","Cook County",2,74,31416,13866,17550
050,17,031,"Illinois","Cook County",2,75,29724,12994,16730
050,17,031,"Illinois","Cook County",2,76,28544,12341,16203
050,17,031,"Illinois","Cook County",2,77,28912,12230,16682
050,17,031,"Illinois","Cook County",2,78,25358,10552,14806
050,17,031,"Illinois","Cook County",2,79,22684,9289,13395
050,17,031,"Illinois","Cook County",2,80,20778,8431,12347
050,17,031,"Illinois","Cook County",2,81,19261,7753,11508
050,17,031,"Illinois","Cook County",2,82,18196,7186,11010
050,17,031,"Illinois","Cook County",2,83,16379,6392,9987
050,17,031,"Illinois","Cook County",2,84,15090,5844,9246
050,17,031,"Illinois","Cook County",2,85,94560,31688,62872
050,17,031,"Illinois","Cook County",3,0,54756,28176,26580
050,17,031,"Illinois","Cook County",3,1,57234,29174,28060
050,17,031,"Illinois","Cook County",3,2,58212,29648,28564
050,17,031,"Illinois","Cook County",3,3,59405,30186,29219
050,17,031,"Illinois","Cook County",3,4,60478,30869,29609
050,17,031,"Illinois","Cook County",3,5,61372,31301,30071
050,17,031,"Illinois","Cook County",3,6,61892,31523,30369
050,17,031,"Illinois","Cook County",3,7,60918,31197,29721
050,17,031,"Illinois","Cook County",3,8,60683,30866,29817
050,17,031,"Illinois","Cook County",3,9,61193,31166,30027
050,17,031,"Illinois","Cook County",3,10,62067,31764,30303
050,17,031,"Illinois","Cook County",3,11,63317,32413,30904
050,17,031,"Illinois","Cook County",3,12,64244,32773,31471
050,17,031,"Illinois","Cook County",3,13,66529,33844,32685
050,17,031,"Illinois","Cook County",3,14,66448,33722,32726
050,17,031,"Illinois","Cook County",3,15,65126,33112,32014
050,17,031,"Illinois","Cook County",3,16,64783,32966,31817
050,17,031,"Illinois","Cook County",3,17,65262,33219,32043
050,17,031,"Illinois","Cook County",3,18,61933,31465,30468
050,17,031,"Illinois","Cook County",3,19,59802,29803,29999
050,17,031,"Illinois","Cook County",3,20,59777,29694,30083
050,17,031,"Illinois","Cook County",3,21,59453,29416,30037
050,17,031,"Illinois","Cook County",3,22,60565,29616,30949
050,17,031,"Illinois","Cook County",3,23,66207,32394,33813
050,17,031,"Illinois","Cook County",3,24,71363,34852,36511
050,17,031,"Illinois","Cook County",3,25,75220,36950,38270
050,17,031,"Illinois","Cook County",3,26,79520,39100,40420
050,17,031,"Illinois","Cook County",3,27,82844,40983,41861
050,17,031,"Illinois","Cook County",3,28,84125,41635,42490
050,17,031,"Illinois","Cook County",3,29,85023,41863,43160
050,17,031,"Illinois","Cook County",3,30,84819,41999,42820
050,17,031,"Illinois","Cook County",3,31,84726,42375,42351
050,17,031,"Illinois","Cook County",3,32,81810,41211,40599
050,17,031,"Illinois","Cook County",3,33,79958,40048,39910
050,17,031,"Illinois","Cook County",3,34,78676,39567,39109
050,17,031,"Illinois","Cook County",3,35,77855,39119,38736
050,17,031,"Illinois","Cook County",3,36,77218,38796,38422
050,17,031,"Illinois","Cook County",3,37,74582,37397,37185
050,17,031,"Illinois","Cook County",3,38,74542,37194,37348
050,17,031,"Illinois","Cook County",3,39,73776,36754,37022
050,17,031,"Illinois","Cook County",3,40,71906,35700,36206
050,17,031,"Illinois","Cook County",3,41,71886,35837,36049
050,17,031,"Illinois","Cook County",3,42,68742,34056,34686
050,17,031,"Illinois","Cook County",3,43,67062,33481,33581
050,17,031,"Illinois","Cook County",3,44,66357,33120,33237
050,17,031,"Illinois","Cook County",3,45,63687,31724,31963
050,17,031,"Illinois","Cook County",3,46,63806,31639,32167
050,17,031,"Illinois","Cook County",3,47,62592,30972,31620
050,17,031,"Illinois","Cook County",3,48,63079,31094,31985
050,17,031,"Illinois","Cook County",3,49,65510,32341,33169
050,17,031,"Illinois","Cook County",3,50,68015,33648,34367
050,17,031,"Illinois","Cook County",3,51,66673,33020,33653
050,17,031,"Illinois","Cook County",3,52,63798,31596,32202
050,17,031,"Illinois","Cook County",3,53,62935,31184,31751
050,17,031,"Illinois","Cook County",3,54,62355,30819,31536
050,17,031,"Illinois","Cook County",3,55,62980,31134,31846
050,17,031,"Illinois","Cook County",3,56,64396,31747,32649
050,17,031,"Illinois","Cook County",3,57,64897,31836,33061
050,17,031,"Illinois","Cook County",3,58,64723,31642,33081
050,17,031,"Illinois","Cook County",3,59,65014,31607,33407
050,17,031,"Illinois","Cook County",3,60,65118,31515,33603
050,17,031,"Illinois","Cook County",3,61,64916,31343,33573
050,17,031,"Illinois","Cook County",3,62,63570,30404,33166
050,17,031,"Illinois","Cook County",3,63,62456,29830,32626
050,17,031,"Illinois","Cook County",3,64,61071,29044,32027
050,17,031,"Illinois","Cook County",3,65,58170,27373,30797
050,17,031,"Illinois","Cook County",3,66,56844,26586,30258
050,17,031,"Illinois","Cook County",3,67,53755,24997,28758
050,17,031,"Illinois","Cook County",3,68,50542,23330,27212
050,17,031,"Illinois","Cook County",3,69,48402,22192,26210
050,17,031,"Illinois","Cook County",3,70,46274,20954,25320
050,17,031,"Illinois","Cook County",3,71,44114,19880,24234
050,17,031,"Illinois","Cook County",3,72,42171,18935,23236
050,17,031,"Illinois","Cook County",3,73,40500,18044,22456
050,17,031,"Illinois","Cook County",3,74,41601,18573,23028
050,17,031,"Illinois","Cook County",3,75,30285,13279,17006
050,17,031,"Illinois","Cook County",3,76,28603,12398,16205
050,17,031,"Illinois","Cook County",3,77,27316,11675,15641
050,17,031,"Illinois","Cook County",3,78,27548,11534,16014
050,17,031,"Illinois","Cook County",3,79,24122,9929,14193
050,17,031,"Illinois","Cook County",3,80,21450,8700,12750
050,17,031,"Illinois","Cook County",3,81,19630,7879,11751
050,17,031,"Illinois","Cook County",3,82,17947,7125,10822
050,17,031,"Illinois","Cook County",3,83,17015,6613,10402
050,17,031,"Illinois","Cook County",3,84,15090,5801,9289
050,17,031,"Illinois","Cook County",3,85,94283,31842,62441
050,17,031,"Illinois","Cook County",4,0,53564,27480,26084
050,17,031,"Illinois","Cook County",4,1,52340,26990,25350
050,17,031,"Illinois","Cook County",4,2,55325,28124,27201
050,17,031,"Illinois","Cook County",4,3,56228,28525,27703
050,17,031,"Illinois","Cook County",4,4,57554,29305,28249
050,17,031,"Illinois","Cook County",4,5,58660,29894,28766
050,17,031,"Illinois","Cook County",4,6,59628,30387,29241
050,17,031,"Illinois","Cook County",4,7,60384,30763,29621
050,17,031,"Illinois","Cook County",4,8,59615,30540,29075
050,17,031,"Illinois","Cook County",4,9,59548,30297,29251
050,17,031,"Illinois","Cook County",4,10,60035,30575,29460
050,17,031,"Illinois","Cook County",4,11,61047,31252,29795
050,17,031,"Illinois","Cook County",4,12,62272,31939,30333
050,17,031,"Illinois","Cook County",4,13,63250,32272,30978
050,17,031,"Illinois","Cook County",4,14,65600,33291,32309
050,17,031,"Illinois","Cook County",4,15,65653,33292,32361
050,17,031,"Illinois","Cook County",4,16,64458,32795,31663
050,17,031,"Illinois","Cook County",4,17,64463,32853,31610
050,17,031,"Illinois","Cook County",4,18,61662,31462,30200
050,17,031,"Illinois","Cook County",4,19,58800,29430,29370
050,17,031,"Illinois","Cook County",4,20,58167,29009,29158
050,17,031,"Illinois","Cook County",4,21,59076,29326,29750
050,17,031,"Illinois","Cook County",4,22,61201,29908,31293
050,17,031,"Illinois","Cook County",4,23,65906,31943,33963
050,17,031,"Illinois","Cook County",4,24,70945,34932,36013
050,17,031,"Illinois","Cook County",4,25,74238,36390,37848
050,17,031,"Illinois","Cook County",4,26,77050,37832,39218
050,17,031,"Illinois","Cook County",4,27,80135,39342,40793
050,17,031,"Illinois","Cook County",4,28,81999,40849,41150
050,17,031,"Illinois","Cook County",4,29,82738,41156,41582
050,17,031,"Illinois","Cook County",4,30,83183,41021,42162
050,17,031,"Illinois","Cook County",4,31,82559,40915,41644
050,17,031,"Illinois","Cook County",4,32,81995,41173,40822
050,17,031,"Illinois","Cook County",4,33,78880,39742,39138
050,17,031,"Illinois","Cook County",4,34,77109,38618,38491
050,17,031,"Illinois","Cook County",4,35,75833,38115,37718
050,17,031,"Illinois","Cook County",4,36,75158,37809,37349
050,17,031,"Illinois","Cook County",4,37,74603,37449,37154
050,17,031,"Illinois","Cook County",4,38,72041,36024,36017
050,17,031,"Illinois","Cook County",4,39,72455,36036,36419
050,17,031,"Illinois","Cook County",4,40,71701,35673,36028
050,17,031,"Illinois","Cook County",4,41,70148,34848,35300
050,17,031,"Illinois","Cook County",4,42,70192,34932,35260
050,17,031,"Illinois","Cook County",4,43,67093,33217,33876
050,17,031,"Illinois","Cook County",4,44,65631,32677,32954
050,17,031,"Illinois","Cook County",4,45,64841,32267,32574
050,17,031,"Illinois","Cook County",4,46,62595,31130,31465
050,17,031,"Illinois","Cook County",4,47,62767,31118,31649
050,17,031,"Illinois","Cook County",4,48,61308,30250,31058
050,17,031,"Illinois","Cook County",4,49,62074,30557,31517
050,17,031,"Illinois","Cook County",4,50,63991,31565,32426
050,17,031,"Illinois","Cook County",4,51,67047,33119,33928
050,17,031,"Illinois","Cook County",4,52,65368,32365,33003
050,17,031,"Illinois","Cook County",4,53,62733,31037,31696
050,17,031,"Illinois","Cook County",4,54,61677,30519,31158
050,17,031,"Illinois","Cook County",4,55,61128,30145,30983
050,17,031,"Illinois","Cook County",4,56,61720,30425,31295
050,17,031,"Illinois","Cook County",4,57,63171,31068,32103
050,17,031,"Illinois","Cook County",4,58,63382,31020,32362
050,17,031,"Illinois","Cook County",4,59,63103,30802,32301
050,17,031,"Illinois","Cook County",4,60,63463,30762,32701
050,17,031,"Illinois","Cook County",4,61,63522,30659,32863
050,17,031,"Illinois","Cook County",4,62,63159,30354,32805
050,17,031,"Illinois","Cook County",4,63,61685,29418,32267
050,17,031,"Illinois","Cook County",4,64,60666,28908,31758
050,17,031,"Illinois","Cook County",4,65,59065,27929,31136
050,17,031,"Illinois","Cook County",4,66,56497,26514,29983
050,17,031,"Illinois","Cook County",4,67,55037,25660,29377
050,17,031,"Illinois","Cook County",4,68,52093,24070,28023
050,17,031,"Illinois","Cook County",4,69,48914,22474,26440
050,17,031,"Illinois","Cook County",4,70,46818,21325,25493
050,17,031,"Illinois","Cook County",4,71,44780,20189,24591
050,17,031,"Illinois","Cook County",4,72,42647,19151,23496
050,17,031,"Illinois","Cook County",4,73,40635,18092,22543
050,17,031,"Illinois","Cook County",4,74,39171,17387,21784
050,17,031,"Illinois","Cook County",4,75,39965,17724,22241
050,17,031,"Illinois","Cook County",4,76,29144,12699,16445
050,17,031,"Illinois","Cook County",4,77,27390,11784,15606
050,17,031,"Illinois","Cook County",4,78,26079,11051,15028
050,17,031,"Illinois","Cook County",4,79,26162,10811,15351
050,17,031,"Illinois","Cook County",4,80,22760,9251,13509
050,17,031,"Illinois","Cook County",4,81,20254,8155,12099
050,17,031,"Illinois","Cook County",4,82,18314,7247,11067
050,17,031,"Illinois","Cook County",4,83,16754,6602,10152
050,17,031,"Illinois","Cook County",4,84,15650,6037,9613
050,17,031,"Illinois","Cook County",4,85,93915,32040,61875
050,17,031,"Illinois","Cook County",5,0,53092,27207,25885
050,17,031,"Illinois","Cook County",5,1,52035,26707,25328
050,17,031,"Illinois","Cook County",5,2,51224,26374,24850
050,17,031,"Illinois","Cook County",5,3,54137,27462,26675
050,17,031,"Illinois","Cook County",5,4,55123,27958,27165
050,17,031,"Illinois","Cook County",5,5,56612,28782,27830
050,17,031,"Illinois","Cook County",5,6,57659,29296,28363
050,17,031,"Illinois","Cook County",5,7,58852,29994,28858
050,17,031,"Illinois","Cook County",5,8,59665,30339,29326
050,17,031,"Illinois","Cook County",5,9,58917,30242,28675
050,17,031,"Illinois","Cook County",5,10,58844,29954,28890
050,17,031,"Illinois","Cook County",5,11,59445,30242,29203
050,17,031,"Illinois","Cook County",5,12,60506,31087,29419
050,17,031,"Illinois","Cook County",5,13,61730,31668,30062
050,17,031,"Illinois","Cook County",5,14,62808,32085,30723
050,17,031,"Illinois","Cook County",5,15,65062,33020,32042
050,17,031,"Illinois","Cook County",5,16,65331,33084,32247
050,17,031,"Illinois","Cook County",5,17,64450,32837,31613
050,17,031,"Illinois","Cook County",5,18,61208,31325,29883
050,17,031,"Illinois","Cook County",5,19,59255,29692,29563
050,17,031,"Illinois","Cook County",5,20,58400,29208,29192
050,17,031,"Illinois","Cook County",5,21,58425,29105,29320
050,17,031,"Illinois","Cook County",5,22,61794,30264,31530
050,17,031,"Illinois","Cook County",5,23,68033,32954,35079
050,17,031,"Illinois","Cook County",5,24,71333,34594,36739
050,17,031,"Illinois","Cook County",5,25,74310,36415,37895
050,17,031,"Illinois","Cook County",5,26,76623,37453,39170
050,17,031,"Illinois","Cook County",5,27,78650,38743,39907
050,17,031,"Illinois","Cook County",5,28,80694,39837,40857
050,17,031,"Illinois","Cook County",5,29,81710,40767,40943
050,17,031,"Illinois","Cook County",5,30,81964,40889,41075
050,17,031,"Illinois","Cook County",5,31,82143,40573,41570
050,17,031,"Illinois","Cook County",5,32,80814,40152,40662
050,17,031,"Illinois","Cook County",5,33,80091,40231,39860
050,17,031,"Illinois","Cook County",5,34,77132,38868,38264
050,17,031,"Illinois","Cook County",5,35,75112,37618,37494
050,17,031,"Illinois","Cook County",5,36,74082,37189,36893
050,17,031,"Illinois","Cook County",5,37,73431,36949,36482
050,17,031,"Illinois","Cook County",5,38,72962,36570,36392
050,17,031,"Illinois","Cook County",5,39,70674,35249,35425
050,17,031,"Illinois","Cook County",5,40,70909,35205,35704
050,17,031,"Illinois","Cook County",5,41,70351,34931,35420
050,17,031,"Illinois","Cook County",5,42,69039,34246,34793
050,17,031,"Illinois","Cook County",5,43,69238,34476,34762
050,17,031,"Illinois","Cook County",5,44,66246,32706,33540
050,17,031,"Illinois","Cook County",5,45,64456,31933,32523
050,17,031,"Illinois","Cook County",5,46,64240,31972,32268
050,17,031,"Illinois","Cook County",5,47,61865,30700,31165
050,17,031,"Illinois","Cook County",5,48,61850,30574,31276
050,17,031,"Illinois","Cook County",5,49,60589,29839,30750
050,17,031,"Illinois","Cook County",5,50,61051,29965,31086
050,17,031,"Illinois","Cook County",5,51,63497,31319,32178
050,17,031,"Illinois","Cook County",5,52,66058,32638,33420
050,17,031,"Illinois","Cook County",5,53,64596,31949,32647
050,17,031,"Illinois","Cook County",5,54,61929,30631,31298
050,17,031,"Illinois","Cook County",5,55,60800,30015,30785
050,17,031,"Illinois","Cook County",5,56,60084,29587,30497
050,17,031,"Illinois","Cook County",5,57,60704,29879,30825
050,17,031,"Illinois","Cook County",5,58,62075,30446,31629
050,17,031,"Illinois","Cook County",5,59,62272,30375,31897
050,17,031,"Illinois","Cook County",5,60,61839,30122,31717
050,17,031,"Illinois","Cook County",5,61,62176,30050,32126
050,17,031,"Illinois","Cook County",5,62,62082,29802,32280
050,17,031,"Illinois","Cook County",5,63,61560,29486,32074
050,17,031,"Illinois","Cook County",5,64,60213,28608,31605
050,17,031,"Illinois","Cook County",5,65,59003,27961,31042
050,17,031,"Illinois","Cook County",5,66,57740,27234,30506
050,17,031,"Illinois","Cook County",5,67,55023,25724,29299
050,17,031,"Illinois","Cook County",5,68,53652,24896,28756
050,17,031,"Illinois","Cook County",5,69,50803,23409,27394
050,17,031,"Illinois","Cook County",5,70,47572,21687,25885
050,17,031,"Illinois","Cook County",5,71,45572,20735,24837
050,17,031,"Illinois","Cook County",5,72,43617,19603,24014
050,17,031,"Illinois","Cook County",5,73,41333,18415,22918
050,17,031,"Illinois","Cook County",5,74,39492,17537,21955
050,17,031,"Illinois","Cook County",5,75,37851,16737,21114
050,17,031,"Illinois","Cook County",5,76,38655,17042,21613
050,17,031,"Illinois","Cook County",5,77,28086,12139,15947
050,17,031,"Illinois","Cook County",5,78,26268,11200,15068
050,17,031,"Illinois","Cook County",5,79,24917,10445,14472
050,17,031,"Illinois","Cook County",5,80,24819,10139,14680
050,17,031,"Illinois","Cook County",5,81,21677,8749,12928
050,17,031,"Illinois","Cook County",5,82,19005,7562,11443
050,17,031,"Illinois","Cook County",5,83,17236,6765,10471
050,17,031,"Illinois","Cook County",5,84,15536,6087,9449
050,17,031,"Illinois","Cook County",5,85,95164,32846,62318
050,17,033,"Illinois","Crawford County",1,0,193,98,95
050,17,033,"Illinois","Crawford County",1,1,193,103,90
050,17,033,"Illinois","Crawford County",1,2,196,104,92
050,17,033,"Illinois","Crawford County",1,3,210,110,100
050,17,033,"Illinois","Crawford County",1,4,209,108,101
050,17,033,"Illinois","Crawford County",1,5,196,90,106
050,17,033,"Illinois","Crawford County",1,6,204,97,107
050,17,033,"Illinois","Crawford County",1,7,206,107,99
050,17,033,"Illinois","Crawford County",1,8,201,88,113
050,17,033,"Illinois","Crawford County",1,9,209,105,104
050,17,033,"Illinois","Crawford County",1,10,232,124,108
050,17,033,"Illinois","Crawford County",1,11,223,119,104
050,17,033,"Illinois","Crawford County",1,12,225,116,109
050,17,033,"Illinois","Crawford County",1,13,225,109,116
050,17,033,"Illinois","Crawford County",1,14,232,118,114
050,17,033,"Illinois","Crawford County",1,15,229,124,105
050,17,033,"Illinois","Crawford County",1,16,213,112,101
050,17,033,"Illinois","Crawford County",1,17,225,107,118
050,17,033,"Illinois","Crawford County",1,18,190,97,93
050,17,033,"Illinois","Crawford County",1,19,166,95,71
050,17,033,"Illinois","Crawford County",1,20,183,114,69
050,17,033,"Illinois","Crawford County",1,21,186,110,76
050,17,033,"Illinois","Crawford County",1,22,193,108,85
050,17,033,"Illinois","Crawford County",1,23,203,108,95
050,17,033,"Illinois","Crawford County",1,24,217,123,94
050,17,033,"Illinois","Crawford County",1,25,227,139,88
050,17,033,"Illinois","Crawford County",1,26,234,137,97
050,17,033,"Illinois","Crawford County",1,27,227,135,92
050,17,033,"Illinois","Crawford County",1,28,258,160,98
050,17,033,"Illinois","Crawford County",1,29,254,134,120
050,17,033,"Illinois","Crawford County",1,30,262,140,122
050,17,033,"Illinois","Crawford County",1,31,234,134,100
050,17,033,"Illinois","Crawford County",1,32,241,142,99
050,17,033,"Illinois","Crawford County",1,33,236,132,104
050,17,033,"Illinois","Crawford County",1,34,256,141,115
050,17,033,"Illinois","Crawford County",1,35,253,145,108
050,17,033,"Illinois","Crawford County",1,36,239,139,100
050,17,033,"Illinois","Crawford County",1,37,253,151,102
050,17,033,"Illinois","Crawford County",1,38,249,137,112
050,17,033,"Illinois","Crawford County",1,39,243,144,99
050,17,033,"Illinois","Crawford County",1,40,251,157,94
050,17,033,"Illinois","Crawford County",1,41,255,149,106
050,17,033,"Illinois","Crawford County",1,42,240,137,103
050,17,033,"Illinois","Crawford County",1,43,229,125,104
050,17,033,"Illinois","Crawford County",1,44,227,123,104
050,17,033,"Illinois","Crawford County",1,45,216,117,99
050,17,033,"Illinois","Crawford County",1,46,217,125,92
050,17,033,"Illinois","Crawford County",1,47,237,133,104
050,17,033,"Illinois","Crawford County",1,48,248,142,106
050,17,033,"Illinois","Crawford County",1,49,240,131,109
050,17,033,"Illinois","Crawford County",1,50,247,143,104
050,17,033,"Illinois","Crawford County",1,51,220,121,99
050,17,033,"Illinois","Crawford County",1,52,218,114,104
050,17,033,"Illinois","Crawford County",1,53,218,121,97
050,17,033,"Illinois","Crawford County",1,54,234,124,110
050,17,033,"Illinois","Crawford County",1,55,272,144,128
050,17,033,"Illinois","Crawford County",1,56,278,136,142
050,17,033,"Illinois","Crawford County",1,57,271,131,140
050,17,033,"Illinois","Crawford County",1,58,289,154,135
050,17,033,"Illinois","Crawford County",1,59,283,153,130
050,17,033,"Illinois","Crawford County",1,60,277,146,131
050,17,033,"Illinois","Crawford County",1,61,285,146,139
050,17,033,"Illinois","Crawford County",1,62,265,134,131
050,17,033,"Illinois","Crawford County",1,63,275,143,132
050,17,033,"Illinois","Crawford County",1,64,247,120,127
050,17,033,"Illinois","Crawford County",1,65,254,124,130
050,17,033,"Illinois","Crawford County",1,66,247,129,118
050,17,033,"Illinois","Crawford County",1,67,244,124,120
050,17,033,"Illinois","Crawford County",1,68,220,111,109
050,17,033,"Illinois","Crawford County",1,69,202,91,111
050,17,033,"Illinois","Crawford County",1,70,203,93,110
050,17,033,"Illinois","Crawford County",1,71,198,94,104
050,17,033,"Illinois","Crawford County",1,72,208,93,115
050,17,033,"Illinois","Crawford County",1,73,198,92,106
050,17,033,"Illinois","Crawford County",1,74,149,73,76
050,17,033,"Illinois","Crawford County",1,75,140,68,72
050,17,033,"Illinois","Crawford County",1,76,118,51,67
050,17,033,"Illinois","Crawford County",1,77,134,59,75
050,17,033,"Illinois","Crawford County",1,78,120,56,64
050,17,033,"Illinois","Crawford County",1,79,100,43,57
050,17,033,"Illinois","Crawford County",1,80,100,38,62
050,17,033,"Illinois","Crawford County",1,81,94,35,59
050,17,033,"Illinois","Crawford County",1,82,94,38,56
050,17,033,"Illinois","Crawford County",1,83,84,37,47
050,17,033,"Illinois","Crawford County",1,84,82,36,46
050,17,033,"Illinois","Crawford County",1,85,421,132,289
050,17,033,"Illinois","Crawford County",2,0,188,100,88
050,17,033,"Illinois","Crawford County",2,1,190,100,90
050,17,033,"Illinois","Crawford County",2,2,194,103,91
050,17,033,"Illinois","Crawford County",2,3,207,109,98
050,17,033,"Illinois","Crawford County",2,4,208,107,101
050,17,033,"Illinois","Crawford County",2,5,201,95,106
050,17,033,"Illinois","Crawford County",2,6,202,95,107
050,17,033,"Illinois","Crawford County",2,7,204,103,101
050,17,033,"Illinois","Crawford County",2,8,201,92,109
050,17,033,"Illinois","Crawford County",2,9,209,102,107
050,17,033,"Illinois","Crawford County",2,10,226,120,106
050,17,033,"Illinois","Crawford County",2,11,224,119,105
050,17,033,"Illinois","Crawford County",2,12,226,118,108
050,17,033,"Illinois","Crawford County",2,13,225,111,114
050,17,033,"Illinois","Crawford County",2,14,230,115,115
050,17,033,"Illinois","Crawford County",2,15,229,122,107
050,17,033,"Illinois","Crawford County",2,16,217,115,102
050,17,033,"Illinois","Crawford County",2,17,223,109,114
050,17,033,"Illinois","Crawford County",2,18,187,96,91
050,17,033,"Illinois","Crawford County",2,19,164,92,72
050,17,033,"Illinois","Crawford County",2,20,182,111,71
050,17,033,"Illinois","Crawford County",2,21,184,109,75
050,17,033,"Illinois","Crawford County",2,22,196,110,86
050,17,033,"Illinois","Crawford County",2,23,208,112,96
050,17,033,"Illinois","Crawford County",2,24,215,120,95
050,17,033,"Illinois","Crawford County",2,25,228,138,90
050,17,033,"Illinois","Crawford County",2,26,230,135,95
050,17,033,"Illinois","Crawford County",2,27,227,136,91
050,17,033,"Illinois","Crawford County",2,28,247,152,95
050,17,033,"Illinois","Crawford County",2,29,250,135,115
050,17,033,"Illinois","Crawford County",2,30,262,139,123
050,17,033,"Illinois","Crawford County",2,31,240,134,106
050,17,033,"Illinois","Crawford County",2,32,241,142,99
050,17,033,"Illinois","Crawford County",2,33,233,131,102
050,17,033,"Illinois","Crawford County",2,34,253,142,111
050,17,033,"Illinois","Crawford County",2,35,251,141,110
050,17,033,"Illinois","Crawford County",2,36,245,142,103
050,17,033,"Illinois","Crawford County",2,37,257,154,103
050,17,033,"Illinois","Crawford County",2,38,248,138,110
050,17,033,"Illinois","Crawford County",2,39,245,144,101
050,17,033,"Illinois","Crawford County",2,40,251,154,97
050,17,033,"Illinois","Crawford County",2,41,249,146,103
050,17,033,"Illinois","Crawford County",2,42,244,142,102
050,17,033,"Illinois","Crawford County",2,43,232,128,104
050,17,033,"Illinois","Crawford County",2,44,225,123,102
050,17,033,"Illinois","Crawford County",2,45,219,119,100
050,17,033,"Illinois","Crawford County",2,46,215,123,92
050,17,033,"Illinois","Crawford County",2,47,231,130,101
050,17,033,"Illinois","Crawford County",2,48,245,140,105
050,17,033,"Illinois","Crawford County",2,49,243,134,109
050,17,033,"Illinois","Crawford County",2,50,243,140,103
050,17,033,"Illinois","Crawford County",2,51,225,126,99
050,17,033,"Illinois","Crawford County",2,52,216,114,102
050,17,033,"Illinois","Crawford County",2,53,217,120,97
050,17,033,"Illinois","Crawford County",2,54,226,121,105
050,17,033,"Illinois","Crawford County",2,55,264,141,123
050,17,033,"Illinois","Crawford County",2,56,276,135,141
050,17,033,"Illinois","Crawford County",2,57,274,132,142
050,17,033,"Illinois","Crawford County",2,58,286,151,135
050,17,033,"Illinois","Crawford County",2,59,284,153,131
050,17,033,"Illinois","Crawford County",2,60,277,147,130
050,17,033,"Illinois","Crawford County",2,61,281,145,136
050,17,033,"Illinois","Crawford County",2,62,269,137,132
050,17,033,"Illinois","Crawford County",2,63,275,143,132
050,17,033,"Illinois","Crawford County",2,64,250,121,129
050,17,033,"Illinois","Crawford County",2,65,251,122,129
050,17,033,"Illinois","Crawford County",2,66,248,127,121
050,17,033,"Illinois","Crawford County",2,67,242,124,118
050,17,033,"Illinois","Crawford County",2,68,227,114,113
050,17,033,"Illinois","Crawford County",2,69,207,96,111
050,17,033,"Illinois","Crawford County",2,70,200,92,108
050,17,033,"Illinois","Crawford County",2,71,201,95,106
050,17,033,"Illinois","Crawford County",2,72,201,91,110
050,17,033,"Illinois","Crawford County",2,73,209,97,112
050,17,033,"Illinois","Crawford County",2,74,152,73,79
050,17,033,"Illinois","Crawford County",2,75,143,70,73
050,17,033,"Illinois","Crawford County",2,76,121,54,67
050,17,033,"Illinois","Crawford County",2,77,133,58,75
050,17,033,"Illinois","Crawford County",2,78,119,55,64
050,17,033,"Illinois","Crawford County",2,79,103,46,57
050,17,033,"Illinois","Crawford County",2,80,97,37,60
050,17,033,"Illinois","Crawford County",2,81,96,36,60
050,17,033,"Illinois","Crawford County",2,82,93,36,57
050,17,033,"Illinois","Crawford County",2,83,84,36,48
050,17,033,"Illinois","Crawford County",2,84,80,35,45
050,17,033,"Illinois","Crawford County",2,85,430,139,291
050,17,033,"Illinois","Crawford County",3,0,178,79,99
050,17,033,"Illinois","Crawford County",3,1,193,104,89
050,17,033,"Illinois","Crawford County",3,2,198,108,90
050,17,033,"Illinois","Crawford County",3,3,201,103,98
050,17,033,"Illinois","Crawford County",3,4,209,113,96
050,17,033,"Illinois","Crawford County",3,5,206,106,100
050,17,033,"Illinois","Crawford County",3,6,198,92,106
050,17,033,"Illinois","Crawford County",3,7,212,98,114
050,17,033,"Illinois","Crawford County",3,8,204,100,104
050,17,033,"Illinois","Crawford County",3,9,197,88,109
050,17,033,"Illinois","Crawford County",3,10,223,107,116
050,17,033,"Illinois","Crawford County",3,11,221,118,103
050,17,033,"Illinois","Crawford County",3,12,221,120,101
050,17,033,"Illinois","Crawford County",3,13,228,117,111
050,17,033,"Illinois","Crawford County",3,14,220,110,110
050,17,033,"Illinois","Crawford County",3,15,224,114,110
050,17,033,"Illinois","Crawford County",3,16,230,131,99
050,17,033,"Illinois","Crawford County",3,17,231,119,112
050,17,033,"Illinois","Crawford County",3,18,195,99,96
050,17,033,"Illinois","Crawford County",3,19,153,82,71
050,17,033,"Illinois","Crawford County",3,20,181,99,82
050,17,033,"Illinois","Crawford County",3,21,181,106,75
050,17,033,"Illinois","Crawford County",3,22,209,122,87
050,17,033,"Illinois","Crawford County",3,23,216,123,93
050,17,033,"Illinois","Crawford County",3,24,206,114,92
050,17,033,"Illinois","Crawford County",3,25,239,139,100
050,17,033,"Illinois","Crawford County",3,26,237,145,92
050,17,033,"Illinois","Crawford County",3,27,245,145,100
050,17,033,"Illinois","Crawford County",3,28,257,153,104
050,17,033,"Illinois","Crawford County",3,29,241,138,103
050,17,033,"Illinois","Crawford County",3,30,258,146,112
050,17,033,"Illinois","Crawford County",3,31,257,137,120
050,17,033,"Illinois","Crawford County",3,32,253,143,110
050,17,033,"Illinois","Crawford County",3,33,231,134,97
050,17,033,"Illinois","Crawford County",3,34,244,146,98
050,17,033,"Illinois","Crawford County",3,35,238,125,113
050,17,033,"Illinois","Crawford County",3,36,269,151,118
050,17,033,"Illinois","Crawford County",3,37,265,167,98
050,17,033,"Illinois","Crawford County",3,38,250,143,107
050,17,033,"Illinois","Crawford County",3,39,256,147,109
050,17,033,"Illinois","Crawford County",3,40,236,136,100
050,17,033,"Illinois","Crawford County",3,41,248,149,99
050,17,033,"Illinois","Crawford County",3,42,264,158,106
050,17,033,"Illinois","Crawford County",3,43,232,134,98
050,17,033,"Illinois","Crawford County",3,44,238,136,102
050,17,033,"Illinois","Crawford County",3,45,218,116,102
050,17,033,"Illinois","Crawford County",3,46,228,126,102
050,17,033,"Illinois","Crawford County",3,47,212,120,92
050,17,033,"Illinois","Crawford County",3,48,237,136,101
050,17,033,"Illinois","Crawford County",3,49,244,134,110
050,17,033,"Illinois","Crawford County",3,50,240,131,109
050,17,033,"Illinois","Crawford County",3,51,239,139,100
050,17,033,"Illinois","Crawford County",3,52,226,123,103
050,17,033,"Illinois","Crawford County",3,53,214,111,103
050,17,033,"Illinois","Crawford County",3,54,210,113,97
050,17,033,"Illinois","Crawford County",3,55,232,123,109
050,17,033,"Illinois","Crawford County",3,56,253,135,118
050,17,033,"Illinois","Crawford County",3,57,272,135,137
050,17,033,"Illinois","Crawford County",3,58,280,141,139
050,17,033,"Illinois","Crawford County",3,59,277,147,130
050,17,033,"Illinois","Crawford County",3,60,273,148,125
050,17,033,"Illinois","Crawford County",3,61,277,152,125
050,17,033,"Illinois","Crawford County",3,62,273,137,136
050,17,033,"Illinois","Crawford County",3,63,263,134,129
050,17,033,"Illinois","Crawford County",3,64,266,137,129
050,17,033,"Illinois","Crawford County",3,65,247,121,126
050,17,033,"Illinois","Crawford County",3,66,245,120,125
050,17,033,"Illinois","Crawford County",3,67,233,114,119
050,17,033,"Illinois","Crawford County",3,68,243,122,121
050,17,033,"Illinois","Crawford County",3,69,227,110,117
050,17,033,"Illinois","Crawford County",3,70,207,98,109
050,17,033,"Illinois","Crawford County",3,71,194,90,104
050,17,033,"Illinois","Crawford County",3,72,192,89,103
050,17,033,"Illinois","Crawford County",3,73,186,84,102
050,17,033,"Illinois","Crawford County",3,74,198,91,107
050,17,033,"Illinois","Crawford County",3,75,148,70,78
050,17,033,"Illinois","Crawford County",3,76,134,65,69
050,17,033,"Illinois","Crawford County",3,77,112,46,66
050,17,033,"Illinois","Crawford County",3,78,124,54,70
050,17,033,"Illinois","Crawford County",3,79,115,53,62
050,17,033,"Illinois","Crawford County",3,80,102,46,56
050,17,033,"Illinois","Crawford County",3,81,89,34,55
050,17,033,"Illinois","Crawford County",3,82,77,23,54
050,17,033,"Illinois","Crawford County",3,83,79,33,46
050,17,033,"Illinois","Crawford County",3,84,74,29,45
050,17,033,"Illinois","Crawford County",3,85,431,143,288
050,17,033,"Illinois","Crawford County",4,0,159,81,78
050,17,033,"Illinois","Crawford County",4,1,172,77,95
050,17,033,"Illinois","Crawford County",4,2,192,102,90
050,17,033,"Illinois","Crawford County",4,3,205,114,91
050,17,033,"Illinois","Crawford County",4,4,196,104,92
050,17,033,"Illinois","Crawford County",4,5,211,115,96
050,17,033,"Illinois","Crawford County",4,6,207,105,102
050,17,033,"Illinois","Crawford County",4,7,200,93,107
050,17,033,"Illinois","Crawford County",4,8,210,99,111
050,17,033,"Illinois","Crawford County",4,9,199,101,98
050,17,033,"Illinois","Crawford County",4,10,210,96,114
050,17,033,"Illinois","Crawford County",4,11,217,102,115
050,17,033,"Illinois","Crawford County",4,12,226,120,106
050,17,033,"Illinois","Crawford County",4,13,219,116,103
050,17,033,"Illinois","Crawford County",4,14,225,115,110
050,17,033,"Illinois","Crawford County",4,15,226,111,115
050,17,033,"Illinois","Crawford County",4,16,228,118,110
050,17,033,"Illinois","Crawford County",4,17,235,137,98
050,17,033,"Illinois","Crawford County",4,18,195,107,88
050,17,033,"Illinois","Crawford County",4,19,156,83,73
050,17,033,"Illinois","Crawford County",4,20,161,85,76
050,17,033,"Illinois","Crawford County",4,21,191,104,87
050,17,033,"Illinois","Crawford County",4,22,191,113,78
050,17,033,"Illinois","Crawford County",4,23,235,135,100
050,17,033,"Illinois","Crawford County",4,24,208,117,91
050,17,033,"Illinois","Crawford County",4,25,209,121,88
050,17,033,"Illinois","Crawford County",4,26,232,131,101
050,17,033,"Illinois","Crawford County",4,27,243,149,94
050,17,033,"Illinois","Crawford County",4,28,244,147,97
050,17,033,"Illinois","Crawford County",4,29,237,134,103
050,17,033,"Illinois","Crawford County",4,30,251,146,105
050,17,033,"Illinois","Crawford County",4,31,244,133,111
050,17,033,"Illinois","Crawford County",4,32,270,152,118
050,17,033,"Illinois","Crawford County",4,33,254,139,115
050,17,033,"Illinois","Crawford County",4,34,242,142,100
050,17,033,"Illinois","Crawford County",4,35,220,122,98
050,17,033,"Illinois","Crawford County",4,36,251,128,123
050,17,033,"Illinois","Crawford County",4,37,283,167,116
050,17,033,"Illinois","Crawford County",4,38,253,154,99
050,17,033,"Illinois","Crawford County",4,39,252,147,105
050,17,033,"Illinois","Crawford County",4,40,241,139,102
050,17,033,"Illinois","Crawford County",4,41,224,125,99
050,17,033,"Illinois","Crawford County",4,42,257,154,103
050,17,033,"Illinois","Crawford County",4,43,258,148,110
050,17,033,"Illinois","Crawford County",4,44,228,134,94
050,17,033,"Illinois","Crawford County",4,45,233,127,106
050,17,033,"Illinois","Crawford County",4,46,220,118,102
050,17,033,"Illinois","Crawford County",4,47,227,124,103
050,17,033,"Illinois","Crawford County",4,48,221,127,94
050,17,033,"Illinois","Crawford County",4,49,219,122,97
050,17,033,"Illinois","Crawford County",4,50,238,126,112
050,17,033,"Illinois","Crawford County",4,51,240,131,109
050,17,033,"Illinois","Crawford County",4,52,233,131,102
050,17,033,"Illinois","Crawford County",4,53,228,123,105
050,17,033,"Illinois","Crawford County",4,54,212,109,103
050,17,033,"Illinois","Crawford County",4,55,217,120,97
050,17,033,"Illinois","Crawford County",4,56,216,113,103
050,17,033,"Illinois","Crawford County",4,57,243,127,116
050,17,033,"Illinois","Crawford County",4,58,274,135,139
050,17,033,"Illinois","Crawford County",4,59,270,131,139
050,17,033,"Illinois","Crawford County",4,60,272,144,128
050,17,033,"Illinois","Crawford County",4,61,273,152,121
050,17,033,"Illinois","Crawford County",4,62,272,144,128
050,17,033,"Illinois","Crawford County",4,63,266,135,131
050,17,033,"Illinois","Crawford County",4,64,257,130,127
050,17,033,"Illinois","Crawford County",4,65,256,130,126
050,17,033,"Illinois","Crawford County",4,66,249,122,127
050,17,033,"Illinois","Crawford County",4,67,232,111,121
050,17,033,"Illinois","Crawford County",4,68,230,109,121
050,17,033,"Illinois","Crawford County",4,69,233,117,116
050,17,033,"Illinois","Crawford County",4,70,226,109,117
050,17,033,"Illinois","Crawford County",4,71,202,97,105
050,17,033,"Illinois","Crawford County",4,72,189,87,102
050,17,033,"Illinois","Crawford County",4,73,182,84,98
050,17,033,"Illinois","Crawford County",4,74,180,79,101
050,17,033,"Illinois","Crawford County",4,75,189,88,101
050,17,033,"Illinois","Crawford County",4,76,145,70,75
050,17,033,"Illinois","Crawford County",4,77,126,57,69
050,17,033,"Illinois","Crawford County",4,78,105,44,61
050,17,033,"Illinois","Crawford County",4,79,118,51,67
050,17,033,"Illinois","Crawford County",4,80,107,46,61
050,17,033,"Illinois","Crawford County",4,81,93,42,51
050,17,033,"Illinois","Crawford County",4,82,77,31,46
050,17,033,"Illinois","Crawford County",4,83,70,20,50
050,17,033,"Illinois","Crawford County",4,84,69,29,40
050,17,033,"Illinois","Crawford County",4,85,419,138,281
050,17,033,"Illinois","Crawford County",5,0,145,72,73
050,17,033,"Illinois","Crawford County",5,1,158,80,78
050,17,033,"Illinois","Crawford County",5,2,162,72,90
050,17,033,"Illinois","Crawford County",5,3,185,96,89
050,17,033,"Illinois","Crawford County",5,4,202,111,91
050,17,033,"Illinois","Crawford County",5,5,192,98,94
050,17,033,"Illinois","Crawford County",5,6,200,104,96
050,17,033,"Illinois","Crawford County",5,7,203,105,98
050,17,033,"Illinois","Crawford County",5,8,205,96,109
050,17,033,"Illinois","Crawford County",5,9,214,100,114
050,17,033,"Illinois","Crawford County",5,10,195,99,96
050,17,033,"Illinois","Crawford County",5,11,203,94,109
050,17,033,"Illinois","Crawford County",5,12,208,99,109
050,17,033,"Illinois","Crawford County",5,13,222,118,104
050,17,033,"Illinois","Crawford County",5,14,218,110,108
050,17,033,"Illinois","Crawford County",5,15,227,118,109
050,17,033,"Illinois","Crawford County",5,16,231,116,115
050,17,033,"Illinois","Crawford County",5,17,230,122,108
050,17,033,"Illinois","Crawford County",5,18,200,121,79
050,17,033,"Illinois","Crawford County",5,19,165,92,73
050,17,033,"Illinois","Crawford County",5,20,175,91,84
050,17,033,"Illinois","Crawford County",5,21,169,92,77
050,17,033,"Illinois","Crawford County",5,22,205,118,87
050,17,033,"Illinois","Crawford County",5,23,207,127,80
050,17,033,"Illinois","Crawford County",5,24,220,129,91
050,17,033,"Illinois","Crawford County",5,25,222,129,93
050,17,033,"Illinois","Crawford County",5,26,206,119,87
050,17,033,"Illinois","Crawford County",5,27,242,143,99
050,17,033,"Illinois","Crawford County",5,28,247,156,91
050,17,033,"Illinois","Crawford County",5,29,229,130,99
050,17,033,"Illinois","Crawford County",5,30,234,134,100
050,17,033,"Illinois","Crawford County",5,31,237,139,98
050,17,033,"Illinois","Crawford County",5,32,256,142,114
050,17,033,"Illinois","Crawford County",5,33,263,146,117
050,17,033,"Illinois","Crawford County",5,34,267,155,112
050,17,033,"Illinois","Crawford County",5,35,222,123,99
050,17,033,"Illinois","Crawford County",5,36,236,132,104
050,17,033,"Illinois","Crawford County",5,37,268,144,124
050,17,033,"Illinois","Crawford County",5,38,267,153,114
050,17,033,"Illinois","Crawford County",5,39,253,153,100
050,17,033,"Illinois","Crawford County",5,40,245,143,102
050,17,033,"Illinois","Crawford County",5,41,230,131,99
050,17,033,"Illinois","Crawford County",5,42,243,140,103
050,17,033,"Illinois","Crawford County",5,43,252,149,103
050,17,033,"Illinois","Crawford County",5,44,248,144,104
050,17,033,"Illinois","Crawford County",5,45,220,124,96
050,17,033,"Illinois","Crawford County",5,46,228,126,102
050,17,033,"Illinois","Crawford County",5,47,210,114,96
050,17,033,"Illinois","Crawford County",5,48,223,123,100
050,17,033,"Illinois","Crawford County",5,49,211,117,94
050,17,033,"Illinois","Crawford County",5,50,211,114,97
050,17,033,"Illinois","Crawford County",5,51,243,129,114
050,17,033,"Illinois","Crawford County",5,52,238,130,108
050,17,033,"Illinois","Crawford County",5,53,233,131,102
050,17,033,"Illinois","Crawford County",5,54,214,112,102
050,17,033,"Illinois","Crawford County",5,55,225,119,106
050,17,033,"Illinois","Crawford County",5,56,221,118,103
050,17,033,"Illinois","Crawford County",5,57,216,110,106
050,17,033,"Illinois","Crawford County",5,58,249,135,114
050,17,033,"Illinois","Crawford County",5,59,270,130,140
050,17,033,"Illinois","Crawford County",5,60,272,135,137
050,17,033,"Illinois","Crawford County",5,61,277,149,128
050,17,033,"Illinois","Crawford County",5,62,262,140,122
050,17,033,"Illinois","Crawford County",5,63,272,147,125
050,17,033,"Illinois","Crawford County",5,64,261,128,133
050,17,033,"Illinois","Crawford County",5,65,253,127,126
050,17,033,"Illinois","Crawford County",5,66,252,131,121
050,17,033,"Illinois","Crawford County",5,67,237,111,126
050,17,033,"Illinois","Crawford County",5,68,226,108,118
050,17,033,"Illinois","Crawford County",5,69,228,105,123
050,17,033,"Illinois","Crawford County",5,70,232,117,115
050,17,033,"Illinois","Crawford County",5,71,217,106,111
050,17,033,"Illinois","Crawford County",5,72,190,90,100
050,17,033,"Illinois","Crawford County",5,73,181,82,99
050,17,033,"Illinois","Crawford County",5,74,174,78,96
050,17,033,"Illinois","Crawford County",5,75,173,76,97
050,17,033,"Illinois","Crawford County",5,76,176,83,93
050,17,033,"Illinois","Crawford County",5,77,136,62,74
050,17,033,"Illinois","Crawford County",5,78,120,54,66
050,17,033,"Illinois","Crawford County",5,79,101,43,58
050,17,033,"Illinois","Crawford County",5,80,110,44,66
050,17,033,"Illinois","Crawford County",5,81,97,41,56
050,17,033,"Illinois","Crawford County",5,82,80,38,42
050,17,033,"Illinois","Crawford County",5,83,68,26,42
050,17,033,"Illinois","Crawford County",5,84,64,18,46
050,17,033,"Illinois","Crawford County",5,85,421,137,284
050,17,035,"Illinois","Cumberland County",1,0,103,52,51
050,17,035,"Illinois","Cumberland County",1,1,116,52,64
050,17,035,"Illinois","Cumberland County",1,2,119,55,64
050,17,035,"Illinois","Cumberland County",1,3,127,70,57
050,17,035,"Illinois","Cumberland County",1,4,141,72,69
050,17,035,"Illinois","Cumberland County",1,5,127,62,65
050,17,035,"Illinois","Cumberland County",1,6,140,69,71
050,17,035,"Illinois","Cumberland County",1,7,141,72,69
050,17,035,"Illinois","Cumberland County",1,8,128,61,67
050,17,035,"Illinois","Cumberland County",1,9,119,62,57
050,17,035,"Illinois","Cumberland County",1,10,132,76,56
050,17,035,"Illinois","Cumberland County",1,11,139,81,58
050,17,035,"Illinois","Cumberland County",1,12,151,82,69
050,17,035,"Illinois","Cumberland County",1,13,140,63,77
050,17,035,"Illinois","Cumberland County",1,14,141,72,69
050,17,035,"Illinois","Cumberland County",1,15,141,75,66
050,17,035,"Illinois","Cumberland County",1,16,133,75,58
050,17,035,"Illinois","Cumberland County",1,17,138,80,58
050,17,035,"Illinois","Cumberland County",1,18,116,57,59
050,17,035,"Illinois","Cumberland County",1,19,82,40,42
050,17,035,"Illinois","Cumberland County",1,20,97,48,49
050,17,035,"Illinois","Cumberland County",1,21,85,42,43
050,17,035,"Illinois","Cumberland County",1,22,108,47,61
050,17,035,"Illinois","Cumberland County",1,23,114,56,58
050,17,035,"Illinois","Cumberland County",1,24,101,49,52
050,17,035,"Illinois","Cumberland County",1,25,102,52,50
050,17,035,"Illinois","Cumberland County",1,26,110,57,53
050,17,035,"Illinois","Cumberland County",1,27,105,54,51
050,17,035,"Illinois","Cumberland County",1,28,109,56,53
050,17,035,"Illinois","Cumberland County",1,29,122,62,60
050,17,035,"Illinois","Cumberland County",1,30,139,71,68
050,17,035,"Illinois","Cumberland County",1,31,117,57,60
050,17,035,"Illinois","Cumberland County",1,32,114,58,56
050,17,035,"Illinois","Cumberland County",1,33,112,60,52
050,17,035,"Illinois","Cumberland County",1,34,121,58,63
050,17,035,"Illinois","Cumberland County",1,35,137,71,66
050,17,035,"Illinois","Cumberland County",1,36,121,62,59
050,17,035,"Illinois","Cumberland County",1,37,121,62,59
050,17,035,"Illinois","Cumberland County",1,38,131,65,66
050,17,035,"Illinois","Cumberland County",1,39,129,65,64
050,17,035,"Illinois","Cumberland County",1,40,142,74,68
050,17,035,"Illinois","Cumberland County",1,41,129,64,65
050,17,035,"Illinois","Cumberland County",1,42,127,63,64
050,17,035,"Illinois","Cumberland County",1,43,119,59,60
050,17,035,"Illinois","Cumberland County",1,44,116,63,53
050,17,035,"Illinois","Cumberland County",1,45,121,70,51
050,17,035,"Illinois","Cumberland County",1,46,119,66,53
050,17,035,"Illinois","Cumberland County",1,47,115,60,55
050,17,035,"Illinois","Cumberland County",1,48,129,57,72
050,17,035,"Illinois","Cumberland County",1,49,136,68,68
050,17,035,"Illinois","Cumberland County",1,50,132,67,65
050,17,035,"Illinois","Cumberland County",1,51,134,71,63
050,17,035,"Illinois","Cumberland County",1,52,121,71,50
050,17,035,"Illinois","Cumberland County",1,53,126,66,60
050,17,035,"Illinois","Cumberland County",1,54,139,67,72
050,17,035,"Illinois","Cumberland County",1,55,147,75,72
050,17,035,"Illinois","Cumberland County",1,56,145,77,68
050,17,035,"Illinois","Cumberland County",1,57,158,83,75
050,17,035,"Illinois","Cumberland County",1,58,163,94,69
050,17,035,"Illinois","Cumberland County",1,59,166,79,87
050,17,035,"Illinois","Cumberland County",1,60,162,76,86
050,17,035,"Illinois","Cumberland County",1,61,168,87,81
050,17,035,"Illinois","Cumberland County",1,62,172,82,90
050,17,035,"Illinois","Cumberland County",1,63,167,79,88
050,17,035,"Illinois","Cumberland County",1,64,151,82,69
050,17,035,"Illinois","Cumberland County",1,65,149,77,72
050,17,035,"Illinois","Cumberland County",1,66,157,76,81
050,17,035,"Illinois","Cumberland County",1,67,129,68,61
050,17,035,"Illinois","Cumberland County",1,68,133,68,65
050,17,035,"Illinois","Cumberland County",1,69,124,57,67
050,17,035,"Illinois","Cumberland County",1,70,118,58,60
050,17,035,"Illinois","Cumberland County",1,71,119,56,63
050,17,035,"Illinois","Cumberland County",1,72,113,60,53
050,17,035,"Illinois","Cumberland County",1,73,99,55,44
050,17,035,"Illinois","Cumberland County",1,74,78,40,38
050,17,035,"Illinois","Cumberland County",1,75,73,32,41
050,17,035,"Illinois","Cumberland County",1,76,78,32,46
050,17,035,"Illinois","Cumberland County",1,77,85,40,45
050,17,035,"Illinois","Cumberland County",1,78,68,34,34
050,17,035,"Illinois","Cumberland County",1,79,55,27,28
050,17,035,"Illinois","Cumberland County",1,80,49,25,24
050,17,035,"Illinois","Cumberland County",1,81,53,24,29
050,17,035,"Illinois","Cumberland County",1,82,44,23,21
050,17,035,"Illinois","Cumberland County",1,83,41,21,20
050,17,035,"Illinois","Cumberland County",1,84,41,16,25
050,17,035,"Illinois","Cumberland County",1,85,274,104,170
050,17,035,"Illinois","Cumberland County",2,0,101,50,51
050,17,035,"Illinois","Cumberland County",2,1,115,52,63
050,17,035,"Illinois","Cumberland County",2,2,118,53,65
050,17,035,"Illinois","Cumberland County",2,3,126,66,60
050,17,035,"Illinois","Cumberland County",2,4,138,72,66
050,17,035,"Illinois","Cumberland County",2,5,130,64,66
050,17,035,"Illinois","Cumberland County",2,6,141,70,71
050,17,035,"Illinois","Cumberland County",2,7,141,72,69
050,17,035,"Illinois","Cumberland County",2,8,129,63,66
050,17,035,"Illinois","Cumberland County",2,9,120,61,59
050,17,035,"Illinois","Cumberland County",2,10,127,72,55
050,17,035,"Illinois","Cumberland County",2,11,137,81,56
050,17,035,"Illinois","Cumberland County",2,12,148,82,66
050,17,035,"Illinois","Cumberland County",2,13,142,68,74
050,17,035,"Illinois","Cumberland County",2,14,142,71,71
050,17,035,"Illinois","Cumberland County",2,15,141,74,67
050,17,035,"Illinois","Cumberland County",2,16,134,75,59
050,17,035,"Illinois","Cumberland County",2,17,138,80,58
050,17,035,"Illinois","Cumberland County",2,18,116,60,56
050,17,035,"Illinois","Cumberland County",2,19,85,41,44
050,17,035,"Illinois","Cumberland County",2,20,95,47,48
050,17,035,"Illinois","Cumberland County",2,21,88,44,44
050,17,035,"Illinois","Cumberland County",2,22,105,47,58
050,17,035,"Illinois","Cumberland County",2,23,114,55,59
050,17,035,"Illinois","Cumberland County",2,24,104,50,54
050,17,035,"Illinois","Cumberland County",2,25,103,52,51
050,17,035,"Illinois","Cumberland County",2,26,110,56,54
050,17,035,"Illinois","Cumberland County",2,27,106,54,52
050,17,035,"Illinois","Cumberland County",2,28,106,55,51
050,17,035,"Illinois","Cumberland County",2,29,119,60,59
050,17,035,"Illinois","Cumberland County",2,30,137,69,68
050,17,035,"Illinois","Cumberland County",2,31,122,60,62
050,17,035,"Illinois","Cumberland County",2,32,113,58,55
050,17,035,"Illinois","Cumberland County",2,33,113,60,53
050,17,035,"Illinois","Cumberland County",2,34,119,58,61
050,17,035,"Illinois","Cumberland County",2,35,134,69,65
050,17,035,"Illinois","Cumberland County",2,36,124,65,59
050,17,035,"Illinois","Cumberland County",2,37,121,61,60
050,17,035,"Illinois","Cumberland County",2,38,127,63,64
050,17,035,"Illinois","Cumberland County",2,39,129,65,64
050,17,035,"Illinois","Cumberland County",2,40,140,72,68
050,17,035,"Illinois","Cumberland County",2,41,132,66,66
050,17,035,"Illinois","Cumberland County",2,42,126,62,64
050,17,035,"Illinois","Cumberland County",2,43,122,60,62
050,17,035,"Illinois","Cumberland County",2,44,116,63,53
050,17,035,"Illinois","Cumberland County",2,45,120,69,51
050,17,035,"Illinois","Cumberland County",2,46,119,67,52
050,17,035,"Illinois","Cumberland County",2,47,116,61,55
050,17,035,"Illinois","Cumberland County",2,48,124,57,67
050,17,035,"Illinois","Cumberland County",2,49,135,66,69
050,17,035,"Illinois","Cumberland County",2,50,133,68,65
050,17,035,"Illinois","Cumberland County",2,51,131,68,63
050,17,035,"Illinois","Cumberland County",2,52,123,70,53
050,17,035,"Illinois","Cumberland County",2,53,124,67,57
050,17,035,"Illinois","Cumberland County",2,54,135,66,69
050,17,035,"Illinois","Cumberland County",2,55,145,74,71
050,17,035,"Illinois","Cumberland County",2,56,145,77,68
050,17,035,"Illinois","Cumberland County",2,57,153,81,72
050,17,035,"Illinois","Cumberland County",2,58,160,90,70
050,17,035,"Illinois","Cumberland County",2,59,166,83,83
050,17,035,"Illinois","Cumberland County",2,60,161,75,86
050,17,035,"Illinois","Cumberland County",2,61,164,84,80
050,17,035,"Illinois","Cumberland County",2,62,169,81,88
050,17,035,"Illinois","Cumberland County",2,63,169,80,89
050,17,035,"Illinois","Cumberland County",2,64,155,81,74
050,17,035,"Illinois","Cumberland County",2,65,149,79,70
050,17,035,"Illinois","Cumberland County",2,66,155,77,78
050,17,035,"Illinois","Cumberland County",2,67,137,71,66
050,17,035,"Illinois","Cumberland County",2,68,131,67,64
050,17,035,"Illinois","Cumberland County",2,69,126,59,67
050,17,035,"Illinois","Cumberland County",2,70,117,56,61
050,17,035,"Illinois","Cumberland County",2,71,120,57,63
050,17,035,"Illinois","Cumberland County",2,72,113,58,55
050,17,035,"Illinois","Cumberland County",2,73,107,59,48
050,17,035,"Illinois","Cumberland County",2,74,78,41,37
050,17,035,"Illinois","Cumberland County",2,75,74,34,40
050,17,035,"Illinois","Cumberland County",2,76,77,32,45
050,17,035,"Illinois","Cumberland County",2,77,82,36,46
050,17,035,"Illinois","Cumberland County",2,78,68,33,35
050,17,035,"Illinois","Cumberland County",2,79,54,27,27
050,17,035,"Illinois","Cumberland County",2,80,51,26,25
050,17,035,"Illinois","Cumberland County",2,81,52,24,28
050,17,035,"Illinois","Cumberland County",2,82,44,22,22
050,17,035,"Illinois","Cumberland County",2,83,41,21,20
050,17,035,"Illinois","Cumberland County",2,84,40,17,23
050,17,035,"Illinois","Cumberland County",2,85,276,104,172
050,17,035,"Illinois","Cumberland County",3,0,127,72,55
050,17,035,"Illinois","Cumberland County",3,1,96,47,49
050,17,035,"Illinois","Cumberland County",3,2,110,48,62
050,17,035,"Illinois","Cumberland County",3,3,106,51,55
050,17,035,"Illinois","Cumberland County",3,4,129,66,63
050,17,035,"Illinois","Cumberland County",3,5,134,71,63
050,17,035,"Illinois","Cumberland County",3,6,128,64,64
050,17,035,"Illinois","Cumberland County",3,7,142,68,74
050,17,035,"Illinois","Cumberland County",3,8,141,71,70
050,17,035,"Illinois","Cumberland County",3,9,126,63,63
050,17,035,"Illinois","Cumberland County",3,10,122,61,61
050,17,035,"Illinois","Cumberland County",3,11,134,78,56
050,17,035,"Illinois","Cumberland County",3,12,136,79,57
050,17,035,"Illinois","Cumberland County",3,13,148,77,71
050,17,035,"Illinois","Cumberland County",3,14,130,65,65
050,17,035,"Illinois","Cumberland County",3,15,143,72,71
050,17,035,"Illinois","Cumberland County",3,16,147,75,72
050,17,035,"Illinois","Cumberland County",3,17,129,72,57
050,17,035,"Illinois","Cumberland County",3,18,118,65,53
050,17,035,"Illinois","Cumberland County",3,19,91,45,46
050,17,035,"Illinois","Cumberland County",3,20,94,46,48
050,17,035,"Illinois","Cumberland County",3,21,93,46,47
050,17,035,"Illinois","Cumberland County",3,22,89,42,47
050,17,035,"Illinois","Cumberland County",3,23,105,51,54
050,17,035,"Illinois","Cumberland County",3,24,113,58,55
050,17,035,"Illinois","Cumberland County",3,25,98,45,53
050,17,035,"Illinois","Cumberland County",3,26,109,59,50
050,17,035,"Illinois","Cumberland County",3,27,109,55,54
050,17,035,"Illinois","Cumberland County",3,28,98,53,45
050,17,035,"Illinois","Cumberland County",3,29,99,48,51
050,17,035,"Illinois","Cumberland County",3,30,110,58,52
050,17,035,"Illinois","Cumberland County",3,31,139,71,68
050,17,035,"Illinois","Cumberland County",3,32,126,61,65
050,17,035,"Illinois","Cumberland County",3,33,108,55,53
050,17,035,"Illinois","Cumberland County",3,34,118,65,53
050,17,035,"Illinois","Cumberland County",3,35,122,57,65
050,17,035,"Illinois","Cumberland County",3,36,128,66,62
050,17,035,"Illinois","Cumberland County",3,37,125,65,60
050,17,035,"Illinois","Cumberland County",3,38,127,62,65
050,17,035,"Illinois","Cumberland County",3,39,129,62,67
050,17,035,"Illinois","Cumberland County",3,40,130,66,64
050,17,035,"Illinois","Cumberland County",3,41,135,68,67
050,17,035,"Illinois","Cumberland County",3,42,132,67,65
050,17,035,"Illinois","Cumberland County",3,43,128,61,67
050,17,035,"Illinois","Cumberland County",3,44,118,58,60
050,17,035,"Illinois","Cumberland County",3,45,117,62,55
050,17,035,"Illinois","Cumberland County",3,46,116,65,51
050,17,035,"Illinois","Cumberland County",3,47,122,68,54
050,17,035,"Illinois","Cumberland County",3,48,109,58,51
050,17,035,"Illinois","Cumberland County",3,49,122,56,66
050,17,035,"Illinois","Cumberland County",3,50,132,65,67
050,17,035,"Illinois","Cumberland County",3,51,133,67,66
050,17,035,"Illinois","Cumberland County",3,52,134,69,65
050,17,035,"Illinois","Cumberland County",3,53,124,72,52
050,17,035,"Illinois","Cumberland County",3,54,120,67,53
050,17,035,"Illinois","Cumberland County",3,55,130,63,67
050,17,035,"Illinois","Cumberland County",3,56,140,72,68
050,17,035,"Illinois","Cumberland County",3,57,149,81,68
050,17,035,"Illinois","Cumberland County",3,58,147,75,72
050,17,035,"Illinois","Cumberland County",3,59,157,87,70
050,17,035,"Illinois","Cumberland County",3,60,165,86,79
050,17,035,"Illinois","Cumberland County",3,61,164,75,89
050,17,035,"Illinois","Cumberland County",3,62,169,87,82
050,17,035,"Illinois","Cumberland County",3,63,172,84,88
050,17,035,"Illinois","Cumberland County",3,64,167,80,87
050,17,035,"Illinois","Cumberland County",3,65,154,80,74
050,17,035,"Illinois","Cumberland County",3,66,150,78,72
050,17,035,"Illinois","Cumberland County",3,67,151,71,80
050,17,035,"Illinois","Cumberland County",3,68,136,68,68
050,17,035,"Illinois","Cumberland County",3,69,126,64,62
050,17,035,"Illinois","Cumberland County",3,70,126,61,65
050,17,035,"Illinois","Cumberland County",3,71,117,56,61
050,17,035,"Illinois","Cumberland County",3,72,120,56,64
050,17,035,"Illinois","Cumberland County",3,73,109,53,56
050,17,035,"Illinois","Cumberland County",3,74,100,53,47
050,17,035,"Illinois","Cumberland County",3,75,78,39,39
050,17,035,"Illinois","Cumberland County",3,76,74,35,39
050,17,035,"Illinois","Cumberland County",3,77,75,30,45
050,17,035,"Illinois","Cumberland County",3,78,77,33,44
050,17,035,"Illinois","Cumberland County",3,79,70,33,37
050,17,035,"Illinois","Cumberland County",3,80,51,27,24
050,17,035,"Illinois","Cumberland County",3,81,46,24,22
050,17,035,"Illinois","Cumberland County",3,82,46,23,23
050,17,035,"Illinois","Cumberland County",3,83,39,17,22
050,17,035,"Illinois","Cumberland County",3,84,36,19,17
050,17,035,"Illinois","Cumberland County",3,85,263,101,162
050,17,035,"Illinois","Cumberland County",4,0,106,52,54
050,17,035,"Illinois","Cumberland County",4,1,129,70,59
050,17,035,"Illinois","Cumberland County",4,2,106,53,53
050,17,035,"Illinois","Cumberland County",4,3,113,52,61
050,17,035,"Illinois","Cumberland County",4,4,108,52,56
050,17,035,"Illinois","Cumberland County",4,5,125,64,61
050,17,035,"Illinois","Cumberland County",4,6,135,72,63
050,17,035,"Illinois","Cumberland County",4,7,125,60,65
050,17,035,"Illinois","Cumberland County",4,8,142,71,71
050,17,035,"Illinois","Cumberland County",4,9,131,66,65
050,17,035,"Illinois","Cumberland County",4,10,124,59,65
050,17,035,"Illinois","Cumberland County",4,11,118,54,64
050,17,035,"Illinois","Cumberland County",4,12,127,76,51
050,17,035,"Illinois","Cumberland County",4,13,136,77,59
050,17,035,"Illinois","Cumberland County",4,14,150,80,70
050,17,035,"Illinois","Cumberland County",4,15,145,72,73
050,17,035,"Illinois","Cumberland County",4,16,150,74,76
050,17,035,"Illinois","Cumberland County",4,17,146,77,69
050,17,035,"Illinois","Cumberland County",4,18,113,61,52
050,17,035,"Illinois","Cumberland County",4,19,89,49,40
050,17,035,"Illinois","Cumberland County",4,20,91,47,44
050,17,035,"Illinois","Cumberland County",4,21,100,49,51
050,17,035,"Illinois","Cumberland County",4,22,106,49,57
050,17,035,"Illinois","Cumberland County",4,23,95,50,45
050,17,035,"Illinois","Cumberland County",4,24,106,51,55
050,17,035,"Illinois","Cumberland County",4,25,114,61,53
050,17,035,"Illinois","Cumberland County",4,26,98,43,55
050,17,035,"Illinois","Cumberland County",4,27,107,55,52
050,17,035,"Illinois","Cumberland County",4,28,108,56,52
050,17,035,"Illinois","Cumberland County",4,29,111,58,53
050,17,035,"Illinois","Cumberland County",4,30,104,51,53
050,17,035,"Illinois","Cumberland County",4,31,107,51,56
050,17,035,"Illinois","Cumberland County",4,32,134,66,68
050,17,035,"Illinois","Cumberland County",4,33,122,58,64
050,17,035,"Illinois","Cumberland County",4,34,107,54,53
050,17,035,"Illinois","Cumberland County",4,35,118,65,53
050,17,035,"Illinois","Cumberland County",4,36,122,53,69
050,17,035,"Illinois","Cumberland County",4,37,128,69,59
050,17,035,"Illinois","Cumberland County",4,38,122,62,60
050,17,035,"Illinois","Cumberland County",4,39,134,67,67
050,17,035,"Illinois","Cumberland County",4,40,135,66,69
050,17,035,"Illinois","Cumberland County",4,41,131,67,64
050,17,035,"Illinois","Cumberland County",4,42,129,67,62
050,17,035,"Illinois","Cumberland County",4,43,135,65,70
050,17,035,"Illinois","Cumberland County",4,44,126,61,65
050,17,035,"Illinois","Cumberland County",4,45,116,55,61
050,17,035,"Illinois","Cumberland County",4,46,121,66,55
050,17,035,"Illinois","Cumberland County",4,47,114,61,53
050,17,035,"Illinois","Cumberland County",4,48,123,68,55
050,17,035,"Illinois","Cumberland County",4,49,109,58,51
050,17,035,"Illinois","Cumberland County",4,50,120,55,65
050,17,035,"Illinois","Cumberland County",4,51,131,60,71
050,17,035,"Illinois","Cumberland County",4,52,131,66,65
050,17,035,"Illinois","Cumberland County",4,53,128,66,62
050,17,035,"Illinois","Cumberland County",4,54,123,70,53
050,17,035,"Illinois","Cumberland County",4,55,119,65,54
050,17,035,"Illinois","Cumberland County",4,56,135,63,72
050,17,035,"Illinois","Cumberland County",4,57,142,74,68
050,17,035,"Illinois","Cumberland County",4,58,147,79,68
050,17,035,"Illinois","Cumberland County",4,59,145,71,74
050,17,035,"Illinois","Cumberland County",4,60,157,87,70
050,17,035,"Illinois","Cumberland County",4,61,171,88,83
050,17,035,"Illinois","Cumberland County",4,62,157,74,83
050,17,035,"Illinois","Cumberland County",4,63,159,81,78
050,17,035,"Illinois","Cumberland County",4,64,168,84,84
050,17,035,"Illinois","Cumberland County",4,65,166,80,86
050,17,035,"Illinois","Cumberland County",4,66,151,79,72
050,17,035,"Illinois","Cumberland County",4,67,147,79,68
050,17,035,"Illinois","Cumberland County",4,68,143,68,75
050,17,035,"Illinois","Cumberland County",4,69,136,66,70
050,17,035,"Illinois","Cumberland County",4,70,119,61,58
050,17,035,"Illinois","Cumberland County",4,71,121,61,60
050,17,035,"Illinois","Cumberland County",4,72,114,58,56
050,17,035,"Illinois","Cumberland County",4,73,109,49,60
050,17,035,"Illinois","Cumberland County",4,74,104,49,55
050,17,035,"Illinois","Cumberland County",4,75,93,50,43
050,17,035,"Illinois","Cumberland County",4,76,77,38,39
050,17,035,"Illinois","Cumberland County",4,77,70,32,38
050,17,035,"Illinois","Cumberland County",4,78,70,29,41
050,17,035,"Illinois","Cumberland County",4,79,74,32,42
050,17,035,"Illinois","Cumberland County",4,80,66,30,36
050,17,035,"Illinois","Cumberland County",4,81,51,26,25
050,17,035,"Illinois","Cumberland County",4,82,36,20,16
050,17,035,"Illinois","Cumberland County",4,83,41,20,21
050,17,035,"Illinois","Cumberland County",4,84,37,16,21
050,17,035,"Illinois","Cumberland County",4,85,259,105,154
050,17,035,"Illinois","Cumberland County",5,0,98,49,49
050,17,035,"Illinois","Cumberland County",5,1,107,47,60
050,17,035,"Illinois","Cumberland County",5,2,123,66,57
050,17,035,"Illinois","Cumberland County",5,3,115,63,52
050,17,035,"Illinois","Cumberland County",5,4,121,55,66
050,17,035,"Illinois","Cumberland County",5,5,106,52,54
050,17,035,"Illinois","Cumberland County",5,6,123,62,61
050,17,035,"Illinois","Cumberland County",5,7,135,71,64
050,17,035,"Illinois","Cumberland County",5,8,125,61,64
050,17,035,"Illinois","Cumberland County",5,9,140,70,70
050,17,035,"Illinois","Cumberland County",5,10,132,65,67
050,17,035,"Illinois","Cumberland County",5,11,127,62,65
050,17,035,"Illinois","Cumberland County",5,12,120,58,62
050,17,035,"Illinois","Cumberland County",5,13,131,77,54
050,17,035,"Illinois","Cumberland County",5,14,135,82,53
050,17,035,"Illinois","Cumberland County",5,15,152,81,71
050,17,035,"Illinois","Cumberland County",5,16,139,70,69
050,17,035,"Illinois","Cumberland County",5,17,138,70,68
050,17,035,"Illinois","Cumberland County",5,18,120,66,54
050,17,035,"Illinois","Cumberland County",5,19,84,45,39
050,17,035,"Illinois","Cumberland County",5,20,108,60,48
050,17,035,"Illinois","Cumberland County",5,21,95,53,42
050,17,035,"Illinois","Cumberland County",5,22,110,54,56
050,17,035,"Illinois","Cumberland County",5,23,100,48,52
050,17,035,"Illinois","Cumberland County",5,24,96,49,47
050,17,035,"Illinois","Cumberland County",5,25,105,51,54
050,17,035,"Illinois","Cumberland County",5,26,115,61,54
050,17,035,"Illinois","Cumberland County",5,27,95,44,51
050,17,035,"Illinois","Cumberland County",5,28,111,58,53
050,17,035,"Illinois","Cumberland County",5,29,114,57,57
050,17,035,"Illinois","Cumberland County",5,30,107,54,53
050,17,035,"Illinois","Cumberland County",5,31,104,50,54
050,17,035,"Illinois","Cumberland County",5,32,108,52,56
050,17,035,"Illinois","Cumberland County",5,33,142,69,73
050,17,035,"Illinois","Cumberland County",5,34,123,62,61
050,17,035,"Illinois","Cumberland County",5,35,106,55,51
050,17,035,"Illinois","Cumberland County",5,36,124,70,54
050,17,035,"Illinois","Cumberland County",5,37,123,53,70
050,17,035,"Illinois","Cumberland County",5,38,129,67,62
050,17,035,"Illinois","Cumberland County",5,39,122,62,60
050,17,035,"Illinois","Cumberland County",5,40,139,67,72
050,17,035,"Illinois","Cumberland County",5,41,134,65,69
050,17,035,"Illinois","Cumberland County",5,42,123,63,60
050,17,035,"Illinois","Cumberland County",5,43,126,64,62
050,17,035,"Illinois","Cumberland County",5,44,134,64,70
050,17,035,"Illinois","Cumberland County",5,45,123,59,64
050,17,035,"Illinois","Cumberland County",5,46,115,55,60
050,17,035,"Illinois","Cumberland County",5,47,117,64,53
050,17,035,"Illinois","Cumberland County",5,48,112,59,53
050,17,035,"Illinois","Cumberland County",5,49,119,67,52
050,17,035,"Illinois","Cumberland County",5,50,116,62,54
050,17,035,"Illinois","Cumberland County",5,51,121,52,69
050,17,035,"Illinois","Cumberland County",5,52,133,62,71
050,17,035,"Illinois","Cumberland County",5,53,130,65,65
050,17,035,"Illinois","Cumberland County",5,54,130,68,62
050,17,035,"Illinois","Cumberland County",5,55,123,72,51
050,17,035,"Illinois","Cumberland County",5,56,118,64,54
050,17,035,"Illinois","Cumberland County",5,57,134,62,72
050,17,035,"Illinois","Cumberland County",5,58,138,70,68
050,17,035,"Illinois","Cumberland County",5,59,146,77,69
050,17,035,"Illinois","Cumberland County",5,60,148,72,76
050,17,035,"Illinois","Cumberland County",5,61,156,86,70
050,17,035,"Illinois","Cumberland County",5,62,168,86,82
050,17,035,"Illinois","Cumberland County",5,63,154,73,81
050,17,035,"Illinois","Cumberland County",5,64,155,81,74
050,17,035,"Illinois","Cumberland County",5,65,163,82,81
050,17,035,"Illinois","Cumberland County",5,66,161,77,84
050,17,035,"Illinois","Cumberland County",5,67,150,78,72
050,17,035,"Illinois","Cumberland County",5,68,142,78,64
050,17,035,"Illinois","Cumberland County",5,69,143,67,76
050,17,035,"Illinois","Cumberland County",5,70,132,64,68
050,17,035,"Illinois","Cumberland County",5,71,119,62,57
050,17,035,"Illinois","Cumberland County",5,72,120,62,58
050,17,035,"Illinois","Cumberland County",5,73,104,52,52
050,17,035,"Illinois","Cumberland County",5,74,106,47,59
050,17,035,"Illinois","Cumberland County",5,75,100,47,53
050,17,035,"Illinois","Cumberland County",5,76,89,47,42
050,17,035,"Illinois","Cumberland County",5,77,75,36,39
050,17,035,"Illinois","Cumberland County",5,78,64,30,34
050,17,035,"Illinois","Cumberland County",5,79,67,25,42
050,17,035,"Illinois","Cumberland County",5,80,71,32,39
050,17,035,"Illinois","Cumberland County",5,81,65,29,36
050,17,035,"Illinois","Cumberland County",5,82,40,22,18
050,17,035,"Illinois","Cumberland County",5,83,32,17,15
050,17,035,"Illinois","Cumberland County",5,84,34,16,18
050,17,035,"Illinois","Cumberland County",5,85,264,109,155
050,17,037,"Illinois","DeKalb County",1,0,1044,532,512
050,17,037,"Illinois","DeKalb County",1,1,1081,540,541
050,17,037,"Illinois","DeKalb County",1,2,1065,556,509
050,17,037,"Illinois","DeKalb County",1,3,1135,570,565
050,17,037,"Illinois","DeKalb County",1,4,1250,646,604
050,17,037,"Illinois","DeKalb County",1,5,1288,667,621
050,17,037,"Illinois","DeKalb County",1,6,1221,625,596
050,17,037,"Illinois","DeKalb County",1,7,1213,600,613
050,17,037,"Illinois","DeKalb County",1,8,1243,639,604
050,17,037,"Illinois","DeKalb County",1,9,1241,655,586
050,17,037,"Illinois","DeKalb County",1,10,1286,670,616
050,17,037,"Illinois","DeKalb County",1,11,1250,625,625
050,17,037,"Illinois","DeKalb County",1,12,1279,640,639
050,17,037,"Illinois","DeKalb County",1,13,1295,654,641
050,17,037,"Illinois","DeKalb County",1,14,1310,671,639
050,17,037,"Illinois","DeKalb County",1,15,1282,672,610
050,17,037,"Illinois","DeKalb County",1,16,1227,647,580
050,17,037,"Illinois","DeKalb County",1,17,1310,664,646
050,17,037,"Illinois","DeKalb County",1,18,1992,1017,975
050,17,037,"Illinois","DeKalb County",1,19,2755,1335,1420
050,17,037,"Illinois","DeKalb County",1,20,2974,1424,1550
050,17,037,"Illinois","DeKalb County",1,21,3406,1733,1673
050,17,037,"Illinois","DeKalb County",1,22,3007,1410,1597
050,17,037,"Illinois","DeKalb County",1,23,2402,1266,1136
050,17,037,"Illinois","DeKalb County",1,24,1912,971,941
050,17,037,"Illinois","DeKalb County",1,25,1626,822,804
050,17,037,"Illinois","DeKalb County",1,26,1473,716,757
050,17,037,"Illinois","DeKalb County",1,27,1357,668,689
050,17,037,"Illinois","DeKalb County",1,28,1307,631,676
050,17,037,"Illinois","DeKalb County",1,29,1291,656,635
050,17,037,"Illinois","DeKalb County",1,30,1205,613,592
050,17,037,"Illinois","DeKalb County",1,31,1223,616,607
050,17,037,"Illinois","DeKalb County",1,32,1300,656,644
050,17,037,"Illinois","DeKalb County",1,33,1199,639,560
050,17,037,"Illinois","DeKalb County",1,34,1224,642,582
050,17,037,"Illinois","DeKalb County",1,35,1195,604,591
050,17,037,"Illinois","DeKalb County",1,36,1211,594,617
050,17,037,"Illinois","DeKalb County",1,37,1242,640,602
050,17,037,"Illinois","DeKalb County",1,38,1255,629,626
050,17,037,"Illinois","DeKalb County",1,39,1247,629,618
050,17,037,"Illinois","DeKalb County",1,40,1239,633,606
050,17,037,"Illinois","DeKalb County",1,41,1183,621,562
050,17,037,"Illinois","DeKalb County",1,42,1074,554,520
050,17,037,"Illinois","DeKalb County",1,43,1040,510,530
050,17,037,"Illinois","DeKalb County",1,44,1047,532,515
050,17,037,"Illinois","DeKalb County",1,45,997,507,490
050,17,037,"Illinois","DeKalb County",1,46,986,489,497
050,17,037,"Illinois","DeKalb County",1,47,1029,523,506
050,17,037,"Illinois","DeKalb County",1,48,1113,575,538
050,17,037,"Illinois","DeKalb County",1,49,1136,578,558
050,17,037,"Illinois","DeKalb County",1,50,1090,552,538
050,17,037,"Illinois","DeKalb County",1,51,1068,533,535
050,17,037,"Illinois","DeKalb County",1,52,1047,532,515
050,17,037,"Illinois","DeKalb County",1,53,1049,537,512
050,17,037,"Illinois","DeKalb County",1,54,1083,549,534
050,17,037,"Illinois","DeKalb County",1,55,1139,561,578
050,17,037,"Illinois","DeKalb County",1,56,1166,587,579
050,17,037,"Illinois","DeKalb County",1,57,1162,576,586
050,17,037,"Illinois","DeKalb County",1,58,1188,577,611
050,17,037,"Illinois","DeKalb County",1,59,1185,589,596
050,17,037,"Illinois","DeKalb County",1,60,1162,586,576
050,17,037,"Illinois","DeKalb County",1,61,1138,568,570
050,17,037,"Illinois","DeKalb County",1,62,1109,580,529
050,17,037,"Illinois","DeKalb County",1,63,1046,543,503
050,17,037,"Illinois","DeKalb County",1,64,1015,501,514
050,17,037,"Illinois","DeKalb County",1,65,973,480,493
050,17,037,"Illinois","DeKalb County",1,66,893,431,462
050,17,037,"Illinois","DeKalb County",1,67,889,434,455
050,17,037,"Illinois","DeKalb County",1,68,863,419,444
050,17,037,"Illinois","DeKalb County",1,69,784,369,415
050,17,037,"Illinois","DeKalb County",1,70,760,374,386
050,17,037,"Illinois","DeKalb County",1,71,706,333,373
050,17,037,"Illinois","DeKalb County",1,72,723,328,395
050,17,037,"Illinois","DeKalb County",1,73,715,342,373
050,17,037,"Illinois","DeKalb County",1,74,474,237,237
050,17,037,"Illinois","DeKalb County",1,75,484,225,259
050,17,037,"Illinois","DeKalb County",1,76,483,211,272
050,17,037,"Illinois","DeKalb County",1,77,482,216,266
050,17,037,"Illinois","DeKalb County",1,78,404,175,229
050,17,037,"Illinois","DeKalb County",1,79,385,166,219
050,17,037,"Illinois","DeKalb County",1,80,352,155,197
050,17,037,"Illinois","DeKalb County",1,81,314,132,182
050,17,037,"Illinois","DeKalb County",1,82,291,117,174
050,17,037,"Illinois","DeKalb County",1,83,285,123,162
050,17,037,"Illinois","DeKalb County",1,84,273,106,167
050,17,037,"Illinois","DeKalb County",1,85,1575,549,1026
050,17,037,"Illinois","DeKalb County",2,0,1097,548,549
050,17,037,"Illinois","DeKalb County",2,1,1069,537,532
050,17,037,"Illinois","DeKalb County",2,2,1074,552,522
050,17,037,"Illinois","DeKalb County",2,3,1117,566,551
050,17,037,"Illinois","DeKalb County",2,4,1222,627,595
050,17,037,"Illinois","DeKalb County",2,5,1274,657,617
050,17,037,"Illinois","DeKalb County",2,6,1241,638,603
050,17,037,"Illinois","DeKalb County",2,7,1210,603,607
050,17,037,"Illinois","DeKalb County",2,8,1230,627,603
050,17,037,"Illinois","DeKalb County",2,9,1239,653,586
050,17,037,"Illinois","DeKalb County",2,10,1271,661,610
050,17,037,"Illinois","DeKalb County",2,11,1250,632,618
050,17,037,"Illinois","DeKalb County",2,12,1280,640,640
050,17,037,"Illinois","DeKalb County",2,13,1291,651,640
050,17,037,"Illinois","DeKalb County",2,14,1303,665,638
050,17,037,"Illinois","DeKalb County",2,15,1285,672,613
050,17,037,"Illinois","DeKalb County",2,16,1243,652,591
050,17,037,"Illinois","DeKalb County",2,17,1290,658,632
050,17,037,"Illinois","DeKalb County",2,18,1974,1004,970
050,17,037,"Illinois","DeKalb County",2,19,2759,1332,1427
050,17,037,"Illinois","DeKalb County",2,20,3010,1442,1568
050,17,037,"Illinois","DeKalb County",2,21,3395,1728,1667
050,17,037,"Illinois","DeKalb County",2,22,2998,1413,1585
050,17,037,"Illinois","DeKalb County",2,23,2372,1251,1121
050,17,037,"Illinois","DeKalb County",2,24,1873,950,923
050,17,037,"Illinois","DeKalb County",2,25,1620,819,801
050,17,037,"Illinois","DeKalb County",2,26,1462,718,744
050,17,037,"Illinois","DeKalb County",2,27,1345,658,687
050,17,037,"Illinois","DeKalb County",2,28,1317,640,677
050,17,037,"Illinois","DeKalb County",2,29,1281,641,640
050,17,037,"Illinois","DeKalb County",2,30,1229,622,607
050,17,037,"Illinois","DeKalb County",2,31,1222,616,606
050,17,037,"Illinois","DeKalb County",2,32,1275,644,631
050,17,037,"Illinois","DeKalb County",2,33,1218,640,578
050,17,037,"Illinois","DeKalb County",2,34,1219,642,577
050,17,037,"Illinois","DeKalb County",2,35,1199,609,590
050,17,037,"Illinois","DeKalb County",2,36,1191,588,603
050,17,037,"Illinois","DeKalb County",2,37,1232,627,605
050,17,037,"Illinois","DeKalb County",2,38,1255,632,623
050,17,037,"Illinois","DeKalb County",2,39,1247,629,618
050,17,037,"Illinois","DeKalb County",2,40,1247,638,609
050,17,037,"Illinois","DeKalb County",2,41,1187,619,568
050,17,037,"Illinois","DeKalb County",2,42,1084,561,523
050,17,037,"Illinois","DeKalb County",2,43,1049,522,527
050,17,037,"Illinois","DeKalb County",2,44,1033,519,514
050,17,037,"Illinois","DeKalb County",2,45,1009,513,496
050,17,037,"Illinois","DeKalb County",2,46,985,492,493
050,17,037,"Illinois","DeKalb County",2,47,1017,513,504
050,17,037,"Illinois","DeKalb County",2,48,1087,560,527
050,17,037,"Illinois","DeKalb County",2,49,1128,579,549
050,17,037,"Illinois","DeKalb County",2,50,1098,557,541
050,17,037,"Illinois","DeKalb County",2,51,1071,538,533
050,17,037,"Illinois","DeKalb County",2,52,1047,528,519
050,17,037,"Illinois","DeKalb County",2,53,1044,535,509
050,17,037,"Illinois","DeKalb County",2,54,1068,542,526
050,17,037,"Illinois","DeKalb County",2,55,1120,557,563
050,17,037,"Illinois","DeKalb County",2,56,1151,578,573
050,17,037,"Illinois","DeKalb County",2,57,1160,578,582
050,17,037,"Illinois","DeKalb County",2,58,1174,573,601
050,17,037,"Illinois","DeKalb County",2,59,1178,583,595
050,17,037,"Illinois","DeKalb County",2,60,1154,578,576
050,17,037,"Illinois","DeKalb County",2,61,1131,565,566
050,17,037,"Illinois","DeKalb County",2,62,1112,573,539
050,17,037,"Illinois","DeKalb County",2,63,1066,554,512
050,17,037,"Illinois","DeKalb County",2,64,1009,504,505
050,17,037,"Illinois","DeKalb County",2,65,979,484,495
050,17,037,"Illinois","DeKalb County",2,66,911,440,471
050,17,037,"Illinois","DeKalb County",2,67,884,430,454
050,17,037,"Illinois","DeKalb County",2,68,857,417,440
050,17,037,"Illinois","DeKalb County",2,69,801,381,420
050,17,037,"Illinois","DeKalb County",2,70,757,370,387
050,17,037,"Illinois","DeKalb County",2,71,718,341,377
050,17,037,"Illinois","DeKalb County",2,72,704,322,382
050,17,037,"Illinois","DeKalb County",2,73,743,347,396
050,17,037,"Illinois","DeKalb County",2,74,496,243,253
050,17,037,"Illinois","DeKalb County",2,75,481,227,254
050,17,037,"Illinois","DeKalb County",2,76,477,214,263
050,17,037,"Illinois","DeKalb County",2,77,486,215,271
050,17,037,"Illinois","DeKalb County",2,78,409,179,230
050,17,037,"Illinois","DeKalb County",2,79,385,165,220
050,17,037,"Illinois","DeKalb County",2,80,357,157,200
050,17,037,"Illinois","DeKalb County",2,81,318,137,181
050,17,037,"Illinois","DeKalb County",2,82,297,118,179
050,17,037,"Illinois","DeKalb County",2,83,281,120,161
050,17,037,"Illinois","DeKalb County",2,84,270,106,164
050,17,037,"Illinois","DeKalb County",2,85,1570,551,1019
050,17,037,"Illinois","DeKalb County",3,0,1016,539,477
050,17,037,"Illinois","DeKalb County",3,1,1128,568,560
050,17,037,"Illinois","DeKalb County",3,2,1080,546,534
050,17,037,"Illinois","DeKalb County",3,3,1105,579,526
050,17,037,"Illinois","DeKalb County",3,4,1138,580,558
050,17,037,"Illinois","DeKalb County",3,5,1230,625,605
050,17,037,"Illinois","DeKalb County",3,6,1300,665,635
050,17,037,"Illinois","DeKalb County",3,7,1257,640,617
050,17,037,"Illinois","DeKalb County",3,8,1226,614,612
050,17,037,"Illinois","DeKalb County",3,9,1237,635,602
050,17,037,"Illinois","DeKalb County",3,10,1246,649,597
050,17,037,"Illinois","DeKalb County",3,11,1277,660,617
050,17,037,"Illinois","DeKalb County",3,12,1273,649,624
050,17,037,"Illinois","DeKalb County",3,13,1306,647,659
050,17,037,"Illinois","DeKalb County",3,14,1292,653,639
050,17,037,"Illinois","DeKalb County",3,15,1308,683,625
050,17,037,"Illinois","DeKalb County",3,16,1302,674,628
050,17,037,"Illinois","DeKalb County",3,17,1250,650,600
050,17,037,"Illinois","DeKalb County",3,18,1987,1013,974
050,17,037,"Illinois","DeKalb County",3,19,2744,1323,1421
050,17,037,"Illinois","DeKalb County",3,20,3055,1459,1596
050,17,037,"Illinois","DeKalb County",3,21,3445,1755,1690
050,17,037,"Illinois","DeKalb County",3,22,3050,1446,1604
050,17,037,"Illinois","DeKalb County",3,23,2298,1208,1090
050,17,037,"Illinois","DeKalb County",3,24,1781,890,891
050,17,037,"Illinois","DeKalb County",3,25,1583,790,793
050,17,037,"Illinois","DeKalb County",3,26,1452,737,715
050,17,037,"Illinois","DeKalb County",3,27,1322,630,692
050,17,037,"Illinois","DeKalb County",3,28,1324,649,675
050,17,037,"Illinois","DeKalb County",3,29,1343,658,685
050,17,037,"Illinois","DeKalb County",3,30,1298,642,656
050,17,037,"Illinois","DeKalb County",3,31,1230,627,603
050,17,037,"Illinois","DeKalb County",3,32,1212,603,609
050,17,037,"Illinois","DeKalb County",3,33,1294,647,647
050,17,037,"Illinois","DeKalb County",3,34,1224,645,579
050,17,037,"Illinois","DeKalb County",3,35,1219,643,576
050,17,037,"Illinois","DeKalb County",3,36,1188,613,575
050,17,037,"Illinois","DeKalb County",3,37,1169,572,597
050,17,037,"Illinois","DeKalb County",3,38,1229,632,597
050,17,037,"Illinois","DeKalb County",3,39,1250,631,619
050,17,037,"Illinois","DeKalb County",3,40,1238,620,618
050,17,037,"Illinois","DeKalb County",3,41,1242,634,608
050,17,037,"Illinois","DeKalb County",3,42,1164,602,562
050,17,037,"Illinois","DeKalb County",3,43,1088,554,534
050,17,037,"Illinois","DeKalb County",3,44,1050,518,532
050,17,037,"Illinois","DeKalb County",3,45,1019,519,500
050,17,037,"Illinois","DeKalb County",3,46,996,508,488
050,17,037,"Illinois","DeKalb County",3,47,980,480,500
050,17,037,"Illinois","DeKalb County",3,48,1015,513,502
050,17,037,"Illinois","DeKalb County",3,49,1076,567,509
050,17,037,"Illinois","DeKalb County",3,50,1119,568,551
050,17,037,"Illinois","DeKalb County",3,51,1080,551,529
050,17,037,"Illinois","DeKalb County",3,52,1055,527,528
050,17,037,"Illinois","DeKalb County",3,53,1029,517,512
050,17,037,"Illinois","DeKalb County",3,54,1023,521,502
050,17,037,"Illinois","DeKalb County",3,55,1053,524,529
050,17,037,"Illinois","DeKalb County",3,56,1106,552,554
050,17,037,"Illinois","DeKalb County",3,57,1130,555,575
050,17,037,"Illinois","DeKalb County",3,58,1147,567,580
050,17,037,"Illinois","DeKalb County",3,59,1161,571,590
050,17,037,"Illinois","DeKalb County",3,60,1153,570,583
050,17,037,"Illinois","DeKalb County",3,61,1138,559,579
050,17,037,"Illinois","DeKalb County",3,62,1128,554,574
050,17,037,"Illinois","DeKalb County",3,63,1092,566,526
050,17,037,"Illinois","DeKalb County",3,64,1042,535,507
050,17,037,"Illinois","DeKalb County",3,65,985,488,497
050,17,037,"Illinois","DeKalb County",3,66,942,468,474
050,17,037,"Illinois","DeKalb County",3,67,898,431,467
050,17,037,"Illinois","DeKalb County",3,68,865,424,441
050,17,037,"Illinois","DeKalb County",3,69,830,395,435
050,17,037,"Illinois","DeKalb County",3,70,789,373,416
050,17,037,"Illinois","DeKalb County",3,71,741,357,384
050,17,037,"Illinois","DeKalb County",3,72,707,341,366
050,17,037,"Illinois","DeKalb County",3,73,687,316,371
050,17,037,"Illinois","DeKalb County",3,74,709,326,383
050,17,037,"Illinois","DeKalb County",3,75,481,234,247
050,17,037,"Illinois","DeKalb County",3,76,473,231,242
050,17,037,"Illinois","DeKalb County",3,77,448,197,251
050,17,037,"Illinois","DeKalb County",3,78,459,205,254
050,17,037,"Illinois","DeKalb County",3,79,398,166,232
050,17,037,"Illinois","DeKalb County",3,80,367,155,212
050,17,037,"Illinois","DeKalb County",3,81,318,135,183
050,17,037,"Illinois","DeKalb County",3,82,298,127,171
050,17,037,"Illinois","DeKalb County",3,83,276,116,160
050,17,037,"Illinois","DeKalb County",3,84,261,105,156
050,17,037,"Illinois","DeKalb County",3,85,1558,533,1025
050,17,037,"Illinois","DeKalb County",4,0,1039,532,507
050,17,037,"Illinois","DeKalb County",4,1,1035,539,496
050,17,037,"Illinois","DeKalb County",4,2,1137,572,565
050,17,037,"Illinois","DeKalb County",4,3,1070,539,531
050,17,037,"Illinois","DeKalb County",4,4,1128,588,540
050,17,037,"Illinois","DeKalb County",4,5,1145,581,564
050,17,037,"Illinois","DeKalb County",4,6,1240,634,606
050,17,037,"Illinois","DeKalb County",4,7,1270,641,629
050,17,037,"Illinois","DeKalb County",4,8,1242,637,605
050,17,037,"Illinois","DeKalb County",4,9,1190,583,607
050,17,037,"Illinois","DeKalb County",4,10,1242,636,606
050,17,037,"Illinois","DeKalb County",4,11,1266,656,610
050,17,037,"Illinois","DeKalb County",4,12,1237,641,596
050,17,037,"Illinois","DeKalb County",4,13,1255,638,617
050,17,037,"Illinois","DeKalb County",4,14,1311,644,667
050,17,037,"Illinois","DeKalb County",4,15,1286,644,642
050,17,037,"Illinois","DeKalb County",4,16,1305,680,625
050,17,037,"Illinois","DeKalb County",4,17,1335,691,644
050,17,037,"Illinois","DeKalb County",4,18,1909,992,917
050,17,037,"Illinois","DeKalb County",4,19,2751,1337,1414
050,17,037,"Illinois","DeKalb County",4,20,3011,1437,1574
050,17,037,"Illinois","DeKalb County",4,21,3522,1783,1739
050,17,037,"Illinois","DeKalb County",4,22,3096,1452,1644
050,17,037,"Illinois","DeKalb County",4,23,2339,1235,1104
050,17,037,"Illinois","DeKalb County",4,24,1703,843,860
050,17,037,"Illinois","DeKalb County",4,25,1499,756,743
050,17,037,"Illinois","DeKalb County",4,26,1441,712,729
050,17,037,"Illinois","DeKalb County",4,27,1287,637,650
050,17,037,"Illinois","DeKalb County",4,28,1264,596,668
050,17,037,"Illinois","DeKalb County",4,29,1326,644,682
050,17,037,"Illinois","DeKalb County",4,30,1320,642,678
050,17,037,"Illinois","DeKalb County",4,31,1316,672,644
050,17,037,"Illinois","DeKalb County",4,32,1216,628,588
050,17,037,"Illinois","DeKalb County",4,33,1223,623,600
050,17,037,"Illinois","DeKalb County",4,34,1288,643,645
050,17,037,"Illinois","DeKalb County",4,35,1179,610,569
050,17,037,"Illinois","DeKalb County",4,36,1214,639,575
050,17,037,"Illinois","DeKalb County",4,37,1170,609,561
050,17,037,"Illinois","DeKalb County",4,38,1148,557,591
050,17,037,"Illinois","DeKalb County",4,39,1186,609,577
050,17,037,"Illinois","DeKalb County",4,40,1238,604,634
050,17,037,"Illinois","DeKalb County",4,41,1238,629,609
050,17,037,"Illinois","DeKalb County",4,42,1230,631,599
050,17,037,"Illinois","DeKalb County",4,43,1135,580,555
050,17,037,"Illinois","DeKalb County",4,44,1081,549,532
050,17,037,"Illinois","DeKalb County",4,45,1053,515,538
050,17,037,"Illinois","DeKalb County",4,46,1011,514,497
050,17,037,"Illinois","DeKalb County",4,47,1005,514,491
050,17,037,"Illinois","DeKalb County",4,48,946,455,491
050,17,037,"Illinois","DeKalb County",4,49,990,516,474
050,17,037,"Illinois","DeKalb County",4,50,1075,572,503
050,17,037,"Illinois","DeKalb County",4,51,1103,559,544
050,17,037,"Illinois","DeKalb County",4,52,1061,541,520
050,17,037,"Illinois","DeKalb County",4,53,1056,532,524
050,17,037,"Illinois","DeKalb County",4,54,1019,501,518
050,17,037,"Illinois","DeKalb County",4,55,1017,524,493
050,17,037,"Illinois","DeKalb County",4,56,1037,521,516
050,17,037,"Illinois","DeKalb County",4,57,1095,555,540
050,17,037,"Illinois","DeKalb County",4,58,1123,551,572
050,17,037,"Illinois","DeKalb County",4,59,1126,565,561
050,17,037,"Illinois","DeKalb County",4,60,1122,558,564
050,17,037,"Illinois","DeKalb County",4,61,1127,554,573
050,17,037,"Illinois","DeKalb County",4,62,1121,552,569
050,17,037,"Illinois","DeKalb County",4,63,1094,533,561
050,17,037,"Illinois","DeKalb County",4,64,1062,542,520
050,17,037,"Illinois","DeKalb County",4,65,1023,518,505
050,17,037,"Illinois","DeKalb County",4,66,946,467,479
050,17,037,"Illinois","DeKalb County",4,67,930,463,467
050,17,037,"Illinois","DeKalb County",4,68,881,420,461
050,17,037,"Illinois","DeKalb County",4,69,835,397,438
050,17,037,"Illinois","DeKalb County",4,70,825,384,441
050,17,037,"Illinois","DeKalb County",4,71,763,358,405
050,17,037,"Illinois","DeKalb County",4,72,725,359,366
050,17,037,"Illinois","DeKalb County",4,73,697,336,361
050,17,037,"Illinois","DeKalb County",4,74,664,296,368
050,17,037,"Illinois","DeKalb County",4,75,700,317,383
050,17,037,"Illinois","DeKalb County",4,76,473,230,243
050,17,037,"Illinois","DeKalb County",4,77,454,221,233
050,17,037,"Illinois","DeKalb County",4,78,432,189,243
050,17,037,"Illinois","DeKalb County",4,79,460,200,260
050,17,037,"Illinois","DeKalb County",4,80,380,161,219
050,17,037,"Illinois","DeKalb County",4,81,334,134,200
050,17,037,"Illinois","DeKalb County",4,82,294,119,175
050,17,037,"Illinois","DeKalb County",4,83,280,124,156
050,17,037,"Illinois","DeKalb County",4,84,258,103,155
050,17,037,"Illinois","DeKalb County",4,85,1563,537,1026
050,17,037,"Illinois","DeKalb County",5,0,1033,530,503
050,17,037,"Illinois","DeKalb County",5,1,1070,543,527
050,17,037,"Illinois","DeKalb County",5,2,1030,531,499
050,17,037,"Illinois","DeKalb County",5,3,1116,577,539
050,17,037,"Illinois","DeKalb County",5,4,1063,533,530
050,17,037,"Illinois","DeKalb County",5,5,1124,576,548
050,17,037,"Illinois","DeKalb County",5,6,1156,588,568
050,17,037,"Illinois","DeKalb County",5,7,1238,627,611
050,17,037,"Illinois","DeKalb County",5,8,1264,650,614
050,17,037,"Illinois","DeKalb County",5,9,1226,631,595
050,17,037,"Illinois","DeKalb County",5,10,1206,600,606
050,17,037,"Illinois","DeKalb County",5,11,1238,631,607
050,17,037,"Illinois","DeKalb County",5,12,1243,653,590
050,17,037,"Illinois","DeKalb County",5,13,1253,648,605
050,17,037,"Illinois","DeKalb County",5,14,1250,641,609
050,17,037,"Illinois","DeKalb County",5,15,1307,645,662
050,17,037,"Illinois","DeKalb County",5,16,1281,651,630
050,17,037,"Illinois","DeKalb County",5,17,1298,681,617
050,17,037,"Illinois","DeKalb County",5,18,1976,1014,962
050,17,037,"Illinois","DeKalb County",5,19,2720,1311,1409
050,17,037,"Illinois","DeKalb County",5,20,3049,1477,1572
050,17,037,"Illinois","DeKalb County",5,21,3453,1755,1698
050,17,037,"Illinois","DeKalb County",5,22,3159,1483,1676
050,17,037,"Illinois","DeKalb County",5,23,2385,1271,1114
050,17,037,"Illinois","DeKalb County",5,24,1789,903,886
050,17,037,"Illinois","DeKalb County",5,25,1446,733,713
050,17,037,"Illinois","DeKalb County",5,26,1322,667,655
050,17,037,"Illinois","DeKalb County",5,27,1315,640,675
050,17,037,"Illinois","DeKalb County",5,28,1284,617,667
050,17,037,"Illinois","DeKalb County",5,29,1277,618,659
050,17,037,"Illinois","DeKalb County",5,30,1325,645,680
050,17,037,"Illinois","DeKalb County",5,31,1309,623,686
050,17,037,"Illinois","DeKalb County",5,32,1310,678,632
050,17,037,"Illinois","DeKalb County",5,33,1237,617,620
050,17,037,"Illinois","DeKalb County",5,34,1221,631,590
050,17,037,"Illinois","DeKalb County",5,35,1298,647,651
050,17,037,"Illinois","DeKalb County",5,36,1184,623,561
050,17,037,"Illinois","DeKalb County",5,37,1204,629,575
050,17,037,"Illinois","DeKalb County",5,38,1157,592,565
050,17,037,"Illinois","DeKalb County",5,39,1135,549,586
050,17,037,"Illinois","DeKalb County",5,40,1169,604,565
050,17,037,"Illinois","DeKalb County",5,41,1231,597,634
050,17,037,"Illinois","DeKalb County",5,42,1206,607,599
050,17,037,"Illinois","DeKalb County",5,43,1226,633,593
050,17,037,"Illinois","DeKalb County",5,44,1140,596,544
050,17,037,"Illinois","DeKalb County",5,45,1054,534,520
050,17,037,"Illinois","DeKalb County",5,46,1043,513,530
050,17,037,"Illinois","DeKalb County",5,47,1011,506,505
050,17,037,"Illinois","DeKalb County",5,48,993,509,484
050,17,037,"Illinois","DeKalb County",5,49,935,465,470
050,17,037,"Illinois","DeKalb County",5,50,973,509,464
050,17,037,"Illinois","DeKalb County",5,51,1084,575,509
050,17,037,"Illinois","DeKalb County",5,52,1079,537,542
050,17,037,"Illinois","DeKalb County",5,53,1046,528,518
050,17,037,"Illinois","DeKalb County",5,54,1054,526,528
050,17,037,"Illinois","DeKalb County",5,55,1009,504,505
050,17,037,"Illinois","DeKalb County",5,56,1030,536,494
050,17,037,"Illinois","DeKalb County",5,57,1044,525,519
050,17,037,"Illinois","DeKalb County",5,58,1095,551,544
050,17,037,"Illinois","DeKalb County",5,59,1087,543,544
050,17,037,"Illinois","DeKalb County",5,60,1092,548,544
050,17,037,"Illinois","DeKalb County",5,61,1119,551,568
050,17,037,"Illinois","DeKalb County",5,62,1108,540,568
050,17,037,"Illinois","DeKalb County",5,63,1093,533,560
050,17,037,"Illinois","DeKalb County",5,64,1076,530,546
050,17,037,"Illinois","DeKalb County",5,65,1036,531,505
050,17,037,"Illinois","DeKalb County",5,66,995,498,497
050,17,037,"Illinois","DeKalb County",5,67,923,454,469
050,17,037,"Illinois","DeKalb County",5,68,915,455,460
050,17,037,"Illinois","DeKalb County",5,69,842,396,446
050,17,037,"Illinois","DeKalb County",5,70,826,388,438
050,17,037,"Illinois","DeKalb County",5,71,799,371,428
050,17,037,"Illinois","DeKalb County",5,72,737,352,385
050,17,037,"Illinois","DeKalb County",5,73,718,363,355
050,17,037,"Illinois","DeKalb County",5,74,683,328,355
050,17,037,"Illinois","DeKalb County",5,75,661,293,368
050,17,037,"Illinois","DeKalb County",5,76,689,316,373
050,17,037,"Illinois","DeKalb County",5,77,459,218,241
050,17,037,"Illinois","DeKalb County",5,78,440,216,224
050,17,037,"Illinois","DeKalb County",5,79,425,180,245
050,17,037,"Illinois","DeKalb County",5,80,443,188,255
050,17,037,"Illinois","DeKalb County",5,81,345,138,207
050,17,037,"Illinois","DeKalb County",5,82,310,121,189
050,17,037,"Illinois","DeKalb County",5,83,275,112,163
050,17,037,"Illinois","DeKalb County",5,84,261,108,153
050,17,037,"Illinois","DeKalb County",5,85,1558,545,1013
050,17,039,"Illinois","De Witt County",1,0,171,88,83
050,17,039,"Illinois","De Witt County",1,1,179,91,88
050,17,039,"Illinois","De Witt County",1,2,167,87,80
050,17,039,"Illinois","De Witt County",1,3,161,74,87
050,17,039,"Illinois","De Witt County",1,4,190,81,109
050,17,039,"Illinois","De Witt County",1,5,172,83,89
050,17,039,"Illinois","De Witt County",1,6,167,75,92
050,17,039,"Illinois","De Witt County",1,7,152,73,79
050,17,039,"Illinois","De Witt County",1,8,188,100,88
050,17,039,"Illinois","De Witt County",1,9,181,95,86
050,17,039,"Illinois","De Witt County",1,10,191,106,85
050,17,039,"Illinois","De Witt County",1,11,188,103,85
050,17,039,"Illinois","De Witt County",1,12,197,107,90
050,17,039,"Illinois","De Witt County",1,13,205,116,89
050,17,039,"Illinois","De Witt County",1,14,179,96,83
050,17,039,"Illinois","De Witt County",1,15,205,116,89
050,17,039,"Illinois","De Witt County",1,16,215,106,109
050,17,039,"Illinois","De Witt County",1,17,220,106,114
050,17,039,"Illinois","De Witt County",1,18,181,93,88
050,17,039,"Illinois","De Witt County",1,19,144,75,69
050,17,039,"Illinois","De Witt County",1,20,156,81,75
050,17,039,"Illinois","De Witt County",1,21,159,84,75
050,17,039,"Illinois","De Witt County",1,22,162,74,88
050,17,039,"Illinois","De Witt County",1,23,142,65,77
050,17,039,"Illinois","De Witt County",1,24,147,76,71
050,17,039,"Illinois","De Witt County",1,25,149,72,77
050,17,039,"Illinois","De Witt County",1,26,170,73,97
050,17,039,"Illinois","De Witt County",1,27,180,86,94
050,17,039,"Illinois","De Witt County",1,28,184,95,89
050,17,039,"Illinois","De Witt County",1,29,169,90,79
050,17,039,"Illinois","De Witt County",1,30,193,105,88
050,17,039,"Illinois","De Witt County",1,31,170,90,80
050,17,039,"Illinois","De Witt County",1,32,169,91,78
050,17,039,"Illinois","De Witt County",1,33,174,84,90
050,17,039,"Illinois","De Witt County",1,34,173,83,90
050,17,039,"Illinois","De Witt County",1,35,188,101,87
050,17,039,"Illinois","De Witt County",1,36,200,105,95
050,17,039,"Illinois","De Witt County",1,37,207,107,100
050,17,039,"Illinois","De Witt County",1,38,177,81,96
050,17,039,"Illinois","De Witt County",1,39,198,92,106
050,17,039,"Illinois","De Witt County",1,40,190,89,101
050,17,039,"Illinois","De Witt County",1,41,195,102,93
050,17,039,"Illinois","De Witt County",1,42,185,98,87
050,17,039,"Illinois","De Witt County",1,43,181,99,82
050,17,039,"Illinois","De Witt County",1,44,183,89,94
050,17,039,"Illinois","De Witt County",1,45,189,96,93
050,17,039,"Illinois","De Witt County",1,46,162,84,78
050,17,039,"Illinois","De Witt County",1,47,177,88,89
050,17,039,"Illinois","De Witt County",1,48,218,113,105
050,17,039,"Illinois","De Witt County",1,49,202,112,90
050,17,039,"Illinois","De Witt County",1,50,198,100,98
050,17,039,"Illinois","De Witt County",1,51,206,119,87
050,17,039,"Illinois","De Witt County",1,52,204,106,98
050,17,039,"Illinois","De Witt County",1,53,218,102,116
050,17,039,"Illinois","De Witt County",1,54,231,106,125
050,17,039,"Illinois","De Witt County",1,55,236,124,112
050,17,039,"Illinois","De Witt County",1,56,242,123,119
050,17,039,"Illinois","De Witt County",1,57,238,119,119
050,17,039,"Illinois","De Witt County",1,58,249,129,120
050,17,039,"Illinois","De Witt County",1,59,242,124,118
050,17,039,"Illinois","De Witt County",1,60,238,119,119
050,17,039,"Illinois","De Witt County",1,61,248,131,117
050,17,039,"Illinois","De Witt County",1,62,247,130,117
050,17,039,"Illinois","De Witt County",1,63,251,130,121
050,17,039,"Illinois","De Witt County",1,64,248,129,119
050,17,039,"Illinois","De Witt County",1,65,226,119,107
050,17,039,"Illinois","De Witt County",1,66,189,99,90
050,17,039,"Illinois","De Witt County",1,67,194,90,104
050,17,039,"Illinois","De Witt County",1,68,190,94,96
050,17,039,"Illinois","De Witt County",1,69,188,93,95
050,17,039,"Illinois","De Witt County",1,70,156,66,90
050,17,039,"Illinois","De Witt County",1,71,169,82,87
050,17,039,"Illinois","De Witt County",1,72,161,84,77
050,17,039,"Illinois","De Witt County",1,73,159,75,84
050,17,039,"Illinois","De Witt County",1,74,120,58,62
050,17,039,"Illinois","De Witt County",1,75,134,56,78
050,17,039,"Illinois","De Witt County",1,76,127,59,68
050,17,039,"Illinois","De Witt County",1,77,124,56,68
050,17,039,"Illinois","De Witt County",1,78,106,49,57
050,17,039,"Illinois","De Witt County",1,79,95,39,56
050,17,039,"Illinois","De Witt County",1,80,91,38,53
050,17,039,"Illinois","De Witt County",1,81,75,34,41
050,17,039,"Illinois","De Witt County",1,82,68,29,39
050,17,039,"Illinois","De Witt County",1,83,65,24,41
050,17,039,"Illinois","De Witt County",1,84,59,22,37
050,17,039,"Illinois","De Witt County",1,85,326,117,209
050,17,039,"Illinois","De Witt County",2,0,178,94,84
050,17,039,"Illinois","De Witt County",2,1,176,89,87
050,17,039,"Illinois","De Witt County",2,2,170,88,82
050,17,039,"Illinois","De Witt County",2,3,161,76,85
050,17,039,"Illinois","De Witt County",2,4,181,78,103
050,17,039,"Illinois","De Witt County",2,5,178,83,95
050,17,039,"Illinois","De Witt County",2,6,165,76,89
050,17,039,"Illinois","De Witt County",2,7,154,74,80
050,17,039,"Illinois","De Witt County",2,8,178,91,87
050,17,039,"Illinois","De Witt County",2,9,181,95,86
050,17,039,"Illinois","De Witt County",2,10,188,102,86
050,17,039,"Illinois","De Witt County",2,11,187,103,84
050,17,039,"Illinois","De Witt County",2,12,196,108,88
050,17,039,"Illinois","De Witt County",2,13,202,114,88
050,17,039,"Illinois","De Witt County",2,14,187,103,84
050,17,039,"Illinois","De Witt County",2,15,199,112,87
050,17,039,"Illinois","De Witt County",2,16,214,109,105
050,17,039,"Illinois","De Witt County",2,17,217,105,112
050,17,039,"Illinois","De Witt County",2,18,179,91,88
050,17,039,"Illinois","De Witt County",2,19,144,75,69
050,17,039,"Illinois","De Witt County",2,20,158,82,76
050,17,039,"Illinois","De Witt County",2,21,161,85,76
050,17,039,"Illinois","De Witt County",2,22,164,78,86
050,17,039,"Illinois","De Witt County",2,23,147,67,80
050,17,039,"Illinois","De Witt County",2,24,146,74,72
050,17,039,"Illinois","De Witt County",2,25,147,71,76
050,17,039,"Illinois","De Witt County",2,26,166,73,93
050,17,039,"Illinois","De Witt County",2,27,176,83,93
050,17,039,"Illinois","De Witt County",2,28,179,92,87
050,17,039,"Illinois","De Witt County",2,29,173,91,82
050,17,039,"Illinois","De Witt County",2,30,187,101,86
050,17,039,"Illinois","De Witt County",2,31,177,94,83
050,17,039,"Illinois","De Witt County",2,32,171,92,79
050,17,039,"Illinois","De Witt County",2,33,173,86,87
050,17,039,"Illinois","De Witt County",2,34,173,84,89
050,17,039,"Illinois","De Witt County",2,35,184,97,87
050,17,039,"Illinois","De Witt County",2,36,196,104,92
050,17,039,"Illinois","De Witt County",2,37,206,108,98
050,17,039,"Illinois","De Witt County",2,38,186,88,98
050,17,039,"Illinois","De Witt County",2,39,191,87,104
050,17,039,"Illinois","De Witt County",2,40,196,91,105
050,17,039,"Illinois","De Witt County",2,41,192,98,94
050,17,039,"Illinois","De Witt County",2,42,188,99,89
050,17,039,"Illinois","De Witt County",2,43,184,99,85
050,17,039,"Illinois","De Witt County",2,44,179,90,89
050,17,039,"Illinois","De Witt County",2,45,187,95,92
050,17,039,"Illinois","De Witt County",2,46,168,87,81
050,17,039,"Illinois","De Witt County",2,47,174,87,87
050,17,039,"Illinois","De Witt County",2,48,206,107,99
050,17,039,"Illinois","De Witt County",2,49,203,110,93
050,17,039,"Illinois","De Witt County",2,50,197,102,95
050,17,039,"Illinois","De Witt County",2,51,202,114,88
050,17,039,"Illinois","De Witt County",2,52,204,108,96
050,17,039,"Illinois","De Witt County",2,53,214,102,112
050,17,039,"Illinois","De Witt County",2,54,227,105,122
050,17,039,"Illinois","De Witt County",2,55,233,118,115
050,17,039,"Illinois","De Witt County",2,56,238,122,116
050,17,039,"Illinois","De Witt County",2,57,237,120,117
050,17,039,"Illinois","De Witt County",2,58,246,127,119
050,17,039,"Illinois","De Witt County",2,59,245,126,119
050,17,039,"Illinois","De Witt County",2,60,237,119,118
050,17,039,"Illinois","De Witt County",2,61,242,126,116
050,17,039,"Illinois","De Witt County",2,62,244,129,115
050,17,039,"Illinois","De Witt County",2,63,252,131,121
050,17,039,"Illinois","De Witt County",2,64,240,124,116
050,17,039,"Illinois","De Witt County",2,65,229,120,109
050,17,039,"Illinois","De Witt County",2,66,196,105,91
050,17,039,"Illinois","De Witt County",2,67,190,91,99
050,17,039,"Illinois","De Witt County",2,68,186,89,97
050,17,039,"Illinois","De Witt County",2,69,186,93,93
050,17,039,"Illinois","De Witt County",2,70,162,73,89
050,17,039,"Illinois","De Witt County",2,71,166,77,89
050,17,039,"Illinois","De Witt County",2,72,160,82,78
050,17,039,"Illinois","De Witt County",2,73,165,81,84
050,17,039,"Illinois","De Witt County",2,74,118,57,61
050,17,039,"Illinois","De Witt County",2,75,130,54,76
050,17,039,"Illinois","De Witt County",2,76,127,57,70
050,17,039,"Illinois","De Witt County",2,77,127,58,69
050,17,039,"Illinois","De Witt County",2,78,107,49,58
050,17,039,"Illinois","De Witt County",2,79,98,41,57
050,17,039,"Illinois","De Witt County",2,80,91,38,53
050,17,039,"Illinois","De Witt County",2,81,78,34,44
050,17,039,"Illinois","De Witt County",2,82,68,28,40
050,17,039,"Illinois","De Witt County",2,83,66,25,41
050,17,039,"Illinois","De Witt County",2,84,55,21,34
050,17,039,"Illinois","De Witt County",2,85,325,114,211
050,17,039,"Illinois","De Witt County",3,0,160,82,78
050,17,039,"Illinois","De Witt County",3,1,188,97,91
050,17,039,"Illinois","De Witt County",3,2,176,91,85
050,17,039,"Illinois","De Witt County",3,3,175,90,85
050,17,039,"Illinois","De Witt County",3,4,163,85,78
050,17,039,"Illinois","De Witt County",3,5,183,82,101
050,17,039,"Illinois","De Witt County",3,6,196,91,105
050,17,039,"Illinois","De Witt County",3,7,172,84,88
050,17,039,"Illinois","De Witt County",3,8,151,75,76
050,17,039,"Illinois","De Witt County",3,9,182,91,91
050,17,039,"Illinois","De Witt County",3,10,184,103,81
050,17,039,"Illinois","De Witt County",3,11,192,108,84
050,17,039,"Illinois","De Witt County",3,12,184,98,86
050,17,039,"Illinois","De Witt County",3,13,204,116,88
050,17,039,"Illinois","De Witt County",3,14,196,105,91
050,17,039,"Illinois","De Witt County",3,15,198,111,87
050,17,039,"Illinois","De Witt County",3,16,190,102,88
050,17,039,"Illinois","De Witt County",3,17,211,106,105
050,17,039,"Illinois","De Witt County",3,18,181,88,93
050,17,039,"Illinois","De Witt County",3,19,139,73,66
050,17,039,"Illinois","De Witt County",3,20,159,81,78
050,17,039,"Illinois","De Witt County",3,21,151,78,73
050,17,039,"Illinois","De Witt County",3,22,163,85,78
050,17,039,"Illinois","De Witt County",3,23,166,76,90
050,17,039,"Illinois","De Witt County",3,24,156,73,83
050,17,039,"Illinois","De Witt County",3,25,147,84,63
050,17,039,"Illinois","De Witt County",3,26,149,73,76
050,17,039,"Illinois","De Witt County",3,27,163,71,92
050,17,039,"Illinois","De Witt County",3,28,166,82,84
050,17,039,"Illinois","De Witt County",3,29,183,91,92
050,17,039,"Illinois","De Witt County",3,30,172,91,81
050,17,039,"Illinois","De Witt County",3,31,187,95,92
050,17,039,"Illinois","De Witt County",3,32,186,96,90
050,17,039,"Illinois","De Witt County",3,33,159,80,79
050,17,039,"Illinois","De Witt County",3,34,174,90,84
050,17,039,"Illinois","De Witt County",3,35,169,81,88
050,17,039,"Illinois","De Witt County",3,36,183,94,89
050,17,039,"Illinois","De Witt County",3,37,204,109,95
050,17,039,"Illinois","De Witt County",3,38,206,105,101
050,17,039,"Illinois","De Witt County",3,39,186,87,99
050,17,039,"Illinois","De Witt County",3,40,187,87,100
050,17,039,"Illinois","De Witt County",3,41,198,88,110
050,17,039,"Illinois","De Witt County",3,42,198,103,95
050,17,039,"Illinois","De Witt County",3,43,190,101,89
050,17,039,"Illinois","De Witt County",3,44,180,100,80
050,17,039,"Illinois","De Witt County",3,45,173,89,84
050,17,039,"Illinois","De Witt County",3,46,190,96,94
050,17,039,"Illinois","De Witt County",3,47,167,84,83
050,17,039,"Illinois","De Witt County",3,48,175,86,89
050,17,039,"Illinois","De Witt County",3,49,199,105,94
050,17,039,"Illinois","De Witt County",3,50,197,103,94
050,17,039,"Illinois","De Witt County",3,51,202,106,96
050,17,039,"Illinois","De Witt County",3,52,198,109,89
050,17,039,"Illinois","De Witt County",3,53,199,106,93
050,17,039,"Illinois","De Witt County",3,54,216,106,110
050,17,039,"Illinois","De Witt County",3,55,221,103,118
050,17,039,"Illinois","De Witt County",3,56,234,120,114
050,17,039,"Illinois","De Witt County",3,57,237,117,120
050,17,039,"Illinois","De Witt County",3,58,233,118,115
050,17,039,"Illinois","De Witt County",3,59,244,124,120
050,17,039,"Illinois","De Witt County",3,60,247,126,121
050,17,039,"Illinois","De Witt County",3,61,243,123,120
050,17,039,"Illinois","De Witt County",3,62,245,128,117
050,17,039,"Illinois","De Witt County",3,63,233,122,111
050,17,039,"Illinois","De Witt County",3,64,245,128,117
050,17,039,"Illinois","De Witt County",3,65,241,124,117
050,17,039,"Illinois","De Witt County",3,66,224,115,109
050,17,039,"Illinois","De Witt County",3,67,195,103,92
050,17,039,"Illinois","De Witt County",3,68,185,86,99
050,17,039,"Illinois","De Witt County",3,69,183,87,96
050,17,039,"Illinois","De Witt County",3,70,182,90,92
050,17,039,"Illinois","De Witt County",3,71,158,70,88
050,17,039,"Illinois","De Witt County",3,72,161,77,84
050,17,039,"Illinois","De Witt County",3,73,150,75,75
050,17,039,"Illinois","De Witt County",3,74,151,72,79
050,17,039,"Illinois","De Witt County",3,75,110,52,58
050,17,039,"Illinois","De Witt County",3,76,128,53,75
050,17,039,"Illinois","De Witt County",3,77,124,57,67
050,17,039,"Illinois","De Witt County",3,78,119,54,65
050,17,039,"Illinois","De Witt County",3,79,98,41,57
050,17,039,"Illinois","De Witt County",3,80,86,33,53
050,17,039,"Illinois","De Witt County",3,81,79,32,47
050,17,039,"Illinois","De Witt County",3,82,70,33,37
050,17,039,"Illinois","De Witt County",3,83,66,24,42
050,17,039,"Illinois","De Witt County",3,84,61,24,37
050,17,039,"Illinois","De Witt County",3,85,327,116,211
050,17,039,"Illinois","De Witt County",4,0,164,78,86
050,17,039,"Illinois","De Witt County",4,1,153,80,73
050,17,039,"Illinois","De Witt County",4,2,187,95,92
050,17,039,"Illinois","De Witt County",4,3,177,89,88
050,17,039,"Illinois","De Witt County",4,4,179,95,84
050,17,039,"Illinois","De Witt County",4,5,167,87,80
050,17,039,"Illinois","De Witt County",4,6,189,88,101
050,17,039,"Illinois","De Witt County",4,7,196,91,105
050,17,039,"Illinois","De Witt County",4,8,175,84,91
050,17,039,"Illinois","De Witt County",4,9,154,78,76
050,17,039,"Illinois","De Witt County",4,10,176,85,91
050,17,039,"Illinois","De Witt County",4,11,180,97,83
050,17,039,"Illinois","De Witt County",4,12,189,103,86
050,17,039,"Illinois","De Witt County",4,13,185,96,89
050,17,039,"Illinois","De Witt County",4,14,206,117,89
050,17,039,"Illinois","De Witt County",4,15,205,106,99
050,17,039,"Illinois","De Witt County",4,16,192,105,87
050,17,039,"Illinois","De Witt County",4,17,196,110,86
050,17,039,"Illinois","De Witt County",4,18,180,99,81
050,17,039,"Illinois","De Witt County",4,19,143,73,70
050,17,039,"Illinois","De Witt County",4,20,140,74,66
050,17,039,"Illinois","De Witt County",4,21,166,83,83
050,17,039,"Illinois","De Witt County",4,22,160,86,74
050,17,039,"Illinois","De Witt County",4,23,169,90,79
050,17,039,"Illinois","De Witt County",4,24,177,81,96
050,17,039,"Illinois","De Witt County",4,25,154,69,85
050,17,039,"Illinois","De Witt County",4,26,138,76,62
050,17,039,"Illinois","De Witt County",4,27,148,74,74
050,17,039,"Illinois","De Witt County",4,28,165,75,90
050,17,039,"Illinois","De Witt County",4,29,178,94,84
050,17,039,"Illinois","De Witt County",4,30,191,92,99
050,17,039,"Illinois","De Witt County",4,31,182,92,90
050,17,039,"Illinois","De Witt County",4,32,186,96,90
050,17,039,"Illinois","De Witt County",4,33,192,103,89
050,17,039,"Illinois","De Witt County",4,34,174,89,85
050,17,039,"Illinois","De Witt County",4,35,180,96,84
050,17,039,"Illinois","De Witt County",4,36,169,79,90
050,17,039,"Illinois","De Witt County",4,37,184,96,88
050,17,039,"Illinois","De Witt County",4,38,203,101,102
050,17,039,"Illinois","De Witt County",4,39,201,106,95
050,17,039,"Illinois","De Witt County",4,40,179,81,98
050,17,039,"Illinois","De Witt County",4,41,189,84,105
050,17,039,"Illinois","De Witt County",4,42,200,87,113
050,17,039,"Illinois","De Witt County",4,43,203,107,96
050,17,039,"Illinois","De Witt County",4,44,186,101,85
050,17,039,"Illinois","De Witt County",4,45,186,106,80
050,17,039,"Illinois","De Witt County",4,46,171,90,81
050,17,039,"Illinois","De Witt County",4,47,184,94,90
050,17,039,"Illinois","De Witt County",4,48,165,83,82
050,17,039,"Illinois","De Witt County",4,49,174,86,88
050,17,039,"Illinois","De Witt County",4,50,192,98,94
050,17,039,"Illinois","De Witt County",4,51,196,102,94
050,17,039,"Illinois","De Witt County",4,52,205,111,94
050,17,039,"Illinois","De Witt County",4,53,194,104,90
050,17,039,"Illinois","De Witt County",4,54,195,105,90
050,17,039,"Illinois","De Witt County",4,55,211,102,109
050,17,039,"Illinois","De Witt County",4,56,220,104,116
050,17,039,"Illinois","De Witt County",4,57,233,117,116
050,17,039,"Illinois","De Witt County",4,58,242,123,119
050,17,039,"Illinois","De Witt County",4,59,223,112,111
050,17,039,"Illinois","De Witt County",4,60,244,128,116
050,17,039,"Illinois","De Witt County",4,61,249,128,121
050,17,039,"Illinois","De Witt County",4,62,241,120,121
050,17,039,"Illinois","De Witt County",4,63,236,125,111
050,17,039,"Illinois","De Witt County",4,64,236,127,109
050,17,039,"Illinois","De Witt County",4,65,238,127,111
050,17,039,"Illinois","De Witt County",4,66,236,121,115
050,17,039,"Illinois","De Witt County",4,67,215,109,106
050,17,039,"Illinois","De Witt County",4,68,193,98,95
050,17,039,"Illinois","De Witt County",4,69,180,83,97
050,17,039,"Illinois","De Witt County",4,70,175,82,93
050,17,039,"Illinois","De Witt County",4,71,178,88,90
050,17,039,"Illinois","De Witt County",4,72,158,70,88
050,17,039,"Illinois","De Witt County",4,73,152,71,81
050,17,039,"Illinois","De Witt County",4,74,141,72,69
050,17,039,"Illinois","De Witt County",4,75,143,66,77
050,17,039,"Illinois","De Witt County",4,76,108,52,56
050,17,039,"Illinois","De Witt County",4,77,124,53,71
050,17,039,"Illinois","De Witt County",4,78,118,54,64
050,17,039,"Illinois","De Witt County",4,79,114,50,64
050,17,039,"Illinois","De Witt County",4,80,85,36,49
050,17,039,"Illinois","De Witt County",4,81,76,29,47
050,17,039,"Illinois","De Witt County",4,82,73,30,43
050,17,039,"Illinois","De Witt County",4,83,68,31,37
050,17,039,"Illinois","De Witt County",4,84,54,20,34
050,17,039,"Illinois","De Witt County",4,85,332,112,220
050,17,039,"Illinois","De Witt County",5,0,163,76,87
050,17,039,"Illinois","De Witt County",5,1,169,87,82
050,17,039,"Illinois","De Witt County",5,2,152,79,73
050,17,039,"Illinois","De Witt County",5,3,189,92,97
050,17,039,"Illinois","De Witt County",5,4,178,86,92
050,17,039,"Illinois","De Witt County",5,5,188,95,93
050,17,039,"Illinois","De Witt County",5,6,177,87,90
050,17,039,"Illinois","De Witt County",5,7,192,87,105
050,17,039,"Illinois","De Witt County",5,8,203,91,112
050,17,039,"Illinois","De Witt County",5,9,178,85,93
050,17,039,"Illinois","De Witt County",5,10,156,76,80
050,17,039,"Illinois","De Witt County",5,11,186,91,95
050,17,039,"Illinois","De Witt County",5,12,191,104,87
050,17,039,"Illinois","De Witt County",5,13,186,99,87
050,17,039,"Illinois","De Witt County",5,14,183,98,85
050,17,039,"Illinois","De Witt County",5,15,210,112,98
050,17,039,"Illinois","De Witt County",5,16,204,108,96
050,17,039,"Illinois","De Witt County",5,17,190,108,82
050,17,039,"Illinois","De Witt County",5,18,160,94,66
050,17,039,"Illinois","De Witt County",5,19,144,80,64
050,17,039,"Illinois","De Witt County",5,20,144,75,69
050,17,039,"Illinois","De Witt County",5,21,143,76,67
050,17,039,"Illinois","De Witt County",5,22,189,93,96
050,17,039,"Illinois","De Witt County",5,23,163,89,74
050,17,039,"Illinois","De Witt County",5,24,160,90,70
050,17,039,"Illinois","De Witt County",5,25,177,79,98
050,17,039,"Illinois","De Witt County",5,26,147,70,77
050,17,039,"Illinois","De Witt County",5,27,148,84,64
050,17,039,"Illinois","De Witt County",5,28,158,84,74
050,17,039,"Illinois","De Witt County",5,29,162,73,89
050,17,039,"Illinois","De Witt County",5,30,180,91,89
050,17,039,"Illinois","De Witt County",5,31,202,98,104
050,17,039,"Illinois","De Witt County",5,32,186,93,93
050,17,039,"Illinois","De Witt County",5,33,187,97,90
050,17,039,"Illinois","De Witt County",5,34,191,105,86
050,17,039,"Illinois","De Witt County",5,35,175,89,86
050,17,039,"Illinois","De Witt County",5,36,187,102,85
050,17,039,"Illinois","De Witt County",5,37,174,84,90
050,17,039,"Illinois","De Witt County",5,38,192,98,94
050,17,039,"Illinois","De Witt County",5,39,198,98,100
050,17,039,"Illinois","De Witt County",5,40,200,105,95
050,17,039,"Illinois","De Witt County",5,41,178,79,99
050,17,039,"Illinois","De Witt County",5,42,193,89,104
050,17,039,"Illinois","De Witt County",5,43,209,92,117
050,17,039,"Illinois","De Witt County",5,44,193,100,93
050,17,039,"Illinois","De Witt County",5,45,186,103,83
050,17,039,"Illinois","De Witt County",5,46,189,109,80
050,17,039,"Illinois","De Witt County",5,47,170,85,85
050,17,039,"Illinois","De Witt County",5,48,186,96,90
050,17,039,"Illinois","De Witt County",5,49,172,90,82
050,17,039,"Illinois","De Witt County",5,50,174,84,90
050,17,039,"Illinois","De Witt County",5,51,189,98,91
050,17,039,"Illinois","De Witt County",5,52,192,99,93
050,17,039,"Illinois","De Witt County",5,53,191,99,92
050,17,039,"Illinois","De Witt County",5,54,191,103,88
050,17,039,"Illinois","De Witt County",5,55,191,105,86
050,17,039,"Illinois","De Witt County",5,56,199,94,105
050,17,039,"Illinois","De Witt County",5,57,219,105,114
050,17,039,"Illinois","De Witt County",5,58,233,118,115
050,17,039,"Illinois","De Witt County",5,59,241,123,118
050,17,039,"Illinois","De Witt County",5,60,222,111,111
050,17,039,"Illinois","De Witt County",5,61,251,127,124
050,17,039,"Illinois","De Witt County",5,62,252,129,123
050,17,039,"Illinois","De Witt County",5,63,239,121,118
050,17,039,"Illinois","De Witt County",5,64,226,121,105
050,17,039,"Illinois","De Witt County",5,65,240,126,114
050,17,039,"Illinois","De Witt County",5,66,231,121,110
050,17,039,"Illinois","De Witt County",5,67,228,116,112
050,17,039,"Illinois","De Witt County",5,68,205,105,100
050,17,039,"Illinois","De Witt County",5,69,185,94,91
050,17,039,"Illinois","De Witt County",5,70,164,74,90
050,17,039,"Illinois","De Witt County",5,71,169,78,91
050,17,039,"Illinois","De Witt County",5,72,175,90,85
050,17,039,"Illinois","De Witt County",5,73,151,65,86
050,17,039,"Illinois","De Witt County",5,74,145,68,77
050,17,039,"Illinois","De Witt County",5,75,133,64,69
050,17,039,"Illinois","De Witt County",5,76,140,64,76
050,17,039,"Illinois","De Witt County",5,77,103,51,52
050,17,039,"Illinois","De Witt County",5,78,119,50,69
050,17,039,"Illinois","De Witt County",5,79,115,51,64
050,17,039,"Illinois","De Witt County",5,80,102,46,56
050,17,039,"Illinois","De Witt County",5,81,82,33,49
050,17,039,"Illinois","De Witt County",5,82,69,26,43
050,17,039,"Illinois","De Witt County",5,83,74,30,44
050,17,039,"Illinois","De Witt County",5,84,56,27,29
050,17,039,"Illinois","De Witt County",5,85,331,110,221
050,17,041,"Illinois","Douglas County",1,0,226,118,108
050,17,041,"Illinois","Douglas County",1,1,244,128,116
050,17,041,"Illinois","Douglas County",1,2,276,154,122
050,17,041,"Illinois","Douglas County",1,3,255,134,121
050,17,041,"Illinois","Douglas County",1,4,278,132,146
050,17,041,"Illinois","Douglas County",1,5,260,127,133
050,17,041,"Illinois","Douglas County",1,6,255,134,121
050,17,041,"Illinois","Douglas County",1,7,267,136,131
050,17,041,"Illinois","Douglas County",1,8,259,125,134
050,17,041,"Illinois","Douglas County",1,9,259,131,128
050,17,041,"Illinois","Douglas County",1,10,274,149,125
050,17,041,"Illinois","Douglas County",1,11,281,149,132
050,17,041,"Illinois","Douglas County",1,12,296,147,149
050,17,041,"Illinois","Douglas County",1,13,296,141,155
050,17,041,"Illinois","Douglas County",1,14,295,151,144
050,17,041,"Illinois","Douglas County",1,15,290,146,144
050,17,041,"Illinois","Douglas County",1,16,293,150,143
050,17,041,"Illinois","Douglas County",1,17,295,154,141
050,17,041,"Illinois","Douglas County",1,18,265,146,119
050,17,041,"Illinois","Douglas County",1,19,208,110,98
050,17,041,"Illinois","Douglas County",1,20,209,105,104
050,17,041,"Illinois","Douglas County",1,21,208,115,93
050,17,041,"Illinois","Douglas County",1,22,222,117,105
050,17,041,"Illinois","Douglas County",1,23,235,123,112
050,17,041,"Illinois","Douglas County",1,24,222,116,106
050,17,041,"Illinois","Douglas County",1,25,204,103,101
050,17,041,"Illinois","Douglas County",1,26,235,126,109
050,17,041,"Illinois","Douglas County",1,27,260,139,121
050,17,041,"Illinois","Douglas County",1,28,229,121,108
050,17,041,"Illinois","Douglas County",1,29,237,115,122
050,17,041,"Illinois","Douglas County",1,30,244,120,124
050,17,041,"Illinois","Douglas County",1,31,252,126,126
050,17,041,"Illinois","Douglas County",1,32,254,134,120
050,17,041,"Illinois","Douglas County",1,33,248,136,112
050,17,041,"Illinois","Douglas County",1,34,251,116,135
050,17,041,"Illinois","Douglas County",1,35,232,112,120
050,17,041,"Illinois","Douglas County",1,36,227,118,109
050,17,041,"Illinois","Douglas County",1,37,234,112,122
050,17,041,"Illinois","Douglas County",1,38,265,137,128
050,17,041,"Illinois","Douglas County",1,39,243,119,124
050,17,041,"Illinois","Douglas County",1,40,241,121,120
050,17,041,"Illinois","Douglas County",1,41,226,115,111
050,17,041,"Illinois","Douglas County",1,42,241,120,121
050,17,041,"Illinois","Douglas County",1,43,231,106,125
050,17,041,"Illinois","Douglas County",1,44,237,117,120
050,17,041,"Illinois","Douglas County",1,45,246,127,119
050,17,041,"Illinois","Douglas County",1,46,216,103,113
050,17,041,"Illinois","Douglas County",1,47,210,109,101
050,17,041,"Illinois","Douglas County",1,48,229,117,112
050,17,041,"Illinois","Douglas County",1,49,241,112,129
050,17,041,"Illinois","Douglas County",1,50,211,105,106
050,17,041,"Illinois","Douglas County",1,51,230,125,105
050,17,041,"Illinois","Douglas County",1,52,236,125,111
050,17,041,"Illinois","Douglas County",1,53,222,118,104
050,17,041,"Illinois","Douglas County",1,54,217,118,99
050,17,041,"Illinois","Douglas County",1,55,235,119,116
050,17,041,"Illinois","Douglas County",1,56,254,131,123
050,17,041,"Illinois","Douglas County",1,57,258,130,128
050,17,041,"Illinois","Douglas County",1,58,264,140,124
050,17,041,"Illinois","Douglas County",1,59,256,132,124
050,17,041,"Illinois","Douglas County",1,60,265,135,130
050,17,041,"Illinois","Douglas County",1,61,286,143,143
050,17,041,"Illinois","Douglas County",1,62,266,136,130
050,17,041,"Illinois","Douglas County",1,63,277,144,133
050,17,041,"Illinois","Douglas County",1,64,273,133,140
050,17,041,"Illinois","Douglas County",1,65,256,127,129
050,17,041,"Illinois","Douglas County",1,66,238,110,128
050,17,041,"Illinois","Douglas County",1,67,222,111,111
050,17,041,"Illinois","Douglas County",1,68,208,102,106
050,17,041,"Illinois","Douglas County",1,69,199,96,103
050,17,041,"Illinois","Douglas County",1,70,191,89,102
050,17,041,"Illinois","Douglas County",1,71,195,100,95
050,17,041,"Illinois","Douglas County",1,72,185,89,96
050,17,041,"Illinois","Douglas County",1,73,179,87,92
050,17,041,"Illinois","Douglas County",1,74,130,63,67
050,17,041,"Illinois","Douglas County",1,75,132,71,61
050,17,041,"Illinois","Douglas County",1,76,124,66,58
050,17,041,"Illinois","Douglas County",1,77,126,54,72
050,17,041,"Illinois","Douglas County",1,78,103,39,64
050,17,041,"Illinois","Douglas County",1,79,102,42,60
050,17,041,"Illinois","Douglas County",1,80,98,47,51
050,17,041,"Illinois","Douglas County",1,81,103,43,60
050,17,041,"Illinois","Douglas County",1,82,102,42,60
050,17,041,"Illinois","Douglas County",1,83,106,39,67
050,17,041,"Illinois","Douglas County",1,84,95,33,62
050,17,041,"Illinois","Douglas County",1,85,491,163,328
050,17,041,"Illinois","Douglas County",2,0,235,118,117
050,17,041,"Illinois","Douglas County",2,1,240,125,115
050,17,041,"Illinois","Douglas County",2,2,272,149,123
050,17,041,"Illinois","Douglas County",2,3,260,138,122
050,17,041,"Illinois","Douglas County",2,4,274,135,139
050,17,041,"Illinois","Douglas County",2,5,265,128,137
050,17,041,"Illinois","Douglas County",2,6,259,134,125
050,17,041,"Illinois","Douglas County",2,7,266,137,129
050,17,041,"Illinois","Douglas County",2,8,260,127,133
050,17,041,"Illinois","Douglas County",2,9,259,129,130
050,17,041,"Illinois","Douglas County",2,10,268,143,125
050,17,041,"Illinois","Douglas County",2,11,280,149,131
050,17,041,"Illinois","Douglas County",2,12,295,148,147
050,17,041,"Illinois","Douglas County",2,13,294,142,152
050,17,041,"Illinois","Douglas County",2,14,294,148,146
050,17,041,"Illinois","Douglas County",2,15,292,146,146
050,17,041,"Illinois","Douglas County",2,16,292,148,144
050,17,041,"Illinois","Douglas County",2,17,294,153,141
050,17,041,"Illinois","Douglas County",2,18,259,144,115
050,17,041,"Illinois","Douglas County",2,19,211,113,98
050,17,041,"Illinois","Douglas County",2,20,215,109,106
050,17,041,"Illinois","Douglas County",2,21,212,113,99
050,17,041,"Illinois","Douglas County",2,22,221,117,104
050,17,041,"Illinois","Douglas County",2,23,234,125,109
050,17,041,"Illinois","Douglas County",2,24,225,118,107
050,17,041,"Illinois","Douglas County",2,25,212,109,103
050,17,041,"Illinois","Douglas County",2,26,232,123,109
050,17,041,"Illinois","Douglas County",2,27,257,139,118
050,17,041,"Illinois","Douglas County",2,28,237,125,112
050,17,041,"Illinois","Douglas County",2,29,237,118,119
050,17,041,"Illinois","Douglas County",2,30,245,120,125
050,17,041,"Illinois","Douglas County",2,31,252,125,127
050,17,041,"Illinois","Douglas County",2,32,253,131,122
050,17,041,"Illinois","Douglas County",2,33,247,133,114
050,17,041,"Illinois","Douglas County",2,34,251,121,130
050,17,041,"Illinois","Douglas County",2,35,236,114,122
050,17,041,"Illinois","Douglas County",2,36,228,116,112
050,17,041,"Illinois","Douglas County",2,37,234,115,119
050,17,041,"Illinois","Douglas County",2,38,259,132,127
050,17,041,"Illinois","Douglas County",2,39,247,124,123
050,17,041,"Illinois","Douglas County",2,40,244,122,122
050,17,041,"Illinois","Douglas County",2,41,228,116,112
050,17,041,"Illinois","Douglas County",2,42,238,119,119
050,17,041,"Illinois","Douglas County",2,43,235,110,125
050,17,041,"Illinois","Douglas County",2,44,233,112,121
050,17,041,"Illinois","Douglas County",2,45,245,125,120
050,17,041,"Illinois","Douglas County",2,46,223,108,115
050,17,041,"Illinois","Douglas County",2,47,210,108,102
050,17,041,"Illinois","Douglas County",2,48,226,117,109
050,17,041,"Illinois","Douglas County",2,49,240,112,128
050,17,041,"Illinois","Douglas County",2,50,220,108,112
050,17,041,"Illinois","Douglas County",2,51,228,123,105
050,17,041,"Illinois","Douglas County",2,52,232,122,110
050,17,041,"Illinois","Douglas County",2,53,220,117,103
050,17,041,"Illinois","Douglas County",2,54,212,114,98
050,17,041,"Illinois","Douglas County",2,55,231,119,112
050,17,041,"Illinois","Douglas County",2,56,249,127,122
050,17,041,"Illinois","Douglas County",2,57,257,130,127
050,17,041,"Illinois","Douglas County",2,58,261,137,124
050,17,041,"Illinois","Douglas County",2,59,259,135,124
050,17,041,"Illinois","Douglas County",2,60,261,133,128
050,17,041,"Illinois","Douglas County",2,61,281,142,139
050,17,041,"Illinois","Douglas County",2,62,270,138,132
050,17,041,"Illinois","Douglas County",2,63,278,145,133
050,17,041,"Illinois","Douglas County",2,64,271,133,138
050,17,041,"Illinois","Douglas County",2,65,259,128,131
050,17,041,"Illinois","Douglas County",2,66,243,113,130
050,17,041,"Illinois","Douglas County",2,67,226,111,115
050,17,041,"Illinois","Douglas County",2,68,209,102,107
050,17,041,"Illinois","Douglas County",2,69,200,97,103
050,17,041,"Illinois","Douglas County",2,70,192,90,102
050,17,041,"Illinois","Douglas County",2,71,195,97,98
050,17,041,"Illinois","Douglas County",2,72,182,90,92
050,17,041,"Illinois","Douglas County",2,73,188,92,96
050,17,041,"Illinois","Douglas County",2,74,131,64,67
050,17,041,"Illinois","Douglas County",2,75,131,68,63
050,17,041,"Illinois","Douglas County",2,76,121,65,56
050,17,041,"Illinois","Douglas County",2,77,126,57,69
050,17,041,"Illinois","Douglas County",2,78,106,43,63
050,17,041,"Illinois","Douglas County",2,79,101,41,60
050,17,041,"Illinois","Douglas County",2,80,99,47,52
050,17,041,"Illinois","Douglas County",2,81,99,42,57
050,17,041,"Illinois","Douglas County",2,82,100,41,59
050,17,041,"Illinois","Douglas County",2,83,107,40,67
050,17,041,"Illinois","Douglas County",2,84,96,35,61
050,17,041,"Illinois","Douglas County",2,85,498,164,334
050,17,041,"Illinois","Douglas County",3,0,244,107,137
050,17,041,"Illinois","Douglas County",3,1,232,107,125
050,17,041,"Illinois","Douglas County",3,2,244,130,114
050,17,041,"Illinois","Douglas County",3,3,269,150,119
050,17,041,"Illinois","Douglas County",3,4,259,138,121
050,17,041,"Illinois","Douglas County",3,5,280,136,144
050,17,041,"Illinois","Douglas County",3,6,257,126,131
050,17,041,"Illinois","Douglas County",3,7,256,131,125
050,17,041,"Illinois","Douglas County",3,8,262,135,127
050,17,041,"Illinois","Douglas County",3,9,255,125,130
050,17,041,"Illinois","Douglas County",3,10,269,134,135
050,17,041,"Illinois","Douglas County",3,11,266,145,121
050,17,041,"Illinois","Douglas County",3,12,277,145,132
050,17,041,"Illinois","Douglas County",3,13,293,148,145
050,17,041,"Illinois","Douglas County",3,14,288,142,146
050,17,041,"Illinois","Douglas County",3,15,301,151,150
050,17,041,"Illinois","Douglas County",3,16,298,150,148
050,17,041,"Illinois","Douglas County",3,17,280,144,136
050,17,041,"Illinois","Douglas County",3,18,250,136,114
050,17,041,"Illinois","Douglas County",3,19,205,115,90
050,17,041,"Illinois","Douglas County",3,20,240,133,107
050,17,041,"Illinois","Douglas County",3,21,232,120,112
050,17,041,"Illinois","Douglas County",3,22,231,120,111
050,17,041,"Illinois","Douglas County",3,23,233,123,110
050,17,041,"Illinois","Douglas County",3,24,250,130,120
050,17,041,"Illinois","Douglas County",3,25,227,112,115
050,17,041,"Illinois","Douglas County",3,26,217,109,108
050,17,041,"Illinois","Douglas County",3,27,246,126,120
050,17,041,"Illinois","Douglas County",3,28,247,136,111
050,17,041,"Illinois","Douglas County",3,29,247,129,118
050,17,041,"Illinois","Douglas County",3,30,234,116,118
050,17,041,"Illinois","Douglas County",3,31,236,119,117
050,17,041,"Illinois","Douglas County",3,32,262,135,127
050,17,041,"Illinois","Douglas County",3,33,258,135,123
050,17,041,"Illinois","Douglas County",3,34,246,134,112
050,17,041,"Illinois","Douglas County",3,35,252,119,133
050,17,041,"Illinois","Douglas County",3,36,230,108,122
050,17,041,"Illinois","Douglas County",3,37,235,120,115
050,17,041,"Illinois","Douglas County",3,38,233,111,122
050,17,041,"Illinois","Douglas County",3,39,251,132,119
050,17,041,"Illinois","Douglas County",3,40,245,124,121
050,17,041,"Illinois","Douglas County",3,41,239,120,119
050,17,041,"Illinois","Douglas County",3,42,238,126,112
050,17,041,"Illinois","Douglas County",3,43,231,116,115
050,17,041,"Illinois","Douglas County",3,44,230,106,124
050,17,041,"Illinois","Douglas County",3,45,239,115,124
050,17,041,"Illinois","Douglas County",3,46,248,124,124
050,17,041,"Illinois","Douglas County",3,47,207,103,104
050,17,041,"Illinois","Douglas County",3,48,205,109,96
050,17,041,"Illinois","Douglas County",3,49,233,119,114
050,17,041,"Illinois","Douglas County",3,50,238,110,128
050,17,041,"Illinois","Douglas County",3,51,224,113,111
050,17,041,"Illinois","Douglas County",3,52,222,120,102
050,17,041,"Illinois","Douglas County",3,53,226,118,108
050,17,041,"Illinois","Douglas County",3,54,211,112,99
050,17,041,"Illinois","Douglas County",3,55,213,114,99
050,17,041,"Illinois","Douglas County",3,56,227,112,115
050,17,041,"Illinois","Douglas County",3,57,245,125,120
050,17,041,"Illinois","Douglas County",3,58,252,125,127
050,17,041,"Illinois","Douglas County",3,59,253,131,122
050,17,041,"Illinois","Douglas County",3,60,260,136,124
050,17,041,"Illinois","Douglas County",3,61,261,132,129
050,17,041,"Illinois","Douglas County",3,62,271,137,134
050,17,041,"Illinois","Douglas County",3,63,269,140,129
050,17,041,"Illinois","Douglas County",3,64,271,134,137
050,17,041,"Illinois","Douglas County",3,65,269,132,137
050,17,041,"Illinois","Douglas County",3,66,256,128,128
050,17,041,"Illinois","Douglas County",3,67,238,115,123
050,17,041,"Illinois","Douglas County",3,68,218,104,114
050,17,041,"Illinois","Douglas County",3,69,194,95,99
050,17,041,"Illinois","Douglas County",3,70,197,94,103
050,17,041,"Illinois","Douglas County",3,71,185,82,103
050,17,041,"Illinois","Douglas County",3,72,190,94,96
050,17,041,"Illinois","Douglas County",3,73,173,88,85
050,17,041,"Illinois","Douglas County",3,74,174,81,93
050,17,041,"Illinois","Douglas County",3,75,129,62,67
050,17,041,"Illinois","Douglas County",3,76,118,66,52
050,17,041,"Illinois","Douglas County",3,77,112,59,53
050,17,041,"Illinois","Douglas County",3,78,120,54,66
050,17,041,"Illinois","Douglas County",3,79,98,38,60
050,17,041,"Illinois","Douglas County",3,80,97,43,54
050,17,041,"Illinois","Douglas County",3,81,93,41,52
050,17,041,"Illinois","Douglas County",3,82,86,33,53
050,17,041,"Illinois","Douglas County",3,83,98,37,61
050,17,041,"Illinois","Douglas County",3,84,89,35,54
050,17,041,"Illinois","Douglas County",3,85,510,164,346
050,17,041,"Illinois","Douglas County",4,0,251,126,125
050,17,041,"Illinois","Douglas County",4,1,259,119,140
050,17,041,"Illinois","Douglas County",4,2,231,114,117
050,17,041,"Illinois","Douglas County",4,3,242,127,115
050,17,041,"Illinois","Douglas County",4,4,282,161,121
050,17,041,"Illinois","Douglas County",4,5,255,135,120
050,17,041,"Illinois","Douglas County",4,6,286,143,143
050,17,041,"Illinois","Douglas County",4,7,259,125,134
050,17,041,"Illinois","Douglas County",4,8,261,131,130
050,17,041,"Illinois","Douglas County",4,9,263,138,125
050,17,041,"Illinois","Douglas County",4,10,260,127,133
050,17,041,"Illinois","Douglas County",4,11,264,130,134
050,17,041,"Illinois","Douglas County",4,12,279,148,131
050,17,041,"Illinois","Douglas County",4,13,278,141,137
050,17,041,"Illinois","Douglas County",4,14,291,146,145
050,17,041,"Illinois","Douglas County",4,15,289,142,147
050,17,041,"Illinois","Douglas County",4,16,301,155,146
050,17,041,"Illinois","Douglas County",4,17,301,151,150
050,17,041,"Illinois","Douglas County",4,18,243,129,114
050,17,041,"Illinois","Douglas County",4,19,203,107,96
050,17,041,"Illinois","Douglas County",4,20,210,117,93
050,17,041,"Illinois","Douglas County",4,21,257,135,122
050,17,041,"Illinois","Douglas County",4,22,237,118,119
050,17,041,"Illinois","Douglas County",4,23,230,120,110
050,17,041,"Illinois","Douglas County",4,24,238,130,108
050,17,041,"Illinois","Douglas County",4,25,253,126,127
050,17,041,"Illinois","Douglas County",4,26,228,112,116
050,17,041,"Illinois","Douglas County",4,27,204,103,101
050,17,041,"Illinois","Douglas County",4,28,245,126,119
050,17,041,"Illinois","Douglas County",4,29,239,129,110
050,17,041,"Illinois","Douglas County",4,30,247,129,118
050,17,041,"Illinois","Douglas County",4,31,237,116,121
050,17,041,"Illinois","Douglas County",4,32,246,124,122
050,17,041,"Illinois","Douglas County",4,33,260,133,127
050,17,041,"Illinois","Douglas County",4,34,258,136,122
050,17,041,"Illinois","Douglas County",4,35,250,134,116
050,17,041,"Illinois","Douglas County",4,36,252,119,133
050,17,041,"Illinois","Douglas County",4,37,230,108,122
050,17,041,"Illinois","Douglas County",4,38,224,113,111
050,17,041,"Illinois","Douglas County",4,39,244,117,127
050,17,041,"Illinois","Douglas County",4,40,245,126,119
050,17,041,"Illinois","Douglas County",4,41,245,127,118
050,17,041,"Illinois","Douglas County",4,42,237,126,111
050,17,041,"Illinois","Douglas County",4,43,239,126,113
050,17,041,"Illinois","Douglas County",4,44,232,114,118
050,17,041,"Illinois","Douglas County",4,45,230,109,121
050,17,041,"Illinois","Douglas County",4,46,247,113,134
050,17,041,"Illinois","Douglas County",4,47,244,123,121
050,17,041,"Illinois","Douglas County",4,48,209,106,103
050,17,041,"Illinois","Douglas County",4,49,211,112,99
050,17,041,"Illinois","Douglas County",4,50,229,114,115
050,17,041,"Illinois","Douglas County",4,51,233,111,122
050,17,041,"Illinois","Douglas County",4,52,225,115,110
050,17,041,"Illinois","Douglas County",4,53,218,117,101
050,17,041,"Illinois","Douglas County",4,54,219,114,105
050,17,041,"Illinois","Douglas County",4,55,205,110,95
050,17,041,"Illinois","Douglas County",4,56,210,108,102
050,17,041,"Illinois","Douglas County",4,57,226,113,113
050,17,041,"Illinois","Douglas County",4,58,239,118,121
050,17,041,"Illinois","Douglas County",4,59,249,125,124
050,17,041,"Illinois","Douglas County",4,60,250,129,121
050,17,041,"Illinois","Douglas County",4,61,267,138,129
050,17,041,"Illinois","Douglas County",4,62,246,124,122
050,17,041,"Illinois","Douglas County",4,63,269,139,130
050,17,041,"Illinois","Douglas County",4,64,260,130,130
050,17,041,"Illinois","Douglas County",4,65,275,137,138
050,17,041,"Illinois","Douglas County",4,66,269,129,140
050,17,041,"Illinois","Douglas County",4,67,257,131,126
050,17,041,"Illinois","Douglas County",4,68,231,108,123
050,17,041,"Illinois","Douglas County",4,69,209,101,108
050,17,041,"Illinois","Douglas County",4,70,189,91,98
050,17,041,"Illinois","Douglas County",4,71,192,90,102
050,17,041,"Illinois","Douglas County",4,72,178,84,94
050,17,041,"Illinois","Douglas County",4,73,186,94,92
050,17,041,"Illinois","Douglas County",4,74,163,81,82
050,17,041,"Illinois","Douglas County",4,75,173,80,93
050,17,041,"Illinois","Douglas County",4,76,113,56,57
050,17,041,"Illinois","Douglas County",4,77,112,59,53
050,17,041,"Illinois","Douglas County",4,78,108,56,52
050,17,041,"Illinois","Douglas County",4,79,113,50,63
050,17,041,"Illinois","Douglas County",4,80,89,36,53
050,17,041,"Illinois","Douglas County",4,81,92,38,54
050,17,041,"Illinois","Douglas County",4,82,80,38,42
050,17,041,"Illinois","Douglas County",4,83,87,31,56
050,17,041,"Illinois","Douglas County",4,84,83,35,48
050,17,041,"Illinois","Douglas County",4,85,497,158,339
050,17,041,"Illinois","Douglas County",5,0,243,122,121
050,17,041,"Illinois","Douglas County",5,1,266,125,141
050,17,041,"Illinois","Douglas County",5,2,257,112,145
050,17,041,"Illinois","Douglas County",5,3,224,116,108
050,17,041,"Illinois","Douglas County",5,4,234,126,108
050,17,041,"Illinois","Douglas County",5,5,279,163,116
050,17,041,"Illinois","Douglas County",5,6,242,126,116
050,17,041,"Illinois","Douglas County",5,7,292,149,143
050,17,041,"Illinois","Douglas County",5,8,257,123,134
050,17,041,"Illinois","Douglas County",5,9,265,135,130
050,17,041,"Illinois","Douglas County",5,10,260,136,124
050,17,041,"Illinois","Douglas County",5,11,262,128,134
050,17,041,"Illinois","Douglas County",5,12,269,127,142
050,17,041,"Illinois","Douglas County",5,13,278,150,128
050,17,041,"Illinois","Douglas County",5,14,270,139,131
050,17,041,"Illinois","Douglas County",5,15,285,143,142
050,17,041,"Illinois","Douglas County",5,16,295,145,150
050,17,041,"Illinois","Douglas County",5,17,292,148,144
050,17,041,"Illinois","Douglas County",5,18,252,128,124
050,17,041,"Illinois","Douglas County",5,19,187,91,96
050,17,041,"Illinois","Douglas County",5,20,226,118,108
050,17,041,"Illinois","Douglas County",5,21,225,121,104
050,17,041,"Illinois","Douglas County",5,22,277,145,132
050,17,041,"Illinois","Douglas County",5,23,254,124,130
050,17,041,"Illinois","Douglas County",5,24,237,120,117
050,17,041,"Illinois","Douglas County",5,25,247,131,116
050,17,041,"Illinois","Douglas County",5,26,266,145,121
050,17,041,"Illinois","Douglas County",5,27,224,113,111
050,17,041,"Illinois","Douglas County",5,28,209,108,101
050,17,041,"Illinois","Douglas County",5,29,248,118,130
050,17,041,"Illinois","Douglas County",5,30,228,126,102
050,17,041,"Illinois","Douglas County",5,31,228,119,109
050,17,041,"Illinois","Douglas County",5,32,240,124,116
050,17,041,"Illinois","Douglas County",5,33,243,124,119
050,17,041,"Illinois","Douglas County",5,34,257,124,133
050,17,041,"Illinois","Douglas County",5,35,269,144,125
050,17,041,"Illinois","Douglas County",5,36,241,128,113
050,17,041,"Illinois","Douglas County",5,37,252,119,133
050,17,041,"Illinois","Douglas County",5,38,239,114,125
050,17,041,"Illinois","Douglas County",5,39,218,109,109
050,17,041,"Illinois","Douglas County",5,40,246,119,127
050,17,041,"Illinois","Douglas County",5,41,249,130,119
050,17,041,"Illinois","Douglas County",5,42,250,128,122
050,17,041,"Illinois","Douglas County",5,43,232,122,110
050,17,041,"Illinois","Douglas County",5,44,233,122,111
050,17,041,"Illinois","Douglas County",5,45,230,113,117
050,17,041,"Illinois","Douglas County",5,46,232,109,123
050,17,041,"Illinois","Douglas County",5,47,245,114,131
050,17,041,"Illinois","Douglas County",5,48,247,128,119
050,17,041,"Illinois","Douglas County",5,49,211,109,102
050,17,041,"Illinois","Douglas County",5,50,211,116,95
050,17,041,"Illinois","Douglas County",5,51,231,115,116
050,17,041,"Illinois","Douglas County",5,52,237,113,124
050,17,041,"Illinois","Douglas County",5,53,217,110,107
050,17,041,"Illinois","Douglas County",5,54,210,111,99
050,17,041,"Illinois","Douglas County",5,55,218,110,108
050,17,041,"Illinois","Douglas County",5,56,212,113,99
050,17,041,"Illinois","Douglas County",5,57,213,113,100
050,17,041,"Illinois","Douglas County",5,58,222,107,115
050,17,041,"Illinois","Douglas County",5,59,233,111,122
050,17,041,"Illinois","Douglas County",5,60,248,128,120
050,17,041,"Illinois","Douglas County",5,61,243,124,119
050,17,041,"Illinois","Douglas County",5,62,256,133,123
050,17,041,"Illinois","Douglas County",5,63,249,131,118
050,17,041,"Illinois","Douglas County",5,64,263,133,130
050,17,041,"Illinois","Douglas County",5,65,261,131,130
050,17,041,"Illinois","Douglas County",5,66,272,133,139
050,17,041,"Illinois","Douglas County",5,67,269,135,134
050,17,041,"Illinois","Douglas County",5,68,252,126,126
050,17,041,"Illinois","Douglas County",5,69,230,108,122
050,17,041,"Illinois","Douglas County",5,70,202,100,102
050,17,041,"Illinois","Douglas County",5,71,184,85,99
050,17,041,"Illinois","Douglas County",5,72,189,89,100
050,17,041,"Illinois","Douglas County",5,73,172,82,90
050,17,041,"Illinois","Douglas County",5,74,172,84,88
050,17,041,"Illinois","Douglas County",5,75,165,81,84
050,17,041,"Illinois","Douglas County",5,76,157,77,80
050,17,041,"Illinois","Douglas County",5,77,107,50,57
050,17,041,"Illinois","Douglas County",5,78,105,56,49
050,17,041,"Illinois","Douglas County",5,79,101,53,48
050,17,041,"Illinois","Douglas County",5,80,107,49,58
050,17,041,"Illinois","Douglas County",5,81,82,31,51
050,17,041,"Illinois","Douglas County",5,82,84,33,51
050,17,041,"Illinois","Douglas County",5,83,78,34,44
050,17,041,"Illinois","Douglas County",5,84,72,30,42
050,17,041,"Illinois","Douglas County",5,85,493,158,335
050,17,043,"Illinois","DuPage County",1,0,10052,5145,4907
050,17,043,"Illinois","DuPage County",1,1,10297,5360,4937
050,17,043,"Illinois","DuPage County",1,2,10808,5508,5300
050,17,043,"Illinois","DuPage County",1,3,11190,5665,5525
050,17,043,"Illinois","DuPage County",1,4,11478,5933,5545
050,17,043,"Illinois","DuPage County",1,5,11536,5903,5633
050,17,043,"Illinois","DuPage County",1,6,11250,5734,5516
050,17,043,"Illinois","DuPage County",1,7,11266,5729,5537
050,17,043,"Illinois","DuPage County",1,8,11473,5846,5627
050,17,043,"Illinois","DuPage County",1,9,11702,6028,5674
050,17,043,"Illinois","DuPage County",1,10,12151,6275,5876
050,17,043,"Illinois","DuPage County",1,11,12326,6366,5960
050,17,043,"Illinois","DuPage County",1,12,12597,6470,6127
050,17,043,"Illinois","DuPage County",1,13,12661,6514,6147
050,17,043,"Illinois","DuPage County",1,14,12638,6468,6170
050,17,043,"Illinois","DuPage County",1,15,12847,6641,6206
050,17,043,"Illinois","DuPage County",1,16,13339,6827,6512
050,17,043,"Illinois","DuPage County",1,17,12960,6608,6352
050,17,043,"Illinois","DuPage County",1,18,11592,6010,5582
050,17,043,"Illinois","DuPage County",1,19,10692,5451,5241
050,17,043,"Illinois","DuPage County",1,20,10915,5616,5299
050,17,043,"Illinois","DuPage County",1,21,10875,5569,5306
050,17,043,"Illinois","DuPage County",1,22,10836,5477,5359
050,17,043,"Illinois","DuPage County",1,23,11045,5477,5568
050,17,043,"Illinois","DuPage County",1,24,10915,5512,5403
050,17,043,"Illinois","DuPage County",1,25,11307,5721,5586
050,17,043,"Illinois","DuPage County",1,26,11393,5784,5609
050,17,043,"Illinois","DuPage County",1,27,11387,5785,5602
050,17,043,"Illinois","DuPage County",1,28,11380,5760,5620
050,17,043,"Illinois","DuPage County",1,29,11174,5702,5472
050,17,043,"Illinois","DuPage County",1,30,11045,5617,5428
050,17,043,"Illinois","DuPage County",1,31,11381,5780,5601
050,17,043,"Illinois","DuPage County",1,32,11587,5895,5692
050,17,043,"Illinois","DuPage County",1,33,12090,6069,6021
050,17,043,"Illinois","DuPage County",1,34,12706,6498,6208
050,17,043,"Illinois","DuPage County",1,35,12880,6562,6318
050,17,043,"Illinois","DuPage County",1,36,12695,6500,6195
050,17,043,"Illinois","DuPage County",1,37,12820,6494,6326
050,17,043,"Illinois","DuPage County",1,38,13035,6602,6433
050,17,043,"Illinois","DuPage County",1,39,12919,6589,6330
050,17,043,"Illinois","DuPage County",1,40,12754,6445,6309
050,17,043,"Illinois","DuPage County",1,41,12285,6164,6121
050,17,043,"Illinois","DuPage County",1,42,12235,6142,6093
050,17,043,"Illinois","DuPage County",1,43,11837,6011,5826
050,17,043,"Illinois","DuPage County",1,44,11568,5880,5688
050,17,043,"Illinois","DuPage County",1,45,11544,5815,5729
050,17,043,"Illinois","DuPage County",1,46,11155,5532,5623
050,17,043,"Illinois","DuPage County",1,47,11462,5655,5807
050,17,043,"Illinois","DuPage County",1,48,12197,6101,6096
050,17,043,"Illinois","DuPage County",1,49,13155,6551,6604
050,17,043,"Illinois","DuPage County",1,50,12588,6241,6347
050,17,043,"Illinois","DuPage County",1,51,12433,6209,6224
050,17,043,"Illinois","DuPage County",1,52,12372,6062,6310
050,17,043,"Illinois","DuPage County",1,53,12605,6201,6404
050,17,043,"Illinois","DuPage County",1,54,12551,6187,6364
050,17,043,"Illinois","DuPage County",1,55,13165,6494,6671
050,17,043,"Illinois","DuPage County",1,56,13639,6652,6987
050,17,043,"Illinois","DuPage County",1,57,13488,6578,6910
050,17,043,"Illinois","DuPage County",1,58,13486,6608,6878
050,17,043,"Illinois","DuPage County",1,59,13495,6578,6917
050,17,043,"Illinois","DuPage County",1,60,13187,6456,6731
050,17,043,"Illinois","DuPage County",1,61,12982,6383,6599
050,17,043,"Illinois","DuPage County",1,62,12923,6285,6638
050,17,043,"Illinois","DuPage County",1,63,12296,5911,6385
050,17,043,"Illinois","DuPage County",1,64,11914,5804,6110
050,17,043,"Illinois","DuPage County",1,65,11490,5623,5867
050,17,043,"Illinois","DuPage County",1,66,10733,5285,5448
050,17,043,"Illinois","DuPage County",1,67,10281,5042,5239
050,17,043,"Illinois","DuPage County",1,68,9827,4699,5128
050,17,043,"Illinois","DuPage County",1,69,9097,4314,4783
050,17,043,"Illinois","DuPage County",1,70,8649,4109,4540
050,17,043,"Illinois","DuPage County",1,71,8349,3901,4448
050,17,043,"Illinois","DuPage County",1,72,8330,3917,4413
050,17,043,"Illinois","DuPage County",1,73,8121,3856,4265
050,17,043,"Illinois","DuPage County",1,74,5952,2725,3227
050,17,043,"Illinois","DuPage County",1,75,5703,2635,3068
050,17,043,"Illinois","DuPage County",1,76,5680,2542,3138
050,17,043,"Illinois","DuPage County",1,77,5561,2479,3082
050,17,043,"Illinois","DuPage County",1,78,4767,2105,2662
050,17,043,"Illinois","DuPage County",1,79,4156,1827,2329
050,17,043,"Illinois","DuPage County",1,80,3747,1615,2132
050,17,043,"Illinois","DuPage County",1,81,3504,1485,2019
050,17,043,"Illinois","DuPage County",1,82,3236,1360,1876
050,17,043,"Illinois","DuPage County",1,83,2962,1225,1737
050,17,043,"Illinois","DuPage County",1,84,2701,1091,1610
050,17,043,"Illinois","DuPage County",1,85,17482,5739,11743
050,17,043,"Illinois","DuPage County",2,0,9937,5092,4845
050,17,043,"Illinois","DuPage County",2,1,10245,5298,4947
050,17,043,"Illinois","DuPage County",2,2,10725,5485,5240
050,17,043,"Illinois","DuPage County",2,3,11088,5628,5460
050,17,043,"Illinois","DuPage County",2,4,11436,5875,5561
050,17,043,"Illinois","DuPage County",2,5,11528,5913,5615
050,17,043,"Illinois","DuPage County",2,6,11340,5789,5551
050,17,043,"Illinois","DuPage County",2,7,11244,5718,5526
050,17,043,"Illinois","DuPage County",2,8,11358,5788,5570
050,17,043,"Illinois","DuPage County",2,9,11619,5975,5644
050,17,043,"Illinois","DuPage County",2,10,12027,6209,5818
050,17,043,"Illinois","DuPage County",2,11,12224,6310,5914
050,17,043,"Illinois","DuPage County",2,12,12575,6465,6110
050,17,043,"Illinois","DuPage County",2,13,12629,6499,6130
050,17,043,"Illinois","DuPage County",2,14,12633,6482,6151
050,17,043,"Illinois","DuPage County",2,15,12815,6607,6208
050,17,043,"Illinois","DuPage County",2,16,13222,6786,6436
050,17,043,"Illinois","DuPage County",2,17,13055,6654,6401
050,17,043,"Illinois","DuPage County",2,18,11565,5987,5578
050,17,043,"Illinois","DuPage County",2,19,10710,5467,5243
050,17,043,"Illinois","DuPage County",2,20,11001,5639,5362
050,17,043,"Illinois","DuPage County",2,21,10870,5551,5319
050,17,043,"Illinois","DuPage County",2,22,10803,5459,5344
050,17,043,"Illinois","DuPage County",2,23,10936,5446,5490
050,17,043,"Illinois","DuPage County",2,24,10901,5490,5411
050,17,043,"Illinois","DuPage County",2,25,11204,5676,5528
050,17,043,"Illinois","DuPage County",2,26,11350,5764,5586
050,17,043,"Illinois","DuPage County",2,27,11302,5742,5560
050,17,043,"Illinois","DuPage County",2,28,11363,5765,5598
050,17,043,"Illinois","DuPage County",2,29,11220,5705,5515
050,17,043,"Illinois","DuPage County",2,30,11165,5679,5486
050,17,043,"Illinois","DuPage County",2,31,11277,5732,5545
050,17,043,"Illinois","DuPage County",2,32,11533,5854,5679
050,17,043,"Illinois","DuPage County",2,33,11990,6046,5944
050,17,043,"Illinois","DuPage County",2,34,12569,6412,6157
050,17,043,"Illinois","DuPage County",2,35,12903,6584,6319
050,17,043,"Illinois","DuPage County",2,36,12671,6473,6198
050,17,043,"Illinois","DuPage County",2,37,12814,6500,6314
050,17,043,"Illinois","DuPage County",2,38,13039,6597,6442
050,17,043,"Illinois","DuPage County",2,39,12900,6574,6326
050,17,043,"Illinois","DuPage County",2,40,12854,6518,6336
050,17,043,"Illinois","DuPage County",2,41,12387,6218,6169
050,17,043,"Illinois","DuPage County",2,42,12171,6105,6066
050,17,043,"Illinois","DuPage County",2,43,11971,6058,5913
050,17,043,"Illinois","DuPage County",2,44,11542,5872,5670
050,17,043,"Illinois","DuPage County",2,45,11564,5830,5734
050,17,043,"Illinois","DuPage County",2,46,11200,5571,5629
050,17,043,"Illinois","DuPage County",2,47,11335,5599,5736
050,17,043,"Illinois","DuPage County",2,48,11987,5976,6011
050,17,043,"Illinois","DuPage County",2,49,12911,6435,6476
050,17,043,"Illinois","DuPage County",2,50,12720,6315,6405
050,17,043,"Illinois","DuPage County",2,51,12401,6170,6231
050,17,043,"Illinois","DuPage County",2,52,12344,6085,6259
050,17,043,"Illinois","DuPage County",2,53,12483,6134,6349
050,17,043,"Illinois","DuPage County",2,54,12477,6151,6326
050,17,043,"Illinois","DuPage County",2,55,12958,6394,6564
050,17,043,"Illinois","DuPage County",2,56,13485,6598,6887
050,17,043,"Illinois","DuPage County",2,57,13470,6571,6899
050,17,043,"Illinois","DuPage County",2,58,13423,6570,6853
050,17,043,"Illinois","DuPage County",2,59,13456,6559,6897
050,17,043,"Illinois","DuPage County",2,60,13187,6446,6741
050,17,043,"Illinois","DuPage County",2,61,12903,6330,6573
050,17,043,"Illinois","DuPage County",2,62,12857,6275,6582
050,17,043,"Illinois","DuPage County",2,63,12453,6002,6451
050,17,043,"Illinois","DuPage County",2,64,11873,5762,6111
050,17,043,"Illinois","DuPage County",2,65,11498,5612,5886
050,17,043,"Illinois","DuPage County",2,66,10855,5330,5525
050,17,043,"Illinois","DuPage County",2,67,10285,5039,5246
050,17,043,"Illinois","DuPage County",2,68,9815,4712,5103
050,17,043,"Illinois","DuPage County",2,69,9261,4392,4869
050,17,043,"Illinois","DuPage County",2,70,8685,4112,4573
050,17,043,"Illinois","DuPage County",2,71,8360,3916,4444
050,17,043,"Illinois","DuPage County",2,72,8171,3833,4338
050,17,043,"Illinois","DuPage County",2,73,8450,4000,4450
050,17,043,"Illinois","DuPage County",2,74,6086,2817,3269
050,17,043,"Illinois","DuPage County",2,75,5727,2635,3092
050,17,043,"Illinois","DuPage County",2,76,5593,2516,3077
050,17,043,"Illinois","DuPage County",2,77,5634,2508,3126
050,17,043,"Illinois","DuPage County",2,78,4846,2141,2705
050,17,043,"Illinois","DuPage County",2,79,4234,1859,2375
050,17,043,"Illinois","DuPage County",2,80,3808,1649,2159
050,17,043,"Illinois","DuPage County",2,81,3494,1477,2017
050,17,043,"Illinois","DuPage County",2,82,3259,1363,1896
050,17,043,"Illinois","DuPage County",2,83,2947,1219,1728
050,17,043,"Illinois","DuPage County",2,84,2710,1091,1619
050,17,043,"Illinois","DuPage County",2,85,17401,5745,11656
050,17,043,"Illinois","DuPage County",3,0,9473,4867,4606
050,17,043,"Illinois","DuPage County",3,1,10008,5091,4917
050,17,043,"Illinois","DuPage County",3,2,10342,5343,4999
050,17,043,"Illinois","DuPage County",3,3,10755,5512,5243
050,17,043,"Illinois","DuPage County",3,4,11034,5608,5426
050,17,043,"Illinois","DuPage County",3,5,11396,5889,5507
050,17,043,"Illinois","DuPage County",3,6,11425,5811,5614
050,17,043,"Illinois","DuPage County",3,7,11308,5753,5555
050,17,043,"Illinois","DuPage County",3,8,11146,5667,5479
050,17,043,"Illinois","DuPage County",3,9,11320,5790,5530
050,17,043,"Illinois","DuPage County",3,10,11549,5965,5584
050,17,043,"Illinois","DuPage County",3,11,11940,6160,5780
050,17,043,"Illinois","DuPage County",3,12,12128,6254,5874
050,17,043,"Illinois","DuPage County",3,13,12541,6443,6098
050,17,043,"Illinois","DuPage County",3,14,12519,6417,6102
050,17,043,"Illinois","DuPage County",3,15,12557,6469,6088
050,17,043,"Illinois","DuPage County",3,16,12733,6569,6164
050,17,043,"Illinois","DuPage County",3,17,13210,6785,6425
050,17,043,"Illinois","DuPage County",3,18,11819,6098,5721
050,17,043,"Illinois","DuPage County",3,19,10441,5350,5091
050,17,043,"Illinois","DuPage County",3,20,10917,5547,5370
050,17,043,"Illinois","DuPage County",3,21,11038,5576,5462
050,17,043,"Illinois","DuPage County",3,22,10874,5533,5341
050,17,043,"Illinois","DuPage County",3,23,10771,5448,5323
050,17,043,"Illinois","DuPage County",3,24,10949,5498,5451
050,17,043,"Illinois","DuPage County",3,25,11003,5569,5434
050,17,043,"Illinois","DuPage County",3,26,11101,5655,5446
050,17,043,"Illinois","DuPage County",3,27,11124,5663,5461
050,17,043,"Illinois","DuPage County",3,28,11227,5733,5494
050,17,043,"Illinois","DuPage County",3,29,11391,5783,5608
050,17,043,"Illinois","DuPage County",3,30,11435,5790,5645
050,17,043,"Illinois","DuPage County",3,31,11292,5725,5567
050,17,043,"Illinois","DuPage County",3,32,11448,5829,5619
050,17,043,"Illinois","DuPage County",3,33,11783,5943,5840
050,17,043,"Illinois","DuPage County",3,34,12157,6127,6030
050,17,043,"Illinois","DuPage County",3,35,12738,6490,6248
050,17,043,"Illinois","DuPage County",3,36,13025,6599,6426
050,17,043,"Illinois","DuPage County",3,37,12709,6538,6171
050,17,043,"Illinois","DuPage County",3,38,12906,6579,6327
050,17,043,"Illinois","DuPage County",3,39,12987,6556,6431
050,17,043,"Illinois","DuPage County",3,40,12864,6544,6320
050,17,043,"Illinois","DuPage County",3,41,12809,6452,6357
050,17,043,"Illinois","DuPage County",3,42,12345,6224,6121
050,17,043,"Illinois","DuPage County",3,43,12070,6025,6045
050,17,043,"Illinois","DuPage County",3,44,11893,6027,5866
050,17,043,"Illinois","DuPage County",3,45,11462,5796,5666
050,17,043,"Illinois","DuPage County",3,46,11412,5746,5666
050,17,043,"Illinois","DuPage County",3,47,11115,5541,5574
050,17,043,"Illinois","DuPage County",3,48,11252,5555,5697
050,17,043,"Illinois","DuPage County",3,49,11876,5938,5938
050,17,043,"Illinois","DuPage County",3,50,12729,6351,6378
050,17,043,"Illinois","DuPage County",3,51,12576,6228,6348
050,17,043,"Illinois","DuPage County",3,52,12281,6138,6143
050,17,043,"Illinois","DuPage County",3,53,12130,5976,6154
050,17,043,"Illinois","DuPage County",3,54,12274,6036,6238
050,17,043,"Illinois","DuPage County",3,55,12240,6052,6188
050,17,043,"Illinois","DuPage County",3,56,12740,6304,6436
050,17,043,"Illinois","DuPage County",3,57,13132,6467,6665
050,17,043,"Illinois","DuPage County",3,58,13152,6405,6747
050,17,043,"Illinois","DuPage County",3,59,13074,6377,6697
050,17,043,"Illinois","DuPage County",3,60,13116,6386,6730
050,17,043,"Illinois","DuPage County",3,61,12803,6254,6549
050,17,043,"Illinois","DuPage County",3,62,12576,6167,6409
050,17,043,"Illinois","DuPage County",3,63,12469,6045,6424
050,17,043,"Illinois","DuPage County",3,64,12162,5845,6317
050,17,043,"Illinois","DuPage County",3,65,11515,5572,5943
050,17,043,"Illinois","DuPage County",3,66,11191,5431,5760
050,17,043,"Illinois","DuPage County",3,67,10565,5183,5382
050,17,043,"Illinois","DuPage County",3,68,10025,4882,5143
050,17,043,"Illinois","DuPage County",3,69,9615,4587,5028
050,17,043,"Illinois","DuPage County",3,70,8955,4215,4740
050,17,043,"Illinois","DuPage County",3,71,8474,3999,4475
050,17,043,"Illinois","DuPage County",3,72,8164,3789,4375
050,17,043,"Illinois","DuPage County",3,73,7953,3703,4250
050,17,043,"Illinois","DuPage County",3,74,8188,3841,4347
050,17,043,"Illinois","DuPage County",3,75,5909,2738,3171
050,17,043,"Illinois","DuPage County",3,76,5538,2527,3011
050,17,043,"Illinois","DuPage County",3,77,5403,2414,2989
050,17,043,"Illinois","DuPage County",3,78,5447,2396,3051
050,17,043,"Illinois","DuPage County",3,79,4621,2028,2593
050,17,043,"Illinois","DuPage County",3,80,4078,1775,2303
050,17,043,"Illinois","DuPage County",3,81,3630,1540,2090
050,17,043,"Illinois","DuPage County",3,82,3302,1368,1934
050,17,043,"Illinois","DuPage County",3,83,3051,1271,1780
050,17,043,"Illinois","DuPage County",3,84,2757,1114,1643
050,17,043,"Illinois","DuPage County",3,85,17396,5784,11612
050,17,043,"Illinois","DuPage County",4,0,9734,4889,4845
050,17,043,"Illinois","DuPage County",4,1,9694,4961,4733
050,17,043,"Illinois","DuPage County",4,2,10111,5095,5016
050,17,043,"Illinois","DuPage County",4,3,10433,5370,5063
050,17,043,"Illinois","DuPage County",4,4,10840,5548,5292
050,17,043,"Illinois","DuPage County",4,5,11126,5622,5504
050,17,043,"Illinois","DuPage County",4,6,11354,5833,5521
050,17,043,"Illinois","DuPage County",4,7,11464,5850,5614
050,17,043,"Illinois","DuPage County",4,8,11213,5681,5532
050,17,043,"Illinois","DuPage County",4,9,11152,5689,5463
050,17,043,"Illinois","DuPage County",4,10,11215,5718,5497
050,17,043,"Illinois","DuPage County",4,11,11440,5932,5508
050,17,043,"Illinois","DuPage County",4,12,11854,6095,5759
050,17,043,"Illinois","DuPage County",4,13,12112,6250,5862
050,17,043,"Illinois","DuPage County",4,14,12482,6410,6072
050,17,043,"Illinois","DuPage County",4,15,12400,6321,6079
050,17,043,"Illinois","DuPage County",4,16,12500,6459,6041
050,17,043,"Illinois","DuPage County",4,17,12673,6531,6142
050,17,043,"Illinois","DuPage County",4,18,11882,6236,5646
050,17,043,"Illinois","DuPage County",4,19,10486,5371,5115
050,17,043,"Illinois","DuPage County",4,20,10552,5356,5196
050,17,043,"Illinois","DuPage County",4,21,10865,5433,5432
050,17,043,"Illinois","DuPage County",4,22,10961,5511,5450
050,17,043,"Illinois","DuPage County",4,23,10679,5460,5219
050,17,043,"Illinois","DuPage County",4,24,10624,5347,5277
050,17,043,"Illinois","DuPage County",4,25,10953,5549,5404
050,17,043,"Illinois","DuPage County",4,26,10914,5555,5359
050,17,043,"Illinois","DuPage County",4,27,10919,5583,5336
050,17,043,"Illinois","DuPage County",4,28,11053,5575,5478
050,17,043,"Illinois","DuPage County",4,29,11262,5679,5583
050,17,043,"Illinois","DuPage County",4,30,11451,5773,5678
050,17,043,"Illinois","DuPage County",4,31,11516,5830,5686
050,17,043,"Illinois","DuPage County",4,32,11488,5799,5689
050,17,043,"Illinois","DuPage County",4,33,11706,5964,5742
050,17,043,"Illinois","DuPage County",4,34,11945,6086,5859
050,17,043,"Illinois","DuPage County",4,35,12283,6184,6099
050,17,043,"Illinois","DuPage County",4,36,12818,6541,6277
050,17,043,"Illinois","DuPage County",4,37,13002,6562,6440
050,17,043,"Illinois","DuPage County",4,38,12760,6562,6198
050,17,043,"Illinois","DuPage County",4,39,12878,6523,6355
050,17,043,"Illinois","DuPage County",4,40,12959,6581,6378
050,17,043,"Illinois","DuPage County",4,41,12791,6496,6295
050,17,043,"Illinois","DuPage County",4,42,12719,6424,6295
050,17,043,"Illinois","DuPage County",4,43,12260,6186,6074
050,17,043,"Illinois","DuPage County",4,44,12049,6025,6024
050,17,043,"Illinois","DuPage County",4,45,11808,5928,5880
050,17,043,"Illinois","DuPage County",4,46,11328,5703,5625
050,17,043,"Illinois","DuPage County",4,47,11296,5710,5586
050,17,043,"Illinois","DuPage County",4,48,11023,5496,5527
050,17,043,"Illinois","DuPage County",4,49,11150,5511,5639
050,17,043,"Illinois","DuPage County",4,50,11672,5853,5819
050,17,043,"Illinois","DuPage County",4,51,12504,6264,6240
050,17,043,"Illinois","DuPage County",4,52,12416,6181,6235
050,17,043,"Illinois","DuPage County",4,53,12047,6019,6028
050,17,043,"Illinois","DuPage County",4,54,11951,5866,6085
050,17,043,"Illinois","DuPage County",4,55,12095,5945,6150
050,17,043,"Illinois","DuPage County",4,56,11931,5879,6052
050,17,043,"Illinois","DuPage County",4,57,12402,6164,6238
050,17,043,"Illinois","DuPage County",4,58,12755,6282,6473
050,17,043,"Illinois","DuPage County",4,59,12799,6196,6603
050,17,043,"Illinois","DuPage County",4,60,12686,6179,6507
050,17,043,"Illinois","DuPage County",4,61,12793,6204,6589
050,17,043,"Illinois","DuPage County",4,62,12521,6131,6390
050,17,043,"Illinois","DuPage County",4,63,12228,5964,6264
050,17,043,"Illinois","DuPage County",4,64,12125,5850,6275
050,17,043,"Illinois","DuPage County",4,65,11839,5684,6155
050,17,043,"Illinois","DuPage County",4,66,11173,5378,5795
050,17,043,"Illinois","DuPage County",4,67,10830,5251,5579
050,17,043,"Illinois","DuPage County",4,68,10199,4979,5220
050,17,043,"Illinois","DuPage County",4,69,9767,4717,5050
050,17,043,"Illinois","DuPage County",4,70,9289,4392,4897
050,17,043,"Illinois","DuPage County",4,71,8753,4097,4656
050,17,043,"Illinois","DuPage County",4,72,8320,3904,4416
050,17,043,"Illinois","DuPage County",4,73,7947,3669,4278
050,17,043,"Illinois","DuPage County",4,74,7718,3567,4151
050,17,043,"Illinois","DuPage County",4,75,7880,3696,4184
050,17,043,"Illinois","DuPage County",4,76,5697,2602,3095
050,17,043,"Illinois","DuPage County",4,77,5320,2405,2915
050,17,043,"Illinois","DuPage County",4,78,5306,2350,2956
050,17,043,"Illinois","DuPage County",4,79,5236,2286,2950
050,17,043,"Illinois","DuPage County",4,80,4465,1941,2524
050,17,043,"Illinois","DuPage County",4,81,3909,1668,2241
050,17,043,"Illinois","DuPage County",4,82,3458,1436,2022
050,17,043,"Illinois","DuPage County",4,83,3142,1298,1844
050,17,043,"Illinois","DuPage County",4,84,2860,1148,1712
050,17,043,"Illinois","DuPage County",4,85,17454,5884,11570
050,17,043,"Illinois","DuPage County",5,0,9735,4883,4852
050,17,043,"Illinois","DuPage County",5,1,9810,4871,4939
050,17,043,"Illinois","DuPage County",5,2,9960,5069,4891
050,17,043,"Illinois","DuPage County",5,3,10237,5174,5063
050,17,043,"Illinois","DuPage County",5,4,10593,5459,5134
050,17,043,"Illinois","DuPage County",5,5,10922,5610,5312
050,17,043,"Illinois","DuPage County",5,6,11181,5660,5521
050,17,043,"Illinois","DuPage County",5,7,11401,5835,5566
050,17,043,"Illinois","DuPage County",5,8,11435,5854,5581
050,17,043,"Illinois","DuPage County",5,9,11260,5692,5568
050,17,043,"Illinois","DuPage County",5,10,11053,5658,5395
050,17,043,"Illinois","DuPage County",5,11,11205,5745,5460
050,17,043,"Illinois","DuPage County",5,12,11425,5871,5554
050,17,043,"Illinois","DuPage County",5,13,11871,6129,5742
050,17,043,"Illinois","DuPage County",5,14,12051,6238,5813
050,17,043,"Illinois","DuPage County",5,15,12508,6411,6097
050,17,043,"Illinois","DuPage County",5,16,12425,6325,6100
050,17,043,"Illinois","DuPage County",5,17,12506,6455,6051
050,17,043,"Illinois","DuPage County",5,18,11384,5991,5393
050,17,043,"Illinois","DuPage County",5,19,10657,5528,5129
050,17,043,"Illinois","DuPage County",5,20,10895,5555,5340
050,17,043,"Illinois","DuPage County",5,21,10644,5308,5336
050,17,043,"Illinois","DuPage County",5,22,10864,5408,5456
050,17,043,"Illinois","DuPage County",5,23,10792,5395,5397
050,17,043,"Illinois","DuPage County",5,24,10747,5475,5272
050,17,043,"Illinois","DuPage County",5,25,10692,5384,5308
050,17,043,"Illinois","DuPage County",5,26,10943,5571,5372
050,17,043,"Illinois","DuPage County",5,27,10709,5454,5255
050,17,043,"Illinois","DuPage County",5,28,10833,5502,5331
050,17,043,"Illinois","DuPage County",5,29,11044,5574,5470
050,17,043,"Illinois","DuPage County",5,30,11416,5763,5653
050,17,043,"Illinois","DuPage County",5,31,11554,5774,5780
050,17,043,"Illinois","DuPage County",5,32,11838,6038,5800
050,17,043,"Illinois","DuPage County",5,33,11778,5982,5796
050,17,043,"Illinois","DuPage County",5,34,11924,6091,5833
050,17,043,"Illinois","DuPage County",5,35,12120,6159,5961
050,17,043,"Illinois","DuPage County",5,36,12390,6270,6120
050,17,043,"Illinois","DuPage County",5,37,13050,6638,6412
050,17,043,"Illinois","DuPage County",5,38,13136,6661,6475
050,17,043,"Illinois","DuPage County",5,39,12760,6534,6226
050,17,043,"Illinois","DuPage County",5,40,12862,6552,6310
050,17,043,"Illinois","DuPage County",5,41,12941,6592,6349
050,17,043,"Illinois","DuPage County",5,42,12768,6473,6295
050,17,043,"Illinois","DuPage County",5,43,12713,6436,6277
050,17,043,"Illinois","DuPage County",5,44,12179,6158,6021
050,17,043,"Illinois","DuPage County",5,45,12005,5993,6012
050,17,043,"Illinois","DuPage County",5,46,11748,5924,5824
050,17,043,"Illinois","DuPage County",5,47,11209,5640,5569
050,17,043,"Illinois","DuPage County",5,48,11260,5722,5538
050,17,043,"Illinois","DuPage County",5,49,11003,5479,5524
050,17,043,"Illinois","DuPage County",5,50,11021,5447,5574
050,17,043,"Illinois","DuPage County",5,51,11549,5777,5772
050,17,043,"Illinois","DuPage County",5,52,12359,6231,6128
050,17,043,"Illinois","DuPage County",5,53,12216,6075,6141
050,17,043,"Illinois","DuPage County",5,54,11860,5924,5936
050,17,043,"Illinois","DuPage County",5,55,11742,5780,5962
050,17,043,"Illinois","DuPage County",5,56,11881,5838,6043
050,17,043,"Illinois","DuPage County",5,57,11737,5769,5968
050,17,043,"Illinois","DuPage County",5,58,12155,6018,6137
050,17,043,"Illinois","DuPage County",5,59,12412,6105,6307
050,17,043,"Illinois","DuPage County",5,60,12509,6037,6472
050,17,043,"Illinois","DuPage County",5,61,12467,6068,6399
050,17,043,"Illinois","DuPage County",5,62,12555,6091,6464
050,17,043,"Illinois","DuPage County",5,63,12242,5962,6280
050,17,043,"Illinois","DuPage County",5,64,11931,5828,6103
050,17,043,"Illinois","DuPage County",5,65,11871,5704,6167
050,17,043,"Illinois","DuPage County",5,66,11510,5487,6023
050,17,043,"Illinois","DuPage County",5,67,10887,5211,5676
050,17,043,"Illinois","DuPage County",5,68,10593,5114,5479
050,17,043,"Illinois","DuPage County",5,69,9983,4865,5118
050,17,043,"Illinois","DuPage County",5,70,9493,4543,4950
050,17,043,"Illinois","DuPage County",5,71,9116,4290,4826
050,17,043,"Illinois","DuPage County",5,72,8579,3966,4613
050,17,043,"Illinois","DuPage County",5,73,8111,3794,4317
050,17,043,"Illinois","DuPage County",5,74,7782,3573,4209
050,17,043,"Illinois","DuPage County",5,75,7496,3456,4040
050,17,043,"Illinois","DuPage County",5,76,7654,3561,4093
050,17,043,"Illinois","DuPage County",5,77,5528,2508,3020
050,17,043,"Illinois","DuPage County",5,78,5191,2344,2847
050,17,043,"Illinois","DuPage County",5,79,5098,2250,2848
050,17,043,"Illinois","DuPage County",5,80,5083,2199,2884
050,17,043,"Illinois","DuPage County",5,81,4293,1840,2453
050,17,043,"Illinois","DuPage County",5,82,3748,1584,2164
050,17,043,"Illinois","DuPage County",5,83,3294,1377,1917
050,17,043,"Illinois","DuPage County",5,84,2987,1203,1784
050,17,043,"Illinois","DuPage County",5,85,17844,6082,11762
050,17,045,"Illinois","Edgar County",1,0,158,81,77
050,17,045,"Illinois","Edgar County",1,1,160,86,74
050,17,045,"Illinois","Edgar County",1,2,180,92,88
050,17,045,"Illinois","Edgar County",1,3,182,96,86
050,17,045,"Illinois","Edgar County",1,4,187,98,89
050,17,045,"Illinois","Edgar County",1,5,166,92,74
050,17,045,"Illinois","Edgar County",1,6,166,85,81
050,17,045,"Illinois","Edgar County",1,7,175,97,78
050,17,045,"Illinois","Edgar County",1,8,172,96,76
050,17,045,"Illinois","Edgar County",1,9,177,91,86
050,17,045,"Illinois","Edgar County",1,10,195,97,98
050,17,045,"Illinois","Edgar County",1,11,199,102,97
050,17,045,"Illinois","Edgar County",1,12,212,98,114
050,17,045,"Illinois","Edgar County",1,13,200,98,102
050,17,045,"Illinois","Edgar County",1,14,208,108,100
050,17,045,"Illinois","Edgar County",1,15,206,102,104
050,17,045,"Illinois","Edgar County",1,16,216,110,106
050,17,045,"Illinois","Edgar County",1,17,222,110,112
050,17,045,"Illinois","Edgar County",1,18,186,100,86
050,17,045,"Illinois","Edgar County",1,19,133,72,61
050,17,045,"Illinois","Edgar County",1,20,159,85,74
050,17,045,"Illinois","Edgar County",1,21,166,84,82
050,17,045,"Illinois","Edgar County",1,22,178,81,97
050,17,045,"Illinois","Edgar County",1,23,157,86,71
050,17,045,"Illinois","Edgar County",1,24,179,96,83
050,17,045,"Illinois","Edgar County",1,25,173,82,91
050,17,045,"Illinois","Edgar County",1,26,185,83,102
050,17,045,"Illinois","Edgar County",1,27,163,79,84
050,17,045,"Illinois","Edgar County",1,28,163,77,86
050,17,045,"Illinois","Edgar County",1,29,172,83,89
050,17,045,"Illinois","Edgar County",1,30,183,92,91
050,17,045,"Illinois","Edgar County",1,31,180,89,91
050,17,045,"Illinois","Edgar County",1,32,175,90,85
050,17,045,"Illinois","Edgar County",1,33,179,95,84
050,17,045,"Illinois","Edgar County",1,34,189,96,93
050,17,045,"Illinois","Edgar County",1,35,192,101,91
050,17,045,"Illinois","Edgar County",1,36,176,90,86
050,17,045,"Illinois","Edgar County",1,37,211,96,115
050,17,045,"Illinois","Edgar County",1,38,213,101,112
050,17,045,"Illinois","Edgar County",1,39,199,93,106
050,17,045,"Illinois","Edgar County",1,40,210,98,112
050,17,045,"Illinois","Edgar County",1,41,201,100,101
050,17,045,"Illinois","Edgar County",1,42,210,110,100
050,17,045,"Illinois","Edgar County",1,43,190,95,95
050,17,045,"Illinois","Edgar County",1,44,177,84,93
050,17,045,"Illinois","Edgar County",1,45,190,104,86
050,17,045,"Illinois","Edgar County",1,46,218,113,105
050,17,045,"Illinois","Edgar County",1,47,235,122,113
050,17,045,"Illinois","Edgar County",1,48,209,114,95
050,17,045,"Illinois","Edgar County",1,49,228,122,106
050,17,045,"Illinois","Edgar County",1,50,209,107,102
050,17,045,"Illinois","Edgar County",1,51,209,107,102
050,17,045,"Illinois","Edgar County",1,52,197,110,87
050,17,045,"Illinois","Edgar County",1,53,196,104,92
050,17,045,"Illinois","Edgar County",1,54,186,90,96
050,17,045,"Illinois","Edgar County",1,55,216,101,115
050,17,045,"Illinois","Edgar County",1,56,254,125,129
050,17,045,"Illinois","Edgar County",1,57,244,125,119
050,17,045,"Illinois","Edgar County",1,58,263,146,117
050,17,045,"Illinois","Edgar County",1,59,269,132,137
050,17,045,"Illinois","Edgar County",1,60,285,142,143
050,17,045,"Illinois","Edgar County",1,61,292,146,146
050,17,045,"Illinois","Edgar County",1,62,266,131,135
050,17,045,"Illinois","Edgar County",1,63,265,126,139
050,17,045,"Illinois","Edgar County",1,64,270,126,144
050,17,045,"Illinois","Edgar County",1,65,251,125,126
050,17,045,"Illinois","Edgar County",1,66,266,138,128
050,17,045,"Illinois","Edgar County",1,67,255,132,123
050,17,045,"Illinois","Edgar County",1,68,239,122,117
050,17,045,"Illinois","Edgar County",1,69,201,104,97
050,17,045,"Illinois","Edgar County",1,70,194,93,101
050,17,045,"Illinois","Edgar County",1,71,196,98,98
050,17,045,"Illinois","Edgar County",1,72,201,94,107
050,17,045,"Illinois","Edgar County",1,73,206,86,120
050,17,045,"Illinois","Edgar County",1,74,151,68,83
050,17,045,"Illinois","Edgar County",1,75,154,67,87
050,17,045,"Illinois","Edgar County",1,76,153,70,83
050,17,045,"Illinois","Edgar County",1,77,146,68,78
050,17,045,"Illinois","Edgar County",1,78,133,58,75
050,17,045,"Illinois","Edgar County",1,79,119,54,65
050,17,045,"Illinois","Edgar County",1,80,114,46,68
050,17,045,"Illinois","Edgar County",1,81,94,36,58
050,17,045,"Illinois","Edgar County",1,82,99,40,59
050,17,045,"Illinois","Edgar County",1,83,93,33,60
050,17,045,"Illinois","Edgar County",1,84,92,33,59
050,17,045,"Illinois","Edgar County",1,85,518,157,361
050,17,045,"Illinois","Edgar County",2,0,159,86,73
050,17,045,"Illinois","Edgar County",2,1,158,84,74
050,17,045,"Illinois","Edgar County",2,2,174,90,84
050,17,045,"Illinois","Edgar County",2,3,183,97,86
050,17,045,"Illinois","Edgar County",2,4,185,98,87
050,17,045,"Illinois","Edgar County",2,5,169,92,77
050,17,045,"Illinois","Edgar County",2,6,166,85,81
050,17,045,"Illinois","Edgar County",2,7,171,94,77
050,17,045,"Illinois","Edgar County",2,8,173,97,76
050,17,045,"Illinois","Edgar County",2,9,172,90,82
050,17,045,"Illinois","Edgar County",2,10,190,95,95
050,17,045,"Illinois","Edgar County",2,11,194,99,95
050,17,045,"Illinois","Edgar County",2,12,208,99,109
050,17,045,"Illinois","Edgar County",2,13,202,97,105
050,17,045,"Illinois","Edgar County",2,14,204,105,99
050,17,045,"Illinois","Edgar County",2,15,205,103,102
050,17,045,"Illinois","Edgar County",2,16,214,108,106
050,17,045,"Illinois","Edgar County",2,17,218,109,109
050,17,045,"Illinois","Edgar County",2,18,184,98,86
050,17,045,"Illinois","Edgar County",2,19,134,73,61
050,17,045,"Illinois","Edgar County",2,20,156,83,73
050,17,045,"Illinois","Edgar County",2,21,165,84,81
050,17,045,"Illinois","Edgar County",2,22,175,82,93
050,17,045,"Illinois","Edgar County",2,23,164,87,77
050,17,045,"Illinois","Edgar County",2,24,173,93,80
050,17,045,"Illinois","Edgar County",2,25,175,85,90
050,17,045,"Illinois","Edgar County",2,26,182,82,100
050,17,045,"Illinois","Edgar County",2,27,165,78,87
050,17,045,"Illinois","Edgar County",2,28,162,76,86
050,17,045,"Illinois","Edgar County",2,29,168,81,87
050,17,045,"Illinois","Edgar County",2,30,184,92,92
050,17,045,"Illinois","Edgar County",2,31,177,87,90
050,17,045,"Illinois","Edgar County",2,32,175,91,84
050,17,045,"Illinois","Edgar County",2,33,177,94,83
050,17,045,"Illinois","Edgar County",2,34,185,95,90
050,17,045,"Illinois","Edgar County",2,35,193,101,92
050,17,045,"Illinois","Edgar County",2,36,178,91,87
050,17,045,"Illinois","Edgar County",2,37,203,96,107
050,17,045,"Illinois","Edgar County",2,38,211,99,112
050,17,045,"Illinois","Edgar County",2,39,201,95,106
050,17,045,"Illinois","Edgar County",2,40,206,96,110
050,17,045,"Illinois","Edgar County",2,41,203,99,104
050,17,045,"Illinois","Edgar County",2,42,207,107,100
050,17,045,"Illinois","Edgar County",2,43,196,99,97
050,17,045,"Illinois","Edgar County",2,44,176,85,91
050,17,045,"Illinois","Edgar County",2,45,185,98,87
050,17,045,"Illinois","Edgar County",2,46,212,112,100
050,17,045,"Illinois","Edgar County",2,47,229,119,110
050,17,045,"Illinois","Edgar County",2,48,214,115,99
050,17,045,"Illinois","Edgar County",2,49,224,121,103
050,17,045,"Illinois","Edgar County",2,50,214,111,103
050,17,045,"Illinois","Edgar County",2,51,208,107,101
050,17,045,"Illinois","Edgar County",2,52,199,109,90
050,17,045,"Illinois","Edgar County",2,53,195,104,91
050,17,045,"Illinois","Edgar County",2,54,187,91,96
050,17,045,"Illinois","Edgar County",2,55,210,98,112
050,17,045,"Illinois","Edgar County",2,56,248,120,128
050,17,045,"Illinois","Edgar County",2,57,247,126,121
050,17,045,"Illinois","Edgar County",2,58,257,141,116
050,17,045,"Illinois","Edgar County",2,59,267,134,133
050,17,045,"Illinois","Edgar County",2,60,277,137,140
050,17,045,"Illinois","Edgar County",2,61,290,143,147
050,17,045,"Illinois","Edgar County",2,62,271,133,138
050,17,045,"Illinois","Edgar County",2,63,266,127,139
050,17,045,"Illinois","Edgar County",2,64,266,124,142
050,17,045,"Illinois","Edgar County",2,65,254,124,130
050,17,045,"Illinois","Edgar County",2,66,262,135,127
050,17,045,"Illinois","Edgar County",2,67,258,134,124
050,17,045,"Illinois","Edgar County",2,68,239,120,119
050,17,045,"Illinois","Edgar County",2,69,209,107,102
050,17,045,"Illinois","Edgar County",2,70,192,95,97
050,17,045,"Illinois","Edgar County",2,71,194,96,98
050,17,045,"Illinois","Edgar County",2,72,198,94,104
050,17,045,"Illinois","Edgar County",2,73,213,91,122
050,17,045,"Illinois","Edgar County",2,74,155,68,87
050,17,045,"Illinois","Edgar County",2,75,157,68,89
050,17,045,"Illinois","Edgar County",2,76,151,69,82
050,17,045,"Illinois","Edgar County",2,77,150,69,81
050,17,045,"Illinois","Edgar County",2,78,131,58,73
050,17,045,"Illinois","Edgar County",2,79,119,53,66
050,17,045,"Illinois","Edgar County",2,80,119,49,70
050,17,045,"Illinois","Edgar County",2,81,96,37,59
050,17,045,"Illinois","Edgar County",2,82,101,40,61
050,17,045,"Illinois","Edgar County",2,83,90,34,56
050,17,045,"Illinois","Edgar County",2,84,94,35,59
050,17,045,"Illinois","Edgar County",2,85,518,156,362
050,17,045,"Illinois","Edgar County",3,0,177,91,86
050,17,045,"Illinois","Edgar County",3,1,162,79,83
050,17,045,"Illinois","Edgar County",3,2,161,85,76
050,17,045,"Illinois","Edgar County",3,3,180,91,89
050,17,045,"Illinois","Edgar County",3,4,169,90,79
050,17,045,"Illinois","Edgar County",3,5,178,96,82
050,17,045,"Illinois","Edgar County",3,6,171,94,77
050,17,045,"Illinois","Edgar County",3,7,165,84,81
050,17,045,"Illinois","Edgar County",3,8,168,93,75
050,17,045,"Illinois","Edgar County",3,9,172,95,77
050,17,045,"Illinois","Edgar County",3,10,167,83,84
050,17,045,"Illinois","Edgar County",3,11,182,92,90
050,17,045,"Illinois","Edgar County",3,12,193,101,92
050,17,045,"Illinois","Edgar County",3,13,210,102,108
050,17,045,"Illinois","Edgar County",3,14,199,98,101
050,17,045,"Illinois","Edgar County",3,15,208,108,100
050,17,045,"Illinois","Edgar County",3,16,199,98,101
050,17,045,"Illinois","Edgar County",3,17,218,111,107
050,17,045,"Illinois","Edgar County",3,18,187,97,90
050,17,045,"Illinois","Edgar County",3,19,143,74,69
050,17,045,"Illinois","Edgar County",3,20,139,73,66
050,17,045,"Illinois","Edgar County",3,21,165,88,77
050,17,045,"Illinois","Edgar County",3,22,168,86,82
050,17,045,"Illinois","Edgar County",3,23,178,83,95
050,17,045,"Illinois","Edgar County",3,24,157,90,67
050,17,045,"Illinois","Edgar County",3,25,160,88,72
050,17,045,"Illinois","Edgar County",3,26,174,89,85
050,17,045,"Illinois","Edgar County",3,27,176,85,91
050,17,045,"Illinois","Edgar County",3,28,150,73,77
050,17,045,"Illinois","Edgar County",3,29,157,74,83
050,17,045,"Illinois","Edgar County",3,30,172,81,91
050,17,045,"Illinois","Edgar County",3,31,184,96,88
050,17,045,"Illinois","Edgar County",3,32,181,88,93
050,17,045,"Illinois","Edgar County",3,33,181,95,86
050,17,045,"Illinois","Edgar County",3,34,189,102,87
050,17,045,"Illinois","Edgar County",3,35,188,92,96
050,17,045,"Illinois","Edgar County",3,36,189,98,91
050,17,045,"Illinois","Edgar County",3,37,183,93,90
050,17,045,"Illinois","Edgar County",3,38,205,98,107
050,17,045,"Illinois","Edgar County",3,39,218,104,114
050,17,045,"Illinois","Edgar County",3,40,198,95,103
050,17,045,"Illinois","Edgar County",3,41,206,96,110
050,17,045,"Illinois","Edgar County",3,42,208,103,105
050,17,045,"Illinois","Edgar County",3,43,198,101,97
050,17,045,"Illinois","Edgar County",3,44,198,99,99
050,17,045,"Illinois","Edgar County",3,45,167,82,85
050,17,045,"Illinois","Edgar County",3,46,182,97,85
050,17,045,"Illinois","Edgar County",3,47,208,109,99
050,17,045,"Illinois","Edgar County",3,48,230,118,112
050,17,045,"Illinois","Edgar County",3,49,212,115,97
050,17,045,"Illinois","Edgar County",3,50,225,121,104
050,17,045,"Illinois","Edgar County",3,51,209,109,100
050,17,045,"Illinois","Edgar County",3,52,198,102,96
050,17,045,"Illinois","Edgar County",3,53,192,106,86
050,17,045,"Illinois","Edgar County",3,54,189,99,90
050,17,045,"Illinois","Edgar County",3,55,183,90,93
050,17,045,"Illinois","Edgar County",3,56,203,98,105
050,17,045,"Illinois","Edgar County",3,57,244,115,129
050,17,045,"Illinois","Edgar County",3,58,244,126,118
050,17,045,"Illinois","Edgar County",3,59,257,139,118
050,17,045,"Illinois","Edgar County",3,60,253,125,128
050,17,045,"Illinois","Edgar County",3,61,279,140,139
050,17,045,"Illinois","Edgar County",3,62,283,139,144
050,17,045,"Illinois","Edgar County",3,63,268,129,139
050,17,045,"Illinois","Edgar County",3,64,265,127,138
050,17,045,"Illinois","Edgar County",3,65,260,123,137
050,17,045,"Illinois","Edgar County",3,66,256,121,135
050,17,045,"Illinois","Edgar County",3,67,261,133,128
050,17,045,"Illinois","Edgar County",3,68,249,126,123
050,17,045,"Illinois","Edgar County",3,69,231,117,114
050,17,045,"Illinois","Edgar County",3,70,202,105,97
050,17,045,"Illinois","Edgar County",3,71,187,87,100
050,17,045,"Illinois","Edgar County",3,72,192,95,97
050,17,045,"Illinois","Edgar County",3,73,192,90,102
050,17,045,"Illinois","Edgar County",3,74,204,84,120
050,17,045,"Illinois","Edgar County",3,75,149,64,85
050,17,045,"Illinois","Edgar County",3,76,148,66,82
050,17,045,"Illinois","Edgar County",3,77,140,63,77
050,17,045,"Illinois","Edgar County",3,78,135,62,73
050,17,045,"Illinois","Edgar County",3,79,124,55,69
050,17,045,"Illinois","Edgar County",3,80,125,55,70
050,17,045,"Illinois","Edgar County",3,81,102,44,58
050,17,045,"Illinois","Edgar County",3,82,99,33,66
050,17,045,"Illinois","Edgar County",3,83,89,32,57
050,17,045,"Illinois","Edgar County",3,84,96,43,53
050,17,045,"Illinois","Edgar County",3,85,513,153,360
050,17,045,"Illinois","Edgar County",4,0,135,64,71
050,17,045,"Illinois","Edgar County",4,1,179,89,90
050,17,045,"Illinois","Edgar County",4,2,155,75,80
050,17,045,"Illinois","Edgar County",4,3,157,81,76
050,17,045,"Illinois","Edgar County",4,4,173,88,85
050,17,045,"Illinois","Edgar County",4,5,169,94,75
050,17,045,"Illinois","Edgar County",4,6,180,98,82
050,17,045,"Illinois","Edgar County",4,7,170,91,79
050,17,045,"Illinois","Edgar County",4,8,169,83,86
050,17,045,"Illinois","Edgar County",4,9,177,96,81
050,17,045,"Illinois","Edgar County",4,10,173,95,78
050,17,045,"Illinois","Edgar County",4,11,161,82,79
050,17,045,"Illinois","Edgar County",4,12,189,93,96
050,17,045,"Illinois","Edgar County",4,13,205,108,97
050,17,045,"Illinois","Edgar County",4,14,215,104,111
050,17,045,"Illinois","Edgar County",4,15,201,95,106
050,17,045,"Illinois","Edgar County",4,16,209,107,102
050,17,045,"Illinois","Edgar County",4,17,205,95,110
050,17,045,"Illinois","Edgar County",4,18,174,93,81
050,17,045,"Illinois","Edgar County",4,19,130,70,60
050,17,045,"Illinois","Edgar County",4,20,149,75,74
050,17,045,"Illinois","Edgar County",4,21,145,72,73
050,17,045,"Illinois","Edgar County",4,22,168,93,75
050,17,045,"Illinois","Edgar County",4,23,163,81,82
050,17,045,"Illinois","Edgar County",4,24,175,86,89
050,17,045,"Illinois","Edgar County",4,25,145,84,61
050,17,045,"Illinois","Edgar County",4,26,157,85,72
050,17,045,"Illinois","Edgar County",4,27,167,85,82
050,17,045,"Illinois","Edgar County",4,28,179,85,94
050,17,045,"Illinois","Edgar County",4,29,165,75,90
050,17,045,"Illinois","Edgar County",4,30,152,81,71
050,17,045,"Illinois","Edgar County",4,31,165,76,89
050,17,045,"Illinois","Edgar County",4,32,176,94,82
050,17,045,"Illinois","Edgar County",4,33,192,91,101
050,17,045,"Illinois","Edgar County",4,34,178,94,84
050,17,045,"Illinois","Edgar County",4,35,192,104,88
050,17,045,"Illinois","Edgar County",4,36,190,91,99
050,17,045,"Illinois","Edgar County",4,37,190,101,89
050,17,045,"Illinois","Edgar County",4,38,182,90,92
050,17,045,"Illinois","Edgar County",4,39,203,94,109
050,17,045,"Illinois","Edgar County",4,40,216,101,115
050,17,045,"Illinois","Edgar County",4,41,203,95,108
050,17,045,"Illinois","Edgar County",4,42,202,96,106
050,17,045,"Illinois","Edgar County",4,43,202,98,104
050,17,045,"Illinois","Edgar County",4,44,191,95,96
050,17,045,"Illinois","Edgar County",4,45,195,99,96
050,17,045,"Illinois","Edgar County",4,46,169,86,83
050,17,045,"Illinois","Edgar County",4,47,181,93,88
050,17,045,"Illinois","Edgar County",4,48,216,119,97
050,17,045,"Illinois","Edgar County",4,49,227,113,114
050,17,045,"Illinois","Edgar County",4,50,215,116,99
050,17,045,"Illinois","Edgar County",4,51,230,125,105
050,17,045,"Illinois","Edgar County",4,52,210,108,102
050,17,045,"Illinois","Edgar County",4,53,195,98,97
050,17,045,"Illinois","Edgar County",4,54,189,101,88
050,17,045,"Illinois","Edgar County",4,55,187,98,89
050,17,045,"Illinois","Edgar County",4,56,182,87,95
050,17,045,"Illinois","Edgar County",4,57,203,93,110
050,17,045,"Illinois","Edgar County",4,58,241,111,130
050,17,045,"Illinois","Edgar County",4,59,246,128,118
050,17,045,"Illinois","Edgar County",4,60,248,130,118
050,17,045,"Illinois","Edgar County",4,61,252,126,126
050,17,045,"Illinois","Edgar County",4,62,276,135,141
050,17,045,"Illinois","Edgar County",4,63,281,139,142
050,17,045,"Illinois","Edgar County",4,64,263,131,132
050,17,045,"Illinois","Edgar County",4,65,256,125,131
050,17,045,"Illinois","Edgar County",4,66,257,119,138
050,17,045,"Illinois","Edgar County",4,67,254,118,136
050,17,045,"Illinois","Edgar County",4,68,256,129,127
050,17,045,"Illinois","Edgar County",4,69,234,116,118
050,17,045,"Illinois","Edgar County",4,70,219,108,111
050,17,045,"Illinois","Edgar County",4,71,198,101,97
050,17,045,"Illinois","Edgar County",4,72,186,87,99
050,17,045,"Illinois","Edgar County",4,73,184,91,93
050,17,045,"Illinois","Edgar County",4,74,188,87,101
050,17,045,"Illinois","Edgar County",4,75,201,78,123
050,17,045,"Illinois","Edgar County",4,76,136,62,74
050,17,045,"Illinois","Edgar County",4,77,140,61,79
050,17,045,"Illinois","Edgar County",4,78,126,57,69
050,17,045,"Illinois","Edgar County",4,79,124,56,68
050,17,045,"Illinois","Edgar County",4,80,126,54,72
050,17,045,"Illinois","Edgar County",4,81,110,46,64
050,17,045,"Illinois","Edgar County",4,82,106,44,62
050,17,045,"Illinois","Edgar County",4,83,89,29,60
050,17,045,"Illinois","Edgar County",4,84,91,40,51
050,17,045,"Illinois","Edgar County",4,85,525,174,351
050,17,045,"Illinois","Edgar County",5,0,109,49,60
050,17,045,"Illinois","Edgar County",5,1,143,72,71
050,17,045,"Illinois","Edgar County",5,2,187,90,97
050,17,045,"Illinois","Edgar County",5,3,156,78,78
050,17,045,"Illinois","Edgar County",5,4,168,89,79
050,17,045,"Illinois","Edgar County",5,5,163,89,74
050,17,045,"Illinois","Edgar County",5,6,182,101,81
050,17,045,"Illinois","Edgar County",5,7,190,103,87
050,17,045,"Illinois","Edgar County",5,8,180,94,86
050,17,045,"Illinois","Edgar County",5,9,171,85,86
050,17,045,"Illinois","Edgar County",5,10,184,99,85
050,17,045,"Illinois","Edgar County",5,11,175,99,76
050,17,045,"Illinois","Edgar County",5,12,162,83,79
050,17,045,"Illinois","Edgar County",5,13,192,95,97
050,17,045,"Illinois","Edgar County",5,14,203,109,94
050,17,045,"Illinois","Edgar County",5,15,213,107,106
050,17,045,"Illinois","Edgar County",5,16,207,102,105
050,17,045,"Illinois","Edgar County",5,17,217,113,104
050,17,045,"Illinois","Edgar County",5,18,172,86,86
050,17,045,"Illinois","Edgar County",5,19,137,73,64
050,17,045,"Illinois","Edgar County",5,20,140,76,64
050,17,045,"Illinois","Edgar County",5,21,155,74,81
050,17,045,"Illinois","Edgar County",5,22,155,79,76
050,17,045,"Illinois","Edgar County",5,23,180,98,82
050,17,045,"Illinois","Edgar County",5,24,162,76,86
050,17,045,"Illinois","Edgar County",5,25,182,88,94
050,17,045,"Illinois","Edgar County",5,26,145,88,57
050,17,045,"Illinois","Edgar County",5,27,157,80,77
050,17,045,"Illinois","Edgar County",5,28,166,84,82
050,17,045,"Illinois","Edgar County",5,29,179,83,96
050,17,045,"Illinois","Edgar County",5,30,168,77,91
050,17,045,"Illinois","Edgar County",5,31,150,75,75
050,17,045,"Illinois","Edgar County",5,32,171,85,86
050,17,045,"Illinois","Edgar County",5,33,185,100,85
050,17,045,"Illinois","Edgar County",5,34,195,86,109
050,17,045,"Illinois","Edgar County",5,35,180,97,83
050,17,045,"Illinois","Edgar County",5,36,192,99,93
050,17,045,"Illinois","Edgar County",5,37,190,95,95
050,17,045,"Illinois","Edgar County",5,38,201,107,94
050,17,045,"Illinois","Edgar County",5,39,179,89,90
050,17,045,"Illinois","Edgar County",5,40,196,89,107
050,17,045,"Illinois","Edgar County",5,41,225,108,117
050,17,045,"Illinois","Edgar County",5,42,206,94,112
050,17,045,"Illinois","Edgar County",5,43,201,95,106
050,17,045,"Illinois","Edgar County",5,44,210,104,106
050,17,045,"Illinois","Edgar County",5,45,194,98,96
050,17,045,"Illinois","Edgar County",5,46,199,101,98
050,17,045,"Illinois","Edgar County",5,47,161,79,82
050,17,045,"Illinois","Edgar County",5,48,182,94,88
050,17,045,"Illinois","Edgar County",5,49,211,116,95
050,17,045,"Illinois","Edgar County",5,50,226,111,115
050,17,045,"Illinois","Edgar County",5,51,208,110,98
050,17,045,"Illinois","Edgar County",5,52,233,126,107
050,17,045,"Illinois","Edgar County",5,53,204,107,97
050,17,045,"Illinois","Edgar County",5,54,193,96,97
050,17,045,"Illinois","Edgar County",5,55,185,98,87
050,17,045,"Illinois","Edgar County",5,56,187,97,90
050,17,045,"Illinois","Edgar County",5,57,185,85,100
050,17,045,"Illinois","Edgar County",5,58,204,91,113
050,17,045,"Illinois","Edgar County",5,59,235,109,126
050,17,045,"Illinois","Edgar County",5,60,238,122,116
050,17,045,"Illinois","Edgar County",5,61,248,129,119
050,17,045,"Illinois","Edgar County",5,62,249,125,124
050,17,045,"Illinois","Edgar County",5,63,270,132,138
050,17,045,"Illinois","Edgar County",5,64,275,137,138
050,17,045,"Illinois","Edgar County",5,65,246,124,122
050,17,045,"Illinois","Edgar County",5,66,256,120,136
050,17,045,"Illinois","Edgar County",5,67,254,114,140
050,17,045,"Illinois","Edgar County",5,68,245,112,133
050,17,045,"Illinois","Edgar County",5,69,248,124,124
050,17,045,"Illinois","Edgar County",5,70,227,113,114
050,17,045,"Illinois","Edgar County",5,71,212,104,108
050,17,045,"Illinois","Edgar County",5,72,205,101,104
050,17,045,"Illinois","Edgar County",5,73,180,86,94
050,17,045,"Illinois","Edgar County",5,74,179,87,92
050,17,045,"Illinois","Edgar County",5,75,180,78,102
050,17,045,"Illinois","Edgar County",5,76,185,77,108
050,17,045,"Illinois","Edgar County",5,77,127,56,71
050,17,045,"Illinois","Edgar County",5,78,128,55,73
050,17,045,"Illinois","Edgar County",5,79,114,50,64
050,17,045,"Illinois","Edgar County",5,80,127,58,69
050,17,045,"Illinois","Edgar County",5,81,113,47,66
050,17,045,"Illinois","Edgar County",5,82,117,48,69
050,17,045,"Illinois","Edgar County",5,83,96,38,58
050,17,045,"Illinois","Edgar County",5,84,95,37,58
050,17,045,"Illinois","Edgar County",5,85,532,185,347
050,17,047,"Illinois","Edwards County",1,0,87,46,41
050,17,047,"Illinois","Edwards County",1,1,83,39,44
050,17,047,"Illinois","Edwards County",1,2,76,27,49
050,17,047,"Illinois","Edwards County",1,3,72,31,41
050,17,047,"Illinois","Edwards County",1,4,72,36,36
050,17,047,"Illinois","Edwards County",1,5,70,36,34
050,17,047,"Illinois","Edwards County",1,6,79,36,43
050,17,047,"Illinois","Edwards County",1,7,82,38,44
050,17,047,"Illinois","Edwards County",1,8,80,43,37
050,17,047,"Illinois","Edwards County",1,9,70,35,35
050,17,047,"Illinois","Edwards County",1,10,78,35,43
050,17,047,"Illinois","Edwards County",1,11,86,43,43
050,17,047,"Illinois","Edwards County",1,12,97,47,50
050,17,047,"Illinois","Edwards County",1,13,70,42,28
050,17,047,"Illinois","Edwards County",1,14,77,40,37
050,17,047,"Illinois","Edwards County",1,15,89,44,45
050,17,047,"Illinois","Edwards County",1,16,98,56,42
050,17,047,"Illinois","Edwards County",1,17,87,48,39
050,17,047,"Illinois","Edwards County",1,18,62,33,29
050,17,047,"Illinois","Edwards County",1,19,60,31,29
050,17,047,"Illinois","Edwards County",1,20,55,25,30
050,17,047,"Illinois","Edwards County",1,21,59,29,30
050,17,047,"Illinois","Edwards County",1,22,55,29,26
050,17,047,"Illinois","Edwards County",1,23,64,34,30
050,17,047,"Illinois","Edwards County",1,24,60,32,28
050,17,047,"Illinois","Edwards County",1,25,52,25,27
050,17,047,"Illinois","Edwards County",1,26,54,25,29
050,17,047,"Illinois","Edwards County",1,27,71,40,31
050,17,047,"Illinois","Edwards County",1,28,74,39,35
050,17,047,"Illinois","Edwards County",1,29,61,32,29
050,17,047,"Illinois","Edwards County",1,30,73,34,39
050,17,047,"Illinois","Edwards County",1,31,54,25,29
050,17,047,"Illinois","Edwards County",1,32,62,34,28
050,17,047,"Illinois","Edwards County",1,33,61,33,28
050,17,047,"Illinois","Edwards County",1,34,64,33,31
050,17,047,"Illinois","Edwards County",1,35,64,31,33
050,17,047,"Illinois","Edwards County",1,36,59,26,33
050,17,047,"Illinois","Edwards County",1,37,79,39,40
050,17,047,"Illinois","Edwards County",1,38,77,42,35
050,17,047,"Illinois","Edwards County",1,39,76,41,35
050,17,047,"Illinois","Edwards County",1,40,74,34,40
050,17,047,"Illinois","Edwards County",1,41,71,34,37
050,17,047,"Illinois","Edwards County",1,42,76,37,39
050,17,047,"Illinois","Edwards County",1,43,76,41,35
050,17,047,"Illinois","Edwards County",1,44,74,37,37
050,17,047,"Illinois","Edwards County",1,45,72,35,37
050,17,047,"Illinois","Edwards County",1,46,66,30,36
050,17,047,"Illinois","Edwards County",1,47,74,44,30
050,17,047,"Illinois","Edwards County",1,48,83,45,38
050,17,047,"Illinois","Edwards County",1,49,90,47,43
050,17,047,"Illinois","Edwards County",1,50,78,41,37
050,17,047,"Illinois","Edwards County",1,51,80,40,40
050,17,047,"Illinois","Edwards County",1,52,79,41,38
050,17,047,"Illinois","Edwards County",1,53,88,43,45
050,17,047,"Illinois","Edwards County",1,54,86,45,41
050,17,047,"Illinois","Edwards County",1,55,92,47,45
050,17,047,"Illinois","Edwards County",1,56,85,48,37
050,17,047,"Illinois","Edwards County",1,57,76,39,37
050,17,047,"Illinois","Edwards County",1,58,83,42,41
050,17,047,"Illinois","Edwards County",1,59,78,39,39
050,17,047,"Illinois","Edwards County",1,60,99,46,53
050,17,047,"Illinois","Edwards County",1,61,100,51,49
050,17,047,"Illinois","Edwards County",1,62,97,53,44
050,17,047,"Illinois","Edwards County",1,63,81,44,37
050,17,047,"Illinois","Edwards County",1,64,92,45,47
050,17,047,"Illinois","Edwards County",1,65,93,42,51
050,17,047,"Illinois","Edwards County",1,66,86,40,46
050,17,047,"Illinois","Edwards County",1,67,77,30,47
050,17,047,"Illinois","Edwards County",1,68,86,42,44
050,17,047,"Illinois","Edwards County",1,69,75,35,40
050,17,047,"Illinois","Edwards County",1,70,76,38,38
050,17,047,"Illinois","Edwards County",1,71,74,38,36
050,17,047,"Illinois","Edwards County",1,72,75,36,39
050,17,047,"Illinois","Edwards County",1,73,88,40,48
050,17,047,"Illinois","Edwards County",1,74,54,24,30
050,17,047,"Illinois","Edwards County",1,75,44,22,22
050,17,047,"Illinois","Edwards County",1,76,50,27,23
050,17,047,"Illinois","Edwards County",1,77,51,23,28
050,17,047,"Illinois","Edwards County",1,78,39,17,22
050,17,047,"Illinois","Edwards County",1,79,42,15,27
050,17,047,"Illinois","Edwards County",1,80,40,17,23
050,17,047,"Illinois","Edwards County",1,81,37,16,21
050,17,047,"Illinois","Edwards County",1,82,37,17,20
050,17,047,"Illinois","Edwards County",1,83,28,9,19
050,17,047,"Illinois","Edwards County",1,84,27,8,19
050,17,047,"Illinois","Edwards County",1,85,167,47,120
050,17,047,"Illinois","Edwards County",2,0,71,39,32
050,17,047,"Illinois","Edwards County",2,1,83,40,43
050,17,047,"Illinois","Edwards County",2,2,76,30,46
050,17,047,"Illinois","Edwards County",2,3,72,29,43
050,17,047,"Illinois","Edwards County",2,4,72,35,37
050,17,047,"Illinois","Edwards County",2,5,72,37,35
050,17,047,"Illinois","Edwards County",2,6,78,36,42
050,17,047,"Illinois","Edwards County",2,7,80,37,43
050,17,047,"Illinois","Edwards County",2,8,81,41,40
050,17,047,"Illinois","Edwards County",2,9,73,37,36
050,17,047,"Illinois","Edwards County",2,10,75,34,41
050,17,047,"Illinois","Edwards County",2,11,84,40,44
050,17,047,"Illinois","Edwards County",2,12,93,46,47
050,17,047,"Illinois","Edwards County",2,13,75,42,33
050,17,047,"Illinois","Edwards County",2,14,75,40,35
050,17,047,"Illinois","Edwards County",2,15,86,44,42
050,17,047,"Illinois","Edwards County",2,16,96,53,43
050,17,047,"Illinois","Edwards County",2,17,89,50,39
050,17,047,"Illinois","Edwards County",2,18,65,35,30
050,17,047,"Illinois","Edwards County",2,19,58,30,28
050,17,047,"Illinois","Edwards County",2,20,57,27,30
050,17,047,"Illinois","Edwards County",2,21,56,28,28
050,17,047,"Illinois","Edwards County",2,22,58,31,27
050,17,047,"Illinois","Edwards County",2,23,61,33,28
050,17,047,"Illinois","Edwards County",2,24,59,31,28
050,17,047,"Illinois","Edwards County",2,25,52,27,25
050,17,047,"Illinois","Edwards County",2,26,54,26,28
050,17,047,"Illinois","Edwards County",2,27,66,37,29
050,17,047,"Illinois","Edwards County",2,28,71,38,33
050,17,047,"Illinois","Edwards County",2,29,64,34,30
050,17,047,"Illinois","Edwards County",2,30,69,33,36
050,17,047,"Illinois","Edwards County",2,31,60,28,32
050,17,047,"Illinois","Edwards County",2,32,60,31,29
050,17,047,"Illinois","Edwards County",2,33,61,33,28
050,17,047,"Illinois","Edwards County",2,34,63,33,30
050,17,047,"Illinois","Edwards County",2,35,65,32,33
050,17,047,"Illinois","Edwards County",2,36,61,28,33
050,17,047,"Illinois","Edwards County",2,37,74,36,38
050,17,047,"Illinois","Edwards County",2,38,78,41,37
050,17,047,"Illinois","Edwards County",2,39,75,40,35
050,17,047,"Illinois","Edwards County",2,40,75,36,39
050,17,047,"Illinois","Edwards County",2,41,71,34,37
050,17,047,"Illinois","Edwards County",2,42,74,36,38
050,17,047,"Illinois","Edwards County",2,43,78,41,37
050,17,047,"Illinois","Edwards County",2,44,73,37,36
050,17,047,"Illinois","Edwards County",2,45,73,36,37
050,17,047,"Illinois","Edwards County",2,46,67,31,36
050,17,047,"Illinois","Edwards County",2,47,73,41,32
050,17,047,"Illinois","Edwards County",2,48,80,44,36
050,17,047,"Illinois","Edwards County",2,49,91,48,43
050,17,047,"Illinois","Edwards County",2,50,80,42,38
050,17,047,"Illinois","Edwards County",2,51,79,40,39
050,17,047,"Illinois","Edwards County",2,52,79,41,38
050,17,047,"Illinois","Edwards County",2,53,86,43,43
050,17,047,"Illinois","Edwards County",2,54,85,44,41
050,17,047,"Illinois","Edwards County",2,55,91,47,44
050,17,047,"Illinois","Edwards County",2,56,87,48,39
050,17,047,"Illinois","Edwards County",2,57,78,41,37
050,17,047,"Illinois","Edwards County",2,58,80,40,40
050,17,047,"Illinois","Edwards County",2,59,80,40,40
050,17,047,"Illinois","Edwards County",2,60,94,44,50
050,17,047,"Illinois","Edwards County",2,61,99,50,49
050,17,047,"Illinois","Edwards County",2,62,95,50,45
050,17,047,"Illinois","Edwards County",2,63,85,47,38
050,17,047,"Illinois","Edwards County",2,64,88,45,43
050,17,047,"Illinois","Edwards County",2,65,91,41,50
050,17,047,"Illinois","Edwards County",2,66,85,39,46
050,17,047,"Illinois","Edwards County",2,67,79,32,47
050,17,047,"Illinois","Edwards County",2,68,83,39,44
050,17,047,"Illinois","Edwards County",2,69,78,36,42
050,17,047,"Illinois","Edwards County",2,70,75,37,38
050,17,047,"Illinois","Edwards County",2,71,75,39,36
050,17,047,"Illinois","Edwards County",2,72,73,36,37
050,17,047,"Illinois","Edwards County",2,73,90,41,49
050,17,047,"Illinois","Edwards County",2,74,57,26,31
050,17,047,"Illinois","Edwards County",2,75,48,23,25
050,17,047,"Illinois","Edwards County",2,76,47,25,22
050,17,047,"Illinois","Edwards County",2,77,52,25,27
050,17,047,"Illinois","Edwards County",2,78,40,18,22
050,17,047,"Illinois","Edwards County",2,79,41,16,25
050,17,047,"Illinois","Edwards County",2,80,40,16,24
050,17,047,"Illinois","Edwards County",2,81,38,16,22
050,17,047,"Illinois","Edwards County",2,82,38,17,21
050,17,047,"Illinois","Edwards County",2,83,29,11,18
050,17,047,"Illinois","Edwards County",2,84,27,8,19
050,17,047,"Illinois","Edwards County",2,85,163,45,118
050,17,047,"Illinois","Edwards County",3,0,56,31,25
050,17,047,"Illinois","Edwards County",3,1,62,34,28
050,17,047,"Illinois","Edwards County",3,2,75,35,40
050,17,047,"Illinois","Edwards County",3,3,75,23,52
050,17,047,"Illinois","Edwards County",3,4,66,27,39
050,17,047,"Illinois","Edwards County",3,5,69,31,38
050,17,047,"Illinois","Edwards County",3,6,75,38,37
050,17,047,"Illinois","Edwards County",3,7,76,35,41
050,17,047,"Illinois","Edwards County",3,8,76,35,41
050,17,047,"Illinois","Edwards County",3,9,84,38,46
050,17,047,"Illinois","Edwards County",3,10,77,38,39
050,17,047,"Illinois","Edwards County",3,11,71,32,39
050,17,047,"Illinois","Edwards County",3,12,76,36,40
050,17,047,"Illinois","Edwards County",3,13,92,44,48
050,17,047,"Illinois","Edwards County",3,14,69,39,30
050,17,047,"Illinois","Edwards County",3,15,74,40,34
050,17,047,"Illinois","Edwards County",3,16,87,41,46
050,17,047,"Illinois","Edwards County",3,17,97,54,43
050,17,047,"Illinois","Edwards County",3,18,76,46,30
050,17,047,"Illinois","Edwards County",3,19,52,29,23
050,17,047,"Illinois","Edwards County",3,20,58,31,27
050,17,047,"Illinois","Edwards County",3,21,60,25,35
050,17,047,"Illinois","Edwards County",3,22,64,30,34
050,17,047,"Illinois","Edwards County",3,23,57,28,29
050,17,047,"Illinois","Edwards County",3,24,51,30,21
050,17,047,"Illinois","Edwards County",3,25,57,26,31
050,17,047,"Illinois","Edwards County",3,26,51,23,28
050,17,047,"Illinois","Edwards County",3,27,50,23,27
050,17,047,"Illinois","Edwards County",3,28,62,35,27
050,17,047,"Illinois","Edwards County",3,29,67,35,32
050,17,047,"Illinois","Edwards County",3,30,68,36,32
050,17,047,"Illinois","Edwards County",3,31,64,33,31
050,17,047,"Illinois","Edwards County",3,32,57,27,30
050,17,047,"Illinois","Edwards County",3,33,57,29,28
050,17,047,"Illinois","Edwards County",3,34,59,33,26
050,17,047,"Illinois","Edwards County",3,35,62,33,29
050,17,047,"Illinois","Edwards County",3,36,66,34,32
050,17,047,"Illinois","Edwards County",3,37,60,26,34
050,17,047,"Illinois","Edwards County",3,38,71,39,32
050,17,047,"Illinois","Edwards County",3,39,72,37,35
050,17,047,"Illinois","Edwards County",3,40,78,40,38
050,17,047,"Illinois","Edwards County",3,41,78,39,39
050,17,047,"Illinois","Edwards County",3,42,65,30,35
050,17,047,"Illinois","Edwards County",3,43,75,35,40
050,17,047,"Illinois","Edwards County",3,44,73,40,33
050,17,047,"Illinois","Edwards County",3,45,77,37,40
050,17,047,"Illinois","Edwards County",3,46,74,36,38
050,17,047,"Illinois","Edwards County",3,47,69,32,37
050,17,047,"Illinois","Edwards County",3,48,70,39,31
050,17,047,"Illinois","Edwards County",3,49,78,42,36
050,17,047,"Illinois","Edwards County",3,50,85,41,44
050,17,047,"Illinois","Edwards County",3,51,80,42,38
050,17,047,"Illinois","Edwards County",3,52,80,41,39
050,17,047,"Illinois","Edwards County",3,53,78,41,37
050,17,047,"Illinois","Edwards County",3,54,87,44,43
050,17,047,"Illinois","Edwards County",3,55,84,43,41
050,17,047,"Illinois","Edwards County",3,56,91,49,42
050,17,047,"Illinois","Edwards County",3,57,87,48,39
050,17,047,"Illinois","Edwards County",3,58,76,41,35
050,17,047,"Illinois","Edwards County",3,59,80,41,39
050,17,047,"Illinois","Edwards County",3,60,80,41,39
050,17,047,"Illinois","Edwards County",3,61,94,42,52
050,17,047,"Illinois","Edwards County",3,62,103,54,49
050,17,047,"Illinois","Edwards County",3,63,93,47,46
050,17,047,"Illinois","Edwards County",3,64,80,42,38
050,17,047,"Illinois","Edwards County",3,65,89,45,44
050,17,047,"Illinois","Edwards County",3,66,90,41,49
050,17,047,"Illinois","Edwards County",3,67,86,40,46
050,17,047,"Illinois","Edwards County",3,68,76,30,46
050,17,047,"Illinois","Edwards County",3,69,81,39,42
050,17,047,"Illinois","Edwards County",3,70,77,36,41
050,17,047,"Illinois","Edwards County",3,71,73,34,39
050,17,047,"Illinois","Edwards County",3,72,72,35,37
050,17,047,"Illinois","Edwards County",3,73,72,35,37
050,17,047,"Illinois","Edwards County",3,74,84,39,45
050,17,047,"Illinois","Edwards County",3,75,59,26,33
050,17,047,"Illinois","Edwards County",3,76,45,20,25
050,17,047,"Illinois","Edwards County",3,77,42,22,20
050,17,047,"Illinois","Edwards County",3,78,49,21,28
050,17,047,"Illinois","Edwards County",3,79,38,18,20
050,17,047,"Illinois","Edwards County",3,80,38,14,24
050,17,047,"Illinois","Edwards County",3,81,40,15,25
050,17,047,"Illinois","Edwards County",3,82,36,14,22
050,17,047,"Illinois","Edwards County",3,83,32,13,19
050,17,047,"Illinois","Edwards County",3,84,29,10,19
050,17,047,"Illinois","Edwards County",3,85,163,47,116
050,17,047,"Illinois","Edwards County",4,0,43,25,18
050,17,047,"Illinois","Edwards County",4,1,61,30,31
050,17,047,"Illinois","Edwards County",4,2,67,36,31
050,17,047,"Illinois","Edwards County",4,3,77,37,40
050,17,047,"Illinois","Edwards County",4,4,76,24,52
050,17,047,"Illinois","Edwards County",4,5,69,28,41
050,17,047,"Illinois","Edwards County",4,6,75,32,43
050,17,047,"Illinois","Edwards County",4,7,70,35,35
050,17,047,"Illinois","Edwards County",4,8,82,38,44
050,17,047,"Illinois","Edwards County",4,9,80,39,41
050,17,047,"Illinois","Edwards County",4,10,83,39,44
050,17,047,"Illinois","Edwards County",4,11,83,40,43
050,17,047,"Illinois","Edwards County",4,12,72,34,38
050,17,047,"Illinois","Edwards County",4,13,78,37,41
050,17,047,"Illinois","Edwards County",4,14,89,40,49
050,17,047,"Illinois","Edwards County",4,15,65,38,27
050,17,047,"Illinois","Edwards County",4,16,74,42,32
050,17,047,"Illinois","Edwards County",4,17,87,41,46
050,17,047,"Illinois","Edwards County",4,18,78,43,35
050,17,047,"Illinois","Edwards County",4,19,56,33,23
050,17,047,"Illinois","Edwards County",4,20,55,32,23
050,17,047,"Illinois","Edwards County",4,21,62,33,29
050,17,047,"Illinois","Edwards County",4,22,58,27,31
050,17,047,"Illinois","Edwards County",4,23,61,27,34
050,17,047,"Illinois","Edwards County",4,24,67,36,31
050,17,047,"Illinois","Edwards County",4,25,58,34,24
050,17,047,"Illinois","Edwards County",4,26,54,24,30
050,17,047,"Illinois","Edwards County",4,27,52,23,29
050,17,047,"Illinois","Edwards County",4,28,53,24,29
050,17,047,"Illinois","Edwards County",4,29,59,32,27
050,17,047,"Illinois","Edwards County",4,30,68,35,33
050,17,047,"Illinois","Edwards County",4,31,71,36,35
050,17,047,"Illinois","Edwards County",4,32,67,33,34
050,17,047,"Illinois","Edwards County",4,33,58,29,29
050,17,047,"Illinois","Edwards County",4,34,53,28,25
050,17,047,"Illinois","Edwards County",4,35,57,32,25
050,17,047,"Illinois","Edwards County",4,36,64,33,31
050,17,047,"Illinois","Edwards County",4,37,66,34,32
050,17,047,"Illinois","Edwards County",4,38,67,30,37
050,17,047,"Illinois","Edwards County",4,39,69,39,30
050,17,047,"Illinois","Edwards County",4,40,78,40,38
050,17,047,"Illinois","Edwards County",4,41,74,40,34
050,17,047,"Illinois","Edwards County",4,42,80,37,43
050,17,047,"Illinois","Edwards County",4,43,69,30,39
050,17,047,"Illinois","Edwards County",4,44,76,36,40
050,17,047,"Illinois","Edwards County",4,45,77,43,34
050,17,047,"Illinois","Edwards County",4,46,77,38,39
050,17,047,"Illinois","Edwards County",4,47,73,36,37
050,17,047,"Illinois","Edwards County",4,48,71,33,38
050,17,047,"Illinois","Edwards County",4,49,75,39,36
050,17,047,"Illinois","Edwards County",4,50,74,41,33
050,17,047,"Illinois","Edwards County",4,51,82,40,42
050,17,047,"Illinois","Edwards County",4,52,82,43,39
050,17,047,"Illinois","Edwards County",4,53,80,43,37
050,17,047,"Illinois","Edwards County",4,54,75,38,37
050,17,047,"Illinois","Edwards County",4,55,83,41,42
050,17,047,"Illinois","Edwards County",4,56,84,41,43
050,17,047,"Illinois","Edwards County",4,57,91,49,42
050,17,047,"Illinois","Edwards County",4,58,91,50,41
050,17,047,"Illinois","Edwards County",4,59,74,40,34
050,17,047,"Illinois","Edwards County",4,60,75,38,37
050,17,047,"Illinois","Edwards County",4,61,76,36,40
050,17,047,"Illinois","Edwards County",4,62,93,43,50
050,17,047,"Illinois","Edwards County",4,63,101,53,48
050,17,047,"Illinois","Edwards County",4,64,90,45,45
050,17,047,"Illinois","Edwards County",4,65,80,42,38
050,17,047,"Illinois","Edwards County",4,66,87,43,44
050,17,047,"Illinois","Edwards County",4,67,90,41,49
050,17,047,"Illinois","Edwards County",4,68,83,38,45
050,17,047,"Illinois","Edwards County",4,69,75,30,45
050,17,047,"Illinois","Edwards County",4,70,78,39,39
050,17,047,"Illinois","Edwards County",4,71,72,35,37
050,17,047,"Illinois","Edwards County",4,72,69,32,37
050,17,047,"Illinois","Edwards County",4,73,72,34,38
050,17,047,"Illinois","Edwards County",4,74,67,33,34
050,17,047,"Illinois","Edwards County",4,75,80,38,42
050,17,047,"Illinois","Edwards County",4,76,55,25,30
050,17,047,"Illinois","Edwards County",4,77,41,17,24
050,17,047,"Illinois","Edwards County",4,78,41,21,20
050,17,047,"Illinois","Edwards County",4,79,48,21,27
050,17,047,"Illinois","Edwards County",4,80,37,18,19
050,17,047,"Illinois","Edwards County",4,81,35,13,22
050,17,047,"Illinois","Edwards County",4,82,37,14,23
050,17,047,"Illinois","Edwards County",4,83,31,11,20
050,17,047,"Illinois","Edwards County",4,84,28,12,16
050,17,047,"Illinois","Edwards County",4,85,167,53,114
050,17,047,"Illinois","Edwards County",5,0,28,17,11
050,17,047,"Illinois","Edwards County",5,1,50,33,17
050,17,047,"Illinois","Edwards County",5,2,56,27,29
050,17,047,"Illinois","Edwards County",5,3,65,36,29
050,17,047,"Illinois","Edwards County",5,4,74,34,40
050,17,047,"Illinois","Edwards County",5,5,74,25,49
050,17,047,"Illinois","Edwards County",5,6,74,28,46
050,17,047,"Illinois","Edwards County",5,7,75,33,42
050,17,047,"Illinois","Edwards County",5,8,65,31,34
050,17,047,"Illinois","Edwards County",5,9,79,38,41
050,17,047,"Illinois","Edwards County",5,10,74,34,40
050,17,047,"Illinois","Edwards County",5,11,87,39,48
050,17,047,"Illinois","Edwards County",5,12,79,39,40
050,17,047,"Illinois","Edwards County",5,13,67,30,37
050,17,047,"Illinois","Edwards County",5,14,75,36,39
050,17,047,"Illinois","Edwards County",5,15,93,44,49
050,17,047,"Illinois","Edwards County",5,16,70,39,31
050,17,047,"Illinois","Edwards County",5,17,78,42,36
050,17,047,"Illinois","Edwards County",5,18,68,32,36
050,17,047,"Illinois","Edwards County",5,19,63,32,31
050,17,047,"Illinois","Edwards County",5,20,61,37,24
050,17,047,"Illinois","Edwards County",5,21,70,38,32
050,17,047,"Illinois","Edwards County",5,22,60,31,29
050,17,047,"Illinois","Edwards County",5,23,56,25,31
050,17,047,"Illinois","Edwards County",5,24,57,29,28
050,17,047,"Illinois","Edwards County",5,25,62,35,27
050,17,047,"Illinois","Edwards County",5,26,61,37,24
050,17,047,"Illinois","Edwards County",5,27,55,24,31
050,17,047,"Illinois","Edwards County",5,28,50,21,29
050,17,047,"Illinois","Edwards County",5,29,55,24,31
050,17,047,"Illinois","Edwards County",5,30,59,31,28
050,17,047,"Illinois","Edwards County",5,31,65,32,33
050,17,047,"Illinois","Edwards County",5,32,66,36,30
050,17,047,"Illinois","Edwards County",5,33,64,31,33
050,17,047,"Illinois","Edwards County",5,34,60,31,29
050,17,047,"Illinois","Edwards County",5,35,54,27,27
050,17,047,"Illinois","Edwards County",5,36,59,33,26
050,17,047,"Illinois","Edwards County",5,37,65,34,31
050,17,047,"Illinois","Edwards County",5,38,67,35,32
050,17,047,"Illinois","Edwards County",5,39,68,32,36
050,17,047,"Illinois","Edwards County",5,40,69,39,30
050,17,047,"Illinois","Edwards County",5,41,76,39,37
050,17,047,"Illinois","Edwards County",5,42,78,41,37
050,17,047,"Illinois","Edwards County",5,43,78,35,43
050,17,047,"Illinois","Edwards County",5,44,71,30,41
050,17,047,"Illinois","Edwards County",5,45,76,35,41
050,17,047,"Illinois","Edwards County",5,46,74,39,35
050,17,047,"Illinois","Edwards County",5,47,80,36,44
050,17,047,"Illinois","Edwards County",5,48,67,33,34
050,17,047,"Illinois","Edwards County",5,49,72,33,39
050,17,047,"Illinois","Edwards County",5,50,74,39,35
050,17,047,"Illinois","Edwards County",5,51,73,40,33
050,17,047,"Illinois","Edwards County",5,52,82,40,42
050,17,047,"Illinois","Edwards County",5,53,83,47,36
050,17,047,"Illinois","Edwards County",5,54,81,41,40
050,17,047,"Illinois","Edwards County",5,55,77,39,38
050,17,047,"Illinois","Edwards County",5,56,79,39,40
050,17,047,"Illinois","Edwards County",5,57,83,41,42
050,17,047,"Illinois","Edwards County",5,58,90,48,42
050,17,047,"Illinois","Edwards County",5,59,94,49,45
050,17,047,"Illinois","Edwards County",5,60,75,39,36
050,17,047,"Illinois","Edwards County",5,61,73,37,36
050,17,047,"Illinois","Edwards County",5,62,77,36,41
050,17,047,"Illinois","Edwards County",5,63,91,42,49
050,17,047,"Illinois","Edwards County",5,64,102,53,49
050,17,047,"Illinois","Edwards County",5,65,93,48,45
050,17,047,"Illinois","Edwards County",5,66,78,41,37
050,17,047,"Illinois","Edwards County",5,67,85,41,44
050,17,047,"Illinois","Edwards County",5,68,86,40,46
050,17,047,"Illinois","Edwards County",5,69,83,37,46
050,17,047,"Illinois","Edwards County",5,70,72,29,43
050,17,047,"Illinois","Edwards County",5,71,76,37,39
050,17,047,"Illinois","Edwards County",5,72,66,31,35
050,17,047,"Illinois","Edwards County",5,73,66,30,36
050,17,047,"Illinois","Edwards County",5,74,66,31,35
050,17,047,"Illinois","Edwards County",5,75,64,33,31
050,17,047,"Illinois","Edwards County",5,76,79,38,41
050,17,047,"Illinois","Edwards County",5,77,51,21,30
050,17,047,"Illinois","Edwards County",5,78,40,15,25
050,17,047,"Illinois","Edwards County",5,79,38,19,19
050,17,047,"Illinois","Edwards County",5,80,45,21,24
050,17,047,"Illinois","Edwards County",5,81,34,17,17
050,17,047,"Illinois","Edwards County",5,82,34,13,21
050,17,047,"Illinois","Edwards County",5,83,30,11,19
050,17,047,"Illinois","Edwards County",5,84,27,10,17
050,17,047,"Illinois","Edwards County",5,85,172,60,112
050,17,049,"Illinois","Effingham County",1,0,441,223,218
050,17,049,"Illinois","Effingham County",1,1,439,217,222
050,17,049,"Illinois","Effingham County",1,2,461,246,215
050,17,049,"Illinois","Effingham County",1,3,484,257,227
050,17,049,"Illinois","Effingham County",1,4,475,225,250
050,17,049,"Illinois","Effingham County",1,5,469,250,219
050,17,049,"Illinois","Effingham County",1,6,470,237,233
050,17,049,"Illinois","Effingham County",1,7,436,214,222
050,17,049,"Illinois","Effingham County",1,8,441,225,216
050,17,049,"Illinois","Effingham County",1,9,480,265,215
050,17,049,"Illinois","Effingham County",1,10,487,243,244
050,17,049,"Illinois","Effingham County",1,11,486,240,246
050,17,049,"Illinois","Effingham County",1,12,465,239,226
050,17,049,"Illinois","Effingham County",1,13,471,244,227
050,17,049,"Illinois","Effingham County",1,14,490,259,231
050,17,049,"Illinois","Effingham County",1,15,477,252,225
050,17,049,"Illinois","Effingham County",1,16,475,234,241
050,17,049,"Illinois","Effingham County",1,17,442,230,212
050,17,049,"Illinois","Effingham County",1,18,378,200,178
050,17,049,"Illinois","Effingham County",1,19,296,161,135
050,17,049,"Illinois","Effingham County",1,20,329,162,167
050,17,049,"Illinois","Effingham County",1,21,366,184,182
050,17,049,"Illinois","Effingham County",1,22,394,216,178
050,17,049,"Illinois","Effingham County",1,23,404,210,194
050,17,049,"Illinois","Effingham County",1,24,396,200,196
050,17,049,"Illinois","Effingham County",1,25,429,234,195
050,17,049,"Illinois","Effingham County",1,26,422,217,205
050,17,049,"Illinois","Effingham County",1,27,458,239,219
050,17,049,"Illinois","Effingham County",1,28,462,234,228
050,17,049,"Illinois","Effingham County",1,29,475,236,239
050,17,049,"Illinois","Effingham County",1,30,449,241,208
050,17,049,"Illinois","Effingham County",1,31,428,223,205
050,17,049,"Illinois","Effingham County",1,32,400,198,202
050,17,049,"Illinois","Effingham County",1,33,434,221,213
050,17,049,"Illinois","Effingham County",1,34,447,228,219
050,17,049,"Illinois","Effingham County",1,35,459,251,208
050,17,049,"Illinois","Effingham County",1,36,433,243,190
050,17,049,"Illinois","Effingham County",1,37,440,232,208
050,17,049,"Illinois","Effingham County",1,38,438,229,209
050,17,049,"Illinois","Effingham County",1,39,424,210,214
050,17,049,"Illinois","Effingham County",1,40,441,227,214
050,17,049,"Illinois","Effingham County",1,41,396,194,202
050,17,049,"Illinois","Effingham County",1,42,389,201,188
050,17,049,"Illinois","Effingham County",1,43,369,194,175
050,17,049,"Illinois","Effingham County",1,44,352,173,179
050,17,049,"Illinois","Effingham County",1,45,360,185,175
050,17,049,"Illinois","Effingham County",1,46,349,178,171
050,17,049,"Illinois","Effingham County",1,47,377,195,182
050,17,049,"Illinois","Effingham County",1,48,399,206,193
050,17,049,"Illinois","Effingham County",1,49,392,195,197
050,17,049,"Illinois","Effingham County",1,50,364,199,165
050,17,049,"Illinois","Effingham County",1,51,405,206,199
050,17,049,"Illinois","Effingham County",1,52,430,217,213
050,17,049,"Illinois","Effingham County",1,53,422,209,213
050,17,049,"Illinois","Effingham County",1,54,435,214,221
050,17,049,"Illinois","Effingham County",1,55,480,231,249
050,17,049,"Illinois","Effingham County",1,56,504,253,251
050,17,049,"Illinois","Effingham County",1,57,514,264,250
050,17,049,"Illinois","Effingham County",1,58,551,271,280
050,17,049,"Illinois","Effingham County",1,59,527,278,249
050,17,049,"Illinois","Effingham County",1,60,531,266,265
050,17,049,"Illinois","Effingham County",1,61,501,249,252
050,17,049,"Illinois","Effingham County",1,62,491,246,245
050,17,049,"Illinois","Effingham County",1,63,489,241,248
050,17,049,"Illinois","Effingham County",1,64,471,234,237
050,17,049,"Illinois","Effingham County",1,65,436,217,219
050,17,049,"Illinois","Effingham County",1,66,402,208,194
050,17,049,"Illinois","Effingham County",1,67,436,218,218
050,17,049,"Illinois","Effingham County",1,68,391,196,195
050,17,049,"Illinois","Effingham County",1,69,353,173,180
050,17,049,"Illinois","Effingham County",1,70,333,160,173
050,17,049,"Illinois","Effingham County",1,71,318,149,169
050,17,049,"Illinois","Effingham County",1,72,336,158,178
050,17,049,"Illinois","Effingham County",1,73,347,169,178
050,17,049,"Illinois","Effingham County",1,74,238,111,127
050,17,049,"Illinois","Effingham County",1,75,210,98,112
050,17,049,"Illinois","Effingham County",1,76,216,86,130
050,17,049,"Illinois","Effingham County",1,77,252,107,145
050,17,049,"Illinois","Effingham County",1,78,211,101,110
050,17,049,"Illinois","Effingham County",1,79,196,83,113
050,17,049,"Illinois","Effingham County",1,80,182,70,112
050,17,049,"Illinois","Effingham County",1,81,170,70,100
050,17,049,"Illinois","Effingham County",1,82,166,68,98
050,17,049,"Illinois","Effingham County",1,83,142,58,84
050,17,049,"Illinois","Effingham County",1,84,130,55,75
050,17,049,"Illinois","Effingham County",1,85,722,259,463
050,17,049,"Illinois","Effingham County",2,0,448,221,227
050,17,049,"Illinois","Effingham County",2,1,436,217,219
050,17,049,"Illinois","Effingham County",2,2,458,241,217
050,17,049,"Illinois","Effingham County",2,3,474,252,222
050,17,049,"Illinois","Effingham County",2,4,482,237,245
050,17,049,"Illinois","Effingham County",2,5,471,245,226
050,17,049,"Illinois","Effingham County",2,6,471,240,231
050,17,049,"Illinois","Effingham County",2,7,443,218,225
050,17,049,"Illinois","Effingham County",2,8,440,222,218
050,17,049,"Illinois","Effingham County",2,9,472,255,217
050,17,049,"Illinois","Effingham County",2,10,486,249,237
050,17,049,"Illinois","Effingham County",2,11,484,241,243
050,17,049,"Illinois","Effingham County",2,12,470,239,231
050,17,049,"Illinois","Effingham County",2,13,471,242,229
050,17,049,"Illinois","Effingham County",2,14,482,254,228
050,17,049,"Illinois","Effingham County",2,15,479,253,226
050,17,049,"Illinois","Effingham County",2,16,476,239,237
050,17,049,"Illinois","Effingham County",2,17,450,232,218
050,17,049,"Illinois","Effingham County",2,18,374,198,176
050,17,049,"Illinois","Effingham County",2,19,302,162,140
050,17,049,"Illinois","Effingham County",2,20,328,164,164
050,17,049,"Illinois","Effingham County",2,21,361,181,180
050,17,049,"Illinois","Effingham County",2,22,393,209,184
050,17,049,"Illinois","Effingham County",2,23,402,209,193
050,17,049,"Illinois","Effingham County",2,24,398,202,196
050,17,049,"Illinois","Effingham County",2,25,424,230,194
050,17,049,"Illinois","Effingham County",2,26,430,225,205
050,17,049,"Illinois","Effingham County",2,27,446,235,211
050,17,049,"Illinois","Effingham County",2,28,460,235,225
050,17,049,"Illinois","Effingham County",2,29,472,237,235
050,17,049,"Illinois","Effingham County",2,30,457,240,217
050,17,049,"Illinois","Effingham County",2,31,426,224,202
050,17,049,"Illinois","Effingham County",2,32,404,200,204
050,17,049,"Illinois","Effingham County",2,33,423,215,208
050,17,049,"Illinois","Effingham County",2,34,445,228,217
050,17,049,"Illinois","Effingham County",2,35,457,246,211
050,17,049,"Illinois","Effingham County",2,36,437,244,193
050,17,049,"Illinois","Effingham County",2,37,439,234,205
050,17,049,"Illinois","Effingham County",2,38,441,229,212
050,17,049,"Illinois","Effingham County",2,39,426,215,211
050,17,049,"Illinois","Effingham County",2,40,441,225,216
050,17,049,"Illinois","Effingham County",2,41,409,203,206
050,17,049,"Illinois","Effingham County",2,42,387,197,190
050,17,049,"Illinois","Effingham County",2,43,379,198,181
050,17,049,"Illinois","Effingham County",2,44,351,176,175
050,17,049,"Illinois","Effingham County",2,45,360,183,177
050,17,049,"Illinois","Effingham County",2,46,349,178,171
050,17,049,"Illinois","Effingham County",2,47,372,193,179
050,17,049,"Illinois","Effingham County",2,48,392,203,189
050,17,049,"Illinois","Effingham County",2,49,396,200,196
050,17,049,"Illinois","Effingham County",2,50,372,198,174
050,17,049,"Illinois","Effingham County",2,51,394,205,189
050,17,049,"Illinois","Effingham County",2,52,422,212,210
050,17,049,"Illinois","Effingham County",2,53,424,212,212
050,17,049,"Illinois","Effingham County",2,54,432,213,219
050,17,049,"Illinois","Effingham County",2,55,465,224,241
050,17,049,"Illinois","Effingham County",2,56,498,247,251
050,17,049,"Illinois","Effingham County",2,57,511,261,250
050,17,049,"Illinois","Effingham County",2,58,542,269,273
050,17,049,"Illinois","Effingham County",2,59,536,276,260
050,17,049,"Illinois","Effingham County",2,60,529,269,260
050,17,049,"Illinois","Effingham County",2,61,503,250,253
050,17,049,"Illinois","Effingham County",2,62,492,246,246
050,17,049,"Illinois","Effingham County",2,63,493,245,248
050,17,049,"Illinois","Effingham County",2,64,472,234,238
050,17,049,"Illinois","Effingham County",2,65,442,219,223
050,17,049,"Illinois","Effingham County",2,66,411,212,199
050,17,049,"Illinois","Effingham County",2,67,426,215,211
050,17,049,"Illinois","Effingham County",2,68,397,199,198
050,17,049,"Illinois","Effingham County",2,69,365,180,185
050,17,049,"Illinois","Effingham County",2,70,333,161,172
050,17,049,"Illinois","Effingham County",2,71,322,151,171
050,17,049,"Illinois","Effingham County",2,72,327,153,174
050,17,049,"Illinois","Effingham County",2,73,362,175,187
050,17,049,"Illinois","Effingham County",2,74,247,117,130
050,17,049,"Illinois","Effingham County",2,75,218,102,116
050,17,049,"Illinois","Effingham County",2,76,212,86,126
050,17,049,"Illinois","Effingham County",2,77,246,103,143
050,17,049,"Illinois","Effingham County",2,78,216,100,116
050,17,049,"Illinois","Effingham County",2,79,197,86,111
050,17,049,"Illinois","Effingham County",2,80,181,72,109
050,17,049,"Illinois","Effingham County",2,81,171,70,101
050,17,049,"Illinois","Effingham County",2,82,169,68,101
050,17,049,"Illinois","Effingham County",2,83,143,59,84
050,17,049,"Illinois","Effingham County",2,84,133,57,76
050,17,049,"Illinois","Effingham County",2,85,726,261,465
050,17,049,"Illinois","Effingham County",3,0,419,204,215
050,17,049,"Illinois","Effingham County",3,1,434,218,216
050,17,049,"Illinois","Effingham County",3,2,442,226,216
050,17,049,"Illinois","Effingham County",3,3,462,242,220
050,17,049,"Illinois","Effingham County",3,4,470,256,214
050,17,049,"Illinois","Effingham County",3,5,468,226,242
050,17,049,"Illinois","Effingham County",3,6,461,237,224
050,17,049,"Illinois","Effingham County",3,7,462,234,228
050,17,049,"Illinois","Effingham County",3,8,448,222,226
050,17,049,"Illinois","Effingham County",3,9,427,219,208
050,17,049,"Illinois","Effingham County",3,10,463,256,207
050,17,049,"Illinois","Effingham County",3,11,474,242,232
050,17,049,"Illinois","Effingham County",3,12,476,233,243
050,17,049,"Illinois","Effingham County",3,13,475,245,230
050,17,049,"Illinois","Effingham County",3,14,486,248,238
050,17,049,"Illinois","Effingham County",3,15,479,262,217
050,17,049,"Illinois","Effingham County",3,16,473,252,221
050,17,049,"Illinois","Effingham County",3,17,490,240,250
050,17,049,"Illinois","Effingham County",3,18,371,199,172
050,17,049,"Illinois","Effingham County",3,19,299,157,142
050,17,049,"Illinois","Effingham County",3,20,325,173,152
050,17,049,"Illinois","Effingham County",3,21,349,176,173
050,17,049,"Illinois","Effingham County",3,22,398,199,199
050,17,049,"Illinois","Effingham County",3,23,414,225,189
050,17,049,"Illinois","Effingham County",3,24,398,202,196
050,17,049,"Illinois","Effingham County",3,25,397,214,183
050,17,049,"Illinois","Effingham County",3,26,418,227,191
050,17,049,"Illinois","Effingham County",3,27,414,218,196
050,17,049,"Illinois","Effingham County",3,28,441,232,209
050,17,049,"Illinois","Effingham County",3,29,461,235,226
050,17,049,"Illinois","Effingham County",3,30,469,234,235
050,17,049,"Illinois","Effingham County",3,31,457,241,216
050,17,049,"Illinois","Effingham County",3,32,443,232,211
050,17,049,"Illinois","Effingham County",3,33,395,199,196
050,17,049,"Illinois","Effingham County",3,34,429,218,211
050,17,049,"Illinois","Effingham County",3,35,442,231,211
050,17,049,"Illinois","Effingham County",3,36,465,253,212
050,17,049,"Illinois","Effingham County",3,37,433,236,197
050,17,049,"Illinois","Effingham County",3,38,435,228,207
050,17,049,"Illinois","Effingham County",3,39,425,228,197
050,17,049,"Illinois","Effingham County",3,40,428,218,210
050,17,049,"Illinois","Effingham County",3,41,443,222,221
050,17,049,"Illinois","Effingham County",3,42,401,205,196
050,17,049,"Illinois","Effingham County",3,43,384,203,181
050,17,049,"Illinois","Effingham County",3,44,371,185,186
050,17,049,"Illinois","Effingham County",3,45,353,179,174
050,17,049,"Illinois","Effingham County",3,46,345,175,170
050,17,049,"Illinois","Effingham County",3,47,357,185,172
050,17,049,"Illinois","Effingham County",3,48,362,186,176
050,17,049,"Illinois","Effingham County",3,49,389,202,187
050,17,049,"Illinois","Effingham County",3,50,395,196,199
050,17,049,"Illinois","Effingham County",3,51,370,197,173
050,17,049,"Illinois","Effingham County",3,52,384,198,186
050,17,049,"Illinois","Effingham County",3,53,417,210,207
050,17,049,"Illinois","Effingham County",3,54,426,212,214
050,17,049,"Illinois","Effingham County",3,55,426,212,214
050,17,049,"Illinois","Effingham County",3,56,466,227,239
050,17,049,"Illinois","Effingham County",3,57,493,246,247
050,17,049,"Illinois","Effingham County",3,58,506,262,244
050,17,049,"Illinois","Effingham County",3,59,539,264,275
050,17,049,"Illinois","Effingham County",3,60,541,281,260
050,17,049,"Illinois","Effingham County",3,61,525,265,260
050,17,049,"Illinois","Effingham County",3,62,498,248,250
050,17,049,"Illinois","Effingham County",3,63,488,243,245
050,17,049,"Illinois","Effingham County",3,64,484,239,245
050,17,049,"Illinois","Effingham County",3,65,470,231,239
050,17,049,"Illinois","Effingham County",3,66,427,215,212
050,17,049,"Illinois","Effingham County",3,67,406,205,201
050,17,049,"Illinois","Effingham County",3,68,410,210,200
050,17,049,"Illinois","Effingham County",3,69,389,192,197
050,17,049,"Illinois","Effingham County",3,70,360,177,183
050,17,049,"Illinois","Effingham County",3,71,327,157,170
050,17,049,"Illinois","Effingham County",3,72,309,143,166
050,17,049,"Illinois","Effingham County",3,73,319,149,170
050,17,049,"Illinois","Effingham County",3,74,351,168,183
050,17,049,"Illinois","Effingham County",3,75,236,111,125
050,17,049,"Illinois","Effingham County",3,76,212,93,119
050,17,049,"Illinois","Effingham County",3,77,202,86,116
050,17,049,"Illinois","Effingham County",3,78,238,98,140
050,17,049,"Illinois","Effingham County",3,79,199,87,112
050,17,049,"Illinois","Effingham County",3,80,185,76,109
050,17,049,"Illinois","Effingham County",3,81,163,62,101
050,17,049,"Illinois","Effingham County",3,82,161,60,101
050,17,049,"Illinois","Effingham County",3,83,147,60,87
050,17,049,"Illinois","Effingham County",3,84,122,53,69
050,17,049,"Illinois","Effingham County",3,85,697,259,438
050,17,049,"Illinois","Effingham County",4,0,403,207,196
050,17,049,"Illinois","Effingham County",4,1,422,212,210
050,17,049,"Illinois","Effingham County",4,2,431,217,214
050,17,049,"Illinois","Effingham County",4,3,444,228,216
050,17,049,"Illinois","Effingham County",4,4,458,241,217
050,17,049,"Illinois","Effingham County",4,5,468,251,217
050,17,049,"Illinois","Effingham County",4,6,460,224,236
050,17,049,"Illinois","Effingham County",4,7,462,244,218
050,17,049,"Illinois","Effingham County",4,8,455,229,226
050,17,049,"Illinois","Effingham County",4,9,445,223,222
050,17,049,"Illinois","Effingham County",4,10,429,218,211
050,17,049,"Illinois","Effingham County",4,11,463,254,209
050,17,049,"Illinois","Effingham County",4,12,483,242,241
050,17,049,"Illinois","Effingham County",4,13,480,235,245
050,17,049,"Illinois","Effingham County",4,14,476,241,235
050,17,049,"Illinois","Effingham County",4,15,485,247,238
050,17,049,"Illinois","Effingham County",4,16,459,248,211
050,17,049,"Illinois","Effingham County",4,17,476,255,221
050,17,049,"Illinois","Effingham County",4,18,400,203,197
050,17,049,"Illinois","Effingham County",4,19,288,159,129
050,17,049,"Illinois","Effingham County",4,20,314,159,155
050,17,049,"Illinois","Effingham County",4,21,333,177,156
050,17,049,"Illinois","Effingham County",4,22,375,187,188
050,17,049,"Illinois","Effingham County",4,23,409,214,195
050,17,049,"Illinois","Effingham County",4,24,412,221,191
050,17,049,"Illinois","Effingham County",4,25,412,210,202
050,17,049,"Illinois","Effingham County",4,26,372,193,179
050,17,049,"Illinois","Effingham County",4,27,400,214,186
050,17,049,"Illinois","Effingham County",4,28,410,214,196
050,17,049,"Illinois","Effingham County",4,29,448,234,214
050,17,049,"Illinois","Effingham County",4,30,459,232,227
050,17,049,"Illinois","Effingham County",4,31,460,232,228
050,17,049,"Illinois","Effingham County",4,32,468,252,216
050,17,049,"Illinois","Effingham County",4,33,437,229,208
050,17,049,"Illinois","Effingham County",4,34,406,203,203
050,17,049,"Illinois","Effingham County",4,35,431,227,204
050,17,049,"Illinois","Effingham County",4,36,455,240,215
050,17,049,"Illinois","Effingham County",4,37,466,258,208
050,17,049,"Illinois","Effingham County",4,38,429,232,197
050,17,049,"Illinois","Effingham County",4,39,421,226,195
050,17,049,"Illinois","Effingham County",4,40,424,229,195
050,17,049,"Illinois","Effingham County",4,41,453,237,216
050,17,049,"Illinois","Effingham County",4,42,425,209,216
050,17,049,"Illinois","Effingham County",4,43,400,202,198
050,17,049,"Illinois","Effingham County",4,44,387,197,190
050,17,049,"Illinois","Effingham County",4,45,384,194,190
050,17,049,"Illinois","Effingham County",4,46,344,174,170
050,17,049,"Illinois","Effingham County",4,47,351,186,165
050,17,049,"Illinois","Effingham County",4,48,346,176,170
050,17,049,"Illinois","Effingham County",4,49,359,185,174
050,17,049,"Illinois","Effingham County",4,50,398,207,191
050,17,049,"Illinois","Effingham County",4,51,389,199,190
050,17,049,"Illinois","Effingham County",4,52,360,191,169
050,17,049,"Illinois","Effingham County",4,53,385,198,187
050,17,049,"Illinois","Effingham County",4,54,412,205,207
050,17,049,"Illinois","Effingham County",4,55,410,204,206
050,17,049,"Illinois","Effingham County",4,56,420,215,205
050,17,049,"Illinois","Effingham County",4,57,454,219,235
050,17,049,"Illinois","Effingham County",4,58,490,249,241
050,17,049,"Illinois","Effingham County",4,59,500,258,242
050,17,049,"Illinois","Effingham County",4,60,540,265,275
050,17,049,"Illinois","Effingham County",4,61,529,275,254
050,17,049,"Illinois","Effingham County",4,62,512,255,257
050,17,049,"Illinois","Effingham County",4,63,496,247,249
050,17,049,"Illinois","Effingham County",4,64,472,238,234
050,17,049,"Illinois","Effingham County",4,65,468,229,239
050,17,049,"Illinois","Effingham County",4,66,457,226,231
050,17,049,"Illinois","Effingham County",4,67,421,208,213
050,17,049,"Illinois","Effingham County",4,68,384,193,191
050,17,049,"Illinois","Effingham County",4,69,404,204,200
050,17,049,"Illinois","Effingham County",4,70,380,190,190
050,17,049,"Illinois","Effingham County",4,71,352,170,182
050,17,049,"Illinois","Effingham County",4,72,310,148,162
050,17,049,"Illinois","Effingham County",4,73,307,141,166
050,17,049,"Illinois","Effingham County",4,74,307,142,165
050,17,049,"Illinois","Effingham County",4,75,341,162,179
050,17,049,"Illinois","Effingham County",4,76,236,106,130
050,17,049,"Illinois","Effingham County",4,77,202,90,112
050,17,049,"Illinois","Effingham County",4,78,193,87,106
050,17,049,"Illinois","Effingham County",4,79,222,86,136
050,17,049,"Illinois","Effingham County",4,80,188,79,109
050,17,049,"Illinois","Effingham County",4,81,168,73,95
050,17,049,"Illinois","Effingham County",4,82,156,57,99
050,17,049,"Illinois","Effingham County",4,83,141,57,84
050,17,049,"Illinois","Effingham County",4,84,126,51,75
050,17,049,"Illinois","Effingham County",4,85,693,270,423
050,17,049,"Illinois","Effingham County",5,0,370,190,180
050,17,049,"Illinois","Effingham County",5,1,423,228,195
050,17,049,"Illinois","Effingham County",5,2,435,218,217
050,17,049,"Illinois","Effingham County",5,3,435,219,216
050,17,049,"Illinois","Effingham County",5,4,449,233,216
050,17,049,"Illinois","Effingham County",5,5,458,236,222
050,17,049,"Illinois","Effingham County",5,6,473,253,220
050,17,049,"Illinois","Effingham County",5,7,457,218,239
050,17,049,"Illinois","Effingham County",5,8,451,239,212
050,17,049,"Illinois","Effingham County",5,9,455,232,223
050,17,049,"Illinois","Effingham County",5,10,442,219,223
050,17,049,"Illinois","Effingham County",5,11,428,220,208
050,17,049,"Illinois","Effingham County",5,12,472,261,211
050,17,049,"Illinois","Effingham County",5,13,471,239,232
050,17,049,"Illinois","Effingham County",5,14,486,233,253
050,17,049,"Illinois","Effingham County",5,15,472,241,231
050,17,049,"Illinois","Effingham County",5,16,477,242,235
050,17,049,"Illinois","Effingham County",5,17,462,257,205
050,17,049,"Illinois","Effingham County",5,18,404,224,180
050,17,049,"Illinois","Effingham County",5,19,311,164,147
050,17,049,"Illinois","Effingham County",5,20,304,164,140
050,17,049,"Illinois","Effingham County",5,21,341,170,171
050,17,049,"Illinois","Effingham County",5,22,360,185,175
050,17,049,"Illinois","Effingham County",5,23,388,196,192
050,17,049,"Illinois","Effingham County",5,24,390,203,187
050,17,049,"Illinois","Effingham County",5,25,418,219,199
050,17,049,"Illinois","Effingham County",5,26,410,202,208
050,17,049,"Illinois","Effingham County",5,27,382,202,180
050,17,049,"Illinois","Effingham County",5,28,398,210,188
050,17,049,"Illinois","Effingham County",5,29,418,218,200
050,17,049,"Illinois","Effingham County",5,30,464,250,214
050,17,049,"Illinois","Effingham County",5,31,466,238,228
050,17,049,"Illinois","Effingham County",5,32,464,234,230
050,17,049,"Illinois","Effingham County",5,33,471,249,222
050,17,049,"Illinois","Effingham County",5,34,448,235,213
050,17,049,"Illinois","Effingham County",5,35,414,209,205
050,17,049,"Illinois","Effingham County",5,36,433,225,208
050,17,049,"Illinois","Effingham County",5,37,461,243,218
050,17,049,"Illinois","Effingham County",5,38,463,258,205
050,17,049,"Illinois","Effingham County",5,39,428,232,196
050,17,049,"Illinois","Effingham County",5,40,419,224,195
050,17,049,"Illinois","Effingham County",5,41,443,239,204
050,17,049,"Illinois","Effingham County",5,42,439,229,210
050,17,049,"Illinois","Effingham County",5,43,420,205,215
050,17,049,"Illinois","Effingham County",5,44,397,205,192
050,17,049,"Illinois","Effingham County",5,45,389,202,187
050,17,049,"Illinois","Effingham County",5,46,386,195,191
050,17,049,"Illinois","Effingham County",5,47,352,180,172
050,17,049,"Illinois","Effingham County",5,48,344,182,162
050,17,049,"Illinois","Effingham County",5,49,349,179,170
050,17,049,"Illinois","Effingham County",5,50,362,182,180
050,17,049,"Illinois","Effingham County",5,51,392,207,185
050,17,049,"Illinois","Effingham County",5,52,382,187,195
050,17,049,"Illinois","Effingham County",5,53,361,192,169
050,17,049,"Illinois","Effingham County",5,54,379,194,185
050,17,049,"Illinois","Effingham County",5,55,410,205,205
050,17,049,"Illinois","Effingham County",5,56,394,194,200
050,17,049,"Illinois","Effingham County",5,57,420,217,203
050,17,049,"Illinois","Effingham County",5,58,465,226,239
050,17,049,"Illinois","Effingham County",5,59,482,243,239
050,17,049,"Illinois","Effingham County",5,60,499,257,242
050,17,049,"Illinois","Effingham County",5,61,527,255,272
050,17,049,"Illinois","Effingham County",5,62,535,279,256
050,17,049,"Illinois","Effingham County",5,63,513,256,257
050,17,049,"Illinois","Effingham County",5,64,494,244,250
050,17,049,"Illinois","Effingham County",5,65,468,235,233
050,17,049,"Illinois","Effingham County",5,66,467,230,237
050,17,049,"Illinois","Effingham County",5,67,452,219,233
050,17,049,"Illinois","Effingham County",5,68,406,201,205
050,17,049,"Illinois","Effingham County",5,69,378,190,188
050,17,049,"Illinois","Effingham County",5,70,395,198,197
050,17,049,"Illinois","Effingham County",5,71,375,184,191
050,17,049,"Illinois","Effingham County",5,72,339,163,176
050,17,049,"Illinois","Effingham County",5,73,306,146,160
050,17,049,"Illinois","Effingham County",5,74,297,134,163
050,17,049,"Illinois","Effingham County",5,75,302,139,163
050,17,049,"Illinois","Effingham County",5,76,335,154,181
050,17,049,"Illinois","Effingham County",5,77,227,105,122
050,17,049,"Illinois","Effingham County",5,78,195,88,107
050,17,049,"Illinois","Effingham County",5,79,184,80,104
050,17,049,"Illinois","Effingham County",5,80,205,77,128
050,17,049,"Illinois","Effingham County",5,81,168,74,94
050,17,049,"Illinois","Effingham County",5,82,162,71,91
050,17,049,"Illinois","Effingham County",5,83,136,53,83
050,17,049,"Illinois","Effingham County",5,84,120,50,70
050,17,049,"Illinois","Effingham County",5,85,709,286,423
050,17,051,"Illinois","Fayette County",1,0,214,110,104
050,17,051,"Illinois","Fayette County",1,1,215,111,104
050,17,051,"Illinois","Fayette County",1,2,237,126,111
050,17,051,"Illinois","Fayette County",1,3,247,135,112
050,17,051,"Illinois","Fayette County",1,4,257,133,124
050,17,051,"Illinois","Fayette County",1,5,236,117,119
050,17,051,"Illinois","Fayette County",1,6,215,116,99
050,17,051,"Illinois","Fayette County",1,7,218,122,96
050,17,051,"Illinois","Fayette County",1,8,229,121,108
050,17,051,"Illinois","Fayette County",1,9,238,125,113
050,17,051,"Illinois","Fayette County",1,10,233,119,114
050,17,051,"Illinois","Fayette County",1,11,251,131,120
050,17,051,"Illinois","Fayette County",1,12,255,132,123
050,17,051,"Illinois","Fayette County",1,13,264,134,130
050,17,051,"Illinois","Fayette County",1,14,251,120,131
050,17,051,"Illinois","Fayette County",1,15,266,136,130
050,17,051,"Illinois","Fayette County",1,16,274,144,130
050,17,051,"Illinois","Fayette County",1,17,270,138,132
050,17,051,"Illinois","Fayette County",1,18,241,139,102
050,17,051,"Illinois","Fayette County",1,19,249,169,80
050,17,051,"Illinois","Fayette County",1,20,266,178,88
050,17,051,"Illinois","Fayette County",1,21,282,184,98
050,17,051,"Illinois","Fayette County",1,22,271,177,94
050,17,051,"Illinois","Fayette County",1,23,296,196,100
050,17,051,"Illinois","Fayette County",1,24,289,176,113
050,17,051,"Illinois","Fayette County",1,25,306,195,111
050,17,051,"Illinois","Fayette County",1,26,300,190,110
050,17,051,"Illinois","Fayette County",1,27,284,187,97
050,17,051,"Illinois","Fayette County",1,28,300,189,111
050,17,051,"Illinois","Fayette County",1,29,293,174,119
050,17,051,"Illinois","Fayette County",1,30,316,191,125
050,17,051,"Illinois","Fayette County",1,31,279,152,127
050,17,051,"Illinois","Fayette County",1,32,263,162,101
050,17,051,"Illinois","Fayette County",1,33,276,159,117
050,17,051,"Illinois","Fayette County",1,34,249,144,105
050,17,051,"Illinois","Fayette County",1,35,296,179,117
050,17,051,"Illinois","Fayette County",1,36,299,182,117
050,17,051,"Illinois","Fayette County",1,37,263,148,115
050,17,051,"Illinois","Fayette County",1,38,295,175,120
050,17,051,"Illinois","Fayette County",1,39,312,186,126
050,17,051,"Illinois","Fayette County",1,40,284,156,128
050,17,051,"Illinois","Fayette County",1,41,280,178,102
050,17,051,"Illinois","Fayette County",1,42,290,187,103
050,17,051,"Illinois","Fayette County",1,43,297,185,112
050,17,051,"Illinois","Fayette County",1,44,271,171,100
050,17,051,"Illinois","Fayette County",1,45,275,163,112
050,17,051,"Illinois","Fayette County",1,46,283,168,115
050,17,051,"Illinois","Fayette County",1,47,273,159,114
050,17,051,"Illinois","Fayette County",1,48,276,153,123
050,17,051,"Illinois","Fayette County",1,49,260,144,116
050,17,051,"Illinois","Fayette County",1,50,284,160,124
050,17,051,"Illinois","Fayette County",1,51,276,166,110
050,17,051,"Illinois","Fayette County",1,52,260,152,108
050,17,051,"Illinois","Fayette County",1,53,253,140,113
050,17,051,"Illinois","Fayette County",1,54,254,134,120
050,17,051,"Illinois","Fayette County",1,55,285,148,137
050,17,051,"Illinois","Fayette County",1,56,304,176,128
050,17,051,"Illinois","Fayette County",1,57,289,154,135
050,17,051,"Illinois","Fayette County",1,58,295,163,132
050,17,051,"Illinois","Fayette County",1,59,306,162,144
050,17,051,"Illinois","Fayette County",1,60,296,147,149
050,17,051,"Illinois","Fayette County",1,61,287,141,146
050,17,051,"Illinois","Fayette County",1,62,277,143,134
050,17,051,"Illinois","Fayette County",1,63,284,160,124
050,17,051,"Illinois","Fayette County",1,64,282,148,134
050,17,051,"Illinois","Fayette County",1,65,269,144,125
050,17,051,"Illinois","Fayette County",1,66,239,121,118
050,17,051,"Illinois","Fayette County",1,67,240,119,121
050,17,051,"Illinois","Fayette County",1,68,235,111,124
050,17,051,"Illinois","Fayette County",1,69,214,102,112
050,17,051,"Illinois","Fayette County",1,70,206,103,103
050,17,051,"Illinois","Fayette County",1,71,201,106,95
050,17,051,"Illinois","Fayette County",1,72,210,105,105
050,17,051,"Illinois","Fayette County",1,73,213,103,110
050,17,051,"Illinois","Fayette County",1,74,146,64,82
050,17,051,"Illinois","Fayette County",1,75,150,61,89
050,17,051,"Illinois","Fayette County",1,76,156,64,92
050,17,051,"Illinois","Fayette County",1,77,132,60,72
050,17,051,"Illinois","Fayette County",1,78,120,55,65
050,17,051,"Illinois","Fayette County",1,79,119,50,69
050,17,051,"Illinois","Fayette County",1,80,109,45,64
050,17,051,"Illinois","Fayette County",1,81,112,46,66
050,17,051,"Illinois","Fayette County",1,82,100,42,58
050,17,051,"Illinois","Fayette County",1,83,102,42,60
050,17,051,"Illinois","Fayette County",1,84,93,42,51
050,17,051,"Illinois","Fayette County",1,85,516,210,306
050,17,051,"Illinois","Fayette County",2,0,216,101,115
050,17,051,"Illinois","Fayette County",2,1,212,109,103
050,17,051,"Illinois","Fayette County",2,2,234,123,111
050,17,051,"Illinois","Fayette County",2,3,244,132,112
050,17,051,"Illinois","Fayette County",2,4,254,132,122
050,17,051,"Illinois","Fayette County",2,5,241,120,121
050,17,051,"Illinois","Fayette County",2,6,221,118,103
050,17,051,"Illinois","Fayette County",2,7,217,120,97
050,17,051,"Illinois","Fayette County",2,8,226,121,105
050,17,051,"Illinois","Fayette County",2,9,234,122,112
050,17,051,"Illinois","Fayette County",2,10,234,120,114
050,17,051,"Illinois","Fayette County",2,11,245,128,117
050,17,051,"Illinois","Fayette County",2,12,257,134,123
050,17,051,"Illinois","Fayette County",2,13,261,132,129
050,17,051,"Illinois","Fayette County",2,14,254,123,131
050,17,051,"Illinois","Fayette County",2,15,262,132,130
050,17,051,"Illinois","Fayette County",2,16,271,142,129
050,17,051,"Illinois","Fayette County",2,17,273,142,131
050,17,051,"Illinois","Fayette County",2,18,241,139,102
050,17,051,"Illinois","Fayette County",2,19,248,167,81
050,17,051,"Illinois","Fayette County",2,20,268,178,90
050,17,051,"Illinois","Fayette County",2,21,281,184,97
050,17,051,"Illinois","Fayette County",2,22,278,183,95
050,17,051,"Illinois","Fayette County",2,23,292,192,100
050,17,051,"Illinois","Fayette County",2,24,289,180,109
050,17,051,"Illinois","Fayette County",2,25,304,194,110
050,17,051,"Illinois","Fayette County",2,26,302,192,110
050,17,051,"Illinois","Fayette County",2,27,288,188,100
050,17,051,"Illinois","Fayette County",2,28,291,184,107
050,17,051,"Illinois","Fayette County",2,29,295,178,117
050,17,051,"Illinois","Fayette County",2,30,315,190,125
050,17,051,"Illinois","Fayette County",2,31,281,156,125
050,17,051,"Illinois","Fayette County",2,32,269,162,107
050,17,051,"Illinois","Fayette County",2,33,273,159,114
050,17,051,"Illinois","Fayette County",2,34,253,144,109
050,17,051,"Illinois","Fayette County",2,35,293,178,115
050,17,051,"Illinois","Fayette County",2,36,295,179,116
050,17,051,"Illinois","Fayette County",2,37,271,156,115
050,17,051,"Illinois","Fayette County",2,38,293,173,120
050,17,051,"Illinois","Fayette County",2,39,308,182,126
050,17,051,"Illinois","Fayette County",2,40,284,157,127
050,17,051,"Illinois","Fayette County",2,41,285,177,108
050,17,051,"Illinois","Fayette County",2,42,286,184,102
050,17,051,"Illinois","Fayette County",2,43,296,186,110
050,17,051,"Illinois","Fayette County",2,44,273,171,102
050,17,051,"Illinois","Fayette County",2,45,276,166,110
050,17,051,"Illinois","Fayette County",2,46,286,172,114
050,17,051,"Illinois","Fayette County",2,47,271,157,114
050,17,051,"Illinois","Fayette County",2,48,272,152,120
050,17,051,"Illinois","Fayette County",2,49,260,143,117
050,17,051,"Illinois","Fayette County",2,50,279,159,120
050,17,051,"Illinois","Fayette County",2,51,274,162,112
050,17,051,"Illinois","Fayette County",2,52,263,154,109
050,17,051,"Illinois","Fayette County",2,53,256,144,112
050,17,051,"Illinois","Fayette County",2,54,252,133,119
050,17,051,"Illinois","Fayette County",2,55,274,142,132
050,17,051,"Illinois","Fayette County",2,56,304,173,131
050,17,051,"Illinois","Fayette County",2,57,294,160,134
050,17,051,"Illinois","Fayette County",2,58,291,159,132
050,17,051,"Illinois","Fayette County",2,59,305,164,141
050,17,051,"Illinois","Fayette County",2,60,296,149,147
050,17,051,"Illinois","Fayette County",2,61,289,142,147
050,17,051,"Illinois","Fayette County",2,62,281,144,137
050,17,051,"Illinois","Fayette County",2,63,284,156,128
050,17,051,"Illinois","Fayette County",2,64,279,149,130
050,17,051,"Illinois","Fayette County",2,65,270,144,126
050,17,051,"Illinois","Fayette County",2,66,247,126,121
050,17,051,"Illinois","Fayette County",2,67,236,117,119
050,17,051,"Illinois","Fayette County",2,68,233,111,122
050,17,051,"Illinois","Fayette County",2,69,220,105,115
050,17,051,"Illinois","Fayette County",2,70,205,100,105
050,17,051,"Illinois","Fayette County",2,71,202,104,98
050,17,051,"Illinois","Fayette County",2,72,203,102,101
050,17,051,"Illinois","Fayette County",2,73,223,109,114
050,17,051,"Illinois","Fayette County",2,74,152,68,84
050,17,051,"Illinois","Fayette County",2,75,147,60,87
050,17,051,"Illinois","Fayette County",2,76,150,60,90
050,17,051,"Illinois","Fayette County",2,77,142,63,79
050,17,051,"Illinois","Fayette County",2,78,119,54,65
050,17,051,"Illinois","Fayette County",2,79,119,51,68
050,17,051,"Illinois","Fayette County",2,80,109,45,64
050,17,051,"Illinois","Fayette County",2,81,106,43,63
050,17,051,"Illinois","Fayette County",2,82,105,44,61
050,17,051,"Illinois","Fayette County",2,83,101,42,59
050,17,051,"Illinois","Fayette County",2,84,91,39,52
050,17,051,"Illinois","Fayette County",2,85,516,211,305
050,17,051,"Illinois","Fayette County",3,0,221,119,102
050,17,051,"Illinois","Fayette County",3,1,215,102,113
050,17,051,"Illinois","Fayette County",3,2,215,111,104
050,17,051,"Illinois","Fayette County",3,3,234,123,111
050,17,051,"Illinois","Fayette County",3,4,250,137,113
050,17,051,"Illinois","Fayette County",3,5,256,131,125
050,17,051,"Illinois","Fayette County",3,6,236,117,119
050,17,051,"Illinois","Fayette County",3,7,225,128,97
050,17,051,"Illinois","Fayette County",3,8,216,119,97
050,17,051,"Illinois","Fayette County",3,9,231,124,107
050,17,051,"Illinois","Fayette County",3,10,237,123,114
050,17,051,"Illinois","Fayette County",3,11,253,131,122
050,17,051,"Illinois","Fayette County",3,12,248,129,119
050,17,051,"Illinois","Fayette County",3,13,256,139,117
050,17,051,"Illinois","Fayette County",3,14,248,123,125
050,17,051,"Illinois","Fayette County",3,15,253,122,131
050,17,051,"Illinois","Fayette County",3,16,255,128,127
050,17,051,"Illinois","Fayette County",3,17,285,157,128
050,17,051,"Illinois","Fayette County",3,18,253,143,110
050,17,051,"Illinois","Fayette County",3,19,229,154,75
050,17,051,"Illinois","Fayette County",3,20,260,170,90
050,17,051,"Illinois","Fayette County",3,21,278,186,92
050,17,051,"Illinois","Fayette County",3,22,284,187,97
050,17,051,"Illinois","Fayette County",3,23,286,187,99
050,17,051,"Illinois","Fayette County",3,24,288,187,101
050,17,051,"Illinois","Fayette County",3,25,312,196,116
050,17,051,"Illinois","Fayette County",3,26,297,192,105
050,17,051,"Illinois","Fayette County",3,27,299,193,106
050,17,051,"Illinois","Fayette County",3,28,271,175,96
050,17,051,"Illinois","Fayette County",3,29,298,185,113
050,17,051,"Illinois","Fayette County",3,30,305,187,118
050,17,051,"Illinois","Fayette County",3,31,298,170,128
050,17,051,"Illinois","Fayette County",3,32,291,166,125
050,17,051,"Illinois","Fayette County",3,33,267,159,108
050,17,051,"Illinois","Fayette County",3,34,258,143,115
050,17,051,"Illinois","Fayette County",3,35,273,167,106
050,17,051,"Illinois","Fayette County",3,36,288,173,115
050,17,051,"Illinois","Fayette County",3,37,273,165,108
050,17,051,"Illinois","Fayette County",3,38,283,170,113
050,17,051,"Illinois","Fayette County",3,39,295,172,123
050,17,051,"Illinois","Fayette County",3,40,282,157,125
050,17,051,"Illinois","Fayette County",3,41,302,178,124
050,17,051,"Illinois","Fayette County",3,42,285,171,114
050,17,051,"Illinois","Fayette County",3,43,298,187,111
050,17,051,"Illinois","Fayette County",3,44,290,175,115
050,17,051,"Illinois","Fayette County",3,45,276,177,99
050,17,051,"Illinois","Fayette County",3,46,298,188,110
050,17,051,"Illinois","Fayette County",3,47,265,158,107
050,17,051,"Illinois","Fayette County",3,48,266,148,118
050,17,051,"Illinois","Fayette County",3,49,259,140,119
050,17,051,"Illinois","Fayette County",3,50,277,164,113
050,17,051,"Illinois","Fayette County",3,51,267,147,120
050,17,051,"Illinois","Fayette County",3,52,266,153,113
050,17,051,"Illinois","Fayette County",3,53,259,155,104
050,17,051,"Illinois","Fayette County",3,54,247,131,116
050,17,051,"Illinois","Fayette County",3,55,233,121,112
050,17,051,"Illinois","Fayette County",3,56,277,147,130
050,17,051,"Illinois","Fayette County",3,57,298,168,130
050,17,051,"Illinois","Fayette County",3,58,285,152,133
050,17,051,"Illinois","Fayette County",3,59,288,158,130
050,17,051,"Illinois","Fayette County",3,60,298,159,139
050,17,051,"Illinois","Fayette County",3,61,294,147,147
050,17,051,"Illinois","Fayette County",3,62,294,147,147
050,17,051,"Illinois","Fayette County",3,63,274,138,136
050,17,051,"Illinois","Fayette County",3,64,294,163,131
050,17,051,"Illinois","Fayette County",3,65,283,156,127
050,17,051,"Illinois","Fayette County",3,66,270,143,127
050,17,051,"Illinois","Fayette County",3,67,245,122,123
050,17,051,"Illinois","Fayette County",3,68,231,114,117
050,17,051,"Illinois","Fayette County",3,69,235,115,120
050,17,051,"Illinois","Fayette County",3,70,205,95,110
050,17,051,"Illinois","Fayette County",3,71,193,93,100
050,17,051,"Illinois","Fayette County",3,72,193,100,93
050,17,051,"Illinois","Fayette County",3,73,194,97,97
050,17,051,"Illinois","Fayette County",3,74,219,106,113
050,17,051,"Illinois","Fayette County",3,75,148,68,80
050,17,051,"Illinois","Fayette County",3,76,139,57,82
050,17,051,"Illinois","Fayette County",3,77,138,56,82
050,17,051,"Illinois","Fayette County",3,78,129,56,73
050,17,051,"Illinois","Fayette County",3,79,116,51,65
050,17,051,"Illinois","Fayette County",3,80,107,46,61
050,17,051,"Illinois","Fayette County",3,81,100,40,60
050,17,051,"Illinois","Fayette County",3,82,102,39,63
050,17,051,"Illinois","Fayette County",3,83,97,40,57
050,17,051,"Illinois","Fayette County",3,84,91,35,56
050,17,051,"Illinois","Fayette County",3,85,511,214,297
050,17,051,"Illinois","Fayette County",4,0,200,111,89
050,17,051,"Illinois","Fayette County",4,1,225,115,110
050,17,051,"Illinois","Fayette County",4,2,218,99,119
050,17,051,"Illinois","Fayette County",4,3,211,112,99
050,17,051,"Illinois","Fayette County",4,4,230,121,109
050,17,051,"Illinois","Fayette County",4,5,252,142,110
050,17,051,"Illinois","Fayette County",4,6,249,129,120
050,17,051,"Illinois","Fayette County",4,7,244,122,122
050,17,051,"Illinois","Fayette County",4,8,228,125,103
050,17,051,"Illinois","Fayette County",4,9,202,110,92
050,17,051,"Illinois","Fayette County",4,10,227,119,108
050,17,051,"Illinois","Fayette County",4,11,229,123,106
050,17,051,"Illinois","Fayette County",4,12,245,130,115
050,17,051,"Illinois","Fayette County",4,13,246,130,116
050,17,051,"Illinois","Fayette County",4,14,259,143,116
050,17,051,"Illinois","Fayette County",4,15,241,127,114
050,17,051,"Illinois","Fayette County",4,16,262,128,134
050,17,051,"Illinois","Fayette County",4,17,283,153,130
050,17,051,"Illinois","Fayette County",4,18,259,153,106
050,17,051,"Illinois","Fayette County",4,19,239,159,80
050,17,051,"Illinois","Fayette County",4,20,239,159,80
050,17,051,"Illinois","Fayette County",4,21,275,183,92
050,17,051,"Illinois","Fayette County",4,22,299,191,108
050,17,051,"Illinois","Fayette County",4,23,287,190,97
050,17,051,"Illinois","Fayette County",4,24,288,190,98
050,17,051,"Illinois","Fayette County",4,25,297,196,101
050,17,051,"Illinois","Fayette County",4,26,312,193,119
050,17,051,"Illinois","Fayette County",4,27,293,187,106
050,17,051,"Illinois","Fayette County",4,28,284,173,111
050,17,051,"Illinois","Fayette County",4,29,268,172,96
050,17,051,"Illinois","Fayette County",4,30,299,183,116
050,17,051,"Illinois","Fayette County",4,31,275,162,113
050,17,051,"Illinois","Fayette County",4,32,304,170,134
050,17,051,"Illinois","Fayette County",4,33,281,159,122
050,17,051,"Illinois","Fayette County",4,34,257,147,110
050,17,051,"Illinois","Fayette County",4,35,273,165,108
050,17,051,"Illinois","Fayette County",4,36,263,158,105
050,17,051,"Illinois","Fayette County",4,37,274,163,111
050,17,051,"Illinois","Fayette County",4,38,295,188,107
050,17,051,"Illinois","Fayette County",4,39,276,160,116
050,17,051,"Illinois","Fayette County",4,40,276,151,125
050,17,051,"Illinois","Fayette County",4,41,300,173,127
050,17,051,"Illinois","Fayette County",4,42,289,171,118
050,17,051,"Illinois","Fayette County",4,43,288,171,117
050,17,051,"Illinois","Fayette County",4,44,285,172,113
050,17,051,"Illinois","Fayette County",4,45,284,174,110
050,17,051,"Illinois","Fayette County",4,46,297,202,95
050,17,051,"Illinois","Fayette County",4,47,278,170,108
050,17,051,"Illinois","Fayette County",4,48,265,150,115
050,17,051,"Illinois","Fayette County",4,49,260,138,122
050,17,051,"Illinois","Fayette County",4,50,259,143,116
050,17,051,"Illinois","Fayette County",4,51,265,153,112
050,17,051,"Illinois","Fayette County",4,52,269,138,131
050,17,051,"Illinois","Fayette County",4,53,266,157,109
050,17,051,"Illinois","Fayette County",4,54,256,151,105
050,17,051,"Illinois","Fayette County",4,55,229,117,112
050,17,051,"Illinois","Fayette County",4,56,237,129,108
050,17,051,"Illinois","Fayette County",4,57,279,146,133
050,17,051,"Illinois","Fayette County",4,58,288,162,126
050,17,051,"Illinois","Fayette County",4,59,278,146,132
050,17,051,"Illinois","Fayette County",4,60,273,148,125
050,17,051,"Illinois","Fayette County",4,61,298,160,138
050,17,051,"Illinois","Fayette County",4,62,290,148,142
050,17,051,"Illinois","Fayette County",4,63,279,136,143
050,17,051,"Illinois","Fayette County",4,64,267,133,134
050,17,051,"Illinois","Fayette County",4,65,291,161,130
050,17,051,"Illinois","Fayette County",4,66,283,155,128
050,17,051,"Illinois","Fayette County",4,67,261,134,127
050,17,051,"Illinois","Fayette County",4,68,237,119,118
050,17,051,"Illinois","Fayette County",4,69,232,115,117
050,17,051,"Illinois","Fayette County",4,70,223,108,115
050,17,051,"Illinois","Fayette County",4,71,193,85,108
050,17,051,"Illinois","Fayette County",4,72,181,85,96
050,17,051,"Illinois","Fayette County",4,73,189,98,91
050,17,051,"Illinois","Fayette County",4,74,184,90,94
050,17,051,"Illinois","Fayette County",4,75,218,104,114
050,17,051,"Illinois","Fayette County",4,76,142,66,76
050,17,051,"Illinois","Fayette County",4,77,134,55,79
050,17,051,"Illinois","Fayette County",4,78,128,49,79
050,17,051,"Illinois","Fayette County",4,79,123,54,69
050,17,051,"Illinois","Fayette County",4,80,105,47,58
050,17,051,"Illinois","Fayette County",4,81,97,43,54
050,17,051,"Illinois","Fayette County",4,82,95,36,59
050,17,051,"Illinois","Fayette County",4,83,94,37,57
050,17,051,"Illinois","Fayette County",4,84,94,40,54
050,17,051,"Illinois","Fayette County",4,85,523,217,306
050,17,051,"Illinois","Fayette County",5,0,186,106,80
050,17,051,"Illinois","Fayette County",5,1,193,105,88
050,17,051,"Illinois","Fayette County",5,2,227,118,109
050,17,051,"Illinois","Fayette County",5,3,218,104,114
050,17,051,"Illinois","Fayette County",5,4,223,119,104
050,17,051,"Illinois","Fayette County",5,5,239,124,115
050,17,051,"Illinois","Fayette County",5,6,254,137,117
050,17,051,"Illinois","Fayette County",5,7,251,135,116
050,17,051,"Illinois","Fayette County",5,8,239,117,122
050,17,051,"Illinois","Fayette County",5,9,229,125,104
050,17,051,"Illinois","Fayette County",5,10,211,108,103
050,17,051,"Illinois","Fayette County",5,11,228,123,105
050,17,051,"Illinois","Fayette County",5,12,227,119,108
050,17,051,"Illinois","Fayette County",5,13,247,128,119
050,17,051,"Illinois","Fayette County",5,14,240,124,116
050,17,051,"Illinois","Fayette County",5,15,254,136,118
050,17,051,"Illinois","Fayette County",5,16,242,125,117
050,17,051,"Illinois","Fayette County",5,17,268,135,133
050,17,051,"Illinois","Fayette County",5,18,249,147,102
050,17,051,"Illinois","Fayette County",5,19,246,169,77
050,17,051,"Illinois","Fayette County",5,20,258,166,92
050,17,051,"Illinois","Fayette County",5,21,254,167,87
050,17,051,"Illinois","Fayette County",5,22,276,188,88
050,17,051,"Illinois","Fayette County",5,23,307,190,117
050,17,051,"Illinois","Fayette County",5,24,304,204,100
050,17,051,"Illinois","Fayette County",5,25,297,200,97
050,17,051,"Illinois","Fayette County",5,26,298,197,101
050,17,051,"Illinois","Fayette County",5,27,308,188,120
050,17,051,"Illinois","Fayette County",5,28,285,178,107
050,17,051,"Illinois","Fayette County",5,29,283,175,108
050,17,051,"Illinois","Fayette County",5,30,280,180,100
050,17,051,"Illinois","Fayette County",5,31,285,164,121
050,17,051,"Illinois","Fayette County",5,32,282,171,111
050,17,051,"Illinois","Fayette County",5,33,296,165,131
050,17,051,"Illinois","Fayette County",5,34,273,152,121
050,17,051,"Illinois","Fayette County",5,35,273,164,109
050,17,051,"Illinois","Fayette County",5,36,264,158,106
050,17,051,"Illinois","Fayette County",5,37,251,146,105
050,17,051,"Illinois","Fayette County",5,38,302,183,119
050,17,051,"Illinois","Fayette County",5,39,295,191,104
050,17,051,"Illinois","Fayette County",5,40,247,135,112
050,17,051,"Illinois","Fayette County",5,41,282,165,117
050,17,051,"Illinois","Fayette County",5,42,295,169,126
050,17,051,"Illinois","Fayette County",5,43,301,180,121
050,17,051,"Illinois","Fayette County",5,44,275,156,119
050,17,051,"Illinois","Fayette County",5,45,275,172,103
050,17,051,"Illinois","Fayette County",5,46,303,197,106
050,17,051,"Illinois","Fayette County",5,47,285,190,95
050,17,051,"Illinois","Fayette County",5,48,264,161,103
050,17,051,"Illinois","Fayette County",5,49,253,140,113
050,17,051,"Illinois","Fayette County",5,50,269,151,118
050,17,051,"Illinois","Fayette County",5,51,250,135,115
050,17,051,"Illinois","Fayette County",5,52,251,139,112
050,17,051,"Illinois","Fayette County",5,53,269,145,124
050,17,051,"Illinois","Fayette County",5,54,259,147,112
050,17,051,"Illinois","Fayette County",5,55,237,137,100
050,17,051,"Illinois","Fayette County",5,56,239,128,111
050,17,051,"Illinois","Fayette County",5,57,233,125,108
050,17,051,"Illinois","Fayette County",5,58,269,138,131
050,17,051,"Illinois","Fayette County",5,59,281,155,126
050,17,051,"Illinois","Fayette County",5,60,269,141,128
050,17,051,"Illinois","Fayette County",5,61,276,150,126
050,17,051,"Illinois","Fayette County",5,62,298,164,134
050,17,051,"Illinois","Fayette County",5,63,275,138,137
050,17,051,"Illinois","Fayette County",5,64,273,133,140
050,17,051,"Illinois","Fayette County",5,65,261,134,127
050,17,051,"Illinois","Fayette County",5,66,288,159,129
050,17,051,"Illinois","Fayette County",5,67,270,145,125
050,17,051,"Illinois","Fayette County",5,68,257,133,124
050,17,051,"Illinois","Fayette County",5,69,243,122,121
050,17,051,"Illinois","Fayette County",5,70,224,109,115
050,17,051,"Illinois","Fayette County",5,71,213,102,111
050,17,051,"Illinois","Fayette County",5,72,187,82,105
050,17,051,"Illinois","Fayette County",5,73,172,78,94
050,17,051,"Illinois","Fayette County",5,74,183,93,90
050,17,051,"Illinois","Fayette County",5,75,183,91,92
050,17,051,"Illinois","Fayette County",5,76,211,100,111
050,17,051,"Illinois","Fayette County",5,77,135,61,74
050,17,051,"Illinois","Fayette County",5,78,123,48,75
050,17,051,"Illinois","Fayette County",5,79,127,50,77
050,17,051,"Illinois","Fayette County",5,80,108,46,62
050,17,051,"Illinois","Fayette County",5,81,95,44,51
050,17,051,"Illinois","Fayette County",5,82,93,40,53
050,17,051,"Illinois","Fayette County",5,83,91,36,55
050,17,051,"Illinois","Fayette County",5,84,89,36,53
050,17,051,"Illinois","Fayette County",5,85,541,234,307
050,17,053,"Illinois","Ford County",1,0,142,74,68
050,17,053,"Illinois","Ford County",1,1,146,71,75
050,17,053,"Illinois","Ford County",1,2,179,96,83
050,17,053,"Illinois","Ford County",1,3,180,97,83
050,17,053,"Illinois","Ford County",1,4,165,87,78
050,17,053,"Illinois","Ford County",1,5,159,87,72
050,17,053,"Illinois","Ford County",1,6,161,79,82
050,17,053,"Illinois","Ford County",1,7,167,91,76
050,17,053,"Illinois","Ford County",1,8,176,110,66
050,17,053,"Illinois","Ford County",1,9,158,89,69
050,17,053,"Illinois","Ford County",1,10,175,87,88
050,17,053,"Illinois","Ford County",1,11,177,90,87
050,17,053,"Illinois","Ford County",1,12,190,97,93
050,17,053,"Illinois","Ford County",1,13,183,90,93
050,17,053,"Illinois","Ford County",1,14,193,102,91
050,17,053,"Illinois","Ford County",1,15,206,108,98
050,17,053,"Illinois","Ford County",1,16,201,94,107
050,17,053,"Illinois","Ford County",1,17,186,88,98
050,17,053,"Illinois","Ford County",1,18,173,86,87
050,17,053,"Illinois","Ford County",1,19,147,76,71
050,17,053,"Illinois","Ford County",1,20,136,71,65
050,17,053,"Illinois","Ford County",1,21,134,71,63
050,17,053,"Illinois","Ford County",1,22,134,65,69
050,17,053,"Illinois","Ford County",1,23,145,73,72
050,17,053,"Illinois","Ford County",1,24,154,77,77
050,17,053,"Illinois","Ford County",1,25,143,69,74
050,17,053,"Illinois","Ford County",1,26,158,84,74
050,17,053,"Illinois","Ford County",1,27,139,70,69
050,17,053,"Illinois","Ford County",1,28,152,80,72
050,17,053,"Illinois","Ford County",1,29,150,75,75
050,17,053,"Illinois","Ford County",1,30,155,80,75
050,17,053,"Illinois","Ford County",1,31,158,78,80
050,17,053,"Illinois","Ford County",1,32,156,79,77
050,17,053,"Illinois","Ford County",1,33,158,85,73
050,17,053,"Illinois","Ford County",1,34,161,71,90
050,17,053,"Illinois","Ford County",1,35,170,87,83
050,17,053,"Illinois","Ford County",1,36,175,87,88
050,17,053,"Illinois","Ford County",1,37,162,80,82
050,17,053,"Illinois","Ford County",1,38,170,87,83
050,17,053,"Illinois","Ford County",1,39,164,87,77
050,17,053,"Illinois","Ford County",1,40,156,80,76
050,17,053,"Illinois","Ford County",1,41,163,81,82
050,17,053,"Illinois","Ford County",1,42,168,82,86
050,17,053,"Illinois","Ford County",1,43,160,82,78
050,17,053,"Illinois","Ford County",1,44,167,91,76
050,17,053,"Illinois","Ford County",1,45,154,76,78
050,17,053,"Illinois","Ford County",1,46,146,75,71
050,17,053,"Illinois","Ford County",1,47,142,74,68
050,17,053,"Illinois","Ford County",1,48,173,89,84
050,17,053,"Illinois","Ford County",1,49,172,85,87
050,17,053,"Illinois","Ford County",1,50,159,83,76
050,17,053,"Illinois","Ford County",1,51,164,80,84
050,17,053,"Illinois","Ford County",1,52,189,91,98
050,17,053,"Illinois","Ford County",1,53,175,88,87
050,17,053,"Illinois","Ford County",1,54,149,74,75
050,17,053,"Illinois","Ford County",1,55,159,77,82
050,17,053,"Illinois","Ford County",1,56,193,91,102
050,17,053,"Illinois","Ford County",1,57,188,94,94
050,17,053,"Illinois","Ford County",1,58,198,94,104
050,17,053,"Illinois","Ford County",1,59,210,102,108
050,17,053,"Illinois","Ford County",1,60,209,108,101
050,17,053,"Illinois","Ford County",1,61,232,121,111
050,17,053,"Illinois","Ford County",1,62,208,106,102
050,17,053,"Illinois","Ford County",1,63,204,108,96
050,17,053,"Illinois","Ford County",1,64,207,94,113
050,17,053,"Illinois","Ford County",1,65,198,96,102
050,17,053,"Illinois","Ford County",1,66,184,84,100
050,17,053,"Illinois","Ford County",1,67,160,81,79
050,17,053,"Illinois","Ford County",1,68,152,80,72
050,17,053,"Illinois","Ford County",1,69,123,60,63
050,17,053,"Illinois","Ford County",1,70,123,55,68
050,17,053,"Illinois","Ford County",1,71,129,66,63
050,17,053,"Illinois","Ford County",1,72,118,60,58
050,17,053,"Illinois","Ford County",1,73,129,66,63
050,17,053,"Illinois","Ford County",1,74,88,48,40
050,17,053,"Illinois","Ford County",1,75,87,43,44
050,17,053,"Illinois","Ford County",1,76,88,39,49
050,17,053,"Illinois","Ford County",1,77,90,37,53
050,17,053,"Illinois","Ford County",1,78,84,35,49
050,17,053,"Illinois","Ford County",1,79,83,40,43
050,17,053,"Illinois","Ford County",1,80,83,33,50
050,17,053,"Illinois","Ford County",1,81,74,29,45
050,17,053,"Illinois","Ford County",1,82,63,25,38
050,17,053,"Illinois","Ford County",1,83,56,27,29
050,17,053,"Illinois","Ford County",1,84,43,18,25
050,17,053,"Illinois","Ford County",1,85,388,104,284
050,17,053,"Illinois","Ford County",2,0,143,76,67
050,17,053,"Illinois","Ford County",2,1,145,71,74
050,17,053,"Illinois","Ford County",2,2,171,90,81
050,17,053,"Illinois","Ford County",2,3,179,97,82
050,17,053,"Illinois","Ford County",2,4,170,90,80
050,17,053,"Illinois","Ford County",2,5,161,88,73
050,17,053,"Illinois","Ford County",2,6,161,82,79
050,17,053,"Illinois","Ford County",2,7,167,89,78
050,17,053,"Illinois","Ford County",2,8,174,106,68
050,17,053,"Illinois","Ford County",2,9,165,95,70
050,17,053,"Illinois","Ford County",2,10,171,87,84
050,17,053,"Illinois","Ford County",2,11,175,87,88
050,17,053,"Illinois","Ford County",2,12,189,96,93
050,17,053,"Illinois","Ford County",2,13,185,91,94
050,17,053,"Illinois","Ford County",2,14,191,99,92
050,17,053,"Illinois","Ford County",2,15,203,106,97
050,17,053,"Illinois","Ford County",2,16,202,97,105
050,17,053,"Illinois","Ford County",2,17,191,91,100
050,17,053,"Illinois","Ford County",2,18,167,82,85
050,17,053,"Illinois","Ford County",2,19,146,74,72
050,17,053,"Illinois","Ford County",2,20,143,74,69
050,17,053,"Illinois","Ford County",2,21,135,71,64
050,17,053,"Illinois","Ford County",2,22,136,66,70
050,17,053,"Illinois","Ford County",2,23,145,72,73
050,17,053,"Illinois","Ford County",2,24,152,75,77
050,17,053,"Illinois","Ford County",2,25,146,72,74
050,17,053,"Illinois","Ford County",2,26,153,81,72
050,17,053,"Illinois","Ford County",2,27,144,74,70
050,17,053,"Illinois","Ford County",2,28,147,75,72
050,17,053,"Illinois","Ford County",2,29,151,78,73
050,17,053,"Illinois","Ford County",2,30,157,81,76
050,17,053,"Illinois","Ford County",2,31,157,78,79
050,17,053,"Illinois","Ford County",2,32,158,80,78
050,17,053,"Illinois","Ford County",2,33,162,85,77
050,17,053,"Illinois","Ford County",2,34,164,76,88
050,17,053,"Illinois","Ford County",2,35,170,83,87
050,17,053,"Illinois","Ford County",2,36,171,86,85
050,17,053,"Illinois","Ford County",2,37,162,80,82
050,17,053,"Illinois","Ford County",2,38,171,87,84
050,17,053,"Illinois","Ford County",2,39,163,85,78
050,17,053,"Illinois","Ford County",2,40,159,82,77
050,17,053,"Illinois","Ford County",2,41,161,81,80
050,17,053,"Illinois","Ford County",2,42,166,82,84
050,17,053,"Illinois","Ford County",2,43,164,84,80
050,17,053,"Illinois","Ford County",2,44,164,89,75
050,17,053,"Illinois","Ford County",2,45,157,80,77
050,17,053,"Illinois","Ford County",2,46,146,75,71
050,17,053,"Illinois","Ford County",2,47,142,73,69
050,17,053,"Illinois","Ford County",2,48,166,85,81
050,17,053,"Illinois","Ford County",2,49,172,86,86
050,17,053,"Illinois","Ford County",2,50,161,82,79
050,17,053,"Illinois","Ford County",2,51,162,81,81
050,17,053,"Illinois","Ford County",2,52,182,89,93
050,17,053,"Illinois","Ford County",2,53,178,88,90
050,17,053,"Illinois","Ford County",2,54,152,77,75
050,17,053,"Illinois","Ford County",2,55,157,77,80
050,17,053,"Illinois","Ford County",2,56,186,88,98
050,17,053,"Illinois","Ford County",2,57,189,93,96
050,17,053,"Illinois","Ford County",2,58,197,94,103
050,17,053,"Illinois","Ford County",2,59,206,99,107
050,17,053,"Illinois","Ford County",2,60,209,107,102
050,17,053,"Illinois","Ford County",2,61,222,114,108
050,17,053,"Illinois","Ford County",2,62,212,109,103
050,17,053,"Illinois","Ford County",2,63,206,108,98
050,17,053,"Illinois","Ford County",2,64,205,96,109
050,17,053,"Illinois","Ford County",2,65,201,96,105
050,17,053,"Illinois","Ford County",2,66,186,86,100
050,17,053,"Illinois","Ford County",2,67,164,81,83
050,17,053,"Illinois","Ford County",2,68,149,79,70
050,17,053,"Illinois","Ford County",2,69,132,66,66
050,17,053,"Illinois","Ford County",2,70,120,54,66
050,17,053,"Illinois","Ford County",2,71,127,63,64
050,17,053,"Illinois","Ford County",2,72,116,58,58
050,17,053,"Illinois","Ford County",2,73,134,68,66
050,17,053,"Illinois","Ford County",2,74,91,48,43
050,17,053,"Illinois","Ford County",2,75,87,44,43
050,17,053,"Illinois","Ford County",2,76,86,40,46
050,17,053,"Illinois","Ford County",2,77,91,37,54
050,17,053,"Illinois","Ford County",2,78,84,35,49
050,17,053,"Illinois","Ford County",2,79,83,39,44
050,17,053,"Illinois","Ford County",2,80,80,33,47
050,17,053,"Illinois","Ford County",2,81,74,29,45
050,17,053,"Illinois","Ford County",2,82,63,24,39
050,17,053,"Illinois","Ford County",2,83,55,25,30
050,17,053,"Illinois","Ford County",2,84,44,19,25
050,17,053,"Illinois","Ford County",2,85,382,103,279
050,17,053,"Illinois","Ford County",3,0,142,67,75
050,17,053,"Illinois","Ford County",3,1,147,85,62
050,17,053,"Illinois","Ford County",3,2,156,77,79
050,17,053,"Illinois","Ford County",3,3,174,87,87
050,17,053,"Illinois","Ford County",3,4,188,110,78
050,17,053,"Illinois","Ford County",3,5,173,95,78
050,17,053,"Illinois","Ford County",3,6,165,89,76
050,17,053,"Illinois","Ford County",3,7,164,88,76
050,17,053,"Illinois","Ford County",3,8,177,93,84
050,17,053,"Illinois","Ford County",3,9,173,102,71
050,17,053,"Illinois","Ford County",3,10,163,97,66
050,17,053,"Illinois","Ford County",3,11,174,90,84
050,17,053,"Illinois","Ford County",3,12,177,88,89
050,17,053,"Illinois","Ford County",3,13,186,96,90
050,17,053,"Illinois","Ford County",3,14,189,91,98
050,17,053,"Illinois","Ford County",3,15,194,103,91
050,17,053,"Illinois","Ford County",3,16,211,112,99
050,17,053,"Illinois","Ford County",3,17,197,95,102
050,17,053,"Illinois","Ford County",3,18,154,76,78
050,17,053,"Illinois","Ford County",3,19,127,66,61
050,17,053,"Illinois","Ford County",3,20,155,81,74
050,17,053,"Illinois","Ford County",3,21,148,76,72
050,17,053,"Illinois","Ford County",3,22,145,75,70
050,17,053,"Illinois","Ford County",3,23,151,74,77
050,17,053,"Illinois","Ford County",3,24,146,76,70
050,17,053,"Illinois","Ford County",3,25,164,76,88
050,17,053,"Illinois","Ford County",3,26,148,75,73
050,17,053,"Illinois","Ford County",3,27,147,78,69
050,17,053,"Illinois","Ford County",3,28,143,76,67
050,17,053,"Illinois","Ford County",3,29,140,73,67
050,17,053,"Illinois","Ford County",3,30,163,83,80
050,17,053,"Illinois","Ford County",3,31,167,84,83
050,17,053,"Illinois","Ford County",3,32,159,78,81
050,17,053,"Illinois","Ford County",3,33,153,77,76
050,17,053,"Illinois","Ford County",3,34,160,82,78
050,17,053,"Illinois","Ford County",3,35,169,81,88
050,17,053,"Illinois","Ford County",3,36,176,86,90
050,17,053,"Illinois","Ford County",3,37,170,85,85
050,17,053,"Illinois","Ford County",3,38,164,82,82
050,17,053,"Illinois","Ford County",3,39,166,84,82
050,17,053,"Illinois","Ford County",3,40,158,84,74
050,17,053,"Illinois","Ford County",3,41,155,82,73
050,17,053,"Illinois","Ford County",3,42,162,86,76
050,17,053,"Illinois","Ford County",3,43,170,85,85
050,17,053,"Illinois","Ford County",3,44,161,84,77
050,17,053,"Illinois","Ford County",3,45,159,85,74
050,17,053,"Illinois","Ford County",3,46,152,80,72
050,17,053,"Illinois","Ford County",3,47,144,74,70
050,17,053,"Illinois","Ford County",3,48,146,73,73
050,17,053,"Illinois","Ford County",3,49,165,83,82
050,17,053,"Illinois","Ford County",3,50,167,83,84
050,17,053,"Illinois","Ford County",3,51,163,88,75
050,17,053,"Illinois","Ford County",3,52,157,80,77
050,17,053,"Illinois","Ford County",3,53,177,86,91
050,17,053,"Illinois","Ford County",3,54,181,91,90
050,17,053,"Illinois","Ford County",3,55,153,80,73
050,17,053,"Illinois","Ford County",3,56,165,79,86
050,17,053,"Illinois","Ford County",3,57,182,87,95
050,17,053,"Illinois","Ford County",3,58,186,90,96
050,17,053,"Illinois","Ford County",3,59,197,94,103
050,17,053,"Illinois","Ford County",3,60,208,103,105
050,17,053,"Illinois","Ford County",3,61,207,102,105
050,17,053,"Illinois","Ford County",3,62,217,112,105
050,17,053,"Illinois","Ford County",3,63,215,111,104
050,17,053,"Illinois","Ford County",3,64,201,104,97
050,17,053,"Illinois","Ford County",3,65,193,94,99
050,17,053,"Illinois","Ford County",3,66,190,87,103
050,17,053,"Illinois","Ford County",3,67,181,85,96
050,17,053,"Illinois","Ford County",3,68,162,79,83
050,17,053,"Illinois","Ford County",3,69,141,76,65
050,17,053,"Illinois","Ford County",3,70,124,65,59
050,17,053,"Illinois","Ford County",3,71,121,55,66
050,17,053,"Illinois","Ford County",3,72,122,57,65
050,17,053,"Illinois","Ford County",3,73,108,53,55
050,17,053,"Illinois","Ford County",3,74,133,66,67
050,17,053,"Illinois","Ford County",3,75,84,44,40
050,17,053,"Illinois","Ford County",3,76,81,42,39
050,17,053,"Illinois","Ford County",3,77,77,31,46
050,17,053,"Illinois","Ford County",3,78,85,32,53
050,17,053,"Illinois","Ford County",3,79,77,33,44
050,17,053,"Illinois","Ford County",3,80,84,40,44
050,17,053,"Illinois","Ford County",3,81,74,29,45
050,17,053,"Illinois","Ford County",3,82,63,24,39
050,17,053,"Illinois","Ford County",3,83,61,24,37
050,17,053,"Illinois","Ford County",3,84,46,20,26
050,17,053,"Illinois","Ford County",3,85,359,98,261
050,17,053,"Illinois","Ford County",4,0,143,67,76
050,17,053,"Illinois","Ford County",4,1,129,66,63
050,17,053,"Illinois","Ford County",4,2,160,83,77
050,17,053,"Illinois","Ford County",4,3,158,77,81
050,17,053,"Illinois","Ford County",4,4,172,86,86
050,17,053,"Illinois","Ford County",4,5,190,101,89
050,17,053,"Illinois","Ford County",4,6,167,91,76
050,17,053,"Illinois","Ford County",4,7,164,87,77
050,17,053,"Illinois","Ford County",4,8,163,87,76
050,17,053,"Illinois","Ford County",4,9,177,86,91
050,17,053,"Illinois","Ford County",4,10,174,102,72
050,17,053,"Illinois","Ford County",4,11,161,96,65
050,17,053,"Illinois","Ford County",4,12,178,92,86
050,17,053,"Illinois","Ford County",4,13,174,90,84
050,17,053,"Illinois","Ford County",4,14,194,98,96
050,17,053,"Illinois","Ford County",4,15,181,89,92
050,17,053,"Illinois","Ford County",4,16,203,101,102
050,17,053,"Illinois","Ford County",4,17,197,104,93
050,17,053,"Illinois","Ford County",4,18,161,85,76
050,17,053,"Illinois","Ford County",4,19,108,57,51
050,17,053,"Illinois","Ford County",4,20,126,66,60
050,17,053,"Illinois","Ford County",4,21,146,79,67
050,17,053,"Illinois","Ford County",4,22,163,86,77
050,17,053,"Illinois","Ford County",4,23,156,77,79
050,17,053,"Illinois","Ford County",4,24,150,77,73
050,17,053,"Illinois","Ford County",4,25,147,74,73
050,17,053,"Illinois","Ford County",4,26,152,67,85
050,17,053,"Illinois","Ford County",4,27,144,72,72
050,17,053,"Illinois","Ford County",4,28,148,79,69
050,17,053,"Illinois","Ford County",4,29,134,71,63
050,17,053,"Illinois","Ford County",4,30,129,67,62
050,17,053,"Illinois","Ford County",4,31,164,81,83
050,17,053,"Illinois","Ford County",4,32,157,80,77
050,17,053,"Illinois","Ford County",4,33,159,75,84
050,17,053,"Illinois","Ford County",4,34,148,74,74
050,17,053,"Illinois","Ford County",4,35,168,86,82
050,17,053,"Illinois","Ford County",4,36,167,84,83
050,17,053,"Illinois","Ford County",4,37,176,85,91
050,17,053,"Illinois","Ford County",4,38,168,79,89
050,17,053,"Illinois","Ford County",4,39,160,79,81
050,17,053,"Illinois","Ford County",4,40,171,85,86
050,17,053,"Illinois","Ford County",4,41,168,91,77
050,17,053,"Illinois","Ford County",4,42,159,87,72
050,17,053,"Illinois","Ford County",4,43,165,89,76
050,17,053,"Illinois","Ford County",4,44,174,89,85
050,17,053,"Illinois","Ford County",4,45,163,80,83
050,17,053,"Illinois","Ford County",4,46,156,84,72
050,17,053,"Illinois","Ford County",4,47,161,85,76
050,17,053,"Illinois","Ford County",4,48,142,70,72
050,17,053,"Illinois","Ford County",4,49,138,72,66
050,17,053,"Illinois","Ford County",4,50,165,82,83
050,17,053,"Illinois","Ford County",4,51,157,81,76
050,17,053,"Illinois","Ford County",4,52,157,83,74
050,17,053,"Illinois","Ford County",4,53,153,81,72
050,17,053,"Illinois","Ford County",4,54,174,88,86
050,17,053,"Illinois","Ford County",4,55,168,85,83
050,17,053,"Illinois","Ford County",4,56,155,81,74
050,17,053,"Illinois","Ford County",4,57,155,74,81
050,17,053,"Illinois","Ford County",4,58,173,83,90
050,17,053,"Illinois","Ford County",4,59,187,93,94
050,17,053,"Illinois","Ford County",4,60,190,92,98
050,17,053,"Illinois","Ford County",4,61,198,95,103
050,17,053,"Illinois","Ford County",4,62,209,101,108
050,17,053,"Illinois","Ford County",4,63,213,108,105
050,17,053,"Illinois","Ford County",4,64,206,105,101
050,17,053,"Illinois","Ford County",4,65,192,100,92
050,17,053,"Illinois","Ford County",4,66,188,87,101
050,17,053,"Illinois","Ford County",4,67,184,85,99
050,17,053,"Illinois","Ford County",4,68,171,80,91
050,17,053,"Illinois","Ford County",4,69,158,77,81
050,17,053,"Illinois","Ford County",4,70,133,74,59
050,17,053,"Illinois","Ford County",4,71,116,59,57
050,17,053,"Illinois","Ford County",4,72,112,51,61
050,17,053,"Illinois","Ford County",4,73,115,53,62
050,17,053,"Illinois","Ford County",4,74,107,52,55
050,17,053,"Illinois","Ford County",4,75,119,60,59
050,17,053,"Illinois","Ford County",4,76,78,41,37
050,17,053,"Illinois","Ford County",4,77,74,35,39
050,17,053,"Illinois","Ford County",4,78,71,29,42
050,17,053,"Illinois","Ford County",4,79,81,33,48
050,17,053,"Illinois","Ford County",4,80,74,32,42
050,17,053,"Illinois","Ford County",4,81,79,37,42
050,17,053,"Illinois","Ford County",4,82,69,27,42
050,17,053,"Illinois","Ford County",4,83,60,24,36
050,17,053,"Illinois","Ford County",4,84,52,18,34
050,17,053,"Illinois","Ford County",4,85,350,98,252
050,17,053,"Illinois","Ford County",5,0,144,68,76
050,17,053,"Illinois","Ford County",5,1,144,62,82
050,17,053,"Illinois","Ford County",5,2,130,64,66
050,17,053,"Illinois","Ford County",5,3,164,77,87
050,17,053,"Illinois","Ford County",5,4,154,76,78
050,17,053,"Illinois","Ford County",5,5,179,89,90
050,17,053,"Illinois","Ford County",5,6,204,104,100
050,17,053,"Illinois","Ford County",5,7,174,93,81
050,17,053,"Illinois","Ford County",5,8,154,83,71
050,17,053,"Illinois","Ford County",5,9,159,88,71
050,17,053,"Illinois","Ford County",5,10,179,89,90
050,17,053,"Illinois","Ford County",5,11,176,103,73
050,17,053,"Illinois","Ford County",5,12,163,99,64
050,17,053,"Illinois","Ford County",5,13,175,88,87
050,17,053,"Illinois","Ford County",5,14,181,91,90
050,17,053,"Illinois","Ford County",5,15,194,102,92
050,17,053,"Illinois","Ford County",5,16,183,93,90
050,17,053,"Illinois","Ford County",5,17,196,99,97
050,17,053,"Illinois","Ford County",5,18,159,89,70
050,17,053,"Illinois","Ford County",5,19,121,64,57
050,17,053,"Illinois","Ford County",5,20,121,60,61
050,17,053,"Illinois","Ford County",5,21,134,71,63
050,17,053,"Illinois","Ford County",5,22,159,81,78
050,17,053,"Illinois","Ford County",5,23,176,89,87
050,17,053,"Illinois","Ford County",5,24,162,83,79
050,17,053,"Illinois","Ford County",5,25,147,71,76
050,17,053,"Illinois","Ford County",5,26,157,80,77
050,17,053,"Illinois","Ford County",5,27,152,70,82
050,17,053,"Illinois","Ford County",5,28,153,79,74
050,17,053,"Illinois","Ford County",5,29,158,86,72
050,17,053,"Illinois","Ford County",5,30,135,75,60
050,17,053,"Illinois","Ford County",5,31,145,77,68
050,17,053,"Illinois","Ford County",5,32,167,90,77
050,17,053,"Illinois","Ford County",5,33,155,81,74
050,17,053,"Illinois","Ford County",5,34,155,71,84
050,17,053,"Illinois","Ford County",5,35,154,78,76
050,17,053,"Illinois","Ford County",5,36,163,88,75
050,17,053,"Illinois","Ford County",5,37,159,80,79
050,17,053,"Illinois","Ford County",5,38,167,79,88
050,17,053,"Illinois","Ford County",5,39,165,81,84
050,17,053,"Illinois","Ford County",5,40,167,84,83
050,17,053,"Illinois","Ford County",5,41,171,83,88
050,17,053,"Illinois","Ford County",5,42,166,95,71
050,17,053,"Illinois","Ford County",5,43,158,85,73
050,17,053,"Illinois","Ford County",5,44,161,89,72
050,17,053,"Illinois","Ford County",5,45,173,84,89
050,17,053,"Illinois","Ford County",5,46,155,77,78
050,17,053,"Illinois","Ford County",5,47,157,82,75
050,17,053,"Illinois","Ford County",5,48,158,81,77
050,17,053,"Illinois","Ford County",5,49,143,74,69
050,17,053,"Illinois","Ford County",5,50,146,76,70
050,17,053,"Illinois","Ford County",5,51,162,78,84
050,17,053,"Illinois","Ford County",5,52,163,89,74
050,17,053,"Illinois","Ford County",5,53,161,84,77
050,17,053,"Illinois","Ford County",5,54,159,86,73
050,17,053,"Illinois","Ford County",5,55,163,79,84
050,17,053,"Illinois","Ford County",5,56,166,83,83
050,17,053,"Illinois","Ford County",5,57,145,75,70
050,17,053,"Illinois","Ford County",5,58,151,71,80
050,17,053,"Illinois","Ford County",5,59,176,85,91
050,17,053,"Illinois","Ford County",5,60,188,95,93
050,17,053,"Illinois","Ford County",5,61,188,90,98
050,17,053,"Illinois","Ford County",5,62,199,97,102
050,17,053,"Illinois","Ford County",5,63,208,100,108
050,17,053,"Illinois","Ford County",5,64,207,105,102
050,17,053,"Illinois","Ford County",5,65,199,104,95
050,17,053,"Illinois","Ford County",5,66,188,98,90
050,17,053,"Illinois","Ford County",5,67,185,90,95
050,17,053,"Illinois","Ford County",5,68,175,80,95
050,17,053,"Illinois","Ford County",5,69,167,77,90
050,17,053,"Illinois","Ford County",5,70,152,78,74
050,17,053,"Illinois","Ford County",5,71,128,71,57
050,17,053,"Illinois","Ford County",5,72,112,55,57
050,17,053,"Illinois","Ford County",5,73,107,47,60
050,17,053,"Illinois","Ford County",5,74,114,54,60
050,17,053,"Illinois","Ford County",5,75,101,52,49
050,17,053,"Illinois","Ford County",5,76,113,58,55
050,17,053,"Illinois","Ford County",5,77,72,35,37
050,17,053,"Illinois","Ford County",5,78,73,34,39
050,17,053,"Illinois","Ford County",5,79,71,29,42
050,17,053,"Illinois","Ford County",5,80,75,29,46
050,17,053,"Illinois","Ford County",5,81,70,29,41
050,17,053,"Illinois","Ford County",5,82,71,33,38
050,17,053,"Illinois","Ford County",5,83,65,25,40
050,17,053,"Illinois","Ford County",5,84,48,16,32
050,17,053,"Illinois","Ford County",5,85,356,98,258
050,17,055,"Illinois","Franklin County",1,0,453,232,221
050,17,055,"Illinois","Franklin County",1,1,449,230,219
050,17,055,"Illinois","Franklin County",1,2,419,205,214
050,17,055,"Illinois","Franklin County",1,3,452,227,225
050,17,055,"Illinois","Franklin County",1,4,465,245,220
050,17,055,"Illinois","Franklin County",1,5,452,244,208
050,17,055,"Illinois","Franklin County",1,6,451,243,208
050,17,055,"Illinois","Franklin County",1,7,440,231,209
050,17,055,"Illinois","Franklin County",1,8,456,246,210
050,17,055,"Illinois","Franklin County",1,9,458,232,226
050,17,055,"Illinois","Franklin County",1,10,475,260,215
050,17,055,"Illinois","Franklin County",1,11,482,250,232
050,17,055,"Illinois","Franklin County",1,12,491,268,223
050,17,055,"Illinois","Franklin County",1,13,499,269,230
050,17,055,"Illinois","Franklin County",1,14,494,257,237
050,17,055,"Illinois","Franklin County",1,15,487,265,222
050,17,055,"Illinois","Franklin County",1,16,526,265,261
050,17,055,"Illinois","Franklin County",1,17,513,269,244
050,17,055,"Illinois","Franklin County",1,18,426,222,204
050,17,055,"Illinois","Franklin County",1,19,337,184,153
050,17,055,"Illinois","Franklin County",1,20,362,182,180
050,17,055,"Illinois","Franklin County",1,21,381,199,182
050,17,055,"Illinois","Franklin County",1,22,377,187,190
050,17,055,"Illinois","Franklin County",1,23,376,181,195
050,17,055,"Illinois","Franklin County",1,24,390,207,183
050,17,055,"Illinois","Franklin County",1,25,438,228,210
050,17,055,"Illinois","Franklin County",1,26,413,204,209
050,17,055,"Illinois","Franklin County",1,27,414,221,193
050,17,055,"Illinois","Franklin County",1,28,457,232,225
050,17,055,"Illinois","Franklin County",1,29,443,226,217
050,17,055,"Illinois","Franklin County",1,30,441,229,212
050,17,055,"Illinois","Franklin County",1,31,413,207,206
050,17,055,"Illinois","Franklin County",1,32,411,207,204
050,17,055,"Illinois","Franklin County",1,33,433,228,205
050,17,055,"Illinois","Franklin County",1,34,432,221,211
050,17,055,"Illinois","Franklin County",1,35,407,194,213
050,17,055,"Illinois","Franklin County",1,36,413,194,219
050,17,055,"Illinois","Franklin County",1,37,414,211,203
050,17,055,"Illinois","Franklin County",1,38,424,206,218
050,17,055,"Illinois","Franklin County",1,39,479,233,246
050,17,055,"Illinois","Franklin County",1,40,441,220,221
050,17,055,"Illinois","Franklin County",1,41,465,229,236
050,17,055,"Illinois","Franklin County",1,42,449,220,229
050,17,055,"Illinois","Franklin County",1,43,454,216,238
050,17,055,"Illinois","Franklin County",1,44,447,214,233
050,17,055,"Illinois","Franklin County",1,45,457,225,232
050,17,055,"Illinois","Franklin County",1,46,464,231,233
050,17,055,"Illinois","Franklin County",1,47,464,223,241
050,17,055,"Illinois","Franklin County",1,48,517,272,245
050,17,055,"Illinois","Franklin County",1,49,507,263,244
050,17,055,"Illinois","Franklin County",1,50,486,257,229
050,17,055,"Illinois","Franklin County",1,51,506,261,245
050,17,055,"Illinois","Franklin County",1,52,506,248,258
050,17,055,"Illinois","Franklin County",1,53,494,240,254
050,17,055,"Illinois","Franklin County",1,54,522,262,260
050,17,055,"Illinois","Franklin County",1,55,538,269,269
050,17,055,"Illinois","Franklin County",1,56,541,274,267
050,17,055,"Illinois","Franklin County",1,57,526,254,272
050,17,055,"Illinois","Franklin County",1,58,526,262,264
050,17,055,"Illinois","Franklin County",1,59,561,273,288
050,17,055,"Illinois","Franklin County",1,60,542,265,277
050,17,055,"Illinois","Franklin County",1,61,518,267,251
050,17,055,"Illinois","Franklin County",1,62,523,272,251
050,17,055,"Illinois","Franklin County",1,63,546,280,266
050,17,055,"Illinois","Franklin County",1,64,533,276,257
050,17,055,"Illinois","Franklin County",1,65,514,248,266
050,17,055,"Illinois","Franklin County",1,66,486,234,252
050,17,055,"Illinois","Franklin County",1,67,477,233,244
050,17,055,"Illinois","Franklin County",1,68,462,213,249
050,17,055,"Illinois","Franklin County",1,69,437,209,228
050,17,055,"Illinois","Franklin County",1,70,453,221,232
050,17,055,"Illinois","Franklin County",1,71,407,198,209
050,17,055,"Illinois","Franklin County",1,72,443,212,231
050,17,055,"Illinois","Franklin County",1,73,446,207,239
050,17,055,"Illinois","Franklin County",1,74,298,134,164
050,17,055,"Illinois","Franklin County",1,75,312,140,172
050,17,055,"Illinois","Franklin County",1,76,335,148,187
050,17,055,"Illinois","Franklin County",1,77,321,143,178
050,17,055,"Illinois","Franklin County",1,78,283,126,157
050,17,055,"Illinois","Franklin County",1,79,268,116,152
050,17,055,"Illinois","Franklin County",1,80,231,105,126
050,17,055,"Illinois","Franklin County",1,81,217,100,117
050,17,055,"Illinois","Franklin County",1,82,197,84,113
050,17,055,"Illinois","Franklin County",1,83,176,78,98
050,17,055,"Illinois","Franklin County",1,84,156,69,87
050,17,055,"Illinois","Franklin County",1,85,808,290,518
050,17,055,"Illinois","Franklin County",2,0,440,224,216
050,17,055,"Illinois","Franklin County",2,1,444,227,217
050,17,055,"Illinois","Franklin County",2,2,426,213,213
050,17,055,"Illinois","Franklin County",2,3,441,220,221
050,17,055,"Illinois","Franklin County",2,4,461,239,222
050,17,055,"Illinois","Franklin County",2,5,451,242,209
050,17,055,"Illinois","Franklin County",2,6,452,243,209
050,17,055,"Illinois","Franklin County",2,7,441,234,207
050,17,055,"Illinois","Franklin County",2,8,453,243,210
050,17,055,"Illinois","Franklin County",2,9,457,236,221
050,17,055,"Illinois","Franklin County",2,10,467,251,216
050,17,055,"Illinois","Franklin County",2,11,474,250,224
050,17,055,"Illinois","Franklin County",2,12,490,265,225
050,17,055,"Illinois","Franklin County",2,13,501,272,229
050,17,055,"Illinois","Franklin County",2,14,493,259,234
050,17,055,"Illinois","Franklin County",2,15,490,266,224
050,17,055,"Illinois","Franklin County",2,16,518,268,250
050,17,055,"Illinois","Franklin County",2,17,512,266,246
050,17,055,"Illinois","Franklin County",2,18,424,224,200
050,17,055,"Illinois","Franklin County",2,19,339,180,159
050,17,055,"Illinois","Franklin County",2,20,369,188,181
050,17,055,"Illinois","Franklin County",2,21,381,197,184
050,17,055,"Illinois","Franklin County",2,22,378,188,190
050,17,055,"Illinois","Franklin County",2,23,377,182,195
050,17,055,"Illinois","Franklin County",2,24,383,199,184
050,17,055,"Illinois","Franklin County",2,25,427,223,204
050,17,055,"Illinois","Franklin County",2,26,420,211,209
050,17,055,"Illinois","Franklin County",2,27,412,217,195
050,17,055,"Illinois","Franklin County",2,28,442,229,213
050,17,055,"Illinois","Franklin County",2,29,445,228,217
050,17,055,"Illinois","Franklin County",2,30,440,228,212
050,17,055,"Illinois","Franklin County",2,31,417,210,207
050,17,055,"Illinois","Franklin County",2,32,411,207,204
050,17,055,"Illinois","Franklin County",2,33,424,222,202
050,17,055,"Illinois","Franklin County",2,34,432,223,209
050,17,055,"Illinois","Franklin County",2,35,417,203,214
050,17,055,"Illinois","Franklin County",2,36,402,190,212
050,17,055,"Illinois","Franklin County",2,37,411,205,206
050,17,055,"Illinois","Franklin County",2,38,425,209,216
050,17,055,"Illinois","Franklin County",2,39,460,223,237
050,17,055,"Illinois","Franklin County",2,40,448,222,226
050,17,055,"Illinois","Franklin County",2,41,457,225,232
050,17,055,"Illinois","Franklin County",2,42,450,220,230
050,17,055,"Illinois","Franklin County",2,43,456,218,238
050,17,055,"Illinois","Franklin County",2,44,446,214,232
050,17,055,"Illinois","Franklin County",2,45,458,223,235
050,17,055,"Illinois","Franklin County",2,46,459,228,231
050,17,055,"Illinois","Franklin County",2,47,463,226,237
050,17,055,"Illinois","Franklin County",2,48,502,257,245
050,17,055,"Illinois","Franklin County",2,49,513,266,247
050,17,055,"Illinois","Franklin County",2,50,493,260,233
050,17,055,"Illinois","Franklin County",2,51,499,259,240
050,17,055,"Illinois","Franklin County",2,52,502,249,253
050,17,055,"Illinois","Franklin County",2,53,498,242,256
050,17,055,"Illinois","Franklin County",2,54,514,257,257
050,17,055,"Illinois","Franklin County",2,55,533,266,267
050,17,055,"Illinois","Franklin County",2,56,541,273,268
050,17,055,"Illinois","Franklin County",2,57,529,258,271
050,17,055,"Illinois","Franklin County",2,58,524,259,265
050,17,055,"Illinois","Franklin County",2,59,555,272,283
050,17,055,"Illinois","Franklin County",2,60,542,265,277
050,17,055,"Illinois","Franklin County",2,61,522,266,256
050,17,055,"Illinois","Franklin County",2,62,520,269,251
050,17,055,"Illinois","Franklin County",2,63,548,282,266
050,17,055,"Illinois","Franklin County",2,64,531,274,257
050,17,055,"Illinois","Franklin County",2,65,518,255,263
050,17,055,"Illinois","Franklin County",2,66,489,235,254
050,17,055,"Illinois","Franklin County",2,67,478,232,246
050,17,055,"Illinois","Franklin County",2,68,459,215,244
050,17,055,"Illinois","Franklin County",2,69,440,209,231
050,17,055,"Illinois","Franklin County",2,70,444,216,228
050,17,055,"Illinois","Franklin County",2,71,419,204,215
050,17,055,"Illinois","Franklin County",2,72,424,204,220
050,17,055,"Illinois","Franklin County",2,73,466,217,249
050,17,055,"Illinois","Franklin County",2,74,313,140,173
050,17,055,"Illinois","Franklin County",2,75,308,137,171
050,17,055,"Illinois","Franklin County",2,76,321,141,180
050,17,055,"Illinois","Franklin County",2,77,327,146,181
050,17,055,"Illinois","Franklin County",2,78,284,126,158
050,17,055,"Illinois","Franklin County",2,79,265,115,150
050,17,055,"Illinois","Franklin County",2,80,235,107,128
050,17,055,"Illinois","Franklin County",2,81,220,100,120
050,17,055,"Illinois","Franklin County",2,82,198,88,110
050,17,055,"Illinois","Franklin County",2,83,178,76,102
050,17,055,"Illinois","Franklin County",2,84,155,70,85
050,17,055,"Illinois","Franklin County",2,85,806,293,513
050,17,055,"Illinois","Franklin County",3,0,370,182,188
050,17,055,"Illinois","Franklin County",3,1,444,224,220
050,17,055,"Illinois","Franklin County",3,2,455,234,221
050,17,055,"Illinois","Franklin County",3,3,448,227,221
050,17,055,"Illinois","Franklin County",3,4,431,208,223
050,17,055,"Illinois","Franklin County",3,5,469,247,222
050,17,055,"Illinois","Franklin County",3,6,465,242,223
050,17,055,"Illinois","Franklin County",3,7,459,255,204
050,17,055,"Illinois","Franklin County",3,8,427,226,201
050,17,055,"Illinois","Franklin County",3,9,440,236,204
050,17,055,"Illinois","Franklin County",3,10,443,231,212
050,17,055,"Illinois","Franklin County",3,11,470,252,218
050,17,055,"Illinois","Franklin County",3,12,478,258,220
050,17,055,"Illinois","Franklin County",3,13,497,267,230
050,17,055,"Illinois","Franklin County",3,14,505,278,227
050,17,055,"Illinois","Franklin County",3,15,471,249,222
050,17,055,"Illinois","Franklin County",3,16,500,277,223
050,17,055,"Illinois","Franklin County",3,17,514,251,263
050,17,055,"Illinois","Franklin County",3,18,428,217,211
050,17,055,"Illinois","Franklin County",3,19,334,174,160
050,17,055,"Illinois","Franklin County",3,20,352,189,163
050,17,055,"Illinois","Franklin County",3,21,384,195,189
050,17,055,"Illinois","Franklin County",3,22,417,225,192
050,17,055,"Illinois","Franklin County",3,23,389,196,193
050,17,055,"Illinois","Franklin County",3,24,399,192,207
050,17,055,"Illinois","Franklin County",3,25,408,221,187
050,17,055,"Illinois","Franklin County",3,26,431,222,209
050,17,055,"Illinois","Franklin County",3,27,437,228,209
050,17,055,"Illinois","Franklin County",3,28,409,214,195
050,17,055,"Illinois","Franklin County",3,29,455,236,219
050,17,055,"Illinois","Franklin County",3,30,438,221,217
050,17,055,"Illinois","Franklin County",3,31,441,227,214
050,17,055,"Illinois","Franklin County",3,32,409,205,204
050,17,055,"Illinois","Franklin County",3,33,418,207,211
050,17,055,"Illinois","Franklin County",3,34,421,223,198
050,17,055,"Illinois","Franklin County",3,35,443,234,209
050,17,055,"Illinois","Franklin County",3,36,405,201,204
050,17,055,"Illinois","Franklin County",3,37,406,193,213
050,17,055,"Illinois","Franklin County",3,38,425,217,208
050,17,055,"Illinois","Franklin County",3,39,431,210,221
050,17,055,"Illinois","Franklin County",3,40,451,220,231
050,17,055,"Illinois","Franklin County",3,41,445,219,226
050,17,055,"Illinois","Franklin County",3,42,455,218,237
050,17,055,"Illinois","Franklin County",3,43,430,213,217
050,17,055,"Illinois","Franklin County",3,44,464,221,243
050,17,055,"Illinois","Franklin County",3,45,442,215,227
050,17,055,"Illinois","Franklin County",3,46,454,222,232
050,17,055,"Illinois","Franklin County",3,47,458,227,231
050,17,055,"Illinois","Franklin County",3,48,476,232,244
050,17,055,"Illinois","Franklin County",3,49,510,260,250
050,17,055,"Illinois","Franklin County",3,50,517,270,247
050,17,055,"Illinois","Franklin County",3,51,491,249,242
050,17,055,"Illinois","Franklin County",3,52,502,263,239
050,17,055,"Illinois","Franklin County",3,53,494,244,250
050,17,055,"Illinois","Franklin County",3,54,490,240,250
050,17,055,"Illinois","Franklin County",3,55,521,256,265
050,17,055,"Illinois","Franklin County",3,56,524,259,265
050,17,055,"Illinois","Franklin County",3,57,544,271,273
050,17,055,"Illinois","Franklin County",3,58,521,251,270
050,17,055,"Illinois","Franklin County",3,59,520,253,267
050,17,055,"Illinois","Franklin County",3,60,540,257,283
050,17,055,"Illinois","Franklin County",3,61,549,266,283
050,17,055,"Illinois","Franklin County",3,62,515,267,248
050,17,055,"Illinois","Franklin County",3,63,501,261,240
050,17,055,"Illinois","Franklin County",3,64,533,267,266
050,17,055,"Illinois","Franklin County",3,65,516,258,258
050,17,055,"Illinois","Franklin County",3,66,500,244,256
050,17,055,"Illinois","Franklin County",3,67,489,230,259
050,17,055,"Illinois","Franklin County",3,68,467,229,238
050,17,055,"Illinois","Franklin County",3,69,432,195,237
050,17,055,"Illinois","Franklin County",3,70,423,196,227
050,17,055,"Illinois","Franklin County",3,71,426,210,216
050,17,055,"Illinois","Franklin County",3,72,404,194,210
050,17,055,"Illinois","Franklin County",3,73,395,190,205
050,17,055,"Illinois","Franklin County",3,74,443,198,245
050,17,055,"Illinois","Franklin County",3,75,300,135,165
050,17,055,"Illinois","Franklin County",3,76,292,120,172
050,17,055,"Illinois","Franklin County",3,77,294,131,163
050,17,055,"Illinois","Franklin County",3,78,312,132,180
050,17,055,"Illinois","Franklin County",3,79,268,120,148
050,17,055,"Illinois","Franklin County",3,80,244,106,138
050,17,055,"Illinois","Franklin County",3,81,222,95,127
050,17,055,"Illinois","Franklin County",3,82,200,91,109
050,17,055,"Illinois","Franklin County",3,83,184,82,102
050,17,055,"Illinois","Franklin County",3,84,150,64,86
050,17,055,"Illinois","Franklin County",3,85,785,285,500
050,17,055,"Illinois","Franklin County",4,0,408,198,210
050,17,055,"Illinois","Franklin County",4,1,386,196,190
050,17,055,"Illinois","Franklin County",4,2,443,222,221
050,17,055,"Illinois","Franklin County",4,3,453,239,214
050,17,055,"Illinois","Franklin County",4,4,450,234,216
050,17,055,"Illinois","Franklin County",4,5,433,211,222
050,17,055,"Illinois","Franklin County",4,6,458,246,212
050,17,055,"Illinois","Franklin County",4,7,461,237,224
050,17,055,"Illinois","Franklin County",4,8,446,237,209
050,17,055,"Illinois","Franklin County",4,9,424,220,204
050,17,055,"Illinois","Franklin County",4,10,458,250,208
050,17,055,"Illinois","Franklin County",4,11,444,225,219
050,17,055,"Illinois","Franklin County",4,12,477,259,218
050,17,055,"Illinois","Franklin County",4,13,481,257,224
050,17,055,"Illinois","Franklin County",4,14,497,270,227
050,17,055,"Illinois","Franklin County",4,15,503,277,226
050,17,055,"Illinois","Franklin County",4,16,482,255,227
050,17,055,"Illinois","Franklin County",4,17,487,266,221
050,17,055,"Illinois","Franklin County",4,18,422,223,199
050,17,055,"Illinois","Franklin County",4,19,325,168,157
050,17,055,"Illinois","Franklin County",4,20,352,181,171
050,17,055,"Illinois","Franklin County",4,21,388,208,180
050,17,055,"Illinois","Franklin County",4,22,401,202,199
050,17,055,"Illinois","Franklin County",4,23,416,228,188
050,17,055,"Illinois","Franklin County",4,24,409,208,201
050,17,055,"Illinois","Franklin County",4,25,400,189,211
050,17,055,"Illinois","Franklin County",4,26,412,232,180
050,17,055,"Illinois","Franklin County",4,27,424,223,201
050,17,055,"Illinois","Franklin County",4,28,432,225,207
050,17,055,"Illinois","Franklin County",4,29,397,202,195
050,17,055,"Illinois","Franklin County",4,30,458,230,228
050,17,055,"Illinois","Franklin County",4,31,428,218,210
050,17,055,"Illinois","Franklin County",4,32,438,220,218
050,17,055,"Illinois","Franklin County",4,33,406,206,200
050,17,055,"Illinois","Franklin County",4,34,425,205,220
050,17,055,"Illinois","Franklin County",4,35,407,215,192
050,17,055,"Illinois","Franklin County",4,36,434,235,199
050,17,055,"Illinois","Franklin County",4,37,421,213,208
050,17,055,"Illinois","Franklin County",4,38,399,196,203
050,17,055,"Illinois","Franklin County",4,39,418,212,206
050,17,055,"Illinois","Franklin County",4,40,444,218,226
050,17,055,"Illinois","Franklin County",4,41,461,229,232
050,17,055,"Illinois","Franklin County",4,42,462,231,231
050,17,055,"Illinois","Franklin County",4,43,465,231,234
050,17,055,"Illinois","Franklin County",4,44,426,212,214
050,17,055,"Illinois","Franklin County",4,45,462,213,249
050,17,055,"Illinois","Franklin County",4,46,443,211,232
050,17,055,"Illinois","Franklin County",4,47,465,232,233
050,17,055,"Illinois","Franklin County",4,48,459,226,233
050,17,055,"Illinois","Franklin County",4,49,470,221,249
050,17,055,"Illinois","Franklin County",4,50,496,255,241
050,17,055,"Illinois","Franklin County",4,51,518,266,252
050,17,055,"Illinois","Franklin County",4,52,479,248,231
050,17,055,"Illinois","Franklin County",4,53,507,270,237
050,17,055,"Illinois","Franklin County",4,54,493,244,249
050,17,055,"Illinois","Franklin County",4,55,485,236,249
050,17,055,"Illinois","Franklin County",4,56,517,254,263
050,17,055,"Illinois","Franklin County",4,57,523,253,270
050,17,055,"Illinois","Franklin County",4,58,546,268,278
050,17,055,"Illinois","Franklin County",4,59,526,255,271
050,17,055,"Illinois","Franklin County",4,60,508,247,261
050,17,055,"Illinois","Franklin County",4,61,533,256,277
050,17,055,"Illinois","Franklin County",4,62,546,267,279
050,17,055,"Illinois","Franklin County",4,63,506,262,244
050,17,055,"Illinois","Franklin County",4,64,487,257,230
050,17,055,"Illinois","Franklin County",4,65,520,255,265
050,17,055,"Illinois","Franklin County",4,66,491,244,247
050,17,055,"Illinois","Franklin County",4,67,499,243,256
050,17,055,"Illinois","Franklin County",4,68,479,228,251
050,17,055,"Illinois","Franklin County",4,69,445,212,233
050,17,055,"Illinois","Franklin County",4,70,413,187,226
050,17,055,"Illinois","Franklin County",4,71,405,184,221
050,17,055,"Illinois","Franklin County",4,72,410,205,205
050,17,055,"Illinois","Franklin County",4,73,387,184,203
050,17,055,"Illinois","Franklin County",4,74,382,180,202
050,17,055,"Illinois","Franklin County",4,75,422,190,232
050,17,055,"Illinois","Franklin County",4,76,291,125,166
050,17,055,"Illinois","Franklin County",4,77,273,112,161
050,17,055,"Illinois","Franklin County",4,78,279,123,156
050,17,055,"Illinois","Franklin County",4,79,301,124,177
050,17,055,"Illinois","Franklin County",4,80,244,108,136
050,17,055,"Illinois","Franklin County",4,81,229,97,132
050,17,055,"Illinois","Franklin County",4,82,204,84,120
050,17,055,"Illinois","Franklin County",4,83,190,81,109
050,17,055,"Illinois","Franklin County",4,84,160,74,86
050,17,055,"Illinois","Franklin County",4,85,761,271,490
050,17,055,"Illinois","Franklin County",5,0,395,190,205
050,17,055,"Illinois","Franklin County",5,1,428,211,217
050,17,055,"Illinois","Franklin County",5,2,401,207,194
050,17,055,"Illinois","Franklin County",5,3,458,235,223
050,17,055,"Illinois","Franklin County",5,4,451,236,215
050,17,055,"Illinois","Franklin County",5,5,445,230,215
050,17,055,"Illinois","Franklin County",5,6,432,203,229
050,17,055,"Illinois","Franklin County",5,7,471,252,219
050,17,055,"Illinois","Franklin County",5,8,468,243,225
050,17,055,"Illinois","Franklin County",5,9,454,249,205
050,17,055,"Illinois","Franklin County",5,10,433,223,210
050,17,055,"Illinois","Franklin County",5,11,458,252,206
050,17,055,"Illinois","Franklin County",5,12,450,229,221
050,17,055,"Illinois","Franklin County",5,13,473,254,219
050,17,055,"Illinois","Franklin County",5,14,484,264,220
050,17,055,"Illinois","Franklin County",5,15,489,264,225
050,17,055,"Illinois","Franklin County",5,16,513,282,231
050,17,055,"Illinois","Franklin County",5,17,477,247,230
050,17,055,"Illinois","Franklin County",5,18,397,221,176
050,17,055,"Illinois","Franklin County",5,19,337,174,163
050,17,055,"Illinois","Franklin County",5,20,375,191,184
050,17,055,"Illinois","Franklin County",5,21,366,187,179
050,17,055,"Illinois","Franklin County",5,22,408,213,195
050,17,055,"Illinois","Franklin County",5,23,405,201,204
050,17,055,"Illinois","Franklin County",5,24,437,234,203
050,17,055,"Illinois","Franklin County",5,25,407,211,196
050,17,055,"Illinois","Franklin County",5,26,398,185,213
050,17,055,"Illinois","Franklin County",5,27,422,229,193
050,17,055,"Illinois","Franklin County",5,28,442,235,207
050,17,055,"Illinois","Franklin County",5,29,440,231,209
050,17,055,"Illinois","Franklin County",5,30,399,201,198
050,17,055,"Illinois","Franklin County",5,31,449,230,219
050,17,055,"Illinois","Franklin County",5,32,432,223,209
050,17,055,"Illinois","Franklin County",5,33,438,216,222
050,17,055,"Illinois","Franklin County",5,34,412,205,207
050,17,055,"Illinois","Franklin County",5,35,429,213,216
050,17,055,"Illinois","Franklin County",5,36,402,214,188
050,17,055,"Illinois","Franklin County",5,37,437,235,202
050,17,055,"Illinois","Franklin County",5,38,424,215,209
050,17,055,"Illinois","Franklin County",5,39,404,195,209
050,17,055,"Illinois","Franklin County",5,40,416,204,212
050,17,055,"Illinois","Franklin County",5,41,448,217,231
050,17,055,"Illinois","Franklin County",5,42,467,224,243
050,17,055,"Illinois","Franklin County",5,43,461,240,221
050,17,055,"Illinois","Franklin County",5,44,469,235,234
050,17,055,"Illinois","Franklin County",5,45,425,213,212
050,17,055,"Illinois","Franklin County",5,46,468,215,253
050,17,055,"Illinois","Franklin County",5,47,444,211,233
050,17,055,"Illinois","Franklin County",5,48,437,216,221
050,17,055,"Illinois","Franklin County",5,49,455,222,233
050,17,055,"Illinois","Franklin County",5,50,473,223,250
050,17,055,"Illinois","Franklin County",5,51,502,257,245
050,17,055,"Illinois","Franklin County",5,52,514,276,238
050,17,055,"Illinois","Franklin County",5,53,471,245,226
050,17,055,"Illinois","Franklin County",5,54,504,267,237
050,17,055,"Illinois","Franklin County",5,55,485,232,253
050,17,055,"Illinois","Franklin County",5,56,490,238,252
050,17,055,"Illinois","Franklin County",5,57,514,257,257
050,17,055,"Illinois","Franklin County",5,58,518,251,267
050,17,055,"Illinois","Franklin County",5,59,559,280,279
050,17,055,"Illinois","Franklin County",5,60,515,247,268
050,17,055,"Illinois","Franklin County",5,61,495,238,257
050,17,055,"Illinois","Franklin County",5,62,515,247,268
050,17,055,"Illinois","Franklin County",5,63,539,264,275
050,17,055,"Illinois","Franklin County",5,64,501,261,240
050,17,055,"Illinois","Franklin County",5,65,487,258,229
050,17,055,"Illinois","Franklin County",5,66,506,250,256
050,17,055,"Illinois","Franklin County",5,67,492,236,256
050,17,055,"Illinois","Franklin County",5,68,495,242,253
050,17,055,"Illinois","Franklin County",5,69,462,217,245
050,17,055,"Illinois","Franklin County",5,70,430,202,228
050,17,055,"Illinois","Franklin County",5,71,390,175,215
050,17,055,"Illinois","Franklin County",5,72,398,179,219
050,17,055,"Illinois","Franklin County",5,73,389,195,194
050,17,055,"Illinois","Franklin County",5,74,381,177,204
050,17,055,"Illinois","Franklin County",5,75,369,179,190
050,17,055,"Illinois","Franklin County",5,76,403,176,227
050,17,055,"Illinois","Franklin County",5,77,264,115,149
050,17,055,"Illinois","Franklin County",5,78,262,101,161
050,17,055,"Illinois","Franklin County",5,79,269,116,153
050,17,055,"Illinois","Franklin County",5,80,274,111,163
050,17,055,"Illinois","Franklin County",5,81,222,91,131
050,17,055,"Illinois","Franklin County",5,82,207,87,120
050,17,055,"Illinois","Franklin County",5,83,187,74,113
050,17,055,"Illinois","Franklin County",5,84,168,73,95
050,17,055,"Illinois","Franklin County",5,85,758,265,493
050,17,057,"Illinois","Fulton County",1,0,297,151,146
050,17,057,"Illinois","Fulton County",1,1,323,161,162
050,17,057,"Illinois","Fulton County",1,2,331,166,165
050,17,057,"Illinois","Fulton County",1,3,336,176,160
050,17,057,"Illinois","Fulton County",1,4,358,185,173
050,17,057,"Illinois","Fulton County",1,5,348,171,177
050,17,057,"Illinois","Fulton County",1,6,355,186,169
050,17,057,"Illinois","Fulton County",1,7,352,188,164
050,17,057,"Illinois","Fulton County",1,8,362,183,179
050,17,057,"Illinois","Fulton County",1,9,387,187,200
050,17,057,"Illinois","Fulton County",1,10,389,199,190
050,17,057,"Illinois","Fulton County",1,11,388,194,194
050,17,057,"Illinois","Fulton County",1,12,411,203,208
050,17,057,"Illinois","Fulton County",1,13,434,218,216
050,17,057,"Illinois","Fulton County",1,14,401,202,199
050,17,057,"Illinois","Fulton County",1,15,417,221,196
050,17,057,"Illinois","Fulton County",1,16,417,216,201
050,17,057,"Illinois","Fulton County",1,17,428,219,209
050,17,057,"Illinois","Fulton County",1,18,378,204,174
050,17,057,"Illinois","Fulton County",1,19,312,175,137
050,17,057,"Illinois","Fulton County",1,20,333,195,138
050,17,057,"Illinois","Fulton County",1,21,355,208,147
050,17,057,"Illinois","Fulton County",1,22,369,202,167
050,17,057,"Illinois","Fulton County",1,23,379,219,160
050,17,057,"Illinois","Fulton County",1,24,388,230,158
050,17,057,"Illinois","Fulton County",1,25,358,199,159
050,17,057,"Illinois","Fulton County",1,26,395,221,174
050,17,057,"Illinois","Fulton County",1,27,426,253,173
050,17,057,"Illinois","Fulton County",1,28,373,215,158
050,17,057,"Illinois","Fulton County",1,29,383,232,151
050,17,057,"Illinois","Fulton County",1,30,386,198,188
050,17,057,"Illinois","Fulton County",1,31,374,196,178
050,17,057,"Illinois","Fulton County",1,32,356,197,159
050,17,057,"Illinois","Fulton County",1,33,406,233,173
050,17,057,"Illinois","Fulton County",1,34,437,253,184
050,17,057,"Illinois","Fulton County",1,35,411,225,186
050,17,057,"Illinois","Fulton County",1,36,406,230,176
050,17,057,"Illinois","Fulton County",1,37,421,240,181
050,17,057,"Illinois","Fulton County",1,38,424,243,181
050,17,057,"Illinois","Fulton County",1,39,423,237,186
050,17,057,"Illinois","Fulton County",1,40,456,240,216
050,17,057,"Illinois","Fulton County",1,41,456,245,211
050,17,057,"Illinois","Fulton County",1,42,429,228,201
050,17,057,"Illinois","Fulton County",1,43,439,242,197
050,17,057,"Illinois","Fulton County",1,44,417,229,188
050,17,057,"Illinois","Fulton County",1,45,416,231,185
050,17,057,"Illinois","Fulton County",1,46,415,223,192
050,17,057,"Illinois","Fulton County",1,47,419,240,179
050,17,057,"Illinois","Fulton County",1,48,464,273,191
050,17,057,"Illinois","Fulton County",1,49,479,273,206
050,17,057,"Illinois","Fulton County",1,50,436,244,192
050,17,057,"Illinois","Fulton County",1,51,416,221,195
050,17,057,"Illinois","Fulton County",1,52,437,230,207
050,17,057,"Illinois","Fulton County",1,53,439,238,201
050,17,057,"Illinois","Fulton County",1,54,439,223,216
050,17,057,"Illinois","Fulton County",1,55,465,227,238
050,17,057,"Illinois","Fulton County",1,56,458,233,225
050,17,057,"Illinois","Fulton County",1,57,486,246,240
050,17,057,"Illinois","Fulton County",1,58,505,264,241
050,17,057,"Illinois","Fulton County",1,59,519,267,252
050,17,057,"Illinois","Fulton County",1,60,492,245,247
050,17,057,"Illinois","Fulton County",1,61,458,226,232
050,17,057,"Illinois","Fulton County",1,62,491,241,250
050,17,057,"Illinois","Fulton County",1,63,490,229,261
050,17,057,"Illinois","Fulton County",1,64,496,236,260
050,17,057,"Illinois","Fulton County",1,65,456,225,231
050,17,057,"Illinois","Fulton County",1,66,460,218,242
050,17,057,"Illinois","Fulton County",1,67,451,225,226
050,17,057,"Illinois","Fulton County",1,68,460,219,241
050,17,057,"Illinois","Fulton County",1,69,411,208,203
050,17,057,"Illinois","Fulton County",1,70,389,199,190
050,17,057,"Illinois","Fulton County",1,71,377,187,190
050,17,057,"Illinois","Fulton County",1,72,396,185,211
050,17,057,"Illinois","Fulton County",1,73,378,179,199
050,17,057,"Illinois","Fulton County",1,74,268,130,138
050,17,057,"Illinois","Fulton County",1,75,266,127,139
050,17,057,"Illinois","Fulton County",1,76,260,109,151
050,17,057,"Illinois","Fulton County",1,77,277,132,145
050,17,057,"Illinois","Fulton County",1,78,228,103,125
050,17,057,"Illinois","Fulton County",1,79,218,102,116
050,17,057,"Illinois","Fulton County",1,80,182,82,100
050,17,057,"Illinois","Fulton County",1,81,190,82,108
050,17,057,"Illinois","Fulton County",1,82,172,75,97
050,17,057,"Illinois","Fulton County",1,83,150,64,86
050,17,057,"Illinois","Fulton County",1,84,136,55,81
050,17,057,"Illinois","Fulton County",1,85,839,299,540
050,17,057,"Illinois","Fulton County",2,0,314,161,153
050,17,057,"Illinois","Fulton County",2,1,314,155,159
050,17,057,"Illinois","Fulton County",2,2,330,164,166
050,17,057,"Illinois","Fulton County",2,3,335,175,160
050,17,057,"Illinois","Fulton County",2,4,355,184,171
050,17,057,"Illinois","Fulton County",2,5,350,174,176
050,17,057,"Illinois","Fulton County",2,6,350,181,169
050,17,057,"Illinois","Fulton County",2,7,353,189,164
050,17,057,"Illinois","Fulton County",2,8,355,181,174
050,17,057,"Illinois","Fulton County",2,9,379,185,194
050,17,057,"Illinois","Fulton County",2,10,388,195,193
050,17,057,"Illinois","Fulton County",2,11,387,195,192
050,17,057,"Illinois","Fulton County",2,12,405,201,204
050,17,057,"Illinois","Fulton County",2,13,427,213,214
050,17,057,"Illinois","Fulton County",2,14,411,207,204
050,17,057,"Illinois","Fulton County",2,15,411,215,196
050,17,057,"Illinois","Fulton County",2,16,418,217,201
050,17,057,"Illinois","Fulton County",2,17,423,216,207
050,17,057,"Illinois","Fulton County",2,18,367,198,169
050,17,057,"Illinois","Fulton County",2,19,313,175,138
050,17,057,"Illinois","Fulton County",2,20,337,196,141
050,17,057,"Illinois","Fulton County",2,21,354,207,147
050,17,057,"Illinois","Fulton County",2,22,367,203,164
050,17,057,"Illinois","Fulton County",2,23,380,217,163
050,17,057,"Illinois","Fulton County",2,24,381,222,159
050,17,057,"Illinois","Fulton County",2,25,363,204,159
050,17,057,"Illinois","Fulton County",2,26,390,219,171
050,17,057,"Illinois","Fulton County",2,27,421,248,173
050,17,057,"Illinois","Fulton County",2,28,381,218,163
050,17,057,"Illinois","Fulton County",2,29,384,231,153
050,17,057,"Illinois","Fulton County",2,30,383,203,180
050,17,057,"Illinois","Fulton County",2,31,375,196,179
050,17,057,"Illinois","Fulton County",2,32,360,198,162
050,17,057,"Illinois","Fulton County",2,33,394,225,169
050,17,057,"Illinois","Fulton County",2,34,429,246,183
050,17,057,"Illinois","Fulton County",2,35,420,233,187
050,17,057,"Illinois","Fulton County",2,36,403,226,177
050,17,057,"Illinois","Fulton County",2,37,420,239,181
050,17,057,"Illinois","Fulton County",2,38,421,241,180
050,17,057,"Illinois","Fulton County",2,39,420,237,183
050,17,057,"Illinois","Fulton County",2,40,449,238,211
050,17,057,"Illinois","Fulton County",2,41,456,243,213
050,17,057,"Illinois","Fulton County",2,42,430,227,203
050,17,057,"Illinois","Fulton County",2,43,441,244,197
050,17,057,"Illinois","Fulton County",2,44,417,229,188
050,17,057,"Illinois","Fulton County",2,45,419,231,188
050,17,057,"Illinois","Fulton County",2,46,412,223,189
050,17,057,"Illinois","Fulton County",2,47,411,231,180
050,17,057,"Illinois","Fulton County",2,48,455,266,189
050,17,057,"Illinois","Fulton County",2,49,478,276,202
050,17,057,"Illinois","Fulton County",2,50,443,247,196
050,17,057,"Illinois","Fulton County",2,51,418,226,192
050,17,057,"Illinois","Fulton County",2,52,425,223,202
050,17,057,"Illinois","Fulton County",2,53,436,235,201
050,17,057,"Illinois","Fulton County",2,54,432,222,210
050,17,057,"Illinois","Fulton County",2,55,456,225,231
050,17,057,"Illinois","Fulton County",2,56,457,229,228
050,17,057,"Illinois","Fulton County",2,57,479,242,237
050,17,057,"Illinois","Fulton County",2,58,498,259,239
050,17,057,"Illinois","Fulton County",2,59,517,268,249
050,17,057,"Illinois","Fulton County",2,60,492,245,247
050,17,057,"Illinois","Fulton County",2,61,462,228,234
050,17,057,"Illinois","Fulton County",2,62,481,235,246
050,17,057,"Illinois","Fulton County",2,63,492,234,258
050,17,057,"Illinois","Fulton County",2,64,492,234,258
050,17,057,"Illinois","Fulton County",2,65,465,226,239
050,17,057,"Illinois","Fulton County",2,66,458,220,238
050,17,057,"Illinois","Fulton County",2,67,447,220,227
050,17,057,"Illinois","Fulton County",2,68,453,218,235
050,17,057,"Illinois","Fulton County",2,69,424,212,212
050,17,057,"Illinois","Fulton County",2,70,394,201,193
050,17,057,"Illinois","Fulton County",2,71,375,187,188
050,17,057,"Illinois","Fulton County",2,72,383,182,201
050,17,057,"Illinois","Fulton County",2,73,401,189,212
050,17,057,"Illinois","Fulton County",2,74,269,127,142
050,17,057,"Illinois","Fulton County",2,75,264,128,136
050,17,057,"Illinois","Fulton County",2,76,257,111,146
050,17,057,"Illinois","Fulton County",2,77,277,126,151
050,17,057,"Illinois","Fulton County",2,78,233,106,127
050,17,057,"Illinois","Fulton County",2,79,218,102,116
050,17,057,"Illinois","Fulton County",2,80,188,86,102
050,17,057,"Illinois","Fulton County",2,81,186,82,104
050,17,057,"Illinois","Fulton County",2,82,174,76,98
050,17,057,"Illinois","Fulton County",2,83,151,65,86
050,17,057,"Illinois","Fulton County",2,84,138,58,80
050,17,057,"Illinois","Fulton County",2,85,816,292,524
050,17,057,"Illinois","Fulton County",3,0,281,144,137
050,17,057,"Illinois","Fulton County",3,1,322,156,166
050,17,057,"Illinois","Fulton County",3,2,306,153,153
050,17,057,"Illinois","Fulton County",3,3,320,157,163
050,17,057,"Illinois","Fulton County",3,4,334,171,163
050,17,057,"Illinois","Fulton County",3,5,356,182,174
050,17,057,"Illinois","Fulton County",3,6,349,165,184
050,17,057,"Illinois","Fulton County",3,7,357,183,174
050,17,057,"Illinois","Fulton County",3,8,353,182,171
050,17,057,"Illinois","Fulton County",3,9,349,178,171
050,17,057,"Illinois","Fulton County",3,10,376,187,189
050,17,057,"Illinois","Fulton County",3,11,405,200,205
050,17,057,"Illinois","Fulton County",3,12,391,200,191
050,17,057,"Illinois","Fulton County",3,13,396,196,200
050,17,057,"Illinois","Fulton County",3,14,421,204,217
050,17,057,"Illinois","Fulton County",3,15,410,215,195
050,17,057,"Illinois","Fulton County",3,16,404,207,197
050,17,057,"Illinois","Fulton County",3,17,428,216,212
050,17,057,"Illinois","Fulton County",3,18,362,194,168
050,17,057,"Illinois","Fulton County",3,19,311,182,129
050,17,057,"Illinois","Fulton County",3,20,346,198,148
050,17,057,"Illinois","Fulton County",3,21,371,215,156
050,17,057,"Illinois","Fulton County",3,22,370,215,155
050,17,057,"Illinois","Fulton County",3,23,393,227,166
050,17,057,"Illinois","Fulton County",3,24,377,214,163
050,17,057,"Illinois","Fulton County",3,25,369,221,148
050,17,057,"Illinois","Fulton County",3,26,388,224,164
050,17,057,"Illinois","Fulton County",3,27,406,239,167
050,17,057,"Illinois","Fulton County",3,28,402,226,176
050,17,057,"Illinois","Fulton County",3,29,405,247,158
050,17,057,"Illinois","Fulton County",3,30,370,219,151
050,17,057,"Illinois","Fulton County",3,31,402,222,180
050,17,057,"Illinois","Fulton County",3,32,389,207,182
050,17,057,"Illinois","Fulton County",3,33,370,204,166
050,17,057,"Illinois","Fulton County",3,34,396,224,172
050,17,057,"Illinois","Fulton County",3,35,413,239,174
050,17,057,"Illinois","Fulton County",3,36,422,229,193
050,17,057,"Illinois","Fulton County",3,37,409,237,172
050,17,057,"Illinois","Fulton County",3,38,430,247,183
050,17,057,"Illinois","Fulton County",3,39,428,253,175
050,17,057,"Illinois","Fulton County",3,40,398,223,175
050,17,057,"Illinois","Fulton County",3,41,462,253,209
050,17,057,"Illinois","Fulton County",3,42,457,243,214
050,17,057,"Illinois","Fulton County",3,43,447,251,196
050,17,057,"Illinois","Fulton County",3,44,434,238,196
050,17,057,"Illinois","Fulton County",3,45,410,222,188
050,17,057,"Illinois","Fulton County",3,46,417,232,185
050,17,057,"Illinois","Fulton County",3,47,406,221,185
050,17,057,"Illinois","Fulton County",3,48,421,239,182
050,17,057,"Illinois","Fulton County",3,49,445,256,189
050,17,057,"Illinois","Fulton County",3,50,463,267,196
050,17,057,"Illinois","Fulton County",3,51,436,249,187
050,17,057,"Illinois","Fulton County",3,52,414,227,187
050,17,057,"Illinois","Fulton County",3,53,437,235,202
050,17,057,"Illinois","Fulton County",3,54,422,223,199
050,17,057,"Illinois","Fulton County",3,55,441,226,215
050,17,057,"Illinois","Fulton County",3,56,458,232,226
050,17,057,"Illinois","Fulton County",3,57,449,225,224
050,17,057,"Illinois","Fulton County",3,58,460,231,229
050,17,057,"Illinois","Fulton County",3,59,500,266,234
050,17,057,"Illinois","Fulton County",3,60,503,259,244
050,17,057,"Illinois","Fulton County",3,61,500,250,250
050,17,057,"Illinois","Fulton County",3,62,451,220,231
050,17,057,"Illinois","Fulton County",3,63,469,226,243
050,17,057,"Illinois","Fulton County",3,64,477,229,248
050,17,057,"Illinois","Fulton County",3,65,484,226,258
050,17,057,"Illinois","Fulton County",3,66,459,227,232
050,17,057,"Illinois","Fulton County",3,67,446,214,232
050,17,057,"Illinois","Fulton County",3,68,441,211,230
050,17,057,"Illinois","Fulton County",3,69,446,209,237
050,17,057,"Illinois","Fulton County",3,70,421,206,215
050,17,057,"Illinois","Fulton County",3,71,377,189,188
050,17,057,"Illinois","Fulton County",3,72,360,177,183
050,17,057,"Illinois","Fulton County",3,73,371,176,195
050,17,057,"Illinois","Fulton County",3,74,378,176,202
050,17,057,"Illinois","Fulton County",3,75,250,117,133
050,17,057,"Illinois","Fulton County",3,76,249,121,128
050,17,057,"Illinois","Fulton County",3,77,241,103,138
050,17,057,"Illinois","Fulton County",3,78,253,112,141
050,17,057,"Illinois","Fulton County",3,79,224,103,121
050,17,057,"Illinois","Fulton County",3,80,197,91,106
050,17,057,"Illinois","Fulton County",3,81,177,80,97
050,17,057,"Illinois","Fulton County",3,82,168,69,99
050,17,057,"Illinois","Fulton County",3,83,160,68,92
050,17,057,"Illinois","Fulton County",3,84,141,64,77
050,17,057,"Illinois","Fulton County",3,85,768,283,485
050,17,057,"Illinois","Fulton County",4,0,259,135,124
050,17,057,"Illinois","Fulton County",4,1,304,150,154
050,17,057,"Illinois","Fulton County",4,2,327,164,163
050,17,057,"Illinois","Fulton County",4,3,324,165,159
050,17,057,"Illinois","Fulton County",4,4,328,160,168
050,17,057,"Illinois","Fulton County",4,5,342,172,170
050,17,057,"Illinois","Fulton County",4,6,366,187,179
050,17,057,"Illinois","Fulton County",4,7,362,178,184
050,17,057,"Illinois","Fulton County",4,8,354,182,172
050,17,057,"Illinois","Fulton County",4,9,356,182,174
050,17,057,"Illinois","Fulton County",4,10,350,185,165
050,17,057,"Illinois","Fulton County",4,11,368,179,189
050,17,057,"Illinois","Fulton County",4,12,395,198,197
050,17,057,"Illinois","Fulton County",4,13,389,197,192
050,17,057,"Illinois","Fulton County",4,14,397,198,199
050,17,057,"Illinois","Fulton County",4,15,425,212,213
050,17,057,"Illinois","Fulton County",4,16,403,207,196
050,17,057,"Illinois","Fulton County",4,17,412,215,197
050,17,057,"Illinois","Fulton County",4,18,368,205,163
050,17,057,"Illinois","Fulton County",4,19,298,164,134
050,17,057,"Illinois","Fulton County",4,20,338,201,137
050,17,057,"Illinois","Fulton County",4,21,357,209,148
050,17,057,"Illinois","Fulton County",4,22,383,218,165
050,17,057,"Illinois","Fulton County",4,23,382,225,157
050,17,057,"Illinois","Fulton County",4,24,377,222,155
050,17,057,"Illinois","Fulton County",4,25,372,207,165
050,17,057,"Illinois","Fulton County",4,26,379,230,149
050,17,057,"Illinois","Fulton County",4,27,417,235,182
050,17,057,"Illinois","Fulton County",4,28,373,210,163
050,17,057,"Illinois","Fulton County",4,29,425,249,176
050,17,057,"Illinois","Fulton County",4,30,402,242,160
050,17,057,"Illinois","Fulton County",4,31,359,211,148
050,17,057,"Illinois","Fulton County",4,32,402,222,180
050,17,057,"Illinois","Fulton County",4,33,401,218,183
050,17,057,"Illinois","Fulton County",4,34,371,198,173
050,17,057,"Illinois","Fulton County",4,35,388,209,179
050,17,057,"Illinois","Fulton County",4,36,404,231,173
050,17,057,"Illinois","Fulton County",4,37,421,234,187
050,17,057,"Illinois","Fulton County",4,38,390,221,169
050,17,057,"Illinois","Fulton County",4,39,423,239,184
050,17,057,"Illinois","Fulton County",4,40,410,233,177
050,17,057,"Illinois","Fulton County",4,41,408,234,174
050,17,057,"Illinois","Fulton County",4,42,454,242,212
050,17,057,"Illinois","Fulton County",4,43,465,254,211
050,17,057,"Illinois","Fulton County",4,44,443,246,197
050,17,057,"Illinois","Fulton County",4,45,436,232,204
050,17,057,"Illinois","Fulton County",4,46,417,225,192
050,17,057,"Illinois","Fulton County",4,47,404,219,185
050,17,057,"Illinois","Fulton County",4,48,405,225,180
050,17,057,"Illinois","Fulton County",4,49,413,231,182
050,17,057,"Illinois","Fulton County",4,50,430,242,188
050,17,057,"Illinois","Fulton County",4,51,464,266,198
050,17,057,"Illinois","Fulton County",4,52,440,251,189
050,17,057,"Illinois","Fulton County",4,53,419,231,188
050,17,057,"Illinois","Fulton County",4,54,422,218,204
050,17,057,"Illinois","Fulton County",4,55,426,218,208
050,17,057,"Illinois","Fulton County",4,56,436,222,214
050,17,057,"Illinois","Fulton County",4,57,457,232,225
050,17,057,"Illinois","Fulton County",4,58,446,227,219
050,17,057,"Illinois","Fulton County",4,59,459,234,225
050,17,057,"Illinois","Fulton County",4,60,484,253,231
050,17,057,"Illinois","Fulton County",4,61,493,254,239
050,17,057,"Illinois","Fulton County",4,62,486,242,244
050,17,057,"Illinois","Fulton County",4,63,437,212,225
050,17,057,"Illinois","Fulton County",4,64,452,215,237
050,17,057,"Illinois","Fulton County",4,65,462,217,245
050,17,057,"Illinois","Fulton County",4,66,470,226,244
050,17,057,"Illinois","Fulton County",4,67,451,221,230
050,17,057,"Illinois","Fulton County",4,68,437,208,229
050,17,057,"Illinois","Fulton County",4,69,429,203,226
050,17,057,"Illinois","Fulton County",4,70,428,202,226
050,17,057,"Illinois","Fulton County",4,71,412,200,212
050,17,057,"Illinois","Fulton County",4,72,363,181,182
050,17,057,"Illinois","Fulton County",4,73,359,175,184
050,17,057,"Illinois","Fulton County",4,74,351,168,183
050,17,057,"Illinois","Fulton County",4,75,353,164,189
050,17,057,"Illinois","Fulton County",4,76,233,108,125
050,17,057,"Illinois","Fulton County",4,77,239,112,127
050,17,057,"Illinois","Fulton County",4,78,228,98,130
050,17,057,"Illinois","Fulton County",4,79,238,104,134
050,17,057,"Illinois","Fulton County",4,80,211,99,112
050,17,057,"Illinois","Fulton County",4,81,184,84,100
050,17,057,"Illinois","Fulton County",4,82,157,65,92
050,17,057,"Illinois","Fulton County",4,83,156,65,91
050,17,057,"Illinois","Fulton County",4,84,144,65,79
050,17,057,"Illinois","Fulton County",4,85,733,281,452
050,17,057,"Illinois","Fulton County",5,0,255,132,123
050,17,057,"Illinois","Fulton County",5,1,261,136,125
050,17,057,"Illinois","Fulton County",5,2,311,153,158
050,17,057,"Illinois","Fulton County",5,3,327,168,159
050,17,057,"Illinois","Fulton County",5,4,326,163,163
050,17,057,"Illinois","Fulton County",5,5,311,146,165
050,17,057,"Illinois","Fulton County",5,6,331,171,160
050,17,057,"Illinois","Fulton County",5,7,378,197,181
050,17,057,"Illinois","Fulton County",5,8,355,169,186
050,17,057,"Illinois","Fulton County",5,9,359,182,177
050,17,057,"Illinois","Fulton County",5,10,356,183,173
050,17,057,"Illinois","Fulton County",5,11,356,191,165
050,17,057,"Illinois","Fulton County",5,12,385,197,188
050,17,057,"Illinois","Fulton County",5,13,393,202,191
050,17,057,"Illinois","Fulton County",5,14,387,197,190
050,17,057,"Illinois","Fulton County",5,15,388,194,194
050,17,057,"Illinois","Fulton County",5,16,418,199,219
050,17,057,"Illinois","Fulton County",5,17,395,201,194
050,17,057,"Illinois","Fulton County",5,18,352,202,150
050,17,057,"Illinois","Fulton County",5,19,281,168,113
050,17,057,"Illinois","Fulton County",5,20,325,185,140
050,17,057,"Illinois","Fulton County",5,21,363,214,149
050,17,057,"Illinois","Fulton County",5,22,377,221,156
050,17,057,"Illinois","Fulton County",5,23,400,233,167
050,17,057,"Illinois","Fulton County",5,24,351,196,155
050,17,057,"Illinois","Fulton County",5,25,374,215,159
050,17,057,"Illinois","Fulton County",5,26,393,218,175
050,17,057,"Illinois","Fulton County",5,27,372,241,131
050,17,057,"Illinois","Fulton County",5,28,394,211,183
050,17,057,"Illinois","Fulton County",5,29,382,226,156
050,17,057,"Illinois","Fulton County",5,30,409,236,173
050,17,057,"Illinois","Fulton County",5,31,396,238,158
050,17,057,"Illinois","Fulton County",5,32,367,213,154
050,17,057,"Illinois","Fulton County",5,33,406,226,180
050,17,057,"Illinois","Fulton County",5,34,397,215,182
050,17,057,"Illinois","Fulton County",5,35,363,190,173
050,17,057,"Illinois","Fulton County",5,36,379,199,180
050,17,057,"Illinois","Fulton County",5,37,413,242,171
050,17,057,"Illinois","Fulton County",5,38,410,231,179
050,17,057,"Illinois","Fulton County",5,39,385,211,174
050,17,057,"Illinois","Fulton County",5,40,420,239,181
050,17,057,"Illinois","Fulton County",5,41,412,240,172
050,17,057,"Illinois","Fulton County",5,42,402,221,181
050,17,057,"Illinois","Fulton County",5,43,461,254,207
050,17,057,"Illinois","Fulton County",5,44,463,250,213
050,17,057,"Illinois","Fulton County",5,45,443,242,201
050,17,057,"Illinois","Fulton County",5,46,426,231,195
050,17,057,"Illinois","Fulton County",5,47,417,224,193
050,17,057,"Illinois","Fulton County",5,48,404,220,184
050,17,057,"Illinois","Fulton County",5,49,405,225,180
050,17,057,"Illinois","Fulton County",5,50,393,210,183
050,17,057,"Illinois","Fulton County",5,51,432,245,187
050,17,057,"Illinois","Fulton County",5,52,469,265,204
050,17,057,"Illinois","Fulton County",5,53,435,252,183
050,17,057,"Illinois","Fulton County",5,54,395,209,186
050,17,057,"Illinois","Fulton County",5,55,425,220,205
050,17,057,"Illinois","Fulton County",5,56,427,222,205
050,17,057,"Illinois","Fulton County",5,57,427,218,209
050,17,057,"Illinois","Fulton County",5,58,444,227,217
050,17,057,"Illinois","Fulton County",5,59,452,231,221
050,17,057,"Illinois","Fulton County",5,60,437,220,217
050,17,057,"Illinois","Fulton County",5,61,481,246,235
050,17,057,"Illinois","Fulton County",5,62,489,250,239
050,17,057,"Illinois","Fulton County",5,63,468,230,238
050,17,057,"Illinois","Fulton County",5,64,434,213,221
050,17,057,"Illinois","Fulton County",5,65,438,204,234
050,17,057,"Illinois","Fulton County",5,66,460,220,240
050,17,057,"Illinois","Fulton County",5,67,452,219,233
050,17,057,"Illinois","Fulton County",5,68,435,211,224
050,17,057,"Illinois","Fulton County",5,69,425,202,223
050,17,057,"Illinois","Fulton County",5,70,422,199,223
050,17,057,"Illinois","Fulton County",5,71,413,189,224
050,17,057,"Illinois","Fulton County",5,72,406,198,208
050,17,057,"Illinois","Fulton County",5,73,355,180,175
050,17,057,"Illinois","Fulton County",5,74,344,168,176
050,17,057,"Illinois","Fulton County",5,75,333,153,180
050,17,057,"Illinois","Fulton County",5,76,331,150,181
050,17,057,"Illinois","Fulton County",5,77,223,100,123
050,17,057,"Illinois","Fulton County",5,78,226,106,120
050,17,057,"Illinois","Fulton County",5,79,212,90,122
050,17,057,"Illinois","Fulton County",5,80,227,102,125
050,17,057,"Illinois","Fulton County",5,81,199,92,107
050,17,057,"Illinois","Fulton County",5,82,170,70,100
050,17,057,"Illinois","Fulton County",5,83,139,59,80
050,17,057,"Illinois","Fulton County",5,84,143,63,80
050,17,057,"Illinois","Fulton County",5,85,746,299,447
050,17,059,"Illinois","Gallatin County",1,0,33,17,16
050,17,059,"Illinois","Gallatin County",1,1,38,15,23
050,17,059,"Illinois","Gallatin County",1,2,43,17,26
050,17,059,"Illinois","Gallatin County",1,3,48,26,22
050,17,059,"Illinois","Gallatin County",1,4,58,34,24
050,17,059,"Illinois","Gallatin County",1,5,53,29,24
050,17,059,"Illinois","Gallatin County",1,6,46,21,25
050,17,059,"Illinois","Gallatin County",1,7,54,24,30
050,17,059,"Illinois","Gallatin County",1,8,52,20,32
050,17,059,"Illinois","Gallatin County",1,9,61,26,35
050,17,059,"Illinois","Gallatin County",1,10,63,35,28
050,17,059,"Illinois","Gallatin County",1,11,47,22,25
050,17,059,"Illinois","Gallatin County",1,12,68,35,33
050,17,059,"Illinois","Gallatin County",1,13,67,36,31
050,17,059,"Illinois","Gallatin County",1,14,55,30,25
050,17,059,"Illinois","Gallatin County",1,15,55,28,27
050,17,059,"Illinois","Gallatin County",1,16,72,35,37
050,17,059,"Illinois","Gallatin County",1,17,66,30,36
050,17,059,"Illinois","Gallatin County",1,18,49,30,19
050,17,059,"Illinois","Gallatin County",1,19,45,24,21
050,17,059,"Illinois","Gallatin County",1,20,43,17,26
050,17,059,"Illinois","Gallatin County",1,21,32,15,17
050,17,059,"Illinois","Gallatin County",1,22,38,20,18
050,17,059,"Illinois","Gallatin County",1,23,45,25,20
050,17,059,"Illinois","Gallatin County",1,24,40,20,20
050,17,059,"Illinois","Gallatin County",1,25,54,22,32
050,17,059,"Illinois","Gallatin County",1,26,60,25,35
050,17,059,"Illinois","Gallatin County",1,27,52,29,23
050,17,059,"Illinois","Gallatin County",1,28,49,29,20
050,17,059,"Illinois","Gallatin County",1,29,54,31,23
050,17,059,"Illinois","Gallatin County",1,30,51,23,28
050,17,059,"Illinois","Gallatin County",1,31,44,22,22
050,17,059,"Illinois","Gallatin County",1,32,46,27,19
050,17,059,"Illinois","Gallatin County",1,33,47,21,26
050,17,059,"Illinois","Gallatin County",1,34,56,29,27
050,17,059,"Illinois","Gallatin County",1,35,54,32,22
050,17,059,"Illinois","Gallatin County",1,36,50,22,28
050,17,059,"Illinois","Gallatin County",1,37,60,32,28
050,17,059,"Illinois","Gallatin County",1,38,59,30,29
050,17,059,"Illinois","Gallatin County",1,39,56,28,28
050,17,059,"Illinois","Gallatin County",1,40,60,31,29
050,17,059,"Illinois","Gallatin County",1,41,57,28,29
050,17,059,"Illinois","Gallatin County",1,42,53,24,29
050,17,059,"Illinois","Gallatin County",1,43,55,23,32
050,17,059,"Illinois","Gallatin County",1,44,66,32,34
050,17,059,"Illinois","Gallatin County",1,45,68,41,27
050,17,059,"Illinois","Gallatin County",1,46,62,33,29
050,17,059,"Illinois","Gallatin County",1,47,66,34,32
050,17,059,"Illinois","Gallatin County",1,48,65,35,30
050,17,059,"Illinois","Gallatin County",1,49,72,41,31
050,17,059,"Illinois","Gallatin County",1,50,63,32,31
050,17,059,"Illinois","Gallatin County",1,51,63,31,32
050,17,059,"Illinois","Gallatin County",1,52,50,23,27
050,17,059,"Illinois","Gallatin County",1,53,61,37,24
050,17,059,"Illinois","Gallatin County",1,54,71,38,33
050,17,059,"Illinois","Gallatin County",1,55,65,32,33
050,17,059,"Illinois","Gallatin County",1,56,76,48,28
050,17,059,"Illinois","Gallatin County",1,57,84,47,37
050,17,059,"Illinois","Gallatin County",1,58,79,39,40
050,17,059,"Illinois","Gallatin County",1,59,73,30,43
050,17,059,"Illinois","Gallatin County",1,60,70,30,40
050,17,059,"Illinois","Gallatin County",1,61,66,29,37
050,17,059,"Illinois","Gallatin County",1,62,65,32,33
050,17,059,"Illinois","Gallatin County",1,63,67,40,27
050,17,059,"Illinois","Gallatin County",1,64,64,34,30
050,17,059,"Illinois","Gallatin County",1,65,61,32,29
050,17,059,"Illinois","Gallatin County",1,66,71,32,39
050,17,059,"Illinois","Gallatin County",1,67,67,35,32
050,17,059,"Illinois","Gallatin County",1,68,74,32,42
050,17,059,"Illinois","Gallatin County",1,69,58,20,38
050,17,059,"Illinois","Gallatin County",1,70,71,28,43
050,17,059,"Illinois","Gallatin County",1,71,74,36,38
050,17,059,"Illinois","Gallatin County",1,72,84,45,39
050,17,059,"Illinois","Gallatin County",1,73,76,38,38
050,17,059,"Illinois","Gallatin County",1,74,43,19,24
050,17,059,"Illinois","Gallatin County",1,75,56,24,32
050,17,059,"Illinois","Gallatin County",1,76,53,26,27
050,17,059,"Illinois","Gallatin County",1,77,54,29,25
050,17,059,"Illinois","Gallatin County",1,78,52,25,27
050,17,059,"Illinois","Gallatin County",1,79,45,22,23
050,17,059,"Illinois","Gallatin County",1,80,38,15,23
050,17,059,"Illinois","Gallatin County",1,81,38,15,23
050,17,059,"Illinois","Gallatin County",1,82,36,13,23
050,17,059,"Illinois","Gallatin County",1,83,34,14,20
050,17,059,"Illinois","Gallatin County",1,84,27,10,17
050,17,059,"Illinois","Gallatin County",1,85,128,46,82
050,17,059,"Illinois","Gallatin County",2,0,36,14,22
050,17,059,"Illinois","Gallatin County",2,1,37,15,22
050,17,059,"Illinois","Gallatin County",2,2,43,17,26
050,17,059,"Illinois","Gallatin County",2,3,46,24,22
050,17,059,"Illinois","Gallatin County",2,4,56,32,24
050,17,059,"Illinois","Gallatin County",2,5,55,30,25
050,17,059,"Illinois","Gallatin County",2,6,49,24,25
050,17,059,"Illinois","Gallatin County",2,7,53,24,29
050,17,059,"Illinois","Gallatin County",2,8,52,21,31
050,17,059,"Illinois","Gallatin County",2,9,61,26,35
050,17,059,"Illinois","Gallatin County",2,10,62,32,30
050,17,059,"Illinois","Gallatin County",2,11,52,26,26
050,17,059,"Illinois","Gallatin County",2,12,63,32,31
050,17,059,"Illinois","Gallatin County",2,13,66,35,31
050,17,059,"Illinois","Gallatin County",2,14,58,32,26
050,17,059,"Illinois","Gallatin County",2,15,54,28,26
050,17,059,"Illinois","Gallatin County",2,16,68,34,34
050,17,059,"Illinois","Gallatin County",2,17,66,31,35
050,17,059,"Illinois","Gallatin County",2,18,51,29,22
050,17,059,"Illinois","Gallatin County",2,19,45,25,20
050,17,059,"Illinois","Gallatin County",2,20,44,19,25
050,17,059,"Illinois","Gallatin County",2,21,35,15,20
050,17,059,"Illinois","Gallatin County",2,22,37,19,18
050,17,059,"Illinois","Gallatin County",2,23,43,23,20
050,17,059,"Illinois","Gallatin County",2,24,42,21,21
050,17,059,"Illinois","Gallatin County",2,25,52,22,30
050,17,059,"Illinois","Gallatin County",2,26,60,25,35
050,17,059,"Illinois","Gallatin County",2,27,54,28,26
050,17,059,"Illinois","Gallatin County",2,28,51,30,21
050,17,059,"Illinois","Gallatin County",2,29,52,30,22
050,17,059,"Illinois","Gallatin County",2,30,51,25,26
050,17,059,"Illinois","Gallatin County",2,31,46,23,23
050,17,059,"Illinois","Gallatin County",2,32,45,25,20
050,17,059,"Illinois","Gallatin County",2,33,47,23,24
050,17,059,"Illinois","Gallatin County",2,34,53,27,26
050,17,059,"Illinois","Gallatin County",2,35,54,31,23
050,17,059,"Illinois","Gallatin County",2,36,51,25,26
050,17,059,"Illinois","Gallatin County",2,37,60,31,29
050,17,059,"Illinois","Gallatin County",2,38,60,30,30
050,17,059,"Illinois","Gallatin County",2,39,56,28,28
050,17,059,"Illinois","Gallatin County",2,40,60,31,29
050,17,059,"Illinois","Gallatin County",2,41,57,28,29
050,17,059,"Illinois","Gallatin County",2,42,53,25,28
050,17,059,"Illinois","Gallatin County",2,43,54,22,32
050,17,059,"Illinois","Gallatin County",2,44,63,30,33
050,17,059,"Illinois","Gallatin County",2,45,68,39,29
050,17,059,"Illinois","Gallatin County",2,46,63,35,28
050,17,059,"Illinois","Gallatin County",2,47,64,33,31
050,17,059,"Illinois","Gallatin County",2,48,64,34,30
050,17,059,"Illinois","Gallatin County",2,49,70,39,31
050,17,059,"Illinois","Gallatin County",2,50,64,33,31
050,17,059,"Illinois","Gallatin County",2,51,63,31,32
050,17,059,"Illinois","Gallatin County",2,52,53,25,28
050,17,059,"Illinois","Gallatin County",2,53,59,34,25
050,17,059,"Illinois","Gallatin County",2,54,65,36,29
050,17,059,"Illinois","Gallatin County",2,55,66,33,33
050,17,059,"Illinois","Gallatin County",2,56,74,45,29
050,17,059,"Illinois","Gallatin County",2,57,81,46,35
050,17,059,"Illinois","Gallatin County",2,58,82,42,40
050,17,059,"Illinois","Gallatin County",2,59,74,32,42
050,17,059,"Illinois","Gallatin County",2,60,71,30,41
050,17,059,"Illinois","Gallatin County",2,61,66,29,37
050,17,059,"Illinois","Gallatin County",2,62,65,31,34
050,17,059,"Illinois","Gallatin County",2,63,66,38,28
050,17,059,"Illinois","Gallatin County",2,64,64,35,29
050,17,059,"Illinois","Gallatin County",2,65,61,32,29
050,17,059,"Illinois","Gallatin County",2,66,69,32,37
050,17,059,"Illinois","Gallatin County",2,67,67,34,33
050,17,059,"Illinois","Gallatin County",2,68,71,32,39
050,17,059,"Illinois","Gallatin County",2,69,62,23,39
050,17,059,"Illinois","Gallatin County",2,70,67,25,42
050,17,059,"Illinois","Gallatin County",2,71,73,33,40
050,17,059,"Illinois","Gallatin County",2,72,80,42,38
050,17,059,"Illinois","Gallatin County",2,73,82,42,40
050,17,059,"Illinois","Gallatin County",2,74,46,21,25
050,17,059,"Illinois","Gallatin County",2,75,53,23,30
050,17,059,"Illinois","Gallatin County",2,76,53,25,28
050,17,059,"Illinois","Gallatin County",2,77,55,29,26
050,17,059,"Illinois","Gallatin County",2,78,51,26,25
050,17,059,"Illinois","Gallatin County",2,79,45,21,24
050,17,059,"Illinois","Gallatin County",2,80,39,16,23
050,17,059,"Illinois","Gallatin County",2,81,38,15,23
050,17,059,"Illinois","Gallatin County",2,82,36,13,23
050,17,059,"Illinois","Gallatin County",2,83,33,13,20
050,17,059,"Illinois","Gallatin County",2,84,29,11,18
050,17,059,"Illinois","Gallatin County",2,85,130,47,83
050,17,059,"Illinois","Gallatin County",3,0,39,23,16
050,17,059,"Illinois","Gallatin County",3,1,29,13,16
050,17,059,"Illinois","Gallatin County",3,2,39,16,23
050,17,059,"Illinois","Gallatin County",3,3,50,18,32
050,17,059,"Illinois","Gallatin County",3,4,48,25,23
050,17,059,"Illinois","Gallatin County",3,5,58,32,26
050,17,059,"Illinois","Gallatin County",3,6,54,30,24
050,17,059,"Illinois","Gallatin County",3,7,53,26,27
050,17,059,"Illinois","Gallatin County",3,8,50,23,27
050,17,059,"Illinois","Gallatin County",3,9,51,20,31
050,17,059,"Illinois","Gallatin County",3,10,63,30,33
050,17,059,"Illinois","Gallatin County",3,11,62,32,30
050,17,059,"Illinois","Gallatin County",3,12,50,25,25
050,17,059,"Illinois","Gallatin County",3,13,62,30,32
050,17,059,"Illinois","Gallatin County",3,14,61,31,30
050,17,059,"Illinois","Gallatin County",3,15,61,31,30
050,17,059,"Illinois","Gallatin County",3,16,60,28,32
050,17,059,"Illinois","Gallatin County",3,17,64,32,32
050,17,059,"Illinois","Gallatin County",3,18,58,30,28
050,17,059,"Illinois","Gallatin County",3,19,41,22,19
050,17,059,"Illinois","Gallatin County",3,20,46,27,19
050,17,059,"Illinois","Gallatin County",3,21,39,17,22
050,17,059,"Illinois","Gallatin County",3,22,37,19,18
050,17,059,"Illinois","Gallatin County",3,23,36,18,18
050,17,059,"Illinois","Gallatin County",3,24,45,24,21
050,17,059,"Illinois","Gallatin County",3,25,39,22,17
050,17,059,"Illinois","Gallatin County",3,26,52,22,30
050,17,059,"Illinois","Gallatin County",3,27,55,26,29
050,17,059,"Illinois","Gallatin County",3,28,51,27,24
050,17,059,"Illinois","Gallatin County",3,29,54,28,26
050,17,059,"Illinois","Gallatin County",3,30,51,31,20
050,17,059,"Illinois","Gallatin County",3,31,53,28,25
050,17,059,"Illinois","Gallatin County",3,32,48,25,23
050,17,059,"Illinois","Gallatin County",3,33,42,22,20
050,17,059,"Illinois","Gallatin County",3,34,48,25,23
050,17,059,"Illinois","Gallatin County",3,35,54,24,30
050,17,059,"Illinois","Gallatin County",3,36,54,30,24
050,17,059,"Illinois","Gallatin County",3,37,54,26,28
050,17,059,"Illinois","Gallatin County",3,38,57,31,26
050,17,059,"Illinois","Gallatin County",3,39,59,29,30
050,17,059,"Illinois","Gallatin County",3,40,55,28,27
050,17,059,"Illinois","Gallatin County",3,41,61,31,30
050,17,059,"Illinois","Gallatin County",3,42,57,28,29
050,17,059,"Illinois","Gallatin County",3,43,49,24,25
050,17,059,"Illinois","Gallatin County",3,44,60,27,33
050,17,059,"Illinois","Gallatin County",3,45,57,28,29
050,17,059,"Illinois","Gallatin County",3,46,68,39,29
050,17,059,"Illinois","Gallatin County",3,47,69,38,31
050,17,059,"Illinois","Gallatin County",3,48,65,31,34
050,17,059,"Illinois","Gallatin County",3,49,60,30,30
050,17,059,"Illinois","Gallatin County",3,50,71,39,32
050,17,059,"Illinois","Gallatin County",3,51,64,33,31
050,17,059,"Illinois","Gallatin County",3,52,59,31,28
050,17,059,"Illinois","Gallatin County",3,53,55,26,29
050,17,059,"Illinois","Gallatin County",3,54,56,32,24
050,17,059,"Illinois","Gallatin County",3,55,62,33,29
050,17,059,"Illinois","Gallatin County",3,56,65,31,34
050,17,059,"Illinois","Gallatin County",3,57,72,42,30
050,17,059,"Illinois","Gallatin County",3,58,85,49,36
050,17,059,"Illinois","Gallatin County",3,59,81,42,39
050,17,059,"Illinois","Gallatin County",3,60,77,32,45
050,17,059,"Illinois","Gallatin County",3,61,77,34,43
050,17,059,"Illinois","Gallatin County",3,62,68,28,40
050,17,059,"Illinois","Gallatin County",3,63,62,29,33
050,17,059,"Illinois","Gallatin County",3,64,65,38,27
050,17,059,"Illinois","Gallatin County",3,65,66,37,29
050,17,059,"Illinois","Gallatin County",3,66,62,33,29
050,17,059,"Illinois","Gallatin County",3,67,68,33,35
050,17,059,"Illinois","Gallatin County",3,68,65,32,33
050,17,059,"Illinois","Gallatin County",3,69,72,32,40
050,17,059,"Illinois","Gallatin County",3,70,65,23,42
050,17,059,"Illinois","Gallatin County",3,71,64,22,42
050,17,059,"Illinois","Gallatin County",3,72,73,33,40
050,17,059,"Illinois","Gallatin County",3,73,81,42,39
050,17,059,"Illinois","Gallatin County",3,74,79,42,37
050,17,059,"Illinois","Gallatin County",3,75,44,20,24
050,17,059,"Illinois","Gallatin County",3,76,52,23,29
050,17,059,"Illinois","Gallatin County",3,77,52,25,27
050,17,059,"Illinois","Gallatin County",3,78,51,26,25
050,17,059,"Illinois","Gallatin County",3,79,46,23,23
050,17,059,"Illinois","Gallatin County",3,80,41,18,23
050,17,059,"Illinois","Gallatin County",3,81,38,15,23
050,17,059,"Illinois","Gallatin County",3,82,36,13,23
050,17,059,"Illinois","Gallatin County",3,83,33,12,21
050,17,059,"Illinois","Gallatin County",3,84,31,12,19
050,17,059,"Illinois","Gallatin County",3,85,129,43,86
050,17,059,"Illinois","Gallatin County",4,0,33,20,13
050,17,059,"Illinois","Gallatin County",4,1,37,25,12
050,17,059,"Illinois","Gallatin County",4,2,30,13,17
050,17,059,"Illinois","Gallatin County",4,3,40,16,24
050,17,059,"Illinois","Gallatin County",4,4,49,17,32
050,17,059,"Illinois","Gallatin County",4,5,45,24,21
050,17,059,"Illinois","Gallatin County",4,6,61,30,31
050,17,059,"Illinois","Gallatin County",4,7,53,28,25
050,17,059,"Illinois","Gallatin County",4,8,59,28,31
050,17,059,"Illinois","Gallatin County",4,9,50,25,25
050,17,059,"Illinois","Gallatin County",4,10,50,18,32
050,17,059,"Illinois","Gallatin County",4,11,70,32,38
050,17,059,"Illinois","Gallatin County",4,12,58,28,30
050,17,059,"Illinois","Gallatin County",4,13,46,25,21
050,17,059,"Illinois","Gallatin County",4,14,64,31,33
050,17,059,"Illinois","Gallatin County",4,15,64,33,31
050,17,059,"Illinois","Gallatin County",4,16,61,30,31
050,17,059,"Illinois","Gallatin County",4,17,57,28,29
050,17,059,"Illinois","Gallatin County",4,18,53,27,26
050,17,059,"Illinois","Gallatin County",4,19,38,20,18
050,17,059,"Illinois","Gallatin County",4,20,42,22,20
050,17,059,"Illinois","Gallatin County",4,21,48,28,20
050,17,059,"Illinois","Gallatin County",4,22,42,20,22
050,17,059,"Illinois","Gallatin County",4,23,40,16,24
050,17,059,"Illinois","Gallatin County",4,24,45,21,24
050,17,059,"Illinois","Gallatin County",4,25,47,28,19
050,17,059,"Illinois","Gallatin County",4,26,42,26,16
050,17,059,"Illinois","Gallatin County",4,27,53,23,30
050,17,059,"Illinois","Gallatin County",4,28,55,27,28
050,17,059,"Illinois","Gallatin County",4,29,46,27,19
050,17,059,"Illinois","Gallatin County",4,30,54,26,28
050,17,059,"Illinois","Gallatin County",4,31,49,29,20
050,17,059,"Illinois","Gallatin County",4,32,46,25,21
050,17,059,"Illinois","Gallatin County",4,33,48,25,23
050,17,059,"Illinois","Gallatin County",4,34,48,26,22
050,17,059,"Illinois","Gallatin County",4,35,47,25,22
050,17,059,"Illinois","Gallatin County",4,36,49,21,28
050,17,059,"Illinois","Gallatin County",4,37,53,31,22
050,17,059,"Illinois","Gallatin County",4,38,58,28,30
050,17,059,"Illinois","Gallatin County",4,39,59,32,27
050,17,059,"Illinois","Gallatin County",4,40,58,26,32
050,17,059,"Illinois","Gallatin County",4,41,52,25,27
050,17,059,"Illinois","Gallatin County",4,42,57,30,27
050,17,059,"Illinois","Gallatin County",4,43,60,30,30
050,17,059,"Illinois","Gallatin County",4,44,50,24,26
050,17,059,"Illinois","Gallatin County",4,45,63,28,35
050,17,059,"Illinois","Gallatin County",4,46,60,32,28
050,17,059,"Illinois","Gallatin County",4,47,66,37,29
050,17,059,"Illinois","Gallatin County",4,48,68,38,30
050,17,059,"Illinois","Gallatin County",4,49,62,29,33
050,17,059,"Illinois","Gallatin County",4,50,59,30,29
050,17,059,"Illinois","Gallatin County",4,51,68,39,29
050,17,059,"Illinois","Gallatin County",4,52,64,33,31
050,17,059,"Illinois","Gallatin County",4,53,58,31,27
050,17,059,"Illinois","Gallatin County",4,54,55,27,28
050,17,059,"Illinois","Gallatin County",4,55,57,32,25
050,17,059,"Illinois","Gallatin County",4,56,63,34,29
050,17,059,"Illinois","Gallatin County",4,57,62,29,33
050,17,059,"Illinois","Gallatin County",4,58,75,40,35
050,17,059,"Illinois","Gallatin County",4,59,77,45,32
050,17,059,"Illinois","Gallatin County",4,60,79,41,38
050,17,059,"Illinois","Gallatin County",4,61,79,33,46
050,17,059,"Illinois","Gallatin County",4,62,82,36,46
050,17,059,"Illinois","Gallatin County",4,63,65,28,37
050,17,059,"Illinois","Gallatin County",4,64,63,31,32
050,17,059,"Illinois","Gallatin County",4,65,62,36,26
050,17,059,"Illinois","Gallatin County",4,66,63,35,28
050,17,059,"Illinois","Gallatin County",4,67,60,34,26
050,17,059,"Illinois","Gallatin County",4,68,66,31,35
050,17,059,"Illinois","Gallatin County",4,69,64,32,32
050,17,059,"Illinois","Gallatin County",4,70,69,30,39
050,17,059,"Illinois","Gallatin County",4,71,60,19,41
050,17,059,"Illinois","Gallatin County",4,72,64,23,41
050,17,059,"Illinois","Gallatin County",4,73,71,32,39
050,17,059,"Illinois","Gallatin County",4,74,82,43,39
050,17,059,"Illinois","Gallatin County",4,75,74,42,32
050,17,059,"Illinois","Gallatin County",4,76,40,18,22
050,17,059,"Illinois","Gallatin County",4,77,50,22,28
050,17,059,"Illinois","Gallatin County",4,78,49,22,27
050,17,059,"Illinois","Gallatin County",4,79,44,24,20
050,17,059,"Illinois","Gallatin County",4,80,42,21,21
050,17,059,"Illinois","Gallatin County",4,81,37,15,22
050,17,059,"Illinois","Gallatin County",4,82,35,12,23
050,17,059,"Illinois","Gallatin County",4,83,35,13,22
050,17,059,"Illinois","Gallatin County",4,84,31,11,20
050,17,059,"Illinois","Gallatin County",4,85,134,40,94
050,17,059,"Illinois","Gallatin County",5,0,23,12,11
050,17,059,"Illinois","Gallatin County",5,1,38,22,16
050,17,059,"Illinois","Gallatin County",5,2,37,25,12
050,17,059,"Illinois","Gallatin County",5,3,29,13,16
050,17,059,"Illinois","Gallatin County",5,4,39,19,20
050,17,059,"Illinois","Gallatin County",5,5,43,20,23
050,17,059,"Illinois","Gallatin County",5,6,45,25,20
050,17,059,"Illinois","Gallatin County",5,7,56,31,25
050,17,059,"Illinois","Gallatin County",5,8,51,26,25
050,17,059,"Illinois","Gallatin County",5,9,57,28,29
050,17,059,"Illinois","Gallatin County",5,10,53,23,30
050,17,059,"Illinois","Gallatin County",5,11,53,21,32
050,17,059,"Illinois","Gallatin County",5,12,68,33,35
050,17,059,"Illinois","Gallatin County",5,13,58,28,30
050,17,059,"Illinois","Gallatin County",5,14,47,23,24
050,17,059,"Illinois","Gallatin County",5,15,65,32,33
050,17,059,"Illinois","Gallatin County",5,16,62,32,30
050,17,059,"Illinois","Gallatin County",5,17,55,26,29
050,17,059,"Illinois","Gallatin County",5,18,50,25,25
050,17,059,"Illinois","Gallatin County",5,19,39,20,19
050,17,059,"Illinois","Gallatin County",5,20,41,21,20
050,17,059,"Illinois","Gallatin County",5,21,39,18,21
050,17,059,"Illinois","Gallatin County",5,22,48,30,18
050,17,059,"Illinois","Gallatin County",5,23,39,17,22
050,17,059,"Illinois","Gallatin County",5,24,35,15,20
050,17,059,"Illinois","Gallatin County",5,25,40,20,20
050,17,059,"Illinois","Gallatin County",5,26,39,22,17
050,17,059,"Illinois","Gallatin County",5,27,38,22,16
050,17,059,"Illinois","Gallatin County",5,28,53,22,31
050,17,059,"Illinois","Gallatin County",5,29,54,27,27
050,17,059,"Illinois","Gallatin County",5,30,43,26,17
050,17,059,"Illinois","Gallatin County",5,31,56,27,29
050,17,059,"Illinois","Gallatin County",5,32,41,23,18
050,17,059,"Illinois","Gallatin County",5,33,44,24,20
050,17,059,"Illinois","Gallatin County",5,34,47,25,22
050,17,059,"Illinois","Gallatin County",5,35,47,26,21
050,17,059,"Illinois","Gallatin County",5,36,46,24,22
050,17,059,"Illinois","Gallatin County",5,37,49,21,28
050,17,059,"Illinois","Gallatin County",5,38,55,32,23
050,17,059,"Illinois","Gallatin County",5,39,57,28,29
050,17,059,"Illinois","Gallatin County",5,40,62,33,29
050,17,059,"Illinois","Gallatin County",5,41,58,26,32
050,17,059,"Illinois","Gallatin County",5,42,52,26,26
050,17,059,"Illinois","Gallatin County",5,43,56,30,26
050,17,059,"Illinois","Gallatin County",5,44,54,26,28
050,17,059,"Illinois","Gallatin County",5,45,50,24,26
050,17,059,"Illinois","Gallatin County",5,46,59,26,33
050,17,059,"Illinois","Gallatin County",5,47,58,31,27
050,17,059,"Illinois","Gallatin County",5,48,62,34,28
050,17,059,"Illinois","Gallatin County",5,49,63,36,27
050,17,059,"Illinois","Gallatin County",5,50,60,27,33
050,17,059,"Illinois","Gallatin County",5,51,55,28,27
050,17,059,"Illinois","Gallatin County",5,52,67,39,28
050,17,059,"Illinois","Gallatin County",5,53,64,33,31
050,17,059,"Illinois","Gallatin County",5,54,56,29,27
050,17,059,"Illinois","Gallatin County",5,55,55,27,28
050,17,059,"Illinois","Gallatin County",5,56,57,32,25
050,17,059,"Illinois","Gallatin County",5,57,64,34,30
050,17,059,"Illinois","Gallatin County",5,58,60,27,33
050,17,059,"Illinois","Gallatin County",5,59,72,39,33
050,17,059,"Illinois","Gallatin County",5,60,73,43,30
050,17,059,"Illinois","Gallatin County",5,61,81,42,39
050,17,059,"Illinois","Gallatin County",5,62,80,33,47
050,17,059,"Illinois","Gallatin County",5,63,84,34,50
050,17,059,"Illinois","Gallatin County",5,64,65,29,36
050,17,059,"Illinois","Gallatin County",5,65,62,30,32
050,17,059,"Illinois","Gallatin County",5,66,60,35,25
050,17,059,"Illinois","Gallatin County",5,67,61,36,25
050,17,059,"Illinois","Gallatin County",5,68,56,32,24
050,17,059,"Illinois","Gallatin County",5,69,67,32,35
050,17,059,"Illinois","Gallatin County",5,70,62,31,31
050,17,059,"Illinois","Gallatin County",5,71,65,26,39
050,17,059,"Illinois","Gallatin County",5,72,61,18,43
050,17,059,"Illinois","Gallatin County",5,73,60,21,39
050,17,059,"Illinois","Gallatin County",5,74,66,28,38
050,17,059,"Illinois","Gallatin County",5,75,77,44,33
050,17,059,"Illinois","Gallatin County",5,76,71,40,31
050,17,059,"Illinois","Gallatin County",5,77,42,18,24
050,17,059,"Illinois","Gallatin County",5,78,47,19,28
050,17,059,"Illinois","Gallatin County",5,79,46,20,26
050,17,059,"Illinois","Gallatin County",5,80,40,21,19
050,17,059,"Illinois","Gallatin County",5,81,41,20,21
050,17,059,"Illinois","Gallatin County",5,82,34,14,20
050,17,059,"Illinois","Gallatin County",5,83,32,11,21
050,17,059,"Illinois","Gallatin County",5,84,33,12,21
050,17,059,"Illinois","Gallatin County",5,85,141,36,105
050,17,061,"Illinois","Greene County",1,0,125,64,61
050,17,061,"Illinois","Greene County",1,1,125,64,61
050,17,061,"Illinois","Greene County",1,2,136,67,69
050,17,061,"Illinois","Greene County",1,3,132,65,67
050,17,061,"Illinois","Greene County",1,4,133,69,64
050,17,061,"Illinois","Greene County",1,5,139,69,70
050,17,061,"Illinois","Greene County",1,6,144,79,65
050,17,061,"Illinois","Greene County",1,7,139,70,69
050,17,061,"Illinois","Greene County",1,8,149,80,69
050,17,061,"Illinois","Greene County",1,9,137,69,68
050,17,061,"Illinois","Greene County",1,10,150,74,76
050,17,061,"Illinois","Greene County",1,11,141,64,77
050,17,061,"Illinois","Greene County",1,12,159,76,83
050,17,061,"Illinois","Greene County",1,13,163,86,77
050,17,061,"Illinois","Greene County",1,14,156,80,76
050,17,061,"Illinois","Greene County",1,15,163,79,84
050,17,061,"Illinois","Greene County",1,16,178,91,87
050,17,061,"Illinois","Greene County",1,17,153,79,74
050,17,061,"Illinois","Greene County",1,18,130,65,65
050,17,061,"Illinois","Greene County",1,19,105,54,51
050,17,061,"Illinois","Greene County",1,20,105,58,47
050,17,061,"Illinois","Greene County",1,21,112,57,55
050,17,061,"Illinois","Greene County",1,22,125,63,62
050,17,061,"Illinois","Greene County",1,23,136,70,66
050,17,061,"Illinois","Greene County",1,24,134,68,66
050,17,061,"Illinois","Greene County",1,25,135,74,61
050,17,061,"Illinois","Greene County",1,26,134,71,63
050,17,061,"Illinois","Greene County",1,27,116,60,56
050,17,061,"Illinois","Greene County",1,28,141,77,64
050,17,061,"Illinois","Greene County",1,29,138,71,67
050,17,061,"Illinois","Greene County",1,30,135,67,68
050,17,061,"Illinois","Greene County",1,31,126,66,60
050,17,061,"Illinois","Greene County",1,32,113,60,53
050,17,061,"Illinois","Greene County",1,33,129,63,66
050,17,061,"Illinois","Greene County",1,34,132,70,62
050,17,061,"Illinois","Greene County",1,35,137,70,67
050,17,061,"Illinois","Greene County",1,36,141,75,66
050,17,061,"Illinois","Greene County",1,37,127,70,57
050,17,061,"Illinois","Greene County",1,38,125,67,58
050,17,061,"Illinois","Greene County",1,39,134,78,56
050,17,061,"Illinois","Greene County",1,40,143,74,69
050,17,061,"Illinois","Greene County",1,41,136,66,70
050,17,061,"Illinois","Greene County",1,42,153,82,71
050,17,061,"Illinois","Greene County",1,43,155,81,74
050,17,061,"Illinois","Greene County",1,44,145,72,73
050,17,061,"Illinois","Greene County",1,45,131,68,63
050,17,061,"Illinois","Greene County",1,46,136,73,63
050,17,061,"Illinois","Greene County",1,47,128,65,63
050,17,061,"Illinois","Greene County",1,48,145,83,62
050,17,061,"Illinois","Greene County",1,49,176,87,89
050,17,061,"Illinois","Greene County",1,50,160,76,84
050,17,061,"Illinois","Greene County",1,51,165,79,86
050,17,061,"Illinois","Greene County",1,52,159,81,78
050,17,061,"Illinois","Greene County",1,53,146,75,71
050,17,061,"Illinois","Greene County",1,54,166,79,87
050,17,061,"Illinois","Greene County",1,55,186,93,93
050,17,061,"Illinois","Greene County",1,56,201,103,98
050,17,061,"Illinois","Greene County",1,57,212,109,103
050,17,061,"Illinois","Greene County",1,58,194,100,94
050,17,061,"Illinois","Greene County",1,59,185,95,90
050,17,061,"Illinois","Greene County",1,60,175,80,95
050,17,061,"Illinois","Greene County",1,61,186,98,88
050,17,061,"Illinois","Greene County",1,62,192,98,94
050,17,061,"Illinois","Greene County",1,63,192,102,90
050,17,061,"Illinois","Greene County",1,64,179,96,83
050,17,061,"Illinois","Greene County",1,65,170,86,84
050,17,061,"Illinois","Greene County",1,66,160,72,88
050,17,061,"Illinois","Greene County",1,67,174,84,90
050,17,061,"Illinois","Greene County",1,68,145,76,69
050,17,061,"Illinois","Greene County",1,69,133,73,60
050,17,061,"Illinois","Greene County",1,70,128,67,61
050,17,061,"Illinois","Greene County",1,71,115,51,64
050,17,061,"Illinois","Greene County",1,72,128,58,70
050,17,061,"Illinois","Greene County",1,73,133,62,71
050,17,061,"Illinois","Greene County",1,74,91,41,50
050,17,061,"Illinois","Greene County",1,75,90,37,53
050,17,061,"Illinois","Greene County",1,76,100,51,49
050,17,061,"Illinois","Greene County",1,77,95,44,51
050,17,061,"Illinois","Greene County",1,78,90,37,53
050,17,061,"Illinois","Greene County",1,79,79,37,42
050,17,061,"Illinois","Greene County",1,80,75,33,42
050,17,061,"Illinois","Greene County",1,81,73,32,41
050,17,061,"Illinois","Greene County",1,82,68,27,41
050,17,061,"Illinois","Greene County",1,83,47,17,30
050,17,061,"Illinois","Greene County",1,84,51,20,31
050,17,061,"Illinois","Greene County",1,85,264,107,157
050,17,061,"Illinois","Greene County",2,0,118,62,56
050,17,061,"Illinois","Greene County",2,1,125,63,62
050,17,061,"Illinois","Greene County",2,2,132,65,67
050,17,061,"Illinois","Greene County",2,3,134,66,68
050,17,061,"Illinois","Greene County",2,4,134,69,65
050,17,061,"Illinois","Greene County",2,5,139,70,69
050,17,061,"Illinois","Greene County",2,6,139,74,65
050,17,061,"Illinois","Greene County",2,7,139,72,67
050,17,061,"Illinois","Greene County",2,8,145,76,69
050,17,061,"Illinois","Greene County",2,9,139,71,68
050,17,061,"Illinois","Greene County",2,10,145,71,74
050,17,061,"Illinois","Greene County",2,11,142,66,76
050,17,061,"Illinois","Greene County",2,12,156,75,81
050,17,061,"Illinois","Greene County",2,13,162,84,78
050,17,061,"Illinois","Greene County",2,14,156,80,76
050,17,061,"Illinois","Greene County",2,15,159,79,80
050,17,061,"Illinois","Greene County",2,16,172,87,85
050,17,061,"Illinois","Greene County",2,17,158,81,77
050,17,061,"Illinois","Greene County",2,18,128,65,63
050,17,061,"Illinois","Greene County",2,19,103,52,51
050,17,061,"Illinois","Greene County",2,20,108,58,50
050,17,061,"Illinois","Greene County",2,21,112,58,54
050,17,061,"Illinois","Greene County",2,22,124,62,62
050,17,061,"Illinois","Greene County",2,23,134,69,65
050,17,061,"Illinois","Greene County",2,24,135,69,66
050,17,061,"Illinois","Greene County",2,25,136,74,62
050,17,061,"Illinois","Greene County",2,26,130,69,61
050,17,061,"Illinois","Greene County",2,27,120,62,58
050,17,061,"Illinois","Greene County",2,28,134,73,61
050,17,061,"Illinois","Greene County",2,29,137,71,66
050,17,061,"Illinois","Greene County",2,30,138,69,69
050,17,061,"Illinois","Greene County",2,31,129,67,62
050,17,061,"Illinois","Greene County",2,32,117,62,55
050,17,061,"Illinois","Greene County",2,33,125,63,62
050,17,061,"Illinois","Greene County",2,34,129,66,63
050,17,061,"Illinois","Greene County",2,35,137,71,66
050,17,061,"Illinois","Greene County",2,36,137,72,65
050,17,061,"Illinois","Greene County",2,37,128,70,58
050,17,061,"Illinois","Greene County",2,38,124,67,57
050,17,061,"Illinois","Greene County",2,39,132,75,57
050,17,061,"Illinois","Greene County",2,40,140,76,64
050,17,061,"Illinois","Greene County",2,41,136,67,69
050,17,061,"Illinois","Greene County",2,42,148,78,70
050,17,061,"Illinois","Greene County",2,43,156,82,74
050,17,061,"Illinois","Greene County",2,44,144,73,71
050,17,061,"Illinois","Greene County",2,45,135,71,64
050,17,061,"Illinois","Greene County",2,46,134,71,63
050,17,061,"Illinois","Greene County",2,47,130,67,63
050,17,061,"Illinois","Greene County",2,48,141,78,63
050,17,061,"Illinois","Greene County",2,49,167,84,83
050,17,061,"Illinois","Greene County",2,50,164,79,85
050,17,061,"Illinois","Greene County",2,51,160,75,85
050,17,061,"Illinois","Greene County",2,52,159,79,80
050,17,061,"Illinois","Greene County",2,53,149,77,72
050,17,061,"Illinois","Greene County",2,54,161,77,84
050,17,061,"Illinois","Greene County",2,55,181,90,91
050,17,061,"Illinois","Greene County",2,56,198,100,98
050,17,061,"Illinois","Greene County",2,57,211,108,103
050,17,061,"Illinois","Greene County",2,58,196,101,95
050,17,061,"Illinois","Greene County",2,59,189,97,92
050,17,061,"Illinois","Greene County",2,60,176,83,93
050,17,061,"Illinois","Greene County",2,61,183,94,89
050,17,061,"Illinois","Greene County",2,62,190,97,93
050,17,061,"Illinois","Greene County",2,63,193,102,91
050,17,061,"Illinois","Greene County",2,64,181,97,84
050,17,061,"Illinois","Greene County",2,65,173,88,85
050,17,061,"Illinois","Greene County",2,66,159,74,85
050,17,061,"Illinois","Greene County",2,67,171,81,90
050,17,061,"Illinois","Greene County",2,68,150,77,73
050,17,061,"Illinois","Greene County",2,69,136,73,63
050,17,061,"Illinois","Greene County",2,70,127,67,60
050,17,061,"Illinois","Greene County",2,71,117,54,63
050,17,061,"Illinois","Greene County",2,72,121,55,66
050,17,061,"Illinois","Greene County",2,73,138,63,75
050,17,061,"Illinois","Greene County",2,74,97,45,52
050,17,061,"Illinois","Greene County",2,75,89,37,52
050,17,061,"Illinois","Greene County",2,76,97,48,49
050,17,061,"Illinois","Greene County",2,77,97,46,51
050,17,061,"Illinois","Greene County",2,78,88,36,52
050,17,061,"Illinois","Greene County",2,79,80,36,44
050,17,061,"Illinois","Greene County",2,80,77,34,43
050,17,061,"Illinois","Greene County",2,81,73,32,41
050,17,061,"Illinois","Greene County",2,82,70,28,42
050,17,061,"Illinois","Greene County",2,83,52,20,32
050,17,061,"Illinois","Greene County",2,84,50,20,30
050,17,061,"Illinois","Greene County",2,85,261,104,157
050,17,061,"Illinois","Greene County",3,0,107,55,52
050,17,061,"Illinois","Greene County",3,1,112,59,53
050,17,061,"Illinois","Greene County",3,2,132,65,67
050,17,061,"Illinois","Greene County",3,3,135,61,74
050,17,061,"Illinois","Greene County",3,4,137,66,71
050,17,061,"Illinois","Greene County",3,5,139,73,66
050,17,061,"Illinois","Greene County",3,6,146,74,72
050,17,061,"Illinois","Greene County",3,7,150,81,69
050,17,061,"Illinois","Greene County",3,8,139,73,66
050,17,061,"Illinois","Greene County",3,9,148,74,74
050,17,061,"Illinois","Greene County",3,10,144,75,69
050,17,061,"Illinois","Greene County",3,11,143,75,68
050,17,061,"Illinois","Greene County",3,12,145,65,80
050,17,061,"Illinois","Greene County",3,13,153,77,76
050,17,061,"Illinois","Greene County",3,14,157,84,73
050,17,061,"Illinois","Greene County",3,15,158,77,81
050,17,061,"Illinois","Greene County",3,16,164,83,81
050,17,061,"Illinois","Greene County",3,17,173,85,88
050,17,061,"Illinois","Greene County",3,18,132,66,66
050,17,061,"Illinois","Greene County",3,19,101,52,49
050,17,061,"Illinois","Greene County",3,20,111,59,52
050,17,061,"Illinois","Greene County",3,21,111,57,54
050,17,061,"Illinois","Greene County",3,22,119,62,57
050,17,061,"Illinois","Greene County",3,23,122,57,65
050,17,061,"Illinois","Greene County",3,24,136,71,65
050,17,061,"Illinois","Greene County",3,25,127,68,59
050,17,061,"Illinois","Greene County",3,26,129,73,56
050,17,061,"Illinois","Greene County",3,27,135,70,65
050,17,061,"Illinois","Greene County",3,28,117,58,59
050,17,061,"Illinois","Greene County",3,29,125,72,53
050,17,061,"Illinois","Greene County",3,30,139,71,68
050,17,061,"Illinois","Greene County",3,31,143,73,70
050,17,061,"Illinois","Greene County",3,32,133,73,60
050,17,061,"Illinois","Greene County",3,33,116,62,54
050,17,061,"Illinois","Greene County",3,34,117,59,58
050,17,061,"Illinois","Greene County",3,35,138,69,69
050,17,061,"Illinois","Greene County",3,36,142,70,72
050,17,061,"Illinois","Greene County",3,37,135,73,62
050,17,061,"Illinois","Greene County",3,38,124,65,59
050,17,061,"Illinois","Greene County",3,39,126,69,57
050,17,061,"Illinois","Greene County",3,40,131,71,60
050,17,061,"Illinois","Greene County",3,41,141,76,65
050,17,061,"Illinois","Greene County",3,42,133,65,68
050,17,061,"Illinois","Greene County",3,43,146,77,69
050,17,061,"Illinois","Greene County",3,44,154,82,72
050,17,061,"Illinois","Greene County",3,45,151,76,75
050,17,061,"Illinois","Greene County",3,46,128,67,61
050,17,061,"Illinois","Greene County",3,47,136,72,64
050,17,061,"Illinois","Greene County",3,48,137,72,65
050,17,061,"Illinois","Greene County",3,49,140,79,61
050,17,061,"Illinois","Greene County",3,50,166,86,80
050,17,061,"Illinois","Greene County",3,51,163,78,85
050,17,061,"Illinois","Greene County",3,52,151,71,80
050,17,061,"Illinois","Greene County",3,53,164,79,85
050,17,061,"Illinois","Greene County",3,54,149,77,72
050,17,061,"Illinois","Greene County",3,55,166,78,88
050,17,061,"Illinois","Greene County",3,56,178,89,89
050,17,061,"Illinois","Greene County",3,57,205,103,102
050,17,061,"Illinois","Greene County",3,58,203,102,101
050,17,061,"Illinois","Greene County",3,59,197,100,97
050,17,061,"Illinois","Greene County",3,60,181,92,89
050,17,061,"Illinois","Greene County",3,61,176,87,89
050,17,061,"Illinois","Greene County",3,62,175,87,88
050,17,061,"Illinois","Greene County",3,63,192,100,92
050,17,061,"Illinois","Greene County",3,64,188,97,91
050,17,061,"Illinois","Greene County",3,65,173,92,81
050,17,061,"Illinois","Greene County",3,66,169,88,81
050,17,061,"Illinois","Greene County",3,67,156,70,86
050,17,061,"Illinois","Greene County",3,68,166,77,89
050,17,061,"Illinois","Greene County",3,69,149,75,74
050,17,061,"Illinois","Greene County",3,70,133,72,61
050,17,061,"Illinois","Greene County",3,71,130,70,60
050,17,061,"Illinois","Greene County",3,72,111,53,58
050,17,061,"Illinois","Greene County",3,73,112,49,63
050,17,061,"Illinois","Greene County",3,74,131,61,70
050,17,061,"Illinois","Greene County",3,75,88,38,50
050,17,061,"Illinois","Greene County",3,76,83,36,47
050,17,061,"Illinois","Greene County",3,77,95,44,51
050,17,061,"Illinois","Greene County",3,78,92,40,52
050,17,061,"Illinois","Greene County",3,79,82,34,48
050,17,061,"Illinois","Greene County",3,80,80,33,47
050,17,061,"Illinois","Greene County",3,81,70,32,38
050,17,061,"Illinois","Greene County",3,82,61,25,36
050,17,061,"Illinois","Greene County",3,83,65,26,39
050,17,061,"Illinois","Greene County",3,84,39,16,23
050,17,061,"Illinois","Greene County",3,85,251,97,154
050,17,061,"Illinois","Greene County",4,0,94,56,38
050,17,061,"Illinois","Greene County",4,1,106,57,49
050,17,061,"Illinois","Greene County",4,2,111,62,49
050,17,061,"Illinois","Greene County",4,3,128,62,66
050,17,061,"Illinois","Greene County",4,4,136,62,74
050,17,061,"Illinois","Greene County",4,5,132,63,69
050,17,061,"Illinois","Greene County",4,6,137,70,67
050,17,061,"Illinois","Greene County",4,7,151,77,74
050,17,061,"Illinois","Greene County",4,8,136,74,62
050,17,061,"Illinois","Greene County",4,9,144,74,70
050,17,061,"Illinois","Greene County",4,10,147,72,75
050,17,061,"Illinois","Greene County",4,11,143,77,66
050,17,061,"Illinois","Greene County",4,12,141,72,69
050,17,061,"Illinois","Greene County",4,13,139,66,73
050,17,061,"Illinois","Greene County",4,14,144,72,72
050,17,061,"Illinois","Greene County",4,15,163,84,79
050,17,061,"Illinois","Greene County",4,16,157,78,79
050,17,061,"Illinois","Greene County",4,17,162,79,83
050,17,061,"Illinois","Greene County",4,18,143,72,71
050,17,061,"Illinois","Greene County",4,19,96,48,48
050,17,061,"Illinois","Greene County",4,20,107,52,55
050,17,061,"Illinois","Greene County",4,21,115,58,57
050,17,061,"Illinois","Greene County",4,22,118,57,61
050,17,061,"Illinois","Greene County",4,23,126,65,61
050,17,061,"Illinois","Greene County",4,24,122,59,63
050,17,061,"Illinois","Greene County",4,25,134,64,70
050,17,061,"Illinois","Greene County",4,26,117,61,56
050,17,061,"Illinois","Greene County",4,27,124,70,54
050,17,061,"Illinois","Greene County",4,28,129,70,59
050,17,061,"Illinois","Greene County",4,29,113,53,60
050,17,061,"Illinois","Greene County",4,30,130,76,54
050,17,061,"Illinois","Greene County",4,31,142,67,75
050,17,061,"Illinois","Greene County",4,32,141,71,70
050,17,061,"Illinois","Greene County",4,33,136,74,62
050,17,061,"Illinois","Greene County",4,34,113,58,55
050,17,061,"Illinois","Greene County",4,35,113,53,60
050,17,061,"Illinois","Greene County",4,36,141,67,74
050,17,061,"Illinois","Greene County",4,37,144,75,69
050,17,061,"Illinois","Greene County",4,38,131,70,61
050,17,061,"Illinois","Greene County",4,39,128,69,59
050,17,061,"Illinois","Greene County",4,40,126,69,57
050,17,061,"Illinois","Greene County",4,41,134,70,64
050,17,061,"Illinois","Greene County",4,42,140,77,63
050,17,061,"Illinois","Greene County",4,43,140,69,71
050,17,061,"Illinois","Greene County",4,44,141,76,65
050,17,061,"Illinois","Greene County",4,45,154,81,73
050,17,061,"Illinois","Greene County",4,46,151,76,75
050,17,061,"Illinois","Greene County",4,47,122,66,56
050,17,061,"Illinois","Greene County",4,48,136,74,62
050,17,061,"Illinois","Greene County",4,49,134,67,67
050,17,061,"Illinois","Greene County",4,50,135,74,61
050,17,061,"Illinois","Greene County",4,51,157,83,74
050,17,061,"Illinois","Greene County",4,52,164,78,86
050,17,061,"Illinois","Greene County",4,53,145,65,80
050,17,061,"Illinois","Greene County",4,54,162,79,83
050,17,061,"Illinois","Greene County",4,55,143,73,70
050,17,061,"Illinois","Greene County",4,56,165,78,87
050,17,061,"Illinois","Greene County",4,57,183,93,90
050,17,061,"Illinois","Greene County",4,58,198,100,98
050,17,061,"Illinois","Greene County",4,59,204,103,101
050,17,061,"Illinois","Greene County",4,60,197,98,99
050,17,061,"Illinois","Greene County",4,61,185,93,92
050,17,061,"Illinois","Greene County",4,62,168,80,88
050,17,061,"Illinois","Greene County",4,63,177,90,87
050,17,061,"Illinois","Greene County",4,64,192,100,92
050,17,061,"Illinois","Greene County",4,65,189,93,96
050,17,061,"Illinois","Greene County",4,66,164,89,75
050,17,061,"Illinois","Greene County",4,67,168,89,79
050,17,061,"Illinois","Greene County",4,68,150,66,84
050,17,061,"Illinois","Greene County",4,69,167,78,89
050,17,061,"Illinois","Greene County",4,70,138,70,68
050,17,061,"Illinois","Greene County",4,71,129,71,58
050,17,061,"Illinois","Greene County",4,72,120,67,53
050,17,061,"Illinois","Greene County",4,73,101,48,53
050,17,061,"Illinois","Greene County",4,74,113,50,63
050,17,061,"Illinois","Greene County",4,75,122,55,67
050,17,061,"Illinois","Greene County",4,76,80,38,42
050,17,061,"Illinois","Greene County",4,77,76,32,44
050,17,061,"Illinois","Greene County",4,78,95,42,53
050,17,061,"Illinois","Greene County",4,79,85,38,47
050,17,061,"Illinois","Greene County",4,80,75,29,46
050,17,061,"Illinois","Greene County",4,81,72,30,42
050,17,061,"Illinois","Greene County",4,82,59,27,32
050,17,061,"Illinois","Greene County",4,83,56,22,34
050,17,061,"Illinois","Greene County",4,84,55,24,31
050,17,061,"Illinois","Greene County",4,85,239,89,150
050,17,061,"Illinois","Greene County",5,0,88,51,37
050,17,061,"Illinois","Greene County",5,1,102,62,40
050,17,061,"Illinois","Greene County",5,2,109,55,54
050,17,061,"Illinois","Greene County",5,3,113,61,52
050,17,061,"Illinois","Greene County",5,4,141,68,73
050,17,061,"Illinois","Greene County",5,5,130,61,69
050,17,061,"Illinois","Greene County",5,6,132,62,70
050,17,061,"Illinois","Greene County",5,7,131,65,66
050,17,061,"Illinois","Greene County",5,8,154,77,77
050,17,061,"Illinois","Greene County",5,9,134,76,58
050,17,061,"Illinois","Greene County",5,10,147,76,71
050,17,061,"Illinois","Greene County",5,11,150,72,78
050,17,061,"Illinois","Greene County",5,12,149,79,70
050,17,061,"Illinois","Greene County",5,13,153,79,74
050,17,061,"Illinois","Greene County",5,14,139,62,77
050,17,061,"Illinois","Greene County",5,15,156,78,78
050,17,061,"Illinois","Greene County",5,16,153,80,73
050,17,061,"Illinois","Greene County",5,17,162,80,82
050,17,061,"Illinois","Greene County",5,18,130,68,62
050,17,061,"Illinois","Greene County",5,19,111,57,54
050,17,061,"Illinois","Greene County",5,20,98,48,50
050,17,061,"Illinois","Greene County",5,21,114,57,57
050,17,061,"Illinois","Greene County",5,22,116,60,56
050,17,061,"Illinois","Greene County",5,23,115,60,55
050,17,061,"Illinois","Greene County",5,24,119,60,59
050,17,061,"Illinois","Greene County",5,25,130,66,64
050,17,061,"Illinois","Greene County",5,26,125,61,64
050,17,061,"Illinois","Greene County",5,27,113,62,51
050,17,061,"Illinois","Greene County",5,28,122,68,54
050,17,061,"Illinois","Greene County",5,29,131,70,61
050,17,061,"Illinois","Greene County",5,30,112,51,61
050,17,061,"Illinois","Greene County",5,31,121,70,51
050,17,061,"Illinois","Greene County",5,32,129,63,66
050,17,061,"Illinois","Greene County",5,33,141,72,69
050,17,061,"Illinois","Greene County",5,34,136,73,63
050,17,061,"Illinois","Greene County",5,35,116,62,54
050,17,061,"Illinois","Greene County",5,36,116,54,62
050,17,061,"Illinois","Greene County",5,37,140,66,74
050,17,061,"Illinois","Greene County",5,38,147,78,69
050,17,061,"Illinois","Greene County",5,39,136,72,64
050,17,061,"Illinois","Greene County",5,40,132,68,64
050,17,061,"Illinois","Greene County",5,41,132,71,61
050,17,061,"Illinois","Greene County",5,42,137,73,64
050,17,061,"Illinois","Greene County",5,43,145,78,67
050,17,061,"Illinois","Greene County",5,44,140,67,73
050,17,061,"Illinois","Greene County",5,45,146,80,66
050,17,061,"Illinois","Greene County",5,46,154,81,73
050,17,061,"Illinois","Greene County",5,47,148,76,72
050,17,061,"Illinois","Greene County",5,48,127,68,59
050,17,061,"Illinois","Greene County",5,49,137,71,66
050,17,061,"Illinois","Greene County",5,50,135,66,69
050,17,061,"Illinois","Greene County",5,51,138,76,62
050,17,061,"Illinois","Greene County",5,52,159,81,78
050,17,061,"Illinois","Greene County",5,53,167,79,88
050,17,061,"Illinois","Greene County",5,54,140,62,78
050,17,061,"Illinois","Greene County",5,55,157,78,79
050,17,061,"Illinois","Greene County",5,56,142,72,70
050,17,061,"Illinois","Greene County",5,57,167,79,88
050,17,061,"Illinois","Greene County",5,58,184,94,90
050,17,061,"Illinois","Greene County",5,59,189,93,96
050,17,061,"Illinois","Greene County",5,60,202,105,97
050,17,061,"Illinois","Greene County",5,61,197,99,98
050,17,061,"Illinois","Greene County",5,62,177,86,91
050,17,061,"Illinois","Greene County",5,63,168,83,85
050,17,061,"Illinois","Greene County",5,64,180,91,89
050,17,061,"Illinois","Greene County",5,65,190,95,95
050,17,061,"Illinois","Greene County",5,66,182,91,91
050,17,061,"Illinois","Greene County",5,67,162,87,75
050,17,061,"Illinois","Greene County",5,68,161,84,77
050,17,061,"Illinois","Greene County",5,69,150,67,83
050,17,061,"Illinois","Greene County",5,70,157,75,82
050,17,061,"Illinois","Greene County",5,71,140,72,68
050,17,061,"Illinois","Greene County",5,72,120,66,54
050,17,061,"Illinois","Greene County",5,73,110,60,50
050,17,061,"Illinois","Greene County",5,74,102,50,52
050,17,061,"Illinois","Greene County",5,75,103,45,58
050,17,061,"Illinois","Greene County",5,76,115,54,61
050,17,061,"Illinois","Greene County",5,77,74,33,41
050,17,061,"Illinois","Greene County",5,78,75,29,46
050,17,061,"Illinois","Greene County",5,79,90,41,49
050,17,061,"Illinois","Greene County",5,80,76,33,43
050,17,061,"Illinois","Greene County",5,81,65,25,40
050,17,061,"Illinois","Greene County",5,82,66,27,39
050,17,061,"Illinois","Greene County",5,83,54,24,30
050,17,061,"Illinois","Greene County",5,84,46,19,27
050,17,061,"Illinois","Greene County",5,85,244,92,152
050,17,063,"Illinois","Grundy County",1,0,566,287,279
050,17,063,"Illinois","Grundy County",1,1,609,303,306
050,17,063,"Illinois","Grundy County",1,2,637,317,320
050,17,063,"Illinois","Grundy County",1,3,644,332,312
050,17,063,"Illinois","Grundy County",1,4,667,338,329
050,17,063,"Illinois","Grundy County",1,5,684,377,307
050,17,063,"Illinois","Grundy County",1,6,693,338,355
050,17,063,"Illinois","Grundy County",1,7,703,343,360
050,17,063,"Illinois","Grundy County",1,8,716,381,335
050,17,063,"Illinois","Grundy County",1,9,756,402,354
050,17,063,"Illinois","Grundy County",1,10,761,397,364
050,17,063,"Illinois","Grundy County",1,11,814,406,408
050,17,063,"Illinois","Grundy County",1,12,851,446,405
050,17,063,"Illinois","Grundy County",1,13,838,420,418
050,17,063,"Illinois","Grundy County",1,14,813,429,384
050,17,063,"Illinois","Grundy County",1,15,803,413,390
050,17,063,"Illinois","Grundy County",1,16,828,425,403
050,17,063,"Illinois","Grundy County",1,17,836,451,385
050,17,063,"Illinois","Grundy County",1,18,697,382,315
050,17,063,"Illinois","Grundy County",1,19,543,286,257
050,17,063,"Illinois","Grundy County",1,20,580,299,281
050,17,063,"Illinois","Grundy County",1,21,564,271,293
050,17,063,"Illinois","Grundy County",1,22,598,302,296
050,17,063,"Illinois","Grundy County",1,23,596,300,296
050,17,063,"Illinois","Grundy County",1,24,603,301,302
050,17,063,"Illinois","Grundy County",1,25,634,325,309
050,17,063,"Illinois","Grundy County",1,26,607,318,289
050,17,063,"Illinois","Grundy County",1,27,627,333,294
050,17,063,"Illinois","Grundy County",1,28,619,297,322
050,17,063,"Illinois","Grundy County",1,29,643,308,335
050,17,063,"Illinois","Grundy County",1,30,661,327,334
050,17,063,"Illinois","Grundy County",1,31,611,308,303
050,17,063,"Illinois","Grundy County",1,32,631,304,327
050,17,063,"Illinois","Grundy County",1,33,664,331,333
050,17,063,"Illinois","Grundy County",1,34,718,350,368
050,17,063,"Illinois","Grundy County",1,35,710,336,374
050,17,063,"Illinois","Grundy County",1,36,716,355,361
050,17,063,"Illinois","Grundy County",1,37,715,353,362
050,17,063,"Illinois","Grundy County",1,38,781,397,384
050,17,063,"Illinois","Grundy County",1,39,802,397,405
050,17,063,"Illinois","Grundy County",1,40,782,400,382
050,17,063,"Illinois","Grundy County",1,41,767,392,375
050,17,063,"Illinois","Grundy County",1,42,760,381,379
050,17,063,"Illinois","Grundy County",1,43,673,344,329
050,17,063,"Illinois","Grundy County",1,44,682,362,320
050,17,063,"Illinois","Grundy County",1,45,688,349,339
050,17,063,"Illinois","Grundy County",1,46,649,306,343
050,17,063,"Illinois","Grundy County",1,47,655,320,335
050,17,063,"Illinois","Grundy County",1,48,717,368,349
050,17,063,"Illinois","Grundy County",1,49,765,383,382
050,17,063,"Illinois","Grundy County",1,50,728,387,341
050,17,063,"Illinois","Grundy County",1,51,718,374,344
050,17,063,"Illinois","Grundy County",1,52,716,358,358
050,17,063,"Illinois","Grundy County",1,53,725,371,354
050,17,063,"Illinois","Grundy County",1,54,651,332,319
050,17,063,"Illinois","Grundy County",1,55,671,346,325
050,17,063,"Illinois","Grundy County",1,56,739,383,356
050,17,063,"Illinois","Grundy County",1,57,720,379,341
050,17,063,"Illinois","Grundy County",1,58,730,366,364
050,17,063,"Illinois","Grundy County",1,59,684,332,352
050,17,063,"Illinois","Grundy County",1,60,650,327,323
050,17,063,"Illinois","Grundy County",1,61,686,355,331
050,17,063,"Illinois","Grundy County",1,62,664,344,320
050,17,063,"Illinois","Grundy County",1,63,612,303,309
050,17,063,"Illinois","Grundy County",1,64,573,262,311
050,17,063,"Illinois","Grundy County",1,65,566,285,281
050,17,063,"Illinois","Grundy County",1,66,550,280,270
050,17,063,"Illinois","Grundy County",1,67,519,235,284
050,17,063,"Illinois","Grundy County",1,68,482,224,258
050,17,063,"Illinois","Grundy County",1,69,439,220,219
050,17,063,"Illinois","Grundy County",1,70,466,236,230
050,17,063,"Illinois","Grundy County",1,71,417,193,224
050,17,063,"Illinois","Grundy County",1,72,442,217,225
050,17,063,"Illinois","Grundy County",1,73,428,213,215
050,17,063,"Illinois","Grundy County",1,74,308,151,157
050,17,063,"Illinois","Grundy County",1,75,291,131,160
050,17,063,"Illinois","Grundy County",1,76,288,139,149
050,17,063,"Illinois","Grundy County",1,77,307,148,159
050,17,063,"Illinois","Grundy County",1,78,250,102,148
050,17,063,"Illinois","Grundy County",1,79,224,96,128
050,17,063,"Illinois","Grundy County",1,80,216,95,121
050,17,063,"Illinois","Grundy County",1,81,192,93,99
050,17,063,"Illinois","Grundy County",1,82,167,71,96
050,17,063,"Illinois","Grundy County",1,83,138,61,77
050,17,063,"Illinois","Grundy County",1,84,142,60,82
050,17,063,"Illinois","Grundy County",1,85,763,247,516
050,17,063,"Illinois","Grundy County",2,0,558,290,268
050,17,063,"Illinois","Grundy County",2,1,599,298,301
050,17,063,"Illinois","Grundy County",2,2,627,312,315
050,17,063,"Illinois","Grundy County",2,3,639,328,311
050,17,063,"Illinois","Grundy County",2,4,669,343,326
050,17,063,"Illinois","Grundy County",2,5,682,367,315
050,17,063,"Illinois","Grundy County",2,6,696,349,347
050,17,063,"Illinois","Grundy County",2,7,704,345,359
050,17,063,"Illinois","Grundy County",2,8,713,371,342
050,17,063,"Illinois","Grundy County",2,9,744,395,349
050,17,063,"Illinois","Grundy County",2,10,762,399,363
050,17,063,"Illinois","Grundy County",2,11,797,404,393
050,17,063,"Illinois","Grundy County",2,12,853,439,414
050,17,063,"Illinois","Grundy County",2,13,839,426,413
050,17,063,"Illinois","Grundy County",2,14,815,424,391
050,17,063,"Illinois","Grundy County",2,15,804,418,386
050,17,063,"Illinois","Grundy County",2,16,823,423,400
050,17,063,"Illinois","Grundy County",2,17,832,445,387
050,17,063,"Illinois","Grundy County",2,18,694,381,313
050,17,063,"Illinois","Grundy County",2,19,552,295,257
050,17,063,"Illinois","Grundy County",2,20,586,302,284
050,17,063,"Illinois","Grundy County",2,21,574,281,293
050,17,063,"Illinois","Grundy County",2,22,592,297,295
050,17,063,"Illinois","Grundy County",2,23,595,300,295
050,17,063,"Illinois","Grundy County",2,24,605,303,302
050,17,063,"Illinois","Grundy County",2,25,616,312,304
050,17,063,"Illinois","Grundy County",2,26,614,323,291
050,17,063,"Illinois","Grundy County",2,27,619,329,290
050,17,063,"Illinois","Grundy County",2,28,617,304,313
050,17,063,"Illinois","Grundy County",2,29,638,304,334
050,17,063,"Illinois","Grundy County",2,30,661,323,338
050,17,063,"Illinois","Grundy County",2,31,627,313,314
050,17,063,"Illinois","Grundy County",2,32,632,307,325
050,17,063,"Illinois","Grundy County",2,33,662,328,334
050,17,063,"Illinois","Grundy County",2,34,708,347,361
050,17,063,"Illinois","Grundy County",2,35,713,339,374
050,17,063,"Illinois","Grundy County",2,36,703,344,359
050,17,063,"Illinois","Grundy County",2,37,720,356,364
050,17,063,"Illinois","Grundy County",2,38,770,389,381
050,17,063,"Illinois","Grundy County",2,39,795,396,399
050,17,063,"Illinois","Grundy County",2,40,793,401,392
050,17,063,"Illinois","Grundy County",2,41,771,392,379
050,17,063,"Illinois","Grundy County",2,42,756,382,374
050,17,063,"Illinois","Grundy County",2,43,694,353,341
050,17,063,"Illinois","Grundy County",2,44,671,352,319
050,17,063,"Illinois","Grundy County",2,45,692,354,338
050,17,063,"Illinois","Grundy County",2,46,657,316,341
050,17,063,"Illinois","Grundy County",2,47,654,318,336
050,17,063,"Illinois","Grundy County",2,48,699,356,343
050,17,063,"Illinois","Grundy County",2,49,756,383,373
050,17,063,"Illinois","Grundy County",2,50,737,387,350
050,17,063,"Illinois","Grundy County",2,51,718,375,343
050,17,063,"Illinois","Grundy County",2,52,715,361,354
050,17,063,"Illinois","Grundy County",2,53,719,366,353
050,17,063,"Illinois","Grundy County",2,54,662,337,325
050,17,063,"Illinois","Grundy County",2,55,664,340,324
050,17,063,"Illinois","Grundy County",2,56,723,375,348
050,17,063,"Illinois","Grundy County",2,57,727,381,346
050,17,063,"Illinois","Grundy County",2,58,723,367,356
050,17,063,"Illinois","Grundy County",2,59,695,340,355
050,17,063,"Illinois","Grundy County",2,60,657,329,328
050,17,063,"Illinois","Grundy County",2,61,678,347,331
050,17,063,"Illinois","Grundy County",2,62,667,346,321
050,17,063,"Illinois","Grundy County",2,63,622,310,312
050,17,063,"Illinois","Grundy County",2,64,573,264,309
050,17,063,"Illinois","Grundy County",2,65,563,279,284
050,17,063,"Illinois","Grundy County",2,66,553,279,274
050,17,063,"Illinois","Grundy County",2,67,525,243,282
050,17,063,"Illinois","Grundy County",2,68,483,224,259
050,17,063,"Illinois","Grundy County",2,69,447,219,228
050,17,063,"Illinois","Grundy County",2,70,453,227,226
050,17,063,"Illinois","Grundy County",2,71,432,205,227
050,17,063,"Illinois","Grundy County",2,72,429,208,221
050,17,063,"Illinois","Grundy County",2,73,456,226,230
050,17,063,"Illinois","Grundy County",2,74,313,154,159
050,17,063,"Illinois","Grundy County",2,75,293,135,158
050,17,063,"Illinois","Grundy County",2,76,286,136,150
050,17,063,"Illinois","Grundy County",2,77,307,147,160
050,17,063,"Illinois","Grundy County",2,78,256,110,146
050,17,063,"Illinois","Grundy County",2,79,226,95,131
050,17,063,"Illinois","Grundy County",2,80,213,93,120
050,17,063,"Illinois","Grundy County",2,81,195,93,102
050,17,063,"Illinois","Grundy County",2,82,176,77,99
050,17,063,"Illinois","Grundy County",2,83,141,62,79
050,17,063,"Illinois","Grundy County",2,84,142,60,82
050,17,063,"Illinois","Grundy County",2,85,755,246,509
050,17,063,"Illinois","Grundy County",3,0,548,279,269
050,17,063,"Illinois","Grundy County",3,1,608,318,290
050,17,063,"Illinois","Grundy County",3,2,623,319,304
050,17,063,"Illinois","Grundy County",3,3,624,293,331
050,17,063,"Illinois","Grundy County",3,4,688,356,332
050,17,063,"Illinois","Grundy County",3,5,695,358,337
050,17,063,"Illinois","Grundy County",3,6,675,360,315
050,17,063,"Illinois","Grundy County",3,7,686,336,350
050,17,063,"Illinois","Grundy County",3,8,691,343,348
050,17,063,"Illinois","Grundy County",3,9,703,366,337
050,17,063,"Illinois","Grundy County",3,10,753,398,355
050,17,063,"Illinois","Grundy County",3,11,780,416,364
050,17,063,"Illinois","Grundy County",3,12,818,419,399
050,17,063,"Illinois","Grundy County",3,13,854,444,410
050,17,063,"Illinois","Grundy County",3,14,839,427,412
050,17,063,"Illinois","Grundy County",3,15,837,439,398
050,17,063,"Illinois","Grundy County",3,16,825,430,395
050,17,063,"Illinois","Grundy County",3,17,810,416,394
050,17,063,"Illinois","Grundy County",3,18,729,403,326
050,17,063,"Illinois","Grundy County",3,19,545,299,246
050,17,063,"Illinois","Grundy County",3,20,606,311,295
050,17,063,"Illinois","Grundy County",3,21,622,311,311
050,17,063,"Illinois","Grundy County",3,22,624,297,327
050,17,063,"Illinois","Grundy County",3,23,614,312,302
050,17,063,"Illinois","Grundy County",3,24,598,302,296
050,17,063,"Illinois","Grundy County",3,25,602,319,283
050,17,063,"Illinois","Grundy County",3,26,632,317,315
050,17,063,"Illinois","Grundy County",3,27,648,338,310
050,17,063,"Illinois","Grundy County",3,28,652,340,312
050,17,063,"Illinois","Grundy County",3,29,653,319,334
050,17,063,"Illinois","Grundy County",3,30,661,325,336
050,17,063,"Illinois","Grundy County",3,31,683,334,349
050,17,063,"Illinois","Grundy County",3,32,655,335,320
050,17,063,"Illinois","Grundy County",3,33,646,310,336
050,17,063,"Illinois","Grundy County",3,34,685,344,341
050,17,063,"Illinois","Grundy County",3,35,707,355,352
050,17,063,"Illinois","Grundy County",3,36,716,346,370
050,17,063,"Illinois","Grundy County",3,37,730,358,372
050,17,063,"Illinois","Grundy County",3,38,735,360,375
050,17,063,"Illinois","Grundy County",3,39,773,393,380
050,17,063,"Illinois","Grundy County",3,40,796,398,398
050,17,063,"Illinois","Grundy County",3,41,799,402,397
050,17,063,"Illinois","Grundy County",3,42,771,394,377
050,17,063,"Illinois","Grundy County",3,43,754,383,371
050,17,063,"Illinois","Grundy County",3,44,682,338,344
050,17,063,"Illinois","Grundy County",3,45,662,352,310
050,17,063,"Illinois","Grundy County",3,46,691,347,344
050,17,063,"Illinois","Grundy County",3,47,661,324,337
050,17,063,"Illinois","Grundy County",3,48,651,310,341
050,17,063,"Illinois","Grundy County",3,49,705,363,342
050,17,063,"Illinois","Grundy County",3,50,774,388,386
050,17,063,"Illinois","Grundy County",3,51,739,386,353
050,17,063,"Illinois","Grundy County",3,52,704,367,337
050,17,063,"Illinois","Grundy County",3,53,725,361,364
050,17,063,"Illinois","Grundy County",3,54,738,371,367
050,17,063,"Illinois","Grundy County",3,55,641,326,315
050,17,063,"Illinois","Grundy County",3,56,681,343,338
050,17,063,"Illinois","Grundy County",3,57,728,373,355
050,17,063,"Illinois","Grundy County",3,58,720,377,343
050,17,063,"Illinois","Grundy County",3,59,709,361,348
050,17,063,"Illinois","Grundy County",3,60,682,335,347
050,17,063,"Illinois","Grundy County",3,61,648,324,324
050,17,063,"Illinois","Grundy County",3,62,670,354,316
050,17,063,"Illinois","Grundy County",3,63,641,328,313
050,17,063,"Illinois","Grundy County",3,64,608,306,302
050,17,063,"Illinois","Grundy County",3,65,559,254,305
050,17,063,"Illinois","Grundy County",3,66,560,277,283
050,17,063,"Illinois","Grundy County",3,67,541,269,272
050,17,063,"Illinois","Grundy County",3,68,515,243,272
050,17,063,"Illinois","Grundy County",3,69,467,211,256
050,17,063,"Illinois","Grundy County",3,70,448,226,222
050,17,063,"Illinois","Grundy County",3,71,438,214,224
050,17,063,"Illinois","Grundy County",3,72,415,192,223
050,17,063,"Illinois","Grundy County",3,73,418,202,216
050,17,063,"Illinois","Grundy County",3,74,433,214,219
050,17,063,"Illinois","Grundy County",3,75,301,146,155
050,17,063,"Illinois","Grundy County",3,76,277,129,148
050,17,063,"Illinois","Grundy County",3,77,266,125,141
050,17,063,"Illinois","Grundy County",3,78,293,141,152
050,17,063,"Illinois","Grundy County",3,79,248,110,138
050,17,063,"Illinois","Grundy County",3,80,209,83,126
050,17,063,"Illinois","Grundy County",3,81,194,84,110
050,17,063,"Illinois","Grundy County",3,82,192,86,106
050,17,063,"Illinois","Grundy County",3,83,156,71,85
050,17,063,"Illinois","Grundy County",3,84,126,50,76
050,17,063,"Illinois","Grundy County",3,85,750,259,491
050,17,063,"Illinois","Grundy County",4,0,571,273,298
050,17,063,"Illinois","Grundy County",4,1,576,278,298
050,17,063,"Illinois","Grundy County",4,2,629,336,293
050,17,063,"Illinois","Grundy County",4,3,651,347,304
050,17,063,"Illinois","Grundy County",4,4,632,301,331
050,17,063,"Illinois","Grundy County",4,5,713,365,348
050,17,063,"Illinois","Grundy County",4,6,695,353,342
050,17,063,"Illinois","Grundy County",4,7,707,367,340
050,17,063,"Illinois","Grundy County",4,8,692,335,357
050,17,063,"Illinois","Grundy County",4,9,695,347,348
050,17,063,"Illinois","Grundy County",4,10,705,372,333
050,17,063,"Illinois","Grundy County",4,11,764,410,354
050,17,063,"Illinois","Grundy County",4,12,773,405,368
050,17,063,"Illinois","Grundy County",4,13,833,424,409
050,17,063,"Illinois","Grundy County",4,14,848,434,414
050,17,063,"Illinois","Grundy County",4,15,837,428,409
050,17,063,"Illinois","Grundy County",4,16,833,435,398
050,17,063,"Illinois","Grundy County",4,17,818,427,391
050,17,063,"Illinois","Grundy County",4,18,677,360,317
050,17,063,"Illinois","Grundy County",4,19,570,321,249
050,17,063,"Illinois","Grundy County",4,20,583,322,261
050,17,063,"Illinois","Grundy County",4,21,639,337,302
050,17,063,"Illinois","Grundy County",4,22,646,319,327
050,17,063,"Illinois","Grundy County",4,23,634,309,325
050,17,063,"Illinois","Grundy County",4,24,623,309,314
050,17,063,"Illinois","Grundy County",4,25,586,303,283
050,17,063,"Illinois","Grundy County",4,26,603,319,284
050,17,063,"Illinois","Grundy County",4,27,662,340,322
050,17,063,"Illinois","Grundy County",4,28,669,346,323
050,17,063,"Illinois","Grundy County",4,29,661,351,310
050,17,063,"Illinois","Grundy County",4,30,685,342,343
050,17,063,"Illinois","Grundy County",4,31,674,330,344
050,17,063,"Illinois","Grundy County",4,32,688,327,361
050,17,063,"Illinois","Grundy County",4,33,702,362,340
050,17,063,"Illinois","Grundy County",4,34,666,313,353
050,17,063,"Illinois","Grundy County",4,35,700,362,338
050,17,063,"Illinois","Grundy County",4,36,715,363,352
050,17,063,"Illinois","Grundy County",4,37,736,358,378
050,17,063,"Illinois","Grundy County",4,38,723,351,372
050,17,063,"Illinois","Grundy County",4,39,730,368,362
050,17,063,"Illinois","Grundy County",4,40,778,392,386
050,17,063,"Illinois","Grundy County",4,41,785,379,406
050,17,063,"Illinois","Grundy County",4,42,795,405,390
050,17,063,"Illinois","Grundy County",4,43,777,404,373
050,17,063,"Illinois","Grundy County",4,44,747,379,368
050,17,063,"Illinois","Grundy County",4,45,674,342,332
050,17,063,"Illinois","Grundy County",4,46,668,351,317
050,17,063,"Illinois","Grundy County",4,47,682,344,338
050,17,063,"Illinois","Grundy County",4,48,642,318,324
050,17,063,"Illinois","Grundy County",4,49,644,312,332
050,17,063,"Illinois","Grundy County",4,50,694,350,344
050,17,063,"Illinois","Grundy County",4,51,776,389,387
050,17,063,"Illinois","Grundy County",4,52,744,388,356
050,17,063,"Illinois","Grundy County",4,53,680,360,320
050,17,063,"Illinois","Grundy County",4,54,729,365,364
050,17,063,"Illinois","Grundy County",4,55,718,360,358
050,17,063,"Illinois","Grundy County",4,56,638,327,311
050,17,063,"Illinois","Grundy County",4,57,662,332,330
050,17,063,"Illinois","Grundy County",4,58,729,373,356
050,17,063,"Illinois","Grundy County",4,59,703,354,349
050,17,063,"Illinois","Grundy County",4,60,703,360,343
050,17,063,"Illinois","Grundy County",4,61,667,328,339
050,17,063,"Illinois","Grundy County",4,62,645,323,322
050,17,063,"Illinois","Grundy County",4,63,651,351,300
050,17,063,"Illinois","Grundy County",4,64,636,322,314
050,17,063,"Illinois","Grundy County",4,65,583,294,289
050,17,063,"Illinois","Grundy County",4,66,546,245,301
050,17,063,"Illinois","Grundy County",4,67,546,263,283
050,17,063,"Illinois","Grundy County",4,68,535,265,270
050,17,063,"Illinois","Grundy County",4,69,507,235,272
050,17,063,"Illinois","Grundy County",4,70,454,207,247
050,17,063,"Illinois","Grundy County",4,71,445,227,218
050,17,063,"Illinois","Grundy County",4,72,424,205,219
050,17,063,"Illinois","Grundy County",4,73,405,187,218
050,17,063,"Illinois","Grundy County",4,74,410,197,213
050,17,063,"Illinois","Grundy County",4,75,421,207,214
050,17,063,"Illinois","Grundy County",4,76,288,140,148
050,17,063,"Illinois","Grundy County",4,77,265,122,143
050,17,063,"Illinois","Grundy County",4,78,256,123,133
050,17,063,"Illinois","Grundy County",4,79,283,136,147
050,17,063,"Illinois","Grundy County",4,80,236,106,130
050,17,063,"Illinois","Grundy County",4,81,190,74,116
050,17,063,"Illinois","Grundy County",4,82,190,79,111
050,17,063,"Illinois","Grundy County",4,83,172,76,96
050,17,063,"Illinois","Grundy County",4,84,146,65,81
050,17,063,"Illinois","Grundy County",4,85,736,266,470
050,17,063,"Illinois","Grundy County",5,0,573,273,300
050,17,063,"Illinois","Grundy County",5,1,582,284,298
050,17,063,"Illinois","Grundy County",5,2,591,283,308
050,17,063,"Illinois","Grundy County",5,3,654,343,311
050,17,063,"Illinois","Grundy County",5,4,673,366,307
050,17,063,"Illinois","Grundy County",5,5,635,298,337
050,17,063,"Illinois","Grundy County",5,6,722,363,359
050,17,063,"Illinois","Grundy County",5,7,711,368,343
050,17,063,"Illinois","Grundy County",5,8,737,374,363
050,17,063,"Illinois","Grundy County",5,9,701,347,354
050,17,063,"Illinois","Grundy County",5,10,711,347,364
050,17,063,"Illinois","Grundy County",5,11,706,369,337
050,17,063,"Illinois","Grundy County",5,12,761,412,349
050,17,063,"Illinois","Grundy County",5,13,770,408,362
050,17,063,"Illinois","Grundy County",5,14,855,435,420
050,17,063,"Illinois","Grundy County",5,15,856,437,419
050,17,063,"Illinois","Grundy County",5,16,844,429,415
050,17,063,"Illinois","Grundy County",5,17,831,436,395
050,17,063,"Illinois","Grundy County",5,18,702,374,328
050,17,063,"Illinois","Grundy County",5,19,537,279,258
050,17,063,"Illinois","Grundy County",5,20,642,358,284
050,17,063,"Illinois","Grundy County",5,21,630,356,274
050,17,063,"Illinois","Grundy County",5,22,680,363,317
050,17,063,"Illinois","Grundy County",5,23,660,333,327
050,17,063,"Illinois","Grundy County",5,24,623,312,311
050,17,063,"Illinois","Grundy County",5,25,622,313,309
050,17,063,"Illinois","Grundy County",5,26,603,309,294
050,17,063,"Illinois","Grundy County",5,27,607,321,286
050,17,063,"Illinois","Grundy County",5,28,699,366,333
050,17,063,"Illinois","Grundy County",5,29,673,346,327
050,17,063,"Illinois","Grundy County",5,30,705,370,335
050,17,063,"Illinois","Grundy County",5,31,715,363,352
050,17,063,"Illinois","Grundy County",5,32,680,347,333
050,17,063,"Illinois","Grundy County",5,33,689,337,352
050,17,063,"Illinois","Grundy County",5,34,721,374,347
050,17,063,"Illinois","Grundy County",5,35,686,327,359
050,17,063,"Illinois","Grundy County",5,36,723,380,343
050,17,063,"Illinois","Grundy County",5,37,737,372,365
050,17,063,"Illinois","Grundy County",5,38,732,365,367
050,17,063,"Illinois","Grundy County",5,39,716,358,358
050,17,063,"Illinois","Grundy County",5,40,746,376,370
050,17,063,"Illinois","Grundy County",5,41,782,396,386
050,17,063,"Illinois","Grundy County",5,42,795,379,416
050,17,063,"Illinois","Grundy County",5,43,807,409,398
050,17,063,"Illinois","Grundy County",5,44,773,399,374
050,17,063,"Illinois","Grundy County",5,45,740,381,359
050,17,063,"Illinois","Grundy County",5,46,678,349,329
050,17,063,"Illinois","Grundy County",5,47,663,355,308
050,17,063,"Illinois","Grundy County",5,48,667,327,340
050,17,063,"Illinois","Grundy County",5,49,627,305,322
050,17,063,"Illinois","Grundy County",5,50,631,305,326
050,17,063,"Illinois","Grundy County",5,51,690,350,340
050,17,063,"Illinois","Grundy County",5,52,768,372,396
050,17,063,"Illinois","Grundy County",5,53,744,390,354
050,17,063,"Illinois","Grundy County",5,54,678,362,316
050,17,063,"Illinois","Grundy County",5,55,728,368,360
050,17,063,"Illinois","Grundy County",5,56,723,358,365
050,17,063,"Illinois","Grundy County",5,57,638,329,309
050,17,063,"Illinois","Grundy County",5,58,654,335,319
050,17,063,"Illinois","Grundy County",5,59,711,368,343
050,17,063,"Illinois","Grundy County",5,60,699,349,350
050,17,063,"Illinois","Grundy County",5,61,690,360,330
050,17,063,"Illinois","Grundy County",5,62,664,329,335
050,17,063,"Illinois","Grundy County",5,63,634,319,315
050,17,063,"Illinois","Grundy County",5,64,644,347,297
050,17,063,"Illinois","Grundy County",5,65,615,312,303
050,17,063,"Illinois","Grundy County",5,66,579,293,286
050,17,063,"Illinois","Grundy County",5,67,535,236,299
050,17,063,"Illinois","Grundy County",5,68,535,260,275
050,17,063,"Illinois","Grundy County",5,69,524,259,265
050,17,063,"Illinois","Grundy County",5,70,504,235,269
050,17,063,"Illinois","Grundy County",5,71,444,202,242
050,17,063,"Illinois","Grundy County",5,72,425,216,209
050,17,063,"Illinois","Grundy County",5,73,416,201,215
050,17,063,"Illinois","Grundy County",5,74,395,182,213
050,17,063,"Illinois","Grundy County",5,75,393,184,209
050,17,063,"Illinois","Grundy County",5,76,398,195,203
050,17,063,"Illinois","Grundy County",5,77,272,133,139
050,17,063,"Illinois","Grundy County",5,78,251,117,134
050,17,063,"Illinois","Grundy County",5,79,242,115,127
050,17,063,"Illinois","Grundy County",5,80,270,132,138
050,17,063,"Illinois","Grundy County",5,81,230,103,127
050,17,063,"Illinois","Grundy County",5,82,187,71,116
050,17,063,"Illinois","Grundy County",5,83,173,72,101
050,17,063,"Illinois","Grundy County",5,84,152,66,86
050,17,063,"Illinois","Grundy County",5,85,769,296,473
050,17,065,"Illinois","Hamilton County",1,0,80,41,39
050,17,065,"Illinois","Hamilton County",1,1,81,43,38
050,17,065,"Illinois","Hamilton County",1,2,80,41,39
050,17,065,"Illinois","Hamilton County",1,3,94,47,47
050,17,065,"Illinois","Hamilton County",1,4,102,53,49
050,17,065,"Illinois","Hamilton County",1,5,94,48,46
050,17,065,"Illinois","Hamilton County",1,6,80,36,44
050,17,065,"Illinois","Hamilton County",1,7,84,43,41
050,17,065,"Illinois","Hamilton County",1,8,101,48,53
050,17,065,"Illinois","Hamilton County",1,9,98,44,54
050,17,065,"Illinois","Hamilton County",1,10,100,58,42
050,17,065,"Illinois","Hamilton County",1,11,104,61,43
050,17,065,"Illinois","Hamilton County",1,12,103,55,48
050,17,065,"Illinois","Hamilton County",1,13,112,51,61
050,17,065,"Illinois","Hamilton County",1,14,124,54,70
050,17,065,"Illinois","Hamilton County",1,15,109,54,55
050,17,065,"Illinois","Hamilton County",1,16,109,56,53
050,17,065,"Illinois","Hamilton County",1,17,114,66,48
050,17,065,"Illinois","Hamilton County",1,18,99,54,45
050,17,065,"Illinois","Hamilton County",1,19,69,35,34
050,17,065,"Illinois","Hamilton County",1,20,72,35,37
050,17,065,"Illinois","Hamilton County",1,21,75,36,39
050,17,065,"Illinois","Hamilton County",1,22,75,37,38
050,17,065,"Illinois","Hamilton County",1,23,88,43,45
050,17,065,"Illinois","Hamilton County",1,24,86,45,41
050,17,065,"Illinois","Hamilton County",1,25,79,45,34
050,17,065,"Illinois","Hamilton County",1,26,82,47,35
050,17,065,"Illinois","Hamilton County",1,27,83,44,39
050,17,065,"Illinois","Hamilton County",1,28,86,42,44
050,17,065,"Illinois","Hamilton County",1,29,91,45,46
050,17,065,"Illinois","Hamilton County",1,30,88,44,44
050,17,065,"Illinois","Hamilton County",1,31,75,35,40
050,17,065,"Illinois","Hamilton County",1,32,76,34,42
050,17,065,"Illinois","Hamilton County",1,33,82,36,46
050,17,065,"Illinois","Hamilton County",1,34,87,43,44
050,17,065,"Illinois","Hamilton County",1,35,84,47,37
050,17,065,"Illinois","Hamilton County",1,36,98,54,44
050,17,065,"Illinois","Hamilton County",1,37,107,56,51
050,17,065,"Illinois","Hamilton County",1,38,95,50,45
050,17,065,"Illinois","Hamilton County",1,39,92,47,45
050,17,065,"Illinois","Hamilton County",1,40,94,42,52
050,17,065,"Illinois","Hamilton County",1,41,92,43,49
050,17,065,"Illinois","Hamilton County",1,42,97,50,47
050,17,065,"Illinois","Hamilton County",1,43,107,47,60
050,17,065,"Illinois","Hamilton County",1,44,100,45,55
050,17,065,"Illinois","Hamilton County",1,45,83,37,46
050,17,065,"Illinois","Hamilton County",1,46,86,45,41
050,17,065,"Illinois","Hamilton County",1,47,97,53,44
050,17,065,"Illinois","Hamilton County",1,48,97,48,49
050,17,065,"Illinois","Hamilton County",1,49,100,48,52
050,17,065,"Illinois","Hamilton County",1,50,96,46,50
050,17,065,"Illinois","Hamilton County",1,51,93,52,41
050,17,065,"Illinois","Hamilton County",1,52,95,48,47
050,17,065,"Illinois","Hamilton County",1,53,94,52,42
050,17,065,"Illinois","Hamilton County",1,54,102,54,48
050,17,065,"Illinois","Hamilton County",1,55,112,55,57
050,17,065,"Illinois","Hamilton County",1,56,121,67,54
050,17,065,"Illinois","Hamilton County",1,57,109,60,49
050,17,065,"Illinois","Hamilton County",1,58,112,57,55
050,17,065,"Illinois","Hamilton County",1,59,120,64,56
050,17,065,"Illinois","Hamilton County",1,60,115,56,59
050,17,065,"Illinois","Hamilton County",1,61,127,66,61
050,17,065,"Illinois","Hamilton County",1,62,126,61,65
050,17,065,"Illinois","Hamilton County",1,63,124,64,60
050,17,065,"Illinois","Hamilton County",1,64,124,58,66
050,17,065,"Illinois","Hamilton County",1,65,113,55,58
050,17,065,"Illinois","Hamilton County",1,66,112,55,57
050,17,065,"Illinois","Hamilton County",1,67,103,54,49
050,17,065,"Illinois","Hamilton County",1,68,105,50,55
050,17,065,"Illinois","Hamilton County",1,69,93,47,46
050,17,065,"Illinois","Hamilton County",1,70,95,50,45
050,17,065,"Illinois","Hamilton County",1,71,97,48,49
050,17,065,"Illinois","Hamilton County",1,72,89,41,48
050,17,065,"Illinois","Hamilton County",1,73,87,41,46
050,17,065,"Illinois","Hamilton County",1,74,75,37,38
050,17,065,"Illinois","Hamilton County",1,75,69,33,36
050,17,065,"Illinois","Hamilton County",1,76,76,43,33
050,17,065,"Illinois","Hamilton County",1,77,69,38,31
050,17,065,"Illinois","Hamilton County",1,78,48,22,26
050,17,065,"Illinois","Hamilton County",1,79,60,23,37
050,17,065,"Illinois","Hamilton County",1,80,58,20,38
050,17,065,"Illinois","Hamilton County",1,81,49,20,29
050,17,065,"Illinois","Hamilton County",1,82,38,12,26
050,17,065,"Illinois","Hamilton County",1,83,38,15,23
050,17,065,"Illinois","Hamilton County",1,84,46,19,27
050,17,065,"Illinois","Hamilton County",1,85,215,59,156
050,17,065,"Illinois","Hamilton County",2,0,94,49,45
050,17,065,"Illinois","Hamilton County",2,1,80,42,38
050,17,065,"Illinois","Hamilton County",2,2,80,41,39
050,17,065,"Illinois","Hamilton County",2,3,91,46,45
050,17,065,"Illinois","Hamilton County",2,4,102,53,49
050,17,065,"Illinois","Hamilton County",2,5,97,50,47
050,17,065,"Illinois","Hamilton County",2,6,84,40,44
050,17,065,"Illinois","Hamilton County",2,7,84,42,42
050,17,065,"Illinois","Hamilton County",2,8,98,47,51
050,17,065,"Illinois","Hamilton County",2,9,99,46,53
050,17,065,"Illinois","Hamilton County",2,10,99,54,45
050,17,065,"Illinois","Hamilton County",2,11,102,59,43
050,17,065,"Illinois","Hamilton County",2,12,103,56,47
050,17,065,"Illinois","Hamilton County",2,13,111,52,59
050,17,065,"Illinois","Hamilton County",2,14,120,53,67
050,17,065,"Illinois","Hamilton County",2,15,112,54,58
050,17,065,"Illinois","Hamilton County",2,16,107,55,52
050,17,065,"Illinois","Hamilton County",2,17,113,64,49
050,17,065,"Illinois","Hamilton County",2,18,95,53,42
050,17,065,"Illinois","Hamilton County",2,19,71,37,34
050,17,065,"Illinois","Hamilton County",2,20,75,37,38
050,17,065,"Illinois","Hamilton County",2,21,75,36,39
050,17,065,"Illinois","Hamilton County",2,22,76,37,39
050,17,065,"Illinois","Hamilton County",2,23,88,42,46
050,17,065,"Illinois","Hamilton County",2,24,87,45,42
050,17,065,"Illinois","Hamilton County",2,25,82,46,36
050,17,065,"Illinois","Hamilton County",2,26,83,48,35
050,17,065,"Illinois","Hamilton County",2,27,84,45,39
050,17,065,"Illinois","Hamilton County",2,28,86,43,43
050,17,065,"Illinois","Hamilton County",2,29,90,44,46
050,17,065,"Illinois","Hamilton County",2,30,90,45,45
050,17,065,"Illinois","Hamilton County",2,31,76,36,40
050,17,065,"Illinois","Hamilton County",2,32,77,35,42
050,17,065,"Illinois","Hamilton County",2,33,81,36,45
050,17,065,"Illinois","Hamilton County",2,34,85,42,43
050,17,065,"Illinois","Hamilton County",2,35,85,46,39
050,17,065,"Illinois","Hamilton County",2,36,95,53,42
050,17,065,"Illinois","Hamilton County",2,37,105,56,49
050,17,065,"Illinois","Hamilton County",2,38,97,51,46
050,17,065,"Illinois","Hamilton County",2,39,91,47,44
050,17,065,"Illinois","Hamilton County",2,40,93,43,50
050,17,065,"Illinois","Hamilton County",2,41,90,42,48
050,17,065,"Illinois","Hamilton County",2,42,95,48,47
050,17,065,"Illinois","Hamilton County",2,43,105,48,57
050,17,065,"Illinois","Hamilton County",2,44,98,43,55
050,17,065,"Illinois","Hamilton County",2,45,88,39,49
050,17,065,"Illinois","Hamilton County",2,46,85,43,42
050,17,065,"Illinois","Hamilton County",2,47,95,51,44
050,17,065,"Illinois","Hamilton County",2,48,97,50,47
050,17,065,"Illinois","Hamilton County",2,49,101,49,52
050,17,065,"Illinois","Hamilton County",2,50,96,45,51
050,17,065,"Illinois","Hamilton County",2,51,93,50,43
050,17,065,"Illinois","Hamilton County",2,52,94,49,45
050,17,065,"Illinois","Hamilton County",2,53,95,52,43
050,17,065,"Illinois","Hamilton County",2,54,99,53,46
050,17,065,"Illinois","Hamilton County",2,55,110,56,54
050,17,065,"Illinois","Hamilton County",2,56,119,64,55
050,17,065,"Illinois","Hamilton County",2,57,113,62,51
050,17,065,"Illinois","Hamilton County",2,58,112,59,53
050,17,065,"Illinois","Hamilton County",2,59,118,62,56
050,17,065,"Illinois","Hamilton County",2,60,115,57,58
050,17,065,"Illinois","Hamilton County",2,61,122,63,59
050,17,065,"Illinois","Hamilton County",2,62,126,62,64
050,17,065,"Illinois","Hamilton County",2,63,125,63,62
050,17,065,"Illinois","Hamilton County",2,64,121,58,63
050,17,065,"Illinois","Hamilton County",2,65,116,56,60
050,17,065,"Illinois","Hamilton County",2,66,113,55,58
050,17,065,"Illinois","Hamilton County",2,67,101,51,50
050,17,065,"Illinois","Hamilton County",2,68,102,49,53
050,17,065,"Illinois","Hamilton County",2,69,96,48,48
050,17,065,"Illinois","Hamilton County",2,70,93,48,45
050,17,065,"Illinois","Hamilton County",2,71,90,47,43
050,17,065,"Illinois","Hamilton County",2,72,90,42,48
050,17,065,"Illinois","Hamilton County",2,73,92,43,49
050,17,065,"Illinois","Hamilton County",2,74,74,36,38
050,17,065,"Illinois","Hamilton County",2,75,70,34,36
050,17,065,"Illinois","Hamilton County",2,76,75,41,34
050,17,065,"Illinois","Hamilton County",2,77,72,40,32
050,17,065,"Illinois","Hamilton County",2,78,53,26,27
050,17,065,"Illinois","Hamilton County",2,79,56,23,33
050,17,065,"Illinois","Hamilton County",2,80,58,21,37
050,17,065,"Illinois","Hamilton County",2,81,50,19,31
050,17,065,"Illinois","Hamilton County",2,82,41,14,27
050,17,065,"Illinois","Hamilton County",2,83,37,14,23
050,17,065,"Illinois","Hamilton County",2,84,45,19,26
050,17,065,"Illinois","Hamilton County",2,85,220,61,159
050,17,065,"Illinois","Hamilton County",3,0,77,33,44
050,17,065,"Illinois","Hamilton County",3,1,101,47,54
050,17,065,"Illinois","Hamilton County",3,2,84,44,40
050,17,065,"Illinois","Hamilton County",3,3,90,49,41
050,17,065,"Illinois","Hamilton County",3,4,98,48,50
050,17,065,"Illinois","Hamilton County",3,5,103,51,52
050,17,065,"Illinois","Hamilton County",3,6,94,50,44
050,17,065,"Illinois","Hamilton County",3,7,84,44,40
050,17,065,"Illinois","Hamilton County",3,8,85,41,44
050,17,065,"Illinois","Hamilton County",3,9,98,47,51
050,17,065,"Illinois","Hamilton County",3,10,95,41,54
050,17,065,"Illinois","Hamilton County",3,11,101,52,49
050,17,065,"Illinois","Hamilton County",3,12,100,57,43
050,17,065,"Illinois","Hamilton County",3,13,98,51,47
050,17,065,"Illinois","Hamilton County",3,14,112,54,58
050,17,065,"Illinois","Hamilton County",3,15,118,52,66
050,17,065,"Illinois","Hamilton County",3,16,109,52,57
050,17,065,"Illinois","Hamilton County",3,17,104,54,50
050,17,065,"Illinois","Hamilton County",3,18,97,55,42
050,17,065,"Illinois","Hamilton County",3,19,70,40,30
050,17,065,"Illinois","Hamilton County",3,20,75,40,35
050,17,065,"Illinois","Hamilton County",3,21,72,36,36
050,17,065,"Illinois","Hamilton County",3,22,69,32,37
050,17,065,"Illinois","Hamilton County",3,23,76,38,38
050,17,065,"Illinois","Hamilton County",3,24,88,42,46
050,17,065,"Illinois","Hamilton County",3,25,98,45,53
050,17,065,"Illinois","Hamilton County",3,26,83,46,37
050,17,065,"Illinois","Hamilton County",3,27,79,46,33
050,17,065,"Illinois","Hamilton County",3,28,84,46,38
050,17,065,"Illinois","Hamilton County",3,29,86,42,44
050,17,065,"Illinois","Hamilton County",3,30,92,45,47
050,17,065,"Illinois","Hamilton County",3,31,95,46,49
050,17,065,"Illinois","Hamilton County",3,32,84,41,43
050,17,065,"Illinois","Hamilton County",3,33,80,36,44
050,17,065,"Illinois","Hamilton County",3,34,91,43,48
050,17,065,"Illinois","Hamilton County",3,35,87,43,44
050,17,065,"Illinois","Hamilton County",3,36,81,43,38
050,17,065,"Illinois","Hamilton County",3,37,95,53,42
050,17,065,"Illinois","Hamilton County",3,38,107,59,48
050,17,065,"Illinois","Hamilton County",3,39,96,51,45
050,17,065,"Illinois","Hamilton County",3,40,95,48,47
050,17,065,"Illinois","Hamilton County",3,41,90,42,48
050,17,065,"Illinois","Hamilton County",3,42,88,40,48
050,17,065,"Illinois","Hamilton County",3,43,89,48,41
050,17,065,"Illinois","Hamilton County",3,44,100,49,51
050,17,065,"Illinois","Hamilton County",3,45,98,44,54
050,17,065,"Illinois","Hamilton County",3,46,84,36,48
050,17,065,"Illinois","Hamilton County",3,47,82,40,42
050,17,065,"Illinois","Hamilton County",3,48,95,51,44
050,17,065,"Illinois","Hamilton County",3,49,96,52,44
050,17,065,"Illinois","Hamilton County",3,50,100,47,53
050,17,065,"Illinois","Hamilton County",3,51,93,43,50
050,17,065,"Illinois","Hamilton County",3,52,92,51,41
050,17,065,"Illinois","Hamilton County",3,53,91,49,42
050,17,065,"Illinois","Hamilton County",3,54,98,52,46
050,17,065,"Illinois","Hamilton County",3,55,95,51,44
050,17,065,"Illinois","Hamilton County",3,56,115,57,58
050,17,065,"Illinois","Hamilton County",3,57,115,62,53
050,17,065,"Illinois","Hamilton County",3,58,113,61,52
050,17,065,"Illinois","Hamilton County",3,59,109,57,52
050,17,065,"Illinois","Hamilton County",3,60,116,61,55
050,17,065,"Illinois","Hamilton County",3,61,113,57,56
050,17,065,"Illinois","Hamilton County",3,62,116,63,53
050,17,065,"Illinois","Hamilton County",3,63,124,59,65
050,17,065,"Illinois","Hamilton County",3,64,120,64,56
050,17,065,"Illinois","Hamilton County",3,65,119,57,62
050,17,065,"Illinois","Hamilton County",3,66,119,58,61
050,17,065,"Illinois","Hamilton County",3,67,111,53,58
050,17,065,"Illinois","Hamilton County",3,68,99,51,48
050,17,065,"Illinois","Hamilton County",3,69,96,46,50
050,17,065,"Illinois","Hamilton County",3,70,95,46,49
050,17,065,"Illinois","Hamilton County",3,71,87,44,43
050,17,065,"Illinois","Hamilton County",3,72,86,45,41
050,17,065,"Illinois","Hamilton County",3,73,87,39,48
050,17,065,"Illinois","Hamilton County",3,74,91,41,50
050,17,065,"Illinois","Hamilton County",3,75,70,35,35
050,17,065,"Illinois","Hamilton County",3,76,69,33,36
050,17,065,"Illinois","Hamilton County",3,77,67,36,31
050,17,065,"Illinois","Hamilton County",3,78,69,39,30
050,17,065,"Illinois","Hamilton County",3,79,48,26,22
050,17,065,"Illinois","Hamilton County",3,80,51,21,30
050,17,065,"Illinois","Hamilton County",3,81,54,19,35
050,17,065,"Illinois","Hamilton County",3,82,47,15,32
050,17,065,"Illinois","Hamilton County",3,83,30,13,17
050,17,065,"Illinois","Hamilton County",3,84,35,14,21
050,17,065,"Illinois","Hamilton County",3,85,220,63,157
050,17,065,"Illinois","Hamilton County",4,0,77,35,42
050,17,065,"Illinois","Hamilton County",4,1,77,34,43
050,17,065,"Illinois","Hamilton County",4,2,107,55,52
050,17,065,"Illinois","Hamilton County",4,3,86,45,41
050,17,065,"Illinois","Hamilton County",4,4,88,46,42
050,17,065,"Illinois","Hamilton County",4,5,101,49,52
050,17,065,"Illinois","Hamilton County",4,6,114,57,57
050,17,065,"Illinois","Hamilton County",4,7,100,59,41
050,17,065,"Illinois","Hamilton County",4,8,94,43,51
050,17,065,"Illinois","Hamilton County",4,9,91,44,47
050,17,065,"Illinois","Hamilton County",4,10,106,49,57
050,17,065,"Illinois","Hamilton County",4,11,99,43,56
050,17,065,"Illinois","Hamilton County",4,12,105,56,49
050,17,065,"Illinois","Hamilton County",4,13,106,61,45
050,17,065,"Illinois","Hamilton County",4,14,104,56,48
050,17,065,"Illinois","Hamilton County",4,15,113,54,59
050,17,065,"Illinois","Hamilton County",4,16,116,50,66
050,17,065,"Illinois","Hamilton County",4,17,111,55,56
050,17,065,"Illinois","Hamilton County",4,18,93,52,41
050,17,065,"Illinois","Hamilton County",4,19,70,40,30
050,17,065,"Illinois","Hamilton County",4,20,77,46,31
050,17,065,"Illinois","Hamilton County",4,21,81,39,42
050,17,065,"Illinois","Hamilton County",4,22,77,34,43
050,17,065,"Illinois","Hamilton County",4,23,68,38,30
050,17,065,"Illinois","Hamilton County",4,24,78,40,38
050,17,065,"Illinois","Hamilton County",4,25,91,43,48
050,17,065,"Illinois","Hamilton County",4,26,92,47,45
050,17,065,"Illinois","Hamilton County",4,27,71,39,32
050,17,065,"Illinois","Hamilton County",4,28,76,45,31
050,17,065,"Illinois","Hamilton County",4,29,84,46,38
050,17,065,"Illinois","Hamilton County",4,30,82,37,45
050,17,065,"Illinois","Hamilton County",4,31,91,43,48
050,17,065,"Illinois","Hamilton County",4,32,102,49,53
050,17,065,"Illinois","Hamilton County",4,33,87,43,44
050,17,065,"Illinois","Hamilton County",4,34,86,39,47
050,17,065,"Illinois","Hamilton County",4,35,91,43,48
050,17,065,"Illinois","Hamilton County",4,36,89,45,44
050,17,065,"Illinois","Hamilton County",4,37,86,46,40
050,17,065,"Illinois","Hamilton County",4,38,105,57,48
050,17,065,"Illinois","Hamilton County",4,39,113,61,52
050,17,065,"Illinois","Hamilton County",4,40,107,57,50
050,17,065,"Illinois","Hamilton County",4,41,96,48,48
050,17,065,"Illinois","Hamilton County",4,42,96,47,49
050,17,065,"Illinois","Hamilton County",4,43,90,40,50
050,17,065,"Illinois","Hamilton County",4,44,91,52,39
050,17,065,"Illinois","Hamilton County",4,45,101,49,52
050,17,065,"Illinois","Hamilton County",4,46,93,43,50
050,17,065,"Illinois","Hamilton County",4,47,85,39,46
050,17,065,"Illinois","Hamilton County",4,48,81,38,43
050,17,065,"Illinois","Hamilton County",4,49,99,54,45
050,17,065,"Illinois","Hamilton County",4,50,94,48,46
050,17,065,"Illinois","Hamilton County",4,51,100,46,54
050,17,065,"Illinois","Hamilton County",4,52,92,43,49
050,17,065,"Illinois","Hamilton County",4,53,99,53,46
050,17,065,"Illinois","Hamilton County",4,54,89,50,39
050,17,065,"Illinois","Hamilton County",4,55,99,53,46
050,17,065,"Illinois","Hamilton County",4,56,98,54,44
050,17,065,"Illinois","Hamilton County",4,57,111,56,55
050,17,065,"Illinois","Hamilton County",4,58,116,61,55
050,17,065,"Illinois","Hamilton County",4,59,111,59,52
050,17,065,"Illinois","Hamilton County",4,60,111,57,54
050,17,065,"Illinois","Hamilton County",4,61,119,60,59
050,17,065,"Illinois","Hamilton County",4,62,107,55,52
050,17,065,"Illinois","Hamilton County",4,63,117,62,55
050,17,065,"Illinois","Hamilton County",4,64,121,58,63
050,17,065,"Illinois","Hamilton County",4,65,120,65,55
050,17,065,"Illinois","Hamilton County",4,66,120,58,62
050,17,065,"Illinois","Hamilton County",4,67,112,51,61
050,17,065,"Illinois","Hamilton County",4,68,108,52,56
050,17,065,"Illinois","Hamilton County",4,69,95,50,45
050,17,065,"Illinois","Hamilton County",4,70,91,44,47
050,17,065,"Illinois","Hamilton County",4,71,88,42,46
050,17,065,"Illinois","Hamilton County",4,72,86,44,42
050,17,065,"Illinois","Hamilton County",4,73,81,43,38
050,17,065,"Illinois","Hamilton County",4,74,85,37,48
050,17,065,"Illinois","Hamilton County",4,75,89,42,47
050,17,065,"Illinois","Hamilton County",4,76,70,31,39
050,17,065,"Illinois","Hamilton County",4,77,62,31,31
050,17,065,"Illinois","Hamilton County",4,78,69,36,33
050,17,065,"Illinois","Hamilton County",4,79,68,39,29
050,17,065,"Illinois","Hamilton County",4,80,45,24,21
050,17,065,"Illinois","Hamilton County",4,81,48,20,28
050,17,065,"Illinois","Hamilton County",4,82,53,17,36
050,17,065,"Illinois","Hamilton County",4,83,38,14,24
050,17,065,"Illinois","Hamilton County",4,84,28,14,14
050,17,065,"Illinois","Hamilton County",4,85,217,64,153
050,17,065,"Illinois","Hamilton County",5,0,73,32,41
050,17,065,"Illinois","Hamilton County",5,1,76,37,39
050,17,065,"Illinois","Hamilton County",5,2,75,34,41
050,17,065,"Illinois","Hamilton County",5,3,109,57,52
050,17,065,"Illinois","Hamilton County",5,4,89,48,41
050,17,065,"Illinois","Hamilton County",5,5,87,46,41
050,17,065,"Illinois","Hamilton County",5,6,101,48,53
050,17,065,"Illinois","Hamilton County",5,7,114,61,53
050,17,065,"Illinois","Hamilton County",5,8,102,60,42
050,17,065,"Illinois","Hamilton County",5,9,97,43,54
050,17,065,"Illinois","Hamilton County",5,10,88,40,48
050,17,065,"Illinois","Hamilton County",5,11,103,51,52
050,17,065,"Illinois","Hamilton County",5,12,93,42,51
050,17,065,"Illinois","Hamilton County",5,13,104,54,50
050,17,065,"Illinois","Hamilton County",5,14,117,68,49
050,17,065,"Illinois","Hamilton County",5,15,110,55,55
050,17,065,"Illinois","Hamilton County",5,16,109,52,57
050,17,065,"Illinois","Hamilton County",5,17,120,54,66
050,17,065,"Illinois","Hamilton County",5,18,94,48,46
050,17,065,"Illinois","Hamilton County",5,19,67,33,34
050,17,065,"Illinois","Hamilton County",5,20,75,41,34
050,17,065,"Illinois","Hamilton County",5,21,82,49,33
050,17,065,"Illinois","Hamilton County",5,22,97,44,53
050,17,065,"Illinois","Hamilton County",5,23,85,39,46
050,17,065,"Illinois","Hamilton County",5,24,73,41,32
050,17,065,"Illinois","Hamilton County",5,25,79,39,40
050,17,065,"Illinois","Hamilton County",5,26,80,35,45
050,17,065,"Illinois","Hamilton County",5,27,84,47,37
050,17,065,"Illinois","Hamilton County",5,28,76,41,35
050,17,065,"Illinois","Hamilton County",5,29,75,46,29
050,17,065,"Illinois","Hamilton County",5,30,83,47,36
050,17,065,"Illinois","Hamilton County",5,31,79,34,45
050,17,065,"Illinois","Hamilton County",5,32,90,42,48
050,17,065,"Illinois","Hamilton County",5,33,98,48,50
050,17,065,"Illinois","Hamilton County",5,34,86,44,42
050,17,065,"Illinois","Hamilton County",5,35,82,38,44
050,17,065,"Illinois","Hamilton County",5,36,89,42,47
050,17,065,"Illinois","Hamilton County",5,37,96,50,46
050,17,065,"Illinois","Hamilton County",5,38,83,43,40
050,17,065,"Illinois","Hamilton County",5,39,104,56,48
050,17,065,"Illinois","Hamilton County",5,40,118,64,54
050,17,065,"Illinois","Hamilton County",5,41,105,57,48
050,17,065,"Illinois","Hamilton County",5,42,90,45,45
050,17,065,"Illinois","Hamilton County",5,43,99,48,51
050,17,065,"Illinois","Hamilton County",5,44,89,40,49
050,17,065,"Illinois","Hamilton County",5,45,91,51,40
050,17,065,"Illinois","Hamilton County",5,46,101,50,51
050,17,065,"Illinois","Hamilton County",5,47,86,44,42
050,17,065,"Illinois","Hamilton County",5,48,88,39,49
050,17,065,"Illinois","Hamilton County",5,49,79,40,39
050,17,065,"Illinois","Hamilton County",5,50,95,55,40
050,17,065,"Illinois","Hamilton County",5,51,93,47,46
050,17,065,"Illinois","Hamilton County",5,52,97,44,53
050,17,065,"Illinois","Hamilton County",5,53,93,42,51
050,17,065,"Illinois","Hamilton County",5,54,100,54,46
050,17,065,"Illinois","Hamilton County",5,55,86,48,38
050,17,065,"Illinois","Hamilton County",5,56,99,53,46
050,17,065,"Illinois","Hamilton County",5,57,95,51,44
050,17,065,"Illinois","Hamilton County",5,58,112,56,56
050,17,065,"Illinois","Hamilton County",5,59,113,59,54
050,17,065,"Illinois","Hamilton County",5,60,109,59,50
050,17,065,"Illinois","Hamilton County",5,61,109,57,52
050,17,065,"Illinois","Hamilton County",5,62,114,58,56
050,17,065,"Illinois","Hamilton County",5,63,109,54,55
050,17,065,"Illinois","Hamilton County",5,64,117,65,52
050,17,065,"Illinois","Hamilton County",5,65,121,55,66
050,17,065,"Illinois","Hamilton County",5,66,118,63,55
050,17,065,"Illinois","Hamilton County",5,67,114,55,59
050,17,065,"Illinois","Hamilton County",5,68,108,52,56
050,17,065,"Illinois","Hamilton County",5,69,108,52,56
050,17,065,"Illinois","Hamilton County",5,70,95,49,46
050,17,065,"Illinois","Hamilton County",5,71,83,39,44
050,17,065,"Illinois","Hamilton County",5,72,84,40,44
050,17,065,"Illinois","Hamilton County",5,73,81,42,39
050,17,065,"Illinois","Hamilton County",5,74,78,40,38
050,17,065,"Illinois","Hamilton County",5,75,77,37,40
050,17,065,"Illinois","Hamilton County",5,76,85,35,50
050,17,065,"Illinois","Hamilton County",5,77,64,28,36
050,17,065,"Illinois","Hamilton County",5,78,63,31,32
050,17,065,"Illinois","Hamilton County",5,79,68,36,32
050,17,065,"Illinois","Hamilton County",5,80,63,36,27
050,17,065,"Illinois","Hamilton County",5,81,42,23,19
050,17,065,"Illinois","Hamilton County",5,82,48,18,30
050,17,065,"Illinois","Hamilton County",5,83,46,16,30
050,17,065,"Illinois","Hamilton County",5,84,37,15,22
050,17,065,"Illinois","Hamilton County",5,85,217,68,149
050,17,067,"Illinois","Hancock County",1,0,178,92,86
050,17,067,"Illinois","Hancock County",1,1,173,85,88
050,17,067,"Illinois","Hancock County",1,2,181,87,94
050,17,067,"Illinois","Hancock County",1,3,184,96,88
050,17,067,"Illinois","Hancock County",1,4,211,92,119
050,17,067,"Illinois","Hancock County",1,5,220,115,105
050,17,067,"Illinois","Hancock County",1,6,207,97,110
050,17,067,"Illinois","Hancock County",1,7,197,109,88
050,17,067,"Illinois","Hancock County",1,8,183,106,77
050,17,067,"Illinois","Hancock County",1,9,191,100,91
050,17,067,"Illinois","Hancock County",1,10,233,124,109
050,17,067,"Illinois","Hancock County",1,11,221,120,101
050,17,067,"Illinois","Hancock County",1,12,232,122,110
050,17,067,"Illinois","Hancock County",1,13,243,125,118
050,17,067,"Illinois","Hancock County",1,14,242,125,117
050,17,067,"Illinois","Hancock County",1,15,216,113,103
050,17,067,"Illinois","Hancock County",1,16,225,113,112
050,17,067,"Illinois","Hancock County",1,17,213,104,109
050,17,067,"Illinois","Hancock County",1,18,187,89,98
050,17,067,"Illinois","Hancock County",1,19,144,72,72
050,17,067,"Illinois","Hancock County",1,20,154,86,68
050,17,067,"Illinois","Hancock County",1,21,151,81,70
050,17,067,"Illinois","Hancock County",1,22,168,81,87
050,17,067,"Illinois","Hancock County",1,23,171,80,91
050,17,067,"Illinois","Hancock County",1,24,172,90,82
050,17,067,"Illinois","Hancock County",1,25,172,91,81
050,17,067,"Illinois","Hancock County",1,26,187,98,89
050,17,067,"Illinois","Hancock County",1,27,178,94,84
050,17,067,"Illinois","Hancock County",1,28,199,102,97
050,17,067,"Illinois","Hancock County",1,29,203,107,96
050,17,067,"Illinois","Hancock County",1,30,170,93,77
050,17,067,"Illinois","Hancock County",1,31,163,87,76
050,17,067,"Illinois","Hancock County",1,32,171,84,87
050,17,067,"Illinois","Hancock County",1,33,176,90,86
050,17,067,"Illinois","Hancock County",1,34,184,84,100
050,17,067,"Illinois","Hancock County",1,35,212,106,106
050,17,067,"Illinois","Hancock County",1,36,205,112,93
050,17,067,"Illinois","Hancock County",1,37,206,106,100
050,17,067,"Illinois","Hancock County",1,38,184,87,97
050,17,067,"Illinois","Hancock County",1,39,197,96,101
050,17,067,"Illinois","Hancock County",1,40,204,95,109
050,17,067,"Illinois","Hancock County",1,41,208,95,113
050,17,067,"Illinois","Hancock County",1,42,190,97,93
050,17,067,"Illinois","Hancock County",1,43,181,83,98
050,17,067,"Illinois","Hancock County",1,44,179,90,89
050,17,067,"Illinois","Hancock County",1,45,204,117,87
050,17,067,"Illinois","Hancock County",1,46,190,108,82
050,17,067,"Illinois","Hancock County",1,47,172,87,85
050,17,067,"Illinois","Hancock County",1,48,200,98,102
050,17,067,"Illinois","Hancock County",1,49,209,105,104
050,17,067,"Illinois","Hancock County",1,50,210,109,101
050,17,067,"Illinois","Hancock County",1,51,207,106,101
050,17,067,"Illinois","Hancock County",1,52,209,112,97
050,17,067,"Illinois","Hancock County",1,53,231,129,102
050,17,067,"Illinois","Hancock County",1,54,242,122,120
050,17,067,"Illinois","Hancock County",1,55,257,123,134
050,17,067,"Illinois","Hancock County",1,56,268,135,133
050,17,067,"Illinois","Hancock County",1,57,256,122,134
050,17,067,"Illinois","Hancock County",1,58,290,147,143
050,17,067,"Illinois","Hancock County",1,59,271,146,125
050,17,067,"Illinois","Hancock County",1,60,278,147,131
050,17,067,"Illinois","Hancock County",1,61,287,145,142
050,17,067,"Illinois","Hancock County",1,62,282,139,143
050,17,067,"Illinois","Hancock County",1,63,256,134,122
050,17,067,"Illinois","Hancock County",1,64,293,149,144
050,17,067,"Illinois","Hancock County",1,65,302,154,148
050,17,067,"Illinois","Hancock County",1,66,258,130,128
050,17,067,"Illinois","Hancock County",1,67,245,124,121
050,17,067,"Illinois","Hancock County",1,68,245,118,127
050,17,067,"Illinois","Hancock County",1,69,212,104,108
050,17,067,"Illinois","Hancock County",1,70,242,123,119
050,17,067,"Illinois","Hancock County",1,71,245,125,120
050,17,067,"Illinois","Hancock County",1,72,231,113,118
050,17,067,"Illinois","Hancock County",1,73,224,106,118
050,17,067,"Illinois","Hancock County",1,74,145,67,78
050,17,067,"Illinois","Hancock County",1,75,156,68,88
050,17,067,"Illinois","Hancock County",1,76,156,68,88
050,17,067,"Illinois","Hancock County",1,77,154,64,90
050,17,067,"Illinois","Hancock County",1,78,138,57,81
050,17,067,"Illinois","Hancock County",1,79,135,59,76
050,17,067,"Illinois","Hancock County",1,80,117,53,64
050,17,067,"Illinois","Hancock County",1,81,119,54,65
050,17,067,"Illinois","Hancock County",1,82,105,52,53
050,17,067,"Illinois","Hancock County",1,83,91,36,55
050,17,067,"Illinois","Hancock County",1,84,90,44,46
050,17,067,"Illinois","Hancock County",1,85,525,197,328
050,17,067,"Illinois","Hancock County",2,0,177,95,82
050,17,067,"Illinois","Hancock County",2,1,173,86,87
050,17,067,"Illinois","Hancock County",2,2,181,88,93
050,17,067,"Illinois","Hancock County",2,3,182,93,89
050,17,067,"Illinois","Hancock County",2,4,208,96,112
050,17,067,"Illinois","Hancock County",2,5,220,110,110
050,17,067,"Illinois","Hancock County",2,6,212,103,109
050,17,067,"Illinois","Hancock County",2,7,199,106,93
050,17,067,"Illinois","Hancock County",2,8,186,107,79
050,17,067,"Illinois","Hancock County",2,9,188,101,87
050,17,067,"Illinois","Hancock County",2,10,221,118,103
050,17,067,"Illinois","Hancock County",2,11,220,120,100
050,17,067,"Illinois","Hancock County",2,12,228,121,107
050,17,067,"Illinois","Hancock County",2,13,239,124,115
050,17,067,"Illinois","Hancock County",2,14,241,125,116
050,17,067,"Illinois","Hancock County",2,15,220,114,106
050,17,067,"Illinois","Hancock County",2,16,224,114,110
050,17,067,"Illinois","Hancock County",2,17,216,106,110
050,17,067,"Illinois","Hancock County",2,18,182,87,95
050,17,067,"Illinois","Hancock County",2,19,144,70,74
050,17,067,"Illinois","Hancock County",2,20,156,84,72
050,17,067,"Illinois","Hancock County",2,21,155,84,71
050,17,067,"Illinois","Hancock County",2,22,167,82,85
050,17,067,"Illinois","Hancock County",2,23,172,82,90
050,17,067,"Illinois","Hancock County",2,24,174,89,85
050,17,067,"Illinois","Hancock County",2,25,172,91,81
050,17,067,"Illinois","Hancock County",2,26,181,94,87
050,17,067,"Illinois","Hancock County",2,27,179,94,85
050,17,067,"Illinois","Hancock County",2,28,194,101,93
050,17,067,"Illinois","Hancock County",2,29,200,104,96
050,17,067,"Illinois","Hancock County",2,30,179,97,82
050,17,067,"Illinois","Hancock County",2,31,164,88,76
050,17,067,"Illinois","Hancock County",2,32,171,86,85
050,17,067,"Illinois","Hancock County",2,33,173,88,85
050,17,067,"Illinois","Hancock County",2,34,183,86,97
050,17,067,"Illinois","Hancock County",2,35,203,100,103
050,17,067,"Illinois","Hancock County",2,36,203,109,94
050,17,067,"Illinois","Hancock County",2,37,206,107,99
050,17,067,"Illinois","Hancock County",2,38,189,92,97
050,17,067,"Illinois","Hancock County",2,39,192,93,99
050,17,067,"Illinois","Hancock County",2,40,203,95,108
050,17,067,"Illinois","Hancock County",2,41,204,93,111
050,17,067,"Illinois","Hancock County",2,42,192,95,97
050,17,067,"Illinois","Hancock County",2,43,184,86,98
050,17,067,"Illinois","Hancock County",2,44,178,87,91
050,17,067,"Illinois","Hancock County",2,45,199,111,88
050,17,067,"Illinois","Hancock County",2,46,191,110,81
050,17,067,"Illinois","Hancock County",2,47,176,91,85
050,17,067,"Illinois","Hancock County",2,48,195,97,98
050,17,067,"Illinois","Hancock County",2,49,208,104,104
050,17,067,"Illinois","Hancock County",2,50,210,108,102
050,17,067,"Illinois","Hancock County",2,51,206,106,100
050,17,067,"Illinois","Hancock County",2,52,205,109,96
050,17,067,"Illinois","Hancock County",2,53,224,124,100
050,17,067,"Illinois","Hancock County",2,54,238,123,115
050,17,067,"Illinois","Hancock County",2,55,255,124,131
050,17,067,"Illinois","Hancock County",2,56,266,133,133
050,17,067,"Illinois","Hancock County",2,57,258,124,134
050,17,067,"Illinois","Hancock County",2,58,280,141,139
050,17,067,"Illinois","Hancock County",2,59,275,146,129
050,17,067,"Illinois","Hancock County",2,60,273,145,128
050,17,067,"Illinois","Hancock County",2,61,283,144,139
050,17,067,"Illinois","Hancock County",2,62,282,140,142
050,17,067,"Illinois","Hancock County",2,63,263,136,127
050,17,067,"Illinois","Hancock County",2,64,281,145,136
050,17,067,"Illinois","Hancock County",2,65,295,150,145
050,17,067,"Illinois","Hancock County",2,66,266,134,132
050,17,067,"Illinois","Hancock County",2,67,244,122,122
050,17,067,"Illinois","Hancock County",2,68,244,118,126
050,17,067,"Illinois","Hancock County",2,69,221,108,113
050,17,067,"Illinois","Hancock County",2,70,232,117,115
050,17,067,"Illinois","Hancock County",2,71,245,124,121
050,17,067,"Illinois","Hancock County",2,72,231,114,117
050,17,067,"Illinois","Hancock County",2,73,232,111,121
050,17,067,"Illinois","Hancock County",2,74,154,72,82
050,17,067,"Illinois","Hancock County",2,75,154,68,86
050,17,067,"Illinois","Hancock County",2,76,153,67,86
050,17,067,"Illinois","Hancock County",2,77,154,64,90
050,17,067,"Illinois","Hancock County",2,78,138,56,82
050,17,067,"Illinois","Hancock County",2,79,132,57,75
050,17,067,"Illinois","Hancock County",2,80,118,52,66
050,17,067,"Illinois","Hancock County",2,81,118,53,65
050,17,067,"Illinois","Hancock County",2,82,103,49,54
050,17,067,"Illinois","Hancock County",2,83,95,40,55
050,17,067,"Illinois","Hancock County",2,84,88,41,47
050,17,067,"Illinois","Hancock County",2,85,523,197,326
050,17,067,"Illinois","Hancock County",3,0,177,95,82
050,17,067,"Illinois","Hancock County",3,1,173,93,80
050,17,067,"Illinois","Hancock County",3,2,170,87,83
050,17,067,"Illinois","Hancock County",3,3,175,85,90
050,17,067,"Illinois","Hancock County",3,4,182,98,84
050,17,067,"Illinois","Hancock County",3,5,204,94,110
050,17,067,"Illinois","Hancock County",3,6,221,113,108
050,17,067,"Illinois","Hancock County",3,7,208,102,106
050,17,067,"Illinois","Hancock County",3,8,204,111,93
050,17,067,"Illinois","Hancock County",3,9,192,107,85
050,17,067,"Illinois","Hancock County",3,10,199,103,96
050,17,067,"Illinois","Hancock County",3,11,231,125,106
050,17,067,"Illinois","Hancock County",3,12,216,115,101
050,17,067,"Illinois","Hancock County",3,13,230,122,108
050,17,067,"Illinois","Hancock County",3,14,245,123,122
050,17,067,"Illinois","Hancock County",3,15,238,121,117
050,17,067,"Illinois","Hancock County",3,16,217,109,108
050,17,067,"Illinois","Hancock County",3,17,227,115,112
050,17,067,"Illinois","Hancock County",3,18,179,93,86
050,17,067,"Illinois","Hancock County",3,19,143,67,76
050,17,067,"Illinois","Hancock County",3,20,152,77,75
050,17,067,"Illinois","Hancock County",3,21,170,88,82
050,17,067,"Illinois","Hancock County",3,22,159,83,76
050,17,067,"Illinois","Hancock County",3,23,165,88,77
050,17,067,"Illinois","Hancock County",3,24,162,83,79
050,17,067,"Illinois","Hancock County",3,25,171,91,80
050,17,067,"Illinois","Hancock County",3,26,171,94,77
050,17,067,"Illinois","Hancock County",3,27,184,99,85
050,17,067,"Illinois","Hancock County",3,28,180,96,84
050,17,067,"Illinois","Hancock County",3,29,191,93,98
050,17,067,"Illinois","Hancock County",3,30,199,103,96
050,17,067,"Illinois","Hancock County",3,31,175,95,80
050,17,067,"Illinois","Hancock County",3,32,159,80,79
050,17,067,"Illinois","Hancock County",3,33,172,85,87
050,17,067,"Illinois","Hancock County",3,34,180,93,87
050,17,067,"Illinois","Hancock County",3,35,183,84,99
050,17,067,"Illinois","Hancock County",3,36,200,101,99
050,17,067,"Illinois","Hancock County",3,37,200,109,91
050,17,067,"Illinois","Hancock County",3,38,211,108,103
050,17,067,"Illinois","Hancock County",3,39,199,100,99
050,17,067,"Illinois","Hancock County",3,40,188,95,93
050,17,067,"Illinois","Hancock County",3,41,203,95,108
050,17,067,"Illinois","Hancock County",3,42,204,95,109
050,17,067,"Illinois","Hancock County",3,43,186,90,96
050,17,067,"Illinois","Hancock County",3,44,187,89,98
050,17,067,"Illinois","Hancock County",3,45,175,83,92
050,17,067,"Illinois","Hancock County",3,46,200,112,88
050,17,067,"Illinois","Hancock County",3,47,187,110,77
050,17,067,"Illinois","Hancock County",3,48,172,88,84
050,17,067,"Illinois","Hancock County",3,49,197,98,99
050,17,067,"Illinois","Hancock County",3,50,211,104,107
050,17,067,"Illinois","Hancock County",3,51,208,107,101
050,17,067,"Illinois","Hancock County",3,52,213,109,104
050,17,067,"Illinois","Hancock County",3,53,201,106,95
050,17,067,"Illinois","Hancock County",3,54,220,122,98
050,17,067,"Illinois","Hancock County",3,55,239,122,117
050,17,067,"Illinois","Hancock County",3,56,246,116,130
050,17,067,"Illinois","Hancock County",3,57,262,134,128
050,17,067,"Illinois","Hancock County",3,58,256,119,137
050,17,067,"Illinois","Hancock County",3,59,271,137,134
050,17,067,"Illinois","Hancock County",3,60,274,148,126
050,17,067,"Illinois","Hancock County",3,61,268,139,129
050,17,067,"Illinois","Hancock County",3,62,284,146,138
050,17,067,"Illinois","Hancock County",3,63,281,140,141
050,17,067,"Illinois","Hancock County",3,64,263,135,128
050,17,067,"Illinois","Hancock County",3,65,268,135,133
050,17,067,"Illinois","Hancock County",3,66,293,148,145
050,17,067,"Illinois","Hancock County",3,67,266,133,133
050,17,067,"Illinois","Hancock County",3,68,238,118,120
050,17,067,"Illinois","Hancock County",3,69,239,117,122
050,17,067,"Illinois","Hancock County",3,70,218,108,110
050,17,067,"Illinois","Hancock County",3,71,218,104,114
050,17,067,"Illinois","Hancock County",3,72,239,121,118
050,17,067,"Illinois","Hancock County",3,73,226,112,114
050,17,067,"Illinois","Hancock County",3,74,216,107,109
050,17,067,"Illinois","Hancock County",3,75,151,68,83
050,17,067,"Illinois","Hancock County",3,76,148,65,83
050,17,067,"Illinois","Hancock County",3,77,146,62,84
050,17,067,"Illinois","Hancock County",3,78,147,57,90
050,17,067,"Illinois","Hancock County",3,79,124,52,72
050,17,067,"Illinois","Hancock County",3,80,127,53,74
050,17,067,"Illinois","Hancock County",3,81,116,54,62
050,17,067,"Illinois","Hancock County",3,82,104,45,59
050,17,067,"Illinois","Hancock County",3,83,100,48,52
050,17,067,"Illinois","Hancock County",3,84,80,34,46
050,17,067,"Illinois","Hancock County",3,85,502,188,314
050,17,067,"Illinois","Hancock County",4,0,171,87,84
050,17,067,"Illinois","Hancock County",4,1,171,93,78
050,17,067,"Illinois","Hancock County",4,2,176,94,82
050,17,067,"Illinois","Hancock County",4,3,184,91,93
050,17,067,"Illinois","Hancock County",4,4,175,83,92
050,17,067,"Illinois","Hancock County",4,5,193,105,88
050,17,067,"Illinois","Hancock County",4,6,208,100,108
050,17,067,"Illinois","Hancock County",4,7,226,119,107
050,17,067,"Illinois","Hancock County",4,8,210,104,106
050,17,067,"Illinois","Hancock County",4,9,208,113,95
050,17,067,"Illinois","Hancock County",4,10,199,116,83
050,17,067,"Illinois","Hancock County",4,11,198,100,98
050,17,067,"Illinois","Hancock County",4,12,231,120,111
050,17,067,"Illinois","Hancock County",4,13,212,113,99
050,17,067,"Illinois","Hancock County",4,14,233,122,111
050,17,067,"Illinois","Hancock County",4,15,243,121,122
050,17,067,"Illinois","Hancock County",4,16,239,120,119
050,17,067,"Illinois","Hancock County",4,17,220,118,102
050,17,067,"Illinois","Hancock County",4,18,190,100,90
050,17,067,"Illinois","Hancock County",4,19,122,65,57
050,17,067,"Illinois","Hancock County",4,20,137,65,72
050,17,067,"Illinois","Hancock County",4,21,165,81,84
050,17,067,"Illinois","Hancock County",4,22,175,89,86
050,17,067,"Illinois","Hancock County",4,23,170,89,81
050,17,067,"Illinois","Hancock County",4,24,171,90,81
050,17,067,"Illinois","Hancock County",4,25,162,90,72
050,17,067,"Illinois","Hancock County",4,26,168,85,83
050,17,067,"Illinois","Hancock County",4,27,175,98,77
050,17,067,"Illinois","Hancock County",4,28,186,106,80
050,17,067,"Illinois","Hancock County",4,29,181,101,80
050,17,067,"Illinois","Hancock County",4,30,192,96,96
050,17,067,"Illinois","Hancock County",4,31,197,102,95
050,17,067,"Illinois","Hancock County",4,32,172,90,82
050,17,067,"Illinois","Hancock County",4,33,164,80,84
050,17,067,"Illinois","Hancock County",4,34,175,85,90
050,17,067,"Illinois","Hancock County",4,35,185,90,95
050,17,067,"Illinois","Hancock County",4,36,179,86,93
050,17,067,"Illinois","Hancock County",4,37,206,104,102
050,17,067,"Illinois","Hancock County",4,38,201,109,92
050,17,067,"Illinois","Hancock County",4,39,214,109,105
050,17,067,"Illinois","Hancock County",4,40,196,97,99
050,17,067,"Illinois","Hancock County",4,41,186,94,92
050,17,067,"Illinois","Hancock County",4,42,197,91,106
050,17,067,"Illinois","Hancock County",4,43,199,96,103
050,17,067,"Illinois","Hancock County",4,44,190,93,97
050,17,067,"Illinois","Hancock County",4,45,190,91,99
050,17,067,"Illinois","Hancock County",4,46,172,84,88
050,17,067,"Illinois","Hancock County",4,47,186,106,80
050,17,067,"Illinois","Hancock County",4,48,183,101,82
050,17,067,"Illinois","Hancock County",4,49,162,79,83
050,17,067,"Illinois","Hancock County",4,50,191,96,95
050,17,067,"Illinois","Hancock County",4,51,207,103,104
050,17,067,"Illinois","Hancock County",4,52,208,109,99
050,17,067,"Illinois","Hancock County",4,53,212,108,104
050,17,067,"Illinois","Hancock County",4,54,192,103,89
050,17,067,"Illinois","Hancock County",4,55,214,116,98
050,17,067,"Illinois","Hancock County",4,56,253,131,122
050,17,067,"Illinois","Hancock County",4,57,240,111,129
050,17,067,"Illinois","Hancock County",4,58,256,131,125
050,17,067,"Illinois","Hancock County",4,59,248,118,130
050,17,067,"Illinois","Hancock County",4,60,266,127,139
050,17,067,"Illinois","Hancock County",4,61,271,145,126
050,17,067,"Illinois","Hancock County",4,62,267,135,132
050,17,067,"Illinois","Hancock County",4,63,284,149,135
050,17,067,"Illinois","Hancock County",4,64,280,138,142
050,17,067,"Illinois","Hancock County",4,65,267,136,131
050,17,067,"Illinois","Hancock County",4,66,267,133,134
050,17,067,"Illinois","Hancock County",4,67,281,143,138
050,17,067,"Illinois","Hancock County",4,68,263,130,133
050,17,067,"Illinois","Hancock County",4,69,243,122,121
050,17,067,"Illinois","Hancock County",4,70,230,115,115
050,17,067,"Illinois","Hancock County",4,71,215,103,112
050,17,067,"Illinois","Hancock County",4,72,211,99,112
050,17,067,"Illinois","Hancock County",4,73,229,116,113
050,17,067,"Illinois","Hancock County",4,74,218,106,112
050,17,067,"Illinois","Hancock County",4,75,213,104,109
050,17,067,"Illinois","Hancock County",4,76,145,66,79
050,17,067,"Illinois","Hancock County",4,77,132,61,71
050,17,067,"Illinois","Hancock County",4,78,138,58,80
050,17,067,"Illinois","Hancock County",4,79,139,53,86
050,17,067,"Illinois","Hancock County",4,80,117,51,66
050,17,067,"Illinois","Hancock County",4,81,121,52,69
050,17,067,"Illinois","Hancock County",4,82,105,48,57
050,17,067,"Illinois","Hancock County",4,83,99,40,59
050,17,067,"Illinois","Hancock County",4,84,84,41,43
050,17,067,"Illinois","Hancock County",4,85,503,185,318
050,17,067,"Illinois","Hancock County",5,0,177,89,88
050,17,067,"Illinois","Hancock County",5,1,157,74,83
050,17,067,"Illinois","Hancock County",5,2,171,88,83
050,17,067,"Illinois","Hancock County",5,3,182,98,84
050,17,067,"Illinois","Hancock County",5,4,183,85,98
050,17,067,"Illinois","Hancock County",5,5,183,89,94
050,17,067,"Illinois","Hancock County",5,6,195,103,92
050,17,067,"Illinois","Hancock County",5,7,207,100,107
050,17,067,"Illinois","Hancock County",5,8,221,115,106
050,17,067,"Illinois","Hancock County",5,9,213,103,110
050,17,067,"Illinois","Hancock County",5,10,213,115,98
050,17,067,"Illinois","Hancock County",5,11,202,119,83
050,17,067,"Illinois","Hancock County",5,12,204,100,104
050,17,067,"Illinois","Hancock County",5,13,240,126,114
050,17,067,"Illinois","Hancock County",5,14,218,117,101
050,17,067,"Illinois","Hancock County",5,15,229,124,105
050,17,067,"Illinois","Hancock County",5,16,242,123,119
050,17,067,"Illinois","Hancock County",5,17,244,123,121
050,17,067,"Illinois","Hancock County",5,18,191,108,83
050,17,067,"Illinois","Hancock County",5,19,148,77,71
050,17,067,"Illinois","Hancock County",5,20,134,71,63
050,17,067,"Illinois","Hancock County",5,21,155,74,81
050,17,067,"Illinois","Hancock County",5,22,176,79,97
050,17,067,"Illinois","Hancock County",5,23,174,87,87
050,17,067,"Illinois","Hancock County",5,24,154,79,75
050,17,067,"Illinois","Hancock County",5,25,167,88,79
050,17,067,"Illinois","Hancock County",5,26,157,85,72
050,17,067,"Illinois","Hancock County",5,27,172,89,83
050,17,067,"Illinois","Hancock County",5,28,173,98,75
050,17,067,"Illinois","Hancock County",5,29,187,107,80
050,17,067,"Illinois","Hancock County",5,30,179,99,80
050,17,067,"Illinois","Hancock County",5,31,191,90,101
050,17,067,"Illinois","Hancock County",5,32,195,103,92
050,17,067,"Illinois","Hancock County",5,33,175,87,88
050,17,067,"Illinois","Hancock County",5,34,163,78,85
050,17,067,"Illinois","Hancock County",5,35,172,82,90
050,17,067,"Illinois","Hancock County",5,36,186,90,96
050,17,067,"Illinois","Hancock County",5,37,181,83,98
050,17,067,"Illinois","Hancock County",5,38,204,101,103
050,17,067,"Illinois","Hancock County",5,39,199,106,93
050,17,067,"Illinois","Hancock County",5,40,221,113,108
050,17,067,"Illinois","Hancock County",5,41,191,94,97
050,17,067,"Illinois","Hancock County",5,42,181,90,91
050,17,067,"Illinois","Hancock County",5,43,198,93,105
050,17,067,"Illinois","Hancock County",5,44,207,97,110
050,17,067,"Illinois","Hancock County",5,45,193,99,94
050,17,067,"Illinois","Hancock County",5,46,183,88,95
050,17,067,"Illinois","Hancock County",5,47,168,84,84
050,17,067,"Illinois","Hancock County",5,48,196,107,89
050,17,067,"Illinois","Hancock County",5,49,183,101,82
050,17,067,"Illinois","Hancock County",5,50,157,76,81
050,17,067,"Illinois","Hancock County",5,51,188,95,93
050,17,067,"Illinois","Hancock County",5,52,207,108,99
050,17,067,"Illinois","Hancock County",5,53,212,111,101
050,17,067,"Illinois","Hancock County",5,54,207,103,104
050,17,067,"Illinois","Hancock County",5,55,190,96,94
050,17,067,"Illinois","Hancock County",5,56,213,114,99
050,17,067,"Illinois","Hancock County",5,57,247,130,117
050,17,067,"Illinois","Hancock County",5,58,242,112,130
050,17,067,"Illinois","Hancock County",5,59,254,132,122
050,17,067,"Illinois","Hancock County",5,60,248,112,136
050,17,067,"Illinois","Hancock County",5,61,274,133,141
050,17,067,"Illinois","Hancock County",5,62,273,145,128
050,17,067,"Illinois","Hancock County",5,63,269,134,135
050,17,067,"Illinois","Hancock County",5,64,290,153,137
050,17,067,"Illinois","Hancock County",5,65,284,141,143
050,17,067,"Illinois","Hancock County",5,66,254,131,123
050,17,067,"Illinois","Hancock County",5,67,259,128,131
050,17,067,"Illinois","Hancock County",5,68,278,140,138
050,17,067,"Illinois","Hancock County",5,69,258,130,128
050,17,067,"Illinois","Hancock County",5,70,238,118,120
050,17,067,"Illinois","Hancock County",5,71,222,107,115
050,17,067,"Illinois","Hancock County",5,72,201,96,105
050,17,067,"Illinois","Hancock County",5,73,204,96,108
050,17,067,"Illinois","Hancock County",5,74,227,115,112
050,17,067,"Illinois","Hancock County",5,75,217,103,114
050,17,067,"Illinois","Hancock County",5,76,205,103,102
050,17,067,"Illinois","Hancock County",5,77,133,61,72
050,17,067,"Illinois","Hancock County",5,78,123,56,67
050,17,067,"Illinois","Hancock County",5,79,129,55,74
050,17,067,"Illinois","Hancock County",5,80,129,48,81
050,17,067,"Illinois","Hancock County",5,81,111,51,60
050,17,067,"Illinois","Hancock County",5,82,111,46,65
050,17,067,"Illinois","Hancock County",5,83,103,46,57
050,17,067,"Illinois","Hancock County",5,84,83,35,48
050,17,067,"Illinois","Hancock County",5,85,511,192,319
050,17,069,"Illinois","Hardin County",1,0,32,16,16
050,17,069,"Illinois","Hardin County",1,1,34,22,12
050,17,069,"Illinois","Hardin County",1,2,24,8,16
050,17,069,"Illinois","Hardin County",1,3,26,12,14
050,17,069,"Illinois","Hardin County",1,4,36,15,21
050,17,069,"Illinois","Hardin County",1,5,24,8,16
050,17,069,"Illinois","Hardin County",1,6,27,17,10
050,17,069,"Illinois","Hardin County",1,7,28,17,11
050,17,069,"Illinois","Hardin County",1,8,34,17,17
050,17,069,"Illinois","Hardin County",1,9,34,18,16
050,17,069,"Illinois","Hardin County",1,10,35,22,13
050,17,069,"Illinois","Hardin County",1,11,41,22,19
050,17,069,"Illinois","Hardin County",1,12,38,18,20
050,17,069,"Illinois","Hardin County",1,13,38,23,15
050,17,069,"Illinois","Hardin County",1,14,40,21,19
050,17,069,"Illinois","Hardin County",1,15,39,19,20
050,17,069,"Illinois","Hardin County",1,16,58,31,27
050,17,069,"Illinois","Hardin County",1,17,47,20,27
050,17,069,"Illinois","Hardin County",1,18,33,20,13
050,17,069,"Illinois","Hardin County",1,19,31,21,10
050,17,069,"Illinois","Hardin County",1,20,32,17,15
050,17,069,"Illinois","Hardin County",1,21,37,21,16
050,17,069,"Illinois","Hardin County",1,22,32,13,19
050,17,069,"Illinois","Hardin County",1,23,36,13,23
050,17,069,"Illinois","Hardin County",1,24,36,13,23
050,17,069,"Illinois","Hardin County",1,25,32,15,17
050,17,069,"Illinois","Hardin County",1,26,41,23,18
050,17,069,"Illinois","Hardin County",1,27,27,15,12
050,17,069,"Illinois","Hardin County",1,28,27,15,12
050,17,069,"Illinois","Hardin County",1,29,34,18,16
050,17,069,"Illinois","Hardin County",1,30,29,15,14
050,17,069,"Illinois","Hardin County",1,31,27,12,15
050,17,069,"Illinois","Hardin County",1,32,34,16,18
050,17,069,"Illinois","Hardin County",1,33,31,16,15
050,17,069,"Illinois","Hardin County",1,34,33,18,15
050,17,069,"Illinois","Hardin County",1,35,32,20,12
050,17,069,"Illinois","Hardin County",1,36,40,20,20
050,17,069,"Illinois","Hardin County",1,37,35,17,18
050,17,069,"Illinois","Hardin County",1,38,41,22,19
050,17,069,"Illinois","Hardin County",1,39,43,24,19
050,17,069,"Illinois","Hardin County",1,40,36,14,22
050,17,069,"Illinois","Hardin County",1,41,44,22,22
050,17,069,"Illinois","Hardin County",1,42,43,24,19
050,17,069,"Illinois","Hardin County",1,43,34,18,16
050,17,069,"Illinois","Hardin County",1,44,41,21,20
050,17,069,"Illinois","Hardin County",1,45,44,25,19
050,17,069,"Illinois","Hardin County",1,46,40,27,13
050,17,069,"Illinois","Hardin County",1,47,47,26,21
050,17,069,"Illinois","Hardin County",1,48,53,26,27
050,17,069,"Illinois","Hardin County",1,49,54,31,23
050,17,069,"Illinois","Hardin County",1,50,51,31,20
050,17,069,"Illinois","Hardin County",1,51,55,33,22
050,17,069,"Illinois","Hardin County",1,52,57,26,31
050,17,069,"Illinois","Hardin County",1,53,53,30,23
050,17,069,"Illinois","Hardin County",1,54,50,25,25
050,17,069,"Illinois","Hardin County",1,55,58,35,23
050,17,069,"Illinois","Hardin County",1,56,60,34,26
050,17,069,"Illinois","Hardin County",1,57,62,27,35
050,17,069,"Illinois","Hardin County",1,58,66,29,37
050,17,069,"Illinois","Hardin County",1,59,65,35,30
050,17,069,"Illinois","Hardin County",1,60,52,31,21
050,17,069,"Illinois","Hardin County",1,61,57,32,25
050,17,069,"Illinois","Hardin County",1,62,53,27,26
050,17,069,"Illinois","Hardin County",1,63,56,24,32
050,17,069,"Illinois","Hardin County",1,64,56,27,29
050,17,069,"Illinois","Hardin County",1,65,62,32,30
050,17,069,"Illinois","Hardin County",1,66,65,27,38
050,17,069,"Illinois","Hardin County",1,67,67,29,38
050,17,069,"Illinois","Hardin County",1,68,66,30,36
050,17,069,"Illinois","Hardin County",1,69,56,25,31
050,17,069,"Illinois","Hardin County",1,70,63,32,31
050,17,069,"Illinois","Hardin County",1,71,56,33,23
050,17,069,"Illinois","Hardin County",1,72,59,34,25
050,17,069,"Illinois","Hardin County",1,73,51,26,25
050,17,069,"Illinois","Hardin County",1,74,43,17,26
050,17,069,"Illinois","Hardin County",1,75,35,16,19
050,17,069,"Illinois","Hardin County",1,76,39,19,20
050,17,069,"Illinois","Hardin County",1,77,35,17,18
050,17,069,"Illinois","Hardin County",1,78,33,20,13
050,17,069,"Illinois","Hardin County",1,79,36,17,19
050,17,069,"Illinois","Hardin County",1,80,29,17,12
050,17,069,"Illinois","Hardin County",1,81,28,17,11
050,17,069,"Illinois","Hardin County",1,82,27,14,13
050,17,069,"Illinois","Hardin County",1,83,27,9,18
050,17,069,"Illinois","Hardin County",1,84,17,6,11
050,17,069,"Illinois","Hardin County",1,85,88,45,43
050,17,069,"Illinois","Hardin County",2,0,35,18,17
050,17,069,"Illinois","Hardin County",2,1,34,21,13
050,17,069,"Illinois","Hardin County",2,2,27,12,15
050,17,069,"Illinois","Hardin County",2,3,26,12,14
050,17,069,"Illinois","Hardin County",2,4,34,14,20
050,17,069,"Illinois","Hardin County",2,5,26,10,16
050,17,069,"Illinois","Hardin County",2,6,27,15,12
050,17,069,"Illinois","Hardin County",2,7,28,17,11
050,17,069,"Illinois","Hardin County",2,8,31,16,15
050,17,069,"Illinois","Hardin County",2,9,33,17,16
050,17,069,"Illinois","Hardin County",2,10,35,21,14
050,17,069,"Illinois","Hardin County",2,11,40,22,18
050,17,069,"Illinois","Hardin County",2,12,38,19,19
050,17,069,"Illinois","Hardin County",2,13,38,23,15
050,17,069,"Illinois","Hardin County",2,14,40,21,19
050,17,069,"Illinois","Hardin County",2,15,38,19,19
050,17,069,"Illinois","Hardin County",2,16,54,28,26
050,17,069,"Illinois","Hardin County",2,17,49,23,26
050,17,069,"Illinois","Hardin County",2,18,34,19,15
050,17,069,"Illinois","Hardin County",2,19,30,20,10
050,17,069,"Illinois","Hardin County",2,20,32,18,14
050,17,069,"Illinois","Hardin County",2,21,35,19,16
050,17,069,"Illinois","Hardin County",2,22,34,15,19
050,17,069,"Illinois","Hardin County",2,23,34,12,22
050,17,069,"Illinois","Hardin County",2,24,36,14,22
050,17,069,"Illinois","Hardin County",2,25,33,15,18
050,17,069,"Illinois","Hardin County",2,26,38,20,18
050,17,069,"Illinois","Hardin County",2,27,30,16,14
050,17,069,"Illinois","Hardin County",2,28,28,15,13
050,17,069,"Illinois","Hardin County",2,29,32,17,15
050,17,069,"Illinois","Hardin County",2,30,31,16,15
050,17,069,"Illinois","Hardin County",2,31,28,13,15
050,17,069,"Illinois","Hardin County",2,32,33,16,17
050,17,069,"Illinois","Hardin County",2,33,31,16,15
050,17,069,"Illinois","Hardin County",2,34,33,18,15
050,17,069,"Illinois","Hardin County",2,35,33,20,13
050,17,069,"Illinois","Hardin County",2,36,39,21,18
050,17,069,"Illinois","Hardin County",2,37,37,18,19
050,17,069,"Illinois","Hardin County",2,38,40,21,19
050,17,069,"Illinois","Hardin County",2,39,42,23,19
050,17,069,"Illinois","Hardin County",2,40,37,16,21
050,17,069,"Illinois","Hardin County",2,41,43,20,23
050,17,069,"Illinois","Hardin County",2,42,44,24,20
050,17,069,"Illinois","Hardin County",2,43,37,20,17
050,17,069,"Illinois","Hardin County",2,44,40,21,19
050,17,069,"Illinois","Hardin County",2,45,43,24,19
050,17,069,"Illinois","Hardin County",2,46,41,26,15
050,17,069,"Illinois","Hardin County",2,47,44,25,19
050,17,069,"Illinois","Hardin County",2,48,52,26,26
050,17,069,"Illinois","Hardin County",2,49,54,30,24
050,17,069,"Illinois","Hardin County",2,50,51,31,20
050,17,069,"Illinois","Hardin County",2,51,54,32,22
050,17,069,"Illinois","Hardin County",2,52,56,28,28
050,17,069,"Illinois","Hardin County",2,53,54,29,25
050,17,069,"Illinois","Hardin County",2,54,49,25,24
050,17,069,"Illinois","Hardin County",2,55,55,32,23
050,17,069,"Illinois","Hardin County",2,56,59,34,25
050,17,069,"Illinois","Hardin County",2,57,62,29,33
050,17,069,"Illinois","Hardin County",2,58,66,29,37
050,17,069,"Illinois","Hardin County",2,59,65,34,31
050,17,069,"Illinois","Hardin County",2,60,56,33,23
050,17,069,"Illinois","Hardin County",2,61,55,31,24
050,17,069,"Illinois","Hardin County",2,62,54,29,25
050,17,069,"Illinois","Hardin County",2,63,53,24,29
050,17,069,"Illinois","Hardin County",2,64,56,26,30
050,17,069,"Illinois","Hardin County",2,65,60,31,29
050,17,069,"Illinois","Hardin County",2,66,64,28,36
050,17,069,"Illinois","Hardin County",2,67,66,29,37
050,17,069,"Illinois","Hardin County",2,68,66,30,36
050,17,069,"Illinois","Hardin County",2,69,59,26,33
050,17,069,"Illinois","Hardin County",2,70,60,30,30
050,17,069,"Illinois","Hardin County",2,71,57,33,24
050,17,069,"Illinois","Hardin County",2,72,58,34,24
050,17,069,"Illinois","Hardin County",2,73,56,29,27
050,17,069,"Illinois","Hardin County",2,74,42,18,24
050,17,069,"Illinois","Hardin County",2,75,38,17,21
050,17,069,"Illinois","Hardin County",2,76,38,18,20
050,17,069,"Illinois","Hardin County",2,77,37,18,19
050,17,069,"Illinois","Hardin County",2,78,33,19,14
050,17,069,"Illinois","Hardin County",2,79,34,17,17
050,17,069,"Illinois","Hardin County",2,80,29,16,13
050,17,069,"Illinois","Hardin County",2,81,28,17,11
050,17,069,"Illinois","Hardin County",2,82,29,15,14
050,17,069,"Illinois","Hardin County",2,83,26,10,16
050,17,069,"Illinois","Hardin County",2,84,19,7,12
050,17,069,"Illinois","Hardin County",2,85,87,44,43
050,17,069,"Illinois","Hardin County",3,0,25,14,11
050,17,069,"Illinois","Hardin County",3,1,46,20,26
050,17,069,"Illinois","Hardin County",3,2,30,16,14
050,17,069,"Illinois","Hardin County",3,3,30,13,17
050,17,069,"Illinois","Hardin County",3,4,25,12,13
050,17,069,"Illinois","Hardin County",3,5,30,13,17
050,17,069,"Illinois","Hardin County",3,6,26,9,17
050,17,069,"Illinois","Hardin County",3,7,27,15,12
050,17,069,"Illinois","Hardin County",3,8,30,19,11
050,17,069,"Illinois","Hardin County",3,9,32,17,15
050,17,069,"Illinois","Hardin County",3,10,36,17,19
050,17,069,"Illinois","Hardin County",3,11,38,23,15
050,17,069,"Illinois","Hardin County",3,12,44,23,21
050,17,069,"Illinois","Hardin County",3,13,42,22,20
050,17,069,"Illinois","Hardin County",3,14,39,23,16
050,17,069,"Illinois","Hardin County",3,15,40,20,20
050,17,069,"Illinois","Hardin County",3,16,35,17,18
050,17,069,"Illinois","Hardin County",3,17,52,27,25
050,17,069,"Illinois","Hardin County",3,18,40,19,21
050,17,069,"Illinois","Hardin County",3,19,28,16,12
050,17,069,"Illinois","Hardin County",3,20,29,19,10
050,17,069,"Illinois","Hardin County",3,21,35,19,16
050,17,069,"Illinois","Hardin County",3,22,32,17,15
050,17,069,"Illinois","Hardin County",3,23,36,20,16
050,17,069,"Illinois","Hardin County",3,24,37,15,22
050,17,069,"Illinois","Hardin County",3,25,34,13,21
050,17,069,"Illinois","Hardin County",3,26,32,15,17
050,17,069,"Illinois","Hardin County",3,27,34,16,18
050,17,069,"Illinois","Hardin County",3,28,32,16,16
050,17,069,"Illinois","Hardin County",3,29,30,16,14
050,17,069,"Illinois","Hardin County",3,30,35,15,20
050,17,069,"Illinois","Hardin County",3,31,34,17,17
050,17,069,"Illinois","Hardin County",3,32,31,16,15
050,17,069,"Illinois","Hardin County",3,33,36,19,17
050,17,069,"Illinois","Hardin County",3,34,36,16,20
050,17,069,"Illinois","Hardin County",3,35,33,19,14
050,17,069,"Illinois","Hardin County",3,36,33,20,13
050,17,069,"Illinois","Hardin County",3,37,43,25,18
050,17,069,"Illinois","Hardin County",3,38,36,18,18
050,17,069,"Illinois","Hardin County",3,39,42,22,20
050,17,069,"Illinois","Hardin County",3,40,42,20,22
050,17,069,"Illinois","Hardin County",3,41,34,14,20
050,17,069,"Illinois","Hardin County",3,42,45,22,23
050,17,069,"Illinois","Hardin County",3,43,42,24,18
050,17,069,"Illinois","Hardin County",3,44,37,21,16
050,17,069,"Illinois","Hardin County",3,45,41,21,20
050,17,069,"Illinois","Hardin County",3,46,44,26,18
050,17,069,"Illinois","Hardin County",3,47,40,25,15
050,17,069,"Illinois","Hardin County",3,48,43,25,18
050,17,069,"Illinois","Hardin County",3,49,54,27,27
050,17,069,"Illinois","Hardin County",3,50,50,27,23
050,17,069,"Illinois","Hardin County",3,51,50,30,20
050,17,069,"Illinois","Hardin County",3,52,53,31,22
050,17,069,"Illinois","Hardin County",3,53,54,27,27
050,17,069,"Illinois","Hardin County",3,54,52,29,23
050,17,069,"Illinois","Hardin County",3,55,53,30,23
050,17,069,"Illinois","Hardin County",3,56,52,28,24
050,17,069,"Illinois","Hardin County",3,57,57,34,23
050,17,069,"Illinois","Hardin County",3,58,58,25,33
050,17,069,"Illinois","Hardin County",3,59,66,28,38
050,17,069,"Illinois","Hardin County",3,60,66,32,34
050,17,069,"Illinois","Hardin County",3,61,57,34,23
050,17,069,"Illinois","Hardin County",3,62,58,31,27
050,17,069,"Illinois","Hardin County",3,63,54,30,24
050,17,069,"Illinois","Hardin County",3,64,53,24,29
050,17,069,"Illinois","Hardin County",3,65,53,25,28
050,17,069,"Illinois","Hardin County",3,66,61,33,28
050,17,069,"Illinois","Hardin County",3,67,64,27,37
050,17,069,"Illinois","Hardin County",3,68,67,29,38
050,17,069,"Illinois","Hardin County",3,69,67,29,38
050,17,069,"Illinois","Hardin County",3,70,59,26,33
050,17,069,"Illinois","Hardin County",3,71,57,28,29
050,17,069,"Illinois","Hardin County",3,72,62,34,28
050,17,069,"Illinois","Hardin County",3,73,59,36,23
050,17,069,"Illinois","Hardin County",3,74,56,30,26
050,17,069,"Illinois","Hardin County",3,75,38,16,22
050,17,069,"Illinois","Hardin County",3,76,36,14,22
050,17,069,"Illinois","Hardin County",3,77,33,15,18
050,17,069,"Illinois","Hardin County",3,78,34,17,17
050,17,069,"Illinois","Hardin County",3,79,29,16,13
050,17,069,"Illinois","Hardin County",3,80,34,18,16
050,17,069,"Illinois","Hardin County",3,81,25,13,12
050,17,069,"Illinois","Hardin County",3,82,24,15,9
050,17,069,"Illinois","Hardin County",3,83,28,13,15
050,17,069,"Illinois","Hardin County",3,84,23,8,15
050,17,069,"Illinois","Hardin County",3,85,86,42,44
050,17,069,"Illinois","Hardin County",4,0,29,12,17
050,17,069,"Illinois","Hardin County",4,1,23,14,9
050,17,069,"Illinois","Hardin County",4,2,42,18,24
050,17,069,"Illinois","Hardin County",4,3,29,17,12
050,17,069,"Illinois","Hardin County",4,4,28,13,15
050,17,069,"Illinois","Hardin County",4,5,27,14,13
050,17,069,"Illinois","Hardin County",4,6,35,16,19
050,17,069,"Illinois","Hardin County",4,7,28,11,17
050,17,069,"Illinois","Hardin County",4,8,29,17,12
050,17,069,"Illinois","Hardin County",4,9,35,22,13
050,17,069,"Illinois","Hardin County",4,10,35,18,17
050,17,069,"Illinois","Hardin County",4,11,36,18,18
050,17,069,"Illinois","Hardin County",4,12,36,21,15
050,17,069,"Illinois","Hardin County",4,13,47,25,22
050,17,069,"Illinois","Hardin County",4,14,46,26,20
050,17,069,"Illinois","Hardin County",4,15,40,25,15
050,17,069,"Illinois","Hardin County",4,16,44,25,19
050,17,069,"Illinois","Hardin County",4,17,38,19,19
050,17,069,"Illinois","Hardin County",4,18,44,23,21
050,17,069,"Illinois","Hardin County",4,19,32,15,17
050,17,069,"Illinois","Hardin County",4,20,28,15,13
050,17,069,"Illinois","Hardin County",4,21,26,16,10
050,17,069,"Illinois","Hardin County",4,22,38,20,18
050,17,069,"Illinois","Hardin County",4,23,31,17,14
050,17,069,"Illinois","Hardin County",4,24,33,17,16
050,17,069,"Illinois","Hardin County",4,25,36,14,22
050,17,069,"Illinois","Hardin County",4,26,34,15,19
050,17,069,"Illinois","Hardin County",4,27,31,15,16
050,17,069,"Illinois","Hardin County",4,28,33,14,19
050,17,069,"Illinois","Hardin County",4,29,30,14,16
050,17,069,"Illinois","Hardin County",4,30,32,16,16
050,17,069,"Illinois","Hardin County",4,31,34,15,19
050,17,069,"Illinois","Hardin County",4,32,34,16,18
050,17,069,"Illinois","Hardin County",4,33,32,16,16
050,17,069,"Illinois","Hardin County",4,34,38,20,18
050,17,069,"Illinois","Hardin County",4,35,37,17,20
050,17,069,"Illinois","Hardin County",4,36,29,16,13
050,17,069,"Illinois","Hardin County",4,37,32,19,13
050,17,069,"Illinois","Hardin County",4,38,44,25,19
050,17,069,"Illinois","Hardin County",4,39,37,19,18
050,17,069,"Illinois","Hardin County",4,40,42,21,21
050,17,069,"Illinois","Hardin County",4,41,45,23,22
050,17,069,"Illinois","Hardin County",4,42,36,17,19
050,17,069,"Illinois","Hardin County",4,43,45,22,23
050,17,069,"Illinois","Hardin County",4,44,46,27,19
050,17,069,"Illinois","Hardin County",4,45,34,19,15
050,17,069,"Illinois","Hardin County",4,46,40,21,19
050,17,069,"Illinois","Hardin County",4,47,44,25,19
050,17,069,"Illinois","Hardin County",4,48,37,22,15
050,17,069,"Illinois","Hardin County",4,49,44,26,18
050,17,069,"Illinois","Hardin County",4,50,53,26,27
050,17,069,"Illinois","Hardin County",4,51,52,29,23
050,17,069,"Illinois","Hardin County",4,52,46,30,16
050,17,069,"Illinois","Hardin County",4,53,51,30,21
050,17,069,"Illinois","Hardin County",4,54,49,23,26
050,17,069,"Illinois","Hardin County",4,55,52,28,24
050,17,069,"Illinois","Hardin County",4,56,48,25,23
050,17,069,"Illinois","Hardin County",4,57,53,29,24
050,17,069,"Illinois","Hardin County",4,58,56,33,23
050,17,069,"Illinois","Hardin County",4,59,55,23,32
050,17,069,"Illinois","Hardin County",4,60,67,31,36
050,17,069,"Illinois","Hardin County",4,61,65,30,35
050,17,069,"Illinois","Hardin County",4,62,58,35,23
050,17,069,"Illinois","Hardin County",4,63,56,29,27
050,17,069,"Illinois","Hardin County",4,64,54,32,22
050,17,069,"Illinois","Hardin County",4,65,56,27,29
050,17,069,"Illinois","Hardin County",4,66,51,24,27
050,17,069,"Illinois","Hardin County",4,67,58,32,26
050,17,069,"Illinois","Hardin County",4,68,65,28,37
050,17,069,"Illinois","Hardin County",4,69,66,28,38
050,17,069,"Illinois","Hardin County",4,70,61,26,35
050,17,069,"Illinois","Hardin County",4,71,56,25,31
050,17,069,"Illinois","Hardin County",4,72,55,26,29
050,17,069,"Illinois","Hardin County",4,73,58,33,25
050,17,069,"Illinois","Hardin County",4,74,56,34,22
050,17,069,"Illinois","Hardin County",4,75,51,26,25
050,17,069,"Illinois","Hardin County",4,76,36,15,21
050,17,069,"Illinois","Hardin County",4,77,30,10,20
050,17,069,"Illinois","Hardin County",4,78,31,15,16
050,17,069,"Illinois","Hardin County",4,79,28,13,15
050,17,069,"Illinois","Hardin County",4,80,26,14,12
050,17,069,"Illinois","Hardin County",4,81,30,17,13
050,17,069,"Illinois","Hardin County",4,82,23,13,10
050,17,069,"Illinois","Hardin County",4,83,21,13,8
050,17,069,"Illinois","Hardin County",4,84,28,13,15
050,17,069,"Illinois","Hardin County",4,85,86,39,47
050,17,069,"Illinois","Hardin County",5,0,27,11,16
050,17,069,"Illinois","Hardin County",5,1,27,10,17
050,17,069,"Illinois","Hardin County",5,2,28,16,12
050,17,069,"Illinois","Hardin County",5,3,42,20,22
050,17,069,"Illinois","Hardin County",5,4,30,16,14
050,17,069,"Illinois","Hardin County",5,5,30,13,17
050,17,069,"Illinois","Hardin County",5,6,35,17,18
050,17,069,"Illinois","Hardin County",5,7,38,18,20
050,17,069,"Illinois","Hardin County",5,8,29,10,19
050,17,069,"Illinois","Hardin County",5,9,29,17,12
050,17,069,"Illinois","Hardin County",5,10,32,19,13
050,17,069,"Illinois","Hardin County",5,11,35,18,17
050,17,069,"Illinois","Hardin County",5,12,39,19,20
050,17,069,"Illinois","Hardin County",5,13,38,20,18
050,17,069,"Illinois","Hardin County",5,14,51,28,23
050,17,069,"Illinois","Hardin County",5,15,53,26,27
050,17,069,"Illinois","Hardin County",5,16,42,25,17
050,17,069,"Illinois","Hardin County",5,17,46,23,23
050,17,069,"Illinois","Hardin County",5,18,28,14,14
050,17,069,"Illinois","Hardin County",5,19,34,18,16
050,17,069,"Illinois","Hardin County",5,20,36,15,21
050,17,069,"Illinois","Hardin County",5,21,33,17,16
050,17,069,"Illinois","Hardin County",5,22,31,18,13
050,17,069,"Illinois","Hardin County",5,23,35,20,15
050,17,069,"Illinois","Hardin County",5,24,36,20,16
050,17,069,"Illinois","Hardin County",5,25,27,13,14
050,17,069,"Illinois","Hardin County",5,26,39,14,25
050,17,069,"Illinois","Hardin County",5,27,35,15,20
050,17,069,"Illinois","Hardin County",5,28,33,15,18
050,17,069,"Illinois","Hardin County",5,29,32,13,19
050,17,069,"Illinois","Hardin County",5,30,33,15,18
050,17,069,"Illinois","Hardin County",5,31,31,14,17
050,17,069,"Illinois","Hardin County",5,32,31,16,15
050,17,069,"Illinois","Hardin County",5,33,31,15,16
050,17,069,"Illinois","Hardin County",5,34,34,14,20
050,17,069,"Illinois","Hardin County",5,35,39,21,18
050,17,069,"Illinois","Hardin County",5,36,40,20,20
050,17,069,"Illinois","Hardin County",5,37,29,16,13
050,17,069,"Illinois","Hardin County",5,38,32,19,13
050,17,069,"Illinois","Hardin County",5,39,41,24,17
050,17,069,"Illinois","Hardin County",5,40,40,19,21
050,17,069,"Illinois","Hardin County",5,41,43,22,21
050,17,069,"Illinois","Hardin County",5,42,45,23,22
050,17,069,"Illinois","Hardin County",5,43,39,17,22
050,17,069,"Illinois","Hardin County",5,44,47,24,23
050,17,069,"Illinois","Hardin County",5,45,48,30,18
050,17,069,"Illinois","Hardin County",5,46,35,21,14
050,17,069,"Illinois","Hardin County",5,47,39,19,20
050,17,069,"Illinois","Hardin County",5,48,46,28,18
050,17,069,"Illinois","Hardin County",5,49,35,21,14
050,17,069,"Illinois","Hardin County",5,50,41,24,17
050,17,069,"Illinois","Hardin County",5,51,55,27,28
050,17,069,"Illinois","Hardin County",5,52,51,28,23
050,17,069,"Illinois","Hardin County",5,53,45,29,16
050,17,069,"Illinois","Hardin County",5,54,49,27,22
050,17,069,"Illinois","Hardin County",5,55,47,24,23
050,17,069,"Illinois","Hardin County",5,56,51,26,25
050,17,069,"Illinois","Hardin County",5,57,49,26,23
050,17,069,"Illinois","Hardin County",5,58,50,28,22
050,17,069,"Illinois","Hardin County",5,59,54,30,24
050,17,069,"Illinois","Hardin County",5,60,57,25,32
050,17,069,"Illinois","Hardin County",5,61,69,31,38
050,17,069,"Illinois","Hardin County",5,62,66,32,34
050,17,069,"Illinois","Hardin County",5,63,54,33,21
050,17,069,"Illinois","Hardin County",5,64,59,31,28
050,17,069,"Illinois","Hardin County",5,65,53,32,21
050,17,069,"Illinois","Hardin County",5,66,57,28,29
050,17,069,"Illinois","Hardin County",5,67,49,24,25
050,17,069,"Illinois","Hardin County",5,68,60,33,27
050,17,069,"Illinois","Hardin County",5,69,60,22,38
050,17,069,"Illinois","Hardin County",5,70,64,25,39
050,17,069,"Illinois","Hardin County",5,71,59,25,34
050,17,069,"Illinois","Hardin County",5,72,56,24,32
050,17,069,"Illinois","Hardin County",5,73,53,26,27
050,17,069,"Illinois","Hardin County",5,74,56,32,24
050,17,069,"Illinois","Hardin County",5,75,48,30,18
050,17,069,"Illinois","Hardin County",5,76,51,24,27
050,17,069,"Illinois","Hardin County",5,77,32,12,20
050,17,069,"Illinois","Hardin County",5,78,26,9,17
050,17,069,"Illinois","Hardin County",5,79,27,12,15
050,17,069,"Illinois","Hardin County",5,80,28,13,15
050,17,069,"Illinois","Hardin County",5,81,23,13,10
050,17,069,"Illinois","Hardin County",5,82,29,17,12
050,17,069,"Illinois","Hardin County",5,83,21,11,10
050,17,069,"Illinois","Hardin County",5,84,21,13,8
050,17,069,"Illinois","Hardin County",5,85,91,43,48
050,17,071,"Illinois","Henderson County",1,0,60,31,29
050,17,071,"Illinois","Henderson County",1,1,56,31,25
050,17,071,"Illinois","Henderson County",1,2,62,36,26
050,17,071,"Illinois","Henderson County",1,3,68,41,27
050,17,071,"Illinois","Henderson County",1,4,57,29,28
050,17,071,"Illinois","Henderson County",1,5,71,36,35
050,17,071,"Illinois","Henderson County",1,6,69,39,30
050,17,071,"Illinois","Henderson County",1,7,61,29,32
050,17,071,"Illinois","Henderson County",1,8,62,27,35
050,17,071,"Illinois","Henderson County",1,9,60,36,24
050,17,071,"Illinois","Henderson County",1,10,69,38,31
050,17,071,"Illinois","Henderson County",1,11,76,30,46
050,17,071,"Illinois","Henderson County",1,12,70,34,36
050,17,071,"Illinois","Henderson County",1,13,68,36,32
050,17,071,"Illinois","Henderson County",1,14,62,30,32
050,17,071,"Illinois","Henderson County",1,15,73,34,39
050,17,071,"Illinois","Henderson County",1,16,77,36,41
050,17,071,"Illinois","Henderson County",1,17,63,31,32
050,17,071,"Illinois","Henderson County",1,18,56,23,33
050,17,071,"Illinois","Henderson County",1,19,54,31,23
050,17,071,"Illinois","Henderson County",1,20,46,27,19
050,17,071,"Illinois","Henderson County",1,21,50,23,27
050,17,071,"Illinois","Henderson County",1,22,57,29,28
050,17,071,"Illinois","Henderson County",1,23,58,28,30
050,17,071,"Illinois","Henderson County",1,24,60,30,30
050,17,071,"Illinois","Henderson County",1,25,69,37,32
050,17,071,"Illinois","Henderson County",1,26,62,33,29
050,17,071,"Illinois","Henderson County",1,27,57,24,33
050,17,071,"Illinois","Henderson County",1,28,58,26,32
050,17,071,"Illinois","Henderson County",1,29,61,34,27
050,17,071,"Illinois","Henderson County",1,30,59,31,28
050,17,071,"Illinois","Henderson County",1,31,60,30,30
050,17,071,"Illinois","Henderson County",1,32,68,36,32
050,17,071,"Illinois","Henderson County",1,33,62,33,29
050,17,071,"Illinois","Henderson County",1,34,58,28,30
050,17,071,"Illinois","Henderson County",1,35,60,31,29
050,17,071,"Illinois","Henderson County",1,36,54,28,26
050,17,071,"Illinois","Henderson County",1,37,67,35,32
050,17,071,"Illinois","Henderson County",1,38,80,44,36
050,17,071,"Illinois","Henderson County",1,39,62,29,33
050,17,071,"Illinois","Henderson County",1,40,66,34,32
050,17,071,"Illinois","Henderson County",1,41,62,30,32
050,17,071,"Illinois","Henderson County",1,42,68,39,29
050,17,071,"Illinois","Henderson County",1,43,66,37,29
050,17,071,"Illinois","Henderson County",1,44,64,34,30
050,17,071,"Illinois","Henderson County",1,45,74,34,40
050,17,071,"Illinois","Henderson County",1,46,68,27,41
050,17,071,"Illinois","Henderson County",1,47,60,29,31
050,17,071,"Illinois","Henderson County",1,48,76,37,39
050,17,071,"Illinois","Henderson County",1,49,84,41,43
050,17,071,"Illinois","Henderson County",1,50,76,35,41
050,17,071,"Illinois","Henderson County",1,51,68,29,39
050,17,071,"Illinois","Henderson County",1,52,81,41,40
050,17,071,"Illinois","Henderson County",1,53,91,42,49
050,17,071,"Illinois","Henderson County",1,54,94,44,50
050,17,071,"Illinois","Henderson County",1,55,98,48,50
050,17,071,"Illinois","Henderson County",1,56,98,57,41
050,17,071,"Illinois","Henderson County",1,57,111,58,53
050,17,071,"Illinois","Henderson County",1,58,113,59,54
050,17,071,"Illinois","Henderson County",1,59,113,54,59
050,17,071,"Illinois","Henderson County",1,60,119,63,56
050,17,071,"Illinois","Henderson County",1,61,122,67,55
050,17,071,"Illinois","Henderson County",1,62,122,60,62
050,17,071,"Illinois","Henderson County",1,63,122,60,62
050,17,071,"Illinois","Henderson County",1,64,116,58,58
050,17,071,"Illinois","Henderson County",1,65,106,51,55
050,17,071,"Illinois","Henderson County",1,66,108,56,52
050,17,071,"Illinois","Henderson County",1,67,100,51,49
050,17,071,"Illinois","Henderson County",1,68,88,45,43
050,17,071,"Illinois","Henderson County",1,69,77,39,38
050,17,071,"Illinois","Henderson County",1,70,98,59,39
050,17,071,"Illinois","Henderson County",1,71,93,49,44
050,17,071,"Illinois","Henderson County",1,72,79,35,44
050,17,071,"Illinois","Henderson County",1,73,79,38,41
050,17,071,"Illinois","Henderson County",1,74,57,33,24
050,17,071,"Illinois","Henderson County",1,75,70,39,31
050,17,071,"Illinois","Henderson County",1,76,68,33,35
050,17,071,"Illinois","Henderson County",1,77,69,28,41
050,17,071,"Illinois","Henderson County",1,78,67,33,34
050,17,071,"Illinois","Henderson County",1,79,54,29,25
050,17,071,"Illinois","Henderson County",1,80,50,20,30
050,17,071,"Illinois","Henderson County",1,81,48,19,29
050,17,071,"Illinois","Henderson County",1,82,42,19,23
050,17,071,"Illinois","Henderson County",1,83,39,17,22
050,17,071,"Illinois","Henderson County",1,84,30,16,14
050,17,071,"Illinois","Henderson County",1,85,229,79,150
050,17,071,"Illinois","Henderson County",2,0,55,28,27
050,17,071,"Illinois","Henderson County",2,1,56,31,25
050,17,071,"Illinois","Henderson County",2,2,61,35,26
050,17,071,"Illinois","Henderson County",2,3,65,39,26
050,17,071,"Illinois","Henderson County",2,4,60,32,28
050,17,071,"Illinois","Henderson County",2,5,68,34,34
050,17,071,"Illinois","Henderson County",2,6,69,38,31
050,17,071,"Illinois","Henderson County",2,7,62,31,31
050,17,071,"Illinois","Henderson County",2,8,62,28,34
050,17,071,"Illinois","Henderson County",2,9,58,33,25
050,17,071,"Illinois","Henderson County",2,10,66,36,30
050,17,071,"Illinois","Henderson County",2,11,72,30,42
050,17,071,"Illinois","Henderson County",2,12,73,33,40
050,17,071,"Illinois","Henderson County",2,13,68,35,33
050,17,071,"Illinois","Henderson County",2,14,63,31,32
050,17,071,"Illinois","Henderson County",2,15,70,33,37
050,17,071,"Illinois","Henderson County",2,16,76,36,40
050,17,071,"Illinois","Henderson County",2,17,66,32,34
050,17,071,"Illinois","Henderson County",2,18,54,24,30
050,17,071,"Illinois","Henderson County",2,19,50,27,23
050,17,071,"Illinois","Henderson County",2,20,48,28,20
050,17,071,"Illinois","Henderson County",2,21,48,23,25
050,17,071,"Illinois","Henderson County",2,22,54,27,27
050,17,071,"Illinois","Henderson County",2,23,58,27,31
050,17,071,"Illinois","Henderson County",2,24,60,30,30
050,17,071,"Illinois","Henderson County",2,25,67,36,31
050,17,071,"Illinois","Henderson County",2,26,62,33,29
050,17,071,"Illinois","Henderson County",2,27,57,25,32
050,17,071,"Illinois","Henderson County",2,28,57,26,31
050,17,071,"Illinois","Henderson County",2,29,60,32,28
050,17,071,"Illinois","Henderson County",2,30,58,31,27
050,17,071,"Illinois","Henderson County",2,31,59,30,29
050,17,071,"Illinois","Henderson County",2,32,65,34,31
050,17,071,"Illinois","Henderson County",2,33,62,33,29
050,17,071,"Illinois","Henderson County",2,34,60,30,30
050,17,071,"Illinois","Henderson County",2,35,60,31,29
050,17,071,"Illinois","Henderson County",2,36,56,29,27
050,17,071,"Illinois","Henderson County",2,37,64,34,30
050,17,071,"Illinois","Henderson County",2,38,77,43,34
050,17,071,"Illinois","Henderson County",2,39,66,33,33
050,17,071,"Illinois","Henderson County",2,40,65,33,32
050,17,071,"Illinois","Henderson County",2,41,64,32,32
050,17,071,"Illinois","Henderson County",2,42,66,37,29
050,17,071,"Illinois","Henderson County",2,43,67,38,29
050,17,071,"Illinois","Henderson County",2,44,62,33,29
050,17,071,"Illinois","Henderson County",2,45,72,34,38
050,17,071,"Illinois","Henderson County",2,46,69,29,40
050,17,071,"Illinois","Henderson County",2,47,62,29,33
050,17,071,"Illinois","Henderson County",2,48,72,35,37
050,17,071,"Illinois","Henderson County",2,49,82,40,42
050,17,071,"Illinois","Henderson County",2,50,77,36,41
050,17,071,"Illinois","Henderson County",2,51,69,30,39
050,17,071,"Illinois","Henderson County",2,52,77,38,39
050,17,071,"Illinois","Henderson County",2,53,88,42,46
050,17,071,"Illinois","Henderson County",2,54,93,43,50
050,17,071,"Illinois","Henderson County",2,55,96,47,49
050,17,071,"Illinois","Henderson County",2,56,98,54,44
050,17,071,"Illinois","Henderson County",2,57,109,58,51
050,17,071,"Illinois","Henderson County",2,58,112,58,54
050,17,071,"Illinois","Henderson County",2,59,113,55,58
050,17,071,"Illinois","Henderson County",2,60,117,61,56
050,17,071,"Illinois","Henderson County",2,61,122,67,55
050,17,071,"Illinois","Henderson County",2,62,122,61,61
050,17,071,"Illinois","Henderson County",2,63,123,61,62
050,17,071,"Illinois","Henderson County",2,64,115,57,58
050,17,071,"Illinois","Henderson County",2,65,106,51,55
050,17,071,"Illinois","Henderson County",2,66,108,55,53
050,17,071,"Illinois","Henderson County",2,67,102,53,49
050,17,071,"Illinois","Henderson County",2,68,90,46,44
050,17,071,"Illinois","Henderson County",2,69,78,39,39
050,17,071,"Illinois","Henderson County",2,70,91,53,38
050,17,071,"Illinois","Henderson County",2,71,93,51,42
050,17,071,"Illinois","Henderson County",2,72,80,36,44
050,17,071,"Illinois","Henderson County",2,73,81,37,44
050,17,071,"Illinois","Henderson County",2,74,59,33,26
050,17,071,"Illinois","Henderson County",2,75,65,37,28
050,17,071,"Illinois","Henderson County",2,76,66,34,32
050,17,071,"Illinois","Henderson County",2,77,70,30,40
050,17,071,"Illinois","Henderson County",2,78,65,30,35
050,17,071,"Illinois","Henderson County",2,79,57,30,27
050,17,071,"Illinois","Henderson County",2,80,48,22,26
050,17,071,"Illinois","Henderson County",2,81,46,18,28
050,17,071,"Illinois","Henderson County",2,82,43,18,25
050,17,071,"Illinois","Henderson County",2,83,38,17,21
050,17,071,"Illinois","Henderson County",2,84,32,16,16
050,17,071,"Illinois","Henderson County",2,85,233,82,151
050,17,071,"Illinois","Henderson County",3,0,50,28,22
050,17,071,"Illinois","Henderson County",3,1,58,31,27
050,17,071,"Illinois","Henderson County",3,2,66,31,35
050,17,071,"Illinois","Henderson County",3,3,60,37,23
050,17,071,"Illinois","Henderson County",3,4,66,38,28
050,17,071,"Illinois","Henderson County",3,5,64,35,29
050,17,071,"Illinois","Henderson County",3,6,60,30,30
050,17,071,"Illinois","Henderson County",3,7,71,38,33
050,17,071,"Illinois","Henderson County",3,8,62,31,31
050,17,071,"Illinois","Henderson County",3,9,66,31,35
050,17,071,"Illinois","Henderson County",3,10,66,37,29
050,17,071,"Illinois","Henderson County",3,11,64,36,28
050,17,071,"Illinois","Henderson County",3,12,82,36,46
050,17,071,"Illinois","Henderson County",3,13,76,36,40
050,17,071,"Illinois","Henderson County",3,14,65,34,31
050,17,071,"Illinois","Henderson County",3,15,63,29,34
050,17,071,"Illinois","Henderson County",3,16,67,32,35
050,17,071,"Illinois","Henderson County",3,17,73,35,38
050,17,071,"Illinois","Henderson County",3,18,56,30,26
050,17,071,"Illinois","Henderson County",3,19,40,17,23
050,17,071,"Illinois","Henderson County",3,20,54,31,23
050,17,071,"Illinois","Henderson County",3,21,49,29,20
050,17,071,"Illinois","Henderson County",3,22,56,27,29
050,17,071,"Illinois","Henderson County",3,23,57,30,27
050,17,071,"Illinois","Henderson County",3,24,57,30,27
050,17,071,"Illinois","Henderson County",3,25,54,25,29
050,17,071,"Illinois","Henderson County",3,26,67,36,31
050,17,071,"Illinois","Henderson County",3,27,56,32,24
050,17,071,"Illinois","Henderson County",3,28,55,26,29
050,17,071,"Illinois","Henderson County",3,29,59,28,31
050,17,071,"Illinois","Henderson County",3,30,58,29,29
050,17,071,"Illinois","Henderson County",3,31,55,29,26
050,17,071,"Illinois","Henderson County",3,32,63,30,33
050,17,071,"Illinois","Henderson County",3,33,69,36,33
050,17,071,"Illinois","Henderson County",3,34,68,34,34
050,17,071,"Illinois","Henderson County",3,35,63,31,32
050,17,071,"Illinois","Henderson County",3,36,60,30,30
050,17,071,"Illinois","Henderson County",3,37,60,31,29
050,17,071,"Illinois","Henderson County",3,38,61,34,27
050,17,071,"Illinois","Henderson County",3,39,82,44,38
050,17,071,"Illinois","Henderson County",3,40,66,32,34
050,17,071,"Illinois","Henderson County",3,41,64,32,32
050,17,071,"Illinois","Henderson County",3,42,64,33,31
050,17,071,"Illinois","Henderson County",3,43,69,42,27
050,17,071,"Illinois","Henderson County",3,44,65,37,28
050,17,071,"Illinois","Henderson County",3,45,63,34,29
050,17,071,"Illinois","Henderson County",3,46,75,36,39
050,17,071,"Illinois","Henderson County",3,47,70,31,39
050,17,071,"Illinois","Henderson County",3,48,66,30,36
050,17,071,"Illinois","Henderson County",3,49,76,36,40
050,17,071,"Illinois","Henderson County",3,50,79,38,41
050,17,071,"Illinois","Henderson County",3,51,81,37,44
050,17,071,"Illinois","Henderson County",3,52,68,29,39
050,17,071,"Illinois","Henderson County",3,53,80,41,39
050,17,071,"Illinois","Henderson County",3,54,89,42,47
050,17,071,"Illinois","Henderson County",3,55,85,41,44
050,17,071,"Illinois","Henderson County",3,56,96,46,50
050,17,071,"Illinois","Henderson County",3,57,98,54,44
050,17,071,"Illinois","Henderson County",3,58,106,54,52
050,17,071,"Illinois","Henderson County",3,59,108,58,50
050,17,071,"Illinois","Henderson County",3,60,111,55,56
050,17,071,"Illinois","Henderson County",3,61,115,60,55
050,17,071,"Illinois","Henderson County",3,62,116,66,50
050,17,071,"Illinois","Henderson County",3,63,120,60,60
050,17,071,"Illinois","Henderson County",3,64,120,61,59
050,17,071,"Illinois","Henderson County",3,65,114,55,59
050,17,071,"Illinois","Henderson County",3,66,100,48,52
050,17,071,"Illinois","Henderson County",3,67,107,54,53
050,17,071,"Illinois","Henderson County",3,68,104,54,50
050,17,071,"Illinois","Henderson County",3,69,87,46,41
050,17,071,"Illinois","Henderson County",3,70,78,39,39
050,17,071,"Illinois","Henderson County",3,71,87,51,36
050,17,071,"Illinois","Henderson County",3,72,93,50,43
050,17,071,"Illinois","Henderson County",3,73,76,34,42
050,17,071,"Illinois","Henderson County",3,74,80,34,46
050,17,071,"Illinois","Henderson County",3,75,54,30,24
050,17,071,"Illinois","Henderson County",3,76,60,34,26
050,17,071,"Illinois","Henderson County",3,77,60,32,28
050,17,071,"Illinois","Henderson County",3,78,67,27,40
050,17,071,"Illinois","Henderson County",3,79,61,29,32
050,17,071,"Illinois","Henderson County",3,80,55,30,25
050,17,071,"Illinois","Henderson County",3,81,45,20,25
050,17,071,"Illinois","Henderson County",3,82,49,18,31
050,17,071,"Illinois","Henderson County",3,83,34,15,19
050,17,071,"Illinois","Henderson County",3,84,35,17,18
050,17,071,"Illinois","Henderson County",3,85,232,87,145
050,17,071,"Illinois","Henderson County",4,0,55,29,26
050,17,071,"Illinois","Henderson County",4,1,47,23,24
050,17,071,"Illinois","Henderson County",4,2,60,34,26
050,17,071,"Illinois","Henderson County",4,3,60,29,31
050,17,071,"Illinois","Henderson County",4,4,56,35,21
050,17,071,"Illinois","Henderson County",4,5,59,34,25
050,17,071,"Illinois","Henderson County",4,6,61,30,31
050,17,071,"Illinois","Henderson County",4,7,60,29,31
050,17,071,"Illinois","Henderson County",4,8,74,38,36
050,17,071,"Illinois","Henderson County",4,9,61,28,33
050,17,071,"Illinois","Henderson County",4,10,69,31,38
050,17,071,"Illinois","Henderson County",4,11,68,42,26
050,17,071,"Illinois","Henderson County",4,12,64,36,28
050,17,071,"Illinois","Henderson County",4,13,71,31,40
050,17,071,"Illinois","Henderson County",4,14,73,33,40
050,17,071,"Illinois","Henderson County",4,15,64,34,30
050,17,071,"Illinois","Henderson County",4,16,63,31,32
050,17,071,"Illinois","Henderson County",4,17,69,34,35
050,17,071,"Illinois","Henderson County",4,18,57,28,29
050,17,071,"Illinois","Henderson County",4,19,45,26,19
050,17,071,"Illinois","Henderson County",4,20,42,18,24
050,17,071,"Illinois","Henderson County",4,21,52,28,24
050,17,071,"Illinois","Henderson County",4,22,54,27,27
050,17,071,"Illinois","Henderson County",4,23,50,28,22
050,17,071,"Illinois","Henderson County",4,24,55,27,28
050,17,071,"Illinois","Henderson County",4,25,48,24,24
050,17,071,"Illinois","Henderson County",4,26,58,31,27
050,17,071,"Illinois","Henderson County",4,27,64,34,30
050,17,071,"Illinois","Henderson County",4,28,56,30,26
050,17,071,"Illinois","Henderson County",4,29,52,27,25
050,17,071,"Illinois","Henderson County",4,30,60,29,31
050,17,071,"Illinois","Henderson County",4,31,55,29,26
050,17,071,"Illinois","Henderson County",4,32,51,28,23
050,17,071,"Illinois","Henderson County",4,33,58,27,31
050,17,071,"Illinois","Henderson County",4,34,70,38,32
050,17,071,"Illinois","Henderson County",4,35,67,33,34
050,17,071,"Illinois","Henderson County",4,36,61,28,33
050,17,071,"Illinois","Henderson County",4,37,59,30,29
050,17,071,"Illinois","Henderson County",4,38,55,26,29
050,17,071,"Illinois","Henderson County",4,39,62,34,28
050,17,071,"Illinois","Henderson County",4,40,74,42,32
050,17,071,"Illinois","Henderson County",4,41,60,30,30
050,17,071,"Illinois","Henderson County",4,42,67,35,32
050,17,071,"Illinois","Henderson County",4,43,64,33,31
050,17,071,"Illinois","Henderson County",4,44,67,40,27
050,17,071,"Illinois","Henderson County",4,45,67,38,29
050,17,071,"Illinois","Henderson County",4,46,64,32,32
050,17,071,"Illinois","Henderson County",4,47,77,38,39
050,17,071,"Illinois","Henderson County",4,48,70,32,38
050,17,071,"Illinois","Henderson County",4,49,67,33,34
050,17,071,"Illinois","Henderson County",4,50,73,35,38
050,17,071,"Illinois","Henderson County",4,51,76,36,40
050,17,071,"Illinois","Henderson County",4,52,81,38,43
050,17,071,"Illinois","Henderson County",4,53,68,27,41
050,17,071,"Illinois","Henderson County",4,54,85,43,42
050,17,071,"Illinois","Henderson County",4,55,92,45,47
050,17,071,"Illinois","Henderson County",4,56,85,39,46
050,17,071,"Illinois","Henderson County",4,57,95,46,49
050,17,071,"Illinois","Henderson County",4,58,98,53,45
050,17,071,"Illinois","Henderson County",4,59,104,55,49
050,17,071,"Illinois","Henderson County",4,60,107,61,46
050,17,071,"Illinois","Henderson County",4,61,111,52,59
050,17,071,"Illinois","Henderson County",4,62,111,59,52
050,17,071,"Illinois","Henderson County",4,63,114,65,49
050,17,071,"Illinois","Henderson County",4,64,116,57,59
050,17,071,"Illinois","Henderson County",4,65,118,60,58
050,17,071,"Illinois","Henderson County",4,66,112,53,59
050,17,071,"Illinois","Henderson County",4,67,97,48,49
050,17,071,"Illinois","Henderson County",4,68,106,52,54
050,17,071,"Illinois","Henderson County",4,69,100,52,48
050,17,071,"Illinois","Henderson County",4,70,87,47,40
050,17,071,"Illinois","Henderson County",4,71,81,39,42
050,17,071,"Illinois","Henderson County",4,72,85,48,37
050,17,071,"Illinois","Henderson County",4,73,89,48,41
050,17,071,"Illinois","Henderson County",4,74,74,34,40
050,17,071,"Illinois","Henderson County",4,75,77,33,44
050,17,071,"Illinois","Henderson County",4,76,51,28,23
050,17,071,"Illinois","Henderson County",4,77,55,32,23
050,17,071,"Illinois","Henderson County",4,78,56,29,27
050,17,071,"Illinois","Henderson County",4,79,60,22,38
050,17,071,"Illinois","Henderson County",4,80,53,25,28
050,17,071,"Illinois","Henderson County",4,81,52,29,23
050,17,071,"Illinois","Henderson County",4,82,44,18,26
050,17,071,"Illinois","Henderson County",4,83,40,14,26
050,17,071,"Illinois","Henderson County",4,84,31,13,18
050,17,071,"Illinois","Henderson County",4,85,242,92,150
050,17,071,"Illinois","Henderson County",5,0,51,27,24
050,17,071,"Illinois","Henderson County",5,1,63,33,30
050,17,071,"Illinois","Henderson County",5,2,52,29,23
050,17,071,"Illinois","Henderson County",5,3,55,30,25
050,17,071,"Illinois","Henderson County",5,4,63,28,35
050,17,071,"Illinois","Henderson County",5,5,56,32,24
050,17,071,"Illinois","Henderson County",5,6,64,34,30
050,17,071,"Illinois","Henderson County",5,7,60,32,28
050,17,071,"Illinois","Henderson County",5,8,60,32,28
050,17,071,"Illinois","Henderson County",5,9,69,35,34
050,17,071,"Illinois","Henderson County",5,10,63,30,33
050,17,071,"Illinois","Henderson County",5,11,65,29,36
050,17,071,"Illinois","Henderson County",5,12,72,42,30
050,17,071,"Illinois","Henderson County",5,13,58,32,26
050,17,071,"Illinois","Henderson County",5,14,69,27,42
050,17,071,"Illinois","Henderson County",5,15,72,31,41
050,17,071,"Illinois","Henderson County",5,16,64,36,28
050,17,071,"Illinois","Henderson County",5,17,56,29,27
050,17,071,"Illinois","Henderson County",5,18,58,28,30
050,17,071,"Illinois","Henderson County",5,19,41,22,19
050,17,071,"Illinois","Henderson County",5,20,47,25,22
050,17,071,"Illinois","Henderson County",5,21,38,15,23
050,17,071,"Illinois","Henderson County",5,22,55,31,24
050,17,071,"Illinois","Henderson County",5,23,60,29,31
050,17,071,"Illinois","Henderson County",5,24,45,23,22
050,17,071,"Illinois","Henderson County",5,25,58,29,29
050,17,071,"Illinois","Henderson County",5,26,49,26,23
050,17,071,"Illinois","Henderson County",5,27,57,28,29
050,17,071,"Illinois","Henderson County",5,28,69,36,33
050,17,071,"Illinois","Henderson County",5,29,52,30,22
050,17,071,"Illinois","Henderson County",5,30,53,27,26
050,17,071,"Illinois","Henderson County",5,31,60,31,29
050,17,071,"Illinois","Henderson County",5,32,66,32,34
050,17,071,"Illinois","Henderson County",5,33,51,26,25
050,17,071,"Illinois","Henderson County",5,34,59,28,31
050,17,071,"Illinois","Henderson County",5,35,69,37,32
050,17,071,"Illinois","Henderson County",5,36,70,33,37
050,17,071,"Illinois","Henderson County",5,37,62,30,32
050,17,071,"Illinois","Henderson County",5,38,60,31,29
050,17,071,"Illinois","Henderson County",5,39,50,23,27
050,17,071,"Illinois","Henderson County",5,40,58,33,25
050,17,071,"Illinois","Henderson County",5,41,77,40,37
050,17,071,"Illinois","Henderson County",5,42,57,29,28
050,17,071,"Illinois","Henderson County",5,43,67,35,32
050,17,071,"Illinois","Henderson County",5,44,68,36,32
050,17,071,"Illinois","Henderson County",5,45,66,41,25
050,17,071,"Illinois","Henderson County",5,46,65,36,29
050,17,071,"Illinois","Henderson County",5,47,59,31,28
050,17,071,"Illinois","Henderson County",5,48,75,38,37
050,17,071,"Illinois","Henderson County",5,49,68,31,37
050,17,071,"Illinois","Henderson County",5,50,64,32,32
050,17,071,"Illinois","Henderson County",5,51,81,36,45
050,17,071,"Illinois","Henderson County",5,52,78,36,42
050,17,071,"Illinois","Henderson County",5,53,81,38,43
050,17,071,"Illinois","Henderson County",5,54,66,26,40
050,17,071,"Illinois","Henderson County",5,55,81,41,40
050,17,071,"Illinois","Henderson County",5,56,90,43,47
050,17,071,"Illinois","Henderson County",5,57,87,42,45
050,17,071,"Illinois","Henderson County",5,58,92,43,49
050,17,071,"Illinois","Henderson County",5,59,98,53,45
050,17,071,"Illinois","Henderson County",5,60,102,54,48
050,17,071,"Illinois","Henderson County",5,61,110,61,49
050,17,071,"Illinois","Henderson County",5,62,107,50,57
050,17,071,"Illinois","Henderson County",5,63,106,56,50
050,17,071,"Illinois","Henderson County",5,64,112,64,48
050,17,071,"Illinois","Henderson County",5,65,116,58,58
050,17,071,"Illinois","Henderson County",5,66,116,58,58
050,17,071,"Illinois","Henderson County",5,67,111,53,58
050,17,071,"Illinois","Henderson County",5,68,98,48,50
050,17,071,"Illinois","Henderson County",5,69,99,47,52
050,17,071,"Illinois","Henderson County",5,70,99,53,46
050,17,071,"Illinois","Henderson County",5,71,85,46,39
050,17,071,"Illinois","Henderson County",5,72,76,36,40
050,17,071,"Illinois","Henderson County",5,73,82,47,35
050,17,071,"Illinois","Henderson County",5,74,86,47,39
050,17,071,"Illinois","Henderson County",5,75,71,32,39
050,17,071,"Illinois","Henderson County",5,76,72,31,41
050,17,071,"Illinois","Henderson County",5,77,50,29,21
050,17,071,"Illinois","Henderson County",5,78,54,31,23
050,17,071,"Illinois","Henderson County",5,79,47,23,24
050,17,071,"Illinois","Henderson County",5,80,50,20,30
050,17,071,"Illinois","Henderson County",5,81,49,24,25
050,17,071,"Illinois","Henderson County",5,82,50,26,24
050,17,071,"Illinois","Henderson County",5,83,35,15,20
050,17,071,"Illinois","Henderson County",5,84,35,11,24
050,17,071,"Illinois","Henderson County",5,85,251,96,155
050,17,073,"Illinois","Henry County",1,0,478,245,233
050,17,073,"Illinois","Henry County",1,1,476,227,249
050,17,073,"Illinois","Henry County",1,2,502,244,258
050,17,073,"Illinois","Henry County",1,3,540,251,289
050,17,073,"Illinois","Henry County",1,4,587,292,295
050,17,073,"Illinois","Henry County",1,5,595,315,280
050,17,073,"Illinois","Henry County",1,6,552,277,275
050,17,073,"Illinois","Henry County",1,7,617,288,329
050,17,073,"Illinois","Henry County",1,8,601,301,300
050,17,073,"Illinois","Henry County",1,9,617,327,290
050,17,073,"Illinois","Henry County",1,10,615,323,292
050,17,073,"Illinois","Henry County",1,11,649,337,312
050,17,073,"Illinois","Henry County",1,12,683,365,318
050,17,073,"Illinois","Henry County",1,13,647,339,308
050,17,073,"Illinois","Henry County",1,14,695,353,342
050,17,073,"Illinois","Henry County",1,15,703,374,329
050,17,073,"Illinois","Henry County",1,16,718,390,328
050,17,073,"Illinois","Henry County",1,17,715,405,310
050,17,073,"Illinois","Henry County",1,18,581,339,242
050,17,073,"Illinois","Henry County",1,19,473,271,202
050,17,073,"Illinois","Henry County",1,20,487,276,211
050,17,073,"Illinois","Henry County",1,21,474,262,212
050,17,073,"Illinois","Henry County",1,22,481,244,237
050,17,073,"Illinois","Henry County",1,23,466,243,223
050,17,073,"Illinois","Henry County",1,24,470,256,214
050,17,073,"Illinois","Henry County",1,25,478,252,226
050,17,073,"Illinois","Henry County",1,26,491,263,228
050,17,073,"Illinois","Henry County",1,27,520,270,250
050,17,073,"Illinois","Henry County",1,28,535,269,266
050,17,073,"Illinois","Henry County",1,29,512,255,257
050,17,073,"Illinois","Henry County",1,30,529,265,264
050,17,073,"Illinois","Henry County",1,31,511,261,250
050,17,073,"Illinois","Henry County",1,32,555,267,288
050,17,073,"Illinois","Henry County",1,33,538,259,279
050,17,073,"Illinois","Henry County",1,34,564,290,274
050,17,073,"Illinois","Henry County",1,35,549,277,272
050,17,073,"Illinois","Henry County",1,36,592,306,286
050,17,073,"Illinois","Henry County",1,37,589,295,294
050,17,073,"Illinois","Henry County",1,38,599,300,299
050,17,073,"Illinois","Henry County",1,39,649,336,313
050,17,073,"Illinois","Henry County",1,40,631,319,312
050,17,073,"Illinois","Henry County",1,41,617,318,299
050,17,073,"Illinois","Henry County",1,42,636,318,318
050,17,073,"Illinois","Henry County",1,43,606,313,293
050,17,073,"Illinois","Henry County",1,44,624,321,303
050,17,073,"Illinois","Henry County",1,45,597,306,291
050,17,073,"Illinois","Henry County",1,46,584,319,265
050,17,073,"Illinois","Henry County",1,47,593,297,296
050,17,073,"Illinois","Henry County",1,48,620,293,327
050,17,073,"Illinois","Henry County",1,49,649,318,331
050,17,073,"Illinois","Henry County",1,50,625,307,318
050,17,073,"Illinois","Henry County",1,51,620,306,314
050,17,073,"Illinois","Henry County",1,52,613,306,307
050,17,073,"Illinois","Henry County",1,53,635,321,314
050,17,073,"Illinois","Henry County",1,54,638,330,308
050,17,073,"Illinois","Henry County",1,55,658,327,331
050,17,073,"Illinois","Henry County",1,56,642,305,337
050,17,073,"Illinois","Henry County",1,57,725,376,349
050,17,073,"Illinois","Henry County",1,58,763,374,389
050,17,073,"Illinois","Henry County",1,59,773,395,378
050,17,073,"Illinois","Henry County",1,60,740,365,375
050,17,073,"Illinois","Henry County",1,61,721,352,369
050,17,073,"Illinois","Henry County",1,62,742,374,368
050,17,073,"Illinois","Henry County",1,63,742,373,369
050,17,073,"Illinois","Henry County",1,64,693,350,343
050,17,073,"Illinois","Henry County",1,65,680,342,338
050,17,073,"Illinois","Henry County",1,66,648,318,330
050,17,073,"Illinois","Henry County",1,67,627,312,315
050,17,073,"Illinois","Henry County",1,68,661,330,331
050,17,073,"Illinois","Henry County",1,69,615,302,313
050,17,073,"Illinois","Henry County",1,70,598,295,303
050,17,073,"Illinois","Henry County",1,71,540,263,277
050,17,073,"Illinois","Henry County",1,72,562,270,292
050,17,073,"Illinois","Henry County",1,73,549,276,273
050,17,073,"Illinois","Henry County",1,74,373,179,194
050,17,073,"Illinois","Henry County",1,75,400,180,220
050,17,073,"Illinois","Henry County",1,76,417,193,224
050,17,073,"Illinois","Henry County",1,77,406,189,217
050,17,073,"Illinois","Henry County",1,78,341,163,178
050,17,073,"Illinois","Henry County",1,79,320,148,172
050,17,073,"Illinois","Henry County",1,80,284,139,145
050,17,073,"Illinois","Henry County",1,81,272,132,140
050,17,073,"Illinois","Henry County",1,82,232,93,139
050,17,073,"Illinois","Henry County",1,83,189,71,118
050,17,073,"Illinois","Henry County",1,84,189,83,106
050,17,073,"Illinois","Henry County",1,85,1259,445,814
050,17,073,"Illinois","Henry County",2,0,490,252,238
050,17,073,"Illinois","Henry County",2,1,475,230,245
050,17,073,"Illinois","Henry County",2,2,494,237,257
050,17,073,"Illinois","Henry County",2,3,523,244,279
050,17,073,"Illinois","Henry County",2,4,573,281,292
050,17,073,"Illinois","Henry County",2,5,586,305,281
050,17,073,"Illinois","Henry County",2,6,561,285,276
050,17,073,"Illinois","Henry County",2,7,599,285,314
050,17,073,"Illinois","Henry County",2,8,604,297,307
050,17,073,"Illinois","Henry County",2,9,610,318,292
050,17,073,"Illinois","Henry County",2,10,612,321,291
050,17,073,"Illinois","Henry County",2,11,639,332,307
050,17,073,"Illinois","Henry County",2,12,676,359,317
050,17,073,"Illinois","Henry County",2,13,657,347,310
050,17,073,"Illinois","Henry County",2,14,682,350,332
050,17,073,"Illinois","Henry County",2,15,706,374,332
050,17,073,"Illinois","Henry County",2,16,721,391,330
050,17,073,"Illinois","Henry County",2,17,717,404,313
050,17,073,"Illinois","Henry County",2,18,579,334,245
050,17,073,"Illinois","Henry County",2,19,472,270,202
050,17,073,"Illinois","Henry County",2,20,494,282,212
050,17,073,"Illinois","Henry County",2,21,473,261,212
050,17,073,"Illinois","Henry County",2,22,479,247,232
050,17,073,"Illinois","Henry County",2,23,465,242,223
050,17,073,"Illinois","Henry County",2,24,462,250,212
050,17,073,"Illinois","Henry County",2,25,474,251,223
050,17,073,"Illinois","Henry County",2,26,486,258,228
050,17,073,"Illinois","Henry County",2,27,510,264,246
050,17,073,"Illinois","Henry County",2,28,530,268,262
050,17,073,"Illinois","Henry County",2,29,516,256,260
050,17,073,"Illinois","Henry County",2,30,526,263,263
050,17,073,"Illinois","Henry County",2,31,516,263,253
050,17,073,"Illinois","Henry County",2,32,544,266,278
050,17,073,"Illinois","Henry County",2,33,544,262,282
050,17,073,"Illinois","Henry County",2,34,559,284,275
050,17,073,"Illinois","Henry County",2,35,558,282,276
050,17,073,"Illinois","Henry County",2,36,578,296,282
050,17,073,"Illinois","Henry County",2,37,587,296,291
050,17,073,"Illinois","Henry County",2,38,602,302,300
050,17,073,"Illinois","Henry County",2,39,638,329,309
050,17,073,"Illinois","Henry County",2,40,642,328,314
050,17,073,"Illinois","Henry County",2,41,620,316,304
050,17,073,"Illinois","Henry County",2,42,634,320,314
050,17,073,"Illinois","Henry County",2,43,617,315,302
050,17,073,"Illinois","Henry County",2,44,615,316,299
050,17,073,"Illinois","Henry County",2,45,609,314,295
050,17,073,"Illinois","Henry County",2,46,583,312,271
050,17,073,"Illinois","Henry County",2,47,588,301,287
050,17,073,"Illinois","Henry County",2,48,610,292,318
050,17,073,"Illinois","Henry County",2,49,648,316,332
050,17,073,"Illinois","Henry County",2,50,631,308,323
050,17,073,"Illinois","Henry County",2,51,620,307,313
050,17,073,"Illinois","Henry County",2,52,611,302,309
050,17,073,"Illinois","Henry County",2,53,629,318,311
050,17,073,"Illinois","Henry County",2,54,628,322,306
050,17,073,"Illinois","Henry County",2,55,650,327,323
050,17,073,"Illinois","Henry County",2,56,646,312,334
050,17,073,"Illinois","Henry County",2,57,706,360,346
050,17,073,"Illinois","Henry County",2,58,754,372,382
050,17,073,"Illinois","Henry County",2,59,772,391,381
050,17,073,"Illinois","Henry County",2,60,743,370,373
050,17,073,"Illinois","Henry County",2,61,718,354,364
050,17,073,"Illinois","Henry County",2,62,739,369,370
050,17,073,"Illinois","Henry County",2,63,746,375,371
050,17,073,"Illinois","Henry County",2,64,701,355,346
050,17,073,"Illinois","Henry County",2,65,685,343,342
050,17,073,"Illinois","Henry County",2,66,649,320,329
050,17,073,"Illinois","Henry County",2,67,628,310,318
050,17,073,"Illinois","Henry County",2,68,647,321,326
050,17,073,"Illinois","Henry County",2,69,630,310,320
050,17,073,"Illinois","Henry County",2,70,595,293,302
050,17,073,"Illinois","Henry County",2,71,551,270,281
050,17,073,"Illinois","Henry County",2,72,544,261,283
050,17,073,"Illinois","Henry County",2,73,574,281,293
050,17,073,"Illinois","Henry County",2,74,388,189,199
050,17,073,"Illinois","Henry County",2,75,392,179,213
050,17,073,"Illinois","Henry County",2,76,403,188,215
050,17,073,"Illinois","Henry County",2,77,414,194,220
050,17,073,"Illinois","Henry County",2,78,344,162,182
050,17,073,"Illinois","Henry County",2,79,319,150,169
050,17,073,"Illinois","Henry County",2,80,290,139,151
050,17,073,"Illinois","Henry County",2,81,271,133,138
050,17,073,"Illinois","Henry County",2,82,241,99,142
050,17,073,"Illinois","Henry County",2,83,194,74,120
050,17,073,"Illinois","Henry County",2,84,185,80,105
050,17,073,"Illinois","Henry County",2,85,1246,447,799
050,17,073,"Illinois","Henry County",3,0,462,233,229
050,17,073,"Illinois","Henry County",3,1,502,246,256
050,17,073,"Illinois","Henry County",3,2,483,241,242
050,17,073,"Illinois","Henry County",3,3,508,247,261
050,17,073,"Illinois","Henry County",3,4,533,255,278
050,17,073,"Illinois","Henry County",3,5,567,280,287
050,17,073,"Illinois","Henry County",3,6,591,307,284
050,17,073,"Illinois","Henry County",3,7,567,287,280
050,17,073,"Illinois","Henry County",3,8,587,286,301
050,17,073,"Illinois","Henry County",3,9,607,297,310
050,17,073,"Illinois","Henry County",3,10,614,316,298
050,17,073,"Illinois","Henry County",3,11,623,328,295
050,17,073,"Illinois","Henry County",3,12,635,329,306
050,17,073,"Illinois","Henry County",3,13,678,367,311
050,17,073,"Illinois","Henry County",3,14,648,339,309
050,17,073,"Illinois","Henry County",3,15,703,378,325
050,17,073,"Illinois","Henry County",3,16,722,391,331
050,17,073,"Illinois","Henry County",3,17,738,417,321
050,17,073,"Illinois","Henry County",3,18,599,328,271
050,17,073,"Illinois","Henry County",3,19,463,259,204
050,17,073,"Illinois","Henry County",3,20,504,284,220
050,17,073,"Illinois","Henry County",3,21,475,261,214
050,17,073,"Illinois","Henry County",3,22,473,256,217
050,17,073,"Illinois","Henry County",3,23,480,253,227
050,17,073,"Illinois","Henry County",3,24,451,229,222
050,17,073,"Illinois","Henry County",3,25,473,252,221
050,17,073,"Illinois","Henry County",3,26,475,246,229
050,17,073,"Illinois","Henry County",3,27,502,261,241
050,17,073,"Illinois","Henry County",3,28,514,261,253
050,17,073,"Illinois","Henry County",3,29,544,281,263
050,17,073,"Illinois","Henry County",3,30,546,268,278
050,17,073,"Illinois","Henry County",3,31,537,266,271
050,17,073,"Illinois","Henry County",3,32,527,274,253
050,17,073,"Illinois","Henry County",3,33,557,274,283
050,17,073,"Illinois","Henry County",3,34,555,263,292
050,17,073,"Illinois","Henry County",3,35,572,289,283
050,17,073,"Illinois","Henry County",3,36,557,282,275
050,17,073,"Illinois","Henry County",3,37,588,311,277
050,17,073,"Illinois","Henry County",3,38,576,294,282
050,17,073,"Illinois","Henry County",3,39,628,319,309
050,17,073,"Illinois","Henry County",3,40,632,323,309
050,17,073,"Illinois","Henry County",3,41,636,319,317
050,17,073,"Illinois","Henry County",3,42,633,326,307
050,17,073,"Illinois","Henry County",3,43,628,315,313
050,17,073,"Illinois","Henry County",3,44,616,315,301
050,17,073,"Illinois","Henry County",3,45,614,316,298
050,17,073,"Illinois","Henry County",3,46,600,305,295
050,17,073,"Illinois","Henry County",3,47,581,321,260
050,17,073,"Illinois","Henry County",3,48,584,293,291
050,17,073,"Illinois","Henry County",3,49,607,294,313
050,17,073,"Illinois","Henry County",3,50,628,306,322
050,17,073,"Illinois","Henry County",3,51,619,305,314
050,17,073,"Illinois","Henry County",3,52,614,299,315
050,17,073,"Illinois","Henry County",3,53,614,315,299
050,17,073,"Illinois","Henry County",3,54,615,306,309
050,17,073,"Illinois","Henry County",3,55,606,308,298
050,17,073,"Illinois","Henry County",3,56,641,318,323
050,17,073,"Illinois","Henry County",3,57,635,305,330
050,17,073,"Illinois","Henry County",3,58,703,358,345
050,17,073,"Illinois","Henry County",3,59,749,373,376
050,17,073,"Illinois","Henry County",3,60,764,385,379
050,17,073,"Illinois","Henry County",3,61,730,355,375
050,17,073,"Illinois","Henry County",3,62,720,357,363
050,17,073,"Illinois","Henry County",3,63,713,350,363
050,17,073,"Illinois","Henry County",3,64,738,367,371
050,17,073,"Illinois","Henry County",3,65,693,345,348
050,17,073,"Illinois","Henry County",3,66,665,339,326
050,17,073,"Illinois","Henry County",3,67,634,310,324
050,17,073,"Illinois","Henry County",3,68,610,297,313
050,17,073,"Illinois","Henry County",3,69,636,309,327
050,17,073,"Illinois","Henry County",3,70,609,304,305
050,17,073,"Illinois","Henry County",3,71,583,284,299
050,17,073,"Illinois","Henry County",3,72,537,263,274
050,17,073,"Illinois","Henry County",3,73,533,252,281
050,17,073,"Illinois","Henry County",3,74,563,271,292
050,17,073,"Illinois","Henry County",3,75,380,180,200
050,17,073,"Illinois","Henry County",3,76,377,168,209
050,17,073,"Illinois","Henry County",3,77,394,183,211
050,17,073,"Illinois","Henry County",3,78,390,182,208
050,17,073,"Illinois","Henry County",3,79,322,150,172
050,17,073,"Illinois","Henry County",3,80,294,138,156
050,17,073,"Illinois","Henry County",3,81,280,129,151
050,17,073,"Illinois","Henry County",3,82,243,112,131
050,17,073,"Illinois","Henry County",3,83,211,87,124
050,17,073,"Illinois","Henry County",3,84,180,74,106
050,17,073,"Illinois","Henry County",3,85,1193,426,767
050,17,073,"Illinois","Henry County",4,0,489,242,247
050,17,073,"Illinois","Henry County",4,1,442,221,221
050,17,073,"Illinois","Henry County",4,2,527,260,267
050,17,073,"Illinois","Henry County",4,3,501,253,248
050,17,073,"Illinois","Henry County",4,4,503,239,264
050,17,073,"Illinois","Henry County",4,5,541,248,293
050,17,073,"Illinois","Henry County",4,6,579,280,299
050,17,073,"Illinois","Henry County",4,7,606,308,298
050,17,073,"Illinois","Henry County",4,8,568,296,272
050,17,073,"Illinois","Henry County",4,9,575,278,297
050,17,073,"Illinois","Henry County",4,10,615,298,317
050,17,073,"Illinois","Henry County",4,11,593,305,288
050,17,073,"Illinois","Henry County",4,12,619,316,303
050,17,073,"Illinois","Henry County",4,13,631,321,310
050,17,073,"Illinois","Henry County",4,14,661,351,310
050,17,073,"Illinois","Henry County",4,15,688,377,311
050,17,073,"Illinois","Henry County",4,16,702,389,313
050,17,073,"Illinois","Henry County",4,17,740,406,334
050,17,073,"Illinois","Henry County",4,18,591,332,259
050,17,073,"Illinois","Henry County",4,19,455,251,204
050,17,073,"Illinois","Henry County",4,20,485,270,215
050,17,073,"Illinois","Henry County",4,21,497,282,215
050,17,073,"Illinois","Henry County",4,22,484,254,230
050,17,073,"Illinois","Henry County",4,23,465,258,207
050,17,073,"Illinois","Henry County",4,24,458,233,225
050,17,073,"Illinois","Henry County",4,25,448,229,219
050,17,073,"Illinois","Henry County",4,26,475,263,212
050,17,073,"Illinois","Henry County",4,27,484,239,245
050,17,073,"Illinois","Henry County",4,28,483,253,230
050,17,073,"Illinois","Henry County",4,29,536,276,260
050,17,073,"Illinois","Henry County",4,30,554,291,263
050,17,073,"Illinois","Henry County",4,31,564,283,281
050,17,073,"Illinois","Henry County",4,32,545,260,285
050,17,073,"Illinois","Henry County",4,33,529,277,252
050,17,073,"Illinois","Henry County",4,34,561,268,293
050,17,073,"Illinois","Henry County",4,35,574,275,299
050,17,073,"Illinois","Henry County",4,36,569,284,285
050,17,073,"Illinois","Henry County",4,37,561,290,271
050,17,073,"Illinois","Henry County",4,38,588,304,284
050,17,073,"Illinois","Henry County",4,39,570,293,277
050,17,073,"Illinois","Henry County",4,40,627,320,307
050,17,073,"Illinois","Henry County",4,41,614,309,305
050,17,073,"Illinois","Henry County",4,42,639,322,317
050,17,073,"Illinois","Henry County",4,43,634,317,317
050,17,073,"Illinois","Henry County",4,44,620,311,309
050,17,073,"Illinois","Henry County",4,45,615,317,298
050,17,073,"Illinois","Henry County",4,46,604,306,298
050,17,073,"Illinois","Henry County",4,47,616,305,311
050,17,073,"Illinois","Henry County",4,48,574,317,257
050,17,073,"Illinois","Henry County",4,49,571,286,285
050,17,073,"Illinois","Henry County",4,50,605,295,310
050,17,073,"Illinois","Henry County",4,51,629,309,320
050,17,073,"Illinois","Henry County",4,52,625,306,319
050,17,073,"Illinois","Henry County",4,53,619,307,312
050,17,073,"Illinois","Henry County",4,54,595,300,295
050,17,073,"Illinois","Henry County",4,55,597,297,300
050,17,073,"Illinois","Henry County",4,56,601,307,294
050,17,073,"Illinois","Henry County",4,57,637,319,318
050,17,073,"Illinois","Henry County",4,58,639,306,333
050,17,073,"Illinois","Henry County",4,59,710,363,347
050,17,073,"Illinois","Henry County",4,60,735,369,366
050,17,073,"Illinois","Henry County",4,61,754,380,374
050,17,073,"Illinois","Henry County",4,62,725,353,372
050,17,073,"Illinois","Henry County",4,63,713,349,364
050,17,073,"Illinois","Henry County",4,64,709,346,363
050,17,073,"Illinois","Henry County",4,65,738,363,375
050,17,073,"Illinois","Henry County",4,66,665,341,324
050,17,073,"Illinois","Henry County",4,67,647,330,317
050,17,073,"Illinois","Henry County",4,68,615,299,316
050,17,073,"Illinois","Henry County",4,69,604,292,312
050,17,073,"Illinois","Henry County",4,70,625,304,321
050,17,073,"Illinois","Henry County",4,71,590,298,292
050,17,073,"Illinois","Henry County",4,72,567,273,294
050,17,073,"Illinois","Henry County",4,73,526,257,269
050,17,073,"Illinois","Henry County",4,74,515,241,274
050,17,073,"Illinois","Henry County",4,75,551,259,292
050,17,073,"Illinois","Henry County",4,76,364,168,196
050,17,073,"Illinois","Henry County",4,77,361,161,200
050,17,073,"Illinois","Henry County",4,78,380,175,205
050,17,073,"Illinois","Henry County",4,79,364,167,197
050,17,073,"Illinois","Henry County",4,80,296,135,161
050,17,073,"Illinois","Henry County",4,81,288,132,156
050,17,073,"Illinois","Henry County",4,82,264,116,148
050,17,073,"Illinois","Henry County",4,83,225,104,121
050,17,073,"Illinois","Henry County",4,84,190,82,108
050,17,073,"Illinois","Henry County",4,85,1158,394,764
050,17,073,"Illinois","Henry County",5,0,492,244,248
050,17,073,"Illinois","Henry County",5,1,501,260,241
050,17,073,"Illinois","Henry County",5,2,429,222,207
050,17,073,"Illinois","Henry County",5,3,535,267,268
050,17,073,"Illinois","Henry County",5,4,505,253,252
050,17,073,"Illinois","Henry County",5,5,507,246,261
050,17,073,"Illinois","Henry County",5,6,560,256,304
050,17,073,"Illinois","Henry County",5,7,581,285,296
050,17,073,"Illinois","Henry County",5,8,611,311,300
050,17,073,"Illinois","Henry County",5,9,570,292,278
050,17,073,"Illinois","Henry County",5,10,565,276,289
050,17,073,"Illinois","Henry County",5,11,613,301,312
050,17,073,"Illinois","Henry County",5,12,608,315,293
050,17,073,"Illinois","Henry County",5,13,596,308,288
050,17,073,"Illinois","Henry County",5,14,622,320,302
050,17,073,"Illinois","Henry County",5,15,691,379,312
050,17,073,"Illinois","Henry County",5,16,699,394,305
050,17,073,"Illinois","Henry County",5,17,720,413,307
050,17,073,"Illinois","Henry County",5,18,586,320,266
050,17,073,"Illinois","Henry County",5,19,450,249,201
050,17,073,"Illinois","Henry County",5,20,488,265,223
050,17,073,"Illinois","Henry County",5,21,497,267,230
050,17,073,"Illinois","Henry County",5,22,498,277,221
050,17,073,"Illinois","Henry County",5,23,467,241,226
050,17,073,"Illinois","Henry County",5,24,455,247,208
050,17,073,"Illinois","Henry County",5,25,452,226,226
050,17,073,"Illinois","Henry County",5,26,430,217,213
050,17,073,"Illinois","Henry County",5,27,468,252,216
050,17,073,"Illinois","Henry County",5,28,494,248,246
050,17,073,"Illinois","Henry County",5,29,492,261,231
050,17,073,"Illinois","Henry County",5,30,552,290,262
050,17,073,"Illinois","Henry County",5,31,570,299,271
050,17,073,"Illinois","Henry County",5,32,598,292,306
050,17,073,"Illinois","Henry County",5,33,566,270,296
050,17,073,"Illinois","Henry County",5,34,530,279,251
050,17,073,"Illinois","Henry County",5,35,573,280,293
050,17,073,"Illinois","Henry County",5,36,589,289,300
050,17,073,"Illinois","Henry County",5,37,577,291,286
050,17,073,"Illinois","Henry County",5,38,567,293,274
050,17,073,"Illinois","Henry County",5,39,598,299,299
050,17,073,"Illinois","Henry County",5,40,594,308,286
050,17,073,"Illinois","Henry County",5,41,626,311,315
050,17,073,"Illinois","Henry County",5,42,641,326,315
050,17,073,"Illinois","Henry County",5,43,627,315,312
050,17,073,"Illinois","Henry County",5,44,638,325,313
050,17,073,"Illinois","Henry County",5,45,633,316,317
050,17,073,"Illinois","Henry County",5,46,606,316,290
050,17,073,"Illinois","Henry County",5,47,597,308,289
050,17,073,"Illinois","Henry County",5,48,612,304,308
050,17,073,"Illinois","Henry County",5,49,580,318,262
050,17,073,"Illinois","Henry County",5,50,554,279,275
050,17,073,"Illinois","Henry County",5,51,597,293,304
050,17,073,"Illinois","Henry County",5,52,623,310,313
050,17,073,"Illinois","Henry County",5,53,614,299,315
050,17,073,"Illinois","Henry County",5,54,606,294,312
050,17,073,"Illinois","Henry County",5,55,585,294,291
050,17,073,"Illinois","Henry County",5,56,601,301,300
050,17,073,"Illinois","Henry County",5,57,590,303,287
050,17,073,"Illinois","Henry County",5,58,638,318,320
050,17,073,"Illinois","Henry County",5,59,632,308,324
050,17,073,"Illinois","Henry County",5,60,697,352,345
050,17,073,"Illinois","Henry County",5,61,723,358,365
050,17,073,"Illinois","Henry County",5,62,754,378,376
050,17,073,"Illinois","Henry County",5,63,706,340,366
050,17,073,"Illinois","Henry County",5,64,706,339,367
050,17,073,"Illinois","Henry County",5,65,712,342,370
050,17,073,"Illinois","Henry County",5,66,713,354,359
050,17,073,"Illinois","Henry County",5,67,650,334,316
050,17,073,"Illinois","Henry County",5,68,639,326,313
050,17,073,"Illinois","Henry County",5,69,610,295,315
050,17,073,"Illinois","Henry County",5,70,583,285,298
050,17,073,"Illinois","Henry County",5,71,612,298,314
050,17,073,"Illinois","Henry County",5,72,570,283,287
050,17,073,"Illinois","Henry County",5,73,556,268,288
050,17,073,"Illinois","Henry County",5,74,514,249,265
050,17,073,"Illinois","Henry County",5,75,495,228,267
050,17,073,"Illinois","Henry County",5,76,533,245,288
050,17,073,"Illinois","Henry County",5,77,358,169,189
050,17,073,"Illinois","Henry County",5,78,346,151,195
050,17,073,"Illinois","Henry County",5,79,358,165,193
050,17,073,"Illinois","Henry County",5,80,337,156,181
050,17,073,"Illinois","Henry County",5,81,282,126,156
050,17,073,"Illinois","Henry County",5,82,271,123,148
050,17,073,"Illinois","Henry County",5,83,250,110,140
050,17,073,"Illinois","Henry County",5,84,203,97,106
050,17,073,"Illinois","Henry County",5,85,1174,396,778
050,17,075,"Illinois","Iroquois County",1,0,293,153,140
050,17,075,"Illinois","Iroquois County",1,1,303,161,142
050,17,075,"Illinois","Iroquois County",1,2,311,155,156
050,17,075,"Illinois","Iroquois County",1,3,339,173,166
050,17,075,"Illinois","Iroquois County",1,4,299,151,148
050,17,075,"Illinois","Iroquois County",1,5,295,142,153
050,17,075,"Illinois","Iroquois County",1,6,301,149,152
050,17,075,"Illinois","Iroquois County",1,7,300,149,151
050,17,075,"Illinois","Iroquois County",1,8,322,160,162
050,17,075,"Illinois","Iroquois County",1,9,327,162,165
050,17,075,"Illinois","Iroquois County",1,10,319,155,164
050,17,075,"Illinois","Iroquois County",1,11,341,164,177
050,17,075,"Illinois","Iroquois County",1,12,346,173,173
050,17,075,"Illinois","Iroquois County",1,13,337,174,163
050,17,075,"Illinois","Iroquois County",1,14,366,191,175
050,17,075,"Illinois","Iroquois County",1,15,360,200,160
050,17,075,"Illinois","Iroquois County",1,16,385,192,193
050,17,075,"Illinois","Iroquois County",1,17,397,206,191
050,17,075,"Illinois","Iroquois County",1,18,326,172,154
050,17,075,"Illinois","Iroquois County",1,19,244,134,110
050,17,075,"Illinois","Iroquois County",1,20,270,139,131
050,17,075,"Illinois","Iroquois County",1,21,272,139,133
050,17,075,"Illinois","Iroquois County",1,22,285,155,130
050,17,075,"Illinois","Iroquois County",1,23,271,143,128
050,17,075,"Illinois","Iroquois County",1,24,300,161,139
050,17,075,"Illinois","Iroquois County",1,25,270,136,134
050,17,075,"Illinois","Iroquois County",1,26,275,135,140
050,17,075,"Illinois","Iroquois County",1,27,274,141,133
050,17,075,"Illinois","Iroquois County",1,28,273,144,129
050,17,075,"Illinois","Iroquois County",1,29,265,146,119
050,17,075,"Illinois","Iroquois County",1,30,303,162,141
050,17,075,"Illinois","Iroquois County",1,31,282,146,136
050,17,075,"Illinois","Iroquois County",1,32,269,132,137
050,17,075,"Illinois","Iroquois County",1,33,296,152,144
050,17,075,"Illinois","Iroquois County",1,34,285,139,146
050,17,075,"Illinois","Iroquois County",1,35,289,145,144
050,17,075,"Illinois","Iroquois County",1,36,299,143,156
050,17,075,"Illinois","Iroquois County",1,37,322,148,174
050,17,075,"Illinois","Iroquois County",1,38,314,146,168
050,17,075,"Illinois","Iroquois County",1,39,315,162,153
050,17,075,"Illinois","Iroquois County",1,40,327,167,160
050,17,075,"Illinois","Iroquois County",1,41,322,154,168
050,17,075,"Illinois","Iroquois County",1,42,297,128,169
050,17,075,"Illinois","Iroquois County",1,43,307,159,148
050,17,075,"Illinois","Iroquois County",1,44,315,170,145
050,17,075,"Illinois","Iroquois County",1,45,318,156,162
050,17,075,"Illinois","Iroquois County",1,46,298,161,137
050,17,075,"Illinois","Iroquois County",1,47,307,165,142
050,17,075,"Illinois","Iroquois County",1,48,316,172,144
050,17,075,"Illinois","Iroquois County",1,49,331,172,159
050,17,075,"Illinois","Iroquois County",1,50,324,163,161
050,17,075,"Illinois","Iroquois County",1,51,311,142,169
050,17,075,"Illinois","Iroquois County",1,52,300,141,159
050,17,075,"Illinois","Iroquois County",1,53,339,157,182
050,17,075,"Illinois","Iroquois County",1,54,356,173,183
050,17,075,"Illinois","Iroquois County",1,55,397,209,188
050,17,075,"Illinois","Iroquois County",1,56,406,194,212
050,17,075,"Illinois","Iroquois County",1,57,416,200,216
050,17,075,"Illinois","Iroquois County",1,58,414,207,207
050,17,075,"Illinois","Iroquois County",1,59,424,213,211
050,17,075,"Illinois","Iroquois County",1,60,435,215,220
050,17,075,"Illinois","Iroquois County",1,61,427,208,219
050,17,075,"Illinois","Iroquois County",1,62,441,211,230
050,17,075,"Illinois","Iroquois County",1,63,437,215,222
050,17,075,"Illinois","Iroquois County",1,64,423,208,215
050,17,075,"Illinois","Iroquois County",1,65,405,199,206
050,17,075,"Illinois","Iroquois County",1,66,381,196,185
050,17,075,"Illinois","Iroquois County",1,67,360,185,175
050,17,075,"Illinois","Iroquois County",1,68,337,160,177
050,17,075,"Illinois","Iroquois County",1,69,304,152,152
050,17,075,"Illinois","Iroquois County",1,70,305,155,150
050,17,075,"Illinois","Iroquois County",1,71,298,150,148
050,17,075,"Illinois","Iroquois County",1,72,304,144,160
050,17,075,"Illinois","Iroquois County",1,73,324,152,172
050,17,075,"Illinois","Iroquois County",1,74,221,96,125
050,17,075,"Illinois","Iroquois County",1,75,220,98,122
050,17,075,"Illinois","Iroquois County",1,76,233,102,131
050,17,075,"Illinois","Iroquois County",1,77,241,109,132
050,17,075,"Illinois","Iroquois County",1,78,201,86,115
050,17,075,"Illinois","Iroquois County",1,79,187,82,105
050,17,075,"Illinois","Iroquois County",1,80,171,84,87
050,17,075,"Illinois","Iroquois County",1,81,165,68,97
050,17,075,"Illinois","Iroquois County",1,82,145,61,84
050,17,075,"Illinois","Iroquois County",1,83,132,62,70
050,17,075,"Illinois","Iroquois County",1,84,130,62,68
050,17,075,"Illinois","Iroquois County",1,85,790,265,525
050,17,075,"Illinois","Iroquois County",2,0,296,153,143
050,17,075,"Illinois","Iroquois County",2,1,300,157,143
050,17,075,"Illinois","Iroquois County",2,2,309,156,153
050,17,075,"Illinois","Iroquois County",2,3,330,167,163
050,17,075,"Illinois","Iroquois County",2,4,311,157,154
050,17,075,"Illinois","Iroquois County",2,5,294,142,152
050,17,075,"Illinois","Iroquois County",2,6,298,146,152
050,17,075,"Illinois","Iroquois County",2,7,300,149,151
050,17,075,"Illinois","Iroquois County",2,8,315,157,158
050,17,075,"Illinois","Iroquois County",2,9,325,160,165
050,17,075,"Illinois","Iroquois County",2,10,320,156,164
050,17,075,"Illinois","Iroquois County",2,11,332,160,172
050,17,075,"Illinois","Iroquois County",2,12,348,174,174
050,17,075,"Illinois","Iroquois County",2,13,337,173,164
050,17,075,"Illinois","Iroquois County",2,14,359,187,172
050,17,075,"Illinois","Iroquois County",2,15,364,199,165
050,17,075,"Illinois","Iroquois County",2,16,380,194,186
050,17,075,"Illinois","Iroquois County",2,17,394,203,191
050,17,075,"Illinois","Iroquois County",2,18,323,169,154
050,17,075,"Illinois","Iroquois County",2,19,251,135,116
050,17,075,"Illinois","Iroquois County",2,20,267,138,129
050,17,075,"Illinois","Iroquois County",2,21,272,139,133
050,17,075,"Illinois","Iroquois County",2,22,283,150,133
050,17,075,"Illinois","Iroquois County",2,23,276,145,131
050,17,075,"Illinois","Iroquois County",2,24,289,153,136
050,17,075,"Illinois","Iroquois County",2,25,276,141,135
050,17,075,"Illinois","Iroquois County",2,26,274,136,138
050,17,075,"Illinois","Iroquois County",2,27,275,140,135
050,17,075,"Illinois","Iroquois County",2,28,272,143,129
050,17,075,"Illinois","Iroquois County",2,29,268,146,122
050,17,075,"Illinois","Iroquois County",2,30,294,159,135
050,17,075,"Illinois","Iroquois County",2,31,284,147,137
050,17,075,"Illinois","Iroquois County",2,32,273,136,137
050,17,075,"Illinois","Iroquois County",2,33,289,146,143
050,17,075,"Illinois","Iroquois County",2,34,286,142,144
050,17,075,"Illinois","Iroquois County",2,35,289,145,144
050,17,075,"Illinois","Iroquois County",2,36,291,141,150
050,17,075,"Illinois","Iroquois County",2,37,315,146,169
050,17,075,"Illinois","Iroquois County",2,38,316,146,170
050,17,075,"Illinois","Iroquois County",2,39,312,156,156
050,17,075,"Illinois","Iroquois County",2,40,321,163,158
050,17,075,"Illinois","Iroquois County",2,41,322,156,166
050,17,075,"Illinois","Iroquois County",2,42,304,135,169
050,17,075,"Illinois","Iroquois County",2,43,305,152,153
050,17,075,"Illinois","Iroquois County",2,44,309,165,144
050,17,075,"Illinois","Iroquois County",2,45,318,159,159
050,17,075,"Illinois","Iroquois County",2,46,302,159,143
050,17,075,"Illinois","Iroquois County",2,47,303,163,140
050,17,075,"Illinois","Iroquois County",2,48,314,171,143
050,17,075,"Illinois","Iroquois County",2,49,327,172,155
050,17,075,"Illinois","Iroquois County",2,50,326,164,162
050,17,075,"Illinois","Iroquois County",2,51,312,146,166
050,17,075,"Illinois","Iroquois County",2,52,303,141,162
050,17,075,"Illinois","Iroquois County",2,53,326,151,175
050,17,075,"Illinois","Iroquois County",2,54,351,170,181
050,17,075,"Illinois","Iroquois County",2,55,385,199,186
050,17,075,"Illinois","Iroquois County",2,56,404,198,206
050,17,075,"Illinois","Iroquois County",2,57,415,200,215
050,17,075,"Illinois","Iroquois County",2,58,412,204,208
050,17,075,"Illinois","Iroquois County",2,59,425,214,211
050,17,075,"Illinois","Iroquois County",2,60,430,214,216
050,17,075,"Illinois","Iroquois County",2,61,424,206,218
050,17,075,"Illinois","Iroquois County",2,62,436,211,225
050,17,075,"Illinois","Iroquois County",2,63,441,216,225
050,17,075,"Illinois","Iroquois County",2,64,422,206,216
050,17,075,"Illinois","Iroquois County",2,65,408,202,206
050,17,075,"Illinois","Iroquois County",2,66,389,199,190
050,17,075,"Illinois","Iroquois County",2,67,362,186,176
050,17,075,"Illinois","Iroquois County",2,68,336,162,174
050,17,075,"Illinois","Iroquois County",2,69,308,152,156
050,17,075,"Illinois","Iroquois County",2,70,302,151,151
050,17,075,"Illinois","Iroquois County",2,71,294,148,146
050,17,075,"Illinois","Iroquois County",2,72,294,142,152
050,17,075,"Illinois","Iroquois County",2,73,332,156,176
050,17,075,"Illinois","Iroquois County",2,74,228,100,128
050,17,075,"Illinois","Iroquois County",2,75,220,97,123
050,17,075,"Illinois","Iroquois County",2,76,224,98,126
050,17,075,"Illinois","Iroquois County",2,77,243,110,133
050,17,075,"Illinois","Iroquois County",2,78,205,90,115
050,17,075,"Illinois","Iroquois County",2,79,187,81,106
050,17,075,"Illinois","Iroquois County",2,80,171,82,89
050,17,075,"Illinois","Iroquois County",2,81,164,70,94
050,17,075,"Illinois","Iroquois County",2,82,150,63,87
050,17,075,"Illinois","Iroquois County",2,83,133,61,72
050,17,075,"Illinois","Iroquois County",2,84,129,61,68
050,17,075,"Illinois","Iroquois County",2,85,781,263,518
050,17,075,"Illinois","Iroquois County",3,0,243,123,120
050,17,075,"Illinois","Iroquois County",3,1,298,156,142
050,17,075,"Illinois","Iroquois County",3,2,299,158,141
050,17,075,"Illinois","Iroquois County",3,3,312,158,154
050,17,075,"Illinois","Iroquois County",3,4,322,162,160
050,17,075,"Illinois","Iroquois County",3,5,305,155,150
050,17,075,"Illinois","Iroquois County",3,6,297,149,148
050,17,075,"Illinois","Iroquois County",3,7,299,142,157
050,17,075,"Illinois","Iroquois County",3,8,299,147,152
050,17,075,"Illinois","Iroquois County",3,9,324,158,166
050,17,075,"Illinois","Iroquois County",3,10,323,154,169
050,17,075,"Illinois","Iroquois County",3,11,313,156,157
050,17,075,"Illinois","Iroquois County",3,12,340,166,174
050,17,075,"Illinois","Iroquois County",3,13,354,176,178
050,17,075,"Illinois","Iroquois County",3,14,348,184,164
050,17,075,"Illinois","Iroquois County",3,15,354,190,164
050,17,075,"Illinois","Iroquois County",3,16,360,196,164
050,17,075,"Illinois","Iroquois County",3,17,368,192,176
050,17,075,"Illinois","Iroquois County",3,18,338,177,161
050,17,075,"Illinois","Iroquois County",3,19,254,131,123
050,17,075,"Illinois","Iroquois County",3,20,267,142,125
050,17,075,"Illinois","Iroquois County",3,21,275,145,130
050,17,075,"Illinois","Iroquois County",3,22,290,144,146
050,17,075,"Illinois","Iroquois County",3,23,275,151,124
050,17,075,"Illinois","Iroquois County",3,24,273,149,124
050,17,075,"Illinois","Iroquois County",3,25,292,156,136
050,17,075,"Illinois","Iroquois County",3,26,274,148,126
050,17,075,"Illinois","Iroquois County",3,27,265,134,131
050,17,075,"Illinois","Iroquois County",3,28,282,140,142
050,17,075,"Illinois","Iroquois County",3,29,269,144,125
050,17,075,"Illinois","Iroquois County",3,30,262,147,115
050,17,075,"Illinois","Iroquois County",3,31,288,155,133
050,17,075,"Illinois","Iroquois County",3,32,291,143,148
050,17,075,"Illinois","Iroquois County",3,33,279,140,139
050,17,075,"Illinois","Iroquois County",3,34,287,145,142
050,17,075,"Illinois","Iroquois County",3,35,297,154,143
050,17,075,"Illinois","Iroquois County",3,36,297,146,151
050,17,075,"Illinois","Iroquois County",3,37,283,134,149
050,17,075,"Illinois","Iroquois County",3,38,324,155,169
050,17,075,"Illinois","Iroquois County",3,39,322,149,173
050,17,075,"Illinois","Iroquois County",3,40,312,156,156
050,17,075,"Illinois","Iroquois County",3,41,339,173,166
050,17,075,"Illinois","Iroquois County",3,42,332,163,169
050,17,075,"Illinois","Iroquois County",3,43,309,138,171
050,17,075,"Illinois","Iroquois County",3,44,300,147,153
050,17,075,"Illinois","Iroquois County",3,45,307,162,145
050,17,075,"Illinois","Iroquois County",3,46,312,158,154
050,17,075,"Illinois","Iroquois County",3,47,289,154,135
050,17,075,"Illinois","Iroquois County",3,48,305,164,141
050,17,075,"Illinois","Iroquois County",3,49,320,174,146
050,17,075,"Illinois","Iroquois County",3,50,319,169,150
050,17,075,"Illinois","Iroquois County",3,51,328,164,164
050,17,075,"Illinois","Iroquois County",3,52,318,152,166
050,17,075,"Illinois","Iroquois County",3,53,306,140,166
050,17,075,"Illinois","Iroquois County",3,54,322,150,172
050,17,075,"Illinois","Iroquois County",3,55,339,170,169
050,17,075,"Illinois","Iroquois County",3,56,378,192,186
050,17,075,"Illinois","Iroquois County",3,57,403,196,207
050,17,075,"Illinois","Iroquois County",3,58,414,201,213
050,17,075,"Illinois","Iroquois County",3,59,410,201,209
050,17,075,"Illinois","Iroquois County",3,60,432,218,214
050,17,075,"Illinois","Iroquois County",3,61,417,207,210
050,17,075,"Illinois","Iroquois County",3,62,411,197,214
050,17,075,"Illinois","Iroquois County",3,63,430,205,225
050,17,075,"Illinois","Iroquois County",3,64,436,210,226
050,17,075,"Illinois","Iroquois County",3,65,415,202,213
050,17,075,"Illinois","Iroquois County",3,66,398,197,201
050,17,075,"Illinois","Iroquois County",3,67,384,191,193
050,17,075,"Illinois","Iroquois County",3,68,354,176,178
050,17,075,"Illinois","Iroquois County",3,69,341,168,173
050,17,075,"Illinois","Iroquois County",3,70,284,137,147
050,17,075,"Illinois","Iroquois County",3,71,284,143,141
050,17,075,"Illinois","Iroquois County",3,72,292,151,141
050,17,075,"Illinois","Iroquois County",3,73,278,134,144
050,17,075,"Illinois","Iroquois County",3,74,322,151,171
050,17,075,"Illinois","Iroquois County",3,75,224,97,127
050,17,075,"Illinois","Iroquois County",3,76,215,87,128
050,17,075,"Illinois","Iroquois County",3,77,203,92,111
050,17,075,"Illinois","Iroquois County",3,78,240,110,130
050,17,075,"Illinois","Iroquois County",3,79,191,80,111
050,17,075,"Illinois","Iroquois County",3,80,176,77,99
050,17,075,"Illinois","Iroquois County",3,81,167,77,90
050,17,075,"Illinois","Iroquois County",3,82,143,60,83
050,17,075,"Illinois","Iroquois County",3,83,143,59,84
050,17,075,"Illinois","Iroquois County",3,84,119,51,68
050,17,075,"Illinois","Iroquois County",3,85,772,272,500
050,17,075,"Illinois","Iroquois County",4,0,269,119,150
050,17,075,"Illinois","Iroquois County",4,1,257,124,133
050,17,075,"Illinois","Iroquois County",4,2,298,155,143
050,17,075,"Illinois","Iroquois County",4,3,292,157,135
050,17,075,"Illinois","Iroquois County",4,4,314,157,157
050,17,075,"Illinois","Iroquois County",4,5,340,179,161
050,17,075,"Illinois","Iroquois County",4,6,306,156,150
050,17,075,"Illinois","Iroquois County",4,7,295,153,142
050,17,075,"Illinois","Iroquois County",4,8,315,150,165
050,17,075,"Illinois","Iroquois County",4,9,292,149,143
050,17,075,"Illinois","Iroquois County",4,10,322,153,169
050,17,075,"Illinois","Iroquois County",4,11,318,159,159
050,17,075,"Illinois","Iroquois County",4,12,314,155,159
050,17,075,"Illinois","Iroquois County",4,13,328,158,170
050,17,075,"Illinois","Iroquois County",4,14,360,184,176
050,17,075,"Illinois","Iroquois County",4,15,364,193,171
050,17,075,"Illinois","Iroquois County",4,16,341,180,161
050,17,075,"Illinois","Iroquois County",4,17,373,204,169
050,17,075,"Illinois","Iroquois County",4,18,317,165,152
050,17,075,"Illinois","Iroquois County",4,19,257,137,120
050,17,075,"Illinois","Iroquois County",4,20,252,129,123
050,17,075,"Illinois","Iroquois County",4,21,272,142,130
050,17,075,"Illinois","Iroquois County",4,22,294,149,145
050,17,075,"Illinois","Iroquois County",4,23,285,143,142
050,17,075,"Illinois","Iroquois County",4,24,272,144,128
050,17,075,"Illinois","Iroquois County",4,25,267,145,122
050,17,075,"Illinois","Iroquois County",4,26,285,162,123
050,17,075,"Illinois","Iroquois County",4,27,285,159,126
050,17,075,"Illinois","Iroquois County",4,28,271,133,138
050,17,075,"Illinois","Iroquois County",4,29,277,135,142
050,17,075,"Illinois","Iroquois County",4,30,271,139,132
050,17,075,"Illinois","Iroquois County",4,31,261,150,111
050,17,075,"Illinois","Iroquois County",4,32,292,159,133
050,17,075,"Illinois","Iroquois County",4,33,286,140,146
050,17,075,"Illinois","Iroquois County",4,34,278,136,142
050,17,075,"Illinois","Iroquois County",4,35,292,146,146
050,17,075,"Illinois","Iroquois County",4,36,293,153,140
050,17,075,"Illinois","Iroquois County",4,37,298,148,150
050,17,075,"Illinois","Iroquois County",4,38,281,131,150
050,17,075,"Illinois","Iroquois County",4,39,313,153,160
050,17,075,"Illinois","Iroquois County",4,40,317,150,167
050,17,075,"Illinois","Iroquois County",4,41,316,157,159
050,17,075,"Illinois","Iroquois County",4,42,346,179,167
050,17,075,"Illinois","Iroquois County",4,43,333,159,174
050,17,075,"Illinois","Iroquois County",4,44,306,136,170
050,17,075,"Illinois","Iroquois County",4,45,308,157,151
050,17,075,"Illinois","Iroquois County",4,46,307,161,146
050,17,075,"Illinois","Iroquois County",4,47,315,164,151
050,17,075,"Illinois","Iroquois County",4,48,292,157,135
050,17,075,"Illinois","Iroquois County",4,49,298,162,136
050,17,075,"Illinois","Iroquois County",4,50,315,165,150
050,17,075,"Illinois","Iroquois County",4,51,304,162,142
050,17,075,"Illinois","Iroquois County",4,52,325,163,162
050,17,075,"Illinois","Iroquois County",4,53,312,148,164
050,17,075,"Illinois","Iroquois County",4,54,304,143,161
050,17,075,"Illinois","Iroquois County",4,55,320,148,172
050,17,075,"Illinois","Iroquois County",4,56,336,174,162
050,17,075,"Illinois","Iroquois County",4,57,367,186,181
050,17,075,"Illinois","Iroquois County",4,58,404,200,204
050,17,075,"Illinois","Iroquois County",4,59,415,199,216
050,17,075,"Illinois","Iroquois County",4,60,403,198,205
050,17,075,"Illinois","Iroquois County",4,61,421,215,206
050,17,075,"Illinois","Iroquois County",4,62,388,186,202
050,17,075,"Illinois","Iroquois County",4,63,405,191,214
050,17,075,"Illinois","Iroquois County",4,64,427,203,224
050,17,075,"Illinois","Iroquois County",4,65,423,206,217
050,17,075,"Illinois","Iroquois County",4,66,398,195,203
050,17,075,"Illinois","Iroquois County",4,67,391,190,201
050,17,075,"Illinois","Iroquois County",4,68,370,180,190
050,17,075,"Illinois","Iroquois County",4,69,346,177,169
050,17,075,"Illinois","Iroquois County",4,70,322,155,167
050,17,075,"Illinois","Iroquois County",4,71,275,136,139
050,17,075,"Illinois","Iroquois County",4,72,274,143,131
050,17,075,"Illinois","Iroquois County",4,73,280,144,136
050,17,075,"Illinois","Iroquois County",4,74,262,123,139
050,17,075,"Illinois","Iroquois County",4,75,316,147,169
050,17,075,"Illinois","Iroquois County",4,76,214,87,127
050,17,075,"Illinois","Iroquois County",4,77,194,85,109
050,17,075,"Illinois","Iroquois County",4,78,201,90,111
050,17,075,"Illinois","Iroquois County",4,79,228,102,126
050,17,075,"Illinois","Iroquois County",4,80,181,74,107
050,17,075,"Illinois","Iroquois County",4,81,165,64,101
050,17,075,"Illinois","Iroquois County",4,82,150,67,83
050,17,075,"Illinois","Iroquois County",4,83,126,52,74
050,17,075,"Illinois","Iroquois County",4,84,127,47,80
050,17,075,"Illinois","Iroquois County",4,85,769,274,495
050,17,075,"Illinois","Iroquois County",5,0,268,118,150
050,17,075,"Illinois","Iroquois County",5,1,258,117,141
050,17,075,"Illinois","Iroquois County",5,2,266,130,136
050,17,075,"Illinois","Iroquois County",5,3,288,149,139
050,17,075,"Illinois","Iroquois County",5,4,315,175,140
050,17,075,"Illinois","Iroquois County",5,5,314,160,154
050,17,075,"Illinois","Iroquois County",5,6,332,181,151
050,17,075,"Illinois","Iroquois County",5,7,297,151,146
050,17,075,"Illinois","Iroquois County",5,8,292,153,139
050,17,075,"Illinois","Iroquois County",5,9,318,145,173
050,17,075,"Illinois","Iroquois County",5,10,291,149,142
050,17,075,"Illinois","Iroquois County",5,11,317,153,164
050,17,075,"Illinois","Iroquois County",5,12,318,156,162
050,17,075,"Illinois","Iroquois County",5,13,325,167,158
050,17,075,"Illinois","Iroquois County",5,14,320,158,162
050,17,075,"Illinois","Iroquois County",5,15,366,188,178
050,17,075,"Illinois","Iroquois County",5,16,356,186,170
050,17,075,"Illinois","Iroquois County",5,17,338,180,158
050,17,075,"Illinois","Iroquois County",5,18,304,171,133
050,17,075,"Illinois","Iroquois County",5,19,246,128,118
050,17,075,"Illinois","Iroquois County",5,20,262,138,124
050,17,075,"Illinois","Iroquois County",5,21,257,133,124
050,17,075,"Illinois","Iroquois County",5,22,283,142,141
050,17,075,"Illinois","Iroquois County",5,23,278,136,142
050,17,075,"Illinois","Iroquois County",5,24,278,138,140
050,17,075,"Illinois","Iroquois County",5,25,272,147,125
050,17,075,"Illinois","Iroquois County",5,26,252,133,119
050,17,075,"Illinois","Iroquois County",5,27,272,155,117
050,17,075,"Illinois","Iroquois County",5,28,275,154,121
050,17,075,"Illinois","Iroquois County",5,29,281,137,144
050,17,075,"Illinois","Iroquois County",5,30,284,137,147
050,17,075,"Illinois","Iroquois County",5,31,259,136,123
050,17,075,"Illinois","Iroquois County",5,32,266,147,119
050,17,075,"Illinois","Iroquois County",5,33,292,160,132
050,17,075,"Illinois","Iroquois County",5,34,291,141,150
050,17,075,"Illinois","Iroquois County",5,35,272,134,138
050,17,075,"Illinois","Iroquois County",5,36,280,139,141
050,17,075,"Illinois","Iroquois County",5,37,287,146,141
050,17,075,"Illinois","Iroquois County",5,38,296,144,152
050,17,075,"Illinois","Iroquois County",5,39,281,132,149
050,17,075,"Illinois","Iroquois County",5,40,309,158,151
050,17,075,"Illinois","Iroquois County",5,41,309,143,166
050,17,075,"Illinois","Iroquois County",5,42,313,159,154
050,17,075,"Illinois","Iroquois County",5,43,335,174,161
050,17,075,"Illinois","Iroquois County",5,44,324,155,169
050,17,075,"Illinois","Iroquois County",5,45,304,141,163
050,17,075,"Illinois","Iroquois County",5,46,306,156,150
050,17,075,"Illinois","Iroquois County",5,47,316,164,152
050,17,075,"Illinois","Iroquois County",5,48,318,166,152
050,17,075,"Illinois","Iroquois County",5,49,298,162,136
050,17,075,"Illinois","Iroquois County",5,50,285,149,136
050,17,075,"Illinois","Iroquois County",5,51,305,163,142
050,17,075,"Illinois","Iroquois County",5,52,309,161,148
050,17,075,"Illinois","Iroquois County",5,53,324,162,162
050,17,075,"Illinois","Iroquois County",5,54,309,150,159
050,17,075,"Illinois","Iroquois County",5,55,299,141,158
050,17,075,"Illinois","Iroquois County",5,56,321,149,172
050,17,075,"Illinois","Iroquois County",5,57,333,169,164
050,17,075,"Illinois","Iroquois County",5,58,369,186,183
050,17,075,"Illinois","Iroquois County",5,59,406,204,202
050,17,075,"Illinois","Iroquois County",5,60,414,199,215
050,17,075,"Illinois","Iroquois County",5,61,397,196,201
050,17,075,"Illinois","Iroquois County",5,62,414,210,204
050,17,075,"Illinois","Iroquois County",5,63,380,182,198
050,17,075,"Illinois","Iroquois County",5,64,396,186,210
050,17,075,"Illinois","Iroquois County",5,65,410,197,213
050,17,075,"Illinois","Iroquois County",5,66,417,203,214
050,17,075,"Illinois","Iroquois County",5,67,399,197,202
050,17,075,"Illinois","Iroquois County",5,68,385,186,199
050,17,075,"Illinois","Iroquois County",5,69,360,180,180
050,17,075,"Illinois","Iroquois County",5,70,336,169,167
050,17,075,"Illinois","Iroquois County",5,71,312,150,162
050,17,075,"Illinois","Iroquois County",5,72,269,138,131
050,17,075,"Illinois","Iroquois County",5,73,264,137,127
050,17,075,"Illinois","Iroquois County",5,74,266,135,131
050,17,075,"Illinois","Iroquois County",5,75,246,116,130
050,17,075,"Illinois","Iroquois County",5,76,299,139,160
050,17,075,"Illinois","Iroquois County",5,77,195,83,112
050,17,075,"Illinois","Iroquois County",5,78,195,85,110
050,17,075,"Illinois","Iroquois County",5,79,195,88,107
050,17,075,"Illinois","Iroquois County",5,80,214,95,119
050,17,075,"Illinois","Iroquois County",5,81,170,65,105
050,17,075,"Illinois","Iroquois County",5,82,146,54,92
050,17,075,"Illinois","Iroquois County",5,83,131,58,73
050,17,075,"Illinois","Iroquois County",5,84,113,42,71
050,17,075,"Illinois","Iroquois County",5,85,774,275,499
050,17,077,"Illinois","Jackson County",1,0,573,288,285
050,17,077,"Illinois","Jackson County",1,1,575,288,287
050,17,077,"Illinois","Jackson County",1,2,528,268,260
050,17,077,"Illinois","Jackson County",1,3,578,306,272
050,17,077,"Illinois","Jackson County",1,4,597,316,281
050,17,077,"Illinois","Jackson County",1,5,599,320,279
050,17,077,"Illinois","Jackson County",1,6,535,288,247
050,17,077,"Illinois","Jackson County",1,7,536,262,274
050,17,077,"Illinois","Jackson County",1,8,553,282,271
050,17,077,"Illinois","Jackson County",1,9,519,255,264
050,17,077,"Illinois","Jackson County",1,10,525,266,259
050,17,077,"Illinois","Jackson County",1,11,558,288,270
050,17,077,"Illinois","Jackson County",1,12,543,275,268
050,17,077,"Illinois","Jackson County",1,13,553,275,278
050,17,077,"Illinois","Jackson County",1,14,547,259,288
050,17,077,"Illinois","Jackson County",1,15,514,247,267
050,17,077,"Illinois","Jackson County",1,16,548,261,287
050,17,077,"Illinois","Jackson County",1,17,561,292,269
050,17,077,"Illinois","Jackson County",1,18,996,511,485
050,17,077,"Illinois","Jackson County",1,19,1648,850,798
050,17,077,"Illinois","Jackson County",1,20,1719,824,895
050,17,077,"Illinois","Jackson County",1,21,1984,1042,942
050,17,077,"Illinois","Jackson County",1,22,1874,986,888
050,17,077,"Illinois","Jackson County",1,23,1590,824,766
050,17,077,"Illinois","Jackson County",1,24,1269,634,635
050,17,077,"Illinois","Jackson County",1,25,933,485,448
050,17,077,"Illinois","Jackson County",1,26,758,384,374
050,17,077,"Illinois","Jackson County",1,27,644,329,315
050,17,077,"Illinois","Jackson County",1,28,708,354,354
050,17,077,"Illinois","Jackson County",1,29,678,332,346
050,17,077,"Illinois","Jackson County",1,30,689,365,324
050,17,077,"Illinois","Jackson County",1,31,637,340,297
050,17,077,"Illinois","Jackson County",1,32,664,332,332
050,17,077,"Illinois","Jackson County",1,33,625,306,319
050,17,077,"Illinois","Jackson County",1,34,571,294,277
050,17,077,"Illinois","Jackson County",1,35,571,289,282
050,17,077,"Illinois","Jackson County",1,36,567,306,261
050,17,077,"Illinois","Jackson County",1,37,584,288,296
050,17,077,"Illinois","Jackson County",1,38,577,295,282
050,17,077,"Illinois","Jackson County",1,39,533,288,245
050,17,077,"Illinois","Jackson County",1,40,550,284,266
050,17,077,"Illinois","Jackson County",1,41,531,270,261
050,17,077,"Illinois","Jackson County",1,42,510,252,258
050,17,077,"Illinois","Jackson County",1,43,502,243,259
050,17,077,"Illinois","Jackson County",1,44,499,246,253
050,17,077,"Illinois","Jackson County",1,45,506,270,236
050,17,077,"Illinois","Jackson County",1,46,515,277,238
050,17,077,"Illinois","Jackson County",1,47,486,257,229
050,17,077,"Illinois","Jackson County",1,48,534,257,277
050,17,077,"Illinois","Jackson County",1,49,521,260,261
050,17,077,"Illinois","Jackson County",1,50,533,272,261
050,17,077,"Illinois","Jackson County",1,51,519,254,265
050,17,077,"Illinois","Jackson County",1,52,469,235,234
050,17,077,"Illinois","Jackson County",1,53,494,242,252
050,17,077,"Illinois","Jackson County",1,54,519,267,252
050,17,077,"Illinois","Jackson County",1,55,555,281,274
050,17,077,"Illinois","Jackson County",1,56,576,290,286
050,17,077,"Illinois","Jackson County",1,57,592,272,320
050,17,077,"Illinois","Jackson County",1,58,606,296,310
050,17,077,"Illinois","Jackson County",1,59,619,290,329
050,17,077,"Illinois","Jackson County",1,60,623,307,316
050,17,077,"Illinois","Jackson County",1,61,628,305,323
050,17,077,"Illinois","Jackson County",1,62,593,292,301
050,17,077,"Illinois","Jackson County",1,63,605,315,290
050,17,077,"Illinois","Jackson County",1,64,607,306,301
050,17,077,"Illinois","Jackson County",1,65,575,274,301
050,17,077,"Illinois","Jackson County",1,66,580,275,305
050,17,077,"Illinois","Jackson County",1,67,570,279,291
050,17,077,"Illinois","Jackson County",1,68,540,263,277
050,17,077,"Illinois","Jackson County",1,69,528,258,270
050,17,077,"Illinois","Jackson County",1,70,529,251,278
050,17,077,"Illinois","Jackson County",1,71,502,256,246
050,17,077,"Illinois","Jackson County",1,72,495,245,250
050,17,077,"Illinois","Jackson County",1,73,476,219,257
050,17,077,"Illinois","Jackson County",1,74,308,138,170
050,17,077,"Illinois","Jackson County",1,75,307,147,160
050,17,077,"Illinois","Jackson County",1,76,281,131,150
050,17,077,"Illinois","Jackson County",1,77,303,133,170
050,17,077,"Illinois","Jackson County",1,78,258,107,151
050,17,077,"Illinois","Jackson County",1,79,233,100,133
050,17,077,"Illinois","Jackson County",1,80,207,97,110
050,17,077,"Illinois","Jackson County",1,81,198,94,104
050,17,077,"Illinois","Jackson County",1,82,199,79,120
050,17,077,"Illinois","Jackson County",1,83,174,73,101
050,17,077,"Illinois","Jackson County",1,84,145,57,88
050,17,077,"Illinois","Jackson County",1,85,1105,380,725
050,17,077,"Illinois","Jackson County",2,0,582,302,280
050,17,077,"Illinois","Jackson County",2,1,574,289,285
050,17,077,"Illinois","Jackson County",2,2,542,276,266
050,17,077,"Illinois","Jackson County",2,3,565,296,269
050,17,077,"Illinois","Jackson County",2,4,592,313,279
050,17,077,"Illinois","Jackson County",2,5,600,319,281
050,17,077,"Illinois","Jackson County",2,6,550,294,256
050,17,077,"Illinois","Jackson County",2,7,533,267,266
050,17,077,"Illinois","Jackson County",2,8,546,276,270
050,17,077,"Illinois","Jackson County",2,9,527,263,264
050,17,077,"Illinois","Jackson County",2,10,526,265,261
050,17,077,"Illinois","Jackson County",2,11,547,282,265
050,17,077,"Illinois","Jackson County",2,12,548,279,269
050,17,077,"Illinois","Jackson County",2,13,554,279,275
050,17,077,"Illinois","Jackson County",2,14,548,261,287
050,17,077,"Illinois","Jackson County",2,15,525,250,275
050,17,077,"Illinois","Jackson County",2,16,544,263,281
050,17,077,"Illinois","Jackson County",2,17,562,287,275
050,17,077,"Illinois","Jackson County",2,18,988,502,486
050,17,077,"Illinois","Jackson County",2,19,1652,853,799
050,17,077,"Illinois","Jackson County",2,20,1747,833,914
050,17,077,"Illinois","Jackson County",2,21,1991,1052,939
050,17,077,"Illinois","Jackson County",2,22,1867,983,884
050,17,077,"Illinois","Jackson County",2,23,1564,806,758
050,17,077,"Illinois","Jackson County",2,24,1253,625,628
050,17,077,"Illinois","Jackson County",2,25,926,476,450
050,17,077,"Illinois","Jackson County",2,26,760,388,372
050,17,077,"Illinois","Jackson County",2,27,641,326,315
050,17,077,"Illinois","Jackson County",2,28,687,343,344
050,17,077,"Illinois","Jackson County",2,29,677,331,346
050,17,077,"Illinois","Jackson County",2,30,681,353,328
050,17,077,"Illinois","Jackson County",2,31,640,339,301
050,17,077,"Illinois","Jackson County",2,32,655,332,323
050,17,077,"Illinois","Jackson County",2,33,630,309,321
050,17,077,"Illinois","Jackson County",2,34,581,295,286
050,17,077,"Illinois","Jackson County",2,35,567,290,277
050,17,077,"Illinois","Jackson County",2,36,561,299,262
050,17,077,"Illinois","Jackson County",2,37,579,291,288
050,17,077,"Illinois","Jackson County",2,38,578,294,284
050,17,077,"Illinois","Jackson County",2,39,540,287,253
050,17,077,"Illinois","Jackson County",2,40,550,287,263
050,17,077,"Illinois","Jackson County",2,41,535,272,263
050,17,077,"Illinois","Jackson County",2,42,509,252,257
050,17,077,"Illinois","Jackson County",2,43,506,246,260
050,17,077,"Illinois","Jackson County",2,44,495,243,252
050,17,077,"Illinois","Jackson County",2,45,502,265,237
050,17,077,"Illinois","Jackson County",2,46,507,272,235
050,17,077,"Illinois","Jackson County",2,47,488,259,229
050,17,077,"Illinois","Jackson County",2,48,519,256,263
050,17,077,"Illinois","Jackson County",2,49,523,259,264
050,17,077,"Illinois","Jackson County",2,50,531,269,262
050,17,077,"Illinois","Jackson County",2,51,513,252,261
050,17,077,"Illinois","Jackson County",2,52,477,237,240
050,17,077,"Illinois","Jackson County",2,53,486,239,247
050,17,077,"Illinois","Jackson County",2,54,509,259,250
050,17,077,"Illinois","Jackson County",2,55,543,275,268
050,17,077,"Illinois","Jackson County",2,56,573,288,285
050,17,077,"Illinois","Jackson County",2,57,583,276,307
050,17,077,"Illinois","Jackson County",2,58,601,290,311
050,17,077,"Illinois","Jackson County",2,59,621,294,327
050,17,077,"Illinois","Jackson County",2,60,617,300,317
050,17,077,"Illinois","Jackson County",2,61,617,299,318
050,17,077,"Illinois","Jackson County",2,62,596,292,304
050,17,077,"Illinois","Jackson County",2,63,603,310,293
050,17,077,"Illinois","Jackson County",2,64,595,304,291
050,17,077,"Illinois","Jackson County",2,65,581,281,300
050,17,077,"Illinois","Jackson County",2,66,575,273,302
050,17,077,"Illinois","Jackson County",2,67,563,273,290
050,17,077,"Illinois","Jackson County",2,68,539,263,276
050,17,077,"Illinois","Jackson County",2,69,534,259,275
050,17,077,"Illinois","Jackson County",2,70,527,253,274
050,17,077,"Illinois","Jackson County",2,71,511,256,255
050,17,077,"Illinois","Jackson County",2,72,486,243,243
050,17,077,"Illinois","Jackson County",2,73,502,235,267
050,17,077,"Illinois","Jackson County",2,74,322,145,177
050,17,077,"Illinois","Jackson County",2,75,306,145,161
050,17,077,"Illinois","Jackson County",2,76,279,130,149
050,17,077,"Illinois","Jackson County",2,77,302,133,169
050,17,077,"Illinois","Jackson County",2,78,263,112,151
050,17,077,"Illinois","Jackson County",2,79,235,98,137
050,17,077,"Illinois","Jackson County",2,80,210,95,115
050,17,077,"Illinois","Jackson County",2,81,195,92,103
050,17,077,"Illinois","Jackson County",2,82,202,85,117
050,17,077,"Illinois","Jackson County",2,83,176,72,104
050,17,077,"Illinois","Jackson County",2,84,147,60,87
050,17,077,"Illinois","Jackson County",2,85,1107,381,726
050,17,077,"Illinois","Jackson County",3,0,568,292,276
050,17,077,"Illinois","Jackson County",3,1,567,299,268
050,17,077,"Illinois","Jackson County",3,2,581,293,288
050,17,077,"Illinois","Jackson County",3,3,534,280,254
050,17,077,"Illinois","Jackson County",3,4,559,297,262
050,17,077,"Illinois","Jackson County",3,5,595,312,283
050,17,077,"Illinois","Jackson County",3,6,605,326,279
050,17,077,"Illinois","Jackson County",3,7,545,290,255
050,17,077,"Illinois","Jackson County",3,8,526,265,261
050,17,077,"Illinois","Jackson County",3,9,551,286,265
050,17,077,"Illinois","Jackson County",3,10,521,261,260
050,17,077,"Illinois","Jackson County",3,11,539,263,276
050,17,077,"Illinois","Jackson County",3,12,541,277,264
050,17,077,"Illinois","Jackson County",3,13,557,284,273
050,17,077,"Illinois","Jackson County",3,14,561,291,270
050,17,077,"Illinois","Jackson County",3,15,564,264,300
050,17,077,"Illinois","Jackson County",3,16,548,261,287
050,17,077,"Illinois","Jackson County",3,17,552,277,275
050,17,077,"Illinois","Jackson County",3,18,987,497,490
050,17,077,"Illinois","Jackson County",3,19,1657,858,799
050,17,077,"Illinois","Jackson County",3,20,1750,841,909
050,17,077,"Illinois","Jackson County",3,21,2063,1111,952
050,17,077,"Illinois","Jackson County",3,22,1873,992,881
050,17,077,"Illinois","Jackson County",3,23,1500,804,696
050,17,077,"Illinois","Jackson County",3,24,1252,626,626
050,17,077,"Illinois","Jackson County",3,25,926,478,448
050,17,077,"Illinois","Jackson County",3,26,766,378,388
050,17,077,"Illinois","Jackson County",3,27,628,320,308
050,17,077,"Illinois","Jackson County",3,28,611,305,306
050,17,077,"Illinois","Jackson County",3,29,631,327,304
050,17,077,"Illinois","Jackson County",3,30,678,339,339
050,17,077,"Illinois","Jackson County",3,31,637,318,319
050,17,077,"Illinois","Jackson County",3,32,586,303,283
050,17,077,"Illinois","Jackson County",3,33,632,312,320
050,17,077,"Illinois","Jackson County",3,34,610,303,307
050,17,077,"Illinois","Jackson County",3,35,558,276,282
050,17,077,"Illinois","Jackson County",3,36,557,288,269
050,17,077,"Illinois","Jackson County",3,37,531,279,252
050,17,077,"Illinois","Jackson County",3,38,574,292,282
050,17,077,"Illinois","Jackson County",3,39,594,305,289
050,17,077,"Illinois","Jackson County",3,40,529,278,251
050,17,077,"Illinois","Jackson County",3,41,565,301,264
050,17,077,"Illinois","Jackson County",3,42,526,264,262
050,17,077,"Illinois","Jackson County",3,43,517,263,254
050,17,077,"Illinois","Jackson County",3,44,511,255,256
050,17,077,"Illinois","Jackson County",3,45,497,248,249
050,17,077,"Illinois","Jackson County",3,46,503,272,231
050,17,077,"Illinois","Jackson County",3,47,490,262,228
050,17,077,"Illinois","Jackson County",3,48,478,253,225
050,17,077,"Illinois","Jackson County",3,49,506,256,250
050,17,077,"Illinois","Jackson County",3,50,514,254,260
050,17,077,"Illinois","Jackson County",3,51,504,237,267
050,17,077,"Illinois","Jackson County",3,52,505,250,255
050,17,077,"Illinois","Jackson County",3,53,474,232,242
050,17,077,"Illinois","Jackson County",3,54,469,234,235
050,17,077,"Illinois","Jackson County",3,55,487,248,239
050,17,077,"Illinois","Jackson County",3,56,553,278,275
050,17,077,"Illinois","Jackson County",3,57,545,277,268
050,17,077,"Illinois","Jackson County",3,58,577,272,305
050,17,077,"Illinois","Jackson County",3,59,601,286,315
050,17,077,"Illinois","Jackson County",3,60,620,299,321
050,17,077,"Illinois","Jackson County",3,61,609,290,319
050,17,077,"Illinois","Jackson County",3,62,589,278,311
050,17,077,"Illinois","Jackson County",3,63,578,285,293
050,17,077,"Illinois","Jackson County",3,64,574,293,281
050,17,077,"Illinois","Jackson County",3,65,581,296,285
050,17,077,"Illinois","Jackson County",3,66,573,275,298
050,17,077,"Illinois","Jackson County",3,67,569,275,294
050,17,077,"Illinois","Jackson County",3,68,545,262,283
050,17,077,"Illinois","Jackson County",3,69,523,252,271
050,17,077,"Illinois","Jackson County",3,70,510,247,263
050,17,077,"Illinois","Jackson County",3,71,510,241,269
050,17,077,"Illinois","Jackson County",3,72,500,250,250
050,17,077,"Illinois","Jackson County",3,73,475,233,242
050,17,077,"Illinois","Jackson County",3,74,486,230,256
050,17,077,"Illinois","Jackson County",3,75,301,132,169
050,17,077,"Illinois","Jackson County",3,76,291,140,151
050,17,077,"Illinois","Jackson County",3,77,267,123,144
050,17,077,"Illinois","Jackson County",3,78,285,124,161
050,17,077,"Illinois","Jackson County",3,79,243,98,145
050,17,077,"Illinois","Jackson County",3,80,218,94,124
050,17,077,"Illinois","Jackson County",3,81,203,93,110
050,17,077,"Illinois","Jackson County",3,82,186,82,104
050,17,077,"Illinois","Jackson County",3,83,191,75,116
050,17,077,"Illinois","Jackson County",3,84,157,65,92
050,17,077,"Illinois","Jackson County",3,85,1054,368,686
050,17,077,"Illinois","Jackson County",4,0,542,263,279
050,17,077,"Illinois","Jackson County",4,1,555,282,273
050,17,077,"Illinois","Jackson County",4,2,552,301,251
050,17,077,"Illinois","Jackson County",4,3,578,281,297
050,17,077,"Illinois","Jackson County",4,4,561,281,280
050,17,077,"Illinois","Jackson County",4,5,573,315,258
050,17,077,"Illinois","Jackson County",4,6,595,322,273
050,17,077,"Illinois","Jackson County",4,7,599,318,281
050,17,077,"Illinois","Jackson County",4,8,548,291,257
050,17,077,"Illinois","Jackson County",4,9,535,277,258
050,17,077,"Illinois","Jackson County",4,10,549,283,266
050,17,077,"Illinois","Jackson County",4,11,541,266,275
050,17,077,"Illinois","Jackson County",4,12,533,267,266
050,17,077,"Illinois","Jackson County",4,13,543,278,265
050,17,077,"Illinois","Jackson County",4,14,559,287,272
050,17,077,"Illinois","Jackson County",4,15,564,302,262
050,17,077,"Illinois","Jackson County",4,16,566,273,293
050,17,077,"Illinois","Jackson County",4,17,561,274,287
050,17,077,"Illinois","Jackson County",4,18,971,483,488
050,17,077,"Illinois","Jackson County",4,19,1643,845,798
050,17,077,"Illinois","Jackson County",4,20,1768,831,937
050,17,077,"Illinois","Jackson County",4,21,2069,1115,954
050,17,077,"Illinois","Jackson County",4,22,1918,1023,895
050,17,077,"Illinois","Jackson County",4,23,1508,789,719
050,17,077,"Illinois","Jackson County",4,24,1200,617,583
050,17,077,"Illinois","Jackson County",4,25,908,463,445
050,17,077,"Illinois","Jackson County",4,26,756,375,381
050,17,077,"Illinois","Jackson County",4,27,593,275,318
050,17,077,"Illinois","Jackson County",4,28,604,301,303
050,17,077,"Illinois","Jackson County",4,29,614,296,318
050,17,077,"Illinois","Jackson County",4,30,654,336,318
050,17,077,"Illinois","Jackson County",4,31,648,326,322
050,17,077,"Illinois","Jackson County",4,32,618,311,307
050,17,077,"Illinois","Jackson County",4,33,583,291,292
050,17,077,"Illinois","Jackson County",4,34,616,303,313
050,17,077,"Illinois","Jackson County",4,35,604,293,311
050,17,077,"Illinois","Jackson County",4,36,562,276,286
050,17,077,"Illinois","Jackson County",4,37,558,279,279
050,17,077,"Illinois","Jackson County",4,38,516,269,247
050,17,077,"Illinois","Jackson County",4,39,567,298,269
050,17,077,"Illinois","Jackson County",4,40,573,291,282
050,17,077,"Illinois","Jackson County",4,41,533,283,250
050,17,077,"Illinois","Jackson County",4,42,550,288,262
050,17,077,"Illinois","Jackson County",4,43,519,257,262
050,17,077,"Illinois","Jackson County",4,44,504,253,251
050,17,077,"Illinois","Jackson County",4,45,494,243,251
050,17,077,"Illinois","Jackson County",4,46,524,270,254
050,17,077,"Illinois","Jackson County",4,47,491,264,227
050,17,077,"Illinois","Jackson County",4,48,473,248,225
050,17,077,"Illinois","Jackson County",4,49,475,253,222
050,17,077,"Illinois","Jackson County",4,50,505,253,252
050,17,077,"Illinois","Jackson County",4,51,491,239,252
050,17,077,"Illinois","Jackson County",4,52,504,240,264
050,17,077,"Illinois","Jackson County",4,53,507,253,254
050,17,077,"Illinois","Jackson County",4,54,479,230,249
050,17,077,"Illinois","Jackson County",4,55,463,226,237
050,17,077,"Illinois","Jackson County",4,56,503,257,246
050,17,077,"Illinois","Jackson County",4,57,534,268,266
050,17,077,"Illinois","Jackson County",4,58,541,274,267
050,17,077,"Illinois","Jackson County",4,59,571,262,309
050,17,077,"Illinois","Jackson County",4,60,591,286,305
050,17,077,"Illinois","Jackson County",4,61,594,284,310
050,17,077,"Illinois","Jackson County",4,62,601,280,321
050,17,077,"Illinois","Jackson County",4,63,577,264,313
050,17,077,"Illinois","Jackson County",4,64,560,277,283
050,17,077,"Illinois","Jackson County",4,65,562,288,274
050,17,077,"Illinois","Jackson County",4,66,570,289,281
050,17,077,"Illinois","Jackson County",4,67,568,270,298
050,17,077,"Illinois","Jackson County",4,68,548,257,291
050,17,077,"Illinois","Jackson County",4,69,530,250,280
050,17,077,"Illinois","Jackson County",4,70,512,240,272
050,17,077,"Illinois","Jackson County",4,71,502,247,255
050,17,077,"Illinois","Jackson County",4,72,506,238,268
050,17,077,"Illinois","Jackson County",4,73,486,242,244
050,17,077,"Illinois","Jackson County",4,74,459,225,234
050,17,077,"Illinois","Jackson County",4,75,460,214,246
050,17,077,"Illinois","Jackson County",4,76,279,125,154
050,17,077,"Illinois","Jackson County",4,77,286,137,149
050,17,077,"Illinois","Jackson County",4,78,262,120,142
050,17,077,"Illinois","Jackson County",4,79,268,110,158
050,17,077,"Illinois","Jackson County",4,80,222,92,130
050,17,077,"Illinois","Jackson County",4,81,208,84,124
050,17,077,"Illinois","Jackson County",4,82,192,87,105
050,17,077,"Illinois","Jackson County",4,83,177,76,101
050,17,077,"Illinois","Jackson County",4,84,173,68,105
050,17,077,"Illinois","Jackson County",4,85,1018,355,663
050,17,077,"Illinois","Jackson County",5,0,541,259,282
050,17,077,"Illinois","Jackson County",5,1,522,255,267
050,17,077,"Illinois","Jackson County",5,2,543,280,263
050,17,077,"Illinois","Jackson County",5,3,541,287,254
050,17,077,"Illinois","Jackson County",5,4,564,266,298
050,17,077,"Illinois","Jackson County",5,5,553,277,276
050,17,077,"Illinois","Jackson County",5,6,577,315,262
050,17,077,"Illinois","Jackson County",5,7,574,310,264
050,17,077,"Illinois","Jackson County",5,8,593,317,276
050,17,077,"Illinois","Jackson County",5,9,524,282,242
050,17,077,"Illinois","Jackson County",5,10,549,283,266
050,17,077,"Illinois","Jackson County",5,11,544,269,275
050,17,077,"Illinois","Jackson County",5,12,544,272,272
050,17,077,"Illinois","Jackson County",5,13,551,265,286
050,17,077,"Illinois","Jackson County",5,14,560,283,277
050,17,077,"Illinois","Jackson County",5,15,567,291,276
050,17,077,"Illinois","Jackson County",5,16,567,301,266
050,17,077,"Illinois","Jackson County",5,17,578,280,298
050,17,077,"Illinois","Jackson County",5,18,982,472,510
050,17,077,"Illinois","Jackson County",5,19,1647,839,808
050,17,077,"Illinois","Jackson County",5,20,1748,830,918
050,17,077,"Illinois","Jackson County",5,21,2036,1081,955
050,17,077,"Illinois","Jackson County",5,22,1927,1038,889
050,17,077,"Illinois","Jackson County",5,23,1566,846,720
050,17,077,"Illinois","Jackson County",5,24,1183,610,573
050,17,077,"Illinois","Jackson County",5,25,901,471,430
050,17,077,"Illinois","Jackson County",5,26,716,363,353
050,17,077,"Illinois","Jackson County",5,27,593,293,300
050,17,077,"Illinois","Jackson County",5,28,559,253,306
050,17,077,"Illinois","Jackson County",5,29,599,291,308
050,17,077,"Illinois","Jackson County",5,30,578,279,299
050,17,077,"Illinois","Jackson County",5,31,636,338,298
050,17,077,"Illinois","Jackson County",5,32,623,310,313
050,17,077,"Illinois","Jackson County",5,33,597,305,292
050,17,077,"Illinois","Jackson County",5,34,559,283,276
050,17,077,"Illinois","Jackson County",5,35,600,285,315
050,17,077,"Illinois","Jackson County",5,36,578,273,305
050,17,077,"Illinois","Jackson County",5,37,561,273,288
050,17,077,"Illinois","Jackson County",5,38,560,287,273
050,17,077,"Illinois","Jackson County",5,39,510,265,245
050,17,077,"Illinois","Jackson County",5,40,560,292,268
050,17,077,"Illinois","Jackson County",5,41,572,296,276
050,17,077,"Illinois","Jackson County",5,42,523,268,255
050,17,077,"Illinois","Jackson County",5,43,531,273,258
050,17,077,"Illinois","Jackson County",5,44,534,256,278
050,17,077,"Illinois","Jackson County",5,45,498,256,242
050,17,077,"Illinois","Jackson County",5,46,494,242,252
050,17,077,"Illinois","Jackson County",5,47,494,249,245
050,17,077,"Illinois","Jackson County",5,48,484,252,232
050,17,077,"Illinois","Jackson County",5,49,473,252,221
050,17,077,"Illinois","Jackson County",5,50,457,245,212
050,17,077,"Illinois","Jackson County",5,51,468,234,234
050,17,077,"Illinois","Jackson County",5,52,483,238,245
050,17,077,"Illinois","Jackson County",5,53,497,237,260
050,17,077,"Illinois","Jackson County",5,54,498,245,253
050,17,077,"Illinois","Jackson County",5,55,462,219,243
050,17,077,"Illinois","Jackson County",5,56,472,236,236
050,17,077,"Illinois","Jackson County",5,57,483,248,235
050,17,077,"Illinois","Jackson County",5,58,525,258,267
050,17,077,"Illinois","Jackson County",5,59,535,268,267
050,17,077,"Illinois","Jackson County",5,60,578,265,313
050,17,077,"Illinois","Jackson County",5,61,577,273,304
050,17,077,"Illinois","Jackson County",5,62,596,287,309
050,17,077,"Illinois","Jackson County",5,63,584,266,318
050,17,077,"Illinois","Jackson County",5,64,562,262,300
050,17,077,"Illinois","Jackson County",5,65,551,278,273
050,17,077,"Illinois","Jackson County",5,66,564,280,284
050,17,077,"Illinois","Jackson County",5,67,561,278,283
050,17,077,"Illinois","Jackson County",5,68,550,252,298
050,17,077,"Illinois","Jackson County",5,69,547,256,291
050,17,077,"Illinois","Jackson County",5,70,521,247,274
050,17,077,"Illinois","Jackson County",5,71,504,241,263
050,17,077,"Illinois","Jackson County",5,72,495,241,254
050,17,077,"Illinois","Jackson County",5,73,489,229,260
050,17,077,"Illinois","Jackson County",5,74,468,227,241
050,17,077,"Illinois","Jackson County",5,75,439,210,229
050,17,077,"Illinois","Jackson County",5,76,437,203,234
050,17,077,"Illinois","Jackson County",5,77,278,122,156
050,17,077,"Illinois","Jackson County",5,78,281,136,145
050,17,077,"Illinois","Jackson County",5,79,239,107,132
050,17,077,"Illinois","Jackson County",5,80,244,103,141
050,17,077,"Illinois","Jackson County",5,81,214,84,130
050,17,077,"Illinois","Jackson County",5,82,198,75,123
050,17,077,"Illinois","Jackson County",5,83,183,82,101
050,17,077,"Illinois","Jackson County",5,84,155,68,87
050,17,077,"Illinois","Jackson County",5,85,1032,357,675
050,17,079,"Illinois","Jasper County",1,0,114,58,56
050,17,079,"Illinois","Jasper County",1,1,124,61,63
050,17,079,"Illinois","Jasper County",1,2,111,55,56
050,17,079,"Illinois","Jasper County",1,3,105,50,55
050,17,079,"Illinois","Jasper County",1,4,104,54,50
050,17,079,"Illinois","Jasper County",1,5,121,67,54
050,17,079,"Illinois","Jasper County",1,6,104,62,42
050,17,079,"Illinois","Jasper County",1,7,109,58,51
050,17,079,"Illinois","Jasper County",1,8,118,60,58
050,17,079,"Illinois","Jasper County",1,9,132,66,66
050,17,079,"Illinois","Jasper County",1,10,130,66,64
050,17,079,"Illinois","Jasper County",1,11,117,55,62
050,17,079,"Illinois","Jasper County",1,12,120,69,51
050,17,079,"Illinois","Jasper County",1,13,110,61,49
050,17,079,"Illinois","Jasper County",1,14,116,61,55
050,17,079,"Illinois","Jasper County",1,15,123,64,59
050,17,079,"Illinois","Jasper County",1,16,133,69,64
050,17,079,"Illinois","Jasper County",1,17,133,65,68
050,17,079,"Illinois","Jasper County",1,18,105,48,57
050,17,079,"Illinois","Jasper County",1,19,87,44,43
050,17,079,"Illinois","Jasper County",1,20,90,46,44
050,17,079,"Illinois","Jasper County",1,21,93,46,47
050,17,079,"Illinois","Jasper County",1,22,83,42,41
050,17,079,"Illinois","Jasper County",1,23,90,45,45
050,17,079,"Illinois","Jasper County",1,24,82,38,44
050,17,079,"Illinois","Jasper County",1,25,94,42,52
050,17,079,"Illinois","Jasper County",1,26,92,40,52
050,17,079,"Illinois","Jasper County",1,27,102,50,52
050,17,079,"Illinois","Jasper County",1,28,100,47,53
050,17,079,"Illinois","Jasper County",1,29,96,56,40
050,17,079,"Illinois","Jasper County",1,30,91,46,45
050,17,079,"Illinois","Jasper County",1,31,103,46,57
050,17,079,"Illinois","Jasper County",1,32,94,43,51
050,17,079,"Illinois","Jasper County",1,33,97,48,49
050,17,079,"Illinois","Jasper County",1,34,97,58,39
050,17,079,"Illinois","Jasper County",1,35,108,56,52
050,17,079,"Illinois","Jasper County",1,36,99,50,49
050,17,079,"Illinois","Jasper County",1,37,115,59,56
050,17,079,"Illinois","Jasper County",1,38,123,70,53
050,17,079,"Illinois","Jasper County",1,39,106,60,46
050,17,079,"Illinois","Jasper County",1,40,114,58,56
050,17,079,"Illinois","Jasper County",1,41,118,57,61
050,17,079,"Illinois","Jasper County",1,42,125,68,57
050,17,079,"Illinois","Jasper County",1,43,109,64,45
050,17,079,"Illinois","Jasper County",1,44,102,60,42
050,17,079,"Illinois","Jasper County",1,45,89,52,37
050,17,079,"Illinois","Jasper County",1,46,97,52,45
050,17,079,"Illinois","Jasper County",1,47,108,55,53
050,17,079,"Illinois","Jasper County",1,48,118,57,61
050,17,079,"Illinois","Jasper County",1,49,106,56,50
050,17,079,"Illinois","Jasper County",1,50,113,56,57
050,17,079,"Illinois","Jasper County",1,51,124,60,64
050,17,079,"Illinois","Jasper County",1,52,103,49,54
050,17,079,"Illinois","Jasper County",1,53,122,60,62
050,17,079,"Illinois","Jasper County",1,54,129,61,68
050,17,079,"Illinois","Jasper County",1,55,150,73,77
050,17,079,"Illinois","Jasper County",1,56,148,79,69
050,17,079,"Illinois","Jasper County",1,57,174,98,76
050,17,079,"Illinois","Jasper County",1,58,155,86,69
050,17,079,"Illinois","Jasper County",1,59,152,92,60
050,17,079,"Illinois","Jasper County",1,60,148,85,63
050,17,079,"Illinois","Jasper County",1,61,135,69,66
050,17,079,"Illinois","Jasper County",1,62,147,74,73
050,17,079,"Illinois","Jasper County",1,63,134,63,71
050,17,079,"Illinois","Jasper County",1,64,129,56,73
050,17,079,"Illinois","Jasper County",1,65,126,59,67
050,17,079,"Illinois","Jasper County",1,66,136,72,64
050,17,079,"Illinois","Jasper County",1,67,125,63,62
050,17,079,"Illinois","Jasper County",1,68,110,56,54
050,17,079,"Illinois","Jasper County",1,69,110,63,47
050,17,079,"Illinois","Jasper County",1,70,106,56,50
050,17,079,"Illinois","Jasper County",1,71,98,40,58
050,17,079,"Illinois","Jasper County",1,72,101,50,51
050,17,079,"Illinois","Jasper County",1,73,109,54,55
050,17,079,"Illinois","Jasper County",1,74,65,30,35
050,17,079,"Illinois","Jasper County",1,75,67,29,38
050,17,079,"Illinois","Jasper County",1,76,71,32,39
050,17,079,"Illinois","Jasper County",1,77,58,31,27
050,17,079,"Illinois","Jasper County",1,78,48,24,24
050,17,079,"Illinois","Jasper County",1,79,48,22,26
050,17,079,"Illinois","Jasper County",1,80,52,18,34
050,17,079,"Illinois","Jasper County",1,81,54,23,31
050,17,079,"Illinois","Jasper County",1,82,44,21,23
050,17,079,"Illinois","Jasper County",1,83,47,26,21
050,17,079,"Illinois","Jasper County",1,84,41,20,21
050,17,079,"Illinois","Jasper County",1,85,251,98,153
050,17,079,"Illinois","Jasper County",2,0,109,57,52
050,17,079,"Illinois","Jasper County",2,1,119,59,60
050,17,079,"Illinois","Jasper County",2,2,112,56,56
050,17,079,"Illinois","Jasper County",2,3,104,50,54
050,17,079,"Illinois","Jasper County",2,4,101,51,50
050,17,079,"Illinois","Jasper County",2,5,117,64,53
050,17,079,"Illinois","Jasper County",2,6,108,63,45
050,17,079,"Illinois","Jasper County",2,7,107,58,49
050,17,079,"Illinois","Jasper County",2,8,116,59,57
050,17,079,"Illinois","Jasper County",2,9,127,64,63
050,17,079,"Illinois","Jasper County",2,10,129,66,63
050,17,079,"Illinois","Jasper County",2,11,119,57,62
050,17,079,"Illinois","Jasper County",2,12,120,66,54
050,17,079,"Illinois","Jasper County",2,13,113,63,50
050,17,079,"Illinois","Jasper County",2,14,112,60,52
050,17,079,"Illinois","Jasper County",2,15,121,63,58
050,17,079,"Illinois","Jasper County",2,16,131,68,63
050,17,079,"Illinois","Jasper County",2,17,134,66,68
050,17,079,"Illinois","Jasper County",2,18,105,50,55
050,17,079,"Illinois","Jasper County",2,19,85,41,44
050,17,079,"Illinois","Jasper County",2,20,92,47,45
050,17,079,"Illinois","Jasper County",2,21,92,45,47
050,17,079,"Illinois","Jasper County",2,22,84,42,42
050,17,079,"Illinois","Jasper County",2,23,85,43,42
050,17,079,"Illinois","Jasper County",2,24,83,39,44
050,17,079,"Illinois","Jasper County",2,25,91,40,51
050,17,079,"Illinois","Jasper County",2,26,93,40,53
050,17,079,"Illinois","Jasper County",2,27,98,47,51
050,17,079,"Illinois","Jasper County",2,28,99,48,51
050,17,079,"Illinois","Jasper County",2,29,96,54,42
050,17,079,"Illinois","Jasper County",2,30,93,49,44
050,17,079,"Illinois","Jasper County",2,31,99,45,54
050,17,079,"Illinois","Jasper County",2,32,95,43,52
050,17,079,"Illinois","Jasper County",2,33,96,47,49
050,17,079,"Illinois","Jasper County",2,34,98,56,42
050,17,079,"Illinois","Jasper County",2,35,105,56,49
050,17,079,"Illinois","Jasper County",2,36,101,51,50
050,17,079,"Illinois","Jasper County",2,37,111,57,54
050,17,079,"Illinois","Jasper County",2,38,121,67,54
050,17,079,"Illinois","Jasper County",2,39,110,62,48
050,17,079,"Illinois","Jasper County",2,40,113,59,54
050,17,079,"Illinois","Jasper County",2,41,118,57,61
050,17,079,"Illinois","Jasper County",2,42,122,65,57
050,17,079,"Illinois","Jasper County",2,43,114,66,48
050,17,079,"Illinois","Jasper County",2,44,103,61,42
050,17,079,"Illinois","Jasper County",2,45,93,54,39
050,17,079,"Illinois","Jasper County",2,46,94,51,43
050,17,079,"Illinois","Jasper County",2,47,106,55,51
050,17,079,"Illinois","Jasper County",2,48,114,56,58
050,17,079,"Illinois","Jasper County",2,49,109,57,52
050,17,079,"Illinois","Jasper County",2,50,111,56,55
050,17,079,"Illinois","Jasper County",2,51,120,58,62
050,17,079,"Illinois","Jasper County",2,52,109,52,57
050,17,079,"Illinois","Jasper County",2,53,117,57,60
050,17,079,"Illinois","Jasper County",2,54,127,61,66
050,17,079,"Illinois","Jasper County",2,55,144,69,75
050,17,079,"Illinois","Jasper County",2,56,149,78,71
050,17,079,"Illinois","Jasper County",2,57,168,93,75
050,17,079,"Illinois","Jasper County",2,58,159,89,70
050,17,079,"Illinois","Jasper County",2,59,153,91,62
050,17,079,"Illinois","Jasper County",2,60,148,86,62
050,17,079,"Illinois","Jasper County",2,61,136,71,65
050,17,079,"Illinois","Jasper County",2,62,143,72,71
050,17,079,"Illinois","Jasper County",2,63,138,66,72
050,17,079,"Illinois","Jasper County",2,64,129,57,72
050,17,079,"Illinois","Jasper County",2,65,125,57,68
050,17,079,"Illinois","Jasper County",2,66,135,70,65
050,17,079,"Illinois","Jasper County",2,67,127,65,62
050,17,079,"Illinois","Jasper County",2,68,111,56,55
050,17,079,"Illinois","Jasper County",2,69,110,61,49
050,17,079,"Illinois","Jasper County",2,70,105,57,48
050,17,079,"Illinois","Jasper County",2,71,98,43,55
050,17,079,"Illinois","Jasper County",2,72,98,46,52
050,17,079,"Illinois","Jasper County",2,73,113,56,57
050,17,079,"Illinois","Jasper County",2,74,70,33,37
050,17,079,"Illinois","Jasper County",2,75,65,28,37
050,17,079,"Illinois","Jasper County",2,76,69,31,38
050,17,079,"Illinois","Jasper County",2,77,62,31,31
050,17,079,"Illinois","Jasper County",2,78,50,25,25
050,17,079,"Illinois","Jasper County",2,79,46,21,25
050,17,079,"Illinois","Jasper County",2,80,50,18,32
050,17,079,"Illinois","Jasper County",2,81,54,22,32
050,17,079,"Illinois","Jasper County",2,82,46,22,24
050,17,079,"Illinois","Jasper County",2,83,45,24,21
050,17,079,"Illinois","Jasper County",2,84,42,21,21
050,17,079,"Illinois","Jasper County",2,85,252,98,154
050,17,079,"Illinois","Jasper County",3,0,102,53,49
050,17,079,"Illinois","Jasper County",3,1,115,57,58
050,17,079,"Illinois","Jasper County",3,2,116,60,56
050,17,079,"Illinois","Jasper County",3,3,118,58,60
050,17,079,"Illinois","Jasper County",3,4,106,52,54
050,17,079,"Illinois","Jasper County",3,5,107,58,49
050,17,079,"Illinois","Jasper County",3,6,117,64,53
050,17,079,"Illinois","Jasper County",3,7,116,67,49
050,17,079,"Illinois","Jasper County",3,8,109,60,49
050,17,079,"Illinois","Jasper County",3,9,117,65,52
050,17,079,"Illinois","Jasper County",3,10,123,60,63
050,17,079,"Illinois","Jasper County",3,11,136,72,64
050,17,079,"Illinois","Jasper County",3,12,120,55,65
050,17,079,"Illinois","Jasper County",3,13,117,63,54
050,17,079,"Illinois","Jasper County",3,14,107,56,51
050,17,079,"Illinois","Jasper County",3,15,106,61,45
050,17,079,"Illinois","Jasper County",3,16,121,62,59
050,17,079,"Illinois","Jasper County",3,17,125,66,59
050,17,079,"Illinois","Jasper County",3,18,105,54,51
050,17,079,"Illinois","Jasper County",3,19,82,39,43
050,17,079,"Illinois","Jasper County",3,20,94,48,46
050,17,079,"Illinois","Jasper County",3,21,88,44,44
050,17,079,"Illinois","Jasper County",3,22,91,49,42
050,17,079,"Illinois","Jasper County",3,23,86,43,43
050,17,079,"Illinois","Jasper County",3,24,85,45,40
050,17,079,"Illinois","Jasper County",3,25,81,36,45
050,17,079,"Illinois","Jasper County",3,26,100,40,60
050,17,079,"Illinois","Jasper County",3,27,96,40,56
050,17,079,"Illinois","Jasper County",3,28,93,45,48
050,17,079,"Illinois","Jasper County",3,29,99,49,50
050,17,079,"Illinois","Jasper County",3,30,98,54,44
050,17,079,"Illinois","Jasper County",3,31,94,51,43
050,17,079,"Illinois","Jasper County",3,32,94,42,52
050,17,079,"Illinois","Jasper County",3,33,101,49,52
050,17,079,"Illinois","Jasper County",3,34,93,43,50
050,17,079,"Illinois","Jasper County",3,35,97,55,42
050,17,079,"Illinois","Jasper County",3,36,109,59,50
050,17,079,"Illinois","Jasper County",3,37,102,52,50
050,17,079,"Illinois","Jasper County",3,38,105,56,49
050,17,079,"Illinois","Jasper County",3,39,124,71,53
050,17,079,"Illinois","Jasper County",3,40,107,61,46
050,17,079,"Illinois","Jasper County",3,41,113,58,55
050,17,079,"Illinois","Jasper County",3,42,118,58,60
050,17,079,"Illinois","Jasper County",3,43,122,65,57
050,17,079,"Illinois","Jasper County",3,44,114,66,48
050,17,079,"Illinois","Jasper County",3,45,99,58,41
050,17,079,"Illinois","Jasper County",3,46,95,52,43
050,17,079,"Illinois","Jasper County",3,47,89,48,41
050,17,079,"Illinois","Jasper County",3,48,102,54,48
050,17,079,"Illinois","Jasper County",3,49,112,57,55
050,17,079,"Illinois","Jasper County",3,50,107,56,51
050,17,079,"Illinois","Jasper County",3,51,114,54,60
050,17,079,"Illinois","Jasper County",3,52,120,57,63
050,17,079,"Illinois","Jasper County",3,53,107,52,55
050,17,079,"Illinois","Jasper County",3,54,116,57,59
050,17,079,"Illinois","Jasper County",3,55,130,61,69
050,17,079,"Illinois","Jasper County",3,56,147,71,76
050,17,079,"Illinois","Jasper County",3,57,146,77,69
050,17,079,"Illinois","Jasper County",3,58,167,93,74
050,17,079,"Illinois","Jasper County",3,59,160,91,69
050,17,079,"Illinois","Jasper County",3,60,155,89,66
050,17,079,"Illinois","Jasper County",3,61,143,81,62
050,17,079,"Illinois","Jasper County",3,62,138,73,65
050,17,079,"Illinois","Jasper County",3,63,142,71,71
050,17,079,"Illinois","Jasper County",3,64,135,64,71
050,17,079,"Illinois","Jasper County",3,65,127,55,72
050,17,079,"Illinois","Jasper County",3,66,124,57,67
050,17,079,"Illinois","Jasper County",3,67,127,66,61
050,17,079,"Illinois","Jasper County",3,68,124,64,60
050,17,079,"Illinois","Jasper County",3,69,109,56,53
050,17,079,"Illinois","Jasper County",3,70,110,60,50
050,17,079,"Illinois","Jasper County",3,71,100,54,46
050,17,079,"Illinois","Jasper County",3,72,99,41,58
050,17,079,"Illinois","Jasper County",3,73,96,48,48
050,17,079,"Illinois","Jasper County",3,74,113,56,57
050,17,079,"Illinois","Jasper County",3,75,68,31,37
050,17,079,"Illinois","Jasper County",3,76,59,24,35
050,17,079,"Illinois","Jasper County",3,77,67,29,38
050,17,079,"Illinois","Jasper County",3,78,60,30,30
050,17,079,"Illinois","Jasper County",3,79,47,24,23
050,17,079,"Illinois","Jasper County",3,80,42,18,24
050,17,079,"Illinois","Jasper County",3,81,49,17,32
050,17,079,"Illinois","Jasper County",3,82,53,23,30
050,17,079,"Illinois","Jasper County",3,83,41,20,21
050,17,079,"Illinois","Jasper County",3,84,39,19,20
050,17,079,"Illinois","Jasper County",3,85,246,100,146
050,17,079,"Illinois","Jasper County",4,0,91,49,42
050,17,079,"Illinois","Jasper County",4,1,104,53,51
050,17,079,"Illinois","Jasper County",4,2,111,55,56
050,17,079,"Illinois","Jasper County",4,3,120,61,59
050,17,079,"Illinois","Jasper County",4,4,117,57,60
050,17,079,"Illinois","Jasper County",4,5,115,56,59
050,17,079,"Illinois","Jasper County",4,6,109,56,53
050,17,079,"Illinois","Jasper County",4,7,122,65,57
050,17,079,"Illinois","Jasper County",4,8,123,71,52
050,17,079,"Illinois","Jasper County",4,9,115,57,58
050,17,079,"Illinois","Jasper County",4,10,116,64,52
050,17,079,"Illinois","Jasper County",4,11,129,64,65
050,17,079,"Illinois","Jasper County",4,12,138,74,64
050,17,079,"Illinois","Jasper County",4,13,117,57,60
050,17,079,"Illinois","Jasper County",4,14,118,64,54
050,17,079,"Illinois","Jasper County",4,15,112,57,55
050,17,079,"Illinois","Jasper County",4,16,109,59,50
050,17,079,"Illinois","Jasper County",4,17,118,62,56
050,17,079,"Illinois","Jasper County",4,18,103,58,45
050,17,079,"Illinois","Jasper County",4,19,76,42,34
050,17,079,"Illinois","Jasper County",4,20,94,48,46
050,17,079,"Illinois","Jasper County",4,21,89,45,44
050,17,079,"Illinois","Jasper County",4,22,85,43,42
050,17,079,"Illinois","Jasper County",4,23,88,46,42
050,17,079,"Illinois","Jasper County",4,24,83,40,43
050,17,079,"Illinois","Jasper County",4,25,88,49,39
050,17,079,"Illinois","Jasper County",4,26,79,37,42
050,17,079,"Illinois","Jasper County",4,27,104,45,59
050,17,079,"Illinois","Jasper County",4,28,96,42,54
050,17,079,"Illinois","Jasper County",4,29,94,48,46
050,17,079,"Illinois","Jasper County",4,30,95,46,49
050,17,079,"Illinois","Jasper County",4,31,102,57,45
050,17,079,"Illinois","Jasper County",4,32,98,54,44
050,17,079,"Illinois","Jasper County",4,33,104,46,58
050,17,079,"Illinois","Jasper County",4,34,101,49,52
050,17,079,"Illinois","Jasper County",4,35,96,42,54
050,17,079,"Illinois","Jasper County",4,36,104,58,46
050,17,079,"Illinois","Jasper County",4,37,110,60,50
050,17,079,"Illinois","Jasper County",4,38,103,52,51
050,17,079,"Illinois","Jasper County",4,39,103,55,48
050,17,079,"Illinois","Jasper County",4,40,127,70,57
050,17,079,"Illinois","Jasper County",4,41,107,61,46
050,17,079,"Illinois","Jasper County",4,42,115,58,57
050,17,079,"Illinois","Jasper County",4,43,115,59,56
050,17,079,"Illinois","Jasper County",4,44,124,68,56
050,17,079,"Illinois","Jasper County",4,45,108,62,46
050,17,079,"Illinois","Jasper County",4,46,98,56,42
050,17,079,"Illinois","Jasper County",4,47,95,53,42
050,17,079,"Illinois","Jasper County",4,48,92,50,42
050,17,079,"Illinois","Jasper County",4,49,103,55,48
050,17,079,"Illinois","Jasper County",4,50,111,55,56
050,17,079,"Illinois","Jasper County",4,51,109,56,53
050,17,079,"Illinois","Jasper County",4,52,114,54,60
050,17,079,"Illinois","Jasper County",4,53,116,55,61
050,17,079,"Illinois","Jasper County",4,54,110,52,58
050,17,079,"Illinois","Jasper County",4,55,117,58,59
050,17,079,"Illinois","Jasper County",4,56,129,61,68
050,17,079,"Illinois","Jasper County",4,57,144,70,74
050,17,079,"Illinois","Jasper County",4,58,141,73,68
050,17,079,"Illinois","Jasper County",4,59,167,95,72
050,17,079,"Illinois","Jasper County",4,60,156,87,69
050,17,079,"Illinois","Jasper County",4,61,152,87,65
050,17,079,"Illinois","Jasper County",4,62,138,77,61
050,17,079,"Illinois","Jasper County",4,63,138,72,66
050,17,079,"Illinois","Jasper County",4,64,136,67,69
050,17,079,"Illinois","Jasper County",4,65,132,62,70
050,17,079,"Illinois","Jasper County",4,66,126,54,72
050,17,079,"Illinois","Jasper County",4,67,123,57,66
050,17,079,"Illinois","Jasper County",4,68,121,63,58
050,17,079,"Illinois","Jasper County",4,69,122,62,60
050,17,079,"Illinois","Jasper County",4,70,110,56,54
050,17,079,"Illinois","Jasper County",4,71,105,54,51
050,17,079,"Illinois","Jasper County",4,72,97,49,48
050,17,079,"Illinois","Jasper County",4,73,100,42,58
050,17,079,"Illinois","Jasper County",4,74,96,47,49
050,17,079,"Illinois","Jasper County",4,75,105,50,55
050,17,079,"Illinois","Jasper County",4,76,62,28,34
050,17,079,"Illinois","Jasper County",4,77,56,21,35
050,17,079,"Illinois","Jasper County",4,78,63,27,36
050,17,079,"Illinois","Jasper County",4,79,59,30,29
050,17,079,"Illinois","Jasper County",4,80,45,23,22
050,17,079,"Illinois","Jasper County",4,81,40,17,23
050,17,079,"Illinois","Jasper County",4,82,47,18,29
050,17,079,"Illinois","Jasper County",4,83,47,21,26
050,17,079,"Illinois","Jasper County",4,84,36,17,19
050,17,079,"Illinois","Jasper County",4,85,239,99,140
050,17,079,"Illinois","Jasper County",5,0,82,45,37
050,17,079,"Illinois","Jasper County",5,1,88,44,44
050,17,079,"Illinois","Jasper County",5,2,104,56,48
050,17,079,"Illinois","Jasper County",5,3,114,58,56
050,17,079,"Illinois","Jasper County",5,4,120,61,59
050,17,079,"Illinois","Jasper County",5,5,116,53,63
050,17,079,"Illinois","Jasper County",5,6,114,56,58
050,17,079,"Illinois","Jasper County",5,7,108,56,52
050,17,079,"Illinois","Jasper County",5,8,122,65,57
050,17,079,"Illinois","Jasper County",5,9,126,73,53
050,17,079,"Illinois","Jasper County",5,10,114,60,54
050,17,079,"Illinois","Jasper County",5,11,120,67,53
050,17,079,"Illinois","Jasper County",5,12,134,65,69
050,17,079,"Illinois","Jasper County",5,13,144,76,68
050,17,079,"Illinois","Jasper County",5,14,118,57,61
050,17,079,"Illinois","Jasper County",5,15,122,68,54
050,17,079,"Illinois","Jasper County",5,16,109,57,52
050,17,079,"Illinois","Jasper County",5,17,109,60,49
050,17,079,"Illinois","Jasper County",5,18,95,50,45
050,17,079,"Illinois","Jasper County",5,19,75,42,33
050,17,079,"Illinois","Jasper County",5,20,80,43,37
050,17,079,"Illinois","Jasper County",5,21,89,47,42
050,17,079,"Illinois","Jasper County",5,22,93,45,48
050,17,079,"Illinois","Jasper County",5,23,91,45,46
050,17,079,"Illinois","Jasper County",5,24,90,48,42
050,17,079,"Illinois","Jasper County",5,25,78,39,39
050,17,079,"Illinois","Jasper County",5,26,96,50,46
050,17,079,"Illinois","Jasper County",5,27,79,39,40
050,17,079,"Illinois","Jasper County",5,28,98,39,59
050,17,079,"Illinois","Jasper County",5,29,101,47,54
050,17,079,"Illinois","Jasper County",5,30,88,48,40
050,17,079,"Illinois","Jasper County",5,31,94,47,47
050,17,079,"Illinois","Jasper County",5,32,96,54,42
050,17,079,"Illinois","Jasper County",5,33,102,59,43
050,17,079,"Illinois","Jasper County",5,34,110,51,59
050,17,079,"Illinois","Jasper County",5,35,105,52,53
050,17,079,"Illinois","Jasper County",5,36,101,46,55
050,17,079,"Illinois","Jasper County",5,37,106,60,46
050,17,079,"Illinois","Jasper County",5,38,112,59,53
050,17,079,"Illinois","Jasper County",5,39,106,54,52
050,17,079,"Illinois","Jasper County",5,40,104,57,47
050,17,079,"Illinois","Jasper County",5,41,135,74,61
050,17,079,"Illinois","Jasper County",5,42,106,61,45
050,17,079,"Illinois","Jasper County",5,43,114,58,56
050,17,079,"Illinois","Jasper County",5,44,112,59,53
050,17,079,"Illinois","Jasper County",5,45,125,67,58
050,17,079,"Illinois","Jasper County",5,46,105,62,43
050,17,079,"Illinois","Jasper County",5,47,99,52,47
050,17,079,"Illinois","Jasper County",5,48,93,50,43
050,17,079,"Illinois","Jasper County",5,49,93,50,43
050,17,079,"Illinois","Jasper County",5,50,100,55,45
050,17,079,"Illinois","Jasper County",5,51,112,53,59
050,17,079,"Illinois","Jasper County",5,52,112,58,54
050,17,079,"Illinois","Jasper County",5,53,114,54,60
050,17,079,"Illinois","Jasper County",5,54,118,55,63
050,17,079,"Illinois","Jasper County",5,55,108,53,55
050,17,079,"Illinois","Jasper County",5,56,111,54,57
050,17,079,"Illinois","Jasper County",5,57,123,60,63
050,17,079,"Illinois","Jasper County",5,58,140,67,73
050,17,079,"Illinois","Jasper County",5,59,142,73,69
050,17,079,"Illinois","Jasper County",5,60,167,94,73
050,17,079,"Illinois","Jasper County",5,61,152,85,67
050,17,079,"Illinois","Jasper County",5,62,152,86,66
050,17,079,"Illinois","Jasper County",5,63,138,77,61
050,17,079,"Illinois","Jasper County",5,64,137,70,67
050,17,079,"Illinois","Jasper County",5,65,136,66,70
050,17,079,"Illinois","Jasper County",5,66,132,63,69
050,17,079,"Illinois","Jasper County",5,67,124,50,74
050,17,079,"Illinois","Jasper County",5,68,118,54,64
050,17,079,"Illinois","Jasper County",5,69,115,60,55
050,17,079,"Illinois","Jasper County",5,70,123,59,64
050,17,079,"Illinois","Jasper County",5,71,104,51,53
050,17,079,"Illinois","Jasper County",5,72,103,53,50
050,17,079,"Illinois","Jasper County",5,73,96,49,47
050,17,079,"Illinois","Jasper County",5,74,100,43,57
050,17,079,"Illinois","Jasper County",5,75,92,44,48
050,17,079,"Illinois","Jasper County",5,76,101,49,52
050,17,079,"Illinois","Jasper County",5,77,61,28,33
050,17,079,"Illinois","Jasper County",5,78,53,20,33
050,17,079,"Illinois","Jasper County",5,79,61,26,35
050,17,079,"Illinois","Jasper County",5,80,57,29,28
050,17,079,"Illinois","Jasper County",5,81,44,22,22
050,17,079,"Illinois","Jasper County",5,82,38,18,20
050,17,079,"Illinois","Jasper County",5,83,44,18,26
050,17,079,"Illinois","Jasper County",5,84,42,18,24
050,17,079,"Illinois","Jasper County",5,85,239,98,141
050,17,081,"Illinois","Jefferson County",1,0,427,221,206
050,17,081,"Illinois","Jefferson County",1,1,449,239,210
050,17,081,"Illinois","Jefferson County",1,2,450,218,232
050,17,081,"Illinois","Jefferson County",1,3,458,222,236
050,17,081,"Illinois","Jefferson County",1,4,505,269,236
050,17,081,"Illinois","Jefferson County",1,5,497,250,247
050,17,081,"Illinois","Jefferson County",1,6,455,225,230
050,17,081,"Illinois","Jefferson County",1,7,456,235,221
050,17,081,"Illinois","Jefferson County",1,8,451,222,229
050,17,081,"Illinois","Jefferson County",1,9,444,217,227
050,17,081,"Illinois","Jefferson County",1,10,506,260,246
050,17,081,"Illinois","Jefferson County",1,11,509,258,251
050,17,081,"Illinois","Jefferson County",1,12,475,239,236
050,17,081,"Illinois","Jefferson County",1,13,484,242,242
050,17,081,"Illinois","Jefferson County",1,14,454,219,235
050,17,081,"Illinois","Jefferson County",1,15,463,235,228
050,17,081,"Illinois","Jefferson County",1,16,476,240,236
050,17,081,"Illinois","Jefferson County",1,17,468,245,223
050,17,081,"Illinois","Jefferson County",1,18,404,230,174
050,17,081,"Illinois","Jefferson County",1,19,326,186,140
050,17,081,"Illinois","Jefferson County",1,20,367,210,157
050,17,081,"Illinois","Jefferson County",1,21,362,211,151
050,17,081,"Illinois","Jefferson County",1,22,363,204,159
050,17,081,"Illinois","Jefferson County",1,23,403,216,187
050,17,081,"Illinois","Jefferson County",1,24,456,241,215
050,17,081,"Illinois","Jefferson County",1,25,446,244,202
050,17,081,"Illinois","Jefferson County",1,26,446,244,202
050,17,081,"Illinois","Jefferson County",1,27,485,261,224
050,17,081,"Illinois","Jefferson County",1,28,499,266,233
050,17,081,"Illinois","Jefferson County",1,29,519,288,231
050,17,081,"Illinois","Jefferson County",1,30,481,267,214
050,17,081,"Illinois","Jefferson County",1,31,435,230,205
050,17,081,"Illinois","Jefferson County",1,32,420,220,200
050,17,081,"Illinois","Jefferson County",1,33,405,222,183
050,17,081,"Illinois","Jefferson County",1,34,429,236,193
050,17,081,"Illinois","Jefferson County",1,35,432,224,208
050,17,081,"Illinois","Jefferson County",1,36,482,258,224
050,17,081,"Illinois","Jefferson County",1,37,464,242,222
050,17,081,"Illinois","Jefferson County",1,38,478,244,234
050,17,081,"Illinois","Jefferson County",1,39,490,278,212
050,17,081,"Illinois","Jefferson County",1,40,459,247,212
050,17,081,"Illinois","Jefferson County",1,41,460,263,197
050,17,081,"Illinois","Jefferson County",1,42,436,235,201
050,17,081,"Illinois","Jefferson County",1,43,471,260,211
050,17,081,"Illinois","Jefferson County",1,44,425,230,195
050,17,081,"Illinois","Jefferson County",1,45,453,243,210
050,17,081,"Illinois","Jefferson County",1,46,416,223,193
050,17,081,"Illinois","Jefferson County",1,47,440,238,202
050,17,081,"Illinois","Jefferson County",1,48,456,242,214
050,17,081,"Illinois","Jefferson County",1,49,451,235,216
050,17,081,"Illinois","Jefferson County",1,50,474,231,243
050,17,081,"Illinois","Jefferson County",1,51,469,250,219
050,17,081,"Illinois","Jefferson County",1,52,449,237,212
050,17,081,"Illinois","Jefferson County",1,53,468,249,219
050,17,081,"Illinois","Jefferson County",1,54,483,260,223
050,17,081,"Illinois","Jefferson County",1,55,524,269,255
050,17,081,"Illinois","Jefferson County",1,56,541,275,266
050,17,081,"Illinois","Jefferson County",1,57,517,268,249
050,17,081,"Illinois","Jefferson County",1,58,480,243,237
050,17,081,"Illinois","Jefferson County",1,59,493,251,242
050,17,081,"Illinois","Jefferson County",1,60,478,243,235
050,17,081,"Illinois","Jefferson County",1,61,529,267,262
050,17,081,"Illinois","Jefferson County",1,62,538,253,285
050,17,081,"Illinois","Jefferson County",1,63,502,248,254
050,17,081,"Illinois","Jefferson County",1,64,482,241,241
050,17,081,"Illinois","Jefferson County",1,65,470,221,249
050,17,081,"Illinois","Jefferson County",1,66,489,231,258
050,17,081,"Illinois","Jefferson County",1,67,473,234,239
050,17,081,"Illinois","Jefferson County",1,68,463,225,238
050,17,081,"Illinois","Jefferson County",1,69,420,197,223
050,17,081,"Illinois","Jefferson County",1,70,419,207,212
050,17,081,"Illinois","Jefferson County",1,71,407,202,205
050,17,081,"Illinois","Jefferson County",1,72,404,204,200
050,17,081,"Illinois","Jefferson County",1,73,407,194,213
050,17,081,"Illinois","Jefferson County",1,74,277,126,151
050,17,081,"Illinois","Jefferson County",1,75,278,125,153
050,17,081,"Illinois","Jefferson County",1,76,281,122,159
050,17,081,"Illinois","Jefferson County",1,77,297,140,157
050,17,081,"Illinois","Jefferson County",1,78,235,111,124
050,17,081,"Illinois","Jefferson County",1,79,216,101,115
050,17,081,"Illinois","Jefferson County",1,80,203,98,105
050,17,081,"Illinois","Jefferson County",1,81,181,75,106
050,17,081,"Illinois","Jefferson County",1,82,172,83,89
050,17,081,"Illinois","Jefferson County",1,83,166,79,87
050,17,081,"Illinois","Jefferson County",1,84,126,54,72
050,17,081,"Illinois","Jefferson County",1,85,813,275,538
050,17,081,"Illinois","Jefferson County",2,0,411,224,187
050,17,081,"Illinois","Jefferson County",2,1,442,233,209
050,17,081,"Illinois","Jefferson County",2,2,449,223,226
050,17,081,"Illinois","Jefferson County",2,3,454,219,235
050,17,081,"Illinois","Jefferson County",2,4,499,260,239
050,17,081,"Illinois","Jefferson County",2,5,495,250,245
050,17,081,"Illinois","Jefferson County",2,6,464,229,235
050,17,081,"Illinois","Jefferson County",2,7,450,228,222
050,17,081,"Illinois","Jefferson County",2,8,446,222,224
050,17,081,"Illinois","Jefferson County",2,9,441,216,225
050,17,081,"Illinois","Jefferson County",2,10,488,247,241
050,17,081,"Illinois","Jefferson County",2,11,507,256,251
050,17,081,"Illinois","Jefferson County",2,12,485,244,241
050,17,081,"Illinois","Jefferson County",2,13,479,240,239
050,17,081,"Illinois","Jefferson County",2,14,459,224,235
050,17,081,"Illinois","Jefferson County",2,15,462,232,230
050,17,081,"Illinois","Jefferson County",2,16,473,239,234
050,17,081,"Illinois","Jefferson County",2,17,470,244,226
050,17,081,"Illinois","Jefferson County",2,18,405,229,176
050,17,081,"Illinois","Jefferson County",2,19,327,187,140
050,17,081,"Illinois","Jefferson County",2,20,368,211,157
050,17,081,"Illinois","Jefferson County",2,21,368,214,154
050,17,081,"Illinois","Jefferson County",2,22,368,207,161
050,17,081,"Illinois","Jefferson County",2,23,402,216,186
050,17,081,"Illinois","Jefferson County",2,24,442,234,208
050,17,081,"Illinois","Jefferson County",2,25,447,244,203
050,17,081,"Illinois","Jefferson County",2,26,449,247,202
050,17,081,"Illinois","Jefferson County",2,27,475,255,220
050,17,081,"Illinois","Jefferson County",2,28,496,266,230
050,17,081,"Illinois","Jefferson County",2,29,511,283,228
050,17,081,"Illinois","Jefferson County",2,30,491,270,221
050,17,081,"Illinois","Jefferson County",2,31,442,236,206
050,17,081,"Illinois","Jefferson County",2,32,419,220,199
050,17,081,"Illinois","Jefferson County",2,33,406,220,186
050,17,081,"Illinois","Jefferson County",2,34,422,230,192
050,17,081,"Illinois","Jefferson County",2,35,434,229,205
050,17,081,"Illinois","Jefferson County",2,36,465,248,217
050,17,081,"Illinois","Jefferson County",2,37,468,245,223
050,17,081,"Illinois","Jefferson County",2,38,476,244,232
050,17,081,"Illinois","Jefferson County",2,39,482,265,217
050,17,081,"Illinois","Jefferson County",2,40,469,256,213
050,17,081,"Illinois","Jefferson County",2,41,461,260,201
050,17,081,"Illinois","Jefferson County",2,42,436,239,197
050,17,081,"Illinois","Jefferson County",2,43,467,257,210
050,17,081,"Illinois","Jefferson County",2,44,430,233,197
050,17,081,"Illinois","Jefferson County",2,45,451,242,209
050,17,081,"Illinois","Jefferson County",2,46,417,225,192
050,17,081,"Illinois","Jefferson County",2,47,432,232,200
050,17,081,"Illinois","Jefferson County",2,48,450,239,211
050,17,081,"Illinois","Jefferson County",2,49,450,234,216
050,17,081,"Illinois","Jefferson County",2,50,466,229,237
050,17,081,"Illinois","Jefferson County",2,51,469,245,224
050,17,081,"Illinois","Jefferson County",2,52,447,235,212
050,17,081,"Illinois","Jefferson County",2,53,462,242,220
050,17,081,"Illinois","Jefferson County",2,54,480,257,223
050,17,081,"Illinois","Jefferson County",2,55,513,266,247
050,17,081,"Illinois","Jefferson County",2,56,538,274,264
050,17,081,"Illinois","Jefferson County",2,57,523,271,252
050,17,081,"Illinois","Jefferson County",2,58,485,244,241
050,17,081,"Illinois","Jefferson County",2,59,493,252,241
050,17,081,"Illinois","Jefferson County",2,60,476,241,235
050,17,081,"Illinois","Jefferson County",2,61,512,259,253
050,17,081,"Illinois","Jefferson County",2,62,531,252,279
050,17,081,"Illinois","Jefferson County",2,63,508,248,260
050,17,081,"Illinois","Jefferson County",2,64,484,242,242
050,17,081,"Illinois","Jefferson County",2,65,470,223,247
050,17,081,"Illinois","Jefferson County",2,66,482,228,254
050,17,081,"Illinois","Jefferson County",2,67,471,230,241
050,17,081,"Illinois","Jefferson County",2,68,454,220,234
050,17,081,"Illinois","Jefferson County",2,69,427,201,226
050,17,081,"Illinois","Jefferson County",2,70,419,205,214
050,17,081,"Illinois","Jefferson County",2,71,409,202,207
050,17,081,"Illinois","Jefferson County",2,72,396,201,195
050,17,081,"Illinois","Jefferson County",2,73,427,207,220
050,17,081,"Illinois","Jefferson County",2,74,286,131,155
050,17,081,"Illinois","Jefferson County",2,75,275,123,152
050,17,081,"Illinois","Jefferson County",2,76,276,120,156
050,17,081,"Illinois","Jefferson County",2,77,296,137,159
050,17,081,"Illinois","Jefferson County",2,78,243,114,129
050,17,081,"Illinois","Jefferson County",2,79,215,100,115
050,17,081,"Illinois","Jefferson County",2,80,205,97,108
050,17,081,"Illinois","Jefferson County",2,81,184,78,106
050,17,081,"Illinois","Jefferson County",2,82,171,79,92
050,17,081,"Illinois","Jefferson County",2,83,166,79,87
050,17,081,"Illinois","Jefferson County",2,84,132,60,72
050,17,081,"Illinois","Jefferson County",2,85,804,278,526
050,17,081,"Illinois","Jefferson County",3,0,427,225,202
050,17,081,"Illinois","Jefferson County",3,1,426,223,203
050,17,081,"Illinois","Jefferson County",3,2,424,220,204
050,17,081,"Illinois","Jefferson County",3,3,454,221,233
050,17,081,"Illinois","Jefferson County",3,4,423,203,220
050,17,081,"Illinois","Jefferson County",3,5,492,253,239
050,17,081,"Illinois","Jefferson County",3,6,480,244,236
050,17,081,"Illinois","Jefferson County",3,7,466,231,235
050,17,081,"Illinois","Jefferson County",3,8,454,235,219
050,17,081,"Illinois","Jefferson County",3,9,440,213,227
050,17,081,"Illinois","Jefferson County",3,10,439,213,226
050,17,081,"Illinois","Jefferson County",3,11,473,235,238
050,17,081,"Illinois","Jefferson County",3,12,500,253,247
050,17,081,"Illinois","Jefferson County",3,13,487,249,238
050,17,081,"Illinois","Jefferson County",3,14,472,236,236
050,17,081,"Illinois","Jefferson County",3,15,465,229,236
050,17,081,"Illinois","Jefferson County",3,16,461,225,236
050,17,081,"Illinois","Jefferson County",3,17,475,241,234
050,17,081,"Illinois","Jefferson County",3,18,418,232,186
050,17,081,"Illinois","Jefferson County",3,19,341,190,151
050,17,081,"Illinois","Jefferson County",3,20,366,206,160
050,17,081,"Illinois","Jefferson County",3,21,392,227,165
050,17,081,"Illinois","Jefferson County",3,22,390,218,172
050,17,081,"Illinois","Jefferson County",3,23,393,218,175
050,17,081,"Illinois","Jefferson County",3,24,408,213,195
050,17,081,"Illinois","Jefferson County",3,25,449,259,190
050,17,081,"Illinois","Jefferson County",3,26,432,237,195
050,17,081,"Illinois","Jefferson County",3,27,451,250,201
050,17,081,"Illinois","Jefferson County",3,28,485,265,220
050,17,081,"Illinois","Jefferson County",3,29,514,286,228
050,17,081,"Illinois","Jefferson County",3,30,500,275,225
050,17,081,"Illinois","Jefferson County",3,31,484,268,216
050,17,081,"Illinois","Jefferson County",3,32,446,235,211
050,17,081,"Illinois","Jefferson County",3,33,430,229,201
050,17,081,"Illinois","Jefferson County",3,34,402,214,188
050,17,081,"Illinois","Jefferson County",3,35,422,234,188
050,17,081,"Illinois","Jefferson County",3,36,412,224,188
050,17,081,"Illinois","Jefferson County",3,37,474,250,224
050,17,081,"Illinois","Jefferson County",3,38,461,239,222
050,17,081,"Illinois","Jefferson County",3,39,485,250,235
050,17,081,"Illinois","Jefferson County",3,40,475,256,219
050,17,081,"Illinois","Jefferson County",3,41,471,261,210
050,17,081,"Illinois","Jefferson County",3,42,446,255,191
050,17,081,"Illinois","Jefferson County",3,43,473,263,210
050,17,081,"Illinois","Jefferson County",3,44,458,250,208
050,17,081,"Illinois","Jefferson County",3,45,447,240,207
050,17,081,"Illinois","Jefferson County",3,46,439,236,203
050,17,081,"Illinois","Jefferson County",3,47,429,231,198
050,17,081,"Illinois","Jefferson County",3,48,427,230,197
050,17,081,"Illinois","Jefferson County",3,49,455,242,213
050,17,081,"Illinois","Jefferson County",3,50,465,245,220
050,17,081,"Illinois","Jefferson County",3,51,494,250,244
050,17,081,"Illinois","Jefferson County",3,52,448,228,220
050,17,081,"Illinois","Jefferson County",3,53,450,242,208
050,17,081,"Illinois","Jefferson County",3,54,469,246,223
050,17,081,"Illinois","Jefferson County",3,55,480,266,214
050,17,081,"Illinois","Jefferson County",3,56,509,261,248
050,17,081,"Illinois","Jefferson County",3,57,532,273,259
050,17,081,"Illinois","Jefferson County",3,58,505,254,251
050,17,081,"Illinois","Jefferson County",3,59,485,249,236
050,17,081,"Illinois","Jefferson County",3,60,498,256,242
050,17,081,"Illinois","Jefferson County",3,61,464,231,233
050,17,081,"Illinois","Jefferson County",3,62,502,255,247
050,17,081,"Illinois","Jefferson County",3,63,526,253,273
050,17,081,"Illinois","Jefferson County",3,64,501,241,260
050,17,081,"Illinois","Jefferson County",3,65,472,230,242
050,17,081,"Illinois","Jefferson County",3,66,465,218,247
050,17,081,"Illinois","Jefferson County",3,67,475,224,251
050,17,081,"Illinois","Jefferson County",3,68,464,227,237
050,17,081,"Illinois","Jefferson County",3,69,430,205,225
050,17,081,"Illinois","Jefferson County",3,70,416,193,223
050,17,081,"Illinois","Jefferson County",3,71,396,203,193
050,17,081,"Illinois","Jefferson County",3,72,384,192,192
050,17,081,"Illinois","Jefferson County",3,73,393,198,195
050,17,081,"Illinois","Jefferson County",3,74,410,202,208
050,17,081,"Illinois","Jefferson County",3,75,261,118,143
050,17,081,"Illinois","Jefferson County",3,76,267,116,151
050,17,081,"Illinois","Jefferson County",3,77,251,110,141
050,17,081,"Illinois","Jefferson County",3,78,289,134,155
050,17,081,"Illinois","Jefferson County",3,79,225,100,125
050,17,081,"Illinois","Jefferson County",3,80,201,97,104
050,17,081,"Illinois","Jefferson County",3,81,186,76,110
050,17,081,"Illinois","Jefferson County",3,82,164,70,94
050,17,081,"Illinois","Jefferson County",3,83,148,72,76
050,17,081,"Illinois","Jefferson County",3,84,144,69,75
050,17,081,"Illinois","Jefferson County",3,85,787,271,516
050,17,081,"Illinois","Jefferson County",4,0,413,206,207
050,17,081,"Illinois","Jefferson County",4,1,445,246,199
050,17,081,"Illinois","Jefferson County",4,2,424,223,201
050,17,081,"Illinois","Jefferson County",4,3,419,220,199
050,17,081,"Illinois","Jefferson County",4,4,450,216,234
050,17,081,"Illinois","Jefferson County",4,5,416,205,211
050,17,081,"Illinois","Jefferson County",4,6,487,249,238
050,17,081,"Illinois","Jefferson County",4,7,467,231,236
050,17,081,"Illinois","Jefferson County",4,8,460,228,232
050,17,081,"Illinois","Jefferson County",4,9,448,233,215
050,17,081,"Illinois","Jefferson County",4,10,446,218,228
050,17,081,"Illinois","Jefferson County",4,11,425,213,212
050,17,081,"Illinois","Jefferson County",4,12,465,233,232
050,17,081,"Illinois","Jefferson County",4,13,482,240,242
050,17,081,"Illinois","Jefferson County",4,14,485,247,238
050,17,081,"Illinois","Jefferson County",4,15,472,238,234
050,17,081,"Illinois","Jefferson County",4,16,461,233,228
050,17,081,"Illinois","Jefferson County",4,17,449,229,220
050,17,081,"Illinois","Jefferson County",4,18,407,215,192
050,17,081,"Illinois","Jefferson County",4,19,339,194,145
050,17,081,"Illinois","Jefferson County",4,20,348,191,157
050,17,081,"Illinois","Jefferson County",4,21,375,207,168
050,17,081,"Illinois","Jefferson County",4,22,427,251,176
050,17,081,"Illinois","Jefferson County",4,23,397,223,174
050,17,081,"Illinois","Jefferson County",4,24,400,212,188
050,17,081,"Illinois","Jefferson County",4,25,408,220,188
050,17,081,"Illinois","Jefferson County",4,26,443,251,192
050,17,081,"Illinois","Jefferson County",4,27,439,244,195
050,17,081,"Illinois","Jefferson County",4,28,448,243,205
050,17,081,"Illinois","Jefferson County",4,29,472,259,213
050,17,081,"Illinois","Jefferson County",4,30,502,281,221
050,17,081,"Illinois","Jefferson County",4,31,496,274,222
050,17,081,"Illinois","Jefferson County",4,32,481,266,215
050,17,081,"Illinois","Jefferson County",4,33,439,230,209
050,17,081,"Illinois","Jefferson County",4,34,408,214,194
050,17,081,"Illinois","Jefferson County",4,35,408,220,188
050,17,081,"Illinois","Jefferson County",4,36,428,241,187
050,17,081,"Illinois","Jefferson County",4,37,420,227,193
050,17,081,"Illinois","Jefferson County",4,38,475,250,225
050,17,081,"Illinois","Jefferson County",4,39,455,239,216
050,17,081,"Illinois","Jefferson County",4,40,451,224,227
050,17,081,"Illinois","Jefferson County",4,41,474,258,216
050,17,081,"Illinois","Jefferson County",4,42,452,252,200
050,17,081,"Illinois","Jefferson County",4,43,446,263,183
050,17,081,"Illinois","Jefferson County",4,44,463,252,211
050,17,081,"Illinois","Jefferson County",4,45,479,260,219
050,17,081,"Illinois","Jefferson County",4,46,426,230,196
050,17,081,"Illinois","Jefferson County",4,47,412,218,194
050,17,081,"Illinois","Jefferson County",4,48,417,225,192
050,17,081,"Illinois","Jefferson County",4,49,409,212,197
050,17,081,"Illinois","Jefferson County",4,50,460,244,216
050,17,081,"Illinois","Jefferson County",4,51,456,246,210
050,17,081,"Illinois","Jefferson County",4,52,474,233,241
050,17,081,"Illinois","Jefferson County",4,53,448,226,222
050,17,081,"Illinois","Jefferson County",4,54,445,234,211
050,17,081,"Illinois","Jefferson County",4,55,470,251,219
050,17,081,"Illinois","Jefferson County",4,56,468,253,215
050,17,081,"Illinois","Jefferson County",4,57,510,261,249
050,17,081,"Illinois","Jefferson County",4,58,507,256,251
050,17,081,"Illinois","Jefferson County",4,59,505,262,243
050,17,081,"Illinois","Jefferson County",4,60,482,245,237
050,17,081,"Illinois","Jefferson County",4,61,482,247,235
050,17,081,"Illinois","Jefferson County",4,62,453,223,230
050,17,081,"Illinois","Jefferson County",4,63,497,255,242
050,17,081,"Illinois","Jefferson County",4,64,518,252,266
050,17,081,"Illinois","Jefferson County",4,65,486,225,261
050,17,081,"Illinois","Jefferson County",4,66,460,224,236
050,17,081,"Illinois","Jefferson County",4,67,456,209,247
050,17,081,"Illinois","Jefferson County",4,68,470,219,251
050,17,081,"Illinois","Jefferson County",4,69,450,218,232
050,17,081,"Illinois","Jefferson County",4,70,426,194,232
050,17,081,"Illinois","Jefferson County",4,71,395,185,210
050,17,081,"Illinois","Jefferson County",4,72,379,192,187
050,17,081,"Illinois","Jefferson County",4,73,376,187,189
050,17,081,"Illinois","Jefferson County",4,74,376,191,185
050,17,081,"Illinois","Jefferson County",4,75,385,189,196
050,17,081,"Illinois","Jefferson County",4,76,248,111,137
050,17,081,"Illinois","Jefferson County",4,77,242,104,138
050,17,081,"Illinois","Jefferson County",4,78,241,100,141
050,17,081,"Illinois","Jefferson County",4,79,264,116,148
050,17,081,"Illinois","Jefferson County",4,80,202,93,109
050,17,081,"Illinois","Jefferson County",4,81,190,84,106
050,17,081,"Illinois","Jefferson County",4,82,168,74,94
050,17,081,"Illinois","Jefferson County",4,83,146,66,80
050,17,081,"Illinois","Jefferson County",4,84,133,66,67
050,17,081,"Illinois","Jefferson County",4,85,793,288,505
050,17,081,"Illinois","Jefferson County",5,0,400,200,200
050,17,081,"Illinois","Jefferson County",5,1,418,211,207
050,17,081,"Illinois","Jefferson County",5,2,435,242,193
050,17,081,"Illinois","Jefferson County",5,3,425,222,203
050,17,081,"Illinois","Jefferson County",5,4,423,221,202
050,17,081,"Illinois","Jefferson County",5,5,445,218,227
050,17,081,"Illinois","Jefferson County",5,6,413,203,210
050,17,081,"Illinois","Jefferson County",5,7,489,250,239
050,17,081,"Illinois","Jefferson County",5,8,453,227,226
050,17,081,"Illinois","Jefferson County",5,9,456,222,234
050,17,081,"Illinois","Jefferson County",5,10,453,230,223
050,17,081,"Illinois","Jefferson County",5,11,450,219,231
050,17,081,"Illinois","Jefferson County",5,12,436,222,214
050,17,081,"Illinois","Jefferson County",5,13,477,239,238
050,17,081,"Illinois","Jefferson County",5,14,494,251,243
050,17,081,"Illinois","Jefferson County",5,15,476,242,234
050,17,081,"Illinois","Jefferson County",5,16,479,248,231
050,17,081,"Illinois","Jefferson County",5,17,457,232,225
050,17,081,"Illinois","Jefferson County",5,18,389,211,178
050,17,081,"Illinois","Jefferson County",5,19,327,180,147
050,17,081,"Illinois","Jefferson County",5,20,360,199,161
050,17,081,"Illinois","Jefferson County",5,21,375,211,164
050,17,081,"Illinois","Jefferson County",5,22,395,225,170
050,17,081,"Illinois","Jefferson County",5,23,451,259,192
050,17,081,"Illinois","Jefferson County",5,24,401,225,176
050,17,081,"Illinois","Jefferson County",5,25,407,227,180
050,17,081,"Illinois","Jefferson County",5,26,404,217,187
050,17,081,"Illinois","Jefferson County",5,27,452,257,195
050,17,081,"Illinois","Jefferson County",5,28,415,236,179
050,17,081,"Illinois","Jefferson County",5,29,442,251,191
050,17,081,"Illinois","Jefferson County",5,30,462,258,204
050,17,081,"Illinois","Jefferson County",5,31,500,281,219
050,17,081,"Illinois","Jefferson County",5,32,489,269,220
050,17,081,"Illinois","Jefferson County",5,33,479,264,215
050,17,081,"Illinois","Jefferson County",5,34,431,219,212
050,17,081,"Illinois","Jefferson County",5,35,417,218,199
050,17,081,"Illinois","Jefferson County",5,36,397,213,184
050,17,081,"Illinois","Jefferson County",5,37,429,243,186
050,17,081,"Illinois","Jefferson County",5,38,425,235,190
050,17,081,"Illinois","Jefferson County",5,39,480,254,226
050,17,081,"Illinois","Jefferson County",5,40,451,240,211
050,17,081,"Illinois","Jefferson County",5,41,468,239,229
050,17,081,"Illinois","Jefferson County",5,42,458,246,212
050,17,081,"Illinois","Jefferson County",5,43,458,259,199
050,17,081,"Illinois","Jefferson County",5,44,435,250,185
050,17,081,"Illinois","Jefferson County",5,45,484,260,224
050,17,081,"Illinois","Jefferson County",5,46,466,255,211
050,17,081,"Illinois","Jefferson County",5,47,428,231,197
050,17,081,"Illinois","Jefferson County",5,48,423,220,203
050,17,081,"Illinois","Jefferson County",5,49,416,224,192
050,17,081,"Illinois","Jefferson County",5,50,404,214,190
050,17,081,"Illinois","Jefferson County",5,51,460,248,212
050,17,081,"Illinois","Jefferson County",5,52,440,227,213
050,17,081,"Illinois","Jefferson County",5,53,480,232,248
050,17,081,"Illinois","Jefferson County",5,54,451,232,219
050,17,081,"Illinois","Jefferson County",5,55,443,240,203
050,17,081,"Illinois","Jefferson County",5,56,459,242,217
050,17,081,"Illinois","Jefferson County",5,57,467,252,215
050,17,081,"Illinois","Jefferson County",5,58,497,245,252
050,17,081,"Illinois","Jefferson County",5,59,510,266,244
050,17,081,"Illinois","Jefferson County",5,60,501,255,246
050,17,081,"Illinois","Jefferson County",5,61,457,230,227
050,17,081,"Illinois","Jefferson County",5,62,486,249,237
050,17,081,"Illinois","Jefferson County",5,63,456,228,228
050,17,081,"Illinois","Jefferson County",5,64,501,258,243
050,17,081,"Illinois","Jefferson County",5,65,503,236,267
050,17,081,"Illinois","Jefferson County",5,66,485,227,258
050,17,081,"Illinois","Jefferson County",5,67,461,223,238
050,17,081,"Illinois","Jefferson County",5,68,453,204,249
050,17,081,"Illinois","Jefferson County",5,69,452,210,242
050,17,081,"Illinois","Jefferson County",5,70,444,210,234
050,17,081,"Illinois","Jefferson County",5,71,402,186,216
050,17,081,"Illinois","Jefferson County",5,72,379,176,203
050,17,081,"Illinois","Jefferson County",5,73,378,190,188
050,17,081,"Illinois","Jefferson County",5,74,361,180,181
050,17,081,"Illinois","Jefferson County",5,75,352,177,175
050,17,081,"Illinois","Jefferson County",5,76,373,183,190
050,17,081,"Illinois","Jefferson County",5,77,230,103,127
050,17,081,"Illinois","Jefferson County",5,78,232,96,136
050,17,081,"Illinois","Jefferson County",5,79,217,85,132
050,17,081,"Illinois","Jefferson County",5,80,244,108,136
050,17,081,"Illinois","Jefferson County",5,81,187,79,108
050,17,081,"Illinois","Jefferson County",5,82,174,83,91
050,17,081,"Illinois","Jefferson County",5,83,145,69,76
050,17,081,"Illinois","Jefferson County",5,84,126,58,68
050,17,081,"Illinois","Jefferson County",5,85,817,311,506
050,17,083,"Illinois","Jersey County",1,0,206,105,101
050,17,083,"Illinois","Jersey County",1,1,202,103,99
050,17,083,"Illinois","Jersey County",1,2,216,112,104
050,17,083,"Illinois","Jersey County",1,3,225,111,114
050,17,083,"Illinois","Jersey County",1,4,238,118,120
050,17,083,"Illinois","Jersey County",1,5,209,110,99
050,17,083,"Illinois","Jersey County",1,6,220,108,112
050,17,083,"Illinois","Jersey County",1,7,244,117,127
050,17,083,"Illinois","Jersey County",1,8,255,135,120
050,17,083,"Illinois","Jersey County",1,9,233,116,117
050,17,083,"Illinois","Jersey County",1,10,251,127,124
050,17,083,"Illinois","Jersey County",1,11,243,124,119
050,17,083,"Illinois","Jersey County",1,12,260,134,126
050,17,083,"Illinois","Jersey County",1,13,279,136,143
050,17,083,"Illinois","Jersey County",1,14,275,132,143
050,17,083,"Illinois","Jersey County",1,15,296,154,142
050,17,083,"Illinois","Jersey County",1,16,294,155,139
050,17,083,"Illinois","Jersey County",1,17,288,152,136
050,17,083,"Illinois","Jersey County",1,18,285,139,146
050,17,083,"Illinois","Jersey County",1,19,287,132,155
050,17,083,"Illinois","Jersey County",1,20,301,151,150
050,17,083,"Illinois","Jersey County",1,21,316,158,158
050,17,083,"Illinois","Jersey County",1,22,308,157,151
050,17,083,"Illinois","Jersey County",1,23,277,147,130
050,17,083,"Illinois","Jersey County",1,24,244,112,132
050,17,083,"Illinois","Jersey County",1,25,219,113,106
050,17,083,"Illinois","Jersey County",1,26,197,100,97
050,17,083,"Illinois","Jersey County",1,27,219,99,120
050,17,083,"Illinois","Jersey County",1,28,230,107,123
050,17,083,"Illinois","Jersey County",1,29,219,111,108
050,17,083,"Illinois","Jersey County",1,30,230,116,114
050,17,083,"Illinois","Jersey County",1,31,245,117,128
050,17,083,"Illinois","Jersey County",1,32,219,117,102
050,17,083,"Illinois","Jersey County",1,33,226,109,117
050,17,083,"Illinois","Jersey County",1,34,251,124,127
050,17,083,"Illinois","Jersey County",1,35,246,121,125
050,17,083,"Illinois","Jersey County",1,36,256,129,127
050,17,083,"Illinois","Jersey County",1,37,264,138,126
050,17,083,"Illinois","Jersey County",1,38,253,135,118
050,17,083,"Illinois","Jersey County",1,39,253,132,121
050,17,083,"Illinois","Jersey County",1,40,257,128,129
050,17,083,"Illinois","Jersey County",1,41,266,122,144
050,17,083,"Illinois","Jersey County",1,42,237,120,117
050,17,083,"Illinois","Jersey County",1,43,234,116,118
050,17,083,"Illinois","Jersey County",1,44,220,108,112
050,17,083,"Illinois","Jersey County",1,45,239,120,119
050,17,083,"Illinois","Jersey County",1,46,234,118,116
050,17,083,"Illinois","Jersey County",1,47,244,137,107
050,17,083,"Illinois","Jersey County",1,48,270,147,123
050,17,083,"Illinois","Jersey County",1,49,293,144,149
050,17,083,"Illinois","Jersey County",1,50,273,132,141
050,17,083,"Illinois","Jersey County",1,51,279,136,143
050,17,083,"Illinois","Jersey County",1,52,269,140,129
050,17,083,"Illinois","Jersey County",1,53,291,150,141
050,17,083,"Illinois","Jersey County",1,54,298,153,145
050,17,083,"Illinois","Jersey County",1,55,333,162,171
050,17,083,"Illinois","Jersey County",1,56,336,161,175
050,17,083,"Illinois","Jersey County",1,57,336,160,176
050,17,083,"Illinois","Jersey County",1,58,384,177,207
050,17,083,"Illinois","Jersey County",1,59,370,178,192
050,17,083,"Illinois","Jersey County",1,60,344,178,166
050,17,083,"Illinois","Jersey County",1,61,328,158,170
050,17,083,"Illinois","Jersey County",1,62,354,175,179
050,17,083,"Illinois","Jersey County",1,63,342,173,169
050,17,083,"Illinois","Jersey County",1,64,316,159,157
050,17,083,"Illinois","Jersey County",1,65,309,146,163
050,17,083,"Illinois","Jersey County",1,66,277,131,146
050,17,083,"Illinois","Jersey County",1,67,272,121,151
050,17,083,"Illinois","Jersey County",1,68,277,137,140
050,17,083,"Illinois","Jersey County",1,69,238,125,113
050,17,083,"Illinois","Jersey County",1,70,230,119,111
050,17,083,"Illinois","Jersey County",1,71,221,100,121
050,17,083,"Illinois","Jersey County",1,72,230,107,123
050,17,083,"Illinois","Jersey County",1,73,210,99,111
050,17,083,"Illinois","Jersey County",1,74,139,69,70
050,17,083,"Illinois","Jersey County",1,75,160,75,85
050,17,083,"Illinois","Jersey County",1,76,170,80,90
050,17,083,"Illinois","Jersey County",1,77,158,69,89
050,17,083,"Illinois","Jersey County",1,78,143,72,71
050,17,083,"Illinois","Jersey County",1,79,136,61,75
050,17,083,"Illinois","Jersey County",1,80,125,55,70
050,17,083,"Illinois","Jersey County",1,81,122,55,67
050,17,083,"Illinois","Jersey County",1,82,111,49,62
050,17,083,"Illinois","Jersey County",1,83,95,40,55
050,17,083,"Illinois","Jersey County",1,84,84,30,54
050,17,083,"Illinois","Jersey County",1,85,485,177,308
050,17,083,"Illinois","Jersey County",2,0,203,103,100
050,17,083,"Illinois","Jersey County",2,1,202,103,99
050,17,083,"Illinois","Jersey County",2,2,211,109,102
050,17,083,"Illinois","Jersey County",2,3,221,111,110
050,17,083,"Illinois","Jersey County",2,4,233,116,117
050,17,083,"Illinois","Jersey County",2,5,215,111,104
050,17,083,"Illinois","Jersey County",2,6,219,110,109
050,17,083,"Illinois","Jersey County",2,7,239,115,124
050,17,083,"Illinois","Jersey County",2,8,252,130,122
050,17,083,"Illinois","Jersey County",2,9,238,121,117
050,17,083,"Illinois","Jersey County",2,10,247,125,122
050,17,083,"Illinois","Jersey County",2,11,245,125,120
050,17,083,"Illinois","Jersey County",2,12,259,131,128
050,17,083,"Illinois","Jersey County",2,13,277,136,141
050,17,083,"Illinois","Jersey County",2,14,279,135,144
050,17,083,"Illinois","Jersey County",2,15,293,150,143
050,17,083,"Illinois","Jersey County",2,16,297,157,140
050,17,083,"Illinois","Jersey County",2,17,290,154,136
050,17,083,"Illinois","Jersey County",2,18,281,138,143
050,17,083,"Illinois","Jersey County",2,19,292,134,158
050,17,083,"Illinois","Jersey County",2,20,306,152,154
050,17,083,"Illinois","Jersey County",2,21,308,155,153
050,17,083,"Illinois","Jersey County",2,22,309,157,152
050,17,083,"Illinois","Jersey County",2,23,275,144,131
050,17,083,"Illinois","Jersey County",2,24,249,118,131
050,17,083,"Illinois","Jersey County",2,25,221,111,110
050,17,083,"Illinois","Jersey County",2,26,201,103,98
050,17,083,"Illinois","Jersey County",2,27,214,99,115
050,17,083,"Illinois","Jersey County",2,28,227,105,122
050,17,083,"Illinois","Jersey County",2,29,221,108,113
050,17,083,"Illinois","Jersey County",2,30,230,114,116
050,17,083,"Illinois","Jersey County",2,31,239,116,123
050,17,083,"Illinois","Jersey County",2,32,225,117,108
050,17,083,"Illinois","Jersey County",2,33,221,110,111
050,17,083,"Illinois","Jersey County",2,34,244,121,123
050,17,083,"Illinois","Jersey County",2,35,250,122,128
050,17,083,"Illinois","Jersey County",2,36,255,128,127
050,17,083,"Illinois","Jersey County",2,37,260,135,125
050,17,083,"Illinois","Jersey County",2,38,259,137,122
050,17,083,"Illinois","Jersey County",2,39,253,133,120
050,17,083,"Illinois","Jersey County",2,40,257,131,126
050,17,083,"Illinois","Jersey County",2,41,263,124,139
050,17,083,"Illinois","Jersey County",2,42,243,120,123
050,17,083,"Illinois","Jersey County",2,43,233,115,118
050,17,083,"Illinois","Jersey County",2,44,219,108,111
050,17,083,"Illinois","Jersey County",2,45,235,118,117
050,17,083,"Illinois","Jersey County",2,46,237,120,117
050,17,083,"Illinois","Jersey County",2,47,243,132,111
050,17,083,"Illinois","Jersey County",2,48,263,145,118
050,17,083,"Illinois","Jersey County",2,49,287,144,143
050,17,083,"Illinois","Jersey County",2,50,277,134,143
050,17,083,"Illinois","Jersey County",2,51,276,134,142
050,17,083,"Illinois","Jersey County",2,52,270,139,131
050,17,083,"Illinois","Jersey County",2,53,285,146,139
050,17,083,"Illinois","Jersey County",2,54,296,151,145
050,17,083,"Illinois","Jersey County",2,55,323,160,163
050,17,083,"Illinois","Jersey County",2,56,335,162,173
050,17,083,"Illinois","Jersey County",2,57,333,159,174
050,17,083,"Illinois","Jersey County",2,58,373,171,202
050,17,083,"Illinois","Jersey County",2,59,376,179,197
050,17,083,"Illinois","Jersey County",2,60,350,178,172
050,17,083,"Illinois","Jersey County",2,61,331,161,170
050,17,083,"Illinois","Jersey County",2,62,347,171,176
050,17,083,"Illinois","Jersey County",2,63,352,177,175
050,17,083,"Illinois","Jersey County",2,64,319,161,158
050,17,083,"Illinois","Jersey County",2,65,310,148,162
050,17,083,"Illinois","Jersey County",2,66,284,133,151
050,17,083,"Illinois","Jersey County",2,67,270,121,149
050,17,083,"Illinois","Jersey County",2,68,268,129,139
050,17,083,"Illinois","Jersey County",2,69,247,126,121
050,17,083,"Illinois","Jersey County",2,70,230,120,110
050,17,083,"Illinois","Jersey County",2,71,221,102,119
050,17,083,"Illinois","Jersey County",2,72,224,103,121
050,17,083,"Illinois","Jersey County",2,73,224,105,119
050,17,083,"Illinois","Jersey County",2,74,144,70,74
050,17,083,"Illinois","Jersey County",2,75,155,74,81
050,17,083,"Illinois","Jersey County",2,76,165,77,88
050,17,083,"Illinois","Jersey County",2,77,164,73,91
050,17,083,"Illinois","Jersey County",2,78,142,68,74
050,17,083,"Illinois","Jersey County",2,79,137,64,73
050,17,083,"Illinois","Jersey County",2,80,127,57,70
050,17,083,"Illinois","Jersey County",2,81,121,55,66
050,17,083,"Illinois","Jersey County",2,82,113,49,64
050,17,083,"Illinois","Jersey County",2,83,98,42,56
050,17,083,"Illinois","Jersey County",2,84,86,31,55
050,17,083,"Illinois","Jersey County",2,85,481,176,305
050,17,083,"Illinois","Jersey County",3,0,186,97,89
050,17,083,"Illinois","Jersey County",3,1,216,114,102
050,17,083,"Illinois","Jersey County",3,2,211,106,105
050,17,083,"Illinois","Jersey County",3,3,213,109,104
050,17,083,"Illinois","Jersey County",3,4,228,117,111
050,17,083,"Illinois","Jersey County",3,5,238,121,117
050,17,083,"Illinois","Jersey County",3,6,209,105,104
050,17,083,"Illinois","Jersey County",3,7,214,107,107
050,17,083,"Illinois","Jersey County",3,8,240,112,128
050,17,083,"Illinois","Jersey County",3,9,255,132,123
050,17,083,"Illinois","Jersey County",3,10,236,121,115
050,17,083,"Illinois","Jersey County",3,11,254,129,125
050,17,083,"Illinois","Jersey County",3,12,245,125,120
050,17,083,"Illinois","Jersey County",3,13,263,133,130
050,17,083,"Illinois","Jersey County",3,14,272,141,131
050,17,083,"Illinois","Jersey County",3,15,267,132,135
050,17,083,"Illinois","Jersey County",3,16,292,151,141
050,17,083,"Illinois","Jersey County",3,17,287,147,140
050,17,083,"Illinois","Jersey County",3,18,259,133,126
050,17,083,"Illinois","Jersey County",3,19,303,142,161
050,17,083,"Illinois","Jersey County",3,20,296,148,148
050,17,083,"Illinois","Jersey County",3,21,286,146,140
050,17,083,"Illinois","Jersey County",3,22,301,151,150
050,17,083,"Illinois","Jersey County",3,23,261,138,123
050,17,083,"Illinois","Jersey County",3,24,264,139,125
050,17,083,"Illinois","Jersey County",3,25,241,116,125
050,17,083,"Illinois","Jersey County",3,26,217,107,110
050,17,083,"Illinois","Jersey County",3,27,221,113,108
050,17,083,"Illinois","Jersey County",3,28,231,115,116
050,17,083,"Illinois","Jersey County",3,29,216,111,105
050,17,083,"Illinois","Jersey County",3,30,226,105,121
050,17,083,"Illinois","Jersey County",3,31,228,120,108
050,17,083,"Illinois","Jersey County",3,32,254,120,134
050,17,083,"Illinois","Jersey County",3,33,220,112,108
050,17,083,"Illinois","Jersey County",3,34,223,111,112
050,17,083,"Illinois","Jersey County",3,35,241,119,122
050,17,083,"Illinois","Jersey County",3,36,248,123,125
050,17,083,"Illinois","Jersey County",3,37,260,130,130
050,17,083,"Illinois","Jersey County",3,38,266,134,132
050,17,083,"Illinois","Jersey County",3,39,259,137,122
050,17,083,"Illinois","Jersey County",3,40,257,136,121
050,17,083,"Illinois","Jersey County",3,41,257,133,124
050,17,083,"Illinois","Jersey County",3,42,267,129,138
050,17,083,"Illinois","Jersey County",3,43,256,127,129
050,17,083,"Illinois","Jersey County",3,44,233,119,114
050,17,083,"Illinois","Jersey County",3,45,231,116,115
050,17,083,"Illinois","Jersey County",3,46,238,118,120
050,17,083,"Illinois","Jersey County",3,47,238,123,115
050,17,083,"Illinois","Jersey County",3,48,241,131,110
050,17,083,"Illinois","Jersey County",3,49,258,140,118
050,17,083,"Illinois","Jersey County",3,50,294,147,147
050,17,083,"Illinois","Jersey County",3,51,277,136,141
050,17,083,"Illinois","Jersey County",3,52,287,138,149
050,17,083,"Illinois","Jersey County",3,53,257,131,126
050,17,083,"Illinois","Jersey County",3,54,286,141,145
050,17,083,"Illinois","Jersey County",3,55,288,153,135
050,17,083,"Illinois","Jersey County",3,56,322,160,162
050,17,083,"Illinois","Jersey County",3,57,332,158,174
050,17,083,"Illinois","Jersey County",3,58,327,157,170
050,17,083,"Illinois","Jersey County",3,59,364,167,197
050,17,083,"Illinois","Jersey County",3,60,367,177,190
050,17,083,"Illinois","Jersey County",3,61,342,177,165
050,17,083,"Illinois","Jersey County",3,62,320,153,167
050,17,083,"Illinois","Jersey County",3,63,340,165,175
050,17,083,"Illinois","Jersey County",3,64,347,180,167
050,17,083,"Illinois","Jersey County",3,65,305,156,149
050,17,083,"Illinois","Jersey County",3,66,308,145,163
050,17,083,"Illinois","Jersey County",3,67,287,129,158
050,17,083,"Illinois","Jersey County",3,68,258,119,139
050,17,083,"Illinois","Jersey County",3,69,259,125,134
050,17,083,"Illinois","Jersey County",3,70,242,124,118
050,17,083,"Illinois","Jersey County",3,71,225,117,108
050,17,083,"Illinois","Jersey County",3,72,218,98,120
050,17,083,"Illinois","Jersey County",3,73,207,95,112
050,17,083,"Illinois","Jersey County",3,74,208,94,114
050,17,083,"Illinois","Jersey County",3,75,143,69,74
050,17,083,"Illinois","Jersey County",3,76,150,69,81
050,17,083,"Illinois","Jersey County",3,77,155,73,82
050,17,083,"Illinois","Jersey County",3,78,150,68,82
050,17,083,"Illinois","Jersey County",3,79,138,65,73
050,17,083,"Illinois","Jersey County",3,80,130,61,69
050,17,083,"Illinois","Jersey County",3,81,119,52,67
050,17,083,"Illinois","Jersey County",3,82,106,47,59
050,17,083,"Illinois","Jersey County",3,83,107,46,61
050,17,083,"Illinois","Jersey County",3,84,95,38,57
050,17,083,"Illinois","Jersey County",3,85,466,174,292
050,17,083,"Illinois","Jersey County",4,0,163,82,81
050,17,083,"Illinois","Jersey County",4,1,180,95,85
050,17,083,"Illinois","Jersey County",4,2,213,112,101
050,17,083,"Illinois","Jersey County",4,3,219,111,108
050,17,083,"Illinois","Jersey County",4,4,219,110,109
050,17,083,"Illinois","Jersey County",4,5,233,117,116
050,17,083,"Illinois","Jersey County",4,6,231,117,114
050,17,083,"Illinois","Jersey County",4,7,211,106,105
050,17,083,"Illinois","Jersey County",4,8,220,106,114
050,17,083,"Illinois","Jersey County",4,9,254,125,129
050,17,083,"Illinois","Jersey County",4,10,254,129,125
050,17,083,"Illinois","Jersey County",4,11,227,113,114
050,17,083,"Illinois","Jersey County",4,12,261,129,132
050,17,083,"Illinois","Jersey County",4,13,247,126,121
050,17,083,"Illinois","Jersey County",4,14,259,127,132
050,17,083,"Illinois","Jersey County",4,15,282,146,136
050,17,083,"Illinois","Jersey County",4,16,262,127,135
050,17,083,"Illinois","Jersey County",4,17,293,155,138
050,17,083,"Illinois","Jersey County",4,18,271,139,132
050,17,083,"Illinois","Jersey County",4,19,283,142,141
050,17,083,"Illinois","Jersey County",4,20,311,155,156
050,17,083,"Illinois","Jersey County",4,21,280,147,133
050,17,083,"Illinois","Jersey County",4,22,295,149,146
050,17,083,"Illinois","Jersey County",4,23,252,133,119
050,17,083,"Illinois","Jersey County",4,24,226,113,113
050,17,083,"Illinois","Jersey County",4,25,249,137,112
050,17,083,"Illinois","Jersey County",4,26,219,109,110
050,17,083,"Illinois","Jersey County",4,27,218,100,118
050,17,083,"Illinois","Jersey County",4,28,219,112,107
050,17,083,"Illinois","Jersey County",4,29,221,116,105
050,17,083,"Illinois","Jersey County",4,30,221,110,111
050,17,083,"Illinois","Jersey County",4,31,219,108,111
050,17,083,"Illinois","Jersey County",4,32,237,127,110
050,17,083,"Illinois","Jersey County",4,33,247,117,130
050,17,083,"Illinois","Jersey County",4,34,216,112,104
050,17,083,"Illinois","Jersey County",4,35,217,107,110
050,17,083,"Illinois","Jersey County",4,36,246,124,122
050,17,083,"Illinois","Jersey County",4,37,255,122,133
050,17,083,"Illinois","Jersey County",4,38,259,131,128
050,17,083,"Illinois","Jersey County",4,39,258,126,132
050,17,083,"Illinois","Jersey County",4,40,263,141,122
050,17,083,"Illinois","Jersey County",4,41,261,139,122
050,17,083,"Illinois","Jersey County",4,42,261,134,127
050,17,083,"Illinois","Jersey County",4,43,274,133,141
050,17,083,"Illinois","Jersey County",4,44,255,128,127
050,17,083,"Illinois","Jersey County",4,45,236,117,119
050,17,083,"Illinois","Jersey County",4,46,243,123,120
050,17,083,"Illinois","Jersey County",4,47,236,117,119
050,17,083,"Illinois","Jersey County",4,48,238,122,116
050,17,083,"Illinois","Jersey County",4,49,241,132,109
050,17,083,"Illinois","Jersey County",4,50,261,143,118
050,17,083,"Illinois","Jersey County",4,51,293,148,145
050,17,083,"Illinois","Jersey County",4,52,287,142,145
050,17,083,"Illinois","Jersey County",4,53,295,145,150
050,17,083,"Illinois","Jersey County",4,54,262,132,130
050,17,083,"Illinois","Jersey County",4,55,282,140,142
050,17,083,"Illinois","Jersey County",4,56,289,150,139
050,17,083,"Illinois","Jersey County",4,57,318,161,157
050,17,083,"Illinois","Jersey County",4,58,336,162,174
050,17,083,"Illinois","Jersey County",4,59,321,156,165
050,17,083,"Illinois","Jersey County",4,60,361,165,196
050,17,083,"Illinois","Jersey County",4,61,363,173,190
050,17,083,"Illinois","Jersey County",4,62,339,174,165
050,17,083,"Illinois","Jersey County",4,63,318,152,166
050,17,083,"Illinois","Jersey County",4,64,326,157,169
050,17,083,"Illinois","Jersey County",4,65,324,167,157
050,17,083,"Illinois","Jersey County",4,66,303,155,148
050,17,083,"Illinois","Jersey County",4,67,303,138,165
050,17,083,"Illinois","Jersey County",4,68,275,123,152
050,17,083,"Illinois","Jersey County",4,69,251,115,136
050,17,083,"Illinois","Jersey County",4,70,250,118,132
050,17,083,"Illinois","Jersey County",4,71,242,122,120
050,17,083,"Illinois","Jersey County",4,72,230,118,112
050,17,083,"Illinois","Jersey County",4,73,204,91,113
050,17,083,"Illinois","Jersey County",4,74,200,89,111
050,17,083,"Illinois","Jersey County",4,75,209,96,113
050,17,083,"Illinois","Jersey County",4,76,143,70,73
050,17,083,"Illinois","Jersey County",4,77,138,64,74
050,17,083,"Illinois","Jersey County",4,78,144,68,76
050,17,083,"Illinois","Jersey County",4,79,148,68,80
050,17,083,"Illinois","Jersey County",4,80,130,61,69
050,17,083,"Illinois","Jersey County",4,81,114,52,62
050,17,083,"Illinois","Jersey County",4,82,107,44,63
050,17,083,"Illinois","Jersey County",4,83,103,47,56
050,17,083,"Illinois","Jersey County",4,84,97,37,60
050,17,083,"Illinois","Jersey County",4,85,470,179,291
050,17,083,"Illinois","Jersey County",5,0,149,78,71
050,17,083,"Illinois","Jersey County",5,1,175,84,91
050,17,083,"Illinois","Jersey County",5,2,175,94,81
050,17,083,"Illinois","Jersey County",5,3,227,116,111
050,17,083,"Illinois","Jersey County",5,4,234,125,109
050,17,083,"Illinois","Jersey County",5,5,229,114,115
050,17,083,"Illinois","Jersey County",5,6,237,124,113
050,17,083,"Illinois","Jersey County",5,7,234,122,112
050,17,083,"Illinois","Jersey County",5,8,204,100,104
050,17,083,"Illinois","Jersey County",5,9,226,114,112
050,17,083,"Illinois","Jersey County",5,10,263,125,138
050,17,083,"Illinois","Jersey County",5,11,257,130,127
050,17,083,"Illinois","Jersey County",5,12,234,118,116
050,17,083,"Illinois","Jersey County",5,13,259,129,130
050,17,083,"Illinois","Jersey County",5,14,255,128,127
050,17,083,"Illinois","Jersey County",5,15,257,130,127
050,17,083,"Illinois","Jersey County",5,16,281,147,134
050,17,083,"Illinois","Jersey County",5,17,261,127,134
050,17,083,"Illinois","Jersey County",5,18,281,147,134
050,17,083,"Illinois","Jersey County",5,19,286,139,147
050,17,083,"Illinois","Jersey County",5,20,298,156,142
050,17,083,"Illinois","Jersey County",5,21,308,159,149
050,17,083,"Illinois","Jersey County",5,22,288,146,142
050,17,083,"Illinois","Jersey County",5,23,244,129,115
050,17,083,"Illinois","Jersey County",5,24,229,119,110
050,17,083,"Illinois","Jersey County",5,25,209,110,99
050,17,083,"Illinois","Jersey County",5,26,252,140,112
050,17,083,"Illinois","Jersey County",5,27,219,107,112
050,17,083,"Illinois","Jersey County",5,28,205,95,110
050,17,083,"Illinois","Jersey County",5,29,212,107,105
050,17,083,"Illinois","Jersey County",5,30,219,112,107
050,17,083,"Illinois","Jersey County",5,31,212,108,104
050,17,083,"Illinois","Jersey County",5,32,226,114,112
050,17,083,"Illinois","Jersey County",5,33,229,122,107
050,17,083,"Illinois","Jersey County",5,34,246,116,130
050,17,083,"Illinois","Jersey County",5,35,213,108,105
050,17,083,"Illinois","Jersey County",5,36,233,115,118
050,17,083,"Illinois","Jersey County",5,37,252,126,126
050,17,083,"Illinois","Jersey County",5,38,254,125,129
050,17,083,"Illinois","Jersey County",5,39,262,131,131
050,17,083,"Illinois","Jersey County",5,40,250,126,124
050,17,083,"Illinois","Jersey County",5,41,262,141,121
050,17,083,"Illinois","Jersey County",5,42,259,138,121
050,17,083,"Illinois","Jersey County",5,43,254,130,124
050,17,083,"Illinois","Jersey County",5,44,273,134,139
050,17,083,"Illinois","Jersey County",5,45,261,133,128
050,17,083,"Illinois","Jersey County",5,46,240,119,121
050,17,083,"Illinois","Jersey County",5,47,241,120,121
050,17,083,"Illinois","Jersey County",5,48,234,115,119
050,17,083,"Illinois","Jersey County",5,49,241,123,118
050,17,083,"Illinois","Jersey County",5,50,237,132,105
050,17,083,"Illinois","Jersey County",5,51,257,141,116
050,17,083,"Illinois","Jersey County",5,52,290,146,144
050,17,083,"Illinois","Jersey County",5,53,278,142,136
050,17,083,"Illinois","Jersey County",5,54,298,149,149
050,17,083,"Illinois","Jersey County",5,55,266,137,129
050,17,083,"Illinois","Jersey County",5,56,276,137,139
050,17,083,"Illinois","Jersey County",5,57,287,147,140
050,17,083,"Illinois","Jersey County",5,58,305,157,148
050,17,083,"Illinois","Jersey County",5,59,333,160,173
050,17,083,"Illinois","Jersey County",5,60,320,154,166
050,17,083,"Illinois","Jersey County",5,61,363,166,197
050,17,083,"Illinois","Jersey County",5,62,353,164,189
050,17,083,"Illinois","Jersey County",5,63,339,173,166
050,17,083,"Illinois","Jersey County",5,64,315,155,160
050,17,083,"Illinois","Jersey County",5,65,314,147,167
050,17,083,"Illinois","Jersey County",5,66,320,165,155
050,17,083,"Illinois","Jersey County",5,67,302,154,148
050,17,083,"Illinois","Jersey County",5,68,292,133,159
050,17,083,"Illinois","Jersey County",5,69,271,120,151
050,17,083,"Illinois","Jersey County",5,70,244,110,134
050,17,083,"Illinois","Jersey County",5,71,244,115,129
050,17,083,"Illinois","Jersey County",5,72,242,124,118
050,17,083,"Illinois","Jersey County",5,73,218,112,106
050,17,083,"Illinois","Jersey County",5,74,202,88,114
050,17,083,"Illinois","Jersey County",5,75,196,88,108
050,17,083,"Illinois","Jersey County",5,76,211,94,117
050,17,083,"Illinois","Jersey County",5,77,136,65,71
050,17,083,"Illinois","Jersey County",5,78,125,58,67
050,17,083,"Illinois","Jersey County",5,79,143,68,75
050,17,083,"Illinois","Jersey County",5,80,139,67,72
050,17,083,"Illinois","Jersey County",5,81,121,56,65
050,17,083,"Illinois","Jersey County",5,82,108,51,57
050,17,083,"Illinois","Jersey County",5,83,110,46,64
050,17,083,"Illinois","Jersey County",5,84,96,39,57
050,17,083,"Illinois","Jersey County",5,85,491,191,300
050,17,085,"Illinois","Jo Daviess County",1,0,160,82,78
050,17,085,"Illinois","Jo Daviess County",1,1,191,106,85
050,17,085,"Illinois","Jo Daviess County",1,2,186,98,88
050,17,085,"Illinois","Jo Daviess County",1,3,190,98,92
050,17,085,"Illinois","Jo Daviess County",1,4,215,108,107
050,17,085,"Illinois","Jo Daviess County",1,5,227,121,106
050,17,085,"Illinois","Jo Daviess County",1,6,214,109,105
050,17,085,"Illinois","Jo Daviess County",1,7,223,117,106
050,17,085,"Illinois","Jo Daviess County",1,8,232,114,118
050,17,085,"Illinois","Jo Daviess County",1,9,229,115,114
050,17,085,"Illinois","Jo Daviess County",1,10,261,140,121
050,17,085,"Illinois","Jo Daviess County",1,11,262,148,114
050,17,085,"Illinois","Jo Daviess County",1,12,266,142,124
050,17,085,"Illinois","Jo Daviess County",1,13,266,135,131
050,17,085,"Illinois","Jo Daviess County",1,14,267,140,127
050,17,085,"Illinois","Jo Daviess County",1,15,268,149,119
050,17,085,"Illinois","Jo Daviess County",1,16,276,148,128
050,17,085,"Illinois","Jo Daviess County",1,17,268,142,126
050,17,085,"Illinois","Jo Daviess County",1,18,216,117,99
050,17,085,"Illinois","Jo Daviess County",1,19,181,97,84
050,17,085,"Illinois","Jo Daviess County",1,20,196,111,85
050,17,085,"Illinois","Jo Daviess County",1,21,191,109,82
050,17,085,"Illinois","Jo Daviess County",1,22,205,118,87
050,17,085,"Illinois","Jo Daviess County",1,23,203,104,99
050,17,085,"Illinois","Jo Daviess County",1,24,182,100,82
050,17,085,"Illinois","Jo Daviess County",1,25,181,100,81
050,17,085,"Illinois","Jo Daviess County",1,26,196,111,85
050,17,085,"Illinois","Jo Daviess County",1,27,190,91,99
050,17,085,"Illinois","Jo Daviess County",1,28,175,82,93
050,17,085,"Illinois","Jo Daviess County",1,29,190,92,98
050,17,085,"Illinois","Jo Daviess County",1,30,200,104,96
050,17,085,"Illinois","Jo Daviess County",1,31,176,95,81
050,17,085,"Illinois","Jo Daviess County",1,32,188,99,89
050,17,085,"Illinois","Jo Daviess County",1,33,200,106,94
050,17,085,"Illinois","Jo Daviess County",1,34,189,100,89
050,17,085,"Illinois","Jo Daviess County",1,35,230,121,109
050,17,085,"Illinois","Jo Daviess County",1,36,225,115,110
050,17,085,"Illinois","Jo Daviess County",1,37,227,106,121
050,17,085,"Illinois","Jo Daviess County",1,38,226,107,119
050,17,085,"Illinois","Jo Daviess County",1,39,230,120,110
050,17,085,"Illinois","Jo Daviess County",1,40,225,110,115
050,17,085,"Illinois","Jo Daviess County",1,41,192,101,91
050,17,085,"Illinois","Jo Daviess County",1,42,220,116,104
050,17,085,"Illinois","Jo Daviess County",1,43,210,113,97
050,17,085,"Illinois","Jo Daviess County",1,44,224,112,112
050,17,085,"Illinois","Jo Daviess County",1,45,234,116,118
050,17,085,"Illinois","Jo Daviess County",1,46,225,116,109
050,17,085,"Illinois","Jo Daviess County",1,47,217,106,111
050,17,085,"Illinois","Jo Daviess County",1,48,243,121,122
050,17,085,"Illinois","Jo Daviess County",1,49,284,146,138
050,17,085,"Illinois","Jo Daviess County",1,50,259,129,130
050,17,085,"Illinois","Jo Daviess County",1,51,244,128,116
050,17,085,"Illinois","Jo Daviess County",1,52,262,139,123
050,17,085,"Illinois","Jo Daviess County",1,53,252,118,134
050,17,085,"Illinois","Jo Daviess County",1,54,281,132,149
050,17,085,"Illinois","Jo Daviess County",1,55,294,150,144
050,17,085,"Illinois","Jo Daviess County",1,56,303,156,147
050,17,085,"Illinois","Jo Daviess County",1,57,353,177,176
050,17,085,"Illinois","Jo Daviess County",1,58,382,195,187
050,17,085,"Illinois","Jo Daviess County",1,59,354,181,173
050,17,085,"Illinois","Jo Daviess County",1,60,356,179,177
050,17,085,"Illinois","Jo Daviess County",1,61,375,187,188
050,17,085,"Illinois","Jo Daviess County",1,62,395,193,202
050,17,085,"Illinois","Jo Daviess County",1,63,376,176,200
050,17,085,"Illinois","Jo Daviess County",1,64,369,170,199
050,17,085,"Illinois","Jo Daviess County",1,65,379,175,204
050,17,085,"Illinois","Jo Daviess County",1,66,373,184,189
050,17,085,"Illinois","Jo Daviess County",1,67,391,186,205
050,17,085,"Illinois","Jo Daviess County",1,68,409,205,204
050,17,085,"Illinois","Jo Daviess County",1,69,369,188,181
050,17,085,"Illinois","Jo Daviess County",1,70,366,197,169
050,17,085,"Illinois","Jo Daviess County",1,71,366,188,178
050,17,085,"Illinois","Jo Daviess County",1,72,392,196,196
050,17,085,"Illinois","Jo Daviess County",1,73,393,188,205
050,17,085,"Illinois","Jo Daviess County",1,74,245,115,130
050,17,085,"Illinois","Jo Daviess County",1,75,257,121,136
050,17,085,"Illinois","Jo Daviess County",1,76,284,140,144
050,17,085,"Illinois","Jo Daviess County",1,77,249,118,131
050,17,085,"Illinois","Jo Daviess County",1,78,217,103,114
050,17,085,"Illinois","Jo Daviess County",1,79,190,95,95
050,17,085,"Illinois","Jo Daviess County",1,80,161,86,75
050,17,085,"Illinois","Jo Daviess County",1,81,177,89,88
050,17,085,"Illinois","Jo Daviess County",1,82,146,68,78
050,17,085,"Illinois","Jo Daviess County",1,83,136,62,74
050,17,085,"Illinois","Jo Daviess County",1,84,117,57,60
050,17,085,"Illinois","Jo Daviess County",1,85,699,264,435
050,17,085,"Illinois","Jo Daviess County",2,0,170,88,82
050,17,085,"Illinois","Jo Daviess County",2,1,184,101,83
050,17,085,"Illinois","Jo Daviess County",2,2,189,100,89
050,17,085,"Illinois","Jo Daviess County",2,3,191,98,93
050,17,085,"Illinois","Jo Daviess County",2,4,211,107,104
050,17,085,"Illinois","Jo Daviess County",2,5,227,120,107
050,17,085,"Illinois","Jo Daviess County",2,6,218,112,106
050,17,085,"Illinois","Jo Daviess County",2,7,219,114,105
050,17,085,"Illinois","Jo Daviess County",2,8,228,113,115
050,17,085,"Illinois","Jo Daviess County",2,9,233,116,117
050,17,085,"Illinois","Jo Daviess County",2,10,252,133,119
050,17,085,"Illinois","Jo Daviess County",2,11,260,144,116
050,17,085,"Illinois","Jo Daviess County",2,12,265,142,123
050,17,085,"Illinois","Jo Daviess County",2,13,265,136,129
050,17,085,"Illinois","Jo Daviess County",2,14,265,138,127
050,17,085,"Illinois","Jo Daviess County",2,15,269,148,121
050,17,085,"Illinois","Jo Daviess County",2,16,275,149,126
050,17,085,"Illinois","Jo Daviess County",2,17,269,144,125
050,17,085,"Illinois","Jo Daviess County",2,18,217,118,99
050,17,085,"Illinois","Jo Daviess County",2,19,180,97,83
050,17,085,"Illinois","Jo Daviess County",2,20,196,109,87
050,17,085,"Illinois","Jo Daviess County",2,21,195,112,83
050,17,085,"Illinois","Jo Daviess County",2,22,205,118,87
050,17,085,"Illinois","Jo Daviess County",2,23,203,108,95
050,17,085,"Illinois","Jo Daviess County",2,24,187,101,86
050,17,085,"Illinois","Jo Daviess County",2,25,183,102,81
050,17,085,"Illinois","Jo Daviess County",2,26,198,112,86
050,17,085,"Illinois","Jo Daviess County",2,27,192,96,96
050,17,085,"Illinois","Jo Daviess County",2,28,179,85,94
050,17,085,"Illinois","Jo Daviess County",2,29,186,90,96
050,17,085,"Illinois","Jo Daviess County",2,30,200,102,98
050,17,085,"Illinois","Jo Daviess County",2,31,182,98,84
050,17,085,"Illinois","Jo Daviess County",2,32,183,97,86
050,17,085,"Illinois","Jo Daviess County",2,33,197,104,93
050,17,085,"Illinois","Jo Daviess County",2,34,194,103,91
050,17,085,"Illinois","Jo Daviess County",2,35,223,118,105
050,17,085,"Illinois","Jo Daviess County",2,36,225,116,109
050,17,085,"Illinois","Jo Daviess County",2,37,229,109,120
050,17,085,"Illinois","Jo Daviess County",2,38,227,106,121
050,17,085,"Illinois","Jo Daviess County",2,39,230,118,112
050,17,085,"Illinois","Jo Daviess County",2,40,227,114,113
050,17,085,"Illinois","Jo Daviess County",2,41,197,100,97
050,17,085,"Illinois","Jo Daviess County",2,42,212,111,101
050,17,085,"Illinois","Jo Daviess County",2,43,214,115,99
050,17,085,"Illinois","Jo Daviess County",2,44,220,113,107
050,17,085,"Illinois","Jo Daviess County",2,45,233,116,117
050,17,085,"Illinois","Jo Daviess County",2,46,228,117,111
050,17,085,"Illinois","Jo Daviess County",2,47,218,108,110
050,17,085,"Illinois","Jo Daviess County",2,48,235,117,118
050,17,085,"Illinois","Jo Daviess County",2,49,274,139,135
050,17,085,"Illinois","Jo Daviess County",2,50,265,133,132
050,17,085,"Illinois","Jo Daviess County",2,51,246,127,119
050,17,085,"Illinois","Jo Daviess County",2,52,260,137,123
050,17,085,"Illinois","Jo Daviess County",2,53,256,124,132
050,17,085,"Illinois","Jo Daviess County",2,54,274,129,145
050,17,085,"Illinois","Jo Daviess County",2,55,293,147,146
050,17,085,"Illinois","Jo Daviess County",2,56,303,155,148
050,17,085,"Illinois","Jo Daviess County",2,57,341,173,168
050,17,085,"Illinois","Jo Daviess County",2,58,375,190,185
050,17,085,"Illinois","Jo Daviess County",2,59,364,186,178
050,17,085,"Illinois","Jo Daviess County",2,60,356,179,177
050,17,085,"Illinois","Jo Daviess County",2,61,372,185,187
050,17,085,"Illinois","Jo Daviess County",2,62,393,193,200
050,17,085,"Illinois","Jo Daviess County",2,63,387,184,203
050,17,085,"Illinois","Jo Daviess County",2,64,369,169,200
050,17,085,"Illinois","Jo Daviess County",2,65,378,174,204
050,17,085,"Illinois","Jo Daviess County",2,66,377,184,193
050,17,085,"Illinois","Jo Daviess County",2,67,385,187,198
050,17,085,"Illinois","Jo Daviess County",2,68,404,201,203
050,17,085,"Illinois","Jo Daviess County",2,69,381,192,189
050,17,085,"Illinois","Jo Daviess County",2,70,365,195,170
050,17,085,"Illinois","Jo Daviess County",2,71,364,189,175
050,17,085,"Illinois","Jo Daviess County",2,72,377,189,188
050,17,085,"Illinois","Jo Daviess County",2,73,410,197,213
050,17,085,"Illinois","Jo Daviess County",2,74,261,123,138
050,17,085,"Illinois","Jo Daviess County",2,75,251,118,133
050,17,085,"Illinois","Jo Daviess County",2,76,273,134,139
050,17,085,"Illinois","Jo Daviess County",2,77,259,124,135
050,17,085,"Illinois","Jo Daviess County",2,78,216,101,115
050,17,085,"Illinois","Jo Daviess County",2,79,193,95,98
050,17,085,"Illinois","Jo Daviess County",2,80,166,87,79
050,17,085,"Illinois","Jo Daviess County",2,81,171,87,84
050,17,085,"Illinois","Jo Daviess County",2,82,152,72,80
050,17,085,"Illinois","Jo Daviess County",2,83,138,62,76
050,17,085,"Illinois","Jo Daviess County",2,84,119,57,62
050,17,085,"Illinois","Jo Daviess County",2,85,704,264,440
050,17,085,"Illinois","Jo Daviess County",3,0,157,82,75
050,17,085,"Illinois","Jo Daviess County",3,1,171,87,84
050,17,085,"Illinois","Jo Daviess County",3,2,179,97,82
050,17,085,"Illinois","Jo Daviess County",3,3,193,101,92
050,17,085,"Illinois","Jo Daviess County",3,4,192,95,97
050,17,085,"Illinois","Jo Daviess County",3,5,202,109,93
050,17,085,"Illinois","Jo Daviess County",3,6,226,122,104
050,17,085,"Illinois","Jo Daviess County",3,7,208,110,98
050,17,085,"Illinois","Jo Daviess County",3,8,216,111,105
050,17,085,"Illinois","Jo Daviess County",3,9,227,106,121
050,17,085,"Illinois","Jo Daviess County",3,10,225,109,116
050,17,085,"Illinois","Jo Daviess County",3,11,255,134,121
050,17,085,"Illinois","Jo Daviess County",3,12,253,137,116
050,17,085,"Illinois","Jo Daviess County",3,13,273,143,130
050,17,085,"Illinois","Jo Daviess County",3,14,262,133,129
050,17,085,"Illinois","Jo Daviess County",3,15,271,143,128
050,17,085,"Illinois","Jo Daviess County",3,16,269,149,120
050,17,085,"Illinois","Jo Daviess County",3,17,270,147,123
050,17,085,"Illinois","Jo Daviess County",3,18,214,116,98
050,17,085,"Illinois","Jo Daviess County",3,19,173,97,76
050,17,085,"Illinois","Jo Daviess County",3,20,189,101,88
050,17,085,"Illinois","Jo Daviess County",3,21,199,109,90
050,17,085,"Illinois","Jo Daviess County",3,22,199,114,85
050,17,085,"Illinois","Jo Daviess County",3,23,206,115,91
050,17,085,"Illinois","Jo Daviess County",3,24,203,111,92
050,17,085,"Illinois","Jo Daviess County",3,25,186,91,95
050,17,085,"Illinois","Jo Daviess County",3,26,196,104,92
050,17,085,"Illinois","Jo Daviess County",3,27,206,121,85
050,17,085,"Illinois","Jo Daviess County",3,28,196,103,93
050,17,085,"Illinois","Jo Daviess County",3,29,189,91,98
050,17,085,"Illinois","Jo Daviess County",3,30,177,86,91
050,17,085,"Illinois","Jo Daviess County",3,31,205,104,101
050,17,085,"Illinois","Jo Daviess County",3,32,191,101,90
050,17,085,"Illinois","Jo Daviess County",3,33,180,91,89
050,17,085,"Illinois","Jo Daviess County",3,34,196,102,94
050,17,085,"Illinois","Jo Daviess County",3,35,198,108,90
050,17,085,"Illinois","Jo Daviess County",3,36,229,120,109
050,17,085,"Illinois","Jo Daviess County",3,37,232,122,110
050,17,085,"Illinois","Jo Daviess County",3,38,227,110,117
050,17,085,"Illinois","Jo Daviess County",3,39,239,113,126
050,17,085,"Illinois","Jo Daviess County",3,40,231,122,109
050,17,085,"Illinois","Jo Daviess County",3,41,223,110,113
050,17,085,"Illinois","Jo Daviess County",3,42,196,101,95
050,17,085,"Illinois","Jo Daviess County",3,43,223,116,107
050,17,085,"Illinois","Jo Daviess County",3,44,212,114,98
050,17,085,"Illinois","Jo Daviess County",3,45,225,113,112
050,17,085,"Illinois","Jo Daviess County",3,46,230,120,110
050,17,085,"Illinois","Jo Daviess County",3,47,227,114,113
050,17,085,"Illinois","Jo Daviess County",3,48,224,114,110
050,17,085,"Illinois","Jo Daviess County",3,49,233,116,117
050,17,085,"Illinois","Jo Daviess County",3,50,275,138,137
050,17,085,"Illinois","Jo Daviess County",3,51,269,136,133
050,17,085,"Illinois","Jo Daviess County",3,52,241,126,115
050,17,085,"Illinois","Jo Daviess County",3,53,264,141,123
050,17,085,"Illinois","Jo Daviess County",3,54,262,131,131
050,17,085,"Illinois","Jo Daviess County",3,55,275,131,144
050,17,085,"Illinois","Jo Daviess County",3,56,292,145,147
050,17,085,"Illinois","Jo Daviess County",3,57,310,158,152
050,17,085,"Illinois","Jo Daviess County",3,58,334,165,169
050,17,085,"Illinois","Jo Daviess County",3,59,380,192,188
050,17,085,"Illinois","Jo Daviess County",3,60,373,194,179
050,17,085,"Illinois","Jo Daviess County",3,61,362,182,180
050,17,085,"Illinois","Jo Daviess County",3,62,380,194,186
050,17,085,"Illinois","Jo Daviess County",3,63,405,206,199
050,17,085,"Illinois","Jo Daviess County",3,64,395,189,206
050,17,085,"Illinois","Jo Daviess County",3,65,373,165,208
050,17,085,"Illinois","Jo Daviess County",3,66,386,175,211
050,17,085,"Illinois","Jo Daviess County",3,67,372,180,192
050,17,085,"Illinois","Jo Daviess County",3,68,387,188,199
050,17,085,"Illinois","Jo Daviess County",3,69,400,200,200
050,17,085,"Illinois","Jo Daviess County",3,70,384,196,188
050,17,085,"Illinois","Jo Daviess County",3,71,355,192,163
050,17,085,"Illinois","Jo Daviess County",3,72,351,185,166
050,17,085,"Illinois","Jo Daviess County",3,73,359,180,179
050,17,085,"Illinois","Jo Daviess County",3,74,400,189,211
050,17,085,"Illinois","Jo Daviess County",3,75,252,120,132
050,17,085,"Illinois","Jo Daviess County",3,76,239,109,130
050,17,085,"Illinois","Jo Daviess County",3,77,255,126,129
050,17,085,"Illinois","Jo Daviess County",3,78,243,114,129
050,17,085,"Illinois","Jo Daviess County",3,79,202,92,110
050,17,085,"Illinois","Jo Daviess County",3,80,179,89,90
050,17,085,"Illinois","Jo Daviess County",3,81,158,80,78
050,17,085,"Illinois","Jo Daviess County",3,82,160,81,79
050,17,085,"Illinois","Jo Daviess County",3,83,143,67,76
050,17,085,"Illinois","Jo Daviess County",3,84,124,53,71
050,17,085,"Illinois","Jo Daviess County",3,85,730,284,446
050,17,085,"Illinois","Jo Daviess County",4,0,162,86,76
050,17,085,"Illinois","Jo Daviess County",4,1,156,76,80
050,17,085,"Illinois","Jo Daviess County",4,2,177,92,85
050,17,085,"Illinois","Jo Daviess County",4,3,177,99,78
050,17,085,"Illinois","Jo Daviess County",4,4,188,100,88
050,17,085,"Illinois","Jo Daviess County",4,5,199,95,104
050,17,085,"Illinois","Jo Daviess County",4,6,206,111,95
050,17,085,"Illinois","Jo Daviess County",4,7,230,123,107
050,17,085,"Illinois","Jo Daviess County",4,8,216,109,107
050,17,085,"Illinois","Jo Daviess County",4,9,209,109,100
050,17,085,"Illinois","Jo Daviess County",4,10,229,109,120
050,17,085,"Illinois","Jo Daviess County",4,11,236,120,116
050,17,085,"Illinois","Jo Daviess County",4,12,262,138,124
050,17,085,"Illinois","Jo Daviess County",4,13,260,139,121
050,17,085,"Illinois","Jo Daviess County",4,14,265,139,126
050,17,085,"Illinois","Jo Daviess County",4,15,272,134,138
050,17,085,"Illinois","Jo Daviess County",4,16,265,140,125
050,17,085,"Illinois","Jo Daviess County",4,17,267,147,120
050,17,085,"Illinois","Jo Daviess County",4,18,228,128,100
050,17,085,"Illinois","Jo Daviess County",4,19,168,91,77
050,17,085,"Illinois","Jo Daviess County",4,20,179,98,81
050,17,085,"Illinois","Jo Daviess County",4,21,186,97,89
050,17,085,"Illinois","Jo Daviess County",4,22,193,109,84
050,17,085,"Illinois","Jo Daviess County",4,23,186,103,83
050,17,085,"Illinois","Jo Daviess County",4,24,203,122,81
050,17,085,"Illinois","Jo Daviess County",4,25,188,104,84
050,17,085,"Illinois","Jo Daviess County",4,26,184,89,95
050,17,085,"Illinois","Jo Daviess County",4,27,181,103,78
050,17,085,"Illinois","Jo Daviess County",4,28,208,114,94
050,17,085,"Illinois","Jo Daviess County",4,29,191,99,92
050,17,085,"Illinois","Jo Daviess County",4,30,188,99,89
050,17,085,"Illinois","Jo Daviess County",4,31,180,84,96
050,17,085,"Illinois","Jo Daviess County",4,32,200,99,101
050,17,085,"Illinois","Jo Daviess County",4,33,195,101,94
050,17,085,"Illinois","Jo Daviess County",4,34,187,94,93
050,17,085,"Illinois","Jo Daviess County",4,35,211,113,98
050,17,085,"Illinois","Jo Daviess County",4,36,207,111,96
050,17,085,"Illinois","Jo Daviess County",4,37,231,123,108
050,17,085,"Illinois","Jo Daviess County",4,38,236,121,115
050,17,085,"Illinois","Jo Daviess County",4,39,220,113,107
050,17,085,"Illinois","Jo Daviess County",4,40,240,114,126
050,17,085,"Illinois","Jo Daviess County",4,41,231,120,111
050,17,085,"Illinois","Jo Daviess County",4,42,219,107,112
050,17,085,"Illinois","Jo Daviess County",4,43,198,102,96
050,17,085,"Illinois","Jo Daviess County",4,44,224,118,106
050,17,085,"Illinois","Jo Daviess County",4,45,216,116,100
050,17,085,"Illinois","Jo Daviess County",4,46,229,116,113
050,17,085,"Illinois","Jo Daviess County",4,47,228,119,109
050,17,085,"Illinois","Jo Daviess County",4,48,228,118,110
050,17,085,"Illinois","Jo Daviess County",4,49,222,113,109
050,17,085,"Illinois","Jo Daviess County",4,50,239,119,120
050,17,085,"Illinois","Jo Daviess County",4,51,278,140,138
050,17,085,"Illinois","Jo Daviess County",4,52,273,139,134
050,17,085,"Illinois","Jo Daviess County",4,53,245,123,122
050,17,085,"Illinois","Jo Daviess County",4,54,274,151,123
050,17,085,"Illinois","Jo Daviess County",4,55,251,126,125
050,17,085,"Illinois","Jo Daviess County",4,56,281,129,152
050,17,085,"Illinois","Jo Daviess County",4,57,296,147,149
050,17,085,"Illinois","Jo Daviess County",4,58,316,163,153
050,17,085,"Illinois","Jo Daviess County",4,59,342,167,175
050,17,085,"Illinois","Jo Daviess County",4,60,386,196,190
050,17,085,"Illinois","Jo Daviess County",4,61,376,195,181
050,17,085,"Illinois","Jo Daviess County",4,62,369,185,184
050,17,085,"Illinois","Jo Daviess County",4,63,385,195,190
050,17,085,"Illinois","Jo Daviess County",4,64,411,214,197
050,17,085,"Illinois","Jo Daviess County",4,65,408,197,211
050,17,085,"Illinois","Jo Daviess County",4,66,387,172,215
050,17,085,"Illinois","Jo Daviess County",4,67,382,173,209
050,17,085,"Illinois","Jo Daviess County",4,68,371,184,187
050,17,085,"Illinois","Jo Daviess County",4,69,380,183,197
050,17,085,"Illinois","Jo Daviess County",4,70,398,201,197
050,17,085,"Illinois","Jo Daviess County",4,71,362,184,178
050,17,085,"Illinois","Jo Daviess County",4,72,362,196,166
050,17,085,"Illinois","Jo Daviess County",4,73,336,175,161
050,17,085,"Illinois","Jo Daviess County",4,74,347,171,176
050,17,085,"Illinois","Jo Daviess County",4,75,380,177,203
050,17,085,"Illinois","Jo Daviess County",4,76,236,113,123
050,17,085,"Illinois","Jo Daviess County",4,77,228,104,124
050,17,085,"Illinois","Jo Daviess County",4,78,234,119,115
050,17,085,"Illinois","Jo Daviess County",4,79,228,107,121
050,17,085,"Illinois","Jo Daviess County",4,80,188,85,103
050,17,085,"Illinois","Jo Daviess County",4,81,171,85,86
050,17,085,"Illinois","Jo Daviess County",4,82,140,67,73
050,17,085,"Illinois","Jo Daviess County",4,83,153,75,78
050,17,085,"Illinois","Jo Daviess County",4,84,122,52,70
050,17,085,"Illinois","Jo Daviess County",4,85,749,291,458
050,17,085,"Illinois","Jo Daviess County",5,0,143,80,63
050,17,085,"Illinois","Jo Daviess County",5,1,164,82,82
050,17,085,"Illinois","Jo Daviess County",5,2,160,81,79
050,17,085,"Illinois","Jo Daviess County",5,3,190,94,96
050,17,085,"Illinois","Jo Daviess County",5,4,177,98,79
050,17,085,"Illinois","Jo Daviess County",5,5,191,106,85
050,17,085,"Illinois","Jo Daviess County",5,6,201,101,100
050,17,085,"Illinois","Jo Daviess County",5,7,202,107,95
050,17,085,"Illinois","Jo Daviess County",5,8,230,126,104
050,17,085,"Illinois","Jo Daviess County",5,9,215,107,108
050,17,085,"Illinois","Jo Daviess County",5,10,206,106,100
050,17,085,"Illinois","Jo Daviess County",5,11,225,109,116
050,17,085,"Illinois","Jo Daviess County",5,12,242,123,119
050,17,085,"Illinois","Jo Daviess County",5,13,263,140,123
050,17,085,"Illinois","Jo Daviess County",5,14,255,137,118
050,17,085,"Illinois","Jo Daviess County",5,15,272,144,128
050,17,085,"Illinois","Jo Daviess County",5,16,266,130,136
050,17,085,"Illinois","Jo Daviess County",5,17,277,143,134
050,17,085,"Illinois","Jo Daviess County",5,18,226,133,93
050,17,085,"Illinois","Jo Daviess County",5,19,174,98,76
050,17,085,"Illinois","Jo Daviess County",5,20,181,95,86
050,17,085,"Illinois","Jo Daviess County",5,21,179,96,83
050,17,085,"Illinois","Jo Daviess County",5,22,212,108,104
050,17,085,"Illinois","Jo Daviess County",5,23,196,110,86
050,17,085,"Illinois","Jo Daviess County",5,24,167,91,76
050,17,085,"Illinois","Jo Daviess County",5,25,188,108,80
050,17,085,"Illinois","Jo Daviess County",5,26,194,106,88
050,17,085,"Illinois","Jo Daviess County",5,27,195,105,90
050,17,085,"Illinois","Jo Daviess County",5,28,176,101,75
050,17,085,"Illinois","Jo Daviess County",5,29,201,110,91
050,17,085,"Illinois","Jo Daviess County",5,30,186,95,91
050,17,085,"Illinois","Jo Daviess County",5,31,181,91,90
050,17,085,"Illinois","Jo Daviess County",5,32,175,81,94
050,17,085,"Illinois","Jo Daviess County",5,33,205,101,104
050,17,085,"Illinois","Jo Daviess County",5,34,197,103,94
050,17,085,"Illinois","Jo Daviess County",5,35,191,93,98
050,17,085,"Illinois","Jo Daviess County",5,36,215,111,104
050,17,085,"Illinois","Jo Daviess County",5,37,207,110,97
050,17,085,"Illinois","Jo Daviess County",5,38,244,132,112
050,17,085,"Illinois","Jo Daviess County",5,39,232,122,110
050,17,085,"Illinois","Jo Daviess County",5,40,214,109,105
050,17,085,"Illinois","Jo Daviess County",5,41,248,116,132
050,17,085,"Illinois","Jo Daviess County",5,42,227,116,111
050,17,085,"Illinois","Jo Daviess County",5,43,216,112,104
050,17,085,"Illinois","Jo Daviess County",5,44,208,106,102
050,17,085,"Illinois","Jo Daviess County",5,45,233,120,113
050,17,085,"Illinois","Jo Daviess County",5,46,214,118,96
050,17,085,"Illinois","Jo Daviess County",5,47,230,115,115
050,17,085,"Illinois","Jo Daviess County",5,48,232,125,107
050,17,085,"Illinois","Jo Daviess County",5,49,230,117,113
050,17,085,"Illinois","Jo Daviess County",5,50,225,114,111
050,17,085,"Illinois","Jo Daviess County",5,51,245,120,125
050,17,085,"Illinois","Jo Daviess County",5,52,273,138,135
050,17,085,"Illinois","Jo Daviess County",5,53,281,144,137
050,17,085,"Illinois","Jo Daviess County",5,54,245,121,124
050,17,085,"Illinois","Jo Daviess County",5,55,276,154,122
050,17,085,"Illinois","Jo Daviess County",5,56,252,131,121
050,17,085,"Illinois","Jo Daviess County",5,57,288,134,154
050,17,085,"Illinois","Jo Daviess County",5,58,299,152,147
050,17,085,"Illinois","Jo Daviess County",5,59,329,171,158
050,17,085,"Illinois","Jo Daviess County",5,60,352,168,184
050,17,085,"Illinois","Jo Daviess County",5,61,383,192,191
050,17,085,"Illinois","Jo Daviess County",5,62,382,197,185
050,17,085,"Illinois","Jo Daviess County",5,63,375,185,190
050,17,085,"Illinois","Jo Daviess County",5,64,394,198,196
050,17,085,"Illinois","Jo Daviess County",5,65,422,220,202
050,17,085,"Illinois","Jo Daviess County",5,66,412,203,209
050,17,085,"Illinois","Jo Daviess County",5,67,379,165,214
050,17,085,"Illinois","Jo Daviess County",5,68,388,179,209
050,17,085,"Illinois","Jo Daviess County",5,69,364,177,187
050,17,085,"Illinois","Jo Daviess County",5,70,372,176,196
050,17,085,"Illinois","Jo Daviess County",5,71,388,192,196
050,17,085,"Illinois","Jo Daviess County",5,72,356,181,175
050,17,085,"Illinois","Jo Daviess County",5,73,350,194,156
050,17,085,"Illinois","Jo Daviess County",5,74,333,174,159
050,17,085,"Illinois","Jo Daviess County",5,75,335,165,170
050,17,085,"Illinois","Jo Daviess County",5,76,357,167,190
050,17,085,"Illinois","Jo Daviess County",5,77,223,109,114
050,17,085,"Illinois","Jo Daviess County",5,78,215,97,118
050,17,085,"Illinois","Jo Daviess County",5,79,228,113,115
050,17,085,"Illinois","Jo Daviess County",5,80,214,100,114
050,17,085,"Illinois","Jo Daviess County",5,81,181,82,99
050,17,085,"Illinois","Jo Daviess County",5,82,150,70,80
050,17,085,"Illinois","Jo Daviess County",5,83,130,60,70
050,17,085,"Illinois","Jo Daviess County",5,84,133,62,71
050,17,085,"Illinois","Jo Daviess County",5,85,774,303,471
050,17,087,"Illinois","Johnson County",1,0,99,51,48
050,17,087,"Illinois","Johnson County",1,1,118,58,60
050,17,087,"Illinois","Johnson County",1,2,106,54,52
050,17,087,"Illinois","Johnson County",1,3,112,48,64
050,17,087,"Illinois","Johnson County",1,4,124,56,68
050,17,087,"Illinois","Johnson County",1,5,129,63,66
050,17,087,"Illinois","Johnson County",1,6,124,68,56
050,17,087,"Illinois","Johnson County",1,7,112,58,54
050,17,087,"Illinois","Johnson County",1,8,117,60,57
050,17,087,"Illinois","Johnson County",1,9,126,60,66
050,17,087,"Illinois","Johnson County",1,10,129,68,61
050,17,087,"Illinois","Johnson County",1,11,137,76,61
050,17,087,"Illinois","Johnson County",1,12,145,67,78
050,17,087,"Illinois","Johnson County",1,13,136,67,69
050,17,087,"Illinois","Johnson County",1,14,132,71,61
050,17,087,"Illinois","Johnson County",1,15,131,59,72
050,17,087,"Illinois","Johnson County",1,16,136,69,67
050,17,087,"Illinois","Johnson County",1,17,151,81,70
050,17,087,"Illinois","Johnson County",1,18,166,114,52
050,17,087,"Illinois","Johnson County",1,19,163,123,40
050,17,087,"Illinois","Johnson County",1,20,182,139,43
050,17,087,"Illinois","Johnson County",1,21,167,122,45
050,17,087,"Illinois","Johnson County",1,22,204,156,48
050,17,087,"Illinois","Johnson County",1,23,168,121,47
050,17,087,"Illinois","Johnson County",1,24,182,123,59
050,17,087,"Illinois","Johnson County",1,25,169,118,51
050,17,087,"Illinois","Johnson County",1,26,188,136,52
050,17,087,"Illinois","Johnson County",1,27,193,136,57
050,17,087,"Illinois","Johnson County",1,28,210,155,55
050,17,087,"Illinois","Johnson County",1,29,234,169,65
050,17,087,"Illinois","Johnson County",1,30,196,141,55
050,17,087,"Illinois","Johnson County",1,31,190,127,63
050,17,087,"Illinois","Johnson County",1,32,196,143,53
050,17,087,"Illinois","Johnson County",1,33,170,118,52
050,17,087,"Illinois","Johnson County",1,34,189,125,64
050,17,087,"Illinois","Johnson County",1,35,167,108,59
050,17,087,"Illinois","Johnson County",1,36,178,111,67
050,17,087,"Illinois","Johnson County",1,37,199,135,64
050,17,087,"Illinois","Johnson County",1,38,168,110,58
050,17,087,"Illinois","Johnson County",1,39,187,119,68
050,17,087,"Illinois","Johnson County",1,40,178,119,59
050,17,087,"Illinois","Johnson County",1,41,169,113,56
050,17,087,"Illinois","Johnson County",1,42,176,116,60
050,17,087,"Illinois","Johnson County",1,43,189,118,71
050,17,087,"Illinois","Johnson County",1,44,160,102,58
050,17,087,"Illinois","Johnson County",1,45,151,101,50
050,17,087,"Illinois","Johnson County",1,46,155,98,57
050,17,087,"Illinois","Johnson County",1,47,193,132,61
050,17,087,"Illinois","Johnson County",1,48,170,117,53
050,17,087,"Illinois","Johnson County",1,49,186,126,60
050,17,087,"Illinois","Johnson County",1,50,175,112,63
050,17,087,"Illinois","Johnson County",1,51,183,109,74
050,17,087,"Illinois","Johnson County",1,52,168,100,68
050,17,087,"Illinois","Johnson County",1,53,171,91,80
050,17,087,"Illinois","Johnson County",1,54,176,101,75
050,17,087,"Illinois","Johnson County",1,55,172,93,79
050,17,087,"Illinois","Johnson County",1,56,186,100,86
050,17,087,"Illinois","Johnson County",1,57,175,97,78
050,17,087,"Illinois","Johnson County",1,58,171,88,83
050,17,087,"Illinois","Johnson County",1,59,197,112,85
050,17,087,"Illinois","Johnson County",1,60,186,92,94
050,17,087,"Illinois","Johnson County",1,61,193,99,94
050,17,087,"Illinois","Johnson County",1,62,186,96,90
050,17,087,"Illinois","Johnson County",1,63,156,76,80
050,17,087,"Illinois","Johnson County",1,64,166,76,90
050,17,087,"Illinois","Johnson County",1,65,158,79,79
050,17,087,"Illinois","Johnson County",1,66,143,74,69
050,17,087,"Illinois","Johnson County",1,67,153,78,75
050,17,087,"Illinois","Johnson County",1,68,150,80,70
050,17,087,"Illinois","Johnson County",1,69,153,82,71
050,17,087,"Illinois","Johnson County",1,70,142,75,67
050,17,087,"Illinois","Johnson County",1,71,154,80,74
050,17,087,"Illinois","Johnson County",1,72,166,77,89
050,17,087,"Illinois","Johnson County",1,73,144,77,67
050,17,087,"Illinois","Johnson County",1,74,101,49,52
050,17,087,"Illinois","Johnson County",1,75,109,52,57
050,17,087,"Illinois","Johnson County",1,76,96,51,45
050,17,087,"Illinois","Johnson County",1,77,120,54,66
050,17,087,"Illinois","Johnson County",1,78,109,52,57
050,17,087,"Illinois","Johnson County",1,79,90,45,45
050,17,087,"Illinois","Johnson County",1,80,75,42,33
050,17,087,"Illinois","Johnson County",1,81,74,40,34
050,17,087,"Illinois","Johnson County",1,82,77,41,36
050,17,087,"Illinois","Johnson County",1,83,58,31,27
050,17,087,"Illinois","Johnson County",1,84,44,23,21
050,17,087,"Illinois","Johnson County",1,85,270,106,164
050,17,087,"Illinois","Johnson County",2,0,109,60,49
050,17,087,"Illinois","Johnson County",2,1,115,57,58
050,17,087,"Illinois","Johnson County",2,2,109,55,54
050,17,087,"Illinois","Johnson County",2,3,109,49,60
050,17,087,"Illinois","Johnson County",2,4,121,54,67
050,17,087,"Illinois","Johnson County",2,5,128,62,66
050,17,087,"Illinois","Johnson County",2,6,125,67,58
050,17,087,"Illinois","Johnson County",2,7,115,61,54
050,17,087,"Illinois","Johnson County",2,8,117,60,57
050,17,087,"Illinois","Johnson County",2,9,124,60,64
050,17,087,"Illinois","Johnson County",2,10,128,66,62
050,17,087,"Illinois","Johnson County",2,11,136,74,62
050,17,087,"Illinois","Johnson County",2,12,145,71,74
050,17,087,"Illinois","Johnson County",2,13,138,68,70
050,17,087,"Illinois","Johnson County",2,14,132,70,62
050,17,087,"Illinois","Johnson County",2,15,131,63,68
050,17,087,"Illinois","Johnson County",2,16,137,69,68
050,17,087,"Illinois","Johnson County",2,17,147,78,69
050,17,087,"Illinois","Johnson County",2,18,168,115,53
050,17,087,"Illinois","Johnson County",2,19,162,121,41
050,17,087,"Illinois","Johnson County",2,20,183,139,44
050,17,087,"Illinois","Johnson County",2,21,168,124,44
050,17,087,"Illinois","Johnson County",2,22,204,156,48
050,17,087,"Illinois","Johnson County",2,23,171,122,49
050,17,087,"Illinois","Johnson County",2,24,179,123,56
050,17,087,"Illinois","Johnson County",2,25,171,118,53
050,17,087,"Illinois","Johnson County",2,26,190,138,52
050,17,087,"Illinois","Johnson County",2,27,190,134,56
050,17,087,"Illinois","Johnson County",2,28,214,157,57
050,17,087,"Illinois","Johnson County",2,29,230,166,64
050,17,087,"Illinois","Johnson County",2,30,199,142,57
050,17,087,"Illinois","Johnson County",2,31,190,130,60
050,17,087,"Illinois","Johnson County",2,32,198,144,54
050,17,087,"Illinois","Johnson County",2,33,169,117,52
050,17,087,"Illinois","Johnson County",2,34,186,123,63
050,17,087,"Illinois","Johnson County",2,35,169,107,62
050,17,087,"Illinois","Johnson County",2,36,177,112,65
050,17,087,"Illinois","Johnson County",2,37,199,134,65
050,17,087,"Illinois","Johnson County",2,38,171,112,59
050,17,087,"Illinois","Johnson County",2,39,185,120,65
050,17,087,"Illinois","Johnson County",2,40,181,120,61
050,17,087,"Illinois","Johnson County",2,41,172,114,58
050,17,087,"Illinois","Johnson County",2,42,176,116,60
050,17,087,"Illinois","Johnson County",2,43,187,117,70
050,17,087,"Illinois","Johnson County",2,44,163,102,61
050,17,087,"Illinois","Johnson County",2,45,150,98,52
050,17,087,"Illinois","Johnson County",2,46,155,100,55
050,17,087,"Illinois","Johnson County",2,47,187,128,59
050,17,087,"Illinois","Johnson County",2,48,169,115,54
050,17,087,"Illinois","Johnson County",2,49,184,127,57
050,17,087,"Illinois","Johnson County",2,50,174,112,62
050,17,087,"Illinois","Johnson County",2,51,178,108,70
050,17,087,"Illinois","Johnson County",2,52,170,101,69
050,17,087,"Illinois","Johnson County",2,53,168,91,77
050,17,087,"Illinois","Johnson County",2,54,177,101,76
050,17,087,"Illinois","Johnson County",2,55,173,93,80
050,17,087,"Illinois","Johnson County",2,56,186,100,86
050,17,087,"Illinois","Johnson County",2,57,178,98,80
050,17,087,"Illinois","Johnson County",2,58,173,91,82
050,17,087,"Illinois","Johnson County",2,59,193,108,85
050,17,087,"Illinois","Johnson County",2,60,185,93,92
050,17,087,"Illinois","Johnson County",2,61,190,97,93
050,17,087,"Illinois","Johnson County",2,62,185,95,90
050,17,087,"Illinois","Johnson County",2,63,165,82,83
050,17,087,"Illinois","Johnson County",2,64,164,77,87
050,17,087,"Illinois","Johnson County",2,65,159,78,81
050,17,087,"Illinois","Johnson County",2,66,144,73,71
050,17,087,"Illinois","Johnson County",2,67,150,77,73
050,17,087,"Illinois","Johnson County",2,68,149,78,71
050,17,087,"Illinois","Johnson County",2,69,155,83,72
050,17,087,"Illinois","Johnson County",2,70,143,77,66
050,17,087,"Illinois","Johnson County",2,71,151,78,73
050,17,087,"Illinois","Johnson County",2,72,158,75,83
050,17,087,"Illinois","Johnson County",2,73,157,81,76
050,17,087,"Illinois","Johnson County",2,74,105,53,52
050,17,087,"Illinois","Johnson County",2,75,106,50,56
050,17,087,"Illinois","Johnson County",2,76,98,51,47
050,17,087,"Illinois","Johnson County",2,77,118,54,64
050,17,087,"Illinois","Johnson County",2,78,105,51,54
050,17,087,"Illinois","Johnson County",2,79,92,45,47
050,17,087,"Illinois","Johnson County",2,80,76,40,36
050,17,087,"Illinois","Johnson County",2,81,74,40,34
050,17,087,"Illinois","Johnson County",2,82,76,41,35
050,17,087,"Illinois","Johnson County",2,83,61,33,28
050,17,087,"Illinois","Johnson County",2,84,46,25,21
050,17,087,"Illinois","Johnson County",2,85,273,108,165
050,17,087,"Illinois","Johnson County",3,0,103,62,41
050,17,087,"Illinois","Johnson County",3,1,104,55,49
050,17,087,"Illinois","Johnson County",3,2,116,59,57
050,17,087,"Illinois","Johnson County",3,3,108,56,52
050,17,087,"Illinois","Johnson County",3,4,103,47,56
050,17,087,"Illinois","Johnson County",3,5,117,55,62
050,17,087,"Illinois","Johnson County",3,6,136,68,68
050,17,087,"Illinois","Johnson County",3,7,137,69,68
050,17,087,"Illinois","Johnson County",3,8,122,61,61
050,17,087,"Illinois","Johnson County",3,9,114,52,62
050,17,087,"Illinois","Johnson County",3,10,124,65,59
050,17,087,"Illinois","Johnson County",3,11,124,67,57
050,17,087,"Illinois","Johnson County",3,12,135,74,61
050,17,087,"Illinois","Johnson County",3,13,139,71,68
050,17,087,"Illinois","Johnson County",3,14,132,63,69
050,17,087,"Illinois","Johnson County",3,15,129,66,63
050,17,087,"Illinois","Johnson County",3,16,134,64,70
050,17,087,"Illinois","Johnson County",3,17,139,67,72
050,17,087,"Illinois","Johnson County",3,18,168,115,53
050,17,087,"Illinois","Johnson County",3,19,168,121,47
050,17,087,"Illinois","Johnson County",3,20,185,138,47
050,17,087,"Illinois","Johnson County",3,21,179,137,42
050,17,087,"Illinois","Johnson County",3,22,195,155,40
050,17,087,"Illinois","Johnson County",3,23,170,125,45
050,17,087,"Illinois","Johnson County",3,24,176,135,41
050,17,087,"Illinois","Johnson County",3,25,172,118,54
050,17,087,"Illinois","Johnson County",3,26,195,141,54
050,17,087,"Illinois","Johnson County",3,27,191,136,55
050,17,087,"Illinois","Johnson County",3,28,222,165,57
050,17,087,"Illinois","Johnson County",3,29,224,167,57
050,17,087,"Illinois","Johnson County",3,30,213,152,61
050,17,087,"Illinois","Johnson County",3,31,214,158,56
050,17,087,"Illinois","Johnson County",3,32,223,160,63
050,17,087,"Illinois","Johnson County",3,33,185,131,54
050,17,087,"Illinois","Johnson County",3,34,186,131,55
050,17,087,"Illinois","Johnson County",3,35,165,104,61
050,17,087,"Illinois","Johnson County",3,36,175,109,66
050,17,087,"Illinois","Johnson County",3,37,213,146,67
050,17,087,"Illinois","Johnson County",3,38,181,121,60
050,17,087,"Illinois","Johnson County",3,39,181,125,56
050,17,087,"Illinois","Johnson County",3,40,208,143,65
050,17,087,"Illinois","Johnson County",3,41,183,124,59
050,17,087,"Illinois","Johnson County",3,42,178,124,54
050,17,087,"Illinois","Johnson County",3,43,177,115,62
050,17,087,"Illinois","Johnson County",3,44,176,111,65
050,17,087,"Illinois","Johnson County",3,45,162,105,57
050,17,087,"Illinois","Johnson County",3,46,160,110,50
050,17,087,"Illinois","Johnson County",3,47,185,133,52
050,17,087,"Illinois","Johnson County",3,48,174,110,64
050,17,087,"Illinois","Johnson County",3,49,190,136,54
050,17,087,"Illinois","Johnson County",3,50,176,124,52
050,17,087,"Illinois","Johnson County",3,51,176,114,62
050,17,087,"Illinois","Johnson County",3,52,170,104,66
050,17,087,"Illinois","Johnson County",3,53,163,96,67
050,17,087,"Illinois","Johnson County",3,54,185,108,77
050,17,087,"Illinois","Johnson County",3,55,167,91,76
050,17,087,"Illinois","Johnson County",3,56,184,99,85
050,17,087,"Illinois","Johnson County",3,57,190,106,84
050,17,087,"Illinois","Johnson County",3,58,167,90,77
050,17,087,"Illinois","Johnson County",3,59,179,99,80
050,17,087,"Illinois","Johnson County",3,60,179,95,84
050,17,087,"Illinois","Johnson County",3,61,185,95,90
050,17,087,"Illinois","Johnson County",3,62,194,95,99
050,17,087,"Illinois","Johnson County",3,63,189,97,92
050,17,087,"Illinois","Johnson County",3,64,164,84,80
050,17,087,"Illinois","Johnson County",3,65,168,78,90
050,17,087,"Illinois","Johnson County",3,66,158,79,79
050,17,087,"Illinois","Johnson County",3,67,142,72,70
050,17,087,"Illinois","Johnson County",3,68,145,72,73
050,17,087,"Illinois","Johnson County",3,69,144,73,71
050,17,087,"Illinois","Johnson County",3,70,144,77,67
050,17,087,"Illinois","Johnson County",3,71,140,75,65
050,17,087,"Illinois","Johnson County",3,72,140,72,68
050,17,087,"Illinois","Johnson County",3,73,152,74,78
050,17,087,"Illinois","Johnson County",3,74,155,78,77
050,17,087,"Illinois","Johnson County",3,75,97,48,49
050,17,087,"Illinois","Johnson County",3,76,101,49,52
050,17,087,"Illinois","Johnson County",3,77,93,44,49
050,17,087,"Illinois","Johnson County",3,78,109,54,55
050,17,087,"Illinois","Johnson County",3,79,101,45,56
050,17,087,"Illinois","Johnson County",3,80,86,44,42
050,17,087,"Illinois","Johnson County",3,81,70,35,35
050,17,087,"Illinois","Johnson County",3,82,74,41,33
050,17,087,"Illinois","Johnson County",3,83,72,40,32
050,17,087,"Illinois","Johnson County",3,84,54,32,22
050,17,087,"Illinois","Johnson County",3,85,269,107,162
050,17,087,"Illinois","Johnson County",4,0,110,63,47
050,17,087,"Illinois","Johnson County",4,1,110,67,43
050,17,087,"Illinois","Johnson County",4,2,101,47,54
050,17,087,"Illinois","Johnson County",4,3,118,60,58
050,17,087,"Illinois","Johnson County",4,4,110,54,56
050,17,087,"Illinois","Johnson County",4,5,101,49,52
050,17,087,"Illinois","Johnson County",4,6,119,58,61
050,17,087,"Illinois","Johnson County",4,7,139,68,71
050,17,087,"Illinois","Johnson County",4,8,141,70,71
050,17,087,"Illinois","Johnson County",4,9,122,64,58
050,17,087,"Illinois","Johnson County",4,10,122,59,63
050,17,087,"Illinois","Johnson County",4,11,125,63,62
050,17,087,"Illinois","Johnson County",4,12,133,73,60
050,17,087,"Illinois","Johnson County",4,13,136,74,62
050,17,087,"Illinois","Johnson County",4,14,146,72,74
050,17,087,"Illinois","Johnson County",4,15,134,64,70
050,17,087,"Illinois","Johnson County",4,16,137,69,68
050,17,087,"Illinois","Johnson County",4,17,139,70,69
050,17,087,"Illinois","Johnson County",4,18,157,103,54
050,17,087,"Illinois","Johnson County",4,19,163,119,44
050,17,087,"Illinois","Johnson County",4,20,185,135,50
050,17,087,"Illinois","Johnson County",4,21,183,135,48
050,17,087,"Illinois","Johnson County",4,22,223,164,59
050,17,087,"Illinois","Johnson County",4,23,162,113,49
050,17,087,"Illinois","Johnson County",4,24,176,127,49
050,17,087,"Illinois","Johnson County",4,25,168,125,43
050,17,087,"Illinois","Johnson County",4,26,185,130,55
050,17,087,"Illinois","Johnson County",4,27,188,129,59
050,17,087,"Illinois","Johnson County",4,28,209,150,59
050,17,087,"Illinois","Johnson County",4,29,222,163,59
050,17,087,"Illinois","Johnson County",4,30,188,133,55
050,17,087,"Illinois","Johnson County",4,31,200,138,62
050,17,087,"Illinois","Johnson County",4,32,222,163,59
050,17,087,"Illinois","Johnson County",4,33,189,126,63
050,17,087,"Illinois","Johnson County",4,34,176,122,54
050,17,087,"Illinois","Johnson County",4,35,157,103,54
050,17,087,"Illinois","Johnson County",4,36,175,107,68
050,17,087,"Illinois","Johnson County",4,37,199,133,66
050,17,087,"Illinois","Johnson County",4,38,195,126,69
050,17,087,"Illinois","Johnson County",4,39,193,129,64
050,17,087,"Illinois","Johnson County",4,40,181,123,58
050,17,087,"Illinois","Johnson County",4,41,193,124,69
050,17,087,"Illinois","Johnson County",4,42,182,117,65
050,17,087,"Illinois","Johnson County",4,43,164,111,53
050,17,087,"Illinois","Johnson County",4,44,166,96,70
050,17,087,"Illinois","Johnson County",4,45,179,111,68
050,17,087,"Illinois","Johnson County",4,46,170,112,58
050,17,087,"Illinois","Johnson County",4,47,182,134,48
050,17,087,"Illinois","Johnson County",4,48,169,114,55
050,17,087,"Illinois","Johnson County",4,49,180,118,62
050,17,087,"Illinois","Johnson County",4,50,176,118,58
050,17,087,"Illinois","Johnson County",4,51,167,111,56
050,17,087,"Illinois","Johnson County",4,52,168,109,59
050,17,087,"Illinois","Johnson County",4,53,169,104,65
050,17,087,"Illinois","Johnson County",4,54,163,97,66
050,17,087,"Illinois","Johnson County",4,55,178,95,83
050,17,087,"Illinois","Johnson County",4,56,172,97,75
050,17,087,"Illinois","Johnson County",4,57,181,95,86
050,17,087,"Illinois","Johnson County",4,58,172,87,85
050,17,087,"Illinois","Johnson County",4,59,171,95,76
050,17,087,"Illinois","Johnson County",4,60,165,85,80
050,17,087,"Illinois","Johnson County",4,61,176,91,85
050,17,087,"Illinois","Johnson County",4,62,180,93,87
050,17,087,"Illinois","Johnson County",4,63,194,96,98
050,17,087,"Illinois","Johnson County",4,64,192,94,98
050,17,087,"Illinois","Johnson County",4,65,167,88,79
050,17,087,"Illinois","Johnson County",4,66,165,72,93
050,17,087,"Illinois","Johnson County",4,67,156,79,77
050,17,087,"Illinois","Johnson County",4,68,136,67,69
050,17,087,"Illinois","Johnson County",4,69,136,63,73
050,17,087,"Illinois","Johnson County",4,70,140,71,69
050,17,087,"Illinois","Johnson County",4,71,137,76,61
050,17,087,"Illinois","Johnson County",4,72,134,69,65
050,17,087,"Illinois","Johnson County",4,73,133,69,64
050,17,087,"Illinois","Johnson County",4,74,149,74,75
050,17,087,"Illinois","Johnson County",4,75,149,75,74
050,17,087,"Illinois","Johnson County",4,76,96,47,49
050,17,087,"Illinois","Johnson County",4,77,98,45,53
050,17,087,"Illinois","Johnson County",4,78,84,42,42
050,17,087,"Illinois","Johnson County",4,79,97,46,51
050,17,087,"Illinois","Johnson County",4,80,93,42,51
050,17,087,"Illinois","Johnson County",4,81,80,42,38
050,17,087,"Illinois","Johnson County",4,82,71,35,36
050,17,087,"Illinois","Johnson County",4,83,68,36,32
050,17,087,"Illinois","Johnson County",4,84,63,36,27
050,17,087,"Illinois","Johnson County",4,85,291,120,171
050,17,087,"Illinois","Johnson County",5,0,99,56,43
050,17,087,"Illinois","Johnson County",5,1,110,60,50
050,17,087,"Illinois","Johnson County",5,2,111,66,45
050,17,087,"Illinois","Johnson County",5,3,100,48,52
050,17,087,"Illinois","Johnson County",5,4,115,57,58
050,17,087,"Illinois","Johnson County",5,5,107,54,53
050,17,087,"Illinois","Johnson County",5,6,109,54,55
050,17,087,"Illinois","Johnson County",5,7,119,60,59
050,17,087,"Illinois","Johnson County",5,8,142,69,73
050,17,087,"Illinois","Johnson County",5,9,136,65,71
050,17,087,"Illinois","Johnson County",5,10,127,66,61
050,17,087,"Illinois","Johnson County",5,11,126,65,61
050,17,087,"Illinois","Johnson County",5,12,128,63,65
050,17,087,"Illinois","Johnson County",5,13,126,69,57
050,17,087,"Illinois","Johnson County",5,14,132,72,60
050,17,087,"Illinois","Johnson County",5,15,144,74,70
050,17,087,"Illinois","Johnson County",5,16,138,68,70
050,17,087,"Illinois","Johnson County",5,17,136,70,66
050,17,087,"Illinois","Johnson County",5,18,161,106,55
050,17,087,"Illinois","Johnson County",5,19,155,111,44
050,17,087,"Illinois","Johnson County",5,20,184,133,51
050,17,087,"Illinois","Johnson County",5,21,188,135,53
050,17,087,"Illinois","Johnson County",5,22,225,165,60
050,17,087,"Illinois","Johnson County",5,23,180,124,56
050,17,087,"Illinois","Johnson County",5,24,168,118,50
050,17,087,"Illinois","Johnson County",5,25,167,119,48
050,17,087,"Illinois","Johnson County",5,26,185,142,43
050,17,087,"Illinois","Johnson County",5,27,174,123,51
050,17,087,"Illinois","Johnson County",5,28,211,151,60
050,17,087,"Illinois","Johnson County",5,29,211,157,54
050,17,087,"Illinois","Johnson County",5,30,192,136,56
050,17,087,"Illinois","Johnson County",5,31,185,127,58
050,17,087,"Illinois","Johnson County",5,32,207,151,56
050,17,087,"Illinois","Johnson County",5,33,190,132,58
050,17,087,"Illinois","Johnson County",5,34,189,125,64
050,17,087,"Illinois","Johnson County",5,35,154,103,51
050,17,087,"Illinois","Johnson County",5,36,166,108,58
050,17,087,"Illinois","Johnson County",5,37,191,128,63
050,17,087,"Illinois","Johnson County",5,38,181,118,63
050,17,087,"Illinois","Johnson County",5,39,198,126,72
050,17,087,"Illinois","Johnson County",5,40,199,132,67
050,17,087,"Illinois","Johnson County",5,41,180,124,56
050,17,087,"Illinois","Johnson County",5,42,203,133,70
050,17,087,"Illinois","Johnson County",5,43,180,112,68
050,17,087,"Illinois","Johnson County",5,44,157,102,55
050,17,087,"Illinois","Johnson County",5,45,168,97,71
050,17,087,"Illinois","Johnson County",5,46,190,122,68
050,17,087,"Illinois","Johnson County",5,47,188,130,58
050,17,087,"Illinois","Johnson County",5,48,160,112,48
050,17,087,"Illinois","Johnson County",5,49,182,123,59
050,17,087,"Illinois","Johnson County",5,50,166,103,63
050,17,087,"Illinois","Johnson County",5,51,178,117,61
050,17,087,"Illinois","Johnson County",5,52,160,100,60
050,17,087,"Illinois","Johnson County",5,53,166,104,62
050,17,087,"Illinois","Johnson County",5,54,174,110,64
050,17,087,"Illinois","Johnson County",5,55,149,85,64
050,17,087,"Illinois","Johnson County",5,56,187,99,88
050,17,087,"Illinois","Johnson County",5,57,163,89,74
050,17,087,"Illinois","Johnson County",5,58,173,87,86
050,17,087,"Illinois","Johnson County",5,59,174,93,81
050,17,087,"Illinois","Johnson County",5,60,157,81,76
050,17,087,"Illinois","Johnson County",5,61,166,83,83
050,17,087,"Illinois","Johnson County",5,62,172,87,85
050,17,087,"Illinois","Johnson County",5,63,181,91,90
050,17,087,"Illinois","Johnson County",5,64,202,100,102
050,17,087,"Illinois","Johnson County",5,65,191,98,93
050,17,087,"Illinois","Johnson County",5,66,156,83,73
050,17,087,"Illinois","Johnson County",5,67,160,69,91
050,17,087,"Illinois","Johnson County",5,68,154,78,76
050,17,087,"Illinois","Johnson County",5,69,128,62,66
050,17,087,"Illinois","Johnson County",5,70,126,59,67
050,17,087,"Illinois","Johnson County",5,71,131,66,65
050,17,087,"Illinois","Johnson County",5,72,130,69,61
050,17,087,"Illinois","Johnson County",5,73,133,69,64
050,17,087,"Illinois","Johnson County",5,74,133,70,63
050,17,087,"Illinois","Johnson County",5,75,137,69,68
050,17,087,"Illinois","Johnson County",5,76,148,73,75
050,17,087,"Illinois","Johnson County",5,77,92,42,50
050,17,087,"Illinois","Johnson County",5,78,89,42,47
050,17,087,"Illinois","Johnson County",5,79,81,36,45
050,17,087,"Illinois","Johnson County",5,80,85,41,44
050,17,087,"Illinois","Johnson County",5,81,88,40,48
050,17,087,"Illinois","Johnson County",5,82,77,41,36
050,17,087,"Illinois","Johnson County",5,83,65,31,34
050,17,087,"Illinois","Johnson County",5,84,58,32,26
050,17,087,"Illinois","Johnson County",5,85,322,135,187
050,17,089,"Illinois","Kane County",1,0,5915,3035,2880
050,17,089,"Illinois","Kane County",1,1,5953,3072,2881
050,17,089,"Illinois","Kane County",1,2,6263,3240,3023
050,17,089,"Illinois","Kane County",1,3,6469,3334,3135
050,17,089,"Illinois","Kane County",1,4,6626,3383,3243
050,17,089,"Illinois","Kane County",1,5,6689,3448,3241
050,17,089,"Illinois","Kane County",1,6,6731,3458,3273
050,17,089,"Illinois","Kane County",1,7,6801,3469,3332
050,17,089,"Illinois","Kane County",1,8,6747,3405,3342
050,17,089,"Illinois","Kane County",1,9,7065,3610,3455
050,17,089,"Illinois","Kane County",1,10,7383,3795,3588
050,17,089,"Illinois","Kane County",1,11,7677,3944,3733
050,17,089,"Illinois","Kane County",1,12,7997,4092,3905
050,17,089,"Illinois","Kane County",1,13,8039,4123,3916
050,17,089,"Illinois","Kane County",1,14,8079,4172,3907
050,17,089,"Illinois","Kane County",1,15,8230,4215,4015
050,17,089,"Illinois","Kane County",1,16,8439,4316,4123
050,17,089,"Illinois","Kane County",1,17,8072,4158,3914
050,17,089,"Illinois","Kane County",1,18,7252,3790,3462
050,17,089,"Illinois","Kane County",1,19,6451,3314,3137
050,17,089,"Illinois","Kane County",1,20,6586,3371,3215
050,17,089,"Illinois","Kane County",1,21,6503,3326,3177
050,17,089,"Illinois","Kane County",1,22,6571,3257,3314
050,17,089,"Illinois","Kane County",1,23,6401,3266,3135
050,17,089,"Illinois","Kane County",1,24,6253,3179,3074
050,17,089,"Illinois","Kane County",1,25,6022,3077,2945
050,17,089,"Illinois","Kane County",1,26,6036,3106,2930
050,17,089,"Illinois","Kane County",1,27,5973,3023,2950
050,17,089,"Illinois","Kane County",1,28,6168,3102,3066
050,17,089,"Illinois","Kane County",1,29,6156,3134,3022
050,17,089,"Illinois","Kane County",1,30,5924,3014,2910
050,17,089,"Illinois","Kane County",1,31,5937,3004,2933
050,17,089,"Illinois","Kane County",1,32,6065,3099,2966
050,17,089,"Illinois","Kane County",1,33,6166,3103,3063
050,17,089,"Illinois","Kane County",1,34,6408,3303,3105
050,17,089,"Illinois","Kane County",1,35,6580,3447,3133
050,17,089,"Illinois","Kane County",1,36,6568,3356,3212
050,17,089,"Illinois","Kane County",1,37,6879,3546,3333
050,17,089,"Illinois","Kane County",1,38,7014,3579,3435
050,17,089,"Illinois","Kane County",1,39,7128,3632,3496
050,17,089,"Illinois","Kane County",1,40,7072,3627,3445
050,17,089,"Illinois","Kane County",1,41,6768,3405,3363
050,17,089,"Illinois","Kane County",1,42,6919,3486,3433
050,17,089,"Illinois","Kane County",1,43,6952,3558,3394
050,17,089,"Illinois","Kane County",1,44,6788,3443,3345
050,17,089,"Illinois","Kane County",1,45,6822,3433,3389
050,17,089,"Illinois","Kane County",1,46,6691,3356,3335
050,17,089,"Illinois","Kane County",1,47,6892,3445,3447
050,17,089,"Illinois","Kane County",1,48,7269,3611,3658
050,17,089,"Illinois","Kane County",1,49,7743,3903,3840
050,17,089,"Illinois","Kane County",1,50,7524,3845,3679
050,17,089,"Illinois","Kane County",1,51,7163,3618,3545
050,17,089,"Illinois","Kane County",1,52,6896,3478,3418
050,17,089,"Illinois","Kane County",1,53,6863,3451,3412
050,17,089,"Illinois","Kane County",1,54,7007,3576,3431
050,17,089,"Illinois","Kane County",1,55,7198,3659,3539
050,17,089,"Illinois","Kane County",1,56,7131,3591,3540
050,17,089,"Illinois","Kane County",1,57,7252,3669,3583
050,17,089,"Illinois","Kane County",1,58,7095,3571,3524
050,17,089,"Illinois","Kane County",1,59,6910,3490,3420
050,17,089,"Illinois","Kane County",1,60,6734,3369,3365
050,17,089,"Illinois","Kane County",1,61,6564,3266,3298
050,17,089,"Illinois","Kane County",1,62,6300,3139,3161
050,17,089,"Illinois","Kane County",1,63,5891,2939,2952
050,17,089,"Illinois","Kane County",1,64,5663,2803,2860
050,17,089,"Illinois","Kane County",1,65,5655,2747,2908
050,17,089,"Illinois","Kane County",1,66,5239,2537,2702
050,17,089,"Illinois","Kane County",1,67,5123,2437,2686
050,17,089,"Illinois","Kane County",1,68,4900,2353,2547
050,17,089,"Illinois","Kane County",1,69,4571,2160,2411
050,17,089,"Illinois","Kane County",1,70,4378,2041,2337
050,17,089,"Illinois","Kane County",1,71,4250,1968,2282
050,17,089,"Illinois","Kane County",1,72,4172,1985,2187
050,17,089,"Illinois","Kane County",1,73,4127,1931,2196
050,17,089,"Illinois","Kane County",1,74,2920,1349,1571
050,17,089,"Illinois","Kane County",1,75,2868,1303,1565
050,17,089,"Illinois","Kane County",1,76,2895,1285,1610
050,17,089,"Illinois","Kane County",1,77,2833,1258,1575
050,17,089,"Illinois","Kane County",1,78,2449,1092,1357
050,17,089,"Illinois","Kane County",1,79,2065,913,1152
050,17,089,"Illinois","Kane County",1,80,1867,817,1050
050,17,089,"Illinois","Kane County",1,81,1784,773,1011
050,17,089,"Illinois","Kane County",1,82,1544,676,868
050,17,089,"Illinois","Kane County",1,83,1382,610,772
050,17,089,"Illinois","Kane County",1,84,1329,577,752
050,17,089,"Illinois","Kane County",1,85,7842,2763,5079
050,17,089,"Illinois","Kane County",2,0,5892,3036,2856
050,17,089,"Illinois","Kane County",2,1,5957,3072,2885
050,17,089,"Illinois","Kane County",2,2,6192,3201,2991
050,17,089,"Illinois","Kane County",2,3,6394,3292,3102
050,17,089,"Illinois","Kane County",2,4,6599,3371,3228
050,17,089,"Illinois","Kane County",2,5,6663,3424,3239
050,17,089,"Illinois","Kane County",2,6,6727,3454,3273
050,17,089,"Illinois","Kane County",2,7,6764,3451,3313
050,17,089,"Illinois","Kane County",2,8,6732,3411,3321
050,17,089,"Illinois","Kane County",2,9,6981,3561,3420
050,17,089,"Illinois","Kane County",2,10,7295,3748,3547
050,17,089,"Illinois","Kane County",2,11,7558,3893,3665
050,17,089,"Illinois","Kane County",2,12,7934,4064,3870
050,17,089,"Illinois","Kane County",2,13,8008,4103,3905
050,17,089,"Illinois","Kane County",2,14,8051,4146,3905
050,17,089,"Illinois","Kane County",2,15,8210,4212,3998
050,17,089,"Illinois","Kane County",2,16,8405,4304,4101
050,17,089,"Illinois","Kane County",2,17,8136,4186,3950
050,17,089,"Illinois","Kane County",2,18,7212,3762,3450
050,17,089,"Illinois","Kane County",2,19,6452,3322,3130
050,17,089,"Illinois","Kane County",2,20,6655,3401,3254
050,17,089,"Illinois","Kane County",2,21,6539,3337,3202
050,17,089,"Illinois","Kane County",2,22,6549,3276,3273
050,17,089,"Illinois","Kane County",2,23,6427,3260,3167
050,17,089,"Illinois","Kane County",2,24,6244,3178,3066
050,17,089,"Illinois","Kane County",2,25,6058,3100,2958
050,17,089,"Illinois","Kane County",2,26,6041,3110,2931
050,17,089,"Illinois","Kane County",2,27,6000,3051,2949
050,17,089,"Illinois","Kane County",2,28,6165,3103,3062
050,17,089,"Illinois","Kane County",2,29,6167,3131,3036
050,17,089,"Illinois","Kane County",2,30,6032,3066,2966
050,17,089,"Illinois","Kane County",2,31,5923,3007,2916
050,17,089,"Illinois","Kane County",2,32,6042,3078,2964
050,17,089,"Illinois","Kane County",2,33,6157,3109,3048
050,17,089,"Illinois","Kane County",2,34,6366,3262,3104
050,17,089,"Illinois","Kane County",2,35,6581,3435,3146
050,17,089,"Illinois","Kane County",2,36,6549,3362,3187
050,17,089,"Illinois","Kane County",2,37,6821,3514,3307
050,17,089,"Illinois","Kane County",2,38,7012,3588,3424
050,17,089,"Illinois","Kane County",2,39,7054,3590,3464
050,17,089,"Illinois","Kane County",2,40,7118,3646,3472
050,17,089,"Illinois","Kane County",2,41,6823,3449,3374
050,17,089,"Illinois","Kane County",2,42,6850,3455,3395
050,17,089,"Illinois","Kane County",2,43,6963,3552,3411
050,17,089,"Illinois","Kane County",2,44,6780,3451,3329
050,17,089,"Illinois","Kane County",2,45,6837,3450,3387
050,17,089,"Illinois","Kane County",2,46,6698,3366,3332
050,17,089,"Illinois","Kane County",2,47,6804,3397,3407
050,17,089,"Illinois","Kane County",2,48,7158,3554,3604
050,17,089,"Illinois","Kane County",2,49,7638,3834,3804
050,17,089,"Illinois","Kane County",2,50,7560,3854,3706
050,17,089,"Illinois","Kane County",2,51,7203,3654,3549
050,17,089,"Illinois","Kane County",2,52,6928,3494,3434
050,17,089,"Illinois","Kane County",2,53,6847,3443,3404
050,17,089,"Illinois","Kane County",2,54,6935,3532,3403
050,17,089,"Illinois","Kane County",2,55,7118,3617,3501
050,17,089,"Illinois","Kane County",2,56,7143,3608,3535
050,17,089,"Illinois","Kane County",2,57,7202,3635,3567
050,17,089,"Illinois","Kane County",2,58,7103,3573,3530
050,17,089,"Illinois","Kane County",2,59,6943,3502,3441
050,17,089,"Illinois","Kane County",2,60,6745,3378,3367
050,17,089,"Illinois","Kane County",2,61,6562,3267,3295
050,17,089,"Illinois","Kane County",2,62,6320,3142,3178
050,17,089,"Illinois","Kane County",2,63,6002,2995,3007
050,17,089,"Illinois","Kane County",2,64,5664,2800,2864
050,17,089,"Illinois","Kane County",2,65,5622,2739,2883
050,17,089,"Illinois","Kane County",2,66,5320,2570,2750
050,17,089,"Illinois","Kane County",2,67,5107,2435,2672
050,17,089,"Illinois","Kane County",2,68,4902,2350,2552
050,17,089,"Illinois","Kane County",2,69,4655,2201,2454
050,17,089,"Illinois","Kane County",2,70,4404,2060,2344
050,17,089,"Illinois","Kane County",2,71,4264,1972,2292
050,17,089,"Illinois","Kane County",2,72,4118,1941,2177
050,17,089,"Illinois","Kane County",2,73,4303,2020,2283
050,17,089,"Illinois","Kane County",2,74,3014,1397,1617
050,17,089,"Illinois","Kane County",2,75,2866,1307,1559
050,17,089,"Illinois","Kane County",2,76,2844,1270,1574
050,17,089,"Illinois","Kane County",2,77,2880,1277,1603
050,17,089,"Illinois","Kane County",2,78,2477,1097,1380
050,17,089,"Illinois","Kane County",2,79,2119,934,1185
050,17,089,"Illinois","Kane County",2,80,1892,830,1062
050,17,089,"Illinois","Kane County",2,81,1759,765,994
050,17,089,"Illinois","Kane County",2,82,1581,694,887
050,17,089,"Illinois","Kane County",2,83,1381,611,770
050,17,089,"Illinois","Kane County",2,84,1327,570,757
050,17,089,"Illinois","Kane County",2,85,7858,2796,5062
050,17,089,"Illinois","Kane County",3,0,5546,2914,2632
050,17,089,"Illinois","Kane County",3,1,5955,3070,2885
050,17,089,"Illinois","Kane County",3,2,6031,3114,2917
050,17,089,"Illinois","Kane County",3,3,6263,3226,3037
050,17,089,"Illinois","Kane County",3,4,6449,3315,3134
050,17,089,"Illinois","Kane County",3,5,6683,3440,3243
050,17,089,"Illinois","Kane County",3,6,6617,3399,3218
050,17,089,"Illinois","Kane County",3,7,6722,3436,3286
050,17,089,"Illinois","Kane County",3,8,6765,3449,3316
050,17,089,"Illinois","Kane County",3,9,6702,3394,3308
050,17,089,"Illinois","Kane County",3,10,6978,3541,3437
050,17,089,"Illinois","Kane County",3,11,7203,3706,3497
050,17,089,"Illinois","Kane County",3,12,7502,3858,3644
050,17,089,"Illinois","Kane County",3,13,7869,4027,3842
050,17,089,"Illinois","Kane County",3,14,8010,4105,3905
050,17,089,"Illinois","Kane County",3,15,8033,4144,3889
050,17,089,"Illinois","Kane County",3,16,8253,4271,3982
050,17,089,"Illinois","Kane County",3,17,8300,4241,4059
050,17,089,"Illinois","Kane County",3,18,7313,3776,3537
050,17,089,"Illinois","Kane County",3,19,6354,3272,3082
050,17,089,"Illinois","Kane County",3,20,6698,3398,3300
050,17,089,"Illinois","Kane County",3,21,6831,3473,3358
050,17,089,"Illinois","Kane County",3,22,6630,3378,3252
050,17,089,"Illinois","Kane County",3,23,6422,3261,3161
050,17,089,"Illinois","Kane County",3,24,6233,3174,3059
050,17,089,"Illinois","Kane County",3,25,6128,3172,2956
050,17,089,"Illinois","Kane County",3,26,6062,3122,2940
050,17,089,"Illinois","Kane County",3,27,6008,3109,2899
050,17,089,"Illinois","Kane County",3,28,6009,3018,2991
050,17,089,"Illinois","Kane County",3,29,6214,3133,3081
050,17,089,"Illinois","Kane County",3,30,6262,3166,3096
050,17,089,"Illinois","Kane County",3,31,6110,3090,3020
050,17,089,"Illinois","Kane County",3,32,6003,3032,2971
050,17,089,"Illinois","Kane County",3,33,6242,3208,3034
050,17,089,"Illinois","Kane County",3,34,6310,3193,3117
050,17,089,"Illinois","Kane County",3,35,6382,3270,3112
050,17,089,"Illinois","Kane County",3,36,6724,3542,3182
050,17,089,"Illinois","Kane County",3,37,6627,3413,3214
050,17,089,"Illinois","Kane County",3,38,6921,3536,3385
050,17,089,"Illinois","Kane County",3,39,6989,3570,3419
050,17,089,"Illinois","Kane County",3,40,7065,3605,3460
050,17,089,"Illinois","Kane County",3,41,7197,3702,3495
050,17,089,"Illinois","Kane County",3,42,6811,3439,3372
050,17,089,"Illinois","Kane County",3,43,6863,3456,3407
050,17,089,"Illinois","Kane County",3,44,6979,3540,3439
050,17,089,"Illinois","Kane County",3,45,6708,3398,3310
050,17,089,"Illinois","Kane County",3,46,6773,3421,3352
050,17,089,"Illinois","Kane County",3,47,6660,3361,3299
050,17,089,"Illinois","Kane County",3,48,6774,3374,3400
050,17,089,"Illinois","Kane County",3,49,7116,3533,3583
050,17,089,"Illinois","Kane County",3,50,7512,3799,3713
050,17,089,"Illinois","Kane County",3,51,7501,3812,3689
050,17,089,"Illinois","Kane County",3,52,7163,3652,3511
050,17,089,"Illinois","Kane County",3,53,6885,3481,3404
050,17,089,"Illinois","Kane County",3,54,6780,3412,3368
050,17,089,"Illinois","Kane County",3,55,6852,3465,3387
050,17,089,"Illinois","Kane County",3,56,6996,3576,3420
050,17,089,"Illinois","Kane County",3,57,7011,3517,3494
050,17,089,"Illinois","Kane County",3,58,7097,3556,3541
050,17,089,"Illinois","Kane County",3,59,6966,3517,3449
050,17,089,"Illinois","Kane County",3,60,6827,3403,3424
050,17,089,"Illinois","Kane County",3,61,6619,3317,3302
050,17,089,"Illinois","Kane County",3,62,6413,3200,3213
050,17,089,"Illinois","Kane County",3,63,6155,3059,3096
050,17,089,"Illinois","Kane County",3,64,5901,2941,2960
050,17,089,"Illinois","Kane County",3,65,5561,2742,2819
050,17,089,"Illinois","Kane County",3,66,5493,2651,2842
050,17,089,"Illinois","Kane County",3,67,5229,2510,2719
050,17,089,"Illinois","Kane County",3,68,5044,2404,2640
050,17,089,"Illinois","Kane County",3,69,4802,2288,2514
050,17,089,"Illinois","Kane County",3,70,4572,2146,2426
050,17,089,"Illinois","Kane County",3,71,4340,2014,2326
050,17,089,"Illinois","Kane County",3,72,4156,1922,2234
050,17,089,"Illinois","Kane County",3,73,4017,1891,2126
050,17,089,"Illinois","Kane County",3,74,4197,1974,2223
050,17,089,"Illinois","Kane County",3,75,2919,1347,1572
050,17,089,"Illinois","Kane County",3,76,2797,1263,1534
050,17,089,"Illinois","Kane County",3,77,2708,1195,1513
050,17,089,"Illinois","Kane County",3,78,2789,1214,1575
050,17,089,"Illinois","Kane County",3,79,2395,1051,1344
050,17,089,"Illinois","Kane County",3,80,2028,903,1125
050,17,089,"Illinois","Kane County",3,81,1779,770,1009
050,17,089,"Illinois","Kane County",3,82,1656,717,939
050,17,089,"Illinois","Kane County",3,83,1462,642,820
050,17,089,"Illinois","Kane County",3,84,1338,555,783
050,17,089,"Illinois","Kane County",3,85,8033,2858,5175
050,17,089,"Illinois","Kane County",4,0,5514,2863,2651
050,17,089,"Illinois","Kane County",4,1,5546,2927,2619
050,17,089,"Illinois","Kane County",4,2,5977,3051,2926
050,17,089,"Illinois","Kane County",4,3,6059,3128,2931
050,17,089,"Illinois","Kane County",4,4,6298,3236,3062
050,17,089,"Illinois","Kane County",4,5,6435,3303,3132
050,17,089,"Illinois","Kane County",4,6,6725,3444,3281
050,17,089,"Illinois","Kane County",4,7,6643,3417,3226
050,17,089,"Illinois","Kane County",4,8,6663,3427,3236
050,17,089,"Illinois","Kane County",4,9,6724,3450,3274
050,17,089,"Illinois","Kane County",4,10,6693,3405,3288
050,17,089,"Illinois","Kane County",4,11,6938,3535,3403
050,17,089,"Illinois","Kane County",4,12,7147,3686,3461
050,17,089,"Illinois","Kane County",4,13,7429,3819,3610
050,17,089,"Illinois","Kane County",4,14,7854,4024,3830
050,17,089,"Illinois","Kane County",4,15,7997,4122,3875
050,17,089,"Illinois","Kane County",4,16,8139,4211,3928
050,17,089,"Illinois","Kane County",4,17,8199,4226,3973
050,17,089,"Illinois","Kane County",4,18,7374,3788,3586
050,17,089,"Illinois","Kane County",4,19,6242,3200,3042
050,17,089,"Illinois","Kane County",4,20,6506,3317,3189
050,17,089,"Illinois","Kane County",4,21,6704,3398,3306
050,17,089,"Illinois","Kane County",4,22,6822,3423,3399
050,17,089,"Illinois","Kane County",4,23,6406,3338,3068
050,17,089,"Illinois","Kane County",4,24,6165,3121,3044
050,17,089,"Illinois","Kane County",4,25,6014,3081,2933
050,17,089,"Illinois","Kane County",4,26,5952,3072,2880
050,17,089,"Illinois","Kane County",4,27,6005,3096,2909
050,17,089,"Illinois","Kane County",4,28,6041,3120,2921
050,17,089,"Illinois","Kane County",4,29,6005,3017,2988
050,17,089,"Illinois","Kane County",4,30,6247,3148,3099
050,17,089,"Illinois","Kane County",4,31,6296,3162,3134
050,17,089,"Illinois","Kane County",4,32,6253,3151,3102
050,17,089,"Illinois","Kane County",4,33,6052,3068,2984
050,17,089,"Illinois","Kane County",4,34,6422,3288,3134
050,17,089,"Illinois","Kane County",4,35,6410,3261,3149
050,17,089,"Illinois","Kane County",4,36,6487,3346,3141
050,17,089,"Illinois","Kane County",4,37,6824,3642,3182
050,17,089,"Illinois","Kane County",4,38,6674,3440,3234
050,17,089,"Illinois","Kane County",4,39,6923,3534,3389
050,17,089,"Illinois","Kane County",4,40,6975,3605,3370
050,17,089,"Illinois","Kane County",4,41,7023,3605,3418
050,17,089,"Illinois","Kane County",4,42,7168,3673,3495
050,17,089,"Illinois","Kane County",4,43,6802,3417,3385
050,17,089,"Illinois","Kane County",4,44,6837,3460,3377
050,17,089,"Illinois","Kane County",4,45,6915,3527,3388
050,17,089,"Illinois","Kane County",4,46,6731,3408,3323
050,17,089,"Illinois","Kane County",4,47,6741,3399,3342
050,17,089,"Illinois","Kane County",4,48,6579,3319,3260
050,17,089,"Illinois","Kane County",4,49,6699,3348,3351
050,17,089,"Illinois","Kane County",4,50,6946,3467,3479
050,17,089,"Illinois","Kane County",4,51,7380,3730,3650
050,17,089,"Illinois","Kane County",4,52,7425,3766,3659
050,17,089,"Illinois","Kane County",4,53,7002,3558,3444
050,17,089,"Illinois","Kane County",4,54,6776,3431,3345
050,17,089,"Illinois","Kane County",4,55,6696,3357,3339
050,17,089,"Illinois","Kane County",4,56,6752,3432,3320
050,17,089,"Illinois","Kane County",4,57,6861,3460,3401
050,17,089,"Illinois","Kane County",4,58,6878,3451,3427
050,17,089,"Illinois","Kane County",4,59,6968,3499,3469
050,17,089,"Illinois","Kane County",4,60,6790,3428,3362
050,17,089,"Illinois","Kane County",4,61,6700,3343,3357
050,17,089,"Illinois","Kane County",4,62,6481,3251,3230
050,17,089,"Illinois","Kane County",4,63,6230,3091,3139
050,17,089,"Illinois","Kane County",4,64,6001,2993,3008
050,17,089,"Illinois","Kane County",4,65,5758,2866,2892
050,17,089,"Illinois","Kane County",4,66,5440,2666,2774
050,17,089,"Illinois","Kane County",4,67,5360,2572,2788
050,17,089,"Illinois","Kane County",4,68,5110,2437,2673
050,17,089,"Illinois","Kane County",4,69,4964,2349,2615
050,17,089,"Illinois","Kane County",4,70,4754,2260,2494
050,17,089,"Illinois","Kane County",4,71,4495,2078,2417
050,17,089,"Illinois","Kane County",4,72,4233,1945,2288
050,17,089,"Illinois","Kane County",4,73,4056,1874,2182
050,17,089,"Illinois","Kane County",4,74,3902,1827,2075
050,17,089,"Illinois","Kane County",4,75,4080,1904,2176
050,17,089,"Illinois","Kane County",4,76,2813,1272,1541
050,17,089,"Illinois","Kane County",4,77,2697,1218,1479
050,17,089,"Illinois","Kane County",4,78,2619,1149,1470
050,17,089,"Illinois","Kane County",4,79,2683,1155,1528
050,17,089,"Illinois","Kane County",4,80,2310,1024,1286
050,17,089,"Illinois","Kane County",4,81,1921,837,1084
050,17,089,"Illinois","Kane County",4,82,1673,711,962
050,17,089,"Illinois","Kane County",4,83,1533,663,870
050,17,089,"Illinois","Kane County",4,84,1402,592,810
050,17,089,"Illinois","Kane County",4,85,8176,2943,5233
050,17,089,"Illinois","Kane County",5,0,5504,2861,2643
050,17,089,"Illinois","Kane County",5,1,5678,2955,2723
050,17,089,"Illinois","Kane County",5,2,5627,2966,2661
050,17,089,"Illinois","Kane County",5,3,6036,3094,2942
050,17,089,"Illinois","Kane County",5,4,6094,3172,2922
050,17,089,"Illinois","Kane County",5,5,6310,3250,3060
050,17,089,"Illinois","Kane County",5,6,6471,3304,3167
050,17,089,"Illinois","Kane County",5,7,6694,3428,3266
050,17,089,"Illinois","Kane County",5,8,6644,3399,3245
050,17,089,"Illinois","Kane County",5,9,6699,3449,3250
050,17,089,"Illinois","Kane County",5,10,6731,3452,3279
050,17,089,"Illinois","Kane County",5,11,6656,3401,3255
050,17,089,"Illinois","Kane County",5,12,6873,3500,3373
050,17,089,"Illinois","Kane County",5,13,7111,3671,3440
050,17,089,"Illinois","Kane County",5,14,7452,3810,3642
050,17,089,"Illinois","Kane County",5,15,7902,4031,3871
050,17,089,"Illinois","Kane County",5,16,8043,4175,3868
050,17,089,"Illinois","Kane County",5,17,8000,4142,3858
050,17,089,"Illinois","Kane County",5,18,7297,3788,3509
050,17,089,"Illinois","Kane County",5,19,6443,3305,3138
050,17,089,"Illinois","Kane County",5,20,6555,3302,3253
050,17,089,"Illinois","Kane County",5,21,6656,3408,3248
050,17,089,"Illinois","Kane County",5,22,6841,3464,3377
050,17,089,"Illinois","Kane County",5,23,6712,3415,3297
050,17,089,"Illinois","Kane County",5,24,6189,3223,2966
050,17,089,"Illinois","Kane County",5,25,6102,3100,3002
050,17,089,"Illinois","Kane County",5,26,5980,3093,2887
050,17,089,"Illinois","Kane County",5,27,5950,3083,2867
050,17,089,"Illinois","Kane County",5,28,6013,3088,2925
050,17,089,"Illinois","Kane County",5,29,6143,3161,2982
050,17,089,"Illinois","Kane County",5,30,6096,3071,3025
050,17,089,"Illinois","Kane County",5,31,6380,3234,3146
050,17,089,"Illinois","Kane County",5,32,6475,3248,3227
050,17,089,"Illinois","Kane County",5,33,6437,3225,3212
050,17,089,"Illinois","Kane County",5,34,6251,3187,3064
050,17,089,"Illinois","Kane County",5,35,6505,3343,3162
050,17,089,"Illinois","Kane County",5,36,6522,3303,3219
050,17,089,"Illinois","Kane County",5,37,6573,3380,3193
050,17,089,"Illinois","Kane County",5,38,6873,3661,3212
050,17,089,"Illinois","Kane County",5,39,6727,3496,3231
050,17,089,"Illinois","Kane County",5,40,7010,3583,3427
050,17,089,"Illinois","Kane County",5,41,6943,3585,3358
050,17,089,"Illinois","Kane County",5,42,7067,3634,3433
050,17,089,"Illinois","Kane County",5,43,7164,3674,3490
050,17,089,"Illinois","Kane County",5,44,6766,3410,3356
050,17,089,"Illinois","Kane County",5,45,6808,3462,3346
050,17,089,"Illinois","Kane County",5,46,6864,3497,3367
050,17,089,"Illinois","Kane County",5,47,6707,3406,3301
050,17,089,"Illinois","Kane County",5,48,6687,3356,3331
050,17,089,"Illinois","Kane County",5,49,6504,3250,3254
050,17,089,"Illinois","Kane County",5,50,6631,3357,3274
050,17,089,"Illinois","Kane County",5,51,6824,3395,3429
050,17,089,"Illinois","Kane County",5,52,7293,3692,3601
050,17,089,"Illinois","Kane County",5,53,7343,3740,3603
050,17,089,"Illinois","Kane County",5,54,6917,3510,3407
050,17,089,"Illinois","Kane County",5,55,6668,3388,3280
050,17,089,"Illinois","Kane County",5,56,6609,3348,3261
050,17,089,"Illinois","Kane County",5,57,6675,3397,3278
050,17,089,"Illinois","Kane County",5,58,6756,3385,3371
050,17,089,"Illinois","Kane County",5,59,6796,3413,3383
050,17,089,"Illinois","Kane County",5,60,6822,3424,3398
050,17,089,"Illinois","Kane County",5,61,6641,3357,3284
050,17,089,"Illinois","Kane County",5,62,6620,3308,3312
050,17,089,"Illinois","Kane County",5,63,6384,3219,3165
050,17,089,"Illinois","Kane County",5,64,6096,3007,3089
050,17,089,"Illinois","Kane County",5,65,5912,2932,2980
050,17,089,"Illinois","Kane County",5,66,5651,2768,2883
050,17,089,"Illinois","Kane County",5,67,5343,2604,2739
050,17,089,"Illinois","Kane County",5,68,5284,2526,2758
050,17,089,"Illinois","Kane County",5,69,5070,2398,2672
050,17,089,"Illinois","Kane County",5,70,4899,2308,2591
050,17,089,"Illinois","Kane County",5,71,4694,2201,2493
050,17,089,"Illinois","Kane County",5,72,4402,2038,2364
050,17,089,"Illinois","Kane County",5,73,4166,1897,2269
050,17,089,"Illinois","Kane County",5,74,3991,1825,2166
050,17,089,"Illinois","Kane County",5,75,3821,1779,2042
050,17,089,"Illinois","Kane County",5,76,3975,1830,2145
050,17,089,"Illinois","Kane County",5,77,2717,1224,1493
050,17,089,"Illinois","Kane County",5,78,2633,1179,1454
050,17,089,"Illinois","Kane County",5,79,2532,1109,1423
050,17,089,"Illinois","Kane County",5,80,2601,1109,1492
050,17,089,"Illinois","Kane County",5,81,2198,956,1242
050,17,089,"Illinois","Kane County",5,82,1826,788,1038
050,17,089,"Illinois","Kane County",5,83,1544,657,887
050,17,089,"Illinois","Kane County",5,84,1463,612,851
050,17,089,"Illinois","Kane County",5,85,8420,3076,5344
050,17,091,"Illinois","Kankakee County",1,0,1209,608,601
050,17,091,"Illinois","Kankakee County",1,1,1217,601,616
050,17,091,"Illinois","Kankakee County",1,2,1289,644,645
050,17,091,"Illinois","Kankakee County",1,3,1353,686,667
050,17,091,"Illinois","Kankakee County",1,4,1331,711,620
050,17,091,"Illinois","Kankakee County",1,5,1324,695,629
050,17,091,"Illinois","Kankakee County",1,6,1299,673,626
050,17,091,"Illinois","Kankakee County",1,7,1254,632,622
050,17,091,"Illinois","Kankakee County",1,8,1298,662,636
050,17,091,"Illinois","Kankakee County",1,9,1294,680,614
050,17,091,"Illinois","Kankakee County",1,10,1397,716,681
050,17,091,"Illinois","Kankakee County",1,11,1471,731,740
050,17,091,"Illinois","Kankakee County",1,12,1548,763,785
050,17,091,"Illinois","Kankakee County",1,13,1589,810,779
050,17,091,"Illinois","Kankakee County",1,14,1549,810,739
050,17,091,"Illinois","Kankakee County",1,15,1537,791,746
050,17,091,"Illinois","Kankakee County",1,16,1553,812,741
050,17,091,"Illinois","Kankakee County",1,17,1564,793,771
050,17,091,"Illinois","Kankakee County",1,18,1591,787,804
050,17,091,"Illinois","Kankakee County",1,19,1599,802,797
050,17,091,"Illinois","Kankakee County",1,20,1531,768,763
050,17,091,"Illinois","Kankakee County",1,21,1577,781,796
050,17,091,"Illinois","Kankakee County",1,22,1500,750,750
050,17,091,"Illinois","Kankakee County",1,23,1299,673,626
050,17,091,"Illinois","Kankakee County",1,24,1285,653,632
050,17,091,"Illinois","Kankakee County",1,25,1313,682,631
050,17,091,"Illinois","Kankakee County",1,26,1362,705,657
050,17,091,"Illinois","Kankakee County",1,27,1372,681,691
050,17,091,"Illinois","Kankakee County",1,28,1441,727,714
050,17,091,"Illinois","Kankakee County",1,29,1433,726,707
050,17,091,"Illinois","Kankakee County",1,30,1315,656,659
050,17,091,"Illinois","Kankakee County",1,31,1248,605,643
050,17,091,"Illinois","Kankakee County",1,32,1270,640,630
050,17,091,"Illinois","Kankakee County",1,33,1190,608,582
050,17,091,"Illinois","Kankakee County",1,34,1264,613,651
050,17,091,"Illinois","Kankakee County",1,35,1279,629,650
050,17,091,"Illinois","Kankakee County",1,36,1295,659,636
050,17,091,"Illinois","Kankakee County",1,37,1300,657,643
050,17,091,"Illinois","Kankakee County",1,38,1271,625,646
050,17,091,"Illinois","Kankakee County",1,39,1385,701,684
050,17,091,"Illinois","Kankakee County",1,40,1405,686,719
050,17,091,"Illinois","Kankakee County",1,41,1264,615,649
050,17,091,"Illinois","Kankakee County",1,42,1301,649,652
050,17,091,"Illinois","Kankakee County",1,43,1271,638,633
050,17,091,"Illinois","Kankakee County",1,44,1213,592,621
050,17,091,"Illinois","Kankakee County",1,45,1238,621,617
050,17,091,"Illinois","Kankakee County",1,46,1242,618,624
050,17,091,"Illinois","Kankakee County",1,47,1294,639,655
050,17,091,"Illinois","Kankakee County",1,48,1327,672,655
050,17,091,"Illinois","Kankakee County",1,49,1411,743,668
050,17,091,"Illinois","Kankakee County",1,50,1362,685,677
050,17,091,"Illinois","Kankakee County",1,51,1324,662,662
050,17,091,"Illinois","Kankakee County",1,52,1394,692,702
050,17,091,"Illinois","Kankakee County",1,53,1349,661,688
050,17,091,"Illinois","Kankakee County",1,54,1296,637,659
050,17,091,"Illinois","Kankakee County",1,55,1365,680,685
050,17,091,"Illinois","Kankakee County",1,56,1497,739,758
050,17,091,"Illinois","Kankakee County",1,57,1488,753,735
050,17,091,"Illinois","Kankakee County",1,58,1509,770,739
050,17,091,"Illinois","Kankakee County",1,59,1509,743,766
050,17,091,"Illinois","Kankakee County",1,60,1495,733,762
050,17,091,"Illinois","Kankakee County",1,61,1398,696,702
050,17,091,"Illinois","Kankakee County",1,62,1412,704,708
050,17,091,"Illinois","Kankakee County",1,63,1370,674,696
050,17,091,"Illinois","Kankakee County",1,64,1325,653,672
050,17,091,"Illinois","Kankakee County",1,65,1286,660,626
050,17,091,"Illinois","Kankakee County",1,66,1275,621,654
050,17,091,"Illinois","Kankakee County",1,67,1213,600,613
050,17,091,"Illinois","Kankakee County",1,68,1202,594,608
050,17,091,"Illinois","Kankakee County",1,69,1093,514,579
050,17,091,"Illinois","Kankakee County",1,70,1019,473,546
050,17,091,"Illinois","Kankakee County",1,71,975,450,525
050,17,091,"Illinois","Kankakee County",1,72,965,442,523
050,17,091,"Illinois","Kankakee County",1,73,1011,460,551
050,17,091,"Illinois","Kankakee County",1,74,702,309,393
050,17,091,"Illinois","Kankakee County",1,75,697,340,357
050,17,091,"Illinois","Kankakee County",1,76,708,327,381
050,17,091,"Illinois","Kankakee County",1,77,690,313,377
050,17,091,"Illinois","Kankakee County",1,78,586,269,317
050,17,091,"Illinois","Kankakee County",1,79,536,237,299
050,17,091,"Illinois","Kankakee County",1,80,484,219,265
050,17,091,"Illinois","Kankakee County",1,81,438,186,252
050,17,091,"Illinois","Kankakee County",1,82,395,157,238
050,17,091,"Illinois","Kankakee County",1,83,391,169,222
050,17,091,"Illinois","Kankakee County",1,84,364,166,198
050,17,091,"Illinois","Kankakee County",1,85,2225,925,1300
050,17,091,"Illinois","Kankakee County",2,0,1184,585,599
050,17,091,"Illinois","Kankakee County",2,1,1217,604,613
050,17,091,"Illinois","Kankakee County",2,2,1280,639,641
050,17,091,"Illinois","Kankakee County",2,3,1330,672,658
050,17,091,"Illinois","Kankakee County",2,4,1337,704,633
050,17,091,"Illinois","Kankakee County",2,5,1323,696,627
050,17,091,"Illinois","Kankakee County",2,6,1299,673,626
050,17,091,"Illinois","Kankakee County",2,7,1262,640,622
050,17,091,"Illinois","Kankakee County",2,8,1282,653,629
050,17,091,"Illinois","Kankakee County",2,9,1288,672,616
050,17,091,"Illinois","Kankakee County",2,10,1366,703,663
050,17,091,"Illinois","Kankakee County",2,11,1442,719,723
050,17,091,"Illinois","Kankakee County",2,12,1534,755,779
050,17,091,"Illinois","Kankakee County",2,13,1577,799,778
050,17,091,"Illinois","Kankakee County",2,14,1561,812,749
050,17,091,"Illinois","Kankakee County",2,15,1547,799,748
050,17,091,"Illinois","Kankakee County",2,16,1550,811,739
050,17,091,"Illinois","Kankakee County",2,17,1563,797,766
050,17,091,"Illinois","Kankakee County",2,18,1579,783,796
050,17,091,"Illinois","Kankakee County",2,19,1599,797,802
050,17,091,"Illinois","Kankakee County",2,20,1548,774,774
050,17,091,"Illinois","Kankakee County",2,21,1573,780,793
050,17,091,"Illinois","Kankakee County",2,22,1497,752,745
050,17,091,"Illinois","Kankakee County",2,23,1306,670,636
050,17,091,"Illinois","Kankakee County",2,24,1281,657,624
050,17,091,"Illinois","Kankakee County",2,25,1309,678,631
050,17,091,"Illinois","Kankakee County",2,26,1348,699,649
050,17,091,"Illinois","Kankakee County",2,27,1366,688,678
050,17,091,"Illinois","Kankakee County",2,28,1419,711,708
050,17,091,"Illinois","Kankakee County",2,29,1430,720,710
050,17,091,"Illinois","Kankakee County",2,30,1348,674,674
050,17,091,"Illinois","Kankakee County",2,31,1266,622,644
050,17,091,"Illinois","Kankakee County",2,32,1256,628,628
050,17,091,"Illinois","Kankakee County",2,33,1205,614,591
050,17,091,"Illinois","Kankakee County",2,34,1247,614,633
050,17,091,"Illinois","Kankakee County",2,35,1286,631,655
050,17,091,"Illinois","Kankakee County",2,36,1281,648,633
050,17,091,"Illinois","Kankakee County",2,37,1300,657,643
050,17,091,"Illinois","Kankakee County",2,38,1277,635,642
050,17,091,"Illinois","Kankakee County",2,39,1351,680,671
050,17,091,"Illinois","Kankakee County",2,40,1410,695,715
050,17,091,"Illinois","Kankakee County",2,41,1291,626,665
050,17,091,"Illinois","Kankakee County",2,42,1288,642,646
050,17,091,"Illinois","Kankakee County",2,43,1286,648,638
050,17,091,"Illinois","Kankakee County",2,44,1214,597,617
050,17,091,"Illinois","Kankakee County",2,45,1236,614,622
050,17,091,"Illinois","Kankakee County",2,46,1240,618,622
050,17,091,"Illinois","Kankakee County",2,47,1268,626,642
050,17,091,"Illinois","Kankakee County",2,48,1316,663,653
050,17,091,"Illinois","Kankakee County",2,49,1395,725,670
050,17,091,"Illinois","Kankakee County",2,50,1372,699,673
050,17,091,"Illinois","Kankakee County",2,51,1328,665,663
050,17,091,"Illinois","Kankakee County",2,52,1368,679,689
050,17,091,"Illinois","Kankakee County",2,53,1356,667,689
050,17,091,"Illinois","Kankakee County",2,54,1302,641,661
050,17,091,"Illinois","Kankakee County",2,55,1344,669,675
050,17,091,"Illinois","Kankakee County",2,56,1468,726,742
050,17,091,"Illinois","Kankakee County",2,57,1484,745,739
050,17,091,"Illinois","Kankakee County",2,58,1493,757,736
050,17,091,"Illinois","Kankakee County",2,59,1508,748,760
050,17,091,"Illinois","Kankakee County",2,60,1487,733,754
050,17,091,"Illinois","Kankakee County",2,61,1410,699,711
050,17,091,"Illinois","Kankakee County",2,62,1403,699,704
050,17,091,"Illinois","Kankakee County",2,63,1378,682,696
050,17,091,"Illinois","Kankakee County",2,64,1316,649,667
050,17,091,"Illinois","Kankakee County",2,65,1288,653,635
050,17,091,"Illinois","Kankakee County",2,66,1273,625,648
050,17,091,"Illinois","Kankakee County",2,67,1214,600,614
050,17,091,"Illinois","Kankakee County",2,68,1183,585,598
050,17,091,"Illinois","Kankakee County",2,69,1120,532,588
050,17,091,"Illinois","Kankakee County",2,70,1031,483,548
050,17,091,"Illinois","Kankakee County",2,71,977,450,527
050,17,091,"Illinois","Kankakee County",2,72,945,434,511
050,17,091,"Illinois","Kankakee County",2,73,1041,474,567
050,17,091,"Illinois","Kankakee County",2,74,720,319,401
050,17,091,"Illinois","Kankakee County",2,75,691,328,363
050,17,091,"Illinois","Kankakee County",2,76,691,327,364
050,17,091,"Illinois","Kankakee County",2,77,706,322,384
050,17,091,"Illinois","Kankakee County",2,78,596,271,325
050,17,091,"Illinois","Kankakee County",2,79,536,236,300
050,17,091,"Illinois","Kankakee County",2,80,489,221,268
050,17,091,"Illinois","Kankakee County",2,81,438,188,250
050,17,091,"Illinois","Kankakee County",2,82,400,161,239
050,17,091,"Illinois","Kankakee County",2,83,383,165,218
050,17,091,"Illinois","Kankakee County",2,84,360,162,198
050,17,091,"Illinois","Kankakee County",2,85,2207,916,1291
050,17,091,"Illinois","Kankakee County",3,0,1095,564,531
050,17,091,"Illinois","Kankakee County",3,1,1204,602,602
050,17,091,"Illinois","Kankakee County",3,2,1239,634,605
050,17,091,"Illinois","Kankakee County",3,3,1268,640,628
050,17,091,"Illinois","Kankakee County",3,4,1329,678,651
050,17,091,"Illinois","Kankakee County",3,5,1360,702,658
050,17,091,"Illinois","Kankakee County",3,6,1317,693,624
050,17,091,"Illinois","Kankakee County",3,7,1326,689,637
050,17,091,"Illinois","Kankakee County",3,8,1260,639,621
050,17,091,"Illinois","Kankakee County",3,9,1279,652,627
050,17,091,"Illinois","Kankakee County",3,10,1278,661,617
050,17,091,"Illinois","Kankakee County",3,11,1387,706,681
050,17,091,"Illinois","Kankakee County",3,12,1438,719,719
050,17,091,"Illinois","Kankakee County",3,13,1551,760,791
050,17,091,"Illinois","Kankakee County",3,14,1567,808,759
050,17,091,"Illinois","Kankakee County",3,15,1539,800,739
050,17,091,"Illinois","Kankakee County",3,16,1524,790,734
050,17,091,"Illinois","Kankakee County",3,17,1552,800,752
050,17,091,"Illinois","Kankakee County",3,18,1572,795,777
050,17,091,"Illinois","Kankakee County",3,19,1580,773,807
050,17,091,"Illinois","Kankakee County",3,20,1584,783,801
050,17,091,"Illinois","Kankakee County",3,21,1585,794,791
050,17,091,"Illinois","Kankakee County",3,22,1499,768,731
050,17,091,"Illinois","Kankakee County",3,23,1313,668,645
050,17,091,"Illinois","Kankakee County",3,24,1310,668,642
050,17,091,"Illinois","Kankakee County",3,25,1255,640,615
050,17,091,"Illinois","Kankakee County",3,26,1306,670,636
050,17,091,"Illinois","Kankakee County",3,27,1350,692,658
050,17,091,"Illinois","Kankakee County",3,28,1366,676,690
050,17,091,"Illinois","Kankakee County",3,29,1397,686,711
050,17,091,"Illinois","Kankakee County",3,30,1427,707,720
050,17,091,"Illinois","Kankakee County",3,31,1339,677,662
050,17,091,"Illinois","Kankakee County",3,32,1258,625,633
050,17,091,"Illinois","Kankakee County",3,33,1273,638,635
050,17,091,"Illinois","Kankakee County",3,34,1213,621,592
050,17,091,"Illinois","Kankakee County",3,35,1265,626,639
050,17,091,"Illinois","Kankakee County",3,36,1290,635,655
050,17,091,"Illinois","Kankakee County",3,37,1298,654,644
050,17,091,"Illinois","Kankakee County",3,38,1285,654,631
050,17,091,"Illinois","Kankakee County",3,39,1251,625,626
050,17,091,"Illinois","Kankakee County",3,40,1343,678,665
050,17,091,"Illinois","Kankakee County",3,41,1364,654,710
050,17,091,"Illinois","Kankakee County",3,42,1271,625,646
050,17,091,"Illinois","Kankakee County",3,43,1284,653,631
050,17,091,"Illinois","Kankakee County",3,44,1276,624,652
050,17,091,"Illinois","Kankakee County",3,45,1195,588,607
050,17,091,"Illinois","Kankakee County",3,46,1245,621,624
050,17,091,"Illinois","Kankakee County",3,47,1228,608,620
050,17,091,"Illinois","Kankakee County",3,48,1253,615,638
050,17,091,"Illinois","Kankakee County",3,49,1314,665,649
050,17,091,"Illinois","Kankakee County",3,50,1376,716,660
050,17,091,"Illinois","Kankakee County",3,51,1351,687,664
050,17,091,"Illinois","Kankakee County",3,52,1301,655,646
050,17,091,"Illinois","Kankakee County",3,53,1362,687,675
050,17,091,"Illinois","Kankakee County",3,54,1346,664,682
050,17,091,"Illinois","Kankakee County",3,55,1280,627,653
050,17,091,"Illinois","Kankakee County",3,56,1345,670,675
050,17,091,"Illinois","Kankakee County",3,57,1434,701,733
050,17,091,"Illinois","Kankakee County",3,58,1467,730,737
050,17,091,"Illinois","Kankakee County",3,59,1476,745,731
050,17,091,"Illinois","Kankakee County",3,60,1466,717,749
050,17,091,"Illinois","Kankakee County",3,61,1460,717,743
050,17,091,"Illinois","Kankakee County",3,62,1386,684,702
050,17,091,"Illinois","Kankakee County",3,63,1361,686,675
050,17,091,"Illinois","Kankakee County",3,64,1329,655,674
050,17,091,"Illinois","Kankakee County",3,65,1268,617,651
050,17,091,"Illinois","Kankakee County",3,66,1245,619,626
050,17,091,"Illinois","Kankakee County",3,67,1242,603,639
050,17,091,"Illinois","Kankakee County",3,68,1184,589,595
050,17,091,"Illinois","Kankakee County",3,69,1152,564,588
050,17,091,"Illinois","Kankakee County",3,70,1094,514,580
050,17,091,"Illinois","Kankakee County",3,71,979,449,530
050,17,091,"Illinois","Kankakee County",3,72,960,441,519
050,17,091,"Illinois","Kankakee County",3,73,902,406,496
050,17,091,"Illinois","Kankakee County",3,74,1004,454,550
050,17,091,"Illinois","Kankakee County",3,75,679,290,389
050,17,091,"Illinois","Kankakee County",3,76,663,319,344
050,17,091,"Illinois","Kankakee County",3,77,658,311,347
050,17,091,"Illinois","Kankakee County",3,78,692,312,380
050,17,091,"Illinois","Kankakee County",3,79,543,243,300
050,17,091,"Illinois","Kankakee County",3,80,504,223,281
050,17,091,"Illinois","Kankakee County",3,81,472,216,256
050,17,091,"Illinois","Kankakee County",3,82,402,166,236
050,17,091,"Illinois","Kankakee County",3,83,380,156,224
050,17,091,"Illinois","Kankakee County",3,84,342,141,201
050,17,091,"Illinois","Kankakee County",3,85,2198,932,1266
050,17,091,"Illinois","Kankakee County",4,0,1137,577,560
050,17,091,"Illinois","Kankakee County",4,1,1085,557,528
050,17,091,"Illinois","Kankakee County",4,2,1206,606,600
050,17,091,"Illinois","Kankakee County",4,3,1254,636,618
050,17,091,"Illinois","Kankakee County",4,4,1264,628,636
050,17,091,"Illinois","Kankakee County",4,5,1337,684,653
050,17,091,"Illinois","Kankakee County",4,6,1346,698,648
050,17,091,"Illinois","Kankakee County",4,7,1313,691,622
050,17,091,"Illinois","Kankakee County",4,8,1330,681,649
050,17,091,"Illinois","Kankakee County",4,9,1285,663,622
050,17,091,"Illinois","Kankakee County",4,10,1291,665,626
050,17,091,"Illinois","Kankakee County",4,11,1284,657,627
050,17,091,"Illinois","Kankakee County",4,12,1371,701,670
050,17,091,"Illinois","Kankakee County",4,13,1450,725,725
050,17,091,"Illinois","Kankakee County",4,14,1550,770,780
050,17,091,"Illinois","Kankakee County",4,15,1596,809,787
050,17,091,"Illinois","Kankakee County",4,16,1529,793,736
050,17,091,"Illinois","Kankakee County",4,17,1540,781,759
050,17,091,"Illinois","Kankakee County",4,18,1541,782,759
050,17,091,"Illinois","Kankakee County",4,19,1549,777,772
050,17,091,"Illinois","Kankakee County",4,20,1531,745,786
050,17,091,"Illinois","Kankakee County",4,21,1608,797,811
050,17,091,"Illinois","Kankakee County",4,22,1521,781,740
050,17,091,"Illinois","Kankakee County",4,23,1307,658,649
050,17,091,"Illinois","Kankakee County",4,24,1290,664,626
050,17,091,"Illinois","Kankakee County",4,25,1289,664,625
050,17,091,"Illinois","Kankakee County",4,26,1253,630,623
050,17,091,"Illinois","Kankakee County",4,27,1281,664,617
050,17,091,"Illinois","Kankakee County",4,28,1380,690,690
050,17,091,"Illinois","Kankakee County",4,29,1343,658,685
050,17,091,"Illinois","Kankakee County",4,30,1397,691,706
050,17,091,"Illinois","Kankakee County",4,31,1415,712,703
050,17,091,"Illinois","Kankakee County",4,32,1364,681,683
050,17,091,"Illinois","Kankakee County",4,33,1243,605,638
050,17,091,"Illinois","Kankakee County",4,34,1274,642,632
050,17,091,"Illinois","Kankakee County",4,35,1220,620,600
050,17,091,"Illinois","Kankakee County",4,36,1238,608,630
050,17,091,"Illinois","Kankakee County",4,37,1295,636,659
050,17,091,"Illinois","Kankakee County",4,38,1299,655,644
050,17,091,"Illinois","Kankakee County",4,39,1285,663,622
050,17,091,"Illinois","Kankakee County",4,40,1272,643,629
050,17,091,"Illinois","Kankakee County",4,41,1333,659,674
050,17,091,"Illinois","Kankakee County",4,42,1385,677,708
050,17,091,"Illinois","Kankakee County",4,43,1311,658,653
050,17,091,"Illinois","Kankakee County",4,44,1259,634,625
050,17,091,"Illinois","Kankakee County",4,45,1249,606,643
050,17,091,"Illinois","Kankakee County",4,46,1210,597,613
050,17,091,"Illinois","Kankakee County",4,47,1229,608,621
050,17,091,"Illinois","Kankakee County",4,48,1206,600,606
050,17,091,"Illinois","Kankakee County",4,49,1240,610,630
050,17,091,"Illinois","Kankakee County",4,50,1288,671,617
050,17,091,"Illinois","Kankakee County",4,51,1375,708,667
050,17,091,"Illinois","Kankakee County",4,52,1320,667,653
050,17,091,"Illinois","Kankakee County",4,53,1283,643,640
050,17,091,"Illinois","Kankakee County",4,54,1347,679,668
050,17,091,"Illinois","Kankakee County",4,55,1314,640,674
050,17,091,"Illinois","Kankakee County",4,56,1283,630,653
050,17,091,"Illinois","Kankakee County",4,57,1311,642,669
050,17,091,"Illinois","Kankakee County",4,58,1429,699,730
050,17,091,"Illinois","Kankakee County",4,59,1423,704,719
050,17,091,"Illinois","Kankakee County",4,60,1435,730,705
050,17,091,"Illinois","Kankakee County",4,61,1436,686,750
050,17,091,"Illinois","Kankakee County",4,62,1432,693,739
050,17,091,"Illinois","Kankakee County",4,63,1349,656,693
050,17,091,"Illinois","Kankakee County",4,64,1328,670,658
050,17,091,"Illinois","Kankakee County",4,65,1282,624,658
050,17,091,"Illinois","Kankakee County",4,66,1233,590,643
050,17,091,"Illinois","Kankakee County",4,67,1204,591,613
050,17,091,"Illinois","Kankakee County",4,68,1221,592,629
050,17,091,"Illinois","Kankakee County",4,69,1145,567,578
050,17,091,"Illinois","Kankakee County",4,70,1138,554,584
050,17,091,"Illinois","Kankakee County",4,71,1061,487,574
050,17,091,"Illinois","Kankakee County",4,72,968,444,524
050,17,091,"Illinois","Kankakee County",4,73,920,421,499
050,17,091,"Illinois","Kankakee County",4,74,870,392,478
050,17,091,"Illinois","Kankakee County",4,75,968,432,536
050,17,091,"Illinois","Kankakee County",4,76,654,289,365
050,17,091,"Illinois","Kankakee County",4,77,632,300,332
050,17,091,"Illinois","Kankakee County",4,78,635,299,336
050,17,091,"Illinois","Kankakee County",4,79,647,290,357
050,17,091,"Illinois","Kankakee County",4,80,498,219,279
050,17,091,"Illinois","Kankakee County",4,81,474,213,261
050,17,091,"Illinois","Kankakee County",4,82,431,197,234
050,17,091,"Illinois","Kankakee County",4,83,383,167,216
050,17,091,"Illinois","Kankakee County",4,84,335,141,194
050,17,091,"Illinois","Kankakee County",4,85,2161,920,1241
050,17,091,"Illinois","Kankakee County",5,0,1127,572,555
050,17,091,"Illinois","Kankakee County",5,1,1194,626,568
050,17,091,"Illinois","Kankakee County",5,2,1117,571,546
050,17,091,"Illinois","Kankakee County",5,3,1217,601,616
050,17,091,"Illinois","Kankakee County",5,4,1258,636,622
050,17,091,"Illinois","Kankakee County",5,5,1263,616,647
050,17,091,"Illinois","Kankakee County",5,6,1344,693,651
050,17,091,"Illinois","Kankakee County",5,7,1351,696,655
050,17,091,"Illinois","Kankakee County",5,8,1315,704,611
050,17,091,"Illinois","Kankakee County",5,9,1320,677,643
050,17,091,"Illinois","Kankakee County",5,10,1289,666,623
050,17,091,"Illinois","Kankakee County",5,11,1285,667,618
050,17,091,"Illinois","Kankakee County",5,12,1272,651,621
050,17,091,"Illinois","Kankakee County",5,13,1376,698,678
050,17,091,"Illinois","Kankakee County",5,14,1444,734,710
050,17,091,"Illinois","Kankakee County",5,15,1568,771,797
050,17,091,"Illinois","Kankakee County",5,16,1609,804,805
050,17,091,"Illinois","Kankakee County",5,17,1537,782,755
050,17,091,"Illinois","Kankakee County",5,18,1531,764,767
050,17,091,"Illinois","Kankakee County",5,19,1533,776,757
050,17,091,"Illinois","Kankakee County",5,20,1532,760,772
050,17,091,"Illinois","Kankakee County",5,21,1614,815,799
050,17,091,"Illinois","Kankakee County",5,22,1526,770,756
050,17,091,"Illinois","Kankakee County",5,23,1363,704,659
050,17,091,"Illinois","Kankakee County",5,24,1327,673,654
050,17,091,"Illinois","Kankakee County",5,25,1301,675,626
050,17,091,"Illinois","Kankakee County",5,26,1265,662,603
050,17,091,"Illinois","Kankakee County",5,27,1263,642,621
050,17,091,"Illinois","Kankakee County",5,28,1284,670,614
050,17,091,"Illinois","Kankakee County",5,29,1378,683,695
050,17,091,"Illinois","Kankakee County",5,30,1359,661,698
050,17,091,"Illinois","Kankakee County",5,31,1395,692,703
050,17,091,"Illinois","Kankakee County",5,32,1415,719,696
050,17,091,"Illinois","Kankakee County",5,33,1374,695,679
050,17,091,"Illinois","Kankakee County",5,34,1212,581,631
050,17,091,"Illinois","Kankakee County",5,35,1282,643,639
050,17,091,"Illinois","Kankakee County",5,36,1222,626,596
050,17,091,"Illinois","Kankakee County",5,37,1260,620,640
050,17,091,"Illinois","Kankakee County",5,38,1298,639,659
050,17,091,"Illinois","Kankakee County",5,39,1296,646,650
050,17,091,"Illinois","Kankakee County",5,40,1301,675,626
050,17,091,"Illinois","Kankakee County",5,41,1251,610,641
050,17,091,"Illinois","Kankakee County",5,42,1352,672,680
050,17,091,"Illinois","Kankakee County",5,43,1396,685,711
050,17,091,"Illinois","Kankakee County",5,44,1310,657,653
050,17,091,"Illinois","Kankakee County",5,45,1246,628,618
050,17,091,"Illinois","Kankakee County",5,46,1250,605,645
050,17,091,"Illinois","Kankakee County",5,47,1191,587,604
050,17,091,"Illinois","Kankakee County",5,48,1222,607,615
050,17,091,"Illinois","Kankakee County",5,49,1203,593,610
050,17,091,"Illinois","Kankakee County",5,50,1223,608,615
050,17,091,"Illinois","Kankakee County",5,51,1302,674,628
050,17,091,"Illinois","Kankakee County",5,52,1341,696,645
050,17,091,"Illinois","Kankakee County",5,53,1326,669,657
050,17,091,"Illinois","Kankakee County",5,54,1251,632,619
050,17,091,"Illinois","Kankakee County",5,55,1306,647,659
050,17,091,"Illinois","Kankakee County",5,56,1305,640,665
050,17,091,"Illinois","Kankakee County",5,57,1259,611,648
050,17,091,"Illinois","Kankakee County",5,58,1308,632,676
050,17,091,"Illinois","Kankakee County",5,59,1411,688,723
050,17,091,"Illinois","Kankakee County",5,60,1393,693,700
050,17,091,"Illinois","Kankakee County",5,61,1396,699,697
050,17,091,"Illinois","Kankakee County",5,62,1411,672,739
050,17,091,"Illinois","Kankakee County",5,63,1411,685,726
050,17,091,"Illinois","Kankakee County",5,64,1321,634,687
050,17,091,"Illinois","Kankakee County",5,65,1307,652,655
050,17,091,"Illinois","Kankakee County",5,66,1261,598,663
050,17,091,"Illinois","Kankakee County",5,67,1195,562,633
050,17,091,"Illinois","Kankakee County",5,68,1185,582,603
050,17,091,"Illinois","Kankakee County",5,69,1185,569,616
050,17,091,"Illinois","Kankakee County",5,70,1118,558,560
050,17,091,"Illinois","Kankakee County",5,71,1112,527,585
050,17,091,"Illinois","Kankakee County",5,72,1054,483,571
050,17,091,"Illinois","Kankakee County",5,73,945,431,514
050,17,091,"Illinois","Kankakee County",5,74,886,397,489
050,17,091,"Illinois","Kankakee County",5,75,842,379,463
050,17,091,"Illinois","Kankakee County",5,76,938,425,513
050,17,091,"Illinois","Kankakee County",5,77,626,272,354
050,17,091,"Illinois","Kankakee County",5,78,618,286,332
050,17,091,"Illinois","Kankakee County",5,79,594,280,314
050,17,091,"Illinois","Kankakee County",5,80,612,275,337
050,17,091,"Illinois","Kankakee County",5,81,472,209,263
050,17,091,"Illinois","Kankakee County",5,82,439,198,241
050,17,091,"Illinois","Kankakee County",5,83,412,200,212
050,17,091,"Illinois","Kankakee County",5,84,336,148,188
050,17,091,"Illinois","Kankakee County",5,85,2201,946,1255
050,17,093,"Illinois","Kendall County",1,0,1464,747,717
050,17,093,"Illinois","Kendall County",1,1,1558,769,789
050,17,093,"Illinois","Kendall County",1,2,1628,830,798
050,17,093,"Illinois","Kendall County",1,3,1760,888,872
050,17,093,"Illinois","Kendall County",1,4,1844,946,898
050,17,093,"Illinois","Kendall County",1,5,1909,1022,887
050,17,093,"Illinois","Kendall County",1,6,1974,1025,949
050,17,093,"Illinois","Kendall County",1,7,2040,1046,994
050,17,093,"Illinois","Kendall County",1,8,2136,1070,1066
050,17,093,"Illinois","Kendall County",1,9,2153,1094,1059
050,17,093,"Illinois","Kendall County",1,10,2224,1153,1071
050,17,093,"Illinois","Kendall County",1,11,2309,1172,1137
050,17,093,"Illinois","Kendall County",1,12,2381,1212,1169
050,17,093,"Illinois","Kendall County",1,13,2398,1228,1170
050,17,093,"Illinois","Kendall County",1,14,2337,1187,1150
050,17,093,"Illinois","Kendall County",1,15,2349,1226,1123
050,17,093,"Illinois","Kendall County",1,16,2367,1223,1144
050,17,093,"Illinois","Kendall County",1,17,2254,1162,1092
050,17,093,"Illinois","Kendall County",1,18,1886,999,887
050,17,093,"Illinois","Kendall County",1,19,1560,819,741
050,17,093,"Illinois","Kendall County",1,20,1573,803,770
050,17,093,"Illinois","Kendall County",1,21,1515,778,737
050,17,093,"Illinois","Kendall County",1,22,1480,734,746
050,17,093,"Illinois","Kendall County",1,23,1496,773,723
050,17,093,"Illinois","Kendall County",1,24,1392,713,679
050,17,093,"Illinois","Kendall County",1,25,1350,712,638
050,17,093,"Illinois","Kendall County",1,26,1364,684,680
050,17,093,"Illinois","Kendall County",1,27,1381,669,712
050,17,093,"Illinois","Kendall County",1,28,1490,721,769
050,17,093,"Illinois","Kendall County",1,29,1529,766,763
050,17,093,"Illinois","Kendall County",1,30,1551,735,816
050,17,093,"Illinois","Kendall County",1,31,1651,813,838
050,17,093,"Illinois","Kendall County",1,32,1754,880,874
050,17,093,"Illinois","Kendall County",1,33,1871,933,938
050,17,093,"Illinois","Kendall County",1,34,2001,984,1017
050,17,093,"Illinois","Kendall County",1,35,2012,1003,1009
050,17,093,"Illinois","Kendall County",1,36,2119,1044,1075
050,17,093,"Illinois","Kendall County",1,37,2175,1092,1083
050,17,093,"Illinois","Kendall County",1,38,2184,1091,1093
050,17,093,"Illinois","Kendall County",1,39,2231,1110,1121
050,17,093,"Illinois","Kendall County",1,40,2223,1112,1111
050,17,093,"Illinois","Kendall County",1,41,2136,1019,1117
050,17,093,"Illinois","Kendall County",1,42,2102,1028,1074
050,17,093,"Illinois","Kendall County",1,43,2048,999,1049
050,17,093,"Illinois","Kendall County",1,44,2030,1006,1024
050,17,093,"Illinois","Kendall County",1,45,2003,994,1009
050,17,093,"Illinois","Kendall County",1,46,2022,1040,982
050,17,093,"Illinois","Kendall County",1,47,2021,1016,1005
050,17,093,"Illinois","Kendall County",1,48,2038,1036,1002
050,17,093,"Illinois","Kendall County",1,49,2116,1073,1043
050,17,093,"Illinois","Kendall County",1,50,2021,1052,969
050,17,093,"Illinois","Kendall County",1,51,1889,973,916
050,17,093,"Illinois","Kendall County",1,52,1750,898,852
050,17,093,"Illinois","Kendall County",1,53,1615,848,767
050,17,093,"Illinois","Kendall County",1,54,1590,841,749
050,17,093,"Illinois","Kendall County",1,55,1566,814,752
050,17,093,"Illinois","Kendall County",1,56,1471,720,751
050,17,093,"Illinois","Kendall County",1,57,1522,784,738
050,17,093,"Illinois","Kendall County",1,58,1463,763,700
050,17,093,"Illinois","Kendall County",1,59,1422,724,698
050,17,093,"Illinois","Kendall County",1,60,1339,667,672
050,17,093,"Illinois","Kendall County",1,61,1254,602,652
050,17,093,"Illinois","Kendall County",1,62,1235,589,646
050,17,093,"Illinois","Kendall County",1,63,1129,549,580
050,17,093,"Illinois","Kendall County",1,64,1122,545,577
050,17,093,"Illinois","Kendall County",1,65,1134,521,613
050,17,093,"Illinois","Kendall County",1,66,1035,473,562
050,17,093,"Illinois","Kendall County",1,67,990,466,524
050,17,093,"Illinois","Kendall County",1,68,967,453,514
050,17,093,"Illinois","Kendall County",1,69,912,426,486
050,17,093,"Illinois","Kendall County",1,70,847,377,470
050,17,093,"Illinois","Kendall County",1,71,814,351,463
050,17,093,"Illinois","Kendall County",1,72,827,382,445
050,17,093,"Illinois","Kendall County",1,73,828,379,449
050,17,093,"Illinois","Kendall County",1,74,564,252,312
050,17,093,"Illinois","Kendall County",1,75,539,249,290
050,17,093,"Illinois","Kendall County",1,76,566,254,312
050,17,093,"Illinois","Kendall County",1,77,549,252,297
050,17,093,"Illinois","Kendall County",1,78,454,207,247
050,17,093,"Illinois","Kendall County",1,79,393,176,217
050,17,093,"Illinois","Kendall County",1,80,335,139,196
050,17,093,"Illinois","Kendall County",1,81,306,125,181
050,17,093,"Illinois","Kendall County",1,82,270,122,148
050,17,093,"Illinois","Kendall County",1,83,231,98,133
050,17,093,"Illinois","Kendall County",1,84,208,83,125
050,17,093,"Illinois","Kendall County",1,85,1322,464,858
050,17,093,"Illinois","Kendall County",2,0,1494,747,747
050,17,093,"Illinois","Kendall County",2,1,1549,767,782
050,17,093,"Illinois","Kendall County",2,2,1632,825,807
050,17,093,"Illinois","Kendall County",2,3,1732,875,857
050,17,093,"Illinois","Kendall County",2,4,1837,940,897
050,17,093,"Illinois","Kendall County",2,5,1906,1011,895
050,17,093,"Illinois","Kendall County",2,6,1971,1032,939
050,17,093,"Illinois","Kendall County",2,7,2034,1044,990
050,17,093,"Illinois","Kendall County",2,8,2115,1063,1052
050,17,093,"Illinois","Kendall County",2,9,2157,1091,1066
050,17,093,"Illinois","Kendall County",2,10,2210,1138,1072
050,17,093,"Illinois","Kendall County",2,11,2289,1167,1122
050,17,093,"Illinois","Kendall County",2,12,2387,1213,1174
050,17,093,"Illinois","Kendall County",2,13,2397,1224,1173
050,17,093,"Illinois","Kendall County",2,14,2354,1200,1154
050,17,093,"Illinois","Kendall County",2,15,2351,1221,1130
050,17,093,"Illinois","Kendall County",2,16,2372,1231,1141
050,17,093,"Illinois","Kendall County",2,17,2282,1179,1103
050,17,093,"Illinois","Kendall County",2,18,1895,1002,893
050,17,093,"Illinois","Kendall County",2,19,1578,831,747
050,17,093,"Illinois","Kendall County",2,20,1599,820,779
050,17,093,"Illinois","Kendall County",2,21,1527,781,746
050,17,093,"Illinois","Kendall County",2,22,1495,746,749
050,17,093,"Illinois","Kendall County",2,23,1497,768,729
050,17,093,"Illinois","Kendall County",2,24,1414,729,685
050,17,093,"Illinois","Kendall County",2,25,1367,713,654
050,17,093,"Illinois","Kendall County",2,26,1377,699,678
050,17,093,"Illinois","Kendall County",2,27,1397,686,711
050,17,093,"Illinois","Kendall County",2,28,1491,731,760
050,17,093,"Illinois","Kendall County",2,29,1535,759,776
050,17,093,"Illinois","Kendall County",2,30,1574,759,815
050,17,093,"Illinois","Kendall County",2,31,1643,805,838
050,17,093,"Illinois","Kendall County",2,32,1744,872,872
050,17,093,"Illinois","Kendall County",2,33,1861,928,933
050,17,093,"Illinois","Kendall County",2,34,1984,985,999
050,17,093,"Illinois","Kendall County",2,35,2030,1011,1019
050,17,093,"Illinois","Kendall County",2,36,2093,1037,1056
050,17,093,"Illinois","Kendall County",2,37,2167,1083,1084
050,17,093,"Illinois","Kendall County",2,38,2200,1098,1102
050,17,093,"Illinois","Kendall County",2,39,2224,1109,1115
050,17,093,"Illinois","Kendall County",2,40,2247,1122,1125
050,17,093,"Illinois","Kendall County",2,41,2150,1040,1110
050,17,093,"Illinois","Kendall County",2,42,2100,1024,1076
050,17,093,"Illinois","Kendall County",2,43,2080,1016,1064
050,17,093,"Illinois","Kendall County",2,44,2013,992,1021
050,17,093,"Illinois","Kendall County",2,45,2023,1003,1020
050,17,093,"Illinois","Kendall County",2,46,2009,1023,986
050,17,093,"Illinois","Kendall County",2,47,2011,1018,993
050,17,093,"Illinois","Kendall County",2,48,2037,1031,1006
050,17,093,"Illinois","Kendall County",2,49,2106,1067,1039
050,17,093,"Illinois","Kendall County",2,50,2043,1054,989
050,17,093,"Illinois","Kendall County",2,51,1916,992,924
050,17,093,"Illinois","Kendall County",2,52,1770,911,859
050,17,093,"Illinois","Kendall County",2,53,1644,859,785
050,17,093,"Illinois","Kendall County",2,54,1591,838,753
050,17,093,"Illinois","Kendall County",2,55,1571,818,753
050,17,093,"Illinois","Kendall County",2,56,1498,745,753
050,17,093,"Illinois","Kendall County",2,57,1511,770,741
050,17,093,"Illinois","Kendall County",2,58,1478,767,711
050,17,093,"Illinois","Kendall County",2,59,1435,734,701
050,17,093,"Illinois","Kendall County",2,60,1354,680,674
050,17,093,"Illinois","Kendall County",2,61,1272,619,653
050,17,093,"Illinois","Kendall County",2,62,1226,588,638
050,17,093,"Illinois","Kendall County",2,63,1162,563,599
050,17,093,"Illinois","Kendall County",2,64,1122,547,575
050,17,093,"Illinois","Kendall County",2,65,1127,523,604
050,17,093,"Illinois","Kendall County",2,66,1059,485,574
050,17,093,"Illinois","Kendall County",2,67,994,464,530
050,17,093,"Illinois","Kendall County",2,68,961,452,509
050,17,093,"Illinois","Kendall County",2,69,932,436,496
050,17,093,"Illinois","Kendall County",2,70,856,385,471
050,17,093,"Illinois","Kendall County",2,71,824,358,466
050,17,093,"Illinois","Kendall County",2,72,807,365,442
050,17,093,"Illinois","Kendall County",2,73,866,398,468
050,17,093,"Illinois","Kendall County",2,74,585,261,324
050,17,093,"Illinois","Kendall County",2,75,541,247,294
050,17,093,"Illinois","Kendall County",2,76,553,249,304
050,17,093,"Illinois","Kendall County",2,77,560,255,305
050,17,093,"Illinois","Kendall County",2,78,469,214,255
050,17,093,"Illinois","Kendall County",2,79,407,182,225
050,17,093,"Illinois","Kendall County",2,80,341,143,198
050,17,093,"Illinois","Kendall County",2,81,312,127,185
050,17,093,"Illinois","Kendall County",2,82,278,123,155
050,17,093,"Illinois","Kendall County",2,83,228,95,133
050,17,093,"Illinois","Kendall County",2,84,209,85,124
050,17,093,"Illinois","Kendall County",2,85,1316,471,845
050,17,093,"Illinois","Kendall County",3,0,1466,752,714
050,17,093,"Illinois","Kendall County",3,1,1618,840,778
050,17,093,"Illinois","Kendall County",3,2,1692,818,874
050,17,093,"Illinois","Kendall County",3,3,1703,855,848
050,17,093,"Illinois","Kendall County",3,4,1770,895,875
050,17,093,"Illinois","Kendall County",3,5,1934,990,944
050,17,093,"Illinois","Kendall County",3,6,1992,1056,936
050,17,093,"Illinois","Kendall County",3,7,2050,1076,974
050,17,093,"Illinois","Kendall County",3,8,2087,1062,1025
050,17,093,"Illinois","Kendall County",3,9,2123,1066,1057
050,17,093,"Illinois","Kendall County",3,10,2170,1107,1063
050,17,093,"Illinois","Kendall County",3,11,2243,1159,1084
050,17,093,"Illinois","Kendall County",3,12,2327,1190,1137
050,17,093,"Illinois","Kendall County",3,13,2411,1239,1172
050,17,093,"Illinois","Kendall County",3,14,2436,1228,1208
050,17,093,"Illinois","Kendall County",3,15,2371,1220,1151
050,17,093,"Illinois","Kendall County",3,16,2360,1230,1130
050,17,093,"Illinois","Kendall County",3,17,2389,1232,1157
050,17,093,"Illinois","Kendall County",3,18,1995,1055,940
050,17,093,"Illinois","Kendall County",3,19,1590,844,746
050,17,093,"Illinois","Kendall County",3,20,1670,877,793
050,17,093,"Illinois","Kendall County",3,21,1629,819,810
050,17,093,"Illinois","Kendall County",3,22,1576,793,783
050,17,093,"Illinois","Kendall County",3,23,1516,783,733
050,17,093,"Illinois","Kendall County",3,24,1481,752,729
050,17,093,"Illinois","Kendall County",3,25,1491,764,727
050,17,093,"Illinois","Kendall County",3,26,1497,750,747
050,17,093,"Illinois","Kendall County",3,27,1490,767,723
050,17,093,"Illinois","Kendall County",3,28,1488,733,755
050,17,093,"Illinois","Kendall County",3,29,1556,741,815
050,17,093,"Illinois","Kendall County",3,30,1688,840,848
050,17,093,"Illinois","Kendall County",3,31,1734,839,895
050,17,093,"Illinois","Kendall County",3,32,1768,864,904
050,17,093,"Illinois","Kendall County",3,33,1866,926,940
050,17,093,"Illinois","Kendall County",3,34,1946,967,979
050,17,093,"Illinois","Kendall County",3,35,2084,1039,1045
050,17,093,"Illinois","Kendall County",3,36,2063,1022,1041
050,17,093,"Illinois","Kendall County",3,37,2140,1062,1078
050,17,093,"Illinois","Kendall County",3,38,2212,1115,1097
050,17,093,"Illinois","Kendall County",3,39,2287,1142,1145
050,17,093,"Illinois","Kendall County",3,40,2282,1153,1129
050,17,093,"Illinois","Kendall County",3,41,2275,1150,1125
050,17,093,"Illinois","Kendall County",3,42,2146,1045,1101
050,17,093,"Illinois","Kendall County",3,43,2125,1038,1087
050,17,093,"Illinois","Kendall County",3,44,2089,1028,1061
050,17,093,"Illinois","Kendall County",3,45,2034,1002,1032
050,17,093,"Illinois","Kendall County",3,46,2009,1009,1000
050,17,093,"Illinois","Kendall County",3,47,2013,1017,996
050,17,093,"Illinois","Kendall County",3,48,1995,1003,992
050,17,093,"Illinois","Kendall County",3,49,2008,1016,992
050,17,093,"Illinois","Kendall County",3,50,2095,1074,1021
050,17,093,"Illinois","Kendall County",3,51,2021,1051,970
050,17,093,"Illinois","Kendall County",3,52,1880,970,910
050,17,093,"Illinois","Kendall County",3,53,1751,901,850
050,17,093,"Illinois","Kendall County",3,54,1628,835,793
050,17,093,"Illinois","Kendall County",3,55,1609,855,754
050,17,093,"Illinois","Kendall County",3,56,1561,810,751
050,17,093,"Illinois","Kendall County",3,57,1489,737,752
050,17,093,"Illinois","Kendall County",3,58,1478,751,727
050,17,093,"Illinois","Kendall County",3,59,1459,752,707
050,17,093,"Illinois","Kendall County",3,60,1432,737,695
050,17,093,"Illinois","Kendall County",3,61,1339,681,658
050,17,093,"Illinois","Kendall County",3,62,1248,600,648
050,17,093,"Illinois","Kendall County",3,63,1192,562,630
050,17,093,"Illinois","Kendall County",3,64,1172,568,604
050,17,093,"Illinois","Kendall County",3,65,1095,534,561
050,17,093,"Illinois","Kendall County",3,66,1124,517,607
050,17,093,"Illinois","Kendall County",3,67,1026,468,558
050,17,093,"Illinois","Kendall County",3,68,978,453,525
050,17,093,"Illinois","Kendall County",3,69,947,442,505
050,17,093,"Illinois","Kendall County",3,70,898,425,473
050,17,093,"Illinois","Kendall County",3,71,843,383,460
050,17,093,"Illinois","Kendall County",3,72,808,355,453
050,17,093,"Illinois","Kendall County",3,73,794,356,438
050,17,093,"Illinois","Kendall County",3,74,846,379,467
050,17,093,"Illinois","Kendall County",3,75,559,247,312
050,17,093,"Illinois","Kendall County",3,76,531,239,292
050,17,093,"Illinois","Kendall County",3,77,533,240,293
050,17,093,"Illinois","Kendall County",3,78,542,246,296
050,17,093,"Illinois","Kendall County",3,79,451,206,245
050,17,093,"Illinois","Kendall County",3,80,393,174,219
050,17,093,"Illinois","Kendall County",3,81,320,128,192
050,17,093,"Illinois","Kendall County",3,82,291,118,173
050,17,093,"Illinois","Kendall County",3,83,252,113,139
050,17,093,"Illinois","Kendall County",3,84,220,87,133
050,17,093,"Illinois","Kendall County",3,85,1325,475,850
050,17,093,"Illinois","Kendall County",4,0,1561,768,793
050,17,093,"Illinois","Kendall County",4,1,1594,791,803
050,17,093,"Illinois","Kendall County",4,2,1725,887,838
050,17,093,"Illinois","Kendall County",4,3,1802,876,926
050,17,093,"Illinois","Kendall County",4,4,1772,888,884
050,17,093,"Illinois","Kendall County",4,5,1861,957,904
050,17,093,"Illinois","Kendall County",4,6,2020,1037,983
050,17,093,"Illinois","Kendall County",4,7,2039,1070,969
050,17,093,"Illinois","Kendall County",4,8,2103,1105,998
050,17,093,"Illinois","Kendall County",4,9,2123,1092,1031
050,17,093,"Illinois","Kendall County",4,10,2186,1099,1087
050,17,093,"Illinois","Kendall County",4,11,2227,1138,1089
050,17,093,"Illinois","Kendall County",4,12,2269,1164,1105
050,17,093,"Illinois","Kendall County",4,13,2334,1191,1143
050,17,093,"Illinois","Kendall County",4,14,2442,1260,1182
050,17,093,"Illinois","Kendall County",4,15,2459,1241,1218
050,17,093,"Illinois","Kendall County",4,16,2355,1216,1139
050,17,093,"Illinois","Kendall County",4,17,2371,1241,1130
050,17,093,"Illinois","Kendall County",4,18,2067,1106,961
050,17,093,"Illinois","Kendall County",4,19,1630,876,754
050,17,093,"Illinois","Kendall County",4,20,1621,859,762
050,17,093,"Illinois","Kendall County",4,21,1712,900,812
050,17,093,"Illinois","Kendall County",4,22,1694,860,834
050,17,093,"Illinois","Kendall County",4,23,1632,818,814
050,17,093,"Illinois","Kendall County",4,24,1535,795,740
050,17,093,"Illinois","Kendall County",4,25,1489,747,742
050,17,093,"Illinois","Kendall County",4,26,1528,784,744
050,17,093,"Illinois","Kendall County",4,27,1571,782,789
050,17,093,"Illinois","Kendall County",4,28,1578,820,758
050,17,093,"Illinois","Kendall County",4,29,1611,776,835
050,17,093,"Illinois","Kendall County",4,30,1721,826,895
050,17,093,"Illinois","Kendall County",4,31,1847,933,914
050,17,093,"Illinois","Kendall County",4,32,1810,899,911
050,17,093,"Illinois","Kendall County",4,33,1895,928,967
050,17,093,"Illinois","Kendall County",4,34,1893,948,945
050,17,093,"Illinois","Kendall County",4,35,2072,1026,1046
050,17,093,"Illinois","Kendall County",4,36,2143,1072,1071
050,17,093,"Illinois","Kendall County",4,37,2119,1049,1070
050,17,093,"Illinois","Kendall County",4,38,2201,1101,1100
050,17,093,"Illinois","Kendall County",4,39,2237,1138,1099
050,17,093,"Illinois","Kendall County",4,40,2369,1181,1188
050,17,093,"Illinois","Kendall County",4,41,2311,1171,1140
050,17,093,"Illinois","Kendall County",4,42,2313,1164,1149
050,17,093,"Illinois","Kendall County",4,43,2188,1072,1116
050,17,093,"Illinois","Kendall County",4,44,2100,1029,1071
050,17,093,"Illinois","Kendall County",4,45,2067,1009,1058
050,17,093,"Illinois","Kendall County",4,46,2037,999,1038
050,17,093,"Illinois","Kendall County",4,47,1995,1003,992
050,17,093,"Illinois","Kendall County",4,48,1987,1001,986
050,17,093,"Illinois","Kendall County",4,49,1977,993,984
050,17,093,"Illinois","Kendall County",4,50,2005,1001,1004
050,17,093,"Illinois","Kendall County",4,51,2113,1077,1036
050,17,093,"Illinois","Kendall County",4,52,1978,1025,953
050,17,093,"Illinois","Kendall County",4,53,1857,970,887
050,17,093,"Illinois","Kendall County",4,54,1700,878,822
050,17,093,"Illinois","Kendall County",4,55,1619,827,792
050,17,093,"Illinois","Kendall County",4,56,1551,825,726
050,17,093,"Illinois","Kendall County",4,57,1506,799,707
050,17,093,"Illinois","Kendall County",4,58,1458,706,752
050,17,093,"Illinois","Kendall County",4,59,1443,726,717
050,17,093,"Illinois","Kendall County",4,60,1461,742,719
050,17,093,"Illinois","Kendall County",4,61,1425,728,697
050,17,093,"Illinois","Kendall County",4,62,1344,681,663
050,17,093,"Illinois","Kendall County",4,63,1237,596,641
050,17,093,"Illinois","Kendall County",4,64,1200,570,630
050,17,093,"Illinois","Kendall County",4,65,1141,551,590
050,17,093,"Illinois","Kendall County",4,66,1078,514,564
050,17,093,"Illinois","Kendall County",4,67,1107,502,605
050,17,093,"Illinois","Kendall County",4,68,1012,463,549
050,17,093,"Illinois","Kendall County",4,69,983,441,542
050,17,093,"Illinois","Kendall County",4,70,942,438,504
050,17,093,"Illinois","Kendall County",4,71,886,420,466
050,17,093,"Illinois","Kendall County",4,72,814,366,448
050,17,093,"Illinois","Kendall County",4,73,785,349,436
050,17,093,"Illinois","Kendall County",4,74,783,335,448
050,17,093,"Illinois","Kendall County",4,75,826,365,461
050,17,093,"Illinois","Kendall County",4,76,542,241,301
050,17,093,"Illinois","Kendall County",4,77,493,228,265
050,17,093,"Illinois","Kendall County",4,78,513,235,278
050,17,093,"Illinois","Kendall County",4,79,528,233,295
050,17,093,"Illinois","Kendall County",4,80,435,193,242
050,17,093,"Illinois","Kendall County",4,81,381,162,219
050,17,093,"Illinois","Kendall County",4,82,291,114,177
050,17,093,"Illinois","Kendall County",4,83,265,104,161
050,17,093,"Illinois","Kendall County",4,84,238,104,134
050,17,093,"Illinois","Kendall County",4,85,1361,480,881
050,17,093,"Illinois","Kendall County",5,0,1553,764,789
050,17,093,"Illinois","Kendall County",5,1,1672,824,848
050,17,093,"Illinois","Kendall County",5,2,1690,846,844
050,17,093,"Illinois","Kendall County",5,3,1814,958,856
050,17,093,"Illinois","Kendall County",5,4,1854,892,962
050,17,093,"Illinois","Kendall County",5,5,1854,929,925
050,17,093,"Illinois","Kendall County",5,6,1916,978,938
050,17,093,"Illinois","Kendall County",5,7,2068,1058,1010
050,17,093,"Illinois","Kendall County",5,8,2125,1120,1005
050,17,093,"Illinois","Kendall County",5,9,2139,1121,1018
050,17,093,"Illinois","Kendall County",5,10,2123,1093,1030
050,17,093,"Illinois","Kendall County",5,11,2201,1109,1092
050,17,093,"Illinois","Kendall County",5,12,2262,1181,1081
050,17,093,"Illinois","Kendall County",5,13,2282,1181,1101
050,17,093,"Illinois","Kendall County",5,14,2347,1216,1131
050,17,093,"Illinois","Kendall County",5,15,2476,1270,1206
050,17,093,"Illinois","Kendall County",5,16,2476,1258,1218
050,17,093,"Illinois","Kendall County",5,17,2359,1217,1142
050,17,093,"Illinois","Kendall County",5,18,2036,1088,948
050,17,093,"Illinois","Kendall County",5,19,1706,916,790
050,17,093,"Illinois","Kendall County",5,20,1732,911,821
050,17,093,"Illinois","Kendall County",5,21,1705,905,800
050,17,093,"Illinois","Kendall County",5,22,1798,930,868
050,17,093,"Illinois","Kendall County",5,23,1718,880,838
050,17,093,"Illinois","Kendall County",5,24,1583,798,785
050,17,093,"Illinois","Kendall County",5,25,1527,810,717
050,17,093,"Illinois","Kendall County",5,26,1501,743,758
050,17,093,"Illinois","Kendall County",5,27,1589,799,790
050,17,093,"Illinois","Kendall County",5,28,1651,839,812
050,17,093,"Illinois","Kendall County",5,29,1642,836,806
050,17,093,"Illinois","Kendall County",5,30,1719,832,887
050,17,093,"Illinois","Kendall County",5,31,1810,886,924
050,17,093,"Illinois","Kendall County",5,32,1956,971,985
050,17,093,"Illinois","Kendall County",5,33,1931,977,954
050,17,093,"Illinois","Kendall County",5,34,1993,976,1017
050,17,093,"Illinois","Kendall County",5,35,1967,993,974
050,17,093,"Illinois","Kendall County",5,36,2136,1062,1074
050,17,093,"Illinois","Kendall County",5,37,2189,1088,1101
050,17,093,"Illinois","Kendall County",5,38,2174,1070,1104
050,17,093,"Illinois","Kendall County",5,39,2258,1114,1144
050,17,093,"Illinois","Kendall County",5,40,2315,1168,1147
050,17,093,"Illinois","Kendall County",5,41,2409,1196,1213
050,17,093,"Illinois","Kendall County",5,42,2342,1191,1151
050,17,093,"Illinois","Kendall County",5,43,2326,1181,1145
050,17,093,"Illinois","Kendall County",5,44,2200,1091,1109
050,17,093,"Illinois","Kendall County",5,45,2157,1066,1091
050,17,093,"Illinois","Kendall County",5,46,2077,1014,1063
050,17,093,"Illinois","Kendall County",5,47,2037,987,1050
050,17,093,"Illinois","Kendall County",5,48,2012,1014,998
050,17,093,"Illinois","Kendall County",5,49,1966,1006,960
050,17,093,"Illinois","Kendall County",5,50,1955,984,971
050,17,093,"Illinois","Kendall County",5,51,2035,990,1045
050,17,093,"Illinois","Kendall County",5,52,2103,1055,1048
050,17,093,"Illinois","Kendall County",5,53,1968,1032,936
050,17,093,"Illinois","Kendall County",5,54,1840,982,858
050,17,093,"Illinois","Kendall County",5,55,1689,881,808
050,17,093,"Illinois","Kendall County",5,56,1622,825,797
050,17,093,"Illinois","Kendall County",5,57,1553,835,718
050,17,093,"Illinois","Kendall County",5,58,1478,775,703
050,17,093,"Illinois","Kendall County",5,59,1439,694,745
050,17,093,"Illinois","Kendall County",5,60,1434,724,710
050,17,093,"Illinois","Kendall County",5,61,1458,728,730
050,17,093,"Illinois","Kendall County",5,62,1381,694,687
050,17,093,"Illinois","Kendall County",5,63,1317,666,651
050,17,093,"Illinois","Kendall County",5,64,1249,594,655
050,17,093,"Illinois","Kendall County",5,65,1204,573,631
050,17,093,"Illinois","Kendall County",5,66,1125,541,584
050,17,093,"Illinois","Kendall County",5,67,1078,511,567
050,17,093,"Illinois","Kendall County",5,68,1087,496,591
050,17,093,"Illinois","Kendall County",5,69,1004,459,545
050,17,093,"Illinois","Kendall County",5,70,968,432,536
050,17,093,"Illinois","Kendall County",5,71,926,431,495
050,17,093,"Illinois","Kendall County",5,72,870,407,463
050,17,093,"Illinois","Kendall County",5,73,788,349,439
050,17,093,"Illinois","Kendall County",5,74,760,328,432
050,17,093,"Illinois","Kendall County",5,75,738,320,418
050,17,093,"Illinois","Kendall County",5,76,809,353,456
050,17,093,"Illinois","Kendall County",5,77,522,230,292
050,17,093,"Illinois","Kendall County",5,78,480,225,255
050,17,093,"Illinois","Kendall County",5,79,491,226,265
050,17,093,"Illinois","Kendall County",5,80,507,216,291
050,17,093,"Illinois","Kendall County",5,81,430,179,251
050,17,093,"Illinois","Kendall County",5,82,346,144,202
050,17,093,"Illinois","Kendall County",5,83,268,100,168
050,17,093,"Illinois","Kendall County",5,84,259,100,159
050,17,093,"Illinois","Kendall County",5,85,1422,524,898
050,17,095,"Illinois","Knox County",1,0,546,282,264
050,17,095,"Illinois","Knox County",1,1,565,304,261
050,17,095,"Illinois","Knox County",1,2,593,316,277
050,17,095,"Illinois","Knox County",1,3,602,325,277
050,17,095,"Illinois","Knox County",1,4,583,309,274
050,17,095,"Illinois","Knox County",1,5,570,291,279
050,17,095,"Illinois","Knox County",1,6,549,285,264
050,17,095,"Illinois","Knox County",1,7,530,276,254
050,17,095,"Illinois","Knox County",1,8,515,270,245
050,17,095,"Illinois","Knox County",1,9,525,273,252
050,17,095,"Illinois","Knox County",1,10,518,263,255
050,17,095,"Illinois","Knox County",1,11,566,282,284
050,17,095,"Illinois","Knox County",1,12,599,306,293
050,17,095,"Illinois","Knox County",1,13,575,288,287
050,17,095,"Illinois","Knox County",1,14,559,289,270
050,17,095,"Illinois","Knox County",1,15,576,291,285
050,17,095,"Illinois","Knox County",1,16,608,316,292
050,17,095,"Illinois","Knox County",1,17,611,304,307
050,17,095,"Illinois","Knox County",1,18,619,301,318
050,17,095,"Illinois","Knox County",1,19,740,367,373
050,17,095,"Illinois","Knox County",1,20,724,388,336
050,17,095,"Illinois","Knox County",1,21,715,372,343
050,17,095,"Illinois","Knox County",1,22,701,351,350
050,17,095,"Illinois","Knox County",1,23,584,321,263
050,17,095,"Illinois","Knox County",1,24,562,323,239
050,17,095,"Illinois","Knox County",1,25,574,312,262
050,17,095,"Illinois","Knox County",1,26,576,319,257
050,17,095,"Illinois","Knox County",1,27,586,328,258
050,17,095,"Illinois","Knox County",1,28,572,307,265
050,17,095,"Illinois","Knox County",1,29,616,340,276
050,17,095,"Illinois","Knox County",1,30,592,334,258
050,17,095,"Illinois","Knox County",1,31,565,303,262
050,17,095,"Illinois","Knox County",1,32,578,324,254
050,17,095,"Illinois","Knox County",1,33,579,335,244
050,17,095,"Illinois","Knox County",1,34,586,330,256
050,17,095,"Illinois","Knox County",1,35,552,311,241
050,17,095,"Illinois","Knox County",1,36,552,287,265
050,17,095,"Illinois","Knox County",1,37,560,288,272
050,17,095,"Illinois","Knox County",1,38,568,317,251
050,17,095,"Illinois","Knox County",1,39,590,320,270
050,17,095,"Illinois","Knox County",1,40,607,335,272
050,17,095,"Illinois","Knox County",1,41,592,329,263
050,17,095,"Illinois","Knox County",1,42,595,319,276
050,17,095,"Illinois","Knox County",1,43,591,314,277
050,17,095,"Illinois","Knox County",1,44,559,301,258
050,17,095,"Illinois","Knox County",1,45,534,286,248
050,17,095,"Illinois","Knox County",1,46,553,300,253
050,17,095,"Illinois","Knox County",1,47,530,271,259
050,17,095,"Illinois","Knox County",1,48,561,298,263
050,17,095,"Illinois","Knox County",1,49,614,330,284
050,17,095,"Illinois","Knox County",1,50,558,275,283
050,17,095,"Illinois","Knox County",1,51,560,293,267
050,17,095,"Illinois","Knox County",1,52,589,312,277
050,17,095,"Illinois","Knox County",1,53,577,278,299
050,17,095,"Illinois","Knox County",1,54,628,314,314
050,17,095,"Illinois","Knox County",1,55,666,327,339
050,17,095,"Illinois","Knox County",1,56,688,348,340
050,17,095,"Illinois","Knox County",1,57,669,326,343
050,17,095,"Illinois","Knox County",1,58,711,343,368
050,17,095,"Illinois","Knox County",1,59,729,363,366
050,17,095,"Illinois","Knox County",1,60,709,356,353
050,17,095,"Illinois","Knox County",1,61,718,351,367
050,17,095,"Illinois","Knox County",1,62,691,341,350
050,17,095,"Illinois","Knox County",1,63,691,349,342
050,17,095,"Illinois","Knox County",1,64,731,349,382
050,17,095,"Illinois","Knox County",1,65,694,338,356
050,17,095,"Illinois","Knox County",1,66,697,345,352
050,17,095,"Illinois","Knox County",1,67,727,338,389
050,17,095,"Illinois","Knox County",1,68,686,317,369
050,17,095,"Illinois","Knox County",1,69,648,322,326
050,17,095,"Illinois","Knox County",1,70,579,287,292
050,17,095,"Illinois","Knox County",1,71,545,264,281
050,17,095,"Illinois","Knox County",1,72,585,274,311
050,17,095,"Illinois","Knox County",1,73,610,279,331
050,17,095,"Illinois","Knox County",1,74,412,185,227
050,17,095,"Illinois","Knox County",1,75,411,180,231
050,17,095,"Illinois","Knox County",1,76,426,188,238
050,17,095,"Illinois","Knox County",1,77,427,207,220
050,17,095,"Illinois","Knox County",1,78,367,171,196
050,17,095,"Illinois","Knox County",1,79,334,159,175
050,17,095,"Illinois","Knox County",1,80,290,134,156
050,17,095,"Illinois","Knox County",1,81,274,129,145
050,17,095,"Illinois","Knox County",1,82,251,107,144
050,17,095,"Illinois","Knox County",1,83,247,101,146
050,17,095,"Illinois","Knox County",1,84,243,90,153
050,17,095,"Illinois","Knox County",1,85,1373,498,875
050,17,095,"Illinois","Knox County",2,0,536,277,259
050,17,095,"Illinois","Knox County",2,1,558,297,261
050,17,095,"Illinois","Knox County",2,2,587,316,271
050,17,095,"Illinois","Knox County",2,3,595,320,275
050,17,095,"Illinois","Knox County",2,4,587,312,275
050,17,095,"Illinois","Knox County",2,5,571,294,277
050,17,095,"Illinois","Knox County",2,6,553,287,266
050,17,095,"Illinois","Knox County",2,7,533,278,255
050,17,095,"Illinois","Knox County",2,8,512,269,243
050,17,095,"Illinois","Knox County",2,9,520,271,249
050,17,095,"Illinois","Knox County",2,10,516,264,252
050,17,095,"Illinois","Knox County",2,11,555,276,279
050,17,095,"Illinois","Knox County",2,12,590,299,291
050,17,095,"Illinois","Knox County",2,13,577,290,287
050,17,095,"Illinois","Knox County",2,14,562,286,276
050,17,095,"Illinois","Knox County",2,15,570,289,281
050,17,095,"Illinois","Knox County",2,16,598,310,288
050,17,095,"Illinois","Knox County",2,17,607,305,302
050,17,095,"Illinois","Knox County",2,18,621,301,320
050,17,095,"Illinois","Knox County",2,19,732,361,371
050,17,095,"Illinois","Knox County",2,20,728,389,339
050,17,095,"Illinois","Knox County",2,21,707,368,339
050,17,095,"Illinois","Knox County",2,22,692,347,345
050,17,095,"Illinois","Knox County",2,23,579,318,261
050,17,095,"Illinois","Knox County",2,24,568,326,242
050,17,095,"Illinois","Knox County",2,25,565,313,252
050,17,095,"Illinois","Knox County",2,26,575,316,259
050,17,095,"Illinois","Knox County",2,27,578,322,256
050,17,095,"Illinois","Knox County",2,28,576,312,264
050,17,095,"Illinois","Knox County",2,29,603,332,271
050,17,095,"Illinois","Knox County",2,30,600,336,264
050,17,095,"Illinois","Knox County",2,31,572,313,259
050,17,095,"Illinois","Knox County",2,32,570,314,256
050,17,095,"Illinois","Knox County",2,33,580,333,247
050,17,095,"Illinois","Knox County",2,34,580,328,252
050,17,095,"Illinois","Knox County",2,35,566,318,248
050,17,095,"Illinois","Knox County",2,36,543,286,257
050,17,095,"Illinois","Knox County",2,37,556,288,268
050,17,095,"Illinois","Knox County",2,38,575,316,259
050,17,095,"Illinois","Knox County",2,39,582,317,265
050,17,095,"Illinois","Knox County",2,40,606,333,273
050,17,095,"Illinois","Knox County",2,41,592,326,266
050,17,095,"Illinois","Knox County",2,42,588,319,269
050,17,095,"Illinois","Knox County",2,43,592,315,277
050,17,095,"Illinois","Knox County",2,44,564,305,259
050,17,095,"Illinois","Knox County",2,45,539,288,251
050,17,095,"Illinois","Knox County",2,46,543,295,248
050,17,095,"Illinois","Knox County",2,47,535,278,257
050,17,095,"Illinois","Knox County",2,48,554,293,261
050,17,095,"Illinois","Knox County",2,49,603,322,281
050,17,095,"Illinois","Knox County",2,50,568,284,284
050,17,095,"Illinois","Knox County",2,51,558,287,271
050,17,095,"Illinois","Knox County",2,52,574,302,272
050,17,095,"Illinois","Knox County",2,53,577,285,292
050,17,095,"Illinois","Knox County",2,54,615,306,309
050,17,095,"Illinois","Knox County",2,55,653,320,333
050,17,095,"Illinois","Knox County",2,56,683,340,343
050,17,095,"Illinois","Knox County",2,57,672,331,341
050,17,095,"Illinois","Knox County",2,58,695,333,362
050,17,095,"Illinois","Knox County",2,59,725,358,367
050,17,095,"Illinois","Knox County",2,60,711,358,353
050,17,095,"Illinois","Knox County",2,61,714,350,364
050,17,095,"Illinois","Knox County",2,62,689,338,351
050,17,095,"Illinois","Knox County",2,63,691,347,344
050,17,095,"Illinois","Knox County",2,64,716,345,371
050,17,095,"Illinois","Knox County",2,65,696,337,359
050,17,095,"Illinois","Knox County",2,66,697,342,355
050,17,095,"Illinois","Knox County",2,67,714,338,376
050,17,095,"Illinois","Knox County",2,68,683,318,365
050,17,095,"Illinois","Knox County",2,69,658,321,337
050,17,095,"Illinois","Knox County",2,70,593,294,299
050,17,095,"Illinois","Knox County",2,71,553,270,283
050,17,095,"Illinois","Knox County",2,72,561,267,294
050,17,095,"Illinois","Knox County",2,73,628,290,338
050,17,095,"Illinois","Knox County",2,74,428,191,237
050,17,095,"Illinois","Knox County",2,75,409,182,227
050,17,095,"Illinois","Knox County",2,76,414,180,234
050,17,095,"Illinois","Knox County",2,77,435,207,228
050,17,095,"Illinois","Knox County",2,78,373,175,198
050,17,095,"Illinois","Knox County",2,79,334,158,176
050,17,095,"Illinois","Knox County",2,80,298,137,161
050,17,095,"Illinois","Knox County",2,81,270,126,144
050,17,095,"Illinois","Knox County",2,82,255,111,144
050,17,095,"Illinois","Knox County",2,83,243,101,142
050,17,095,"Illinois","Knox County",2,84,238,91,147
050,17,095,"Illinois","Knox County",2,85,1378,497,881
050,17,095,"Illinois","Knox County",3,0,505,280,225
050,17,095,"Illinois","Knox County",3,1,553,298,255
050,17,095,"Illinois","Knox County",3,2,558,301,257
050,17,095,"Illinois","Knox County",3,3,552,287,265
050,17,095,"Illinois","Knox County",3,4,589,311,278
050,17,095,"Illinois","Knox County",3,5,577,310,267
050,17,095,"Illinois","Knox County",3,6,583,305,278
050,17,095,"Illinois","Knox County",3,7,546,273,273
050,17,095,"Illinois","Knox County",3,8,536,280,256
050,17,095,"Illinois","Knox County",3,9,498,260,238
050,17,095,"Illinois","Knox County",3,10,509,266,243
050,17,095,"Illinois","Knox County",3,11,510,263,247
050,17,095,"Illinois","Knox County",3,12,549,270,279
050,17,095,"Illinois","Knox County",3,13,576,290,286
050,17,095,"Illinois","Knox County",3,14,587,297,290
050,17,095,"Illinois","Knox County",3,15,575,296,279
050,17,095,"Illinois","Knox County",3,16,567,292,275
050,17,095,"Illinois","Knox County",3,17,614,316,298
050,17,095,"Illinois","Knox County",3,18,645,318,327
050,17,095,"Illinois","Knox County",3,19,726,358,368
050,17,095,"Illinois","Knox County",3,20,744,398,346
050,17,095,"Illinois","Knox County",3,21,694,368,326
050,17,095,"Illinois","Knox County",3,22,644,327,317
050,17,095,"Illinois","Knox County",3,23,561,312,249
050,17,095,"Illinois","Knox County",3,24,575,337,238
050,17,095,"Illinois","Knox County",3,25,548,320,228
050,17,095,"Illinois","Knox County",3,26,550,307,243
050,17,095,"Illinois","Knox County",3,27,572,322,250
050,17,095,"Illinois","Knox County",3,28,577,327,250
050,17,095,"Illinois","Knox County",3,29,577,321,256
050,17,095,"Illinois","Knox County",3,30,602,331,271
050,17,095,"Illinois","Knox County",3,31,610,350,260
050,17,095,"Illinois","Knox County",3,32,559,297,262
050,17,095,"Illinois","Knox County",3,33,563,310,253
050,17,095,"Illinois","Knox County",3,34,567,320,247
050,17,095,"Illinois","Knox County",3,35,603,342,261
050,17,095,"Illinois","Knox County",3,36,554,301,253
050,17,095,"Illinois","Knox County",3,37,539,287,252
050,17,095,"Illinois","Knox County",3,38,575,309,266
050,17,095,"Illinois","Knox County",3,39,560,308,252
050,17,095,"Illinois","Knox County",3,40,594,328,266
050,17,095,"Illinois","Knox County",3,41,574,313,261
050,17,095,"Illinois","Knox County",3,42,576,309,267
050,17,095,"Illinois","Knox County",3,43,584,312,272
050,17,095,"Illinois","Knox County",3,44,608,323,285
050,17,095,"Illinois","Knox County",3,45,547,294,253
050,17,095,"Illinois","Knox County",3,46,545,299,246
050,17,095,"Illinois","Knox County",3,47,546,292,254
050,17,095,"Illinois","Knox County",3,48,534,288,246
050,17,095,"Illinois","Knox County",3,49,552,291,261
050,17,095,"Illinois","Knox County",3,50,579,309,270
050,17,095,"Illinois","Knox County",3,51,575,290,285
050,17,095,"Illinois","Knox County",3,52,553,287,266
050,17,095,"Illinois","Knox County",3,53,574,306,268
050,17,095,"Illinois","Knox County",3,54,589,299,290
050,17,095,"Illinois","Knox County",3,55,599,296,303
050,17,095,"Illinois","Knox County",3,56,655,317,338
050,17,095,"Illinois","Knox County",3,57,671,333,338
050,17,095,"Illinois","Knox County",3,58,661,328,333
050,17,095,"Illinois","Knox County",3,59,685,328,357
050,17,095,"Illinois","Knox County",3,60,722,361,361
050,17,095,"Illinois","Knox County",3,61,702,357,345
050,17,095,"Illinois","Knox County",3,62,681,328,353
050,17,095,"Illinois","Knox County",3,63,690,341,349
050,17,095,"Illinois","Knox County",3,64,674,329,345
050,17,095,"Illinois","Knox County",3,65,685,330,355
050,17,095,"Illinois","Knox County",3,66,681,329,352
050,17,095,"Illinois","Knox County",3,67,685,329,356
050,17,095,"Illinois","Knox County",3,68,700,326,374
050,17,095,"Illinois","Knox County",3,69,666,312,354
050,17,095,"Illinois","Knox County",3,70,643,312,331
050,17,095,"Illinois","Knox County",3,71,574,288,286
050,17,095,"Illinois","Knox County",3,72,545,260,285
050,17,095,"Illinois","Knox County",3,73,544,257,287
050,17,095,"Illinois","Knox County",3,74,602,275,327
050,17,095,"Illinois","Knox County",3,75,402,178,224
050,17,095,"Illinois","Knox County",3,76,386,167,219
050,17,095,"Illinois","Knox County",3,77,389,166,223
050,17,095,"Illinois","Knox County",3,78,410,191,219
050,17,095,"Illinois","Knox County",3,79,337,158,179
050,17,095,"Illinois","Knox County",3,80,314,142,172
050,17,095,"Illinois","Knox County",3,81,278,129,149
050,17,095,"Illinois","Knox County",3,82,256,117,139
050,17,095,"Illinois","Knox County",3,83,233,99,134
050,17,095,"Illinois","Knox County",3,84,225,96,129
050,17,095,"Illinois","Knox County",3,85,1356,492,864
050,17,095,"Illinois","Knox County",4,0,475,260,215
050,17,095,"Illinois","Knox County",4,1,519,292,227
050,17,095,"Illinois","Knox County",4,2,526,276,250
050,17,095,"Illinois","Knox County",4,3,553,300,253
050,17,095,"Illinois","Knox County",4,4,549,286,263
050,17,095,"Illinois","Knox County",4,5,580,307,273
050,17,095,"Illinois","Knox County",4,6,575,302,273
050,17,095,"Illinois","Knox County",4,7,563,290,273
050,17,095,"Illinois","Knox County",4,8,540,277,263
050,17,095,"Illinois","Knox County",4,9,531,281,250
050,17,095,"Illinois","Knox County",4,10,504,267,237
050,17,095,"Illinois","Knox County",4,11,525,274,251
050,17,095,"Illinois","Knox County",4,12,505,265,240
050,17,095,"Illinois","Knox County",4,13,548,276,272
050,17,095,"Illinois","Knox County",4,14,572,291,281
050,17,095,"Illinois","Knox County",4,15,573,287,286
050,17,095,"Illinois","Knox County",4,16,570,287,283
050,17,095,"Illinois","Knox County",4,17,569,287,282
050,17,095,"Illinois","Knox County",4,18,652,330,322
050,17,095,"Illinois","Knox County",4,19,733,364,369
050,17,095,"Illinois","Knox County",4,20,738,397,341
050,17,095,"Illinois","Knox County",4,21,717,371,346
050,17,095,"Illinois","Knox County",4,22,651,334,317
050,17,095,"Illinois","Knox County",4,23,547,293,254
050,17,095,"Illinois","Knox County",4,24,554,325,229
050,17,095,"Illinois","Knox County",4,25,539,313,226
050,17,095,"Illinois","Knox County",4,26,541,305,236
050,17,095,"Illinois","Knox County",4,27,532,300,232
050,17,095,"Illinois","Knox County",4,28,541,304,237
050,17,095,"Illinois","Knox County",4,29,547,320,227
050,17,095,"Illinois","Knox County",4,30,554,312,242
050,17,095,"Illinois","Knox County",4,31,610,343,267
050,17,095,"Illinois","Knox County",4,32,578,326,252
050,17,095,"Illinois","Knox County",4,33,589,307,282
050,17,095,"Illinois","Knox County",4,34,546,296,250
050,17,095,"Illinois","Knox County",4,35,551,309,242
050,17,095,"Illinois","Knox County",4,36,578,315,263
050,17,095,"Illinois","Knox County",4,37,546,293,253
050,17,095,"Illinois","Knox County",4,38,564,304,260
050,17,095,"Illinois","Knox County",4,39,553,295,258
050,17,095,"Illinois","Knox County",4,40,552,307,245
050,17,095,"Illinois","Knox County",4,41,580,313,267
050,17,095,"Illinois","Knox County",4,42,555,297,258
050,17,095,"Illinois","Knox County",4,43,549,294,255
050,17,095,"Illinois","Knox County",4,44,578,312,266
050,17,095,"Illinois","Knox County",4,45,588,310,278
050,17,095,"Illinois","Knox County",4,46,540,290,250
050,17,095,"Illinois","Knox County",4,47,547,294,253
050,17,095,"Illinois","Knox County",4,48,544,291,253
050,17,095,"Illinois","Knox County",4,49,524,285,239
050,17,095,"Illinois","Knox County",4,50,530,274,256
050,17,095,"Illinois","Knox County",4,51,583,311,272
050,17,095,"Illinois","Knox County",4,52,570,289,281
050,17,095,"Illinois","Knox County",4,53,555,288,267
050,17,095,"Illinois","Knox County",4,54,583,318,265
050,17,095,"Illinois","Knox County",4,55,565,278,287
050,17,095,"Illinois","Knox County",4,56,596,290,306
050,17,095,"Illinois","Knox County",4,57,636,309,327
050,17,095,"Illinois","Knox County",4,58,660,325,335
050,17,095,"Illinois","Knox County",4,59,644,325,319
050,17,095,"Illinois","Knox County",4,60,696,336,360
050,17,095,"Illinois","Knox County",4,61,705,348,357
050,17,095,"Illinois","Knox County",4,62,693,349,344
050,17,095,"Illinois","Knox County",4,63,681,326,355
050,17,095,"Illinois","Knox County",4,64,668,329,339
050,17,095,"Illinois","Knox County",4,65,644,313,331
050,17,095,"Illinois","Knox County",4,66,655,309,346
050,17,095,"Illinois","Knox County",4,67,670,318,352
050,17,095,"Illinois","Knox County",4,68,662,307,355
050,17,095,"Illinois","Knox County",4,69,680,317,363
050,17,095,"Illinois","Knox County",4,70,656,309,347
050,17,095,"Illinois","Knox County",4,71,624,306,318
050,17,095,"Illinois","Knox County",4,72,567,282,285
050,17,095,"Illinois","Knox County",4,73,527,250,277
050,17,095,"Illinois","Knox County",4,74,536,250,286
050,17,095,"Illinois","Knox County",4,75,571,261,310
050,17,095,"Illinois","Knox County",4,76,385,168,217
050,17,095,"Illinois","Knox County",4,77,367,160,207
050,17,095,"Illinois","Knox County",4,78,371,157,214
050,17,095,"Illinois","Knox County",4,79,374,176,198
050,17,095,"Illinois","Knox County",4,80,313,144,169
050,17,095,"Illinois","Knox County",4,81,284,128,156
050,17,095,"Illinois","Knox County",4,82,270,126,144
050,17,095,"Illinois","Knox County",4,83,242,105,137
050,17,095,"Illinois","Knox County",4,84,216,92,124
050,17,095,"Illinois","Knox County",4,85,1346,498,848
050,17,095,"Illinois","Knox County",5,0,464,253,211
050,17,095,"Illinois","Knox County",5,1,498,270,228
050,17,095,"Illinois","Knox County",5,2,520,291,229
050,17,095,"Illinois","Knox County",5,3,521,273,248
050,17,095,"Illinois","Knox County",5,4,538,293,245
050,17,095,"Illinois","Knox County",5,5,541,281,260
050,17,095,"Illinois","Knox County",5,6,577,306,271
050,17,095,"Illinois","Knox County",5,7,564,297,267
050,17,095,"Illinois","Knox County",5,8,584,311,273
050,17,095,"Illinois","Knox County",5,9,556,283,273
050,17,095,"Illinois","Knox County",5,10,548,298,250
050,17,095,"Illinois","Knox County",5,11,518,273,245
050,17,095,"Illinois","Knox County",5,12,517,271,246
050,17,095,"Illinois","Knox County",5,13,523,275,248
050,17,095,"Illinois","Knox County",5,14,549,273,276
050,17,095,"Illinois","Knox County",5,15,584,295,289
050,17,095,"Illinois","Knox County",5,16,591,291,300
050,17,095,"Illinois","Knox County",5,17,590,302,288
050,17,095,"Illinois","Knox County",5,18,611,306,305
050,17,095,"Illinois","Knox County",5,19,735,371,364
050,17,095,"Illinois","Knox County",5,20,766,420,346
050,17,095,"Illinois","Knox County",5,21,697,359,338
050,17,095,"Illinois","Knox County",5,22,677,347,330
050,17,095,"Illinois","Knox County",5,23,542,302,240
050,17,095,"Illinois","Knox County",5,24,539,304,235
050,17,095,"Illinois","Knox County",5,25,550,315,235
050,17,095,"Illinois","Knox County",5,26,543,322,221
050,17,095,"Illinois","Knox County",5,27,542,313,229
050,17,095,"Illinois","Knox County",5,28,534,298,236
050,17,095,"Illinois","Knox County",5,29,547,305,242
050,17,095,"Illinois","Knox County",5,30,537,323,214
050,17,095,"Illinois","Knox County",5,31,559,309,250
050,17,095,"Illinois","Knox County",5,32,588,321,267
050,17,095,"Illinois","Knox County",5,33,604,331,273
050,17,095,"Illinois","Knox County",5,34,571,292,279
050,17,095,"Illinois","Knox County",5,35,570,303,267
050,17,095,"Illinois","Knox County",5,36,531,295,236
050,17,095,"Illinois","Knox County",5,37,569,314,255
050,17,095,"Illinois","Knox County",5,38,576,315,261
050,17,095,"Illinois","Knox County",5,39,550,292,258
050,17,095,"Illinois","Knox County",5,40,557,302,255
050,17,095,"Illinois","Knox County",5,41,557,298,259
050,17,095,"Illinois","Knox County",5,42,584,315,269
050,17,095,"Illinois","Knox County",5,43,548,290,258
050,17,095,"Illinois","Knox County",5,44,543,296,247
050,17,095,"Illinois","Knox County",5,45,553,289,264
050,17,095,"Illinois","Knox County",5,46,598,319,279
050,17,095,"Illinois","Knox County",5,47,537,280,257
050,17,095,"Illinois","Knox County",5,48,541,292,249
050,17,095,"Illinois","Knox County",5,49,535,285,250
050,17,095,"Illinois","Knox County",5,50,503,266,237
050,17,095,"Illinois","Knox County",5,51,529,278,251
050,17,095,"Illinois","Knox County",5,52,579,305,274
050,17,095,"Illinois","Knox County",5,53,563,281,282
050,17,095,"Illinois","Knox County",5,54,571,304,267
050,17,095,"Illinois","Knox County",5,55,550,300,250
050,17,095,"Illinois","Knox County",5,56,581,280,301
050,17,095,"Illinois","Knox County",5,57,589,286,303
050,17,095,"Illinois","Knox County",5,58,617,302,315
050,17,095,"Illinois","Knox County",5,59,652,325,327
050,17,095,"Illinois","Knox County",5,60,640,325,315
050,17,095,"Illinois","Knox County",5,61,691,337,354
050,17,095,"Illinois","Knox County",5,62,689,338,351
050,17,095,"Illinois","Knox County",5,63,686,345,341
050,17,095,"Illinois","Knox County",5,64,662,313,349
050,17,095,"Illinois","Knox County",5,65,644,316,328
050,17,095,"Illinois","Knox County",5,66,627,305,322
050,17,095,"Illinois","Knox County",5,67,649,300,349
050,17,095,"Illinois","Knox County",5,68,655,306,349
050,17,095,"Illinois","Knox County",5,69,641,302,339
050,17,095,"Illinois","Knox County",5,70,656,307,349
050,17,095,"Illinois","Knox County",5,71,635,295,340
050,17,095,"Illinois","Knox County",5,72,618,300,318
050,17,095,"Illinois","Knox County",5,73,533,267,266
050,17,095,"Illinois","Knox County",5,74,526,246,280
050,17,095,"Illinois","Knox County",5,75,505,234,271
050,17,095,"Illinois","Knox County",5,76,550,247,303
050,17,095,"Illinois","Knox County",5,77,368,159,209
050,17,095,"Illinois","Knox County",5,78,352,153,199
050,17,095,"Illinois","Knox County",5,79,339,143,196
050,17,095,"Illinois","Knox County",5,80,350,166,184
050,17,095,"Illinois","Knox County",5,81,285,130,155
050,17,095,"Illinois","Knox County",5,82,275,127,148
050,17,095,"Illinois","Knox County",5,83,256,117,139
050,17,095,"Illinois","Knox County",5,84,230,102,128
050,17,095,"Illinois","Knox County",5,85,1341,506,835
050,17,097,"Illinois","Lake County",1,0,7108,3621,3487
050,17,097,"Illinois","Lake County",1,1,7547,3836,3711
050,17,097,"Illinois","Lake County",1,2,8000,4083,3917
050,17,097,"Illinois","Lake County",1,3,8413,4284,4129
050,17,097,"Illinois","Lake County",1,4,8772,4469,4303
050,17,097,"Illinois","Lake County",1,5,8927,4546,4381
050,17,097,"Illinois","Lake County",1,6,8871,4530,4341
050,17,097,"Illinois","Lake County",1,7,9140,4680,4460
050,17,097,"Illinois","Lake County",1,8,9334,4795,4539
050,17,097,"Illinois","Lake County",1,9,9550,4883,4667
050,17,097,"Illinois","Lake County",1,10,10059,5097,4962
050,17,097,"Illinois","Lake County",1,11,10435,5296,5139
050,17,097,"Illinois","Lake County",1,12,10883,5591,5292
050,17,097,"Illinois","Lake County",1,13,10964,5547,5417
050,17,097,"Illinois","Lake County",1,14,10868,5539,5329
050,17,097,"Illinois","Lake County",1,15,10960,5611,5349
050,17,097,"Illinois","Lake County",1,16,11302,5757,5545
050,17,097,"Illinois","Lake County",1,17,11265,5847,5418
050,17,097,"Illinois","Lake County",1,18,11218,6168,5050
050,17,097,"Illinois","Lake County",1,19,11429,6608,4821
050,17,097,"Illinois","Lake County",1,20,10822,6054,4768
050,17,097,"Illinois","Lake County",1,21,10349,5692,4657
050,17,097,"Illinois","Lake County",1,22,10134,5477,4657
050,17,097,"Illinois","Lake County",1,23,9451,5025,4426
050,17,097,"Illinois","Lake County",1,24,9044,4825,4219
050,17,097,"Illinois","Lake County",1,25,8891,4735,4156
050,17,097,"Illinois","Lake County",1,26,8530,4454,4076
050,17,097,"Illinois","Lake County",1,27,8237,4332,3905
050,17,097,"Illinois","Lake County",1,28,7997,4213,3784
050,17,097,"Illinois","Lake County",1,29,7501,3960,3541
050,17,097,"Illinois","Lake County",1,30,7302,3716,3586
050,17,097,"Illinois","Lake County",1,31,7302,3721,3581
050,17,097,"Illinois","Lake County",1,32,7725,3969,3756
050,17,097,"Illinois","Lake County",1,33,8063,4017,4046
050,17,097,"Illinois","Lake County",1,34,8314,4178,4136
050,17,097,"Illinois","Lake County",1,35,8552,4363,4189
050,17,097,"Illinois","Lake County",1,36,8750,4379,4371
050,17,097,"Illinois","Lake County",1,37,8943,4518,4425
050,17,097,"Illinois","Lake County",1,38,9034,4537,4497
050,17,097,"Illinois","Lake County",1,39,9310,4682,4628
050,17,097,"Illinois","Lake County",1,40,9353,4682,4671
050,17,097,"Illinois","Lake County",1,41,9236,4673,4563
050,17,097,"Illinois","Lake County",1,42,9276,4712,4564
050,17,097,"Illinois","Lake County",1,43,9123,4556,4567
050,17,097,"Illinois","Lake County",1,44,9074,4553,4521
050,17,097,"Illinois","Lake County",1,45,9126,4578,4548
050,17,097,"Illinois","Lake County",1,46,9022,4475,4547
050,17,097,"Illinois","Lake County",1,47,9049,4510,4539
050,17,097,"Illinois","Lake County",1,48,9770,4917,4853
050,17,097,"Illinois","Lake County",1,49,10379,5187,5192
050,17,097,"Illinois","Lake County",1,50,10094,5088,5006
050,17,097,"Illinois","Lake County",1,51,9887,4920,4967
050,17,097,"Illinois","Lake County",1,52,9671,4843,4828
050,17,097,"Illinois","Lake County",1,53,9820,4919,4901
050,17,097,"Illinois","Lake County",1,54,9926,4918,5008
050,17,097,"Illinois","Lake County",1,55,10238,5075,5163
050,17,097,"Illinois","Lake County",1,56,10368,5157,5211
050,17,097,"Illinois","Lake County",1,57,10332,5112,5220
050,17,097,"Illinois","Lake County",1,58,10215,5120,5095
050,17,097,"Illinois","Lake County",1,59,10175,5074,5101
050,17,097,"Illinois","Lake County",1,60,9904,4892,5012
050,17,097,"Illinois","Lake County",1,61,9757,4885,4872
050,17,097,"Illinois","Lake County",1,62,9498,4723,4775
050,17,097,"Illinois","Lake County",1,63,8912,4428,4484
050,17,097,"Illinois","Lake County",1,64,8357,4122,4235
050,17,097,"Illinois","Lake County",1,65,8036,3936,4100
050,17,097,"Illinois","Lake County",1,66,7484,3638,3846
050,17,097,"Illinois","Lake County",1,67,7267,3533,3734
050,17,097,"Illinois","Lake County",1,68,6962,3417,3545
050,17,097,"Illinois","Lake County",1,69,6413,3042,3371
050,17,097,"Illinois","Lake County",1,70,6059,2888,3171
050,17,097,"Illinois","Lake County",1,71,5748,2739,3009
050,17,097,"Illinois","Lake County",1,72,5837,2801,3036
050,17,097,"Illinois","Lake County",1,73,5807,2789,3018
050,17,097,"Illinois","Lake County",1,74,4083,1909,2174
050,17,097,"Illinois","Lake County",1,75,3937,1846,2091
050,17,097,"Illinois","Lake County",1,76,3865,1823,2042
050,17,097,"Illinois","Lake County",1,77,3863,1750,2113
050,17,097,"Illinois","Lake County",1,78,3261,1473,1788
050,17,097,"Illinois","Lake County",1,79,2809,1256,1553
050,17,097,"Illinois","Lake County",1,80,2557,1112,1445
050,17,097,"Illinois","Lake County",1,81,2421,1024,1397
050,17,097,"Illinois","Lake County",1,82,2247,955,1292
050,17,097,"Illinois","Lake County",1,83,2022,851,1171
050,17,097,"Illinois","Lake County",1,84,1923,812,1111
050,17,097,"Illinois","Lake County",1,85,11877,4266,7611
050,17,097,"Illinois","Lake County",2,0,7078,3597,3481
050,17,097,"Illinois","Lake County",2,1,7489,3808,3681
050,17,097,"Illinois","Lake County",2,2,7914,4035,3879
050,17,097,"Illinois","Lake County",2,3,8317,4240,4077
050,17,097,"Illinois","Lake County",2,4,8717,4443,4274
050,17,097,"Illinois","Lake County",2,5,8915,4542,4373
050,17,097,"Illinois","Lake County",2,6,8914,4553,4361
050,17,097,"Illinois","Lake County",2,7,9074,4645,4429
050,17,097,"Illinois","Lake County",2,8,9270,4753,4517
050,17,097,"Illinois","Lake County",2,9,9500,4861,4639
050,17,097,"Illinois","Lake County",2,10,9954,5051,4903
050,17,097,"Illinois","Lake County",2,11,10315,5232,5083
050,17,097,"Illinois","Lake County",2,12,10821,5540,5281
050,17,097,"Illinois","Lake County",2,13,10927,5554,5373
050,17,097,"Illinois","Lake County",2,14,10889,5543,5346
050,17,097,"Illinois","Lake County",2,15,10941,5595,5346
050,17,097,"Illinois","Lake County",2,16,11215,5725,5490
050,17,097,"Illinois","Lake County",2,17,11277,5833,5444
050,17,097,"Illinois","Lake County",2,18,11202,6177,5025
050,17,097,"Illinois","Lake County",2,19,11447,6613,4834
050,17,097,"Illinois","Lake County",2,20,10923,6116,4807
050,17,097,"Illinois","Lake County",2,21,10357,5689,4668
050,17,097,"Illinois","Lake County",2,22,10066,5438,4628
050,17,097,"Illinois","Lake County",2,23,9469,5032,4437
050,17,097,"Illinois","Lake County",2,24,9027,4809,4218
050,17,097,"Illinois","Lake County",2,25,8806,4686,4120
050,17,097,"Illinois","Lake County",2,26,8533,4474,4059
050,17,097,"Illinois","Lake County",2,27,8231,4319,3912
050,17,097,"Illinois","Lake County",2,28,8030,4227,3803
050,17,097,"Illinois","Lake County",2,29,7581,3984,3597
050,17,097,"Illinois","Lake County",2,30,7391,3781,3610
050,17,097,"Illinois","Lake County",2,31,7307,3720,3587
050,17,097,"Illinois","Lake County",2,32,7645,3918,3727
050,17,097,"Illinois","Lake County",2,33,8009,4012,3997
050,17,097,"Illinois","Lake County",2,34,8280,4155,4125
050,17,097,"Illinois","Lake County",2,35,8561,4350,4211
050,17,097,"Illinois","Lake County",2,36,8679,4356,4323
050,17,097,"Illinois","Lake County",2,37,8940,4507,4433
050,17,097,"Illinois","Lake County",2,38,9079,4567,4512
050,17,097,"Illinois","Lake County",2,39,9235,4649,4586
050,17,097,"Illinois","Lake County",2,40,9415,4726,4689
050,17,097,"Illinois","Lake County",2,41,9257,4679,4578
050,17,097,"Illinois","Lake County",2,42,9248,4703,4545
050,17,097,"Illinois","Lake County",2,43,9200,4614,4586
050,17,097,"Illinois","Lake County",2,44,9020,4527,4493
050,17,097,"Illinois","Lake County",2,45,9145,4592,4553
050,17,097,"Illinois","Lake County",2,46,9005,4476,4529
050,17,097,"Illinois","Lake County",2,47,9017,4488,4529
050,17,097,"Illinois","Lake County",2,48,9587,4812,4775
050,17,097,"Illinois","Lake County",2,49,10242,5136,5106
050,17,097,"Illinois","Lake County",2,50,10140,5102,5038
050,17,097,"Illinois","Lake County",2,51,9886,4935,4951
050,17,097,"Illinois","Lake County",2,52,9675,4844,4831
050,17,097,"Illinois","Lake County",2,53,9737,4876,4861
050,17,097,"Illinois","Lake County",2,54,9833,4890,4943
050,17,097,"Illinois","Lake County",2,55,10104,5008,5096
050,17,097,"Illinois","Lake County",2,56,10310,5121,5189
050,17,097,"Illinois","Lake County",2,57,10284,5091,5193
050,17,097,"Illinois","Lake County",2,58,10195,5090,5105
050,17,097,"Illinois","Lake County",2,59,10171,5072,5099
050,17,097,"Illinois","Lake County",2,60,9902,4900,5002
050,17,097,"Illinois","Lake County",2,61,9714,4845,4869
050,17,097,"Illinois","Lake County",2,62,9479,4720,4759
050,17,097,"Illinois","Lake County",2,63,9060,4507,4553
050,17,097,"Illinois","Lake County",2,64,8389,4139,4250
050,17,097,"Illinois","Lake County",2,65,8040,3940,4100
050,17,097,"Illinois","Lake County",2,66,7561,3675,3886
050,17,097,"Illinois","Lake County",2,67,7249,3515,3734
050,17,097,"Illinois","Lake County",2,68,6948,3400,3548
050,17,097,"Illinois","Lake County",2,69,6528,3117,3411
050,17,097,"Illinois","Lake County",2,70,6069,2884,3185
050,17,097,"Illinois","Lake County",2,71,5786,2752,3034
050,17,097,"Illinois","Lake County",2,72,5705,2729,2976
050,17,097,"Illinois","Lake County",2,73,6016,2891,3125
050,17,097,"Illinois","Lake County",2,74,4215,1983,2232
050,17,097,"Illinois","Lake County",2,75,3948,1847,2101
050,17,097,"Illinois","Lake County",2,76,3812,1784,2028
050,17,097,"Illinois","Lake County",2,77,3910,1778,2132
050,17,097,"Illinois","Lake County",2,78,3310,1496,1814
050,17,097,"Illinois","Lake County",2,79,2860,1279,1581
050,17,097,"Illinois","Lake County",2,80,2586,1132,1454
050,17,097,"Illinois","Lake County",2,81,2418,1030,1388
050,17,097,"Illinois","Lake County",2,82,2266,953,1313
050,17,097,"Illinois","Lake County",2,83,2029,850,1179
050,17,097,"Illinois","Lake County",2,84,1893,790,1103
050,17,097,"Illinois","Lake County",2,85,11792,4238,7554
050,17,097,"Illinois","Lake County",3,0,6615,3361,3254
050,17,097,"Illinois","Lake County",3,1,7278,3662,3616
050,17,097,"Illinois","Lake County",3,2,7786,3928,3858
050,17,097,"Illinois","Lake County",3,3,8107,4131,3976
050,17,097,"Illinois","Lake County",3,4,8458,4308,4150
050,17,097,"Illinois","Lake County",3,5,8926,4563,4363
050,17,097,"Illinois","Lake County",3,6,9014,4606,4408
050,17,097,"Illinois","Lake County",3,7,8974,4594,4380
050,17,097,"Illinois","Lake County",3,8,9081,4650,4431
050,17,097,"Illinois","Lake County",3,9,9284,4764,4520
050,17,097,"Illinois","Lake County",3,10,9540,4864,4676
050,17,097,"Illinois","Lake County",3,11,9978,5072,4906
050,17,097,"Illinois","Lake County",3,12,10311,5248,5063
050,17,097,"Illinois","Lake County",3,13,10809,5509,5300
050,17,097,"Illinois","Lake County",3,14,10943,5568,5375
050,17,097,"Illinois","Lake County",3,15,10947,5584,5363
050,17,097,"Illinois","Lake County",3,16,10914,5563,5351
050,17,097,"Illinois","Lake County",3,17,11237,5719,5518
050,17,097,"Illinois","Lake County",3,18,11193,6102,5091
050,17,097,"Illinois","Lake County",3,19,11328,6603,4725
050,17,097,"Illinois","Lake County",3,20,10980,6198,4782
050,17,097,"Illinois","Lake County",3,21,10587,5770,4817
050,17,097,"Illinois","Lake County",3,22,10187,5505,4682
050,17,097,"Illinois","Lake County",3,23,9454,5083,4371
050,17,097,"Illinois","Lake County",3,24,9078,4830,4248
050,17,097,"Illinois","Lake County",3,25,8637,4568,4069
050,17,097,"Illinois","Lake County",3,26,8460,4465,3995
050,17,097,"Illinois","Lake County",3,27,8149,4280,3869
050,17,097,"Illinois","Lake County",3,28,8055,4191,3864
050,17,097,"Illinois","Lake County",3,29,7963,4092,3871
050,17,097,"Illinois","Lake County",3,30,7795,4074,3721
050,17,097,"Illinois","Lake County",3,31,7656,3897,3759
050,17,097,"Illinois","Lake County",3,32,7646,3871,3775
050,17,097,"Illinois","Lake County",3,33,7991,4089,3902
050,17,097,"Illinois","Lake County",3,34,8270,4111,4159
050,17,097,"Illinois","Lake County",3,35,8602,4318,4284
050,17,097,"Illinois","Lake County",3,36,8748,4385,4363
050,17,097,"Illinois","Lake County",3,37,8923,4497,4426
050,17,097,"Illinois","Lake County",3,38,9084,4573,4511
050,17,097,"Illinois","Lake County",3,39,9283,4697,4586
050,17,097,"Illinois","Lake County",3,40,9379,4749,4630
050,17,097,"Illinois","Lake County",3,41,9496,4780,4716
050,17,097,"Illinois","Lake County",3,42,9349,4759,4590
050,17,097,"Illinois","Lake County",3,43,9264,4685,4579
050,17,097,"Illinois","Lake County",3,44,9229,4619,4610
050,17,097,"Illinois","Lake County",3,45,9048,4561,4487
050,17,097,"Illinois","Lake County",3,46,9067,4556,4511
050,17,097,"Illinois","Lake County",3,47,9007,4493,4514
050,17,097,"Illinois","Lake County",3,48,8966,4463,4503
050,17,097,"Illinois","Lake County",3,49,9530,4800,4730
050,17,097,"Illinois","Lake County",3,50,10096,5053,5043
050,17,097,"Illinois","Lake County",3,51,10156,5120,5036
050,17,097,"Illinois","Lake County",3,52,9682,4830,4852
050,17,097,"Illinois","Lake County",3,53,9502,4785,4717
050,17,097,"Illinois","Lake County",3,54,9619,4810,4809
050,17,097,"Illinois","Lake County",3,55,9698,4838,4860
050,17,097,"Illinois","Lake County",3,56,9902,4905,4997
050,17,097,"Illinois","Lake County",3,57,10066,5017,5049
050,17,097,"Illinois","Lake County",3,58,10005,4962,5043
050,17,097,"Illinois","Lake County",3,59,9946,4961,4985
050,17,097,"Illinois","Lake County",3,60,9888,4925,4963
050,17,097,"Illinois","Lake County",3,61,9649,4771,4878
050,17,097,"Illinois","Lake County",3,62,9404,4690,4714
050,17,097,"Illinois","Lake County",3,63,9201,4588,4613
050,17,097,"Illinois","Lake County",3,64,8820,4354,4466
050,17,097,"Illinois","Lake County",3,65,8112,4004,4108
050,17,097,"Illinois","Lake County",3,66,7835,3838,3997
050,17,097,"Illinois","Lake County",3,67,7353,3547,3806
050,17,097,"Illinois","Lake County",3,68,7066,3414,3652
050,17,097,"Illinois","Lake County",3,69,6748,3291,3457
050,17,097,"Illinois","Lake County",3,70,6361,3033,3328
050,17,097,"Illinois","Lake County",3,71,5908,2789,3119
050,17,097,"Illinois","Lake County",3,72,5641,2653,2988
050,17,097,"Illinois","Lake County",3,73,5546,2633,2913
050,17,097,"Illinois","Lake County",3,74,5835,2785,3050
050,17,097,"Illinois","Lake County",3,75,4074,1916,2158
050,17,097,"Illinois","Lake County",3,76,3822,1769,2053
050,17,097,"Illinois","Lake County",3,77,3717,1721,1996
050,17,097,"Illinois","Lake County",3,78,3757,1713,2044
050,17,097,"Illinois","Lake County",3,79,3223,1422,1801
050,17,097,"Illinois","Lake County",3,80,2750,1236,1514
050,17,097,"Illinois","Lake County",3,81,2480,1072,1408
050,17,097,"Illinois","Lake County",3,82,2300,963,1337
050,17,097,"Illinois","Lake County",3,83,2111,871,1240
050,17,097,"Illinois","Lake County",3,84,1846,768,1078
050,17,097,"Illinois","Lake County",3,85,11845,4253,7592
050,17,097,"Illinois","Lake County",4,0,6642,3324,3318
050,17,097,"Illinois","Lake County",4,1,6992,3535,3457
050,17,097,"Illinois","Lake County",4,2,7579,3823,3756
050,17,097,"Illinois","Lake County",4,3,8021,4083,3938
050,17,097,"Illinois","Lake County",4,4,8311,4261,4050
050,17,097,"Illinois","Lake County",4,5,8603,4383,4220
050,17,097,"Illinois","Lake County",4,6,9043,4626,4417
050,17,097,"Illinois","Lake County",4,7,9070,4607,4463
050,17,097,"Illinois","Lake County",4,8,9013,4590,4423
050,17,097,"Illinois","Lake County",4,9,9096,4670,4426
050,17,097,"Illinois","Lake County",4,10,9297,4789,4508
050,17,097,"Illinois","Lake County",4,11,9582,4866,4716
050,17,097,"Illinois","Lake County",4,12,10081,5177,4904
050,17,097,"Illinois","Lake County",4,13,10348,5285,5063
050,17,097,"Illinois","Lake County",4,14,10829,5535,5294
050,17,097,"Illinois","Lake County",4,15,10919,5540,5379
050,17,097,"Illinois","Lake County",4,16,10845,5507,5338
050,17,097,"Illinois","Lake County",4,17,10868,5569,5299
050,17,097,"Illinois","Lake County",4,18,11121,6050,5071
050,17,097,"Illinois","Lake County",4,19,11183,6468,4715
050,17,097,"Illinois","Lake County",4,20,10671,6059,4612
050,17,097,"Illinois","Lake County",4,21,10529,5802,4727
050,17,097,"Illinois","Lake County",4,22,10219,5469,4750
050,17,097,"Illinois","Lake County",4,23,9415,5034,4381
050,17,097,"Illinois","Lake County",4,24,8788,4717,4071
050,17,097,"Illinois","Lake County",4,25,8461,4457,4004
050,17,097,"Illinois","Lake County",4,26,8180,4323,3857
050,17,097,"Illinois","Lake County",4,27,8182,4335,3847
050,17,097,"Illinois","Lake County",4,28,7923,4144,3779
050,17,097,"Illinois","Lake County",4,29,7929,4053,3876
050,17,097,"Illinois","Lake County",4,30,7904,4032,3872
050,17,097,"Illinois","Lake County",4,31,7879,4019,3860
050,17,097,"Illinois","Lake County",4,32,7863,3984,3879
050,17,097,"Illinois","Lake County",4,33,7893,3981,3912
050,17,097,"Illinois","Lake County",4,34,8333,4240,4093
050,17,097,"Illinois","Lake County",4,35,8540,4236,4304
050,17,097,"Illinois","Lake County",4,36,8827,4438,4389
050,17,097,"Illinois","Lake County",4,37,8985,4534,4451
050,17,097,"Illinois","Lake County",4,38,9056,4585,4471
050,17,097,"Illinois","Lake County",4,39,9218,4631,4587
050,17,097,"Illinois","Lake County",4,40,9423,4780,4643
050,17,097,"Illinois","Lake County",4,41,9472,4802,4670
050,17,097,"Illinois","Lake County",4,42,9608,4837,4771
050,17,097,"Illinois","Lake County",4,43,9381,4767,4614
050,17,097,"Illinois","Lake County",4,44,9326,4728,4598
050,17,097,"Illinois","Lake County",4,45,9228,4641,4587
050,17,097,"Illinois","Lake County",4,46,8959,4501,4458
050,17,097,"Illinois","Lake County",4,47,8985,4502,4483
050,17,097,"Illinois","Lake County",4,48,8918,4462,4456
050,17,097,"Illinois","Lake County",4,49,8876,4423,4453
050,17,097,"Illinois","Lake County",4,50,9383,4707,4676
050,17,097,"Illinois","Lake County",4,51,10063,5042,5021
050,17,097,"Illinois","Lake County",4,52,10002,5040,4962
050,17,097,"Illinois","Lake County",4,53,9534,4761,4773
050,17,097,"Illinois","Lake County",4,54,9359,4703,4656
050,17,097,"Illinois","Lake County",4,55,9454,4751,4703
050,17,097,"Illinois","Lake County",4,56,9471,4726,4745
050,17,097,"Illinois","Lake County",4,57,9647,4786,4861
050,17,097,"Illinois","Lake County",4,58,9838,4890,4948
050,17,097,"Illinois","Lake County",4,59,9770,4866,4904
050,17,097,"Illinois","Lake County",4,60,9678,4798,4880
050,17,097,"Illinois","Lake County",4,61,9596,4750,4846
050,17,097,"Illinois","Lake County",4,62,9376,4649,4727
050,17,097,"Illinois","Lake County",4,63,9111,4544,4567
050,17,097,"Illinois","Lake County",4,64,8920,4417,4503
050,17,097,"Illinois","Lake County",4,65,8568,4260,4308
050,17,097,"Illinois","Lake County",4,66,7901,3875,4026
050,17,097,"Illinois","Lake County",4,67,7593,3684,3909
050,17,097,"Illinois","Lake County",4,68,7162,3438,3724
050,17,097,"Illinois","Lake County",4,69,6877,3310,3567
050,17,097,"Illinois","Lake County",4,70,6555,3165,3390
050,17,097,"Illinois","Lake County",4,71,6198,2939,3259
050,17,097,"Illinois","Lake County",4,72,5788,2707,3081
050,17,097,"Illinois","Lake County",4,73,5496,2564,2932
050,17,097,"Illinois","Lake County",4,74,5375,2530,2845
050,17,097,"Illinois","Lake County",4,75,5678,2718,2960
050,17,097,"Illinois","Lake County",4,76,3925,1814,2111
050,17,097,"Illinois","Lake County",4,77,3738,1717,2021
050,17,097,"Illinois","Lake County",4,78,3578,1663,1915
050,17,097,"Illinois","Lake County",4,79,3604,1611,1993
050,17,097,"Illinois","Lake County",4,80,3123,1377,1746
050,17,097,"Illinois","Lake County",4,81,2657,1170,1487
050,17,097,"Illinois","Lake County",4,82,2376,1023,1353
050,17,097,"Illinois","Lake County",4,83,2176,894,1282
050,17,097,"Illinois","Lake County",4,84,1963,794,1169
050,17,097,"Illinois","Lake County",4,85,11952,4306,7646
050,17,097,"Illinois","Lake County",5,0,6543,3275,3268
050,17,097,"Illinois","Lake County",5,1,6945,3462,3483
050,17,097,"Illinois","Lake County",5,2,7226,3647,3579
050,17,097,"Illinois","Lake County",5,3,7691,3914,3777
050,17,097,"Illinois","Lake County",5,4,8149,4153,3996
050,17,097,"Illinois","Lake County",5,5,8456,4297,4159
050,17,097,"Illinois","Lake County",5,6,8744,4457,4287
050,17,097,"Illinois","Lake County",5,7,9099,4661,4438
050,17,097,"Illinois","Lake County",5,8,9109,4625,4484
050,17,097,"Illinois","Lake County",5,9,9092,4610,4482
050,17,097,"Illinois","Lake County",5,10,9112,4675,4437
050,17,097,"Illinois","Lake County",5,11,9391,4832,4559
050,17,097,"Illinois","Lake County",5,12,9581,4885,4696
050,17,097,"Illinois","Lake County",5,13,10083,5165,4918
050,17,097,"Illinois","Lake County",5,14,10324,5273,5051
050,17,097,"Illinois","Lake County",5,15,10844,5536,5308
050,17,097,"Illinois","Lake County",5,16,10926,5532,5394
050,17,097,"Illinois","Lake County",5,17,10894,5561,5333
050,17,097,"Illinois","Lake County",5,18,10802,5863,4939
050,17,097,"Illinois","Lake County",5,19,11112,6351,4761
050,17,097,"Illinois","Lake County",5,20,10786,6054,4732
050,17,097,"Illinois","Lake County",5,21,10378,5712,4666
050,17,097,"Illinois","Lake County",5,22,10281,5550,4731
050,17,097,"Illinois","Lake County",5,23,9520,5058,4462
050,17,097,"Illinois","Lake County",5,24,8844,4748,4096
050,17,097,"Illinois","Lake County",5,25,8221,4388,3833
050,17,097,"Illinois","Lake County",5,26,8059,4224,3835
050,17,097,"Illinois","Lake County",5,27,7836,4145,3691
050,17,097,"Illinois","Lake County",5,28,8038,4236,3802
050,17,097,"Illinois","Lake County",5,29,7923,4070,3853
050,17,097,"Illinois","Lake County",5,30,7888,4029,3859
050,17,097,"Illinois","Lake County",5,31,7965,3997,3968
050,17,097,"Illinois","Lake County",5,32,8081,4108,3973
050,17,097,"Illinois","Lake County",5,33,7985,4017,3968
050,17,097,"Illinois","Lake County",5,34,8073,4053,4020
050,17,097,"Illinois","Lake County",5,35,8522,4339,4183
050,17,097,"Illinois","Lake County",5,36,8777,4362,4415
050,17,097,"Illinois","Lake County",5,37,9044,4570,4474
050,17,097,"Illinois","Lake County",5,38,9132,4605,4527
050,17,097,"Illinois","Lake County",5,39,9166,4655,4511
050,17,097,"Illinois","Lake County",5,40,9419,4730,4689
050,17,097,"Illinois","Lake County",5,41,9485,4812,4673
050,17,097,"Illinois","Lake County",5,42,9549,4861,4688
050,17,097,"Illinois","Lake County",5,43,9553,4788,4765
050,17,097,"Illinois","Lake County",5,44,9352,4735,4617
050,17,097,"Illinois","Lake County",5,45,9312,4732,4580
050,17,097,"Illinois","Lake County",5,46,9244,4639,4605
050,17,097,"Illinois","Lake County",5,47,8941,4496,4445
050,17,097,"Illinois","Lake County",5,48,8954,4484,4470
050,17,097,"Illinois","Lake County",5,49,8827,4437,4390
050,17,097,"Illinois","Lake County",5,50,8797,4400,4397
050,17,097,"Illinois","Lake County",5,51,9389,4711,4678
050,17,097,"Illinois","Lake County",5,52,9917,4992,4925
050,17,097,"Illinois","Lake County",5,53,9855,4955,4900
050,17,097,"Illinois","Lake County",5,54,9433,4723,4710
050,17,097,"Illinois","Lake County",5,55,9238,4654,4584
050,17,097,"Illinois","Lake County",5,56,9329,4699,4630
050,17,097,"Illinois","Lake County",5,57,9264,4638,4626
050,17,097,"Illinois","Lake County",5,58,9439,4704,4735
050,17,097,"Illinois","Lake County",5,59,9636,4779,4857
050,17,097,"Illinois","Lake County",5,60,9544,4722,4822
050,17,097,"Illinois","Lake County",5,61,9444,4685,4759
050,17,097,"Illinois","Lake County",5,62,9374,4657,4717
050,17,097,"Illinois","Lake County",5,63,9136,4531,4605
050,17,097,"Illinois","Lake County",5,64,8857,4401,4456
050,17,097,"Illinois","Lake County",5,65,8689,4294,4395
050,17,097,"Illinois","Lake County",5,66,8420,4189,4231
050,17,097,"Illinois","Lake County",5,67,7754,3781,3973
050,17,097,"Illinois","Lake County",5,68,7467,3631,3836
050,17,097,"Illinois","Lake County",5,69,7022,3348,3674
050,17,097,"Illinois","Lake County",5,70,6728,3225,3503
050,17,097,"Illinois","Lake County",5,71,6394,3072,3322
050,17,097,"Illinois","Lake County",5,72,6128,2889,3239
050,17,097,"Illinois","Lake County",5,73,5672,2637,3035
050,17,097,"Illinois","Lake County",5,74,5383,2497,2886
050,17,097,"Illinois","Lake County",5,75,5253,2473,2780
050,17,097,"Illinois","Lake County",5,76,5542,2623,2919
050,17,097,"Illinois","Lake County",5,77,3840,1784,2056
050,17,097,"Illinois","Lake County",5,78,3574,1647,1927
050,17,097,"Illinois","Lake County",5,79,3457,1571,1886
050,17,097,"Illinois","Lake County",5,80,3495,1572,1923
050,17,097,"Illinois","Lake County",5,81,3003,1298,1705
050,17,097,"Illinois","Lake County",5,82,2553,1121,1432
050,17,097,"Illinois","Lake County",5,83,2251,953,1298
050,17,097,"Illinois","Lake County",5,84,2021,838,1183
050,17,097,"Illinois","Lake County",5,85,12184,4389,7795
050,17,099,"Illinois","LaSalle County",1,0,1061,541,520
050,17,099,"Illinois","LaSalle County",1,1,1087,558,529
050,17,099,"Illinois","LaSalle County",1,2,1207,646,561
050,17,099,"Illinois","LaSalle County",1,3,1270,647,623
050,17,099,"Illinois","LaSalle County",1,4,1282,674,608
050,17,099,"Illinois","LaSalle County",1,5,1260,670,590
050,17,099,"Illinois","LaSalle County",1,6,1257,636,621
050,17,099,"Illinois","LaSalle County",1,7,1204,614,590
050,17,099,"Illinois","LaSalle County",1,8,1220,627,593
050,17,099,"Illinois","LaSalle County",1,9,1286,682,604
050,17,099,"Illinois","LaSalle County",1,10,1328,692,636
050,17,099,"Illinois","LaSalle County",1,11,1433,711,722
050,17,099,"Illinois","LaSalle County",1,12,1401,676,725
050,17,099,"Illinois","LaSalle County",1,13,1456,739,717
050,17,099,"Illinois","LaSalle County",1,14,1402,708,694
050,17,099,"Illinois","LaSalle County",1,15,1424,726,698
050,17,099,"Illinois","LaSalle County",1,16,1548,788,760
050,17,099,"Illinois","LaSalle County",1,17,1505,802,703
050,17,099,"Illinois","LaSalle County",1,18,1292,693,599
050,17,099,"Illinois","LaSalle County",1,19,1128,609,519
050,17,099,"Illinois","LaSalle County",1,20,1176,630,546
050,17,099,"Illinois","LaSalle County",1,21,1233,666,567
050,17,099,"Illinois","LaSalle County",1,22,1268,684,584
050,17,099,"Illinois","LaSalle County",1,23,1275,675,600
050,17,099,"Illinois","LaSalle County",1,24,1263,686,577
050,17,099,"Illinois","LaSalle County",1,25,1262,692,570
050,17,099,"Illinois","LaSalle County",1,26,1252,665,587
050,17,099,"Illinois","LaSalle County",1,27,1312,660,652
050,17,099,"Illinois","LaSalle County",1,28,1365,705,660
050,17,099,"Illinois","LaSalle County",1,29,1348,718,630
050,17,099,"Illinois","LaSalle County",1,30,1360,718,642
050,17,099,"Illinois","LaSalle County",1,31,1274,637,637
050,17,099,"Illinois","LaSalle County",1,32,1264,674,590
050,17,099,"Illinois","LaSalle County",1,33,1256,691,565
050,17,099,"Illinois","LaSalle County",1,34,1345,734,611
050,17,099,"Illinois","LaSalle County",1,35,1398,724,674
050,17,099,"Illinois","LaSalle County",1,36,1341,685,656
050,17,099,"Illinois","LaSalle County",1,37,1362,731,631
050,17,099,"Illinois","LaSalle County",1,38,1386,714,672
050,17,099,"Illinois","LaSalle County",1,39,1432,746,686
050,17,099,"Illinois","LaSalle County",1,40,1398,728,670
050,17,099,"Illinois","LaSalle County",1,41,1323,696,627
050,17,099,"Illinois","LaSalle County",1,42,1289,696,593
050,17,099,"Illinois","LaSalle County",1,43,1228,652,576
050,17,099,"Illinois","LaSalle County",1,44,1186,637,549
050,17,099,"Illinois","LaSalle County",1,45,1236,657,579
050,17,099,"Illinois","LaSalle County",1,46,1268,671,597
050,17,099,"Illinois","LaSalle County",1,47,1260,645,615
050,17,099,"Illinois","LaSalle County",1,48,1308,664,644
050,17,099,"Illinois","LaSalle County",1,49,1409,722,687
050,17,099,"Illinois","LaSalle County",1,50,1379,702,677
050,17,099,"Illinois","LaSalle County",1,51,1361,691,670
050,17,099,"Illinois","LaSalle County",1,52,1410,704,706
050,17,099,"Illinois","LaSalle County",1,53,1495,777,718
050,17,099,"Illinois","LaSalle County",1,54,1466,748,718
050,17,099,"Illinois","LaSalle County",1,55,1582,797,785
050,17,099,"Illinois","LaSalle County",1,56,1630,835,795
050,17,099,"Illinois","LaSalle County",1,57,1680,850,830
050,17,099,"Illinois","LaSalle County",1,58,1708,877,831
050,17,099,"Illinois","LaSalle County",1,59,1752,899,853
050,17,099,"Illinois","LaSalle County",1,60,1730,869,861
050,17,099,"Illinois","LaSalle County",1,61,1732,862,870
050,17,099,"Illinois","LaSalle County",1,62,1693,844,849
050,17,099,"Illinois","LaSalle County",1,63,1605,830,775
050,17,099,"Illinois","LaSalle County",1,64,1551,779,772
050,17,099,"Illinois","LaSalle County",1,65,1482,759,723
050,17,099,"Illinois","LaSalle County",1,66,1429,718,711
050,17,099,"Illinois","LaSalle County",1,67,1408,706,702
050,17,099,"Illinois","LaSalle County",1,68,1365,681,684
050,17,099,"Illinois","LaSalle County",1,69,1232,624,608
050,17,099,"Illinois","LaSalle County",1,70,1180,578,602
050,17,099,"Illinois","LaSalle County",1,71,1086,535,551
050,17,099,"Illinois","LaSalle County",1,72,1057,502,555
050,17,099,"Illinois","LaSalle County",1,73,1025,489,536
050,17,099,"Illinois","LaSalle County",1,74,758,364,394
050,17,099,"Illinois","LaSalle County",1,75,761,355,406
050,17,099,"Illinois","LaSalle County",1,76,798,360,438
050,17,099,"Illinois","LaSalle County",1,77,791,359,432
050,17,099,"Illinois","LaSalle County",1,78,694,320,374
050,17,099,"Illinois","LaSalle County",1,79,620,266,354
050,17,099,"Illinois","LaSalle County",1,80,564,227,337
050,17,099,"Illinois","LaSalle County",1,81,541,227,314
050,17,099,"Illinois","LaSalle County",1,82,511,228,283
050,17,099,"Illinois","LaSalle County",1,83,441,200,241
050,17,099,"Illinois","LaSalle County",1,84,426,180,246
050,17,099,"Illinois","LaSalle County",1,85,2579,908,1671
050,17,099,"Illinois","LaSalle County",2,0,1045,534,511
050,17,099,"Illinois","LaSalle County",2,1,1078,553,525
050,17,099,"Illinois","LaSalle County",2,2,1177,625,552
050,17,099,"Illinois","LaSalle County",2,3,1249,644,605
050,17,099,"Illinois","LaSalle County",2,4,1278,669,609
050,17,099,"Illinois","LaSalle County",2,5,1266,672,594
050,17,099,"Illinois","LaSalle County",2,6,1257,647,610
050,17,099,"Illinois","LaSalle County",2,7,1217,621,596
050,17,099,"Illinois","LaSalle County",2,8,1212,623,589
050,17,099,"Illinois","LaSalle County",2,9,1269,667,602
050,17,099,"Illinois","LaSalle County",2,10,1319,691,628
050,17,099,"Illinois","LaSalle County",2,11,1400,701,699
050,17,099,"Illinois","LaSalle County",2,12,1415,689,726
050,17,099,"Illinois","LaSalle County",2,13,1437,721,716
050,17,099,"Illinois","LaSalle County",2,14,1414,716,698
050,17,099,"Illinois","LaSalle County",2,15,1416,716,700
050,17,099,"Illinois","LaSalle County",2,16,1516,773,743
050,17,099,"Illinois","LaSalle County",2,17,1515,799,716
050,17,099,"Illinois","LaSalle County",2,18,1295,702,593
050,17,099,"Illinois","LaSalle County",2,19,1125,607,518
050,17,099,"Illinois","LaSalle County",2,20,1195,643,552
050,17,099,"Illinois","LaSalle County",2,21,1230,662,568
050,17,099,"Illinois","LaSalle County",2,22,1272,685,587
050,17,099,"Illinois","LaSalle County",2,23,1274,674,600
050,17,099,"Illinois","LaSalle County",2,24,1266,685,581
050,17,099,"Illinois","LaSalle County",2,25,1256,685,571
050,17,099,"Illinois","LaSalle County",2,26,1254,670,584
050,17,099,"Illinois","LaSalle County",2,27,1295,661,634
050,17,099,"Illinois","LaSalle County",2,28,1347,696,651
050,17,099,"Illinois","LaSalle County",2,29,1347,711,636
050,17,099,"Illinois","LaSalle County",2,30,1360,718,642
050,17,099,"Illinois","LaSalle County",2,31,1293,660,633
050,17,099,"Illinois","LaSalle County",2,32,1265,662,603
050,17,099,"Illinois","LaSalle County",2,33,1259,688,571
050,17,099,"Illinois","LaSalle County",2,34,1321,718,603
050,17,099,"Illinois","LaSalle County",2,35,1385,726,659
050,17,099,"Illinois","LaSalle County",2,36,1345,688,657
050,17,099,"Illinois","LaSalle County",2,37,1358,720,638
050,17,099,"Illinois","LaSalle County",2,38,1391,720,671
050,17,099,"Illinois","LaSalle County",2,39,1416,736,680
050,17,099,"Illinois","LaSalle County",2,40,1410,733,677
050,17,099,"Illinois","LaSalle County",2,41,1343,702,641
050,17,099,"Illinois","LaSalle County",2,42,1297,699,598
050,17,099,"Illinois","LaSalle County",2,43,1253,668,585
050,17,099,"Illinois","LaSalle County",2,44,1183,634,549
050,17,099,"Illinois","LaSalle County",2,45,1224,652,572
050,17,099,"Illinois","LaSalle County",2,46,1260,669,591
050,17,099,"Illinois","LaSalle County",2,47,1258,648,610
050,17,099,"Illinois","LaSalle County",2,48,1286,652,634
050,17,099,"Illinois","LaSalle County",2,49,1393,714,679
050,17,099,"Illinois","LaSalle County",2,50,1382,701,681
050,17,099,"Illinois","LaSalle County",2,51,1363,689,674
050,17,099,"Illinois","LaSalle County",2,52,1386,692,694
050,17,099,"Illinois","LaSalle County",2,53,1468,759,709
050,17,099,"Illinois","LaSalle County",2,54,1471,758,713
050,17,099,"Illinois","LaSalle County",2,55,1551,783,768
050,17,099,"Illinois","LaSalle County",2,56,1621,822,799
050,17,099,"Illinois","LaSalle County",2,57,1655,838,817
050,17,099,"Illinois","LaSalle County",2,58,1692,863,829
050,17,099,"Illinois","LaSalle County",2,59,1740,893,847
050,17,099,"Illinois","LaSalle County",2,60,1723,870,853
050,17,099,"Illinois","LaSalle County",2,61,1719,859,860
050,17,099,"Illinois","LaSalle County",2,62,1689,840,849
050,17,099,"Illinois","LaSalle County",2,63,1639,838,801
050,17,099,"Illinois","LaSalle County",2,64,1546,782,764
050,17,099,"Illinois","LaSalle County",2,65,1491,758,733
050,17,099,"Illinois","LaSalle County",2,66,1433,718,715
050,17,099,"Illinois","LaSalle County",2,67,1402,701,701
050,17,099,"Illinois","LaSalle County",2,68,1355,678,677
050,17,099,"Illinois","LaSalle County",2,69,1272,642,630
050,17,099,"Illinois","LaSalle County",2,70,1178,580,598
050,17,099,"Illinois","LaSalle County",2,71,1107,544,563
050,17,099,"Illinois","LaSalle County",2,72,1039,496,543
050,17,099,"Illinois","LaSalle County",2,73,1071,510,561
050,17,099,"Illinois","LaSalle County",2,74,759,362,397
050,17,099,"Illinois","LaSalle County",2,75,749,351,398
050,17,099,"Illinois","LaSalle County",2,76,785,356,429
050,17,099,"Illinois","LaSalle County",2,77,801,362,439
050,17,099,"Illinois","LaSalle County",2,78,699,320,379
050,17,099,"Illinois","LaSalle County",2,79,624,270,354
050,17,099,"Illinois","LaSalle County",2,80,570,234,336
050,17,099,"Illinois","LaSalle County",2,81,531,218,313
050,17,099,"Illinois","LaSalle County",2,82,514,228,286
050,17,099,"Illinois","LaSalle County",2,83,445,200,245
050,17,099,"Illinois","LaSalle County",2,84,420,179,241
050,17,099,"Illinois","LaSalle County",2,85,2584,918,1666
050,17,099,"Illinois","LaSalle County",3,0,1103,538,565
050,17,099,"Illinois","LaSalle County",3,1,1058,544,514
050,17,099,"Illinois","LaSalle County",3,2,1102,566,536
050,17,099,"Illinois","LaSalle County",3,3,1181,626,555
050,17,099,"Illinois","LaSalle County",3,4,1229,627,602
050,17,099,"Illinois","LaSalle County",3,5,1285,653,632
050,17,099,"Illinois","LaSalle County",3,6,1267,669,598
050,17,099,"Illinois","LaSalle County",3,7,1256,646,610
050,17,099,"Illinois","LaSalle County",3,8,1224,621,603
050,17,099,"Illinois","LaSalle County",3,9,1232,625,607
050,17,099,"Illinois","LaSalle County",3,10,1283,685,598
050,17,099,"Illinois","LaSalle County",3,11,1315,677,638
050,17,099,"Illinois","LaSalle County",3,12,1391,705,686
050,17,099,"Illinois","LaSalle County",3,13,1415,679,736
050,17,099,"Illinois","LaSalle County",3,14,1461,728,733
050,17,099,"Illinois","LaSalle County",3,15,1438,721,717
050,17,099,"Illinois","LaSalle County",3,16,1418,731,687
050,17,099,"Illinois","LaSalle County",3,17,1515,775,740
050,17,099,"Illinois","LaSalle County",3,18,1339,736,603
050,17,099,"Illinois","LaSalle County",3,19,1115,614,501
050,17,099,"Illinois","LaSalle County",3,20,1211,651,560
050,17,099,"Illinois","LaSalle County",3,21,1263,673,590
050,17,099,"Illinois","LaSalle County",3,22,1282,687,595
050,17,099,"Illinois","LaSalle County",3,23,1303,693,610
050,17,099,"Illinois","LaSalle County",3,24,1316,720,596
050,17,099,"Illinois","LaSalle County",3,25,1276,701,575
050,17,099,"Illinois","LaSalle County",3,26,1291,693,598
050,17,099,"Illinois","LaSalle County",3,27,1261,689,572
050,17,099,"Illinois","LaSalle County",3,28,1297,680,617
050,17,099,"Illinois","LaSalle County",3,29,1367,702,665
050,17,099,"Illinois","LaSalle County",3,30,1355,706,649
050,17,099,"Illinois","LaSalle County",3,31,1376,747,629
050,17,099,"Illinois","LaSalle County",3,32,1315,676,639
050,17,099,"Illinois","LaSalle County",3,33,1265,672,593
050,17,099,"Illinois","LaSalle County",3,34,1234,668,566
050,17,099,"Illinois","LaSalle County",3,35,1313,718,595
050,17,099,"Illinois","LaSalle County",3,36,1420,743,677
050,17,099,"Illinois","LaSalle County",3,37,1361,692,669
050,17,099,"Illinois","LaSalle County",3,38,1375,734,641
050,17,099,"Illinois","LaSalle County",3,39,1391,738,653
050,17,099,"Illinois","LaSalle County",3,40,1385,713,672
050,17,099,"Illinois","LaSalle County",3,41,1407,730,677
050,17,099,"Illinois","LaSalle County",3,42,1354,713,641
050,17,099,"Illinois","LaSalle County",3,43,1300,698,602
050,17,099,"Illinois","LaSalle County",3,44,1256,666,590
050,17,099,"Illinois","LaSalle County",3,45,1166,625,541
050,17,099,"Illinois","LaSalle County",3,46,1258,676,582
050,17,099,"Illinois","LaSalle County",3,47,1223,654,569
050,17,099,"Illinois","LaSalle County",3,48,1250,632,618
050,17,099,"Illinois","LaSalle County",3,49,1320,684,636
050,17,099,"Illinois","LaSalle County",3,50,1381,705,676
050,17,099,"Illinois","LaSalle County",3,51,1383,703,680
050,17,099,"Illinois","LaSalle County",3,52,1334,672,662
050,17,099,"Illinois","LaSalle County",3,53,1381,693,688
050,17,099,"Illinois","LaSalle County",3,54,1484,768,716
050,17,099,"Illinois","LaSalle County",3,55,1463,755,708
050,17,099,"Illinois","LaSalle County",3,56,1533,776,757
050,17,099,"Illinois","LaSalle County",3,57,1585,800,785
050,17,099,"Illinois","LaSalle County",3,58,1653,827,826
050,17,099,"Illinois","LaSalle County",3,59,1659,841,818
050,17,099,"Illinois","LaSalle County",3,60,1710,877,833
050,17,099,"Illinois","LaSalle County",3,61,1694,859,835
050,17,099,"Illinois","LaSalle County",3,62,1666,828,838
050,17,099,"Illinois","LaSalle County",3,63,1681,843,838
050,17,099,"Illinois","LaSalle County",3,64,1617,817,800
050,17,099,"Illinois","LaSalle County",3,65,1533,780,753
050,17,099,"Illinois","LaSalle County",3,66,1469,747,722
050,17,099,"Illinois","LaSalle County",3,67,1395,685,710
050,17,099,"Illinois","LaSalle County",3,68,1370,687,683
050,17,099,"Illinois","LaSalle County",3,69,1327,666,661
050,17,099,"Illinois","LaSalle County",3,70,1229,611,618
050,17,099,"Illinois","LaSalle County",3,71,1140,565,575
050,17,099,"Illinois","LaSalle County",3,72,1055,504,551
050,17,099,"Illinois","LaSalle County",3,73,1007,474,533
050,17,099,"Illinois","LaSalle County",3,74,1032,500,532
050,17,099,"Illinois","LaSalle County",3,75,722,333,389
050,17,099,"Illinois","LaSalle County",3,76,723,333,390
050,17,099,"Illinois","LaSalle County",3,77,746,338,408
050,17,099,"Illinois","LaSalle County",3,78,762,345,417
050,17,099,"Illinois","LaSalle County",3,79,663,297,366
050,17,099,"Illinois","LaSalle County",3,80,586,259,327
050,17,099,"Illinois","LaSalle County",3,81,524,215,309
050,17,099,"Illinois","LaSalle County",3,82,488,206,282
050,17,099,"Illinois","LaSalle County",3,83,478,207,271
050,17,099,"Illinois","LaSalle County",3,84,410,176,234
050,17,099,"Illinois","LaSalle County",3,85,2459,887,1572
050,17,099,"Illinois","LaSalle County",4,0,1114,544,570
050,17,099,"Illinois","LaSalle County",4,1,1120,525,595
050,17,099,"Illinois","LaSalle County",4,2,1076,542,534
050,17,099,"Illinois","LaSalle County",4,3,1108,573,535
050,17,099,"Illinois","LaSalle County",4,4,1197,625,572
050,17,099,"Illinois","LaSalle County",4,5,1259,637,622
050,17,099,"Illinois","LaSalle County",4,6,1293,660,633
050,17,099,"Illinois","LaSalle County",4,7,1259,666,593
050,17,099,"Illinois","LaSalle County",4,8,1261,640,621
050,17,099,"Illinois","LaSalle County",4,9,1221,624,597
050,17,099,"Illinois","LaSalle County",4,10,1252,635,617
050,17,099,"Illinois","LaSalle County",4,11,1262,672,590
050,17,099,"Illinois","LaSalle County",4,12,1322,675,647
050,17,099,"Illinois","LaSalle County",4,13,1398,703,695
050,17,099,"Illinois","LaSalle County",4,14,1418,690,728
050,17,099,"Illinois","LaSalle County",4,15,1469,729,740
050,17,099,"Illinois","LaSalle County",4,16,1413,707,706
050,17,099,"Illinois","LaSalle County",4,17,1402,714,688
050,17,099,"Illinois","LaSalle County",4,18,1318,708,610
050,17,099,"Illinois","LaSalle County",4,19,1095,620,475
050,17,099,"Illinois","LaSalle County",4,20,1184,651,533
050,17,099,"Illinois","LaSalle County",4,21,1240,665,575
050,17,099,"Illinois","LaSalle County",4,22,1288,679,609
050,17,099,"Illinois","LaSalle County",4,23,1275,667,608
050,17,099,"Illinois","LaSalle County",4,24,1292,692,600
050,17,099,"Illinois","LaSalle County",4,25,1261,669,592
050,17,099,"Illinois","LaSalle County",4,26,1227,661,566
050,17,099,"Illinois","LaSalle County",4,27,1279,687,592
050,17,099,"Illinois","LaSalle County",4,28,1265,684,581
050,17,099,"Illinois","LaSalle County",4,29,1248,644,604
050,17,099,"Illinois","LaSalle County",4,30,1330,673,657
050,17,099,"Illinois","LaSalle County",4,31,1387,725,662
050,17,099,"Illinois","LaSalle County",4,32,1377,731,646
050,17,099,"Illinois","LaSalle County",4,33,1316,671,645
050,17,099,"Illinois","LaSalle County",4,34,1246,653,593
050,17,099,"Illinois","LaSalle County",4,35,1223,655,568
050,17,099,"Illinois","LaSalle County",4,36,1303,699,604
050,17,099,"Illinois","LaSalle County",4,37,1411,739,672
050,17,099,"Illinois","LaSalle County",4,38,1340,677,663
050,17,099,"Illinois","LaSalle County",4,39,1376,727,649
050,17,099,"Illinois","LaSalle County",4,40,1362,707,655
050,17,099,"Illinois","LaSalle County",4,41,1378,703,675
050,17,099,"Illinois","LaSalle County",4,42,1404,741,663
050,17,099,"Illinois","LaSalle County",4,43,1331,691,640
050,17,099,"Illinois","LaSalle County",4,44,1299,703,596
050,17,099,"Illinois","LaSalle County",4,45,1223,636,587
050,17,099,"Illinois","LaSalle County",4,46,1164,622,542
050,17,099,"Illinois","LaSalle County",4,47,1234,672,562
050,17,099,"Illinois","LaSalle County",4,48,1192,623,569
050,17,099,"Illinois","LaSalle County",4,49,1253,652,601
050,17,099,"Illinois","LaSalle County",4,50,1296,670,626
050,17,099,"Illinois","LaSalle County",4,51,1369,701,668
050,17,099,"Illinois","LaSalle County",4,52,1338,664,674
050,17,099,"Illinois","LaSalle County",4,53,1324,664,660
050,17,099,"Illinois","LaSalle County",4,54,1388,697,691
050,17,099,"Illinois","LaSalle County",4,55,1480,774,706
050,17,099,"Illinois","LaSalle County",4,56,1438,731,707
050,17,099,"Illinois","LaSalle County",4,57,1506,756,750
050,17,099,"Illinois","LaSalle County",4,58,1567,789,778
050,17,099,"Illinois","LaSalle County",4,59,1626,821,805
050,17,099,"Illinois","LaSalle County",4,60,1634,823,811
050,17,099,"Illinois","LaSalle County",4,61,1670,857,813
050,17,099,"Illinois","LaSalle County",4,62,1658,835,823
050,17,099,"Illinois","LaSalle County",4,63,1660,815,845
050,17,099,"Illinois","LaSalle County",4,64,1677,842,835
050,17,099,"Illinois","LaSalle County",4,65,1591,800,791
050,17,099,"Illinois","LaSalle County",4,66,1515,770,745
050,17,099,"Illinois","LaSalle County",4,67,1452,731,721
050,17,099,"Illinois","LaSalle County",4,68,1370,673,697
050,17,099,"Illinois","LaSalle County",4,69,1344,685,659
050,17,099,"Illinois","LaSalle County",4,70,1282,637,645
050,17,099,"Illinois","LaSalle County",4,71,1176,578,598
050,17,099,"Illinois","LaSalle County",4,72,1092,530,562
050,17,099,"Illinois","LaSalle County",4,73,1025,485,540
050,17,099,"Illinois","LaSalle County",4,74,968,462,506
050,17,099,"Illinois","LaSalle County",4,75,983,470,513
050,17,099,"Illinois","LaSalle County",4,76,689,315,374
050,17,099,"Illinois","LaSalle County",4,77,675,310,365
050,17,099,"Illinois","LaSalle County",4,78,728,335,393
050,17,099,"Illinois","LaSalle County",4,79,714,309,405
050,17,099,"Illinois","LaSalle County",4,80,628,285,343
050,17,099,"Illinois","LaSalle County",4,81,539,236,303
050,17,099,"Illinois","LaSalle County",4,82,489,199,290
050,17,099,"Illinois","LaSalle County",4,83,450,186,264
050,17,099,"Illinois","LaSalle County",4,84,452,195,257
050,17,099,"Illinois","LaSalle County",4,85,2423,906,1517
050,17,099,"Illinois","LaSalle County",5,0,1111,542,569
050,17,099,"Illinois","LaSalle County",5,1,1131,561,570
050,17,099,"Illinois","LaSalle County",5,2,1127,536,591
050,17,099,"Illinois","LaSalle County",5,3,1107,576,531
050,17,099,"Illinois","LaSalle County",5,4,1132,585,547
050,17,099,"Illinois","LaSalle County",5,5,1216,634,582
050,17,099,"Illinois","LaSalle County",5,6,1283,653,630
050,17,099,"Illinois","LaSalle County",5,7,1315,682,633
050,17,099,"Illinois","LaSalle County",5,8,1289,674,615
050,17,099,"Illinois","LaSalle County",5,9,1288,651,637
050,17,099,"Illinois","LaSalle County",5,10,1251,642,609
050,17,099,"Illinois","LaSalle County",5,11,1260,650,610
050,17,099,"Illinois","LaSalle County",5,12,1286,682,604
050,17,099,"Illinois","LaSalle County",5,13,1327,674,653
050,17,099,"Illinois","LaSalle County",5,14,1393,707,686
050,17,099,"Illinois","LaSalle County",5,15,1413,690,723
050,17,099,"Illinois","LaSalle County",5,16,1482,733,749
050,17,099,"Illinois","LaSalle County",5,17,1421,715,706
050,17,099,"Illinois","LaSalle County",5,18,1242,673,569
050,17,099,"Illinois","LaSalle County",5,19,1113,613,500
050,17,099,"Illinois","LaSalle County",5,20,1179,666,513
050,17,099,"Illinois","LaSalle County",5,21,1246,678,568
050,17,099,"Illinois","LaSalle County",5,22,1306,686,620
050,17,099,"Illinois","LaSalle County",5,23,1281,681,600
050,17,099,"Illinois","LaSalle County",5,24,1291,699,592
050,17,099,"Illinois","LaSalle County",5,25,1273,681,592
050,17,099,"Illinois","LaSalle County",5,26,1231,654,577
050,17,099,"Illinois","LaSalle County",5,27,1244,671,573
050,17,099,"Illinois","LaSalle County",5,28,1309,705,604
050,17,099,"Illinois","LaSalle County",5,29,1271,675,596
050,17,099,"Illinois","LaSalle County",5,30,1236,645,591
050,17,099,"Illinois","LaSalle County",5,31,1358,697,661
050,17,099,"Illinois","LaSalle County",5,32,1409,742,667
050,17,099,"Illinois","LaSalle County",5,33,1390,740,650
050,17,099,"Illinois","LaSalle County",5,34,1324,671,653
050,17,099,"Illinois","LaSalle County",5,35,1246,651,595
050,17,099,"Illinois","LaSalle County",5,36,1245,659,586
050,17,099,"Illinois","LaSalle County",5,37,1279,688,591
050,17,099,"Illinois","LaSalle County",5,38,1407,728,679
050,17,099,"Illinois","LaSalle County",5,39,1374,701,673
050,17,099,"Illinois","LaSalle County",5,40,1364,718,646
050,17,099,"Illinois","LaSalle County",5,41,1368,714,654
050,17,099,"Illinois","LaSalle County",5,42,1400,726,674
050,17,099,"Illinois","LaSalle County",5,43,1424,760,664
050,17,099,"Illinois","LaSalle County",5,44,1327,690,637
050,17,099,"Illinois","LaSalle County",5,45,1257,667,590
050,17,099,"Illinois","LaSalle County",5,46,1240,647,593
050,17,099,"Illinois","LaSalle County",5,47,1171,625,546
050,17,099,"Illinois","LaSalle County",5,48,1208,635,573
050,17,099,"Illinois","LaSalle County",5,49,1217,645,572
050,17,099,"Illinois","LaSalle County",5,50,1239,630,609
050,17,099,"Illinois","LaSalle County",5,51,1298,672,626
050,17,099,"Illinois","LaSalle County",5,52,1353,688,665
050,17,099,"Illinois","LaSalle County",5,53,1345,677,668
050,17,099,"Illinois","LaSalle County",5,54,1335,666,669
050,17,099,"Illinois","LaSalle County",5,55,1389,695,694
050,17,099,"Illinois","LaSalle County",5,56,1480,773,707
050,17,099,"Illinois","LaSalle County",5,57,1413,710,703
050,17,099,"Illinois","LaSalle County",5,58,1495,755,740
050,17,099,"Illinois","LaSalle County",5,59,1549,779,770
050,17,099,"Illinois","LaSalle County",5,60,1589,797,792
050,17,099,"Illinois","LaSalle County",5,61,1607,816,791
050,17,099,"Illinois","LaSalle County",5,62,1632,836,796
050,17,099,"Illinois","LaSalle County",5,63,1647,823,824
050,17,099,"Illinois","LaSalle County",5,64,1643,801,842
050,17,099,"Illinois","LaSalle County",5,65,1649,824,825
050,17,099,"Illinois","LaSalle County",5,66,1571,784,787
050,17,099,"Illinois","LaSalle County",5,67,1497,759,738
050,17,099,"Illinois","LaSalle County",5,68,1431,718,713
050,17,099,"Illinois","LaSalle County",5,69,1361,672,689
050,17,099,"Illinois","LaSalle County",5,70,1303,660,643
050,17,099,"Illinois","LaSalle County",5,71,1243,612,631
050,17,099,"Illinois","LaSalle County",5,72,1141,552,589
050,17,099,"Illinois","LaSalle County",5,73,1069,511,558
050,17,099,"Illinois","LaSalle County",5,74,988,477,511
050,17,099,"Illinois","LaSalle County",5,75,918,426,492
050,17,099,"Illinois","LaSalle County",5,76,932,441,491
050,17,099,"Illinois","LaSalle County",5,77,660,300,360
050,17,099,"Illinois","LaSalle County",5,78,660,308,352
050,17,099,"Illinois","LaSalle County",5,79,691,308,383
050,17,099,"Illinois","LaSalle County",5,80,684,298,386
050,17,099,"Illinois","LaSalle County",5,81,582,268,314
050,17,099,"Illinois","LaSalle County",5,82,510,226,284
050,17,099,"Illinois","LaSalle County",5,83,448,183,265
050,17,099,"Illinois","LaSalle County",5,84,418,168,250
050,17,099,"Illinois","LaSalle County",5,85,2477,962,1515
050,17,101,"Illinois","Lawrence County",1,0,139,70,69
050,17,101,"Illinois","Lawrence County",1,1,139,61,78
050,17,101,"Illinois","Lawrence County",1,2,141,68,73
050,17,101,"Illinois","Lawrence County",1,3,141,67,74
050,17,101,"Illinois","Lawrence County",1,4,159,89,70
050,17,101,"Illinois","Lawrence County",1,5,181,101,80
050,17,101,"Illinois","Lawrence County",1,6,174,85,89
050,17,101,"Illinois","Lawrence County",1,7,159,74,85
050,17,101,"Illinois","Lawrence County",1,8,178,85,93
050,17,101,"Illinois","Lawrence County",1,9,147,74,73
050,17,101,"Illinois","Lawrence County",1,10,171,85,86
050,17,101,"Illinois","Lawrence County",1,11,181,95,86
050,17,101,"Illinois","Lawrence County",1,12,173,92,81
050,17,101,"Illinois","Lawrence County",1,13,182,94,88
050,17,101,"Illinois","Lawrence County",1,14,172,93,79
050,17,101,"Illinois","Lawrence County",1,15,168,88,80
050,17,101,"Illinois","Lawrence County",1,16,162,80,82
050,17,101,"Illinois","Lawrence County",1,17,176,89,87
050,17,101,"Illinois","Lawrence County",1,18,154,92,62
050,17,101,"Illinois","Lawrence County",1,19,141,92,49
050,17,101,"Illinois","Lawrence County",1,20,151,100,51
050,17,101,"Illinois","Lawrence County",1,21,198,142,56
050,17,101,"Illinois","Lawrence County",1,22,205,146,59
050,17,101,"Illinois","Lawrence County",1,23,220,142,78
050,17,101,"Illinois","Lawrence County",1,24,221,147,74
050,17,101,"Illinois","Lawrence County",1,25,221,149,72
050,17,101,"Illinois","Lawrence County",1,26,226,151,75
050,17,101,"Illinois","Lawrence County",1,27,248,165,83
050,17,101,"Illinois","Lawrence County",1,28,248,169,79
050,17,101,"Illinois","Lawrence County",1,29,253,166,87
050,17,101,"Illinois","Lawrence County",1,30,217,140,77
050,17,101,"Illinois","Lawrence County",1,31,213,141,72
050,17,101,"Illinois","Lawrence County",1,32,201,134,67
050,17,101,"Illinois","Lawrence County",1,33,198,128,70
050,17,101,"Illinois","Lawrence County",1,34,224,143,81
050,17,101,"Illinois","Lawrence County",1,35,199,123,76
050,17,101,"Illinois","Lawrence County",1,36,213,134,79
050,17,101,"Illinois","Lawrence County",1,37,208,132,76
050,17,101,"Illinois","Lawrence County",1,38,199,123,76
050,17,101,"Illinois","Lawrence County",1,39,228,152,76
050,17,101,"Illinois","Lawrence County",1,40,206,131,75
050,17,101,"Illinois","Lawrence County",1,41,237,144,93
050,17,101,"Illinois","Lawrence County",1,42,213,123,90
050,17,101,"Illinois","Lawrence County",1,43,205,110,95
050,17,101,"Illinois","Lawrence County",1,44,218,143,75
050,17,101,"Illinois","Lawrence County",1,45,178,112,66
050,17,101,"Illinois","Lawrence County",1,46,189,120,69
050,17,101,"Illinois","Lawrence County",1,47,216,130,86
050,17,101,"Illinois","Lawrence County",1,48,188,107,81
050,17,101,"Illinois","Lawrence County",1,49,203,118,85
050,17,101,"Illinois","Lawrence County",1,50,215,141,74
050,17,101,"Illinois","Lawrence County",1,51,206,132,74
050,17,101,"Illinois","Lawrence County",1,52,157,88,69
050,17,101,"Illinois","Lawrence County",1,53,156,82,74
050,17,101,"Illinois","Lawrence County",1,54,192,96,96
050,17,101,"Illinois","Lawrence County",1,55,189,97,92
050,17,101,"Illinois","Lawrence County",1,56,196,104,92
050,17,101,"Illinois","Lawrence County",1,57,213,107,106
050,17,101,"Illinois","Lawrence County",1,58,218,102,116
050,17,101,"Illinois","Lawrence County",1,59,216,108,108
050,17,101,"Illinois","Lawrence County",1,60,214,104,110
050,17,101,"Illinois","Lawrence County",1,61,196,89,107
050,17,101,"Illinois","Lawrence County",1,62,219,103,116
050,17,101,"Illinois","Lawrence County",1,63,205,96,109
050,17,101,"Illinois","Lawrence County",1,64,171,82,89
050,17,101,"Illinois","Lawrence County",1,65,191,98,93
050,17,101,"Illinois","Lawrence County",1,66,178,85,93
050,17,101,"Illinois","Lawrence County",1,67,168,81,87
050,17,101,"Illinois","Lawrence County",1,68,166,77,89
050,17,101,"Illinois","Lawrence County",1,69,155,74,81
050,17,101,"Illinois","Lawrence County",1,70,160,71,89
050,17,101,"Illinois","Lawrence County",1,71,135,70,65
050,17,101,"Illinois","Lawrence County",1,72,149,72,77
050,17,101,"Illinois","Lawrence County",1,73,151,75,76
050,17,101,"Illinois","Lawrence County",1,74,112,48,64
050,17,101,"Illinois","Lawrence County",1,75,101,41,60
050,17,101,"Illinois","Lawrence County",1,76,95,49,46
050,17,101,"Illinois","Lawrence County",1,77,103,49,54
050,17,101,"Illinois","Lawrence County",1,78,102,38,64
050,17,101,"Illinois","Lawrence County",1,79,84,35,49
050,17,101,"Illinois","Lawrence County",1,80,79,34,45
050,17,101,"Illinois","Lawrence County",1,81,84,32,52
050,17,101,"Illinois","Lawrence County",1,82,76,24,52
050,17,101,"Illinois","Lawrence County",1,83,66,23,43
050,17,101,"Illinois","Lawrence County",1,84,54,18,36
050,17,101,"Illinois","Lawrence County",1,85,338,117,221
050,17,101,"Illinois","Lawrence County",2,0,138,68,70
050,17,101,"Illinois","Lawrence County",2,1,137,61,76
050,17,101,"Illinois","Lawrence County",2,2,138,65,73
050,17,101,"Illinois","Lawrence County",2,3,140,67,73
050,17,101,"Illinois","Lawrence County",2,4,155,83,72
050,17,101,"Illinois","Lawrence County",2,5,175,98,77
050,17,101,"Illinois","Lawrence County",2,6,178,91,87
050,17,101,"Illinois","Lawrence County",2,7,164,77,87
050,17,101,"Illinois","Lawrence County",2,8,171,81,90
050,17,101,"Illinois","Lawrence County",2,9,151,74,77
050,17,101,"Illinois","Lawrence County",2,10,164,81,83
050,17,101,"Illinois","Lawrence County",2,11,178,93,85
050,17,101,"Illinois","Lawrence County",2,12,177,94,83
050,17,101,"Illinois","Lawrence County",2,13,178,92,86
050,17,101,"Illinois","Lawrence County",2,14,174,92,82
050,17,101,"Illinois","Lawrence County",2,15,169,87,82
050,17,101,"Illinois","Lawrence County",2,16,164,83,81
050,17,101,"Illinois","Lawrence County",2,17,171,85,86
050,17,101,"Illinois","Lawrence County",2,18,153,90,63
050,17,101,"Illinois","Lawrence County",2,19,143,93,50
050,17,101,"Illinois","Lawrence County",2,20,154,101,53
050,17,101,"Illinois","Lawrence County",2,21,195,140,55
050,17,101,"Illinois","Lawrence County",2,22,207,146,61
050,17,101,"Illinois","Lawrence County",2,23,216,140,76
050,17,101,"Illinois","Lawrence County",2,24,220,146,74
050,17,101,"Illinois","Lawrence County",2,25,225,151,74
050,17,101,"Illinois","Lawrence County",2,26,224,149,75
050,17,101,"Illinois","Lawrence County",2,27,249,167,82
050,17,101,"Illinois","Lawrence County",2,28,246,166,80
050,17,101,"Illinois","Lawrence County",2,29,253,167,86
050,17,101,"Illinois","Lawrence County",2,30,222,144,78
050,17,101,"Illinois","Lawrence County",2,31,211,140,71
050,17,101,"Illinois","Lawrence County",2,32,202,135,67
050,17,101,"Illinois","Lawrence County",2,33,195,126,69
050,17,101,"Illinois","Lawrence County",2,34,219,139,80
050,17,101,"Illinois","Lawrence County",2,35,206,127,79
050,17,101,"Illinois","Lawrence County",2,36,213,134,79
050,17,101,"Illinois","Lawrence County",2,37,207,129,78
050,17,101,"Illinois","Lawrence County",2,38,199,124,75
050,17,101,"Illinois","Lawrence County",2,39,225,149,76
050,17,101,"Illinois","Lawrence County",2,40,207,131,76
050,17,101,"Illinois","Lawrence County",2,41,232,142,90
050,17,101,"Illinois","Lawrence County",2,42,215,128,87
050,17,101,"Illinois","Lawrence County",2,43,206,111,95
050,17,101,"Illinois","Lawrence County",2,44,212,137,75
050,17,101,"Illinois","Lawrence County",2,45,184,116,68
050,17,101,"Illinois","Lawrence County",2,46,187,119,68
050,17,101,"Illinois","Lawrence County",2,47,207,125,82
050,17,101,"Illinois","Lawrence County",2,48,193,111,82
050,17,101,"Illinois","Lawrence County",2,49,201,117,84
050,17,101,"Illinois","Lawrence County",2,50,216,140,76
050,17,101,"Illinois","Lawrence County",2,51,206,133,73
050,17,101,"Illinois","Lawrence County",2,52,161,93,68
050,17,101,"Illinois","Lawrence County",2,53,153,80,73
050,17,101,"Illinois","Lawrence County",2,54,186,94,92
050,17,101,"Illinois","Lawrence County",2,55,186,95,91
050,17,101,"Illinois","Lawrence County",2,56,193,101,92
050,17,101,"Illinois","Lawrence County",2,57,209,107,102
050,17,101,"Illinois","Lawrence County",2,58,216,101,115
050,17,101,"Illinois","Lawrence County",2,59,217,108,109
050,17,101,"Illinois","Lawrence County",2,60,213,102,111
050,17,101,"Illinois","Lawrence County",2,61,197,91,106
050,17,101,"Illinois","Lawrence County",2,62,214,101,113
050,17,101,"Illinois","Lawrence County",2,63,205,96,109
050,17,101,"Illinois","Lawrence County",2,64,176,83,93
050,17,101,"Illinois","Lawrence County",2,65,185,94,91
050,17,101,"Illinois","Lawrence County",2,66,184,89,95
050,17,101,"Illinois","Lawrence County",2,67,168,80,88
050,17,101,"Illinois","Lawrence County",2,68,166,78,88
050,17,101,"Illinois","Lawrence County",2,69,159,76,83
050,17,101,"Illinois","Lawrence County",2,70,162,72,90
050,17,101,"Illinois","Lawrence County",2,71,139,69,70
050,17,101,"Illinois","Lawrence County",2,72,143,71,72
050,17,101,"Illinois","Lawrence County",2,73,156,78,78
050,17,101,"Illinois","Lawrence County",2,74,113,50,63
050,17,101,"Illinois","Lawrence County",2,75,104,43,61
050,17,101,"Illinois","Lawrence County",2,76,97,49,48
050,17,101,"Illinois","Lawrence County",2,77,104,49,55
050,17,101,"Illinois","Lawrence County",2,78,99,39,60
050,17,101,"Illinois","Lawrence County",2,79,87,35,52
050,17,101,"Illinois","Lawrence County",2,80,78,34,44
050,17,101,"Illinois","Lawrence County",2,81,83,32,51
050,17,101,"Illinois","Lawrence County",2,82,79,25,54
050,17,101,"Illinois","Lawrence County",2,83,67,23,44
050,17,101,"Illinois","Lawrence County",2,84,55,18,37
050,17,101,"Illinois","Lawrence County",2,85,342,119,223
050,17,101,"Illinois","Lawrence County",3,0,145,73,72
050,17,101,"Illinois","Lawrence County",3,1,135,63,72
050,17,101,"Illinois","Lawrence County",3,2,136,65,71
050,17,101,"Illinois","Lawrence County",3,3,139,68,71
050,17,101,"Illinois","Lawrence County",3,4,149,74,75
050,17,101,"Illinois","Lawrence County",3,5,146,80,66
050,17,101,"Illinois","Lawrence County",3,6,172,102,70
050,17,101,"Illinois","Lawrence County",3,7,175,91,84
050,17,101,"Illinois","Lawrence County",3,8,157,75,82
050,17,101,"Illinois","Lawrence County",3,9,170,76,94
050,17,101,"Illinois","Lawrence County",3,10,152,73,79
050,17,101,"Illinois","Lawrence County",3,11,163,80,83
050,17,101,"Illinois","Lawrence County",3,12,174,94,80
050,17,101,"Illinois","Lawrence County",3,13,165,88,77
050,17,101,"Illinois","Lawrence County",3,14,178,91,87
050,17,101,"Illinois","Lawrence County",3,15,175,97,78
050,17,101,"Illinois","Lawrence County",3,16,164,88,76
050,17,101,"Illinois","Lawrence County",3,17,167,89,78
050,17,101,"Illinois","Lawrence County",3,18,161,89,72
050,17,101,"Illinois","Lawrence County",3,19,139,92,47
050,17,101,"Illinois","Lawrence County",3,20,164,115,49
050,17,101,"Illinois","Lawrence County",3,21,187,137,50
050,17,101,"Illinois","Lawrence County",3,22,208,147,61
050,17,101,"Illinois","Lawrence County",3,23,204,138,66
050,17,101,"Illinois","Lawrence County",3,24,226,151,75
050,17,101,"Illinois","Lawrence County",3,25,222,149,73
050,17,101,"Illinois","Lawrence County",3,26,225,154,71
050,17,101,"Illinois","Lawrence County",3,27,254,174,80
050,17,101,"Illinois","Lawrence County",3,28,233,160,73
050,17,101,"Illinois","Lawrence County",3,29,232,163,69
050,17,101,"Illinois","Lawrence County",3,30,247,161,86
050,17,101,"Illinois","Lawrence County",3,31,227,152,75
050,17,101,"Illinois","Lawrence County",3,32,215,148,67
050,17,101,"Illinois","Lawrence County",3,33,197,124,73
050,17,101,"Illinois","Lawrence County",3,34,206,138,68
050,17,101,"Illinois","Lawrence County",3,35,216,139,77
050,17,101,"Illinois","Lawrence County",3,36,222,143,79
050,17,101,"Illinois","Lawrence County",3,37,203,126,77
050,17,101,"Illinois","Lawrence County",3,38,203,127,76
050,17,101,"Illinois","Lawrence County",3,39,225,152,73
050,17,101,"Illinois","Lawrence County",3,40,209,132,77
050,17,101,"Illinois","Lawrence County",3,41,229,143,86
050,17,101,"Illinois","Lawrence County",3,42,227,149,78
050,17,101,"Illinois","Lawrence County",3,43,203,112,91
050,17,101,"Illinois","Lawrence County",3,44,215,125,90
050,17,101,"Illinois","Lawrence County",3,45,195,121,74
050,17,101,"Illinois","Lawrence County",3,46,192,126,66
050,17,101,"Illinois","Lawrence County",3,47,179,114,65
050,17,101,"Illinois","Lawrence County",3,48,198,123,75
050,17,101,"Illinois","Lawrence County",3,49,199,115,84
050,17,101,"Illinois","Lawrence County",3,50,214,136,78
050,17,101,"Illinois","Lawrence County",3,51,216,141,75
050,17,101,"Illinois","Lawrence County",3,52,192,116,76
050,17,101,"Illinois","Lawrence County",3,53,149,82,67
050,17,101,"Illinois","Lawrence County",3,54,172,86,86
050,17,101,"Illinois","Lawrence County",3,55,169,86,83
050,17,101,"Illinois","Lawrence County",3,56,187,101,86
050,17,101,"Illinois","Lawrence County",3,57,185,98,87
050,17,101,"Illinois","Lawrence County",3,58,206,105,101
050,17,101,"Illinois","Lawrence County",3,59,213,103,110
050,17,101,"Illinois","Lawrence County",3,60,218,106,112
050,17,101,"Illinois","Lawrence County",3,61,203,103,100
050,17,101,"Illinois","Lawrence County",3,62,201,93,108
050,17,101,"Illinois","Lawrence County",3,63,205,96,109
050,17,101,"Illinois","Lawrence County",3,64,204,91,113
050,17,101,"Illinois","Lawrence County",3,65,164,79,85
050,17,101,"Illinois","Lawrence County",3,66,178,91,87
050,17,101,"Illinois","Lawrence County",3,67,180,89,91
050,17,101,"Illinois","Lawrence County",3,68,164,78,86
050,17,101,"Illinois","Lawrence County",3,69,164,75,89
050,17,101,"Illinois","Lawrence County",3,70,169,77,92
050,17,101,"Illinois","Lawrence County",3,71,146,63,83
050,17,101,"Illinois","Lawrence County",3,72,137,69,68
050,17,101,"Illinois","Lawrence County",3,73,138,70,68
050,17,101,"Illinois","Lawrence County",3,74,145,70,75
050,17,101,"Illinois","Lawrence County",3,75,111,48,63
050,17,101,"Illinois","Lawrence County",3,76,104,49,55
050,17,101,"Illinois","Lawrence County",3,77,90,40,50
050,17,101,"Illinois","Lawrence County",3,78,99,44,55
050,17,101,"Illinois","Lawrence County",3,79,94,38,56
050,17,101,"Illinois","Lawrence County",3,80,78,36,42
050,17,101,"Illinois","Lawrence County",3,81,78,34,44
050,17,101,"Illinois","Lawrence County",3,82,85,28,57
050,17,101,"Illinois","Lawrence County",3,83,70,28,42
050,17,101,"Illinois","Lawrence County",3,84,58,16,42
050,17,101,"Illinois","Lawrence County",3,85,318,107,211
050,17,101,"Illinois","Lawrence County",4,0,100,49,51
050,17,101,"Illinois","Lawrence County",4,1,144,70,74
050,17,101,"Illinois","Lawrence County",4,2,124,59,65
050,17,101,"Illinois","Lawrence County",4,3,128,59,69
050,17,101,"Illinois","Lawrence County",4,4,141,67,74
050,17,101,"Illinois","Lawrence County",4,5,141,64,77
050,17,101,"Illinois","Lawrence County",4,6,141,81,60
050,17,101,"Illinois","Lawrence County",4,7,173,101,72
050,17,101,"Illinois","Lawrence County",4,8,169,88,81
050,17,101,"Illinois","Lawrence County",4,9,163,76,87
050,17,101,"Illinois","Lawrence County",4,10,163,71,92
050,17,101,"Illinois","Lawrence County",4,11,154,74,80
050,17,101,"Illinois","Lawrence County",4,12,164,81,83
050,17,101,"Illinois","Lawrence County",4,13,176,93,83
050,17,101,"Illinois","Lawrence County",4,14,165,88,77
050,17,101,"Illinois","Lawrence County",4,15,175,90,85
050,17,101,"Illinois","Lawrence County",4,16,166,91,75
050,17,101,"Illinois","Lawrence County",4,17,171,86,85
050,17,101,"Illinois","Lawrence County",4,18,156,97,59
050,17,101,"Illinois","Lawrence County",4,19,145,92,53
050,17,101,"Illinois","Lawrence County",4,20,152,106,46
050,17,101,"Illinois","Lawrence County",4,21,198,148,50
050,17,101,"Illinois","Lawrence County",4,22,187,137,50
050,17,101,"Illinois","Lawrence County",4,23,192,128,64
050,17,101,"Illinois","Lawrence County",4,24,203,143,60
050,17,101,"Illinois","Lawrence County",4,25,218,139,79
050,17,101,"Illinois","Lawrence County",4,26,191,131,60
050,17,101,"Illinois","Lawrence County",4,27,222,157,65
050,17,101,"Illinois","Lawrence County",4,28,232,153,79
050,17,101,"Illinois","Lawrence County",4,29,230,151,79
050,17,101,"Illinois","Lawrence County",4,30,218,148,70
050,17,101,"Illinois","Lawrence County",4,31,243,156,87
050,17,101,"Illinois","Lawrence County",4,32,213,145,68
050,17,101,"Illinois","Lawrence County",4,33,196,129,67
050,17,101,"Illinois","Lawrence County",4,34,190,126,64
050,17,101,"Illinois","Lawrence County",4,35,196,128,68
050,17,101,"Illinois","Lawrence County",4,36,236,157,79
050,17,101,"Illinois","Lawrence County",4,37,213,133,80
050,17,101,"Illinois","Lawrence County",4,38,199,114,85
050,17,101,"Illinois","Lawrence County",4,39,220,145,75
050,17,101,"Illinois","Lawrence County",4,40,206,134,72
050,17,101,"Illinois","Lawrence County",4,41,228,138,90
050,17,101,"Illinois","Lawrence County",4,42,216,140,76
050,17,101,"Illinois","Lawrence County",4,43,210,133,77
050,17,101,"Illinois","Lawrence County",4,44,196,120,76
050,17,101,"Illinois","Lawrence County",4,45,200,110,90
050,17,101,"Illinois","Lawrence County",4,46,190,121,69
050,17,101,"Illinois","Lawrence County",4,47,183,113,70
050,17,101,"Illinois","Lawrence County",4,48,169,104,65
050,17,101,"Illinois","Lawrence County",4,49,197,122,75
050,17,101,"Illinois","Lawrence County",4,50,211,128,83
050,17,101,"Illinois","Lawrence County",4,51,214,134,80
050,17,101,"Illinois","Lawrence County",4,52,189,116,73
050,17,101,"Illinois","Lawrence County",4,53,183,107,76
050,17,101,"Illinois","Lawrence County",4,54,167,89,78
050,17,101,"Illinois","Lawrence County",4,55,151,75,76
050,17,101,"Illinois","Lawrence County",4,56,175,93,82
050,17,101,"Illinois","Lawrence County",4,57,180,98,82
050,17,101,"Illinois","Lawrence County",4,58,180,89,91
050,17,101,"Illinois","Lawrence County",4,59,206,107,99
050,17,101,"Illinois","Lawrence County",4,60,214,97,117
050,17,101,"Illinois","Lawrence County",4,61,216,106,110
050,17,101,"Illinois","Lawrence County",4,62,206,109,97
050,17,101,"Illinois","Lawrence County",4,63,189,82,107
050,17,101,"Illinois","Lawrence County",4,64,204,93,111
050,17,101,"Illinois","Lawrence County",4,65,202,93,109
050,17,101,"Illinois","Lawrence County",4,66,165,77,88
050,17,101,"Illinois","Lawrence County",4,67,165,86,79
050,17,101,"Illinois","Lawrence County",4,68,172,83,89
050,17,101,"Illinois","Lawrence County",4,69,162,79,83
050,17,101,"Illinois","Lawrence County",4,70,169,72,97
050,17,101,"Illinois","Lawrence County",4,71,156,70,86
050,17,101,"Illinois","Lawrence County",4,72,141,62,79
050,17,101,"Illinois","Lawrence County",4,73,128,66,62
050,17,101,"Illinois","Lawrence County",4,74,134,66,68
050,17,101,"Illinois","Lawrence County",4,75,137,61,76
050,17,101,"Illinois","Lawrence County",4,76,111,55,56
050,17,101,"Illinois","Lawrence County",4,77,101,41,60
050,17,101,"Illinois","Lawrence County",4,78,85,37,48
050,17,101,"Illinois","Lawrence County",4,79,89,40,49
050,17,101,"Illinois","Lawrence County",4,80,81,34,47
050,17,101,"Illinois","Lawrence County",4,81,77,35,42
050,17,101,"Illinois","Lawrence County",4,82,76,29,47
050,17,101,"Illinois","Lawrence County",4,83,77,28,49
050,17,101,"Illinois","Lawrence County",4,84,59,21,38
050,17,101,"Illinois","Lawrence County",4,85,316,106,210
050,17,101,"Illinois","Lawrence County",5,0,89,47,42
050,17,101,"Illinois","Lawrence County",5,1,108,55,53
050,17,101,"Illinois","Lawrence County",5,2,155,77,78
050,17,101,"Illinois","Lawrence County",5,3,134,67,67
050,17,101,"Illinois","Lawrence County",5,4,126,57,69
050,17,101,"Illinois","Lawrence County",5,5,148,74,74
050,17,101,"Illinois","Lawrence County",5,6,143,72,71
050,17,101,"Illinois","Lawrence County",5,7,140,79,61
050,17,101,"Illinois","Lawrence County",5,8,170,97,73
050,17,101,"Illinois","Lawrence County",5,9,168,90,78
050,17,101,"Illinois","Lawrence County",5,10,167,83,84
050,17,101,"Illinois","Lawrence County",5,11,170,75,95
050,17,101,"Illinois","Lawrence County",5,12,154,74,80
050,17,101,"Illinois","Lawrence County",5,13,161,77,84
050,17,101,"Illinois","Lawrence County",5,14,169,92,77
050,17,101,"Illinois","Lawrence County",5,15,164,89,75
050,17,101,"Illinois","Lawrence County",5,16,176,91,85
050,17,101,"Illinois","Lawrence County",5,17,168,93,75
050,17,101,"Illinois","Lawrence County",5,18,158,92,66
050,17,101,"Illinois","Lawrence County",5,19,144,95,49
050,17,101,"Illinois","Lawrence County",5,20,171,111,60
050,17,101,"Illinois","Lawrence County",5,21,194,143,51
050,17,101,"Illinois","Lawrence County",5,22,212,155,57
050,17,101,"Illinois","Lawrence County",5,23,181,126,55
050,17,101,"Illinois","Lawrence County",5,24,205,132,73
050,17,101,"Illinois","Lawrence County",5,25,209,148,61
050,17,101,"Illinois","Lawrence County",5,26,211,138,73
050,17,101,"Illinois","Lawrence County",5,27,215,152,63
050,17,101,"Illinois","Lawrence County",5,28,218,149,69
050,17,101,"Illinois","Lawrence County",5,29,232,153,79
050,17,101,"Illinois","Lawrence County",5,30,200,126,74
050,17,101,"Illinois","Lawrence County",5,31,224,153,71
050,17,101,"Illinois","Lawrence County",5,32,239,156,83
050,17,101,"Illinois","Lawrence County",5,33,208,136,72
050,17,101,"Illinois","Lawrence County",5,34,195,126,69
050,17,101,"Illinois","Lawrence County",5,35,187,123,64
050,17,101,"Illinois","Lawrence County",5,36,199,136,63
050,17,101,"Illinois","Lawrence County",5,37,219,140,79
050,17,101,"Illinois","Lawrence County",5,38,213,124,89
050,17,101,"Illinois","Lawrence County",5,39,218,133,85
050,17,101,"Illinois","Lawrence County",5,40,204,130,74
050,17,101,"Illinois","Lawrence County",5,41,226,141,85
050,17,101,"Illinois","Lawrence County",5,42,222,142,80
050,17,101,"Illinois","Lawrence County",5,43,209,129,80
050,17,101,"Illinois","Lawrence County",5,44,211,145,66
050,17,101,"Illinois","Lawrence County",5,45,173,100,73
050,17,101,"Illinois","Lawrence County",5,46,207,115,92
050,17,101,"Illinois","Lawrence County",5,47,177,109,68
050,17,101,"Illinois","Lawrence County",5,48,178,107,71
050,17,101,"Illinois","Lawrence County",5,49,170,107,63
050,17,101,"Illinois","Lawrence County",5,50,212,135,77
050,17,101,"Illinois","Lawrence County",5,51,205,125,80
050,17,101,"Illinois","Lawrence County",5,52,192,110,82
050,17,101,"Illinois","Lawrence County",5,53,175,103,72
050,17,101,"Illinois","Lawrence County",5,54,194,111,83
050,17,101,"Illinois","Lawrence County",5,55,151,78,73
050,17,101,"Illinois","Lawrence County",5,56,154,82,72
050,17,101,"Illinois","Lawrence County",5,57,171,90,81
050,17,101,"Illinois","Lawrence County",5,58,177,90,87
050,17,101,"Illinois","Lawrence County",5,59,177,91,86
050,17,101,"Illinois","Lawrence County",5,60,203,100,103
050,17,101,"Illinois","Lawrence County",5,61,208,99,109
050,17,101,"Illinois","Lawrence County",5,62,216,112,104
050,17,101,"Illinois","Lawrence County",5,63,195,101,94
050,17,101,"Illinois","Lawrence County",5,64,195,81,114
050,17,101,"Illinois","Lawrence County",5,65,199,92,107
050,17,101,"Illinois","Lawrence County",5,66,203,92,111
050,17,101,"Illinois","Lawrence County",5,67,159,71,88
050,17,101,"Illinois","Lawrence County",5,68,159,82,77
050,17,101,"Illinois","Lawrence County",5,69,166,81,85
050,17,101,"Illinois","Lawrence County",5,70,167,76,91
050,17,101,"Illinois","Lawrence County",5,71,152,62,90
050,17,101,"Illinois","Lawrence County",5,72,146,66,80
050,17,101,"Illinois","Lawrence County",5,73,134,63,71
050,17,101,"Illinois","Lawrence County",5,74,122,61,61
050,17,101,"Illinois","Lawrence County",5,75,125,58,67
050,17,101,"Illinois","Lawrence County",5,76,137,68,69
050,17,101,"Illinois","Lawrence County",5,77,106,47,59
050,17,101,"Illinois","Lawrence County",5,78,93,36,57
050,17,101,"Illinois","Lawrence County",5,79,77,33,44
050,17,101,"Illinois","Lawrence County",5,80,82,41,41
050,17,101,"Illinois","Lawrence County",5,81,81,35,46
050,17,101,"Illinois","Lawrence County",5,82,80,31,49
050,17,101,"Illinois","Lawrence County",5,83,68,28,40
050,17,101,"Illinois","Lawrence County",5,84,64,21,43
050,17,101,"Illinois","Lawrence County",5,85,329,109,220
050,17,103,"Illinois","Lee County",1,0,330,172,158
050,17,103,"Illinois","Lee County",1,1,339,186,153
050,17,103,"Illinois","Lee County",1,2,344,175,169
050,17,103,"Illinois","Lee County",1,3,352,172,180
050,17,103,"Illinois","Lee County",1,4,370,184,186
050,17,103,"Illinois","Lee County",1,5,352,178,174
050,17,103,"Illinois","Lee County",1,6,378,176,202
050,17,103,"Illinois","Lee County",1,7,385,198,187
050,17,103,"Illinois","Lee County",1,8,397,182,215
050,17,103,"Illinois","Lee County",1,9,360,174,186
050,17,103,"Illinois","Lee County",1,10,390,221,169
050,17,103,"Illinois","Lee County",1,11,407,213,194
050,17,103,"Illinois","Lee County",1,12,420,220,200
050,17,103,"Illinois","Lee County",1,13,438,231,207
050,17,103,"Illinois","Lee County",1,14,399,199,200
050,17,103,"Illinois","Lee County",1,15,402,195,207
050,17,103,"Illinois","Lee County",1,16,414,202,212
050,17,103,"Illinois","Lee County",1,17,386,192,194
050,17,103,"Illinois","Lee County",1,18,329,184,145
050,17,103,"Illinois","Lee County",1,19,295,166,129
050,17,103,"Illinois","Lee County",1,20,304,167,137
050,17,103,"Illinois","Lee County",1,21,329,179,150
050,17,103,"Illinois","Lee County",1,22,352,193,159
050,17,103,"Illinois","Lee County",1,23,351,192,159
050,17,103,"Illinois","Lee County",1,24,368,209,159
050,17,103,"Illinois","Lee County",1,25,429,233,196
050,17,103,"Illinois","Lee County",1,26,415,229,186
050,17,103,"Illinois","Lee County",1,27,425,244,181
050,17,103,"Illinois","Lee County",1,28,466,264,202
050,17,103,"Illinois","Lee County",1,29,439,255,184
050,17,103,"Illinois","Lee County",1,30,428,243,185
050,17,103,"Illinois","Lee County",1,31,421,248,173
050,17,103,"Illinois","Lee County",1,32,423,254,169
050,17,103,"Illinois","Lee County",1,33,426,260,166
050,17,103,"Illinois","Lee County",1,34,433,267,166
050,17,103,"Illinois","Lee County",1,35,398,244,154
050,17,103,"Illinois","Lee County",1,36,386,213,173
050,17,103,"Illinois","Lee County",1,37,417,240,177
050,17,103,"Illinois","Lee County",1,38,435,254,181
050,17,103,"Illinois","Lee County",1,39,456,264,192
050,17,103,"Illinois","Lee County",1,40,446,255,191
050,17,103,"Illinois","Lee County",1,41,433,253,180
050,17,103,"Illinois","Lee County",1,42,395,233,162
050,17,103,"Illinois","Lee County",1,43,419,249,170
050,17,103,"Illinois","Lee County",1,44,394,213,181
050,17,103,"Illinois","Lee County",1,45,406,228,178
050,17,103,"Illinois","Lee County",1,46,411,241,170
050,17,103,"Illinois","Lee County",1,47,398,227,171
050,17,103,"Illinois","Lee County",1,48,416,236,180
050,17,103,"Illinois","Lee County",1,49,474,270,204
050,17,103,"Illinois","Lee County",1,50,477,265,212
050,17,103,"Illinois","Lee County",1,51,429,234,195
050,17,103,"Illinois","Lee County",1,52,424,218,206
050,17,103,"Illinois","Lee County",1,53,477,239,238
050,17,103,"Illinois","Lee County",1,54,487,247,240
050,17,103,"Illinois","Lee County",1,55,509,267,242
050,17,103,"Illinois","Lee County",1,56,478,254,224
050,17,103,"Illinois","Lee County",1,57,486,273,213
050,17,103,"Illinois","Lee County",1,58,524,287,237
050,17,103,"Illinois","Lee County",1,59,555,299,256
050,17,103,"Illinois","Lee County",1,60,542,303,239
050,17,103,"Illinois","Lee County",1,61,558,304,254
050,17,103,"Illinois","Lee County",1,62,539,287,252
050,17,103,"Illinois","Lee County",1,63,499,250,249
050,17,103,"Illinois","Lee County",1,64,503,258,245
050,17,103,"Illinois","Lee County",1,65,456,227,229
050,17,103,"Illinois","Lee County",1,66,448,233,215
050,17,103,"Illinois","Lee County",1,67,449,229,220
050,17,103,"Illinois","Lee County",1,68,419,202,217
050,17,103,"Illinois","Lee County",1,69,409,207,202
050,17,103,"Illinois","Lee County",1,70,375,183,192
050,17,103,"Illinois","Lee County",1,71,376,183,193
050,17,103,"Illinois","Lee County",1,72,400,201,199
050,17,103,"Illinois","Lee County",1,73,416,208,208
050,17,103,"Illinois","Lee County",1,74,286,135,151
050,17,103,"Illinois","Lee County",1,75,258,130,128
050,17,103,"Illinois","Lee County",1,76,247,114,133
050,17,103,"Illinois","Lee County",1,77,244,113,131
050,17,103,"Illinois","Lee County",1,78,213,98,115
050,17,103,"Illinois","Lee County",1,79,204,103,101
050,17,103,"Illinois","Lee County",1,80,172,79,93
050,17,103,"Illinois","Lee County",1,81,185,74,111
050,17,103,"Illinois","Lee County",1,82,172,87,85
050,17,103,"Illinois","Lee County",1,83,146,61,85
050,17,103,"Illinois","Lee County",1,84,138,54,84
050,17,103,"Illinois","Lee County",1,85,871,322,549
050,17,103,"Illinois","Lee County",2,0,330,165,165
050,17,103,"Illinois","Lee County",2,1,334,181,153
050,17,103,"Illinois","Lee County",2,2,338,174,164
050,17,103,"Illinois","Lee County",2,3,350,174,176
050,17,103,"Illinois","Lee County",2,4,370,185,185
050,17,103,"Illinois","Lee County",2,5,353,178,175
050,17,103,"Illinois","Lee County",2,6,373,177,196
050,17,103,"Illinois","Lee County",2,7,381,192,189
050,17,103,"Illinois","Lee County",2,8,392,184,208
050,17,103,"Illinois","Lee County",2,9,369,177,192
050,17,103,"Illinois","Lee County",2,10,383,208,175
050,17,103,"Illinois","Lee County",2,11,397,210,187
050,17,103,"Illinois","Lee County",2,12,421,220,201
050,17,103,"Illinois","Lee County",2,13,431,227,204
050,17,103,"Illinois","Lee County",2,14,409,207,202
050,17,103,"Illinois","Lee County",2,15,400,195,205
050,17,103,"Illinois","Lee County",2,16,411,199,212
050,17,103,"Illinois","Lee County",2,17,393,194,199
050,17,103,"Illinois","Lee County",2,18,327,179,148
050,17,103,"Illinois","Lee County",2,19,289,164,125
050,17,103,"Illinois","Lee County",2,20,312,172,140
050,17,103,"Illinois","Lee County",2,21,330,180,150
050,17,103,"Illinois","Lee County",2,22,353,192,161
050,17,103,"Illinois","Lee County",2,23,353,196,157
050,17,103,"Illinois","Lee County",2,24,369,208,161
050,17,103,"Illinois","Lee County",2,25,417,229,188
050,17,103,"Illinois","Lee County",2,26,415,228,187
050,17,103,"Illinois","Lee County",2,27,421,239,182
050,17,103,"Illinois","Lee County",2,28,457,261,196
050,17,103,"Illinois","Lee County",2,29,449,260,189
050,17,103,"Illinois","Lee County",2,30,427,243,184
050,17,103,"Illinois","Lee County",2,31,423,250,173
050,17,103,"Illinois","Lee County",2,32,423,253,170
050,17,103,"Illinois","Lee County",2,33,424,259,165
050,17,103,"Illinois","Lee County",2,34,427,262,165
050,17,103,"Illinois","Lee County",2,35,400,244,156
050,17,103,"Illinois","Lee County",2,36,386,217,169
050,17,103,"Illinois","Lee County",2,37,412,236,176
050,17,103,"Illinois","Lee County",2,38,434,252,182
050,17,103,"Illinois","Lee County",2,39,453,264,189
050,17,103,"Illinois","Lee County",2,40,448,256,192
050,17,103,"Illinois","Lee County",2,41,437,254,183
050,17,103,"Illinois","Lee County",2,42,402,235,167
050,17,103,"Illinois","Lee County",2,43,421,250,171
050,17,103,"Illinois","Lee County",2,44,394,217,177
050,17,103,"Illinois","Lee County",2,45,402,225,177
050,17,103,"Illinois","Lee County",2,46,405,236,169
050,17,103,"Illinois","Lee County",2,47,395,225,170
050,17,103,"Illinois","Lee County",2,48,408,229,179
050,17,103,"Illinois","Lee County",2,49,465,267,198
050,17,103,"Illinois","Lee County",2,50,472,263,209
050,17,103,"Illinois","Lee County",2,51,438,242,196
050,17,103,"Illinois","Lee County",2,52,420,218,202
050,17,103,"Illinois","Lee County",2,53,464,236,228
050,17,103,"Illinois","Lee County",2,54,481,243,238
050,17,103,"Illinois","Lee County",2,55,500,261,239
050,17,103,"Illinois","Lee County",2,56,481,254,227
050,17,103,"Illinois","Lee County",2,57,482,267,215
050,17,103,"Illinois","Lee County",2,58,512,283,229
050,17,103,"Illinois","Lee County",2,59,548,297,251
050,17,103,"Illinois","Lee County",2,60,539,298,241
050,17,103,"Illinois","Lee County",2,61,553,305,248
050,17,103,"Illinois","Lee County",2,62,539,290,249
050,17,103,"Illinois","Lee County",2,63,506,255,251
050,17,103,"Illinois","Lee County",2,64,498,253,245
050,17,103,"Illinois","Lee County",2,65,458,230,228
050,17,103,"Illinois","Lee County",2,66,452,233,219
050,17,103,"Illinois","Lee County",2,67,444,227,217
050,17,103,"Illinois","Lee County",2,68,418,206,212
050,17,103,"Illinois","Lee County",2,69,409,205,204
050,17,103,"Illinois","Lee County",2,70,379,187,192
050,17,103,"Illinois","Lee County",2,71,377,184,193
050,17,103,"Illinois","Lee County",2,72,387,194,193
050,17,103,"Illinois","Lee County",2,73,429,211,218
050,17,103,"Illinois","Lee County",2,74,294,141,153
050,17,103,"Illinois","Lee County",2,75,264,132,132
050,17,103,"Illinois","Lee County",2,76,246,117,129
050,17,103,"Illinois","Lee County",2,77,247,114,133
050,17,103,"Illinois","Lee County",2,78,219,102,117
050,17,103,"Illinois","Lee County",2,79,201,96,105
050,17,103,"Illinois","Lee County",2,80,177,85,92
050,17,103,"Illinois","Lee County",2,81,179,75,104
050,17,103,"Illinois","Lee County",2,82,174,83,91
050,17,103,"Illinois","Lee County",2,83,149,66,83
050,17,103,"Illinois","Lee County",2,84,140,56,84
050,17,103,"Illinois","Lee County",2,85,873,323,550
050,17,103,"Illinois","Lee County",3,0,327,172,155
050,17,103,"Illinois","Lee County",3,1,326,158,168
050,17,103,"Illinois","Lee County",3,2,348,196,152
050,17,103,"Illinois","Lee County",3,3,348,179,169
050,17,103,"Illinois","Lee County",3,4,359,183,176
050,17,103,"Illinois","Lee County",3,5,376,179,197
050,17,103,"Illinois","Lee County",3,6,351,177,174
050,17,103,"Illinois","Lee County",3,7,372,177,195
050,17,103,"Illinois","Lee County",3,8,393,199,194
050,17,103,"Illinois","Lee County",3,9,392,189,203
050,17,103,"Illinois","Lee County",3,10,379,182,197
050,17,103,"Illinois","Lee County",3,11,364,196,168
050,17,103,"Illinois","Lee County",3,12,392,202,190
050,17,103,"Illinois","Lee County",3,13,427,227,200
050,17,103,"Illinois","Lee County",3,14,430,229,201
050,17,103,"Illinois","Lee County",3,15,418,210,208
050,17,103,"Illinois","Lee County",3,16,403,196,207
050,17,103,"Illinois","Lee County",3,17,403,193,210
050,17,103,"Illinois","Lee County",3,18,342,177,165
050,17,103,"Illinois","Lee County",3,19,286,165,121
050,17,103,"Illinois","Lee County",3,20,322,181,141
050,17,103,"Illinois","Lee County",3,21,347,179,168
050,17,103,"Illinois","Lee County",3,22,350,196,154
050,17,103,"Illinois","Lee County",3,23,367,205,162
050,17,103,"Illinois","Lee County",3,24,358,199,159
050,17,103,"Illinois","Lee County",3,25,394,222,172
050,17,103,"Illinois","Lee County",3,26,413,231,182
050,17,103,"Illinois","Lee County",3,27,407,226,181
050,17,103,"Illinois","Lee County",3,28,447,272,175
050,17,103,"Illinois","Lee County",3,29,491,280,211
050,17,103,"Illinois","Lee County",3,30,433,250,183
050,17,103,"Illinois","Lee County",3,31,441,253,188
050,17,103,"Illinois","Lee County",3,32,427,253,174
050,17,103,"Illinois","Lee County",3,33,439,270,169
050,17,103,"Illinois","Lee County",3,34,424,248,176
050,17,103,"Illinois","Lee County",3,35,407,243,164
050,17,103,"Illinois","Lee County",3,36,403,249,154
050,17,103,"Illinois","Lee County",3,37,414,247,167
050,17,103,"Illinois","Lee County",3,38,436,256,180
050,17,103,"Illinois","Lee County",3,39,427,257,170
050,17,103,"Illinois","Lee County",3,40,466,269,197
050,17,103,"Illinois","Lee County",3,41,472,277,195
050,17,103,"Illinois","Lee County",3,42,439,264,175
050,17,103,"Illinois","Lee County",3,43,429,262,167
050,17,103,"Illinois","Lee County",3,44,422,243,179
050,17,103,"Illinois","Lee County",3,45,399,226,173
050,17,103,"Illinois","Lee County",3,46,413,235,178
050,17,103,"Illinois","Lee County",3,47,405,229,176
050,17,103,"Illinois","Lee County",3,48,375,207,168
050,17,103,"Illinois","Lee County",3,49,428,248,180
050,17,103,"Illinois","Lee County",3,50,460,261,199
050,17,103,"Illinois","Lee County",3,51,465,261,204
050,17,103,"Illinois","Lee County",3,52,442,239,203
050,17,103,"Illinois","Lee County",3,53,430,238,192
050,17,103,"Illinois","Lee County",3,54,473,242,231
050,17,103,"Illinois","Lee County",3,55,474,241,233
050,17,103,"Illinois","Lee County",3,56,502,265,237
050,17,103,"Illinois","Lee County",3,57,481,253,228
050,17,103,"Illinois","Lee County",3,58,486,271,215
050,17,103,"Illinois","Lee County",3,59,515,295,220
050,17,103,"Illinois","Lee County",3,60,523,285,238
050,17,103,"Illinois","Lee County",3,61,538,303,235
050,17,103,"Illinois","Lee County",3,62,547,310,237
050,17,103,"Illinois","Lee County",3,63,507,267,240
050,17,103,"Illinois","Lee County",3,64,507,253,254
050,17,103,"Illinois","Lee County",3,65,477,238,239
050,17,103,"Illinois","Lee County",3,66,454,228,226
050,17,103,"Illinois","Lee County",3,67,440,224,216
050,17,103,"Illinois","Lee County",3,68,425,211,214
050,17,103,"Illinois","Lee County",3,69,398,191,207
050,17,103,"Illinois","Lee County",3,70,405,204,201
050,17,103,"Illinois","Lee County",3,71,380,184,196
050,17,103,"Illinois","Lee County",3,72,367,183,184
050,17,103,"Illinois","Lee County",3,73,372,180,192
050,17,103,"Illinois","Lee County",3,74,415,200,215
050,17,103,"Illinois","Lee County",3,75,283,137,146
050,17,103,"Illinois","Lee County",3,76,259,127,132
050,17,103,"Illinois","Lee County",3,77,230,110,120
050,17,103,"Illinois","Lee County",3,78,232,110,122
050,17,103,"Illinois","Lee County",3,79,199,89,110
050,17,103,"Illinois","Lee County",3,80,192,89,103
050,17,103,"Illinois","Lee County",3,81,169,77,92
050,17,103,"Illinois","Lee County",3,82,153,66,87
050,17,103,"Illinois","Lee County",3,83,165,76,89
050,17,103,"Illinois","Lee County",3,84,137,59,78
050,17,103,"Illinois","Lee County",3,85,862,316,546
050,17,103,"Illinois","Lee County",4,0,336,170,166
050,17,103,"Illinois","Lee County",4,1,314,172,142
050,17,103,"Illinois","Lee County",4,2,329,157,172
050,17,103,"Illinois","Lee County",4,3,344,192,152
050,17,103,"Illinois","Lee County",4,4,336,166,170
050,17,103,"Illinois","Lee County",4,5,355,182,173
050,17,103,"Illinois","Lee County",4,6,373,177,196
050,17,103,"Illinois","Lee County",4,7,365,193,172
050,17,103,"Illinois","Lee County",4,8,367,178,189
050,17,103,"Illinois","Lee County",4,9,399,198,201
050,17,103,"Illinois","Lee County",4,10,394,184,210
050,17,103,"Illinois","Lee County",4,11,380,190,190
050,17,103,"Illinois","Lee County",4,12,370,201,169
050,17,103,"Illinois","Lee County",4,13,400,201,199
050,17,103,"Illinois","Lee County",4,14,425,231,194
050,17,103,"Illinois","Lee County",4,15,433,238,195
050,17,103,"Illinois","Lee County",4,16,430,219,211
050,17,103,"Illinois","Lee County",4,17,412,196,216
050,17,103,"Illinois","Lee County",4,18,345,175,170
050,17,103,"Illinois","Lee County",4,19,285,159,126
050,17,103,"Illinois","Lee County",4,20,293,162,131
050,17,103,"Illinois","Lee County",4,21,350,187,163
050,17,103,"Illinois","Lee County",4,22,355,196,159
050,17,103,"Illinois","Lee County",4,23,363,210,153
050,17,103,"Illinois","Lee County",4,24,375,211,164
050,17,103,"Illinois","Lee County",4,25,359,208,151
050,17,103,"Illinois","Lee County",4,26,374,213,161
050,17,103,"Illinois","Lee County",4,27,418,231,187
050,17,103,"Illinois","Lee County",4,28,409,229,180
050,17,103,"Illinois","Lee County",4,29,443,261,182
050,17,103,"Illinois","Lee County",4,30,469,263,206
050,17,103,"Illinois","Lee County",4,31,437,260,177
050,17,103,"Illinois","Lee County",4,32,453,259,194
050,17,103,"Illinois","Lee County",4,33,435,258,177
050,17,103,"Illinois","Lee County",4,34,429,252,177
050,17,103,"Illinois","Lee County",4,35,403,231,172
050,17,103,"Illinois","Lee County",4,36,411,239,172
050,17,103,"Illinois","Lee County",4,37,408,256,152
050,17,103,"Illinois","Lee County",4,38,425,255,170
050,17,103,"Illinois","Lee County",4,39,441,255,186
050,17,103,"Illinois","Lee County",4,40,414,247,167
050,17,103,"Illinois","Lee County",4,41,462,260,202
050,17,103,"Illinois","Lee County",4,42,445,252,193
050,17,103,"Illinois","Lee County",4,43,448,271,177
050,17,103,"Illinois","Lee County",4,44,413,244,169
050,17,103,"Illinois","Lee County",4,45,429,254,175
050,17,103,"Illinois","Lee County",4,46,382,219,163
050,17,103,"Illinois","Lee County",4,47,388,215,173
050,17,103,"Illinois","Lee County",4,48,384,213,171
050,17,103,"Illinois","Lee County",4,49,387,225,162
050,17,103,"Illinois","Lee County",4,50,424,237,187
050,17,103,"Illinois","Lee County",4,51,453,255,198
050,17,103,"Illinois","Lee County",4,52,453,250,203
050,17,103,"Illinois","Lee County",4,53,450,250,200
050,17,103,"Illinois","Lee County",4,54,416,229,187
050,17,103,"Illinois","Lee County",4,55,462,233,229
050,17,103,"Illinois","Lee County",4,56,454,230,224
050,17,103,"Illinois","Lee County",4,57,494,259,235
050,17,103,"Illinois","Lee County",4,58,482,248,234
050,17,103,"Illinois","Lee County",4,59,494,280,214
050,17,103,"Illinois","Lee County",4,60,493,282,211
050,17,103,"Illinois","Lee County",4,61,546,295,251
050,17,103,"Illinois","Lee County",4,62,522,293,229
050,17,103,"Illinois","Lee County",4,63,531,289,242
050,17,103,"Illinois","Lee County",4,64,508,266,242
050,17,103,"Illinois","Lee County",4,65,496,241,255
050,17,103,"Illinois","Lee County",4,66,463,231,232
050,17,103,"Illinois","Lee County",4,67,446,222,224
050,17,103,"Illinois","Lee County",4,68,428,210,218
050,17,103,"Illinois","Lee County",4,69,413,206,207
050,17,103,"Illinois","Lee County",4,70,397,195,202
050,17,103,"Illinois","Lee County",4,71,400,198,202
050,17,103,"Illinois","Lee County",4,72,370,183,187
050,17,103,"Illinois","Lee County",4,73,359,174,185
050,17,103,"Illinois","Lee County",4,74,350,166,184
050,17,103,"Illinois","Lee County",4,75,405,192,213
050,17,103,"Illinois","Lee County",4,76,268,129,139
050,17,103,"Illinois","Lee County",4,77,241,118,123
050,17,103,"Illinois","Lee County",4,78,222,109,113
050,17,103,"Illinois","Lee County",4,79,225,102,123
050,17,103,"Illinois","Lee County",4,80,189,85,104
050,17,103,"Illinois","Lee County",4,81,186,85,101
050,17,103,"Illinois","Lee County",4,82,142,68,74
050,17,103,"Illinois","Lee County",4,83,139,52,87
050,17,103,"Illinois","Lee County",4,84,153,70,83
050,17,103,"Illinois","Lee County",4,85,870,322,548
050,17,103,"Illinois","Lee County",5,0,339,171,168
050,17,103,"Illinois","Lee County",5,1,331,161,170
050,17,103,"Illinois","Lee County",5,2,308,168,140
050,17,103,"Illinois","Lee County",5,3,328,154,174
050,17,103,"Illinois","Lee County",5,4,326,186,140
050,17,103,"Illinois","Lee County",5,5,325,159,166
050,17,103,"Illinois","Lee County",5,6,346,180,166
050,17,103,"Illinois","Lee County",5,7,374,172,202
050,17,103,"Illinois","Lee County",5,8,352,185,167
050,17,103,"Illinois","Lee County",5,9,370,175,195
050,17,103,"Illinois","Lee County",5,10,378,188,190
050,17,103,"Illinois","Lee County",5,11,394,185,209
050,17,103,"Illinois","Lee County",5,12,383,198,185
050,17,103,"Illinois","Lee County",5,13,370,199,171
050,17,103,"Illinois","Lee County",5,14,390,198,192
050,17,103,"Illinois","Lee County",5,15,418,224,194
050,17,103,"Illinois","Lee County",5,16,436,238,198
050,17,103,"Illinois","Lee County",5,17,411,208,203
050,17,103,"Illinois","Lee County",5,18,351,181,170
050,17,103,"Illinois","Lee County",5,19,287,155,132
050,17,103,"Illinois","Lee County",5,20,314,172,142
050,17,103,"Illinois","Lee County",5,21,319,175,144
050,17,103,"Illinois","Lee County",5,22,379,207,172
050,17,103,"Illinois","Lee County",5,23,364,196,168
050,17,103,"Illinois","Lee County",5,24,359,208,151
050,17,103,"Illinois","Lee County",5,25,377,220,157
050,17,103,"Illinois","Lee County",5,26,349,195,154
050,17,103,"Illinois","Lee County",5,27,372,207,165
050,17,103,"Illinois","Lee County",5,28,404,231,173
050,17,103,"Illinois","Lee County",5,29,424,241,183
050,17,103,"Illinois","Lee County",5,30,435,253,182
050,17,103,"Illinois","Lee County",5,31,491,280,211
050,17,103,"Illinois","Lee County",5,32,438,260,178
050,17,103,"Illinois","Lee County",5,33,456,269,187
050,17,103,"Illinois","Lee County",5,34,424,243,181
050,17,103,"Illinois","Lee County",5,35,418,250,168
050,17,103,"Illinois","Lee County",5,36,399,233,166
050,17,103,"Illinois","Lee County",5,37,411,250,161
050,17,103,"Illinois","Lee County",5,38,412,258,154
050,17,103,"Illinois","Lee County",5,39,435,263,172
050,17,103,"Illinois","Lee County",5,40,431,246,185
050,17,103,"Illinois","Lee County",5,41,423,245,178
050,17,103,"Illinois","Lee County",5,42,449,253,196
050,17,103,"Illinois","Lee County",5,43,457,266,191
050,17,103,"Illinois","Lee County",5,44,431,259,172
050,17,103,"Illinois","Lee County",5,45,411,243,168
050,17,103,"Illinois","Lee County",5,46,421,248,173
050,17,103,"Illinois","Lee County",5,47,370,202,168
050,17,103,"Illinois","Lee County",5,48,371,197,174
050,17,103,"Illinois","Lee County",5,49,398,230,168
050,17,103,"Illinois","Lee County",5,50,381,211,170
050,17,103,"Illinois","Lee County",5,51,419,235,184
050,17,103,"Illinois","Lee County",5,52,435,245,190
050,17,103,"Illinois","Lee County",5,53,464,260,204
050,17,103,"Illinois","Lee County",5,54,445,240,205
050,17,103,"Illinois","Lee County",5,55,415,230,185
050,17,103,"Illinois","Lee County",5,56,438,215,223
050,17,103,"Illinois","Lee County",5,57,446,227,219
050,17,103,"Illinois","Lee County",5,58,494,257,237
050,17,103,"Illinois","Lee County",5,59,481,253,228
050,17,103,"Illinois","Lee County",5,60,473,260,213
050,17,103,"Illinois","Lee County",5,61,500,293,207
050,17,103,"Illinois","Lee County",5,62,542,295,247
050,17,103,"Illinois","Lee County",5,63,500,276,224
050,17,103,"Illinois","Lee County",5,64,545,297,248
050,17,103,"Illinois","Lee County",5,65,489,248,241
050,17,103,"Illinois","Lee County",5,66,489,241,248
050,17,103,"Illinois","Lee County",5,67,455,221,234
050,17,103,"Illinois","Lee County",5,68,434,214,220
050,17,103,"Illinois","Lee County",5,69,417,202,215
050,17,103,"Illinois","Lee County",5,70,403,203,200
050,17,103,"Illinois","Lee County",5,71,392,191,201
050,17,103,"Illinois","Lee County",5,72,386,197,189
050,17,103,"Illinois","Lee County",5,73,358,176,182
050,17,103,"Illinois","Lee County",5,74,338,164,174
050,17,103,"Illinois","Lee County",5,75,346,161,185
050,17,103,"Illinois","Lee County",5,76,389,183,206
050,17,103,"Illinois","Lee County",5,77,257,125,132
050,17,103,"Illinois","Lee County",5,78,231,115,116
050,17,103,"Illinois","Lee County",5,79,210,99,111
050,17,103,"Illinois","Lee County",5,80,216,97,119
050,17,103,"Illinois","Lee County",5,81,177,80,97
050,17,103,"Illinois","Lee County",5,82,164,76,88
050,17,103,"Illinois","Lee County",5,83,132,59,73
050,17,103,"Illinois","Lee County",5,84,125,45,80
050,17,103,"Illinois","Lee County",5,85,909,347,562
050,17,105,"Illinois","Livingston County",1,0,429,220,209
050,17,105,"Illinois","Livingston County",1,1,420,221,199
050,17,105,"Illinois","Livingston County",1,2,429,224,205
050,17,105,"Illinois","Livingston County",1,3,419,211,208
050,17,105,"Illinois","Livingston County",1,4,419,222,197
050,17,105,"Illinois","Livingston County",1,5,410,208,202
050,17,105,"Illinois","Livingston County",1,6,411,204,207
050,17,105,"Illinois","Livingston County",1,7,428,238,190
050,17,105,"Illinois","Livingston County",1,8,424,237,187
050,17,105,"Illinois","Livingston County",1,9,416,211,205
050,17,105,"Illinois","Livingston County",1,10,449,231,218
050,17,105,"Illinois","Livingston County",1,11,453,238,215
050,17,105,"Illinois","Livingston County",1,12,486,268,218
050,17,105,"Illinois","Livingston County",1,13,466,253,213
050,17,105,"Illinois","Livingston County",1,14,453,233,220
050,17,105,"Illinois","Livingston County",1,15,457,253,204
050,17,105,"Illinois","Livingston County",1,16,510,287,223
050,17,105,"Illinois","Livingston County",1,17,487,267,220
050,17,105,"Illinois","Livingston County",1,18,429,230,199
050,17,105,"Illinois","Livingston County",1,19,355,195,160
050,17,105,"Illinois","Livingston County",1,20,368,205,163
050,17,105,"Illinois","Livingston County",1,21,392,222,170
050,17,105,"Illinois","Livingston County",1,22,420,226,194
050,17,105,"Illinois","Livingston County",1,23,408,204,204
050,17,105,"Illinois","Livingston County",1,24,409,205,204
050,17,105,"Illinois","Livingston County",1,25,417,213,204
050,17,105,"Illinois","Livingston County",1,26,430,219,211
050,17,105,"Illinois","Livingston County",1,27,439,233,206
050,17,105,"Illinois","Livingston County",1,28,465,245,220
050,17,105,"Illinois","Livingston County",1,29,455,234,221
050,17,105,"Illinois","Livingston County",1,30,431,210,221
050,17,105,"Illinois","Livingston County",1,31,406,212,194
050,17,105,"Illinois","Livingston County",1,32,433,229,204
050,17,105,"Illinois","Livingston County",1,33,434,229,205
050,17,105,"Illinois","Livingston County",1,34,457,231,226
050,17,105,"Illinois","Livingston County",1,35,466,234,232
050,17,105,"Illinois","Livingston County",1,36,437,213,224
050,17,105,"Illinois","Livingston County",1,37,445,225,220
050,17,105,"Illinois","Livingston County",1,38,427,222,205
050,17,105,"Illinois","Livingston County",1,39,443,231,212
050,17,105,"Illinois","Livingston County",1,40,436,228,208
050,17,105,"Illinois","Livingston County",1,41,431,231,200
050,17,105,"Illinois","Livingston County",1,42,413,200,213
050,17,105,"Illinois","Livingston County",1,43,399,197,202
050,17,105,"Illinois","Livingston County",1,44,399,214,185
050,17,105,"Illinois","Livingston County",1,45,383,197,186
050,17,105,"Illinois","Livingston County",1,46,386,212,174
050,17,105,"Illinois","Livingston County",1,47,399,207,192
050,17,105,"Illinois","Livingston County",1,48,430,215,215
050,17,105,"Illinois","Livingston County",1,49,450,225,225
050,17,105,"Illinois","Livingston County",1,50,425,222,203
050,17,105,"Illinois","Livingston County",1,51,411,210,201
050,17,105,"Illinois","Livingston County",1,52,419,207,212
050,17,105,"Illinois","Livingston County",1,53,461,245,216
050,17,105,"Illinois","Livingston County",1,54,463,230,233
050,17,105,"Illinois","Livingston County",1,55,513,250,263
050,17,105,"Illinois","Livingston County",1,56,510,269,241
050,17,105,"Illinois","Livingston County",1,57,511,253,258
050,17,105,"Illinois","Livingston County",1,58,530,258,272
050,17,105,"Illinois","Livingston County",1,59,540,265,275
050,17,105,"Illinois","Livingston County",1,60,544,275,269
050,17,105,"Illinois","Livingston County",1,61,571,304,267
050,17,105,"Illinois","Livingston County",1,62,562,292,270
050,17,105,"Illinois","Livingston County",1,63,527,266,261
050,17,105,"Illinois","Livingston County",1,64,494,242,252
050,17,105,"Illinois","Livingston County",1,65,463,225,238
050,17,105,"Illinois","Livingston County",1,66,439,233,206
050,17,105,"Illinois","Livingston County",1,67,441,238,203
050,17,105,"Illinois","Livingston County",1,68,426,206,220
050,17,105,"Illinois","Livingston County",1,69,405,193,212
050,17,105,"Illinois","Livingston County",1,70,403,203,200
050,17,105,"Illinois","Livingston County",1,71,364,175,189
050,17,105,"Illinois","Livingston County",1,72,361,180,181
050,17,105,"Illinois","Livingston County",1,73,352,167,185
050,17,105,"Illinois","Livingston County",1,74,243,103,140
050,17,105,"Illinois","Livingston County",1,75,239,104,135
050,17,105,"Illinois","Livingston County",1,76,244,96,148
050,17,105,"Illinois","Livingston County",1,77,270,121,149
050,17,105,"Illinois","Livingston County",1,78,223,102,121
050,17,105,"Illinois","Livingston County",1,79,199,102,97
050,17,105,"Illinois","Livingston County",1,80,195,91,104
050,17,105,"Illinois","Livingston County",1,81,179,82,97
050,17,105,"Illinois","Livingston County",1,82,180,73,107
050,17,105,"Illinois","Livingston County",1,83,162,69,93
050,17,105,"Illinois","Livingston County",1,84,141,61,80
050,17,105,"Illinois","Livingston County",1,85,959,328,631
050,17,105,"Illinois","Livingston County",2,0,415,217,198
050,17,105,"Illinois","Livingston County",2,1,416,218,198
050,17,105,"Illinois","Livingston County",2,2,426,221,205
050,17,105,"Illinois","Livingston County",2,3,421,215,206
050,17,105,"Illinois","Livingston County",2,4,422,222,200
050,17,105,"Illinois","Livingston County",2,5,416,213,203
050,17,105,"Illinois","Livingston County",2,6,412,206,206
050,17,105,"Illinois","Livingston County",2,7,422,229,193
050,17,105,"Illinois","Livingston County",2,8,420,236,184
050,17,105,"Illinois","Livingston County",2,9,420,219,201
050,17,105,"Illinois","Livingston County",2,10,442,227,215
050,17,105,"Illinois","Livingston County",2,11,450,238,212
050,17,105,"Illinois","Livingston County",2,12,482,264,218
050,17,105,"Illinois","Livingston County",2,13,473,259,214
050,17,105,"Illinois","Livingston County",2,14,457,238,219
050,17,105,"Illinois","Livingston County",2,15,460,250,210
050,17,105,"Illinois","Livingston County",2,16,500,279,221
050,17,105,"Illinois","Livingston County",2,17,495,273,222
050,17,105,"Illinois","Livingston County",2,18,420,229,191
050,17,105,"Illinois","Livingston County",2,19,355,194,161
050,17,105,"Illinois","Livingston County",2,20,378,210,168
050,17,105,"Illinois","Livingston County",2,21,390,221,169
050,17,105,"Illinois","Livingston County",2,22,416,226,190
050,17,105,"Illinois","Livingston County",2,23,413,211,202
050,17,105,"Illinois","Livingston County",2,24,405,205,200
050,17,105,"Illinois","Livingston County",2,25,417,213,204
050,17,105,"Illinois","Livingston County",2,26,422,212,210
050,17,105,"Illinois","Livingston County",2,27,436,229,207
050,17,105,"Illinois","Livingston County",2,28,465,245,220
050,17,105,"Illinois","Livingston County",2,29,455,236,219
050,17,105,"Illinois","Livingston County",2,30,437,216,221
050,17,105,"Illinois","Livingston County",2,31,411,211,200
050,17,105,"Illinois","Livingston County",2,32,428,224,204
050,17,105,"Illinois","Livingston County",2,33,435,229,206
050,17,105,"Illinois","Livingston County",2,34,453,231,222
050,17,105,"Illinois","Livingston County",2,35,464,232,232
050,17,105,"Illinois","Livingston County",2,36,441,216,225
050,17,105,"Illinois","Livingston County",2,37,443,222,221
050,17,105,"Illinois","Livingston County",2,38,436,228,208
050,17,105,"Illinois","Livingston County",2,39,442,229,213
050,17,105,"Illinois","Livingston County",2,40,440,230,210
050,17,105,"Illinois","Livingston County",2,41,428,230,198
050,17,105,"Illinois","Livingston County",2,42,412,203,209
050,17,105,"Illinois","Livingston County",2,43,406,200,206
050,17,105,"Illinois","Livingston County",2,44,394,209,185
050,17,105,"Illinois","Livingston County",2,45,384,198,186
050,17,105,"Illinois","Livingston County",2,46,387,210,177
050,17,105,"Illinois","Livingston County",2,47,395,207,188
050,17,105,"Illinois","Livingston County",2,48,421,212,209
050,17,105,"Illinois","Livingston County",2,49,445,223,222
050,17,105,"Illinois","Livingston County",2,50,434,225,209
050,17,105,"Illinois","Livingston County",2,51,413,212,201
050,17,105,"Illinois","Livingston County",2,52,414,207,207
050,17,105,"Illinois","Livingston County",2,53,450,235,215
050,17,105,"Illinois","Livingston County",2,54,459,232,227
050,17,105,"Illinois","Livingston County",2,55,500,245,255
050,17,105,"Illinois","Livingston County",2,56,507,264,243
050,17,105,"Illinois","Livingston County",2,57,514,258,256
050,17,105,"Illinois","Livingston County",2,58,524,255,269
050,17,105,"Illinois","Livingston County",2,59,535,262,273
050,17,105,"Illinois","Livingston County",2,60,539,270,269
050,17,105,"Illinois","Livingston County",2,61,560,294,266
050,17,105,"Illinois","Livingston County",2,62,562,293,269
050,17,105,"Illinois","Livingston County",2,63,540,274,266
050,17,105,"Illinois","Livingston County",2,64,496,245,251
050,17,105,"Illinois","Livingston County",2,65,469,229,240
050,17,105,"Illinois","Livingston County",2,66,442,229,213
050,17,105,"Illinois","Livingston County",2,67,437,235,202
050,17,105,"Illinois","Livingston County",2,68,424,211,213
050,17,105,"Illinois","Livingston County",2,69,411,198,213
050,17,105,"Illinois","Livingston County",2,70,402,199,203
050,17,105,"Illinois","Livingston County",2,71,376,182,194
050,17,105,"Illinois","Livingston County",2,72,354,176,178
050,17,105,"Illinois","Livingston County",2,73,371,178,193
050,17,105,"Illinois","Livingston County",2,74,253,111,142
050,17,105,"Illinois","Livingston County",2,75,236,101,135
050,17,105,"Illinois","Livingston County",2,76,240,97,143
050,17,105,"Illinois","Livingston County",2,77,266,115,151
050,17,105,"Illinois","Livingston County",2,78,227,103,124
050,17,105,"Illinois","Livingston County",2,79,201,100,101
050,17,105,"Illinois","Livingston County",2,80,194,93,101
050,17,105,"Illinois","Livingston County",2,81,179,82,97
050,17,105,"Illinois","Livingston County",2,82,177,75,102
050,17,105,"Illinois","Livingston County",2,83,162,69,93
050,17,105,"Illinois","Livingston County",2,84,146,62,84
050,17,105,"Illinois","Livingston County",2,85,955,330,625
050,17,105,"Illinois","Livingston County",3,0,420,232,188
050,17,105,"Illinois","Livingston County",3,1,396,211,185
050,17,105,"Illinois","Livingston County",3,2,416,210,206
050,17,105,"Illinois","Livingston County",3,3,441,232,209
050,17,105,"Illinois","Livingston County",3,4,432,222,210
050,17,105,"Illinois","Livingston County",3,5,431,224,207
050,17,105,"Illinois","Livingston County",3,6,423,217,206
050,17,105,"Illinois","Livingston County",3,7,427,216,211
050,17,105,"Illinois","Livingston County",3,8,413,225,188
050,17,105,"Illinois","Livingston County",3,9,420,231,189
050,17,105,"Illinois","Livingston County",3,10,404,213,191
050,17,105,"Illinois","Livingston County",3,11,446,219,227
050,17,105,"Illinois","Livingston County",3,12,451,242,209
050,17,105,"Illinois","Livingston County",3,13,479,256,223
050,17,105,"Illinois","Livingston County",3,14,475,256,219
050,17,105,"Illinois","Livingston County",3,15,453,237,216
050,17,105,"Illinois","Livingston County",3,16,468,253,215
050,17,105,"Illinois","Livingston County",3,17,508,289,219
050,17,105,"Illinois","Livingston County",3,18,420,234,186
050,17,105,"Illinois","Livingston County",3,19,338,185,153
050,17,105,"Illinois","Livingston County",3,20,387,202,185
050,17,105,"Illinois","Livingston County",3,21,393,221,172
050,17,105,"Illinois","Livingston County",3,22,420,226,194
050,17,105,"Illinois","Livingston County",3,23,437,238,199
050,17,105,"Illinois","Livingston County",3,24,417,214,203
050,17,105,"Illinois","Livingston County",3,25,390,199,191
050,17,105,"Illinois","Livingston County",3,26,421,208,213
050,17,105,"Illinois","Livingston County",3,27,425,207,218
050,17,105,"Illinois","Livingston County",3,28,445,224,221
050,17,105,"Illinois","Livingston County",3,29,473,251,222
050,17,105,"Illinois","Livingston County",3,30,456,237,219
050,17,105,"Illinois","Livingston County",3,31,441,218,223
050,17,105,"Illinois","Livingston County",3,32,416,222,194
050,17,105,"Illinois","Livingston County",3,33,437,234,203
050,17,105,"Illinois","Livingston County",3,34,458,240,218
050,17,105,"Illinois","Livingston County",3,35,453,232,221
050,17,105,"Illinois","Livingston County",3,36,454,224,230
050,17,105,"Illinois","Livingston County",3,37,453,224,229
050,17,105,"Illinois","Livingston County",3,38,443,225,218
050,17,105,"Illinois","Livingston County",3,39,448,229,219
050,17,105,"Illinois","Livingston County",3,40,442,224,218
050,17,105,"Illinois","Livingston County",3,41,440,234,206
050,17,105,"Illinois","Livingston County",3,42,437,234,203
050,17,105,"Illinois","Livingston County",3,43,412,211,201
050,17,105,"Illinois","Livingston County",3,44,403,214,189
050,17,105,"Illinois","Livingston County",3,45,394,208,186
050,17,105,"Illinois","Livingston County",3,46,407,214,193
050,17,105,"Illinois","Livingston County",3,47,378,207,171
050,17,105,"Illinois","Livingston County",3,48,396,211,185
050,17,105,"Illinois","Livingston County",3,49,418,217,201
050,17,105,"Illinois","Livingston County",3,50,450,227,223
050,17,105,"Illinois","Livingston County",3,51,428,220,208
050,17,105,"Illinois","Livingston County",3,52,419,225,194
050,17,105,"Illinois","Livingston County",3,53,403,197,206
050,17,105,"Illinois","Livingston County",3,54,445,229,216
050,17,105,"Illinois","Livingston County",3,55,448,230,218
050,17,105,"Illinois","Livingston County",3,56,498,242,256
050,17,105,"Illinois","Livingston County",3,57,490,252,238
050,17,105,"Illinois","Livingston County",3,58,519,264,255
050,17,105,"Illinois","Livingston County",3,59,517,249,268
050,17,105,"Illinois","Livingston County",3,60,530,266,264
050,17,105,"Illinois","Livingston County",3,61,543,276,267
050,17,105,"Illinois","Livingston County",3,62,555,286,269
050,17,105,"Illinois","Livingston County",3,63,548,288,260
050,17,105,"Illinois","Livingston County",3,64,536,276,260
050,17,105,"Illinois","Livingston County",3,65,493,241,252
050,17,105,"Illinois","Livingston County",3,66,463,225,238
050,17,105,"Illinois","Livingston County",3,67,431,220,211
050,17,105,"Illinois","Livingston County",3,68,429,229,200
050,17,105,"Illinois","Livingston County",3,69,404,202,202
050,17,105,"Illinois","Livingston County",3,70,397,192,205
050,17,105,"Illinois","Livingston County",3,71,397,196,201
050,17,105,"Illinois","Livingston County",3,72,358,171,187
050,17,105,"Illinois","Livingston County",3,73,333,161,172
050,17,105,"Illinois","Livingston County",3,74,359,163,196
050,17,105,"Illinois","Livingston County",3,75,239,110,129
050,17,105,"Illinois","Livingston County",3,76,228,95,133
050,17,105,"Illinois","Livingston County",3,77,229,96,133
050,17,105,"Illinois","Livingston County",3,78,251,103,148
050,17,105,"Illinois","Livingston County",3,79,215,101,114
050,17,105,"Illinois","Livingston County",3,80,186,91,95
050,17,105,"Illinois","Livingston County",3,81,182,89,93
050,17,105,"Illinois","Livingston County",3,82,177,81,96
050,17,105,"Illinois","Livingston County",3,83,150,66,84
050,17,105,"Illinois","Livingston County",3,84,145,65,80
050,17,105,"Illinois","Livingston County",3,85,919,321,598
050,17,105,"Illinois","Livingston County",4,0,382,215,167
050,17,105,"Illinois","Livingston County",4,1,406,222,184
050,17,105,"Illinois","Livingston County",4,2,394,207,187
050,17,105,"Illinois","Livingston County",4,3,434,228,206
050,17,105,"Illinois","Livingston County",4,4,437,227,210
050,17,105,"Illinois","Livingston County",4,5,450,230,220
050,17,105,"Illinois","Livingston County",4,6,432,224,208
050,17,105,"Illinois","Livingston County",4,7,418,212,206
050,17,105,"Illinois","Livingston County",4,8,422,213,209
050,17,105,"Illinois","Livingston County",4,9,414,221,193
050,17,105,"Illinois","Livingston County",4,10,420,230,190
050,17,105,"Illinois","Livingston County",4,11,413,220,193
050,17,105,"Illinois","Livingston County",4,12,438,212,226
050,17,105,"Illinois","Livingston County",4,13,442,229,213
050,17,105,"Illinois","Livingston County",4,14,467,246,221
050,17,105,"Illinois","Livingston County",4,15,484,265,219
050,17,105,"Illinois","Livingston County",4,16,464,245,219
050,17,105,"Illinois","Livingston County",4,17,463,247,216
050,17,105,"Illinois","Livingston County",4,18,440,261,179
050,17,105,"Illinois","Livingston County",4,19,343,196,147
050,17,105,"Illinois","Livingston County",4,20,345,188,157
050,17,105,"Illinois","Livingston County",4,21,402,211,191
050,17,105,"Illinois","Livingston County",4,22,414,225,189
050,17,105,"Illinois","Livingston County",4,23,431,227,204
050,17,105,"Illinois","Livingston County",4,24,423,220,203
050,17,105,"Illinois","Livingston County",4,25,406,216,190
050,17,105,"Illinois","Livingston County",4,26,393,206,187
050,17,105,"Illinois","Livingston County",4,27,411,198,213
050,17,105,"Illinois","Livingston County",4,28,442,220,222
050,17,105,"Illinois","Livingston County",4,29,436,220,216
050,17,105,"Illinois","Livingston County",4,30,477,254,223
050,17,105,"Illinois","Livingston County",4,31,457,234,223
050,17,105,"Illinois","Livingston County",4,32,425,212,213
050,17,105,"Illinois","Livingston County",4,33,425,224,201
050,17,105,"Illinois","Livingston County",4,34,443,236,207
050,17,105,"Illinois","Livingston County",4,35,451,229,222
050,17,105,"Illinois","Livingston County",4,36,454,229,225
050,17,105,"Illinois","Livingston County",4,37,458,225,233
050,17,105,"Illinois","Livingston County",4,38,451,233,218
050,17,105,"Illinois","Livingston County",4,39,455,227,228
050,17,105,"Illinois","Livingston County",4,40,445,221,224
050,17,105,"Illinois","Livingston County",4,41,449,230,219
050,17,105,"Illinois","Livingston County",4,42,447,230,217
050,17,105,"Illinois","Livingston County",4,43,430,229,201
050,17,105,"Illinois","Livingston County",4,44,414,215,199
050,17,105,"Illinois","Livingston County",4,45,388,203,185
050,17,105,"Illinois","Livingston County",4,46,404,215,189
050,17,105,"Illinois","Livingston County",4,47,394,204,190
050,17,105,"Illinois","Livingston County",4,48,373,205,168
050,17,105,"Illinois","Livingston County",4,49,392,208,184
050,17,105,"Illinois","Livingston County",4,50,412,211,201
050,17,105,"Illinois","Livingston County",4,51,451,225,226
050,17,105,"Illinois","Livingston County",4,52,429,222,207
050,17,105,"Illinois","Livingston County",4,53,411,220,191
050,17,105,"Illinois","Livingston County",4,54,392,186,206
050,17,105,"Illinois","Livingston County",4,55,446,227,219
050,17,105,"Illinois","Livingston County",4,56,444,224,220
050,17,105,"Illinois","Livingston County",4,57,500,238,262
050,17,105,"Illinois","Livingston County",4,58,484,247,237
050,17,105,"Illinois","Livingston County",4,59,508,259,249
050,17,105,"Illinois","Livingston County",4,60,509,243,266
050,17,105,"Illinois","Livingston County",4,61,522,267,255
050,17,105,"Illinois","Livingston County",4,62,527,271,256
050,17,105,"Illinois","Livingston County",4,63,543,281,262
050,17,105,"Illinois","Livingston County",4,64,529,280,249
050,17,105,"Illinois","Livingston County",4,65,518,265,253
050,17,105,"Illinois","Livingston County",4,66,479,235,244
050,17,105,"Illinois","Livingston County",4,67,454,221,233
050,17,105,"Illinois","Livingston County",4,68,420,218,202
050,17,105,"Illinois","Livingston County",4,69,413,218,195
050,17,105,"Illinois","Livingston County",4,70,385,193,192
050,17,105,"Illinois","Livingston County",4,71,379,184,195
050,17,105,"Illinois","Livingston County",4,72,395,195,200
050,17,105,"Illinois","Livingston County",4,73,340,162,178
050,17,105,"Illinois","Livingston County",4,74,328,154,174
050,17,105,"Illinois","Livingston County",4,75,341,156,185
050,17,105,"Illinois","Livingston County",4,76,231,105,126
050,17,105,"Illinois","Livingston County",4,77,220,92,128
050,17,105,"Illinois","Livingston County",4,78,216,89,127
050,17,105,"Illinois","Livingston County",4,79,241,102,139
050,17,105,"Illinois","Livingston County",4,80,204,95,109
050,17,105,"Illinois","Livingston County",4,81,182,93,89
050,17,105,"Illinois","Livingston County",4,82,183,85,98
050,17,105,"Illinois","Livingston County",4,83,157,74,83
050,17,105,"Illinois","Livingston County",4,84,131,63,68
050,17,105,"Illinois","Livingston County",4,85,895,322,573
050,17,105,"Illinois","Livingston County",5,0,381,213,168
050,17,105,"Illinois","Livingston County",5,1,370,212,158
050,17,105,"Illinois","Livingston County",5,2,414,227,187
050,17,105,"Illinois","Livingston County",5,3,418,219,199
050,17,105,"Illinois","Livingston County",5,4,437,228,209
050,17,105,"Illinois","Livingston County",5,5,438,230,208
050,17,105,"Illinois","Livingston County",5,6,457,235,222
050,17,105,"Illinois","Livingston County",5,7,430,226,204
050,17,105,"Illinois","Livingston County",5,8,420,211,209
050,17,105,"Illinois","Livingston County",5,9,425,220,205
050,17,105,"Illinois","Livingston County",5,10,413,226,187
050,17,105,"Illinois","Livingston County",5,11,422,232,190
050,17,105,"Illinois","Livingston County",5,12,416,217,199
050,17,105,"Illinois","Livingston County",5,13,440,213,227
050,17,105,"Illinois","Livingston County",5,14,439,229,210
050,17,105,"Illinois","Livingston County",5,15,479,254,225
050,17,105,"Illinois","Livingston County",5,16,485,266,219
050,17,105,"Illinois","Livingston County",5,17,456,245,211
050,17,105,"Illinois","Livingston County",5,18,389,218,171
050,17,105,"Illinois","Livingston County",5,19,342,196,146
050,17,105,"Illinois","Livingston County",5,20,360,203,157
050,17,105,"Illinois","Livingston County",5,21,369,196,173
050,17,105,"Illinois","Livingston County",5,22,429,226,203
050,17,105,"Illinois","Livingston County",5,23,428,231,197
050,17,105,"Illinois","Livingston County",5,24,423,217,206
050,17,105,"Illinois","Livingston County",5,25,421,228,193
050,17,105,"Illinois","Livingston County",5,26,396,213,183
050,17,105,"Illinois","Livingston County",5,27,390,198,192
050,17,105,"Illinois","Livingston County",5,28,439,205,234
050,17,105,"Illinois","Livingston County",5,29,430,217,213
050,17,105,"Illinois","Livingston County",5,30,444,225,219
050,17,105,"Illinois","Livingston County",5,31,491,267,224
050,17,105,"Illinois","Livingston County",5,32,456,235,221
050,17,105,"Illinois","Livingston County",5,33,423,217,206
050,17,105,"Illinois","Livingston County",5,34,427,222,205
050,17,105,"Illinois","Livingston County",5,35,442,238,204
050,17,105,"Illinois","Livingston County",5,36,437,222,215
050,17,105,"Illinois","Livingston County",5,37,459,233,226
050,17,105,"Illinois","Livingston County",5,38,452,230,222
050,17,105,"Illinois","Livingston County",5,39,462,236,226
050,17,105,"Illinois","Livingston County",5,40,449,221,228
050,17,105,"Illinois","Livingston County",5,41,437,222,215
050,17,105,"Illinois","Livingston County",5,42,444,218,226
050,17,105,"Illinois","Livingston County",5,43,446,233,213
050,17,105,"Illinois","Livingston County",5,44,423,238,185
050,17,105,"Illinois","Livingston County",5,45,406,208,198
050,17,105,"Illinois","Livingston County",5,46,397,214,183
050,17,105,"Illinois","Livingston County",5,47,396,206,190
050,17,105,"Illinois","Livingston County",5,48,391,206,185
050,17,105,"Illinois","Livingston County",5,49,364,199,165
050,17,105,"Illinois","Livingston County",5,50,393,212,181
050,17,105,"Illinois","Livingston County",5,51,413,205,208
050,17,105,"Illinois","Livingston County",5,52,445,229,216
050,17,105,"Illinois","Livingston County",5,53,421,213,208
050,17,105,"Illinois","Livingston County",5,54,403,213,190
050,17,105,"Illinois","Livingston County",5,55,393,187,206
050,17,105,"Illinois","Livingston County",5,56,436,222,214
050,17,105,"Illinois","Livingston County",5,57,445,218,227
050,17,105,"Illinois","Livingston County",5,58,480,232,248
050,17,105,"Illinois","Livingston County",5,59,474,239,235
050,17,105,"Illinois","Livingston County",5,60,507,256,251
050,17,105,"Illinois","Livingston County",5,61,512,249,263
050,17,105,"Illinois","Livingston County",5,62,506,258,248
050,17,105,"Illinois","Livingston County",5,63,515,270,245
050,17,105,"Illinois","Livingston County",5,64,530,274,256
050,17,105,"Illinois","Livingston County",5,65,514,270,244
050,17,105,"Illinois","Livingston County",5,66,504,260,244
050,17,105,"Illinois","Livingston County",5,67,462,226,236
050,17,105,"Illinois","Livingston County",5,68,448,220,228
050,17,105,"Illinois","Livingston County",5,69,402,210,192
050,17,105,"Illinois","Livingston County",5,70,401,210,191
050,17,105,"Illinois","Livingston County",5,71,378,190,188
050,17,105,"Illinois","Livingston County",5,72,370,178,192
050,17,105,"Illinois","Livingston County",5,73,378,185,193
050,17,105,"Illinois","Livingston County",5,74,334,156,178
050,17,105,"Illinois","Livingston County",5,75,315,153,162
050,17,105,"Illinois","Livingston County",5,76,330,148,182
050,17,105,"Illinois","Livingston County",5,77,224,104,120
050,17,105,"Illinois","Livingston County",5,78,205,83,122
050,17,105,"Illinois","Livingston County",5,79,209,88,121
050,17,105,"Illinois","Livingston County",5,80,226,98,128
050,17,105,"Illinois","Livingston County",5,81,193,92,101
050,17,105,"Illinois","Livingston County",5,82,178,87,91
050,17,105,"Illinois","Livingston County",5,83,166,78,88
050,17,105,"Illinois","Livingston County",5,84,135,66,69
050,17,105,"Illinois","Livingston County",5,85,873,320,553
050,17,107,"Illinois","Logan County",1,0,288,148,140
050,17,107,"Illinois","Logan County",1,1,287,150,137
050,17,107,"Illinois","Logan County",1,2,286,145,141
050,17,107,"Illinois","Logan County",1,3,291,149,142
050,17,107,"Illinois","Logan County",1,4,301,169,132
050,17,107,"Illinois","Logan County",1,5,345,179,166
050,17,107,"Illinois","Logan County",1,6,306,164,142
050,17,107,"Illinois","Logan County",1,7,284,140,144
050,17,107,"Illinois","Logan County",1,8,278,147,131
050,17,107,"Illinois","Logan County",1,9,300,148,152
050,17,107,"Illinois","Logan County",1,10,302,160,142
050,17,107,"Illinois","Logan County",1,11,331,178,153
050,17,107,"Illinois","Logan County",1,12,340,169,171
050,17,107,"Illinois","Logan County",1,13,325,163,162
050,17,107,"Illinois","Logan County",1,14,315,150,165
050,17,107,"Illinois","Logan County",1,15,332,167,165
050,17,107,"Illinois","Logan County",1,16,350,186,164
050,17,107,"Illinois","Logan County",1,17,354,197,157
050,17,107,"Illinois","Logan County",1,18,329,182,147
050,17,107,"Illinois","Logan County",1,19,323,174,149
050,17,107,"Illinois","Logan County",1,20,363,203,160
050,17,107,"Illinois","Logan County",1,21,314,173,141
050,17,107,"Illinois","Logan County",1,22,345,191,154
050,17,107,"Illinois","Logan County",1,23,365,191,174
050,17,107,"Illinois","Logan County",1,24,367,202,165
050,17,107,"Illinois","Logan County",1,25,395,212,183
050,17,107,"Illinois","Logan County",1,26,373,216,157
050,17,107,"Illinois","Logan County",1,27,381,219,162
050,17,107,"Illinois","Logan County",1,28,347,177,170
050,17,107,"Illinois","Logan County",1,29,383,210,173
050,17,107,"Illinois","Logan County",1,30,387,217,170
050,17,107,"Illinois","Logan County",1,31,401,238,163
050,17,107,"Illinois","Logan County",1,32,364,197,167
050,17,107,"Illinois","Logan County",1,33,387,212,175
050,17,107,"Illinois","Logan County",1,34,361,193,168
050,17,107,"Illinois","Logan County",1,35,376,206,170
050,17,107,"Illinois","Logan County",1,36,365,208,157
050,17,107,"Illinois","Logan County",1,37,389,215,174
050,17,107,"Illinois","Logan County",1,38,403,216,187
050,17,107,"Illinois","Logan County",1,39,408,217,191
050,17,107,"Illinois","Logan County",1,40,382,200,182
050,17,107,"Illinois","Logan County",1,41,368,191,177
050,17,107,"Illinois","Logan County",1,42,368,186,182
050,17,107,"Illinois","Logan County",1,43,361,186,175
050,17,107,"Illinois","Logan County",1,44,346,172,174
050,17,107,"Illinois","Logan County",1,45,337,172,165
050,17,107,"Illinois","Logan County",1,46,312,154,158
050,17,107,"Illinois","Logan County",1,47,307,148,159
050,17,107,"Illinois","Logan County",1,48,330,176,154
050,17,107,"Illinois","Logan County",1,49,367,198,169
050,17,107,"Illinois","Logan County",1,50,342,186,156
050,17,107,"Illinois","Logan County",1,51,329,173,156
050,17,107,"Illinois","Logan County",1,52,329,171,158
050,17,107,"Illinois","Logan County",1,53,333,173,160
050,17,107,"Illinois","Logan County",1,54,340,167,173
050,17,107,"Illinois","Logan County",1,55,330,169,161
050,17,107,"Illinois","Logan County",1,56,381,190,191
050,17,107,"Illinois","Logan County",1,57,377,191,186
050,17,107,"Illinois","Logan County",1,58,395,205,190
050,17,107,"Illinois","Logan County",1,59,410,210,200
050,17,107,"Illinois","Logan County",1,60,395,187,208
050,17,107,"Illinois","Logan County",1,61,392,191,201
050,17,107,"Illinois","Logan County",1,62,392,197,195
050,17,107,"Illinois","Logan County",1,63,361,190,171
050,17,107,"Illinois","Logan County",1,64,361,177,184
050,17,107,"Illinois","Logan County",1,65,344,169,175
050,17,107,"Illinois","Logan County",1,66,341,163,178
050,17,107,"Illinois","Logan County",1,67,343,164,179
050,17,107,"Illinois","Logan County",1,68,321,151,170
050,17,107,"Illinois","Logan County",1,69,307,142,165
050,17,107,"Illinois","Logan County",1,70,303,151,152
050,17,107,"Illinois","Logan County",1,71,280,140,140
050,17,107,"Illinois","Logan County",1,72,271,119,152
050,17,107,"Illinois","Logan County",1,73,263,118,145
050,17,107,"Illinois","Logan County",1,74,191,86,105
050,17,107,"Illinois","Logan County",1,75,196,99,97
050,17,107,"Illinois","Logan County",1,76,210,98,112
050,17,107,"Illinois","Logan County",1,77,216,98,118
050,17,107,"Illinois","Logan County",1,78,163,65,98
050,17,107,"Illinois","Logan County",1,79,161,70,91
050,17,107,"Illinois","Logan County",1,80,150,61,89
050,17,107,"Illinois","Logan County",1,81,146,59,87
050,17,107,"Illinois","Logan County",1,82,136,60,76
050,17,107,"Illinois","Logan County",1,83,117,47,70
050,17,107,"Illinois","Logan County",1,84,120,38,82
050,17,107,"Illinois","Logan County",1,85,730,237,493
050,17,107,"Illinois","Logan County",2,0,269,141,128
050,17,107,"Illinois","Logan County",2,1,284,148,136
050,17,107,"Illinois","Logan County",2,2,284,144,140
050,17,107,"Illinois","Logan County",2,3,284,145,139
050,17,107,"Illinois","Logan County",2,4,300,166,134
050,17,107,"Illinois","Logan County",2,5,331,177,154
050,17,107,"Illinois","Logan County",2,6,314,166,148
050,17,107,"Illinois","Logan County",2,7,290,148,142
050,17,107,"Illinois","Logan County",2,8,278,146,132
050,17,107,"Illinois","Logan County",2,9,293,146,147
050,17,107,"Illinois","Logan County",2,10,305,160,145
050,17,107,"Illinois","Logan County",2,11,323,172,151
050,17,107,"Illinois","Logan County",2,12,340,173,167
050,17,107,"Illinois","Logan County",2,13,329,164,165
050,17,107,"Illinois","Logan County",2,14,317,153,164
050,17,107,"Illinois","Logan County",2,15,329,163,166
050,17,107,"Illinois","Logan County",2,16,347,180,167
050,17,107,"Illinois","Logan County",2,17,352,195,157
050,17,107,"Illinois","Logan County",2,18,326,183,143
050,17,107,"Illinois","Logan County",2,19,328,177,151
050,17,107,"Illinois","Logan County",2,20,365,206,159
050,17,107,"Illinois","Logan County",2,21,317,173,144
050,17,107,"Illinois","Logan County",2,22,345,190,155
050,17,107,"Illinois","Logan County",2,23,364,193,171
050,17,107,"Illinois","Logan County",2,24,361,197,164
050,17,107,"Illinois","Logan County",2,25,392,215,177
050,17,107,"Illinois","Logan County",2,26,374,211,163
050,17,107,"Illinois","Logan County",2,27,378,220,158
050,17,107,"Illinois","Logan County",2,28,348,180,168
050,17,107,"Illinois","Logan County",2,29,378,207,171
050,17,107,"Illinois","Logan County",2,30,391,217,174
050,17,107,"Illinois","Logan County",2,31,395,232,163
050,17,107,"Illinois","Logan County",2,32,367,203,164
050,17,107,"Illinois","Logan County",2,33,382,212,170
050,17,107,"Illinois","Logan County",2,34,368,195,173
050,17,107,"Illinois","Logan County",2,35,373,205,168
050,17,107,"Illinois","Logan County",2,36,368,205,163
050,17,107,"Illinois","Logan County",2,37,380,212,168
050,17,107,"Illinois","Logan County",2,38,401,216,185
050,17,107,"Illinois","Logan County",2,39,403,216,187
050,17,107,"Illinois","Logan County",2,40,392,204,188
050,17,107,"Illinois","Logan County",2,41,368,192,176
050,17,107,"Illinois","Logan County",2,42,367,188,179
050,17,107,"Illinois","Logan County",2,43,370,190,180
050,17,107,"Illinois","Logan County",2,44,341,170,171
050,17,107,"Illinois","Logan County",2,45,340,174,166
050,17,107,"Illinois","Logan County",2,46,312,154,158
050,17,107,"Illinois","Logan County",2,47,309,149,160
050,17,107,"Illinois","Logan County",2,48,321,169,152
050,17,107,"Illinois","Logan County",2,49,359,193,166
050,17,107,"Illinois","Logan County",2,50,347,188,159
050,17,107,"Illinois","Logan County",2,51,330,175,155
050,17,107,"Illinois","Logan County",2,52,324,170,154
050,17,107,"Illinois","Logan County",2,53,332,172,160
050,17,107,"Illinois","Logan County",2,54,339,168,171
050,17,107,"Illinois","Logan County",2,55,328,167,161
050,17,107,"Illinois","Logan County",2,56,368,184,184
050,17,107,"Illinois","Logan County",2,57,376,191,185
050,17,107,"Illinois","Logan County",2,58,387,199,188
050,17,107,"Illinois","Logan County",2,59,403,205,198
050,17,107,"Illinois","Logan County",2,60,393,192,201
050,17,107,"Illinois","Logan County",2,61,388,187,201
050,17,107,"Illinois","Logan County",2,62,389,195,194
050,17,107,"Illinois","Logan County",2,63,372,195,177
050,17,107,"Illinois","Logan County",2,64,359,178,181
050,17,107,"Illinois","Logan County",2,65,342,169,173
050,17,107,"Illinois","Logan County",2,66,339,163,176
050,17,107,"Illinois","Logan County",2,67,341,162,179
050,17,107,"Illinois","Logan County",2,68,323,152,171
050,17,107,"Illinois","Logan County",2,69,311,144,167
050,17,107,"Illinois","Logan County",2,70,303,149,154
050,17,107,"Illinois","Logan County",2,71,281,141,140
050,17,107,"Illinois","Logan County",2,72,266,122,144
050,17,107,"Illinois","Logan County",2,73,277,123,154
050,17,107,"Illinois","Logan County",2,74,194,88,106
050,17,107,"Illinois","Logan County",2,75,191,93,98
050,17,107,"Illinois","Logan County",2,76,202,95,107
050,17,107,"Illinois","Logan County",2,77,220,99,121
050,17,107,"Illinois","Logan County",2,78,167,68,99
050,17,107,"Illinois","Logan County",2,79,163,69,94
050,17,107,"Illinois","Logan County",2,80,150,61,89
050,17,107,"Illinois","Logan County",2,81,142,57,85
050,17,107,"Illinois","Logan County",2,82,136,58,78
050,17,107,"Illinois","Logan County",2,83,120,50,70
050,17,107,"Illinois","Logan County",2,84,121,40,81
050,17,107,"Illinois","Logan County",2,85,736,238,498
050,17,107,"Illinois","Logan County",3,0,236,130,106
050,17,107,"Illinois","Logan County",3,1,267,140,127
050,17,107,"Illinois","Logan County",3,2,273,142,131
050,17,107,"Illinois","Logan County",3,3,290,149,141
050,17,107,"Illinois","Logan County",3,4,293,143,150
050,17,107,"Illinois","Logan County",3,5,305,163,142
050,17,107,"Illinois","Logan County",3,6,319,167,152
050,17,107,"Illinois","Logan County",3,7,321,170,151
050,17,107,"Illinois","Logan County",3,8,298,148,150
050,17,107,"Illinois","Logan County",3,9,272,140,132
050,17,107,"Illinois","Logan County",3,10,297,150,147
050,17,107,"Illinois","Logan County",3,11,309,161,148
050,17,107,"Illinois","Logan County",3,12,325,169,156
050,17,107,"Illinois","Logan County",3,13,334,169,165
050,17,107,"Illinois","Logan County",3,14,332,163,169
050,17,107,"Illinois","Logan County",3,15,324,156,168
050,17,107,"Illinois","Logan County",3,16,334,170,164
050,17,107,"Illinois","Logan County",3,17,345,183,162
050,17,107,"Illinois","Logan County",3,18,341,198,143
050,17,107,"Illinois","Logan County",3,19,334,183,151
050,17,107,"Illinois","Logan County",3,20,366,210,156
050,17,107,"Illinois","Logan County",3,21,327,172,155
050,17,107,"Illinois","Logan County",3,22,345,187,158
050,17,107,"Illinois","Logan County",3,23,350,189,161
050,17,107,"Illinois","Logan County",3,24,357,191,166
050,17,107,"Illinois","Logan County",3,25,402,221,181
050,17,107,"Illinois","Logan County",3,26,406,221,185
050,17,107,"Illinois","Logan County",3,27,394,233,161
050,17,107,"Illinois","Logan County",3,28,377,202,175
050,17,107,"Illinois","Logan County",3,29,372,206,166
050,17,107,"Illinois","Logan County",3,30,396,201,195
050,17,107,"Illinois","Logan County",3,31,408,227,181
050,17,107,"Illinois","Logan County",3,32,379,217,162
050,17,107,"Illinois","Logan County",3,33,379,217,162
050,17,107,"Illinois","Logan County",3,34,382,199,183
050,17,107,"Illinois","Logan County",3,35,363,192,171
050,17,107,"Illinois","Logan County",3,36,395,208,187
050,17,107,"Illinois","Logan County",3,37,377,217,160
050,17,107,"Illinois","Logan County",3,38,402,219,183
050,17,107,"Illinois","Logan County",3,39,398,225,173
050,17,107,"Illinois","Logan County",3,40,414,210,204
050,17,107,"Illinois","Logan County",3,41,380,196,184
050,17,107,"Illinois","Logan County",3,42,373,201,172
050,17,107,"Illinois","Logan County",3,43,395,203,192
050,17,107,"Illinois","Logan County",3,44,367,181,186
050,17,107,"Illinois","Logan County",3,45,340,170,170
050,17,107,"Illinois","Logan County",3,46,332,167,165
050,17,107,"Illinois","Logan County",3,47,315,155,160
050,17,107,"Illinois","Logan County",3,48,297,149,148
050,17,107,"Illinois","Logan County",3,49,331,173,158
050,17,107,"Illinois","Logan County",3,50,365,198,167
050,17,107,"Illinois","Logan County",3,51,346,183,163
050,17,107,"Illinois","Logan County",3,52,321,171,150
050,17,107,"Illinois","Logan County",3,53,327,169,158
050,17,107,"Illinois","Logan County",3,54,341,168,173
050,17,107,"Illinois","Logan County",3,55,323,162,161
050,17,107,"Illinois","Logan County",3,56,333,170,163
050,17,107,"Illinois","Logan County",3,57,363,182,181
050,17,107,"Illinois","Logan County",3,58,380,195,185
050,17,107,"Illinois","Logan County",3,59,371,186,185
050,17,107,"Illinois","Logan County",3,60,390,204,186
050,17,107,"Illinois","Logan County",3,61,379,184,195
050,17,107,"Illinois","Logan County",3,62,377,181,196
050,17,107,"Illinois","Logan County",3,63,383,190,193
050,17,107,"Illinois","Logan County",3,64,373,195,178
050,17,107,"Illinois","Logan County",3,65,346,171,175
050,17,107,"Illinois","Logan County",3,66,337,166,171
050,17,107,"Illinois","Logan County",3,67,320,153,167
050,17,107,"Illinois","Logan County",3,68,334,156,178
050,17,107,"Illinois","Logan County",3,69,311,145,166
050,17,107,"Illinois","Logan County",3,70,308,143,165
050,17,107,"Illinois","Logan County",3,71,286,140,146
050,17,107,"Illinois","Logan County",3,72,268,135,133
050,17,107,"Illinois","Logan County",3,73,264,115,149
050,17,107,"Illinois","Logan County",3,74,269,121,148
050,17,107,"Illinois","Logan County",3,75,184,83,101
050,17,107,"Illinois","Logan County",3,76,180,88,92
050,17,107,"Illinois","Logan County",3,77,196,86,110
050,17,107,"Illinois","Logan County",3,78,209,93,116
050,17,107,"Illinois","Logan County",3,79,164,66,98
050,17,107,"Illinois","Logan County",3,80,153,65,88
050,17,107,"Illinois","Logan County",3,81,143,58,85
050,17,107,"Illinois","Logan County",3,82,127,48,79
050,17,107,"Illinois","Logan County",3,83,121,52,69
050,17,107,"Illinois","Logan County",3,84,112,46,66
050,17,107,"Illinois","Logan County",3,85,707,225,482
050,17,107,"Illinois","Logan County",4,0,255,128,127
050,17,107,"Illinois","Logan County",4,1,239,132,107
050,17,107,"Illinois","Logan County",4,2,255,135,120
050,17,107,"Illinois","Logan County",4,3,270,138,132
050,17,107,"Illinois","Logan County",4,4,296,155,141
050,17,107,"Illinois","Logan County",4,5,282,136,146
050,17,107,"Illinois","Logan County",4,6,298,159,139
050,17,107,"Illinois","Logan County",4,7,319,168,151
050,17,107,"Illinois","Logan County",4,8,326,171,155
050,17,107,"Illinois","Logan County",4,9,300,150,150
050,17,107,"Illinois","Logan County",4,10,270,142,128
050,17,107,"Illinois","Logan County",4,11,293,147,146
050,17,107,"Illinois","Logan County",4,12,309,162,147
050,17,107,"Illinois","Logan County",4,13,331,172,159
050,17,107,"Illinois","Logan County",4,14,345,174,171
050,17,107,"Illinois","Logan County",4,15,343,172,171
050,17,107,"Illinois","Logan County",4,16,325,162,163
050,17,107,"Illinois","Logan County",4,17,347,176,171
050,17,107,"Illinois","Logan County",4,18,340,186,154
050,17,107,"Illinois","Logan County",4,19,341,195,146
050,17,107,"Illinois","Logan County",4,20,376,221,155
050,17,107,"Illinois","Logan County",4,21,326,179,147
050,17,107,"Illinois","Logan County",4,22,364,199,165
050,17,107,"Illinois","Logan County",4,23,353,195,158
050,17,107,"Illinois","Logan County",4,24,360,185,175
050,17,107,"Illinois","Logan County",4,25,366,211,155
050,17,107,"Illinois","Logan County",4,26,369,195,174
050,17,107,"Illinois","Logan County",4,27,397,226,171
050,17,107,"Illinois","Logan County",4,28,353,194,159
050,17,107,"Illinois","Logan County",4,29,380,223,157
050,17,107,"Illinois","Logan County",4,30,387,207,180
050,17,107,"Illinois","Logan County",4,31,398,209,189
050,17,107,"Illinois","Logan County",4,32,384,217,167
050,17,107,"Illinois","Logan County",4,33,378,226,152
050,17,107,"Illinois","Logan County",4,34,375,200,175
050,17,107,"Illinois","Logan County",4,35,382,202,180
050,17,107,"Illinois","Logan County",4,36,367,184,183
050,17,107,"Illinois","Logan County",4,37,376,201,175
050,17,107,"Illinois","Logan County",4,38,359,205,154
050,17,107,"Illinois","Logan County",4,39,382,213,169
050,17,107,"Illinois","Logan County",4,40,396,212,184
050,17,107,"Illinois","Logan County",4,41,386,197,189
050,17,107,"Illinois","Logan County",4,42,380,200,180
050,17,107,"Illinois","Logan County",4,43,382,208,174
050,17,107,"Illinois","Logan County",4,44,379,190,189
050,17,107,"Illinois","Logan County",4,45,357,181,176
050,17,107,"Illinois","Logan County",4,46,319,160,159
050,17,107,"Illinois","Logan County",4,47,319,159,160
050,17,107,"Illinois","Logan County",4,48,301,155,146
050,17,107,"Illinois","Logan County",4,49,297,150,147
050,17,107,"Illinois","Logan County",4,50,319,168,151
050,17,107,"Illinois","Logan County",4,51,357,191,166
050,17,107,"Illinois","Logan County",4,52,325,171,154
050,17,107,"Illinois","Logan County",4,53,327,177,150
050,17,107,"Illinois","Logan County",4,54,343,170,173
050,17,107,"Illinois","Logan County",4,55,315,154,161
050,17,107,"Illinois","Logan County",4,56,327,167,160
050,17,107,"Illinois","Logan County",4,57,315,164,151
050,17,107,"Illinois","Logan County",4,58,359,181,178
050,17,107,"Illinois","Logan County",4,59,363,177,186
050,17,107,"Illinois","Logan County",4,60,360,182,178
050,17,107,"Illinois","Logan County",4,61,378,186,192
050,17,107,"Illinois","Logan County",4,62,369,182,187
050,17,107,"Illinois","Logan County",4,63,363,174,189
050,17,107,"Illinois","Logan County",4,64,383,190,193
050,17,107,"Illinois","Logan County",4,65,346,180,166
050,17,107,"Illinois","Logan County",4,66,338,170,168
050,17,107,"Illinois","Logan County",4,67,335,166,169
050,17,107,"Illinois","Logan County",4,68,312,152,160
050,17,107,"Illinois","Logan County",4,69,321,149,172
050,17,107,"Illinois","Logan County",4,70,301,141,160
050,17,107,"Illinois","Logan County",4,71,296,133,163
050,17,107,"Illinois","Logan County",4,72,278,136,142
050,17,107,"Illinois","Logan County",4,73,263,128,135
050,17,107,"Illinois","Logan County",4,74,256,119,137
050,17,107,"Illinois","Logan County",4,75,266,117,149
050,17,107,"Illinois","Logan County",4,76,178,79,99
050,17,107,"Illinois","Logan County",4,77,182,82,100
050,17,107,"Illinois","Logan County",4,78,181,76,105
050,17,107,"Illinois","Logan County",4,79,210,94,116
050,17,107,"Illinois","Logan County",4,80,160,63,97
050,17,107,"Illinois","Logan County",4,81,146,59,87
050,17,107,"Illinois","Logan County",4,82,130,53,77
050,17,107,"Illinois","Logan County",4,83,117,43,74
050,17,107,"Illinois","Logan County",4,84,125,52,73
050,17,107,"Illinois","Logan County",4,85,690,232,458
050,17,107,"Illinois","Logan County",5,0,252,125,127
050,17,107,"Illinois","Logan County",5,1,266,137,129
050,17,107,"Illinois","Logan County",5,2,234,124,110
050,17,107,"Illinois","Logan County",5,3,252,134,118
050,17,107,"Illinois","Logan County",5,4,284,150,134
050,17,107,"Illinois","Logan County",5,5,290,155,135
050,17,107,"Illinois","Logan County",5,6,276,132,144
050,17,107,"Illinois","Logan County",5,7,316,165,151
050,17,107,"Illinois","Logan County",5,8,321,171,150
050,17,107,"Illinois","Logan County",5,9,332,175,157
050,17,107,"Illinois","Logan County",5,10,301,152,149
050,17,107,"Illinois","Logan County",5,11,263,139,124
050,17,107,"Illinois","Logan County",5,12,304,153,151
050,17,107,"Illinois","Logan County",5,13,314,166,148
050,17,107,"Illinois","Logan County",5,14,333,167,166
050,17,107,"Illinois","Logan County",5,15,342,169,173
050,17,107,"Illinois","Logan County",5,16,326,165,161
050,17,107,"Illinois","Logan County",5,17,324,159,165
050,17,107,"Illinois","Logan County",5,18,327,176,151
050,17,107,"Illinois","Logan County",5,19,335,188,147
050,17,107,"Illinois","Logan County",5,20,380,237,143
050,17,107,"Illinois","Logan County",5,21,339,192,147
050,17,107,"Illinois","Logan County",5,22,349,197,152
050,17,107,"Illinois","Logan County",5,23,384,202,182
050,17,107,"Illinois","Logan County",5,24,352,192,160
050,17,107,"Illinois","Logan County",5,25,376,203,173
050,17,107,"Illinois","Logan County",5,26,344,198,146
050,17,107,"Illinois","Logan County",5,27,361,197,164
050,17,107,"Illinois","Logan County",5,28,369,193,176
050,17,107,"Illinois","Logan County",5,29,362,206,156
050,17,107,"Illinois","Logan County",5,30,420,230,190
050,17,107,"Illinois","Logan County",5,31,400,217,183
050,17,107,"Illinois","Logan County",5,32,392,204,188
050,17,107,"Illinois","Logan County",5,33,393,231,162
050,17,107,"Illinois","Logan County",5,34,388,218,170
050,17,107,"Illinois","Logan County",5,35,378,206,172
050,17,107,"Illinois","Logan County",5,36,377,189,188
050,17,107,"Illinois","Logan County",5,37,370,187,183
050,17,107,"Illinois","Logan County",5,38,381,209,172
050,17,107,"Illinois","Logan County",5,39,350,204,146
050,17,107,"Illinois","Logan County",5,40,388,205,183
050,17,107,"Illinois","Logan County",5,41,384,202,182
050,17,107,"Illinois","Logan County",5,42,388,200,188
050,17,107,"Illinois","Logan County",5,43,392,213,179
050,17,107,"Illinois","Logan County",5,44,371,200,171
050,17,107,"Illinois","Logan County",5,45,364,186,178
050,17,107,"Illinois","Logan County",5,46,342,169,173
050,17,107,"Illinois","Logan County",5,47,314,151,163
050,17,107,"Illinois","Logan County",5,48,309,157,152
050,17,107,"Illinois","Logan County",5,49,308,155,153
050,17,107,"Illinois","Logan County",5,50,288,150,138
050,17,107,"Illinois","Logan County",5,51,312,158,154
050,17,107,"Illinois","Logan County",5,52,341,187,154
050,17,107,"Illinois","Logan County",5,53,324,170,154
050,17,107,"Illinois","Logan County",5,54,335,173,162
050,17,107,"Illinois","Logan County",5,55,319,154,165
050,17,107,"Illinois","Logan County",5,56,317,159,158
050,17,107,"Illinois","Logan County",5,57,322,165,157
050,17,107,"Illinois","Logan County",5,58,322,166,156
050,17,107,"Illinois","Logan County",5,59,341,165,176
050,17,107,"Illinois","Logan County",5,60,355,176,179
050,17,107,"Illinois","Logan County",5,61,352,171,181
050,17,107,"Illinois","Logan County",5,62,372,185,187
050,17,107,"Illinois","Logan County",5,63,363,179,184
050,17,107,"Illinois","Logan County",5,64,358,174,184
050,17,107,"Illinois","Logan County",5,65,370,181,189
050,17,107,"Illinois","Logan County",5,66,338,176,162
050,17,107,"Illinois","Logan County",5,67,333,165,168
050,17,107,"Illinois","Logan County",5,68,314,156,158
050,17,107,"Illinois","Logan County",5,69,304,147,157
050,17,107,"Illinois","Logan County",5,70,322,151,171
050,17,107,"Illinois","Logan County",5,71,293,138,155
050,17,107,"Illinois","Logan County",5,72,286,126,160
050,17,107,"Illinois","Logan County",5,73,283,134,149
050,17,107,"Illinois","Logan County",5,74,257,128,129
050,17,107,"Illinois","Logan County",5,75,247,113,134
050,17,107,"Illinois","Logan County",5,76,253,110,143
050,17,107,"Illinois","Logan County",5,77,173,72,101
050,17,107,"Illinois","Logan County",5,78,167,73,94
050,17,107,"Illinois","Logan County",5,79,177,75,102
050,17,107,"Illinois","Logan County",5,80,203,90,113
050,17,107,"Illinois","Logan County",5,81,152,56,96
050,17,107,"Illinois","Logan County",5,82,135,55,80
050,17,107,"Illinois","Logan County",5,83,123,50,73
050,17,107,"Illinois","Logan County",5,84,121,43,78
050,17,107,"Illinois","Logan County",5,85,701,245,456
050,17,109,"Illinois","McDonough County",1,0,228,118,110
050,17,109,"Illinois","McDonough County",1,1,257,136,121
050,17,109,"Illinois","McDonough County",1,2,264,141,123
050,17,109,"Illinois","McDonough County",1,3,264,131,133
050,17,109,"Illinois","McDonough County",1,4,246,124,122
050,17,109,"Illinois","McDonough County",1,5,249,125,124
050,17,109,"Illinois","McDonough County",1,6,250,134,116
050,17,109,"Illinois","McDonough County",1,7,265,135,130
050,17,109,"Illinois","McDonough County",1,8,270,142,128
050,17,109,"Illinois","McDonough County",1,9,267,140,127
050,17,109,"Illinois","McDonough County",1,10,267,140,127
050,17,109,"Illinois","McDonough County",1,11,282,135,147
050,17,109,"Illinois","McDonough County",1,12,266,140,126
050,17,109,"Illinois","McDonough County",1,13,291,151,140
050,17,109,"Illinois","McDonough County",1,14,287,160,127
050,17,109,"Illinois","McDonough County",1,15,291,146,145
050,17,109,"Illinois","McDonough County",1,16,295,143,152
050,17,109,"Illinois","McDonough County",1,17,304,158,146
050,17,109,"Illinois","McDonough County",1,18,563,246,317
050,17,109,"Illinois","McDonough County",1,19,943,426,517
050,17,109,"Illinois","McDonough County",1,20,1091,502,589
050,17,109,"Illinois","McDonough County",1,21,1044,538,506
050,17,109,"Illinois","McDonough County",1,22,835,440,395
050,17,109,"Illinois","McDonough County",1,23,579,309,270
050,17,109,"Illinois","McDonough County",1,24,420,234,186
050,17,109,"Illinois","McDonough County",1,25,343,189,154
050,17,109,"Illinois","McDonough County",1,26,310,170,140
050,17,109,"Illinois","McDonough County",1,27,284,150,134
050,17,109,"Illinois","McDonough County",1,28,272,144,128
050,17,109,"Illinois","McDonough County",1,29,318,160,158
050,17,109,"Illinois","McDonough County",1,30,312,184,128
050,17,109,"Illinois","McDonough County",1,31,322,169,153
050,17,109,"Illinois","McDonough County",1,32,292,164,128
050,17,109,"Illinois","McDonough County",1,33,307,161,146
050,17,109,"Illinois","McDonough County",1,34,291,144,147
050,17,109,"Illinois","McDonough County",1,35,302,147,155
050,17,109,"Illinois","McDonough County",1,36,283,142,141
050,17,109,"Illinois","McDonough County",1,37,317,148,169
050,17,109,"Illinois","McDonough County",1,38,308,160,148
050,17,109,"Illinois","McDonough County",1,39,297,138,159
050,17,109,"Illinois","McDonough County",1,40,294,143,151
050,17,109,"Illinois","McDonough County",1,41,265,130,135
050,17,109,"Illinois","McDonough County",1,42,265,134,131
050,17,109,"Illinois","McDonough County",1,43,264,136,128
050,17,109,"Illinois","McDonough County",1,44,245,123,122
050,17,109,"Illinois","McDonough County",1,45,245,120,125
050,17,109,"Illinois","McDonough County",1,46,235,117,118
050,17,109,"Illinois","McDonough County",1,47,265,136,129
050,17,109,"Illinois","McDonough County",1,48,286,155,131
050,17,109,"Illinois","McDonough County",1,49,283,142,141
050,17,109,"Illinois","McDonough County",1,50,291,143,148
050,17,109,"Illinois","McDonough County",1,51,237,117,120
050,17,109,"Illinois","McDonough County",1,52,231,115,116
050,17,109,"Illinois","McDonough County",1,53,273,131,142
050,17,109,"Illinois","McDonough County",1,54,282,138,144
050,17,109,"Illinois","McDonough County",1,55,306,159,147
050,17,109,"Illinois","McDonough County",1,56,314,159,155
050,17,109,"Illinois","McDonough County",1,57,335,170,165
050,17,109,"Illinois","McDonough County",1,58,324,161,163
050,17,109,"Illinois","McDonough County",1,59,330,154,176
050,17,109,"Illinois","McDonough County",1,60,356,173,183
050,17,109,"Illinois","McDonough County",1,61,331,164,167
050,17,109,"Illinois","McDonough County",1,62,386,193,193
050,17,109,"Illinois","McDonough County",1,63,345,170,175
050,17,109,"Illinois","McDonough County",1,64,301,156,145
050,17,109,"Illinois","McDonough County",1,65,313,155,158
050,17,109,"Illinois","McDonough County",1,66,326,167,159
050,17,109,"Illinois","McDonough County",1,67,333,150,183
050,17,109,"Illinois","McDonough County",1,68,321,148,173
050,17,109,"Illinois","McDonough County",1,69,314,158,156
050,17,109,"Illinois","McDonough County",1,70,288,152,136
050,17,109,"Illinois","McDonough County",1,71,269,121,148
050,17,109,"Illinois","McDonough County",1,72,281,136,145
050,17,109,"Illinois","McDonough County",1,73,265,134,131
050,17,109,"Illinois","McDonough County",1,74,172,77,95
050,17,109,"Illinois","McDonough County",1,75,180,83,97
050,17,109,"Illinois","McDonough County",1,76,192,88,104
050,17,109,"Illinois","McDonough County",1,77,178,87,91
050,17,109,"Illinois","McDonough County",1,78,157,70,87
050,17,109,"Illinois","McDonough County",1,79,145,66,79
050,17,109,"Illinois","McDonough County",1,80,136,60,76
050,17,109,"Illinois","McDonough County",1,81,132,57,75
050,17,109,"Illinois","McDonough County",1,82,105,44,61
050,17,109,"Illinois","McDonough County",1,83,90,33,57
050,17,109,"Illinois","McDonough County",1,84,109,46,63
050,17,109,"Illinois","McDonough County",1,85,761,219,542
050,17,109,"Illinois","McDonough County",2,0,244,124,120
050,17,109,"Illinois","McDonough County",2,1,248,132,116
050,17,109,"Illinois","McDonough County",2,2,260,138,122
050,17,109,"Illinois","McDonough County",2,3,263,134,129
050,17,109,"Illinois","McDonough County",2,4,249,126,123
050,17,109,"Illinois","McDonough County",2,5,245,122,123
050,17,109,"Illinois","McDonough County",2,6,247,129,118
050,17,109,"Illinois","McDonough County",2,7,257,132,125
050,17,109,"Illinois","McDonough County",2,8,265,138,127
050,17,109,"Illinois","McDonough County",2,9,264,139,125
050,17,109,"Illinois","McDonough County",2,10,267,138,129
050,17,109,"Illinois","McDonough County",2,11,275,136,139
050,17,109,"Illinois","McDonough County",2,12,274,141,133
050,17,109,"Illinois","McDonough County",2,13,286,149,137
050,17,109,"Illinois","McDonough County",2,14,287,158,129
050,17,109,"Illinois","McDonough County",2,15,287,148,139
050,17,109,"Illinois","McDonough County",2,16,291,143,148
050,17,109,"Illinois","McDonough County",2,17,303,153,150
050,17,109,"Illinois","McDonough County",2,18,564,246,318
050,17,109,"Illinois","McDonough County",2,19,940,426,514
050,17,109,"Illinois","McDonough County",2,20,1109,508,601
050,17,109,"Illinois","McDonough County",2,21,1052,544,508
050,17,109,"Illinois","McDonough County",2,22,824,437,387
050,17,109,"Illinois","McDonough County",2,23,576,308,268
050,17,109,"Illinois","McDonough County",2,24,426,237,189
050,17,109,"Illinois","McDonough County",2,25,336,183,153
050,17,109,"Illinois","McDonough County",2,26,308,169,139
050,17,109,"Illinois","McDonough County",2,27,277,148,129
050,17,109,"Illinois","McDonough County",2,28,276,145,131
050,17,109,"Illinois","McDonough County",2,29,306,156,150
050,17,109,"Illinois","McDonough County",2,30,311,177,134
050,17,109,"Illinois","McDonough County",2,31,315,171,144
050,17,109,"Illinois","McDonough County",2,32,292,161,131
050,17,109,"Illinois","McDonough County",2,33,299,159,140
050,17,109,"Illinois","McDonough County",2,34,290,145,145
050,17,109,"Illinois","McDonough County",2,35,296,146,150
050,17,109,"Illinois","McDonough County",2,36,281,139,142
050,17,109,"Illinois","McDonough County",2,37,302,144,158
050,17,109,"Illinois","McDonough County",2,38,311,159,152
050,17,109,"Illinois","McDonough County",2,39,300,142,158
050,17,109,"Illinois","McDonough County",2,40,292,141,151
050,17,109,"Illinois","McDonough County",2,41,268,130,138
050,17,109,"Illinois","McDonough County",2,42,261,131,130
050,17,109,"Illinois","McDonough County",2,43,263,134,129
050,17,109,"Illinois","McDonough County",2,44,242,122,120
050,17,109,"Illinois","McDonough County",2,45,246,120,126
050,17,109,"Illinois","McDonough County",2,46,233,117,116
050,17,109,"Illinois","McDonough County",2,47,257,132,125
050,17,109,"Illinois","McDonough County",2,48,277,149,128
050,17,109,"Illinois","McDonough County",2,49,280,143,137
050,17,109,"Illinois","McDonough County",2,50,288,143,145
050,17,109,"Illinois","McDonough County",2,51,249,124,125
050,17,109,"Illinois","McDonough County",2,52,233,116,117
050,17,109,"Illinois","McDonough County",2,53,261,125,136
050,17,109,"Illinois","McDonough County",2,54,279,137,142
050,17,109,"Illinois","McDonough County",2,55,300,154,146
050,17,109,"Illinois","McDonough County",2,56,313,161,152
050,17,109,"Illinois","McDonough County",2,57,326,165,161
050,17,109,"Illinois","McDonough County",2,58,324,161,163
050,17,109,"Illinois","McDonough County",2,59,327,156,171
050,17,109,"Illinois","McDonough County",2,60,347,168,179
050,17,109,"Illinois","McDonough County",2,61,334,167,167
050,17,109,"Illinois","McDonough County",2,62,370,187,183
050,17,109,"Illinois","McDonough County",2,63,353,174,179
050,17,109,"Illinois","McDonough County",2,64,307,157,150
050,17,109,"Illinois","McDonough County",2,65,309,155,154
050,17,109,"Illinois","McDonough County",2,66,322,164,158
050,17,109,"Illinois","McDonough County",2,67,326,150,176
050,17,109,"Illinois","McDonough County",2,68,320,148,172
050,17,109,"Illinois","McDonough County",2,69,316,157,159
050,17,109,"Illinois","McDonough County",2,70,290,150,140
050,17,109,"Illinois","McDonough County",2,71,272,128,144
050,17,109,"Illinois","McDonough County",2,72,271,128,143
050,17,109,"Illinois","McDonough County",2,73,281,140,141
050,17,109,"Illinois","McDonough County",2,74,179,82,97
050,17,109,"Illinois","McDonough County",2,75,180,82,98
050,17,109,"Illinois","McDonough County",2,76,189,86,103
050,17,109,"Illinois","McDonough County",2,77,186,89,97
050,17,109,"Illinois","McDonough County",2,78,155,70,85
050,17,109,"Illinois","McDonough County",2,79,148,66,82
050,17,109,"Illinois","McDonough County",2,80,135,58,77
050,17,109,"Illinois","McDonough County",2,81,130,56,74
050,17,109,"Illinois","McDonough County",2,82,110,47,63
050,17,109,"Illinois","McDonough County",2,83,91,35,56
050,17,109,"Illinois","McDonough County",2,84,104,41,63
050,17,109,"Illinois","McDonough County",2,85,753,217,536
050,17,109,"Illinois","McDonough County",3,0,256,149,107
050,17,109,"Illinois","McDonough County",3,1,240,128,112
050,17,109,"Illinois","McDonough County",3,2,248,129,119
050,17,109,"Illinois","McDonough County",3,3,259,138,121
050,17,109,"Illinois","McDonough County",3,4,263,125,138
050,17,109,"Illinois","McDonough County",3,5,250,127,123
050,17,109,"Illinois","McDonough County",3,6,248,125,123
050,17,109,"Illinois","McDonough County",3,7,239,128,111
050,17,109,"Illinois","McDonough County",3,8,261,140,121
050,17,109,"Illinois","McDonough County",3,9,269,144,125
050,17,109,"Illinois","McDonough County",3,10,270,146,124
050,17,109,"Illinois","McDonough County",3,11,275,144,131
050,17,109,"Illinois","McDonough County",3,12,266,137,129
050,17,109,"Illinois","McDonough County",3,13,281,139,142
050,17,109,"Illinois","McDonough County",3,14,294,149,145
050,17,109,"Illinois","McDonough County",3,15,287,159,128
050,17,109,"Illinois","McDonough County",3,16,291,154,137
050,17,109,"Illinois","McDonough County",3,17,287,143,144
050,17,109,"Illinois","McDonough County",3,18,564,234,330
050,17,109,"Illinois","McDonough County",3,19,922,420,502
050,17,109,"Illinois","McDonough County",3,20,1113,502,611
050,17,109,"Illinois","McDonough County",3,21,1072,557,515
050,17,109,"Illinois","McDonough County",3,22,821,438,383
050,17,109,"Illinois","McDonough County",3,23,582,306,276
050,17,109,"Illinois","McDonough County",3,24,438,248,190
050,17,109,"Illinois","McDonough County",3,25,328,165,163
050,17,109,"Illinois","McDonough County",3,26,298,162,136
050,17,109,"Illinois","McDonough County",3,27,260,147,113
050,17,109,"Illinois","McDonough County",3,28,276,152,124
050,17,109,"Illinois","McDonough County",3,29,282,144,138
050,17,109,"Illinois","McDonough County",3,30,300,163,137
050,17,109,"Illinois","McDonough County",3,31,311,172,139
050,17,109,"Illinois","McDonough County",3,32,309,171,138
050,17,109,"Illinois","McDonough County",3,33,285,160,125
050,17,109,"Illinois","McDonough County",3,34,284,152,132
050,17,109,"Illinois","McDonough County",3,35,283,141,142
050,17,109,"Illinois","McDonough County",3,36,300,150,150
050,17,109,"Illinois","McDonough County",3,37,282,130,152
050,17,109,"Illinois","McDonough County",3,38,293,141,152
050,17,109,"Illinois","McDonough County",3,39,317,159,158
050,17,109,"Illinois","McDonough County",3,40,291,139,152
050,17,109,"Illinois","McDonough County",3,41,289,143,146
050,17,109,"Illinois","McDonough County",3,42,256,123,133
050,17,109,"Illinois","McDonough County",3,43,256,130,126
050,17,109,"Illinois","McDonough County",3,44,251,124,127
050,17,109,"Illinois","McDonough County",3,45,239,116,123
050,17,109,"Illinois","McDonough County",3,46,240,119,121
050,17,109,"Illinois","McDonough County",3,47,240,124,116
050,17,109,"Illinois","McDonough County",3,48,259,137,122
050,17,109,"Illinois","McDonough County",3,49,269,147,122
050,17,109,"Illinois","McDonough County",3,50,279,143,136
050,17,109,"Illinois","McDonough County",3,51,273,137,136
050,17,109,"Illinois","McDonough County",3,52,245,119,126
050,17,109,"Illinois","McDonough County",3,53,232,113,119
050,17,109,"Illinois","McDonough County",3,54,257,123,134
050,17,109,"Illinois","McDonough County",3,55,272,132,140
050,17,109,"Illinois","McDonough County",3,56,297,159,138
050,17,109,"Illinois","McDonough County",3,57,314,156,158
050,17,109,"Illinois","McDonough County",3,58,325,161,164
050,17,109,"Illinois","McDonough County",3,59,313,161,152
050,17,109,"Illinois","McDonough County",3,60,326,155,171
050,17,109,"Illinois","McDonough County",3,61,336,160,176
050,17,109,"Illinois","McDonough County",3,62,350,176,174
050,17,109,"Illinois","McDonough County",3,63,348,176,172
050,17,109,"Illinois","McDonough County",3,64,338,166,172
050,17,109,"Illinois","McDonough County",3,65,295,149,146
050,17,109,"Illinois","McDonough County",3,66,300,148,152
050,17,109,"Illinois","McDonough County",3,67,310,151,159
050,17,109,"Illinois","McDonough County",3,68,321,153,168
050,17,109,"Illinois","McDonough County",3,69,309,144,165
050,17,109,"Illinois","McDonough County",3,70,309,152,157
050,17,109,"Illinois","McDonough County",3,71,275,145,130
050,17,109,"Illinois","McDonough County",3,72,268,126,142
050,17,109,"Illinois","McDonough County",3,73,265,124,141
050,17,109,"Illinois","McDonough County",3,74,269,132,137
050,17,109,"Illinois","McDonough County",3,75,172,82,90
050,17,109,"Illinois","McDonough County",3,76,177,75,102
050,17,109,"Illinois","McDonough County",3,77,182,81,101
050,17,109,"Illinois","McDonough County",3,78,171,83,88
050,17,109,"Illinois","McDonough County",3,79,157,67,90
050,17,109,"Illinois","McDonough County",3,80,131,57,74
050,17,109,"Illinois","McDonough County",3,81,124,58,66
050,17,109,"Illinois","McDonough County",3,82,123,54,69
050,17,109,"Illinois","McDonough County",3,83,107,45,62
050,17,109,"Illinois","McDonough County",3,84,83,27,56
050,17,109,"Illinois","McDonough County",3,85,733,219,514
050,17,109,"Illinois","McDonough County",4,0,244,135,109
050,17,109,"Illinois","McDonough County",4,1,260,150,110
050,17,109,"Illinois","McDonough County",4,2,260,137,123
050,17,109,"Illinois","McDonough County",4,3,248,130,118
050,17,109,"Illinois","McDonough County",4,4,273,141,132
050,17,109,"Illinois","McDonough County",4,5,269,132,137
050,17,109,"Illinois","McDonough County",4,6,256,129,127
050,17,109,"Illinois","McDonough County",4,7,242,122,120
050,17,109,"Illinois","McDonough County",4,8,256,138,118
050,17,109,"Illinois","McDonough County",4,9,266,144,122
050,17,109,"Illinois","McDonough County",4,10,272,145,127
050,17,109,"Illinois","McDonough County",4,11,281,152,129
050,17,109,"Illinois","McDonough County",4,12,287,149,138
050,17,109,"Illinois","McDonough County",4,13,276,150,126
050,17,109,"Illinois","McDonough County",4,14,293,147,146
050,17,109,"Illinois","McDonough County",4,15,283,141,142
050,17,109,"Illinois","McDonough County",4,16,295,161,134
050,17,109,"Illinois","McDonough County",4,17,298,156,142
050,17,109,"Illinois","McDonough County",4,18,550,227,323
050,17,109,"Illinois","McDonough County",4,19,925,415,510
050,17,109,"Illinois","McDonough County",4,20,1099,501,598
050,17,109,"Illinois","McDonough County",4,21,1093,561,532
050,17,109,"Illinois","McDonough County",4,22,851,455,396
050,17,109,"Illinois","McDonough County",4,23,597,326,271
050,17,109,"Illinois","McDonough County",4,24,428,239,189
050,17,109,"Illinois","McDonough County",4,25,320,167,153
050,17,109,"Illinois","McDonough County",4,26,295,146,149
050,17,109,"Illinois","McDonough County",4,27,285,155,130
050,17,109,"Illinois","McDonough County",4,28,264,148,116
050,17,109,"Illinois","McDonough County",4,29,279,146,133
050,17,109,"Illinois","McDonough County",4,30,272,142,130
050,17,109,"Illinois","McDonough County",4,31,299,165,134
050,17,109,"Illinois","McDonough County",4,32,307,172,135
050,17,109,"Illinois","McDonough County",4,33,325,177,148
050,17,109,"Illinois","McDonough County",4,34,273,145,128
050,17,109,"Illinois","McDonough County",4,35,298,164,134
050,17,109,"Illinois","McDonough County",4,36,278,138,140
050,17,109,"Illinois","McDonough County",4,37,284,142,142
050,17,109,"Illinois","McDonough County",4,38,297,146,151
050,17,109,"Illinois","McDonough County",4,39,310,146,164
050,17,109,"Illinois","McDonough County",4,40,321,163,158
050,17,109,"Illinois","McDonough County",4,41,278,132,146
050,17,109,"Illinois","McDonough County",4,42,290,147,143
050,17,109,"Illinois","McDonough County",4,43,255,119,136
050,17,109,"Illinois","McDonough County",4,44,254,125,129
050,17,109,"Illinois","McDonough County",4,45,255,125,130
050,17,109,"Illinois","McDonough County",4,46,234,116,118
050,17,109,"Illinois","McDonough County",4,47,246,121,125
050,17,109,"Illinois","McDonough County",4,48,243,130,113
050,17,109,"Illinois","McDonough County",4,49,253,129,124
050,17,109,"Illinois","McDonough County",4,50,272,142,130
050,17,109,"Illinois","McDonough County",4,51,270,143,127
050,17,109,"Illinois","McDonough County",4,52,270,136,134
050,17,109,"Illinois","McDonough County",4,53,238,117,121
050,17,109,"Illinois","McDonough County",4,54,233,111,122
050,17,109,"Illinois","McDonough County",4,55,256,121,135
050,17,109,"Illinois","McDonough County",4,56,270,132,138
050,17,109,"Illinois","McDonough County",4,57,300,160,140
050,17,109,"Illinois","McDonough County",4,58,310,148,162
050,17,109,"Illinois","McDonough County",4,59,328,168,160
050,17,109,"Illinois","McDonough County",4,60,312,161,151
050,17,109,"Illinois","McDonough County",4,61,317,146,171
050,17,109,"Illinois","McDonough County",4,62,342,166,176
050,17,109,"Illinois","McDonough County",4,63,329,160,169
050,17,109,"Illinois","McDonough County",4,64,333,169,164
050,17,109,"Illinois","McDonough County",4,65,326,164,162
050,17,109,"Illinois","McDonough County",4,66,291,147,144
050,17,109,"Illinois","McDonough County",4,67,291,137,154
050,17,109,"Illinois","McDonough County",4,68,309,159,150
050,17,109,"Illinois","McDonough County",4,69,313,149,164
050,17,109,"Illinois","McDonough County",4,70,293,131,162
050,17,109,"Illinois","McDonough County",4,71,295,143,152
050,17,109,"Illinois","McDonough County",4,72,271,141,130
050,17,109,"Illinois","McDonough County",4,73,256,120,136
050,17,109,"Illinois","McDonough County",4,74,256,118,138
050,17,109,"Illinois","McDonough County",4,75,261,133,128
050,17,109,"Illinois","McDonough County",4,76,165,77,88
050,17,109,"Illinois","McDonough County",4,77,166,72,94
050,17,109,"Illinois","McDonough County",4,78,162,73,89
050,17,109,"Illinois","McDonough County",4,79,177,84,93
050,17,109,"Illinois","McDonough County",4,80,142,60,82
050,17,109,"Illinois","McDonough County",4,81,118,53,65
050,17,109,"Illinois","McDonough County",4,82,119,56,63
050,17,109,"Illinois","McDonough County",4,83,115,51,64
050,17,109,"Illinois","McDonough County",4,84,107,40,67
050,17,109,"Illinois","McDonough County",4,85,684,204,480
050,17,109,"Illinois","McDonough County",5,0,233,129,104
050,17,109,"Illinois","McDonough County",5,1,251,135,116
050,17,109,"Illinois","McDonough County",5,2,264,146,118
050,17,109,"Illinois","McDonough County",5,3,271,134,137
050,17,109,"Illinois","McDonough County",5,4,252,136,116
050,17,109,"Illinois","McDonough County",5,5,292,154,138
050,17,109,"Illinois","McDonough County",5,6,274,137,137
050,17,109,"Illinois","McDonough County",5,7,253,129,124
050,17,109,"Illinois","McDonough County",5,8,255,131,124
050,17,109,"Illinois","McDonough County",5,9,259,143,116
050,17,109,"Illinois","McDonough County",5,10,278,154,124
050,17,109,"Illinois","McDonough County",5,11,279,150,129
050,17,109,"Illinois","McDonough County",5,12,298,153,145
050,17,109,"Illinois","McDonough County",5,13,274,146,128
050,17,109,"Illinois","McDonough County",5,14,272,146,126
050,17,109,"Illinois","McDonough County",5,15,284,140,144
050,17,109,"Illinois","McDonough County",5,16,285,140,145
050,17,109,"Illinois","McDonough County",5,17,291,159,132
050,17,109,"Illinois","McDonough County",5,18,547,239,308
050,17,109,"Illinois","McDonough County",5,19,916,405,511
050,17,109,"Illinois","McDonough County",5,20,1102,495,607
050,17,109,"Illinois","McDonough County",5,21,1064,550,514
050,17,109,"Illinois","McDonough County",5,22,840,434,406
050,17,109,"Illinois","McDonough County",5,23,629,338,291
050,17,109,"Illinois","McDonough County",5,24,478,268,210
050,17,109,"Illinois","McDonough County",5,25,303,162,141
050,17,109,"Illinois","McDonough County",5,26,285,148,137
050,17,109,"Illinois","McDonough County",5,27,255,116,139
050,17,109,"Illinois","McDonough County",5,28,270,136,134
050,17,109,"Illinois","McDonough County",5,29,266,142,124
050,17,109,"Illinois","McDonough County",5,30,285,149,136
050,17,109,"Illinois","McDonough County",5,31,274,141,133
050,17,109,"Illinois","McDonough County",5,32,313,167,146
050,17,109,"Illinois","McDonough County",5,33,308,171,137
050,17,109,"Illinois","McDonough County",5,34,318,168,150
050,17,109,"Illinois","McDonough County",5,35,293,158,135
050,17,109,"Illinois","McDonough County",5,36,304,169,135
050,17,109,"Illinois","McDonough County",5,37,279,143,136
050,17,109,"Illinois","McDonough County",5,38,283,143,140
050,17,109,"Illinois","McDonough County",5,39,298,150,148
050,17,109,"Illinois","McDonough County",5,40,293,144,149
050,17,109,"Illinois","McDonough County",5,41,318,164,154
050,17,109,"Illinois","McDonough County",5,42,279,132,147
050,17,109,"Illinois","McDonough County",5,43,276,143,133
050,17,109,"Illinois","McDonough County",5,44,255,118,137
050,17,109,"Illinois","McDonough County",5,45,257,125,132
050,17,109,"Illinois","McDonough County",5,46,251,127,124
050,17,109,"Illinois","McDonough County",5,47,237,120,117
050,17,109,"Illinois","McDonough County",5,48,246,125,121
050,17,109,"Illinois","McDonough County",5,49,233,123,110
050,17,109,"Illinois","McDonough County",5,50,254,128,126
050,17,109,"Illinois","McDonough County",5,51,272,142,130
050,17,109,"Illinois","McDonough County",5,52,269,144,125
050,17,109,"Illinois","McDonough County",5,53,261,129,132
050,17,109,"Illinois","McDonough County",5,54,233,115,118
050,17,109,"Illinois","McDonough County",5,55,229,107,122
050,17,109,"Illinois","McDonough County",5,56,252,124,128
050,17,109,"Illinois","McDonough County",5,57,277,130,147
050,17,109,"Illinois","McDonough County",5,58,301,157,144
050,17,109,"Illinois","McDonough County",5,59,296,150,146
050,17,109,"Illinois","McDonough County",5,60,332,169,163
050,17,109,"Illinois","McDonough County",5,61,304,153,151
050,17,109,"Illinois","McDonough County",5,62,322,148,174
050,17,109,"Illinois","McDonough County",5,63,330,157,173
050,17,109,"Illinois","McDonough County",5,64,330,162,168
050,17,109,"Illinois","McDonough County",5,65,326,166,160
050,17,109,"Illinois","McDonough County",5,66,321,161,160
050,17,109,"Illinois","McDonough County",5,67,291,140,151
050,17,109,"Illinois","McDonough County",5,68,290,143,147
050,17,109,"Illinois","McDonough County",5,69,298,153,145
050,17,109,"Illinois","McDonough County",5,70,293,137,156
050,17,109,"Illinois","McDonough County",5,71,273,122,151
050,17,109,"Illinois","McDonough County",5,72,283,137,146
050,17,109,"Illinois","McDonough County",5,73,268,139,129
050,17,109,"Illinois","McDonough County",5,74,242,111,131
050,17,109,"Illinois","McDonough County",5,75,251,121,130
050,17,109,"Illinois","McDonough County",5,76,249,125,124
050,17,109,"Illinois","McDonough County",5,77,156,73,83
050,17,109,"Illinois","McDonough County",5,78,148,63,85
050,17,109,"Illinois","McDonough County",5,79,164,72,92
050,17,109,"Illinois","McDonough County",5,80,156,75,81
050,17,109,"Illinois","McDonough County",5,81,128,57,71
050,17,109,"Illinois","McDonough County",5,82,116,53,63
050,17,109,"Illinois","McDonough County",5,83,109,51,58
050,17,109,"Illinois","McDonough County",5,84,115,48,67
050,17,109,"Illinois","McDonough County",5,85,680,204,476
050,17,111,"Illinois","McHenry County",1,0,2968,1512,1456
050,17,111,"Illinois","McHenry County",1,1,3141,1587,1554
050,17,111,"Illinois","McHenry County",1,2,3302,1701,1601
050,17,111,"Illinois","McHenry County",1,3,3477,1768,1709
050,17,111,"Illinois","McHenry County",1,4,3684,1869,1815
050,17,111,"Illinois","McHenry County",1,5,3811,1916,1895
050,17,111,"Illinois","McHenry County",1,6,3717,1940,1777
050,17,111,"Illinois","McHenry County",1,7,3789,1909,1880
050,17,111,"Illinois","McHenry County",1,8,3999,2052,1947
050,17,111,"Illinois","McHenry County",1,9,3958,2066,1892
050,17,111,"Illinois","McHenry County",1,10,4235,2194,2041
050,17,111,"Illinois","McHenry County",1,11,4346,2210,2136
050,17,111,"Illinois","McHenry County",1,12,4477,2299,2178
050,17,111,"Illinois","McHenry County",1,13,4615,2364,2251
050,17,111,"Illinois","McHenry County",1,14,4739,2406,2333
050,17,111,"Illinois","McHenry County",1,15,4658,2397,2261
050,17,111,"Illinois","McHenry County",1,16,4836,2541,2295
050,17,111,"Illinois","McHenry County",1,17,4776,2423,2353
050,17,111,"Illinois","McHenry County",1,18,4138,2156,1982
050,17,111,"Illinois","McHenry County",1,19,3319,1744,1575
050,17,111,"Illinois","McHenry County",1,20,3545,1852,1693
050,17,111,"Illinois","McHenry County",1,21,3627,1885,1742
050,17,111,"Illinois","McHenry County",1,22,3611,1816,1795
050,17,111,"Illinois","McHenry County",1,23,3580,1849,1731
050,17,111,"Illinois","McHenry County",1,24,3434,1761,1673
050,17,111,"Illinois","McHenry County",1,25,3466,1795,1671
050,17,111,"Illinois","McHenry County",1,26,3370,1755,1615
050,17,111,"Illinois","McHenry County",1,27,3430,1754,1676
050,17,111,"Illinois","McHenry County",1,28,3435,1713,1722
050,17,111,"Illinois","McHenry County",1,29,3642,1820,1822
050,17,111,"Illinois","McHenry County",1,30,3512,1761,1751
050,17,111,"Illinois","McHenry County",1,31,3481,1813,1668
050,17,111,"Illinois","McHenry County",1,32,3582,1814,1768
050,17,111,"Illinois","McHenry County",1,33,3630,1863,1767
050,17,111,"Illinois","McHenry County",1,34,3777,1970,1807
050,17,111,"Illinois","McHenry County",1,35,3831,1939,1892
050,17,111,"Illinois","McHenry County",1,36,3841,1969,1872
050,17,111,"Illinois","McHenry County",1,37,4016,2036,1980
050,17,111,"Illinois","McHenry County",1,38,4120,2067,2053
050,17,111,"Illinois","McHenry County",1,39,4043,2063,1980
050,17,111,"Illinois","McHenry County",1,40,4076,2108,1968
050,17,111,"Illinois","McHenry County",1,41,3987,2026,1961
050,17,111,"Illinois","McHenry County",1,42,3980,2008,1972
050,17,111,"Illinois","McHenry County",1,43,3883,1970,1913
050,17,111,"Illinois","McHenry County",1,44,3842,1903,1939
050,17,111,"Illinois","McHenry County",1,45,3925,1956,1969
050,17,111,"Illinois","McHenry County",1,46,3836,1918,1918
050,17,111,"Illinois","McHenry County",1,47,3985,1987,1998
050,17,111,"Illinois","McHenry County",1,48,4362,2190,2172
050,17,111,"Illinois","McHenry County",1,49,4829,2388,2441
050,17,111,"Illinois","McHenry County",1,50,4720,2357,2363
050,17,111,"Illinois","McHenry County",1,51,4655,2338,2317
050,17,111,"Illinois","McHenry County",1,52,4537,2274,2263
050,17,111,"Illinois","McHenry County",1,53,4685,2342,2343
050,17,111,"Illinois","McHenry County",1,54,4759,2351,2408
050,17,111,"Illinois","McHenry County",1,55,4898,2429,2469
050,17,111,"Illinois","McHenry County",1,56,4883,2461,2422
050,17,111,"Illinois","McHenry County",1,57,4915,2505,2410
050,17,111,"Illinois","McHenry County",1,58,4893,2493,2400
050,17,111,"Illinois","McHenry County",1,59,4826,2428,2398
050,17,111,"Illinois","McHenry County",1,60,4749,2373,2376
050,17,111,"Illinois","McHenry County",1,61,4513,2260,2253
050,17,111,"Illinois","McHenry County",1,62,4382,2211,2171
050,17,111,"Illinois","McHenry County",1,63,4072,2026,2046
050,17,111,"Illinois","McHenry County",1,64,3872,1940,1932
050,17,111,"Illinois","McHenry County",1,65,3706,1859,1847
050,17,111,"Illinois","McHenry County",1,66,3517,1744,1773
050,17,111,"Illinois","McHenry County",1,67,3334,1608,1726
050,17,111,"Illinois","McHenry County",1,68,3145,1537,1608
050,17,111,"Illinois","McHenry County",1,69,2948,1443,1505
050,17,111,"Illinois","McHenry County",1,70,2774,1344,1430
050,17,111,"Illinois","McHenry County",1,71,2667,1258,1409
050,17,111,"Illinois","McHenry County",1,72,2687,1246,1441
050,17,111,"Illinois","McHenry County",1,73,2660,1269,1391
050,17,111,"Illinois","McHenry County",1,74,1878,872,1006
050,17,111,"Illinois","McHenry County",1,75,1815,828,987
050,17,111,"Illinois","McHenry County",1,76,1905,864,1041
050,17,111,"Illinois","McHenry County",1,77,1944,878,1066
050,17,111,"Illinois","McHenry County",1,78,1613,731,882
050,17,111,"Illinois","McHenry County",1,79,1365,619,746
050,17,111,"Illinois","McHenry County",1,80,1135,529,606
050,17,111,"Illinois","McHenry County",1,81,1067,460,607
050,17,111,"Illinois","McHenry County",1,82,983,422,561
050,17,111,"Illinois","McHenry County",1,83,841,351,490
050,17,111,"Illinois","McHenry County",1,84,773,319,454
050,17,111,"Illinois","McHenry County",1,85,4434,1530,2904
050,17,111,"Illinois","McHenry County",2,0,3016,1563,1453
050,17,111,"Illinois","McHenry County",2,1,3121,1583,1538
050,17,111,"Illinois","McHenry County",2,2,3285,1682,1603
050,17,111,"Illinois","McHenry County",2,3,3439,1755,1684
050,17,111,"Illinois","McHenry County",2,4,3667,1861,1806
050,17,111,"Illinois","McHenry County",2,5,3791,1912,1879
050,17,111,"Illinois","McHenry County",2,6,3758,1942,1816
050,17,111,"Illinois","McHenry County",2,7,3778,1920,1858
050,17,111,"Illinois","McHenry County",2,8,3934,2012,1922
050,17,111,"Illinois","McHenry County",2,9,3974,2070,1904
050,17,111,"Illinois","McHenry County",2,10,4174,2166,2008
050,17,111,"Illinois","McHenry County",2,11,4300,2195,2105
050,17,111,"Illinois","McHenry County",2,12,4455,2281,2174
050,17,111,"Illinois","McHenry County",2,13,4576,2343,2233
050,17,111,"Illinois","McHenry County",2,14,4695,2387,2308
050,17,111,"Illinois","McHenry County",2,15,4678,2400,2278
050,17,111,"Illinois","McHenry County",2,16,4793,2502,2291
050,17,111,"Illinois","McHenry County",2,17,4788,2450,2338
050,17,111,"Illinois","McHenry County",2,18,4091,2131,1960
050,17,111,"Illinois","McHenry County",2,19,3349,1757,1592
050,17,111,"Illinois","McHenry County",2,20,3563,1860,1703
050,17,111,"Illinois","McHenry County",2,21,3616,1878,1738
050,17,111,"Illinois","McHenry County",2,22,3608,1830,1778
050,17,111,"Illinois","McHenry County",2,23,3575,1835,1740
050,17,111,"Illinois","McHenry County",2,24,3452,1773,1679
050,17,111,"Illinois","McHenry County",2,25,3430,1774,1656
050,17,111,"Illinois","McHenry County",2,26,3389,1765,1624
050,17,111,"Illinois","McHenry County",2,27,3410,1747,1663
050,17,111,"Illinois","McHenry County",2,28,3463,1736,1727
050,17,111,"Illinois","McHenry County",2,29,3608,1793,1815
050,17,111,"Illinois","McHenry County",2,30,3577,1797,1780
050,17,111,"Illinois","McHenry County",2,31,3506,1809,1697
050,17,111,"Illinois","McHenry County",2,32,3570,1817,1753
050,17,111,"Illinois","McHenry County",2,33,3630,1861,1769
050,17,111,"Illinois","McHenry County",2,34,3756,1953,1803
050,17,111,"Illinois","McHenry County",2,35,3854,1965,1889
050,17,111,"Illinois","McHenry County",2,36,3825,1958,1867
050,17,111,"Illinois","McHenry County",2,37,3992,2033,1959
050,17,111,"Illinois","McHenry County",2,38,4110,2065,2045
050,17,111,"Illinois","McHenry County",2,39,4061,2063,1998
050,17,111,"Illinois","McHenry County",2,40,4092,2111,1981
050,17,111,"Illinois","McHenry County",2,41,3998,2039,1959
050,17,111,"Illinois","McHenry County",2,42,3973,2012,1961
050,17,111,"Illinois","McHenry County",2,43,3928,1992,1936
050,17,111,"Illinois","McHenry County",2,44,3823,1909,1914
050,17,111,"Illinois","McHenry County",2,45,3919,1948,1971
050,17,111,"Illinois","McHenry County",2,46,3830,1912,1918
050,17,111,"Illinois","McHenry County",2,47,3927,1959,1968
050,17,111,"Illinois","McHenry County",2,48,4261,2135,2126
050,17,111,"Illinois","McHenry County",2,49,4724,2347,2377
050,17,111,"Illinois","McHenry County",2,50,4738,2360,2378
050,17,111,"Illinois","McHenry County",2,51,4628,2323,2305
050,17,111,"Illinois","McHenry County",2,52,4534,2276,2258
050,17,111,"Illinois","McHenry County",2,53,4629,2312,2317
050,17,111,"Illinois","McHenry County",2,54,4698,2326,2372
050,17,111,"Illinois","McHenry County",2,55,4831,2389,2442
050,17,111,"Illinois","McHenry County",2,56,4881,2457,2424
050,17,111,"Illinois","McHenry County",2,57,4890,2487,2403
050,17,111,"Illinois","McHenry County",2,58,4868,2478,2390
050,17,111,"Illinois","McHenry County",2,59,4850,2449,2401
050,17,111,"Illinois","McHenry County",2,60,4728,2365,2363
050,17,111,"Illinois","McHenry County",2,61,4544,2273,2271
050,17,111,"Illinois","McHenry County",2,62,4388,2206,2182
050,17,111,"Illinois","McHenry County",2,63,4156,2072,2084
050,17,111,"Illinois","McHenry County",2,64,3882,1939,1943
050,17,111,"Illinois","McHenry County",2,65,3719,1863,1856
050,17,111,"Illinois","McHenry County",2,66,3547,1763,1784
050,17,111,"Illinois","McHenry County",2,67,3357,1628,1729
050,17,111,"Illinois","McHenry County",2,68,3155,1534,1621
050,17,111,"Illinois","McHenry County",2,69,2999,1462,1537
050,17,111,"Illinois","McHenry County",2,70,2790,1352,1438
050,17,111,"Illinois","McHenry County",2,71,2682,1266,1416
050,17,111,"Illinois","McHenry County",2,72,2624,1221,1403
050,17,111,"Illinois","McHenry County",2,73,2780,1319,1461
050,17,111,"Illinois","McHenry County",2,74,1927,903,1024
050,17,111,"Illinois","McHenry County",2,75,1822,834,988
050,17,111,"Illinois","McHenry County",2,76,1855,840,1015
050,17,111,"Illinois","McHenry County",2,77,1960,884,1076
050,17,111,"Illinois","McHenry County",2,78,1639,739,900
050,17,111,"Illinois","McHenry County",2,79,1393,631,762
050,17,111,"Illinois","McHenry County",2,80,1174,541,633
050,17,111,"Illinois","McHenry County",2,81,1061,465,596
050,17,111,"Illinois","McHenry County",2,82,981,419,562
050,17,111,"Illinois","McHenry County",2,83,847,353,494
050,17,111,"Illinois","McHenry County",2,84,762,318,444
050,17,111,"Illinois","McHenry County",2,85,4431,1523,2908
050,17,111,"Illinois","McHenry County",3,0,2905,1488,1417
050,17,111,"Illinois","McHenry County",3,1,3216,1680,1536
050,17,111,"Illinois","McHenry County",3,2,3220,1641,1579
050,17,111,"Illinois","McHenry County",3,3,3466,1765,1701
050,17,111,"Illinois","McHenry County",3,4,3558,1792,1766
050,17,111,"Illinois","McHenry County",3,5,3725,1896,1829
050,17,111,"Illinois","McHenry County",3,6,3944,1996,1948
050,17,111,"Illinois","McHenry County",3,7,3779,1954,1825
050,17,111,"Illinois","McHenry County",3,8,3851,1949,1902
050,17,111,"Illinois","McHenry County",3,9,4031,2054,1977
050,17,111,"Illinois","McHenry County",3,10,4043,2098,1945
050,17,111,"Illinois","McHenry County",3,11,4241,2191,2050
050,17,111,"Illinois","McHenry County",3,12,4307,2187,2120
050,17,111,"Illinois","McHenry County",3,13,4503,2293,2210
050,17,111,"Illinois","McHenry County",3,14,4608,2379,2229
050,17,111,"Illinois","McHenry County",3,15,4693,2387,2306
050,17,111,"Illinois","McHenry County",3,16,4691,2398,2293
050,17,111,"Illinois","McHenry County",3,17,4775,2485,2290
050,17,111,"Illinois","McHenry County",3,18,4130,2181,1949
050,17,111,"Illinois","McHenry County",3,19,3356,1745,1611
050,17,111,"Illinois","McHenry County",3,20,3547,1845,1702
050,17,111,"Illinois","McHenry County",3,21,3638,1882,1756
050,17,111,"Illinois","McHenry County",3,22,3715,1902,1813
050,17,111,"Illinois","McHenry County",3,23,3638,1884,1754
050,17,111,"Illinois","McHenry County",3,24,3504,1832,1672
050,17,111,"Illinois","McHenry County",3,25,3417,1771,1646
050,17,111,"Illinois","McHenry County",3,26,3453,1784,1669
050,17,111,"Illinois","McHenry County",3,27,3519,1818,1701
050,17,111,"Illinois","McHenry County",3,28,3596,1814,1782
050,17,111,"Illinois","McHenry County",3,29,3587,1810,1777
050,17,111,"Illinois","McHenry County",3,30,3774,1910,1864
050,17,111,"Illinois","McHenry County",3,31,3802,1926,1876
050,17,111,"Illinois","McHenry County",3,32,3648,1889,1759
050,17,111,"Illinois","McHenry County",3,33,3734,1893,1841
050,17,111,"Illinois","McHenry County",3,34,3825,1948,1877
050,17,111,"Illinois","McHenry County",3,35,3896,2034,1862
050,17,111,"Illinois","McHenry County",3,36,3978,2043,1935
050,17,111,"Illinois","McHenry County",3,37,3962,2038,1924
050,17,111,"Illinois","McHenry County",3,38,4119,2104,2015
050,17,111,"Illinois","McHenry County",3,39,4203,2131,2072
050,17,111,"Illinois","McHenry County",3,40,4169,2115,2054
050,17,111,"Illinois","McHenry County",3,41,4211,2181,2030
050,17,111,"Illinois","McHenry County",3,42,4018,2061,1957
050,17,111,"Illinois","McHenry County",3,43,3991,2039,1952
050,17,111,"Illinois","McHenry County",3,44,3945,2012,1933
050,17,111,"Illinois","McHenry County",3,45,3832,1922,1910
050,17,111,"Illinois","McHenry County",3,46,3914,1941,1973
050,17,111,"Illinois","McHenry County",3,47,3812,1918,1894
050,17,111,"Illinois","McHenry County",3,48,3917,1948,1969
050,17,111,"Illinois","McHenry County",3,49,4241,2119,2122
050,17,111,"Illinois","McHenry County",3,50,4679,2329,2350
050,17,111,"Illinois","McHenry County",3,51,4657,2312,2345
050,17,111,"Illinois","McHenry County",3,52,4559,2290,2269
050,17,111,"Illinois","McHenry County",3,53,4488,2253,2235
050,17,111,"Illinois","McHenry County",3,54,4536,2283,2253
050,17,111,"Illinois","McHenry County",3,55,4662,2304,2358
050,17,111,"Illinois","McHenry County",3,56,4716,2328,2388
050,17,111,"Illinois","McHenry County",3,57,4761,2387,2374
050,17,111,"Illinois","McHenry County",3,58,4764,2424,2340
050,17,111,"Illinois","McHenry County",3,59,4780,2453,2327
050,17,111,"Illinois","McHenry County",3,60,4686,2360,2326
050,17,111,"Illinois","McHenry County",3,61,4651,2302,2349
050,17,111,"Illinois","McHenry County",3,62,4442,2220,2222
050,17,111,"Illinois","McHenry County",3,63,4268,2135,2133
050,17,111,"Illinois","McHenry County",3,64,4036,2004,2032
050,17,111,"Illinois","McHenry County",3,65,3794,1887,1907
050,17,111,"Illinois","McHenry County",3,66,3645,1812,1833
050,17,111,"Illinois","McHenry County",3,67,3469,1716,1753
050,17,111,"Illinois","McHenry County",3,68,3263,1568,1695
050,17,111,"Illinois","McHenry County",3,69,3105,1514,1591
050,17,111,"Illinois","McHenry County",3,70,2922,1407,1515
050,17,111,"Illinois","McHenry County",3,71,2756,1322,1434
050,17,111,"Illinois","McHenry County",3,72,2616,1215,1401
050,17,111,"Illinois","McHenry County",3,73,2558,1183,1375
050,17,111,"Illinois","McHenry County",3,74,2687,1273,1414
050,17,111,"Illinois","McHenry County",3,75,1861,874,987
050,17,111,"Illinois","McHenry County",3,76,1768,793,975
050,17,111,"Illinois","McHenry County",3,77,1770,789,981
050,17,111,"Illinois","McHenry County",3,78,1875,849,1026
050,17,111,"Illinois","McHenry County",3,79,1528,693,835
050,17,111,"Illinois","McHenry County",3,80,1327,600,727
050,17,111,"Illinois","McHenry County",3,81,1111,506,605
050,17,111,"Illinois","McHenry County",3,82,1000,436,564
050,17,111,"Illinois","McHenry County",3,83,902,377,525
050,17,111,"Illinois","McHenry County",3,84,775,299,476
050,17,111,"Illinois","McHenry County",3,85,4479,1572,2907
050,17,111,"Illinois","McHenry County",4,0,3057,1610,1447
050,17,111,"Illinois","McHenry County",4,1,3085,1560,1525
050,17,111,"Illinois","McHenry County",4,2,3393,1793,1600
050,17,111,"Illinois","McHenry County",4,3,3355,1713,1642
050,17,111,"Illinois","McHenry County",4,4,3545,1822,1723
050,17,111,"Illinois","McHenry County",4,5,3680,1849,1831
050,17,111,"Illinois","McHenry County",4,6,3833,1958,1875
050,17,111,"Illinois","McHenry County",4,7,4013,2040,1973
050,17,111,"Illinois","McHenry County",4,8,3852,1977,1875
050,17,111,"Illinois","McHenry County",4,9,3903,1975,1928
050,17,111,"Illinois","McHenry County",4,10,4085,2085,2000
050,17,111,"Illinois","McHenry County",4,11,4080,2127,1953
050,17,111,"Illinois","McHenry County",4,12,4258,2193,2065
050,17,111,"Illinois","McHenry County",4,13,4320,2205,2115
050,17,111,"Illinois","McHenry County",4,14,4536,2309,2227
050,17,111,"Illinois","McHenry County",4,15,4642,2388,2254
050,17,111,"Illinois","McHenry County",4,16,4727,2395,2332
050,17,111,"Illinois","McHenry County",4,17,4643,2363,2280
050,17,111,"Illinois","McHenry County",4,18,4066,2181,1885
050,17,111,"Illinois","McHenry County",4,19,3258,1732,1526
050,17,111,"Illinois","McHenry County",4,20,3447,1749,1698
050,17,111,"Illinois","McHenry County",4,21,3577,1864,1713
050,17,111,"Illinois","McHenry County",4,22,3710,1906,1804
050,17,111,"Illinois","McHenry County",4,23,3562,1859,1703
050,17,111,"Illinois","McHenry County",4,24,3469,1812,1657
050,17,111,"Illinois","McHenry County",4,25,3365,1789,1576
050,17,111,"Illinois","McHenry County",4,26,3303,1714,1589
050,17,111,"Illinois","McHenry County",4,27,3443,1755,1688
050,17,111,"Illinois","McHenry County",4,28,3551,1834,1717
050,17,111,"Illinois","McHenry County",4,29,3651,1837,1814
050,17,111,"Illinois","McHenry County",4,30,3713,1882,1831
050,17,111,"Illinois","McHenry County",4,31,3932,1967,1965
050,17,111,"Illinois","McHenry County",4,32,3932,1978,1954
050,17,111,"Illinois","McHenry County",4,33,3753,1937,1816
050,17,111,"Illinois","McHenry County",4,34,3886,1961,1925
050,17,111,"Illinois","McHenry County",4,35,3970,1999,1971
050,17,111,"Illinois","McHenry County",4,36,3984,2079,1905
050,17,111,"Illinois","McHenry County",4,37,4092,2083,2009
050,17,111,"Illinois","McHenry County",4,38,4116,2120,1996
050,17,111,"Illinois","McHenry County",4,39,4157,2107,2050
050,17,111,"Illinois","McHenry County",4,40,4289,2165,2124
050,17,111,"Illinois","McHenry County",4,41,4184,2124,2060
050,17,111,"Illinois","McHenry County",4,42,4225,2198,2027
050,17,111,"Illinois","McHenry County",4,43,4035,2083,1952
050,17,111,"Illinois","McHenry County",4,44,3978,2031,1947
050,17,111,"Illinois","McHenry County",4,45,3931,2018,1913
050,17,111,"Illinois","McHenry County",4,46,3824,1908,1916
050,17,111,"Illinois","McHenry County",4,47,3888,1933,1955
050,17,111,"Illinois","McHenry County",4,48,3801,1911,1890
050,17,111,"Illinois","McHenry County",4,49,3919,1960,1959
050,17,111,"Illinois","McHenry County",4,50,4223,2100,2123
050,17,111,"Illinois","McHenry County",4,51,4601,2302,2299
050,17,111,"Illinois","McHenry County",4,52,4590,2279,2311
050,17,111,"Illinois","McHenry County",4,53,4535,2277,2258
050,17,111,"Illinois","McHenry County",4,54,4390,2221,2169
050,17,111,"Illinois","McHenry County",4,55,4461,2252,2209
050,17,111,"Illinois","McHenry County",4,56,4523,2226,2297
050,17,111,"Illinois","McHenry County",4,57,4598,2255,2343
050,17,111,"Illinois","McHenry County",4,58,4642,2317,2325
050,17,111,"Illinois","McHenry County",4,59,4645,2362,2283
050,17,111,"Illinois","McHenry County",4,60,4638,2349,2289
050,17,111,"Illinois","McHenry County",4,61,4602,2306,2296
050,17,111,"Illinois","McHenry County",4,62,4465,2209,2256
050,17,111,"Illinois","McHenry County",4,63,4294,2137,2157
050,17,111,"Illinois","McHenry County",4,64,4162,2072,2090
050,17,111,"Illinois","McHenry County",4,65,3925,1939,1986
050,17,111,"Illinois","McHenry County",4,66,3729,1861,1868
050,17,111,"Illinois","McHenry County",4,67,3566,1765,1801
050,17,111,"Illinois","McHenry County",4,68,3412,1670,1742
050,17,111,"Illinois","McHenry County",4,69,3184,1543,1641
050,17,111,"Illinois","McHenry County",4,70,3003,1466,1537
050,17,111,"Illinois","McHenry County",4,71,2872,1371,1501
050,17,111,"Illinois","McHenry County",4,72,2731,1288,1443
050,17,111,"Illinois","McHenry County",4,73,2583,1188,1395
050,17,111,"Illinois","McHenry County",4,74,2477,1141,1336
050,17,111,"Illinois","McHenry County",4,75,2606,1202,1404
050,17,111,"Illinois","McHenry County",4,76,1815,846,969
050,17,111,"Illinois","McHenry County",4,77,1703,756,947
050,17,111,"Illinois","McHenry County",4,78,1688,748,940
050,17,111,"Illinois","McHenry County",4,79,1777,809,968
050,17,111,"Illinois","McHenry County",4,80,1470,668,802
050,17,111,"Illinois","McHenry County",4,81,1266,569,697
050,17,111,"Illinois","McHenry County",4,82,1029,466,563
050,17,111,"Illinois","McHenry County",4,83,945,410,535
050,17,111,"Illinois","McHenry County",4,84,824,327,497
050,17,111,"Illinois","McHenry County",4,85,4566,1592,2974
050,17,111,"Illinois","McHenry County",5,0,3036,1592,1444
050,17,111,"Illinois","McHenry County",5,1,3184,1667,1517
050,17,111,"Illinois","McHenry County",5,2,3182,1619,1563
050,17,111,"Illinois","McHenry County",5,3,3435,1774,1661
050,17,111,"Illinois","McHenry County",5,4,3459,1770,1689
050,17,111,"Illinois","McHenry County",5,5,3583,1828,1755
050,17,111,"Illinois","McHenry County",5,6,3751,1908,1843
050,17,111,"Illinois","McHenry County",5,7,3904,2006,1898
050,17,111,"Illinois","McHenry County",5,8,4059,2059,2000
050,17,111,"Illinois","McHenry County",5,9,3892,2005,1887
050,17,111,"Illinois","McHenry County",5,10,3934,2003,1931
050,17,111,"Illinois","McHenry County",5,11,4140,2119,2021
050,17,111,"Illinois","McHenry County",5,12,4094,2129,1965
050,17,111,"Illinois","McHenry County",5,13,4306,2230,2076
050,17,111,"Illinois","McHenry County",5,14,4355,2219,2136
050,17,111,"Illinois","McHenry County",5,15,4548,2315,2233
050,17,111,"Illinois","McHenry County",5,16,4647,2404,2243
050,17,111,"Illinois","McHenry County",5,17,4708,2378,2330
050,17,111,"Illinois","McHenry County",5,18,3947,2083,1864
050,17,111,"Illinois","McHenry County",5,19,3239,1754,1485
050,17,111,"Illinois","McHenry County",5,20,3479,1815,1664
050,17,111,"Illinois","McHenry County",5,21,3585,1808,1777
050,17,111,"Illinois","McHenry County",5,22,3689,1897,1792
050,17,111,"Illinois","McHenry County",5,23,3632,1882,1750
050,17,111,"Illinois","McHenry County",5,24,3414,1800,1614
050,17,111,"Illinois","McHenry County",5,25,3396,1758,1638
050,17,111,"Illinois","McHenry County",5,26,3280,1744,1536
050,17,111,"Illinois","McHenry County",5,27,3279,1683,1596
050,17,111,"Illinois","McHenry County",5,28,3453,1761,1692
050,17,111,"Illinois","McHenry County",5,29,3615,1865,1750
050,17,111,"Illinois","McHenry County",5,30,3728,1877,1851
050,17,111,"Illinois","McHenry County",5,31,3819,1941,1878
050,17,111,"Illinois","McHenry County",5,32,4025,2028,1997
050,17,111,"Illinois","McHenry County",5,33,4108,2060,2048
050,17,111,"Illinois","McHenry County",5,34,3893,2060,1833
050,17,111,"Illinois","McHenry County",5,35,4057,2022,2035
050,17,111,"Illinois","McHenry County",5,36,4047,2035,2012
050,17,111,"Illinois","McHenry County",5,37,4054,2112,1942
050,17,111,"Illinois","McHenry County",5,38,4150,2113,2037
050,17,111,"Illinois","McHenry County",5,39,4206,2166,2040
050,17,111,"Illinois","McHenry County",5,40,4237,2151,2086
050,17,111,"Illinois","McHenry County",5,41,4287,2170,2117
050,17,111,"Illinois","McHenry County",5,42,4211,2155,2056
050,17,111,"Illinois","McHenry County",5,43,4200,2174,2026
050,17,111,"Illinois","McHenry County",5,44,4018,2075,1943
050,17,111,"Illinois","McHenry County",5,45,3998,2053,1945
050,17,111,"Illinois","McHenry County",5,46,3918,2006,1912
050,17,111,"Illinois","McHenry County",5,47,3812,1897,1915
050,17,111,"Illinois","McHenry County",5,48,3845,1907,1938
050,17,111,"Illinois","McHenry County",5,49,3850,1943,1907
050,17,111,"Illinois","McHenry County",5,50,3841,1899,1942
050,17,111,"Illinois","McHenry County",5,51,4192,2086,2106
050,17,111,"Illinois","McHenry County",5,52,4548,2273,2275
050,17,111,"Illinois","McHenry County",5,53,4526,2257,2269
050,17,111,"Illinois","McHenry County",5,54,4466,2250,2216
050,17,111,"Illinois","McHenry County",5,55,4352,2207,2145
050,17,111,"Illinois","McHenry County",5,56,4406,2202,2204
050,17,111,"Illinois","McHenry County",5,57,4485,2199,2286
050,17,111,"Illinois","McHenry County",5,58,4531,2208,2323
050,17,111,"Illinois","McHenry County",5,59,4595,2273,2322
050,17,111,"Illinois","McHenry County",5,60,4583,2317,2266
050,17,111,"Illinois","McHenry County",5,61,4618,2338,2280
050,17,111,"Illinois","McHenry County",5,62,4546,2269,2277
050,17,111,"Illinois","McHenry County",5,63,4401,2165,2236
050,17,111,"Illinois","McHenry County",5,64,4263,2095,2168
050,17,111,"Illinois","McHenry County",5,65,4124,2039,2085
050,17,111,"Illinois","McHenry County",5,66,3896,1913,1983
050,17,111,"Illinois","McHenry County",5,67,3670,1837,1833
050,17,111,"Illinois","McHenry County",5,68,3553,1751,1802
050,17,111,"Illinois","McHenry County",5,69,3355,1638,1717
050,17,111,"Illinois","McHenry County",5,70,3144,1506,1638
050,17,111,"Illinois","McHenry County",5,71,2993,1464,1529
050,17,111,"Illinois","McHenry County",5,72,2844,1346,1498
050,17,111,"Illinois","McHenry County",5,73,2689,1256,1433
050,17,111,"Illinois","McHenry County",5,74,2515,1155,1360
050,17,111,"Illinois","McHenry County",5,75,2425,1119,1306
050,17,111,"Illinois","McHenry County",5,76,2546,1164,1382
050,17,111,"Illinois","McHenry County",5,77,1766,813,953
050,17,111,"Illinois","McHenry County",5,78,1634,733,901
050,17,111,"Illinois","McHenry County",5,79,1595,707,888
050,17,111,"Illinois","McHenry County",5,80,1710,784,926
050,17,111,"Illinois","McHenry County",5,81,1446,643,803
050,17,111,"Illinois","McHenry County",5,82,1212,551,661
050,17,111,"Illinois","McHenry County",5,83,972,442,530
050,17,111,"Illinois","McHenry County",5,84,890,367,523
050,17,111,"Illinois","McHenry County",5,85,4780,1680,3100
050,17,113,"Illinois","McLean County",1,0,1782,905,877
050,17,113,"Illinois","McLean County",1,1,1877,961,916
050,17,113,"Illinois","McLean County",1,2,1980,1001,979
050,17,113,"Illinois","McLean County",1,3,2046,1031,1015
050,17,113,"Illinois","McLean County",1,4,2073,1052,1021
050,17,113,"Illinois","McLean County",1,5,2025,1034,991
050,17,113,"Illinois","McLean County",1,6,2057,1043,1014
050,17,113,"Illinois","McLean County",1,7,2090,1043,1047
050,17,113,"Illinois","McLean County",1,8,2035,1011,1024
050,17,113,"Illinois","McLean County",1,9,2095,1063,1032
050,17,113,"Illinois","McLean County",1,10,2058,1059,999
050,17,113,"Illinois","McLean County",1,11,2095,1070,1025
050,17,113,"Illinois","McLean County",1,12,2242,1120,1122
050,17,113,"Illinois","McLean County",1,13,2176,1101,1075
050,17,113,"Illinois","McLean County",1,14,2179,1095,1084
050,17,113,"Illinois","McLean County",1,15,2151,1133,1018
050,17,113,"Illinois","McLean County",1,16,2178,1128,1050
050,17,113,"Illinois","McLean County",1,17,2174,1103,1071
050,17,113,"Illinois","McLean County",1,18,3143,1435,1708
050,17,113,"Illinois","McLean County",1,19,4568,1965,2603
050,17,113,"Illinois","McLean County",1,20,5233,2357,2876
050,17,113,"Illinois","McLean County",1,21,5003,2291,2712
050,17,113,"Illinois","McLean County",1,22,4299,2158,2141
050,17,113,"Illinois","McLean County",1,23,3407,1764,1643
050,17,113,"Illinois","McLean County",1,24,2732,1405,1327
050,17,113,"Illinois","McLean County",1,25,2423,1199,1224
050,17,113,"Illinois","McLean County",1,26,2324,1157,1167
050,17,113,"Illinois","McLean County",1,27,2192,1130,1062
050,17,113,"Illinois","McLean County",1,28,2136,1060,1076
050,17,113,"Illinois","McLean County",1,29,2117,1066,1051
050,17,113,"Illinois","McLean County",1,30,2035,999,1036
050,17,113,"Illinois","McLean County",1,31,2132,1051,1081
050,17,113,"Illinois","McLean County",1,32,2124,1033,1091
050,17,113,"Illinois","McLean County",1,33,2014,1006,1008
050,17,113,"Illinois","McLean County",1,34,2125,1081,1044
050,17,113,"Illinois","McLean County",1,35,2176,1103,1073
050,17,113,"Illinois","McLean County",1,36,2165,1103,1062
050,17,113,"Illinois","McLean County",1,37,2244,1108,1136
050,17,113,"Illinois","McLean County",1,38,2117,1072,1045
050,17,113,"Illinois","McLean County",1,39,2155,1097,1058
050,17,113,"Illinois","McLean County",1,40,2110,1027,1083
050,17,113,"Illinois","McLean County",1,41,2141,1062,1079
050,17,113,"Illinois","McLean County",1,42,2138,1091,1047
050,17,113,"Illinois","McLean County",1,43,1975,983,992
050,17,113,"Illinois","McLean County",1,44,1868,938,930
050,17,113,"Illinois","McLean County",1,45,1886,939,947
050,17,113,"Illinois","McLean County",1,46,1752,884,868
050,17,113,"Illinois","McLean County",1,47,1830,936,894
050,17,113,"Illinois","McLean County",1,48,1980,1037,943
050,17,113,"Illinois","McLean County",1,49,2108,1075,1033
050,17,113,"Illinois","McLean County",1,50,1953,967,986
050,17,113,"Illinois","McLean County",1,51,1924,933,991
050,17,113,"Illinois","McLean County",1,52,1866,898,968
050,17,113,"Illinois","McLean County",1,53,1865,929,936
050,17,113,"Illinois","McLean County",1,54,1928,940,988
050,17,113,"Illinois","McLean County",1,55,2038,985,1053
050,17,113,"Illinois","McLean County",1,56,2034,990,1044
050,17,113,"Illinois","McLean County",1,57,2078,1017,1061
050,17,113,"Illinois","McLean County",1,58,2162,1054,1108
050,17,113,"Illinois","McLean County",1,59,2106,1048,1058
050,17,113,"Illinois","McLean County",1,60,1988,977,1011
050,17,113,"Illinois","McLean County",1,61,1977,987,990
050,17,113,"Illinois","McLean County",1,62,1914,952,962
050,17,113,"Illinois","McLean County",1,63,1865,875,990
050,17,113,"Illinois","McLean County",1,64,1821,847,974
050,17,113,"Illinois","McLean County",1,65,1763,832,931
050,17,113,"Illinois","McLean County",1,66,1719,813,906
050,17,113,"Illinois","McLean County",1,67,1634,741,893
050,17,113,"Illinois","McLean County",1,68,1580,746,834
050,17,113,"Illinois","McLean County",1,69,1458,680,778
050,17,113,"Illinois","McLean County",1,70,1350,620,730
050,17,113,"Illinois","McLean County",1,71,1359,653,706
050,17,113,"Illinois","McLean County",1,72,1328,656,672
050,17,113,"Illinois","McLean County",1,73,1231,596,635
050,17,113,"Illinois","McLean County",1,74,860,418,442
050,17,113,"Illinois","McLean County",1,75,840,412,428
050,17,113,"Illinois","McLean County",1,76,865,393,472
050,17,113,"Illinois","McLean County",1,77,863,378,485
050,17,113,"Illinois","McLean County",1,78,700,310,390
050,17,113,"Illinois","McLean County",1,79,621,257,364
050,17,113,"Illinois","McLean County",1,80,583,249,334
050,17,113,"Illinois","McLean County",1,81,580,248,332
050,17,113,"Illinois","McLean County",1,82,516,218,298
050,17,113,"Illinois","McLean County",1,83,453,188,265
050,17,113,"Illinois","McLean County",1,84,440,186,254
050,17,113,"Illinois","McLean County",1,85,2729,962,1767
050,17,113,"Illinois","McLean County",2,0,1755,891,864
050,17,113,"Illinois","McLean County",2,1,1854,947,907
050,17,113,"Illinois","McLean County",2,2,1963,995,968
050,17,113,"Illinois","McLean County",2,3,2021,1019,1002
050,17,113,"Illinois","McLean County",2,4,2071,1047,1024
050,17,113,"Illinois","McLean County",2,5,2042,1040,1002
050,17,113,"Illinois","McLean County",2,6,2063,1052,1011
050,17,113,"Illinois","McLean County",2,7,2082,1044,1038
050,17,113,"Illinois","McLean County",2,8,2049,1020,1029
050,17,113,"Illinois","McLean County",2,9,2083,1053,1030
050,17,113,"Illinois","McLean County",2,10,2065,1057,1008
050,17,113,"Illinois","McLean County",2,11,2076,1061,1015
050,17,113,"Illinois","McLean County",2,12,2216,1116,1100
050,17,113,"Illinois","McLean County",2,13,2190,1105,1085
050,17,113,"Illinois","McLean County",2,14,2177,1098,1079
050,17,113,"Illinois","McLean County",2,15,2160,1125,1035
050,17,113,"Illinois","McLean County",2,16,2171,1129,1042
050,17,113,"Illinois","McLean County",2,17,2174,1105,1069
050,17,113,"Illinois","McLean County",2,18,3127,1427,1700
050,17,113,"Illinois","McLean County",2,19,4576,1971,2605
050,17,113,"Illinois","McLean County",2,20,5290,2381,2909
050,17,113,"Illinois","McLean County",2,21,4989,2285,2704
050,17,113,"Illinois","McLean County",2,22,4294,2155,2139
050,17,113,"Illinois","McLean County",2,23,3393,1759,1634
050,17,113,"Illinois","McLean County",2,24,2712,1394,1318
050,17,113,"Illinois","McLean County",2,25,2443,1212,1231
050,17,113,"Illinois","McLean County",2,26,2288,1144,1144
050,17,113,"Illinois","McLean County",2,27,2191,1116,1075
050,17,113,"Illinois","McLean County",2,28,2146,1078,1068
050,17,113,"Illinois","McLean County",2,29,2114,1055,1059
050,17,113,"Illinois","McLean County",2,30,2061,1013,1048
050,17,113,"Illinois","McLean County",2,31,2101,1034,1067
050,17,113,"Illinois","McLean County",2,32,2117,1033,1084
050,17,113,"Illinois","McLean County",2,33,2036,1012,1024
050,17,113,"Illinois","McLean County",2,34,2099,1062,1037
050,17,113,"Illinois","McLean County",2,35,2171,1103,1068
050,17,113,"Illinois","McLean County",2,36,2143,1089,1054
050,17,113,"Illinois","McLean County",2,37,2222,1106,1116
050,17,113,"Illinois","McLean County",2,38,2150,1083,1067
050,17,113,"Illinois","McLean County",2,39,2144,1088,1056
050,17,113,"Illinois","McLean County",2,40,2126,1048,1078
050,17,113,"Illinois","McLean County",2,41,2129,1055,1074
050,17,113,"Illinois","McLean County",2,42,2129,1079,1050
050,17,113,"Illinois","McLean County",2,43,2020,1007,1013
050,17,113,"Illinois","McLean County",2,44,1871,939,932
050,17,113,"Illinois","McLean County",2,45,1885,939,946
050,17,113,"Illinois","McLean County",2,46,1773,889,884
050,17,113,"Illinois","McLean County",2,47,1798,915,883
050,17,113,"Illinois","McLean County",2,48,1937,1006,931
050,17,113,"Illinois","McLean County",2,49,2090,1073,1017
050,17,113,"Illinois","McLean County",2,50,1995,996,999
050,17,113,"Illinois","McLean County",2,51,1921,936,985
050,17,113,"Illinois","McLean County",2,52,1875,907,968
050,17,113,"Illinois","McLean County",2,53,1864,919,945
050,17,113,"Illinois","McLean County",2,54,1903,932,971
050,17,113,"Illinois","McLean County",2,55,1998,970,1028
050,17,113,"Illinois","McLean County",2,56,2035,989,1046
050,17,113,"Illinois","McLean County",2,57,2070,1013,1057
050,17,113,"Illinois","McLean County",2,58,2130,1040,1090
050,17,113,"Illinois","McLean County",2,59,2116,1046,1070
050,17,113,"Illinois","McLean County",2,60,2008,989,1019
050,17,113,"Illinois","McLean County",2,61,1960,978,982
050,17,113,"Illinois","McLean County",2,62,1915,951,964
050,17,113,"Illinois","McLean County",2,63,1888,897,991
050,17,113,"Illinois","McLean County",2,64,1808,840,968
050,17,113,"Illinois","McLean County",2,65,1769,830,939
050,17,113,"Illinois","McLean County",2,66,1724,812,912
050,17,113,"Illinois","McLean County",2,67,1645,753,892
050,17,113,"Illinois","McLean County",2,68,1573,736,837
050,17,113,"Illinois","McLean County",2,69,1489,695,794
050,17,113,"Illinois","McLean County",2,70,1365,630,735
050,17,113,"Illinois","McLean County",2,71,1351,644,707
050,17,113,"Illinois","McLean County",2,72,1308,641,667
050,17,113,"Illinois","McLean County",2,73,1315,637,678
050,17,113,"Illinois","McLean County",2,74,892,431,461
050,17,113,"Illinois","McLean County",2,75,841,413,428
050,17,113,"Illinois","McLean County",2,76,848,392,456
050,17,113,"Illinois","McLean County",2,77,871,387,484
050,17,113,"Illinois","McLean County",2,78,722,321,401
050,17,113,"Illinois","McLean County",2,79,636,267,369
050,17,113,"Illinois","McLean County",2,80,590,251,339
050,17,113,"Illinois","McLean County",2,81,571,245,326
050,17,113,"Illinois","McLean County",2,82,526,224,302
050,17,113,"Illinois","McLean County",2,83,458,192,266
050,17,113,"Illinois","McLean County",2,84,441,186,255
050,17,113,"Illinois","McLean County",2,85,2751,978,1773
050,17,113,"Illinois","McLean County",3,0,1701,849,852
050,17,113,"Illinois","McLean County",3,1,1854,920,934
050,17,113,"Illinois","McLean County",3,2,1839,946,893
050,17,113,"Illinois","McLean County",3,3,1979,999,980
050,17,113,"Illinois","McLean County",3,4,2010,1016,994
050,17,113,"Illinois","McLean County",3,5,2100,1064,1036
050,17,113,"Illinois","McLean County",3,6,2060,1060,1000
050,17,113,"Illinois","McLean County",3,7,2047,1044,1003
050,17,113,"Illinois","McLean County",3,8,2057,1020,1037
050,17,113,"Illinois","McLean County",3,9,2060,1032,1028
050,17,113,"Illinois","McLean County",3,10,2086,1062,1024
050,17,113,"Illinois","McLean County",3,11,2016,1019,997
050,17,113,"Illinois","McLean County",3,12,2089,1072,1017
050,17,113,"Illinois","McLean County",3,13,2209,1109,1100
050,17,113,"Illinois","McLean County",3,14,2176,1099,1077
050,17,113,"Illinois","McLean County",3,15,2153,1088,1065
050,17,113,"Illinois","McLean County",3,16,2142,1106,1036
050,17,113,"Illinois","McLean County",3,17,2184,1138,1046
050,17,113,"Illinois","McLean County",3,18,3166,1467,1699
050,17,113,"Illinois","McLean County",3,19,4579,1975,2604
050,17,113,"Illinois","McLean County",3,20,5301,2411,2890
050,17,113,"Illinois","McLean County",3,21,5103,2344,2759
050,17,113,"Illinois","McLean County",3,22,4319,2170,2149
050,17,113,"Illinois","McLean County",3,23,3353,1770,1583
050,17,113,"Illinois","McLean County",3,24,2742,1406,1336
050,17,113,"Illinois","McLean County",3,25,2474,1214,1260
050,17,113,"Illinois","McLean County",3,26,2225,1133,1092
050,17,113,"Illinois","McLean County",3,27,2197,1092,1105
050,17,113,"Illinois","McLean County",3,28,2211,1147,1064
050,17,113,"Illinois","McLean County",3,29,2173,1107,1066
050,17,113,"Illinois","McLean County",3,30,2116,1068,1048
050,17,113,"Illinois","McLean County",3,31,2094,1039,1055
050,17,113,"Illinois","McLean County",3,32,2088,1043,1045
050,17,113,"Illinois","McLean County",3,33,2143,1063,1080
050,17,113,"Illinois","McLean County",3,34,2031,1005,1026
050,17,113,"Illinois","McLean County",3,35,2098,1050,1048
050,17,113,"Illinois","McLean County",3,36,2132,1078,1054
050,17,113,"Illinois","McLean County",3,37,2137,1079,1058
050,17,113,"Illinois","McLean County",3,38,2241,1117,1124
050,17,113,"Illinois","McLean County",3,39,2146,1085,1061
050,17,113,"Illinois","McLean County",3,40,2109,1070,1039
050,17,113,"Illinois","McLean County",3,41,2126,1066,1060
050,17,113,"Illinois","McLean County",3,42,2123,1062,1061
050,17,113,"Illinois","McLean County",3,43,2116,1061,1055
050,17,113,"Illinois","McLean County",3,44,2019,1017,1002
050,17,113,"Illinois","McLean County",3,45,1870,936,934
050,17,113,"Illinois","McLean County",3,46,1875,926,949
050,17,113,"Illinois","McLean County",3,47,1755,879,876
050,17,113,"Illinois","McLean County",3,48,1793,903,890
050,17,113,"Illinois","McLean County",3,49,1926,988,938
050,17,113,"Illinois","McLean County",3,50,2059,1049,1010
050,17,113,"Illinois","McLean County",3,51,1977,982,995
050,17,113,"Illinois","McLean County",3,52,1893,923,970
050,17,113,"Illinois","McLean County",3,53,1865,901,964
050,17,113,"Illinois","McLean County",3,54,1845,916,929
050,17,113,"Illinois","McLean County",3,55,1871,914,957
050,17,113,"Illinois","McLean County",3,56,1963,947,1016
050,17,113,"Illinois","McLean County",3,57,2021,985,1036
050,17,113,"Illinois","McLean County",3,58,2038,1000,1038
050,17,113,"Illinois","McLean County",3,59,2106,1042,1064
050,17,113,"Illinois","McLean County",3,60,2077,1020,1057
050,17,113,"Illinois","McLean County",3,61,1976,967,1009
050,17,113,"Illinois","McLean County",3,62,1920,946,974
050,17,113,"Illinois","McLean County",3,63,1840,902,938
050,17,113,"Illinois","McLean County",3,64,1844,884,960
050,17,113,"Illinois","McLean County",3,65,1771,817,954
050,17,113,"Illinois","McLean County",3,66,1723,802,921
050,17,113,"Illinois","McLean County",3,67,1690,799,891
050,17,113,"Illinois","McLean County",3,68,1597,729,868
050,17,113,"Illinois","McLean County",3,69,1534,719,815
050,17,113,"Illinois","McLean County",3,70,1435,667,768
050,17,113,"Illinois","McLean County",3,71,1343,612,731
050,17,113,"Illinois","McLean County",3,72,1321,620,701
050,17,113,"Illinois","McLean County",3,73,1277,626,651
050,17,113,"Illinois","McLean County",3,74,1288,618,670
050,17,113,"Illinois","McLean County",3,75,854,411,443
050,17,113,"Illinois","McLean County",3,76,809,391,418
050,17,113,"Illinois","McLean County",3,77,813,373,440
050,17,113,"Illinois","McLean County",3,78,831,370,461
050,17,113,"Illinois","McLean County",3,79,698,304,394
050,17,113,"Illinois","McLean County",3,80,610,245,365
050,17,113,"Illinois","McLean County",3,81,550,227,323
050,17,113,"Illinois","McLean County",3,82,532,227,305
050,17,113,"Illinois","McLean County",3,83,497,208,289
050,17,113,"Illinois","McLean County",3,84,406,166,240
050,17,113,"Illinois","McLean County",3,85,2692,967,1725
050,17,113,"Illinois","McLean County",4,0,1701,847,854
050,17,113,"Illinois","McLean County",4,1,1782,892,890
050,17,113,"Illinois","McLean County",4,2,1851,927,924
050,17,113,"Illinois","McLean County",4,3,1860,946,914
050,17,113,"Illinois","McLean County",4,4,1984,1011,973
050,17,113,"Illinois","McLean County",4,5,2048,1044,1004
050,17,113,"Illinois","McLean County",4,6,2102,1064,1038
050,17,113,"Illinois","McLean County",4,7,2052,1052,1000
050,17,113,"Illinois","McLean County",4,8,2070,1061,1009
050,17,113,"Illinois","McLean County",4,9,2052,1014,1038
050,17,113,"Illinois","McLean County",4,10,2044,1024,1020
050,17,113,"Illinois","McLean County",4,11,2067,1060,1007
050,17,113,"Illinois","McLean County",4,12,2033,1029,1004
050,17,113,"Illinois","McLean County",4,13,2078,1068,1010
050,17,113,"Illinois","McLean County",4,14,2168,1094,1074
050,17,113,"Illinois","McLean County",4,15,2162,1075,1087
050,17,113,"Illinois","McLean County",4,16,2136,1087,1049
050,17,113,"Illinois","McLean County",4,17,2165,1124,1041
050,17,113,"Illinois","McLean County",4,18,3145,1468,1677
050,17,113,"Illinois","McLean County",4,19,4567,2021,2546
050,17,113,"Illinois","McLean County",4,20,5280,2402,2878
050,17,113,"Illinois","McLean County",4,21,5131,2384,2747
050,17,113,"Illinois","McLean County",4,22,4450,2248,2202
050,17,113,"Illinois","McLean County",4,23,3356,1805,1551
050,17,113,"Illinois","McLean County",4,24,2673,1391,1282
050,17,113,"Illinois","McLean County",4,25,2462,1204,1258
050,17,113,"Illinois","McLean County",4,26,2240,1106,1134
050,17,113,"Illinois","McLean County",4,27,2163,1114,1049
050,17,113,"Illinois","McLean County",4,28,2172,1090,1082
050,17,113,"Illinois","McLean County",4,29,2183,1142,1041
050,17,113,"Illinois","McLean County",4,30,2132,1085,1047
050,17,113,"Illinois","McLean County",4,31,2148,1091,1057
050,17,113,"Illinois","McLean County",4,32,2139,1061,1078
050,17,113,"Illinois","McLean County",4,33,2079,1038,1041
050,17,113,"Illinois","McLean County",4,34,2168,1062,1106
050,17,113,"Illinois","McLean County",4,35,2045,1022,1023
050,17,113,"Illinois","McLean County",4,36,2090,1055,1035
050,17,113,"Illinois","McLean County",4,37,2109,1065,1044
050,17,113,"Illinois","McLean County",4,38,2139,1094,1045
050,17,113,"Illinois","McLean County",4,39,2232,1102,1130
050,17,113,"Illinois","McLean County",4,40,2100,1070,1030
050,17,113,"Illinois","McLean County",4,41,2108,1075,1033
050,17,113,"Illinois","McLean County",4,42,2135,1064,1071
050,17,113,"Illinois","McLean County",4,43,2129,1062,1067
050,17,113,"Illinois","McLean County",4,44,2102,1056,1046
050,17,113,"Illinois","McLean County",4,45,1975,995,980
050,17,113,"Illinois","McLean County",4,46,1828,904,924
050,17,113,"Illinois","McLean County",4,47,1862,926,936
050,17,113,"Illinois","McLean County",4,48,1743,870,873
050,17,113,"Illinois","McLean County",4,49,1777,887,890
050,17,113,"Illinois","McLean County",4,50,1920,985,935
050,17,113,"Illinois","McLean County",4,51,2052,1036,1016
050,17,113,"Illinois","McLean County",4,52,1964,975,989
050,17,113,"Illinois","McLean County",4,53,1880,921,959
050,17,113,"Illinois","McLean County",4,54,1833,897,936
050,17,113,"Illinois","McLean County",4,55,1817,901,916
050,17,113,"Illinois","McLean County",4,56,1851,899,952
050,17,113,"Illinois","McLean County",4,57,1908,930,978
050,17,113,"Illinois","McLean County",4,58,1971,956,1015
050,17,113,"Illinois","McLean County",4,59,1965,956,1009
050,17,113,"Illinois","McLean County",4,60,2061,1017,1044
050,17,113,"Illinois","McLean County",4,61,1996,979,1017
050,17,113,"Illinois","McLean County",4,62,1912,922,990
050,17,113,"Illinois","McLean County",4,63,1868,918,950
050,17,113,"Illinois","McLean County",4,64,1791,879,912
050,17,113,"Illinois","McLean County",4,65,1793,854,939
050,17,113,"Illinois","McLean County",4,66,1711,773,938
050,17,113,"Illinois","McLean County",4,67,1676,778,898
050,17,113,"Illinois","McLean County",4,68,1648,771,877
050,17,113,"Illinois","McLean County",4,69,1552,692,860
050,17,113,"Illinois","McLean County",4,70,1476,685,791
050,17,113,"Illinois","McLean County",4,71,1416,642,774
050,17,113,"Illinois","McLean County",4,72,1295,594,701
050,17,113,"Illinois","McLean County",4,73,1282,602,680
050,17,113,"Illinois","McLean County",4,74,1245,611,634
050,17,113,"Illinois","McLean County",4,75,1244,582,662
050,17,113,"Illinois","McLean County",4,76,822,392,430
050,17,113,"Illinois","McLean County",4,77,798,383,415
050,17,113,"Illinois","McLean County",4,78,770,351,419
050,17,113,"Illinois","McLean County",4,79,795,346,449
050,17,113,"Illinois","McLean County",4,80,671,284,387
050,17,113,"Illinois","McLean County",4,81,563,224,339
050,17,113,"Illinois","McLean County",4,82,506,211,295
050,17,113,"Illinois","McLean County",4,83,510,217,293
050,17,113,"Illinois","McLean County",4,84,462,192,270
050,17,113,"Illinois","McLean County",4,85,2677,964,1713
050,17,113,"Illinois","McLean County",5,0,1715,853,862
050,17,113,"Illinois","McLean County",5,1,1676,815,861
050,17,113,"Illinois","McLean County",5,2,1785,891,894
050,17,113,"Illinois","McLean County",5,3,1845,927,918
050,17,113,"Illinois","McLean County",5,4,1827,935,892
050,17,113,"Illinois","McLean County",5,5,1934,992,942
050,17,113,"Illinois","McLean County",5,6,2055,1047,1008
050,17,113,"Illinois","McLean County",5,7,2089,1050,1039
050,17,113,"Illinois","McLean County",5,8,2036,1058,978
050,17,113,"Illinois","McLean County",5,9,2057,1064,993
050,17,113,"Illinois","McLean County",5,10,2016,991,1025
050,17,113,"Illinois","McLean County",5,11,2023,1005,1018
050,17,113,"Illinois","McLean County",5,12,2043,1037,1006
050,17,113,"Illinois","McLean County",5,13,2016,1017,999
050,17,113,"Illinois","McLean County",5,14,2081,1086,995
050,17,113,"Illinois","McLean County",5,15,2174,1093,1081
050,17,113,"Illinois","McLean County",5,16,2175,1076,1099
050,17,113,"Illinois","McLean County",5,17,2172,1095,1077
050,17,113,"Illinois","McLean County",5,18,3106,1451,1655
050,17,113,"Illinois","McLean County",5,19,4586,2029,2557
050,17,113,"Illinois","McLean County",5,20,5276,2447,2829
050,17,113,"Illinois","McLean County",5,21,5028,2335,2693
050,17,113,"Illinois","McLean County",5,22,4494,2298,2196
050,17,113,"Illinois","McLean County",5,23,3496,1880,1616
050,17,113,"Illinois","McLean County",5,24,2565,1347,1218
050,17,113,"Illinois","McLean County",5,25,2442,1208,1234
050,17,113,"Illinois","McLean County",5,26,2208,1082,1126
050,17,113,"Illinois","McLean County",5,27,2104,1042,1062
050,17,113,"Illinois","McLean County",5,28,2116,1119,997
050,17,113,"Illinois","McLean County",5,29,2128,1044,1084
050,17,113,"Illinois","McLean County",5,30,2162,1143,1019
050,17,113,"Illinois","McLean County",5,31,2147,1111,1036
050,17,113,"Illinois","McLean County",5,32,2141,1082,1059
050,17,113,"Illinois","McLean County",5,33,2169,1091,1078
050,17,113,"Illinois","McLean County",5,34,2106,1060,1046
050,17,113,"Illinois","McLean County",5,35,2158,1074,1084
050,17,113,"Illinois","McLean County",5,36,2027,1015,1012
050,17,113,"Illinois","McLean County",5,37,2063,1038,1025
050,17,113,"Illinois","McLean County",5,38,2086,1072,1014
050,17,113,"Illinois","McLean County",5,39,2152,1084,1068
050,17,113,"Illinois","McLean County",5,40,2209,1079,1130
050,17,113,"Illinois","McLean County",5,41,2083,1057,1026
050,17,113,"Illinois","McLean County",5,42,2096,1065,1031
050,17,113,"Illinois","McLean County",5,43,2123,1062,1061
050,17,113,"Illinois","McLean County",5,44,2087,1045,1042
050,17,113,"Illinois","McLean County",5,45,2079,1038,1041
050,17,113,"Illinois","McLean County",5,46,1959,973,986
050,17,113,"Illinois","McLean County",5,47,1826,903,923
050,17,113,"Illinois","McLean County",5,48,1860,927,933
050,17,113,"Illinois","McLean County",5,49,1714,849,865
050,17,113,"Illinois","McLean County",5,50,1770,879,891
050,17,113,"Illinois","McLean County",5,51,1892,969,923
050,17,113,"Illinois","McLean County",5,52,2012,1019,993
050,17,113,"Illinois","McLean County",5,53,1934,958,976
050,17,113,"Illinois","McLean County",5,54,1854,910,944
050,17,113,"Illinois","McLean County",5,55,1794,881,913
050,17,113,"Illinois","McLean County",5,56,1779,882,897
050,17,113,"Illinois","McLean County",5,57,1824,890,934
050,17,113,"Illinois","McLean County",5,58,1893,932,961
050,17,113,"Illinois","McLean County",5,59,1952,954,998
050,17,113,"Illinois","McLean County",5,60,1927,937,990
050,17,113,"Illinois","McLean County",5,61,2008,982,1026
050,17,113,"Illinois","McLean County",5,62,1945,959,986
050,17,113,"Illinois","McLean County",5,63,1853,892,961
050,17,113,"Illinois","McLean County",5,64,1807,877,930
050,17,113,"Illinois","McLean County",5,65,1748,861,887
050,17,113,"Illinois","McLean County",5,66,1772,842,930
050,17,113,"Illinois","McLean County",5,67,1674,758,916
050,17,113,"Illinois","McLean County",5,68,1637,760,877
050,17,113,"Illinois","McLean County",5,69,1609,747,862
050,17,113,"Illinois","McLean County",5,70,1515,677,838
050,17,113,"Illinois","McLean County",5,71,1459,665,794
050,17,113,"Illinois","McLean County",5,72,1363,610,753
050,17,113,"Illinois","McLean County",5,73,1265,580,685
050,17,113,"Illinois","McLean County",5,74,1265,597,668
050,17,113,"Illinois","McLean County",5,75,1202,586,616
050,17,113,"Illinois","McLean County",5,76,1215,557,658
050,17,113,"Illinois","McLean County",5,77,802,379,423
050,17,113,"Illinois","McLean County",5,78,765,369,396
050,17,113,"Illinois","McLean County",5,79,745,341,404
050,17,113,"Illinois","McLean County",5,80,779,325,454
050,17,113,"Illinois","McLean County",5,81,632,266,366
050,17,113,"Illinois","McLean County",5,82,531,216,315
050,17,113,"Illinois","McLean County",5,83,488,205,283
050,17,113,"Illinois","McLean County",5,84,468,200,268
050,17,113,"Illinois","McLean County",5,85,2748,1008,1740
050,17,115,"Illinois","Macon County",1,0,1232,636,596
050,17,115,"Illinois","Macon County",1,1,1269,664,605
050,17,115,"Illinois","Macon County",1,2,1330,665,665
050,17,115,"Illinois","Macon County",1,3,1320,675,645
050,17,115,"Illinois","Macon County",1,4,1294,673,621
050,17,115,"Illinois","Macon County",1,5,1350,705,645
050,17,115,"Illinois","Macon County",1,6,1292,666,626
050,17,115,"Illinois","Macon County",1,7,1285,655,630
050,17,115,"Illinois","Macon County",1,8,1240,644,596
050,17,115,"Illinois","Macon County",1,9,1309,699,610
050,17,115,"Illinois","Macon County",1,10,1336,683,653
050,17,115,"Illinois","Macon County",1,11,1340,664,676
050,17,115,"Illinois","Macon County",1,12,1380,701,679
050,17,115,"Illinois","Macon County",1,13,1392,714,678
050,17,115,"Illinois","Macon County",1,14,1323,660,663
050,17,115,"Illinois","Macon County",1,15,1335,664,671
050,17,115,"Illinois","Macon County",1,16,1323,685,638
050,17,115,"Illinois","Macon County",1,17,1324,689,635
050,17,115,"Illinois","Macon County",1,18,1295,670,625
050,17,115,"Illinois","Macon County",1,19,1293,622,671
050,17,115,"Illinois","Macon County",1,20,1325,644,681
050,17,115,"Illinois","Macon County",1,21,1276,625,651
050,17,115,"Illinois","Macon County",1,22,1167,559,608
050,17,115,"Illinois","Macon County",1,23,1173,565,608
050,17,115,"Illinois","Macon County",1,24,1208,579,629
050,17,115,"Illinois","Macon County",1,25,1240,594,646
050,17,115,"Illinois","Macon County",1,26,1229,601,628
050,17,115,"Illinois","Macon County",1,27,1278,633,645
050,17,115,"Illinois","Macon County",1,28,1311,615,696
050,17,115,"Illinois","Macon County",1,29,1324,644,680
050,17,115,"Illinois","Macon County",1,30,1266,614,652
050,17,115,"Illinois","Macon County",1,31,1235,606,629
050,17,115,"Illinois","Macon County",1,32,1195,590,605
050,17,115,"Illinois","Macon County",1,33,1110,514,596
050,17,115,"Illinois","Macon County",1,34,1133,517,616
050,17,115,"Illinois","Macon County",1,35,1154,537,617
050,17,115,"Illinois","Macon County",1,36,1196,577,619
050,17,115,"Illinois","Macon County",1,37,1223,590,633
050,17,115,"Illinois","Macon County",1,38,1221,586,635
050,17,115,"Illinois","Macon County",1,39,1244,603,641
050,17,115,"Illinois","Macon County",1,40,1236,580,656
050,17,115,"Illinois","Macon County",1,41,1214,591,623
050,17,115,"Illinois","Macon County",1,42,1211,567,644
050,17,115,"Illinois","Macon County",1,43,1220,575,645
050,17,115,"Illinois","Macon County",1,44,1144,545,599
050,17,115,"Illinois","Macon County",1,45,1174,546,628
050,17,115,"Illinois","Macon County",1,46,1169,551,618
050,17,115,"Illinois","Macon County",1,47,1153,574,579
050,17,115,"Illinois","Macon County",1,48,1225,604,621
050,17,115,"Illinois","Macon County",1,49,1262,630,632
050,17,115,"Illinois","Macon County",1,50,1171,583,588
050,17,115,"Illinois","Macon County",1,51,1069,521,548
050,17,115,"Illinois","Macon County",1,52,1122,562,560
050,17,115,"Illinois","Macon County",1,53,1221,603,618
050,17,115,"Illinois","Macon County",1,54,1266,609,657
050,17,115,"Illinois","Macon County",1,55,1327,631,696
050,17,115,"Illinois","Macon County",1,56,1380,650,730
050,17,115,"Illinois","Macon County",1,57,1403,685,718
050,17,115,"Illinois","Macon County",1,58,1456,715,741
050,17,115,"Illinois","Macon County",1,59,1494,730,764
050,17,115,"Illinois","Macon County",1,60,1446,725,721
050,17,115,"Illinois","Macon County",1,61,1476,726,750
050,17,115,"Illinois","Macon County",1,62,1547,745,802
050,17,115,"Illinois","Macon County",1,63,1507,715,792
050,17,115,"Illinois","Macon County",1,64,1489,707,782
050,17,115,"Illinois","Macon County",1,65,1442,686,756
050,17,115,"Illinois","Macon County",1,66,1354,637,717
050,17,115,"Illinois","Macon County",1,67,1324,615,709
050,17,115,"Illinois","Macon County",1,68,1314,618,696
050,17,115,"Illinois","Macon County",1,69,1238,579,659
050,17,115,"Illinois","Macon County",1,70,1174,560,614
050,17,115,"Illinois","Macon County",1,71,1184,554,630
050,17,115,"Illinois","Macon County",1,72,1178,553,625
050,17,115,"Illinois","Macon County",1,73,1148,556,592
050,17,115,"Illinois","Macon County",1,74,749,350,399
050,17,115,"Illinois","Macon County",1,75,760,340,420
050,17,115,"Illinois","Macon County",1,76,796,360,436
050,17,115,"Illinois","Macon County",1,77,805,364,441
050,17,115,"Illinois","Macon County",1,78,662,304,358
050,17,115,"Illinois","Macon County",1,79,641,281,360
050,17,115,"Illinois","Macon County",1,80,556,248,308
050,17,115,"Illinois","Macon County",1,81,530,240,290
050,17,115,"Illinois","Macon County",1,82,476,209,267
050,17,115,"Illinois","Macon County",1,83,435,168,267
050,17,115,"Illinois","Macon County",1,84,406,169,237
050,17,115,"Illinois","Macon County",1,85,2660,896,1764
050,17,115,"Illinois","Macon County",2,0,1229,617,612
050,17,115,"Illinois","Macon County",2,1,1258,656,602
050,17,115,"Illinois","Macon County",2,2,1321,668,653
050,17,115,"Illinois","Macon County",2,3,1316,670,646
050,17,115,"Illinois","Macon County",2,4,1297,671,626
050,17,115,"Illinois","Macon County",2,5,1336,697,639
050,17,115,"Illinois","Macon County",2,6,1309,675,634
050,17,115,"Illinois","Macon County",2,7,1281,655,626
050,17,115,"Illinois","Macon County",2,8,1240,644,596
050,17,115,"Illinois","Macon County",2,9,1283,684,599
050,17,115,"Illinois","Macon County",2,10,1320,684,636
050,17,115,"Illinois","Macon County",2,11,1334,666,668
050,17,115,"Illinois","Macon County",2,12,1375,693,682
050,17,115,"Illinois","Macon County",2,13,1386,708,678
050,17,115,"Illinois","Macon County",2,14,1337,670,667
050,17,115,"Illinois","Macon County",2,15,1327,662,665
050,17,115,"Illinois","Macon County",2,16,1324,679,645
050,17,115,"Illinois","Macon County",2,17,1321,686,635
050,17,115,"Illinois","Macon County",2,18,1287,665,622
050,17,115,"Illinois","Macon County",2,19,1301,628,673
050,17,115,"Illinois","Macon County",2,20,1333,650,683
050,17,115,"Illinois","Macon County",2,21,1270,623,647
050,17,115,"Illinois","Macon County",2,22,1174,570,604
050,17,115,"Illinois","Macon County",2,23,1169,560,609
050,17,115,"Illinois","Macon County",2,24,1195,570,625
050,17,115,"Illinois","Macon County",2,25,1218,584,634
050,17,115,"Illinois","Macon County",2,26,1236,601,635
050,17,115,"Illinois","Macon County",2,27,1260,625,635
050,17,115,"Illinois","Macon County",2,28,1303,619,684
050,17,115,"Illinois","Macon County",2,29,1312,634,678
050,17,115,"Illinois","Macon County",2,30,1280,623,657
050,17,115,"Illinois","Macon County",2,31,1234,605,629
050,17,115,"Illinois","Macon County",2,32,1197,588,609
050,17,115,"Illinois","Macon County",2,33,1129,530,599
050,17,115,"Illinois","Macon County",2,34,1125,515,610
050,17,115,"Illinois","Macon County",2,35,1154,536,618
050,17,115,"Illinois","Macon County",2,36,1174,558,616
050,17,115,"Illinois","Macon County",2,37,1215,589,626
050,17,115,"Illinois","Macon County",2,38,1227,588,639
050,17,115,"Illinois","Macon County",2,39,1232,594,638
050,17,115,"Illinois","Macon County",2,40,1241,587,654
050,17,115,"Illinois","Macon County",2,41,1209,582,627
050,17,115,"Illinois","Macon County",2,42,1207,569,638
050,17,115,"Illinois","Macon County",2,43,1222,573,649
050,17,115,"Illinois","Macon County",2,44,1146,545,601
050,17,115,"Illinois","Macon County",2,45,1178,551,627
050,17,115,"Illinois","Macon County",2,46,1160,545,615
050,17,115,"Illinois","Macon County",2,47,1151,563,588
050,17,115,"Illinois","Macon County",2,48,1212,599,613
050,17,115,"Illinois","Macon County",2,49,1258,630,628
050,17,115,"Illinois","Macon County",2,50,1189,594,595
050,17,115,"Illinois","Macon County",2,51,1086,531,555
050,17,115,"Illinois","Macon County",2,52,1108,552,556
050,17,115,"Illinois","Macon County",2,53,1192,590,602
050,17,115,"Illinois","Macon County",2,54,1248,604,644
050,17,115,"Illinois","Macon County",2,55,1307,622,685
050,17,115,"Illinois","Macon County",2,56,1368,644,724
050,17,115,"Illinois","Macon County",2,57,1392,675,717
050,17,115,"Illinois","Macon County",2,58,1439,705,734
050,17,115,"Illinois","Macon County",2,59,1484,725,759
050,17,115,"Illinois","Macon County",2,60,1447,721,726
050,17,115,"Illinois","Macon County",2,61,1453,716,737
050,17,115,"Illinois","Macon County",2,62,1518,737,781
050,17,115,"Illinois","Macon County",2,63,1520,722,798
050,17,115,"Illinois","Macon County",2,64,1477,700,777
050,17,115,"Illinois","Macon County",2,65,1443,683,760
050,17,115,"Illinois","Macon County",2,66,1376,646,730
050,17,115,"Illinois","Macon County",2,67,1319,616,703
050,17,115,"Illinois","Macon County",2,68,1299,607,692
050,17,115,"Illinois","Macon County",2,69,1256,589,667
050,17,115,"Illinois","Macon County",2,70,1176,556,620
050,17,115,"Illinois","Macon County",2,71,1180,554,626
050,17,115,"Illinois","Macon County",2,72,1156,542,614
050,17,115,"Illinois","Macon County",2,73,1201,578,623
050,17,115,"Illinois","Macon County",2,74,791,372,419
050,17,115,"Illinois","Macon County",2,75,755,341,414
050,17,115,"Illinois","Macon County",2,76,772,348,424
050,17,115,"Illinois","Macon County",2,77,810,360,450
050,17,115,"Illinois","Macon County",2,78,672,307,365
050,17,115,"Illinois","Macon County",2,79,634,283,351
050,17,115,"Illinois","Macon County",2,80,573,254,319
050,17,115,"Illinois","Macon County",2,81,526,236,290
050,17,115,"Illinois","Macon County",2,82,483,210,273
050,17,115,"Illinois","Macon County",2,83,436,175,261
050,17,115,"Illinois","Macon County",2,84,406,163,243
050,17,115,"Illinois","Macon County",2,85,2657,901,1756
050,17,115,"Illinois","Macon County",3,0,1206,618,588
050,17,115,"Illinois","Macon County",3,1,1238,621,617
050,17,115,"Illinois","Macon County",3,2,1266,666,600
050,17,115,"Illinois","Macon County",3,3,1299,654,645
050,17,115,"Illinois","Macon County",3,4,1297,662,635
050,17,115,"Illinois","Macon County",3,5,1277,660,617
050,17,115,"Illinois","Macon County",3,6,1316,692,624
050,17,115,"Illinois","Macon County",3,7,1304,677,627
050,17,115,"Illinois","Macon County",3,8,1249,645,604
050,17,115,"Illinois","Macon County",3,9,1226,634,592
050,17,115,"Illinois","Macon County",3,10,1278,678,600
050,17,115,"Illinois","Macon County",3,11,1310,671,639
050,17,115,"Illinois","Macon County",3,12,1312,644,668
050,17,115,"Illinois","Macon County",3,13,1350,678,672
050,17,115,"Illinois","Macon County",3,14,1388,712,676
050,17,115,"Illinois","Macon County",3,15,1324,662,662
050,17,115,"Illinois","Macon County",3,16,1315,651,664
050,17,115,"Illinois","Macon County",3,17,1340,683,657
050,17,115,"Illinois","Macon County",3,18,1282,673,609
050,17,115,"Illinois","Macon County",3,19,1306,646,660
050,17,115,"Illinois","Macon County",3,20,1304,641,663
050,17,115,"Illinois","Macon County",3,21,1244,608,636
050,17,115,"Illinois","Macon County",3,22,1205,578,627
050,17,115,"Illinois","Macon County",3,23,1174,573,601
050,17,115,"Illinois","Macon County",3,24,1169,541,628
050,17,115,"Illinois","Macon County",3,25,1130,531,599
050,17,115,"Illinois","Macon County",3,26,1195,554,641
050,17,115,"Illinois","Macon County",3,27,1213,587,626
050,17,115,"Illinois","Macon County",3,28,1248,596,652
050,17,115,"Illinois","Macon County",3,29,1270,605,665
050,17,115,"Illinois","Macon County",3,30,1310,625,685
050,17,115,"Illinois","Macon County",3,31,1266,612,654
050,17,115,"Illinois","Macon County",3,32,1238,600,638
050,17,115,"Illinois","Macon County",3,33,1183,581,602
050,17,115,"Illinois","Macon County",3,34,1110,520,590
050,17,115,"Illinois","Macon County",3,35,1129,531,598
050,17,115,"Illinois","Macon County",3,36,1140,527,613
050,17,115,"Illinois","Macon County",3,37,1158,568,590
050,17,115,"Illinois","Macon County",3,38,1212,579,633
050,17,115,"Illinois","Macon County",3,39,1207,583,624
050,17,115,"Illinois","Macon County",3,40,1225,578,647
050,17,115,"Illinois","Macon County",3,41,1235,598,637
050,17,115,"Illinois","Macon County",3,42,1219,577,642
050,17,115,"Illinois","Macon County",3,43,1180,555,625
050,17,115,"Illinois","Macon County",3,44,1211,573,638
050,17,115,"Illinois","Macon County",3,45,1141,537,604
050,17,115,"Illinois","Macon County",3,46,1151,542,609
050,17,115,"Illinois","Macon County",3,47,1139,537,602
050,17,115,"Illinois","Macon County",3,48,1163,568,595
050,17,115,"Illinois","Macon County",3,49,1191,586,605
050,17,115,"Illinois","Macon County",3,50,1239,621,618
050,17,115,"Illinois","Macon County",3,51,1167,579,588
050,17,115,"Illinois","Macon County",3,52,1066,530,536
050,17,115,"Illinois","Macon County",3,53,1088,534,554
050,17,115,"Illinois","Macon County",3,54,1174,589,585
050,17,115,"Illinois","Macon County",3,55,1207,584,623
050,17,115,"Illinois","Macon County",3,56,1278,603,675
050,17,115,"Illinois","Macon County",3,57,1329,629,700
050,17,115,"Illinois","Macon County",3,58,1387,663,724
050,17,115,"Illinois","Macon County",3,59,1416,706,710
050,17,115,"Illinois","Macon County",3,60,1471,721,750
050,17,115,"Illinois","Macon County",3,61,1395,692,703
050,17,115,"Illinois","Macon County",3,62,1408,693,715
050,17,115,"Illinois","Macon County",3,63,1455,698,757
050,17,115,"Illinois","Macon County",3,64,1479,697,782
050,17,115,"Illinois","Macon County",3,65,1443,675,768
050,17,115,"Illinois","Macon County",3,66,1400,657,743
050,17,115,"Illinois","Macon County",3,67,1333,624,709
050,17,115,"Illinois","Macon County",3,68,1288,592,696
050,17,115,"Illinois","Macon County",3,69,1263,590,673
050,17,115,"Illinois","Macon County",3,70,1206,557,649
050,17,115,"Illinois","Macon County",3,71,1134,526,608
050,17,115,"Illinois","Macon County",3,72,1130,527,603
050,17,115,"Illinois","Macon County",3,73,1116,524,592
050,17,115,"Illinois","Macon County",3,74,1177,563,614
050,17,115,"Illinois","Macon County",3,75,753,350,403
050,17,115,"Illinois","Macon County",3,76,708,318,390
050,17,115,"Illinois","Macon County",3,77,752,329,423
050,17,115,"Illinois","Macon County",3,78,763,333,430
050,17,115,"Illinois","Macon County",3,79,640,292,348
050,17,115,"Illinois","Macon County",3,80,583,249,334
050,17,115,"Illinois","Macon County",3,81,541,234,307
050,17,115,"Illinois","Macon County",3,82,493,223,270
050,17,115,"Illinois","Macon County",3,83,438,187,251
050,17,115,"Illinois","Macon County",3,84,398,154,244
050,17,115,"Illinois","Macon County",3,85,2636,913,1723
050,17,115,"Illinois","Macon County",4,0,1148,582,566
050,17,115,"Illinois","Macon County",4,1,1217,605,612
050,17,115,"Illinois","Macon County",4,2,1196,602,594
050,17,115,"Illinois","Macon County",4,3,1289,682,607
050,17,115,"Illinois","Macon County",4,4,1274,643,631
050,17,115,"Illinois","Macon County",4,5,1284,658,626
050,17,115,"Illinois","Macon County",4,6,1274,645,629
050,17,115,"Illinois","Macon County",4,7,1283,680,603
050,17,115,"Illinois","Macon County",4,8,1280,657,623
050,17,115,"Illinois","Macon County",4,9,1275,661,614
050,17,115,"Illinois","Macon County",4,10,1216,638,578
050,17,115,"Illinois","Macon County",4,11,1269,675,594
050,17,115,"Illinois","Macon County",4,12,1296,671,625
050,17,115,"Illinois","Macon County",4,13,1307,643,664
050,17,115,"Illinois","Macon County",4,14,1331,680,651
050,17,115,"Illinois","Macon County",4,15,1360,700,660
050,17,115,"Illinois","Macon County",4,16,1320,664,656
050,17,115,"Illinois","Macon County",4,17,1305,642,663
050,17,115,"Illinois","Macon County",4,18,1297,667,630
050,17,115,"Illinois","Macon County",4,19,1264,623,641
050,17,115,"Illinois","Macon County",4,20,1306,657,649
050,17,115,"Illinois","Macon County",4,21,1233,617,616
050,17,115,"Illinois","Macon County",4,22,1161,578,583
050,17,115,"Illinois","Macon County",4,23,1186,570,616
050,17,115,"Illinois","Macon County",4,24,1143,550,593
050,17,115,"Illinois","Macon County",4,25,1146,553,593
050,17,115,"Illinois","Macon County",4,26,1138,520,618
050,17,115,"Illinois","Macon County",4,27,1163,553,610
050,17,115,"Illinois","Macon County",4,28,1193,575,618
050,17,115,"Illinois","Macon County",4,29,1214,578,636
050,17,115,"Illinois","Macon County",4,30,1252,594,658
050,17,115,"Illinois","Macon County",4,31,1277,615,662
050,17,115,"Illinois","Macon County",4,32,1256,595,661
050,17,115,"Illinois","Macon County",4,33,1244,593,651
050,17,115,"Illinois","Macon County",4,34,1164,578,586
050,17,115,"Illinois","Macon County",4,35,1097,534,563
050,17,115,"Illinois","Macon County",4,36,1130,532,598
050,17,115,"Illinois","Macon County",4,37,1139,536,603
050,17,115,"Illinois","Macon County",4,38,1155,560,595
050,17,115,"Illinois","Macon County",4,39,1180,559,621
050,17,115,"Illinois","Macon County",4,40,1204,584,620
050,17,115,"Illinois","Macon County",4,41,1219,589,630
050,17,115,"Illinois","Macon County",4,42,1238,586,652
050,17,115,"Illinois","Macon County",4,43,1179,551,628
050,17,115,"Illinois","Macon County",4,44,1150,536,614
050,17,115,"Illinois","Macon County",4,45,1216,577,639
050,17,115,"Illinois","Macon County",4,46,1122,534,588
050,17,115,"Illinois","Macon County",4,47,1140,539,601
050,17,115,"Illinois","Macon County",4,48,1143,546,597
050,17,115,"Illinois","Macon County",4,49,1134,559,575
050,17,115,"Illinois","Macon County",4,50,1183,586,597
050,17,115,"Illinois","Macon County",4,51,1217,615,602
050,17,115,"Illinois","Macon County",4,52,1163,578,585
050,17,115,"Illinois","Macon County",4,53,1054,519,535
050,17,115,"Illinois","Macon County",4,54,1083,531,552
050,17,115,"Illinois","Macon County",4,55,1157,580,577
050,17,115,"Illinois","Macon County",4,56,1187,569,618
050,17,115,"Illinois","Macon County",4,57,1248,593,655
050,17,115,"Illinois","Macon County",4,58,1309,614,695
050,17,115,"Illinois","Macon County",4,59,1348,638,710
050,17,115,"Illinois","Macon County",4,60,1398,707,691
050,17,115,"Illinois","Macon County",4,61,1437,689,748
050,17,115,"Illinois","Macon County",4,62,1363,682,681
050,17,115,"Illinois","Macon County",4,63,1335,652,683
050,17,115,"Illinois","Macon County",4,64,1419,680,739
050,17,115,"Illinois","Macon County",4,65,1443,673,770
050,17,115,"Illinois","Macon County",4,66,1398,645,753
050,17,115,"Illinois","Macon County",4,67,1338,625,713
050,17,115,"Illinois","Macon County",4,68,1272,580,692
050,17,115,"Illinois","Macon County",4,69,1244,572,672
050,17,115,"Illinois","Macon County",4,70,1211,563,648
050,17,115,"Illinois","Macon County",4,71,1167,539,628
050,17,115,"Illinois","Macon County",4,72,1090,498,592
050,17,115,"Illinois","Macon County",4,73,1087,510,577
050,17,115,"Illinois","Macon County",4,74,1081,499,582
050,17,115,"Illinois","Macon County",4,75,1126,541,585
050,17,115,"Illinois","Macon County",4,76,717,336,381
050,17,115,"Illinois","Macon County",4,77,688,299,389
050,17,115,"Illinois","Macon County",4,78,691,293,398
050,17,115,"Illinois","Macon County",4,79,722,305,417
050,17,115,"Illinois","Macon County",4,80,604,270,334
050,17,115,"Illinois","Macon County",4,81,559,235,324
050,17,115,"Illinois","Macon County",4,82,508,224,284
050,17,115,"Illinois","Macon County",4,83,454,199,255
050,17,115,"Illinois","Macon County",4,84,404,169,235
050,17,115,"Illinois","Macon County",4,85,2621,917,1704
050,17,115,"Illinois","Macon County",5,0,1141,585,556
050,17,115,"Illinois","Macon County",5,1,1146,550,596
050,17,115,"Illinois","Macon County",5,2,1213,604,609
050,17,115,"Illinois","Macon County",5,3,1201,601,600
050,17,115,"Illinois","Macon County",5,4,1279,667,612
050,17,115,"Illinois","Macon County",5,5,1265,646,619
050,17,115,"Illinois","Macon County",5,6,1253,644,609
050,17,115,"Illinois","Macon County",5,7,1256,645,611
050,17,115,"Illinois","Macon County",5,8,1269,674,595
050,17,115,"Illinois","Macon County",5,9,1283,666,617
050,17,115,"Illinois","Macon County",5,10,1286,670,616
050,17,115,"Illinois","Macon County",5,11,1222,637,585
050,17,115,"Illinois","Macon County",5,12,1257,670,587
050,17,115,"Illinois","Macon County",5,13,1298,670,628
050,17,115,"Illinois","Macon County",5,14,1314,645,669
050,17,115,"Illinois","Macon County",5,15,1325,678,647
050,17,115,"Illinois","Macon County",5,16,1350,684,666
050,17,115,"Illinois","Macon County",5,17,1329,658,671
050,17,115,"Illinois","Macon County",5,18,1275,630,645
050,17,115,"Illinois","Macon County",5,19,1278,616,662
050,17,115,"Illinois","Macon County",5,20,1274,643,631
050,17,115,"Illinois","Macon County",5,21,1256,628,628
050,17,115,"Illinois","Macon County",5,22,1171,589,582
050,17,115,"Illinois","Macon County",5,23,1161,587,574
050,17,115,"Illinois","Macon County",5,24,1183,577,606
050,17,115,"Illinois","Macon County",5,25,1087,528,559
050,17,115,"Illinois","Macon County",5,26,1126,526,600
050,17,115,"Illinois","Macon County",5,27,1122,528,594
050,17,115,"Illinois","Macon County",5,28,1132,524,608
050,17,115,"Illinois","Macon County",5,29,1182,555,627
050,17,115,"Illinois","Macon County",5,30,1206,585,621
050,17,115,"Illinois","Macon County",5,31,1214,567,647
050,17,115,"Illinois","Macon County",5,32,1265,620,645
050,17,115,"Illinois","Macon County",5,33,1261,601,660
050,17,115,"Illinois","Macon County",5,34,1243,589,654
050,17,115,"Illinois","Macon County",5,35,1145,567,578
050,17,115,"Illinois","Macon County",5,36,1077,499,578
050,17,115,"Illinois","Macon County",5,37,1109,525,584
050,17,115,"Illinois","Macon County",5,38,1148,532,616
050,17,115,"Illinois","Macon County",5,39,1150,552,598
050,17,115,"Illinois","Macon County",5,40,1163,546,617
050,17,115,"Illinois","Macon County",5,41,1198,588,610
050,17,115,"Illinois","Macon County",5,42,1207,569,638
050,17,115,"Illinois","Macon County",5,43,1230,590,640
050,17,115,"Illinois","Macon County",5,44,1161,541,620
050,17,115,"Illinois","Macon County",5,45,1170,550,620
050,17,115,"Illinois","Macon County",5,46,1187,560,627
050,17,115,"Illinois","Macon County",5,47,1103,529,574
050,17,115,"Illinois","Macon County",5,48,1154,535,619
050,17,115,"Illinois","Macon County",5,49,1130,540,590
050,17,115,"Illinois","Macon County",5,50,1116,549,567
050,17,115,"Illinois","Macon County",5,51,1172,583,589
050,17,115,"Illinois","Macon County",5,52,1232,628,604
050,17,115,"Illinois","Macon County",5,53,1150,567,583
050,17,115,"Illinois","Macon County",5,54,1047,523,524
050,17,115,"Illinois","Macon County",5,55,1087,539,548
050,17,115,"Illinois","Macon County",5,56,1137,564,573
050,17,115,"Illinois","Macon County",5,57,1178,569,609
050,17,115,"Illinois","Macon County",5,58,1222,584,638
050,17,115,"Illinois","Macon County",5,59,1301,606,695
050,17,115,"Illinois","Macon County",5,60,1326,625,701
050,17,115,"Illinois","Macon County",5,61,1384,689,695
050,17,115,"Illinois","Macon County",5,62,1418,680,738
050,17,115,"Illinois","Macon County",5,63,1298,636,662
050,17,115,"Illinois","Macon County",5,64,1325,646,679
050,17,115,"Illinois","Macon County",5,65,1395,659,736
050,17,115,"Illinois","Macon County",5,66,1412,655,757
050,17,115,"Illinois","Macon County",5,67,1355,618,737
050,17,115,"Illinois","Macon County",5,68,1300,595,705
050,17,115,"Illinois","Macon County",5,69,1245,564,681
050,17,115,"Illinois","Macon County",5,70,1204,549,655
050,17,115,"Illinois","Macon County",5,71,1178,547,631
050,17,115,"Illinois","Macon County",5,72,1124,516,608
050,17,115,"Illinois","Macon County",5,73,1054,480,574
050,17,115,"Illinois","Macon County",5,74,1064,490,574
050,17,115,"Illinois","Macon County",5,75,1047,483,564
050,17,115,"Illinois","Macon County",5,76,1083,523,560
050,17,115,"Illinois","Macon County",5,77,697,320,377
050,17,115,"Illinois","Macon County",5,78,628,266,362
050,17,115,"Illinois","Macon County",5,79,664,276,388
050,17,115,"Illinois","Macon County",5,80,676,278,398
050,17,115,"Illinois","Macon County",5,81,578,256,322
050,17,115,"Illinois","Macon County",5,82,527,223,304
050,17,115,"Illinois","Macon County",5,83,474,200,274
050,17,115,"Illinois","Macon County",5,84,413,172,241
050,17,115,"Illinois","Macon County",5,85,2625,936,1689
050,17,117,"Illinois","Macoupin County",1,0,452,231,221
050,17,117,"Illinois","Macoupin County",1,1,471,239,232
050,17,117,"Illinois","Macoupin County",1,2,465,246,219
050,17,117,"Illinois","Macoupin County",1,3,471,265,206
050,17,117,"Illinois","Macoupin County",1,4,489,254,235
050,17,117,"Illinois","Macoupin County",1,5,475,247,228
050,17,117,"Illinois","Macoupin County",1,6,477,240,237
050,17,117,"Illinois","Macoupin County",1,7,502,246,256
050,17,117,"Illinois","Macoupin County",1,8,494,251,243
050,17,117,"Illinois","Macoupin County",1,9,513,259,254
050,17,117,"Illinois","Macoupin County",1,10,541,288,253
050,17,117,"Illinois","Macoupin County",1,11,568,304,264
050,17,117,"Illinois","Macoupin County",1,12,614,331,283
050,17,117,"Illinois","Macoupin County",1,13,609,320,289
050,17,117,"Illinois","Macoupin County",1,14,582,314,268
050,17,117,"Illinois","Macoupin County",1,15,595,327,268
050,17,117,"Illinois","Macoupin County",1,16,607,319,288
050,17,117,"Illinois","Macoupin County",1,17,617,320,297
050,17,117,"Illinois","Macoupin County",1,18,535,271,264
050,17,117,"Illinois","Macoupin County",1,19,439,219,220
050,17,117,"Illinois","Macoupin County",1,20,464,248,216
050,17,117,"Illinois","Macoupin County",1,21,483,261,222
050,17,117,"Illinois","Macoupin County",1,22,484,245,239
050,17,117,"Illinois","Macoupin County",1,23,462,245,217
050,17,117,"Illinois","Macoupin County",1,24,447,238,209
050,17,117,"Illinois","Macoupin County",1,25,441,223,218
050,17,117,"Illinois","Macoupin County",1,26,431,210,221
050,17,117,"Illinois","Macoupin County",1,27,479,248,231
050,17,117,"Illinois","Macoupin County",1,28,470,240,230
050,17,117,"Illinois","Macoupin County",1,29,498,238,260
050,17,117,"Illinois","Macoupin County",1,30,514,255,259
050,17,117,"Illinois","Macoupin County",1,31,493,230,263
050,17,117,"Illinois","Macoupin County",1,32,479,228,251
050,17,117,"Illinois","Macoupin County",1,33,472,237,235
050,17,117,"Illinois","Macoupin County",1,34,514,253,261
050,17,117,"Illinois","Macoupin County",1,35,523,255,268
050,17,117,"Illinois","Macoupin County",1,36,543,276,267
050,17,117,"Illinois","Macoupin County",1,37,568,288,280
050,17,117,"Illinois","Macoupin County",1,38,549,280,269
050,17,117,"Illinois","Macoupin County",1,39,551,283,268
050,17,117,"Illinois","Macoupin County",1,40,593,285,308
050,17,117,"Illinois","Macoupin County",1,41,564,277,287
050,17,117,"Illinois","Macoupin County",1,42,537,275,262
050,17,117,"Illinois","Macoupin County",1,43,518,253,265
050,17,117,"Illinois","Macoupin County",1,44,523,259,264
050,17,117,"Illinois","Macoupin County",1,45,563,282,281
050,17,117,"Illinois","Macoupin County",1,46,531,268,263
050,17,117,"Illinois","Macoupin County",1,47,518,259,259
050,17,117,"Illinois","Macoupin County",1,48,554,301,253
050,17,117,"Illinois","Macoupin County",1,49,592,331,261
050,17,117,"Illinois","Macoupin County",1,50,572,301,271
050,17,117,"Illinois","Macoupin County",1,51,576,286,290
050,17,117,"Illinois","Macoupin County",1,52,549,274,275
050,17,117,"Illinois","Macoupin County",1,53,553,271,282
050,17,117,"Illinois","Macoupin County",1,54,630,305,325
050,17,117,"Illinois","Macoupin County",1,55,667,314,353
050,17,117,"Illinois","Macoupin County",1,56,687,328,359
050,17,117,"Illinois","Macoupin County",1,57,686,342,344
050,17,117,"Illinois","Macoupin County",1,58,713,351,362
050,17,117,"Illinois","Macoupin County",1,59,726,367,359
050,17,117,"Illinois","Macoupin County",1,60,714,363,351
050,17,117,"Illinois","Macoupin County",1,61,681,336,345
050,17,117,"Illinois","Macoupin County",1,62,709,357,352
050,17,117,"Illinois","Macoupin County",1,63,686,355,331
050,17,117,"Illinois","Macoupin County",1,64,698,353,345
050,17,117,"Illinois","Macoupin County",1,65,667,323,344
050,17,117,"Illinois","Macoupin County",1,66,640,300,340
050,17,117,"Illinois","Macoupin County",1,67,624,304,320
050,17,117,"Illinois","Macoupin County",1,68,595,298,297
050,17,117,"Illinois","Macoupin County",1,69,551,278,273
050,17,117,"Illinois","Macoupin County",1,70,524,260,264
050,17,117,"Illinois","Macoupin County",1,71,505,237,268
050,17,117,"Illinois","Macoupin County",1,72,486,226,260
050,17,117,"Illinois","Macoupin County",1,73,501,232,269
050,17,117,"Illinois","Macoupin County",1,74,346,153,193
050,17,117,"Illinois","Macoupin County",1,75,328,154,174
050,17,117,"Illinois","Macoupin County",1,76,344,164,180
050,17,117,"Illinois","Macoupin County",1,77,342,153,189
050,17,117,"Illinois","Macoupin County",1,78,286,130,156
050,17,117,"Illinois","Macoupin County",1,79,259,122,137
050,17,117,"Illinois","Macoupin County",1,80,240,109,131
050,17,117,"Illinois","Macoupin County",1,81,208,87,121
050,17,117,"Illinois","Macoupin County",1,82,227,96,131
050,17,117,"Illinois","Macoupin County",1,83,199,80,119
050,17,117,"Illinois","Macoupin County",1,84,190,69,121
050,17,117,"Illinois","Macoupin County",1,85,1190,401,789
050,17,117,"Illinois","Macoupin County",2,0,447,228,219
050,17,117,"Illinois","Macoupin County",2,1,464,236,228
050,17,117,"Illinois","Macoupin County",2,2,467,245,222
050,17,117,"Illinois","Macoupin County",2,3,467,258,209
050,17,117,"Illinois","Macoupin County",2,4,485,257,228
050,17,117,"Illinois","Macoupin County",2,5,476,248,228
050,17,117,"Illinois","Macoupin County",2,6,477,242,235
050,17,117,"Illinois","Macoupin County",2,7,495,244,251
050,17,117,"Illinois","Macoupin County",2,8,498,250,248
050,17,117,"Illinois","Macoupin County",2,9,510,258,252
050,17,117,"Illinois","Macoupin County",2,10,534,279,255
050,17,117,"Illinois","Macoupin County",2,11,561,301,260
050,17,117,"Illinois","Macoupin County",2,12,606,326,280
050,17,117,"Illinois","Macoupin County",2,13,605,319,286
050,17,117,"Illinois","Macoupin County",2,14,587,316,271
050,17,117,"Illinois","Macoupin County",2,15,592,323,269
050,17,117,"Illinois","Macoupin County",2,16,602,321,281
050,17,117,"Illinois","Macoupin County",2,17,613,318,295
050,17,117,"Illinois","Macoupin County",2,18,532,269,263
050,17,117,"Illinois","Macoupin County",2,19,443,222,221
050,17,117,"Illinois","Macoupin County",2,20,470,247,223
050,17,117,"Illinois","Macoupin County",2,21,484,261,223
050,17,117,"Illinois","Macoupin County",2,22,485,248,237
050,17,117,"Illinois","Macoupin County",2,23,461,243,218
050,17,117,"Illinois","Macoupin County",2,24,446,238,208
050,17,117,"Illinois","Macoupin County",2,25,443,227,216
050,17,117,"Illinois","Macoupin County",2,26,433,213,220
050,17,117,"Illinois","Macoupin County",2,27,464,238,226
050,17,117,"Illinois","Macoupin County",2,28,472,241,231
050,17,117,"Illinois","Macoupin County",2,29,490,238,252
050,17,117,"Illinois","Macoupin County",2,30,508,249,259
050,17,117,"Illinois","Macoupin County",2,31,495,235,260
050,17,117,"Illinois","Macoupin County",2,32,478,226,252
050,17,117,"Illinois","Macoupin County",2,33,471,233,238
050,17,117,"Illinois","Macoupin County",2,34,504,247,257
050,17,117,"Illinois","Macoupin County",2,35,527,259,268
050,17,117,"Illinois","Macoupin County",2,36,536,270,266
050,17,117,"Illinois","Macoupin County",2,37,565,288,277
050,17,117,"Illinois","Macoupin County",2,38,557,285,272
050,17,117,"Illinois","Macoupin County",2,39,549,282,267
050,17,117,"Illinois","Macoupin County",2,40,587,286,301
050,17,117,"Illinois","Macoupin County",2,41,569,279,290
050,17,117,"Illinois","Macoupin County",2,42,541,273,268
050,17,117,"Illinois","Macoupin County",2,43,526,259,267
050,17,117,"Illinois","Macoupin County",2,44,517,255,262
050,17,117,"Illinois","Macoupin County",2,45,554,277,277
050,17,117,"Illinois","Macoupin County",2,46,533,268,265
050,17,117,"Illinois","Macoupin County",2,47,519,261,258
050,17,117,"Illinois","Macoupin County",2,48,544,288,256
050,17,117,"Illinois","Macoupin County",2,49,585,325,260
050,17,117,"Illinois","Macoupin County",2,50,578,307,271
050,17,117,"Illinois","Macoupin County",2,51,573,290,283
050,17,117,"Illinois","Macoupin County",2,52,551,275,276
050,17,117,"Illinois","Macoupin County",2,53,553,273,280
050,17,117,"Illinois","Macoupin County",2,54,605,292,313
050,17,117,"Illinois","Macoupin County",2,55,654,308,346
050,17,117,"Illinois","Macoupin County",2,56,681,323,358
050,17,117,"Illinois","Macoupin County",2,57,686,339,347
050,17,117,"Illinois","Macoupin County",2,58,701,346,355
050,17,117,"Illinois","Macoupin County",2,59,722,361,361
050,17,117,"Illinois","Macoupin County",2,60,709,359,350
050,17,117,"Illinois","Macoupin County",2,61,688,341,347
050,17,117,"Illinois","Macoupin County",2,62,699,349,350
050,17,117,"Illinois","Macoupin County",2,63,694,355,339
050,17,117,"Illinois","Macoupin County",2,64,686,350,336
050,17,117,"Illinois","Macoupin County",2,65,670,326,344
050,17,117,"Illinois","Macoupin County",2,66,648,307,341
050,17,117,"Illinois","Macoupin County",2,67,621,298,323
050,17,117,"Illinois","Macoupin County",2,68,594,295,299
050,17,117,"Illinois","Macoupin County",2,69,568,285,283
050,17,117,"Illinois","Macoupin County",2,70,527,264,263
050,17,117,"Illinois","Macoupin County",2,71,506,239,267
050,17,117,"Illinois","Macoupin County",2,72,476,222,254
050,17,117,"Illinois","Macoupin County",2,73,517,237,280
050,17,117,"Illinois","Macoupin County",2,74,353,157,196
050,17,117,"Illinois","Macoupin County",2,75,333,155,178
050,17,117,"Illinois","Macoupin County",2,76,334,157,177
050,17,117,"Illinois","Macoupin County",2,77,349,159,190
050,17,117,"Illinois","Macoupin County",2,78,291,131,160
050,17,117,"Illinois","Macoupin County",2,79,260,121,139
050,17,117,"Illinois","Macoupin County",2,80,243,112,131
050,17,117,"Illinois","Macoupin County",2,81,211,90,121
050,17,117,"Illinois","Macoupin County",2,82,225,95,130
050,17,117,"Illinois","Macoupin County",2,83,198,82,116
050,17,117,"Illinois","Macoupin County",2,84,191,70,121
050,17,117,"Illinois","Macoupin County",2,85,1187,397,790
050,17,117,"Illinois","Macoupin County",3,0,404,199,205
050,17,117,"Illinois","Macoupin County",3,1,456,238,218
050,17,117,"Illinois","Macoupin County",3,2,471,246,225
050,17,117,"Illinois","Macoupin County",3,3,474,249,225
050,17,117,"Illinois","Macoupin County",3,4,472,263,209
050,17,117,"Illinois","Macoupin County",3,5,460,243,217
050,17,117,"Illinois","Macoupin County",3,6,471,246,225
050,17,117,"Illinois","Macoupin County",3,7,495,249,246
050,17,117,"Illinois","Macoupin County",3,8,492,251,241
050,17,117,"Illinois","Macoupin County",3,9,502,253,249
050,17,117,"Illinois","Macoupin County",3,10,516,265,251
050,17,117,"Illinois","Macoupin County",3,11,536,283,253
050,17,117,"Illinois","Macoupin County",3,12,543,291,252
050,17,117,"Illinois","Macoupin County",3,13,618,318,300
050,17,117,"Illinois","Macoupin County",3,14,608,318,290
050,17,117,"Illinois","Macoupin County",3,15,583,322,261
050,17,117,"Illinois","Macoupin County",3,16,575,313,262
050,17,117,"Illinois","Macoupin County",3,17,607,322,285
050,17,117,"Illinois","Macoupin County",3,18,524,277,247
050,17,117,"Illinois","Macoupin County",3,19,447,221,226
050,17,117,"Illinois","Macoupin County",3,20,479,239,240
050,17,117,"Illinois","Macoupin County",3,21,483,252,231
050,17,117,"Illinois","Macoupin County",3,22,483,249,234
050,17,117,"Illinois","Macoupin County",3,23,483,259,224
050,17,117,"Illinois","Macoupin County",3,24,461,242,219
050,17,117,"Illinois","Macoupin County",3,25,442,228,214
050,17,117,"Illinois","Macoupin County",3,26,438,218,220
050,17,117,"Illinois","Macoupin County",3,27,449,222,227
050,17,117,"Illinois","Macoupin County",3,28,462,235,227
050,17,117,"Illinois","Macoupin County",3,29,468,232,236
050,17,117,"Illinois","Macoupin County",3,30,492,241,251
050,17,117,"Illinois","Macoupin County",3,31,521,250,271
050,17,117,"Illinois","Macoupin County",3,32,495,231,264
050,17,117,"Illinois","Macoupin County",3,33,474,231,243
050,17,117,"Illinois","Macoupin County",3,34,465,224,241
050,17,117,"Illinois","Macoupin County",3,35,509,255,254
050,17,117,"Illinois","Macoupin County",3,36,537,264,273
050,17,117,"Illinois","Macoupin County",3,37,547,279,268
050,17,117,"Illinois","Macoupin County",3,38,558,285,273
050,17,117,"Illinois","Macoupin County",3,39,559,283,276
050,17,117,"Illinois","Macoupin County",3,40,551,282,269
050,17,117,"Illinois","Macoupin County",3,41,585,287,298
050,17,117,"Illinois","Macoupin County",3,42,563,274,289
050,17,117,"Illinois","Macoupin County",3,43,538,270,268
050,17,117,"Illinois","Macoupin County",3,44,534,265,269
050,17,117,"Illinois","Macoupin County",3,45,495,242,253
050,17,117,"Illinois","Macoupin County",3,46,547,280,267
050,17,117,"Illinois","Macoupin County",3,47,539,268,271
050,17,117,"Illinois","Macoupin County",3,48,504,249,255
050,17,117,"Illinois","Macoupin County",3,49,541,285,256
050,17,117,"Illinois","Macoupin County",3,50,578,320,258
050,17,117,"Illinois","Macoupin County",3,51,580,299,281
050,17,117,"Illinois","Macoupin County",3,52,566,285,281
050,17,117,"Illinois","Macoupin County",3,53,549,274,275
050,17,117,"Illinois","Macoupin County",3,54,544,263,281
050,17,117,"Illinois","Macoupin County",3,55,600,288,312
050,17,117,"Illinois","Macoupin County",3,56,655,309,346
050,17,117,"Illinois","Macoupin County",3,57,665,319,346
050,17,117,"Illinois","Macoupin County",3,58,689,341,348
050,17,117,"Illinois","Macoupin County",3,59,698,347,351
050,17,117,"Illinois","Macoupin County",3,60,725,361,364
050,17,117,"Illinois","Macoupin County",3,61,683,342,341
050,17,117,"Illinois","Macoupin County",3,62,671,325,346
050,17,117,"Illinois","Macoupin County",3,63,706,353,353
050,17,117,"Illinois","Macoupin County",3,64,684,352,332
050,17,117,"Illinois","Macoupin County",3,65,679,350,329
050,17,117,"Illinois","Macoupin County",3,66,657,321,336
050,17,117,"Illinois","Macoupin County",3,67,631,302,329
050,17,117,"Illinois","Macoupin County",3,68,623,298,325
050,17,117,"Illinois","Macoupin County",3,69,580,284,296
050,17,117,"Illinois","Macoupin County",3,70,551,278,273
050,17,117,"Illinois","Macoupin County",3,71,506,246,260
050,17,117,"Illinois","Macoupin County",3,72,479,229,250
050,17,117,"Illinois","Macoupin County",3,73,452,206,246
050,17,117,"Illinois","Macoupin County",3,74,497,228,269
050,17,117,"Illinois","Macoupin County",3,75,333,153,180
050,17,117,"Illinois","Macoupin County",3,76,320,139,181
050,17,117,"Illinois","Macoupin County",3,77,327,153,174
050,17,117,"Illinois","Macoupin County",3,78,321,146,175
050,17,117,"Illinois","Macoupin County",3,79,262,119,143
050,17,117,"Illinois","Macoupin County",3,80,237,109,128
050,17,117,"Illinois","Macoupin County",3,81,232,106,126
050,17,117,"Illinois","Macoupin County",3,82,211,85,126
050,17,117,"Illinois","Macoupin County",3,83,200,82,118
050,17,117,"Illinois","Macoupin County",3,84,180,73,107
050,17,117,"Illinois","Macoupin County",3,85,1165,391,774
050,17,117,"Illinois","Macoupin County",4,0,393,209,184
050,17,117,"Illinois","Macoupin County",4,1,426,213,213
050,17,117,"Illinois","Macoupin County",4,2,468,245,223
050,17,117,"Illinois","Macoupin County",4,3,473,236,237
050,17,117,"Illinois","Macoupin County",4,4,475,256,219
050,17,117,"Illinois","Macoupin County",4,5,482,264,218
050,17,117,"Illinois","Macoupin County",4,6,483,261,222
050,17,117,"Illinois","Macoupin County",4,7,474,254,220
050,17,117,"Illinois","Macoupin County",4,8,483,242,241
050,17,117,"Illinois","Macoupin County",4,9,493,247,246
050,17,117,"Illinois","Macoupin County",4,10,503,257,246
050,17,117,"Illinois","Macoupin County",4,11,512,259,253
050,17,117,"Illinois","Macoupin County",4,12,524,276,248
050,17,117,"Illinois","Macoupin County",4,13,541,284,257
050,17,117,"Illinois","Macoupin County",4,14,613,314,299
050,17,117,"Illinois","Macoupin County",4,15,599,317,282
050,17,117,"Illinois","Macoupin County",4,16,564,308,256
050,17,117,"Illinois","Macoupin County",4,17,589,317,272
050,17,117,"Illinois","Macoupin County",4,18,531,287,244
050,17,117,"Illinois","Macoupin County",4,19,428,226,202
050,17,117,"Illinois","Macoupin County",4,20,474,240,234
050,17,117,"Illinois","Macoupin County",4,21,492,248,244
050,17,117,"Illinois","Macoupin County",4,22,498,255,243
050,17,117,"Illinois","Macoupin County",4,23,464,247,217
050,17,117,"Illinois","Macoupin County",4,24,462,244,218
050,17,117,"Illinois","Macoupin County",4,25,441,238,203
050,17,117,"Illinois","Macoupin County",4,26,447,226,221
050,17,117,"Illinois","Macoupin County",4,27,436,212,224
050,17,117,"Illinois","Macoupin County",4,28,442,224,218
050,17,117,"Illinois","Macoupin County",4,29,456,238,218
050,17,117,"Illinois","Macoupin County",4,30,446,221,225
050,17,117,"Illinois","Macoupin County",4,31,480,235,245
050,17,117,"Illinois","Macoupin County",4,32,518,256,262
050,17,117,"Illinois","Macoupin County",4,33,490,219,271
050,17,117,"Illinois","Macoupin County",4,34,485,233,252
050,17,117,"Illinois","Macoupin County",4,35,473,240,233
050,17,117,"Illinois","Macoupin County",4,36,497,249,248
050,17,117,"Illinois","Macoupin County",4,37,541,268,273
050,17,117,"Illinois","Macoupin County",4,38,543,268,275
050,17,117,"Illinois","Macoupin County",4,39,560,286,274
050,17,117,"Illinois","Macoupin County",4,40,554,267,287
050,17,117,"Illinois","Macoupin County",4,41,532,275,257
050,17,117,"Illinois","Macoupin County",4,42,579,276,303
050,17,117,"Illinois","Macoupin County",4,43,548,273,275
050,17,117,"Illinois","Macoupin County",4,44,554,284,270
050,17,117,"Illinois","Macoupin County",4,45,516,258,258
050,17,117,"Illinois","Macoupin County",4,46,495,246,249
050,17,117,"Illinois","Macoupin County",4,47,552,286,266
050,17,117,"Illinois","Macoupin County",4,48,562,274,288
050,17,117,"Illinois","Macoupin County",4,49,510,257,253
050,17,117,"Illinois","Macoupin County",4,50,553,288,265
050,17,117,"Illinois","Macoupin County",4,51,582,317,265
050,17,117,"Illinois","Macoupin County",4,52,584,304,280
050,17,117,"Illinois","Macoupin County",4,53,572,288,284
050,17,117,"Illinois","Macoupin County",4,54,545,267,278
050,17,117,"Illinois","Macoupin County",4,55,538,258,280
050,17,117,"Illinois","Macoupin County",4,56,591,283,308
050,17,117,"Illinois","Macoupin County",4,57,646,307,339
050,17,117,"Illinois","Macoupin County",4,58,662,316,346
050,17,117,"Illinois","Macoupin County",4,59,691,346,345
050,17,117,"Illinois","Macoupin County",4,60,697,349,348
050,17,117,"Illinois","Macoupin County",4,61,724,366,358
050,17,117,"Illinois","Macoupin County",4,62,664,324,340
050,17,117,"Illinois","Macoupin County",4,63,661,323,338
050,17,117,"Illinois","Macoupin County",4,64,700,356,344
050,17,117,"Illinois","Macoupin County",4,65,677,341,336
050,17,117,"Illinois","Macoupin County",4,66,653,338,315
050,17,117,"Illinois","Macoupin County",4,67,646,318,328
050,17,117,"Illinois","Macoupin County",4,68,616,294,322
050,17,117,"Illinois","Macoupin County",4,69,620,293,327
050,17,117,"Illinois","Macoupin County",4,70,563,274,289
050,17,117,"Illinois","Macoupin County",4,71,537,264,273
050,17,117,"Illinois","Macoupin County",4,72,484,241,243
050,17,117,"Illinois","Macoupin County",4,73,453,213,240
050,17,117,"Illinois","Macoupin County",4,74,435,195,240
050,17,117,"Illinois","Macoupin County",4,75,477,215,262
050,17,117,"Illinois","Macoupin County",4,76,321,139,182
050,17,117,"Illinois","Macoupin County",4,77,309,129,180
050,17,117,"Illinois","Macoupin County",4,78,311,141,170
050,17,117,"Illinois","Macoupin County",4,79,300,140,160
050,17,117,"Illinois","Macoupin County",4,80,242,108,134
050,17,117,"Illinois","Macoupin County",4,81,228,104,124
050,17,117,"Illinois","Macoupin County",4,82,230,105,125
050,17,117,"Illinois","Macoupin County",4,83,176,68,108
050,17,117,"Illinois","Macoupin County",4,84,173,68,105
050,17,117,"Illinois","Macoupin County",4,85,1161,385,776
050,17,117,"Illinois","Macoupin County",5,0,367,194,173
050,17,117,"Illinois","Macoupin County",5,1,414,226,188
050,17,117,"Illinois","Macoupin County",5,2,438,219,219
050,17,117,"Illinois","Macoupin County",5,3,464,242,222
050,17,117,"Illinois","Macoupin County",5,4,486,252,234
050,17,117,"Illinois","Macoupin County",5,5,485,258,227
050,17,117,"Illinois","Macoupin County",5,6,479,266,213
050,17,117,"Illinois","Macoupin County",5,7,487,261,226
050,17,117,"Illinois","Macoupin County",5,8,484,263,221
050,17,117,"Illinois","Macoupin County",5,9,487,242,245
050,17,117,"Illinois","Macoupin County",5,10,492,250,242
050,17,117,"Illinois","Macoupin County",5,11,509,255,254
050,17,117,"Illinois","Macoupin County",5,12,500,253,247
050,17,117,"Illinois","Macoupin County",5,13,529,278,251
050,17,117,"Illinois","Macoupin County",5,14,539,287,252
050,17,117,"Illinois","Macoupin County",5,15,616,312,304
050,17,117,"Illinois","Macoupin County",5,16,593,318,275
050,17,117,"Illinois","Macoupin County",5,17,558,304,254
050,17,117,"Illinois","Macoupin County",5,18,516,276,240
050,17,117,"Illinois","Macoupin County",5,19,425,231,194
050,17,117,"Illinois","Macoupin County",5,20,462,245,217
050,17,117,"Illinois","Macoupin County",5,21,491,243,248
050,17,117,"Illinois","Macoupin County",5,22,494,238,256
050,17,117,"Illinois","Macoupin County",5,23,493,257,236
050,17,117,"Illinois","Macoupin County",5,24,460,249,211
050,17,117,"Illinois","Macoupin County",5,25,451,242,209
050,17,117,"Illinois","Macoupin County",5,26,461,255,206
050,17,117,"Illinois","Macoupin County",5,27,452,234,218
050,17,117,"Illinois","Macoupin County",5,28,453,228,225
050,17,117,"Illinois","Macoupin County",5,29,470,244,226
050,17,117,"Illinois","Macoupin County",5,30,477,253,224
050,17,117,"Illinois","Macoupin County",5,31,473,236,237
050,17,117,"Illinois","Macoupin County",5,32,488,238,250
050,17,117,"Illinois","Macoupin County",5,33,527,258,269
050,17,117,"Illinois","Macoupin County",5,34,491,215,276
050,17,117,"Illinois","Macoupin County",5,35,470,234,236
050,17,117,"Illinois","Macoupin County",5,36,487,248,239
050,17,117,"Illinois","Macoupin County",5,37,507,253,254
050,17,117,"Illinois","Macoupin County",5,38,539,263,276
050,17,117,"Illinois","Macoupin County",5,39,560,273,287
050,17,117,"Illinois","Macoupin County",5,40,569,292,277
050,17,117,"Illinois","Macoupin County",5,41,543,258,285
050,17,117,"Illinois","Macoupin County",5,42,536,275,261
050,17,117,"Illinois","Macoupin County",5,43,576,270,306
050,17,117,"Illinois","Macoupin County",5,44,565,285,280
050,17,117,"Illinois","Macoupin County",5,45,548,281,267
050,17,117,"Illinois","Macoupin County",5,46,520,263,257
050,17,117,"Illinois","Macoupin County",5,47,511,254,257
050,17,117,"Illinois","Macoupin County",5,48,554,281,273
050,17,117,"Illinois","Macoupin County",5,49,555,276,279
050,17,117,"Illinois","Macoupin County",5,50,507,254,253
050,17,117,"Illinois","Macoupin County",5,51,544,282,262
050,17,117,"Illinois","Macoupin County",5,52,573,313,260
050,17,117,"Illinois","Macoupin County",5,53,588,308,280
050,17,117,"Illinois","Macoupin County",5,54,563,282,281
050,17,117,"Illinois","Macoupin County",5,55,524,256,268
050,17,117,"Illinois","Macoupin County",5,56,544,262,282
050,17,117,"Illinois","Macoupin County",5,57,583,284,299
050,17,117,"Illinois","Macoupin County",5,58,659,308,351
050,17,117,"Illinois","Macoupin County",5,59,668,319,349
050,17,117,"Illinois","Macoupin County",5,60,685,338,347
050,17,117,"Illinois","Macoupin County",5,61,692,346,346
050,17,117,"Illinois","Macoupin County",5,62,715,358,357
050,17,117,"Illinois","Macoupin County",5,63,658,317,341
050,17,117,"Illinois","Macoupin County",5,64,647,319,328
050,17,117,"Illinois","Macoupin County",5,65,694,349,345
050,17,117,"Illinois","Macoupin County",5,66,665,337,328
050,17,117,"Illinois","Macoupin County",5,67,635,331,304
050,17,117,"Illinois","Macoupin County",5,68,642,315,327
050,17,117,"Illinois","Macoupin County",5,69,601,278,323
050,17,117,"Illinois","Macoupin County",5,70,597,279,318
050,17,117,"Illinois","Macoupin County",5,71,547,257,290
050,17,117,"Illinois","Macoupin County",5,72,520,261,259
050,17,117,"Illinois","Macoupin County",5,73,456,225,231
050,17,117,"Illinois","Macoupin County",5,74,442,209,233
050,17,117,"Illinois","Macoupin County",5,75,407,182,225
050,17,117,"Illinois","Macoupin County",5,76,462,199,263
050,17,117,"Illinois","Macoupin County",5,77,310,131,179
050,17,117,"Illinois","Macoupin County",5,78,288,116,172
050,17,117,"Illinois","Macoupin County",5,79,286,134,152
050,17,117,"Illinois","Macoupin County",5,80,281,127,154
050,17,117,"Illinois","Macoupin County",5,81,230,103,127
050,17,117,"Illinois","Macoupin County",5,82,224,103,121
050,17,117,"Illinois","Macoupin County",5,83,199,90,109
050,17,117,"Illinois","Macoupin County",5,84,161,56,105
050,17,117,"Illinois","Macoupin County",5,85,1170,382,788
050,17,119,"Illinois","Madison County",1,0,2723,1400,1323
050,17,119,"Illinois","Madison County",1,1,2828,1454,1374
050,17,119,"Illinois","Madison County",1,2,2986,1502,1484
050,17,119,"Illinois","Madison County",1,3,3025,1567,1458
050,17,119,"Illinois","Madison County",1,4,3091,1590,1501
050,17,119,"Illinois","Madison County",1,5,3149,1630,1519
050,17,119,"Illinois","Madison County",1,6,3156,1628,1528
050,17,119,"Illinois","Madison County",1,7,3175,1614,1561
050,17,119,"Illinois","Madison County",1,8,3272,1655,1617
050,17,119,"Illinois","Madison County",1,9,3296,1732,1564
050,17,119,"Illinois","Madison County",1,10,3305,1717,1588
050,17,119,"Illinois","Madison County",1,11,3336,1677,1659
050,17,119,"Illinois","Madison County",1,12,3433,1712,1721
050,17,119,"Illinois","Madison County",1,13,3507,1787,1720
050,17,119,"Illinois","Madison County",1,14,3345,1721,1624
050,17,119,"Illinois","Madison County",1,15,3416,1782,1634
050,17,119,"Illinois","Madison County",1,16,3469,1789,1680
050,17,119,"Illinois","Madison County",1,17,3402,1784,1618
050,17,119,"Illinois","Madison County",1,18,3630,1852,1778
050,17,119,"Illinois","Madison County",1,19,3956,1908,2048
050,17,119,"Illinois","Madison County",1,20,3083,1490,1593
050,17,119,"Illinois","Madison County",1,21,3065,1544,1521
050,17,119,"Illinois","Madison County",1,22,3119,1538,1581
050,17,119,"Illinois","Madison County",1,23,3180,1567,1613
050,17,119,"Illinois","Madison County",1,24,3193,1596,1597
050,17,119,"Illinois","Madison County",1,25,3246,1602,1644
050,17,119,"Illinois","Madison County",1,26,3263,1635,1628
050,17,119,"Illinois","Madison County",1,27,3243,1619,1624
050,17,119,"Illinois","Madison County",1,28,3359,1662,1697
050,17,119,"Illinois","Madison County",1,29,3568,1801,1767
050,17,119,"Illinois","Madison County",1,30,3592,1792,1800
050,17,119,"Illinois","Madison County",1,31,3524,1774,1750
050,17,119,"Illinois","Madison County",1,32,3535,1702,1833
050,17,119,"Illinois","Madison County",1,33,3527,1760,1767
050,17,119,"Illinois","Madison County",1,34,3482,1745,1737
050,17,119,"Illinois","Madison County",1,35,3418,1701,1717
050,17,119,"Illinois","Madison County",1,36,3464,1753,1711
050,17,119,"Illinois","Madison County",1,37,3515,1756,1759
050,17,119,"Illinois","Madison County",1,38,3481,1754,1727
050,17,119,"Illinois","Madison County",1,39,3445,1686,1759
050,17,119,"Illinois","Madison County",1,40,3300,1596,1704
050,17,119,"Illinois","Madison County",1,41,3259,1564,1695
050,17,119,"Illinois","Madison County",1,42,3189,1567,1622
050,17,119,"Illinois","Madison County",1,43,3097,1500,1597
050,17,119,"Illinois","Madison County",1,44,2923,1457,1466
050,17,119,"Illinois","Madison County",1,45,3085,1508,1577
050,17,119,"Illinois","Madison County",1,46,3067,1475,1592
050,17,119,"Illinois","Madison County",1,47,3132,1544,1588
050,17,119,"Illinois","Madison County",1,48,3432,1694,1738
050,17,119,"Illinois","Madison County",1,49,3528,1761,1767
050,17,119,"Illinois","Madison County",1,50,3423,1713,1710
050,17,119,"Illinois","Madison County",1,51,3270,1616,1654
050,17,119,"Illinois","Madison County",1,52,3170,1612,1558
050,17,119,"Illinois","Madison County",1,53,3307,1658,1649
050,17,119,"Illinois","Madison County",1,54,3527,1747,1780
050,17,119,"Illinois","Madison County",1,55,3756,1892,1864
050,17,119,"Illinois","Madison County",1,56,3667,1797,1870
050,17,119,"Illinois","Madison County",1,57,3778,1865,1913
050,17,119,"Illinois","Madison County",1,58,3971,1966,2005
050,17,119,"Illinois","Madison County",1,59,3907,1934,1973
050,17,119,"Illinois","Madison County",1,60,3862,1956,1906
050,17,119,"Illinois","Madison County",1,61,3873,1915,1958
050,17,119,"Illinois","Madison County",1,62,3926,1921,2005
050,17,119,"Illinois","Madison County",1,63,3713,1854,1859
050,17,119,"Illinois","Madison County",1,64,3515,1715,1800
050,17,119,"Illinois","Madison County",1,65,3436,1670,1766
050,17,119,"Illinois","Madison County",1,66,3251,1576,1675
050,17,119,"Illinois","Madison County",1,67,3079,1468,1611
050,17,119,"Illinois","Madison County",1,68,2955,1419,1536
050,17,119,"Illinois","Madison County",1,69,2661,1213,1448
050,17,119,"Illinois","Madison County",1,70,2580,1173,1407
050,17,119,"Illinois","Madison County",1,71,2469,1125,1344
050,17,119,"Illinois","Madison County",1,72,2510,1134,1376
050,17,119,"Illinois","Madison County",1,73,2566,1191,1375
050,17,119,"Illinois","Madison County",1,74,1747,801,946
050,17,119,"Illinois","Madison County",1,75,1738,796,942
050,17,119,"Illinois","Madison County",1,76,1766,765,1001
050,17,119,"Illinois","Madison County",1,77,1755,770,985
050,17,119,"Illinois","Madison County",1,78,1548,677,871
050,17,119,"Illinois","Madison County",1,79,1377,582,795
050,17,119,"Illinois","Madison County",1,80,1242,509,733
050,17,119,"Illinois","Madison County",1,81,1188,480,708
050,17,119,"Illinois","Madison County",1,82,1129,480,649
050,17,119,"Illinois","Madison County",1,83,966,398,568
050,17,119,"Illinois","Madison County",1,84,911,380,531
050,17,119,"Illinois","Madison County",1,85,5515,1788,3727
050,17,119,"Illinois","Madison County",2,0,2714,1401,1313
050,17,119,"Illinois","Madison County",2,1,2798,1438,1360
050,17,119,"Illinois","Madison County",2,2,2949,1490,1459
050,17,119,"Illinois","Madison County",2,3,3005,1545,1460
050,17,119,"Illinois","Madison County",2,4,3083,1591,1492
050,17,119,"Illinois","Madison County",2,5,3138,1623,1515
050,17,119,"Illinois","Madison County",2,6,3165,1632,1533
050,17,119,"Illinois","Madison County",2,7,3174,1618,1556
050,17,119,"Illinois","Madison County",2,8,3237,1642,1595
050,17,119,"Illinois","Madison County",2,9,3291,1717,1574
050,17,119,"Illinois","Madison County",2,10,3307,1721,1586
050,17,119,"Illinois","Madison County",2,11,3311,1678,1633
050,17,119,"Illinois","Madison County",2,12,3419,1708,1711
050,17,119,"Illinois","Madison County",2,13,3485,1770,1715
050,17,119,"Illinois","Madison County",2,14,3384,1740,1644
050,17,119,"Illinois","Madison County",2,15,3400,1766,1634
050,17,119,"Illinois","Madison County",2,16,3458,1790,1668
050,17,119,"Illinois","Madison County",2,17,3425,1786,1639
050,17,119,"Illinois","Madison County",2,18,3621,1851,1770
050,17,119,"Illinois","Madison County",2,19,3972,1915,2057
050,17,119,"Illinois","Madison County",2,20,3122,1513,1609
050,17,119,"Illinois","Madison County",2,21,3063,1544,1519
050,17,119,"Illinois","Madison County",2,22,3126,1542,1584
050,17,119,"Illinois","Madison County",2,23,3172,1574,1598
050,17,119,"Illinois","Madison County",2,24,3173,1582,1591
050,17,119,"Illinois","Madison County",2,25,3238,1604,1634
050,17,119,"Illinois","Madison County",2,26,3257,1624,1633
050,17,119,"Illinois","Madison County",2,27,3249,1619,1630
050,17,119,"Illinois","Madison County",2,28,3331,1657,1674
050,17,119,"Illinois","Madison County",2,29,3504,1760,1744
050,17,119,"Illinois","Madison County",2,30,3604,1804,1800
050,17,119,"Illinois","Madison County",2,31,3526,1773,1753
050,17,119,"Illinois","Madison County",2,32,3517,1711,1806
050,17,119,"Illinois","Madison County",2,33,3517,1742,1775
050,17,119,"Illinois","Madison County",2,34,3483,1739,1744
050,17,119,"Illinois","Madison County",2,35,3452,1729,1723
050,17,119,"Illinois","Madison County",2,36,3428,1724,1704
050,17,119,"Illinois","Madison County",2,37,3514,1760,1754
050,17,119,"Illinois","Madison County",2,38,3508,1757,1751
050,17,119,"Illinois","Madison County",2,39,3451,1701,1750
050,17,119,"Illinois","Madison County",2,40,3353,1625,1728
050,17,119,"Illinois","Madison County",2,41,3267,1571,1696
050,17,119,"Illinois","Madison County",2,42,3187,1560,1627
050,17,119,"Illinois","Madison County",2,43,3147,1533,1614
050,17,119,"Illinois","Madison County",2,44,2940,1452,1488
050,17,119,"Illinois","Madison County",2,45,3066,1506,1560
050,17,119,"Illinois","Madison County",2,46,3055,1476,1579
050,17,119,"Illinois","Madison County",2,47,3101,1516,1585
050,17,119,"Illinois","Madison County",2,48,3345,1650,1695
050,17,119,"Illinois","Madison County",2,49,3515,1749,1766
050,17,119,"Illinois","Madison County",2,50,3449,1726,1723
050,17,119,"Illinois","Madison County",2,51,3292,1631,1661
050,17,119,"Illinois","Madison County",2,52,3173,1600,1573
050,17,119,"Illinois","Madison County",2,53,3274,1647,1627
050,17,119,"Illinois","Madison County",2,54,3453,1718,1735
050,17,119,"Illinois","Madison County",2,55,3695,1852,1843
050,17,119,"Illinois","Madison County",2,56,3690,1819,1871
050,17,119,"Illinois","Madison County",2,57,3756,1853,1903
050,17,119,"Illinois","Madison County",2,58,3912,1933,1979
050,17,119,"Illinois","Madison County",2,59,3931,1944,1987
050,17,119,"Illinois","Madison County",2,60,3847,1943,1904
050,17,119,"Illinois","Madison County",2,61,3848,1913,1935
050,17,119,"Illinois","Madison County",2,62,3892,1906,1986
050,17,119,"Illinois","Madison County",2,63,3783,1877,1906
050,17,119,"Illinois","Madison County",2,64,3527,1727,1800
050,17,119,"Illinois","Madison County",2,65,3439,1673,1766
050,17,119,"Illinois","Madison County",2,66,3285,1589,1696
050,17,119,"Illinois","Madison County",2,67,3100,1487,1613
050,17,119,"Illinois","Madison County",2,68,2941,1408,1533
050,17,119,"Illinois","Madison County",2,69,2742,1273,1469
050,17,119,"Illinois","Madison County",2,70,2567,1163,1404
050,17,119,"Illinois","Madison County",2,71,2476,1121,1355
050,17,119,"Illinois","Madison County",2,72,2440,1105,1335
050,17,119,"Illinois","Madison County",2,73,2643,1216,1427
050,17,119,"Illinois","Madison County",2,74,1813,832,981
050,17,119,"Illinois","Madison County",2,75,1731,790,941
050,17,119,"Illinois","Madison County",2,76,1731,761,970
050,17,119,"Illinois","Madison County",2,77,1769,775,994
050,17,119,"Illinois","Madison County",2,78,1551,677,874
050,17,119,"Illinois","Madison County",2,79,1400,593,807
050,17,119,"Illinois","Madison County",2,80,1263,518,745
050,17,119,"Illinois","Madison County",2,81,1174,470,704
050,17,119,"Illinois","Madison County",2,82,1135,476,659
050,17,119,"Illinois","Madison County",2,83,973,397,576
050,17,119,"Illinois","Madison County",2,84,906,373,533
050,17,119,"Illinois","Madison County",2,85,5495,1795,3700
050,17,119,"Illinois","Madison County",3,0,2675,1387,1288
050,17,119,"Illinois","Madison County",3,1,2706,1401,1305
050,17,119,"Illinois","Madison County",3,2,2819,1440,1379
050,17,119,"Illinois","Madison County",3,3,2966,1505,1461
050,17,119,"Illinois","Madison County",3,4,2995,1553,1442
050,17,119,"Illinois","Madison County",3,5,3114,1609,1505
050,17,119,"Illinois","Madison County",3,6,3166,1645,1521
050,17,119,"Illinois","Madison County",3,7,3147,1627,1520
050,17,119,"Illinois","Madison County",3,8,3174,1622,1552
050,17,119,"Illinois","Madison County",3,9,3234,1620,1614
050,17,119,"Illinois","Madison County",3,10,3315,1713,1602
050,17,119,"Illinois","Madison County",3,11,3298,1709,1589
050,17,119,"Illinois","Madison County",3,12,3329,1694,1635
050,17,119,"Illinois","Madison County",3,13,3447,1739,1708
050,17,119,"Illinois","Madison County",3,14,3507,1795,1712
050,17,119,"Illinois","Madison County",3,15,3383,1717,1666
050,17,119,"Illinois","Madison County",3,16,3412,1773,1639
050,17,119,"Illinois","Madison County",3,17,3448,1795,1653
050,17,119,"Illinois","Madison County",3,18,3707,1892,1815
050,17,119,"Illinois","Madison County",3,19,3956,1912,2044
050,17,119,"Illinois","Madison County",3,20,3114,1520,1594
050,17,119,"Illinois","Madison County",3,21,3097,1555,1542
050,17,119,"Illinois","Madison County",3,22,3147,1558,1589
050,17,119,"Illinois","Madison County",3,23,3191,1608,1583
050,17,119,"Illinois","Madison County",3,24,3184,1557,1627
050,17,119,"Illinois","Madison County",3,25,3181,1615,1566
050,17,119,"Illinois","Madison County",3,26,3274,1634,1640
050,17,119,"Illinois","Madison County",3,27,3219,1588,1631
050,17,119,"Illinois","Madison County",3,28,3256,1630,1626
050,17,119,"Illinois","Madison County",3,29,3299,1659,1640
050,17,119,"Illinois","Madison County",3,30,3514,1767,1747
050,17,119,"Illinois","Madison County",3,31,3629,1817,1812
050,17,119,"Illinois","Madison County",3,32,3537,1765,1772
050,17,119,"Illinois","Madison County",3,33,3541,1701,1840
050,17,119,"Illinois","Madison County",3,34,3529,1746,1783
050,17,119,"Illinois","Madison County",3,35,3489,1754,1735
050,17,119,"Illinois","Madison County",3,36,3460,1727,1733
050,17,119,"Illinois","Madison County",3,37,3393,1681,1712
050,17,119,"Illinois","Madison County",3,38,3487,1744,1743
050,17,119,"Illinois","Madison County",3,39,3489,1737,1752
050,17,119,"Illinois","Madison County",3,40,3440,1701,1739
050,17,119,"Illinois","Madison County",3,41,3365,1642,1723
050,17,119,"Illinois","Madison County",3,42,3258,1562,1696
050,17,119,"Illinois","Madison County",3,43,3197,1571,1626
050,17,119,"Illinois","Madison County",3,44,3124,1509,1615
050,17,119,"Illinois","Madison County",3,45,2928,1448,1480
050,17,119,"Illinois","Madison County",3,46,3054,1493,1561
050,17,119,"Illinois","Madison County",3,47,3043,1483,1560
050,17,119,"Illinois","Madison County",3,48,3064,1494,1570
050,17,119,"Illinois","Madison County",3,49,3351,1643,1708
050,17,119,"Illinois","Madison County",3,50,3535,1759,1776
050,17,119,"Illinois","Madison County",3,51,3420,1712,1708
050,17,119,"Illinois","Madison County",3,52,3252,1602,1650
050,17,119,"Illinois","Madison County",3,53,3155,1589,1566
050,17,119,"Illinois","Madison County",3,54,3241,1638,1603
050,17,119,"Illinois","Madison County",3,55,3399,1688,1711
050,17,119,"Illinois","Madison County",3,56,3622,1811,1811
050,17,119,"Illinois","Madison County",3,57,3652,1819,1833
050,17,119,"Illinois","Madison County",3,58,3720,1816,1904
050,17,119,"Illinois","Madison County",3,59,3842,1904,1938
050,17,119,"Illinois","Madison County",3,60,3857,1908,1949
050,17,119,"Illinois","Madison County",3,61,3785,1913,1872
050,17,119,"Illinois","Madison County",3,62,3766,1858,1908
050,17,119,"Illinois","Madison County",3,63,3842,1871,1971
050,17,119,"Illinois","Madison County",3,64,3700,1831,1869
050,17,119,"Illinois","Madison County",3,65,3446,1679,1767
050,17,119,"Illinois","Madison County",3,66,3359,1627,1732
050,17,119,"Illinois","Madison County",3,67,3232,1547,1685
050,17,119,"Illinois","Madison County",3,68,3000,1419,1581
050,17,119,"Illinois","Madison County",3,69,2868,1373,1495
050,17,119,"Illinois","Madison County",3,70,2676,1227,1449
050,17,119,"Illinois","Madison County",3,71,2465,1115,1350
050,17,119,"Illinois","Madison County",3,72,2416,1085,1331
050,17,119,"Illinois","Madison County",3,73,2350,1041,1309
050,17,119,"Illinois","Madison County",3,74,2548,1160,1388
050,17,119,"Illinois","Madison County",3,75,1760,807,953
050,17,119,"Illinois","Madison County",3,76,1651,740,911
050,17,119,"Illinois","Madison County",3,77,1631,708,923
050,17,119,"Illinois","Madison County",3,78,1679,717,962
050,17,119,"Illinois","Madison County",3,79,1464,625,839
050,17,119,"Illinois","Madison County",3,80,1326,557,769
050,17,119,"Illinois","Madison County",3,81,1170,461,709
050,17,119,"Illinois","Madison County",3,82,1100,435,665
050,17,119,"Illinois","Madison County",3,83,1017,411,606
050,17,119,"Illinois","Madison County",3,84,902,365,537
050,17,119,"Illinois","Madison County",3,85,5367,1766,3601
050,17,119,"Illinois","Madison County",4,0,2467,1299,1168
050,17,119,"Illinois","Madison County",4,1,2741,1424,1317
050,17,119,"Illinois","Madison County",4,2,2727,1427,1300
050,17,119,"Illinois","Madison County",4,3,2792,1420,1372
050,17,119,"Illinois","Madison County",4,4,2983,1496,1487
050,17,119,"Illinois","Madison County",4,5,3008,1554,1454
050,17,119,"Illinois","Madison County",4,6,3126,1592,1534
050,17,119,"Illinois","Madison County",4,7,3166,1640,1526
050,17,119,"Illinois","Madison County",4,8,3186,1638,1548
050,17,119,"Illinois","Madison County",4,9,3171,1623,1548
050,17,119,"Illinois","Madison County",4,10,3217,1622,1595
050,17,119,"Illinois","Madison County",4,11,3327,1717,1610
050,17,119,"Illinois","Madison County",4,12,3301,1707,1594
050,17,119,"Illinois","Madison County",4,13,3330,1709,1621
050,17,119,"Illinois","Madison County",4,14,3495,1761,1734
050,17,119,"Illinois","Madison County",4,15,3473,1770,1703
050,17,119,"Illinois","Madison County",4,16,3374,1712,1662
050,17,119,"Illinois","Madison County",4,17,3405,1765,1640
050,17,119,"Illinois","Madison County",4,18,3686,1890,1796
050,17,119,"Illinois","Madison County",4,19,3957,1934,2023
050,17,119,"Illinois","Madison County",4,20,3064,1523,1541
050,17,119,"Illinois","Madison County",4,21,3036,1529,1507
050,17,119,"Illinois","Madison County",4,22,3128,1526,1602
050,17,119,"Illinois","Madison County",4,23,3207,1616,1591
050,17,119,"Illinois","Madison County",4,24,3214,1654,1560
050,17,119,"Illinois","Madison County",4,25,3151,1554,1597
050,17,119,"Illinois","Madison County",4,26,3085,1556,1529
050,17,119,"Illinois","Madison County",4,27,3236,1646,1590
050,17,119,"Illinois","Madison County",4,28,3204,1590,1614
050,17,119,"Illinois","Madison County",4,29,3235,1601,1634
050,17,119,"Illinois","Madison County",4,30,3300,1659,1641
050,17,119,"Illinois","Madison County",4,31,3549,1781,1768
050,17,119,"Illinois","Madison County",4,32,3636,1815,1821
050,17,119,"Illinois","Madison County",4,33,3494,1736,1758
050,17,119,"Illinois","Madison County",4,34,3558,1705,1853
050,17,119,"Illinois","Madison County",4,35,3583,1774,1809
050,17,119,"Illinois","Madison County",4,36,3504,1736,1768
050,17,119,"Illinois","Madison County",4,37,3464,1720,1744
050,17,119,"Illinois","Madison County",4,38,3416,1694,1722
050,17,119,"Illinois","Madison County",4,39,3470,1715,1755
050,17,119,"Illinois","Madison County",4,40,3453,1726,1727
050,17,119,"Illinois","Madison County",4,41,3438,1710,1728
050,17,119,"Illinois","Madison County",4,42,3370,1654,1716
050,17,119,"Illinois","Madison County",4,43,3272,1564,1708
050,17,119,"Illinois","Madison County",4,44,3191,1562,1629
050,17,119,"Illinois","Madison County",4,45,3138,1517,1621
050,17,119,"Illinois","Madison County",4,46,2907,1424,1483
050,17,119,"Illinois","Madison County",4,47,3019,1471,1548
050,17,119,"Illinois","Madison County",4,48,3015,1476,1539
050,17,119,"Illinois","Madison County",4,49,3025,1458,1567
050,17,119,"Illinois","Madison County",4,50,3313,1636,1677
050,17,119,"Illinois","Madison County",4,51,3493,1754,1739
050,17,119,"Illinois","Madison County",4,52,3365,1683,1682
050,17,119,"Illinois","Madison County",4,53,3214,1596,1618
050,17,119,"Illinois","Madison County",4,54,3093,1550,1543
050,17,119,"Illinois","Madison County",4,55,3240,1632,1608
050,17,119,"Illinois","Madison County",4,56,3332,1641,1691
050,17,119,"Illinois","Madison County",4,57,3577,1775,1802
050,17,119,"Illinois","Madison County",4,58,3629,1800,1829
050,17,119,"Illinois","Madison County",4,59,3657,1789,1868
050,17,119,"Illinois","Madison County",4,60,3768,1847,1921
050,17,119,"Illinois","Madison County",4,61,3802,1880,1922
050,17,119,"Illinois","Madison County",4,62,3705,1868,1837
050,17,119,"Illinois","Madison County",4,63,3716,1818,1898
050,17,119,"Illinois","Madison County",4,64,3756,1818,1938
050,17,119,"Illinois","Madison County",4,65,3624,1788,1836
050,17,119,"Illinois","Madison County",4,66,3362,1637,1725
050,17,119,"Illinois","Madison County",4,67,3307,1593,1714
050,17,119,"Illinois","Madison County",4,68,3130,1488,1642
050,17,119,"Illinois","Madison County",4,69,2946,1394,1552
050,17,119,"Illinois","Madison County",4,70,2813,1326,1487
050,17,119,"Illinois","Madison County",4,71,2589,1181,1408
050,17,119,"Illinois","Madison County",4,72,2400,1074,1326
050,17,119,"Illinois","Madison County",4,73,2333,1024,1309
050,17,119,"Illinois","Madison County",4,74,2252,996,1256
050,17,119,"Illinois","Madison County",4,75,2470,1118,1352
050,17,119,"Illinois","Madison County",4,76,1685,766,919
050,17,119,"Illinois","Madison County",4,77,1571,711,860
050,17,119,"Illinois","Madison County",4,78,1551,655,896
050,17,119,"Illinois","Madison County",4,79,1596,671,925
050,17,119,"Illinois","Madison County",4,80,1392,589,803
050,17,119,"Illinois","Madison County",4,81,1239,506,733
050,17,119,"Illinois","Madison County",4,82,1106,438,668
050,17,119,"Illinois","Madison County",4,83,984,375,609
050,17,119,"Illinois","Madison County",4,84,957,390,567
050,17,119,"Illinois","Madison County",4,85,5311,1755,3556
050,17,119,"Illinois","Madison County",5,0,2161,1129,1032
050,17,119,"Illinois","Madison County",5,1,2514,1321,1193
050,17,119,"Illinois","Madison County",5,2,2762,1436,1326
050,17,119,"Illinois","Madison County",5,3,2761,1423,1338
050,17,119,"Illinois","Madison County",5,4,2768,1411,1357
050,17,119,"Illinois","Madison County",5,5,3013,1527,1486
050,17,119,"Illinois","Madison County",5,6,3023,1548,1475
050,17,119,"Illinois","Madison County",5,7,3152,1613,1539
050,17,119,"Illinois","Madison County",5,8,3191,1639,1552
050,17,119,"Illinois","Madison County",5,9,3166,1629,1537
050,17,119,"Illinois","Madison County",5,10,3148,1620,1528
050,17,119,"Illinois","Madison County",5,11,3219,1632,1587
050,17,119,"Illinois","Madison County",5,12,3335,1722,1613
050,17,119,"Illinois","Madison County",5,13,3328,1711,1617
050,17,119,"Illinois","Madison County",5,14,3330,1703,1627
050,17,119,"Illinois","Madison County",5,15,3491,1756,1735
050,17,119,"Illinois","Madison County",5,16,3462,1754,1708
050,17,119,"Illinois","Madison County",5,17,3378,1714,1664
050,17,119,"Illinois","Madison County",5,18,3618,1841,1777
050,17,119,"Illinois","Madison County",5,19,3945,1916,2029
050,17,119,"Illinois","Madison County",5,20,3104,1545,1559
050,17,119,"Illinois","Madison County",5,21,3023,1557,1466
050,17,119,"Illinois","Madison County",5,22,3130,1543,1587
050,17,119,"Illinois","Madison County",5,23,3183,1582,1601
050,17,119,"Illinois","Madison County",5,24,3181,1616,1565
050,17,119,"Illinois","Madison County",5,25,3195,1646,1549
050,17,119,"Illinois","Madison County",5,26,3124,1542,1582
050,17,119,"Illinois","Madison County",5,27,3154,1584,1570
050,17,119,"Illinois","Madison County",5,28,3229,1613,1616
050,17,119,"Illinois","Madison County",5,29,3155,1543,1612
050,17,119,"Illinois","Madison County",5,30,3266,1595,1671
050,17,119,"Illinois","Madison County",5,31,3300,1657,1643
050,17,119,"Illinois","Madison County",5,32,3534,1755,1779
050,17,119,"Illinois","Madison County",5,33,3658,1843,1815
050,17,119,"Illinois","Madison County",5,34,3524,1754,1770
050,17,119,"Illinois","Madison County",5,35,3555,1724,1831
050,17,119,"Illinois","Madison County",5,36,3570,1760,1810
050,17,119,"Illinois","Madison County",5,37,3483,1719,1764
050,17,119,"Illinois","Madison County",5,38,3462,1699,1763
050,17,119,"Illinois","Madison County",5,39,3410,1688,1722
050,17,119,"Illinois","Madison County",5,40,3481,1718,1763
050,17,119,"Illinois","Madison County",5,41,3455,1729,1726
050,17,119,"Illinois","Madison County",5,42,3444,1721,1723
050,17,119,"Illinois","Madison County",5,43,3404,1678,1726
050,17,119,"Illinois","Madison County",5,44,3277,1564,1713
050,17,119,"Illinois","Madison County",5,45,3181,1539,1642
050,17,119,"Illinois","Madison County",5,46,3114,1510,1604
050,17,119,"Illinois","Madison County",5,47,2911,1415,1496
050,17,119,"Illinois","Madison County",5,48,3008,1471,1537
050,17,119,"Illinois","Madison County",5,49,2995,1463,1532
050,17,119,"Illinois","Madison County",5,50,3010,1451,1559
050,17,119,"Illinois","Madison County",5,51,3332,1629,1703
050,17,119,"Illinois","Madison County",5,52,3468,1739,1729
050,17,119,"Illinois","Madison County",5,53,3365,1695,1670
050,17,119,"Illinois","Madison County",5,54,3192,1593,1599
050,17,119,"Illinois","Madison County",5,55,3079,1547,1532
050,17,119,"Illinois","Madison County",5,56,3201,1593,1608
050,17,119,"Illinois","Madison County",5,57,3305,1629,1676
050,17,119,"Illinois","Madison County",5,58,3541,1753,1788
050,17,119,"Illinois","Madison County",5,59,3585,1778,1807
050,17,119,"Illinois","Madison County",5,60,3596,1750,1846
050,17,119,"Illinois","Madison County",5,61,3731,1820,1911
050,17,119,"Illinois","Madison County",5,62,3723,1847,1876
050,17,119,"Illinois","Madison County",5,63,3646,1834,1812
050,17,119,"Illinois","Madison County",5,64,3621,1754,1867
050,17,119,"Illinois","Madison County",5,65,3680,1775,1905
050,17,119,"Illinois","Madison County",5,66,3524,1720,1804
050,17,119,"Illinois","Madison County",5,67,3327,1603,1724
050,17,119,"Illinois","Madison County",5,68,3236,1543,1693
050,17,119,"Illinois","Madison County",5,69,3078,1472,1606
050,17,119,"Illinois","Madison County",5,70,2894,1351,1543
050,17,119,"Illinois","Madison County",5,71,2735,1288,1447
050,17,119,"Illinois","Madison County",5,72,2536,1142,1394
050,17,119,"Illinois","Madison County",5,73,2323,1021,1302
050,17,119,"Illinois","Madison County",5,74,2259,979,1280
050,17,119,"Illinois","Madison County",5,75,2186,966,1220
050,17,119,"Illinois","Madison County",5,76,2378,1070,1308
050,17,119,"Illinois","Madison County",5,77,1594,725,869
050,17,119,"Illinois","Madison County",5,78,1495,668,827
050,17,119,"Illinois","Madison County",5,79,1484,624,860
050,17,119,"Illinois","Madison County",5,80,1521,634,887
050,17,119,"Illinois","Madison County",5,81,1304,542,762
050,17,119,"Illinois","Madison County",5,82,1169,478,691
050,17,119,"Illinois","Madison County",5,83,1008,391,617
050,17,119,"Illinois","Madison County",5,84,932,362,570
050,17,119,"Illinois","Madison County",5,85,5419,1815,3604
050,17,121,"Illinois","Marion County",1,0,455,233,222
050,17,121,"Illinois","Marion County",1,1,459,237,222
050,17,121,"Illinois","Marion County",1,2,478,267,211
050,17,121,"Illinois","Marion County",1,3,479,241,238
050,17,121,"Illinois","Marion County",1,4,491,247,244
050,17,121,"Illinois","Marion County",1,5,501,258,243
050,17,121,"Illinois","Marion County",1,6,474,244,230
050,17,121,"Illinois","Marion County",1,7,492,255,237
050,17,121,"Illinois","Marion County",1,8,490,244,246
050,17,121,"Illinois","Marion County",1,9,498,254,244
050,17,121,"Illinois","Marion County",1,10,499,245,254
050,17,121,"Illinois","Marion County",1,11,524,271,253
050,17,121,"Illinois","Marion County",1,12,544,270,274
050,17,121,"Illinois","Marion County",1,13,534,277,257
050,17,121,"Illinois","Marion County",1,14,526,288,238
050,17,121,"Illinois","Marion County",1,15,498,272,226
050,17,121,"Illinois","Marion County",1,16,452,237,215
050,17,121,"Illinois","Marion County",1,17,471,242,229
050,17,121,"Illinois","Marion County",1,18,447,232,215
050,17,121,"Illinois","Marion County",1,19,373,189,184
050,17,121,"Illinois","Marion County",1,20,373,192,181
050,17,121,"Illinois","Marion County",1,21,377,181,196
050,17,121,"Illinois","Marion County",1,22,377,184,193
050,17,121,"Illinois","Marion County",1,23,396,207,189
050,17,121,"Illinois","Marion County",1,24,427,226,201
050,17,121,"Illinois","Marion County",1,25,421,216,205
050,17,121,"Illinois","Marion County",1,26,451,218,233
050,17,121,"Illinois","Marion County",1,27,475,231,244
050,17,121,"Illinois","Marion County",1,28,472,239,233
050,17,121,"Illinois","Marion County",1,29,471,252,219
050,17,121,"Illinois","Marion County",1,30,469,230,239
050,17,121,"Illinois","Marion County",1,31,440,217,223
050,17,121,"Illinois","Marion County",1,32,429,219,210
050,17,121,"Illinois","Marion County",1,33,395,200,195
050,17,121,"Illinois","Marion County",1,34,418,204,214
050,17,121,"Illinois","Marion County",1,35,413,202,211
050,17,121,"Illinois","Marion County",1,36,423,218,205
050,17,121,"Illinois","Marion County",1,37,440,216,224
050,17,121,"Illinois","Marion County",1,38,435,223,212
050,17,121,"Illinois","Marion County",1,39,466,236,230
050,17,121,"Illinois","Marion County",1,40,470,235,235
050,17,121,"Illinois","Marion County",1,41,436,216,220
050,17,121,"Illinois","Marion County",1,42,421,218,203
050,17,121,"Illinois","Marion County",1,43,417,215,202
050,17,121,"Illinois","Marion County",1,44,434,219,215
050,17,121,"Illinois","Marion County",1,45,410,203,207
050,17,121,"Illinois","Marion County",1,46,417,214,203
050,17,121,"Illinois","Marion County",1,47,413,213,200
050,17,121,"Illinois","Marion County",1,48,463,244,219
050,17,121,"Illinois","Marion County",1,49,513,261,252
050,17,121,"Illinois","Marion County",1,50,455,215,240
050,17,121,"Illinois","Marion County",1,51,427,220,207
050,17,121,"Illinois","Marion County",1,52,445,218,227
050,17,121,"Illinois","Marion County",1,53,440,217,223
050,17,121,"Illinois","Marion County",1,54,471,246,225
050,17,121,"Illinois","Marion County",1,55,532,262,270
050,17,121,"Illinois","Marion County",1,56,534,275,259
050,17,121,"Illinois","Marion County",1,57,548,257,291
050,17,121,"Illinois","Marion County",1,58,559,266,293
050,17,121,"Illinois","Marion County",1,59,565,262,303
050,17,121,"Illinois","Marion County",1,60,541,260,281
050,17,121,"Illinois","Marion County",1,61,560,279,281
050,17,121,"Illinois","Marion County",1,62,556,263,293
050,17,121,"Illinois","Marion County",1,63,523,240,283
050,17,121,"Illinois","Marion County",1,64,547,271,276
050,17,121,"Illinois","Marion County",1,65,525,253,272
050,17,121,"Illinois","Marion County",1,66,479,233,246
050,17,121,"Illinois","Marion County",1,67,463,238,225
050,17,121,"Illinois","Marion County",1,68,476,236,240
050,17,121,"Illinois","Marion County",1,69,416,193,223
050,17,121,"Illinois","Marion County",1,70,406,196,210
050,17,121,"Illinois","Marion County",1,71,397,192,205
050,17,121,"Illinois","Marion County",1,72,383,177,206
050,17,121,"Illinois","Marion County",1,73,389,162,227
050,17,121,"Illinois","Marion County",1,74,299,135,164
050,17,121,"Illinois","Marion County",1,75,283,140,143
050,17,121,"Illinois","Marion County",1,76,276,124,152
050,17,121,"Illinois","Marion County",1,77,280,129,151
050,17,121,"Illinois","Marion County",1,78,237,99,138
050,17,121,"Illinois","Marion County",1,79,224,100,124
050,17,121,"Illinois","Marion County",1,80,212,95,117
050,17,121,"Illinois","Marion County",1,81,214,91,123
050,17,121,"Illinois","Marion County",1,82,175,74,101
050,17,121,"Illinois","Marion County",1,83,161,68,93
050,17,121,"Illinois","Marion County",1,84,155,67,88
050,17,121,"Illinois","Marion County",1,85,936,336,600
050,17,121,"Illinois","Marion County",2,0,450,229,221
050,17,121,"Illinois","Marion County",2,1,457,236,221
050,17,121,"Illinois","Marion County",2,2,472,259,213
050,17,121,"Illinois","Marion County",2,3,478,247,231
050,17,121,"Illinois","Marion County",2,4,489,246,243
050,17,121,"Illinois","Marion County",2,5,498,255,243
050,17,121,"Illinois","Marion County",2,6,483,250,233
050,17,121,"Illinois","Marion County",2,7,489,252,237
050,17,121,"Illinois","Marion County",2,8,490,244,246
050,17,121,"Illinois","Marion County",2,9,498,253,245
050,17,121,"Illinois","Marion County",2,10,498,247,251
050,17,121,"Illinois","Marion County",2,11,513,261,252
050,17,121,"Illinois","Marion County",2,12,539,270,269
050,17,121,"Illinois","Marion County",2,13,536,277,259
050,17,121,"Illinois","Marion County",2,14,528,287,241
050,17,121,"Illinois","Marion County",2,15,503,275,228
050,17,121,"Illinois","Marion County",2,16,464,248,216
050,17,121,"Illinois","Marion County",2,17,468,242,226
050,17,121,"Illinois","Marion County",2,18,438,230,208
050,17,121,"Illinois","Marion County",2,19,376,192,184
050,17,121,"Illinois","Marion County",2,20,379,193,186
050,17,121,"Illinois","Marion County",2,21,373,181,192
050,17,121,"Illinois","Marion County",2,22,377,183,194
050,17,121,"Illinois","Marion County",2,23,392,203,189
050,17,121,"Illinois","Marion County",2,24,418,221,197
050,17,121,"Illinois","Marion County",2,25,424,217,207
050,17,121,"Illinois","Marion County",2,26,442,216,226
050,17,121,"Illinois","Marion County",2,27,468,230,238
050,17,121,"Illinois","Marion County",2,28,470,235,235
050,17,121,"Illinois","Marion County",2,29,470,248,222
050,17,121,"Illinois","Marion County",2,30,472,236,236
050,17,121,"Illinois","Marion County",2,31,446,220,226
050,17,121,"Illinois","Marion County",2,32,431,218,213
050,17,121,"Illinois","Marion County",2,33,405,204,201
050,17,121,"Illinois","Marion County",2,34,412,203,209
050,17,121,"Illinois","Marion County",2,35,414,202,212
050,17,121,"Illinois","Marion County",2,36,419,212,207
050,17,121,"Illinois","Marion County",2,37,436,216,220
050,17,121,"Illinois","Marion County",2,38,436,220,216
050,17,121,"Illinois","Marion County",2,39,459,234,225
050,17,121,"Illinois","Marion County",2,40,470,236,234
050,17,121,"Illinois","Marion County",2,41,442,217,225
050,17,121,"Illinois","Marion County",2,42,418,215,203
050,17,121,"Illinois","Marion County",2,43,421,216,205
050,17,121,"Illinois","Marion County",2,44,425,216,209
050,17,121,"Illinois","Marion County",2,45,417,208,209
050,17,121,"Illinois","Marion County",2,46,415,213,202
050,17,121,"Illinois","Marion County",2,47,411,211,200
050,17,121,"Illinois","Marion County",2,48,450,237,213
050,17,121,"Illinois","Marion County",2,49,502,257,245
050,17,121,"Illinois","Marion County",2,50,466,226,240
050,17,121,"Illinois","Marion County",2,51,433,219,214
050,17,121,"Illinois","Marion County",2,52,440,217,223
050,17,121,"Illinois","Marion County",2,53,442,219,223
050,17,121,"Illinois","Marion County",2,54,461,238,223
050,17,121,"Illinois","Marion County",2,55,512,255,257
050,17,121,"Illinois","Marion County",2,56,532,270,262
050,17,121,"Illinois","Marion County",2,57,541,257,284
050,17,121,"Illinois","Marion County",2,58,554,263,291
050,17,121,"Illinois","Marion County",2,59,566,263,303
050,17,121,"Illinois","Marion County",2,60,540,256,284
050,17,121,"Illinois","Marion County",2,61,552,271,281
050,17,121,"Illinois","Marion County",2,62,555,266,289
050,17,121,"Illinois","Marion County",2,63,535,247,288
050,17,121,"Illinois","Marion County",2,64,532,259,273
050,17,121,"Illinois","Marion County",2,65,528,254,274
050,17,121,"Illinois","Marion County",2,66,486,237,249
050,17,121,"Illinois","Marion County",2,67,464,234,230
050,17,121,"Illinois","Marion County",2,68,468,236,232
050,17,121,"Illinois","Marion County",2,69,430,203,227
050,17,121,"Illinois","Marion County",2,70,405,191,214
050,17,121,"Illinois","Marion County",2,71,395,193,202
050,17,121,"Illinois","Marion County",2,72,371,171,200
050,17,121,"Illinois","Marion County",2,73,405,173,232
050,17,121,"Illinois","Marion County",2,74,301,132,169
050,17,121,"Illinois","Marion County",2,75,287,139,148
050,17,121,"Illinois","Marion County",2,76,276,127,149
050,17,121,"Illinois","Marion County",2,77,278,127,151
050,17,121,"Illinois","Marion County",2,78,242,103,139
050,17,121,"Illinois","Marion County",2,79,221,97,124
050,17,121,"Illinois","Marion County",2,80,209,95,114
050,17,121,"Illinois","Marion County",2,81,209,91,118
050,17,121,"Illinois","Marion County",2,82,184,79,105
050,17,121,"Illinois","Marion County",2,83,160,67,93
050,17,121,"Illinois","Marion County",2,84,156,68,88
050,17,121,"Illinois","Marion County",2,85,935,336,599
050,17,121,"Illinois","Marion County",3,0,496,264,232
050,17,121,"Illinois","Marion County",3,1,434,225,209
050,17,121,"Illinois","Marion County",3,2,454,231,223
050,17,121,"Illinois","Marion County",3,3,458,248,210
050,17,121,"Illinois","Marion County",3,4,491,246,245
050,17,121,"Illinois","Marion County",3,5,478,242,236
050,17,121,"Illinois","Marion County",3,6,503,253,250
050,17,121,"Illinois","Marion County",3,7,482,251,231
050,17,121,"Illinois","Marion County",3,8,483,246,237
050,17,121,"Illinois","Marion County",3,9,487,243,244
050,17,121,"Illinois","Marion County",3,10,495,246,249
050,17,121,"Illinois","Marion County",3,11,486,240,246
050,17,121,"Illinois","Marion County",3,12,528,271,257
050,17,121,"Illinois","Marion County",3,13,552,275,277
050,17,121,"Illinois","Marion County",3,14,538,275,263
050,17,121,"Illinois","Marion County",3,15,530,282,248
050,17,121,"Illinois","Marion County",3,16,503,275,228
050,17,121,"Illinois","Marion County",3,17,471,249,222
050,17,121,"Illinois","Marion County",3,18,422,228,194
050,17,121,"Illinois","Marion County",3,19,363,186,177
050,17,121,"Illinois","Marion County",3,20,397,196,201
050,17,121,"Illinois","Marion County",3,21,391,197,194
050,17,121,"Illinois","Marion County",3,22,387,185,202
050,17,121,"Illinois","Marion County",3,23,400,200,200
050,17,121,"Illinois","Marion County",3,24,379,193,186
050,17,121,"Illinois","Marion County",3,25,402,208,194
050,17,121,"Illinois","Marion County",3,26,426,217,209
050,17,121,"Illinois","Marion County",3,27,451,220,231
050,17,121,"Illinois","Marion County",3,28,457,230,227
050,17,121,"Illinois","Marion County",3,29,454,232,222
050,17,121,"Illinois","Marion County",3,30,465,249,216
050,17,121,"Illinois","Marion County",3,31,467,240,227
050,17,121,"Illinois","Marion County",3,32,449,215,234
050,17,121,"Illinois","Marion County",3,33,437,224,213
050,17,121,"Illinois","Marion County",3,34,417,205,212
050,17,121,"Illinois","Marion County",3,35,394,202,192
050,17,121,"Illinois","Marion County",3,36,431,212,219
050,17,121,"Illinois","Marion County",3,37,411,208,203
050,17,121,"Illinois","Marion County",3,38,432,215,217
050,17,121,"Illinois","Marion County",3,39,450,233,217
050,17,121,"Illinois","Marion County",3,40,446,231,215
050,17,121,"Illinois","Marion County",3,41,476,242,234
050,17,121,"Illinois","Marion County",3,42,448,225,223
050,17,121,"Illinois","Marion County",3,43,404,206,198
050,17,121,"Illinois","Marion County",3,44,419,217,202
050,17,121,"Illinois","Marion County",3,45,435,219,216
050,17,121,"Illinois","Marion County",3,46,430,221,209
050,17,121,"Illinois","Marion County",3,47,407,207,200
050,17,121,"Illinois","Marion County",3,48,420,218,202
050,17,121,"Illinois","Marion County",3,49,452,233,219
050,17,121,"Illinois","Marion County",3,50,480,245,235
050,17,121,"Illinois","Marion County",3,51,453,222,231
050,17,121,"Illinois","Marion County",3,52,419,212,207
050,17,121,"Illinois","Marion County",3,53,445,220,225
050,17,121,"Illinois","Marion County",3,54,435,215,220
050,17,121,"Illinois","Marion County",3,55,460,241,219
050,17,121,"Illinois","Marion County",3,56,506,251,255
050,17,121,"Illinois","Marion County",3,57,535,274,261
050,17,121,"Illinois","Marion County",3,58,541,259,282
050,17,121,"Illinois","Marion County",3,59,551,264,287
050,17,121,"Illinois","Marion County",3,60,563,260,303
050,17,121,"Illinois","Marion County",3,61,523,241,282
050,17,121,"Illinois","Marion County",3,62,533,266,267
050,17,121,"Illinois","Marion County",3,63,546,262,284
050,17,121,"Illinois","Marion County",3,64,516,233,283
050,17,121,"Illinois","Marion County",3,65,526,251,275
050,17,121,"Illinois","Marion County",3,66,515,250,265
050,17,121,"Illinois","Marion County",3,67,469,227,242
050,17,121,"Illinois","Marion County",3,68,452,229,223
050,17,121,"Illinois","Marion County",3,69,452,228,224
050,17,121,"Illinois","Marion County",3,70,417,193,224
050,17,121,"Illinois","Marion County",3,71,385,187,198
050,17,121,"Illinois","Marion County",3,72,378,182,196
050,17,121,"Illinois","Marion County",3,73,349,161,188
050,17,121,"Illinois","Marion County",3,74,392,167,225
050,17,121,"Illinois","Marion County",3,75,274,121,153
050,17,121,"Illinois","Marion County",3,76,274,129,145
050,17,121,"Illinois","Marion County",3,77,242,109,133
050,17,121,"Illinois","Marion County",3,78,263,113,150
050,17,121,"Illinois","Marion County",3,79,207,85,122
050,17,121,"Illinois","Marion County",3,80,204,85,119
050,17,121,"Illinois","Marion County",3,81,188,88,100
050,17,121,"Illinois","Marion County",3,82,187,81,106
050,17,121,"Illinois","Marion County",3,83,165,71,94
050,17,121,"Illinois","Marion County",3,84,142,53,89
050,17,121,"Illinois","Marion County",3,85,904,333,571
050,17,121,"Illinois","Marion County",4,0,436,218,218
050,17,121,"Illinois","Marion County",4,1,488,259,229
050,17,121,"Illinois","Marion County",4,2,428,220,208
050,17,121,"Illinois","Marion County",4,3,435,222,213
050,17,121,"Illinois","Marion County",4,4,456,251,205
050,17,121,"Illinois","Marion County",4,5,463,238,225
050,17,121,"Illinois","Marion County",4,6,479,242,237
050,17,121,"Illinois","Marion County",4,7,492,248,244
050,17,121,"Illinois","Marion County",4,8,473,247,226
050,17,121,"Illinois","Marion County",4,9,480,244,236
050,17,121,"Illinois","Marion County",4,10,475,239,236
050,17,121,"Illinois","Marion County",4,11,489,247,242
050,17,121,"Illinois","Marion County",4,12,492,242,250
050,17,121,"Illinois","Marion County",4,13,522,272,250
050,17,121,"Illinois","Marion County",4,14,543,272,271
050,17,121,"Illinois","Marion County",4,15,541,281,260
050,17,121,"Illinois","Marion County",4,16,528,284,244
050,17,121,"Illinois","Marion County",4,17,497,266,231
050,17,121,"Illinois","Marion County",4,18,412,229,183
050,17,121,"Illinois","Marion County",4,19,347,187,160
050,17,121,"Illinois","Marion County",4,20,367,181,186
050,17,121,"Illinois","Marion County",4,21,390,188,202
050,17,121,"Illinois","Marion County",4,22,399,194,205
050,17,121,"Illinois","Marion County",4,23,402,196,206
050,17,121,"Illinois","Marion County",4,24,402,212,190
050,17,121,"Illinois","Marion County",4,25,382,184,198
050,17,121,"Illinois","Marion County",4,26,406,207,199
050,17,121,"Illinois","Marion County",4,27,416,213,203
050,17,121,"Illinois","Marion County",4,28,432,211,221
050,17,121,"Illinois","Marion County",4,29,460,236,224
050,17,121,"Illinois","Marion County",4,30,448,235,213
050,17,121,"Illinois","Marion County",4,31,465,246,219
050,17,121,"Illinois","Marion County",4,32,445,232,213
050,17,121,"Illinois","Marion County",4,33,424,194,230
050,17,121,"Illinois","Marion County",4,34,438,220,218
050,17,121,"Illinois","Marion County",4,35,407,197,210
050,17,121,"Illinois","Marion County",4,36,400,200,200
050,17,121,"Illinois","Marion County",4,37,421,216,205
050,17,121,"Illinois","Marion County",4,38,410,202,208
050,17,121,"Illinois","Marion County",4,39,432,216,216
050,17,121,"Illinois","Marion County",4,40,450,225,225
050,17,121,"Illinois","Marion County",4,41,446,224,222
050,17,121,"Illinois","Marion County",4,42,475,246,229
050,17,121,"Illinois","Marion County",4,43,441,213,228
050,17,121,"Illinois","Marion County",4,44,401,205,196
050,17,121,"Illinois","Marion County",4,45,419,214,205
050,17,121,"Illinois","Marion County",4,46,438,222,216
050,17,121,"Illinois","Marion County",4,47,419,216,203
050,17,121,"Illinois","Marion County",4,48,409,210,199
050,17,121,"Illinois","Marion County",4,49,422,219,203
050,17,121,"Illinois","Marion County",4,50,448,232,216
050,17,121,"Illinois","Marion County",4,51,470,239,231
050,17,121,"Illinois","Marion County",4,52,452,225,227
050,17,121,"Illinois","Marion County",4,53,416,212,204
050,17,121,"Illinois","Marion County",4,54,436,210,226
050,17,121,"Illinois","Marion County",4,55,431,209,222
050,17,121,"Illinois","Marion County",4,56,463,244,219
050,17,121,"Illinois","Marion County",4,57,496,243,253
050,17,121,"Illinois","Marion County",4,58,522,267,255
050,17,121,"Illinois","Marion County",4,59,542,255,287
050,17,121,"Illinois","Marion County",4,60,546,263,283
050,17,121,"Illinois","Marion County",4,61,558,250,308
050,17,121,"Illinois","Marion County",4,62,517,238,279
050,17,121,"Illinois","Marion County",4,63,513,250,263
050,17,121,"Illinois","Marion County",4,64,538,261,277
050,17,121,"Illinois","Marion County",4,65,500,223,277
050,17,121,"Illinois","Marion County",4,66,518,246,272
050,17,121,"Illinois","Marion County",4,67,498,242,256
050,17,121,"Illinois","Marion County",4,68,455,218,237
050,17,121,"Illinois","Marion County",4,69,436,219,217
050,17,121,"Illinois","Marion County",4,70,442,218,224
050,17,121,"Illinois","Marion County",4,71,386,179,207
050,17,121,"Illinois","Marion County",4,72,374,180,194
050,17,121,"Illinois","Marion County",4,73,366,175,191
050,17,121,"Illinois","Marion County",4,74,342,158,184
050,17,121,"Illinois","Marion County",4,75,371,158,213
050,17,121,"Illinois","Marion County",4,76,262,113,149
050,17,121,"Illinois","Marion County",4,77,251,118,133
050,17,121,"Illinois","Marion County",4,78,236,103,133
050,17,121,"Illinois","Marion County",4,79,231,94,137
050,17,121,"Illinois","Marion County",4,80,200,80,120
050,17,121,"Illinois","Marion County",4,81,178,77,101
050,17,121,"Illinois","Marion County",4,82,176,77,99
050,17,121,"Illinois","Marion County",4,83,162,65,97
050,17,121,"Illinois","Marion County",4,84,148,57,91
050,17,121,"Illinois","Marion County",4,85,883,318,565
050,17,121,"Illinois","Marion County",5,0,420,210,210
050,17,121,"Illinois","Marion County",5,1,437,224,213
050,17,121,"Illinois","Marion County",5,2,491,256,235
050,17,121,"Illinois","Marion County",5,3,438,225,213
050,17,121,"Illinois","Marion County",5,4,437,223,214
050,17,121,"Illinois","Marion County",5,5,454,244,210
050,17,121,"Illinois","Marion County",5,6,466,225,241
050,17,121,"Illinois","Marion County",5,7,477,230,247
050,17,121,"Illinois","Marion County",5,8,480,246,234
050,17,121,"Illinois","Marion County",5,9,487,253,234
050,17,121,"Illinois","Marion County",5,10,483,251,232
050,17,121,"Illinois","Marion County",5,11,462,222,240
050,17,121,"Illinois","Marion County",5,12,501,253,248
050,17,121,"Illinois","Marion County",5,13,492,245,247
050,17,121,"Illinois","Marion County",5,14,513,266,247
050,17,121,"Illinois","Marion County",5,15,544,272,272
050,17,121,"Illinois","Marion County",5,16,533,274,259
050,17,121,"Illinois","Marion County",5,17,523,282,241
050,17,121,"Illinois","Marion County",5,18,444,249,195
050,17,121,"Illinois","Marion County",5,19,349,189,160
050,17,121,"Illinois","Marion County",5,20,350,185,165
050,17,121,"Illinois","Marion County",5,21,380,180,200
050,17,121,"Illinois","Marion County",5,22,413,197,216
050,17,121,"Illinois","Marion County",5,23,408,210,198
050,17,121,"Illinois","Marion County",5,24,387,195,192
050,17,121,"Illinois","Marion County",5,25,400,205,195
050,17,121,"Illinois","Marion County",5,26,373,180,193
050,17,121,"Illinois","Marion County",5,27,399,203,196
050,17,121,"Illinois","Marion County",5,28,401,203,198
050,17,121,"Illinois","Marion County",5,29,424,209,215
050,17,121,"Illinois","Marion County",5,30,459,230,229
050,17,121,"Illinois","Marion County",5,31,450,230,220
050,17,121,"Illinois","Marion County",5,32,457,236,221
050,17,121,"Illinois","Marion County",5,33,449,237,212
050,17,121,"Illinois","Marion County",5,34,435,198,237
050,17,121,"Illinois","Marion County",5,35,429,213,216
050,17,121,"Illinois","Marion County",5,36,418,200,218
050,17,121,"Illinois","Marion County",5,37,395,201,194
050,17,121,"Illinois","Marion County",5,38,415,214,201
050,17,121,"Illinois","Marion County",5,39,412,205,207
050,17,121,"Illinois","Marion County",5,40,446,224,222
050,17,121,"Illinois","Marion County",5,41,458,225,233
050,17,121,"Illinois","Marion County",5,42,455,234,221
050,17,121,"Illinois","Marion County",5,43,472,244,228
050,17,121,"Illinois","Marion County",5,44,429,210,219
050,17,121,"Illinois","Marion County",5,45,394,205,189
050,17,121,"Illinois","Marion County",5,46,423,218,205
050,17,121,"Illinois","Marion County",5,47,420,208,212
050,17,121,"Illinois","Marion County",5,48,417,215,202
050,17,121,"Illinois","Marion County",5,49,404,203,201
050,17,121,"Illinois","Marion County",5,50,416,216,200
050,17,121,"Illinois","Marion County",5,51,447,234,213
050,17,121,"Illinois","Marion County",5,52,476,241,235
050,17,121,"Illinois","Marion County",5,53,454,230,224
050,17,121,"Illinois","Marion County",5,54,412,208,204
050,17,121,"Illinois","Marion County",5,55,440,209,231
050,17,121,"Illinois","Marion County",5,56,425,210,215
050,17,121,"Illinois","Marion County",5,57,458,236,222
050,17,121,"Illinois","Marion County",5,58,489,244,245
050,17,121,"Illinois","Marion County",5,59,518,260,258
050,17,121,"Illinois","Marion County",5,60,531,251,280
050,17,121,"Illinois","Marion County",5,61,543,257,286
050,17,121,"Illinois","Marion County",5,62,548,248,300
050,17,121,"Illinois","Marion County",5,63,507,226,281
050,17,121,"Illinois","Marion County",5,64,508,249,259
050,17,121,"Illinois","Marion County",5,65,535,256,279
050,17,121,"Illinois","Marion County",5,66,502,231,271
050,17,121,"Illinois","Marion County",5,67,500,234,266
050,17,121,"Illinois","Marion County",5,68,490,239,251
050,17,121,"Illinois","Marion County",5,69,432,206,226
050,17,121,"Illinois","Marion County",5,70,429,211,218
050,17,121,"Illinois","Marion County",5,71,418,207,211
050,17,121,"Illinois","Marion County",5,72,366,166,200
050,17,121,"Illinois","Marion County",5,73,368,175,193
050,17,121,"Illinois","Marion County",5,74,352,168,184
050,17,121,"Illinois","Marion County",5,75,312,146,166
050,17,121,"Illinois","Marion County",5,76,355,146,209
050,17,121,"Illinois","Marion County",5,77,238,102,136
050,17,121,"Illinois","Marion County",5,78,246,112,134
050,17,121,"Illinois","Marion County",5,79,212,88,124
050,17,121,"Illinois","Marion County",5,80,221,89,132
050,17,121,"Illinois","Marion County",5,81,178,72,106
050,17,121,"Illinois","Marion County",5,82,167,68,99
050,17,121,"Illinois","Marion County",5,83,156,64,92
050,17,121,"Illinois","Marion County",5,84,145,51,94
050,17,121,"Illinois","Marion County",5,85,876,317,559
050,17,123,"Illinois","Marshall County",1,0,128,67,61
050,17,123,"Illinois","Marshall County",1,1,133,74,59
050,17,123,"Illinois","Marshall County",1,2,109,56,53
050,17,123,"Illinois","Marshall County",1,3,124,59,65
050,17,123,"Illinois","Marshall County",1,4,141,72,69
050,17,123,"Illinois","Marshall County",1,5,137,60,77
050,17,123,"Illinois","Marshall County",1,6,125,60,65
050,17,123,"Illinois","Marshall County",1,7,127,61,66
050,17,123,"Illinois","Marshall County",1,8,123,62,61
050,17,123,"Illinois","Marshall County",1,9,143,76,67
050,17,123,"Illinois","Marshall County",1,10,140,64,76
050,17,123,"Illinois","Marshall County",1,11,139,74,65
050,17,123,"Illinois","Marshall County",1,12,142,80,62
050,17,123,"Illinois","Marshall County",1,13,156,85,71
050,17,123,"Illinois","Marshall County",1,14,147,73,74
050,17,123,"Illinois","Marshall County",1,15,125,65,60
050,17,123,"Illinois","Marshall County",1,16,138,75,63
050,17,123,"Illinois","Marshall County",1,17,152,74,78
050,17,123,"Illinois","Marshall County",1,18,116,68,48
050,17,123,"Illinois","Marshall County",1,19,87,53,34
050,17,123,"Illinois","Marshall County",1,20,101,56,45
050,17,123,"Illinois","Marshall County",1,21,105,51,54
050,17,123,"Illinois","Marshall County",1,22,114,51,63
050,17,123,"Illinois","Marshall County",1,23,130,66,64
050,17,123,"Illinois","Marshall County",1,24,124,65,59
050,17,123,"Illinois","Marshall County",1,25,121,63,58
050,17,123,"Illinois","Marshall County",1,26,134,64,70
050,17,123,"Illinois","Marshall County",1,27,133,65,68
050,17,123,"Illinois","Marshall County",1,28,145,70,75
050,17,123,"Illinois","Marshall County",1,29,143,80,63
050,17,123,"Illinois","Marshall County",1,30,121,72,49
050,17,123,"Illinois","Marshall County",1,31,106,62,44
050,17,123,"Illinois","Marshall County",1,32,105,50,55
050,17,123,"Illinois","Marshall County",1,33,134,71,63
050,17,123,"Illinois","Marshall County",1,34,142,65,77
050,17,123,"Illinois","Marshall County",1,35,117,58,59
050,17,123,"Illinois","Marshall County",1,36,127,58,69
050,17,123,"Illinois","Marshall County",1,37,123,68,55
050,17,123,"Illinois","Marshall County",1,38,133,78,55
050,17,123,"Illinois","Marshall County",1,39,138,79,59
050,17,123,"Illinois","Marshall County",1,40,131,60,71
050,17,123,"Illinois","Marshall County",1,41,125,74,51
050,17,123,"Illinois","Marshall County",1,42,127,69,58
050,17,123,"Illinois","Marshall County",1,43,126,66,60
050,17,123,"Illinois","Marshall County",1,44,130,65,65
050,17,123,"Illinois","Marshall County",1,45,140,67,73
050,17,123,"Illinois","Marshall County",1,46,113,60,53
050,17,123,"Illinois","Marshall County",1,47,119,61,58
050,17,123,"Illinois","Marshall County",1,48,135,73,62
050,17,123,"Illinois","Marshall County",1,49,151,82,69
050,17,123,"Illinois","Marshall County",1,50,160,84,76
050,17,123,"Illinois","Marshall County",1,51,142,69,73
050,17,123,"Illinois","Marshall County",1,52,136,65,71
050,17,123,"Illinois","Marshall County",1,53,155,84,71
050,17,123,"Illinois","Marshall County",1,54,181,85,96
050,17,123,"Illinois","Marshall County",1,55,161,73,88
050,17,123,"Illinois","Marshall County",1,56,169,87,82
050,17,123,"Illinois","Marshall County",1,57,180,86,94
050,17,123,"Illinois","Marshall County",1,58,195,96,99
050,17,123,"Illinois","Marshall County",1,59,183,97,86
050,17,123,"Illinois","Marshall County",1,60,181,90,91
050,17,123,"Illinois","Marshall County",1,61,180,98,82
050,17,123,"Illinois","Marshall County",1,62,193,106,87
050,17,123,"Illinois","Marshall County",1,63,178,86,92
050,17,123,"Illinois","Marshall County",1,64,183,90,93
050,17,123,"Illinois","Marshall County",1,65,183,94,89
050,17,123,"Illinois","Marshall County",1,66,183,90,93
050,17,123,"Illinois","Marshall County",1,67,170,86,84
050,17,123,"Illinois","Marshall County",1,68,162,92,70
050,17,123,"Illinois","Marshall County",1,69,158,86,72
050,17,123,"Illinois","Marshall County",1,70,142,64,78
050,17,123,"Illinois","Marshall County",1,71,147,62,85
050,17,123,"Illinois","Marshall County",1,72,146,65,81
050,17,123,"Illinois","Marshall County",1,73,147,72,75
050,17,123,"Illinois","Marshall County",1,74,100,50,50
050,17,123,"Illinois","Marshall County",1,75,102,51,51
050,17,123,"Illinois","Marshall County",1,76,114,55,59
050,17,123,"Illinois","Marshall County",1,77,119,59,60
050,17,123,"Illinois","Marshall County",1,78,102,47,55
050,17,123,"Illinois","Marshall County",1,79,86,43,43
050,17,123,"Illinois","Marshall County",1,80,90,41,49
050,17,123,"Illinois","Marshall County",1,81,81,33,48
050,17,123,"Illinois","Marshall County",1,82,66,23,43
050,17,123,"Illinois","Marshall County",1,83,59,26,33
050,17,123,"Illinois","Marshall County",1,84,62,25,37
050,17,123,"Illinois","Marshall County",1,85,331,109,222
050,17,123,"Illinois","Marshall County",2,0,128,65,63
050,17,123,"Illinois","Marshall County",2,1,130,71,59
050,17,123,"Illinois","Marshall County",2,2,117,61,56
050,17,123,"Illinois","Marshall County",2,3,119,58,61
050,17,123,"Illinois","Marshall County",2,4,136,68,68
050,17,123,"Illinois","Marshall County",2,5,139,63,76
050,17,123,"Illinois","Marshall County",2,6,128,61,67
050,17,123,"Illinois","Marshall County",2,7,127,62,65
050,17,123,"Illinois","Marshall County",2,8,124,61,63
050,17,123,"Illinois","Marshall County",2,9,138,73,65
050,17,123,"Illinois","Marshall County",2,10,141,67,74
050,17,123,"Illinois","Marshall County",2,11,138,72,66
050,17,123,"Illinois","Marshall County",2,12,145,81,64
050,17,123,"Illinois","Marshall County",2,13,154,86,68
050,17,123,"Illinois","Marshall County",2,14,149,75,74
050,17,123,"Illinois","Marshall County",2,15,129,67,62
050,17,123,"Illinois","Marshall County",2,16,135,74,61
050,17,123,"Illinois","Marshall County",2,17,145,74,71
050,17,123,"Illinois","Marshall County",2,18,117,66,51
050,17,123,"Illinois","Marshall County",2,19,87,51,36
050,17,123,"Illinois","Marshall County",2,20,102,57,45
050,17,123,"Illinois","Marshall County",2,21,104,51,53
050,17,123,"Illinois","Marshall County",2,22,114,53,61
050,17,123,"Illinois","Marshall County",2,23,127,63,64
050,17,123,"Illinois","Marshall County",2,24,124,66,58
050,17,123,"Illinois","Marshall County",2,25,122,63,59
050,17,123,"Illinois","Marshall County",2,26,132,64,68
050,17,123,"Illinois","Marshall County",2,27,135,67,68
050,17,123,"Illinois","Marshall County",2,28,142,69,73
050,17,123,"Illinois","Marshall County",2,29,142,76,66
050,17,123,"Illinois","Marshall County",2,30,124,74,50
050,17,123,"Illinois","Marshall County",2,31,109,64,45
050,17,123,"Illinois","Marshall County",2,32,106,54,52
050,17,123,"Illinois","Marshall County",2,33,128,66,62
050,17,123,"Illinois","Marshall County",2,34,142,67,75
050,17,123,"Illinois","Marshall County",2,35,125,61,64
050,17,123,"Illinois","Marshall County",2,36,122,57,65
050,17,123,"Illinois","Marshall County",2,37,123,65,58
050,17,123,"Illinois","Marshall County",2,38,130,75,55
050,17,123,"Illinois","Marshall County",2,39,136,78,58
050,17,123,"Illinois","Marshall County",2,40,135,67,68
050,17,123,"Illinois","Marshall County",2,41,125,70,55
050,17,123,"Illinois","Marshall County",2,42,126,69,57
050,17,123,"Illinois","Marshall County",2,43,127,67,60
050,17,123,"Illinois","Marshall County",2,44,126,64,62
050,17,123,"Illinois","Marshall County",2,45,139,66,73
050,17,123,"Illinois","Marshall County",2,46,118,61,57
050,17,123,"Illinois","Marshall County",2,47,116,60,56
050,17,123,"Illinois","Marshall County",2,48,130,69,61
050,17,123,"Illinois","Marshall County",2,49,147,79,68
050,17,123,"Illinois","Marshall County",2,50,158,84,74
050,17,123,"Illinois","Marshall County",2,51,144,71,73
050,17,123,"Illinois","Marshall County",2,52,136,65,71
050,17,123,"Illinois","Marshall County",2,53,151,80,71
050,17,123,"Illinois","Marshall County",2,54,170,82,88
050,17,123,"Illinois","Marshall County",2,55,165,76,89
050,17,123,"Illinois","Marshall County",2,56,165,83,82
050,17,123,"Illinois","Marshall County",2,57,178,86,92
050,17,123,"Illinois","Marshall County",2,58,190,93,97
050,17,123,"Illinois","Marshall County",2,59,187,97,90
050,17,123,"Illinois","Marshall County",2,60,182,92,90
050,17,123,"Illinois","Marshall County",2,61,178,96,82
050,17,123,"Illinois","Marshall County",2,62,188,104,84
050,17,123,"Illinois","Marshall County",2,63,184,92,92
050,17,123,"Illinois","Marshall County",2,64,181,89,92
050,17,123,"Illinois","Marshall County",2,65,181,93,88
050,17,123,"Illinois","Marshall County",2,66,182,91,91
050,17,123,"Illinois","Marshall County",2,67,171,85,86
050,17,123,"Illinois","Marshall County",2,68,163,90,73
050,17,123,"Illinois","Marshall County",2,69,159,87,72
050,17,123,"Illinois","Marshall County",2,70,144,67,77
050,17,123,"Illinois","Marshall County",2,71,146,63,83
050,17,123,"Illinois","Marshall County",2,72,139,62,77
050,17,123,"Illinois","Marshall County",2,73,153,73,80
050,17,123,"Illinois","Marshall County",2,74,105,52,53
050,17,123,"Illinois","Marshall County",2,75,102,51,51
050,17,123,"Illinois","Marshall County",2,76,109,53,56
050,17,123,"Illinois","Marshall County",2,77,123,61,62
050,17,123,"Illinois","Marshall County",2,78,101,47,54
050,17,123,"Illinois","Marshall County",2,79,88,44,44
050,17,123,"Illinois","Marshall County",2,80,89,41,48
050,17,123,"Illinois","Marshall County",2,81,80,34,46
050,17,123,"Illinois","Marshall County",2,82,70,26,44
050,17,123,"Illinois","Marshall County",2,83,60,25,35
050,17,123,"Illinois","Marshall County",2,84,61,25,36
050,17,123,"Illinois","Marshall County",2,85,330,107,223
050,17,123,"Illinois","Marshall County",3,0,102,48,54
050,17,123,"Illinois","Marshall County",3,1,124,67,57
050,17,123,"Illinois","Marshall County",3,2,140,71,69
050,17,123,"Illinois","Marshall County",3,3,124,64,60
050,17,123,"Illinois","Marshall County",3,4,112,55,57
050,17,123,"Illinois","Marshall County",3,5,130,74,56
050,17,123,"Illinois","Marshall County",3,6,138,68,70
050,17,123,"Illinois","Marshall County",3,7,133,58,75
050,17,123,"Illinois","Marshall County",3,8,131,60,71
050,17,123,"Illinois","Marshall County",3,9,122,63,59
050,17,123,"Illinois","Marshall County",3,10,132,68,64
050,17,123,"Illinois","Marshall County",3,11,137,65,72
050,17,123,"Illinois","Marshall County",3,12,138,71,67
050,17,123,"Illinois","Marshall County",3,13,147,83,64
050,17,123,"Illinois","Marshall County",3,14,153,83,70
050,17,123,"Illinois","Marshall County",3,15,148,75,73
050,17,123,"Illinois","Marshall County",3,16,128,64,64
050,17,123,"Illinois","Marshall County",3,17,131,71,60
050,17,123,"Illinois","Marshall County",3,18,119,59,60
050,17,123,"Illinois","Marshall County",3,19,97,56,41
050,17,123,"Illinois","Marshall County",3,20,106,65,41
050,17,123,"Illinois","Marshall County",3,21,106,59,47
050,17,123,"Illinois","Marshall County",3,22,109,55,54
050,17,123,"Illinois","Marshall County",3,23,113,59,54
050,17,123,"Illinois","Marshall County",3,24,121,60,61
050,17,123,"Illinois","Marshall County",3,25,135,67,68
050,17,123,"Illinois","Marshall County",3,26,129,58,71
050,17,123,"Illinois","Marshall County",3,27,145,71,74
050,17,123,"Illinois","Marshall County",3,28,140,74,66
050,17,123,"Illinois","Marshall County",3,29,147,73,74
050,17,123,"Illinois","Marshall County",3,30,146,78,68
050,17,123,"Illinois","Marshall County",3,31,126,76,50
050,17,123,"Illinois","Marshall County",3,32,110,64,46
050,17,123,"Illinois","Marshall County",3,33,108,54,54
050,17,123,"Illinois","Marshall County",3,34,127,65,62
050,17,123,"Illinois","Marshall County",3,35,142,66,76
050,17,123,"Illinois","Marshall County",3,36,118,55,63
050,17,123,"Illinois","Marshall County",3,37,125,63,62
050,17,123,"Illinois","Marshall County",3,38,123,68,55
050,17,123,"Illinois","Marshall County",3,39,123,68,55
050,17,123,"Illinois","Marshall County",3,40,133,75,58
050,17,123,"Illinois","Marshall County",3,41,139,70,69
050,17,123,"Illinois","Marshall County",3,42,121,69,52
050,17,123,"Illinois","Marshall County",3,43,128,69,59
050,17,123,"Illinois","Marshall County",3,44,124,66,58
050,17,123,"Illinois","Marshall County",3,45,128,63,65
050,17,123,"Illinois","Marshall County",3,46,137,65,72
050,17,123,"Illinois","Marshall County",3,47,118,64,54
050,17,123,"Illinois","Marshall County",3,48,121,66,55
050,17,123,"Illinois","Marshall County",3,49,126,65,61
050,17,123,"Illinois","Marshall County",3,50,151,80,71
050,17,123,"Illinois","Marshall County",3,51,156,83,73
050,17,123,"Illinois","Marshall County",3,52,140,66,74
050,17,123,"Illinois","Marshall County",3,53,140,69,71
050,17,123,"Illinois","Marshall County",3,54,142,73,69
050,17,123,"Illinois","Marshall County",3,55,172,85,87
050,17,123,"Illinois","Marshall County",3,56,174,77,97
050,17,123,"Illinois","Marshall County",3,57,166,85,81
050,17,123,"Illinois","Marshall County",3,58,178,87,91
050,17,123,"Illinois","Marshall County",3,59,199,96,103
050,17,123,"Illinois","Marshall County",3,60,187,94,93
050,17,123,"Illinois","Marshall County",3,61,181,93,88
050,17,123,"Illinois","Marshall County",3,62,173,92,81
050,17,123,"Illinois","Marshall County",3,63,190,104,86
050,17,123,"Illinois","Marshall County",3,64,186,94,92
050,17,123,"Illinois","Marshall County",3,65,180,88,92
050,17,123,"Illinois","Marshall County",3,66,182,94,88
050,17,123,"Illinois","Marshall County",3,67,175,88,87
050,17,123,"Illinois","Marshall County",3,68,172,83,89
050,17,123,"Illinois","Marshall County",3,69,162,91,71
050,17,123,"Illinois","Marshall County",3,70,152,80,72
050,17,123,"Illinois","Marshall County",3,71,145,65,80
050,17,123,"Illinois","Marshall County",3,72,136,58,78
050,17,123,"Illinois","Marshall County",3,73,134,60,74
050,17,123,"Illinois","Marshall County",3,74,143,70,73
050,17,123,"Illinois","Marshall County",3,75,100,48,52
050,17,123,"Illinois","Marshall County",3,76,95,46,49
050,17,123,"Illinois","Marshall County",3,77,108,55,53
050,17,123,"Illinois","Marshall County",3,78,110,49,61
050,17,123,"Illinois","Marshall County",3,79,102,50,52
050,17,123,"Illinois","Marshall County",3,80,76,38,38
050,17,123,"Illinois","Marshall County",3,81,81,36,45
050,17,123,"Illinois","Marshall County",3,82,81,36,45
050,17,123,"Illinois","Marshall County",3,83,57,19,38
050,17,123,"Illinois","Marshall County",3,84,60,24,36
050,17,123,"Illinois","Marshall County",3,85,322,106,216
050,17,123,"Illinois","Marshall County",4,0,122,63,59
050,17,123,"Illinois","Marshall County",4,1,114,57,57
050,17,123,"Illinois","Marshall County",4,2,131,72,59
050,17,123,"Illinois","Marshall County",4,3,151,74,77
050,17,123,"Illinois","Marshall County",4,4,125,63,62
050,17,123,"Illinois","Marshall County",4,5,111,58,53
050,17,123,"Illinois","Marshall County",4,6,125,67,58
050,17,123,"Illinois","Marshall County",4,7,145,65,80
050,17,123,"Illinois","Marshall County",4,8,132,58,74
050,17,123,"Illinois","Marshall County",4,9,130,53,77
050,17,123,"Illinois","Marshall County",4,10,115,59,56
050,17,123,"Illinois","Marshall County",4,11,138,72,66
050,17,123,"Illinois","Marshall County",4,12,144,70,74
050,17,123,"Illinois","Marshall County",4,13,137,75,62
050,17,123,"Illinois","Marshall County",4,14,139,82,57
050,17,123,"Illinois","Marshall County",4,15,153,83,70
050,17,123,"Illinois","Marshall County",4,16,151,81,70
050,17,123,"Illinois","Marshall County",4,17,133,66,67
050,17,123,"Illinois","Marshall County",4,18,111,60,51
050,17,123,"Illinois","Marshall County",4,19,92,47,45
050,17,123,"Illinois","Marshall County",4,20,101,54,47
050,17,123,"Illinois","Marshall County",4,21,105,60,45
050,17,123,"Illinois","Marshall County",4,22,110,62,48
050,17,123,"Illinois","Marshall County",4,23,107,56,51
050,17,123,"Illinois","Marshall County",4,24,118,63,55
050,17,123,"Illinois","Marshall County",4,25,122,67,55
050,17,123,"Illinois","Marshall County",4,26,139,71,68
050,17,123,"Illinois","Marshall County",4,27,133,58,75
050,17,123,"Illinois","Marshall County",4,28,140,69,71
050,17,123,"Illinois","Marshall County",4,29,136,75,61
050,17,123,"Illinois","Marshall County",4,30,149,77,72
050,17,123,"Illinois","Marshall County",4,31,152,82,70
050,17,123,"Illinois","Marshall County",4,32,132,77,55
050,17,123,"Illinois","Marshall County",4,33,113,65,48
050,17,123,"Illinois","Marshall County",4,34,113,59,54
050,17,123,"Illinois","Marshall County",4,35,138,75,63
050,17,123,"Illinois","Marshall County",4,36,140,67,73
050,17,123,"Illinois","Marshall County",4,37,123,56,67
050,17,123,"Illinois","Marshall County",4,38,128,63,65
050,17,123,"Illinois","Marshall County",4,39,112,56,56
050,17,123,"Illinois","Marshall County",4,40,126,69,57
050,17,123,"Illinois","Marshall County",4,41,130,76,54
050,17,123,"Illinois","Marshall County",4,42,142,69,73
050,17,123,"Illinois","Marshall County",4,43,124,68,56
050,17,123,"Illinois","Marshall County",4,44,121,64,57
050,17,123,"Illinois","Marshall County",4,45,123,64,59
050,17,123,"Illinois","Marshall County",4,46,128,60,68
050,17,123,"Illinois","Marshall County",4,47,133,66,67
050,17,123,"Illinois","Marshall County",4,48,121,67,54
050,17,123,"Illinois","Marshall County",4,49,123,68,55
050,17,123,"Illinois","Marshall County",4,50,126,65,61
050,17,123,"Illinois","Marshall County",4,51,152,79,73
050,17,123,"Illinois","Marshall County",4,52,156,83,73
050,17,123,"Illinois","Marshall County",4,53,141,68,73
050,17,123,"Illinois","Marshall County",4,54,135,66,69
050,17,123,"Illinois","Marshall County",4,55,148,75,73
050,17,123,"Illinois","Marshall County",4,56,179,91,88
050,17,123,"Illinois","Marshall County",4,57,181,81,100
050,17,123,"Illinois","Marshall County",4,58,159,80,79
050,17,123,"Illinois","Marshall County",4,59,171,82,89
050,17,123,"Illinois","Marshall County",4,60,195,94,101
050,17,123,"Illinois","Marshall County",4,61,189,97,92
050,17,123,"Illinois","Marshall County",4,62,182,94,88
050,17,123,"Illinois","Marshall County",4,63,179,93,86
050,17,123,"Illinois","Marshall County",4,64,189,103,86
050,17,123,"Illinois","Marshall County",4,65,179,91,88
050,17,123,"Illinois","Marshall County",4,66,185,90,95
050,17,123,"Illinois","Marshall County",4,67,175,90,85
050,17,123,"Illinois","Marshall County",4,68,171,88,83
050,17,123,"Illinois","Marshall County",4,69,171,82,89
050,17,123,"Illinois","Marshall County",4,70,152,82,70
050,17,123,"Illinois","Marshall County",4,71,154,80,74
050,17,123,"Illinois","Marshall County",4,72,146,65,81
050,17,123,"Illinois","Marshall County",4,73,135,58,77
050,17,123,"Illinois","Marshall County",4,74,136,61,75
050,17,123,"Illinois","Marshall County",4,75,137,65,72
050,17,123,"Illinois","Marshall County",4,76,92,44,48
050,17,123,"Illinois","Marshall County",4,77,98,51,47
050,17,123,"Illinois","Marshall County",4,78,97,49,48
050,17,123,"Illinois","Marshall County",4,79,108,50,58
050,17,123,"Illinois","Marshall County",4,80,98,49,49
050,17,123,"Illinois","Marshall County",4,81,66,29,37
050,17,123,"Illinois","Marshall County",4,82,75,36,39
050,17,123,"Illinois","Marshall County",4,83,71,32,39
050,17,123,"Illinois","Marshall County",4,84,53,16,37
050,17,123,"Illinois","Marshall County",4,85,309,102,207
050,17,123,"Illinois","Marshall County",5,0,120,63,57
050,17,123,"Illinois","Marshall County",5,1,122,66,56
050,17,123,"Illinois","Marshall County",5,2,109,55,54
050,17,123,"Illinois","Marshall County",5,3,131,68,63
050,17,123,"Illinois","Marshall County",5,4,138,68,70
050,17,123,"Illinois","Marshall County",5,5,135,73,62
050,17,123,"Illinois","Marshall County",5,6,116,60,56
050,17,123,"Illinois","Marshall County",5,7,129,70,59
050,17,123,"Illinois","Marshall County",5,8,149,67,82
050,17,123,"Illinois","Marshall County",5,9,125,60,65
050,17,123,"Illinois","Marshall County",5,10,135,57,78
050,17,123,"Illinois","Marshall County",5,11,118,59,59
050,17,123,"Illinois","Marshall County",5,12,134,72,62
050,17,123,"Illinois","Marshall County",5,13,153,70,83
050,17,123,"Illinois","Marshall County",5,14,136,73,63
050,17,123,"Illinois","Marshall County",5,15,142,79,63
050,17,123,"Illinois","Marshall County",5,16,151,84,67
050,17,123,"Illinois","Marshall County",5,17,155,78,77
050,17,123,"Illinois","Marshall County",5,18,112,58,54
050,17,123,"Illinois","Marshall County",5,19,93,52,41
050,17,123,"Illinois","Marshall County",5,20,103,55,48
050,17,123,"Illinois","Marshall County",5,21,111,58,53
050,17,123,"Illinois","Marshall County",5,22,121,64,57
050,17,123,"Illinois","Marshall County",5,23,113,61,52
050,17,123,"Illinois","Marshall County",5,24,104,61,43
050,17,123,"Illinois","Marshall County",5,25,114,54,60
050,17,123,"Illinois","Marshall County",5,26,125,73,52
050,17,123,"Illinois","Marshall County",5,27,138,76,62
050,17,123,"Illinois","Marshall County",5,28,124,51,73
050,17,123,"Illinois","Marshall County",5,29,131,66,65
050,17,123,"Illinois","Marshall County",5,30,134,72,62
050,17,123,"Illinois","Marshall County",5,31,142,74,68
050,17,123,"Illinois","Marshall County",5,32,150,78,72
050,17,123,"Illinois","Marshall County",5,33,134,77,57
050,17,123,"Illinois","Marshall County",5,34,115,67,48
050,17,123,"Illinois","Marshall County",5,35,115,59,56
050,17,123,"Illinois","Marshall County",5,36,142,74,68
050,17,123,"Illinois","Marshall County",5,37,137,63,74
050,17,123,"Illinois","Marshall County",5,38,128,61,67
050,17,123,"Illinois","Marshall County",5,39,126,65,61
050,17,123,"Illinois","Marshall County",5,40,113,56,57
050,17,123,"Illinois","Marshall County",5,41,135,75,60
050,17,123,"Illinois","Marshall County",5,42,136,82,54
050,17,123,"Illinois","Marshall County",5,43,145,68,77
050,17,123,"Illinois","Marshall County",5,44,118,69,49
050,17,123,"Illinois","Marshall County",5,45,126,65,61
050,17,123,"Illinois","Marshall County",5,46,120,63,57
050,17,123,"Illinois","Marshall County",5,47,135,62,73
050,17,123,"Illinois","Marshall County",5,48,141,70,71
050,17,123,"Illinois","Marshall County",5,49,130,72,58
050,17,123,"Illinois","Marshall County",5,50,122,64,58
050,17,123,"Illinois","Marshall County",5,51,129,70,59
050,17,123,"Illinois","Marshall County",5,52,150,74,76
050,17,123,"Illinois","Marshall County",5,53,158,84,74
050,17,123,"Illinois","Marshall County",5,54,141,66,75
050,17,123,"Illinois","Marshall County",5,55,134,67,67
050,17,123,"Illinois","Marshall County",5,56,152,77,75
050,17,123,"Illinois","Marshall County",5,57,180,93,87
050,17,123,"Illinois","Marshall County",5,58,171,76,95
050,17,123,"Illinois","Marshall County",5,59,158,78,80
050,17,123,"Illinois","Marshall County",5,60,175,86,89
050,17,123,"Illinois","Marshall County",5,61,185,89,96
050,17,123,"Illinois","Marshall County",5,62,190,96,94
050,17,123,"Illinois","Marshall County",5,63,196,101,95
050,17,123,"Illinois","Marshall County",5,64,186,97,89
050,17,123,"Illinois","Marshall County",5,65,180,99,81
050,17,123,"Illinois","Marshall County",5,66,188,99,89
050,17,123,"Illinois","Marshall County",5,67,179,86,93
050,17,123,"Illinois","Marshall County",5,68,177,90,87
050,17,123,"Illinois","Marshall County",5,69,169,86,83
050,17,123,"Illinois","Marshall County",5,70,164,78,86
050,17,123,"Illinois","Marshall County",5,71,155,80,75
050,17,123,"Illinois","Marshall County",5,72,149,78,71
050,17,123,"Illinois","Marshall County",5,73,138,64,74
050,17,123,"Illinois","Marshall County",5,74,127,53,74
050,17,123,"Illinois","Marshall County",5,75,127,55,72
050,17,123,"Illinois","Marshall County",5,76,128,59,69
050,17,123,"Illinois","Marshall County",5,77,97,48,49
050,17,123,"Illinois","Marshall County",5,78,89,46,43
050,17,123,"Illinois","Marshall County",5,79,100,54,46
050,17,123,"Illinois","Marshall County",5,80,102,48,54
050,17,123,"Illinois","Marshall County",5,81,88,42,46
050,17,123,"Illinois","Marshall County",5,82,65,31,34
050,17,123,"Illinois","Marshall County",5,83,66,32,34
050,17,123,"Illinois","Marshall County",5,84,69,28,41
050,17,123,"Illinois","Marshall County",5,85,290,89,201
050,17,125,"Illinois","Mason County",1,0,127,65,62
050,17,125,"Illinois","Mason County",1,1,131,71,60
050,17,125,"Illinois","Mason County",1,2,122,60,62
050,17,125,"Illinois","Mason County",1,3,144,62,82
050,17,125,"Illinois","Mason County",1,4,133,62,71
050,17,125,"Illinois","Mason County",1,5,136,71,65
050,17,125,"Illinois","Mason County",1,6,144,76,68
050,17,125,"Illinois","Mason County",1,7,150,77,73
050,17,125,"Illinois","Mason County",1,8,152,88,64
050,17,125,"Illinois","Mason County",1,9,166,98,68
050,17,125,"Illinois","Mason County",1,10,155,80,75
050,17,125,"Illinois","Mason County",1,11,158,73,85
050,17,125,"Illinois","Mason County",1,12,157,76,81
050,17,125,"Illinois","Mason County",1,13,167,87,80
050,17,125,"Illinois","Mason County",1,14,178,82,96
050,17,125,"Illinois","Mason County",1,15,174,83,91
050,17,125,"Illinois","Mason County",1,16,181,77,104
050,17,125,"Illinois","Mason County",1,17,173,76,97
050,17,125,"Illinois","Mason County",1,18,138,75,63
050,17,125,"Illinois","Mason County",1,19,110,64,46
050,17,125,"Illinois","Mason County",1,20,125,62,63
050,17,125,"Illinois","Mason County",1,21,134,69,65
050,17,125,"Illinois","Mason County",1,22,145,74,71
050,17,125,"Illinois","Mason County",1,23,128,69,59
050,17,125,"Illinois","Mason County",1,24,129,66,63
050,17,125,"Illinois","Mason County",1,25,138,70,68
050,17,125,"Illinois","Mason County",1,26,136,70,66
050,17,125,"Illinois","Mason County",1,27,141,73,68
050,17,125,"Illinois","Mason County",1,28,144,77,67
050,17,125,"Illinois","Mason County",1,29,149,73,76
050,17,125,"Illinois","Mason County",1,30,145,77,68
050,17,125,"Illinois","Mason County",1,31,136,66,70
050,17,125,"Illinois","Mason County",1,32,126,63,63
050,17,125,"Illinois","Mason County",1,33,119,66,53
050,17,125,"Illinois","Mason County",1,34,132,63,69
050,17,125,"Illinois","Mason County",1,35,137,73,64
050,17,125,"Illinois","Mason County",1,36,131,61,70
050,17,125,"Illinois","Mason County",1,37,160,71,89
050,17,125,"Illinois","Mason County",1,38,136,63,73
050,17,125,"Illinois","Mason County",1,39,163,76,87
050,17,125,"Illinois","Mason County",1,40,181,98,83
050,17,125,"Illinois","Mason County",1,41,145,82,63
050,17,125,"Illinois","Mason County",1,42,142,71,71
050,17,125,"Illinois","Mason County",1,43,146,71,75
050,17,125,"Illinois","Mason County",1,44,167,89,78
050,17,125,"Illinois","Mason County",1,45,163,85,78
050,17,125,"Illinois","Mason County",1,46,155,79,76
050,17,125,"Illinois","Mason County",1,47,162,84,78
050,17,125,"Illinois","Mason County",1,48,168,81,87
050,17,125,"Illinois","Mason County",1,49,178,95,83
050,17,125,"Illinois","Mason County",1,50,160,90,70
050,17,125,"Illinois","Mason County",1,51,151,79,72
050,17,125,"Illinois","Mason County",1,52,152,79,73
050,17,125,"Illinois","Mason County",1,53,173,94,79
050,17,125,"Illinois","Mason County",1,54,179,94,85
050,17,125,"Illinois","Mason County",1,55,193,99,94
050,17,125,"Illinois","Mason County",1,56,197,93,104
050,17,125,"Illinois","Mason County",1,57,217,109,108
050,17,125,"Illinois","Mason County",1,58,210,103,107
050,17,125,"Illinois","Mason County",1,59,209,107,102
050,17,125,"Illinois","Mason County",1,60,195,99,96
050,17,125,"Illinois","Mason County",1,61,199,100,99
050,17,125,"Illinois","Mason County",1,62,205,98,107
050,17,125,"Illinois","Mason County",1,63,173,85,88
050,17,125,"Illinois","Mason County",1,64,175,91,84
050,17,125,"Illinois","Mason County",1,65,196,93,103
050,17,125,"Illinois","Mason County",1,66,180,85,95
050,17,125,"Illinois","Mason County",1,67,180,84,96
050,17,125,"Illinois","Mason County",1,68,180,92,88
050,17,125,"Illinois","Mason County",1,69,150,86,64
050,17,125,"Illinois","Mason County",1,70,170,94,76
050,17,125,"Illinois","Mason County",1,71,175,88,87
050,17,125,"Illinois","Mason County",1,72,168,88,80
050,17,125,"Illinois","Mason County",1,73,165,85,80
050,17,125,"Illinois","Mason County",1,74,112,49,63
050,17,125,"Illinois","Mason County",1,75,112,45,67
050,17,125,"Illinois","Mason County",1,76,120,53,67
050,17,125,"Illinois","Mason County",1,77,128,61,67
050,17,125,"Illinois","Mason County",1,78,103,53,50
050,17,125,"Illinois","Mason County",1,79,80,45,35
050,17,125,"Illinois","Mason County",1,80,85,49,36
050,17,125,"Illinois","Mason County",1,81,90,37,53
050,17,125,"Illinois","Mason County",1,82,72,27,45
050,17,125,"Illinois","Mason County",1,83,57,25,32
050,17,125,"Illinois","Mason County",1,84,53,23,30
050,17,125,"Illinois","Mason County",1,85,370,117,253
050,17,125,"Illinois","Mason County",2,0,140,72,68
050,17,125,"Illinois","Mason County",2,1,129,70,59
050,17,125,"Illinois","Mason County",2,2,123,62,61
050,17,125,"Illinois","Mason County",2,3,136,61,75
050,17,125,"Illinois","Mason County",2,4,136,62,74
050,17,125,"Illinois","Mason County",2,5,135,68,67
050,17,125,"Illinois","Mason County",2,6,145,77,68
050,17,125,"Illinois","Mason County",2,7,149,78,71
050,17,125,"Illinois","Mason County",2,8,151,85,66
050,17,125,"Illinois","Mason County",2,9,161,94,67
050,17,125,"Illinois","Mason County",2,10,159,85,74
050,17,125,"Illinois","Mason County",2,11,155,74,81
050,17,125,"Illinois","Mason County",2,12,159,76,83
050,17,125,"Illinois","Mason County",2,13,162,82,80
050,17,125,"Illinois","Mason County",2,14,173,82,91
050,17,125,"Illinois","Mason County",2,15,174,82,92
050,17,125,"Illinois","Mason County",2,16,178,78,100
050,17,125,"Illinois","Mason County",2,17,173,77,96
050,17,125,"Illinois","Mason County",2,18,141,74,67
050,17,125,"Illinois","Mason County",2,19,111,63,48
050,17,125,"Illinois","Mason County",2,20,124,64,60
050,17,125,"Illinois","Mason County",2,21,135,70,65
050,17,125,"Illinois","Mason County",2,22,143,74,69
050,17,125,"Illinois","Mason County",2,23,134,72,62
050,17,125,"Illinois","Mason County",2,24,129,67,62
050,17,125,"Illinois","Mason County",2,25,138,70,68
050,17,125,"Illinois","Mason County",2,26,139,71,68
050,17,125,"Illinois","Mason County",2,27,138,72,66
050,17,125,"Illinois","Mason County",2,28,143,77,66
050,17,125,"Illinois","Mason County",2,29,148,74,74
050,17,125,"Illinois","Mason County",2,30,144,74,70
050,17,125,"Illinois","Mason County",2,31,137,67,70
050,17,125,"Illinois","Mason County",2,32,127,62,65
050,17,125,"Illinois","Mason County",2,33,120,65,55
050,17,125,"Illinois","Mason County",2,34,129,64,65
050,17,125,"Illinois","Mason County",2,35,137,71,66
050,17,125,"Illinois","Mason County",2,36,130,62,68
050,17,125,"Illinois","Mason County",2,37,151,68,83
050,17,125,"Illinois","Mason County",2,38,143,65,78
050,17,125,"Illinois","Mason County",2,39,156,72,84
050,17,125,"Illinois","Mason County",2,40,177,94,83
050,17,125,"Illinois","Mason County",2,41,154,86,68
050,17,125,"Illinois","Mason County",2,42,141,73,68
050,17,125,"Illinois","Mason County",2,43,149,73,76
050,17,125,"Illinois","Mason County",2,44,162,85,77
050,17,125,"Illinois","Mason County",2,45,164,87,77
050,17,125,"Illinois","Mason County",2,46,156,81,75
050,17,125,"Illinois","Mason County",2,47,159,82,77
050,17,125,"Illinois","Mason County",2,48,166,82,84
050,17,125,"Illinois","Mason County",2,49,174,91,83
050,17,125,"Illinois","Mason County",2,50,163,90,73
050,17,125,"Illinois","Mason County",2,51,152,81,71
050,17,125,"Illinois","Mason County",2,52,149,77,72
050,17,125,"Illinois","Mason County",2,53,167,91,76
050,17,125,"Illinois","Mason County",2,54,177,94,83
050,17,125,"Illinois","Mason County",2,55,190,98,92
050,17,125,"Illinois","Mason County",2,56,196,95,101
050,17,125,"Illinois","Mason County",2,57,211,105,106
050,17,125,"Illinois","Mason County",2,58,209,104,105
050,17,125,"Illinois","Mason County",2,59,209,106,103
050,17,125,"Illinois","Mason County",2,60,196,100,96
050,17,125,"Illinois","Mason County",2,61,198,99,99
050,17,125,"Illinois","Mason County",2,62,202,98,104
050,17,125,"Illinois","Mason County",2,63,182,89,93
050,17,125,"Illinois","Mason County",2,64,174,90,84
050,17,125,"Illinois","Mason County",2,65,188,91,97
050,17,125,"Illinois","Mason County",2,66,182,85,97
050,17,125,"Illinois","Mason County",2,67,178,83,95
050,17,125,"Illinois","Mason County",2,68,179,90,89
050,17,125,"Illinois","Mason County",2,69,156,86,70
050,17,125,"Illinois","Mason County",2,70,163,90,73
050,17,125,"Illinois","Mason County",2,71,175,90,85
050,17,125,"Illinois","Mason County",2,72,167,87,80
050,17,125,"Illinois","Mason County",2,73,174,90,84
050,17,125,"Illinois","Mason County",2,74,115,53,62
050,17,125,"Illinois","Mason County",2,75,112,46,66
050,17,125,"Illinois","Mason County",2,76,117,50,67
050,17,125,"Illinois","Mason County",2,77,125,58,67
050,17,125,"Illinois","Mason County",2,78,103,53,50
050,17,125,"Illinois","Mason County",2,79,84,47,37
050,17,125,"Illinois","Mason County",2,80,83,48,35
050,17,125,"Illinois","Mason County",2,81,88,39,49
050,17,125,"Illinois","Mason County",2,82,73,28,45
050,17,125,"Illinois","Mason County",2,83,60,26,34
050,17,125,"Illinois","Mason County",2,84,53,24,29
050,17,125,"Illinois","Mason County",2,85,371,120,251
050,17,125,"Illinois","Mason County",3,0,100,47,53
050,17,125,"Illinois","Mason County",3,1,139,63,76
050,17,125,"Illinois","Mason County",3,2,124,70,54
050,17,125,"Illinois","Mason County",3,3,122,61,61
050,17,125,"Illinois","Mason County",3,4,139,64,75
050,17,125,"Illinois","Mason County",3,5,141,70,71
050,17,125,"Illinois","Mason County",3,6,135,75,60
050,17,125,"Illinois","Mason County",3,7,142,77,65
050,17,125,"Illinois","Mason County",3,8,138,74,64
050,17,125,"Illinois","Mason County",3,9,151,75,76
050,17,125,"Illinois","Mason County",3,10,151,85,66
050,17,125,"Illinois","Mason County",3,11,158,85,73
050,17,125,"Illinois","Mason County",3,12,148,71,77
050,17,125,"Illinois","Mason County",3,13,158,74,84
050,17,125,"Illinois","Mason County",3,14,169,88,81
050,17,125,"Illinois","Mason County",3,15,171,81,90
050,17,125,"Illinois","Mason County",3,16,186,88,98
050,17,125,"Illinois","Mason County",3,17,187,80,107
050,17,125,"Illinois","Mason County",3,18,149,67,82
050,17,125,"Illinois","Mason County",3,19,107,58,49
050,17,125,"Illinois","Mason County",3,20,119,62,57
050,17,125,"Illinois","Mason County",3,21,125,66,59
050,17,125,"Illinois","Mason County",3,22,147,74,73
050,17,125,"Illinois","Mason County",3,23,144,70,74
050,17,125,"Illinois","Mason County",3,24,136,65,71
050,17,125,"Illinois","Mason County",3,25,125,60,65
050,17,125,"Illinois","Mason County",3,26,126,66,60
050,17,125,"Illinois","Mason County",3,27,128,71,57
050,17,125,"Illinois","Mason County",3,28,143,78,65
050,17,125,"Illinois","Mason County",3,29,138,69,69
050,17,125,"Illinois","Mason County",3,30,145,75,70
050,17,125,"Illinois","Mason County",3,31,136,69,67
050,17,125,"Illinois","Mason County",3,32,144,71,73
050,17,125,"Illinois","Mason County",3,33,124,62,62
050,17,125,"Illinois","Mason County",3,34,114,64,50
050,17,125,"Illinois","Mason County",3,35,132,68,64
050,17,125,"Illinois","Mason County",3,36,130,65,65
050,17,125,"Illinois","Mason County",3,37,123,61,62
050,17,125,"Illinois","Mason County",3,38,143,63,80
050,17,125,"Illinois","Mason County",3,39,144,60,84
050,17,125,"Illinois","Mason County",3,40,157,73,84
050,17,125,"Illinois","Mason County",3,41,182,93,89
050,17,125,"Illinois","Mason County",3,42,153,88,65
050,17,125,"Illinois","Mason County",3,43,147,74,73
050,17,125,"Illinois","Mason County",3,44,153,75,78
050,17,125,"Illinois","Mason County",3,45,157,84,73
050,17,125,"Illinois","Mason County",3,46,166,87,79
050,17,125,"Illinois","Mason County",3,47,157,79,78
050,17,125,"Illinois","Mason County",3,48,164,83,81
050,17,125,"Illinois","Mason County",3,49,156,77,79
050,17,125,"Illinois","Mason County",3,50,171,89,82
050,17,125,"Illinois","Mason County",3,51,160,88,72
050,17,125,"Illinois","Mason County",3,52,151,78,73
050,17,125,"Illinois","Mason County",3,53,145,75,70
050,17,125,"Illinois","Mason County",3,54,167,91,76
050,17,125,"Illinois","Mason County",3,55,172,89,83
050,17,125,"Illinois","Mason County",3,56,186,99,87
050,17,125,"Illinois","Mason County",3,57,190,91,99
050,17,125,"Illinois","Mason County",3,58,210,102,108
050,17,125,"Illinois","Mason County",3,59,210,103,107
050,17,125,"Illinois","Mason County",3,60,207,103,104
050,17,125,"Illinois","Mason County",3,61,194,101,93
050,17,125,"Illinois","Mason County",3,62,201,99,102
050,17,125,"Illinois","Mason County",3,63,198,96,102
050,17,125,"Illinois","Mason County",3,64,180,90,90
050,17,125,"Illinois","Mason County",3,65,167,86,81
050,17,125,"Illinois","Mason County",3,66,178,87,91
050,17,125,"Illinois","Mason County",3,67,179,82,97
050,17,125,"Illinois","Mason County",3,68,174,81,93
050,17,125,"Illinois","Mason County",3,69,169,85,84
050,17,125,"Illinois","Mason County",3,70,150,82,68
050,17,125,"Illinois","Mason County",3,71,158,87,71
050,17,125,"Illinois","Mason County",3,72,159,81,78
050,17,125,"Illinois","Mason County",3,73,155,77,78
050,17,125,"Illinois","Mason County",3,74,164,86,78
050,17,125,"Illinois","Mason County",3,75,116,52,64
050,17,125,"Illinois","Mason County",3,76,103,41,62
050,17,125,"Illinois","Mason County",3,77,113,48,65
050,17,125,"Illinois","Mason County",3,78,114,53,61
050,17,125,"Illinois","Mason County",3,79,102,55,47
050,17,125,"Illinois","Mason County",3,80,80,43,37
050,17,125,"Illinois","Mason County",3,81,76,42,34
050,17,125,"Illinois","Mason County",3,82,77,34,43
050,17,125,"Illinois","Mason County",3,83,64,24,40
050,17,125,"Illinois","Mason County",3,84,56,25,31
050,17,125,"Illinois","Mason County",3,85,361,113,248
050,17,125,"Illinois","Mason County",4,0,87,39,48
050,17,125,"Illinois","Mason County",4,1,87,45,42
050,17,125,"Illinois","Mason County",4,2,139,61,78
050,17,125,"Illinois","Mason County",4,3,130,73,57
050,17,125,"Illinois","Mason County",4,4,128,64,64
050,17,125,"Illinois","Mason County",4,5,138,67,71
050,17,125,"Illinois","Mason County",4,6,144,66,78
050,17,125,"Illinois","Mason County",4,7,138,73,65
050,17,125,"Illinois","Mason County",4,8,152,87,65
050,17,125,"Illinois","Mason County",4,9,145,77,68
050,17,125,"Illinois","Mason County",4,10,152,78,74
050,17,125,"Illinois","Mason County",4,11,163,92,71
050,17,125,"Illinois","Mason County",4,12,161,88,73
050,17,125,"Illinois","Mason County",4,13,157,71,86
050,17,125,"Illinois","Mason County",4,14,160,79,81
050,17,125,"Illinois","Mason County",4,15,172,89,83
050,17,125,"Illinois","Mason County",4,16,173,81,92
050,17,125,"Illinois","Mason County",4,17,186,88,98
050,17,125,"Illinois","Mason County",4,18,146,65,81
050,17,125,"Illinois","Mason County",4,19,108,51,57
050,17,125,"Illinois","Mason County",4,20,106,56,50
050,17,125,"Illinois","Mason County",4,21,123,67,56
050,17,125,"Illinois","Mason County",4,22,136,69,67
050,17,125,"Illinois","Mason County",4,23,142,75,67
050,17,125,"Illinois","Mason County",4,24,130,65,65
050,17,125,"Illinois","Mason County",4,25,142,65,77
050,17,125,"Illinois","Mason County",4,26,125,62,63
050,17,125,"Illinois","Mason County",4,27,122,63,59
050,17,125,"Illinois","Mason County",4,28,125,68,57
050,17,125,"Illinois","Mason County",4,29,146,76,70
050,17,125,"Illinois","Mason County",4,30,148,75,73
050,17,125,"Illinois","Mason County",4,31,148,79,69
050,17,125,"Illinois","Mason County",4,32,137,66,71
050,17,125,"Illinois","Mason County",4,33,148,70,78
050,17,125,"Illinois","Mason County",4,34,123,59,64
050,17,125,"Illinois","Mason County",4,35,113,63,50
050,17,125,"Illinois","Mason County",4,36,129,67,62
050,17,125,"Illinois","Mason County",4,37,135,72,63
050,17,125,"Illinois","Mason County",4,38,123,60,63
050,17,125,"Illinois","Mason County",4,39,149,64,85
050,17,125,"Illinois","Mason County",4,40,143,57,86
050,17,125,"Illinois","Mason County",4,41,155,74,81
050,17,125,"Illinois","Mason County",4,42,178,92,86
050,17,125,"Illinois","Mason County",4,43,162,94,68
050,17,125,"Illinois","Mason County",4,44,148,73,75
050,17,125,"Illinois","Mason County",4,45,158,75,83
050,17,125,"Illinois","Mason County",4,46,158,85,73
050,17,125,"Illinois","Mason County",4,47,159,78,81
050,17,125,"Illinois","Mason County",4,48,153,78,75
050,17,125,"Illinois","Mason County",4,49,164,85,79
050,17,125,"Illinois","Mason County",4,50,158,78,80
050,17,125,"Illinois","Mason County",4,51,168,89,79
050,17,125,"Illinois","Mason County",4,52,152,81,71
050,17,125,"Illinois","Mason County",4,53,148,77,71
050,17,125,"Illinois","Mason County",4,54,153,80,73
050,17,125,"Illinois","Mason County",4,55,164,92,72
050,17,125,"Illinois","Mason County",4,56,170,88,82
050,17,125,"Illinois","Mason County",4,57,187,100,87
050,17,125,"Illinois","Mason County",4,58,194,90,104
050,17,125,"Illinois","Mason County",4,59,205,100,105
050,17,125,"Illinois","Mason County",4,60,222,108,114
050,17,125,"Illinois","Mason County",4,61,197,100,97
050,17,125,"Illinois","Mason County",4,62,195,99,96
050,17,125,"Illinois","Mason County",4,63,199,99,100
050,17,125,"Illinois","Mason County",4,64,193,95,98
050,17,125,"Illinois","Mason County",4,65,170,84,86
050,17,125,"Illinois","Mason County",4,66,167,87,80
050,17,125,"Illinois","Mason County",4,67,171,85,86
050,17,125,"Illinois","Mason County",4,68,167,76,91
050,17,125,"Illinois","Mason County",4,69,168,79,89
050,17,125,"Illinois","Mason County",4,70,165,83,82
050,17,125,"Illinois","Mason County",4,71,145,79,66
050,17,125,"Illinois","Mason County",4,72,147,82,65
050,17,125,"Illinois","Mason County",4,73,156,79,77
050,17,125,"Illinois","Mason County",4,74,143,70,73
050,17,125,"Illinois","Mason County",4,75,162,83,79
050,17,125,"Illinois","Mason County",4,76,108,46,62
050,17,125,"Illinois","Mason County",4,77,99,40,59
050,17,125,"Illinois","Mason County",4,78,104,46,58
050,17,125,"Illinois","Mason County",4,79,107,48,59
050,17,125,"Illinois","Mason County",4,80,95,51,44
050,17,125,"Illinois","Mason County",4,81,80,41,39
050,17,125,"Illinois","Mason County",4,82,69,42,27
050,17,125,"Illinois","Mason County",4,83,67,31,36
050,17,125,"Illinois","Mason County",4,84,60,24,36
050,17,125,"Illinois","Mason County",4,85,350,114,236
050,17,125,"Illinois","Mason County",5,0,85,38,47
050,17,125,"Illinois","Mason County",5,1,93,40,53
050,17,125,"Illinois","Mason County",5,2,94,45,49
050,17,125,"Illinois","Mason County",5,3,138,64,74
050,17,125,"Illinois","Mason County",5,4,138,76,62
050,17,125,"Illinois","Mason County",5,5,137,66,71
050,17,125,"Illinois","Mason County",5,6,138,75,63
050,17,125,"Illinois","Mason County",5,7,136,62,74
050,17,125,"Illinois","Mason County",5,8,142,70,72
050,17,125,"Illinois","Mason County",5,9,148,82,66
050,17,125,"Illinois","Mason County",5,10,134,75,59
050,17,125,"Illinois","Mason County",5,11,152,74,78
050,17,125,"Illinois","Mason County",5,12,146,77,69
050,17,125,"Illinois","Mason County",5,13,161,83,78
050,17,125,"Illinois","Mason County",5,14,159,78,81
050,17,125,"Illinois","Mason County",5,15,155,77,78
050,17,125,"Illinois","Mason County",5,16,175,89,86
050,17,125,"Illinois","Mason County",5,17,174,84,90
050,17,125,"Illinois","Mason County",5,18,148,74,74
050,17,125,"Illinois","Mason County",5,19,107,49,58
050,17,125,"Illinois","Mason County",5,20,115,57,58
050,17,125,"Illinois","Mason County",5,21,114,61,53
050,17,125,"Illinois","Mason County",5,22,126,67,59
050,17,125,"Illinois","Mason County",5,23,139,73,66
050,17,125,"Illinois","Mason County",5,24,132,68,64
050,17,125,"Illinois","Mason County",5,25,122,63,59
050,17,125,"Illinois","Mason County",5,26,133,60,73
050,17,125,"Illinois","Mason County",5,27,126,64,62
050,17,125,"Illinois","Mason County",5,28,126,68,58
050,17,125,"Illinois","Mason County",5,29,119,62,57
050,17,125,"Illinois","Mason County",5,30,144,78,66
050,17,125,"Illinois","Mason County",5,31,148,73,75
050,17,125,"Illinois","Mason County",5,32,145,76,69
050,17,125,"Illinois","Mason County",5,33,137,69,68
050,17,125,"Illinois","Mason County",5,34,144,69,75
050,17,125,"Illinois","Mason County",5,35,130,63,67
050,17,125,"Illinois","Mason County",5,36,105,58,47
050,17,125,"Illinois","Mason County",5,37,131,69,62
050,17,125,"Illinois","Mason County",5,38,139,75,64
050,17,125,"Illinois","Mason County",5,39,121,57,64
050,17,125,"Illinois","Mason County",5,40,147,66,81
050,17,125,"Illinois","Mason County",5,41,140,59,81
050,17,125,"Illinois","Mason County",5,42,154,69,85
050,17,125,"Illinois","Mason County",5,43,179,92,87
050,17,125,"Illinois","Mason County",5,44,166,97,69
050,17,125,"Illinois","Mason County",5,45,147,77,70
050,17,125,"Illinois","Mason County",5,46,156,75,81
050,17,125,"Illinois","Mason County",5,47,154,82,72
050,17,125,"Illinois","Mason County",5,48,163,81,82
050,17,125,"Illinois","Mason County",5,49,156,82,74
050,17,125,"Illinois","Mason County",5,50,160,81,79
050,17,125,"Illinois","Mason County",5,51,157,78,79
050,17,125,"Illinois","Mason County",5,52,166,88,78
050,17,125,"Illinois","Mason County",5,53,151,77,74
050,17,125,"Illinois","Mason County",5,54,150,77,73
050,17,125,"Illinois","Mason County",5,55,152,79,73
050,17,125,"Illinois","Mason County",5,56,162,91,71
050,17,125,"Illinois","Mason County",5,57,175,90,85
050,17,125,"Illinois","Mason County",5,58,187,96,91
050,17,125,"Illinois","Mason County",5,59,190,90,100
050,17,125,"Illinois","Mason County",5,60,206,102,104
050,17,125,"Illinois","Mason County",5,61,225,109,116
050,17,125,"Illinois","Mason County",5,62,191,97,94
050,17,125,"Illinois","Mason County",5,63,196,101,95
050,17,125,"Illinois","Mason County",5,64,197,97,100
050,17,125,"Illinois","Mason County",5,65,187,91,96
050,17,125,"Illinois","Mason County",5,66,172,84,88
050,17,125,"Illinois","Mason County",5,67,167,87,80
050,17,125,"Illinois","Mason County",5,68,174,88,86
050,17,125,"Illinois","Mason County",5,69,159,73,86
050,17,125,"Illinois","Mason County",5,70,165,77,88
050,17,125,"Illinois","Mason County",5,71,158,80,78
050,17,125,"Illinois","Mason County",5,72,136,72,64
050,17,125,"Illinois","Mason County",5,73,140,79,61
050,17,125,"Illinois","Mason County",5,74,148,75,73
050,17,125,"Illinois","Mason County",5,75,140,68,72
050,17,125,"Illinois","Mason County",5,76,148,76,72
050,17,125,"Illinois","Mason County",5,77,104,43,61
050,17,125,"Illinois","Mason County",5,78,93,40,53
050,17,125,"Illinois","Mason County",5,79,100,43,57
050,17,125,"Illinois","Mason County",5,80,100,43,57
050,17,125,"Illinois","Mason County",5,81,93,48,45
050,17,125,"Illinois","Mason County",5,82,73,39,34
050,17,125,"Illinois","Mason County",5,83,62,38,24
050,17,125,"Illinois","Mason County",5,84,64,33,31
050,17,125,"Illinois","Mason County",5,85,357,117,240
050,17,127,"Illinois","Massac County",1,0,136,71,65
050,17,127,"Illinois","Massac County",1,1,145,70,75
050,17,127,"Illinois","Massac County",1,2,150,74,76
050,17,127,"Illinois","Massac County",1,3,161,82,79
050,17,127,"Illinois","Massac County",1,4,166,82,84
050,17,127,"Illinois","Massac County",1,5,153,82,71
050,17,127,"Illinois","Massac County",1,6,159,94,65
050,17,127,"Illinois","Massac County",1,7,148,73,75
050,17,127,"Illinois","Massac County",1,8,156,74,82
050,17,127,"Illinois","Massac County",1,9,174,87,87
050,17,127,"Illinois","Massac County",1,10,186,95,91
050,17,127,"Illinois","Massac County",1,11,187,95,92
050,17,127,"Illinois","Massac County",1,12,189,89,100
050,17,127,"Illinois","Massac County",1,13,191,90,101
050,17,127,"Illinois","Massac County",1,14,188,85,103
050,17,127,"Illinois","Massac County",1,15,196,101,95
050,17,127,"Illinois","Massac County",1,16,193,101,92
050,17,127,"Illinois","Massac County",1,17,202,97,105
050,17,127,"Illinois","Massac County",1,18,166,83,83
050,17,127,"Illinois","Massac County",1,19,134,63,71
050,17,127,"Illinois","Massac County",1,20,128,65,63
050,17,127,"Illinois","Massac County",1,21,137,67,70
050,17,127,"Illinois","Massac County",1,22,146,74,72
050,17,127,"Illinois","Massac County",1,23,141,71,70
050,17,127,"Illinois","Massac County",1,24,134,69,65
050,17,127,"Illinois","Massac County",1,25,142,73,69
050,17,127,"Illinois","Massac County",1,26,170,83,87
050,17,127,"Illinois","Massac County",1,27,130,66,64
050,17,127,"Illinois","Massac County",1,28,137,74,63
050,17,127,"Illinois","Massac County",1,29,156,75,81
050,17,127,"Illinois","Massac County",1,30,150,75,75
050,17,127,"Illinois","Massac County",1,31,157,78,79
050,17,127,"Illinois","Massac County",1,32,113,62,51
050,17,127,"Illinois","Massac County",1,33,131,58,73
050,17,127,"Illinois","Massac County",1,34,148,73,75
050,17,127,"Illinois","Massac County",1,35,132,72,60
050,17,127,"Illinois","Massac County",1,36,138,68,70
050,17,127,"Illinois","Massac County",1,37,155,70,85
050,17,127,"Illinois","Massac County",1,38,177,82,95
050,17,127,"Illinois","Massac County",1,39,182,78,104
050,17,127,"Illinois","Massac County",1,40,175,78,97
050,17,127,"Illinois","Massac County",1,41,163,75,88
050,17,127,"Illinois","Massac County",1,42,168,83,85
050,17,127,"Illinois","Massac County",1,43,160,79,81
050,17,127,"Illinois","Massac County",1,44,181,92,89
050,17,127,"Illinois","Massac County",1,45,186,98,88
050,17,127,"Illinois","Massac County",1,46,176,79,97
050,17,127,"Illinois","Massac County",1,47,160,71,89
050,17,127,"Illinois","Massac County",1,48,178,88,90
050,17,127,"Illinois","Massac County",1,49,204,110,94
050,17,127,"Illinois","Massac County",1,50,208,114,94
050,17,127,"Illinois","Massac County",1,51,200,102,98
050,17,127,"Illinois","Massac County",1,52,181,87,94
050,17,127,"Illinois","Massac County",1,53,171,93,78
050,17,127,"Illinois","Massac County",1,54,186,94,92
050,17,127,"Illinois","Massac County",1,55,221,109,112
050,17,127,"Illinois","Massac County",1,56,219,114,105
050,17,127,"Illinois","Massac County",1,57,200,103,97
050,17,127,"Illinois","Massac County",1,58,218,115,103
050,17,127,"Illinois","Massac County",1,59,233,116,117
050,17,127,"Illinois","Massac County",1,60,237,107,130
050,17,127,"Illinois","Massac County",1,61,231,107,124
050,17,127,"Illinois","Massac County",1,62,225,107,118
050,17,127,"Illinois","Massac County",1,63,207,90,117
050,17,127,"Illinois","Massac County",1,64,222,99,123
050,17,127,"Illinois","Massac County",1,65,190,98,92
050,17,127,"Illinois","Massac County",1,66,189,96,93
050,17,127,"Illinois","Massac County",1,67,161,82,79
050,17,127,"Illinois","Massac County",1,68,139,65,74
050,17,127,"Illinois","Massac County",1,69,152,71,81
050,17,127,"Illinois","Massac County",1,70,175,88,87
050,17,127,"Illinois","Massac County",1,71,160,72,88
050,17,127,"Illinois","Massac County",1,72,145,66,79
050,17,127,"Illinois","Massac County",1,73,141,60,81
050,17,127,"Illinois","Massac County",1,74,114,53,61
050,17,127,"Illinois","Massac County",1,75,111,50,61
050,17,127,"Illinois","Massac County",1,76,128,58,70
050,17,127,"Illinois","Massac County",1,77,117,56,61
050,17,127,"Illinois","Massac County",1,78,117,47,70
050,17,127,"Illinois","Massac County",1,79,96,38,58
050,17,127,"Illinois","Massac County",1,80,81,36,45
050,17,127,"Illinois","Massac County",1,81,86,38,48
050,17,127,"Illinois","Massac County",1,82,80,35,45
050,17,127,"Illinois","Massac County",1,83,67,30,37
050,17,127,"Illinois","Massac County",1,84,65,28,37
050,17,127,"Illinois","Massac County",1,85,462,169,293
050,17,127,"Illinois","Massac County",2,0,136,73,63
050,17,127,"Illinois","Massac County",2,1,141,70,71
050,17,127,"Illinois","Massac County",2,2,149,73,76
050,17,127,"Illinois","Massac County",2,3,158,81,77
050,17,127,"Illinois","Massac County",2,4,163,82,81
050,17,127,"Illinois","Massac County",2,5,159,84,75
050,17,127,"Illinois","Massac County",2,6,157,90,67
050,17,127,"Illinois","Massac County",2,7,149,77,72
050,17,127,"Illinois","Massac County",2,8,154,74,80
050,17,127,"Illinois","Massac County",2,9,169,84,85
050,17,127,"Illinois","Massac County",2,10,180,92,88
050,17,127,"Illinois","Massac County",2,11,183,93,90
050,17,127,"Illinois","Massac County",2,12,189,91,98
050,17,127,"Illinois","Massac County",2,13,192,90,102
050,17,127,"Illinois","Massac County",2,14,186,86,100
050,17,127,"Illinois","Massac County",2,15,196,99,97
050,17,127,"Illinois","Massac County",2,16,193,100,93
050,17,127,"Illinois","Massac County",2,17,201,98,103
050,17,127,"Illinois","Massac County",2,18,167,81,86
050,17,127,"Illinois","Massac County",2,19,136,64,72
050,17,127,"Illinois","Massac County",2,20,133,67,66
050,17,127,"Illinois","Massac County",2,21,138,68,70
050,17,127,"Illinois","Massac County",2,22,144,72,72
050,17,127,"Illinois","Massac County",2,23,141,71,70
050,17,127,"Illinois","Massac County",2,24,137,70,67
050,17,127,"Illinois","Massac County",2,25,144,74,70
050,17,127,"Illinois","Massac County",2,26,165,81,84
050,17,127,"Illinois","Massac County",2,27,139,71,68
050,17,127,"Illinois","Massac County",2,28,136,73,63
050,17,127,"Illinois","Massac County",2,29,152,75,77
050,17,127,"Illinois","Massac County",2,30,152,76,76
050,17,127,"Illinois","Massac County",2,31,153,76,77
050,17,127,"Illinois","Massac County",2,32,125,67,58
050,17,127,"Illinois","Massac County",2,33,127,58,69
050,17,127,"Illinois","Massac County",2,34,145,71,74
050,17,127,"Illinois","Massac County",2,35,136,72,64
050,17,127,"Illinois","Massac County",2,36,136,68,68
050,17,127,"Illinois","Massac County",2,37,150,68,82
050,17,127,"Illinois","Massac County",2,38,171,78,93
050,17,127,"Illinois","Massac County",2,39,180,78,102
050,17,127,"Illinois","Massac County",2,40,177,78,99
050,17,127,"Illinois","Massac County",2,41,164,76,88
050,17,127,"Illinois","Massac County",2,42,165,80,85
050,17,127,"Illinois","Massac County",2,43,164,80,84
050,17,127,"Illinois","Massac County",2,44,175,88,87
050,17,127,"Illinois","Massac County",2,45,187,98,89
050,17,127,"Illinois","Massac County",2,46,176,82,94
050,17,127,"Illinois","Massac County",2,47,161,72,89
050,17,127,"Illinois","Massac County",2,48,172,84,88
050,17,127,"Illinois","Massac County",2,49,198,103,95
050,17,127,"Illinois","Massac County",2,50,207,112,95
050,17,127,"Illinois","Massac County",2,51,201,104,97
050,17,127,"Illinois","Massac County",2,52,182,90,92
050,17,127,"Illinois","Massac County",2,53,174,92,82
050,17,127,"Illinois","Massac County",2,54,181,93,88
050,17,127,"Illinois","Massac County",2,55,213,105,108
050,17,127,"Illinois","Massac County",2,56,219,113,106
050,17,127,"Illinois","Massac County",2,57,204,106,98
050,17,127,"Illinois","Massac County",2,58,213,111,102
050,17,127,"Illinois","Massac County",2,59,231,116,115
050,17,127,"Illinois","Massac County",2,60,234,107,127
050,17,127,"Illinois","Massac County",2,61,229,106,123
050,17,127,"Illinois","Massac County",2,62,227,107,120
050,17,127,"Illinois","Massac County",2,63,214,95,119
050,17,127,"Illinois","Massac County",2,64,215,95,120
050,17,127,"Illinois","Massac County",2,65,195,96,99
050,17,127,"Illinois","Massac County",2,66,189,96,93
050,17,127,"Illinois","Massac County",2,67,167,84,83
050,17,127,"Illinois","Massac County",2,68,142,69,73
050,17,127,"Illinois","Massac County",2,69,150,70,80
050,17,127,"Illinois","Massac County",2,70,170,84,86
050,17,127,"Illinois","Massac County",2,71,164,76,88
050,17,127,"Illinois","Massac County",2,72,145,66,79
050,17,127,"Illinois","Massac County",2,73,149,63,86
050,17,127,"Illinois","Massac County",2,74,111,52,59
050,17,127,"Illinois","Massac County",2,75,109,49,60
050,17,127,"Illinois","Massac County",2,76,122,56,66
050,17,127,"Illinois","Massac County",2,77,120,55,65
050,17,127,"Illinois","Massac County",2,78,116,49,67
050,17,127,"Illinois","Massac County",2,79,103,41,62
050,17,127,"Illinois","Massac County",2,80,81,35,46
050,17,127,"Illinois","Massac County",2,81,85,39,46
050,17,127,"Illinois","Massac County",2,82,78,34,44
050,17,127,"Illinois","Massac County",2,83,69,30,39
050,17,127,"Illinois","Massac County",2,84,63,27,36
050,17,127,"Illinois","Massac County",2,85,460,167,293
050,17,127,"Illinois","Massac County",3,0,124,65,59
050,17,127,"Illinois","Massac County",3,1,147,77,70
050,17,127,"Illinois","Massac County",3,2,140,67,73
050,17,127,"Illinois","Massac County",3,3,148,74,74
050,17,127,"Illinois","Massac County",3,4,170,90,80
050,17,127,"Illinois","Massac County",3,5,165,82,83
050,17,127,"Illinois","Massac County",3,6,155,77,78
050,17,127,"Illinois","Massac County",3,7,154,86,68
050,17,127,"Illinois","Massac County",3,8,148,78,70
050,17,127,"Illinois","Massac County",3,9,159,78,81
050,17,127,"Illinois","Massac County",3,10,164,82,82
050,17,127,"Illinois","Massac County",3,11,163,82,81
050,17,127,"Illinois","Massac County",3,12,177,91,86
050,17,127,"Illinois","Massac County",3,13,205,99,106
050,17,127,"Illinois","Massac County",3,14,178,89,89
050,17,127,"Illinois","Massac County",3,15,173,80,93
050,17,127,"Illinois","Massac County",3,16,195,100,95
050,17,127,"Illinois","Massac County",3,17,190,100,90
050,17,127,"Illinois","Massac County",3,18,166,80,86
050,17,127,"Illinois","Massac County",3,19,130,63,67
050,17,127,"Illinois","Massac County",3,20,145,67,78
050,17,127,"Illinois","Massac County",3,21,139,67,72
050,17,127,"Illinois","Massac County",3,22,148,79,69
050,17,127,"Illinois","Massac County",3,23,152,73,79
050,17,127,"Illinois","Massac County",3,24,139,69,70
050,17,127,"Illinois","Massac County",3,25,131,69,62
050,17,127,"Illinois","Massac County",3,26,134,72,62
050,17,127,"Illinois","Massac County",3,27,160,77,83
050,17,127,"Illinois","Massac County",3,28,132,63,69
050,17,127,"Illinois","Massac County",3,29,135,68,67
050,17,127,"Illinois","Massac County",3,30,156,72,84
050,17,127,"Illinois","Massac County",3,31,143,71,72
050,17,127,"Illinois","Massac County",3,32,160,86,74
050,17,127,"Illinois","Massac County",3,33,121,68,53
050,17,127,"Illinois","Massac County",3,34,122,59,63
050,17,127,"Illinois","Massac County",3,35,144,71,73
050,17,127,"Illinois","Massac County",3,36,138,73,65
050,17,127,"Illinois","Massac County",3,37,133,64,69
050,17,127,"Illinois","Massac County",3,38,154,67,87
050,17,127,"Illinois","Massac County",3,39,172,81,91
050,17,127,"Illinois","Massac County",3,40,180,79,101
050,17,127,"Illinois","Massac County",3,41,180,82,98
050,17,127,"Illinois","Massac County",3,42,168,77,91
050,17,127,"Illinois","Massac County",3,43,173,83,90
050,17,127,"Illinois","Massac County",3,44,165,83,82
050,17,127,"Illinois","Massac County",3,45,179,89,90
050,17,127,"Illinois","Massac County",3,46,194,101,93
050,17,127,"Illinois","Massac County",3,47,167,80,87
050,17,127,"Illinois","Massac County",3,48,156,73,83
050,17,127,"Illinois","Massac County",3,49,171,83,88
050,17,127,"Illinois","Massac County",3,50,201,103,98
050,17,127,"Illinois","Massac County",3,51,210,115,95
050,17,127,"Illinois","Massac County",3,52,192,97,95
050,17,127,"Illinois","Massac County",3,53,192,97,95
050,17,127,"Illinois","Massac County",3,54,170,90,80
050,17,127,"Illinois","Massac County",3,55,178,91,87
050,17,127,"Illinois","Massac County",3,56,209,105,104
050,17,127,"Illinois","Massac County",3,57,220,111,109
050,17,127,"Illinois","Massac County",3,58,203,106,97
050,17,127,"Illinois","Massac County",3,59,211,111,100
050,17,127,"Illinois","Massac County",3,60,232,114,118
050,17,127,"Illinois","Massac County",3,61,226,106,120
050,17,127,"Illinois","Massac County",3,62,226,109,117
050,17,127,"Illinois","Massac County",3,63,220,102,118
050,17,127,"Illinois","Massac County",3,64,208,91,117
050,17,127,"Illinois","Massac County",3,65,209,90,119
050,17,127,"Illinois","Massac County",3,66,187,92,95
050,17,127,"Illinois","Massac County",3,67,177,89,88
050,17,127,"Illinois","Massac County",3,68,162,82,80
050,17,127,"Illinois","Massac County",3,69,145,72,73
050,17,127,"Illinois","Massac County",3,70,148,69,79
050,17,127,"Illinois","Massac County",3,71,161,78,83
050,17,127,"Illinois","Massac County",3,72,155,75,80
050,17,127,"Illinois","Massac County",3,73,148,63,85
050,17,127,"Illinois","Massac County",3,74,147,64,83
050,17,127,"Illinois","Massac County",3,75,94,42,52
050,17,127,"Illinois","Massac County",3,76,99,43,56
050,17,127,"Illinois","Massac County",3,77,112,50,62
050,17,127,"Illinois","Massac County",3,78,118,56,62
050,17,127,"Illinois","Massac County",3,79,112,47,65
050,17,127,"Illinois","Massac County",3,80,92,37,55
050,17,127,"Illinois","Massac County",3,81,82,33,49
050,17,127,"Illinois","Massac County",3,82,69,32,37
050,17,127,"Illinois","Massac County",3,83,75,36,39
050,17,127,"Illinois","Massac County",3,84,66,24,42
050,17,127,"Illinois","Massac County",3,85,448,167,281
050,17,127,"Illinois","Massac County",4,0,107,57,50
050,17,127,"Illinois","Massac County",4,1,134,71,63
050,17,127,"Illinois","Massac County",4,2,154,77,77
050,17,127,"Illinois","Massac County",4,3,144,61,83
050,17,127,"Illinois","Massac County",4,4,153,73,80
050,17,127,"Illinois","Massac County",4,5,170,85,85
050,17,127,"Illinois","Massac County",4,6,156,78,78
050,17,127,"Illinois","Massac County",4,7,148,74,74
050,17,127,"Illinois","Massac County",4,8,162,91,71
050,17,127,"Illinois","Massac County",4,9,148,77,71
050,17,127,"Illinois","Massac County",4,10,161,85,76
050,17,127,"Illinois","Massac County",4,11,163,75,88
050,17,127,"Illinois","Massac County",4,12,172,90,82
050,17,127,"Illinois","Massac County",4,13,180,96,84
050,17,127,"Illinois","Massac County",4,14,197,92,105
050,17,127,"Illinois","Massac County",4,15,177,91,86
050,17,127,"Illinois","Massac County",4,16,178,85,93
050,17,127,"Illinois","Massac County",4,17,189,98,91
050,17,127,"Illinois","Massac County",4,18,160,89,71
050,17,127,"Illinois","Massac County",4,19,116,57,59
050,17,127,"Illinois","Massac County",4,20,131,58,73
050,17,127,"Illinois","Massac County",4,21,145,69,76
050,17,127,"Illinois","Massac County",4,22,143,69,74
050,17,127,"Illinois","Massac County",4,23,164,88,76
050,17,127,"Illinois","Massac County",4,24,158,74,84
050,17,127,"Illinois","Massac County",4,25,146,78,68
050,17,127,"Illinois","Massac County",4,26,134,74,60
050,17,127,"Illinois","Massac County",4,27,127,72,55
050,17,127,"Illinois","Massac County",4,28,155,71,84
050,17,127,"Illinois","Massac County",4,29,139,62,77
050,17,127,"Illinois","Massac County",4,30,143,74,69
050,17,127,"Illinois","Massac County",4,31,161,74,87
050,17,127,"Illinois","Massac County",4,32,139,71,68
050,17,127,"Illinois","Massac County",4,33,160,86,74
050,17,127,"Illinois","Massac County",4,34,114,67,47
050,17,127,"Illinois","Massac County",4,35,122,57,65
050,17,127,"Illinois","Massac County",4,36,145,68,77
050,17,127,"Illinois","Massac County",4,37,140,70,70
050,17,127,"Illinois","Massac County",4,38,141,65,76
050,17,127,"Illinois","Massac County",4,39,155,66,89
050,17,127,"Illinois","Massac County",4,40,181,92,89
050,17,127,"Illinois","Massac County",4,41,176,80,96
050,17,127,"Illinois","Massac County",4,42,179,80,99
050,17,127,"Illinois","Massac County",4,43,163,74,89
050,17,127,"Illinois","Massac County",4,44,175,88,87
050,17,127,"Illinois","Massac County",4,45,170,81,89
050,17,127,"Illinois","Massac County",4,46,166,79,87
050,17,127,"Illinois","Massac County",4,47,192,98,94
050,17,127,"Illinois","Massac County",4,48,166,83,83
050,17,127,"Illinois","Massac County",4,49,156,73,83
050,17,127,"Illinois","Massac County",4,50,165,82,83
050,17,127,"Illinois","Massac County",4,51,200,103,97
050,17,127,"Illinois","Massac County",4,52,206,113,93
050,17,127,"Illinois","Massac County",4,53,196,100,96
050,17,127,"Illinois","Massac County",4,54,192,93,99
050,17,127,"Illinois","Massac County",4,55,172,88,84
050,17,127,"Illinois","Massac County",4,56,182,95,87
050,17,127,"Illinois","Massac County",4,57,203,103,100
050,17,127,"Illinois","Massac County",4,58,219,110,109
050,17,127,"Illinois","Massac County",4,59,204,110,94
050,17,127,"Illinois","Massac County",4,60,212,109,103
050,17,127,"Illinois","Massac County",4,61,228,115,113
050,17,127,"Illinois","Massac County",4,62,218,100,118
050,17,127,"Illinois","Massac County",4,63,218,104,114
050,17,127,"Illinois","Massac County",4,64,218,99,119
050,17,127,"Illinois","Massac County",4,65,204,88,116
050,17,127,"Illinois","Massac County",4,66,199,87,112
050,17,127,"Illinois","Massac County",4,67,178,87,91
050,17,127,"Illinois","Massac County",4,68,173,91,82
050,17,127,"Illinois","Massac County",4,69,159,80,79
050,17,127,"Illinois","Massac County",4,70,143,70,73
050,17,127,"Illinois","Massac County",4,71,145,66,79
050,17,127,"Illinois","Massac County",4,72,159,75,84
050,17,127,"Illinois","Massac County",4,73,151,69,82
050,17,127,"Illinois","Massac County",4,74,141,62,79
050,17,127,"Illinois","Massac County",4,75,131,58,73
050,17,127,"Illinois","Massac County",4,76,92,39,53
050,17,127,"Illinois","Massac County",4,77,93,38,55
050,17,127,"Illinois","Massac County",4,78,109,51,58
050,17,127,"Illinois","Massac County",4,79,109,52,57
050,17,127,"Illinois","Massac County",4,80,99,40,59
050,17,127,"Illinois","Massac County",4,81,96,38,58
050,17,127,"Illinois","Massac County",4,82,70,27,43
050,17,127,"Illinois","Massac County",4,83,63,32,31
050,17,127,"Illinois","Massac County",4,84,70,30,40
050,17,127,"Illinois","Massac County",4,85,455,165,290
050,17,127,"Illinois","Massac County",5,0,79,44,35
050,17,127,"Illinois","Massac County",5,1,102,54,48
050,17,127,"Illinois","Massac County",5,2,135,68,67
050,17,127,"Illinois","Massac County",5,3,154,80,74
050,17,127,"Illinois","Massac County",5,4,142,64,78
050,17,127,"Illinois","Massac County",5,5,146,69,77
050,17,127,"Illinois","Massac County",5,6,162,79,83
050,17,127,"Illinois","Massac County",5,7,157,82,75
050,17,127,"Illinois","Massac County",5,8,149,76,73
050,17,127,"Illinois","Massac County",5,9,153,85,68
050,17,127,"Illinois","Massac County",5,10,158,85,73
050,17,127,"Illinois","Massac County",5,11,161,83,78
050,17,127,"Illinois","Massac County",5,12,152,71,81
050,17,127,"Illinois","Massac County",5,13,170,84,86
050,17,127,"Illinois","Massac County",5,14,176,92,84
050,17,127,"Illinois","Massac County",5,15,203,95,108
050,17,127,"Illinois","Massac County",5,16,183,93,90
050,17,127,"Illinois","Massac County",5,17,184,86,98
050,17,127,"Illinois","Massac County",5,18,160,87,73
050,17,127,"Illinois","Massac County",5,19,124,70,54
050,17,127,"Illinois","Massac County",5,20,128,61,67
050,17,127,"Illinois","Massac County",5,21,134,59,75
050,17,127,"Illinois","Massac County",5,22,154,72,82
050,17,127,"Illinois","Massac County",5,23,152,73,79
050,17,127,"Illinois","Massac County",5,24,159,82,77
050,17,127,"Illinois","Massac County",5,25,174,84,90
050,17,127,"Illinois","Massac County",5,26,136,72,64
050,17,127,"Illinois","Massac County",5,27,128,70,58
050,17,127,"Illinois","Massac County",5,28,123,67,56
050,17,127,"Illinois","Massac County",5,29,148,69,79
050,17,127,"Illinois","Massac County",5,30,145,68,77
050,17,127,"Illinois","Massac County",5,31,136,74,62
050,17,127,"Illinois","Massac County",5,32,174,79,95
050,17,127,"Illinois","Massac County",5,33,132,62,70
050,17,127,"Illinois","Massac County",5,34,163,86,77
050,17,127,"Illinois","Massac County",5,35,116,65,51
050,17,127,"Illinois","Massac County",5,36,126,58,68
050,17,127,"Illinois","Massac County",5,37,148,71,77
050,17,127,"Illinois","Massac County",5,38,139,74,65
050,17,127,"Illinois","Massac County",5,39,139,62,77
050,17,127,"Illinois","Massac County",5,40,154,66,88
050,17,127,"Illinois","Massac County",5,41,179,85,94
050,17,127,"Illinois","Massac County",5,42,173,81,92
050,17,127,"Illinois","Massac County",5,43,178,78,100
050,17,127,"Illinois","Massac County",5,44,161,77,84
050,17,127,"Illinois","Massac County",5,45,172,85,87
050,17,127,"Illinois","Massac County",5,46,169,81,88
050,17,127,"Illinois","Massac County",5,47,161,77,84
050,17,127,"Illinois","Massac County",5,48,190,99,91
050,17,127,"Illinois","Massac County",5,49,168,84,84
050,17,127,"Illinois","Massac County",5,50,160,71,89
050,17,127,"Illinois","Massac County",5,51,168,84,84
050,17,127,"Illinois","Massac County",5,52,203,106,97
050,17,127,"Illinois","Massac County",5,53,203,113,90
050,17,127,"Illinois","Massac County",5,54,188,96,92
050,17,127,"Illinois","Massac County",5,55,194,91,103
050,17,127,"Illinois","Massac County",5,56,171,90,81
050,17,127,"Illinois","Massac County",5,57,182,96,86
050,17,127,"Illinois","Massac County",5,58,205,106,99
050,17,127,"Illinois","Massac County",5,59,220,113,107
050,17,127,"Illinois","Massac County",5,60,205,111,94
050,17,127,"Illinois","Massac County",5,61,212,112,100
050,17,127,"Illinois","Massac County",5,62,226,114,112
050,17,127,"Illinois","Massac County",5,63,207,97,110
050,17,127,"Illinois","Massac County",5,64,220,105,115
050,17,127,"Illinois","Massac County",5,65,221,97,124
050,17,127,"Illinois","Massac County",5,66,200,88,112
050,17,127,"Illinois","Massac County",5,67,189,79,110
050,17,127,"Illinois","Massac County",5,68,175,86,89
050,17,127,"Illinois","Massac County",5,69,169,88,81
050,17,127,"Illinois","Massac County",5,70,161,81,80
050,17,127,"Illinois","Massac County",5,71,137,65,72
050,17,127,"Illinois","Massac County",5,72,143,63,80
050,17,127,"Illinois","Massac County",5,73,155,68,87
050,17,127,"Illinois","Massac County",5,74,144,69,75
050,17,127,"Illinois","Massac County",5,75,123,56,67
050,17,127,"Illinois","Massac County",5,76,129,55,74
050,17,127,"Illinois","Massac County",5,77,79,32,47
050,17,127,"Illinois","Massac County",5,78,91,39,52
050,17,127,"Illinois","Massac County",5,79,108,51,57
050,17,127,"Illinois","Massac County",5,80,96,44,52
050,17,127,"Illinois","Massac County",5,81,100,41,59
050,17,127,"Illinois","Massac County",5,82,85,33,52
050,17,127,"Illinois","Massac County",5,83,59,25,34
050,17,127,"Illinois","Massac County",5,84,58,25,33
050,17,127,"Illinois","Massac County",5,85,466,172,294
050,17,129,"Illinois","Menard County",1,0,109,58,51
050,17,129,"Illinois","Menard County",1,1,114,67,47
050,17,129,"Illinois","Menard County",1,2,131,65,66
050,17,129,"Illinois","Menard County",1,3,158,69,89
050,17,129,"Illinois","Menard County",1,4,147,79,68
050,17,129,"Illinois","Menard County",1,5,130,63,67
050,17,129,"Illinois","Menard County",1,6,144,81,63
050,17,129,"Illinois","Menard County",1,7,139,75,64
050,17,129,"Illinois","Menard County",1,8,144,79,65
050,17,129,"Illinois","Menard County",1,9,135,65,70
050,17,129,"Illinois","Menard County",1,10,156,79,77
050,17,129,"Illinois","Menard County",1,11,175,87,88
050,17,129,"Illinois","Menard County",1,12,164,80,84
050,17,129,"Illinois","Menard County",1,13,189,92,97
050,17,129,"Illinois","Menard County",1,14,170,84,86
050,17,129,"Illinois","Menard County",1,15,170,89,81
050,17,129,"Illinois","Menard County",1,16,173,90,83
050,17,129,"Illinois","Menard County",1,17,171,89,82
050,17,129,"Illinois","Menard County",1,18,134,73,61
050,17,129,"Illinois","Menard County",1,19,104,54,50
050,17,129,"Illinois","Menard County",1,20,104,55,49
050,17,129,"Illinois","Menard County",1,21,112,58,54
050,17,129,"Illinois","Menard County",1,22,112,63,49
050,17,129,"Illinois","Menard County",1,23,131,71,60
050,17,129,"Illinois","Menard County",1,24,123,68,55
050,17,129,"Illinois","Menard County",1,25,110,50,60
050,17,129,"Illinois","Menard County",1,26,121,60,61
050,17,129,"Illinois","Menard County",1,27,124,61,63
050,17,129,"Illinois","Menard County",1,28,127,53,74
050,17,129,"Illinois","Menard County",1,29,146,68,78
050,17,129,"Illinois","Menard County",1,30,137,65,72
050,17,129,"Illinois","Menard County",1,31,149,67,82
050,17,129,"Illinois","Menard County",1,32,146,76,70
050,17,129,"Illinois","Menard County",1,33,141,75,66
050,17,129,"Illinois","Menard County",1,34,131,60,71
050,17,129,"Illinois","Menard County",1,35,132,64,68
050,17,129,"Illinois","Menard County",1,36,158,76,82
050,17,129,"Illinois","Menard County",1,37,159,74,85
050,17,129,"Illinois","Menard County",1,38,171,78,93
050,17,129,"Illinois","Menard County",1,39,183,94,89
050,17,129,"Illinois","Menard County",1,40,166,85,81
050,17,129,"Illinois","Menard County",1,41,147,81,66
050,17,129,"Illinois","Menard County",1,42,150,72,78
050,17,129,"Illinois","Menard County",1,43,147,71,76
050,17,129,"Illinois","Menard County",1,44,160,80,80
050,17,129,"Illinois","Menard County",1,45,145,76,69
050,17,129,"Illinois","Menard County",1,46,131,67,64
050,17,129,"Illinois","Menard County",1,47,132,69,63
050,17,129,"Illinois","Menard County",1,48,148,72,76
050,17,129,"Illinois","Menard County",1,49,153,73,80
050,17,129,"Illinois","Menard County",1,50,141,71,70
050,17,129,"Illinois","Menard County",1,51,151,66,85
050,17,129,"Illinois","Menard County",1,52,160,81,79
050,17,129,"Illinois","Menard County",1,53,159,74,85
050,17,129,"Illinois","Menard County",1,54,170,89,81
050,17,129,"Illinois","Menard County",1,55,211,102,109
050,17,129,"Illinois","Menard County",1,56,203,101,102
050,17,129,"Illinois","Menard County",1,57,213,103,110
050,17,129,"Illinois","Menard County",1,58,208,98,110
050,17,129,"Illinois","Menard County",1,59,194,92,102
050,17,129,"Illinois","Menard County",1,60,177,93,84
050,17,129,"Illinois","Menard County",1,61,196,103,93
050,17,129,"Illinois","Menard County",1,62,203,105,98
050,17,129,"Illinois","Menard County",1,63,195,104,91
050,17,129,"Illinois","Menard County",1,64,188,99,89
050,17,129,"Illinois","Menard County",1,65,160,79,81
050,17,129,"Illinois","Menard County",1,66,161,75,86
050,17,129,"Illinois","Menard County",1,67,152,74,78
050,17,129,"Illinois","Menard County",1,68,149,73,76
050,17,129,"Illinois","Menard County",1,69,139,62,77
050,17,129,"Illinois","Menard County",1,70,147,64,83
050,17,129,"Illinois","Menard County",1,71,155,77,78
050,17,129,"Illinois","Menard County",1,72,145,80,65
050,17,129,"Illinois","Menard County",1,73,134,66,68
050,17,129,"Illinois","Menard County",1,74,89,38,51
050,17,129,"Illinois","Menard County",1,75,104,41,63
050,17,129,"Illinois","Menard County",1,76,92,40,52
050,17,129,"Illinois","Menard County",1,77,78,36,42
050,17,129,"Illinois","Menard County",1,78,64,30,34
050,17,129,"Illinois","Menard County",1,79,62,30,32
050,17,129,"Illinois","Menard County",1,80,66,28,38
050,17,129,"Illinois","Menard County",1,81,64,27,37
050,17,129,"Illinois","Menard County",1,82,54,20,34
050,17,129,"Illinois","Menard County",1,83,54,26,28
050,17,129,"Illinois","Menard County",1,84,40,17,23
050,17,129,"Illinois","Menard County",1,85,264,93,171
050,17,129,"Illinois","Menard County",2,0,110,53,57
050,17,129,"Illinois","Menard County",2,1,114,65,49
050,17,129,"Illinois","Menard County",2,2,128,65,63
050,17,129,"Illinois","Menard County",2,3,153,69,84
050,17,129,"Illinois","Menard County",2,4,153,78,75
050,17,129,"Illinois","Menard County",2,5,133,68,65
050,17,129,"Illinois","Menard County",2,6,140,76,64
050,17,129,"Illinois","Menard County",2,7,141,77,64
050,17,129,"Illinois","Menard County",2,8,142,76,66
050,17,129,"Illinois","Menard County",2,9,137,69,68
050,17,129,"Illinois","Menard County",2,10,152,76,76
050,17,129,"Illinois","Menard County",2,11,170,85,85
050,17,129,"Illinois","Menard County",2,12,167,82,85
050,17,129,"Illinois","Menard County",2,13,183,90,93
050,17,129,"Illinois","Menard County",2,14,176,87,89
050,17,129,"Illinois","Menard County",2,15,172,89,83
050,17,129,"Illinois","Menard County",2,16,170,89,81
050,17,129,"Illinois","Menard County",2,17,170,88,82
050,17,129,"Illinois","Menard County",2,18,133,73,60
050,17,129,"Illinois","Menard County",2,19,101,53,48
050,17,129,"Illinois","Menard County",2,20,105,56,49
050,17,129,"Illinois","Menard County",2,21,106,56,50
050,17,129,"Illinois","Menard County",2,22,113,63,50
050,17,129,"Illinois","Menard County",2,23,125,68,57
050,17,129,"Illinois","Menard County",2,24,122,66,56
050,17,129,"Illinois","Menard County",2,25,112,53,59
050,17,129,"Illinois","Menard County",2,26,120,58,62
050,17,129,"Illinois","Menard County",2,27,124,60,64
050,17,129,"Illinois","Menard County",2,28,128,55,73
050,17,129,"Illinois","Menard County",2,29,144,64,80
050,17,129,"Illinois","Menard County",2,30,142,67,75
050,17,129,"Illinois","Menard County",2,31,145,66,79
050,17,129,"Illinois","Menard County",2,32,145,74,71
050,17,129,"Illinois","Menard County",2,33,143,76,67
050,17,129,"Illinois","Menard County",2,34,132,63,69
050,17,129,"Illinois","Menard County",2,35,133,63,70
050,17,129,"Illinois","Menard County",2,36,152,74,78
050,17,129,"Illinois","Menard County",2,37,159,74,85
050,17,129,"Illinois","Menard County",2,38,169,78,91
050,17,129,"Illinois","Menard County",2,39,181,91,90
050,17,129,"Illinois","Menard County",2,40,171,88,83
050,17,129,"Illinois","Menard County",2,41,151,83,68
050,17,129,"Illinois","Menard County",2,42,146,73,73
050,17,129,"Illinois","Menard County",2,43,147,72,75
050,17,129,"Illinois","Menard County",2,44,154,77,77
050,17,129,"Illinois","Menard County",2,45,151,78,73
050,17,129,"Illinois","Menard County",2,46,134,69,65
050,17,129,"Illinois","Menard County",2,47,131,68,63
050,17,129,"Illinois","Menard County",2,48,145,71,74
050,17,129,"Illinois","Menard County",2,49,154,74,80
050,17,129,"Illinois","Menard County",2,50,144,71,73
050,17,129,"Illinois","Menard County",2,51,149,67,82
050,17,129,"Illinois","Menard County",2,52,157,76,81
050,17,129,"Illinois","Menard County",2,53,160,76,84
050,17,129,"Illinois","Menard County",2,54,166,86,80
050,17,129,"Illinois","Menard County",2,55,203,99,104
050,17,129,"Illinois","Menard County",2,56,206,102,104
050,17,129,"Illinois","Menard County",2,57,211,103,108
050,17,129,"Illinois","Menard County",2,58,208,98,110
050,17,129,"Illinois","Menard County",2,59,195,92,103
050,17,129,"Illinois","Menard County",2,60,181,92,89
050,17,129,"Illinois","Menard County",2,61,188,99,89
050,17,129,"Illinois","Menard County",2,62,199,104,95
050,17,129,"Illinois","Menard County",2,63,201,106,95
050,17,129,"Illinois","Menard County",2,64,188,100,88
050,17,129,"Illinois","Menard County",2,65,164,82,82
050,17,129,"Illinois","Menard County",2,66,160,76,84
050,17,129,"Illinois","Menard County",2,67,152,72,80
050,17,129,"Illinois","Menard County",2,68,145,70,75
050,17,129,"Illinois","Menard County",2,69,141,65,76
050,17,129,"Illinois","Menard County",2,70,144,63,81
050,17,129,"Illinois","Menard County",2,71,153,74,79
050,17,129,"Illinois","Menard County",2,72,142,77,65
050,17,129,"Illinois","Menard County",2,73,143,73,70
050,17,129,"Illinois","Menard County",2,74,94,42,52
050,17,129,"Illinois","Menard County",2,75,100,40,60
050,17,129,"Illinois","Menard County",2,76,93,39,54
050,17,129,"Illinois","Menard County",2,77,84,38,46
050,17,129,"Illinois","Menard County",2,78,65,30,35
050,17,129,"Illinois","Menard County",2,79,61,29,32
050,17,129,"Illinois","Menard County",2,80,66,29,37
050,17,129,"Illinois","Menard County",2,81,63,27,36
050,17,129,"Illinois","Menard County",2,82,55,20,35
050,17,129,"Illinois","Menard County",2,83,54,25,29
050,17,129,"Illinois","Menard County",2,84,43,19,24
050,17,129,"Illinois","Menard County",2,85,263,94,169
050,17,129,"Illinois","Menard County",3,0,121,65,56
050,17,129,"Illinois","Menard County",3,1,116,57,59
050,17,129,"Illinois","Menard County",3,2,121,71,50
050,17,129,"Illinois","Menard County",3,3,121,58,63
050,17,129,"Illinois","Menard County",3,4,154,70,84
050,17,129,"Illinois","Menard County",3,5,145,74,71
050,17,129,"Illinois","Menard County",3,6,145,75,70
050,17,129,"Illinois","Menard County",3,7,140,74,66
050,17,129,"Illinois","Menard County",3,8,147,78,69
050,17,129,"Illinois","Menard County",3,9,142,77,65
050,17,129,"Illinois","Menard County",3,10,137,68,69
050,17,129,"Illinois","Menard County",3,11,150,71,79
050,17,129,"Illinois","Menard County",3,12,176,90,86
050,17,129,"Illinois","Menard County",3,13,167,81,86
050,17,129,"Illinois","Menard County",3,14,168,80,88
050,17,129,"Illinois","Menard County",3,15,173,87,86
050,17,129,"Illinois","Menard County",3,16,164,84,80
050,17,129,"Illinois","Menard County",3,17,167,89,78
050,17,129,"Illinois","Menard County",3,18,144,76,68
050,17,129,"Illinois","Menard County",3,19,101,55,46
050,17,129,"Illinois","Menard County",3,20,106,53,53
050,17,129,"Illinois","Menard County",3,21,103,58,45
050,17,129,"Illinois","Menard County",3,22,107,58,49
050,17,129,"Illinois","Menard County",3,23,116,66,50
050,17,129,"Illinois","Menard County",3,24,123,63,60
050,17,129,"Illinois","Menard County",3,25,122,63,59
050,17,129,"Illinois","Menard County",3,26,109,50,59
050,17,129,"Illinois","Menard County",3,27,118,52,66
050,17,129,"Illinois","Menard County",3,28,128,64,64
050,17,129,"Illinois","Menard County",3,29,132,61,71
050,17,129,"Illinois","Menard County",3,30,154,71,83
050,17,129,"Illinois","Menard County",3,31,145,68,77
050,17,129,"Illinois","Menard County",3,32,139,59,80
050,17,129,"Illinois","Menard County",3,33,146,73,73
050,17,129,"Illinois","Menard County",3,34,148,73,75
050,17,129,"Illinois","Menard County",3,35,132,65,67
050,17,129,"Illinois","Menard County",3,36,135,59,76
050,17,129,"Illinois","Menard County",3,37,149,75,74
050,17,129,"Illinois","Menard County",3,38,161,77,84
050,17,129,"Illinois","Menard County",3,39,161,78,83
050,17,129,"Illinois","Menard County",3,40,187,97,90
050,17,129,"Illinois","Menard County",3,41,162,85,77
050,17,129,"Illinois","Menard County",3,42,153,81,72
050,17,129,"Illinois","Menard County",3,43,141,71,70
050,17,129,"Illinois","Menard County",3,44,152,76,76
050,17,129,"Illinois","Menard County",3,45,145,72,73
050,17,129,"Illinois","Menard County",3,46,147,80,67
050,17,129,"Illinois","Menard County",3,47,136,72,64
050,17,129,"Illinois","Menard County",3,48,130,70,60
050,17,129,"Illinois","Menard County",3,49,141,66,75
050,17,129,"Illinois","Menard County",3,50,153,71,82
050,17,129,"Illinois","Menard County",3,51,142,70,72
050,17,129,"Illinois","Menard County",3,52,150,68,82
050,17,129,"Illinois","Menard County",3,53,156,74,82
050,17,129,"Illinois","Menard County",3,54,165,80,85
050,17,129,"Illinois","Menard County",3,55,167,82,85
050,17,129,"Illinois","Menard County",3,56,194,91,103
050,17,129,"Illinois","Menard County",3,57,205,102,103
050,17,129,"Illinois","Menard County",3,58,204,100,104
050,17,129,"Illinois","Menard County",3,59,206,98,108
050,17,129,"Illinois","Menard County",3,60,191,92,99
050,17,129,"Illinois","Menard County",3,61,181,91,90
050,17,129,"Illinois","Menard County",3,62,182,96,86
050,17,129,"Illinois","Menard County",3,63,195,101,94
050,17,129,"Illinois","Menard County",3,64,196,103,93
050,17,129,"Illinois","Menard County",3,65,185,99,86
050,17,129,"Illinois","Menard County",3,66,161,79,82
050,17,129,"Illinois","Menard County",3,67,156,75,81
050,17,129,"Illinois","Menard County",3,68,146,69,77
050,17,129,"Illinois","Menard County",3,69,141,69,72
050,17,129,"Illinois","Menard County",3,70,139,67,72
050,17,129,"Illinois","Menard County",3,71,145,65,80
050,17,129,"Illinois","Menard County",3,72,147,70,77
050,17,129,"Illinois","Menard County",3,73,136,74,62
050,17,129,"Illinois","Menard County",3,74,138,71,67
050,17,129,"Illinois","Menard County",3,75,92,40,52
050,17,129,"Illinois","Menard County",3,76,93,38,55
050,17,129,"Illinois","Menard County",3,77,92,37,55
050,17,129,"Illinois","Menard County",3,78,79,37,42
050,17,129,"Illinois","Menard County",3,79,61,28,33
050,17,129,"Illinois","Menard County",3,80,61,29,32
050,17,129,"Illinois","Menard County",3,81,58,23,35
050,17,129,"Illinois","Menard County",3,82,56,25,31
050,17,129,"Illinois","Menard County",3,83,53,22,31
050,17,129,"Illinois","Menard County",3,84,48,20,28
050,17,129,"Illinois","Menard County",3,85,266,95,171
050,17,129,"Illinois","Menard County",4,0,112,54,58
050,17,129,"Illinois","Menard County",4,1,134,61,73
050,17,129,"Illinois","Menard County",4,2,120,61,59
050,17,129,"Illinois","Menard County",4,3,122,73,49
050,17,129,"Illinois","Menard County",4,4,120,59,61
050,17,129,"Illinois","Menard County",4,5,152,70,82
050,17,129,"Illinois","Menard County",4,6,139,70,69
050,17,129,"Illinois","Menard County",4,7,138,71,67
050,17,129,"Illinois","Menard County",4,8,144,78,66
050,17,129,"Illinois","Menard County",4,9,149,77,72
050,17,129,"Illinois","Menard County",4,10,131,73,58
050,17,129,"Illinois","Menard County",4,11,147,76,71
050,17,129,"Illinois","Menard County",4,12,149,73,76
050,17,129,"Illinois","Menard County",4,13,175,91,84
050,17,129,"Illinois","Menard County",4,14,171,81,90
050,17,129,"Illinois","Menard County",4,15,172,82,90
050,17,129,"Illinois","Menard County",4,16,171,83,88
050,17,129,"Illinois","Menard County",4,17,157,78,79
050,17,129,"Illinois","Menard County",4,18,130,70,60
050,17,129,"Illinois","Menard County",4,19,104,55,49
050,17,129,"Illinois","Menard County",4,20,108,59,49
050,17,129,"Illinois","Menard County",4,21,118,59,59
050,17,129,"Illinois","Menard County",4,22,111,60,51
050,17,129,"Illinois","Menard County",4,23,112,55,57
050,17,129,"Illinois","Menard County",4,24,116,70,46
050,17,129,"Illinois","Menard County",4,25,130,65,65
050,17,129,"Illinois","Menard County",4,26,128,68,60
050,17,129,"Illinois","Menard County",4,27,109,53,56
050,17,129,"Illinois","Menard County",4,28,117,49,68
050,17,129,"Illinois","Menard County",4,29,125,58,67
050,17,129,"Illinois","Menard County",4,30,133,57,76
050,17,129,"Illinois","Menard County",4,31,148,71,77
050,17,129,"Illinois","Menard County",4,32,145,69,76
050,17,129,"Illinois","Menard County",4,33,136,62,74
050,17,129,"Illinois","Menard County",4,34,141,72,69
050,17,129,"Illinois","Menard County",4,35,153,75,78
050,17,129,"Illinois","Menard County",4,36,140,69,71
050,17,129,"Illinois","Menard County",4,37,138,62,76
050,17,129,"Illinois","Menard County",4,38,151,72,79
050,17,129,"Illinois","Menard County",4,39,163,77,86
050,17,129,"Illinois","Menard County",4,40,161,80,81
050,17,129,"Illinois","Menard County",4,41,186,92,94
050,17,129,"Illinois","Menard County",4,42,158,86,72
050,17,129,"Illinois","Menard County",4,43,145,80,65
050,17,129,"Illinois","Menard County",4,44,136,67,69
050,17,129,"Illinois","Menard County",4,45,153,78,75
050,17,129,"Illinois","Menard County",4,46,147,73,74
050,17,129,"Illinois","Menard County",4,47,145,75,70
050,17,129,"Illinois","Menard County",4,48,137,75,62
050,17,129,"Illinois","Menard County",4,49,129,69,60
050,17,129,"Illinois","Menard County",4,50,140,62,78
050,17,129,"Illinois","Menard County",4,51,151,70,81
050,17,129,"Illinois","Menard County",4,52,146,72,74
050,17,129,"Illinois","Menard County",4,53,148,69,79
050,17,129,"Illinois","Menard County",4,54,154,73,81
050,17,129,"Illinois","Menard County",4,55,163,79,84
050,17,129,"Illinois","Menard County",4,56,166,80,86
050,17,129,"Illinois","Menard County",4,57,191,88,103
050,17,129,"Illinois","Menard County",4,58,206,102,104
050,17,129,"Illinois","Menard County",4,59,206,100,106
050,17,129,"Illinois","Menard County",4,60,204,99,105
050,17,129,"Illinois","Menard County",4,61,189,87,102
050,17,129,"Illinois","Menard County",4,62,187,96,91
050,17,129,"Illinois","Menard County",4,63,186,94,92
050,17,129,"Illinois","Menard County",4,64,189,94,95
050,17,129,"Illinois","Menard County",4,65,194,102,92
050,17,129,"Illinois","Menard County",4,66,175,94,81
050,17,129,"Illinois","Menard County",4,67,150,78,72
050,17,129,"Illinois","Menard County",4,68,161,78,83
050,17,129,"Illinois","Menard County",4,69,146,73,73
050,17,129,"Illinois","Menard County",4,70,139,70,69
050,17,129,"Illinois","Menard County",4,71,136,66,70
050,17,129,"Illinois","Menard County",4,72,135,57,78
050,17,129,"Illinois","Menard County",4,73,139,65,74
050,17,129,"Illinois","Menard County",4,74,131,73,58
050,17,129,"Illinois","Menard County",4,75,130,62,68
050,17,129,"Illinois","Menard County",4,76,85,37,48
050,17,129,"Illinois","Menard County",4,77,92,35,57
050,17,129,"Illinois","Menard County",4,78,81,33,48
050,17,129,"Illinois","Menard County",4,79,70,32,38
050,17,129,"Illinois","Menard County",4,80,63,27,36
050,17,129,"Illinois","Menard County",4,81,57,24,33
050,17,129,"Illinois","Menard County",4,82,50,20,30
050,17,129,"Illinois","Menard County",4,83,53,28,25
050,17,129,"Illinois","Menard County",4,84,43,16,27
050,17,129,"Illinois","Menard County",4,85,260,93,167
050,17,129,"Illinois","Menard County",5,0,109,52,57
050,17,129,"Illinois","Menard County",5,1,118,56,62
050,17,129,"Illinois","Menard County",5,2,143,64,79
050,17,129,"Illinois","Menard County",5,3,110,53,57
050,17,129,"Illinois","Menard County",5,4,131,79,52
050,17,129,"Illinois","Menard County",5,5,116,55,61
050,17,129,"Illinois","Menard County",5,6,147,72,75
050,17,129,"Illinois","Menard County",5,7,141,70,71
050,17,129,"Illinois","Menard County",5,8,128,62,66
050,17,129,"Illinois","Menard County",5,9,143,78,65
050,17,129,"Illinois","Menard County",5,10,142,70,72
050,17,129,"Illinois","Menard County",5,11,134,73,61
050,17,129,"Illinois","Menard County",5,12,153,79,74
050,17,129,"Illinois","Menard County",5,13,157,76,81
050,17,129,"Illinois","Menard County",5,14,173,89,84
050,17,129,"Illinois","Menard County",5,15,172,80,92
050,17,129,"Illinois","Menard County",5,16,177,86,91
050,17,129,"Illinois","Menard County",5,17,166,81,85
050,17,129,"Illinois","Menard County",5,18,126,64,62
050,17,129,"Illinois","Menard County",5,19,88,50,38
050,17,129,"Illinois","Menard County",5,20,113,59,54
050,17,129,"Illinois","Menard County",5,21,105,58,47
050,17,129,"Illinois","Menard County",5,22,128,58,70
050,17,129,"Illinois","Menard County",5,23,112,56,56
050,17,129,"Illinois","Menard County",5,24,109,58,51
050,17,129,"Illinois","Menard County",5,25,114,67,47
050,17,129,"Illinois","Menard County",5,26,121,59,62
050,17,129,"Illinois","Menard County",5,27,118,63,55
050,17,129,"Illinois","Menard County",5,28,104,47,57
050,17,129,"Illinois","Menard County",5,29,123,52,71
050,17,129,"Illinois","Menard County",5,30,122,56,66
050,17,129,"Illinois","Menard County",5,31,129,57,72
050,17,129,"Illinois","Menard County",5,32,146,69,77
050,17,129,"Illinois","Menard County",5,33,151,68,83
050,17,129,"Illinois","Menard County",5,34,144,67,77
050,17,129,"Illinois","Menard County",5,35,141,75,66
050,17,129,"Illinois","Menard County",5,36,150,74,76
050,17,129,"Illinois","Menard County",5,37,139,72,67
050,17,129,"Illinois","Menard County",5,38,143,65,78
050,17,129,"Illinois","Menard County",5,39,153,73,80
050,17,129,"Illinois","Menard County",5,40,167,79,88
050,17,129,"Illinois","Menard County",5,41,158,81,77
050,17,129,"Illinois","Menard County",5,42,192,94,98
050,17,129,"Illinois","Menard County",5,43,160,85,75
050,17,129,"Illinois","Menard County",5,44,146,81,65
050,17,129,"Illinois","Menard County",5,45,134,67,67
050,17,129,"Illinois","Menard County",5,46,149,72,77
050,17,129,"Illinois","Menard County",5,47,153,74,79
050,17,129,"Illinois","Menard County",5,48,150,80,70
050,17,129,"Illinois","Menard County",5,49,141,77,64
050,17,129,"Illinois","Menard County",5,50,130,71,59
050,17,129,"Illinois","Menard County",5,51,137,61,76
050,17,129,"Illinois","Menard County",5,52,157,74,83
050,17,129,"Illinois","Menard County",5,53,139,69,70
050,17,129,"Illinois","Menard County",5,54,135,59,76
050,17,129,"Illinois","Menard County",5,55,156,71,85
050,17,129,"Illinois","Menard County",5,56,162,76,86
050,17,129,"Illinois","Menard County",5,57,170,84,86
050,17,129,"Illinois","Menard County",5,58,192,87,105
050,17,129,"Illinois","Menard County",5,59,202,98,104
050,17,129,"Illinois","Menard County",5,60,201,95,106
050,17,129,"Illinois","Menard County",5,61,200,94,106
050,17,129,"Illinois","Menard County",5,62,187,89,98
050,17,129,"Illinois","Menard County",5,63,178,89,89
050,17,129,"Illinois","Menard County",5,64,185,90,95
050,17,129,"Illinois","Menard County",5,65,190,96,94
050,17,129,"Illinois","Menard County",5,66,188,98,90
050,17,129,"Illinois","Menard County",5,67,168,92,76
050,17,129,"Illinois","Menard County",5,68,150,80,70
050,17,129,"Illinois","Menard County",5,69,159,78,81
050,17,129,"Illinois","Menard County",5,70,143,73,70
050,17,129,"Illinois","Menard County",5,71,132,65,67
050,17,129,"Illinois","Menard County",5,72,130,64,66
050,17,129,"Illinois","Menard County",5,73,128,54,74
050,17,129,"Illinois","Menard County",5,74,136,65,71
050,17,129,"Illinois","Menard County",5,75,132,71,61
050,17,129,"Illinois","Menard County",5,76,121,61,60
050,17,129,"Illinois","Menard County",5,77,83,35,48
050,17,129,"Illinois","Menard County",5,78,84,32,52
050,17,129,"Illinois","Menard County",5,79,74,26,48
050,17,129,"Illinois","Menard County",5,80,70,32,38
050,17,129,"Illinois","Menard County",5,81,55,21,34
050,17,129,"Illinois","Menard County",5,82,49,20,29
050,17,129,"Illinois","Menard County",5,83,51,24,27
050,17,129,"Illinois","Menard County",5,84,41,21,20
050,17,129,"Illinois","Menard County",5,85,250,92,158
050,17,131,"Illinois","Mercer County",1,0,142,74,68
050,17,131,"Illinois","Mercer County",1,1,154,76,78
050,17,131,"Illinois","Mercer County",1,2,151,69,82
050,17,131,"Illinois","Mercer County",1,3,163,86,77
050,17,131,"Illinois","Mercer County",1,4,169,83,86
050,17,131,"Illinois","Mercer County",1,5,156,79,77
050,17,131,"Illinois","Mercer County",1,6,190,101,89
050,17,131,"Illinois","Mercer County",1,7,179,96,83
050,17,131,"Illinois","Mercer County",1,8,168,82,86
050,17,131,"Illinois","Mercer County",1,9,176,83,93
050,17,131,"Illinois","Mercer County",1,10,206,93,113
050,17,131,"Illinois","Mercer County",1,11,209,111,98
050,17,131,"Illinois","Mercer County",1,12,220,112,108
050,17,131,"Illinois","Mercer County",1,13,233,113,120
050,17,131,"Illinois","Mercer County",1,14,219,104,115
050,17,131,"Illinois","Mercer County",1,15,202,104,98
050,17,131,"Illinois","Mercer County",1,16,197,102,95
050,17,131,"Illinois","Mercer County",1,17,232,121,111
050,17,131,"Illinois","Mercer County",1,18,182,96,86
050,17,131,"Illinois","Mercer County",1,19,146,74,72
050,17,131,"Illinois","Mercer County",1,20,150,88,62
050,17,131,"Illinois","Mercer County",1,21,147,80,67
050,17,131,"Illinois","Mercer County",1,22,155,83,72
050,17,131,"Illinois","Mercer County",1,23,153,82,71
050,17,131,"Illinois","Mercer County",1,24,155,86,69
050,17,131,"Illinois","Mercer County",1,25,147,72,75
050,17,131,"Illinois","Mercer County",1,26,145,76,69
050,17,131,"Illinois","Mercer County",1,27,142,75,67
050,17,131,"Illinois","Mercer County",1,28,160,87,73
050,17,131,"Illinois","Mercer County",1,29,181,100,81
050,17,131,"Illinois","Mercer County",1,30,164,82,82
050,17,131,"Illinois","Mercer County",1,31,156,81,75
050,17,131,"Illinois","Mercer County",1,32,168,95,73
050,17,131,"Illinois","Mercer County",1,33,154,72,82
050,17,131,"Illinois","Mercer County",1,34,168,84,84
050,17,131,"Illinois","Mercer County",1,35,174,91,83
050,17,131,"Illinois","Mercer County",1,36,198,99,99
050,17,131,"Illinois","Mercer County",1,37,199,91,108
050,17,131,"Illinois","Mercer County",1,38,188,92,96
050,17,131,"Illinois","Mercer County",1,39,188,95,93
050,17,131,"Illinois","Mercer County",1,40,205,105,100
050,17,131,"Illinois","Mercer County",1,41,191,86,105
050,17,131,"Illinois","Mercer County",1,42,196,100,96
050,17,131,"Illinois","Mercer County",1,43,198,107,91
050,17,131,"Illinois","Mercer County",1,44,173,92,81
050,17,131,"Illinois","Mercer County",1,45,185,94,91
050,17,131,"Illinois","Mercer County",1,46,184,91,93
050,17,131,"Illinois","Mercer County",1,47,193,97,96
050,17,131,"Illinois","Mercer County",1,48,192,106,86
050,17,131,"Illinois","Mercer County",1,49,199,100,99
050,17,131,"Illinois","Mercer County",1,50,195,92,103
050,17,131,"Illinois","Mercer County",1,51,196,94,102
050,17,131,"Illinois","Mercer County",1,52,217,99,118
050,17,131,"Illinois","Mercer County",1,53,227,111,116
050,17,131,"Illinois","Mercer County",1,54,205,99,106
050,17,131,"Illinois","Mercer County",1,55,235,115,120
050,17,131,"Illinois","Mercer County",1,56,244,126,118
050,17,131,"Illinois","Mercer County",1,57,247,124,123
050,17,131,"Illinois","Mercer County",1,58,258,124,134
050,17,131,"Illinois","Mercer County",1,59,246,123,123
050,17,131,"Illinois","Mercer County",1,60,246,135,111
050,17,131,"Illinois","Mercer County",1,61,226,123,103
050,17,131,"Illinois","Mercer County",1,62,238,125,113
050,17,131,"Illinois","Mercer County",1,63,230,121,109
050,17,131,"Illinois","Mercer County",1,64,222,113,109
050,17,131,"Illinois","Mercer County",1,65,216,108,108
050,17,131,"Illinois","Mercer County",1,66,211,110,101
050,17,131,"Illinois","Mercer County",1,67,223,116,107
050,17,131,"Illinois","Mercer County",1,68,212,110,102
050,17,131,"Illinois","Mercer County",1,69,195,97,98
050,17,131,"Illinois","Mercer County",1,70,191,95,96
050,17,131,"Illinois","Mercer County",1,71,192,100,92
050,17,131,"Illinois","Mercer County",1,72,182,94,88
050,17,131,"Illinois","Mercer County",1,73,175,83,92
050,17,131,"Illinois","Mercer County",1,74,113,54,59
050,17,131,"Illinois","Mercer County",1,75,120,55,65
050,17,131,"Illinois","Mercer County",1,76,149,70,79
050,17,131,"Illinois","Mercer County",1,77,153,74,79
050,17,131,"Illinois","Mercer County",1,78,123,63,60
050,17,131,"Illinois","Mercer County",1,79,112,53,59
050,17,131,"Illinois","Mercer County",1,80,88,44,44
050,17,131,"Illinois","Mercer County",1,81,91,41,50
050,17,131,"Illinois","Mercer County",1,82,77,32,45
050,17,131,"Illinois","Mercer County",1,83,71,27,44
050,17,131,"Illinois","Mercer County",1,84,61,23,38
050,17,131,"Illinois","Mercer County",1,85,409,174,235
050,17,131,"Illinois","Mercer County",2,0,136,71,65
050,17,131,"Illinois","Mercer County",2,1,151,75,76
050,17,131,"Illinois","Mercer County",2,2,151,71,80
050,17,131,"Illinois","Mercer County",2,3,158,81,77
050,17,131,"Illinois","Mercer County",2,4,166,83,83
050,17,131,"Illinois","Mercer County",2,5,159,80,79
050,17,131,"Illinois","Mercer County",2,6,185,98,87
050,17,131,"Illinois","Mercer County",2,7,184,99,85
050,17,131,"Illinois","Mercer County",2,8,169,85,84
050,17,131,"Illinois","Mercer County",2,9,176,85,91
050,17,131,"Illinois","Mercer County",2,10,199,92,107
050,17,131,"Illinois","Mercer County",2,11,206,105,101
050,17,131,"Illinois","Mercer County",2,12,216,110,106
050,17,131,"Illinois","Mercer County",2,13,227,111,116
050,17,131,"Illinois","Mercer County",2,14,223,107,116
050,17,131,"Illinois","Mercer County",2,15,203,102,101
050,17,131,"Illinois","Mercer County",2,16,196,102,94
050,17,131,"Illinois","Mercer County",2,17,224,118,106
050,17,131,"Illinois","Mercer County",2,18,184,96,88
050,17,131,"Illinois","Mercer County",2,19,146,76,70
050,17,131,"Illinois","Mercer County",2,20,151,86,65
050,17,131,"Illinois","Mercer County",2,21,149,81,68
050,17,131,"Illinois","Mercer County",2,22,153,82,71
050,17,131,"Illinois","Mercer County",2,23,153,83,70
050,17,131,"Illinois","Mercer County",2,24,155,87,68
050,17,131,"Illinois","Mercer County",2,25,148,76,72
050,17,131,"Illinois","Mercer County",2,26,147,76,71
050,17,131,"Illinois","Mercer County",2,27,142,75,67
050,17,131,"Illinois","Mercer County",2,28,155,85,70
050,17,131,"Illinois","Mercer County",2,29,174,97,77
050,17,131,"Illinois","Mercer County",2,30,169,86,83
050,17,131,"Illinois","Mercer County",2,31,159,81,78
050,17,131,"Illinois","Mercer County",2,32,162,89,73
050,17,131,"Illinois","Mercer County",2,33,159,77,82
050,17,131,"Illinois","Mercer County",2,34,165,81,84
050,17,131,"Illinois","Mercer County",2,35,174,90,84
050,17,131,"Illinois","Mercer County",2,36,193,98,95
050,17,131,"Illinois","Mercer County",2,37,199,93,106
050,17,131,"Illinois","Mercer County",2,38,188,91,97
050,17,131,"Illinois","Mercer County",2,39,187,93,94
050,17,131,"Illinois","Mercer County",2,40,201,103,98
050,17,131,"Illinois","Mercer County",2,41,194,91,103
050,17,131,"Illinois","Mercer County",2,42,192,95,97
050,17,131,"Illinois","Mercer County",2,43,199,106,93
050,17,131,"Illinois","Mercer County",2,44,177,95,82
050,17,131,"Illinois","Mercer County",2,45,181,92,89
050,17,131,"Illinois","Mercer County",2,46,184,92,92
050,17,131,"Illinois","Mercer County",2,47,188,94,94
050,17,131,"Illinois","Mercer County",2,48,191,103,88
050,17,131,"Illinois","Mercer County",2,49,199,103,96
050,17,131,"Illinois","Mercer County",2,50,194,93,101
050,17,131,"Illinois","Mercer County",2,51,196,94,102
050,17,131,"Illinois","Mercer County",2,52,209,97,112
050,17,131,"Illinois","Mercer County",2,53,225,108,117
050,17,131,"Illinois","Mercer County",2,54,209,102,107
050,17,131,"Illinois","Mercer County",2,55,227,110,117
050,17,131,"Illinois","Mercer County",2,56,242,123,119
050,17,131,"Illinois","Mercer County",2,57,247,125,122
050,17,131,"Illinois","Mercer County",2,58,253,123,130
050,17,131,"Illinois","Mercer County",2,59,250,124,126
050,17,131,"Illinois","Mercer County",2,60,246,133,113
050,17,131,"Illinois","Mercer County",2,61,230,126,104
050,17,131,"Illinois","Mercer County",2,62,232,123,109
050,17,131,"Illinois","Mercer County",2,63,232,122,110
050,17,131,"Illinois","Mercer County",2,64,218,113,105
050,17,131,"Illinois","Mercer County",2,65,215,107,108
050,17,131,"Illinois","Mercer County",2,66,212,109,103
050,17,131,"Illinois","Mercer County",2,67,217,112,105
050,17,131,"Illinois","Mercer County",2,68,213,111,102
050,17,131,"Illinois","Mercer County",2,69,199,99,100
050,17,131,"Illinois","Mercer County",2,70,189,95,94
050,17,131,"Illinois","Mercer County",2,71,189,97,92
050,17,131,"Illinois","Mercer County",2,72,181,93,88
050,17,131,"Illinois","Mercer County",2,73,184,90,94
050,17,131,"Illinois","Mercer County",2,74,120,57,63
050,17,131,"Illinois","Mercer County",2,75,118,54,64
050,17,131,"Illinois","Mercer County",2,76,137,63,74
050,17,131,"Illinois","Mercer County",2,77,152,72,80
050,17,131,"Illinois","Mercer County",2,78,129,65,64
050,17,131,"Illinois","Mercer County",2,79,113,54,59
050,17,131,"Illinois","Mercer County",2,80,89,44,45
050,17,131,"Illinois","Mercer County",2,81,89,41,48
050,17,131,"Illinois","Mercer County",2,82,81,35,46
050,17,131,"Illinois","Mercer County",2,83,71,28,43
050,17,131,"Illinois","Mercer County",2,84,64,24,40
050,17,131,"Illinois","Mercer County",2,85,413,175,238
050,17,131,"Illinois","Mercer County",3,0,143,78,65
050,17,131,"Illinois","Mercer County",3,1,161,85,76
050,17,131,"Illinois","Mercer County",3,2,153,72,81
050,17,131,"Illinois","Mercer County",3,3,154,71,83
050,17,131,"Illinois","Mercer County",3,4,153,78,75
050,17,131,"Illinois","Mercer County",3,5,174,88,86
050,17,131,"Illinois","Mercer County",3,6,158,79,79
050,17,131,"Illinois","Mercer County",3,7,183,99,84
050,17,131,"Illinois","Mercer County",3,8,183,100,83
050,17,131,"Illinois","Mercer County",3,9,162,79,83
050,17,131,"Illinois","Mercer County",3,10,178,89,89
050,17,131,"Illinois","Mercer County",3,11,207,98,109
050,17,131,"Illinois","Mercer County",3,12,212,108,104
050,17,131,"Illinois","Mercer County",3,13,227,116,111
050,17,131,"Illinois","Mercer County",3,14,228,111,117
050,17,131,"Illinois","Mercer County",3,15,212,101,111
050,17,131,"Illinois","Mercer County",3,16,205,102,103
050,17,131,"Illinois","Mercer County",3,17,200,102,98
050,17,131,"Illinois","Mercer County",3,18,191,101,90
050,17,131,"Illinois","Mercer County",3,19,148,77,71
050,17,131,"Illinois","Mercer County",3,20,154,82,72
050,17,131,"Illinois","Mercer County",3,21,162,91,71
050,17,131,"Illinois","Mercer County",3,22,159,85,74
050,17,131,"Illinois","Mercer County",3,23,161,88,73
050,17,131,"Illinois","Mercer County",3,24,148,81,67
050,17,131,"Illinois","Mercer County",3,25,161,89,72
050,17,131,"Illinois","Mercer County",3,26,142,77,65
050,17,131,"Illinois","Mercer County",3,27,140,74,66
050,17,131,"Illinois","Mercer County",3,28,148,73,75
050,17,131,"Illinois","Mercer County",3,29,156,90,66
050,17,131,"Illinois","Mercer County",3,30,174,99,75
050,17,131,"Illinois","Mercer County",3,31,180,94,86
050,17,131,"Illinois","Mercer County",3,32,172,85,87
050,17,131,"Illinois","Mercer County",3,33,156,83,73
050,17,131,"Illinois","Mercer County",3,34,166,83,83
050,17,131,"Illinois","Mercer County",3,35,165,81,84
050,17,131,"Illinois","Mercer County",3,36,174,88,86
050,17,131,"Illinois","Mercer County",3,37,206,103,103
050,17,131,"Illinois","Mercer County",3,38,205,98,107
050,17,131,"Illinois","Mercer County",3,39,199,93,106
050,17,131,"Illinois","Mercer County",3,40,188,93,95
050,17,131,"Illinois","Mercer County",3,41,200,103,97
050,17,131,"Illinois","Mercer County",3,42,193,90,103
050,17,131,"Illinois","Mercer County",3,43,200,98,102
050,17,131,"Illinois","Mercer County",3,44,199,105,94
050,17,131,"Illinois","Mercer County",3,45,177,94,83
050,17,131,"Illinois","Mercer County",3,46,183,92,91
050,17,131,"Illinois","Mercer County",3,47,184,93,91
050,17,131,"Illinois","Mercer County",3,48,189,96,93
050,17,131,"Illinois","Mercer County",3,49,190,104,86
050,17,131,"Illinois","Mercer County",3,50,205,104,101
050,17,131,"Illinois","Mercer County",3,51,194,93,101
050,17,131,"Illinois","Mercer County",3,52,197,95,102
050,17,131,"Illinois","Mercer County",3,53,201,92,109
050,17,131,"Illinois","Mercer County",3,54,225,108,117
050,17,131,"Illinois","Mercer County",3,55,205,102,103
050,17,131,"Illinois","Mercer County",3,56,222,110,112
050,17,131,"Illinois","Mercer County",3,57,237,121,116
050,17,131,"Illinois","Mercer County",3,58,246,125,121
050,17,131,"Illinois","Mercer County",3,59,252,122,130
050,17,131,"Illinois","Mercer County",3,60,247,124,123
050,17,131,"Illinois","Mercer County",3,61,238,131,107
050,17,131,"Illinois","Mercer County",3,62,227,121,106
050,17,131,"Illinois","Mercer County",3,63,231,122,109
050,17,131,"Illinois","Mercer County",3,64,228,122,106
050,17,131,"Illinois","Mercer County",3,65,218,113,105
050,17,131,"Illinois","Mercer County",3,66,210,104,106
050,17,131,"Illinois","Mercer County",3,67,210,107,103
050,17,131,"Illinois","Mercer County",3,68,209,109,100
050,17,131,"Illinois","Mercer County",3,69,209,107,102
050,17,131,"Illinois","Mercer County",3,70,192,99,93
050,17,131,"Illinois","Mercer County",3,71,180,89,91
050,17,131,"Illinois","Mercer County",3,72,183,94,89
050,17,131,"Illinois","Mercer County",3,73,174,92,82
050,17,131,"Illinois","Mercer County",3,74,177,84,93
050,17,131,"Illinois","Mercer County",3,75,110,50,60
050,17,131,"Illinois","Mercer County",3,76,113,53,60
050,17,131,"Illinois","Mercer County",3,77,125,56,69
050,17,131,"Illinois","Mercer County",3,78,145,68,77
050,17,131,"Illinois","Mercer County",3,79,119,58,61
050,17,131,"Illinois","Mercer County",3,80,99,47,52
050,17,131,"Illinois","Mercer County",3,81,83,39,44
050,17,131,"Illinois","Mercer County",3,82,76,35,41
050,17,131,"Illinois","Mercer County",3,83,73,32,41
050,17,131,"Illinois","Mercer County",3,84,63,22,41
050,17,131,"Illinois","Mercer County",3,85,394,158,236
050,17,131,"Illinois","Mercer County",4,0,137,72,65
050,17,131,"Illinois","Mercer County",4,1,155,86,69
050,17,131,"Illinois","Mercer County",4,2,159,80,79
050,17,131,"Illinois","Mercer County",4,3,157,76,81
050,17,131,"Illinois","Mercer County",4,4,143,63,80
050,17,131,"Illinois","Mercer County",4,5,158,82,76
050,17,131,"Illinois","Mercer County",4,6,177,88,89
050,17,131,"Illinois","Mercer County",4,7,157,80,77
050,17,131,"Illinois","Mercer County",4,8,184,95,89
050,17,131,"Illinois","Mercer County",4,9,189,102,87
050,17,131,"Illinois","Mercer County",4,10,183,91,92
050,17,131,"Illinois","Mercer County",4,11,182,90,92
050,17,131,"Illinois","Mercer County",4,12,208,100,108
050,17,131,"Illinois","Mercer County",4,13,207,105,102
050,17,131,"Illinois","Mercer County",4,14,223,114,109
050,17,131,"Illinois","Mercer County",4,15,234,114,120
050,17,131,"Illinois","Mercer County",4,16,215,101,114
050,17,131,"Illinois","Mercer County",4,17,201,104,97
050,17,131,"Illinois","Mercer County",4,18,169,92,77
050,17,131,"Illinois","Mercer County",4,19,145,80,65
050,17,131,"Illinois","Mercer County",4,20,154,79,75
050,17,131,"Illinois","Mercer County",4,21,167,80,87
050,17,131,"Illinois","Mercer County",4,22,171,95,76
050,17,131,"Illinois","Mercer County",4,23,171,92,79
050,17,131,"Illinois","Mercer County",4,24,156,85,71
050,17,131,"Illinois","Mercer County",4,25,139,76,63
050,17,131,"Illinois","Mercer County",4,26,152,90,62
050,17,131,"Illinois","Mercer County",4,27,146,79,67
050,17,131,"Illinois","Mercer County",4,28,136,67,69
050,17,131,"Illinois","Mercer County",4,29,150,78,72
050,17,131,"Illinois","Mercer County",4,30,162,91,71
050,17,131,"Illinois","Mercer County",4,31,177,100,77
050,17,131,"Illinois","Mercer County",4,32,177,85,92
050,17,131,"Illinois","Mercer County",4,33,173,84,89
050,17,131,"Illinois","Mercer County",4,34,158,85,73
050,17,131,"Illinois","Mercer County",4,35,180,95,85
050,17,131,"Illinois","Mercer County",4,36,166,79,87
050,17,131,"Illinois","Mercer County",4,37,179,85,94
050,17,131,"Illinois","Mercer County",4,38,205,104,101
050,17,131,"Illinois","Mercer County",4,39,206,98,108
050,17,131,"Illinois","Mercer County",4,40,205,98,107
050,17,131,"Illinois","Mercer County",4,41,195,99,96
050,17,131,"Illinois","Mercer County",4,42,202,103,99
050,17,131,"Illinois","Mercer County",4,43,201,97,104
050,17,131,"Illinois","Mercer County",4,44,202,103,99
050,17,131,"Illinois","Mercer County",4,45,205,110,95
050,17,131,"Illinois","Mercer County",4,46,174,91,83
050,17,131,"Illinois","Mercer County",4,47,182,93,89
050,17,131,"Illinois","Mercer County",4,48,179,87,92
050,17,131,"Illinois","Mercer County",4,49,184,98,86
050,17,131,"Illinois","Mercer County",4,50,181,98,83
050,17,131,"Illinois","Mercer County",4,51,205,103,102
050,17,131,"Illinois","Mercer County",4,52,200,100,100
050,17,131,"Illinois","Mercer County",4,53,196,91,105
050,17,131,"Illinois","Mercer County",4,54,199,92,107
050,17,131,"Illinois","Mercer County",4,55,223,105,118
050,17,131,"Illinois","Mercer County",4,56,200,100,100
050,17,131,"Illinois","Mercer County",4,57,222,112,110
050,17,131,"Illinois","Mercer County",4,58,238,121,117
050,17,131,"Illinois","Mercer County",4,59,251,123,128
050,17,131,"Illinois","Mercer County",4,60,248,121,127
050,17,131,"Illinois","Mercer County",4,61,247,123,124
050,17,131,"Illinois","Mercer County",4,62,241,133,108
050,17,131,"Illinois","Mercer County",4,63,231,126,105
050,17,131,"Illinois","Mercer County",4,64,227,119,108
050,17,131,"Illinois","Mercer County",4,65,230,122,108
050,17,131,"Illinois","Mercer County",4,66,215,115,100
050,17,131,"Illinois","Mercer County",4,67,204,101,103
050,17,131,"Illinois","Mercer County",4,68,201,102,99
050,17,131,"Illinois","Mercer County",4,69,210,108,102
050,17,131,"Illinois","Mercer County",4,70,203,104,99
050,17,131,"Illinois","Mercer County",4,71,183,95,88
050,17,131,"Illinois","Mercer County",4,72,174,85,89
050,17,131,"Illinois","Mercer County",4,73,183,94,89
050,17,131,"Illinois","Mercer County",4,74,166,88,78
050,17,131,"Illinois","Mercer County",4,75,161,74,87
050,17,131,"Illinois","Mercer County",4,76,101,45,56
050,17,131,"Illinois","Mercer County",4,77,106,49,57
050,17,131,"Illinois","Mercer County",4,78,116,49,67
050,17,131,"Illinois","Mercer County",4,79,133,59,74
050,17,131,"Illinois","Mercer County",4,80,107,55,52
050,17,131,"Illinois","Mercer County",4,81,96,46,50
050,17,131,"Illinois","Mercer County",4,82,74,34,40
050,17,131,"Illinois","Mercer County",4,83,73,34,39
050,17,131,"Illinois","Mercer County",4,84,65,26,39
050,17,131,"Illinois","Mercer County",4,85,386,144,242
050,17,131,"Illinois","Mercer County",5,0,137,73,64
050,17,131,"Illinois","Mercer County",5,1,138,65,73
050,17,131,"Illinois","Mercer County",5,2,151,81,70
050,17,131,"Illinois","Mercer County",5,3,172,87,85
050,17,131,"Illinois","Mercer County",5,4,161,76,85
050,17,131,"Illinois","Mercer County",5,5,153,71,82
050,17,131,"Illinois","Mercer County",5,6,161,87,74
050,17,131,"Illinois","Mercer County",5,7,180,90,90
050,17,131,"Illinois","Mercer County",5,8,166,82,84
050,17,131,"Illinois","Mercer County",5,9,184,97,87
050,17,131,"Illinois","Mercer County",5,10,184,96,88
050,17,131,"Illinois","Mercer County",5,11,177,88,89
050,17,131,"Illinois","Mercer County",5,12,187,95,92
050,17,131,"Illinois","Mercer County",5,13,203,95,108
050,17,131,"Illinois","Mercer County",5,14,220,115,105
050,17,131,"Illinois","Mercer County",5,15,229,116,113
050,17,131,"Illinois","Mercer County",5,16,224,106,118
050,17,131,"Illinois","Mercer County",5,17,223,110,113
050,17,131,"Illinois","Mercer County",5,18,174,94,80
050,17,131,"Illinois","Mercer County",5,19,128,69,59
050,17,131,"Illinois","Mercer County",5,20,157,85,72
050,17,131,"Illinois","Mercer County",5,21,160,80,80
050,17,131,"Illinois","Mercer County",5,22,178,86,92
050,17,131,"Illinois","Mercer County",5,23,170,97,73
050,17,131,"Illinois","Mercer County",5,24,169,88,81
050,17,131,"Illinois","Mercer County",5,25,159,91,68
050,17,131,"Illinois","Mercer County",5,26,141,79,62
050,17,131,"Illinois","Mercer County",5,27,160,89,71
050,17,131,"Illinois","Mercer County",5,28,157,83,74
050,17,131,"Illinois","Mercer County",5,29,144,71,73
050,17,131,"Illinois","Mercer County",5,30,156,74,82
050,17,131,"Illinois","Mercer County",5,31,161,91,70
050,17,131,"Illinois","Mercer County",5,32,183,102,81
050,17,131,"Illinois","Mercer County",5,33,180,92,88
050,17,131,"Illinois","Mercer County",5,34,174,86,88
050,17,131,"Illinois","Mercer County",5,35,169,88,81
050,17,131,"Illinois","Mercer County",5,36,171,90,81
050,17,131,"Illinois","Mercer County",5,37,169,85,84
050,17,131,"Illinois","Mercer County",5,38,176,81,95
050,17,131,"Illinois","Mercer County",5,39,213,111,102
050,17,131,"Illinois","Mercer County",5,40,203,97,106
050,17,131,"Illinois","Mercer County",5,41,200,97,103
050,17,131,"Illinois","Mercer County",5,42,189,98,91
050,17,131,"Illinois","Mercer County",5,43,208,106,102
050,17,131,"Illinois","Mercer County",5,44,197,93,104
050,17,131,"Illinois","Mercer County",5,45,188,95,93
050,17,131,"Illinois","Mercer County",5,46,199,107,92
050,17,131,"Illinois","Mercer County",5,47,172,89,83
050,17,131,"Illinois","Mercer County",5,48,178,93,85
050,17,131,"Illinois","Mercer County",5,49,185,92,93
050,17,131,"Illinois","Mercer County",5,50,177,93,84
050,17,131,"Illinois","Mercer County",5,51,179,93,86
050,17,131,"Illinois","Mercer County",5,52,203,102,101
050,17,131,"Illinois","Mercer County",5,53,201,101,100
050,17,131,"Illinois","Mercer County",5,54,191,88,103
050,17,131,"Illinois","Mercer County",5,55,207,94,113
050,17,131,"Illinois","Mercer County",5,56,217,107,110
050,17,131,"Illinois","Mercer County",5,57,202,101,101
050,17,131,"Illinois","Mercer County",5,58,218,113,105
050,17,131,"Illinois","Mercer County",5,59,236,120,116
050,17,131,"Illinois","Mercer County",5,60,250,125,125
050,17,131,"Illinois","Mercer County",5,61,248,123,125
050,17,131,"Illinois","Mercer County",5,62,246,122,124
050,17,131,"Illinois","Mercer County",5,63,236,130,106
050,17,131,"Illinois","Mercer County",5,64,232,128,104
050,17,131,"Illinois","Mercer County",5,65,220,118,102
050,17,131,"Illinois","Mercer County",5,66,226,117,109
050,17,131,"Illinois","Mercer County",5,67,212,111,101
050,17,131,"Illinois","Mercer County",5,68,200,98,102
050,17,131,"Illinois","Mercer County",5,69,197,99,98
050,17,131,"Illinois","Mercer County",5,70,208,107,101
050,17,131,"Illinois","Mercer County",5,71,191,98,93
050,17,131,"Illinois","Mercer County",5,72,182,93,89
050,17,131,"Illinois","Mercer County",5,73,172,82,90
050,17,131,"Illinois","Mercer County",5,74,181,91,90
050,17,131,"Illinois","Mercer County",5,75,148,76,72
050,17,131,"Illinois","Mercer County",5,76,152,70,82
050,17,131,"Illinois","Mercer County",5,77,92,40,52
050,17,131,"Illinois","Mercer County",5,78,96,43,53
050,17,131,"Illinois","Mercer County",5,79,108,42,66
050,17,131,"Illinois","Mercer County",5,80,121,54,67
050,17,131,"Illinois","Mercer County",5,81,102,53,49
050,17,131,"Illinois","Mercer County",5,82,88,40,48
050,17,131,"Illinois","Mercer County",5,83,74,34,40
050,17,131,"Illinois","Mercer County",5,84,64,26,38
050,17,131,"Illinois","Mercer County",5,85,392,136,256
050,17,133,"Illinois","Monroe County",1,0,379,195,184
050,17,133,"Illinois","Monroe County",1,1,383,205,178
050,17,133,"Illinois","Monroe County",1,2,381,222,159
050,17,133,"Illinois","Monroe County",1,3,402,226,176
050,17,133,"Illinois","Monroe County",1,4,454,244,210
050,17,133,"Illinois","Monroe County",1,5,429,224,205
050,17,133,"Illinois","Monroe County",1,6,396,185,211
050,17,133,"Illinois","Monroe County",1,7,418,206,212
050,17,133,"Illinois","Monroe County",1,8,438,236,202
050,17,133,"Illinois","Monroe County",1,9,405,210,195
050,17,133,"Illinois","Monroe County",1,10,455,230,225
050,17,133,"Illinois","Monroe County",1,11,452,229,223
050,17,133,"Illinois","Monroe County",1,12,467,241,226
050,17,133,"Illinois","Monroe County",1,13,502,254,248
050,17,133,"Illinois","Monroe County",1,14,488,243,245
050,17,133,"Illinois","Monroe County",1,15,454,224,230
050,17,133,"Illinois","Monroe County",1,16,443,229,214
050,17,133,"Illinois","Monroe County",1,17,479,261,218
050,17,133,"Illinois","Monroe County",1,18,405,231,174
050,17,133,"Illinois","Monroe County",1,19,309,170,139
050,17,133,"Illinois","Monroe County",1,20,323,181,142
050,17,133,"Illinois","Monroe County",1,21,351,190,161
050,17,133,"Illinois","Monroe County",1,22,347,189,158
050,17,133,"Illinois","Monroe County",1,23,337,170,167
050,17,133,"Illinois","Monroe County",1,24,335,172,163
050,17,133,"Illinois","Monroe County",1,25,338,179,159
050,17,133,"Illinois","Monroe County",1,26,329,179,150
050,17,133,"Illinois","Monroe County",1,27,329,176,153
050,17,133,"Illinois","Monroe County",1,28,342,170,172
050,17,133,"Illinois","Monroe County",1,29,365,173,192
050,17,133,"Illinois","Monroe County",1,30,375,190,185
050,17,133,"Illinois","Monroe County",1,31,369,181,188
050,17,133,"Illinois","Monroe County",1,32,356,170,186
050,17,133,"Illinois","Monroe County",1,33,411,188,223
050,17,133,"Illinois","Monroe County",1,34,448,205,243
050,17,133,"Illinois","Monroe County",1,35,449,226,223
050,17,133,"Illinois","Monroe County",1,36,442,226,216
050,17,133,"Illinois","Monroe County",1,37,473,226,247
050,17,133,"Illinois","Monroe County",1,38,516,260,256
050,17,133,"Illinois","Monroe County",1,39,498,253,245
050,17,133,"Illinois","Monroe County",1,40,473,237,236
050,17,133,"Illinois","Monroe County",1,41,492,251,241
050,17,133,"Illinois","Monroe County",1,42,456,253,203
050,17,133,"Illinois","Monroe County",1,43,441,245,196
050,17,133,"Illinois","Monroe County",1,44,412,219,193
050,17,133,"Illinois","Monroe County",1,45,406,219,187
050,17,133,"Illinois","Monroe County",1,46,393,193,200
050,17,133,"Illinois","Monroe County",1,47,423,210,213
050,17,133,"Illinois","Monroe County",1,48,442,237,205
050,17,133,"Illinois","Monroe County",1,49,497,248,249
050,17,133,"Illinois","Monroe County",1,50,452,221,231
050,17,133,"Illinois","Monroe County",1,51,476,230,246
050,17,133,"Illinois","Monroe County",1,52,483,220,263
050,17,133,"Illinois","Monroe County",1,53,492,232,260
050,17,133,"Illinois","Monroe County",1,54,492,241,251
050,17,133,"Illinois","Monroe County",1,55,536,257,279
050,17,133,"Illinois","Monroe County",1,56,551,273,278
050,17,133,"Illinois","Monroe County",1,57,529,269,260
050,17,133,"Illinois","Monroe County",1,58,558,299,259
050,17,133,"Illinois","Monroe County",1,59,579,290,289
050,17,133,"Illinois","Monroe County",1,60,548,269,279
050,17,133,"Illinois","Monroe County",1,61,563,294,269
050,17,133,"Illinois","Monroe County",1,62,590,303,287
050,17,133,"Illinois","Monroe County",1,63,579,285,294
050,17,133,"Illinois","Monroe County",1,64,512,253,259
050,17,133,"Illinois","Monroe County",1,65,490,253,237
050,17,133,"Illinois","Monroe County",1,66,449,228,221
050,17,133,"Illinois","Monroe County",1,67,417,217,200
050,17,133,"Illinois","Monroe County",1,68,413,206,207
050,17,133,"Illinois","Monroe County",1,69,381,178,203
050,17,133,"Illinois","Monroe County",1,70,347,160,187
050,17,133,"Illinois","Monroe County",1,71,341,169,172
050,17,133,"Illinois","Monroe County",1,72,327,176,151
050,17,133,"Illinois","Monroe County",1,73,319,165,154
050,17,133,"Illinois","Monroe County",1,74,226,108,118
050,17,133,"Illinois","Monroe County",1,75,218,101,117
050,17,133,"Illinois","Monroe County",1,76,213,95,118
050,17,133,"Illinois","Monroe County",1,77,219,102,117
050,17,133,"Illinois","Monroe County",1,78,193,100,93
050,17,133,"Illinois","Monroe County",1,79,180,88,92
050,17,133,"Illinois","Monroe County",1,80,162,71,91
050,17,133,"Illinois","Monroe County",1,81,153,65,88
050,17,133,"Illinois","Monroe County",1,82,171,75,96
050,17,133,"Illinois","Monroe County",1,83,141,55,86
050,17,133,"Illinois","Monroe County",1,84,126,46,80
050,17,133,"Illinois","Monroe County",1,85,820,290,530
050,17,133,"Illinois","Monroe County",2,0,373,195,178
050,17,133,"Illinois","Monroe County",2,1,384,205,179
050,17,133,"Illinois","Monroe County",2,2,388,221,167
050,17,133,"Illinois","Monroe County",2,3,397,226,171
050,17,133,"Illinois","Monroe County",2,4,446,242,204
050,17,133,"Illinois","Monroe County",2,5,436,228,208
050,17,133,"Illinois","Monroe County",2,6,408,196,212
050,17,133,"Illinois","Monroe County",2,7,412,201,211
050,17,133,"Illinois","Monroe County",2,8,430,227,203
050,17,133,"Illinois","Monroe County",2,9,410,214,196
050,17,133,"Illinois","Monroe County",2,10,442,225,217
050,17,133,"Illinois","Monroe County",2,11,452,229,223
050,17,133,"Illinois","Monroe County",2,12,468,241,227
050,17,133,"Illinois","Monroe County",2,13,494,251,243
050,17,133,"Illinois","Monroe County",2,14,492,247,245
050,17,133,"Illinois","Monroe County",2,15,462,229,233
050,17,133,"Illinois","Monroe County",2,16,445,227,218
050,17,133,"Illinois","Monroe County",2,17,468,251,217
050,17,133,"Illinois","Monroe County",2,18,400,227,173
050,17,133,"Illinois","Monroe County",2,19,314,174,140
050,17,133,"Illinois","Monroe County",2,20,327,182,145
050,17,133,"Illinois","Monroe County",2,21,346,188,158
050,17,133,"Illinois","Monroe County",2,22,350,189,161
050,17,133,"Illinois","Monroe County",2,23,337,172,165
050,17,133,"Illinois","Monroe County",2,24,332,169,163
050,17,133,"Illinois","Monroe County",2,25,335,177,158
050,17,133,"Illinois","Monroe County",2,26,331,179,152
050,17,133,"Illinois","Monroe County",2,27,328,178,150
050,17,133,"Illinois","Monroe County",2,28,340,172,168
050,17,133,"Illinois","Monroe County",2,29,360,171,189
050,17,133,"Illinois","Monroe County",2,30,374,186,188
050,17,133,"Illinois","Monroe County",2,31,370,183,187
050,17,133,"Illinois","Monroe County",2,32,361,173,188
050,17,133,"Illinois","Monroe County",2,33,400,184,216
050,17,133,"Illinois","Monroe County",2,34,442,201,241
050,17,133,"Illinois","Monroe County",2,35,457,224,233
050,17,133,"Illinois","Monroe County",2,36,443,225,218
050,17,133,"Illinois","Monroe County",2,37,467,227,240
050,17,133,"Illinois","Monroe County",2,38,511,254,257
050,17,133,"Illinois","Monroe County",2,39,500,255,245
050,17,133,"Illinois","Monroe County",2,40,480,242,238
050,17,133,"Illinois","Monroe County",2,41,489,249,240
050,17,133,"Illinois","Monroe County",2,42,463,253,210
050,17,133,"Illinois","Monroe County",2,43,446,248,198
050,17,133,"Illinois","Monroe County",2,44,414,222,192
050,17,133,"Illinois","Monroe County",2,45,408,218,190
050,17,133,"Illinois","Monroe County",2,46,396,199,197
050,17,133,"Illinois","Monroe County",2,47,413,205,208
050,17,133,"Illinois","Monroe County",2,48,436,231,205
050,17,133,"Illinois","Monroe County",2,49,486,248,238
050,17,133,"Illinois","Monroe County",2,50,462,228,234
050,17,133,"Illinois","Monroe County",2,51,469,227,242
050,17,133,"Illinois","Monroe County",2,52,481,222,259
050,17,133,"Illinois","Monroe County",2,53,490,229,261
050,17,133,"Illinois","Monroe County",2,54,489,237,252
050,17,133,"Illinois","Monroe County",2,55,527,253,274
050,17,133,"Illinois","Monroe County",2,56,549,270,279
050,17,133,"Illinois","Monroe County",2,57,534,268,266
050,17,133,"Illinois","Monroe County",2,58,548,289,259
050,17,133,"Illinois","Monroe County",2,59,573,292,281
050,17,133,"Illinois","Monroe County",2,60,550,271,279
050,17,133,"Illinois","Monroe County",2,61,556,285,271
050,17,133,"Illinois","Monroe County",2,62,583,302,281
050,17,133,"Illinois","Monroe County",2,63,587,293,294
050,17,133,"Illinois","Monroe County",2,64,523,258,265
050,17,133,"Illinois","Monroe County",2,65,492,251,241
050,17,133,"Illinois","Monroe County",2,66,459,234,225
050,17,133,"Illinois","Monroe County",2,67,426,220,206
050,17,133,"Illinois","Monroe County",2,68,410,208,202
050,17,133,"Illinois","Monroe County",2,69,388,183,205
050,17,133,"Illinois","Monroe County",2,70,354,163,191
050,17,133,"Illinois","Monroe County",2,71,340,164,176
050,17,133,"Illinois","Monroe County",2,72,325,171,154
050,17,133,"Illinois","Monroe County",2,73,338,177,161
050,17,133,"Illinois","Monroe County",2,74,235,115,120
050,17,133,"Illinois","Monroe County",2,75,218,101,117
050,17,133,"Illinois","Monroe County",2,76,213,95,118
050,17,133,"Illinois","Monroe County",2,77,224,104,120
050,17,133,"Illinois","Monroe County",2,78,191,94,97
050,17,133,"Illinois","Monroe County",2,79,183,91,92
050,17,133,"Illinois","Monroe County",2,80,165,75,90
050,17,133,"Illinois","Monroe County",2,81,153,64,89
050,17,133,"Illinois","Monroe County",2,82,167,73,94
050,17,133,"Illinois","Monroe County",2,83,145,58,87
050,17,133,"Illinois","Monroe County",2,84,128,48,80
050,17,133,"Illinois","Monroe County",2,85,815,290,525
050,17,133,"Illinois","Monroe County",3,0,293,153,140
050,17,133,"Illinois","Monroe County",3,1,391,214,177
050,17,133,"Illinois","Monroe County",3,2,390,207,183
050,17,133,"Illinois","Monroe County",3,3,403,222,181
050,17,133,"Illinois","Monroe County",3,4,403,226,177
050,17,133,"Illinois","Monroe County",3,5,452,243,209
050,17,133,"Illinois","Monroe County",3,6,454,239,215
050,17,133,"Illinois","Monroe County",3,7,405,191,214
050,17,133,"Illinois","Monroe County",3,8,410,201,209
050,17,133,"Illinois","Monroe County",3,9,437,228,209
050,17,133,"Illinois","Monroe County",3,10,413,212,201
050,17,133,"Illinois","Monroe County",3,11,449,222,227
050,17,133,"Illinois","Monroe County",3,12,451,224,227
050,17,133,"Illinois","Monroe County",3,13,469,242,227
050,17,133,"Illinois","Monroe County",3,14,494,256,238
050,17,133,"Illinois","Monroe County",3,15,483,244,239
050,17,133,"Illinois","Monroe County",3,16,461,228,233
050,17,133,"Illinois","Monroe County",3,17,457,230,227
050,17,133,"Illinois","Monroe County",3,18,393,220,173
050,17,133,"Illinois","Monroe County",3,19,307,176,131
050,17,133,"Illinois","Monroe County",3,20,342,186,156
050,17,133,"Illinois","Monroe County",3,21,348,191,157
050,17,133,"Illinois","Monroe County",3,22,341,180,161
050,17,133,"Illinois","Monroe County",3,23,353,191,162
050,17,133,"Illinois","Monroe County",3,24,325,160,165
050,17,133,"Illinois","Monroe County",3,25,327,171,156
050,17,133,"Illinois","Monroe County",3,26,337,176,161
050,17,133,"Illinois","Monroe County",3,27,330,184,146
050,17,133,"Illinois","Monroe County",3,28,334,186,148
050,17,133,"Illinois","Monroe County",3,29,353,177,176
050,17,133,"Illinois","Monroe County",3,30,377,183,194
050,17,133,"Illinois","Monroe County",3,31,369,182,187
050,17,133,"Illinois","Monroe County",3,32,388,188,200
050,17,133,"Illinois","Monroe County",3,33,371,180,191
050,17,133,"Illinois","Monroe County",3,34,405,185,220
050,17,133,"Illinois","Monroe County",3,35,445,205,240
050,17,133,"Illinois","Monroe County",3,36,469,235,234
050,17,133,"Illinois","Monroe County",3,37,451,231,220
050,17,133,"Illinois","Monroe County",3,38,481,231,250
050,17,133,"Illinois","Monroe County",3,39,520,262,258
050,17,133,"Illinois","Monroe County",3,40,516,265,251
050,17,133,"Illinois","Monroe County",3,41,487,246,241
050,17,133,"Illinois","Monroe County",3,42,509,256,253
050,17,133,"Illinois","Monroe County",3,43,474,259,215
050,17,133,"Illinois","Monroe County",3,44,439,243,196
050,17,133,"Illinois","Monroe County",3,45,417,226,191
050,17,133,"Illinois","Monroe County",3,46,409,217,192
050,17,133,"Illinois","Monroe County",3,47,405,205,200
050,17,133,"Illinois","Monroe County",3,48,418,204,214
050,17,133,"Illinois","Monroe County",3,49,438,233,205
050,17,133,"Illinois","Monroe County",3,50,477,248,229
050,17,133,"Illinois","Monroe County",3,51,463,229,234
050,17,133,"Illinois","Monroe County",3,52,469,229,240
050,17,133,"Illinois","Monroe County",3,53,479,221,258
050,17,133,"Illinois","Monroe County",3,54,479,223,256
050,17,133,"Illinois","Monroe County",3,55,491,233,258
050,17,133,"Illinois","Monroe County",3,56,524,253,271
050,17,133,"Illinois","Monroe County",3,57,549,270,279
050,17,133,"Illinois","Monroe County",3,58,530,263,267
050,17,133,"Illinois","Monroe County",3,59,545,285,260
050,17,133,"Illinois","Monroe County",3,60,558,287,271
050,17,133,"Illinois","Monroe County",3,61,555,270,285
050,17,133,"Illinois","Monroe County",3,62,548,276,272
050,17,133,"Illinois","Monroe County",3,63,577,303,274
050,17,133,"Illinois","Monroe County",3,64,582,291,291
050,17,133,"Illinois","Monroe County",3,65,525,256,269
050,17,133,"Illinois","Monroe County",3,66,487,247,240
050,17,133,"Illinois","Monroe County",3,67,452,229,223
050,17,133,"Illinois","Monroe County",3,68,424,217,207
050,17,133,"Illinois","Monroe County",3,69,405,202,203
050,17,133,"Illinois","Monroe County",3,70,382,180,202
050,17,133,"Illinois","Monroe County",3,71,346,161,185
050,17,133,"Illinois","Monroe County",3,72,330,154,176
050,17,133,"Illinois","Monroe County",3,73,313,161,152
050,17,133,"Illinois","Monroe County",3,74,320,167,153
050,17,133,"Illinois","Monroe County",3,75,232,115,117
050,17,133,"Illinois","Monroe County",3,76,216,95,121
050,17,133,"Illinois","Monroe County",3,77,209,94,115
050,17,133,"Illinois","Monroe County",3,78,210,92,118
050,17,133,"Illinois","Monroe County",3,79,189,91,98
050,17,133,"Illinois","Monroe County",3,80,172,84,88
050,17,133,"Illinois","Monroe County",3,81,158,66,92
050,17,133,"Illinois","Monroe County",3,82,146,58,88
050,17,133,"Illinois","Monroe County",3,83,154,66,88
050,17,133,"Illinois","Monroe County",3,84,125,44,81
050,17,133,"Illinois","Monroe County",3,85,790,267,523
050,17,133,"Illinois","Monroe County",4,0,240,136,104
050,17,133,"Illinois","Monroe County",4,1,317,167,150
050,17,133,"Illinois","Monroe County",4,2,402,224,178
050,17,133,"Illinois","Monroe County",4,3,386,210,176
050,17,133,"Illinois","Monroe County",4,4,412,225,187
050,17,133,"Illinois","Monroe County",4,5,410,229,181
050,17,133,"Illinois","Monroe County",4,6,461,248,213
050,17,133,"Illinois","Monroe County",4,7,462,243,219
050,17,133,"Illinois","Monroe County",4,8,406,193,213
050,17,133,"Illinois","Monroe County",4,9,429,217,212
050,17,133,"Illinois","Monroe County",4,10,441,228,213
050,17,133,"Illinois","Monroe County",4,11,417,212,205
050,17,133,"Illinois","Monroe County",4,12,457,225,232
050,17,133,"Illinois","Monroe County",4,13,464,235,229
050,17,133,"Illinois","Monroe County",4,14,471,245,226
050,17,133,"Illinois","Monroe County",4,15,498,258,240
050,17,133,"Illinois","Monroe County",4,16,491,254,237
050,17,133,"Illinois","Monroe County",4,17,459,223,236
050,17,133,"Illinois","Monroe County",4,18,371,198,173
050,17,133,"Illinois","Monroe County",4,19,290,161,129
050,17,133,"Illinois","Monroe County",4,20,325,189,136
050,17,133,"Illinois","Monroe County",4,21,352,195,157
050,17,133,"Illinois","Monroe County",4,22,353,189,164
050,17,133,"Illinois","Monroe County",4,23,332,181,151
050,17,133,"Illinois","Monroe County",4,24,351,201,150
050,17,133,"Illinois","Monroe County",4,25,302,147,155
050,17,133,"Illinois","Monroe County",4,26,327,166,161
050,17,133,"Illinois","Monroe County",4,27,332,167,165
050,17,133,"Illinois","Monroe County",4,28,328,182,146
050,17,133,"Illinois","Monroe County",4,29,338,192,146
050,17,133,"Illinois","Monroe County",4,30,350,162,188
050,17,133,"Illinois","Monroe County",4,31,386,195,191
050,17,133,"Illinois","Monroe County",4,32,376,186,190
050,17,133,"Illinois","Monroe County",4,33,396,194,202
050,17,133,"Illinois","Monroe County",4,34,402,192,210
050,17,133,"Illinois","Monroe County",4,35,425,197,228
050,17,133,"Illinois","Monroe County",4,36,460,217,243
050,17,133,"Illinois","Monroe County",4,37,487,245,242
050,17,133,"Illinois","Monroe County",4,38,479,250,229
050,17,133,"Illinois","Monroe County",4,39,485,231,254
050,17,133,"Illinois","Monroe County",4,40,533,266,267
050,17,133,"Illinois","Monroe County",4,41,525,264,261
050,17,133,"Illinois","Monroe County",4,42,490,246,244
050,17,133,"Illinois","Monroe County",4,43,506,259,247
050,17,133,"Illinois","Monroe County",4,44,486,266,220
050,17,133,"Illinois","Monroe County",4,45,432,238,194
050,17,133,"Illinois","Monroe County",4,46,417,229,188
050,17,133,"Illinois","Monroe County",4,47,404,215,189
050,17,133,"Illinois","Monroe County",4,48,408,209,199
050,17,133,"Illinois","Monroe County",4,49,410,196,214
050,17,133,"Illinois","Monroe County",4,50,435,233,202
050,17,133,"Illinois","Monroe County",4,51,467,240,227
050,17,133,"Illinois","Monroe County",4,52,459,228,231
050,17,133,"Illinois","Monroe County",4,53,470,221,249
050,17,133,"Illinois","Monroe County",4,54,475,219,256
050,17,133,"Illinois","Monroe County",4,55,467,216,251
050,17,133,"Illinois","Monroe County",4,56,490,230,260
050,17,133,"Illinois","Monroe County",4,57,527,252,275
050,17,133,"Illinois","Monroe County",4,58,536,263,273
050,17,133,"Illinois","Monroe County",4,59,528,257,271
050,17,133,"Illinois","Monroe County",4,60,530,272,258
050,17,133,"Illinois","Monroe County",4,61,555,281,274
050,17,133,"Illinois","Monroe County",4,62,551,271,280
050,17,133,"Illinois","Monroe County",4,63,558,281,277
050,17,133,"Illinois","Monroe County",4,64,575,305,270
050,17,133,"Illinois","Monroe County",4,65,572,281,291
050,17,133,"Illinois","Monroe County",4,66,515,250,265
050,17,133,"Illinois","Monroe County",4,67,491,244,247
050,17,133,"Illinois","Monroe County",4,68,459,232,227
050,17,133,"Illinois","Monroe County",4,69,416,212,204
050,17,133,"Illinois","Monroe County",4,70,401,199,202
050,17,133,"Illinois","Monroe County",4,71,383,182,201
050,17,133,"Illinois","Monroe County",4,72,346,158,188
050,17,133,"Illinois","Monroe County",4,73,317,144,173
050,17,133,"Illinois","Monroe County",4,74,304,153,151
050,17,133,"Illinois","Monroe County",4,75,300,159,141
050,17,133,"Illinois","Monroe County",4,76,230,110,120
050,17,133,"Illinois","Monroe County",4,77,210,96,114
050,17,133,"Illinois","Monroe County",4,78,190,80,110
050,17,133,"Illinois","Monroe County",4,79,204,88,116
050,17,133,"Illinois","Monroe County",4,80,183,83,100
050,17,133,"Illinois","Monroe County",4,81,164,77,87
050,17,133,"Illinois","Monroe County",4,82,155,65,90
050,17,133,"Illinois","Monroe County",4,83,141,51,90
050,17,133,"Illinois","Monroe County",4,84,134,57,77
050,17,133,"Illinois","Monroe County",4,85,782,243,539
050,17,133,"Illinois","Monroe County",5,0,131,75,56
050,17,133,"Illinois","Monroe County",5,1,276,152,124
050,17,133,"Illinois","Monroe County",5,2,336,170,166
050,17,133,"Illinois","Monroe County",5,3,398,219,179
050,17,133,"Illinois","Monroe County",5,4,403,213,190
050,17,133,"Illinois","Monroe County",5,5,431,232,199
050,17,133,"Illinois","Monroe County",5,6,409,223,186
050,17,133,"Illinois","Monroe County",5,7,468,246,222
050,17,133,"Illinois","Monroe County",5,8,467,242,225
050,17,133,"Illinois","Monroe County",5,9,414,200,214
050,17,133,"Illinois","Monroe County",5,10,431,215,216
050,17,133,"Illinois","Monroe County",5,11,455,231,224
050,17,133,"Illinois","Monroe County",5,12,424,221,203
050,17,133,"Illinois","Monroe County",5,13,449,223,226
050,17,133,"Illinois","Monroe County",5,14,466,229,237
050,17,133,"Illinois","Monroe County",5,15,468,238,230
050,17,133,"Illinois","Monroe County",5,16,501,260,241
050,17,133,"Illinois","Monroe County",5,17,487,246,241
050,17,133,"Illinois","Monroe County",5,18,384,192,192
050,17,133,"Illinois","Monroe County",5,19,290,152,138
050,17,133,"Illinois","Monroe County",5,20,311,171,140
050,17,133,"Illinois","Monroe County",5,21,343,197,146
050,17,133,"Illinois","Monroe County",5,22,371,201,170
050,17,133,"Illinois","Monroe County",5,23,358,190,168
050,17,133,"Illinois","Monroe County",5,24,310,164,146
050,17,133,"Illinois","Monroe County",5,25,328,184,144
050,17,133,"Illinois","Monroe County",5,26,289,141,148
050,17,133,"Illinois","Monroe County",5,27,330,165,165
050,17,133,"Illinois","Monroe County",5,28,341,174,167
050,17,133,"Illinois","Monroe County",5,29,333,175,158
050,17,133,"Illinois","Monroe County",5,30,340,198,142
050,17,133,"Illinois","Monroe County",5,31,363,167,196
050,17,133,"Illinois","Monroe County",5,32,396,204,192
050,17,133,"Illinois","Monroe County",5,33,386,194,192
050,17,133,"Illinois","Monroe County",5,34,410,203,207
050,17,133,"Illinois","Monroe County",5,35,414,194,220
050,17,133,"Illinois","Monroe County",5,36,438,200,238
050,17,133,"Illinois","Monroe County",5,37,477,225,252
050,17,133,"Illinois","Monroe County",5,38,492,247,245
050,17,133,"Illinois","Monroe County",5,39,492,259,233
050,17,133,"Illinois","Monroe County",5,40,493,240,253
050,17,133,"Illinois","Monroe County",5,41,547,276,271
050,17,133,"Illinois","Monroe County",5,42,535,269,266
050,17,133,"Illinois","Monroe County",5,43,498,250,248
050,17,133,"Illinois","Monroe County",5,44,506,258,248
050,17,133,"Illinois","Monroe County",5,45,477,259,218
050,17,133,"Illinois","Monroe County",5,46,440,241,199
050,17,133,"Illinois","Monroe County",5,47,416,225,191
050,17,133,"Illinois","Monroe County",5,48,405,216,189
050,17,133,"Illinois","Monroe County",5,49,404,209,195
050,17,133,"Illinois","Monroe County",5,50,413,203,210
050,17,133,"Illinois","Monroe County",5,51,429,228,201
050,17,133,"Illinois","Monroe County",5,52,457,233,224
050,17,133,"Illinois","Monroe County",5,53,459,229,230
050,17,133,"Illinois","Monroe County",5,54,463,216,247
050,17,133,"Illinois","Monroe County",5,55,481,221,260
050,17,133,"Illinois","Monroe County",5,56,474,222,252
050,17,133,"Illinois","Monroe County",5,57,487,229,258
050,17,133,"Illinois","Monroe County",5,58,525,250,275
050,17,133,"Illinois","Monroe County",5,59,544,268,276
050,17,133,"Illinois","Monroe County",5,60,513,252,261
050,17,133,"Illinois","Monroe County",5,61,524,266,258
050,17,133,"Illinois","Monroe County",5,62,553,279,274
050,17,133,"Illinois","Monroe County",5,63,545,267,278
050,17,133,"Illinois","Monroe County",5,64,559,275,284
050,17,133,"Illinois","Monroe County",5,65,569,298,271
050,17,133,"Illinois","Monroe County",5,66,570,280,290
050,17,133,"Illinois","Monroe County",5,67,505,247,258
050,17,133,"Illinois","Monroe County",5,68,494,244,250
050,17,133,"Illinois","Monroe County",5,69,446,226,220
050,17,133,"Illinois","Monroe County",5,70,411,210,201
050,17,133,"Illinois","Monroe County",5,71,394,200,194
050,17,133,"Illinois","Monroe County",5,72,370,169,201
050,17,133,"Illinois","Monroe County",5,73,333,149,184
050,17,133,"Illinois","Monroe County",5,74,307,138,169
050,17,133,"Illinois","Monroe County",5,75,292,152,140
050,17,133,"Illinois","Monroe County",5,76,295,153,142
050,17,133,"Illinois","Monroe County",5,77,226,108,118
050,17,133,"Illinois","Monroe County",5,78,195,88,107
050,17,133,"Illinois","Monroe County",5,79,183,76,107
050,17,133,"Illinois","Monroe County",5,80,197,84,113
050,17,133,"Illinois","Monroe County",5,81,174,76,98
050,17,133,"Illinois","Monroe County",5,82,162,75,87
050,17,133,"Illinois","Monroe County",5,83,146,60,86
050,17,133,"Illinois","Monroe County",5,84,128,42,86
050,17,133,"Illinois","Monroe County",5,85,803,247,556
050,17,135,"Illinois","Montgomery County",1,0,288,145,143
050,17,135,"Illinois","Montgomery County",1,1,285,144,141
050,17,135,"Illinois","Montgomery County",1,2,288,147,141
050,17,135,"Illinois","Montgomery County",1,3,318,155,163
050,17,135,"Illinois","Montgomery County",1,4,302,143,159
050,17,135,"Illinois","Montgomery County",1,5,292,146,146
050,17,135,"Illinois","Montgomery County",1,6,307,149,158
050,17,135,"Illinois","Montgomery County",1,7,304,156,148
050,17,135,"Illinois","Montgomery County",1,8,323,162,161
050,17,135,"Illinois","Montgomery County",1,9,324,160,164
050,17,135,"Illinois","Montgomery County",1,10,321,159,162
050,17,135,"Illinois","Montgomery County",1,11,355,191,164
050,17,135,"Illinois","Montgomery County",1,12,364,191,173
050,17,135,"Illinois","Montgomery County",1,13,368,183,185
050,17,135,"Illinois","Montgomery County",1,14,341,183,158
050,17,135,"Illinois","Montgomery County",1,15,322,164,158
050,17,135,"Illinois","Montgomery County",1,16,341,175,166
050,17,135,"Illinois","Montgomery County",1,17,352,184,168
050,17,135,"Illinois","Montgomery County",1,18,301,169,132
050,17,135,"Illinois","Montgomery County",1,19,248,148,100
050,17,135,"Illinois","Montgomery County",1,20,273,166,107
050,17,135,"Illinois","Montgomery County",1,21,270,162,108
050,17,135,"Illinois","Montgomery County",1,22,330,211,119
050,17,135,"Illinois","Montgomery County",1,23,322,197,125
050,17,135,"Illinois","Montgomery County",1,24,314,183,131
050,17,135,"Illinois","Montgomery County",1,25,329,197,132
050,17,135,"Illinois","Montgomery County",1,26,347,205,142
050,17,135,"Illinois","Montgomery County",1,27,339,194,145
050,17,135,"Illinois","Montgomery County",1,28,370,221,149
050,17,135,"Illinois","Montgomery County",1,29,332,202,130
050,17,135,"Illinois","Montgomery County",1,30,365,230,135
050,17,135,"Illinois","Montgomery County",1,31,336,201,135
050,17,135,"Illinois","Montgomery County",1,32,340,205,135
050,17,135,"Illinois","Montgomery County",1,33,312,171,141
050,17,135,"Illinois","Montgomery County",1,34,325,177,148
050,17,135,"Illinois","Montgomery County",1,35,356,201,155
050,17,135,"Illinois","Montgomery County",1,36,359,210,149
050,17,135,"Illinois","Montgomery County",1,37,400,230,170
050,17,135,"Illinois","Montgomery County",1,38,408,226,182
050,17,135,"Illinois","Montgomery County",1,39,375,211,164
050,17,135,"Illinois","Montgomery County",1,40,375,222,153
050,17,135,"Illinois","Montgomery County",1,41,325,191,134
050,17,135,"Illinois","Montgomery County",1,42,321,183,138
050,17,135,"Illinois","Montgomery County",1,43,323,188,135
050,17,135,"Illinois","Montgomery County",1,44,318,175,143
050,17,135,"Illinois","Montgomery County",1,45,320,181,139
050,17,135,"Illinois","Montgomery County",1,46,316,190,126
050,17,135,"Illinois","Montgomery County",1,47,326,190,136
050,17,135,"Illinois","Montgomery County",1,48,346,194,152
050,17,135,"Illinois","Montgomery County",1,49,374,211,163
050,17,135,"Illinois","Montgomery County",1,50,338,186,152
050,17,135,"Illinois","Montgomery County",1,51,367,202,165
050,17,135,"Illinois","Montgomery County",1,52,336,186,150
050,17,135,"Illinois","Montgomery County",1,53,361,196,165
050,17,135,"Illinois","Montgomery County",1,54,391,191,200
050,17,135,"Illinois","Montgomery County",1,55,413,196,217
050,17,135,"Illinois","Montgomery County",1,56,403,206,197
050,17,135,"Illinois","Montgomery County",1,57,411,215,196
050,17,135,"Illinois","Montgomery County",1,58,453,223,230
050,17,135,"Illinois","Montgomery County",1,59,444,219,225
050,17,135,"Illinois","Montgomery County",1,60,418,203,215
050,17,135,"Illinois","Montgomery County",1,61,411,214,197
050,17,135,"Illinois","Montgomery County",1,62,412,207,205
050,17,135,"Illinois","Montgomery County",1,63,416,202,214
050,17,135,"Illinois","Montgomery County",1,64,438,220,218
050,17,135,"Illinois","Montgomery County",1,65,390,200,190
050,17,135,"Illinois","Montgomery County",1,66,357,183,174
050,17,135,"Illinois","Montgomery County",1,67,378,192,186
050,17,135,"Illinois","Montgomery County",1,68,358,177,181
050,17,135,"Illinois","Montgomery County",1,69,335,172,163
050,17,135,"Illinois","Montgomery County",1,70,307,157,150
050,17,135,"Illinois","Montgomery County",1,71,304,154,150
050,17,135,"Illinois","Montgomery County",1,72,274,137,137
050,17,135,"Illinois","Montgomery County",1,73,288,139,149
050,17,135,"Illinois","Montgomery County",1,74,196,94,102
050,17,135,"Illinois","Montgomery County",1,75,200,94,106
050,17,135,"Illinois","Montgomery County",1,76,206,93,113
050,17,135,"Illinois","Montgomery County",1,77,204,98,106
050,17,135,"Illinois","Montgomery County",1,78,195,88,107
050,17,135,"Illinois","Montgomery County",1,79,185,75,110
050,17,135,"Illinois","Montgomery County",1,80,174,65,109
050,17,135,"Illinois","Montgomery County",1,81,170,77,93
050,17,135,"Illinois","Montgomery County",1,82,150,61,89
050,17,135,"Illinois","Montgomery County",1,83,122,49,73
050,17,135,"Illinois","Montgomery County",1,84,123,52,71
050,17,135,"Illinois","Montgomery County",1,85,865,288,577
050,17,135,"Illinois","Montgomery County",2,0,278,142,136
050,17,135,"Illinois","Montgomery County",2,1,283,143,140
050,17,135,"Illinois","Montgomery County",2,2,288,146,142
050,17,135,"Illinois","Montgomery County",2,3,311,154,157
050,17,135,"Illinois","Montgomery County",2,4,307,146,161
050,17,135,"Illinois","Montgomery County",2,5,295,145,150
050,17,135,"Illinois","Montgomery County",2,6,304,149,155
050,17,135,"Illinois","Montgomery County",2,7,305,153,152
050,17,135,"Illinois","Montgomery County",2,8,319,161,158
050,17,135,"Illinois","Montgomery County",2,9,322,161,161
050,17,135,"Illinois","Montgomery County",2,10,320,159,161
050,17,135,"Illinois","Montgomery County",2,11,342,180,162
050,17,135,"Illinois","Montgomery County",2,12,362,191,171
050,17,135,"Illinois","Montgomery County",2,13,366,185,181
050,17,135,"Illinois","Montgomery County",2,14,348,182,166
050,17,135,"Illinois","Montgomery County",2,15,326,169,157
050,17,135,"Illinois","Montgomery County",2,16,335,171,164
050,17,135,"Illinois","Montgomery County",2,17,351,183,168
050,17,135,"Illinois","Montgomery County",2,18,300,168,132
050,17,135,"Illinois","Montgomery County",2,19,250,149,101
050,17,135,"Illinois","Montgomery County",2,20,275,165,110
050,17,135,"Illinois","Montgomery County",2,21,274,164,110
050,17,135,"Illinois","Montgomery County",2,22,329,210,119
050,17,135,"Illinois","Montgomery County",2,23,316,192,124
050,17,135,"Illinois","Montgomery County",2,24,313,184,129
050,17,135,"Illinois","Montgomery County",2,25,327,194,133
050,17,135,"Illinois","Montgomery County",2,26,342,203,139
050,17,135,"Illinois","Montgomery County",2,27,339,194,145
050,17,135,"Illinois","Montgomery County",2,28,362,216,146
050,17,135,"Illinois","Montgomery County",2,29,342,208,134
050,17,135,"Illinois","Montgomery County",2,30,358,224,134
050,17,135,"Illinois","Montgomery County",2,31,340,207,133
050,17,135,"Illinois","Montgomery County",2,32,335,200,135
050,17,135,"Illinois","Montgomery County",2,33,317,176,141
050,17,135,"Illinois","Montgomery County",2,34,323,178,145
050,17,135,"Illinois","Montgomery County",2,35,348,196,152
050,17,135,"Illinois","Montgomery County",2,36,357,207,150
050,17,135,"Illinois","Montgomery County",2,37,388,223,165
050,17,135,"Illinois","Montgomery County",2,38,410,230,180
050,17,135,"Illinois","Montgomery County",2,39,384,216,168
050,17,135,"Illinois","Montgomery County",2,40,377,220,157
050,17,135,"Illinois","Montgomery County",2,41,333,194,139
050,17,135,"Illinois","Montgomery County",2,42,320,184,136
050,17,135,"Illinois","Montgomery County",2,43,327,190,137
050,17,135,"Illinois","Montgomery County",2,44,313,175,138
050,17,135,"Illinois","Montgomery County",2,45,319,179,140
050,17,135,"Illinois","Montgomery County",2,46,315,187,128
050,17,135,"Illinois","Montgomery County",2,47,322,191,131
050,17,135,"Illinois","Montgomery County",2,48,339,191,148
050,17,135,"Illinois","Montgomery County",2,49,365,205,160
050,17,135,"Illinois","Montgomery County",2,50,345,190,155
050,17,135,"Illinois","Montgomery County",2,51,359,197,162
050,17,135,"Illinois","Montgomery County",2,52,342,188,154
050,17,135,"Illinois","Montgomery County",2,53,354,193,161
050,17,135,"Illinois","Montgomery County",2,54,378,190,188
050,17,135,"Illinois","Montgomery County",2,55,406,195,211
050,17,135,"Illinois","Montgomery County",2,56,407,204,203
050,17,135,"Illinois","Montgomery County",2,57,409,213,196
050,17,135,"Illinois","Montgomery County",2,58,442,219,223
050,17,135,"Illinois","Montgomery County",2,59,444,218,226
050,17,135,"Illinois","Montgomery County",2,60,423,205,218
050,17,135,"Illinois","Montgomery County",2,61,412,210,202
050,17,135,"Illinois","Montgomery County",2,62,407,205,202
050,17,135,"Illinois","Montgomery County",2,63,416,203,213
050,17,135,"Illinois","Montgomery County",2,64,426,212,214
050,17,135,"Illinois","Montgomery County",2,65,398,203,195
050,17,135,"Illinois","Montgomery County",2,66,367,188,179
050,17,135,"Illinois","Montgomery County",2,67,375,191,184
050,17,135,"Illinois","Montgomery County",2,68,357,177,180
050,17,135,"Illinois","Montgomery County",2,69,344,176,168
050,17,135,"Illinois","Montgomery County",2,70,309,157,152
050,17,135,"Illinois","Montgomery County",2,71,303,155,148
050,17,135,"Illinois","Montgomery County",2,72,275,138,137
050,17,135,"Illinois","Montgomery County",2,73,299,146,153
050,17,135,"Illinois","Montgomery County",2,74,203,97,106
050,17,135,"Illinois","Montgomery County",2,75,197,94,103
050,17,135,"Illinois","Montgomery County",2,76,203,91,112
050,17,135,"Illinois","Montgomery County",2,77,206,97,109
050,17,135,"Illinois","Montgomery County",2,78,189,86,103
050,17,135,"Illinois","Montgomery County",2,79,184,76,108
050,17,135,"Illinois","Montgomery County",2,80,174,67,107
050,17,135,"Illinois","Montgomery County",2,81,171,75,96
050,17,135,"Illinois","Montgomery County",2,82,151,60,91
050,17,135,"Illinois","Montgomery County",2,83,125,51,74
050,17,135,"Illinois","Montgomery County",2,84,117,50,67
050,17,135,"Illinois","Montgomery County",2,85,864,291,573
050,17,135,"Illinois","Montgomery County",3,0,249,143,106
050,17,135,"Illinois","Montgomery County",3,1,287,142,145
050,17,135,"Illinois","Montgomery County",3,2,294,144,150
050,17,135,"Illinois","Montgomery County",3,3,283,144,139
050,17,135,"Illinois","Montgomery County",3,4,306,151,155
050,17,135,"Illinois","Montgomery County",3,5,312,150,162
050,17,135,"Illinois","Montgomery County",3,6,300,155,145
050,17,135,"Illinois","Montgomery County",3,7,309,151,158
050,17,135,"Illinois","Montgomery County",3,8,304,154,150
050,17,135,"Illinois","Montgomery County",3,9,314,158,156
050,17,135,"Illinois","Montgomery County",3,10,317,155,162
050,17,135,"Illinois","Montgomery County",3,11,312,155,157
050,17,135,"Illinois","Montgomery County",3,12,343,179,164
050,17,135,"Illinois","Montgomery County",3,13,367,197,170
050,17,135,"Illinois","Montgomery County",3,14,363,183,180
050,17,135,"Illinois","Montgomery County",3,15,346,179,167
050,17,135,"Illinois","Montgomery County",3,16,322,166,156
050,17,135,"Illinois","Montgomery County",3,17,345,173,172
050,17,135,"Illinois","Montgomery County",3,18,323,185,138
050,17,135,"Illinois","Montgomery County",3,19,259,154,105
050,17,135,"Illinois","Montgomery County",3,20,286,166,120
050,17,135,"Illinois","Montgomery County",3,21,297,174,123
050,17,135,"Illinois","Montgomery County",3,22,329,215,114
050,17,135,"Illinois","Montgomery County",3,23,297,178,119
050,17,135,"Illinois","Montgomery County",3,24,326,205,121
050,17,135,"Illinois","Montgomery County",3,25,322,202,120
050,17,135,"Illinois","Montgomery County",3,26,348,216,132
050,17,135,"Illinois","Montgomery County",3,27,328,195,133
050,17,135,"Illinois","Montgomery County",3,28,347,201,146
050,17,135,"Illinois","Montgomery County",3,29,357,220,137
050,17,135,"Illinois","Montgomery County",3,30,361,226,135
050,17,135,"Illinois","Montgomery County",3,31,354,221,133
050,17,135,"Illinois","Montgomery County",3,32,344,215,129
050,17,135,"Illinois","Montgomery County",3,33,331,196,135
050,17,135,"Illinois","Montgomery County",3,34,335,200,135
050,17,135,"Illinois","Montgomery County",3,35,337,192,145
050,17,135,"Illinois","Montgomery County",3,36,365,207,158
050,17,135,"Illinois","Montgomery County",3,37,346,200,146
050,17,135,"Illinois","Montgomery County",3,38,395,236,159
050,17,135,"Illinois","Montgomery County",3,39,406,230,176
050,17,135,"Illinois","Montgomery County",3,40,395,229,166
050,17,135,"Illinois","Montgomery County",3,41,377,218,159
050,17,135,"Illinois","Montgomery County",3,42,337,201,136
050,17,135,"Illinois","Montgomery County",3,43,335,199,136
050,17,135,"Illinois","Montgomery County",3,44,327,191,136
050,17,135,"Illinois","Montgomery County",3,45,308,172,136
050,17,135,"Illinois","Montgomery County",3,46,335,189,146
050,17,135,"Illinois","Montgomery County",3,47,322,195,127
050,17,135,"Illinois","Montgomery County",3,48,309,179,130
050,17,135,"Illinois","Montgomery County",3,49,337,190,147
050,17,135,"Illinois","Montgomery County",3,50,362,201,161
050,17,135,"Illinois","Montgomery County",3,51,337,189,148
050,17,135,"Illinois","Montgomery County",3,52,352,198,154
050,17,135,"Illinois","Montgomery County",3,53,347,186,161
050,17,135,"Illinois","Montgomery County",3,54,342,181,161
050,17,135,"Illinois","Montgomery County",3,55,380,190,190
050,17,135,"Illinois","Montgomery County",3,56,402,189,213
050,17,135,"Illinois","Montgomery County",3,57,409,207,202
050,17,135,"Illinois","Montgomery County",3,58,393,199,194
050,17,135,"Illinois","Montgomery County",3,59,427,215,212
050,17,135,"Illinois","Montgomery County",3,60,427,211,216
050,17,135,"Illinois","Montgomery County",3,61,426,207,219
050,17,135,"Illinois","Montgomery County",3,62,403,205,198
050,17,135,"Illinois","Montgomery County",3,63,409,210,199
050,17,135,"Illinois","Montgomery County",3,64,419,209,210
050,17,135,"Illinois","Montgomery County",3,65,407,198,209
050,17,135,"Illinois","Montgomery County",3,66,377,192,185
050,17,135,"Illinois","Montgomery County",3,67,363,185,178
050,17,135,"Illinois","Montgomery County",3,68,344,175,169
050,17,135,"Illinois","Montgomery County",3,69,350,175,175
050,17,135,"Illinois","Montgomery County",3,70,329,163,166
050,17,135,"Illinois","Montgomery County",3,71,301,155,146
050,17,135,"Illinois","Montgomery County",3,72,275,136,139
050,17,135,"Illinois","Montgomery County",3,73,270,134,136
050,17,135,"Illinois","Montgomery County",3,74,296,144,152
050,17,135,"Illinois","Montgomery County",3,75,192,93,99
050,17,135,"Illinois","Montgomery County",3,76,188,87,101
050,17,135,"Illinois","Montgomery County",3,77,188,83,105
050,17,135,"Illinois","Montgomery County",3,78,187,88,99
050,17,135,"Illinois","Montgomery County",3,79,175,76,99
050,17,135,"Illinois","Montgomery County",3,80,165,68,97
050,17,135,"Illinois","Montgomery County",3,81,168,68,100
050,17,135,"Illinois","Montgomery County",3,82,158,63,95
050,17,135,"Illinois","Montgomery County",3,83,146,57,89
050,17,135,"Illinois","Montgomery County",3,84,108,44,64
050,17,135,"Illinois","Montgomery County",3,85,812,268,544
050,17,135,"Illinois","Montgomery County",4,0,233,137,96
050,17,135,"Illinois","Montgomery County",4,1,264,154,110
050,17,135,"Illinois","Montgomery County",4,2,285,145,140
050,17,135,"Illinois","Montgomery County",4,3,303,150,153
050,17,135,"Illinois","Montgomery County",4,4,287,149,138
050,17,135,"Illinois","Montgomery County",4,5,314,164,150
050,17,135,"Illinois","Montgomery County",4,6,312,156,156
050,17,135,"Illinois","Montgomery County",4,7,309,159,150
050,17,135,"Illinois","Montgomery County",4,8,320,152,168
050,17,135,"Illinois","Montgomery County",4,9,304,154,150
050,17,135,"Illinois","Montgomery County",4,10,307,154,153
050,17,135,"Illinois","Montgomery County",4,11,327,161,166
050,17,135,"Illinois","Montgomery County",4,12,317,158,159
050,17,135,"Illinois","Montgomery County",4,13,336,169,167
050,17,135,"Illinois","Montgomery County",4,14,368,199,169
050,17,135,"Illinois","Montgomery County",4,15,361,184,177
050,17,135,"Illinois","Montgomery County",4,16,339,170,169
050,17,135,"Illinois","Montgomery County",4,17,324,168,156
050,17,135,"Illinois","Montgomery County",4,18,301,160,141
050,17,135,"Illinois","Montgomery County",4,19,258,154,104
050,17,135,"Illinois","Montgomery County",4,20,289,172,117
050,17,135,"Illinois","Montgomery County",4,21,302,174,128
050,17,135,"Illinois","Montgomery County",4,22,341,211,130
050,17,135,"Illinois","Montgomery County",4,23,299,184,115
050,17,135,"Illinois","Montgomery County",4,24,301,175,126
050,17,135,"Illinois","Montgomery County",4,25,336,219,117
050,17,135,"Illinois","Montgomery County",4,26,340,211,129
050,17,135,"Illinois","Montgomery County",4,27,338,205,133
050,17,135,"Illinois","Montgomery County",4,28,330,199,131
050,17,135,"Illinois","Montgomery County",4,29,324,193,131
050,17,135,"Illinois","Montgomery County",4,30,362,221,141
050,17,135,"Illinois","Montgomery County",4,31,344,204,140
050,17,135,"Illinois","Montgomery County",4,32,345,207,138
050,17,135,"Illinois","Montgomery County",4,33,333,195,138
050,17,135,"Illinois","Montgomery County",4,34,337,205,132
050,17,135,"Illinois","Montgomery County",4,35,337,201,136
050,17,135,"Illinois","Montgomery County",4,36,340,185,155
050,17,135,"Illinois","Montgomery County",4,37,354,199,155
050,17,135,"Illinois","Montgomery County",4,38,362,213,149
050,17,135,"Illinois","Montgomery County",4,39,398,232,166
050,17,135,"Illinois","Montgomery County",4,40,412,238,174
050,17,135,"Illinois","Montgomery County",4,41,385,216,169
050,17,135,"Illinois","Montgomery County",4,42,382,217,165
050,17,135,"Illinois","Montgomery County",4,43,339,201,138
050,17,135,"Illinois","Montgomery County",4,44,327,193,134
050,17,135,"Illinois","Montgomery County",4,45,331,189,142
050,17,135,"Illinois","Montgomery County",4,46,317,175,142
050,17,135,"Illinois","Montgomery County",4,47,336,186,150
050,17,135,"Illinois","Montgomery County",4,48,316,183,133
050,17,135,"Illinois","Montgomery County",4,49,312,177,135
050,17,135,"Illinois","Montgomery County",4,50,333,185,148
050,17,135,"Illinois","Montgomery County",4,51,364,202,162
050,17,135,"Illinois","Montgomery County",4,52,338,187,151
050,17,135,"Illinois","Montgomery County",4,53,353,198,155
050,17,135,"Illinois","Montgomery County",4,54,335,177,158
050,17,135,"Illinois","Montgomery County",4,55,344,184,160
050,17,135,"Illinois","Montgomery County",4,56,374,180,194
050,17,135,"Illinois","Montgomery County",4,57,400,190,210
050,17,135,"Illinois","Montgomery County",4,58,402,198,204
050,17,135,"Illinois","Montgomery County",4,59,376,189,187
050,17,135,"Illinois","Montgomery County",4,60,425,211,214
050,17,135,"Illinois","Montgomery County",4,61,425,211,214
050,17,135,"Illinois","Montgomery County",4,62,413,201,212
050,17,135,"Illinois","Montgomery County",4,63,402,206,196
050,17,135,"Illinois","Montgomery County",4,64,404,205,199
050,17,135,"Illinois","Montgomery County",4,65,408,197,211
050,17,135,"Illinois","Montgomery County",4,66,403,192,211
050,17,135,"Illinois","Montgomery County",4,67,376,190,186
050,17,135,"Illinois","Montgomery County",4,68,344,173,171
050,17,135,"Illinois","Montgomery County",4,69,346,177,169
050,17,135,"Illinois","Montgomery County",4,70,336,163,173
050,17,135,"Illinois","Montgomery County",4,71,324,163,161
050,17,135,"Illinois","Montgomery County",4,72,279,146,133
050,17,135,"Illinois","Montgomery County",4,73,272,133,139
050,17,135,"Illinois","Montgomery County",4,74,266,131,135
050,17,135,"Illinois","Montgomery County",4,75,276,131,145
050,17,135,"Illinois","Montgomery County",4,76,191,91,100
050,17,135,"Illinois","Montgomery County",4,77,180,84,96
050,17,135,"Illinois","Montgomery County",4,78,166,71,95
050,17,135,"Illinois","Montgomery County",4,79,171,78,93
050,17,135,"Illinois","Montgomery County",4,80,162,70,92
050,17,135,"Illinois","Montgomery County",4,81,159,71,88
050,17,135,"Illinois","Montgomery County",4,82,155,54,101
050,17,135,"Illinois","Montgomery County",4,83,147,58,89
050,17,135,"Illinois","Montgomery County",4,84,126,46,80
050,17,135,"Illinois","Montgomery County",4,85,788,258,530
050,17,135,"Illinois","Montgomery County",5,0,230,134,96
050,17,135,"Illinois","Montgomery County",5,1,224,130,94
050,17,135,"Illinois","Montgomery County",5,2,265,153,112
050,17,135,"Illinois","Montgomery County",5,3,282,149,133
050,17,135,"Illinois","Montgomery County",5,4,301,147,154
050,17,135,"Illinois","Montgomery County",5,5,291,155,136
050,17,135,"Illinois","Montgomery County",5,6,317,164,153
050,17,135,"Illinois","Montgomery County",5,7,315,159,156
050,17,135,"Illinois","Montgomery County",5,8,309,164,145
050,17,135,"Illinois","Montgomery County",5,9,322,158,164
050,17,135,"Illinois","Montgomery County",5,10,310,159,151
050,17,135,"Illinois","Montgomery County",5,11,311,156,155
050,17,135,"Illinois","Montgomery County",5,12,318,161,157
050,17,135,"Illinois","Montgomery County",5,13,317,157,160
050,17,135,"Illinois","Montgomery County",5,14,338,169,169
050,17,135,"Illinois","Montgomery County",5,15,379,202,177
050,17,135,"Illinois","Montgomery County",5,16,356,182,174
050,17,135,"Illinois","Montgomery County",5,17,347,180,167
050,17,135,"Illinois","Montgomery County",5,18,284,160,124
050,17,135,"Illinois","Montgomery County",5,19,246,143,103
050,17,135,"Illinois","Montgomery County",5,20,296,175,121
050,17,135,"Illinois","Montgomery County",5,21,310,189,121
050,17,135,"Illinois","Montgomery County",5,22,362,223,139
050,17,135,"Illinois","Montgomery County",5,23,314,186,128
050,17,135,"Illinois","Montgomery County",5,24,291,188,103
050,17,135,"Illinois","Montgomery County",5,25,306,179,127
050,17,135,"Illinois","Montgomery County",5,26,326,213,113
050,17,135,"Illinois","Montgomery County",5,27,320,197,123
050,17,135,"Illinois","Montgomery County",5,28,344,209,135
050,17,135,"Illinois","Montgomery County",5,29,324,201,123
050,17,135,"Illinois","Montgomery County",5,30,335,198,137
050,17,135,"Illinois","Montgomery County",5,31,346,205,141
050,17,135,"Illinois","Montgomery County",5,32,337,199,138
050,17,135,"Illinois","Montgomery County",5,33,331,197,134
050,17,135,"Illinois","Montgomery County",5,34,360,210,150
050,17,135,"Illinois","Montgomery County",5,35,340,206,134
050,17,135,"Illinois","Montgomery County",5,36,336,197,139
050,17,135,"Illinois","Montgomery County",5,37,327,178,149
050,17,135,"Illinois","Montgomery County",5,38,363,209,154
050,17,135,"Illinois","Montgomery County",5,39,354,207,147
050,17,135,"Illinois","Montgomery County",5,40,393,231,162
050,17,135,"Illinois","Montgomery County",5,41,393,223,170
050,17,135,"Illinois","Montgomery County",5,42,380,211,169
050,17,135,"Illinois","Montgomery County",5,43,383,220,163
050,17,135,"Illinois","Montgomery County",5,44,337,197,140
050,17,135,"Illinois","Montgomery County",5,45,322,189,133
050,17,135,"Illinois","Montgomery County",5,46,333,187,146
050,17,135,"Illinois","Montgomery County",5,47,317,179,138
050,17,135,"Illinois","Montgomery County",5,48,327,177,150
050,17,135,"Illinois","Montgomery County",5,49,316,178,138
050,17,135,"Illinois","Montgomery County",5,50,307,170,137
050,17,135,"Illinois","Montgomery County",5,51,336,185,151
050,17,135,"Illinois","Montgomery County",5,52,362,197,165
050,17,135,"Illinois","Montgomery County",5,53,337,181,156
050,17,135,"Illinois","Montgomery County",5,54,344,186,158
050,17,135,"Illinois","Montgomery County",5,55,330,178,152
050,17,135,"Illinois","Montgomery County",5,56,324,172,152
050,17,135,"Illinois","Montgomery County",5,57,375,184,191
050,17,135,"Illinois","Montgomery County",5,58,396,188,208
050,17,135,"Illinois","Montgomery County",5,59,386,189,197
050,17,135,"Illinois","Montgomery County",5,60,371,183,188
050,17,135,"Illinois","Montgomery County",5,61,430,216,214
050,17,135,"Illinois","Montgomery County",5,62,421,207,214
050,17,135,"Illinois","Montgomery County",5,63,418,205,213
050,17,135,"Illinois","Montgomery County",5,64,398,202,196
050,17,135,"Illinois","Montgomery County",5,65,386,191,195
050,17,135,"Illinois","Montgomery County",5,66,398,193,205
050,17,135,"Illinois","Montgomery County",5,67,402,192,210
050,17,135,"Illinois","Montgomery County",5,68,359,178,181
050,17,135,"Illinois","Montgomery County",5,69,340,173,167
050,17,135,"Illinois","Montgomery County",5,70,333,166,167
050,17,135,"Illinois","Montgomery County",5,71,328,161,167
050,17,135,"Illinois","Montgomery County",5,72,304,151,153
050,17,135,"Illinois","Montgomery County",5,73,272,139,133
050,17,135,"Illinois","Montgomery County",5,74,271,128,143
050,17,135,"Illinois","Montgomery County",5,75,247,119,128
050,17,135,"Illinois","Montgomery County",5,76,268,128,140
050,17,135,"Illinois","Montgomery County",5,77,182,86,96
050,17,135,"Illinois","Montgomery County",5,78,159,71,88
050,17,135,"Illinois","Montgomery County",5,79,154,62,92
050,17,135,"Illinois","Montgomery County",5,80,159,75,84
050,17,135,"Illinois","Montgomery County",5,81,151,71,80
050,17,135,"Illinois","Montgomery County",5,82,150,56,94
050,17,135,"Illinois","Montgomery County",5,83,145,51,94
050,17,135,"Illinois","Montgomery County",5,84,131,51,80
050,17,135,"Illinois","Montgomery County",5,85,804,258,546
050,17,137,"Illinois","Morgan County",1,0,317,161,156
050,17,137,"Illinois","Morgan County",1,1,315,156,159
050,17,137,"Illinois","Morgan County",1,2,354,173,181
050,17,137,"Illinois","Morgan County",1,3,345,166,179
050,17,137,"Illinois","Morgan County",1,4,339,177,162
050,17,137,"Illinois","Morgan County",1,5,338,192,146
050,17,137,"Illinois","Morgan County",1,6,323,173,150
050,17,137,"Illinois","Morgan County",1,7,351,171,180
050,17,137,"Illinois","Morgan County",1,8,327,158,169
050,17,137,"Illinois","Morgan County",1,9,343,168,175
050,17,137,"Illinois","Morgan County",1,10,342,174,168
050,17,137,"Illinois","Morgan County",1,11,395,214,181
050,17,137,"Illinois","Morgan County",1,12,381,204,177
050,17,137,"Illinois","Morgan County",1,13,379,203,176
050,17,137,"Illinois","Morgan County",1,14,365,193,172
050,17,137,"Illinois","Morgan County",1,15,359,191,168
050,17,137,"Illinois","Morgan County",1,16,391,210,181
050,17,137,"Illinois","Morgan County",1,17,398,198,200
050,17,137,"Illinois","Morgan County",1,18,437,228,209
050,17,137,"Illinois","Morgan County",1,19,459,252,207
050,17,137,"Illinois","Morgan County",1,20,430,229,201
050,17,137,"Illinois","Morgan County",1,21,471,227,244
050,17,137,"Illinois","Morgan County",1,22,409,202,207
050,17,137,"Illinois","Morgan County",1,23,395,220,175
050,17,137,"Illinois","Morgan County",1,24,383,201,182
050,17,137,"Illinois","Morgan County",1,25,378,211,167
050,17,137,"Illinois","Morgan County",1,26,379,212,167
050,17,137,"Illinois","Morgan County",1,27,380,196,184
050,17,137,"Illinois","Morgan County",1,28,384,204,180
050,17,137,"Illinois","Morgan County",1,29,413,223,190
050,17,137,"Illinois","Morgan County",1,30,449,243,206
050,17,137,"Illinois","Morgan County",1,31,407,213,194
050,17,137,"Illinois","Morgan County",1,32,408,219,189
050,17,137,"Illinois","Morgan County",1,33,400,229,171
050,17,137,"Illinois","Morgan County",1,34,410,223,187
050,17,137,"Illinois","Morgan County",1,35,421,226,195
050,17,137,"Illinois","Morgan County",1,36,421,229,192
050,17,137,"Illinois","Morgan County",1,37,444,252,192
050,17,137,"Illinois","Morgan County",1,38,450,262,188
050,17,137,"Illinois","Morgan County",1,39,406,219,187
050,17,137,"Illinois","Morgan County",1,40,401,230,171
050,17,137,"Illinois","Morgan County",1,41,396,203,193
050,17,137,"Illinois","Morgan County",1,42,407,214,193
050,17,137,"Illinois","Morgan County",1,43,416,214,202
050,17,137,"Illinois","Morgan County",1,44,355,187,168
050,17,137,"Illinois","Morgan County",1,45,344,186,158
050,17,137,"Illinois","Morgan County",1,46,383,199,184
050,17,137,"Illinois","Morgan County",1,47,388,209,179
050,17,137,"Illinois","Morgan County",1,48,396,205,191
050,17,137,"Illinois","Morgan County",1,49,395,198,197
050,17,137,"Illinois","Morgan County",1,50,395,202,193
050,17,137,"Illinois","Morgan County",1,51,394,202,192
050,17,137,"Illinois","Morgan County",1,52,421,218,203
050,17,137,"Illinois","Morgan County",1,53,400,213,187
050,17,137,"Illinois","Morgan County",1,54,405,213,192
050,17,137,"Illinois","Morgan County",1,55,439,217,222
050,17,137,"Illinois","Morgan County",1,56,491,226,265
050,17,137,"Illinois","Morgan County",1,57,491,244,247
050,17,137,"Illinois","Morgan County",1,58,521,265,256
050,17,137,"Illinois","Morgan County",1,59,502,255,247
050,17,137,"Illinois","Morgan County",1,60,502,249,253
050,17,137,"Illinois","Morgan County",1,61,500,237,263
050,17,137,"Illinois","Morgan County",1,62,482,236,246
050,17,137,"Illinois","Morgan County",1,63,461,226,235
050,17,137,"Illinois","Morgan County",1,64,455,217,238
050,17,137,"Illinois","Morgan County",1,65,420,214,206
050,17,137,"Illinois","Morgan County",1,66,416,210,206
050,17,137,"Illinois","Morgan County",1,67,425,203,222
050,17,137,"Illinois","Morgan County",1,68,408,186,222
050,17,137,"Illinois","Morgan County",1,69,368,182,186
050,17,137,"Illinois","Morgan County",1,70,375,169,206
050,17,137,"Illinois","Morgan County",1,71,366,181,185
050,17,137,"Illinois","Morgan County",1,72,370,186,184
050,17,137,"Illinois","Morgan County",1,73,355,179,176
050,17,137,"Illinois","Morgan County",1,74,255,123,132
050,17,137,"Illinois","Morgan County",1,75,246,103,143
050,17,137,"Illinois","Morgan County",1,76,273,118,155
050,17,137,"Illinois","Morgan County",1,77,261,113,148
050,17,137,"Illinois","Morgan County",1,78,232,103,129
050,17,137,"Illinois","Morgan County",1,79,205,86,119
050,17,137,"Illinois","Morgan County",1,80,199,82,117
050,17,137,"Illinois","Morgan County",1,81,174,70,104
050,17,137,"Illinois","Morgan County",1,82,162,71,91
050,17,137,"Illinois","Morgan County",1,83,154,73,81
050,17,137,"Illinois","Morgan County",1,84,129,56,73
050,17,137,"Illinois","Morgan County",1,85,891,283,608
050,17,137,"Illinois","Morgan County",2,0,315,154,161
050,17,137,"Illinois","Morgan County",2,1,310,155,155
050,17,137,"Illinois","Morgan County",2,2,343,168,175
050,17,137,"Illinois","Morgan County",2,3,345,169,176
050,17,137,"Illinois","Morgan County",2,4,340,175,165
050,17,137,"Illinois","Morgan County",2,5,339,189,150
050,17,137,"Illinois","Morgan County",2,6,325,175,150
050,17,137,"Illinois","Morgan County",2,7,344,170,174
050,17,137,"Illinois","Morgan County",2,8,333,161,172
050,17,137,"Illinois","Morgan County",2,9,339,166,173
050,17,137,"Illinois","Morgan County",2,10,346,175,171
050,17,137,"Illinois","Morgan County",2,11,376,200,176
050,17,137,"Illinois","Morgan County",2,12,382,205,177
050,17,137,"Illinois","Morgan County",2,13,379,203,176
050,17,137,"Illinois","Morgan County",2,14,366,195,171
050,17,137,"Illinois","Morgan County",2,15,362,192,170
050,17,137,"Illinois","Morgan County",2,16,383,206,177
050,17,137,"Illinois","Morgan County",2,17,400,202,198
050,17,137,"Illinois","Morgan County",2,18,428,222,206
050,17,137,"Illinois","Morgan County",2,19,465,257,208
050,17,137,"Illinois","Morgan County",2,20,440,229,211
050,17,137,"Illinois","Morgan County",2,21,468,228,240
050,17,137,"Illinois","Morgan County",2,22,419,209,210
050,17,137,"Illinois","Morgan County",2,23,391,214,177
050,17,137,"Illinois","Morgan County",2,24,386,206,180
050,17,137,"Illinois","Morgan County",2,25,378,209,169
050,17,137,"Illinois","Morgan County",2,26,379,214,165
050,17,137,"Illinois","Morgan County",2,27,379,199,180
050,17,137,"Illinois","Morgan County",2,28,387,204,183
050,17,137,"Illinois","Morgan County",2,29,407,218,189
050,17,137,"Illinois","Morgan County",2,30,440,238,202
050,17,137,"Illinois","Morgan County",2,31,410,214,196
050,17,137,"Illinois","Morgan County",2,32,408,219,189
050,17,137,"Illinois","Morgan County",2,33,399,224,175
050,17,137,"Illinois","Morgan County",2,34,402,222,180
050,17,137,"Illinois","Morgan County",2,35,420,225,195
050,17,137,"Illinois","Morgan County",2,36,420,230,190
050,17,137,"Illinois","Morgan County",2,37,435,244,191
050,17,137,"Illinois","Morgan County",2,38,452,262,190
050,17,137,"Illinois","Morgan County",2,39,415,229,186
050,17,137,"Illinois","Morgan County",2,40,407,232,175
050,17,137,"Illinois","Morgan County",2,41,390,205,185
050,17,137,"Illinois","Morgan County",2,42,402,209,193
050,17,137,"Illinois","Morgan County",2,43,416,214,202
050,17,137,"Illinois","Morgan County",2,44,362,189,173
050,17,137,"Illinois","Morgan County",2,45,349,186,163
050,17,137,"Illinois","Morgan County",2,46,378,201,177
050,17,137,"Illinois","Morgan County",2,47,380,201,179
050,17,137,"Illinois","Morgan County",2,48,396,211,185
050,17,137,"Illinois","Morgan County",2,49,397,200,197
050,17,137,"Illinois","Morgan County",2,50,396,202,194
050,17,137,"Illinois","Morgan County",2,51,389,199,190
050,17,137,"Illinois","Morgan County",2,52,414,216,198
050,17,137,"Illinois","Morgan County",2,53,402,211,191
050,17,137,"Illinois","Morgan County",2,54,403,215,188
050,17,137,"Illinois","Morgan County",2,55,429,215,214
050,17,137,"Illinois","Morgan County",2,56,478,223,255
050,17,137,"Illinois","Morgan County",2,57,493,242,251
050,17,137,"Illinois","Morgan County",2,58,511,257,254
050,17,137,"Illinois","Morgan County",2,59,502,252,250
050,17,137,"Illinois","Morgan County",2,60,499,248,251
050,17,137,"Illinois","Morgan County",2,61,498,239,259
050,17,137,"Illinois","Morgan County",2,62,483,234,249
050,17,137,"Illinois","Morgan County",2,63,468,230,238
050,17,137,"Illinois","Morgan County",2,64,449,217,232
050,17,137,"Illinois","Morgan County",2,65,427,216,211
050,17,137,"Illinois","Morgan County",2,66,417,210,207
050,17,137,"Illinois","Morgan County",2,67,420,205,215
050,17,137,"Illinois","Morgan County",2,68,405,187,218
050,17,137,"Illinois","Morgan County",2,69,381,184,197
050,17,137,"Illinois","Morgan County",2,70,368,169,199
050,17,137,"Illinois","Morgan County",2,71,367,177,190
050,17,137,"Illinois","Morgan County",2,72,360,180,180
050,17,137,"Illinois","Morgan County",2,73,375,188,187
050,17,137,"Illinois","Morgan County",2,74,261,128,133
050,17,137,"Illinois","Morgan County",2,75,244,106,138
050,17,137,"Illinois","Morgan County",2,76,266,114,152
050,17,137,"Illinois","Morgan County",2,77,268,115,153
050,17,137,"Illinois","Morgan County",2,78,229,101,128
050,17,137,"Illinois","Morgan County",2,79,206,87,119
050,17,137,"Illinois","Morgan County",2,80,197,82,115
050,17,137,"Illinois","Morgan County",2,81,175,69,106
050,17,137,"Illinois","Morgan County",2,82,161,68,93
050,17,137,"Illinois","Morgan County",2,83,153,70,83
050,17,137,"Illinois","Morgan County",2,84,129,56,73
050,17,137,"Illinois","Morgan County",2,85,890,288,602
050,17,137,"Illinois","Morgan County",3,0,327,164,163
050,17,137,"Illinois","Morgan County",3,1,325,163,162
050,17,137,"Illinois","Morgan County",3,2,306,149,157
050,17,137,"Illinois","Morgan County",3,3,342,172,170
050,17,137,"Illinois","Morgan County",3,4,341,168,173
050,17,137,"Illinois","Morgan County",3,5,328,174,154
050,17,137,"Illinois","Morgan County",3,6,339,180,159
050,17,137,"Illinois","Morgan County",3,7,325,173,152
050,17,137,"Illinois","Morgan County",3,8,348,171,177
050,17,137,"Illinois","Morgan County",3,9,321,158,163
050,17,137,"Illinois","Morgan County",3,10,344,170,174
050,17,137,"Illinois","Morgan County",3,11,348,168,180
050,17,137,"Illinois","Morgan County",3,12,370,198,172
050,17,137,"Illinois","Morgan County",3,13,374,197,177
050,17,137,"Illinois","Morgan County",3,14,381,203,178
050,17,137,"Illinois","Morgan County",3,15,368,194,174
050,17,137,"Illinois","Morgan County",3,16,348,187,161
050,17,137,"Illinois","Morgan County",3,17,387,202,185
050,17,137,"Illinois","Morgan County",3,18,403,216,187
050,17,137,"Illinois","Morgan County",3,19,466,268,198
050,17,137,"Illinois","Morgan County",3,20,445,228,217
050,17,137,"Illinois","Morgan County",3,21,465,234,231
050,17,137,"Illinois","Morgan County",3,22,426,217,209
050,17,137,"Illinois","Morgan County",3,23,375,193,182
050,17,137,"Illinois","Morgan County",3,24,378,203,175
050,17,137,"Illinois","Morgan County",3,25,366,207,159
050,17,137,"Illinois","Morgan County",3,26,409,220,189
050,17,137,"Illinois","Morgan County",3,27,374,210,164
050,17,137,"Illinois","Morgan County",3,28,392,204,188
050,17,137,"Illinois","Morgan County",3,29,398,219,179
050,17,137,"Illinois","Morgan County",3,30,408,227,181
050,17,137,"Illinois","Morgan County",3,31,421,224,197
050,17,137,"Illinois","Morgan County",3,32,431,226,205
050,17,137,"Illinois","Morgan County",3,33,401,214,187
050,17,137,"Illinois","Morgan County",3,34,390,219,171
050,17,137,"Illinois","Morgan County",3,35,425,239,186
050,17,137,"Illinois","Morgan County",3,36,432,242,190
050,17,137,"Illinois","Morgan County",3,37,422,237,185
050,17,137,"Illinois","Morgan County",3,38,441,249,192
050,17,137,"Illinois","Morgan County",3,39,442,261,181
050,17,137,"Illinois","Morgan County",3,40,431,240,191
050,17,137,"Illinois","Morgan County",3,41,388,211,177
050,17,137,"Illinois","Morgan County",3,42,393,207,186
050,17,137,"Illinois","Morgan County",3,43,400,210,190
050,17,137,"Illinois","Morgan County",3,44,402,200,202
050,17,137,"Illinois","Morgan County",3,45,356,180,176
050,17,137,"Illinois","Morgan County",3,46,375,209,166
050,17,137,"Illinois","Morgan County",3,47,345,173,172
050,17,137,"Illinois","Morgan County",3,48,384,211,173
050,17,137,"Illinois","Morgan County",3,49,386,203,183
050,17,137,"Illinois","Morgan County",3,50,401,204,197
050,17,137,"Illinois","Morgan County",3,51,381,195,186
050,17,137,"Illinois","Morgan County",3,52,396,202,194
050,17,137,"Illinois","Morgan County",3,53,400,207,193
050,17,137,"Illinois","Morgan County",3,54,395,209,186
050,17,137,"Illinois","Morgan County",3,55,395,204,191
050,17,137,"Illinois","Morgan County",3,56,417,202,215
050,17,137,"Illinois","Morgan County",3,57,484,234,250
050,17,137,"Illinois","Morgan County",3,58,492,242,250
050,17,137,"Illinois","Morgan County",3,59,506,252,254
050,17,137,"Illinois","Morgan County",3,60,490,243,247
050,17,137,"Illinois","Morgan County",3,61,496,247,249
050,17,137,"Illinois","Morgan County",3,62,493,235,258
050,17,137,"Illinois","Morgan County",3,63,456,218,238
050,17,137,"Illinois","Morgan County",3,64,476,232,244
050,17,137,"Illinois","Morgan County",3,65,433,215,218
050,17,137,"Illinois","Morgan County",3,66,415,202,213
050,17,137,"Illinois","Morgan County",3,67,403,207,196
050,17,137,"Illinois","Morgan County",3,68,405,197,208
050,17,137,"Illinois","Morgan County",3,69,404,181,223
050,17,137,"Illinois","Morgan County",3,70,373,176,197
050,17,137,"Illinois","Morgan County",3,71,353,165,188
050,17,137,"Illinois","Morgan County",3,72,365,173,192
050,17,137,"Illinois","Morgan County",3,73,339,165,174
050,17,137,"Illinois","Morgan County",3,74,361,180,181
050,17,137,"Illinois","Morgan County",3,75,247,121,126
050,17,137,"Illinois","Morgan County",3,76,240,101,139
050,17,137,"Illinois","Morgan County",3,77,248,101,147
050,17,137,"Illinois","Morgan County",3,78,253,112,141
050,17,137,"Illinois","Morgan County",3,79,221,95,126
050,17,137,"Illinois","Morgan County",3,80,199,84,115
050,17,137,"Illinois","Morgan County",3,81,187,75,112
050,17,137,"Illinois","Morgan County",3,82,163,65,98
050,17,137,"Illinois","Morgan County",3,83,156,57,99
050,17,137,"Illinois","Morgan County",3,84,128,63,65
050,17,137,"Illinois","Morgan County",3,85,883,297,586
050,17,137,"Illinois","Morgan County",4,0,326,167,159
050,17,137,"Illinois","Morgan County",4,1,322,167,155
050,17,137,"Illinois","Morgan County",4,2,314,154,160
050,17,137,"Illinois","Morgan County",4,3,322,158,164
050,17,137,"Illinois","Morgan County",4,4,336,166,170
050,17,137,"Illinois","Morgan County",4,5,342,170,172
050,17,137,"Illinois","Morgan County",4,6,329,173,156
050,17,137,"Illinois","Morgan County",4,7,335,187,148
050,17,137,"Illinois","Morgan County",4,8,341,181,160
050,17,137,"Illinois","Morgan County",4,9,347,170,177
050,17,137,"Illinois","Morgan County",4,10,331,165,166
050,17,137,"Illinois","Morgan County",4,11,336,166,170
050,17,137,"Illinois","Morgan County",4,12,349,174,175
050,17,137,"Illinois","Morgan County",4,13,381,199,182
050,17,137,"Illinois","Morgan County",4,14,386,202,184
050,17,137,"Illinois","Morgan County",4,15,387,210,177
050,17,137,"Illinois","Morgan County",4,16,369,199,170
050,17,137,"Illinois","Morgan County",4,17,347,180,167
050,17,137,"Illinois","Morgan County",4,18,390,212,178
050,17,137,"Illinois","Morgan County",4,19,445,249,196
050,17,137,"Illinois","Morgan County",4,20,427,224,203
050,17,137,"Illinois","Morgan County",4,21,471,230,241
050,17,137,"Illinois","Morgan County",4,22,435,225,210
050,17,137,"Illinois","Morgan County",4,23,358,197,161
050,17,137,"Illinois","Morgan County",4,24,374,190,184
050,17,137,"Illinois","Morgan County",4,25,377,210,167
050,17,137,"Illinois","Morgan County",4,26,367,214,153
050,17,137,"Illinois","Morgan County",4,27,385,198,187
050,17,137,"Illinois","Morgan County",4,28,397,223,174
050,17,137,"Illinois","Morgan County",4,29,386,207,179
050,17,137,"Illinois","Morgan County",4,30,387,212,175
050,17,137,"Illinois","Morgan County",4,31,390,211,179
050,17,137,"Illinois","Morgan County",4,32,432,237,195
050,17,137,"Illinois","Morgan County",4,33,425,221,204
050,17,137,"Illinois","Morgan County",4,34,384,204,180
050,17,137,"Illinois","Morgan County",4,35,405,217,188
050,17,137,"Illinois","Morgan County",4,36,417,241,176
050,17,137,"Illinois","Morgan County",4,37,414,227,187
050,17,137,"Illinois","Morgan County",4,38,404,219,185
050,17,137,"Illinois","Morgan County",4,39,440,253,187
050,17,137,"Illinois","Morgan County",4,40,453,261,192
050,17,137,"Illinois","Morgan County",4,41,405,220,185
050,17,137,"Illinois","Morgan County",4,42,389,206,183
050,17,137,"Illinois","Morgan County",4,43,398,211,187
050,17,137,"Illinois","Morgan County",4,44,376,190,186
050,17,137,"Illinois","Morgan County",4,45,400,197,203
050,17,137,"Illinois","Morgan County",4,46,377,203,174
050,17,137,"Illinois","Morgan County",4,47,338,179,159
050,17,137,"Illinois","Morgan County",4,48,351,185,166
050,17,137,"Illinois","Morgan County",4,49,368,195,173
050,17,137,"Illinois","Morgan County",4,50,388,205,183
050,17,137,"Illinois","Morgan County",4,51,389,192,197
050,17,137,"Illinois","Morgan County",4,52,392,200,192
050,17,137,"Illinois","Morgan County",4,53,391,198,193
050,17,137,"Illinois","Morgan County",4,54,391,199,192
050,17,137,"Illinois","Morgan County",4,55,383,194,189
050,17,137,"Illinois","Morgan County",4,56,379,183,196
050,17,137,"Illinois","Morgan County",4,57,418,210,208
050,17,137,"Illinois","Morgan County",4,58,477,227,250
050,17,137,"Illinois","Morgan County",4,59,482,235,247
050,17,137,"Illinois","Morgan County",4,60,495,242,253
050,17,137,"Illinois","Morgan County",4,61,489,249,240
050,17,137,"Illinois","Morgan County",4,62,489,237,252
050,17,137,"Illinois","Morgan County",4,63,476,228,248
050,17,137,"Illinois","Morgan County",4,64,453,211,242
050,17,137,"Illinois","Morgan County",4,65,460,223,237
050,17,137,"Illinois","Morgan County",4,66,424,202,222
050,17,137,"Illinois","Morgan County",4,67,397,196,201
050,17,137,"Illinois","Morgan County",4,68,386,197,189
050,17,137,"Illinois","Morgan County",4,69,395,189,206
050,17,137,"Illinois","Morgan County",4,70,389,174,215
050,17,137,"Illinois","Morgan County",4,71,351,166,185
050,17,137,"Illinois","Morgan County",4,72,349,164,185
050,17,137,"Illinois","Morgan County",4,73,337,152,185
050,17,137,"Illinois","Morgan County",4,74,329,161,168
050,17,137,"Illinois","Morgan County",4,75,347,171,176
050,17,137,"Illinois","Morgan County",4,76,250,119,131
050,17,137,"Illinois","Morgan County",4,77,230,94,136
050,17,137,"Illinois","Morgan County",4,78,229,93,136
050,17,137,"Illinois","Morgan County",4,79,240,103,137
050,17,137,"Illinois","Morgan County",4,80,206,92,114
050,17,137,"Illinois","Morgan County",4,81,186,72,114
050,17,137,"Illinois","Morgan County",4,82,176,72,104
050,17,137,"Illinois","Morgan County",4,83,163,61,102
050,17,137,"Illinois","Morgan County",4,84,124,45,79
050,17,137,"Illinois","Morgan County",4,85,873,312,561
050,17,137,"Illinois","Morgan County",5,0,324,166,158
050,17,137,"Illinois","Morgan County",5,1,325,170,155
050,17,137,"Illinois","Morgan County",5,2,307,163,144
050,17,137,"Illinois","Morgan County",5,3,323,159,164
050,17,137,"Illinois","Morgan County",5,4,317,164,153
050,17,137,"Illinois","Morgan County",5,5,340,168,172
050,17,137,"Illinois","Morgan County",5,6,348,173,175
050,17,137,"Illinois","Morgan County",5,7,339,179,160
050,17,137,"Illinois","Morgan County",5,8,344,187,157
050,17,137,"Illinois","Morgan County",5,9,350,188,162
050,17,137,"Illinois","Morgan County",5,10,362,178,184
050,17,137,"Illinois","Morgan County",5,11,326,162,164
050,17,137,"Illinois","Morgan County",5,12,352,173,179
050,17,137,"Illinois","Morgan County",5,13,345,170,175
050,17,137,"Illinois","Morgan County",5,14,384,200,184
050,17,137,"Illinois","Morgan County",5,15,397,205,192
050,17,137,"Illinois","Morgan County",5,16,393,207,186
050,17,137,"Illinois","Morgan County",5,17,366,189,177
050,17,137,"Illinois","Morgan County",5,18,369,197,172
050,17,137,"Illinois","Morgan County",5,19,434,252,182
050,17,137,"Illinois","Morgan County",5,20,426,217,209
050,17,137,"Illinois","Morgan County",5,21,451,221,230
050,17,137,"Illinois","Morgan County",5,22,438,221,217
050,17,137,"Illinois","Morgan County",5,23,383,216,167
050,17,137,"Illinois","Morgan County",5,24,350,189,161
050,17,137,"Illinois","Morgan County",5,25,365,203,162
050,17,137,"Illinois","Morgan County",5,26,382,217,165
050,17,137,"Illinois","Morgan County",5,27,378,214,164
050,17,137,"Illinois","Morgan County",5,28,404,197,207
050,17,137,"Illinois","Morgan County",5,29,401,231,170
050,17,137,"Illinois","Morgan County",5,30,384,215,169
050,17,137,"Illinois","Morgan County",5,31,368,197,171
050,17,137,"Illinois","Morgan County",5,32,404,222,182
050,17,137,"Illinois","Morgan County",5,33,423,233,190
050,17,137,"Illinois","Morgan County",5,34,411,205,206
050,17,137,"Illinois","Morgan County",5,35,390,203,187
050,17,137,"Illinois","Morgan County",5,36,416,229,187
050,17,137,"Illinois","Morgan County",5,37,408,234,174
050,17,137,"Illinois","Morgan County",5,38,406,217,189
050,17,137,"Illinois","Morgan County",5,39,410,226,184
050,17,137,"Illinois","Morgan County",5,40,450,253,197
050,17,137,"Illinois","Morgan County",5,41,444,249,195
050,17,137,"Illinois","Morgan County",5,42,412,225,187
050,17,137,"Illinois","Morgan County",5,43,391,208,183
050,17,137,"Illinois","Morgan County",5,44,386,198,188
050,17,137,"Illinois","Morgan County",5,45,378,189,189
050,17,137,"Illinois","Morgan County",5,46,421,213,208
050,17,137,"Illinois","Morgan County",5,47,346,184,162
050,17,137,"Illinois","Morgan County",5,48,347,192,155
050,17,137,"Illinois","Morgan County",5,49,343,180,163
050,17,137,"Illinois","Morgan County",5,50,368,199,169
050,17,137,"Illinois","Morgan County",5,51,374,197,177
050,17,137,"Illinois","Morgan County",5,52,397,198,199
050,17,137,"Illinois","Morgan County",5,53,372,183,189
050,17,137,"Illinois","Morgan County",5,54,384,200,184
050,17,137,"Illinois","Morgan County",5,55,373,183,190
050,17,137,"Illinois","Morgan County",5,56,376,186,190
050,17,137,"Illinois","Morgan County",5,57,382,194,188
050,17,137,"Illinois","Morgan County",5,58,413,202,211
050,17,137,"Illinois","Morgan County",5,59,458,214,244
050,17,137,"Illinois","Morgan County",5,60,463,225,238
050,17,137,"Illinois","Morgan County",5,61,492,242,250
050,17,137,"Illinois","Morgan County",5,62,479,241,238
050,17,137,"Illinois","Morgan County",5,63,472,226,246
050,17,137,"Illinois","Morgan County",5,64,459,217,242
050,17,137,"Illinois","Morgan County",5,65,440,204,236
050,17,137,"Illinois","Morgan County",5,66,448,208,240
050,17,137,"Illinois","Morgan County",5,67,411,203,208
050,17,137,"Illinois","Morgan County",5,68,386,187,199
050,17,137,"Illinois","Morgan County",5,69,392,198,194
050,17,137,"Illinois","Morgan County",5,70,382,183,199
050,17,137,"Illinois","Morgan County",5,71,366,168,198
050,17,137,"Illinois","Morgan County",5,72,343,162,181
050,17,137,"Illinois","Morgan County",5,73,331,145,186
050,17,137,"Illinois","Morgan County",5,74,324,147,177
050,17,137,"Illinois","Morgan County",5,75,317,154,163
050,17,137,"Illinois","Morgan County",5,76,339,165,174
050,17,137,"Illinois","Morgan County",5,77,238,112,126
050,17,137,"Illinois","Morgan County",5,78,218,88,130
050,17,137,"Illinois","Morgan County",5,79,217,84,133
050,17,137,"Illinois","Morgan County",5,80,222,97,125
050,17,137,"Illinois","Morgan County",5,81,188,79,109
050,17,137,"Illinois","Morgan County",5,82,178,73,105
050,17,137,"Illinois","Morgan County",5,83,173,67,106
050,17,137,"Illinois","Morgan County",5,84,132,48,84
050,17,137,"Illinois","Morgan County",5,85,872,310,562
050,17,139,"Illinois","Moultrie County",1,0,156,83,73
050,17,139,"Illinois","Moultrie County",1,1,150,83,67
050,17,139,"Illinois","Moultrie County",1,2,189,103,86
050,17,139,"Illinois","Moultrie County",1,3,182,102,80
050,17,139,"Illinois","Moultrie County",1,4,202,104,98
050,17,139,"Illinois","Moultrie County",1,5,196,93,103
050,17,139,"Illinois","Moultrie County",1,6,199,92,107
050,17,139,"Illinois","Moultrie County",1,7,208,93,115
050,17,139,"Illinois","Moultrie County",1,8,203,100,103
050,17,139,"Illinois","Moultrie County",1,9,190,101,89
050,17,139,"Illinois","Moultrie County",1,10,203,107,96
050,17,139,"Illinois","Moultrie County",1,11,209,111,98
050,17,139,"Illinois","Moultrie County",1,12,244,126,118
050,17,139,"Illinois","Moultrie County",1,13,243,125,118
050,17,139,"Illinois","Moultrie County",1,14,224,114,110
050,17,139,"Illinois","Moultrie County",1,15,220,115,105
050,17,139,"Illinois","Moultrie County",1,16,227,115,112
050,17,139,"Illinois","Moultrie County",1,17,234,123,111
050,17,139,"Illinois","Moultrie County",1,18,186,93,93
050,17,139,"Illinois","Moultrie County",1,19,141,81,60
050,17,139,"Illinois","Moultrie County",1,20,143,85,58
050,17,139,"Illinois","Moultrie County",1,21,143,78,65
050,17,139,"Illinois","Moultrie County",1,22,157,89,68
050,17,139,"Illinois","Moultrie County",1,23,163,90,73
050,17,139,"Illinois","Moultrie County",1,24,155,77,78
050,17,139,"Illinois","Moultrie County",1,25,149,71,78
050,17,139,"Illinois","Moultrie County",1,26,158,82,76
050,17,139,"Illinois","Moultrie County",1,27,163,88,75
050,17,139,"Illinois","Moultrie County",1,28,168,87,81
050,17,139,"Illinois","Moultrie County",1,29,175,80,95
050,17,139,"Illinois","Moultrie County",1,30,170,79,91
050,17,139,"Illinois","Moultrie County",1,31,158,73,85
050,17,139,"Illinois","Moultrie County",1,32,153,73,80
050,17,139,"Illinois","Moultrie County",1,33,176,87,89
050,17,139,"Illinois","Moultrie County",1,34,174,84,90
050,17,139,"Illinois","Moultrie County",1,35,164,87,77
050,17,139,"Illinois","Moultrie County",1,36,190,95,95
050,17,139,"Illinois","Moultrie County",1,37,181,94,87
050,17,139,"Illinois","Moultrie County",1,38,185,91,94
050,17,139,"Illinois","Moultrie County",1,39,197,91,106
050,17,139,"Illinois","Moultrie County",1,40,197,89,108
050,17,139,"Illinois","Moultrie County",1,41,195,95,100
050,17,139,"Illinois","Moultrie County",1,42,157,81,76
050,17,139,"Illinois","Moultrie County",1,43,151,82,69
050,17,139,"Illinois","Moultrie County",1,44,170,80,90
050,17,139,"Illinois","Moultrie County",1,45,164,77,87
050,17,139,"Illinois","Moultrie County",1,46,174,92,82
050,17,139,"Illinois","Moultrie County",1,47,161,86,75
050,17,139,"Illinois","Moultrie County",1,48,153,74,79
050,17,139,"Illinois","Moultrie County",1,49,163,81,82
050,17,139,"Illinois","Moultrie County",1,50,169,85,84
050,17,139,"Illinois","Moultrie County",1,51,168,81,87
050,17,139,"Illinois","Moultrie County",1,52,160,81,79
050,17,139,"Illinois","Moultrie County",1,53,173,99,74
050,17,139,"Illinois","Moultrie County",1,54,168,81,87
050,17,139,"Illinois","Moultrie County",1,55,205,99,106
050,17,139,"Illinois","Moultrie County",1,56,195,96,99
050,17,139,"Illinois","Moultrie County",1,57,189,82,107
050,17,139,"Illinois","Moultrie County",1,58,219,96,123
050,17,139,"Illinois","Moultrie County",1,59,213,109,104
050,17,139,"Illinois","Moultrie County",1,60,209,98,111
050,17,139,"Illinois","Moultrie County",1,61,195,98,97
050,17,139,"Illinois","Moultrie County",1,62,181,89,92
050,17,139,"Illinois","Moultrie County",1,63,185,93,92
050,17,139,"Illinois","Moultrie County",1,64,196,97,99
050,17,139,"Illinois","Moultrie County",1,65,174,87,87
050,17,139,"Illinois","Moultrie County",1,66,186,94,92
050,17,139,"Illinois","Moultrie County",1,67,189,88,101
050,17,139,"Illinois","Moultrie County",1,68,168,85,83
050,17,139,"Illinois","Moultrie County",1,69,140,70,70
050,17,139,"Illinois","Moultrie County",1,70,154,76,78
050,17,139,"Illinois","Moultrie County",1,71,144,63,81
050,17,139,"Illinois","Moultrie County",1,72,139,65,74
050,17,139,"Illinois","Moultrie County",1,73,137,63,74
050,17,139,"Illinois","Moultrie County",1,74,90,43,47
050,17,139,"Illinois","Moultrie County",1,75,98,47,51
050,17,139,"Illinois","Moultrie County",1,76,99,47,52
050,17,139,"Illinois","Moultrie County",1,77,91,42,49
050,17,139,"Illinois","Moultrie County",1,78,87,43,44
050,17,139,"Illinois","Moultrie County",1,79,75,31,44
050,17,139,"Illinois","Moultrie County",1,80,71,29,42
050,17,139,"Illinois","Moultrie County",1,81,69,31,38
050,17,139,"Illinois","Moultrie County",1,82,61,26,35
050,17,139,"Illinois","Moultrie County",1,83,67,28,39
050,17,139,"Illinois","Moultrie County",1,84,56,20,36
050,17,139,"Illinois","Moultrie County",1,85,394,126,268
050,17,139,"Illinois","Moultrie County",2,0,145,79,66
050,17,139,"Illinois","Moultrie County",2,1,148,82,66
050,17,139,"Illinois","Moultrie County",2,2,178,98,80
050,17,139,"Illinois","Moultrie County",2,3,182,102,80
050,17,139,"Illinois","Moultrie County",2,4,198,103,95
050,17,139,"Illinois","Moultrie County",2,5,196,95,101
050,17,139,"Illinois","Moultrie County",2,6,197,91,106
050,17,139,"Illinois","Moultrie County",2,7,206,92,114
050,17,139,"Illinois","Moultrie County",2,8,203,98,105
050,17,139,"Illinois","Moultrie County",2,9,193,100,93
050,17,139,"Illinois","Moultrie County",2,10,201,107,94
050,17,139,"Illinois","Moultrie County",2,11,209,110,99
050,17,139,"Illinois","Moultrie County",2,12,239,124,115
050,17,139,"Illinois","Moultrie County",2,13,242,125,117
050,17,139,"Illinois","Moultrie County",2,14,229,119,110
050,17,139,"Illinois","Moultrie County",2,15,220,114,106
050,17,139,"Illinois","Moultrie County",2,16,226,116,110
050,17,139,"Illinois","Moultrie County",2,17,233,122,111
050,17,139,"Illinois","Moultrie County",2,18,188,97,91
050,17,139,"Illinois","Moultrie County",2,19,142,79,63
050,17,139,"Illinois","Moultrie County",2,20,148,86,62
050,17,139,"Illinois","Moultrie County",2,21,146,82,64
050,17,139,"Illinois","Moultrie County",2,22,154,87,67
050,17,139,"Illinois","Moultrie County",2,23,165,92,73
050,17,139,"Illinois","Moultrie County",2,24,157,79,78
050,17,139,"Illinois","Moultrie County",2,25,148,71,77
050,17,139,"Illinois","Moultrie County",2,26,158,81,77
050,17,139,"Illinois","Moultrie County",2,27,161,86,75
050,17,139,"Illinois","Moultrie County",2,28,167,87,80
050,17,139,"Illinois","Moultrie County",2,29,172,82,90
050,17,139,"Illinois","Moultrie County",2,30,172,79,93
050,17,139,"Illinois","Moultrie County",2,31,159,73,86
050,17,139,"Illinois","Moultrie County",2,32,155,73,82
050,17,139,"Illinois","Moultrie County",2,33,173,85,88
050,17,139,"Illinois","Moultrie County",2,34,173,84,89
050,17,139,"Illinois","Moultrie County",2,35,168,87,81
050,17,139,"Illinois","Moultrie County",2,36,181,92,89
050,17,139,"Illinois","Moultrie County",2,37,182,94,88
050,17,139,"Illinois","Moultrie County",2,38,182,90,92
050,17,139,"Illinois","Moultrie County",2,39,192,90,102
050,17,139,"Illinois","Moultrie County",2,40,199,91,108
050,17,139,"Illinois","Moultrie County",2,41,197,94,103
050,17,139,"Illinois","Moultrie County",2,42,165,83,82
050,17,139,"Illinois","Moultrie County",2,43,156,85,71
050,17,139,"Illinois","Moultrie County",2,44,165,81,84
050,17,139,"Illinois","Moultrie County",2,45,164,77,87
050,17,139,"Illinois","Moultrie County",2,46,171,88,83
050,17,139,"Illinois","Moultrie County",2,47,160,86,74
050,17,139,"Illinois","Moultrie County",2,48,155,75,80
050,17,139,"Illinois","Moultrie County",2,49,159,80,79
050,17,139,"Illinois","Moultrie County",2,50,166,81,85
050,17,139,"Illinois","Moultrie County",2,51,167,81,86
050,17,139,"Illinois","Moultrie County",2,52,160,80,80
050,17,139,"Illinois","Moultrie County",2,53,170,95,75
050,17,139,"Illinois","Moultrie County",2,54,168,86,82
050,17,139,"Illinois","Moultrie County",2,55,194,94,100
050,17,139,"Illinois","Moultrie County",2,56,196,95,101
050,17,139,"Illinois","Moultrie County",2,57,191,85,106
050,17,139,"Illinois","Moultrie County",2,58,210,92,118
050,17,139,"Illinois","Moultrie County",2,59,216,107,109
050,17,139,"Illinois","Moultrie County",2,60,210,101,109
050,17,139,"Illinois","Moultrie County",2,61,197,97,100
050,17,139,"Illinois","Moultrie County",2,62,185,91,94
050,17,139,"Illinois","Moultrie County",2,63,186,93,93
050,17,139,"Illinois","Moultrie County",2,64,192,95,97
050,17,139,"Illinois","Moultrie County",2,65,179,89,90
050,17,139,"Illinois","Moultrie County",2,66,183,92,91
050,17,139,"Illinois","Moultrie County",2,67,187,89,98
050,17,139,"Illinois","Moultrie County",2,68,169,83,86
050,17,139,"Illinois","Moultrie County",2,69,146,73,73
050,17,139,"Illinois","Moultrie County",2,70,149,73,76
050,17,139,"Illinois","Moultrie County",2,71,146,67,79
050,17,139,"Illinois","Moultrie County",2,72,136,63,73
050,17,139,"Illinois","Moultrie County",2,73,143,66,77
050,17,139,"Illinois","Moultrie County",2,74,93,44,49
050,17,139,"Illinois","Moultrie County",2,75,96,45,51
050,17,139,"Illinois","Moultrie County",2,76,98,47,51
050,17,139,"Illinois","Moultrie County",2,77,94,45,49
050,17,139,"Illinois","Moultrie County",2,78,84,41,43
050,17,139,"Illinois","Moultrie County",2,79,76,32,44
050,17,139,"Illinois","Moultrie County",2,80,72,30,42
050,17,139,"Illinois","Moultrie County",2,81,65,29,36
050,17,139,"Illinois","Moultrie County",2,82,65,28,37
050,17,139,"Illinois","Moultrie County",2,83,67,28,39
050,17,139,"Illinois","Moultrie County",2,84,55,20,35
050,17,139,"Illinois","Moultrie County",2,85,391,125,266
050,17,139,"Illinois","Moultrie County",3,0,210,115,95
050,17,139,"Illinois","Moultrie County",3,1,164,87,77
050,17,139,"Illinois","Moultrie County",3,2,146,74,72
050,17,139,"Illinois","Moultrie County",3,3,184,93,91
050,17,139,"Illinois","Moultrie County",3,4,175,94,81
050,17,139,"Illinois","Moultrie County",3,5,200,105,95
050,17,139,"Illinois","Moultrie County",3,6,203,100,103
050,17,139,"Illinois","Moultrie County",3,7,202,93,109
050,17,139,"Illinois","Moultrie County",3,8,206,90,116
050,17,139,"Illinois","Moultrie County",3,9,206,102,104
050,17,139,"Illinois","Moultrie County",3,10,206,105,101
050,17,139,"Illinois","Moultrie County",3,11,213,117,96
050,17,139,"Illinois","Moultrie County",3,12,214,110,104
050,17,139,"Illinois","Moultrie County",3,13,240,125,115
050,17,139,"Illinois","Moultrie County",3,14,243,122,121
050,17,139,"Illinois","Moultrie County",3,15,237,121,116
050,17,139,"Illinois","Moultrie County",3,16,221,114,107
050,17,139,"Illinois","Moultrie County",3,17,224,117,107
050,17,139,"Illinois","Moultrie County",3,18,203,110,93
050,17,139,"Illinois","Moultrie County",3,19,138,68,70
050,17,139,"Illinois","Moultrie County",3,20,148,81,67
050,17,139,"Illinois","Moultrie County",3,21,156,88,68
050,17,139,"Illinois","Moultrie County",3,22,144,82,62
050,17,139,"Illinois","Moultrie County",3,23,175,98,77
050,17,139,"Illinois","Moultrie County",3,24,149,81,68
050,17,139,"Illinois","Moultrie County",3,25,156,83,73
050,17,139,"Illinois","Moultrie County",3,26,155,79,76
050,17,139,"Illinois","Moultrie County",3,27,163,82,81
050,17,139,"Illinois","Moultrie County",3,28,170,87,83
050,17,139,"Illinois","Moultrie County",3,29,156,80,76
050,17,139,"Illinois","Moultrie County",3,30,165,78,87
050,17,139,"Illinois","Moultrie County",3,31,172,82,90
050,17,139,"Illinois","Moultrie County",3,32,166,77,89
050,17,139,"Illinois","Moultrie County",3,33,171,88,83
050,17,139,"Illinois","Moultrie County",3,34,171,80,91
050,17,139,"Illinois","Moultrie County",3,35,181,86,95
050,17,139,"Illinois","Moultrie County",3,36,171,91,80
050,17,139,"Illinois","Moultrie County",3,37,175,88,87
050,17,139,"Illinois","Moultrie County",3,38,182,93,89
050,17,139,"Illinois","Moultrie County",3,39,193,95,98
050,17,139,"Illinois","Moultrie County",3,40,194,93,101
050,17,139,"Illinois","Moultrie County",3,41,201,93,108
050,17,139,"Illinois","Moultrie County",3,42,190,89,101
050,17,139,"Illinois","Moultrie County",3,43,162,86,76
050,17,139,"Illinois","Moultrie County",3,44,158,82,76
050,17,139,"Illinois","Moultrie County",3,45,165,78,87
050,17,139,"Illinois","Moultrie County",3,46,174,79,95
050,17,139,"Illinois","Moultrie County",3,47,160,82,78
050,17,139,"Illinois","Moultrie County",3,48,166,86,80
050,17,139,"Illinois","Moultrie County",3,49,156,77,79
050,17,139,"Illinois","Moultrie County",3,50,162,85,77
050,17,139,"Illinois","Moultrie County",3,51,166,78,88
050,17,139,"Illinois","Moultrie County",3,52,175,82,93
050,17,139,"Illinois","Moultrie County",3,53,164,86,78
050,17,139,"Illinois","Moultrie County",3,54,174,99,75
050,17,139,"Illinois","Moultrie County",3,55,168,88,80
050,17,139,"Illinois","Moultrie County",3,56,191,92,99
050,17,139,"Illinois","Moultrie County",3,57,199,95,104
050,17,139,"Illinois","Moultrie County",3,58,193,85,108
050,17,139,"Illinois","Moultrie County",3,59,207,93,114
050,17,139,"Illinois","Moultrie County",3,60,216,110,106
050,17,139,"Illinois","Moultrie County",3,61,208,97,111
050,17,139,"Illinois","Moultrie County",3,62,193,95,98
050,17,139,"Illinois","Moultrie County",3,63,184,91,93
050,17,139,"Illinois","Moultrie County",3,64,186,94,92
050,17,139,"Illinois","Moultrie County",3,65,186,91,95
050,17,139,"Illinois","Moultrie County",3,66,174,85,89
050,17,139,"Illinois","Moultrie County",3,67,176,89,87
050,17,139,"Illinois","Moultrie County",3,68,175,87,88
050,17,139,"Illinois","Moultrie County",3,69,163,79,84
050,17,139,"Illinois","Moultrie County",3,70,137,69,68
050,17,139,"Illinois","Moultrie County",3,71,143,72,71
050,17,139,"Illinois","Moultrie County",3,72,137,62,75
050,17,139,"Illinois","Moultrie County",3,73,129,59,70
050,17,139,"Illinois","Moultrie County",3,74,135,60,75
050,17,139,"Illinois","Moultrie County",3,75,89,43,46
050,17,139,"Illinois","Moultrie County",3,76,90,40,50
050,17,139,"Illinois","Moultrie County",3,77,100,50,50
050,17,139,"Illinois","Moultrie County",3,78,87,40,47
050,17,139,"Illinois","Moultrie County",3,79,75,34,41
050,17,139,"Illinois","Moultrie County",3,80,74,29,45
050,17,139,"Illinois","Moultrie County",3,81,58,25,33
050,17,139,"Illinois","Moultrie County",3,82,60,25,35
050,17,139,"Illinois","Moultrie County",3,83,66,25,41
050,17,139,"Illinois","Moultrie County",3,84,56,22,34
050,17,139,"Illinois","Moultrie County",3,85,385,120,265
050,17,139,"Illinois","Moultrie County",4,0,164,80,84
050,17,139,"Illinois","Moultrie County",4,1,212,115,97
050,17,139,"Illinois","Moultrie County",4,2,148,76,72
050,17,139,"Illinois","Moultrie County",4,3,149,77,72
050,17,139,"Illinois","Moultrie County",4,4,178,88,90
050,17,139,"Illinois","Moultrie County",4,5,177,94,83
050,17,139,"Illinois","Moultrie County",4,6,200,111,89
050,17,139,"Illinois","Moultrie County",4,7,207,105,102
050,17,139,"Illinois","Moultrie County",4,8,199,92,107
050,17,139,"Illinois","Moultrie County",4,9,208,93,115
050,17,139,"Illinois","Moultrie County",4,10,208,103,105
050,17,139,"Illinois","Moultrie County",4,11,204,106,98
050,17,139,"Illinois","Moultrie County",4,12,203,115,88
050,17,139,"Illinois","Moultrie County",4,13,215,115,100
050,17,139,"Illinois","Moultrie County",4,14,240,121,119
050,17,139,"Illinois","Moultrie County",4,15,235,123,112
050,17,139,"Illinois","Moultrie County",4,16,229,117,112
050,17,139,"Illinois","Moultrie County",4,17,220,112,108
050,17,139,"Illinois","Moultrie County",4,18,184,102,82
050,17,139,"Illinois","Moultrie County",4,19,147,81,66
050,17,139,"Illinois","Moultrie County",4,20,131,62,69
050,17,139,"Illinois","Moultrie County",4,21,144,82,62
050,17,139,"Illinois","Moultrie County",4,22,160,88,72
050,17,139,"Illinois","Moultrie County",4,23,139,85,54
050,17,139,"Illinois","Moultrie County",4,24,167,83,84
050,17,139,"Illinois","Moultrie County",4,25,139,70,69
050,17,139,"Illinois","Moultrie County",4,26,154,84,70
050,17,139,"Illinois","Moultrie County",4,27,166,93,73
050,17,139,"Illinois","Moultrie County",4,28,167,76,91
050,17,139,"Illinois","Moultrie County",4,29,160,85,75
050,17,139,"Illinois","Moultrie County",4,30,163,85,78
050,17,139,"Illinois","Moultrie County",4,31,171,81,90
050,17,139,"Illinois","Moultrie County",4,32,164,82,82
050,17,139,"Illinois","Moultrie County",4,33,166,83,83
050,17,139,"Illinois","Moultrie County",4,34,163,79,84
050,17,139,"Illinois","Moultrie County",4,35,175,82,93
050,17,139,"Illinois","Moultrie County",4,36,164,73,91
050,17,139,"Illinois","Moultrie County",4,37,178,97,81
050,17,139,"Illinois","Moultrie County",4,38,170,86,84
050,17,139,"Illinois","Moultrie County",4,39,188,95,93
050,17,139,"Illinois","Moultrie County",4,40,188,98,90
050,17,139,"Illinois","Moultrie County",4,41,195,96,99
050,17,139,"Illinois","Moultrie County",4,42,201,87,114
050,17,139,"Illinois","Moultrie County",4,43,188,90,98
050,17,139,"Illinois","Moultrie County",4,44,163,85,78
050,17,139,"Illinois","Moultrie County",4,45,158,80,78
050,17,139,"Illinois","Moultrie County",4,46,172,83,89
050,17,139,"Illinois","Moultrie County",4,47,161,73,88
050,17,139,"Illinois","Moultrie County",4,48,158,79,79
050,17,139,"Illinois","Moultrie County",4,49,155,82,73
050,17,139,"Illinois","Moultrie County",4,50,155,72,83
050,17,139,"Illinois","Moultrie County",4,51,169,82,87
050,17,139,"Illinois","Moultrie County",4,52,166,79,87
050,17,139,"Illinois","Moultrie County",4,53,172,83,89
050,17,139,"Illinois","Moultrie County",4,54,163,82,81
050,17,139,"Illinois","Moultrie County",4,55,176,103,73
050,17,139,"Illinois","Moultrie County",4,56,164,89,75
050,17,139,"Illinois","Moultrie County",4,57,188,89,99
050,17,139,"Illinois","Moultrie County",4,58,201,97,104
050,17,139,"Illinois","Moultrie County",4,59,191,82,109
050,17,139,"Illinois","Moultrie County",4,60,208,96,112
050,17,139,"Illinois","Moultrie County",4,61,211,108,103
050,17,139,"Illinois","Moultrie County",4,62,207,101,106
050,17,139,"Illinois","Moultrie County",4,63,188,95,93
050,17,139,"Illinois","Moultrie County",4,64,182,90,92
050,17,139,"Illinois","Moultrie County",4,65,178,87,91
050,17,139,"Illinois","Moultrie County",4,66,189,91,98
050,17,139,"Illinois","Moultrie County",4,67,168,80,88
050,17,139,"Illinois","Moultrie County",4,68,171,88,83
050,17,139,"Illinois","Moultrie County",4,69,171,86,85
050,17,139,"Illinois","Moultrie County",4,70,157,76,81
050,17,139,"Illinois","Moultrie County",4,71,129,66,63
050,17,139,"Illinois","Moultrie County",4,72,135,66,69
050,17,139,"Illinois","Moultrie County",4,73,134,62,72
050,17,139,"Illinois","Moultrie County",4,74,121,55,66
050,17,139,"Illinois","Moultrie County",4,75,135,61,74
050,17,139,"Illinois","Moultrie County",4,76,85,39,46
050,17,139,"Illinois","Moultrie County",4,77,90,42,48
050,17,139,"Illinois","Moultrie County",4,78,92,45,47
050,17,139,"Illinois","Moultrie County",4,79,81,35,46
050,17,139,"Illinois","Moultrie County",4,80,69,29,40
050,17,139,"Illinois","Moultrie County",4,81,65,27,38
050,17,139,"Illinois","Moultrie County",4,82,59,23,36
050,17,139,"Illinois","Moultrie County",4,83,61,22,39
050,17,139,"Illinois","Moultrie County",4,84,58,19,39
050,17,139,"Illinois","Moultrie County",4,85,391,123,268
050,17,139,"Illinois","Moultrie County",5,0,160,79,81
050,17,139,"Illinois","Moultrie County",5,1,165,88,77
050,17,139,"Illinois","Moultrie County",5,2,200,109,91
050,17,139,"Illinois","Moultrie County",5,3,156,81,75
050,17,139,"Illinois","Moultrie County",5,4,153,81,72
050,17,139,"Illinois","Moultrie County",5,5,198,100,98
050,17,139,"Illinois","Moultrie County",5,6,175,85,90
050,17,139,"Illinois","Moultrie County",5,7,208,110,98
050,17,139,"Illinois","Moultrie County",5,8,207,102,105
050,17,139,"Illinois","Moultrie County",5,9,201,97,104
050,17,139,"Illinois","Moultrie County",5,10,201,93,108
050,17,139,"Illinois","Moultrie County",5,11,215,107,108
050,17,139,"Illinois","Moultrie County",5,12,199,102,97
050,17,139,"Illinois","Moultrie County",5,13,208,117,91
050,17,139,"Illinois","Moultrie County",5,14,209,105,104
050,17,139,"Illinois","Moultrie County",5,15,247,122,125
050,17,139,"Illinois","Moultrie County",5,16,234,126,108
050,17,139,"Illinois","Moultrie County",5,17,226,112,114
050,17,139,"Illinois","Moultrie County",5,18,176,96,80
050,17,139,"Illinois","Moultrie County",5,19,133,73,60
050,17,139,"Illinois","Moultrie County",5,20,155,89,66
050,17,139,"Illinois","Moultrie County",5,21,158,70,88
050,17,139,"Illinois","Moultrie County",5,22,157,83,74
050,17,139,"Illinois","Moultrie County",5,23,168,98,70
050,17,139,"Illinois","Moultrie County",5,24,142,74,68
050,17,139,"Illinois","Moultrie County",5,25,158,79,79
050,17,139,"Illinois","Moultrie County",5,26,149,73,76
050,17,139,"Illinois","Moultrie County",5,27,170,92,78
050,17,139,"Illinois","Moultrie County",5,28,160,92,68
050,17,139,"Illinois","Moultrie County",5,29,158,71,87
050,17,139,"Illinois","Moultrie County",5,30,162,85,77
050,17,139,"Illinois","Moultrie County",5,31,175,91,84
050,17,139,"Illinois","Moultrie County",5,32,168,81,87
050,17,139,"Illinois","Moultrie County",5,33,182,94,88
050,17,139,"Illinois","Moultrie County",5,34,158,82,76
050,17,139,"Illinois","Moultrie County",5,35,166,83,83
050,17,139,"Illinois","Moultrie County",5,36,180,86,94
050,17,139,"Illinois","Moultrie County",5,37,159,72,87
050,17,139,"Illinois","Moultrie County",5,38,175,90,85
050,17,139,"Illinois","Moultrie County",5,39,173,90,83
050,17,139,"Illinois","Moultrie County",5,40,191,101,90
050,17,139,"Illinois","Moultrie County",5,41,191,100,91
050,17,139,"Illinois","Moultrie County",5,42,191,90,101
050,17,139,"Illinois","Moultrie County",5,43,215,95,120
050,17,139,"Illinois","Moultrie County",5,44,191,94,97
050,17,139,"Illinois","Moultrie County",5,45,157,83,74
050,17,139,"Illinois","Moultrie County",5,46,161,80,81
050,17,139,"Illinois","Moultrie County",5,47,169,84,85
050,17,139,"Illinois","Moultrie County",5,48,161,75,86
050,17,139,"Illinois","Moultrie County",5,49,156,82,74
050,17,139,"Illinois","Moultrie County",5,50,144,74,70
050,17,139,"Illinois","Moultrie County",5,51,150,65,85
050,17,139,"Illinois","Moultrie County",5,52,168,80,88
050,17,139,"Illinois","Moultrie County",5,53,165,79,86
050,17,139,"Illinois","Moultrie County",5,54,172,81,91
050,17,139,"Illinois","Moultrie County",5,55,153,80,73
050,17,139,"Illinois","Moultrie County",5,56,168,96,72
050,17,139,"Illinois","Moultrie County",5,57,163,86,77
050,17,139,"Illinois","Moultrie County",5,58,193,90,103
050,17,139,"Illinois","Moultrie County",5,59,202,97,105
050,17,139,"Illinois","Moultrie County",5,60,184,84,100
050,17,139,"Illinois","Moultrie County",5,61,207,97,110
050,17,139,"Illinois","Moultrie County",5,62,209,109,100
050,17,139,"Illinois","Moultrie County",5,63,195,92,103
050,17,139,"Illinois","Moultrie County",5,64,187,93,94
050,17,139,"Illinois","Moultrie County",5,65,173,86,87
050,17,139,"Illinois","Moultrie County",5,66,180,88,92
050,17,139,"Illinois","Moultrie County",5,67,191,90,101
050,17,139,"Illinois","Moultrie County",5,68,163,80,83
050,17,139,"Illinois","Moultrie County",5,69,170,87,83
050,17,139,"Illinois","Moultrie County",5,70,163,82,81
050,17,139,"Illinois","Moultrie County",5,71,150,72,78
050,17,139,"Illinois","Moultrie County",5,72,124,63,61
050,17,139,"Illinois","Moultrie County",5,73,128,66,62
050,17,139,"Illinois","Moultrie County",5,74,122,57,65
050,17,139,"Illinois","Moultrie County",5,75,120,54,66
050,17,139,"Illinois","Moultrie County",5,76,128,54,74
050,17,139,"Illinois","Moultrie County",5,77,83,41,42
050,17,139,"Illinois","Moultrie County",5,78,83,39,44
050,17,139,"Illinois","Moultrie County",5,79,84,38,46
050,17,139,"Illinois","Moultrie County",5,80,76,30,46
050,17,139,"Illinois","Moultrie County",5,81,56,24,32
050,17,139,"Illinois","Moultrie County",5,82,61,24,37
050,17,139,"Illinois","Moultrie County",5,83,62,20,42
050,17,139,"Illinois","Moultrie County",5,84,53,16,37
050,17,139,"Illinois","Moultrie County",5,85,385,114,271
050,17,141,"Illinois","Ogle County",1,0,536,271,265
050,17,141,"Illinois","Ogle County",1,1,553,285,268
050,17,141,"Illinois","Ogle County",1,2,551,273,278
050,17,141,"Illinois","Ogle County",1,3,582,300,282
050,17,141,"Illinois","Ogle County",1,4,597,302,295
050,17,141,"Illinois","Ogle County",1,5,601,309,292
050,17,141,"Illinois","Ogle County",1,6,619,313,306
050,17,141,"Illinois","Ogle County",1,7,631,305,326
050,17,141,"Illinois","Ogle County",1,8,610,293,317
050,17,141,"Illinois","Ogle County",1,9,671,346,325
050,17,141,"Illinois","Ogle County",1,10,681,359,322
050,17,141,"Illinois","Ogle County",1,11,699,357,342
050,17,141,"Illinois","Ogle County",1,12,755,384,371
050,17,141,"Illinois","Ogle County",1,13,752,374,378
050,17,141,"Illinois","Ogle County",1,14,730,378,352
050,17,141,"Illinois","Ogle County",1,15,684,340,344
050,17,141,"Illinois","Ogle County",1,16,727,355,372
050,17,141,"Illinois","Ogle County",1,17,762,377,385
050,17,141,"Illinois","Ogle County",1,18,614,324,290
050,17,141,"Illinois","Ogle County",1,19,523,274,249
050,17,141,"Illinois","Ogle County",1,20,553,282,271
050,17,141,"Illinois","Ogle County",1,21,565,288,277
050,17,141,"Illinois","Ogle County",1,22,547,272,275
050,17,141,"Illinois","Ogle County",1,23,570,279,291
050,17,141,"Illinois","Ogle County",1,24,546,269,277
050,17,141,"Illinois","Ogle County",1,25,536,290,246
050,17,141,"Illinois","Ogle County",1,26,595,307,288
050,17,141,"Illinois","Ogle County",1,27,591,300,291
050,17,141,"Illinois","Ogle County",1,28,604,307,297
050,17,141,"Illinois","Ogle County",1,29,610,301,309
050,17,141,"Illinois","Ogle County",1,30,614,315,299
050,17,141,"Illinois","Ogle County",1,31,586,301,285
050,17,141,"Illinois","Ogle County",1,32,546,276,270
050,17,141,"Illinois","Ogle County",1,33,586,286,300
050,17,141,"Illinois","Ogle County",1,34,580,298,282
050,17,141,"Illinois","Ogle County",1,35,622,292,330
050,17,141,"Illinois","Ogle County",1,36,641,308,333
050,17,141,"Illinois","Ogle County",1,37,639,320,319
050,17,141,"Illinois","Ogle County",1,38,634,340,294
050,17,141,"Illinois","Ogle County",1,39,619,329,290
050,17,141,"Illinois","Ogle County",1,40,643,347,296
050,17,141,"Illinois","Ogle County",1,41,643,323,320
050,17,141,"Illinois","Ogle County",1,42,589,281,308
050,17,141,"Illinois","Ogle County",1,43,580,282,298
050,17,141,"Illinois","Ogle County",1,44,592,296,296
050,17,141,"Illinois","Ogle County",1,45,572,301,271
050,17,141,"Illinois","Ogle County",1,46,556,284,272
050,17,141,"Illinois","Ogle County",1,47,590,291,299
050,17,141,"Illinois","Ogle County",1,48,703,359,344
050,17,141,"Illinois","Ogle County",1,49,731,373,358
050,17,141,"Illinois","Ogle County",1,50,677,338,339
050,17,141,"Illinois","Ogle County",1,51,678,356,322
050,17,141,"Illinois","Ogle County",1,52,672,344,328
050,17,141,"Illinois","Ogle County",1,53,705,342,363
050,17,141,"Illinois","Ogle County",1,54,687,336,351
050,17,141,"Illinois","Ogle County",1,55,735,385,350
050,17,141,"Illinois","Ogle County",1,56,795,422,373
050,17,141,"Illinois","Ogle County",1,57,811,433,378
050,17,141,"Illinois","Ogle County",1,58,841,430,411
050,17,141,"Illinois","Ogle County",1,59,848,413,435
050,17,141,"Illinois","Ogle County",1,60,793,401,392
050,17,141,"Illinois","Ogle County",1,61,789,384,405
050,17,141,"Illinois","Ogle County",1,62,780,374,406
050,17,141,"Illinois","Ogle County",1,63,694,363,331
050,17,141,"Illinois","Ogle County",1,64,652,331,321
050,17,141,"Illinois","Ogle County",1,65,664,339,325
050,17,141,"Illinois","Ogle County",1,66,635,324,311
050,17,141,"Illinois","Ogle County",1,67,613,305,308
050,17,141,"Illinois","Ogle County",1,68,614,318,296
050,17,141,"Illinois","Ogle County",1,69,541,271,270
050,17,141,"Illinois","Ogle County",1,70,535,263,272
050,17,141,"Illinois","Ogle County",1,71,510,242,268
050,17,141,"Illinois","Ogle County",1,72,532,247,285
050,17,141,"Illinois","Ogle County",1,73,559,271,288
050,17,141,"Illinois","Ogle County",1,74,393,182,211
050,17,141,"Illinois","Ogle County",1,75,404,202,202
050,17,141,"Illinois","Ogle County",1,76,395,195,200
050,17,141,"Illinois","Ogle County",1,77,402,193,209
050,17,141,"Illinois","Ogle County",1,78,349,164,185
050,17,141,"Illinois","Ogle County",1,79,298,126,172
050,17,141,"Illinois","Ogle County",1,80,264,115,149
050,17,141,"Illinois","Ogle County",1,81,261,119,142
050,17,141,"Illinois","Ogle County",1,82,231,111,120
050,17,141,"Illinois","Ogle County",1,83,225,100,125
050,17,141,"Illinois","Ogle County",1,84,204,95,109
050,17,141,"Illinois","Ogle County",1,85,1133,392,741
050,17,141,"Illinois","Ogle County",2,0,527,272,255
050,17,141,"Illinois","Ogle County",2,1,550,283,267
050,17,141,"Illinois","Ogle County",2,2,554,276,278
050,17,141,"Illinois","Ogle County",2,3,575,294,281
050,17,141,"Illinois","Ogle County",2,4,595,302,293
050,17,141,"Illinois","Ogle County",2,5,600,306,294
050,17,141,"Illinois","Ogle County",2,6,617,313,304
050,17,141,"Illinois","Ogle County",2,7,626,305,321
050,17,141,"Illinois","Ogle County",2,8,611,295,316
050,17,141,"Illinois","Ogle County",2,9,659,335,324
050,17,141,"Illinois","Ogle County",2,10,678,352,326
050,17,141,"Illinois","Ogle County",2,11,695,355,340
050,17,141,"Illinois","Ogle County",2,12,743,378,365
050,17,141,"Illinois","Ogle County",2,13,752,376,376
050,17,141,"Illinois","Ogle County",2,14,735,376,359
050,17,141,"Illinois","Ogle County",2,15,696,350,346
050,17,141,"Illinois","Ogle County",2,16,717,352,365
050,17,141,"Illinois","Ogle County",2,17,751,373,378
050,17,141,"Illinois","Ogle County",2,18,615,322,293
050,17,141,"Illinois","Ogle County",2,19,516,271,245
050,17,141,"Illinois","Ogle County",2,20,557,284,273
050,17,141,"Illinois","Ogle County",2,21,563,286,277
050,17,141,"Illinois","Ogle County",2,22,554,277,277
050,17,141,"Illinois","Ogle County",2,23,567,276,291
050,17,141,"Illinois","Ogle County",2,24,547,271,276
050,17,141,"Illinois","Ogle County",2,25,541,287,254
050,17,141,"Illinois","Ogle County",2,26,578,302,276
050,17,141,"Illinois","Ogle County",2,27,588,302,286
050,17,141,"Illinois","Ogle County",2,28,600,306,294
050,17,141,"Illinois","Ogle County",2,29,614,307,307
050,17,141,"Illinois","Ogle County",2,30,621,314,307
050,17,141,"Illinois","Ogle County",2,31,590,302,288
050,17,141,"Illinois","Ogle County",2,32,559,284,275
050,17,141,"Illinois","Ogle County",2,33,575,285,290
050,17,141,"Illinois","Ogle County",2,34,580,293,287
050,17,141,"Illinois","Ogle County",2,35,617,296,321
050,17,141,"Illinois","Ogle County",2,36,632,302,330
050,17,141,"Illinois","Ogle County",2,37,644,321,323
050,17,141,"Illinois","Ogle County",2,38,636,336,300
050,17,141,"Illinois","Ogle County",2,39,622,331,291
050,17,141,"Illinois","Ogle County",2,40,646,347,299
050,17,141,"Illinois","Ogle County",2,41,637,325,312
050,17,141,"Illinois","Ogle County",2,42,597,290,307
050,17,141,"Illinois","Ogle County",2,43,589,286,303
050,17,141,"Illinois","Ogle County",2,44,584,291,293
050,17,141,"Illinois","Ogle County",2,45,579,301,278
050,17,141,"Illinois","Ogle County",2,46,555,286,269
050,17,141,"Illinois","Ogle County",2,47,580,290,290
050,17,141,"Illinois","Ogle County",2,48,671,340,331
050,17,141,"Illinois","Ogle County",2,49,726,371,355
050,17,141,"Illinois","Ogle County",2,50,692,348,344
050,17,141,"Illinois","Ogle County",2,51,673,349,324
050,17,141,"Illinois","Ogle County",2,52,669,345,324
050,17,141,"Illinois","Ogle County",2,53,692,338,354
050,17,141,"Illinois","Ogle County",2,54,689,336,353
050,17,141,"Illinois","Ogle County",2,55,720,371,349
050,17,141,"Illinois","Ogle County",2,56,781,414,367
050,17,141,"Illinois","Ogle County",2,57,805,430,375
050,17,141,"Illinois","Ogle County",2,58,830,428,402
050,17,141,"Illinois","Ogle County",2,59,849,418,431
050,17,141,"Illinois","Ogle County",2,60,798,399,399
050,17,141,"Illinois","Ogle County",2,61,787,384,403
050,17,141,"Illinois","Ogle County",2,62,777,374,403
050,17,141,"Illinois","Ogle County",2,63,717,367,350
050,17,141,"Illinois","Ogle County",2,64,657,336,321
050,17,141,"Illinois","Ogle County",2,65,658,336,322
050,17,141,"Illinois","Ogle County",2,66,642,328,314
050,17,141,"Illinois","Ogle County",2,67,615,309,306
050,17,141,"Illinois","Ogle County",2,68,607,312,295
050,17,141,"Illinois","Ogle County",2,69,562,285,277
050,17,141,"Illinois","Ogle County",2,70,533,263,270
050,17,141,"Illinois","Ogle County",2,71,509,243,266
050,17,141,"Illinois","Ogle County",2,72,514,239,275
050,17,141,"Illinois","Ogle County",2,73,568,272,296
050,17,141,"Illinois","Ogle County",2,74,405,190,215
050,17,141,"Illinois","Ogle County",2,75,401,198,203
050,17,141,"Illinois","Ogle County",2,76,391,194,197
050,17,141,"Illinois","Ogle County",2,77,404,194,210
050,17,141,"Illinois","Ogle County",2,78,350,164,186
050,17,141,"Illinois","Ogle County",2,79,306,133,173
050,17,141,"Illinois","Ogle County",2,80,269,116,153
050,17,141,"Illinois","Ogle County",2,81,255,116,139
050,17,141,"Illinois","Ogle County",2,82,237,113,124
050,17,141,"Illinois","Ogle County",2,83,222,101,121
050,17,141,"Illinois","Ogle County",2,84,204,92,112
050,17,141,"Illinois","Ogle County",2,85,1143,402,741
050,17,141,"Illinois","Ogle County",3,0,505,254,251
050,17,141,"Illinois","Ogle County",3,1,531,279,252
050,17,141,"Illinois","Ogle County",3,2,565,286,279
050,17,141,"Illinois","Ogle County",3,3,558,287,271
050,17,141,"Illinois","Ogle County",3,4,593,299,294
050,17,141,"Illinois","Ogle County",3,5,587,298,289
050,17,141,"Illinois","Ogle County",3,6,596,309,287
050,17,141,"Illinois","Ogle County",3,7,610,306,304
050,17,141,"Illinois","Ogle County",3,8,650,316,334
050,17,141,"Illinois","Ogle County",3,9,617,298,319
050,17,141,"Illinois","Ogle County",3,10,673,339,334
050,17,141,"Illinois","Ogle County",3,11,667,346,321
050,17,141,"Illinois","Ogle County",3,12,706,363,343
050,17,141,"Illinois","Ogle County",3,13,726,371,355
050,17,141,"Illinois","Ogle County",3,14,751,376,375
050,17,141,"Illinois","Ogle County",3,15,725,372,353
050,17,141,"Illinois","Ogle County",3,16,697,357,340
050,17,141,"Illinois","Ogle County",3,17,717,351,366
050,17,141,"Illinois","Ogle County",3,18,639,328,311
050,17,141,"Illinois","Ogle County",3,19,503,267,236
050,17,141,"Illinois","Ogle County",3,20,546,280,266
050,17,141,"Illinois","Ogle County",3,21,557,289,268
050,17,141,"Illinois","Ogle County",3,22,582,295,287
050,17,141,"Illinois","Ogle County",3,23,544,267,277
050,17,141,"Illinois","Ogle County",3,24,549,273,276
050,17,141,"Illinois","Ogle County",3,25,532,268,264
050,17,141,"Illinois","Ogle County",3,26,580,307,273
050,17,141,"Illinois","Ogle County",3,27,585,309,276
050,17,141,"Illinois","Ogle County",3,28,565,289,276
050,17,141,"Illinois","Ogle County",3,29,602,303,299
050,17,141,"Illinois","Ogle County",3,30,612,306,306
050,17,141,"Illinois","Ogle County",3,31,637,327,310
050,17,141,"Illinois","Ogle County",3,32,597,296,301
050,17,141,"Illinois","Ogle County",3,33,578,293,285
050,17,141,"Illinois","Ogle County",3,34,562,272,290
050,17,141,"Illinois","Ogle County",3,35,586,301,285
050,17,141,"Illinois","Ogle County",3,36,629,304,325
050,17,141,"Illinois","Ogle County",3,37,658,324,334
050,17,141,"Illinois","Ogle County",3,38,636,315,321
050,17,141,"Illinois","Ogle County",3,39,637,342,295
050,17,141,"Illinois","Ogle County",3,40,630,336,294
050,17,141,"Illinois","Ogle County",3,41,654,354,300
050,17,141,"Illinois","Ogle County",3,42,630,328,302
050,17,141,"Illinois","Ogle County",3,43,594,289,305
050,17,141,"Illinois","Ogle County",3,44,583,280,303
050,17,141,"Illinois","Ogle County",3,45,586,295,291
050,17,141,"Illinois","Ogle County",3,46,588,303,285
050,17,141,"Illinois","Ogle County",3,47,561,291,270
050,17,141,"Illinois","Ogle County",3,48,574,286,288
050,17,141,"Illinois","Ogle County",3,49,673,343,330
050,17,141,"Illinois","Ogle County",3,50,717,367,350
050,17,141,"Illinois","Ogle County",3,51,691,347,344
050,17,141,"Illinois","Ogle County",3,52,679,354,325
050,17,141,"Illinois","Ogle County",3,53,664,340,324
050,17,141,"Illinois","Ogle County",3,54,704,336,368
050,17,141,"Illinois","Ogle County",3,55,675,331,344
050,17,141,"Illinois","Ogle County",3,56,713,368,345
050,17,141,"Illinois","Ogle County",3,57,769,409,360
050,17,141,"Illinois","Ogle County",3,58,798,429,369
050,17,141,"Illinois","Ogle County",3,59,805,410,395
050,17,141,"Illinois","Ogle County",3,60,848,415,433
050,17,141,"Illinois","Ogle County",3,61,786,390,396
050,17,141,"Illinois","Ogle County",3,62,758,373,385
050,17,141,"Illinois","Ogle County",3,63,773,370,403
050,17,141,"Illinois","Ogle County",3,64,698,357,341
050,17,141,"Illinois","Ogle County",3,65,648,337,311
050,17,141,"Illinois","Ogle County",3,66,642,330,312
050,17,141,"Illinois","Ogle County",3,67,623,321,302
050,17,141,"Illinois","Ogle County",3,68,602,303,299
050,17,141,"Illinois","Ogle County",3,69,592,301,291
050,17,141,"Illinois","Ogle County",3,70,557,284,273
050,17,141,"Illinois","Ogle County",3,71,519,256,263
050,17,141,"Illinois","Ogle County",3,72,509,239,270
050,17,141,"Illinois","Ogle County",3,73,500,229,271
050,17,141,"Illinois","Ogle County",3,74,546,254,292
050,17,141,"Illinois","Ogle County",3,75,383,179,204
050,17,141,"Illinois","Ogle County",3,76,386,191,195
050,17,141,"Illinois","Ogle County",3,77,382,189,193
050,17,141,"Illinois","Ogle County",3,78,386,179,207
050,17,141,"Illinois","Ogle County",3,79,334,160,174
050,17,141,"Illinois","Ogle County",3,80,286,123,163
050,17,141,"Illinois","Ogle County",3,81,250,111,139
050,17,141,"Illinois","Ogle County",3,82,234,103,131
050,17,141,"Illinois","Ogle County",3,83,221,99,122
050,17,141,"Illinois","Ogle County",3,84,200,90,110
050,17,141,"Illinois","Ogle County",3,85,1123,404,719
050,17,141,"Illinois","Ogle County",4,0,516,269,247
050,17,141,"Illinois","Ogle County",4,1,528,263,265
050,17,141,"Illinois","Ogle County",4,2,526,277,249
050,17,141,"Illinois","Ogle County",4,3,555,278,277
050,17,141,"Illinois","Ogle County",4,4,569,299,270
050,17,141,"Illinois","Ogle County",4,5,612,315,297
050,17,141,"Illinois","Ogle County",4,6,596,300,296
050,17,141,"Illinois","Ogle County",4,7,604,311,293
050,17,141,"Illinois","Ogle County",4,8,612,311,301
050,17,141,"Illinois","Ogle County",4,9,670,333,337
050,17,141,"Illinois","Ogle County",4,10,629,305,324
050,17,141,"Illinois","Ogle County",4,11,670,335,335
050,17,141,"Illinois","Ogle County",4,12,668,350,318
050,17,141,"Illinois","Ogle County",4,13,677,353,324
050,17,141,"Illinois","Ogle County",4,14,745,376,369
050,17,141,"Illinois","Ogle County",4,15,769,384,385
050,17,141,"Illinois","Ogle County",4,16,749,387,362
050,17,141,"Illinois","Ogle County",4,17,688,348,340
050,17,141,"Illinois","Ogle County",4,18,612,317,295
050,17,141,"Illinois","Ogle County",4,19,513,269,244
050,17,141,"Illinois","Ogle County",4,20,517,270,247
050,17,141,"Illinois","Ogle County",4,21,552,284,268
050,17,141,"Illinois","Ogle County",4,22,551,283,268
050,17,141,"Illinois","Ogle County",4,23,592,291,301
050,17,141,"Illinois","Ogle County",4,24,552,268,284
050,17,141,"Illinois","Ogle County",4,25,532,262,270
050,17,141,"Illinois","Ogle County",4,26,509,262,247
050,17,141,"Illinois","Ogle County",4,27,589,318,271
050,17,141,"Illinois","Ogle County",4,28,576,307,269
050,17,141,"Illinois","Ogle County",4,29,596,303,293
050,17,141,"Illinois","Ogle County",4,30,617,304,313
050,17,141,"Illinois","Ogle County",4,31,645,326,319
050,17,141,"Illinois","Ogle County",4,32,649,333,316
050,17,141,"Illinois","Ogle County",4,33,598,299,299
050,17,141,"Illinois","Ogle County",4,34,590,295,295
050,17,141,"Illinois","Ogle County",4,35,558,272,286
050,17,141,"Illinois","Ogle County",4,36,578,289,289
050,17,141,"Illinois","Ogle County",4,37,646,319,327
050,17,141,"Illinois","Ogle County",4,38,656,325,331
050,17,141,"Illinois","Ogle County",4,39,643,320,323
050,17,141,"Illinois","Ogle County",4,40,645,344,301
050,17,141,"Illinois","Ogle County",4,41,639,346,293
050,17,141,"Illinois","Ogle County",4,42,660,371,289
050,17,141,"Illinois","Ogle County",4,43,638,339,299
050,17,141,"Illinois","Ogle County",4,44,600,294,306
050,17,141,"Illinois","Ogle County",4,45,580,280,300
050,17,141,"Illinois","Ogle County",4,46,589,290,299
050,17,141,"Illinois","Ogle County",4,47,583,298,285
050,17,141,"Illinois","Ogle County",4,48,555,289,266
050,17,141,"Illinois","Ogle County",4,49,572,283,289
050,17,141,"Illinois","Ogle County",4,50,657,324,333
050,17,141,"Illinois","Ogle County",4,51,705,365,340
050,17,141,"Illinois","Ogle County",4,52,691,348,343
050,17,141,"Illinois","Ogle County",4,53,670,342,328
050,17,141,"Illinois","Ogle County",4,54,675,349,326
050,17,141,"Illinois","Ogle County",4,55,678,333,345
050,17,141,"Illinois","Ogle County",4,56,671,334,337
050,17,141,"Illinois","Ogle County",4,57,710,369,341
050,17,141,"Illinois","Ogle County",4,58,738,389,349
050,17,141,"Illinois","Ogle County",4,59,788,413,375
050,17,141,"Illinois","Ogle County",4,60,794,399,395
050,17,141,"Illinois","Ogle County",4,61,838,412,426
050,17,141,"Illinois","Ogle County",4,62,768,378,390
050,17,141,"Illinois","Ogle County",4,63,755,369,386
050,17,141,"Illinois","Ogle County",4,64,772,370,402
050,17,141,"Illinois","Ogle County",4,65,703,359,344
050,17,141,"Illinois","Ogle County",4,66,635,328,307
050,17,141,"Illinois","Ogle County",4,67,632,324,308
050,17,141,"Illinois","Ogle County",4,68,604,313,291
050,17,141,"Illinois","Ogle County",4,69,584,291,293
050,17,141,"Illinois","Ogle County",4,70,577,292,285
050,17,141,"Illinois","Ogle County",4,71,535,280,255
050,17,141,"Illinois","Ogle County",4,72,508,245,263
050,17,141,"Illinois","Ogle County",4,73,494,231,263
050,17,141,"Illinois","Ogle County",4,74,475,215,260
050,17,141,"Illinois","Ogle County",4,75,527,243,284
050,17,141,"Illinois","Ogle County",4,76,374,175,199
050,17,141,"Illinois","Ogle County",4,77,369,178,191
050,17,141,"Illinois","Ogle County",4,78,364,170,194
050,17,141,"Illinois","Ogle County",4,79,368,166,202
050,17,141,"Illinois","Ogle County",4,80,316,150,166
050,17,141,"Illinois","Ogle County",4,81,266,110,156
050,17,141,"Illinois","Ogle County",4,82,230,102,128
050,17,141,"Illinois","Ogle County",4,83,219,89,130
050,17,141,"Illinois","Ogle County",4,84,196,91,105
050,17,141,"Illinois","Ogle County",4,85,1144,409,735
050,17,141,"Illinois","Ogle County",5,0,508,262,246
050,17,141,"Illinois","Ogle County",5,1,544,288,256
050,17,141,"Illinois","Ogle County",5,2,544,272,272
050,17,141,"Illinois","Ogle County",5,3,542,282,260
050,17,141,"Illinois","Ogle County",5,4,588,283,305
050,17,141,"Illinois","Ogle County",5,5,580,302,278
050,17,141,"Illinois","Ogle County",5,6,625,321,304
050,17,141,"Illinois","Ogle County",5,7,605,306,299
050,17,141,"Illinois","Ogle County",5,8,599,312,287
050,17,141,"Illinois","Ogle County",5,9,632,327,305
050,17,141,"Illinois","Ogle County",5,10,656,328,328
050,17,141,"Illinois","Ogle County",5,11,638,303,335
050,17,141,"Illinois","Ogle County",5,12,677,338,339
050,17,141,"Illinois","Ogle County",5,13,674,347,327
050,17,141,"Illinois","Ogle County",5,14,684,344,340
050,17,141,"Illinois","Ogle County",5,15,745,380,365
050,17,141,"Illinois","Ogle County",5,16,748,378,370
050,17,141,"Illinois","Ogle County",5,17,738,385,353
050,17,141,"Illinois","Ogle County",5,18,571,297,274
050,17,141,"Illinois","Ogle County",5,19,474,244,230
050,17,141,"Illinois","Ogle County",5,20,534,277,257
050,17,141,"Illinois","Ogle County",5,21,519,266,253
050,17,141,"Illinois","Ogle County",5,22,563,286,277
050,17,141,"Illinois","Ogle County",5,23,560,288,272
050,17,141,"Illinois","Ogle County",5,24,559,283,276
050,17,141,"Illinois","Ogle County",5,25,549,270,279
050,17,141,"Illinois","Ogle County",5,26,524,268,256
050,17,141,"Illinois","Ogle County",5,27,540,272,268
050,17,141,"Illinois","Ogle County",5,28,595,319,276
050,17,141,"Illinois","Ogle County",5,29,593,313,280
050,17,141,"Illinois","Ogle County",5,30,595,303,292
050,17,141,"Illinois","Ogle County",5,31,636,314,322
050,17,141,"Illinois","Ogle County",5,32,668,337,331
050,17,141,"Illinois","Ogle County",5,33,652,330,322
050,17,141,"Illinois","Ogle County",5,34,600,291,309
050,17,141,"Illinois","Ogle County",5,35,603,303,300
050,17,141,"Illinois","Ogle County",5,36,578,270,308
050,17,141,"Illinois","Ogle County",5,37,583,296,287
050,17,141,"Illinois","Ogle County",5,38,635,313,322
050,17,141,"Illinois","Ogle County",5,39,661,332,329
050,17,141,"Illinois","Ogle County",5,40,651,327,324
050,17,141,"Illinois","Ogle County",5,41,639,335,304
050,17,141,"Illinois","Ogle County",5,42,636,349,287
050,17,141,"Illinois","Ogle County",5,43,652,369,283
050,17,141,"Illinois","Ogle County",5,44,639,334,305
050,17,141,"Illinois","Ogle County",5,45,594,293,301
050,17,141,"Illinois","Ogle County",5,46,571,277,294
050,17,141,"Illinois","Ogle County",5,47,588,289,299
050,17,141,"Illinois","Ogle County",5,48,578,292,286
050,17,141,"Illinois","Ogle County",5,49,568,297,271
050,17,141,"Illinois","Ogle County",5,50,566,280,286
050,17,141,"Illinois","Ogle County",5,51,644,316,328
050,17,141,"Illinois","Ogle County",5,52,696,358,338
050,17,141,"Illinois","Ogle County",5,53,678,339,339
050,17,141,"Illinois","Ogle County",5,54,670,346,324
050,17,141,"Illinois","Ogle County",5,55,671,348,323
050,17,141,"Illinois","Ogle County",5,56,665,329,336
050,17,141,"Illinois","Ogle County",5,57,668,333,335
050,17,141,"Illinois","Ogle County",5,58,712,370,342
050,17,141,"Illinois","Ogle County",5,59,737,386,351
050,17,141,"Illinois","Ogle County",5,60,777,409,368
050,17,141,"Illinois","Ogle County",5,61,780,385,395
050,17,141,"Illinois","Ogle County",5,62,822,403,419
050,17,141,"Illinois","Ogle County",5,63,755,371,384
050,17,141,"Illinois","Ogle County",5,64,743,361,382
050,17,141,"Illinois","Ogle County",5,65,752,367,385
050,17,141,"Illinois","Ogle County",5,66,710,358,352
050,17,141,"Illinois","Ogle County",5,67,627,325,302
050,17,141,"Illinois","Ogle County",5,68,621,321,300
050,17,141,"Illinois","Ogle County",5,69,598,303,295
050,17,141,"Illinois","Ogle County",5,70,579,291,288
050,17,141,"Illinois","Ogle County",5,71,568,291,277
050,17,141,"Illinois","Ogle County",5,72,530,276,254
050,17,141,"Illinois","Ogle County",5,73,493,235,258
050,17,141,"Illinois","Ogle County",5,74,467,213,254
050,17,141,"Illinois","Ogle County",5,75,448,200,248
050,17,141,"Illinois","Ogle County",5,76,511,237,274
050,17,141,"Illinois","Ogle County",5,77,358,163,195
050,17,141,"Illinois","Ogle County",5,78,358,171,187
050,17,141,"Illinois","Ogle County",5,79,356,165,191
050,17,141,"Illinois","Ogle County",5,80,357,161,196
050,17,141,"Illinois","Ogle County",5,81,297,136,161
050,17,141,"Illinois","Ogle County",5,82,242,99,143
050,17,141,"Illinois","Ogle County",5,83,215,85,130
050,17,141,"Illinois","Ogle County",5,84,193,79,114
050,17,141,"Illinois","Ogle County",5,85,1166,417,749
050,17,143,"Illinois","Peoria County",1,0,2451,1253,1198
050,17,143,"Illinois","Peoria County",1,1,2456,1252,1204
050,17,143,"Illinois","Peoria County",1,2,2521,1285,1236
050,17,143,"Illinois","Peoria County",1,3,2427,1250,1177
050,17,143,"Illinois","Peoria County",1,4,2481,1264,1217
050,17,143,"Illinois","Peoria County",1,5,2552,1303,1249
050,17,143,"Illinois","Peoria County",1,6,2492,1298,1194
050,17,143,"Illinois","Peoria County",1,7,2434,1253,1181
050,17,143,"Illinois","Peoria County",1,8,2343,1234,1109
050,17,143,"Illinois","Peoria County",1,9,2324,1230,1094
050,17,143,"Illinois","Peoria County",1,10,2412,1243,1169
050,17,143,"Illinois","Peoria County",1,11,2452,1249,1203
050,17,143,"Illinois","Peoria County",1,12,2482,1275,1207
050,17,143,"Illinois","Peoria County",1,13,2484,1264,1220
050,17,143,"Illinois","Peoria County",1,14,2410,1219,1191
050,17,143,"Illinois","Peoria County",1,15,2342,1198,1144
050,17,143,"Illinois","Peoria County",1,16,2373,1225,1148
050,17,143,"Illinois","Peoria County",1,17,2372,1239,1133
050,17,143,"Illinois","Peoria County",1,18,2382,1203,1179
050,17,143,"Illinois","Peoria County",1,19,2377,1136,1241
050,17,143,"Illinois","Peoria County",1,20,2245,1086,1159
050,17,143,"Illinois","Peoria County",1,21,2137,1042,1095
050,17,143,"Illinois","Peoria County",1,22,2140,1053,1087
050,17,143,"Illinois","Peoria County",1,23,2202,1086,1116
050,17,143,"Illinois","Peoria County",1,24,2270,1115,1155
050,17,143,"Illinois","Peoria County",1,25,2363,1146,1217
050,17,143,"Illinois","Peoria County",1,26,2422,1213,1209
050,17,143,"Illinois","Peoria County",1,27,2437,1209,1228
050,17,143,"Illinois","Peoria County",1,28,2460,1211,1249
050,17,143,"Illinois","Peoria County",1,29,2522,1264,1258
050,17,143,"Illinois","Peoria County",1,30,2501,1198,1303
050,17,143,"Illinois","Peoria County",1,31,2484,1219,1265
050,17,143,"Illinois","Peoria County",1,32,2338,1152,1186
050,17,143,"Illinois","Peoria County",1,33,2322,1146,1176
050,17,143,"Illinois","Peoria County",1,34,2322,1144,1178
050,17,143,"Illinois","Peoria County",1,35,2359,1163,1196
050,17,143,"Illinois","Peoria County",1,36,2288,1124,1164
050,17,143,"Illinois","Peoria County",1,37,2303,1144,1159
050,17,143,"Illinois","Peoria County",1,38,2302,1174,1128
050,17,143,"Illinois","Peoria County",1,39,2364,1224,1140
050,17,143,"Illinois","Peoria County",1,40,2272,1164,1108
050,17,143,"Illinois","Peoria County",1,41,2221,1111,1110
050,17,143,"Illinois","Peoria County",1,42,2113,1041,1072
050,17,143,"Illinois","Peoria County",1,43,2124,1030,1094
050,17,143,"Illinois","Peoria County",1,44,2053,1033,1020
050,17,143,"Illinois","Peoria County",1,45,2054,999,1055
050,17,143,"Illinois","Peoria County",1,46,1976,945,1031
050,17,143,"Illinois","Peoria County",1,47,2021,985,1036
050,17,143,"Illinois","Peoria County",1,48,2121,1015,1106
050,17,143,"Illinois","Peoria County",1,49,2280,1119,1161
050,17,143,"Illinois","Peoria County",1,50,2260,1126,1134
050,17,143,"Illinois","Peoria County",1,51,2148,1053,1095
050,17,143,"Illinois","Peoria County",1,52,2075,1005,1070
050,17,143,"Illinois","Peoria County",1,53,2142,1045,1097
050,17,143,"Illinois","Peoria County",1,54,2154,1065,1089
050,17,143,"Illinois","Peoria County",1,55,2173,1093,1080
050,17,143,"Illinois","Peoria County",1,56,2242,1156,1086
050,17,143,"Illinois","Peoria County",1,57,2251,1083,1168
050,17,143,"Illinois","Peoria County",1,58,2271,1079,1192
050,17,143,"Illinois","Peoria County",1,59,2329,1084,1245
050,17,143,"Illinois","Peoria County",1,60,2335,1119,1216
050,17,143,"Illinois","Peoria County",1,61,2279,1080,1199
050,17,143,"Illinois","Peoria County",1,62,2315,1104,1211
050,17,143,"Illinois","Peoria County",1,63,2275,1062,1213
050,17,143,"Illinois","Peoria County",1,64,2222,1030,1192
050,17,143,"Illinois","Peoria County",1,65,2223,1051,1172
050,17,143,"Illinois","Peoria County",1,66,2165,1018,1147
050,17,143,"Illinois","Peoria County",1,67,2071,1011,1060
050,17,143,"Illinois","Peoria County",1,68,1972,935,1037
050,17,143,"Illinois","Peoria County",1,69,1865,872,993
050,17,143,"Illinois","Peoria County",1,70,1832,834,998
050,17,143,"Illinois","Peoria County",1,71,1770,805,965
050,17,143,"Illinois","Peoria County",1,72,1815,857,958
050,17,143,"Illinois","Peoria County",1,73,1779,821,958
050,17,143,"Illinois","Peoria County",1,74,1228,565,663
050,17,143,"Illinois","Peoria County",1,75,1191,546,645
050,17,143,"Illinois","Peoria County",1,76,1240,585,655
050,17,143,"Illinois","Peoria County",1,77,1205,565,640
050,17,143,"Illinois","Peoria County",1,78,989,431,558
050,17,143,"Illinois","Peoria County",1,79,914,392,522
050,17,143,"Illinois","Peoria County",1,80,815,347,468
050,17,143,"Illinois","Peoria County",1,81,776,332,444
050,17,143,"Illinois","Peoria County",1,82,754,335,419
050,17,143,"Illinois","Peoria County",1,83,654,283,371
050,17,143,"Illinois","Peoria County",1,84,590,222,368
050,17,143,"Illinois","Peoria County",1,85,3934,1309,2625
050,17,143,"Illinois","Peoria County",2,0,2366,1195,1171
050,17,143,"Illinois","Peoria County",2,1,2440,1246,1194
050,17,143,"Illinois","Peoria County",2,2,2492,1272,1220
050,17,143,"Illinois","Peoria County",2,3,2431,1249,1182
050,17,143,"Illinois","Peoria County",2,4,2460,1256,1204
050,17,143,"Illinois","Peoria County",2,5,2528,1288,1240
050,17,143,"Illinois","Peoria County",2,6,2500,1292,1208
050,17,143,"Illinois","Peoria County",2,7,2435,1257,1178
050,17,143,"Illinois","Peoria County",2,8,2350,1231,1119
050,17,143,"Illinois","Peoria County",2,9,2318,1227,1091
050,17,143,"Illinois","Peoria County",2,10,2378,1231,1147
050,17,143,"Illinois","Peoria County",2,11,2431,1242,1189
050,17,143,"Illinois","Peoria County",2,12,2478,1271,1207
050,17,143,"Illinois","Peoria County",2,13,2471,1258,1213
050,17,143,"Illinois","Peoria County",2,14,2416,1224,1192
050,17,143,"Illinois","Peoria County",2,15,2353,1199,1154
050,17,143,"Illinois","Peoria County",2,16,2361,1218,1143
050,17,143,"Illinois","Peoria County",2,17,2370,1232,1138
050,17,143,"Illinois","Peoria County",2,18,2373,1208,1165
050,17,143,"Illinois","Peoria County",2,19,2388,1148,1240
050,17,143,"Illinois","Peoria County",2,20,2256,1089,1167
050,17,143,"Illinois","Peoria County",2,21,2135,1032,1103
050,17,143,"Illinois","Peoria County",2,22,2136,1047,1089
050,17,143,"Illinois","Peoria County",2,23,2191,1085,1106
050,17,143,"Illinois","Peoria County",2,24,2249,1109,1140
050,17,143,"Illinois","Peoria County",2,25,2340,1141,1199
050,17,143,"Illinois","Peoria County",2,26,2406,1198,1208
050,17,143,"Illinois","Peoria County",2,27,2427,1209,1218
050,17,143,"Illinois","Peoria County",2,28,2443,1206,1237
050,17,143,"Illinois","Peoria County",2,29,2498,1239,1259
050,17,143,"Illinois","Peoria County",2,30,2507,1212,1295
050,17,143,"Illinois","Peoria County",2,31,2463,1203,1260
050,17,143,"Illinois","Peoria County",2,32,2361,1160,1201
050,17,143,"Illinois","Peoria County",2,33,2316,1145,1171
050,17,143,"Illinois","Peoria County",2,34,2309,1138,1171
050,17,143,"Illinois","Peoria County",2,35,2351,1162,1189
050,17,143,"Illinois","Peoria County",2,36,2281,1124,1157
050,17,143,"Illinois","Peoria County",2,37,2285,1129,1156
050,17,143,"Illinois","Peoria County",2,38,2310,1166,1144
050,17,143,"Illinois","Peoria County",2,39,2336,1208,1128
050,17,143,"Illinois","Peoria County",2,40,2306,1186,1120
050,17,143,"Illinois","Peoria County",2,41,2220,1115,1105
050,17,143,"Illinois","Peoria County",2,42,2121,1048,1073
050,17,143,"Illinois","Peoria County",2,43,2130,1038,1092
050,17,143,"Illinois","Peoria County",2,44,2039,1018,1021
050,17,143,"Illinois","Peoria County",2,45,2061,1010,1051
050,17,143,"Illinois","Peoria County",2,46,1980,952,1028
050,17,143,"Illinois","Peoria County",2,47,2000,969,1031
050,17,143,"Illinois","Peoria County",2,48,2095,1005,1090
050,17,143,"Illinois","Peoria County",2,49,2241,1098,1143
050,17,143,"Illinois","Peoria County",2,50,2255,1120,1135
050,17,143,"Illinois","Peoria County",2,51,2165,1063,1102
050,17,143,"Illinois","Peoria County",2,52,2081,1011,1070
050,17,143,"Illinois","Peoria County",2,53,2125,1034,1091
050,17,143,"Illinois","Peoria County",2,54,2142,1057,1085
050,17,143,"Illinois","Peoria County",2,55,2154,1077,1077
050,17,143,"Illinois","Peoria County",2,56,2224,1140,1084
050,17,143,"Illinois","Peoria County",2,57,2239,1098,1141
050,17,143,"Illinois","Peoria County",2,58,2249,1070,1179
050,17,143,"Illinois","Peoria County",2,59,2304,1081,1223
050,17,143,"Illinois","Peoria County",2,60,2314,1099,1215
050,17,143,"Illinois","Peoria County",2,61,2270,1077,1193
050,17,143,"Illinois","Peoria County",2,62,2288,1089,1199
050,17,143,"Illinois","Peoria County",2,63,2289,1070,1219
050,17,143,"Illinois","Peoria County",2,64,2207,1023,1184
050,17,143,"Illinois","Peoria County",2,65,2213,1040,1173
050,17,143,"Illinois","Peoria County",2,66,2173,1024,1149
050,17,143,"Illinois","Peoria County",2,67,2066,997,1069
050,17,143,"Illinois","Peoria County",2,68,1973,940,1033
050,17,143,"Illinois","Peoria County",2,69,1892,889,1003
050,17,143,"Illinois","Peoria County",2,70,1821,830,991
050,17,143,"Illinois","Peoria County",2,71,1778,809,969
050,17,143,"Illinois","Peoria County",2,72,1768,824,944
050,17,143,"Illinois","Peoria County",2,73,1870,873,997
050,17,143,"Illinois","Peoria County",2,74,1264,577,687
050,17,143,"Illinois","Peoria County",2,75,1195,547,648
050,17,143,"Illinois","Peoria County",2,76,1203,559,644
050,17,143,"Illinois","Peoria County",2,77,1233,579,654
050,17,143,"Illinois","Peoria County",2,78,1001,445,556
050,17,143,"Illinois","Peoria County",2,79,922,395,527
050,17,143,"Illinois","Peoria County",2,80,823,353,470
050,17,143,"Illinois","Peoria County",2,81,770,326,444
050,17,143,"Illinois","Peoria County",2,82,749,329,420
050,17,143,"Illinois","Peoria County",2,83,667,292,375
050,17,143,"Illinois","Peoria County",2,84,585,228,357
050,17,143,"Illinois","Peoria County",2,85,3915,1302,2613
050,17,143,"Illinois","Peoria County",3,0,2196,1125,1071
050,17,143,"Illinois","Peoria County",3,1,2284,1148,1136
050,17,143,"Illinois","Peoria County",3,2,2440,1237,1203
050,17,143,"Illinois","Peoria County",3,3,2437,1254,1183
050,17,143,"Illinois","Peoria County",3,4,2412,1258,1154
050,17,143,"Illinois","Peoria County",3,5,2431,1220,1211
050,17,143,"Illinois","Peoria County",3,6,2489,1263,1226
050,17,143,"Illinois","Peoria County",3,7,2466,1297,1169
050,17,143,"Illinois","Peoria County",3,8,2431,1278,1153
050,17,143,"Illinois","Peoria County",3,9,2300,1200,1100
050,17,143,"Illinois","Peoria County",3,10,2309,1218,1091
050,17,143,"Illinois","Peoria County",3,11,2359,1219,1140
050,17,143,"Illinois","Peoria County",3,12,2449,1241,1208
050,17,143,"Illinois","Peoria County",3,13,2499,1289,1210
050,17,143,"Illinois","Peoria County",3,14,2468,1261,1207
050,17,143,"Illinois","Peoria County",3,15,2408,1223,1185
050,17,143,"Illinois","Peoria County",3,16,2327,1179,1148
050,17,143,"Illinois","Peoria County",3,17,2346,1215,1131
050,17,143,"Illinois","Peoria County",3,18,2406,1238,1168
050,17,143,"Illinois","Peoria County",3,19,2367,1143,1224
050,17,143,"Illinois","Peoria County",3,20,2239,1077,1162
050,17,143,"Illinois","Peoria County",3,21,2171,1032,1139
050,17,143,"Illinois","Peoria County",3,22,2165,1055,1110
050,17,143,"Illinois","Peoria County",3,23,2148,1057,1091
050,17,143,"Illinois","Peoria County",3,24,2205,1084,1121
050,17,143,"Illinois","Peoria County",3,25,2214,1069,1145
050,17,143,"Illinois","Peoria County",3,26,2274,1130,1144
050,17,143,"Illinois","Peoria County",3,27,2433,1210,1223
050,17,143,"Illinois","Peoria County",3,28,2393,1189,1204
050,17,143,"Illinois","Peoria County",3,29,2440,1207,1233
050,17,143,"Illinois","Peoria County",3,30,2406,1198,1208
050,17,143,"Illinois","Peoria County",3,31,2455,1218,1237
050,17,143,"Illinois","Peoria County",3,32,2385,1129,1256
050,17,143,"Illinois","Peoria County",3,33,2323,1122,1201
050,17,143,"Illinois","Peoria County",3,34,2250,1114,1136
050,17,143,"Illinois","Peoria County",3,35,2306,1117,1189
050,17,143,"Illinois","Peoria County",3,36,2330,1158,1172
050,17,143,"Illinois","Peoria County",3,37,2231,1107,1124
050,17,143,"Illinois","Peoria County",3,38,2215,1100,1115
050,17,143,"Illinois","Peoria County",3,39,2299,1157,1142
050,17,143,"Illinois","Peoria County",3,40,2327,1212,1115
050,17,143,"Illinois","Peoria County",3,41,2279,1168,1111
050,17,143,"Illinois","Peoria County",3,42,2219,1127,1092
050,17,143,"Illinois","Peoria County",3,43,2088,1029,1059
050,17,143,"Illinois","Peoria County",3,44,2073,991,1082
050,17,143,"Illinois","Peoria County",3,45,2027,1019,1008
050,17,143,"Illinois","Peoria County",3,46,2017,981,1036
050,17,143,"Illinois","Peoria County",3,47,1973,941,1032
050,17,143,"Illinois","Peoria County",3,48,1987,956,1031
050,17,143,"Illinois","Peoria County",3,49,2033,980,1053
050,17,143,"Illinois","Peoria County",3,50,2195,1065,1130
050,17,143,"Illinois","Peoria County",3,51,2242,1098,1144
050,17,143,"Illinois","Peoria County",3,52,2118,1052,1066
050,17,143,"Illinois","Peoria County",3,53,2044,985,1059
050,17,143,"Illinois","Peoria County",3,54,2108,1032,1076
050,17,143,"Illinois","Peoria County",3,55,2075,1014,1061
050,17,143,"Illinois","Peoria County",3,56,2124,1062,1062
050,17,143,"Illinois","Peoria County",3,57,2191,1124,1067
050,17,143,"Illinois","Peoria County",3,58,2214,1084,1130
050,17,143,"Illinois","Peoria County",3,59,2195,1034,1161
050,17,143,"Illinois","Peoria County",3,60,2217,1039,1178
050,17,143,"Illinois","Peoria County",3,61,2256,1073,1183
050,17,143,"Illinois","Peoria County",3,62,2213,1045,1168
050,17,143,"Illinois","Peoria County",3,63,2249,1069,1180
050,17,143,"Illinois","Peoria County",3,64,2240,1037,1203
050,17,143,"Illinois","Peoria County",3,65,2146,998,1148
050,17,143,"Illinois","Peoria County",3,66,2133,996,1137
050,17,143,"Illinois","Peoria County",3,67,2100,993,1107
050,17,143,"Illinois","Peoria County",3,68,2010,956,1054
050,17,143,"Illinois","Peoria County",3,69,1931,921,1010
050,17,143,"Illinois","Peoria County",3,70,1816,852,964
050,17,143,"Illinois","Peoria County",3,71,1743,785,958
050,17,143,"Illinois","Peoria County",3,72,1709,770,939
050,17,143,"Illinois","Peoria County",3,73,1705,796,909
050,17,143,"Illinois","Peoria County",3,74,1789,826,963
050,17,143,"Illinois","Peoria County",3,75,1202,551,651
050,17,143,"Illinois","Peoria County",3,76,1144,511,633
050,17,143,"Illinois","Peoria County",3,77,1163,539,624
050,17,143,"Illinois","Peoria County",3,78,1157,544,613
050,17,143,"Illinois","Peoria County",3,79,958,413,545
050,17,143,"Illinois","Peoria County",3,80,855,371,484
050,17,143,"Illinois","Peoria County",3,81,779,321,458
050,17,143,"Illinois","Peoria County",3,82,728,303,425
050,17,143,"Illinois","Peoria County",3,83,688,294,394
050,17,143,"Illinois","Peoria County",3,84,624,268,356
050,17,143,"Illinois","Peoria County",3,85,3848,1282,2566
050,17,143,"Illinois","Peoria County",4,0,2131,1061,1070
050,17,143,"Illinois","Peoria County",4,1,2206,1111,1095
050,17,143,"Illinois","Peoria County",4,2,2305,1165,1140
050,17,143,"Illinois","Peoria County",4,3,2434,1242,1192
050,17,143,"Illinois","Peoria County",4,4,2441,1254,1187
050,17,143,"Illinois","Peoria County",4,5,2410,1252,1158
050,17,143,"Illinois","Peoria County",4,6,2420,1206,1214
050,17,143,"Illinois","Peoria County",4,7,2486,1262,1224
050,17,143,"Illinois","Peoria County",4,8,2400,1251,1149
050,17,143,"Illinois","Peoria County",4,9,2377,1259,1118
050,17,143,"Illinois","Peoria County",4,10,2271,1190,1081
050,17,143,"Illinois","Peoria County",4,11,2249,1182,1067
050,17,143,"Illinois","Peoria County",4,12,2351,1229,1122
050,17,143,"Illinois","Peoria County",4,13,2424,1235,1189
050,17,143,"Illinois","Peoria County",4,14,2477,1277,1200
050,17,143,"Illinois","Peoria County",4,15,2422,1240,1182
050,17,143,"Illinois","Peoria County",4,16,2367,1205,1162
050,17,143,"Illinois","Peoria County",4,17,2293,1147,1146
050,17,143,"Illinois","Peoria County",4,18,2354,1198,1156
050,17,143,"Illinois","Peoria County",4,19,2327,1158,1169
050,17,143,"Illinois","Peoria County",4,20,2163,1058,1105
050,17,143,"Illinois","Peoria County",4,21,2178,1041,1137
050,17,143,"Illinois","Peoria County",4,22,2142,1020,1122
050,17,143,"Illinois","Peoria County",4,23,2205,1074,1131
050,17,143,"Illinois","Peoria County",4,24,2191,1091,1100
050,17,143,"Illinois","Peoria County",4,25,2259,1113,1146
050,17,143,"Illinois","Peoria County",4,26,2171,1067,1104
050,17,143,"Illinois","Peoria County",4,27,2277,1135,1142
050,17,143,"Illinois","Peoria County",4,28,2397,1181,1216
050,17,143,"Illinois","Peoria County",4,29,2413,1195,1218
050,17,143,"Illinois","Peoria County",4,30,2386,1187,1199
050,17,143,"Illinois","Peoria County",4,31,2341,1165,1176
050,17,143,"Illinois","Peoria County",4,32,2433,1206,1227
050,17,143,"Illinois","Peoria County",4,33,2366,1133,1233
050,17,143,"Illinois","Peoria County",4,34,2307,1133,1174
050,17,143,"Illinois","Peoria County",4,35,2243,1110,1133
050,17,143,"Illinois","Peoria County",4,36,2317,1124,1193
050,17,143,"Illinois","Peoria County",4,37,2271,1122,1149
050,17,143,"Illinois","Peoria County",4,38,2198,1084,1114
050,17,143,"Illinois","Peoria County",4,39,2194,1087,1107
050,17,143,"Illinois","Peoria County",4,40,2272,1151,1121
050,17,143,"Illinois","Peoria County",4,41,2275,1158,1117
050,17,143,"Illinois","Peoria County",4,42,2236,1150,1086
050,17,143,"Illinois","Peoria County",4,43,2206,1120,1086
050,17,143,"Illinois","Peoria County",4,44,2086,1043,1043
050,17,143,"Illinois","Peoria County",4,45,2056,989,1067
050,17,143,"Illinois","Peoria County",4,46,1966,972,994
050,17,143,"Illinois","Peoria County",4,47,1996,979,1017
050,17,143,"Illinois","Peoria County",4,48,1977,958,1019
050,17,143,"Illinois","Peoria County",4,49,1945,939,1006
050,17,143,"Illinois","Peoria County",4,50,2006,961,1045
050,17,143,"Illinois","Peoria County",4,51,2163,1038,1125
050,17,143,"Illinois","Peoria County",4,52,2183,1072,1111
050,17,143,"Illinois","Peoria County",4,53,2081,1025,1056
050,17,143,"Illinois","Peoria County",4,54,1995,960,1035
050,17,143,"Illinois","Peoria County",4,55,2052,1009,1043
050,17,143,"Illinois","Peoria County",4,56,2050,995,1055
050,17,143,"Illinois","Peoria County",4,57,2084,1031,1053
050,17,143,"Illinois","Peoria County",4,58,2129,1093,1036
050,17,143,"Illinois","Peoria County",4,59,2172,1066,1106
050,17,143,"Illinois","Peoria County",4,60,2119,985,1134
050,17,143,"Illinois","Peoria County",4,61,2158,1015,1143
050,17,143,"Illinois","Peoria County",4,62,2183,1039,1144
050,17,143,"Illinois","Peoria County",4,63,2158,1016,1142
050,17,143,"Illinois","Peoria County",4,64,2174,1026,1148
050,17,143,"Illinois","Peoria County",4,65,2164,1001,1163
050,17,143,"Illinois","Peoria County",4,66,2098,972,1126
050,17,143,"Illinois","Peoria County",4,67,2075,957,1118
050,17,143,"Illinois","Peoria County",4,68,2041,965,1076
050,17,143,"Illinois","Peoria County",4,69,1950,937,1013
050,17,143,"Illinois","Peoria County",4,70,1861,889,972
050,17,143,"Illinois","Peoria County",4,71,1775,826,949
050,17,143,"Illinois","Peoria County",4,72,1701,752,949
050,17,143,"Illinois","Peoria County",4,73,1656,749,907
050,17,143,"Illinois","Peoria County",4,74,1626,741,885
050,17,143,"Illinois","Peoria County",4,75,1725,800,925
050,17,143,"Illinois","Peoria County",4,76,1155,516,639
050,17,143,"Illinois","Peoria County",4,77,1114,499,615
050,17,143,"Illinois","Peoria County",4,78,1088,505,583
050,17,143,"Illinois","Peoria County",4,79,1107,509,598
050,17,143,"Illinois","Peoria County",4,80,877,386,491
050,17,143,"Illinois","Peoria County",4,81,799,332,467
050,17,143,"Illinois","Peoria County",4,82,737,300,437
050,17,143,"Illinois","Peoria County",4,83,667,272,395
050,17,143,"Illinois","Peoria County",4,84,632,258,374
050,17,143,"Illinois","Peoria County",4,85,3833,1297,2536
050,17,143,"Illinois","Peoria County",5,0,2067,1027,1040
050,17,143,"Illinois","Peoria County",5,1,2167,1064,1103
050,17,143,"Illinois","Peoria County",5,2,2193,1106,1087
050,17,143,"Illinois","Peoria County",5,3,2308,1164,1144
050,17,143,"Illinois","Peoria County",5,4,2470,1260,1210
050,17,143,"Illinois","Peoria County",5,5,2469,1256,1213
050,17,143,"Illinois","Peoria County",5,6,2414,1257,1157
050,17,143,"Illinois","Peoria County",5,7,2405,1195,1210
050,17,143,"Illinois","Peoria County",5,8,2454,1264,1190
050,17,143,"Illinois","Peoria County",5,9,2364,1236,1128
050,17,143,"Illinois","Peoria County",5,10,2377,1247,1130
050,17,143,"Illinois","Peoria County",5,11,2254,1166,1088
050,17,143,"Illinois","Peoria County",5,12,2291,1207,1084
050,17,143,"Illinois","Peoria County",5,13,2361,1221,1140
050,17,143,"Illinois","Peoria County",5,14,2415,1236,1179
050,17,143,"Illinois","Peoria County",5,15,2440,1268,1172
050,17,143,"Illinois","Peoria County",5,16,2423,1256,1167
050,17,143,"Illinois","Peoria County",5,17,2375,1207,1168
050,17,143,"Illinois","Peoria County",5,18,2293,1148,1145
050,17,143,"Illinois","Peoria County",5,19,2348,1151,1197
050,17,143,"Illinois","Peoria County",5,20,2190,1108,1082
050,17,143,"Illinois","Peoria County",5,21,2114,1014,1100
050,17,143,"Illinois","Peoria County",5,22,2185,1041,1144
050,17,143,"Illinois","Peoria County",5,23,2151,1029,1122
050,17,143,"Illinois","Peoria County",5,24,2271,1117,1154
050,17,143,"Illinois","Peoria County",5,25,2207,1129,1078
050,17,143,"Illinois","Peoria County",5,26,2234,1107,1127
050,17,143,"Illinois","Peoria County",5,27,2166,1071,1095
050,17,143,"Illinois","Peoria County",5,28,2311,1151,1160
050,17,143,"Illinois","Peoria County",5,29,2470,1233,1237
050,17,143,"Illinois","Peoria County",5,30,2420,1172,1248
050,17,143,"Illinois","Peoria County",5,31,2405,1197,1208
050,17,143,"Illinois","Peoria County",5,32,2352,1163,1189
050,17,143,"Illinois","Peoria County",5,33,2471,1248,1223
050,17,143,"Illinois","Peoria County",5,34,2340,1098,1242
050,17,143,"Illinois","Peoria County",5,35,2293,1121,1172
050,17,143,"Illinois","Peoria County",5,36,2252,1128,1124
050,17,143,"Illinois","Peoria County",5,37,2262,1085,1177
050,17,143,"Illinois","Peoria County",5,38,2248,1095,1153
050,17,143,"Illinois","Peoria County",5,39,2164,1081,1083
050,17,143,"Illinois","Peoria County",5,40,2186,1077,1109
050,17,143,"Illinois","Peoria County",5,41,2240,1141,1099
050,17,143,"Illinois","Peoria County",5,42,2240,1146,1094
050,17,143,"Illinois","Peoria County",5,43,2205,1132,1073
050,17,143,"Illinois","Peoria County",5,44,2208,1110,1098
050,17,143,"Illinois","Peoria County",5,45,2086,1061,1025
050,17,143,"Illinois","Peoria County",5,46,2033,963,1070
050,17,143,"Illinois","Peoria County",5,47,1939,954,985
050,17,143,"Illinois","Peoria County",5,48,2003,969,1034
050,17,143,"Illinois","Peoria County",5,49,1940,948,992
050,17,143,"Illinois","Peoria County",5,50,1925,933,992
050,17,143,"Illinois","Peoria County",5,51,1996,941,1055
050,17,143,"Illinois","Peoria County",5,52,2134,1033,1101
050,17,143,"Illinois","Peoria County",5,53,2141,1047,1094
050,17,143,"Illinois","Peoria County",5,54,2064,1014,1050
050,17,143,"Illinois","Peoria County",5,55,1930,923,1007
050,17,143,"Illinois","Peoria County",5,56,2002,990,1012
050,17,143,"Illinois","Peoria County",5,57,2000,977,1023
050,17,143,"Illinois","Peoria County",5,58,2032,1001,1031
050,17,143,"Illinois","Peoria County",5,59,2106,1082,1024
050,17,143,"Illinois","Peoria County",5,60,2131,1042,1089
050,17,143,"Illinois","Peoria County",5,61,2070,974,1096
050,17,143,"Illinois","Peoria County",5,62,2107,992,1115
050,17,143,"Illinois","Peoria County",5,63,2150,1013,1137
050,17,143,"Illinois","Peoria County",5,64,2094,982,1112
050,17,143,"Illinois","Peoria County",5,65,2113,987,1126
050,17,143,"Illinois","Peoria County",5,66,2120,971,1149
050,17,143,"Illinois","Peoria County",5,67,2058,960,1098
050,17,143,"Illinois","Peoria County",5,68,2024,923,1101
050,17,143,"Illinois","Peoria County",5,69,1995,950,1045
050,17,143,"Illinois","Peoria County",5,70,1912,919,993
050,17,143,"Illinois","Peoria County",5,71,1831,869,962
050,17,143,"Illinois","Peoria County",5,72,1705,785,920
050,17,143,"Illinois","Peoria County",5,73,1654,729,925
050,17,143,"Illinois","Peoria County",5,74,1586,710,876
050,17,143,"Illinois","Peoria County",5,75,1577,727,850
050,17,143,"Illinois","Peoria County",5,76,1650,747,903
050,17,143,"Illinois","Peoria County",5,77,1111,498,613
050,17,143,"Illinois","Peoria County",5,78,1028,463,565
050,17,143,"Illinois","Peoria County",5,79,1041,468,573
050,17,143,"Illinois","Peoria County",5,80,1026,487,539
050,17,143,"Illinois","Peoria County",5,81,819,349,470
050,17,143,"Illinois","Peoria County",5,82,767,313,454
050,17,143,"Illinois","Peoria County",5,83,672,265,407
050,17,143,"Illinois","Peoria County",5,84,602,238,364
050,17,143,"Illinois","Peoria County",5,85,3866,1329,2537
050,17,145,"Illinois","Perry County",1,0,175,90,85
050,17,145,"Illinois","Perry County",1,1,191,99,92
050,17,145,"Illinois","Perry County",1,2,202,95,107
050,17,145,"Illinois","Perry County",1,3,213,105,108
050,17,145,"Illinois","Perry County",1,4,223,104,119
050,17,145,"Illinois","Perry County",1,5,214,107,107
050,17,145,"Illinois","Perry County",1,6,233,118,115
050,17,145,"Illinois","Perry County",1,7,211,114,97
050,17,145,"Illinois","Perry County",1,8,214,113,101
050,17,145,"Illinois","Perry County",1,9,212,100,112
050,17,145,"Illinois","Perry County",1,10,237,118,119
050,17,145,"Illinois","Perry County",1,11,230,113,117
050,17,145,"Illinois","Perry County",1,12,263,146,117
050,17,145,"Illinois","Perry County",1,13,252,126,126
050,17,145,"Illinois","Perry County",1,14,259,134,125
050,17,145,"Illinois","Perry County",1,15,263,141,122
050,17,145,"Illinois","Perry County",1,16,281,156,125
050,17,145,"Illinois","Perry County",1,17,277,147,130
050,17,145,"Illinois","Perry County",1,18,244,158,86
050,17,145,"Illinois","Perry County",1,19,230,155,75
050,17,145,"Illinois","Perry County",1,20,252,184,68
050,17,145,"Illinois","Perry County",1,21,257,181,76
050,17,145,"Illinois","Perry County",1,22,276,197,79
050,17,145,"Illinois","Perry County",1,23,264,186,78
050,17,145,"Illinois","Perry County",1,24,273,176,97
050,17,145,"Illinois","Perry County",1,25,251,158,93
050,17,145,"Illinois","Perry County",1,26,273,172,101
050,17,145,"Illinois","Perry County",1,27,275,170,105
050,17,145,"Illinois","Perry County",1,28,309,193,116
050,17,145,"Illinois","Perry County",1,29,300,189,111
050,17,145,"Illinois","Perry County",1,30,289,189,100
050,17,145,"Illinois","Perry County",1,31,273,180,93
050,17,145,"Illinois","Perry County",1,32,276,184,92
050,17,145,"Illinois","Perry County",1,33,249,154,95
050,17,145,"Illinois","Perry County",1,34,254,149,105
050,17,145,"Illinois","Perry County",1,35,259,153,106
050,17,145,"Illinois","Perry County",1,36,259,155,104
050,17,145,"Illinois","Perry County",1,37,294,171,123
050,17,145,"Illinois","Perry County",1,38,281,171,110
050,17,145,"Illinois","Perry County",1,39,273,162,111
050,17,145,"Illinois","Perry County",1,40,261,150,111
050,17,145,"Illinois","Perry County",1,41,270,160,110
050,17,145,"Illinois","Perry County",1,42,280,168,112
050,17,145,"Illinois","Perry County",1,43,269,160,109
050,17,145,"Illinois","Perry County",1,44,255,140,115
050,17,145,"Illinois","Perry County",1,45,256,139,117
050,17,145,"Illinois","Perry County",1,46,265,144,121
050,17,145,"Illinois","Perry County",1,47,258,145,113
050,17,145,"Illinois","Perry County",1,48,287,160,127
050,17,145,"Illinois","Perry County",1,49,303,170,133
050,17,145,"Illinois","Perry County",1,50,242,140,102
050,17,145,"Illinois","Perry County",1,51,237,140,97
050,17,145,"Illinois","Perry County",1,52,248,132,116
050,17,145,"Illinois","Perry County",1,53,243,129,114
050,17,145,"Illinois","Perry County",1,54,276,146,130
050,17,145,"Illinois","Perry County",1,55,302,157,145
050,17,145,"Illinois","Perry County",1,56,287,155,132
050,17,145,"Illinois","Perry County",1,57,286,156,130
050,17,145,"Illinois","Perry County",1,58,302,157,145
050,17,145,"Illinois","Perry County",1,59,293,151,142
050,17,145,"Illinois","Perry County",1,60,275,138,137
050,17,145,"Illinois","Perry County",1,61,287,143,144
050,17,145,"Illinois","Perry County",1,62,249,128,121
050,17,145,"Illinois","Perry County",1,63,263,139,124
050,17,145,"Illinois","Perry County",1,64,278,140,138
050,17,145,"Illinois","Perry County",1,65,283,142,141
050,17,145,"Illinois","Perry County",1,66,279,134,145
050,17,145,"Illinois","Perry County",1,67,253,125,128
050,17,145,"Illinois","Perry County",1,68,249,122,127
050,17,145,"Illinois","Perry County",1,69,233,114,119
050,17,145,"Illinois","Perry County",1,70,219,113,106
050,17,145,"Illinois","Perry County",1,71,215,101,114
050,17,145,"Illinois","Perry County",1,72,227,96,131
050,17,145,"Illinois","Perry County",1,73,244,106,138
050,17,145,"Illinois","Perry County",1,74,163,71,92
050,17,145,"Illinois","Perry County",1,75,159,68,91
050,17,145,"Illinois","Perry County",1,76,170,80,90
050,17,145,"Illinois","Perry County",1,77,155,79,76
050,17,145,"Illinois","Perry County",1,78,131,57,74
050,17,145,"Illinois","Perry County",1,79,124,52,72
050,17,145,"Illinois","Perry County",1,80,117,53,64
050,17,145,"Illinois","Perry County",1,81,103,52,51
050,17,145,"Illinois","Perry County",1,82,91,50,41
050,17,145,"Illinois","Perry County",1,83,87,41,46
050,17,145,"Illinois","Perry County",1,84,88,34,54
050,17,145,"Illinois","Perry County",1,85,518,163,355
050,17,145,"Illinois","Perry County",2,0,180,95,85
050,17,145,"Illinois","Perry County",2,1,186,96,90
050,17,145,"Illinois","Perry County",2,2,202,97,105
050,17,145,"Illinois","Perry County",2,3,208,100,108
050,17,145,"Illinois","Perry County",2,4,221,105,116
050,17,145,"Illinois","Perry County",2,5,216,107,109
050,17,145,"Illinois","Perry County",2,6,229,115,114
050,17,145,"Illinois","Perry County",2,7,218,116,102
050,17,145,"Illinois","Perry County",2,8,212,113,99
050,17,145,"Illinois","Perry County",2,9,214,105,109
050,17,145,"Illinois","Perry County",2,10,229,112,117
050,17,145,"Illinois","Perry County",2,11,234,116,118
050,17,145,"Illinois","Perry County",2,12,257,138,119
050,17,145,"Illinois","Perry County",2,13,254,130,124
050,17,145,"Illinois","Perry County",2,14,255,132,123
050,17,145,"Illinois","Perry County",2,15,262,138,124
050,17,145,"Illinois","Perry County",2,16,276,151,125
050,17,145,"Illinois","Perry County",2,17,275,148,127
050,17,145,"Illinois","Perry County",2,18,252,160,92
050,17,145,"Illinois","Perry County",2,19,225,153,72
050,17,145,"Illinois","Perry County",2,20,254,183,71
050,17,145,"Illinois","Perry County",2,21,257,183,74
050,17,145,"Illinois","Perry County",2,22,275,197,78
050,17,145,"Illinois","Perry County",2,23,266,187,79
050,17,145,"Illinois","Perry County",2,24,269,176,93
050,17,145,"Illinois","Perry County",2,25,252,158,94
050,17,145,"Illinois","Perry County",2,26,265,167,98
050,17,145,"Illinois","Perry County",2,27,268,166,102
050,17,145,"Illinois","Perry County",2,28,301,188,113
050,17,145,"Illinois","Perry County",2,29,296,185,111
050,17,145,"Illinois","Perry County",2,30,297,193,104
050,17,145,"Illinois","Perry County",2,31,275,181,94
050,17,145,"Illinois","Perry County",2,32,275,182,93
050,17,145,"Illinois","Perry County",2,33,251,156,95
050,17,145,"Illinois","Perry County",2,34,252,148,104
050,17,145,"Illinois","Perry County",2,35,260,154,106
050,17,145,"Illinois","Perry County",2,36,260,155,105
050,17,145,"Illinois","Perry County",2,37,285,168,117
050,17,145,"Illinois","Perry County",2,38,282,170,112
050,17,145,"Illinois","Perry County",2,39,274,163,111
050,17,145,"Illinois","Perry County",2,40,262,149,113
050,17,145,"Illinois","Perry County",2,41,270,161,109
050,17,145,"Illinois","Perry County",2,42,276,164,112
050,17,145,"Illinois","Perry County",2,43,272,161,111
050,17,145,"Illinois","Perry County",2,44,251,140,111
050,17,145,"Illinois","Perry County",2,45,256,141,115
050,17,145,"Illinois","Perry County",2,46,264,145,119
050,17,145,"Illinois","Perry County",2,47,255,141,114
050,17,145,"Illinois","Perry County",2,48,283,158,125
050,17,145,"Illinois","Perry County",2,49,299,168,131
050,17,145,"Illinois","Perry County",2,50,252,144,108
050,17,145,"Illinois","Perry County",2,51,240,142,98
050,17,145,"Illinois","Perry County",2,52,244,133,111
050,17,145,"Illinois","Perry County",2,53,241,126,115
050,17,145,"Illinois","Perry County",2,54,270,144,126
050,17,145,"Illinois","Perry County",2,55,295,154,141
050,17,145,"Illinois","Perry County",2,56,291,156,135
050,17,145,"Illinois","Perry County",2,57,285,156,129
050,17,145,"Illinois","Perry County",2,58,295,154,141
050,17,145,"Illinois","Perry County",2,59,294,152,142
050,17,145,"Illinois","Perry County",2,60,278,140,138
050,17,145,"Illinois","Perry County",2,61,283,142,141
050,17,145,"Illinois","Perry County",2,62,256,130,126
050,17,145,"Illinois","Perry County",2,63,261,136,125
050,17,145,"Illinois","Perry County",2,64,268,136,132
050,17,145,"Illinois","Perry County",2,65,283,143,140
050,17,145,"Illinois","Perry County",2,66,279,135,144
050,17,145,"Illinois","Perry County",2,67,256,125,131
050,17,145,"Illinois","Perry County",2,68,247,121,126
050,17,145,"Illinois","Perry County",2,69,238,117,121
050,17,145,"Illinois","Perry County",2,70,219,110,109
050,17,145,"Illinois","Perry County",2,71,216,104,112
050,17,145,"Illinois","Perry County",2,72,220,96,124
050,17,145,"Illinois","Perry County",2,73,252,110,142
050,17,145,"Illinois","Perry County",2,74,171,74,97
050,17,145,"Illinois","Perry County",2,75,158,68,90
050,17,145,"Illinois","Perry County",2,76,168,77,91
050,17,145,"Illinois","Perry County",2,77,159,79,80
050,17,145,"Illinois","Perry County",2,78,136,62,74
050,17,145,"Illinois","Perry County",2,79,123,51,72
050,17,145,"Illinois","Perry County",2,80,115,50,65
050,17,145,"Illinois","Perry County",2,81,106,53,53
050,17,145,"Illinois","Perry County",2,82,89,48,41
050,17,145,"Illinois","Perry County",2,83,87,43,44
050,17,145,"Illinois","Perry County",2,84,88,35,53
050,17,145,"Illinois","Perry County",2,85,516,160,356
050,17,145,"Illinois","Perry County",3,0,196,103,93
050,17,145,"Illinois","Perry County",3,1,185,103,82
050,17,145,"Illinois","Perry County",3,2,191,94,97
050,17,145,"Illinois","Perry County",3,3,209,94,115
050,17,145,"Illinois","Perry County",3,4,210,104,106
050,17,145,"Illinois","Perry County",3,5,220,105,115
050,17,145,"Illinois","Perry County",3,6,214,98,116
050,17,145,"Illinois","Perry County",3,7,234,122,112
050,17,145,"Illinois","Perry County",3,8,212,112,100
050,17,145,"Illinois","Perry County",3,9,208,110,98
050,17,145,"Illinois","Perry County",3,10,226,109,117
050,17,145,"Illinois","Perry County",3,11,225,111,114
050,17,145,"Illinois","Perry County",3,12,239,125,114
050,17,145,"Illinois","Perry County",3,13,263,147,116
050,17,145,"Illinois","Perry County",3,14,259,132,127
050,17,145,"Illinois","Perry County",3,15,246,125,121
050,17,145,"Illinois","Perry County",3,16,262,134,128
050,17,145,"Illinois","Perry County",3,17,272,156,116
050,17,145,"Illinois","Perry County",3,18,277,169,108
050,17,145,"Illinois","Perry County",3,19,227,156,71
050,17,145,"Illinois","Perry County",3,20,265,186,79
050,17,145,"Illinois","Perry County",3,21,265,193,72
050,17,145,"Illinois","Perry County",3,22,272,197,75
050,17,145,"Illinois","Perry County",3,23,275,195,80
050,17,145,"Illinois","Perry County",3,24,270,190,80
050,17,145,"Illinois","Perry County",3,25,263,173,90
050,17,145,"Illinois","Perry County",3,26,264,170,94
050,17,145,"Illinois","Perry County",3,27,263,168,95
050,17,145,"Illinois","Perry County",3,28,291,188,103
050,17,145,"Illinois","Perry County",3,29,311,201,110
050,17,145,"Illinois","Perry County",3,30,328,208,120
050,17,145,"Illinois","Perry County",3,31,289,190,99
050,17,145,"Illinois","Perry County",3,32,303,202,101
050,17,145,"Illinois","Perry County",3,33,263,171,92
050,17,145,"Illinois","Perry County",3,34,264,163,101
050,17,145,"Illinois","Perry County",3,35,261,155,106
050,17,145,"Illinois","Perry County",3,36,272,163,109
050,17,145,"Illinois","Perry County",3,37,260,157,103
050,17,145,"Illinois","Perry County",3,38,286,167,119
050,17,145,"Illinois","Perry County",3,39,289,176,113
050,17,145,"Illinois","Perry County",3,40,267,156,111
050,17,145,"Illinois","Perry County",3,41,276,167,109
050,17,145,"Illinois","Perry County",3,42,259,149,110
050,17,145,"Illinois","Perry County",3,43,277,165,112
050,17,145,"Illinois","Perry County",3,44,251,139,112
050,17,145,"Illinois","Perry County",3,45,261,150,111
050,17,145,"Illinois","Perry County",3,46,265,151,114
050,17,145,"Illinois","Perry County",3,47,253,135,118
050,17,145,"Illinois","Perry County",3,48,260,146,114
050,17,145,"Illinois","Perry County",3,49,282,154,128
050,17,145,"Illinois","Perry County",3,50,289,159,130
050,17,145,"Illinois","Perry County",3,51,268,160,108
050,17,145,"Illinois","Perry County",3,52,239,139,100
050,17,145,"Illinois","Perry County",3,53,232,123,109
050,17,145,"Illinois","Perry County",3,54,253,138,115
050,17,145,"Illinois","Perry County",3,55,271,146,125
050,17,145,"Illinois","Perry County",3,56,289,150,139
050,17,145,"Illinois","Perry County",3,57,290,153,137
050,17,145,"Illinois","Perry County",3,58,279,149,130
050,17,145,"Illinois","Perry County",3,59,290,153,137
050,17,145,"Illinois","Perry County",3,60,290,154,136
050,17,145,"Illinois","Perry County",3,61,276,137,139
050,17,145,"Illinois","Perry County",3,62,285,145,140
050,17,145,"Illinois","Perry County",3,63,258,129,129
050,17,145,"Illinois","Perry County",3,64,260,134,126
050,17,145,"Illinois","Perry County",3,65,269,139,130
050,17,145,"Illinois","Perry County",3,66,281,141,140
050,17,145,"Illinois","Perry County",3,67,264,124,140
050,17,145,"Illinois","Perry County",3,68,249,124,125
050,17,145,"Illinois","Perry County",3,69,238,117,121
050,17,145,"Illinois","Perry County",3,70,242,116,126
050,17,145,"Illinois","Perry County",3,71,216,107,109
050,17,145,"Illinois","Perry County",3,72,201,98,103
050,17,145,"Illinois","Perry County",3,73,219,97,122
050,17,145,"Illinois","Perry County",3,74,242,104,138
050,17,145,"Illinois","Perry County",3,75,160,71,89
050,17,145,"Illinois","Perry County",3,76,149,59,90
050,17,145,"Illinois","Perry County",3,77,150,70,80
050,17,145,"Illinois","Perry County",3,78,160,80,80
050,17,145,"Illinois","Perry County",3,79,127,56,71
050,17,145,"Illinois","Perry County",3,80,110,45,65
050,17,145,"Illinois","Perry County",3,81,109,47,62
050,17,145,"Illinois","Perry County",3,82,98,49,49
050,17,145,"Illinois","Perry County",3,83,84,38,46
050,17,145,"Illinois","Perry County",3,84,93,42,51
050,17,145,"Illinois","Perry County",3,85,504,162,342
050,17,145,"Illinois","Perry County",4,0,180,92,88
050,17,145,"Illinois","Perry County",4,1,191,100,91
050,17,145,"Illinois","Perry County",4,2,190,104,86
050,17,145,"Illinois","Perry County",4,3,196,101,95
050,17,145,"Illinois","Perry County",4,4,198,90,108
050,17,145,"Illinois","Perry County",4,5,214,101,113
050,17,145,"Illinois","Perry County",4,6,222,102,120
050,17,145,"Illinois","Perry County",4,7,204,100,104
050,17,145,"Illinois","Perry County",4,8,232,122,110
050,17,145,"Illinois","Perry County",4,9,205,110,95
050,17,145,"Illinois","Perry County",4,10,210,110,100
050,17,145,"Illinois","Perry County",4,11,215,108,107
050,17,145,"Illinois","Perry County",4,12,221,111,110
050,17,145,"Illinois","Perry County",4,13,230,118,112
050,17,145,"Illinois","Perry County",4,14,260,142,118
050,17,145,"Illinois","Perry County",4,15,254,127,127
050,17,145,"Illinois","Perry County",4,16,254,125,129
050,17,145,"Illinois","Perry County",4,17,260,139,121
050,17,145,"Illinois","Perry County",4,18,275,175,100
050,17,145,"Illinois","Perry County",4,19,230,154,76
050,17,145,"Illinois","Perry County",4,20,243,173,70
050,17,145,"Illinois","Perry County",4,21,265,182,83
050,17,145,"Illinois","Perry County",4,22,279,204,75
050,17,145,"Illinois","Perry County",4,23,268,190,78
050,17,145,"Illinois","Perry County",4,24,259,181,78
050,17,145,"Illinois","Perry County",4,25,251,175,76
050,17,145,"Illinois","Perry County",4,26,253,161,92
050,17,145,"Illinois","Perry County",4,27,237,145,92
050,17,145,"Illinois","Perry County",4,28,269,173,96
050,17,145,"Illinois","Perry County",4,29,264,161,103
050,17,145,"Illinois","Perry County",4,30,300,188,112
050,17,145,"Illinois","Perry County",4,31,320,204,116
050,17,145,"Illinois","Perry County",4,32,292,191,101
050,17,145,"Illinois","Perry County",4,33,254,167,87
050,17,145,"Illinois","Perry County",4,34,265,172,93
050,17,145,"Illinois","Perry County",4,35,263,163,100
050,17,145,"Illinois","Perry County",4,36,261,153,108
050,17,145,"Illinois","Perry County",4,37,261,153,108
050,17,145,"Illinois","Perry County",4,38,255,149,106
050,17,145,"Illinois","Perry County",4,39,285,169,116
050,17,145,"Illinois","Perry County",4,40,277,166,111
050,17,145,"Illinois","Perry County",4,41,269,158,111
050,17,145,"Illinois","Perry County",4,42,259,150,109
050,17,145,"Illinois","Perry County",4,43,255,145,110
050,17,145,"Illinois","Perry County",4,44,260,146,114
050,17,145,"Illinois","Perry County",4,45,258,149,109
050,17,145,"Illinois","Perry County",4,46,265,149,116
050,17,145,"Illinois","Perry County",4,47,258,142,116
050,17,145,"Illinois","Perry County",4,48,255,141,114
050,17,145,"Illinois","Perry County",4,49,251,146,105
050,17,145,"Illinois","Perry County",4,50,266,140,126
050,17,145,"Illinois","Perry County",4,51,285,162,123
050,17,145,"Illinois","Perry County",4,52,248,153,95
050,17,145,"Illinois","Perry County",4,53,214,116,98
050,17,145,"Illinois","Perry County",4,54,231,123,108
050,17,145,"Illinois","Perry County",4,55,241,133,108
050,17,145,"Illinois","Perry County",4,56,258,135,123
050,17,145,"Illinois","Perry County",4,57,276,141,135
050,17,145,"Illinois","Perry County",4,58,283,144,139
050,17,145,"Illinois","Perry County",4,59,276,144,132
050,17,145,"Illinois","Perry County",4,60,290,154,136
050,17,145,"Illinois","Perry County",4,61,282,149,133
050,17,145,"Illinois","Perry County",4,62,276,140,136
050,17,145,"Illinois","Perry County",4,63,275,138,137
050,17,145,"Illinois","Perry County",4,64,251,127,124
050,17,145,"Illinois","Perry County",4,65,254,134,120
050,17,145,"Illinois","Perry County",4,66,260,132,128
050,17,145,"Illinois","Perry County",4,67,266,131,135
050,17,145,"Illinois","Perry County",4,68,258,121,137
050,17,145,"Illinois","Perry County",4,69,244,120,124
050,17,145,"Illinois","Perry County",4,70,234,114,120
050,17,145,"Illinois","Perry County",4,71,229,109,120
050,17,145,"Illinois","Perry County",4,72,203,102,101
050,17,145,"Illinois","Perry County",4,73,199,95,104
050,17,145,"Illinois","Perry County",4,74,212,93,119
050,17,145,"Illinois","Perry County",4,75,224,94,130
050,17,145,"Illinois","Perry County",4,76,155,66,89
050,17,145,"Illinois","Perry County",4,77,139,56,83
050,17,145,"Illinois","Perry County",4,78,144,67,77
050,17,145,"Illinois","Perry County",4,79,155,78,77
050,17,145,"Illinois","Perry County",4,80,116,54,62
050,17,145,"Illinois","Perry County",4,81,105,45,60
050,17,145,"Illinois","Perry County",4,82,96,42,54
050,17,145,"Illinois","Perry County",4,83,84,37,47
050,17,145,"Illinois","Perry County",4,84,88,38,50
050,17,145,"Illinois","Perry County",4,85,503,172,331
050,17,145,"Illinois","Perry County",5,0,175,89,86
050,17,145,"Illinois","Perry County",5,1,189,97,92
050,17,145,"Illinois","Perry County",5,2,185,96,89
050,17,145,"Illinois","Perry County",5,3,190,101,89
050,17,145,"Illinois","Perry County",5,4,192,103,89
050,17,145,"Illinois","Perry County",5,5,212,93,119
050,17,145,"Illinois","Perry County",5,6,205,103,102
050,17,145,"Illinois","Perry County",5,7,231,109,122
050,17,145,"Illinois","Perry County",5,8,219,103,116
050,17,145,"Illinois","Perry County",5,9,238,120,118
050,17,145,"Illinois","Perry County",5,10,209,107,102
050,17,145,"Illinois","Perry County",5,11,211,112,99
050,17,145,"Illinois","Perry County",5,12,222,112,110
050,17,145,"Illinois","Perry County",5,13,226,112,114
050,17,145,"Illinois","Perry County",5,14,226,115,111
050,17,145,"Illinois","Perry County",5,15,262,145,117
050,17,145,"Illinois","Perry County",5,16,249,129,120
050,17,145,"Illinois","Perry County",5,17,265,137,128
050,17,145,"Illinois","Perry County",5,18,254,160,94
050,17,145,"Illinois","Perry County",5,19,241,162,79
050,17,145,"Illinois","Perry County",5,20,259,174,85
050,17,145,"Illinois","Perry County",5,21,260,180,80
050,17,145,"Illinois","Perry County",5,22,287,204,83
050,17,145,"Illinois","Perry County",5,23,279,203,76
050,17,145,"Illinois","Perry County",5,24,269,185,84
050,17,145,"Illinois","Perry County",5,25,250,167,83
050,17,145,"Illinois","Perry County",5,26,247,173,74
050,17,145,"Illinois","Perry County",5,27,241,157,84
050,17,145,"Illinois","Perry County",5,28,251,157,94
050,17,145,"Illinois","Perry County",5,29,262,162,100
050,17,145,"Illinois","Perry County",5,30,290,181,109
050,17,145,"Illinois","Perry County",5,31,316,193,123
050,17,145,"Illinois","Perry County",5,32,325,209,116
050,17,145,"Illinois","Perry County",5,33,263,166,97
050,17,145,"Illinois","Perry County",5,34,247,155,92
050,17,145,"Illinois","Perry County",5,35,278,182,96
050,17,145,"Illinois","Perry County",5,36,270,167,103
050,17,145,"Illinois","Perry County",5,37,253,146,107
050,17,145,"Illinois","Perry County",5,38,262,153,109
050,17,145,"Illinois","Perry County",5,39,261,153,108
050,17,145,"Illinois","Perry County",5,40,276,156,120
050,17,145,"Illinois","Perry County",5,41,287,177,110
050,17,145,"Illinois","Perry County",5,42,251,148,103
050,17,145,"Illinois","Perry County",5,43,264,153,111
050,17,145,"Illinois","Perry County",5,44,241,132,109
050,17,145,"Illinois","Perry County",5,45,268,156,112
050,17,145,"Illinois","Perry County",5,46,261,152,109
050,17,145,"Illinois","Perry County",5,47,252,138,114
050,17,145,"Illinois","Perry County",5,48,257,141,116
050,17,145,"Illinois","Perry County",5,49,254,140,114
050,17,145,"Illinois","Perry County",5,50,237,132,105
050,17,145,"Illinois","Perry County",5,51,271,145,126
050,17,145,"Illinois","Perry County",5,52,268,149,119
050,17,145,"Illinois","Perry County",5,53,230,137,93
050,17,145,"Illinois","Perry County",5,54,223,123,100
050,17,145,"Illinois","Perry County",5,55,228,122,106
050,17,145,"Illinois","Perry County",5,56,231,122,109
050,17,145,"Illinois","Perry County",5,57,257,132,125
050,17,145,"Illinois","Perry County",5,58,273,132,141
050,17,145,"Illinois","Perry County",5,59,282,140,142
050,17,145,"Illinois","Perry County",5,60,277,146,131
050,17,145,"Illinois","Perry County",5,61,286,152,134
050,17,145,"Illinois","Perry County",5,62,288,154,134
050,17,145,"Illinois","Perry County",5,63,267,135,132
050,17,145,"Illinois","Perry County",5,64,267,138,129
050,17,145,"Illinois","Perry County",5,65,253,127,126
050,17,145,"Illinois","Perry County",5,66,249,130,119
050,17,145,"Illinois","Perry County",5,67,249,127,122
050,17,145,"Illinois","Perry County",5,68,260,126,134
050,17,145,"Illinois","Perry County",5,69,255,118,137
050,17,145,"Illinois","Perry County",5,70,243,118,125
050,17,145,"Illinois","Perry County",5,71,230,113,117
050,17,145,"Illinois","Perry County",5,72,213,103,110
050,17,145,"Illinois","Perry County",5,73,199,100,99
050,17,145,"Illinois","Perry County",5,74,195,93,102
050,17,145,"Illinois","Perry County",5,75,204,89,115
050,17,145,"Illinois","Perry County",5,76,215,84,131
050,17,145,"Illinois","Perry County",5,77,147,66,81
050,17,145,"Illinois","Perry County",5,78,137,55,82
050,17,145,"Illinois","Perry County",5,79,140,64,76
050,17,145,"Illinois","Perry County",5,80,144,73,71
050,17,145,"Illinois","Perry County",5,81,108,52,56
050,17,145,"Illinois","Perry County",5,82,94,40,54
050,17,145,"Illinois","Perry County",5,83,86,32,54
050,17,145,"Illinois","Perry County",5,84,89,37,52
050,17,145,"Illinois","Perry County",5,85,526,189,337
050,17,147,"Illinois","Piatt County",1,0,178,91,87
050,17,147,"Illinois","Piatt County",1,1,192,92,100
050,17,147,"Illinois","Piatt County",1,2,181,97,84
050,17,147,"Illinois","Piatt County",1,3,190,99,91
050,17,147,"Illinois","Piatt County",1,4,189,93,96
050,17,147,"Illinois","Piatt County",1,5,212,108,104
050,17,147,"Illinois","Piatt County",1,6,195,91,104
050,17,147,"Illinois","Piatt County",1,7,213,99,114
050,17,147,"Illinois","Piatt County",1,8,203,106,97
050,17,147,"Illinois","Piatt County",1,9,200,105,95
050,17,147,"Illinois","Piatt County",1,10,210,113,97
050,17,147,"Illinois","Piatt County",1,11,206,102,104
050,17,147,"Illinois","Piatt County",1,12,198,87,111
050,17,147,"Illinois","Piatt County",1,13,208,109,99
050,17,147,"Illinois","Piatt County",1,14,217,123,94
050,17,147,"Illinois","Piatt County",1,15,216,116,100
050,17,147,"Illinois","Piatt County",1,16,245,125,120
050,17,147,"Illinois","Piatt County",1,17,235,123,112
050,17,147,"Illinois","Piatt County",1,18,197,107,90
050,17,147,"Illinois","Piatt County",1,19,159,90,69
050,17,147,"Illinois","Piatt County",1,20,144,79,65
050,17,147,"Illinois","Piatt County",1,21,155,79,76
050,17,147,"Illinois","Piatt County",1,22,172,87,85
050,17,147,"Illinois","Piatt County",1,23,168,84,84
050,17,147,"Illinois","Piatt County",1,24,158,93,65
050,17,147,"Illinois","Piatt County",1,25,174,94,80
050,17,147,"Illinois","Piatt County",1,26,177,92,85
050,17,147,"Illinois","Piatt County",1,27,165,82,83
050,17,147,"Illinois","Piatt County",1,28,153,81,72
050,17,147,"Illinois","Piatt County",1,29,169,74,95
050,17,147,"Illinois","Piatt County",1,30,189,87,102
050,17,147,"Illinois","Piatt County",1,31,195,104,91
050,17,147,"Illinois","Piatt County",1,32,193,98,95
050,17,147,"Illinois","Piatt County",1,33,198,99,99
050,17,147,"Illinois","Piatt County",1,34,214,105,109
050,17,147,"Illinois","Piatt County",1,35,202,93,109
050,17,147,"Illinois","Piatt County",1,36,225,118,107
050,17,147,"Illinois","Piatt County",1,37,206,104,102
050,17,147,"Illinois","Piatt County",1,38,208,111,97
050,17,147,"Illinois","Piatt County",1,39,203,112,91
050,17,147,"Illinois","Piatt County",1,40,227,124,103
050,17,147,"Illinois","Piatt County",1,41,216,103,113
050,17,147,"Illinois","Piatt County",1,42,207,96,111
050,17,147,"Illinois","Piatt County",1,43,200,96,104
050,17,147,"Illinois","Piatt County",1,44,190,99,91
050,17,147,"Illinois","Piatt County",1,45,197,109,88
050,17,147,"Illinois","Piatt County",1,46,199,97,102
050,17,147,"Illinois","Piatt County",1,47,195,93,102
050,17,147,"Illinois","Piatt County",1,48,202,105,97
050,17,147,"Illinois","Piatt County",1,49,227,120,107
050,17,147,"Illinois","Piatt County",1,50,196,102,94
050,17,147,"Illinois","Piatt County",1,51,188,93,95
050,17,147,"Illinois","Piatt County",1,52,184,90,94
050,17,147,"Illinois","Piatt County",1,53,192,99,93
050,17,147,"Illinois","Piatt County",1,54,211,107,104
050,17,147,"Illinois","Piatt County",1,55,234,115,119
050,17,147,"Illinois","Piatt County",1,56,235,120,115
050,17,147,"Illinois","Piatt County",1,57,266,127,139
050,17,147,"Illinois","Piatt County",1,58,277,139,138
050,17,147,"Illinois","Piatt County",1,59,277,143,134
050,17,147,"Illinois","Piatt County",1,60,280,137,143
050,17,147,"Illinois","Piatt County",1,61,270,133,137
050,17,147,"Illinois","Piatt County",1,62,240,126,114
050,17,147,"Illinois","Piatt County",1,63,254,135,119
050,17,147,"Illinois","Piatt County",1,64,248,118,130
050,17,147,"Illinois","Piatt County",1,65,235,110,125
050,17,147,"Illinois","Piatt County",1,66,218,100,118
050,17,147,"Illinois","Piatt County",1,67,206,111,95
050,17,147,"Illinois","Piatt County",1,68,212,107,105
050,17,147,"Illinois","Piatt County",1,69,195,96,99
050,17,147,"Illinois","Piatt County",1,70,189,93,96
050,17,147,"Illinois","Piatt County",1,71,171,81,90
050,17,147,"Illinois","Piatt County",1,72,196,95,101
050,17,147,"Illinois","Piatt County",1,73,196,96,100
050,17,147,"Illinois","Piatt County",1,74,132,61,71
050,17,147,"Illinois","Piatt County",1,75,125,63,62
050,17,147,"Illinois","Piatt County",1,76,121,54,67
050,17,147,"Illinois","Piatt County",1,77,146,66,80
050,17,147,"Illinois","Piatt County",1,78,112,43,69
050,17,147,"Illinois","Piatt County",1,79,97,44,53
050,17,147,"Illinois","Piatt County",1,80,91,43,48
050,17,147,"Illinois","Piatt County",1,81,85,40,45
050,17,147,"Illinois","Piatt County",1,82,87,33,54
050,17,147,"Illinois","Piatt County",1,83,81,27,54
050,17,147,"Illinois","Piatt County",1,84,77,36,41
050,17,147,"Illinois","Piatt County",1,85,380,153,227
050,17,147,"Illinois","Piatt County",2,0,179,88,91
050,17,147,"Illinois","Piatt County",2,1,188,92,96
050,17,147,"Illinois","Piatt County",2,2,184,96,88
050,17,147,"Illinois","Piatt County",2,3,189,98,91
050,17,147,"Illinois","Piatt County",2,4,192,96,96
050,17,147,"Illinois","Piatt County",2,5,206,103,103
050,17,147,"Illinois","Piatt County",2,6,199,96,103
050,17,147,"Illinois","Piatt County",2,7,208,97,111
050,17,147,"Illinois","Piatt County",2,8,204,104,100
050,17,147,"Illinois","Piatt County",2,9,201,106,95
050,17,147,"Illinois","Piatt County",2,10,209,111,98
050,17,147,"Illinois","Piatt County",2,11,207,103,104
050,17,147,"Illinois","Piatt County",2,12,199,91,108
050,17,147,"Illinois","Piatt County",2,13,205,103,102
050,17,147,"Illinois","Piatt County",2,14,215,119,96
050,17,147,"Illinois","Piatt County",2,15,214,116,98
050,17,147,"Illinois","Piatt County",2,16,240,124,116
050,17,147,"Illinois","Piatt County",2,17,238,123,115
050,17,147,"Illinois","Piatt County",2,18,196,107,89
050,17,147,"Illinois","Piatt County",2,19,157,88,69
050,17,147,"Illinois","Piatt County",2,20,150,82,68
050,17,147,"Illinois","Piatt County",2,21,155,80,75
050,17,147,"Illinois","Piatt County",2,22,170,86,84
050,17,147,"Illinois","Piatt County",2,23,170,86,84
050,17,147,"Illinois","Piatt County",2,24,160,90,70
050,17,147,"Illinois","Piatt County",2,25,174,96,78
050,17,147,"Illinois","Piatt County",2,26,178,93,85
050,17,147,"Illinois","Piatt County",2,27,166,84,82
050,17,147,"Illinois","Piatt County",2,28,158,83,75
050,17,147,"Illinois","Piatt County",2,29,170,77,93
050,17,147,"Illinois","Piatt County",2,30,188,85,103
050,17,147,"Illinois","Piatt County",2,31,193,102,91
050,17,147,"Illinois","Piatt County",2,32,195,100,95
050,17,147,"Illinois","Piatt County",2,33,194,98,96
050,17,147,"Illinois","Piatt County",2,34,210,103,107
050,17,147,"Illinois","Piatt County",2,35,207,97,110
050,17,147,"Illinois","Piatt County",2,36,219,111,108
050,17,147,"Illinois","Piatt County",2,37,210,107,103
050,17,147,"Illinois","Piatt County",2,38,209,111,98
050,17,147,"Illinois","Piatt County",2,39,206,113,93
050,17,147,"Illinois","Piatt County",2,40,223,123,100
050,17,147,"Illinois","Piatt County",2,41,221,110,111
050,17,147,"Illinois","Piatt County",2,42,207,98,109
050,17,147,"Illinois","Piatt County",2,43,202,97,105
050,17,147,"Illinois","Piatt County",2,44,190,98,92
050,17,147,"Illinois","Piatt County",2,45,196,106,90
050,17,147,"Illinois","Piatt County",2,46,198,98,100
050,17,147,"Illinois","Piatt County",2,47,196,95,101
050,17,147,"Illinois","Piatt County",2,48,200,102,98
050,17,147,"Illinois","Piatt County",2,49,223,118,105
050,17,147,"Illinois","Piatt County",2,50,201,106,95
050,17,147,"Illinois","Piatt County",2,51,189,95,94
050,17,147,"Illinois","Piatt County",2,52,185,91,94
050,17,147,"Illinois","Piatt County",2,53,192,98,94
050,17,147,"Illinois","Piatt County",2,54,208,106,102
050,17,147,"Illinois","Piatt County",2,55,225,112,113
050,17,147,"Illinois","Piatt County",2,56,236,119,117
050,17,147,"Illinois","Piatt County",2,57,257,125,132
050,17,147,"Illinois","Piatt County",2,58,276,138,138
050,17,147,"Illinois","Piatt County",2,59,274,140,134
050,17,147,"Illinois","Piatt County",2,60,279,139,140
050,17,147,"Illinois","Piatt County",2,61,271,135,136
050,17,147,"Illinois","Piatt County",2,62,242,124,118
050,17,147,"Illinois","Piatt County",2,63,254,134,120
050,17,147,"Illinois","Piatt County",2,64,245,118,127
050,17,147,"Illinois","Piatt County",2,65,238,112,126
050,17,147,"Illinois","Piatt County",2,66,223,103,120
050,17,147,"Illinois","Piatt County",2,67,209,108,101
050,17,147,"Illinois","Piatt County",2,68,207,105,102
050,17,147,"Illinois","Piatt County",2,69,200,98,102
050,17,147,"Illinois","Piatt County",2,70,190,93,97
050,17,147,"Illinois","Piatt County",2,71,176,84,92
050,17,147,"Illinois","Piatt County",2,72,185,88,97
050,17,147,"Illinois","Piatt County",2,73,206,102,104
050,17,147,"Illinois","Piatt County",2,74,137,63,74
050,17,147,"Illinois","Piatt County",2,75,122,61,61
050,17,147,"Illinois","Piatt County",2,76,119,56,63
050,17,147,"Illinois","Piatt County",2,77,147,66,81
050,17,147,"Illinois","Piatt County",2,78,117,47,70
050,17,147,"Illinois","Piatt County",2,79,99,44,55
050,17,147,"Illinois","Piatt County",2,80,90,43,47
050,17,147,"Illinois","Piatt County",2,81,86,40,46
050,17,147,"Illinois","Piatt County",2,82,85,34,51
050,17,147,"Illinois","Piatt County",2,83,81,28,53
050,17,147,"Illinois","Piatt County",2,84,75,33,42
050,17,147,"Illinois","Piatt County",2,85,387,156,231
050,17,147,"Illinois","Piatt County",3,0,155,80,75
050,17,147,"Illinois","Piatt County",3,1,170,83,87
050,17,147,"Illinois","Piatt County",3,2,198,103,95
050,17,147,"Illinois","Piatt County",3,3,195,101,94
050,17,147,"Illinois","Piatt County",3,4,201,98,103
050,17,147,"Illinois","Piatt County",3,5,199,96,103
050,17,147,"Illinois","Piatt County",3,6,222,109,113
050,17,147,"Illinois","Piatt County",3,7,200,99,101
050,17,147,"Illinois","Piatt County",3,8,210,97,113
050,17,147,"Illinois","Piatt County",3,9,212,106,106
050,17,147,"Illinois","Piatt County",3,10,204,112,92
050,17,147,"Illinois","Piatt County",3,11,210,107,103
050,17,147,"Illinois","Piatt County",3,12,218,110,108
050,17,147,"Illinois","Piatt County",3,13,205,97,108
050,17,147,"Illinois","Piatt County",3,14,207,99,108
050,17,147,"Illinois","Piatt County",3,15,214,116,98
050,17,147,"Illinois","Piatt County",3,16,215,116,99
050,17,147,"Illinois","Piatt County",3,17,236,120,116
050,17,147,"Illinois","Piatt County",3,18,193,104,89
050,17,147,"Illinois","Piatt County",3,19,155,85,70
050,17,147,"Illinois","Piatt County",3,20,166,92,74
050,17,147,"Illinois","Piatt County",3,21,150,78,72
050,17,147,"Illinois","Piatt County",3,22,153,78,75
050,17,147,"Illinois","Piatt County",3,23,165,83,82
050,17,147,"Illinois","Piatt County",3,24,165,83,82
050,17,147,"Illinois","Piatt County",3,25,162,95,67
050,17,147,"Illinois","Piatt County",3,26,174,88,86
050,17,147,"Illinois","Piatt County",3,27,181,96,85
050,17,147,"Illinois","Piatt County",3,28,178,90,88
050,17,147,"Illinois","Piatt County",3,29,180,98,82
050,17,147,"Illinois","Piatt County",3,30,187,84,103
050,17,147,"Illinois","Piatt County",3,31,196,88,108
050,17,147,"Illinois","Piatt County",3,32,209,103,106
050,17,147,"Illinois","Piatt County",3,33,187,96,91
050,17,147,"Illinois","Piatt County",3,34,199,97,102
050,17,147,"Illinois","Piatt County",3,35,217,107,110
050,17,147,"Illinois","Piatt County",3,36,220,102,118
050,17,147,"Illinois","Piatt County",3,37,229,115,114
050,17,147,"Illinois","Piatt County",3,38,230,120,110
050,17,147,"Illinois","Piatt County",3,39,212,111,101
050,17,147,"Illinois","Piatt County",3,40,217,121,96
050,17,147,"Illinois","Piatt County",3,41,220,121,99
050,17,147,"Illinois","Piatt County",3,42,213,109,104
050,17,147,"Illinois","Piatt County",3,43,202,94,108
050,17,147,"Illinois","Piatt County",3,44,204,98,106
050,17,147,"Illinois","Piatt County",3,45,186,93,93
050,17,147,"Illinois","Piatt County",3,46,203,105,98
050,17,147,"Illinois","Piatt County",3,47,197,103,94
050,17,147,"Illinois","Piatt County",3,48,202,100,102
050,17,147,"Illinois","Piatt County",3,49,201,98,103
050,17,147,"Illinois","Piatt County",3,50,215,117,98
050,17,147,"Illinois","Piatt County",3,51,204,109,95
050,17,147,"Illinois","Piatt County",3,52,183,90,93
050,17,147,"Illinois","Piatt County",3,53,188,91,97
050,17,147,"Illinois","Piatt County",3,54,198,106,92
050,17,147,"Illinois","Piatt County",3,55,209,104,105
050,17,147,"Illinois","Piatt County",3,56,232,114,118
050,17,147,"Illinois","Piatt County",3,57,233,114,119
050,17,147,"Illinois","Piatt County",3,58,270,133,137
050,17,147,"Illinois","Piatt County",3,59,259,128,131
050,17,147,"Illinois","Piatt County",3,60,268,137,131
050,17,147,"Illinois","Piatt County",3,61,277,141,136
050,17,147,"Illinois","Piatt County",3,62,258,127,131
050,17,147,"Illinois","Piatt County",3,63,238,123,115
050,17,147,"Illinois","Piatt County",3,64,246,127,119
050,17,147,"Illinois","Piatt County",3,65,242,117,125
050,17,147,"Illinois","Piatt County",3,66,237,113,124
050,17,147,"Illinois","Piatt County",3,67,221,100,121
050,17,147,"Illinois","Piatt County",3,68,210,107,103
050,17,147,"Illinois","Piatt County",3,69,199,101,98
050,17,147,"Illinois","Piatt County",3,70,200,97,103
050,17,147,"Illinois","Piatt County",3,71,181,86,95
050,17,147,"Illinois","Piatt County",3,72,172,83,89
050,17,147,"Illinois","Piatt County",3,73,178,86,92
050,17,147,"Illinois","Piatt County",3,74,201,96,105
050,17,147,"Illinois","Piatt County",3,75,131,61,70
050,17,147,"Illinois","Piatt County",3,76,113,56,57
050,17,147,"Illinois","Piatt County",3,77,123,56,67
050,17,147,"Illinois","Piatt County",3,78,139,62,77
050,17,147,"Illinois","Piatt County",3,79,112,48,64
050,17,147,"Illinois","Piatt County",3,80,93,41,52
050,17,147,"Illinois","Piatt County",3,81,85,40,45
050,17,147,"Illinois","Piatt County",3,82,80,35,45
050,17,147,"Illinois","Piatt County",3,83,75,29,46
050,17,147,"Illinois","Piatt County",3,84,73,29,44
050,17,147,"Illinois","Piatt County",3,85,390,162,228
050,17,147,"Illinois","Piatt County",4,0,151,78,73
050,17,147,"Illinois","Piatt County",4,1,151,81,70
050,17,147,"Illinois","Piatt County",4,2,175,86,89
050,17,147,"Illinois","Piatt County",4,3,195,99,96
050,17,147,"Illinois","Piatt County",4,4,196,104,92
050,17,147,"Illinois","Piatt County",4,5,212,111,101
050,17,147,"Illinois","Piatt County",4,6,206,100,106
050,17,147,"Illinois","Piatt County",4,7,233,111,122
050,17,147,"Illinois","Piatt County",4,8,205,99,106
050,17,147,"Illinois","Piatt County",4,9,208,95,113
050,17,147,"Illinois","Piatt County",4,10,218,109,109
050,17,147,"Illinois","Piatt County",4,11,209,114,95
050,17,147,"Illinois","Piatt County",4,12,214,110,104
050,17,147,"Illinois","Piatt County",4,13,215,108,107
050,17,147,"Illinois","Piatt County",4,14,209,96,113
050,17,147,"Illinois","Piatt County",4,15,210,103,107
050,17,147,"Illinois","Piatt County",4,16,209,113,96
050,17,147,"Illinois","Piatt County",4,17,211,116,95
050,17,147,"Illinois","Piatt County",4,18,184,92,92
050,17,147,"Illinois","Piatt County",4,19,133,68,65
050,17,147,"Illinois","Piatt County",4,20,161,89,72
050,17,147,"Illinois","Piatt County",4,21,164,86,78
050,17,147,"Illinois","Piatt County",4,22,163,89,74
050,17,147,"Illinois","Piatt County",4,23,159,80,79
050,17,147,"Illinois","Piatt County",4,24,157,80,77
050,17,147,"Illinois","Piatt County",4,25,175,97,78
050,17,147,"Illinois","Piatt County",4,26,160,92,68
050,17,147,"Illinois","Piatt County",4,27,178,91,87
050,17,147,"Illinois","Piatt County",4,28,165,88,77
050,17,147,"Illinois","Piatt County",4,29,175,80,95
050,17,147,"Illinois","Piatt County",4,30,192,104,88
050,17,147,"Illinois","Piatt County",4,31,194,90,104
050,17,147,"Illinois","Piatt County",4,32,216,93,123
050,17,147,"Illinois","Piatt County",4,33,202,98,104
050,17,147,"Illinois","Piatt County",4,34,184,94,90
050,17,147,"Illinois","Piatt County",4,35,200,100,100
050,17,147,"Illinois","Piatt County",4,36,229,115,114
050,17,147,"Illinois","Piatt County",4,37,214,101,113
050,17,147,"Illinois","Piatt County",4,38,224,112,112
050,17,147,"Illinois","Piatt County",4,39,222,115,107
050,17,147,"Illinois","Piatt County",4,40,217,114,103
050,17,147,"Illinois","Piatt County",4,41,220,118,102
050,17,147,"Illinois","Piatt County",4,42,220,125,95
050,17,147,"Illinois","Piatt County",4,43,208,104,104
050,17,147,"Illinois","Piatt County",4,44,208,103,105
050,17,147,"Illinois","Piatt County",4,45,207,98,109
050,17,147,"Illinois","Piatt County",4,46,185,96,89
050,17,147,"Illinois","Piatt County",4,47,201,108,93
050,17,147,"Illinois","Piatt County",4,48,199,101,98
050,17,147,"Illinois","Piatt County",4,49,206,101,105
050,17,147,"Illinois","Piatt County",4,50,197,98,99
050,17,147,"Illinois","Piatt County",4,51,220,116,104
050,17,147,"Illinois","Piatt County",4,52,204,112,92
050,17,147,"Illinois","Piatt County",4,53,183,81,102
050,17,147,"Illinois","Piatt County",4,54,191,100,91
050,17,147,"Illinois","Piatt County",4,55,194,103,91
050,17,147,"Illinois","Piatt County",4,56,209,108,101
050,17,147,"Illinois","Piatt County",4,57,227,112,115
050,17,147,"Illinois","Piatt County",4,58,237,119,118
050,17,147,"Illinois","Piatt County",4,59,254,124,130
050,17,147,"Illinois","Piatt County",4,60,252,122,130
050,17,147,"Illinois","Piatt County",4,61,270,141,129
050,17,147,"Illinois","Piatt County",4,62,260,130,130
050,17,147,"Illinois","Piatt County",4,63,259,126,133
050,17,147,"Illinois","Piatt County",4,64,231,116,115
050,17,147,"Illinois","Piatt County",4,65,241,123,118
050,17,147,"Illinois","Piatt County",4,66,238,119,119
050,17,147,"Illinois","Piatt County",4,67,240,117,123
050,17,147,"Illinois","Piatt County",4,68,219,97,122
050,17,147,"Illinois","Piatt County",4,69,211,108,103
050,17,147,"Illinois","Piatt County",4,70,198,99,99
050,17,147,"Illinois","Piatt County",4,71,195,91,104
050,17,147,"Illinois","Piatt County",4,72,176,81,95
050,17,147,"Illinois","Piatt County",4,73,175,83,92
050,17,147,"Illinois","Piatt County",4,74,171,78,93
050,17,147,"Illinois","Piatt County",4,75,189,92,97
050,17,147,"Illinois","Piatt County",4,76,127,59,68
050,17,147,"Illinois","Piatt County",4,77,118,58,60
050,17,147,"Illinois","Piatt County",4,78,107,46,61
050,17,147,"Illinois","Piatt County",4,79,135,61,74
050,17,147,"Illinois","Piatt County",4,80,99,44,55
050,17,147,"Illinois","Piatt County",4,81,86,38,48
050,17,147,"Illinois","Piatt County",4,82,80,34,46
050,17,147,"Illinois","Piatt County",4,83,69,26,43
050,17,147,"Illinois","Piatt County",4,84,69,31,38
050,17,147,"Illinois","Piatt County",4,85,395,162,233
050,17,147,"Illinois","Piatt County",5,0,153,79,74
050,17,147,"Illinois","Piatt County",5,1,143,77,66
050,17,147,"Illinois","Piatt County",5,2,161,84,77
050,17,147,"Illinois","Piatt County",5,3,186,95,91
050,17,147,"Illinois","Piatt County",5,4,208,107,101
050,17,147,"Illinois","Piatt County",5,5,196,104,92
050,17,147,"Illinois","Piatt County",5,6,220,114,106
050,17,147,"Illinois","Piatt County",5,7,215,107,108
050,17,147,"Illinois","Piatt County",5,8,235,115,120
050,17,147,"Illinois","Piatt County",5,9,214,106,108
050,17,147,"Illinois","Piatt County",5,10,208,95,113
050,17,147,"Illinois","Piatt County",5,11,222,111,111
050,17,147,"Illinois","Piatt County",5,12,212,117,95
050,17,147,"Illinois","Piatt County",5,13,211,108,103
050,17,147,"Illinois","Piatt County",5,14,217,103,114
050,17,147,"Illinois","Piatt County",5,15,221,106,115
050,17,147,"Illinois","Piatt County",5,16,208,100,108
050,17,147,"Illinois","Piatt County",5,17,202,111,91
050,17,147,"Illinois","Piatt County",5,18,173,101,72
050,17,147,"Illinois","Piatt County",5,19,138,75,63
050,17,147,"Illinois","Piatt County",5,20,141,73,68
050,17,147,"Illinois","Piatt County",5,21,174,91,83
050,17,147,"Illinois","Piatt County",5,22,175,90,85
050,17,147,"Illinois","Piatt County",5,23,154,80,74
050,17,147,"Illinois","Piatt County",5,24,144,78,66
050,17,147,"Illinois","Piatt County",5,25,149,79,70
050,17,147,"Illinois","Piatt County",5,26,176,96,80
050,17,147,"Illinois","Piatt County",5,27,159,87,72
050,17,147,"Illinois","Piatt County",5,28,187,95,92
050,17,147,"Illinois","Piatt County",5,29,178,89,89
050,17,147,"Illinois","Piatt County",5,30,182,87,95
050,17,147,"Illinois","Piatt County",5,31,193,111,82
050,17,147,"Illinois","Piatt County",5,32,206,88,118
050,17,147,"Illinois","Piatt County",5,33,196,86,110
050,17,147,"Illinois","Piatt County",5,34,212,103,109
050,17,147,"Illinois","Piatt County",5,35,180,92,88
050,17,147,"Illinois","Piatt County",5,36,206,105,101
050,17,147,"Illinois","Piatt County",5,37,231,115,116
050,17,147,"Illinois","Piatt County",5,38,230,109,121
050,17,147,"Illinois","Piatt County",5,39,225,109,116
050,17,147,"Illinois","Piatt County",5,40,234,119,115
050,17,147,"Illinois","Piatt County",5,41,227,115,112
050,17,147,"Illinois","Piatt County",5,42,221,126,95
050,17,147,"Illinois","Piatt County",5,43,217,120,97
050,17,147,"Illinois","Piatt County",5,44,206,104,102
050,17,147,"Illinois","Piatt County",5,45,208,102,106
050,17,147,"Illinois","Piatt County",5,46,209,100,109
050,17,147,"Illinois","Piatt County",5,47,187,103,84
050,17,147,"Illinois","Piatt County",5,48,196,109,87
050,17,147,"Illinois","Piatt County",5,49,207,104,103
050,17,147,"Illinois","Piatt County",5,50,200,101,99
050,17,147,"Illinois","Piatt County",5,51,190,95,95
050,17,147,"Illinois","Piatt County",5,52,221,115,106
050,17,147,"Illinois","Piatt County",5,53,203,110,93
050,17,147,"Illinois","Piatt County",5,54,187,87,100
050,17,147,"Illinois","Piatt County",5,55,185,97,88
050,17,147,"Illinois","Piatt County",5,56,197,106,91
050,17,147,"Illinois","Piatt County",5,57,205,105,100
050,17,147,"Illinois","Piatt County",5,58,232,115,117
050,17,147,"Illinois","Piatt County",5,59,222,108,114
050,17,147,"Illinois","Piatt County",5,60,256,127,129
050,17,147,"Illinois","Piatt County",5,61,254,126,128
050,17,147,"Illinois","Piatt County",5,62,256,132,124
050,17,147,"Illinois","Piatt County",5,63,259,129,130
050,17,147,"Illinois","Piatt County",5,64,259,126,133
050,17,147,"Illinois","Piatt County",5,65,230,117,113
050,17,147,"Illinois","Piatt County",5,66,242,126,116
050,17,147,"Illinois","Piatt County",5,67,236,118,118
050,17,147,"Illinois","Piatt County",5,68,241,116,125
050,17,147,"Illinois","Piatt County",5,69,216,96,120
050,17,147,"Illinois","Piatt County",5,70,213,109,104
050,17,147,"Illinois","Piatt County",5,71,193,94,99
050,17,147,"Illinois","Piatt County",5,72,196,91,105
050,17,147,"Illinois","Piatt County",5,73,177,83,94
050,17,147,"Illinois","Piatt County",5,74,167,77,90
050,17,147,"Illinois","Piatt County",5,75,159,77,82
050,17,147,"Illinois","Piatt County",5,76,180,85,95
050,17,147,"Illinois","Piatt County",5,77,135,62,73
050,17,147,"Illinois","Piatt County",5,78,112,55,57
050,17,147,"Illinois","Piatt County",5,79,100,44,56
050,17,147,"Illinois","Piatt County",5,80,119,57,62
050,17,147,"Illinois","Piatt County",5,81,92,41,51
050,17,147,"Illinois","Piatt County",5,82,81,33,48
050,17,147,"Illinois","Piatt County",5,83,74,31,43
050,17,147,"Illinois","Piatt County",5,84,64,28,36
050,17,147,"Illinois","Piatt County",5,85,408,164,244
050,17,149,"Illinois","Pike County",1,0,192,100,92
050,17,149,"Illinois","Pike County",1,1,187,96,91
050,17,149,"Illinois","Pike County",1,2,189,97,92
050,17,149,"Illinois","Pike County",1,3,178,89,89
050,17,149,"Illinois","Pike County",1,4,190,93,97
050,17,149,"Illinois","Pike County",1,5,191,101,90
050,17,149,"Illinois","Pike County",1,6,178,97,81
050,17,149,"Illinois","Pike County",1,7,172,98,74
050,17,149,"Illinois","Pike County",1,8,167,81,86
050,17,149,"Illinois","Pike County",1,9,183,93,90
050,17,149,"Illinois","Pike County",1,10,181,93,88
050,17,149,"Illinois","Pike County",1,11,192,96,96
050,17,149,"Illinois","Pike County",1,12,208,106,102
050,17,149,"Illinois","Pike County",1,13,208,111,97
050,17,149,"Illinois","Pike County",1,14,204,108,96
050,17,149,"Illinois","Pike County",1,15,192,95,97
050,17,149,"Illinois","Pike County",1,16,188,98,90
050,17,149,"Illinois","Pike County",1,17,184,92,92
050,17,149,"Illinois","Pike County",1,18,168,98,70
050,17,149,"Illinois","Pike County",1,19,127,68,59
050,17,149,"Illinois","Pike County",1,20,134,71,63
050,17,149,"Illinois","Pike County",1,21,138,76,62
050,17,149,"Illinois","Pike County",1,22,142,82,60
050,17,149,"Illinois","Pike County",1,23,140,74,66
050,17,149,"Illinois","Pike County",1,24,163,91,72
050,17,149,"Illinois","Pike County",1,25,170,84,86
050,17,149,"Illinois","Pike County",1,26,161,70,91
050,17,149,"Illinois","Pike County",1,27,163,82,81
050,17,149,"Illinois","Pike County",1,28,168,101,67
050,17,149,"Illinois","Pike County",1,29,157,79,78
050,17,149,"Illinois","Pike County",1,30,168,83,85
050,17,149,"Illinois","Pike County",1,31,157,68,89
050,17,149,"Illinois","Pike County",1,32,181,90,91
050,17,149,"Illinois","Pike County",1,33,168,86,82
050,17,149,"Illinois","Pike County",1,34,167,75,92
050,17,149,"Illinois","Pike County",1,35,171,89,82
050,17,149,"Illinois","Pike County",1,36,174,96,78
050,17,149,"Illinois","Pike County",1,37,177,92,85
050,17,149,"Illinois","Pike County",1,38,163,85,78
050,17,149,"Illinois","Pike County",1,39,177,92,85
050,17,149,"Illinois","Pike County",1,40,168,87,81
050,17,149,"Illinois","Pike County",1,41,161,80,81
050,17,149,"Illinois","Pike County",1,42,159,78,81
050,17,149,"Illinois","Pike County",1,43,147,69,78
050,17,149,"Illinois","Pike County",1,44,154,79,75
050,17,149,"Illinois","Pike County",1,45,153,82,71
050,17,149,"Illinois","Pike County",1,46,148,74,74
050,17,149,"Illinois","Pike County",1,47,171,93,78
050,17,149,"Illinois","Pike County",1,48,186,96,90
050,17,149,"Illinois","Pike County",1,49,188,96,92
050,17,149,"Illinois","Pike County",1,50,169,91,78
050,17,149,"Illinois","Pike County",1,51,184,95,89
050,17,149,"Illinois","Pike County",1,52,197,107,90
050,17,149,"Illinois","Pike County",1,53,194,95,99
050,17,149,"Illinois","Pike County",1,54,188,93,95
050,17,149,"Illinois","Pike County",1,55,185,99,86
050,17,149,"Illinois","Pike County",1,56,186,93,93
050,17,149,"Illinois","Pike County",1,57,211,100,111
050,17,149,"Illinois","Pike County",1,58,222,99,123
050,17,149,"Illinois","Pike County",1,59,212,96,116
050,17,149,"Illinois","Pike County",1,60,211,99,112
050,17,149,"Illinois","Pike County",1,61,208,100,108
050,17,149,"Illinois","Pike County",1,62,214,113,101
050,17,149,"Illinois","Pike County",1,63,206,116,90
050,17,149,"Illinois","Pike County",1,64,221,118,103
050,17,149,"Illinois","Pike County",1,65,215,107,108
050,17,149,"Illinois","Pike County",1,66,211,107,104
050,17,149,"Illinois","Pike County",1,67,208,108,100
050,17,149,"Illinois","Pike County",1,68,198,102,96
050,17,149,"Illinois","Pike County",1,69,172,84,88
050,17,149,"Illinois","Pike County",1,70,155,74,81
050,17,149,"Illinois","Pike County",1,71,159,79,80
050,17,149,"Illinois","Pike County",1,72,148,75,73
050,17,149,"Illinois","Pike County",1,73,154,77,77
050,17,149,"Illinois","Pike County",1,74,115,54,61
050,17,149,"Illinois","Pike County",1,75,115,50,65
050,17,149,"Illinois","Pike County",1,76,123,59,64
050,17,149,"Illinois","Pike County",1,77,139,68,71
050,17,149,"Illinois","Pike County",1,78,107,41,66
050,17,149,"Illinois","Pike County",1,79,106,42,64
050,17,149,"Illinois","Pike County",1,80,102,46,56
050,17,149,"Illinois","Pike County",1,81,97,44,53
050,17,149,"Illinois","Pike County",1,82,87,40,47
050,17,149,"Illinois","Pike County",1,83,72,29,43
050,17,149,"Illinois","Pike County",1,84,64,32,32
050,17,149,"Illinois","Pike County",1,85,426,126,300
050,17,149,"Illinois","Pike County",2,0,186,96,90
050,17,149,"Illinois","Pike County",2,1,185,96,89
050,17,149,"Illinois","Pike County",2,2,187,97,90
050,17,149,"Illinois","Pike County",2,3,179,90,89
050,17,149,"Illinois","Pike County",2,4,187,92,95
050,17,149,"Illinois","Pike County",2,5,190,99,91
050,17,149,"Illinois","Pike County",2,6,179,97,82
050,17,149,"Illinois","Pike County",2,7,173,98,75
050,17,149,"Illinois","Pike County",2,8,166,85,81
050,17,149,"Illinois","Pike County",2,9,177,89,88
050,17,149,"Illinois","Pike County",2,10,180,93,87
050,17,149,"Illinois","Pike County",2,11,186,93,93
050,17,149,"Illinois","Pike County",2,12,203,103,100
050,17,149,"Illinois","Pike County",2,13,205,108,97
050,17,149,"Illinois","Pike County",2,14,204,108,96
050,17,149,"Illinois","Pike County",2,15,195,99,96
050,17,149,"Illinois","Pike County",2,16,189,98,91
050,17,149,"Illinois","Pike County",2,17,184,93,91
050,17,149,"Illinois","Pike County",2,18,162,92,70
050,17,149,"Illinois","Pike County",2,19,128,70,58
050,17,149,"Illinois","Pike County",2,20,134,72,62
050,17,149,"Illinois","Pike County",2,21,136,76,60
050,17,149,"Illinois","Pike County",2,22,141,81,60
050,17,149,"Illinois","Pike County",2,23,141,77,64
050,17,149,"Illinois","Pike County",2,24,155,84,71
050,17,149,"Illinois","Pike County",2,25,165,83,82
050,17,149,"Illinois","Pike County",2,26,161,72,89
050,17,149,"Illinois","Pike County",2,27,161,79,82
050,17,149,"Illinois","Pike County",2,28,166,96,70
050,17,149,"Illinois","Pike County",2,29,158,84,74
050,17,149,"Illinois","Pike County",2,30,166,82,84
050,17,149,"Illinois","Pike County",2,31,160,73,87
050,17,149,"Illinois","Pike County",2,32,175,85,90
050,17,149,"Illinois","Pike County",2,33,171,87,84
050,17,149,"Illinois","Pike County",2,34,170,79,91
050,17,149,"Illinois","Pike County",2,35,171,86,85
050,17,149,"Illinois","Pike County",2,36,173,95,78
050,17,149,"Illinois","Pike County",2,37,177,94,83
050,17,149,"Illinois","Pike County",2,38,166,87,79
050,17,149,"Illinois","Pike County",2,39,171,89,82
050,17,149,"Illinois","Pike County",2,40,170,87,83
050,17,149,"Illinois","Pike County",2,41,162,81,81
050,17,149,"Illinois","Pike County",2,42,156,77,79
050,17,149,"Illinois","Pike County",2,43,150,70,80
050,17,149,"Illinois","Pike County",2,44,151,76,75
050,17,149,"Illinois","Pike County",2,45,153,81,72
050,17,149,"Illinois","Pike County",2,46,149,75,74
050,17,149,"Illinois","Pike County",2,47,163,87,76
050,17,149,"Illinois","Pike County",2,48,179,94,85
050,17,149,"Illinois","Pike County",2,49,187,96,91
050,17,149,"Illinois","Pike County",2,50,172,91,81
050,17,149,"Illinois","Pike County",2,51,179,94,85
050,17,149,"Illinois","Pike County",2,52,191,102,89
050,17,149,"Illinois","Pike County",2,53,194,98,96
050,17,149,"Illinois","Pike County",2,54,188,92,96
050,17,149,"Illinois","Pike County",2,55,185,97,88
050,17,149,"Illinois","Pike County",2,56,187,95,92
050,17,149,"Illinois","Pike County",2,57,205,99,106
050,17,149,"Illinois","Pike County",2,58,218,98,120
050,17,149,"Illinois","Pike County",2,59,212,97,115
050,17,149,"Illinois","Pike County",2,60,211,98,113
050,17,149,"Illinois","Pike County",2,61,208,100,108
050,17,149,"Illinois","Pike County",2,62,210,108,102
050,17,149,"Illinois","Pike County",2,63,210,117,93
050,17,149,"Illinois","Pike County",2,64,216,117,99
050,17,149,"Illinois","Pike County",2,65,215,109,106
050,17,149,"Illinois","Pike County",2,66,211,107,104
050,17,149,"Illinois","Pike County",2,67,207,107,100
050,17,149,"Illinois","Pike County",2,68,199,103,96
050,17,149,"Illinois","Pike County",2,69,177,86,91
050,17,149,"Illinois","Pike County",2,70,155,74,81
050,17,149,"Illinois","Pike County",2,71,156,78,78
050,17,149,"Illinois","Pike County",2,72,146,73,73
050,17,149,"Illinois","Pike County",2,73,159,81,78
050,17,149,"Illinois","Pike County",2,74,116,55,61
050,17,149,"Illinois","Pike County",2,75,115,52,63
050,17,149,"Illinois","Pike County",2,76,118,56,62
050,17,149,"Illinois","Pike County",2,77,136,66,70
050,17,149,"Illinois","Pike County",2,78,111,47,64
050,17,149,"Illinois","Pike County",2,79,103,40,63
050,17,149,"Illinois","Pike County",2,80,101,43,58
050,17,149,"Illinois","Pike County",2,81,96,43,53
050,17,149,"Illinois","Pike County",2,82,87,39,48
050,17,149,"Illinois","Pike County",2,83,70,31,39
050,17,149,"Illinois","Pike County",2,84,64,31,33
050,17,149,"Illinois","Pike County",2,85,429,130,299
050,17,149,"Illinois","Pike County",3,0,177,89,88
050,17,149,"Illinois","Pike County",3,1,191,99,92
050,17,149,"Illinois","Pike County",3,2,184,92,92
050,17,149,"Illinois","Pike County",3,3,188,97,91
050,17,149,"Illinois","Pike County",3,4,177,92,85
050,17,149,"Illinois","Pike County",3,5,187,93,94
050,17,149,"Illinois","Pike County",3,6,187,95,92
050,17,149,"Illinois","Pike County",3,7,177,96,81
050,17,149,"Illinois","Pike County",3,8,179,98,81
050,17,149,"Illinois","Pike County",3,9,171,85,86
050,17,149,"Illinois","Pike County",3,10,180,92,88
050,17,149,"Illinois","Pike County",3,11,195,101,94
050,17,149,"Illinois","Pike County",3,12,193,100,93
050,17,149,"Illinois","Pike County",3,13,204,101,103
050,17,149,"Illinois","Pike County",3,14,211,110,101
050,17,149,"Illinois","Pike County",3,15,201,109,92
050,17,149,"Illinois","Pike County",3,16,193,99,94
050,17,149,"Illinois","Pike County",3,17,192,100,92
050,17,149,"Illinois","Pike County",3,18,160,85,75
050,17,149,"Illinois","Pike County",3,19,124,69,55
050,17,149,"Illinois","Pike County",3,20,145,78,67
050,17,149,"Illinois","Pike County",3,21,140,73,67
050,17,149,"Illinois","Pike County",3,22,144,77,67
050,17,149,"Illinois","Pike County",3,23,145,79,66
050,17,149,"Illinois","Pike County",3,24,147,77,70
050,17,149,"Illinois","Pike County",3,25,155,86,69
050,17,149,"Illinois","Pike County",3,26,171,85,86
050,17,149,"Illinois","Pike County",3,27,169,81,88
050,17,149,"Illinois","Pike County",3,28,164,81,83
050,17,149,"Illinois","Pike County",3,29,170,98,72
050,17,149,"Illinois","Pike County",3,30,160,83,77
050,17,149,"Illinois","Pike County",3,31,162,81,81
050,17,149,"Illinois","Pike County",3,32,158,75,83
050,17,149,"Illinois","Pike County",3,33,180,85,95
050,17,149,"Illinois","Pike County",3,34,169,84,85
050,17,149,"Illinois","Pike County",3,35,170,81,89
050,17,149,"Illinois","Pike County",3,36,169,84,85
050,17,149,"Illinois","Pike County",3,37,185,98,87
050,17,149,"Illinois","Pike County",3,38,183,99,84
050,17,149,"Illinois","Pike County",3,39,182,97,85
050,17,149,"Illinois","Pike County",3,40,161,85,76
050,17,149,"Illinois","Pike County",3,41,168,84,84
050,17,149,"Illinois","Pike County",3,42,160,83,77
050,17,149,"Illinois","Pike County",3,43,156,75,81
050,17,149,"Illinois","Pike County",3,44,151,71,80
050,17,149,"Illinois","Pike County",3,45,146,75,71
050,17,149,"Illinois","Pike County",3,46,156,83,73
050,17,149,"Illinois","Pike County",3,47,150,75,75
050,17,149,"Illinois","Pike County",3,48,165,87,78
050,17,149,"Illinois","Pike County",3,49,175,91,84
050,17,149,"Illinois","Pike County",3,50,187,95,92
050,17,149,"Illinois","Pike County",3,51,169,88,81
050,17,149,"Illinois","Pike County",3,52,181,91,90
050,17,149,"Illinois","Pike County",3,53,194,105,89
050,17,149,"Illinois","Pike County",3,54,193,94,99
050,17,149,"Illinois","Pike County",3,55,178,87,91
050,17,149,"Illinois","Pike County",3,56,186,100,86
050,17,149,"Illinois","Pike County",3,57,186,94,92
050,17,149,"Illinois","Pike County",3,58,206,102,104
050,17,149,"Illinois","Pike County",3,59,213,94,119
050,17,149,"Illinois","Pike County",3,60,209,94,115
050,17,149,"Illinois","Pike County",3,61,202,95,107
050,17,149,"Illinois","Pike County",3,62,207,96,111
050,17,149,"Illinois","Pike County",3,63,207,102,105
050,17,149,"Illinois","Pike County",3,64,206,112,94
050,17,149,"Illinois","Pike County",3,65,211,113,98
050,17,149,"Illinois","Pike County",3,66,208,103,105
050,17,149,"Illinois","Pike County",3,67,206,104,102
050,17,149,"Illinois","Pike County",3,68,205,104,101
050,17,149,"Illinois","Pike County",3,69,194,99,95
050,17,149,"Illinois","Pike County",3,70,169,80,89
050,17,149,"Illinois","Pike County",3,71,150,73,77
050,17,149,"Illinois","Pike County",3,72,150,73,77
050,17,149,"Illinois","Pike County",3,73,149,75,74
050,17,149,"Illinois","Pike County",3,74,151,74,77
050,17,149,"Illinois","Pike County",3,75,107,51,56
050,17,149,"Illinois","Pike County",3,76,109,49,60
050,17,149,"Illinois","Pike County",3,77,115,52,63
050,17,149,"Illinois","Pike County",3,78,127,64,63
050,17,149,"Illinois","Pike County",3,79,98,40,58
050,17,149,"Illinois","Pike County",3,80,92,32,60
050,17,149,"Illinois","Pike County",3,81,87,34,53
050,17,149,"Illinois","Pike County",3,82,84,33,51
050,17,149,"Illinois","Pike County",3,83,79,36,43
050,17,149,"Illinois","Pike County",3,84,59,24,35
050,17,149,"Illinois","Pike County",3,85,420,132,288
050,17,149,"Illinois","Pike County",4,0,164,81,83
050,17,149,"Illinois","Pike County",4,1,171,78,93
050,17,149,"Illinois","Pike County",4,2,198,104,94
050,17,149,"Illinois","Pike County",4,3,191,94,97
050,17,149,"Illinois","Pike County",4,4,190,98,92
050,17,149,"Illinois","Pike County",4,5,173,88,85
050,17,149,"Illinois","Pike County",4,6,191,98,93
050,17,149,"Illinois","Pike County",4,7,184,97,87
050,17,149,"Illinois","Pike County",4,8,185,97,88
050,17,149,"Illinois","Pike County",4,9,170,94,76
050,17,149,"Illinois","Pike County",4,10,177,87,90
050,17,149,"Illinois","Pike County",4,11,179,92,87
050,17,149,"Illinois","Pike County",4,12,201,106,95
050,17,149,"Illinois","Pike County",4,13,189,100,89
050,17,149,"Illinois","Pike County",4,14,208,107,101
050,17,149,"Illinois","Pike County",4,15,204,108,96
050,17,149,"Illinois","Pike County",4,16,191,100,91
050,17,149,"Illinois","Pike County",4,17,191,96,95
050,17,149,"Illinois","Pike County",4,18,153,86,67
050,17,149,"Illinois","Pike County",4,19,123,68,55
050,17,149,"Illinois","Pike County",4,20,134,77,57
050,17,149,"Illinois","Pike County",4,21,144,76,68
050,17,149,"Illinois","Pike County",4,22,149,75,74
050,17,149,"Illinois","Pike County",4,23,142,74,68
050,17,149,"Illinois","Pike County",4,24,142,77,65
050,17,149,"Illinois","Pike County",4,25,151,84,67
050,17,149,"Illinois","Pike County",4,26,162,89,73
050,17,149,"Illinois","Pike County",4,27,179,92,87
050,17,149,"Illinois","Pike County",4,28,160,78,82
050,17,149,"Illinois","Pike County",4,29,162,84,78
050,17,149,"Illinois","Pike County",4,30,168,95,73
050,17,149,"Illinois","Pike County",4,31,166,84,82
050,17,149,"Illinois","Pike County",4,32,162,82,80
050,17,149,"Illinois","Pike County",4,33,165,81,84
050,17,149,"Illinois","Pike County",4,34,184,86,98
050,17,149,"Illinois","Pike County",4,35,172,87,85
050,17,149,"Illinois","Pike County",4,36,172,82,90
050,17,149,"Illinois","Pike County",4,37,163,85,78
050,17,149,"Illinois","Pike County",4,38,183,98,85
050,17,149,"Illinois","Pike County",4,39,188,103,85
050,17,149,"Illinois","Pike County",4,40,172,92,80
050,17,149,"Illinois","Pike County",4,41,169,88,81
050,17,149,"Illinois","Pike County",4,42,162,83,79
050,17,149,"Illinois","Pike County",4,43,164,87,77
050,17,149,"Illinois","Pike County",4,44,159,75,84
050,17,149,"Illinois","Pike County",4,45,158,74,84
050,17,149,"Illinois","Pike County",4,46,143,71,72
050,17,149,"Illinois","Pike County",4,47,151,81,70
050,17,149,"Illinois","Pike County",4,48,148,75,73
050,17,149,"Illinois","Pike County",4,49,160,86,74
050,17,149,"Illinois","Pike County",4,50,167,87,80
050,17,149,"Illinois","Pike County",4,51,192,97,95
050,17,149,"Illinois","Pike County",4,52,166,86,80
050,17,149,"Illinois","Pike County",4,53,182,92,90
050,17,149,"Illinois","Pike County",4,54,192,101,91
050,17,149,"Illinois","Pike County",4,55,184,91,93
050,17,149,"Illinois","Pike County",4,56,179,87,92
050,17,149,"Illinois","Pike County",4,57,180,95,85
050,17,149,"Illinois","Pike County",4,58,185,96,89
050,17,149,"Illinois","Pike County",4,59,201,98,103
050,17,149,"Illinois","Pike County",4,60,214,96,118
050,17,149,"Illinois","Pike County",4,61,205,99,106
050,17,149,"Illinois","Pike County",4,62,201,92,109
050,17,149,"Illinois","Pike County",4,63,205,95,110
050,17,149,"Illinois","Pike County",4,64,204,102,102
050,17,149,"Illinois","Pike County",4,65,201,112,89
050,17,149,"Illinois","Pike County",4,66,202,108,94
050,17,149,"Illinois","Pike County",4,67,202,98,104
050,17,149,"Illinois","Pike County",4,68,196,95,101
050,17,149,"Illinois","Pike County",4,69,198,99,99
050,17,149,"Illinois","Pike County",4,70,191,95,96
050,17,149,"Illinois","Pike County",4,71,168,83,85
050,17,149,"Illinois","Pike County",4,72,145,73,72
050,17,149,"Illinois","Pike County",4,73,150,71,79
050,17,149,"Illinois","Pike County",4,74,135,66,69
050,17,149,"Illinois","Pike County",4,75,138,67,71
050,17,149,"Illinois","Pike County",4,76,104,47,57
050,17,149,"Illinois","Pike County",4,77,105,45,60
050,17,149,"Illinois","Pike County",4,78,108,49,59
050,17,149,"Illinois","Pike County",4,79,120,58,62
050,17,149,"Illinois","Pike County",4,80,93,37,56
050,17,149,"Illinois","Pike County",4,81,80,27,53
050,17,149,"Illinois","Pike County",4,82,79,26,53
050,17,149,"Illinois","Pike County",4,83,77,29,48
050,17,149,"Illinois","Pike County",4,84,70,32,38
050,17,149,"Illinois","Pike County",4,85,413,130,283
050,17,149,"Illinois","Pike County",5,0,156,77,79
050,17,149,"Illinois","Pike County",5,1,166,81,85
050,17,149,"Illinois","Pike County",5,2,176,84,92
050,17,149,"Illinois","Pike County",5,3,182,94,88
050,17,149,"Illinois","Pike County",5,4,184,92,92
050,17,149,"Illinois","Pike County",5,5,184,93,91
050,17,149,"Illinois","Pike County",5,6,175,91,84
050,17,149,"Illinois","Pike County",5,7,193,95,98
050,17,149,"Illinois","Pike County",5,8,182,99,83
050,17,149,"Illinois","Pike County",5,9,182,93,89
050,17,149,"Illinois","Pike County",5,10,169,93,76
050,17,149,"Illinois","Pike County",5,11,182,91,91
050,17,149,"Illinois","Pike County",5,12,181,97,84
050,17,149,"Illinois","Pike County",5,13,202,107,95
050,17,149,"Illinois","Pike County",5,14,190,98,92
050,17,149,"Illinois","Pike County",5,15,218,108,110
050,17,149,"Illinois","Pike County",5,16,205,109,96
050,17,149,"Illinois","Pike County",5,17,200,105,95
050,17,149,"Illinois","Pike County",5,18,163,87,76
050,17,149,"Illinois","Pike County",5,19,118,63,55
050,17,149,"Illinois","Pike County",5,20,142,74,68
050,17,149,"Illinois","Pike County",5,21,133,76,57
050,17,149,"Illinois","Pike County",5,22,153,81,72
050,17,149,"Illinois","Pike County",5,23,151,75,76
050,17,149,"Illinois","Pike County",5,24,144,76,68
050,17,149,"Illinois","Pike County",5,25,144,82,62
050,17,149,"Illinois","Pike County",5,26,145,82,63
050,17,149,"Illinois","Pike County",5,27,158,87,71
050,17,149,"Illinois","Pike County",5,28,168,88,80
050,17,149,"Illinois","Pike County",5,29,159,78,81
050,17,149,"Illinois","Pike County",5,30,160,78,82
050,17,149,"Illinois","Pike County",5,31,162,92,70
050,17,149,"Illinois","Pike County",5,32,166,83,83
050,17,149,"Illinois","Pike County",5,33,169,84,85
050,17,149,"Illinois","Pike County",5,34,170,86,84
050,17,149,"Illinois","Pike County",5,35,184,85,99
050,17,149,"Illinois","Pike County",5,36,182,96,86
050,17,149,"Illinois","Pike County",5,37,174,86,88
050,17,149,"Illinois","Pike County",5,38,166,86,80
050,17,149,"Illinois","Pike County",5,39,177,97,80
050,17,149,"Illinois","Pike County",5,40,188,101,87
050,17,149,"Illinois","Pike County",5,41,176,95,81
050,17,149,"Illinois","Pike County",5,42,171,91,80
050,17,149,"Illinois","Pike County",5,43,158,80,78
050,17,149,"Illinois","Pike County",5,44,159,82,77
050,17,149,"Illinois","Pike County",5,45,152,68,84
050,17,149,"Illinois","Pike County",5,46,155,70,85
050,17,149,"Illinois","Pike County",5,47,141,71,70
050,17,149,"Illinois","Pike County",5,48,152,80,72
050,17,149,"Illinois","Pike County",5,49,147,74,73
050,17,149,"Illinois","Pike County",5,50,153,83,70
050,17,149,"Illinois","Pike County",5,51,165,84,81
050,17,149,"Illinois","Pike County",5,52,187,96,91
050,17,149,"Illinois","Pike County",5,53,166,84,82
050,17,149,"Illinois","Pike County",5,54,179,92,87
050,17,149,"Illinois","Pike County",5,55,186,97,89
050,17,149,"Illinois","Pike County",5,56,178,90,88
050,17,149,"Illinois","Pike County",5,57,174,83,91
050,17,149,"Illinois","Pike County",5,58,174,92,82
050,17,149,"Illinois","Pike County",5,59,179,92,87
050,17,149,"Illinois","Pike County",5,60,202,97,105
050,17,149,"Illinois","Pike County",5,61,209,98,111
050,17,149,"Illinois","Pike County",5,62,200,94,106
050,17,149,"Illinois","Pike County",5,63,195,89,106
050,17,149,"Illinois","Pike County",5,64,195,89,106
050,17,149,"Illinois","Pike County",5,65,200,100,100
050,17,149,"Illinois","Pike County",5,66,196,108,88
050,17,149,"Illinois","Pike County",5,67,199,103,96
050,17,149,"Illinois","Pike County",5,68,195,93,102
050,17,149,"Illinois","Pike County",5,69,192,90,102
050,17,149,"Illinois","Pike County",5,70,196,96,100
050,17,149,"Illinois","Pike County",5,71,186,94,92
050,17,149,"Illinois","Pike County",5,72,165,83,82
050,17,149,"Illinois","Pike County",5,73,144,73,71
050,17,149,"Illinois","Pike County",5,74,141,64,77
050,17,149,"Illinois","Pike County",5,75,123,59,64
050,17,149,"Illinois","Pike County",5,76,132,62,70
050,17,149,"Illinois","Pike County",5,77,103,45,58
050,17,149,"Illinois","Pike County",5,78,100,44,56
050,17,149,"Illinois","Pike County",5,79,101,44,57
050,17,149,"Illinois","Pike County",5,80,112,51,61
050,17,149,"Illinois","Pike County",5,81,79,31,48
050,17,149,"Illinois","Pike County",5,82,71,19,52
050,17,149,"Illinois","Pike County",5,83,72,22,50
050,17,149,"Illinois","Pike County",5,84,66,24,42
050,17,149,"Illinois","Pike County",5,85,413,135,278
050,17,151,"Illinois","Pope County",1,0,24,12,12
050,17,151,"Illinois","Pope County",1,1,21,9,12
050,17,151,"Illinois","Pope County",1,2,20,9,11
050,17,151,"Illinois","Pope County",1,3,20,10,10
050,17,151,"Illinois","Pope County",1,4,17,10,7
050,17,151,"Illinois","Pope County",1,5,20,10,10
050,17,151,"Illinois","Pope County",1,6,21,11,10
050,17,151,"Illinois","Pope County",1,7,22,11,11
050,17,151,"Illinois","Pope County",1,8,25,12,13
050,17,151,"Illinois","Pope County",1,9,20,10,10
050,17,151,"Illinois","Pope County",1,10,21,12,9
050,17,151,"Illinois","Pope County",1,11,25,14,11
050,17,151,"Illinois","Pope County",1,12,26,16,10
050,17,151,"Illinois","Pope County",1,13,30,14,16
050,17,151,"Illinois","Pope County",1,14,36,17,19
050,17,151,"Illinois","Pope County",1,15,35,19,16
050,17,151,"Illinois","Pope County",1,16,26,14,12
050,17,151,"Illinois","Pope County",1,17,26,14,12
050,17,151,"Illinois","Pope County",1,18,38,25,13
050,17,151,"Illinois","Pope County",1,19,34,24,10
050,17,151,"Illinois","Pope County",1,20,30,20,10
050,17,151,"Illinois","Pope County",1,21,34,21,13
050,17,151,"Illinois","Pope County",1,22,34,18,16
050,17,151,"Illinois","Pope County",1,23,33,19,14
050,17,151,"Illinois","Pope County",1,24,31,21,10
050,17,151,"Illinois","Pope County",1,25,34,20,14
050,17,151,"Illinois","Pope County",1,26,26,13,13
050,17,151,"Illinois","Pope County",1,27,24,11,13
050,17,151,"Illinois","Pope County",1,28,35,18,17
050,17,151,"Illinois","Pope County",1,29,26,13,13
050,17,151,"Illinois","Pope County",1,30,28,12,16
050,17,151,"Illinois","Pope County",1,31,27,12,15
050,17,151,"Illinois","Pope County",1,32,29,16,13
050,17,151,"Illinois","Pope County",1,33,35,19,16
050,17,151,"Illinois","Pope County",1,34,28,11,17
050,17,151,"Illinois","Pope County",1,35,32,14,18
050,17,151,"Illinois","Pope County",1,36,44,21,23
050,17,151,"Illinois","Pope County",1,37,49,26,23
050,17,151,"Illinois","Pope County",1,38,49,32,17
050,17,151,"Illinois","Pope County",1,39,34,18,16
050,17,151,"Illinois","Pope County",1,40,46,24,22
050,17,151,"Illinois","Pope County",1,41,45,22,23
050,17,151,"Illinois","Pope County",1,42,39,21,18
050,17,151,"Illinois","Pope County",1,43,46,22,24
050,17,151,"Illinois","Pope County",1,44,37,20,17
050,17,151,"Illinois","Pope County",1,45,39,21,18
050,17,151,"Illinois","Pope County",1,46,38,19,19
050,17,151,"Illinois","Pope County",1,47,47,19,28
050,17,151,"Illinois","Pope County",1,48,54,27,27
050,17,151,"Illinois","Pope County",1,49,64,29,35
050,17,151,"Illinois","Pope County",1,50,47,23,24
050,17,151,"Illinois","Pope County",1,51,44,22,22
050,17,151,"Illinois","Pope County",1,52,58,31,27
050,17,151,"Illinois","Pope County",1,53,63,40,23
050,17,151,"Illinois","Pope County",1,54,67,39,28
050,17,151,"Illinois","Pope County",1,55,55,28,27
050,17,151,"Illinois","Pope County",1,56,74,34,40
050,17,151,"Illinois","Pope County",1,57,92,47,45
050,17,151,"Illinois","Pope County",1,58,82,43,39
050,17,151,"Illinois","Pope County",1,59,82,45,37
050,17,151,"Illinois","Pope County",1,60,71,29,42
050,17,151,"Illinois","Pope County",1,61,86,42,44
050,17,151,"Illinois","Pope County",1,62,75,36,39
050,17,151,"Illinois","Pope County",1,63,92,45,47
050,17,151,"Illinois","Pope County",1,64,75,36,39
050,17,151,"Illinois","Pope County",1,65,72,33,39
050,17,151,"Illinois","Pope County",1,66,73,39,34
050,17,151,"Illinois","Pope County",1,67,74,39,35
050,17,151,"Illinois","Pope County",1,68,67,34,33
050,17,151,"Illinois","Pope County",1,69,62,35,27
050,17,151,"Illinois","Pope County",1,70,67,33,34
050,17,151,"Illinois","Pope County",1,71,58,30,28
050,17,151,"Illinois","Pope County",1,72,55,30,25
050,17,151,"Illinois","Pope County",1,73,61,31,30
050,17,151,"Illinois","Pope County",1,74,43,21,22
050,17,151,"Illinois","Pope County",1,75,33,16,17
050,17,151,"Illinois","Pope County",1,76,42,24,18
050,17,151,"Illinois","Pope County",1,77,41,22,19
050,17,151,"Illinois","Pope County",1,78,36,19,17
050,17,151,"Illinois","Pope County",1,79,33,18,15
050,17,151,"Illinois","Pope County",1,80,29,10,19
050,17,151,"Illinois","Pope County",1,81,37,17,20
050,17,151,"Illinois","Pope County",1,82,23,14,9
050,17,151,"Illinois","Pope County",1,83,22,14,8
050,17,151,"Illinois","Pope County",1,84,15,7,8
050,17,151,"Illinois","Pope County",1,85,134,63,71
050,17,151,"Illinois","Pope County",2,0,22,11,11
050,17,151,"Illinois","Pope County",2,1,21,9,12
050,17,151,"Illinois","Pope County",2,2,20,9,11
050,17,151,"Illinois","Pope County",2,3,21,10,11
050,17,151,"Illinois","Pope County",2,4,18,10,8
050,17,151,"Illinois","Pope County",2,5,20,10,10
050,17,151,"Illinois","Pope County",2,6,21,11,10
050,17,151,"Illinois","Pope County",2,7,22,11,11
050,17,151,"Illinois","Pope County",2,8,24,11,13
050,17,151,"Illinois","Pope County",2,9,20,10,10
050,17,151,"Illinois","Pope County",2,10,20,10,10
050,17,151,"Illinois","Pope County",2,11,24,14,10
050,17,151,"Illinois","Pope County",2,12,26,15,11
050,17,151,"Illinois","Pope County",2,13,29,14,15
050,17,151,"Illinois","Pope County",2,14,35,16,19
050,17,151,"Illinois","Pope County",2,15,34,18,16
050,17,151,"Illinois","Pope County",2,16,27,14,13
050,17,151,"Illinois","Pope County",2,17,26,14,12
050,17,151,"Illinois","Pope County",2,18,34,23,11
050,17,151,"Illinois","Pope County",2,19,35,24,11
050,17,151,"Illinois","Pope County",2,20,30,20,10
050,17,151,"Illinois","Pope County",2,21,33,21,12
050,17,151,"Illinois","Pope County",2,22,34,19,15
050,17,151,"Illinois","Pope County",2,23,33,18,15
050,17,151,"Illinois","Pope County",2,24,31,20,11
050,17,151,"Illinois","Pope County",2,25,33,20,13
050,17,151,"Illinois","Pope County",2,26,28,14,14
050,17,151,"Illinois","Pope County",2,27,25,12,13
050,17,151,"Illinois","Pope County",2,28,32,16,16
050,17,151,"Illinois","Pope County",2,29,28,14,14
050,17,151,"Illinois","Pope County",2,30,26,11,15
050,17,151,"Illinois","Pope County",2,31,28,13,15
050,17,151,"Illinois","Pope County",2,32,29,15,14
050,17,151,"Illinois","Pope County",2,33,33,18,15
050,17,151,"Illinois","Pope County",2,34,29,13,16
050,17,151,"Illinois","Pope County",2,35,31,14,17
050,17,151,"Illinois","Pope County",2,36,42,20,22
050,17,151,"Illinois","Pope County",2,37,47,24,23
050,17,151,"Illinois","Pope County",2,38,49,31,18
050,17,151,"Illinois","Pope County",2,39,36,21,15
050,17,151,"Illinois","Pope County",2,40,43,22,21
050,17,151,"Illinois","Pope County",2,41,44,22,22
050,17,151,"Illinois","Pope County",2,42,40,21,19
050,17,151,"Illinois","Pope County",2,43,45,22,23
050,17,151,"Illinois","Pope County",2,44,40,21,19
050,17,151,"Illinois","Pope County",2,45,38,21,17
050,17,151,"Illinois","Pope County",2,46,39,20,19
050,17,151,"Illinois","Pope County",2,47,44,19,25
050,17,151,"Illinois","Pope County",2,48,53,25,28
050,17,151,"Illinois","Pope County",2,49,62,29,33
050,17,151,"Illinois","Pope County",2,50,51,24,27
050,17,151,"Illinois","Pope County",2,51,46,23,23
050,17,151,"Illinois","Pope County",2,52,54,29,25
050,17,151,"Illinois","Pope County",2,53,64,39,25
050,17,151,"Illinois","Pope County",2,54,66,39,27
050,17,151,"Illinois","Pope County",2,55,58,31,27
050,17,151,"Illinois","Pope County",2,56,70,33,37
050,17,151,"Illinois","Pope County",2,57,88,44,44
050,17,151,"Illinois","Pope County",2,58,85,44,41
050,17,151,"Illinois","Pope County",2,59,83,45,38
050,17,151,"Illinois","Pope County",2,60,74,33,41
050,17,151,"Illinois","Pope County",2,61,82,38,44
050,17,151,"Illinois","Pope County",2,62,77,37,40
050,17,151,"Illinois","Pope County",2,63,89,44,45
050,17,151,"Illinois","Pope County",2,64,78,37,41
050,17,151,"Illinois","Pope County",2,65,74,34,40
050,17,151,"Illinois","Pope County",2,66,72,38,34
050,17,151,"Illinois","Pope County",2,67,74,39,35
050,17,151,"Illinois","Pope County",2,68,69,36,33
050,17,151,"Illinois","Pope County",2,69,63,35,28
050,17,151,"Illinois","Pope County",2,70,65,33,32
050,17,151,"Illinois","Pope County",2,71,61,32,29
050,17,151,"Illinois","Pope County",2,72,53,29,24
050,17,151,"Illinois","Pope County",2,73,62,32,30
050,17,151,"Illinois","Pope County",2,74,43,21,22
050,17,151,"Illinois","Pope County",2,75,34,16,18
050,17,151,"Illinois","Pope County",2,76,39,22,17
050,17,151,"Illinois","Pope County",2,77,41,22,19
050,17,151,"Illinois","Pope County",2,78,36,20,16
050,17,151,"Illinois","Pope County",2,79,33,17,16
050,17,151,"Illinois","Pope County",2,80,30,12,18
050,17,151,"Illinois","Pope County",2,81,34,16,18
050,17,151,"Illinois","Pope County",2,82,27,15,12
050,17,151,"Illinois","Pope County",2,83,22,14,8
050,17,151,"Illinois","Pope County",2,84,16,8,8
050,17,151,"Illinois","Pope County",2,85,137,64,73
050,17,151,"Illinois","Pope County",3,0,27,14,13
050,17,151,"Illinois","Pope County",3,1,22,11,11
050,17,151,"Illinois","Pope County",3,2,26,10,16
050,17,151,"Illinois","Pope County",3,3,23,10,13
050,17,151,"Illinois","Pope County",3,4,19,8,11
050,17,151,"Illinois","Pope County",3,5,17,11,6
050,17,151,"Illinois","Pope County",3,6,22,12,10
050,17,151,"Illinois","Pope County",3,7,17,10,7
050,17,151,"Illinois","Pope County",3,8,18,10,8
050,17,151,"Illinois","Pope County",3,9,27,12,15
050,17,151,"Illinois","Pope County",3,10,18,9,9
050,17,151,"Illinois","Pope County",3,11,21,11,10
050,17,151,"Illinois","Pope County",3,12,23,14,9
050,17,151,"Illinois","Pope County",3,13,26,15,11
050,17,151,"Illinois","Pope County",3,14,29,16,13
050,17,151,"Illinois","Pope County",3,15,36,16,20
050,17,151,"Illinois","Pope County",3,16,34,17,17
050,17,151,"Illinois","Pope County",3,17,31,19,12
050,17,151,"Illinois","Pope County",3,18,31,19,12
050,17,151,"Illinois","Pope County",3,19,35,23,12
050,17,151,"Illinois","Pope County",3,20,34,21,13
050,17,151,"Illinois","Pope County",3,21,31,19,12
050,17,151,"Illinois","Pope County",3,22,38,24,14
050,17,151,"Illinois","Pope County",3,23,31,17,14
050,17,151,"Illinois","Pope County",3,24,32,18,14
050,17,151,"Illinois","Pope County",3,25,34,18,16
050,17,151,"Illinois","Pope County",3,26,34,19,15
050,17,151,"Illinois","Pope County",3,27,31,16,15
050,17,151,"Illinois","Pope County",3,28,24,11,13
050,17,151,"Illinois","Pope County",3,29,37,21,16
050,17,151,"Illinois","Pope County",3,30,25,11,14
050,17,151,"Illinois","Pope County",3,31,23,10,13
050,17,151,"Illinois","Pope County",3,32,26,12,14
050,17,151,"Illinois","Pope County",3,33,28,13,15
050,17,151,"Illinois","Pope County",3,34,37,18,19
050,17,151,"Illinois","Pope County",3,35,29,13,16
050,17,151,"Illinois","Pope County",3,36,32,14,18
050,17,151,"Illinois","Pope County",3,37,35,14,21
050,17,151,"Illinois","Pope County",3,38,47,24,23
050,17,151,"Illinois","Pope County",3,39,45,27,18
050,17,151,"Illinois","Pope County",3,40,37,22,15
050,17,151,"Illinois","Pope County",3,41,42,22,20
050,17,151,"Illinois","Pope County",3,42,44,22,22
050,17,151,"Illinois","Pope County",3,43,42,22,20
050,17,151,"Illinois","Pope County",3,44,44,21,23
050,17,151,"Illinois","Pope County",3,45,40,22,18
050,17,151,"Illinois","Pope County",3,46,37,21,16
050,17,151,"Illinois","Pope County",3,47,40,23,17
050,17,151,"Illinois","Pope County",3,48,44,19,25
050,17,151,"Illinois","Pope County",3,49,51,23,28
050,17,151,"Illinois","Pope County",3,50,61,27,34
050,17,151,"Illinois","Pope County",3,51,51,23,28
050,17,151,"Illinois","Pope County",3,52,47,25,22
050,17,151,"Illinois","Pope County",3,53,54,26,28
050,17,151,"Illinois","Pope County",3,54,63,41,22
050,17,151,"Illinois","Pope County",3,55,70,39,31
050,17,151,"Illinois","Pope County",3,56,62,34,28
050,17,151,"Illinois","Pope County",3,57,75,37,38
050,17,151,"Illinois","Pope County",3,58,88,43,45
050,17,151,"Illinois","Pope County",3,59,84,44,40
050,17,151,"Illinois","Pope County",3,60,81,43,38
050,17,151,"Illinois","Pope County",3,61,75,32,43
050,17,151,"Illinois","Pope County",3,62,76,38,38
050,17,151,"Illinois","Pope County",3,63,79,39,40
050,17,151,"Illinois","Pope County",3,64,86,42,44
050,17,151,"Illinois","Pope County",3,65,79,38,41
050,17,151,"Illinois","Pope County",3,66,78,35,43
050,17,151,"Illinois","Pope County",3,67,71,38,33
050,17,151,"Illinois","Pope County",3,68,75,40,35
050,17,151,"Illinois","Pope County",3,69,71,39,32
050,17,151,"Illinois","Pope County",3,70,62,34,28
050,17,151,"Illinois","Pope County",3,71,63,31,32
050,17,151,"Illinois","Pope County",3,72,59,29,30
050,17,151,"Illinois","Pope County",3,73,54,30,24
050,17,151,"Illinois","Pope County",3,74,60,30,30
050,17,151,"Illinois","Pope County",3,75,43,21,22
050,17,151,"Illinois","Pope County",3,76,28,13,15
050,17,151,"Illinois","Pope County",3,77,35,19,16
050,17,151,"Illinois","Pope County",3,78,41,22,19
050,17,151,"Illinois","Pope County",3,79,33,18,15
050,17,151,"Illinois","Pope County",3,80,35,20,15
050,17,151,"Illinois","Pope County",3,81,30,13,17
050,17,151,"Illinois","Pope County",3,82,31,13,18
050,17,151,"Illinois","Pope County",3,83,22,12,10
050,17,151,"Illinois","Pope County",3,84,19,12,7
050,17,151,"Illinois","Pope County",3,85,141,65,76
050,17,151,"Illinois","Pope County",4,0,23,13,10
050,17,151,"Illinois","Pope County",4,1,27,15,12
050,17,151,"Illinois","Pope County",4,2,20,10,10
050,17,151,"Illinois","Pope County",4,3,25,11,14
050,17,151,"Illinois","Pope County",4,4,22,12,10
050,17,151,"Illinois","Pope County",4,5,21,9,12
050,17,151,"Illinois","Pope County",4,6,18,12,6
050,17,151,"Illinois","Pope County",4,7,23,13,10
050,17,151,"Illinois","Pope County",4,8,21,12,9
050,17,151,"Illinois","Pope County",4,9,19,10,9
050,17,151,"Illinois","Pope County",4,10,26,11,15
050,17,151,"Illinois","Pope County",4,11,21,9,12
050,17,151,"Illinois","Pope County",4,12,21,12,9
050,17,151,"Illinois","Pope County",4,13,24,14,10
050,17,151,"Illinois","Pope County",4,14,22,11,11
050,17,151,"Illinois","Pope County",4,15,31,16,15
050,17,151,"Illinois","Pope County",4,16,36,18,18
050,17,151,"Illinois","Pope County",4,17,39,21,18
050,17,151,"Illinois","Pope County",4,18,31,21,10
050,17,151,"Illinois","Pope County",4,19,33,21,12
050,17,151,"Illinois","Pope County",4,20,31,19,12
050,17,151,"Illinois","Pope County",4,21,34,20,14
050,17,151,"Illinois","Pope County",4,22,35,19,16
050,17,151,"Illinois","Pope County",4,23,29,19,10
050,17,151,"Illinois","Pope County",4,24,31,18,13
050,17,151,"Illinois","Pope County",4,25,28,14,14
050,17,151,"Illinois","Pope County",4,26,33,18,15
050,17,151,"Illinois","Pope County",4,27,31,14,17
050,17,151,"Illinois","Pope County",4,28,30,17,13
050,17,151,"Illinois","Pope County",4,29,24,14,10
050,17,151,"Illinois","Pope County",4,30,34,19,15
050,17,151,"Illinois","Pope County",4,31,24,9,15
050,17,151,"Illinois","Pope County",4,32,23,9,14
050,17,151,"Illinois","Pope County",4,33,25,12,13
050,17,151,"Illinois","Pope County",4,34,24,8,16
050,17,151,"Illinois","Pope County",4,35,36,19,17
050,17,151,"Illinois","Pope County",4,36,28,14,14
050,17,151,"Illinois","Pope County",4,37,30,13,17
050,17,151,"Illinois","Pope County",4,38,36,15,21
050,17,151,"Illinois","Pope County",4,39,48,23,25
050,17,151,"Illinois","Pope County",4,40,46,28,18
050,17,151,"Illinois","Pope County",4,41,38,24,14
050,17,151,"Illinois","Pope County",4,42,41,21,20
050,17,151,"Illinois","Pope County",4,43,43,21,22
050,17,151,"Illinois","Pope County",4,44,43,22,21
050,17,151,"Illinois","Pope County",4,45,44,21,23
050,17,151,"Illinois","Pope County",4,46,44,25,19
050,17,151,"Illinois","Pope County",4,47,35,19,16
050,17,151,"Illinois","Pope County",4,48,39,24,15
050,17,151,"Illinois","Pope County",4,49,43,18,25
050,17,151,"Illinois","Pope County",4,50,55,24,31
050,17,151,"Illinois","Pope County",4,51,66,31,35
050,17,151,"Illinois","Pope County",4,52,50,22,28
050,17,151,"Illinois","Pope County",4,53,50,27,23
050,17,151,"Illinois","Pope County",4,54,55,26,29
050,17,151,"Illinois","Pope County",4,55,61,39,22
050,17,151,"Illinois","Pope County",4,56,72,39,33
050,17,151,"Illinois","Pope County",4,57,64,35,29
050,17,151,"Illinois","Pope County",4,58,80,42,38
050,17,151,"Illinois","Pope County",4,59,87,43,44
050,17,151,"Illinois","Pope County",4,60,88,47,41
050,17,151,"Illinois","Pope County",4,61,83,43,40
050,17,151,"Illinois","Pope County",4,62,74,33,41
050,17,151,"Illinois","Pope County",4,63,76,37,39
050,17,151,"Illinois","Pope County",4,64,78,38,40
050,17,151,"Illinois","Pope County",4,65,84,39,45
050,17,151,"Illinois","Pope County",4,66,79,38,41
050,17,151,"Illinois","Pope County",4,67,73,32,41
050,17,151,"Illinois","Pope County",4,68,72,40,32
050,17,151,"Illinois","Pope County",4,69,76,39,37
050,17,151,"Illinois","Pope County",4,70,69,37,32
050,17,151,"Illinois","Pope County",4,71,61,32,29
050,17,151,"Illinois","Pope County",4,72,61,29,32
050,17,151,"Illinois","Pope County",4,73,58,29,29
050,17,151,"Illinois","Pope County",4,74,55,29,26
050,17,151,"Illinois","Pope County",4,75,56,29,27
050,17,151,"Illinois","Pope County",4,76,37,17,20
050,17,151,"Illinois","Pope County",4,77,26,12,14
050,17,151,"Illinois","Pope County",4,78,38,19,19
050,17,151,"Illinois","Pope County",4,79,39,18,21
050,17,151,"Illinois","Pope County",4,80,33,18,15
050,17,151,"Illinois","Pope County",4,81,35,20,15
050,17,151,"Illinois","Pope County",4,82,28,11,17
050,17,151,"Illinois","Pope County",4,83,28,12,16
050,17,151,"Illinois","Pope County",4,84,20,10,10
050,17,151,"Illinois","Pope County",4,85,146,70,76
050,17,151,"Illinois","Pope County",5,0,24,14,10
050,17,151,"Illinois","Pope County",5,1,19,10,9
050,17,151,"Illinois","Pope County",5,2,24,13,11
050,17,151,"Illinois","Pope County",5,3,22,11,11
050,17,151,"Illinois","Pope County",5,4,25,12,13
050,17,151,"Illinois","Pope County",5,5,21,11,10
050,17,151,"Illinois","Pope County",5,6,20,8,12
050,17,151,"Illinois","Pope County",5,7,15,8,7
050,17,151,"Illinois","Pope County",5,8,19,10,9
050,17,151,"Illinois","Pope County",5,9,17,9,8
050,17,151,"Illinois","Pope County",5,10,16,8,8
050,17,151,"Illinois","Pope County",5,11,28,14,14
050,17,151,"Illinois","Pope County",5,12,23,10,13
050,17,151,"Illinois","Pope County",5,13,22,13,9
050,17,151,"Illinois","Pope County",5,14,23,13,10
050,17,151,"Illinois","Pope County",5,15,26,13,13
050,17,151,"Illinois","Pope County",5,16,32,16,16
050,17,151,"Illinois","Pope County",5,17,43,21,22
050,17,151,"Illinois","Pope County",5,18,40,25,15
050,17,151,"Illinois","Pope County",5,19,31,20,11
050,17,151,"Illinois","Pope County",5,20,30,17,13
050,17,151,"Illinois","Pope County",5,21,32,20,12
050,17,151,"Illinois","Pope County",5,22,33,21,12
050,17,151,"Illinois","Pope County",5,23,33,18,15
050,17,151,"Illinois","Pope County",5,24,31,23,8
050,17,151,"Illinois","Pope County",5,25,25,14,11
050,17,151,"Illinois","Pope County",5,26,28,14,14
050,17,151,"Illinois","Pope County",5,27,34,19,15
050,17,151,"Illinois","Pope County",5,28,28,14,14
050,17,151,"Illinois","Pope County",5,29,27,15,12
050,17,151,"Illinois","Pope County",5,30,21,13,8
050,17,151,"Illinois","Pope County",5,31,28,15,13
050,17,151,"Illinois","Pope County",5,32,25,6,19
050,17,151,"Illinois","Pope County",5,33,22,9,13
050,17,151,"Illinois","Pope County",5,34,25,11,14
050,17,151,"Illinois","Pope County",5,35,25,8,17
050,17,151,"Illinois","Pope County",5,36,40,21,19
050,17,151,"Illinois","Pope County",5,37,30,14,16
050,17,151,"Illinois","Pope County",5,38,29,13,16
050,17,151,"Illinois","Pope County",5,39,42,17,25
050,17,151,"Illinois","Pope County",5,40,51,26,25
050,17,151,"Illinois","Pope County",5,41,45,27,18
050,17,151,"Illinois","Pope County",5,42,38,24,14
050,17,151,"Illinois","Pope County",5,43,40,20,20
050,17,151,"Illinois","Pope County",5,44,43,21,22
050,17,151,"Illinois","Pope County",5,45,41,22,19
050,17,151,"Illinois","Pope County",5,46,45,19,26
050,17,151,"Illinois","Pope County",5,47,45,26,19
050,17,151,"Illinois","Pope County",5,48,35,19,16
050,17,151,"Illinois","Pope County",5,49,43,24,19
050,17,151,"Illinois","Pope County",5,50,45,19,26
050,17,151,"Illinois","Pope County",5,51,59,25,34
050,17,151,"Illinois","Pope County",5,52,62,29,33
050,17,151,"Illinois","Pope County",5,53,56,22,34
050,17,151,"Illinois","Pope County",5,54,50,27,23
050,17,151,"Illinois","Pope County",5,55,53,27,26
050,17,151,"Illinois","Pope County",5,56,61,39,22
050,17,151,"Illinois","Pope County",5,57,73,39,34
050,17,151,"Illinois","Pope County",5,58,64,35,29
050,17,151,"Illinois","Pope County",5,59,82,42,40
050,17,151,"Illinois","Pope County",5,60,88,43,45
050,17,151,"Illinois","Pope County",5,61,85,47,38
050,17,151,"Illinois","Pope County",5,62,80,42,38
050,17,151,"Illinois","Pope County",5,63,74,32,42
050,17,151,"Illinois","Pope County",5,64,72,36,36
050,17,151,"Illinois","Pope County",5,65,74,36,38
050,17,151,"Illinois","Pope County",5,66,83,37,46
050,17,151,"Illinois","Pope County",5,67,83,40,43
050,17,151,"Illinois","Pope County",5,68,71,32,39
050,17,151,"Illinois","Pope County",5,69,72,39,33
050,17,151,"Illinois","Pope County",5,70,77,42,35
050,17,151,"Illinois","Pope County",5,71,67,35,32
050,17,151,"Illinois","Pope County",5,72,59,31,28
050,17,151,"Illinois","Pope County",5,73,58,28,30
050,17,151,"Illinois","Pope County",5,74,58,28,30
050,17,151,"Illinois","Pope County",5,75,52,29,23
050,17,151,"Illinois","Pope County",5,76,49,24,25
050,17,151,"Illinois","Pope County",5,77,35,17,18
050,17,151,"Illinois","Pope County",5,78,27,13,14
050,17,151,"Illinois","Pope County",5,79,36,17,19
050,17,151,"Illinois","Pope County",5,80,39,19,20
050,17,151,"Illinois","Pope County",5,81,33,18,15
050,17,151,"Illinois","Pope County",5,82,31,17,14
050,17,151,"Illinois","Pope County",5,83,24,9,15
050,17,151,"Illinois","Pope County",5,84,25,9,16
050,17,151,"Illinois","Pope County",5,85,146,68,78
050,17,153,"Illinois","Pulaski County",1,0,41,20,21
050,17,153,"Illinois","Pulaski County",1,1,48,25,23
050,17,153,"Illinois","Pulaski County",1,2,56,27,29
050,17,153,"Illinois","Pulaski County",1,3,69,24,45
050,17,153,"Illinois","Pulaski County",1,4,52,25,27
050,17,153,"Illinois","Pulaski County",1,5,71,38,33
050,17,153,"Illinois","Pulaski County",1,6,57,26,31
050,17,153,"Illinois","Pulaski County",1,7,53,25,28
050,17,153,"Illinois","Pulaski County",1,8,53,23,30
050,17,153,"Illinois","Pulaski County",1,9,50,26,24
050,17,153,"Illinois","Pulaski County",1,10,51,28,23
050,17,153,"Illinois","Pulaski County",1,11,61,38,23
050,17,153,"Illinois","Pulaski County",1,12,61,30,31
050,17,153,"Illinois","Pulaski County",1,13,71,30,41
050,17,153,"Illinois","Pulaski County",1,14,75,36,39
050,17,153,"Illinois","Pulaski County",1,15,82,44,38
050,17,153,"Illinois","Pulaski County",1,16,74,41,33
050,17,153,"Illinois","Pulaski County",1,17,70,37,33
050,17,153,"Illinois","Pulaski County",1,18,55,29,26
050,17,153,"Illinois","Pulaski County",1,19,54,28,26
050,17,153,"Illinois","Pulaski County",1,20,54,30,24
050,17,153,"Illinois","Pulaski County",1,21,44,26,18
050,17,153,"Illinois","Pulaski County",1,22,52,30,22
050,17,153,"Illinois","Pulaski County",1,23,55,30,25
050,17,153,"Illinois","Pulaski County",1,24,54,33,21
050,17,153,"Illinois","Pulaski County",1,25,55,31,24
050,17,153,"Illinois","Pulaski County",1,26,43,24,19
050,17,153,"Illinois","Pulaski County",1,27,58,28,30
050,17,153,"Illinois","Pulaski County",1,28,65,37,28
050,17,153,"Illinois","Pulaski County",1,29,63,39,24
050,17,153,"Illinois","Pulaski County",1,30,62,31,31
050,17,153,"Illinois","Pulaski County",1,31,56,30,26
050,17,153,"Illinois","Pulaski County",1,32,60,31,29
050,17,153,"Illinois","Pulaski County",1,33,65,38,27
050,17,153,"Illinois","Pulaski County",1,34,62,33,29
050,17,153,"Illinois","Pulaski County",1,35,51,21,30
050,17,153,"Illinois","Pulaski County",1,36,64,31,33
050,17,153,"Illinois","Pulaski County",1,37,53,28,25
050,17,153,"Illinois","Pulaski County",1,38,54,27,27
050,17,153,"Illinois","Pulaski County",1,39,58,32,26
050,17,153,"Illinois","Pulaski County",1,40,61,35,26
050,17,153,"Illinois","Pulaski County",1,41,47,26,21
050,17,153,"Illinois","Pulaski County",1,42,67,42,25
050,17,153,"Illinois","Pulaski County",1,43,67,38,29
050,17,153,"Illinois","Pulaski County",1,44,70,33,37
050,17,153,"Illinois","Pulaski County",1,45,55,25,30
050,17,153,"Illinois","Pulaski County",1,46,60,25,35
050,17,153,"Illinois","Pulaski County",1,47,69,36,33
050,17,153,"Illinois","Pulaski County",1,48,61,27,34
050,17,153,"Illinois","Pulaski County",1,49,54,26,28
050,17,153,"Illinois","Pulaski County",1,50,57,32,25
050,17,153,"Illinois","Pulaski County",1,51,56,36,20
050,17,153,"Illinois","Pulaski County",1,52,58,33,25
050,17,153,"Illinois","Pulaski County",1,53,54,27,27
050,17,153,"Illinois","Pulaski County",1,54,65,31,34
050,17,153,"Illinois","Pulaski County",1,55,71,37,34
050,17,153,"Illinois","Pulaski County",1,56,77,43,34
050,17,153,"Illinois","Pulaski County",1,57,73,44,29
050,17,153,"Illinois","Pulaski County",1,58,69,34,35
050,17,153,"Illinois","Pulaski County",1,59,89,40,49
050,17,153,"Illinois","Pulaski County",1,60,87,42,45
050,17,153,"Illinois","Pulaski County",1,61,75,36,39
050,17,153,"Illinois","Pulaski County",1,62,83,38,45
050,17,153,"Illinois","Pulaski County",1,63,92,41,51
050,17,153,"Illinois","Pulaski County",1,64,92,49,43
050,17,153,"Illinois","Pulaski County",1,65,79,40,39
050,17,153,"Illinois","Pulaski County",1,66,81,37,44
050,17,153,"Illinois","Pulaski County",1,67,80,41,39
050,17,153,"Illinois","Pulaski County",1,68,79,40,39
050,17,153,"Illinois","Pulaski County",1,69,71,27,44
050,17,153,"Illinois","Pulaski County",1,70,74,32,42
050,17,153,"Illinois","Pulaski County",1,71,61,32,29
050,17,153,"Illinois","Pulaski County",1,72,69,37,32
050,17,153,"Illinois","Pulaski County",1,73,60,30,30
050,17,153,"Illinois","Pulaski County",1,74,41,17,24
050,17,153,"Illinois","Pulaski County",1,75,39,16,23
050,17,153,"Illinois","Pulaski County",1,76,40,18,22
050,17,153,"Illinois","Pulaski County",1,77,35,15,20
050,17,153,"Illinois","Pulaski County",1,78,35,19,16
050,17,153,"Illinois","Pulaski County",1,79,34,12,22
050,17,153,"Illinois","Pulaski County",1,80,31,13,18
050,17,153,"Illinois","Pulaski County",1,81,32,15,17
050,17,153,"Illinois","Pulaski County",1,82,33,18,15
050,17,153,"Illinois","Pulaski County",1,83,24,13,11
050,17,153,"Illinois","Pulaski County",1,84,29,12,17
050,17,153,"Illinois","Pulaski County",1,85,122,62,60
050,17,153,"Illinois","Pulaski County",2,0,46,22,24
050,17,153,"Illinois","Pulaski County",2,1,46,24,22
050,17,153,"Illinois","Pulaski County",2,2,56,27,29
050,17,153,"Illinois","Pulaski County",2,3,63,25,38
050,17,153,"Illinois","Pulaski County",2,4,55,25,30
050,17,153,"Illinois","Pulaski County",2,5,65,34,31
050,17,153,"Illinois","Pulaski County",2,6,60,29,31
050,17,153,"Illinois","Pulaski County",2,7,53,25,28
050,17,153,"Illinois","Pulaski County",2,8,54,24,30
050,17,153,"Illinois","Pulaski County",2,9,50,26,24
050,17,153,"Illinois","Pulaski County",2,10,53,29,24
050,17,153,"Illinois","Pulaski County",2,11,57,34,23
050,17,153,"Illinois","Pulaski County",2,12,62,32,30
050,17,153,"Illinois","Pulaski County",2,13,69,31,38
050,17,153,"Illinois","Pulaski County",2,14,75,34,41
050,17,153,"Illinois","Pulaski County",2,15,80,43,37
050,17,153,"Illinois","Pulaski County",2,16,76,42,34
050,17,153,"Illinois","Pulaski County",2,17,68,37,31
050,17,153,"Illinois","Pulaski County",2,18,56,30,26
050,17,153,"Illinois","Pulaski County",2,19,52,27,25
050,17,153,"Illinois","Pulaski County",2,20,56,31,25
050,17,153,"Illinois","Pulaski County",2,21,47,27,20
050,17,153,"Illinois","Pulaski County",2,22,52,29,23
050,17,153,"Illinois","Pulaski County",2,23,55,30,25
050,17,153,"Illinois","Pulaski County",2,24,53,32,21
050,17,153,"Illinois","Pulaski County",2,25,55,31,24
050,17,153,"Illinois","Pulaski County",2,26,46,26,20
050,17,153,"Illinois","Pulaski County",2,27,53,26,27
050,17,153,"Illinois","Pulaski County",2,28,63,36,27
050,17,153,"Illinois","Pulaski County",2,29,63,38,25
050,17,153,"Illinois","Pulaski County",2,30,62,33,29
050,17,153,"Illinois","Pulaski County",2,31,56,30,26
050,17,153,"Illinois","Pulaski County",2,32,58,31,27
050,17,153,"Illinois","Pulaski County",2,33,65,37,28
050,17,153,"Illinois","Pulaski County",2,34,61,33,28
050,17,153,"Illinois","Pulaski County",2,35,53,24,29
050,17,153,"Illinois","Pulaski County",2,36,60,28,32
050,17,153,"Illinois","Pulaski County",2,37,55,28,27
050,17,153,"Illinois","Pulaski County",2,38,54,27,27
050,17,153,"Illinois","Pulaski County",2,39,55,30,25
050,17,153,"Illinois","Pulaski County",2,40,61,34,27
050,17,153,"Illinois","Pulaski County",2,41,51,28,23
050,17,153,"Illinois","Pulaski County",2,42,62,38,24
050,17,153,"Illinois","Pulaski County",2,43,66,38,28
050,17,153,"Illinois","Pulaski County",2,44,69,35,34
050,17,153,"Illinois","Pulaski County",2,45,60,28,32
050,17,153,"Illinois","Pulaski County",2,46,58,25,33
050,17,153,"Illinois","Pulaski County",2,47,67,33,34
050,17,153,"Illinois","Pulaski County",2,48,63,29,34
050,17,153,"Illinois","Pulaski County",2,49,56,26,30
050,17,153,"Illinois","Pulaski County",2,50,55,30,25
050,17,153,"Illinois","Pulaski County",2,51,55,34,21
050,17,153,"Illinois","Pulaski County",2,52,57,33,24
050,17,153,"Illinois","Pulaski County",2,53,56,29,27
050,17,153,"Illinois","Pulaski County",2,54,62,30,32
050,17,153,"Illinois","Pulaski County",2,55,70,36,34
050,17,153,"Illinois","Pulaski County",2,56,75,41,34
050,17,153,"Illinois","Pulaski County",2,57,73,43,30
050,17,153,"Illinois","Pulaski County",2,58,70,36,34
050,17,153,"Illinois","Pulaski County",2,59,83,37,46
050,17,153,"Illinois","Pulaski County",2,60,88,42,46
050,17,153,"Illinois","Pulaski County",2,61,79,39,40
050,17,153,"Illinois","Pulaski County",2,62,79,36,43
050,17,153,"Illinois","Pulaski County",2,63,88,38,50
050,17,153,"Illinois","Pulaski County",2,64,92,48,44
050,17,153,"Illinois","Pulaski County",2,65,83,43,40
050,17,153,"Illinois","Pulaski County",2,66,79,38,41
050,17,153,"Illinois","Pulaski County",2,67,80,40,40
050,17,153,"Illinois","Pulaski County",2,68,73,38,35
050,17,153,"Illinois","Pulaski County",2,69,73,30,43
050,17,153,"Illinois","Pulaski County",2,70,73,31,42
050,17,153,"Illinois","Pulaski County",2,71,63,31,32
050,17,153,"Illinois","Pulaski County",2,72,64,34,30
050,17,153,"Illinois","Pulaski County",2,73,65,33,32
050,17,153,"Illinois","Pulaski County",2,74,44,20,24
050,17,153,"Illinois","Pulaski County",2,75,41,17,24
050,17,153,"Illinois","Pulaski County",2,76,39,17,22
050,17,153,"Illinois","Pulaski County",2,77,36,16,20
050,17,153,"Illinois","Pulaski County",2,78,33,17,16
050,17,153,"Illinois","Pulaski County",2,79,33,13,20
050,17,153,"Illinois","Pulaski County",2,80,30,12,18
050,17,153,"Illinois","Pulaski County",2,81,31,14,17
050,17,153,"Illinois","Pulaski County",2,82,31,15,16
050,17,153,"Illinois","Pulaski County",2,83,25,13,12
050,17,153,"Illinois","Pulaski County",2,84,29,12,17
050,17,153,"Illinois","Pulaski County",2,85,122,62,60
050,17,153,"Illinois","Pulaski County",3,0,68,40,28
050,17,153,"Illinois","Pulaski County",3,1,40,23,17
050,17,153,"Illinois","Pulaski County",3,2,41,18,23
050,17,153,"Illinois","Pulaski County",3,3,52,24,28
050,17,153,"Illinois","Pulaski County",3,4,68,29,39
050,17,153,"Illinois","Pulaski County",3,5,55,24,31
050,17,153,"Illinois","Pulaski County",3,6,65,34,31
050,17,153,"Illinois","Pulaski County",3,7,65,32,33
050,17,153,"Illinois","Pulaski County",3,8,44,21,23
050,17,153,"Illinois","Pulaski County",3,9,50,24,26
050,17,153,"Illinois","Pulaski County",3,10,51,25,26
050,17,153,"Illinois","Pulaski County",3,11,50,30,20
050,17,153,"Illinois","Pulaski County",3,12,59,31,28
050,17,153,"Illinois","Pulaski County",3,13,61,29,32
050,17,153,"Illinois","Pulaski County",3,14,74,31,43
050,17,153,"Illinois","Pulaski County",3,15,72,32,40
050,17,153,"Illinois","Pulaski County",3,16,81,42,39
050,17,153,"Illinois","Pulaski County",3,17,82,45,37
050,17,153,"Illinois","Pulaski County",3,18,56,32,24
050,17,153,"Illinois","Pulaski County",3,19,46,25,21
050,17,153,"Illinois","Pulaski County",3,20,64,36,28
050,17,153,"Illinois","Pulaski County",3,21,58,30,28
050,17,153,"Illinois","Pulaski County",3,22,45,24,21
050,17,153,"Illinois","Pulaski County",3,23,48,25,23
050,17,153,"Illinois","Pulaski County",3,24,50,25,25
050,17,153,"Illinois","Pulaski County",3,25,50,30,20
050,17,153,"Illinois","Pulaski County",3,26,52,31,21
050,17,153,"Illinois","Pulaski County",3,27,52,32,20
050,17,153,"Illinois","Pulaski County",3,28,51,27,24
050,17,153,"Illinois","Pulaski County",3,29,57,31,26
050,17,153,"Illinois","Pulaski County",3,30,63,36,27
050,17,153,"Illinois","Pulaski County",3,31,62,32,30
050,17,153,"Illinois","Pulaski County",3,32,57,29,28
050,17,153,"Illinois","Pulaski County",3,33,54,31,23
050,17,153,"Illinois","Pulaski County",3,34,60,32,28
050,17,153,"Illinois","Pulaski County",3,35,60,31,29
050,17,153,"Illinois","Pulaski County",3,36,60,32,28
050,17,153,"Illinois","Pulaski County",3,37,61,26,35
050,17,153,"Illinois","Pulaski County",3,38,52,27,25
050,17,153,"Illinois","Pulaski County",3,39,54,27,27
050,17,153,"Illinois","Pulaski County",3,40,61,29,32
050,17,153,"Illinois","Pulaski County",3,41,59,33,26
050,17,153,"Illinois","Pulaski County",3,42,47,26,21
050,17,153,"Illinois","Pulaski County",3,43,59,36,23
050,17,153,"Illinois","Pulaski County",3,44,70,39,31
050,17,153,"Illinois","Pulaski County",3,45,69,34,35
050,17,153,"Illinois","Pulaski County",3,46,60,28,32
050,17,153,"Illinois","Pulaski County",3,47,59,27,32
050,17,153,"Illinois","Pulaski County",3,48,63,32,31
050,17,153,"Illinois","Pulaski County",3,49,58,27,31
050,17,153,"Illinois","Pulaski County",3,50,55,26,29
050,17,153,"Illinois","Pulaski County",3,51,54,29,25
050,17,153,"Illinois","Pulaski County",3,52,57,34,23
050,17,153,"Illinois","Pulaski County",3,53,53,30,23
050,17,153,"Illinois","Pulaski County",3,54,56,29,27
050,17,153,"Illinois","Pulaski County",3,55,60,30,30
050,17,153,"Illinois","Pulaski County",3,56,64,30,34
050,17,153,"Illinois","Pulaski County",3,57,72,40,32
050,17,153,"Illinois","Pulaski County",3,58,71,40,31
050,17,153,"Illinois","Pulaski County",3,59,66,33,33
050,17,153,"Illinois","Pulaski County",3,60,80,35,45
050,17,153,"Illinois","Pulaski County",3,61,84,41,43
050,17,153,"Illinois","Pulaski County",3,62,79,39,40
050,17,153,"Illinois","Pulaski County",3,63,78,32,46
050,17,153,"Illinois","Pulaski County",3,64,89,38,51
050,17,153,"Illinois","Pulaski County",3,65,91,46,45
050,17,153,"Illinois","Pulaski County",3,66,79,39,40
050,17,153,"Illinois","Pulaski County",3,67,76,36,40
050,17,153,"Illinois","Pulaski County",3,68,76,38,38
050,17,153,"Illinois","Pulaski County",3,69,67,36,31
050,17,153,"Illinois","Pulaski County",3,70,70,27,43
050,17,153,"Illinois","Pulaski County",3,71,72,30,42
050,17,153,"Illinois","Pulaski County",3,72,58,26,32
050,17,153,"Illinois","Pulaski County",3,73,62,32,30
050,17,153,"Illinois","Pulaski County",3,74,59,29,30
050,17,153,"Illinois","Pulaski County",3,75,44,20,24
050,17,153,"Illinois","Pulaski County",3,76,42,18,24
050,17,153,"Illinois","Pulaski County",3,77,36,17,19
050,17,153,"Illinois","Pulaski County",3,78,35,16,19
050,17,153,"Illinois","Pulaski County",3,79,30,17,13
050,17,153,"Illinois","Pulaski County",3,80,31,11,20
050,17,153,"Illinois","Pulaski County",3,81,29,11,18
050,17,153,"Illinois","Pulaski County",3,82,28,14,14
050,17,153,"Illinois","Pulaski County",3,83,29,13,16
050,17,153,"Illinois","Pulaski County",3,84,25,11,14
050,17,153,"Illinois","Pulaski County",3,85,123,62,61
050,17,153,"Illinois","Pulaski County",4,0,43,23,20
050,17,153,"Illinois","Pulaski County",4,1,62,38,24
050,17,153,"Illinois","Pulaski County",4,2,38,22,16
050,17,153,"Illinois","Pulaski County",4,3,40,17,23
050,17,153,"Illinois","Pulaski County",4,4,61,31,30
050,17,153,"Illinois","Pulaski County",4,5,67,29,38
050,17,153,"Illinois","Pulaski County",4,6,55,26,29
050,17,153,"Illinois","Pulaski County",4,7,65,34,31
050,17,153,"Illinois","Pulaski County",4,8,66,32,34
050,17,153,"Illinois","Pulaski County",4,9,49,23,26
050,17,153,"Illinois","Pulaski County",4,10,49,24,25
050,17,153,"Illinois","Pulaski County",4,11,53,28,25
050,17,153,"Illinois","Pulaski County",4,12,42,25,17
050,17,153,"Illinois","Pulaski County",4,13,62,34,28
050,17,153,"Illinois","Pulaski County",4,14,55,30,25
050,17,153,"Illinois","Pulaski County",4,15,72,32,40
050,17,153,"Illinois","Pulaski County",4,16,63,30,33
050,17,153,"Illinois","Pulaski County",4,17,79,42,37
050,17,153,"Illinois","Pulaski County",4,18,67,41,26
050,17,153,"Illinois","Pulaski County",4,19,44,27,17
050,17,153,"Illinois","Pulaski County",4,20,45,24,21
050,17,153,"Illinois","Pulaski County",4,21,59,34,25
050,17,153,"Illinois","Pulaski County",4,22,58,31,27
050,17,153,"Illinois","Pulaski County",4,23,47,23,24
050,17,153,"Illinois","Pulaski County",4,24,54,27,27
050,17,153,"Illinois","Pulaski County",4,25,52,28,24
050,17,153,"Illinois","Pulaski County",4,26,54,30,24
050,17,153,"Illinois","Pulaski County",4,27,48,28,20
050,17,153,"Illinois","Pulaski County",4,28,53,31,22
050,17,153,"Illinois","Pulaski County",4,29,58,29,29
050,17,153,"Illinois","Pulaski County",4,30,57,31,26
050,17,153,"Illinois","Pulaski County",4,31,61,35,26
050,17,153,"Illinois","Pulaski County",4,32,65,35,30
050,17,153,"Illinois","Pulaski County",4,33,53,27,26
050,17,153,"Illinois","Pulaski County",4,34,54,30,24
050,17,153,"Illinois","Pulaski County",4,35,61,33,28
050,17,153,"Illinois","Pulaski County",4,36,53,29,24
050,17,153,"Illinois","Pulaski County",4,37,62,35,27
050,17,153,"Illinois","Pulaski County",4,38,59,26,33
050,17,153,"Illinois","Pulaski County",4,39,49,25,24
050,17,153,"Illinois","Pulaski County",4,40,53,25,28
050,17,153,"Illinois","Pulaski County",4,41,62,30,32
050,17,153,"Illinois","Pulaski County",4,42,57,32,25
050,17,153,"Illinois","Pulaski County",4,43,44,24,20
050,17,153,"Illinois","Pulaski County",4,44,61,39,22
050,17,153,"Illinois","Pulaski County",4,45,62,34,28
050,17,153,"Illinois","Pulaski County",4,46,78,39,39
050,17,153,"Illinois","Pulaski County",4,47,59,28,31
050,17,153,"Illinois","Pulaski County",4,48,63,27,36
050,17,153,"Illinois","Pulaski County",4,49,61,30,31
050,17,153,"Illinois","Pulaski County",4,50,56,24,32
050,17,153,"Illinois","Pulaski County",4,51,55,26,29
050,17,153,"Illinois","Pulaski County",4,52,55,29,26
050,17,153,"Illinois","Pulaski County",4,53,57,32,25
050,17,153,"Illinois","Pulaski County",4,54,51,29,22
050,17,153,"Illinois","Pulaski County",4,55,55,27,28
050,17,153,"Illinois","Pulaski County",4,56,60,30,30
050,17,153,"Illinois","Pulaski County",4,57,64,32,32
050,17,153,"Illinois","Pulaski County",4,58,60,36,24
050,17,153,"Illinois","Pulaski County",4,59,71,41,30
050,17,153,"Illinois","Pulaski County",4,60,68,33,35
050,17,153,"Illinois","Pulaski County",4,61,78,34,44
050,17,153,"Illinois","Pulaski County",4,62,78,37,41
050,17,153,"Illinois","Pulaski County",4,63,80,41,39
050,17,153,"Illinois","Pulaski County",4,64,76,30,46
050,17,153,"Illinois","Pulaski County",4,65,90,39,51
050,17,153,"Illinois","Pulaski County",4,66,85,43,42
050,17,153,"Illinois","Pulaski County",4,67,77,37,40
050,17,153,"Illinois","Pulaski County",4,68,69,33,36
050,17,153,"Illinois","Pulaski County",4,69,74,39,35
050,17,153,"Illinois","Pulaski County",4,70,66,35,31
050,17,153,"Illinois","Pulaski County",4,71,68,27,41
050,17,153,"Illinois","Pulaski County",4,72,66,24,42
050,17,153,"Illinois","Pulaski County",4,73,53,23,30
050,17,153,"Illinois","Pulaski County",4,74,54,26,28
050,17,153,"Illinois","Pulaski County",4,75,58,29,29
050,17,153,"Illinois","Pulaski County",4,76,42,19,23
050,17,153,"Illinois","Pulaski County",4,77,38,17,21
050,17,153,"Illinois","Pulaski County",4,78,34,15,19
050,17,153,"Illinois","Pulaski County",4,79,30,14,16
050,17,153,"Illinois","Pulaski County",4,80,30,16,14
050,17,153,"Illinois","Pulaski County",4,81,29,10,19
050,17,153,"Illinois","Pulaski County",4,82,28,11,17
050,17,153,"Illinois","Pulaski County",4,83,28,13,15
050,17,153,"Illinois","Pulaski County",4,84,23,10,13
050,17,153,"Illinois","Pulaski County",4,85,110,57,53
050,17,153,"Illinois","Pulaski County",5,0,37,21,16
050,17,153,"Illinois","Pulaski County",5,1,41,22,19
050,17,153,"Illinois","Pulaski County",5,2,52,32,20
050,17,153,"Illinois","Pulaski County",5,3,42,26,16
050,17,153,"Illinois","Pulaski County",5,4,44,19,25
050,17,153,"Illinois","Pulaski County",5,5,65,31,34
050,17,153,"Illinois","Pulaski County",5,6,71,32,39
050,17,153,"Illinois","Pulaski County",5,7,57,27,30
050,17,153,"Illinois","Pulaski County",5,8,69,37,32
050,17,153,"Illinois","Pulaski County",5,9,67,32,35
050,17,153,"Illinois","Pulaski County",5,10,58,26,32
050,17,153,"Illinois","Pulaski County",5,11,50,24,26
050,17,153,"Illinois","Pulaski County",5,12,55,31,24
050,17,153,"Illinois","Pulaski County",5,13,48,27,21
050,17,153,"Illinois","Pulaski County",5,14,57,34,23
050,17,153,"Illinois","Pulaski County",5,15,54,29,25
050,17,153,"Illinois","Pulaski County",5,16,72,30,42
050,17,153,"Illinois","Pulaski County",5,17,63,32,31
050,17,153,"Illinois","Pulaski County",5,18,72,42,30
050,17,153,"Illinois","Pulaski County",5,19,58,36,22
050,17,153,"Illinois","Pulaski County",5,20,49,28,21
050,17,153,"Illinois","Pulaski County",5,21,48,25,23
050,17,153,"Illinois","Pulaski County",5,22,64,37,27
050,17,153,"Illinois","Pulaski County",5,23,67,33,34
050,17,153,"Illinois","Pulaski County",5,24,45,23,22
050,17,153,"Illinois","Pulaski County",5,25,55,29,26
050,17,153,"Illinois","Pulaski County",5,26,46,24,22
050,17,153,"Illinois","Pulaski County",5,27,48,26,22
050,17,153,"Illinois","Pulaski County",5,28,51,29,22
050,17,153,"Illinois","Pulaski County",5,29,49,26,23
050,17,153,"Illinois","Pulaski County",5,30,57,28,29
050,17,153,"Illinois","Pulaski County",5,31,64,30,34
050,17,153,"Illinois","Pulaski County",5,32,61,34,27
050,17,153,"Illinois","Pulaski County",5,33,62,35,27
050,17,153,"Illinois","Pulaski County",5,34,58,30,28
050,17,153,"Illinois","Pulaski County",5,35,55,31,24
050,17,153,"Illinois","Pulaski County",5,36,65,33,32
050,17,153,"Illinois","Pulaski County",5,37,51,26,25
050,17,153,"Illinois","Pulaski County",5,38,64,33,31
050,17,153,"Illinois","Pulaski County",5,39,62,29,33
050,17,153,"Illinois","Pulaski County",5,40,48,25,23
050,17,153,"Illinois","Pulaski County",5,41,54,27,27
050,17,153,"Illinois","Pulaski County",5,42,64,32,32
050,17,153,"Illinois","Pulaski County",5,43,56,33,23
050,17,153,"Illinois","Pulaski County",5,44,48,23,25
050,17,153,"Illinois","Pulaski County",5,45,58,39,19
050,17,153,"Illinois","Pulaski County",5,46,57,34,23
050,17,153,"Illinois","Pulaski County",5,47,76,38,38
050,17,153,"Illinois","Pulaski County",5,48,61,28,33
050,17,153,"Illinois","Pulaski County",5,49,57,25,32
050,17,153,"Illinois","Pulaski County",5,50,60,31,29
050,17,153,"Illinois","Pulaski County",5,51,55,24,31
050,17,153,"Illinois","Pulaski County",5,52,57,28,29
050,17,153,"Illinois","Pulaski County",5,53,53,28,25
050,17,153,"Illinois","Pulaski County",5,54,59,34,25
050,17,153,"Illinois","Pulaski County",5,55,51,29,22
050,17,153,"Illinois","Pulaski County",5,56,53,25,28
050,17,153,"Illinois","Pulaski County",5,57,63,30,33
050,17,153,"Illinois","Pulaski County",5,58,63,29,34
050,17,153,"Illinois","Pulaski County",5,59,61,37,24
050,17,153,"Illinois","Pulaski County",5,60,68,38,30
050,17,153,"Illinois","Pulaski County",5,61,62,31,31
050,17,153,"Illinois","Pulaski County",5,62,76,33,43
050,17,153,"Illinois","Pulaski County",5,63,79,38,41
050,17,153,"Illinois","Pulaski County",5,64,76,38,38
050,17,153,"Illinois","Pulaski County",5,65,74,28,46
050,17,153,"Illinois","Pulaski County",5,66,87,35,52
050,17,153,"Illinois","Pulaski County",5,67,82,40,42
050,17,153,"Illinois","Pulaski County",5,68,73,35,38
050,17,153,"Illinois","Pulaski County",5,69,70,34,36
050,17,153,"Illinois","Pulaski County",5,70,73,38,35
050,17,153,"Illinois","Pulaski County",5,71,64,35,29
050,17,153,"Illinois","Pulaski County",5,72,66,25,41
050,17,153,"Illinois","Pulaski County",5,73,58,20,38
050,17,153,"Illinois","Pulaski County",5,74,46,18,28
050,17,153,"Illinois","Pulaski County",5,75,54,27,27
050,17,153,"Illinois","Pulaski County",5,76,57,28,29
050,17,153,"Illinois","Pulaski County",5,77,38,17,21
050,17,153,"Illinois","Pulaski County",5,78,33,15,18
050,17,153,"Illinois","Pulaski County",5,79,31,15,16
050,17,153,"Illinois","Pulaski County",5,80,31,14,17
050,17,153,"Illinois","Pulaski County",5,81,29,15,14
050,17,153,"Illinois","Pulaski County",5,82,26,10,16
050,17,153,"Illinois","Pulaski County",5,83,27,10,17
050,17,153,"Illinois","Pulaski County",5,84,24,11,13
050,17,153,"Illinois","Pulaski County",5,85,100,54,46
050,17,155,"Illinois","Putnam County",1,0,38,19,19
050,17,155,"Illinois","Putnam County",1,1,45,17,28
050,17,155,"Illinois","Putnam County",1,2,57,24,33
050,17,155,"Illinois","Putnam County",1,3,54,26,28
050,17,155,"Illinois","Putnam County",1,4,62,30,32
050,17,155,"Illinois","Putnam County",1,5,73,36,37
050,17,155,"Illinois","Putnam County",1,6,54,32,22
050,17,155,"Illinois","Putnam County",1,7,66,36,30
050,17,155,"Illinois","Putnam County",1,8,66,38,28
050,17,155,"Illinois","Putnam County",1,9,66,31,35
050,17,155,"Illinois","Putnam County",1,10,55,25,30
050,17,155,"Illinois","Putnam County",1,11,58,37,21
050,17,155,"Illinois","Putnam County",1,12,72,49,23
050,17,155,"Illinois","Putnam County",1,13,74,36,38
050,17,155,"Illinois","Putnam County",1,14,73,37,36
050,17,155,"Illinois","Putnam County",1,15,64,28,36
050,17,155,"Illinois","Putnam County",1,16,77,38,39
050,17,155,"Illinois","Putnam County",1,17,76,41,35
050,17,155,"Illinois","Putnam County",1,18,65,34,31
050,17,155,"Illinois","Putnam County",1,19,53,25,28
050,17,155,"Illinois","Putnam County",1,20,57,31,26
050,17,155,"Illinois","Putnam County",1,21,44,27,17
050,17,155,"Illinois","Putnam County",1,22,53,32,21
050,17,155,"Illinois","Putnam County",1,23,54,31,23
050,17,155,"Illinois","Putnam County",1,24,59,32,27
050,17,155,"Illinois","Putnam County",1,25,50,27,23
050,17,155,"Illinois","Putnam County",1,26,56,30,26
050,17,155,"Illinois","Putnam County",1,27,60,28,32
050,17,155,"Illinois","Putnam County",1,28,58,30,28
050,17,155,"Illinois","Putnam County",1,29,56,32,24
050,17,155,"Illinois","Putnam County",1,30,72,40,32
050,17,155,"Illinois","Putnam County",1,31,49,26,23
050,17,155,"Illinois","Putnam County",1,32,63,30,33
050,17,155,"Illinois","Putnam County",1,33,50,22,28
050,17,155,"Illinois","Putnam County",1,34,64,32,32
050,17,155,"Illinois","Putnam County",1,35,65,32,33
050,17,155,"Illinois","Putnam County",1,36,67,32,35
050,17,155,"Illinois","Putnam County",1,37,71,35,36
050,17,155,"Illinois","Putnam County",1,38,69,36,33
050,17,155,"Illinois","Putnam County",1,39,62,33,29
050,17,155,"Illinois","Putnam County",1,40,66,37,29
050,17,155,"Illinois","Putnam County",1,41,68,37,31
050,17,155,"Illinois","Putnam County",1,42,61,29,32
050,17,155,"Illinois","Putnam County",1,43,55,27,28
050,17,155,"Illinois","Putnam County",1,44,54,24,30
050,17,155,"Illinois","Putnam County",1,45,64,32,32
050,17,155,"Illinois","Putnam County",1,46,51,26,25
050,17,155,"Illinois","Putnam County",1,47,46,26,20
050,17,155,"Illinois","Putnam County",1,48,57,26,31
050,17,155,"Illinois","Putnam County",1,49,77,40,37
050,17,155,"Illinois","Putnam County",1,50,83,45,38
050,17,155,"Illinois","Putnam County",1,51,77,34,43
050,17,155,"Illinois","Putnam County",1,52,67,33,34
050,17,155,"Illinois","Putnam County",1,53,69,34,35
050,17,155,"Illinois","Putnam County",1,54,82,39,43
050,17,155,"Illinois","Putnam County",1,55,82,39,43
050,17,155,"Illinois","Putnam County",1,56,91,47,44
050,17,155,"Illinois","Putnam County",1,57,89,48,41
050,17,155,"Illinois","Putnam County",1,58,86,43,43
050,17,155,"Illinois","Putnam County",1,59,93,51,42
050,17,155,"Illinois","Putnam County",1,60,99,51,48
050,17,155,"Illinois","Putnam County",1,61,100,48,52
050,17,155,"Illinois","Putnam County",1,62,94,51,43
050,17,155,"Illinois","Putnam County",1,63,101,55,46
050,17,155,"Illinois","Putnam County",1,64,87,46,41
050,17,155,"Illinois","Putnam County",1,65,86,51,35
050,17,155,"Illinois","Putnam County",1,66,83,43,40
050,17,155,"Illinois","Putnam County",1,67,83,42,41
050,17,155,"Illinois","Putnam County",1,68,90,54,36
050,17,155,"Illinois","Putnam County",1,69,96,51,45
050,17,155,"Illinois","Putnam County",1,70,84,41,43
050,17,155,"Illinois","Putnam County",1,71,74,39,35
050,17,155,"Illinois","Putnam County",1,72,79,37,42
050,17,155,"Illinois","Putnam County",1,73,83,40,43
050,17,155,"Illinois","Putnam County",1,74,48,19,29
050,17,155,"Illinois","Putnam County",1,75,47,25,22
050,17,155,"Illinois","Putnam County",1,76,59,32,27
050,17,155,"Illinois","Putnam County",1,77,48,23,25
050,17,155,"Illinois","Putnam County",1,78,47,25,22
050,17,155,"Illinois","Putnam County",1,79,35,15,20
050,17,155,"Illinois","Putnam County",1,80,32,16,16
050,17,155,"Illinois","Putnam County",1,81,34,14,20
050,17,155,"Illinois","Putnam County",1,82,33,15,18
050,17,155,"Illinois","Putnam County",1,83,26,13,13
050,17,155,"Illinois","Putnam County",1,84,24,11,13
050,17,155,"Illinois","Putnam County",1,85,119,48,71
050,17,155,"Illinois","Putnam County",2,0,37,18,19
050,17,155,"Illinois","Putnam County",2,1,43,17,26
050,17,155,"Illinois","Putnam County",2,2,55,23,32
050,17,155,"Illinois","Putnam County",2,3,55,25,30
050,17,155,"Illinois","Putnam County",2,4,62,30,32
050,17,155,"Illinois","Putnam County",2,5,70,34,36
050,17,155,"Illinois","Putnam County",2,6,60,33,27
050,17,155,"Illinois","Putnam County",2,7,62,34,28
050,17,155,"Illinois","Putnam County",2,8,66,36,30
050,17,155,"Illinois","Putnam County",2,9,64,32,32
050,17,155,"Illinois","Putnam County",2,10,57,26,31
050,17,155,"Illinois","Putnam County",2,11,57,34,23
050,17,155,"Illinois","Putnam County",2,12,70,46,24
050,17,155,"Illinois","Putnam County",2,13,73,38,35
050,17,155,"Illinois","Putnam County",2,14,73,36,37
050,17,155,"Illinois","Putnam County",2,15,66,29,37
050,17,155,"Illinois","Putnam County",2,16,76,37,39
050,17,155,"Illinois","Putnam County",2,17,77,40,37
050,17,155,"Illinois","Putnam County",2,18,61,32,29
050,17,155,"Illinois","Putnam County",2,19,52,25,27
050,17,155,"Illinois","Putnam County",2,20,58,31,27
050,17,155,"Illinois","Putnam County",2,21,48,28,20
050,17,155,"Illinois","Putnam County",2,22,50,30,20
050,17,155,"Illinois","Putnam County",2,23,55,33,22
050,17,155,"Illinois","Putnam County",2,24,55,30,25
050,17,155,"Illinois","Putnam County",2,25,52,28,24
050,17,155,"Illinois","Putnam County",2,26,53,27,26
050,17,155,"Illinois","Putnam County",2,27,59,28,31
050,17,155,"Illinois","Putnam County",2,28,58,30,28
050,17,155,"Illinois","Putnam County",2,29,59,33,26
050,17,155,"Illinois","Putnam County",2,30,70,39,31
050,17,155,"Illinois","Putnam County",2,31,57,30,27
050,17,155,"Illinois","Putnam County",2,32,60,29,31
050,17,155,"Illinois","Putnam County",2,33,52,24,28
050,17,155,"Illinois","Putnam County",2,34,61,29,32
050,17,155,"Illinois","Putnam County",2,35,67,33,34
050,17,155,"Illinois","Putnam County",2,36,66,31,35
050,17,155,"Illinois","Putnam County",2,37,70,35,35
050,17,155,"Illinois","Putnam County",2,38,69,36,33
050,17,155,"Illinois","Putnam County",2,39,64,34,30
050,17,155,"Illinois","Putnam County",2,40,66,37,29
050,17,155,"Illinois","Putnam County",2,41,67,37,30
050,17,155,"Illinois","Putnam County",2,42,62,30,32
050,17,155,"Illinois","Putnam County",2,43,57,28,29
050,17,155,"Illinois","Putnam County",2,44,55,25,30
050,17,155,"Illinois","Putnam County",2,45,62,31,31
050,17,155,"Illinois","Putnam County",2,46,54,27,27
050,17,155,"Illinois","Putnam County",2,47,49,27,22
050,17,155,"Illinois","Putnam County",2,48,56,26,30
050,17,155,"Illinois","Putnam County",2,49,73,37,36
050,17,155,"Illinois","Putnam County",2,50,81,44,37
050,17,155,"Illinois","Putnam County",2,51,79,37,42
050,17,155,"Illinois","Putnam County",2,52,69,33,36
050,17,155,"Illinois","Putnam County",2,53,68,33,35
050,17,155,"Illinois","Putnam County",2,54,78,37,41
050,17,155,"Illinois","Putnam County",2,55,82,39,43
050,17,155,"Illinois","Putnam County",2,56,88,45,43
050,17,155,"Illinois","Putnam County",2,57,89,47,42
050,17,155,"Illinois","Putnam County",2,58,87,45,42
050,17,155,"Illinois","Putnam County",2,59,89,48,41
050,17,155,"Illinois","Putnam County",2,60,98,51,47
050,17,155,"Illinois","Putnam County",2,61,99,48,51
050,17,155,"Illinois","Putnam County",2,62,94,49,45
050,17,155,"Illinois","Putnam County",2,63,100,54,46
050,17,155,"Illinois","Putnam County",2,64,89,47,42
050,17,155,"Illinois","Putnam County",2,65,85,49,36
050,17,155,"Illinois","Putnam County",2,66,83,44,39
050,17,155,"Illinois","Putnam County",2,67,83,42,41
050,17,155,"Illinois","Putnam County",2,68,87,51,36
050,17,155,"Illinois","Putnam County",2,69,95,52,43
050,17,155,"Illinois","Putnam County",2,70,87,44,43
050,17,155,"Illinois","Putnam County",2,71,77,40,37
050,17,155,"Illinois","Putnam County",2,72,75,35,40
050,17,155,"Illinois","Putnam County",2,73,85,41,44
050,17,155,"Illinois","Putnam County",2,74,53,22,31
050,17,155,"Illinois","Putnam County",2,75,48,24,24
050,17,155,"Illinois","Putnam County",2,76,56,30,26
050,17,155,"Illinois","Putnam County",2,77,52,26,26
050,17,155,"Illinois","Putnam County",2,78,45,23,22
050,17,155,"Illinois","Putnam County",2,79,37,16,21
050,17,155,"Illinois","Putnam County",2,80,32,16,16
050,17,155,"Illinois","Putnam County",2,81,33,14,19
050,17,155,"Illinois","Putnam County",2,82,34,15,19
050,17,155,"Illinois","Putnam County",2,83,27,13,14
050,17,155,"Illinois","Putnam County",2,84,24,11,13
050,17,155,"Illinois","Putnam County",2,85,122,50,72
050,17,155,"Illinois","Putnam County",3,0,47,24,23
050,17,155,"Illinois","Putnam County",3,1,45,26,19
050,17,155,"Illinois","Putnam County",3,2,40,16,24
050,17,155,"Illinois","Putnam County",3,3,56,21,35
050,17,155,"Illinois","Putnam County",3,4,59,26,33
050,17,155,"Illinois","Putnam County",3,5,64,33,31
050,17,155,"Illinois","Putnam County",3,6,66,33,33
050,17,155,"Illinois","Putnam County",3,7,63,31,32
050,17,155,"Illinois","Putnam County",3,8,57,34,23
050,17,155,"Illinois","Putnam County",3,9,62,31,31
050,17,155,"Illinois","Putnam County",3,10,69,37,32
050,17,155,"Illinois","Putnam County",3,11,57,26,31
050,17,155,"Illinois","Putnam County",3,12,59,36,23
050,17,155,"Illinois","Putnam County",3,13,72,46,26
050,17,155,"Illinois","Putnam County",3,14,75,43,32
050,17,155,"Illinois","Putnam County",3,15,74,37,37
050,17,155,"Illinois","Putnam County",3,16,66,29,37
050,17,155,"Illinois","Putnam County",3,17,76,41,35
050,17,155,"Illinois","Putnam County",3,18,59,32,27
050,17,155,"Illinois","Putnam County",3,19,49,25,24
050,17,155,"Illinois","Putnam County",3,20,54,25,29
050,17,155,"Illinois","Putnam County",3,21,53,28,25
050,17,155,"Illinois","Putnam County",3,22,57,30,27
050,17,155,"Illinois","Putnam County",3,23,52,31,21
050,17,155,"Illinois","Putnam County",3,24,51,32,19
050,17,155,"Illinois","Putnam County",3,25,47,26,21
050,17,155,"Illinois","Putnam County",3,26,46,26,20
050,17,155,"Illinois","Putnam County",3,27,47,23,24
050,17,155,"Illinois","Putnam County",3,28,67,35,32
050,17,155,"Illinois","Putnam County",3,29,57,28,29
050,17,155,"Illinois","Putnam County",3,30,62,30,32
050,17,155,"Illinois","Putnam County",3,31,66,39,27
050,17,155,"Illinois","Putnam County",3,32,58,29,29
050,17,155,"Illinois","Putnam County",3,33,56,26,30
050,17,155,"Illinois","Putnam County",3,34,54,25,29
050,17,155,"Illinois","Putnam County",3,35,63,31,32
050,17,155,"Illinois","Putnam County",3,36,66,32,34
050,17,155,"Illinois","Putnam County",3,37,64,27,37
050,17,155,"Illinois","Putnam County",3,38,70,35,35
050,17,155,"Illinois","Putnam County",3,39,71,38,33
050,17,155,"Illinois","Putnam County",3,40,64,36,28
050,17,155,"Illinois","Putnam County",3,41,68,41,27
050,17,155,"Illinois","Putnam County",3,42,68,38,30
050,17,155,"Illinois","Putnam County",3,43,65,32,33
050,17,155,"Illinois","Putnam County",3,44,60,29,31
050,17,155,"Illinois","Putnam County",3,45,58,27,31
050,17,155,"Illinois","Putnam County",3,46,59,31,28
050,17,155,"Illinois","Putnam County",3,47,51,25,26
050,17,155,"Illinois","Putnam County",3,48,50,27,23
050,17,155,"Illinois","Putnam County",3,49,52,24,28
050,17,155,"Illinois","Putnam County",3,50,76,39,37
050,17,155,"Illinois","Putnam County",3,51,80,41,39
050,17,155,"Illinois","Putnam County",3,52,74,34,40
050,17,155,"Illinois","Putnam County",3,53,66,33,33
050,17,155,"Illinois","Putnam County",3,54,66,32,34
050,17,155,"Illinois","Putnam County",3,55,78,35,43
050,17,155,"Illinois","Putnam County",3,56,84,39,45
050,17,155,"Illinois","Putnam County",3,57,92,47,45
050,17,155,"Illinois","Putnam County",3,58,89,47,42
050,17,155,"Illinois","Putnam County",3,59,90,52,38
050,17,155,"Illinois","Putnam County",3,60,92,48,44
050,17,155,"Illinois","Putnam County",3,61,95,51,44
050,17,155,"Illinois","Putnam County",3,62,98,47,51
050,17,155,"Illinois","Putnam County",3,63,93,46,47
050,17,155,"Illinois","Putnam County",3,64,96,53,43
050,17,155,"Illinois","Putnam County",3,65,87,45,42
050,17,155,"Illinois","Putnam County",3,66,80,47,33
050,17,155,"Illinois","Putnam County",3,67,79,43,36
050,17,155,"Illinois","Putnam County",3,68,80,40,40
050,17,155,"Illinois","Putnam County",3,69,86,51,35
050,17,155,"Illinois","Putnam County",3,70,93,51,42
050,17,155,"Illinois","Putnam County",3,71,84,41,43
050,17,155,"Illinois","Putnam County",3,72,75,39,36
050,17,155,"Illinois","Putnam County",3,73,74,36,38
050,17,155,"Illinois","Putnam County",3,74,78,40,38
050,17,155,"Illinois","Putnam County",3,75,50,19,31
050,17,155,"Illinois","Putnam County",3,76,46,22,24
050,17,155,"Illinois","Putnam County",3,77,53,29,24
050,17,155,"Illinois","Putnam County",3,78,49,26,23
050,17,155,"Illinois","Putnam County",3,79,44,22,22
050,17,155,"Illinois","Putnam County",3,80,35,14,21
050,17,155,"Illinois","Putnam County",3,81,29,15,14
050,17,155,"Illinois","Putnam County",3,82,32,14,18
050,17,155,"Illinois","Putnam County",3,83,33,14,19
050,17,155,"Illinois","Putnam County",3,84,28,13,15
050,17,155,"Illinois","Putnam County",3,85,133,54,79
050,17,155,"Illinois","Putnam County",4,0,42,18,24
050,17,155,"Illinois","Putnam County",4,1,60,31,29
050,17,155,"Illinois","Putnam County",4,2,43,26,17
050,17,155,"Illinois","Putnam County",4,3,39,16,23
050,17,155,"Illinois","Putnam County",4,4,56,23,33
050,17,155,"Illinois","Putnam County",4,5,52,22,30
050,17,155,"Illinois","Putnam County",4,6,63,34,29
050,17,155,"Illinois","Putnam County",4,7,55,26,29
050,17,155,"Illinois","Putnam County",4,8,64,32,32
050,17,155,"Illinois","Putnam County",4,9,58,35,23
050,17,155,"Illinois","Putnam County",4,10,60,29,31
050,17,155,"Illinois","Putnam County",4,11,67,34,33
050,17,155,"Illinois","Putnam County",4,12,56,26,30
050,17,155,"Illinois","Putnam County",4,13,64,38,26
050,17,155,"Illinois","Putnam County",4,14,62,43,19
050,17,155,"Illinois","Putnam County",4,15,67,38,29
050,17,155,"Illinois","Putnam County",4,16,74,38,36
050,17,155,"Illinois","Putnam County",4,17,67,29,38
050,17,155,"Illinois","Putnam County",4,18,67,34,33
050,17,155,"Illinois","Putnam County",4,19,46,25,21
050,17,155,"Illinois","Putnam County",4,20,50,27,23
050,17,155,"Illinois","Putnam County",4,21,55,26,29
050,17,155,"Illinois","Putnam County",4,22,60,29,31
050,17,155,"Illinois","Putnam County",4,23,53,26,27
050,17,155,"Illinois","Putnam County",4,24,57,32,25
050,17,155,"Illinois","Putnam County",4,25,50,33,17
050,17,155,"Illinois","Putnam County",4,26,48,28,20
050,17,155,"Illinois","Putnam County",4,27,50,25,25
050,17,155,"Illinois","Putnam County",4,28,54,24,30
050,17,155,"Illinois","Putnam County",4,29,70,39,31
050,17,155,"Illinois","Putnam County",4,30,58,28,30
050,17,155,"Illinois","Putnam County",4,31,61,31,30
050,17,155,"Illinois","Putnam County",4,32,64,37,27
050,17,155,"Illinois","Putnam County",4,33,54,26,28
050,17,155,"Illinois","Putnam County",4,34,57,26,31
050,17,155,"Illinois","Putnam County",4,35,58,28,30
050,17,155,"Illinois","Putnam County",4,36,58,29,29
050,17,155,"Illinois","Putnam County",4,37,63,32,31
050,17,155,"Illinois","Putnam County",4,38,66,30,36
050,17,155,"Illinois","Putnam County",4,39,71,37,34
050,17,155,"Illinois","Putnam County",4,40,69,35,34
050,17,155,"Illinois","Putnam County",4,41,63,35,28
050,17,155,"Illinois","Putnam County",4,42,70,42,28
050,17,155,"Illinois","Putnam County",4,43,75,41,34
050,17,155,"Illinois","Putnam County",4,44,66,33,33
050,17,155,"Illinois","Putnam County",4,45,62,34,28
050,17,155,"Illinois","Putnam County",4,46,60,27,33
050,17,155,"Illinois","Putnam County",4,47,61,33,28
050,17,155,"Illinois","Putnam County",4,48,55,28,27
050,17,155,"Illinois","Putnam County",4,49,50,27,23
050,17,155,"Illinois","Putnam County",4,50,52,24,28
050,17,155,"Illinois","Putnam County",4,51,76,38,38
050,17,155,"Illinois","Putnam County",4,52,80,41,39
050,17,155,"Illinois","Putnam County",4,53,78,38,40
050,17,155,"Illinois","Putnam County",4,54,66,33,33
050,17,155,"Illinois","Putnam County",4,55,64,31,33
050,17,155,"Illinois","Putnam County",4,56,77,37,40
050,17,155,"Illinois","Putnam County",4,57,82,38,44
050,17,155,"Illinois","Putnam County",4,58,93,47,46
050,17,155,"Illinois","Putnam County",4,59,90,47,43
050,17,155,"Illinois","Putnam County",4,60,87,51,36
050,17,155,"Illinois","Putnam County",4,61,95,50,45
050,17,155,"Illinois","Putnam County",4,62,94,46,48
050,17,155,"Illinois","Putnam County",4,63,93,46,47
050,17,155,"Illinois","Putnam County",4,64,96,47,49
050,17,155,"Illinois","Putnam County",4,65,95,53,42
050,17,155,"Illinois","Putnam County",4,66,86,45,41
050,17,155,"Illinois","Putnam County",4,67,81,48,33
050,17,155,"Illinois","Putnam County",4,68,77,42,35
050,17,155,"Illinois","Putnam County",4,69,78,39,39
050,17,155,"Illinois","Putnam County",4,70,85,50,35
050,17,155,"Illinois","Putnam County",4,71,93,52,41
050,17,155,"Illinois","Putnam County",4,72,82,39,43
050,17,155,"Illinois","Putnam County",4,73,71,36,35
050,17,155,"Illinois","Putnam County",4,74,69,33,36
050,17,155,"Illinois","Putnam County",4,75,73,40,33
050,17,155,"Illinois","Putnam County",4,76,47,17,30
050,17,155,"Illinois","Putnam County",4,77,39,17,22
050,17,155,"Illinois","Putnam County",4,78,52,29,23
050,17,155,"Illinois","Putnam County",4,79,46,25,21
050,17,155,"Illinois","Putnam County",4,80,42,20,22
050,17,155,"Illinois","Putnam County",4,81,33,13,20
050,17,155,"Illinois","Putnam County",4,82,27,15,12
050,17,155,"Illinois","Putnam County",4,83,30,14,16
050,17,155,"Illinois","Putnam County",4,84,29,11,18
050,17,155,"Illinois","Putnam County",4,85,145,60,85
050,17,155,"Illinois","Putnam County",5,0,41,17,24
050,17,155,"Illinois","Putnam County",5,1,49,23,26
050,17,155,"Illinois","Putnam County",5,2,61,35,26
050,17,155,"Illinois","Putnam County",5,3,36,20,16
050,17,155,"Illinois","Putnam County",5,4,44,20,24
050,17,155,"Illinois","Putnam County",5,5,60,26,34
050,17,155,"Illinois","Putnam County",5,6,58,26,32
050,17,155,"Illinois","Putnam County",5,7,63,30,33
050,17,155,"Illinois","Putnam County",5,8,57,29,28
050,17,155,"Illinois","Putnam County",5,9,59,28,31
050,17,155,"Illinois","Putnam County",5,10,62,35,27
050,17,155,"Illinois","Putnam County",5,11,64,34,30
050,17,155,"Illinois","Putnam County",5,12,72,38,34
050,17,155,"Illinois","Putnam County",5,13,56,25,31
050,17,155,"Illinois","Putnam County",5,14,71,40,31
050,17,155,"Illinois","Putnam County",5,15,65,43,22
050,17,155,"Illinois","Putnam County",5,16,71,44,27
050,17,155,"Illinois","Putnam County",5,17,75,39,36
050,17,155,"Illinois","Putnam County",5,18,57,28,29
050,17,155,"Illinois","Putnam County",5,19,51,28,23
050,17,155,"Illinois","Putnam County",5,20,48,26,22
050,17,155,"Illinois","Putnam County",5,21,48,24,24
050,17,155,"Illinois","Putnam County",5,22,59,25,34
050,17,155,"Illinois","Putnam County",5,23,59,28,31
050,17,155,"Illinois","Putnam County",5,24,51,29,22
050,17,155,"Illinois","Putnam County",5,25,61,34,27
050,17,155,"Illinois","Putnam County",5,26,52,32,20
050,17,155,"Illinois","Putnam County",5,27,49,25,24
050,17,155,"Illinois","Putnam County",5,28,50,27,23
050,17,155,"Illinois","Putnam County",5,29,58,28,30
050,17,155,"Illinois","Putnam County",5,30,71,39,32
050,17,155,"Illinois","Putnam County",5,31,53,29,24
050,17,155,"Illinois","Putnam County",5,32,64,32,32
050,17,155,"Illinois","Putnam County",5,33,65,38,27
050,17,155,"Illinois","Putnam County",5,34,61,27,34
050,17,155,"Illinois","Putnam County",5,35,59,28,31
050,17,155,"Illinois","Putnam County",5,36,62,35,27
050,17,155,"Illinois","Putnam County",5,37,64,34,30
050,17,155,"Illinois","Putnam County",5,38,65,33,32
050,17,155,"Illinois","Putnam County",5,39,66,30,36
050,17,155,"Illinois","Putnam County",5,40,72,34,38
050,17,155,"Illinois","Putnam County",5,41,65,33,32
050,17,155,"Illinois","Putnam County",5,42,57,30,27
050,17,155,"Illinois","Putnam County",5,43,75,45,30
050,17,155,"Illinois","Putnam County",5,44,75,42,33
050,17,155,"Illinois","Putnam County",5,45,69,35,34
050,17,155,"Illinois","Putnam County",5,46,62,36,26
050,17,155,"Illinois","Putnam County",5,47,54,25,29
050,17,155,"Illinois","Putnam County",5,48,59,32,27
050,17,155,"Illinois","Putnam County",5,49,53,25,28
050,17,155,"Illinois","Putnam County",5,50,44,24,20
050,17,155,"Illinois","Putnam County",5,51,56,27,29
050,17,155,"Illinois","Putnam County",5,52,75,40,35
050,17,155,"Illinois","Putnam County",5,53,79,41,38
050,17,155,"Illinois","Putnam County",5,54,75,38,37
050,17,155,"Illinois","Putnam County",5,55,63,33,30
050,17,155,"Illinois","Putnam County",5,56,69,34,35
050,17,155,"Illinois","Putnam County",5,57,75,36,39
050,17,155,"Illinois","Putnam County",5,58,78,36,42
050,17,155,"Illinois","Putnam County",5,59,89,45,44
050,17,155,"Illinois","Putnam County",5,60,87,44,43
050,17,155,"Illinois","Putnam County",5,61,90,50,40
050,17,155,"Illinois","Putnam County",5,62,95,52,43
050,17,155,"Illinois","Putnam County",5,63,93,45,48
050,17,155,"Illinois","Putnam County",5,64,95,47,48
050,17,155,"Illinois","Putnam County",5,65,99,49,50
050,17,155,"Illinois","Putnam County",5,66,91,49,42
050,17,155,"Illinois","Putnam County",5,67,84,43,41
050,17,155,"Illinois","Putnam County",5,68,79,47,32
050,17,155,"Illinois","Putnam County",5,69,75,39,36
050,17,155,"Illinois","Putnam County",5,70,75,38,37
050,17,155,"Illinois","Putnam County",5,71,83,49,34
050,17,155,"Illinois","Putnam County",5,72,94,53,41
050,17,155,"Illinois","Putnam County",5,73,80,38,42
050,17,155,"Illinois","Putnam County",5,74,70,35,35
050,17,155,"Illinois","Putnam County",5,75,70,33,37
050,17,155,"Illinois","Putnam County",5,76,66,35,31
050,17,155,"Illinois","Putnam County",5,77,45,16,29
050,17,155,"Illinois","Putnam County",5,78,36,16,20
050,17,155,"Illinois","Putnam County",5,79,50,28,22
050,17,155,"Illinois","Putnam County",5,80,45,24,21
050,17,155,"Illinois","Putnam County",5,81,40,19,21
050,17,155,"Illinois","Putnam County",5,82,30,13,17
050,17,155,"Illinois","Putnam County",5,83,26,15,11
050,17,155,"Illinois","Putnam County",5,84,28,12,16
050,17,155,"Illinois","Putnam County",5,85,154,62,92
050,17,157,"Illinois","Randolph County",1,0,292,152,140
050,17,157,"Illinois","Randolph County",1,1,301,153,148
050,17,157,"Illinois","Randolph County",1,2,317,154,163
050,17,157,"Illinois","Randolph County",1,3,361,180,181
050,17,157,"Illinois","Randolph County",1,4,331,158,173
050,17,157,"Illinois","Randolph County",1,5,313,150,163
050,17,157,"Illinois","Randolph County",1,6,328,174,154
050,17,157,"Illinois","Randolph County",1,7,335,179,156
050,17,157,"Illinois","Randolph County",1,8,325,167,158
050,17,157,"Illinois","Randolph County",1,9,336,174,162
050,17,157,"Illinois","Randolph County",1,10,354,177,177
050,17,157,"Illinois","Randolph County",1,11,342,153,189
050,17,157,"Illinois","Randolph County",1,12,366,193,173
050,17,157,"Illinois","Randolph County",1,13,341,186,155
050,17,157,"Illinois","Randolph County",1,14,347,182,165
050,17,157,"Illinois","Randolph County",1,15,375,197,178
050,17,157,"Illinois","Randolph County",1,16,371,187,184
050,17,157,"Illinois","Randolph County",1,17,367,187,180
050,17,157,"Illinois","Randolph County",1,18,311,168,143
050,17,157,"Illinois","Randolph County",1,19,258,151,107
050,17,157,"Illinois","Randolph County",1,20,303,170,133
050,17,157,"Illinois","Randolph County",1,21,307,175,132
050,17,157,"Illinois","Randolph County",1,22,338,207,131
050,17,157,"Illinois","Randolph County",1,23,340,209,131
050,17,157,"Illinois","Randolph County",1,24,326,189,137
050,17,157,"Illinois","Randolph County",1,25,356,206,150
050,17,157,"Illinois","Randolph County",1,26,359,221,138
050,17,157,"Illinois","Randolph County",1,27,356,215,141
050,17,157,"Illinois","Randolph County",1,28,372,215,157
050,17,157,"Illinois","Randolph County",1,29,401,235,166
050,17,157,"Illinois","Randolph County",1,30,376,221,155
050,17,157,"Illinois","Randolph County",1,31,389,237,152
050,17,157,"Illinois","Randolph County",1,32,369,222,147
050,17,157,"Illinois","Randolph County",1,33,377,244,133
050,17,157,"Illinois","Randolph County",1,34,383,233,150
050,17,157,"Illinois","Randolph County",1,35,378,224,154
050,17,157,"Illinois","Randolph County",1,36,381,221,160
050,17,157,"Illinois","Randolph County",1,37,404,233,171
050,17,157,"Illinois","Randolph County",1,38,404,237,167
050,17,157,"Illinois","Randolph County",1,39,389,219,170
050,17,157,"Illinois","Randolph County",1,40,380,213,167
050,17,157,"Illinois","Randolph County",1,41,378,219,159
050,17,157,"Illinois","Randolph County",1,42,390,222,168
050,17,157,"Illinois","Randolph County",1,43,363,197,166
050,17,157,"Illinois","Randolph County",1,44,355,209,146
050,17,157,"Illinois","Randolph County",1,45,352,204,148
050,17,157,"Illinois","Randolph County",1,46,349,186,163
050,17,157,"Illinois","Randolph County",1,47,360,199,161
050,17,157,"Illinois","Randolph County",1,48,417,239,178
050,17,157,"Illinois","Randolph County",1,49,390,219,171
050,17,157,"Illinois","Randolph County",1,50,357,204,153
050,17,157,"Illinois","Randolph County",1,51,358,212,146
050,17,157,"Illinois","Randolph County",1,52,353,194,159
050,17,157,"Illinois","Randolph County",1,53,381,209,172
050,17,157,"Illinois","Randolph County",1,54,404,227,177
050,17,157,"Illinois","Randolph County",1,55,416,223,193
050,17,157,"Illinois","Randolph County",1,56,455,250,205
050,17,157,"Illinois","Randolph County",1,57,450,249,201
050,17,157,"Illinois","Randolph County",1,58,493,268,225
050,17,157,"Illinois","Randolph County",1,59,471,253,218
050,17,157,"Illinois","Randolph County",1,60,459,244,215
050,17,157,"Illinois","Randolph County",1,61,423,222,201
050,17,157,"Illinois","Randolph County",1,62,462,243,219
050,17,157,"Illinois","Randolph County",1,63,440,224,216
050,17,157,"Illinois","Randolph County",1,64,418,207,211
050,17,157,"Illinois","Randolph County",1,65,410,206,204
050,17,157,"Illinois","Randolph County",1,66,427,220,207
050,17,157,"Illinois","Randolph County",1,67,396,202,194
050,17,157,"Illinois","Randolph County",1,68,377,186,191
050,17,157,"Illinois","Randolph County",1,69,326,156,170
050,17,157,"Illinois","Randolph County",1,70,322,146,176
050,17,157,"Illinois","Randolph County",1,71,294,146,148
050,17,157,"Illinois","Randolph County",1,72,299,144,155
050,17,157,"Illinois","Randolph County",1,73,311,140,171
050,17,157,"Illinois","Randolph County",1,74,221,96,125
050,17,157,"Illinois","Randolph County",1,75,244,109,135
050,17,157,"Illinois","Randolph County",1,76,225,103,122
050,17,157,"Illinois","Randolph County",1,77,217,93,124
050,17,157,"Illinois","Randolph County",1,78,216,87,129
050,17,157,"Illinois","Randolph County",1,79,200,81,119
050,17,157,"Illinois","Randolph County",1,80,162,67,95
050,17,157,"Illinois","Randolph County",1,81,155,61,94
050,17,157,"Illinois","Randolph County",1,82,149,56,93
050,17,157,"Illinois","Randolph County",1,83,142,55,87
050,17,157,"Illinois","Randolph County",1,84,129,44,85
050,17,157,"Illinois","Randolph County",1,85,889,274,615
050,17,157,"Illinois","Randolph County",2,0,310,156,154
050,17,157,"Illinois","Randolph County",2,1,295,150,145
050,17,157,"Illinois","Randolph County",2,2,312,154,158
050,17,157,"Illinois","Randolph County",2,3,344,170,174
050,17,157,"Illinois","Randolph County",2,4,337,163,174
050,17,157,"Illinois","Randolph County",2,5,317,153,164
050,17,157,"Illinois","Randolph County",2,6,326,169,157
050,17,157,"Illinois","Randolph County",2,7,333,178,155
050,17,157,"Illinois","Randolph County",2,8,326,170,156
050,17,157,"Illinois","Randolph County",2,9,331,170,161
050,17,157,"Illinois","Randolph County",2,10,350,175,175
050,17,157,"Illinois","Randolph County",2,11,342,156,186
050,17,157,"Illinois","Randolph County",2,12,362,184,178
050,17,157,"Illinois","Randolph County",2,13,346,188,158
050,17,157,"Illinois","Randolph County",2,14,348,185,163
050,17,157,"Illinois","Randolph County",2,15,368,193,175
050,17,157,"Illinois","Randolph County",2,16,372,189,183
050,17,157,"Illinois","Randolph County",2,17,371,190,181
050,17,157,"Illinois","Randolph County",2,18,308,167,141
050,17,157,"Illinois","Randolph County",2,19,262,153,109
050,17,157,"Illinois","Randolph County",2,20,303,173,130
050,17,157,"Illinois","Randolph County",2,21,308,175,133
050,17,157,"Illinois","Randolph County",2,22,335,204,131
050,17,157,"Illinois","Randolph County",2,23,340,210,130
050,17,157,"Illinois","Randolph County",2,24,328,194,134
050,17,157,"Illinois","Randolph County",2,25,348,202,146
050,17,157,"Illinois","Randolph County",2,26,361,221,140
050,17,157,"Illinois","Randolph County",2,27,353,215,138
050,17,157,"Illinois","Randolph County",2,28,372,218,154
050,17,157,"Illinois","Randolph County",2,29,396,231,165
050,17,157,"Illinois","Randolph County",2,30,380,221,159
050,17,157,"Illinois","Randolph County",2,31,385,233,152
050,17,157,"Illinois","Randolph County",2,32,369,222,147
050,17,157,"Illinois","Randolph County",2,33,377,243,134
050,17,157,"Illinois","Randolph County",2,34,374,231,143
050,17,157,"Illinois","Randolph County",2,35,377,223,154
050,17,157,"Illinois","Randolph County",2,36,378,220,158
050,17,157,"Illinois","Randolph County",2,37,400,231,169
050,17,157,"Illinois","Randolph County",2,38,405,238,167
050,17,157,"Illinois","Randolph County",2,39,391,221,170
050,17,157,"Illinois","Randolph County",2,40,385,217,168
050,17,157,"Illinois","Randolph County",2,41,379,216,163
050,17,157,"Illinois","Randolph County",2,42,384,220,164
050,17,157,"Illinois","Randolph County",2,43,368,202,166
050,17,157,"Illinois","Randolph County",2,44,356,206,150
050,17,157,"Illinois","Randolph County",2,45,352,204,148
050,17,157,"Illinois","Randolph County",2,46,348,189,159
050,17,157,"Illinois","Randolph County",2,47,353,195,158
050,17,157,"Illinois","Randolph County",2,48,406,233,173
050,17,157,"Illinois","Randolph County",2,49,389,218,171
050,17,157,"Illinois","Randolph County",2,50,365,206,159
050,17,157,"Illinois","Randolph County",2,51,352,205,147
050,17,157,"Illinois","Randolph County",2,52,356,199,157
050,17,157,"Illinois","Randolph County",2,53,370,203,167
050,17,157,"Illinois","Randolph County",2,54,396,223,173
050,17,157,"Illinois","Randolph County",2,55,409,220,189
050,17,157,"Illinois","Randolph County",2,56,450,245,205
050,17,157,"Illinois","Randolph County",2,57,450,247,203
050,17,157,"Illinois","Randolph County",2,58,482,264,218
050,17,157,"Illinois","Randolph County",2,59,471,252,219
050,17,157,"Illinois","Randolph County",2,60,461,246,215
050,17,157,"Illinois","Randolph County",2,61,428,225,203
050,17,157,"Illinois","Randolph County",2,62,453,239,214
050,17,157,"Illinois","Randolph County",2,63,449,231,218
050,17,157,"Illinois","Randolph County",2,64,417,207,210
050,17,157,"Illinois","Randolph County",2,65,408,205,203
050,17,157,"Illinois","Randolph County",2,66,425,216,209
050,17,157,"Illinois","Randolph County",2,67,399,205,194
050,17,157,"Illinois","Randolph County",2,68,378,189,189
050,17,157,"Illinois","Randolph County",2,69,339,164,175
050,17,157,"Illinois","Randolph County",2,70,322,148,174
050,17,157,"Illinois","Randolph County",2,71,298,145,153
050,17,157,"Illinois","Randolph County",2,72,288,136,152
050,17,157,"Illinois","Randolph County",2,73,324,147,177
050,17,157,"Illinois","Randolph County",2,74,224,99,125
050,17,157,"Illinois","Randolph County",2,75,239,106,133
050,17,157,"Illinois","Randolph County",2,76,223,102,121
050,17,157,"Illinois","Randolph County",2,77,220,96,124
050,17,157,"Illinois","Randolph County",2,78,213,83,130
050,17,157,"Illinois","Randolph County",2,79,196,81,115
050,17,157,"Illinois","Randolph County",2,80,165,68,97
050,17,157,"Illinois","Randolph County",2,81,156,60,96
050,17,157,"Illinois","Randolph County",2,82,151,56,95
050,17,157,"Illinois","Randolph County",2,83,140,55,85
050,17,157,"Illinois","Randolph County",2,84,126,42,84
050,17,157,"Illinois","Randolph County",2,85,887,274,613
050,17,157,"Illinois","Randolph County",3,0,298,160,138
050,17,157,"Illinois","Randolph County",3,1,310,159,151
050,17,157,"Illinois","Randolph County",3,2,293,151,142
050,17,157,"Illinois","Randolph County",3,3,319,159,160
050,17,157,"Illinois","Randolph County",3,4,342,168,174
050,17,157,"Illinois","Randolph County",3,5,351,170,181
050,17,157,"Illinois","Randolph County",3,6,330,161,169
050,17,157,"Illinois","Randolph County",3,7,325,161,164
050,17,157,"Illinois","Randolph County",3,8,352,189,163
050,17,157,"Illinois","Randolph County",3,9,332,177,155
050,17,157,"Illinois","Randolph County",3,10,334,170,164
050,17,157,"Illinois","Randolph County",3,11,338,171,167
050,17,157,"Illinois","Randolph County",3,12,343,162,181
050,17,157,"Illinois","Randolph County",3,13,381,194,187
050,17,157,"Illinois","Randolph County",3,14,353,193,160
050,17,157,"Illinois","Randolph County",3,15,333,182,151
050,17,157,"Illinois","Randolph County",3,16,369,198,171
050,17,157,"Illinois","Randolph County",3,17,381,196,185
050,17,157,"Illinois","Randolph County",3,18,324,173,151
050,17,157,"Illinois","Randolph County",3,19,257,153,104
050,17,157,"Illinois","Randolph County",3,20,286,176,110
050,17,157,"Illinois","Randolph County",3,21,321,178,143
050,17,157,"Illinois","Randolph County",3,22,344,199,145
050,17,157,"Illinois","Randolph County",3,23,347,219,128
050,17,157,"Illinois","Randolph County",3,24,337,212,125
050,17,157,"Illinois","Randolph County",3,25,329,200,129
050,17,157,"Illinois","Randolph County",3,26,370,228,142
050,17,157,"Illinois","Randolph County",3,27,364,221,143
050,17,157,"Illinois","Randolph County",3,28,391,245,146
050,17,157,"Illinois","Randolph County",3,29,398,241,157
050,17,157,"Illinois","Randolph County",3,30,395,231,164
050,17,157,"Illinois","Randolph County",3,31,402,245,157
050,17,157,"Illinois","Randolph County",3,32,373,224,149
050,17,157,"Illinois","Randolph County",3,33,414,257,157
050,17,157,"Illinois","Randolph County",3,34,365,233,132
050,17,157,"Illinois","Randolph County",3,35,355,216,139
050,17,157,"Illinois","Randolph County",3,36,393,239,154
050,17,157,"Illinois","Randolph County",3,37,379,222,157
050,17,157,"Illinois","Randolph County",3,38,407,237,170
050,17,157,"Illinois","Randolph County",3,39,415,249,166
050,17,157,"Illinois","Randolph County",3,40,398,227,171
050,17,157,"Illinois","Randolph County",3,41,401,231,170
050,17,157,"Illinois","Randolph County",3,42,392,226,166
050,17,157,"Illinois","Randolph County",3,43,384,221,163
050,17,157,"Illinois","Randolph County",3,44,383,212,171
050,17,157,"Illinois","Randolph County",3,45,337,195,142
050,17,157,"Illinois","Randolph County",3,46,351,206,145
050,17,157,"Illinois","Randolph County",3,47,345,189,156
050,17,157,"Illinois","Randolph County",3,48,380,216,164
050,17,157,"Illinois","Randolph County",3,49,380,219,161
050,17,157,"Illinois","Randolph County",3,50,388,214,174
050,17,157,"Illinois","Randolph County",3,51,354,201,153
050,17,157,"Illinois","Randolph County",3,52,360,210,150
050,17,157,"Illinois","Randolph County",3,53,352,201,151
050,17,157,"Illinois","Randolph County",3,54,382,217,165
050,17,157,"Illinois","Randolph County",3,55,383,214,169
050,17,157,"Illinois","Randolph County",3,56,421,228,193
050,17,157,"Illinois","Randolph County",3,57,441,238,203
050,17,157,"Illinois","Randolph County",3,58,455,253,202
050,17,157,"Illinois","Randolph County",3,59,455,253,202
050,17,157,"Illinois","Randolph County",3,60,467,251,216
050,17,157,"Illinois","Randolph County",3,61,447,236,211
050,17,157,"Illinois","Randolph County",3,62,430,227,203
050,17,157,"Illinois","Randolph County",3,63,442,234,208
050,17,157,"Illinois","Randolph County",3,64,441,224,217
050,17,157,"Illinois","Randolph County",3,65,397,196,201
050,17,157,"Illinois","Randolph County",3,66,405,202,203
050,17,157,"Illinois","Randolph County",3,67,410,210,200
050,17,157,"Illinois","Randolph County",3,68,392,195,197
050,17,157,"Illinois","Randolph County",3,69,360,180,180
050,17,157,"Illinois","Randolph County",3,70,330,159,171
050,17,157,"Illinois","Randolph County",3,71,301,139,162
050,17,157,"Illinois","Randolph County",3,72,293,137,156
050,17,157,"Illinois","Randolph County",3,73,291,131,160
050,17,157,"Illinois","Randolph County",3,74,313,142,171
050,17,157,"Illinois","Randolph County",3,75,214,93,121
050,17,157,"Illinois","Randolph County",3,76,222,104,118
050,17,157,"Illinois","Randolph County",3,77,203,93,110
050,17,157,"Illinois","Randolph County",3,78,234,90,144
050,17,157,"Illinois","Randolph County",3,79,195,77,118
050,17,157,"Illinois","Randolph County",3,80,180,83,97
050,17,157,"Illinois","Randolph County",3,81,163,62,101
050,17,157,"Illinois","Randolph County",3,82,152,51,101
050,17,157,"Illinois","Randolph County",3,83,135,53,82
050,17,157,"Illinois","Randolph County",3,84,117,42,75
050,17,157,"Illinois","Randolph County",3,85,878,266,612
050,17,157,"Illinois","Randolph County",4,0,286,154,132
050,17,157,"Illinois","Randolph County",4,1,291,159,132
050,17,157,"Illinois","Randolph County",4,2,328,162,166
050,17,157,"Illinois","Randolph County",4,3,299,152,147
050,17,157,"Illinois","Randolph County",4,4,340,166,174
050,17,157,"Illinois","Randolph County",4,5,347,169,178
050,17,157,"Illinois","Randolph County",4,6,356,172,184
050,17,157,"Illinois","Randolph County",4,7,327,164,163
050,17,157,"Illinois","Randolph County",4,8,330,170,160
050,17,157,"Illinois","Randolph County",4,9,355,188,167
050,17,157,"Illinois","Randolph County",4,10,315,169,146
050,17,157,"Illinois","Randolph County",4,11,334,171,163
050,17,157,"Illinois","Randolph County",4,12,339,174,165
050,17,157,"Illinois","Randolph County",4,13,343,160,183
050,17,157,"Illinois","Randolph County",4,14,381,191,190
050,17,157,"Illinois","Randolph County",4,15,345,191,154
050,17,157,"Illinois","Randolph County",4,16,340,188,152
050,17,157,"Illinois","Randolph County",4,17,379,205,174
050,17,157,"Illinois","Randolph County",4,18,333,187,146
050,17,157,"Illinois","Randolph County",4,19,275,160,115
050,17,157,"Illinois","Randolph County",4,20,293,173,120
050,17,157,"Illinois","Randolph County",4,21,311,189,122
050,17,157,"Illinois","Randolph County",4,22,351,201,150
050,17,157,"Illinois","Randolph County",4,23,358,205,153
050,17,157,"Illinois","Randolph County",4,24,347,210,137
050,17,157,"Illinois","Randolph County",4,25,335,212,123
050,17,157,"Illinois","Randolph County",4,26,333,212,121
050,17,157,"Illinois","Randolph County",4,27,374,224,150
050,17,157,"Illinois","Randolph County",4,28,366,217,149
050,17,157,"Illinois","Randolph County",4,29,382,241,141
050,17,157,"Illinois","Randolph County",4,30,373,212,161
050,17,157,"Illinois","Randolph County",4,31,406,235,171
050,17,157,"Illinois","Randolph County",4,32,379,219,160
050,17,157,"Illinois","Randolph County",4,33,404,246,158
050,17,157,"Illinois","Randolph County",4,34,409,250,159
050,17,157,"Illinois","Randolph County",4,35,343,215,128
050,17,157,"Illinois","Randolph County",4,36,358,217,141
050,17,157,"Illinois","Randolph County",4,37,395,240,155
050,17,157,"Illinois","Randolph County",4,38,367,212,155
050,17,157,"Illinois","Randolph County",4,39,394,224,170
050,17,157,"Illinois","Randolph County",4,40,404,241,163
050,17,157,"Illinois","Randolph County",4,41,382,214,168
050,17,157,"Illinois","Randolph County",4,42,393,224,169
050,17,157,"Illinois","Randolph County",4,43,386,221,165
050,17,157,"Illinois","Randolph County",4,44,391,226,165
050,17,157,"Illinois","Randolph County",4,45,373,208,165
050,17,157,"Illinois","Randolph County",4,46,330,191,139
050,17,157,"Illinois","Randolph County",4,47,340,198,142
050,17,157,"Illinois","Randolph County",4,48,366,206,160
050,17,157,"Illinois","Randolph County",4,49,351,193,158
050,17,157,"Illinois","Randolph County",4,50,373,209,164
050,17,157,"Illinois","Randolph County",4,51,377,209,168
050,17,157,"Illinois","Randolph County",4,52,364,198,166
050,17,157,"Illinois","Randolph County",4,53,353,205,148
050,17,157,"Illinois","Randolph County",4,54,356,205,151
050,17,157,"Illinois","Randolph County",4,55,378,205,173
050,17,157,"Illinois","Randolph County",4,56,384,214,170
050,17,157,"Illinois","Randolph County",4,57,410,218,192
050,17,157,"Illinois","Randolph County",4,58,455,248,207
050,17,157,"Illinois","Randolph County",4,59,431,235,196
050,17,157,"Illinois","Randolph County",4,60,460,256,204
050,17,157,"Illinois","Randolph County",4,61,443,234,209
050,17,157,"Illinois","Randolph County",4,62,448,235,213
050,17,157,"Illinois","Randolph County",4,63,426,223,203
050,17,157,"Illinois","Randolph County",4,64,434,229,205
050,17,157,"Illinois","Randolph County",4,65,430,211,219
050,17,157,"Illinois","Randolph County",4,66,386,190,196
050,17,157,"Illinois","Randolph County",4,67,383,198,185
050,17,157,"Illinois","Randolph County",4,68,400,202,198
050,17,157,"Illinois","Randolph County",4,69,373,190,183
050,17,157,"Illinois","Randolph County",4,70,352,176,176
050,17,157,"Illinois","Randolph County",4,71,316,152,164
050,17,157,"Illinois","Randolph County",4,72,291,133,158
050,17,157,"Illinois","Randolph County",4,73,297,135,162
050,17,157,"Illinois","Randolph County",4,74,282,127,155
050,17,157,"Illinois","Randolph County",4,75,308,139,169
050,17,157,"Illinois","Randolph County",4,76,200,89,111
050,17,157,"Illinois","Randolph County",4,77,211,98,113
050,17,157,"Illinois","Randolph County",4,78,216,91,125
050,17,157,"Illinois","Randolph County",4,79,210,83,127
050,17,157,"Illinois","Randolph County",4,80,173,69,104
050,17,157,"Illinois","Randolph County",4,81,176,73,103
050,17,157,"Illinois","Randolph County",4,82,160,51,109
050,17,157,"Illinois","Randolph County",4,83,138,44,94
050,17,157,"Illinois","Randolph County",4,84,121,43,78
050,17,157,"Illinois","Randolph County",4,85,874,273,601
050,17,157,"Illinois","Randolph County",5,0,249,133,116
050,17,157,"Illinois","Randolph County",5,1,295,156,139
050,17,157,"Illinois","Randolph County",5,2,289,161,128
050,17,157,"Illinois","Randolph County",5,3,325,159,166
050,17,157,"Illinois","Randolph County",5,4,320,155,165
050,17,157,"Illinois","Randolph County",5,5,345,165,180
050,17,157,"Illinois","Randolph County",5,6,346,171,175
050,17,157,"Illinois","Randolph County",5,7,348,175,173
050,17,157,"Illinois","Randolph County",5,8,330,164,166
050,17,157,"Illinois","Randolph County",5,9,334,167,167
050,17,157,"Illinois","Randolph County",5,10,344,184,160
050,17,157,"Illinois","Randolph County",5,11,315,172,143
050,17,157,"Illinois","Randolph County",5,12,338,169,169
050,17,157,"Illinois","Randolph County",5,13,331,164,167
050,17,157,"Illinois","Randolph County",5,14,348,165,183
050,17,157,"Illinois","Randolph County",5,15,379,196,183
050,17,157,"Illinois","Randolph County",5,16,346,192,154
050,17,157,"Illinois","Randolph County",5,17,343,194,149
050,17,157,"Illinois","Randolph County",5,18,314,180,134
050,17,157,"Illinois","Randolph County",5,19,281,172,109
050,17,157,"Illinois","Randolph County",5,20,317,195,122
050,17,157,"Illinois","Randolph County",5,21,314,188,126
050,17,157,"Illinois","Randolph County",5,22,332,204,128
050,17,157,"Illinois","Randolph County",5,23,356,202,154
050,17,157,"Illinois","Randolph County",5,24,365,215,150
050,17,157,"Illinois","Randolph County",5,25,351,220,131
050,17,157,"Illinois","Randolph County",5,26,361,239,122
050,17,157,"Illinois","Randolph County",5,27,328,207,121
050,17,157,"Illinois","Randolph County",5,28,374,232,142
050,17,157,"Illinois","Randolph County",5,29,364,218,146
050,17,157,"Illinois","Randolph County",5,30,362,218,144
050,17,157,"Illinois","Randolph County",5,31,369,213,156
050,17,157,"Illinois","Randolph County",5,32,383,209,174
050,17,157,"Illinois","Randolph County",5,33,408,242,166
050,17,157,"Illinois","Randolph County",5,34,388,232,156
050,17,157,"Illinois","Randolph County",5,35,400,237,163
050,17,157,"Illinois","Randolph County",5,36,341,215,126
050,17,157,"Illinois","Randolph County",5,37,364,225,139
050,17,157,"Illinois","Randolph County",5,38,390,234,156
050,17,157,"Illinois","Randolph County",5,39,353,203,150
050,17,157,"Illinois","Randolph County",5,40,391,222,169
050,17,157,"Illinois","Randolph County",5,41,390,231,159
050,17,157,"Illinois","Randolph County",5,42,398,220,178
050,17,157,"Illinois","Randolph County",5,43,374,208,166
050,17,157,"Illinois","Randolph County",5,44,398,230,168
050,17,157,"Illinois","Randolph County",5,45,372,216,156
050,17,157,"Illinois","Randolph County",5,46,356,197,159
050,17,157,"Illinois","Randolph County",5,47,324,185,139
050,17,157,"Illinois","Randolph County",5,48,368,217,151
050,17,157,"Illinois","Randolph County",5,49,339,189,150
050,17,157,"Illinois","Randolph County",5,50,352,190,162
050,17,157,"Illinois","Randolph County",5,51,355,202,153
050,17,157,"Illinois","Randolph County",5,52,385,213,172
050,17,157,"Illinois","Randolph County",5,53,363,197,166
050,17,157,"Illinois","Randolph County",5,54,355,212,143
050,17,157,"Illinois","Randolph County",5,55,345,193,152
050,17,157,"Illinois","Randolph County",5,56,377,201,176
050,17,157,"Illinois","Randolph County",5,57,384,208,176
050,17,157,"Illinois","Randolph County",5,58,411,219,192
050,17,157,"Illinois","Randolph County",5,59,433,231,202
050,17,157,"Illinois","Randolph County",5,60,436,239,197
050,17,157,"Illinois","Randolph County",5,61,445,243,202
050,17,157,"Illinois","Randolph County",5,62,440,231,209
050,17,157,"Illinois","Randolph County",5,63,435,230,205
050,17,157,"Illinois","Randolph County",5,64,416,212,204
050,17,157,"Illinois","Randolph County",5,65,427,223,204
050,17,157,"Illinois","Randolph County",5,66,423,206,217
050,17,157,"Illinois","Randolph County",5,67,374,186,188
050,17,157,"Illinois","Randolph County",5,68,380,195,185
050,17,157,"Illinois","Randolph County",5,69,388,201,187
050,17,157,"Illinois","Randolph County",5,70,370,190,180
050,17,157,"Illinois","Randolph County",5,71,336,168,168
050,17,157,"Illinois","Randolph County",5,72,311,144,167
050,17,157,"Illinois","Randolph County",5,73,296,131,165
050,17,157,"Illinois","Randolph County",5,74,290,134,156
050,17,157,"Illinois","Randolph County",5,75,271,123,148
050,17,157,"Illinois","Randolph County",5,76,285,129,156
050,17,157,"Illinois","Randolph County",5,77,187,82,105
050,17,157,"Illinois","Randolph County",5,78,231,97,134
050,17,157,"Illinois","Randolph County",5,79,194,82,112
050,17,157,"Illinois","Randolph County",5,80,185,77,108
050,17,157,"Illinois","Randolph County",5,81,167,61,106
050,17,157,"Illinois","Randolph County",5,82,168,62,106
050,17,157,"Illinois","Randolph County",5,83,145,46,99
050,17,157,"Illinois","Randolph County",5,84,125,34,91
050,17,157,"Illinois","Randolph County",5,85,880,284,596
050,17,159,"Illinois","Richland County",1,0,170,88,82
050,17,159,"Illinois","Richland County",1,1,176,85,91
050,17,159,"Illinois","Richland County",1,2,185,91,94
050,17,159,"Illinois","Richland County",1,3,207,101,106
050,17,159,"Illinois","Richland County",1,4,212,104,108
050,17,159,"Illinois","Richland County",1,5,216,107,109
050,17,159,"Illinois","Richland County",1,6,210,114,96
050,17,159,"Illinois","Richland County",1,7,203,104,99
050,17,159,"Illinois","Richland County",1,8,196,90,106
050,17,159,"Illinois","Richland County",1,9,201,108,93
050,17,159,"Illinois","Richland County",1,10,197,119,78
050,17,159,"Illinois","Richland County",1,11,208,113,95
050,17,159,"Illinois","Richland County",1,12,204,112,92
050,17,159,"Illinois","Richland County",1,13,204,102,102
050,17,159,"Illinois","Richland County",1,14,206,106,100
050,17,159,"Illinois","Richland County",1,15,216,111,105
050,17,159,"Illinois","Richland County",1,16,221,116,105
050,17,159,"Illinois","Richland County",1,17,212,118,94
050,17,159,"Illinois","Richland County",1,18,179,103,76
050,17,159,"Illinois","Richland County",1,19,133,69,64
050,17,159,"Illinois","Richland County",1,20,133,68,65
050,17,159,"Illinois","Richland County",1,21,150,79,71
050,17,159,"Illinois","Richland County",1,22,153,79,74
050,17,159,"Illinois","Richland County",1,23,144,72,72
050,17,159,"Illinois","Richland County",1,24,145,75,70
050,17,159,"Illinois","Richland County",1,25,161,80,81
050,17,159,"Illinois","Richland County",1,26,167,82,85
050,17,159,"Illinois","Richland County",1,27,184,85,99
050,17,159,"Illinois","Richland County",1,28,213,109,104
050,17,159,"Illinois","Richland County",1,29,188,99,89
050,17,159,"Illinois","Richland County",1,30,205,102,103
050,17,159,"Illinois","Richland County",1,31,188,104,84
050,17,159,"Illinois","Richland County",1,32,166,82,84
050,17,159,"Illinois","Richland County",1,33,176,82,94
050,17,159,"Illinois","Richland County",1,34,205,98,107
050,17,159,"Illinois","Richland County",1,35,205,102,103
050,17,159,"Illinois","Richland County",1,36,180,87,93
050,17,159,"Illinois","Richland County",1,37,191,93,98
050,17,159,"Illinois","Richland County",1,38,181,94,87
050,17,159,"Illinois","Richland County",1,39,187,95,92
050,17,159,"Illinois","Richland County",1,40,181,90,91
050,17,159,"Illinois","Richland County",1,41,208,109,99
050,17,159,"Illinois","Richland County",1,42,190,96,94
050,17,159,"Illinois","Richland County",1,43,173,96,77
050,17,159,"Illinois","Richland County",1,44,164,83,81
050,17,159,"Illinois","Richland County",1,45,197,99,98
050,17,159,"Illinois","Richland County",1,46,173,89,84
050,17,159,"Illinois","Richland County",1,47,173,83,90
050,17,159,"Illinois","Richland County",1,48,181,82,99
050,17,159,"Illinois","Richland County",1,49,200,104,96
050,17,159,"Illinois","Richland County",1,50,193,97,96
050,17,159,"Illinois","Richland County",1,51,189,99,90
050,17,159,"Illinois","Richland County",1,52,172,92,80
050,17,159,"Illinois","Richland County",1,53,184,95,89
050,17,159,"Illinois","Richland County",1,54,196,95,101
050,17,159,"Illinois","Richland County",1,55,224,104,120
050,17,159,"Illinois","Richland County",1,56,226,114,112
050,17,159,"Illinois","Richland County",1,57,232,117,115
050,17,159,"Illinois","Richland County",1,58,232,115,117
050,17,159,"Illinois","Richland County",1,59,243,122,121
050,17,159,"Illinois","Richland County",1,60,241,123,118
050,17,159,"Illinois","Richland County",1,61,221,100,121
050,17,159,"Illinois","Richland County",1,62,240,111,129
050,17,159,"Illinois","Richland County",1,63,241,126,115
050,17,159,"Illinois","Richland County",1,64,234,115,119
050,17,159,"Illinois","Richland County",1,65,217,106,111
050,17,159,"Illinois","Richland County",1,66,198,107,91
050,17,159,"Illinois","Richland County",1,67,190,93,97
050,17,159,"Illinois","Richland County",1,68,185,86,99
050,17,159,"Illinois","Richland County",1,69,189,92,97
050,17,159,"Illinois","Richland County",1,70,167,77,90
050,17,159,"Illinois","Richland County",1,71,154,72,82
050,17,159,"Illinois","Richland County",1,72,154,81,73
050,17,159,"Illinois","Richland County",1,73,145,70,75
050,17,159,"Illinois","Richland County",1,74,112,49,63
050,17,159,"Illinois","Richland County",1,75,121,55,66
050,17,159,"Illinois","Richland County",1,76,122,57,65
050,17,159,"Illinois","Richland County",1,77,122,53,69
050,17,159,"Illinois","Richland County",1,78,104,47,57
050,17,159,"Illinois","Richland County",1,79,109,53,56
050,17,159,"Illinois","Richland County",1,80,118,55,63
050,17,159,"Illinois","Richland County",1,81,104,46,58
050,17,159,"Illinois","Richland County",1,82,78,30,48
050,17,159,"Illinois","Richland County",1,83,92,37,55
050,17,159,"Illinois","Richland County",1,84,68,34,34
050,17,159,"Illinois","Richland County",1,85,476,157,319
050,17,159,"Illinois","Richland County",2,0,163,82,81
050,17,159,"Illinois","Richland County",2,1,174,85,89
050,17,159,"Illinois","Richland County",2,2,183,90,93
050,17,159,"Illinois","Richland County",2,3,201,99,102
050,17,159,"Illinois","Richland County",2,4,213,105,108
050,17,159,"Illinois","Richland County",2,5,217,108,109
050,17,159,"Illinois","Richland County",2,6,212,113,99
050,17,159,"Illinois","Richland County",2,7,204,105,99
050,17,159,"Illinois","Richland County",2,8,198,94,104
050,17,159,"Illinois","Richland County",2,9,199,103,96
050,17,159,"Illinois","Richland County",2,10,199,117,82
050,17,159,"Illinois","Richland County",2,11,203,113,90
050,17,159,"Illinois","Richland County",2,12,208,114,94
050,17,159,"Illinois","Richland County",2,13,205,105,100
050,17,159,"Illinois","Richland County",2,14,209,105,104
050,17,159,"Illinois","Richland County",2,15,214,110,104
050,17,159,"Illinois","Richland County",2,16,221,115,106
050,17,159,"Illinois","Richland County",2,17,217,120,97
050,17,159,"Illinois","Richland County",2,18,179,103,76
050,17,159,"Illinois","Richland County",2,19,134,72,62
050,17,159,"Illinois","Richland County",2,20,137,71,66
050,17,159,"Illinois","Richland County",2,21,147,77,70
050,17,159,"Illinois","Richland County",2,22,153,79,74
050,17,159,"Illinois","Richland County",2,23,147,75,72
050,17,159,"Illinois","Richland County",2,24,146,76,70
050,17,159,"Illinois","Richland County",2,25,158,80,78
050,17,159,"Illinois","Richland County",2,26,164,81,83
050,17,159,"Illinois","Richland County",2,27,178,84,94
050,17,159,"Illinois","Richland County",2,28,208,104,104
050,17,159,"Illinois","Richland County",2,29,193,100,93
050,17,159,"Illinois","Richland County",2,30,204,103,101
050,17,159,"Illinois","Richland County",2,31,194,104,90
050,17,159,"Illinois","Richland County",2,32,174,88,86
050,17,159,"Illinois","Richland County",2,33,173,82,91
050,17,159,"Illinois","Richland County",2,34,196,94,102
050,17,159,"Illinois","Richland County",2,35,206,102,104
050,17,159,"Illinois","Richland County",2,36,185,91,94
050,17,159,"Illinois","Richland County",2,37,189,92,97
050,17,159,"Illinois","Richland County",2,38,185,95,90
050,17,159,"Illinois","Richland County",2,39,187,95,92
050,17,159,"Illinois","Richland County",2,40,185,92,93
050,17,159,"Illinois","Richland County",2,41,201,104,97
050,17,159,"Illinois","Richland County",2,42,190,96,94
050,17,159,"Illinois","Richland County",2,43,176,95,81
050,17,159,"Illinois","Richland County",2,44,166,85,81
050,17,159,"Illinois","Richland County",2,45,190,96,94
050,17,159,"Illinois","Richland County",2,46,175,89,86
050,17,159,"Illinois","Richland County",2,47,172,83,89
050,17,159,"Illinois","Richland County",2,48,180,83,97
050,17,159,"Illinois","Richland County",2,49,197,100,97
050,17,159,"Illinois","Richland County",2,50,198,100,98
050,17,159,"Illinois","Richland County",2,51,187,98,89
050,17,159,"Illinois","Richland County",2,52,174,92,82
050,17,159,"Illinois","Richland County",2,53,182,96,86
050,17,159,"Illinois","Richland County",2,54,194,96,98
050,17,159,"Illinois","Richland County",2,55,216,101,115
050,17,159,"Illinois","Richland County",2,56,225,112,113
050,17,159,"Illinois","Richland County",2,57,230,116,114
050,17,159,"Illinois","Richland County",2,58,232,115,117
050,17,159,"Illinois","Richland County",2,59,238,119,119
050,17,159,"Illinois","Richland County",2,60,240,122,118
050,17,159,"Illinois","Richland County",2,61,225,104,121
050,17,159,"Illinois","Richland County",2,62,234,108,126
050,17,159,"Illinois","Richland County",2,63,246,126,120
050,17,159,"Illinois","Richland County",2,64,231,114,117
050,17,159,"Illinois","Richland County",2,65,220,107,113
050,17,159,"Illinois","Richland County",2,66,201,105,96
050,17,159,"Illinois","Richland County",2,67,190,95,95
050,17,159,"Illinois","Richland County",2,68,184,87,97
050,17,159,"Illinois","Richland County",2,69,189,91,98
050,17,159,"Illinois","Richland County",2,70,170,80,90
050,17,159,"Illinois","Richland County",2,71,154,71,83
050,17,159,"Illinois","Richland County",2,72,153,79,74
050,17,159,"Illinois","Richland County",2,73,153,76,77
050,17,159,"Illinois","Richland County",2,74,112,51,61
050,17,159,"Illinois","Richland County",2,75,120,54,66
050,17,159,"Illinois","Richland County",2,76,119,56,63
050,17,159,"Illinois","Richland County",2,77,124,54,70
050,17,159,"Illinois","Richland County",2,78,105,48,57
050,17,159,"Illinois","Richland County",2,79,106,51,55
050,17,159,"Illinois","Richland County",2,80,115,54,61
050,17,159,"Illinois","Richland County",2,81,105,47,58
050,17,159,"Illinois","Richland County",2,82,82,33,49
050,17,159,"Illinois","Richland County",2,83,90,36,54
050,17,159,"Illinois","Richland County",2,84,68,33,35
050,17,159,"Illinois","Richland County",2,85,469,154,315
050,17,159,"Illinois","Richland County",3,0,181,97,84
050,17,159,"Illinois","Richland County",3,1,157,78,79
050,17,159,"Illinois","Richland County",3,2,184,87,97
050,17,159,"Illinois","Richland County",3,3,193,91,102
050,17,159,"Illinois","Richland County",3,4,200,98,102
050,17,159,"Illinois","Richland County",3,5,215,107,108
050,17,159,"Illinois","Richland County",3,6,221,110,111
050,17,159,"Illinois","Richland County",3,7,216,117,99
050,17,159,"Illinois","Richland County",3,8,200,103,97
050,17,159,"Illinois","Richland County",3,9,198,99,99
050,17,159,"Illinois","Richland County",3,10,197,100,97
050,17,159,"Illinois","Richland County",3,11,204,118,86
050,17,159,"Illinois","Richland County",3,12,207,118,89
050,17,159,"Illinois","Richland County",3,13,207,108,99
050,17,159,"Illinois","Richland County",3,14,215,110,105
050,17,159,"Illinois","Richland County",3,15,202,99,103
050,17,159,"Illinois","Richland County",3,16,224,116,108
050,17,159,"Illinois","Richland County",3,17,224,117,107
050,17,159,"Illinois","Richland County",3,18,186,106,80
050,17,159,"Illinois","Richland County",3,19,135,74,61
050,17,159,"Illinois","Richland County",3,20,139,75,64
050,17,159,"Illinois","Richland County",3,21,151,79,72
050,17,159,"Illinois","Richland County",3,22,162,80,82
050,17,159,"Illinois","Richland County",3,23,148,79,69
050,17,159,"Illinois","Richland County",3,24,148,78,70
050,17,159,"Illinois","Richland County",3,25,154,84,70
050,17,159,"Illinois","Richland County",3,26,160,80,80
050,17,159,"Illinois","Richland County",3,27,164,87,77
050,17,159,"Illinois","Richland County",3,28,190,90,100
050,17,159,"Illinois","Richland County",3,29,211,108,103
050,17,159,"Illinois","Richland County",3,30,188,97,91
050,17,159,"Illinois","Richland County",3,31,200,100,100
050,17,159,"Illinois","Richland County",3,32,188,100,88
050,17,159,"Illinois","Richland County",3,33,179,91,88
050,17,159,"Illinois","Richland County",3,34,168,81,87
050,17,159,"Illinois","Richland County",3,35,206,99,107
050,17,159,"Illinois","Richland County",3,36,198,100,98
050,17,159,"Illinois","Richland County",3,37,183,86,97
050,17,159,"Illinois","Richland County",3,38,190,92,98
050,17,159,"Illinois","Richland County",3,39,195,101,94
050,17,159,"Illinois","Richland County",3,40,183,95,88
050,17,159,"Illinois","Richland County",3,41,184,90,94
050,17,159,"Illinois","Richland County",3,42,194,102,92
050,17,159,"Illinois","Richland County",3,43,191,101,90
050,17,159,"Illinois","Richland County",3,44,183,98,85
050,17,159,"Illinois","Richland County",3,45,162,82,80
050,17,159,"Illinois","Richland County",3,46,191,97,94
050,17,159,"Illinois","Richland County",3,47,176,87,89
050,17,159,"Illinois","Richland County",3,48,174,83,91
050,17,159,"Illinois","Richland County",3,49,176,81,95
050,17,159,"Illinois","Richland County",3,50,210,101,109
050,17,159,"Illinois","Richland County",3,51,191,99,92
050,17,159,"Illinois","Richland County",3,52,193,101,92
050,17,159,"Illinois","Richland County",3,53,173,90,83
050,17,159,"Illinois","Richland County",3,54,183,93,90
050,17,159,"Illinois","Richland County",3,55,192,95,97
050,17,159,"Illinois","Richland County",3,56,212,98,114
050,17,159,"Illinois","Richland County",3,57,232,114,118
050,17,159,"Illinois","Richland County",3,58,222,117,105
050,17,159,"Illinois","Richland County",3,59,230,112,118
050,17,159,"Illinois","Richland County",3,60,242,119,123
050,17,159,"Illinois","Richland County",3,61,232,111,121
050,17,159,"Illinois","Richland County",3,62,227,105,122
050,17,159,"Illinois","Richland County",3,63,234,110,124
050,17,159,"Illinois","Richland County",3,64,236,119,117
050,17,159,"Illinois","Richland County",3,65,226,109,117
050,17,159,"Illinois","Richland County",3,66,212,105,107
050,17,159,"Illinois","Richland County",3,67,194,101,93
050,17,159,"Illinois","Richland County",3,68,184,93,91
050,17,159,"Illinois","Richland County",3,69,176,86,90
050,17,159,"Illinois","Richland County",3,70,184,89,95
050,17,159,"Illinois","Richland County",3,71,166,78,88
050,17,159,"Illinois","Richland County",3,72,153,71,82
050,17,159,"Illinois","Richland County",3,73,141,70,71
050,17,159,"Illinois","Richland County",3,74,152,73,79
050,17,159,"Illinois","Richland County",3,75,106,51,55
050,17,159,"Illinois","Richland County",3,76,110,51,59
050,17,159,"Illinois","Richland County",3,77,116,53,63
050,17,159,"Illinois","Richland County",3,78,120,54,66
050,17,159,"Illinois","Richland County",3,79,97,43,54
050,17,159,"Illinois","Richland County",3,80,106,46,60
050,17,159,"Illinois","Richland County",3,81,110,54,56
050,17,159,"Illinois","Richland County",3,82,94,45,49
050,17,159,"Illinois","Richland County",3,83,84,30,54
050,17,159,"Illinois","Richland County",3,84,70,34,36
050,17,159,"Illinois","Richland County",3,85,455,154,301
050,17,159,"Illinois","Richland County",4,0,158,82,76
050,17,159,"Illinois","Richland County",4,1,185,105,80
050,17,159,"Illinois","Richland County",4,2,154,85,69
050,17,159,"Illinois","Richland County",4,3,183,87,96
050,17,159,"Illinois","Richland County",4,4,198,96,102
050,17,159,"Illinois","Richland County",4,5,196,97,99
050,17,159,"Illinois","Richland County",4,6,216,103,113
050,17,159,"Illinois","Richland County",4,7,211,104,107
050,17,159,"Illinois","Richland County",4,8,221,116,105
050,17,159,"Illinois","Richland County",4,9,193,103,90
050,17,159,"Illinois","Richland County",4,10,205,101,104
050,17,159,"Illinois","Richland County",4,11,189,97,92
050,17,159,"Illinois","Richland County",4,12,202,115,87
050,17,159,"Illinois","Richland County",4,13,200,109,91
050,17,159,"Illinois","Richland County",4,14,211,112,99
050,17,159,"Illinois","Richland County",4,15,204,105,99
050,17,159,"Illinois","Richland County",4,16,206,101,105
050,17,159,"Illinois","Richland County",4,17,223,115,108
050,17,159,"Illinois","Richland County",4,18,179,97,82
050,17,159,"Illinois","Richland County",4,19,138,80,58
050,17,159,"Illinois","Richland County",4,20,138,75,63
050,17,159,"Illinois","Richland County",4,21,150,79,71
050,17,159,"Illinois","Richland County",4,22,152,83,69
050,17,159,"Illinois","Richland County",4,23,161,80,81
050,17,159,"Illinois","Richland County",4,24,150,87,63
050,17,159,"Illinois","Richland County",4,25,148,78,70
050,17,159,"Illinois","Richland County",4,26,160,82,78
050,17,159,"Illinois","Richland County",4,27,149,81,68
050,17,159,"Illinois","Richland County",4,28,166,83,83
050,17,159,"Illinois","Richland County",4,29,176,82,94
050,17,159,"Illinois","Richland County",4,30,206,102,104
050,17,159,"Illinois","Richland County",4,31,190,96,94
050,17,159,"Illinois","Richland County",4,32,207,102,105
050,17,159,"Illinois","Richland County",4,33,194,105,89
050,17,159,"Illinois","Richland County",4,34,182,90,92
050,17,159,"Illinois","Richland County",4,35,163,80,83
050,17,159,"Illinois","Richland County",4,36,207,104,103
050,17,159,"Illinois","Richland County",4,37,195,94,101
050,17,159,"Illinois","Richland County",4,38,187,91,96
050,17,159,"Illinois","Richland County",4,39,196,94,102
050,17,159,"Illinois","Richland County",4,40,182,95,87
050,17,159,"Illinois","Richland County",4,41,190,99,91
050,17,159,"Illinois","Richland County",4,42,172,84,88
050,17,159,"Illinois","Richland County",4,43,193,102,91
050,17,159,"Illinois","Richland County",4,44,196,99,97
050,17,159,"Illinois","Richland County",4,45,176,98,78
050,17,159,"Illinois","Richland County",4,46,156,80,76
050,17,159,"Illinois","Richland County",4,47,185,94,91
050,17,159,"Illinois","Richland County",4,48,169,83,86
050,17,159,"Illinois","Richland County",4,49,171,86,85
050,17,159,"Illinois","Richland County",4,50,181,83,98
050,17,159,"Illinois","Richland County",4,51,203,101,102
050,17,159,"Illinois","Richland County",4,52,188,97,91
050,17,159,"Illinois","Richland County",4,53,189,100,89
050,17,159,"Illinois","Richland County",4,54,172,88,84
050,17,159,"Illinois","Richland County",4,55,182,93,89
050,17,159,"Illinois","Richland County",4,56,189,92,97
050,17,159,"Illinois","Richland County",4,57,216,96,120
050,17,159,"Illinois","Richland County",4,58,223,115,108
050,17,159,"Illinois","Richland County",4,59,221,114,107
050,17,159,"Illinois","Richland County",4,60,234,117,117
050,17,159,"Illinois","Richland County",4,61,241,111,130
050,17,159,"Illinois","Richland County",4,62,231,110,121
050,17,159,"Illinois","Richland County",4,63,236,112,124
050,17,159,"Illinois","Richland County",4,64,229,108,121
050,17,159,"Illinois","Richland County",4,65,232,120,112
050,17,159,"Illinois","Richland County",4,66,224,106,118
050,17,159,"Illinois","Richland County",4,67,207,99,108
050,17,159,"Illinois","Richland County",4,68,189,98,91
050,17,159,"Illinois","Richland County",4,69,180,92,88
050,17,159,"Illinois","Richland County",4,70,169,84,85
050,17,159,"Illinois","Richland County",4,71,175,80,95
050,17,159,"Illinois","Richland County",4,72,161,76,85
050,17,159,"Illinois","Richland County",4,73,142,66,76
050,17,159,"Illinois","Richland County",4,74,140,69,71
050,17,159,"Illinois","Richland County",4,75,142,70,72
050,17,159,"Illinois","Richland County",4,76,96,47,49
050,17,159,"Illinois","Richland County",4,77,104,45,59
050,17,159,"Illinois","Richland County",4,78,113,54,59
050,17,159,"Illinois","Richland County",4,79,105,43,62
050,17,159,"Illinois","Richland County",4,80,96,41,55
050,17,159,"Illinois","Richland County",4,81,94,41,53
050,17,159,"Illinois","Richland County",4,82,105,52,53
050,17,159,"Illinois","Richland County",4,83,95,43,52
050,17,159,"Illinois","Richland County",4,84,62,26,36
050,17,159,"Illinois","Richland County",4,85,450,151,299
050,17,159,"Illinois","Richland County",5,0,143,73,70
050,17,159,"Illinois","Richland County",5,1,162,85,77
050,17,159,"Illinois","Richland County",5,2,178,102,76
050,17,159,"Illinois","Richland County",5,3,152,86,66
050,17,159,"Illinois","Richland County",5,4,192,90,102
050,17,159,"Illinois","Richland County",5,5,193,98,95
050,17,159,"Illinois","Richland County",5,6,201,98,103
050,17,159,"Illinois","Richland County",5,7,205,102,103
050,17,159,"Illinois","Richland County",5,8,210,102,108
050,17,159,"Illinois","Richland County",5,9,219,114,105
050,17,159,"Illinois","Richland County",5,10,196,103,93
050,17,159,"Illinois","Richland County",5,11,199,91,108
050,17,159,"Illinois","Richland County",5,12,185,93,92
050,17,159,"Illinois","Richland County",5,13,211,123,88
050,17,159,"Illinois","Richland County",5,14,204,113,91
050,17,159,"Illinois","Richland County",5,15,207,108,99
050,17,159,"Illinois","Richland County",5,16,212,110,102
050,17,159,"Illinois","Richland County",5,17,204,100,104
050,17,159,"Illinois","Richland County",5,18,183,101,82
050,17,159,"Illinois","Richland County",5,19,145,76,69
050,17,159,"Illinois","Richland County",5,20,162,94,68
050,17,159,"Illinois","Richland County",5,21,143,78,65
050,17,159,"Illinois","Richland County",5,22,166,84,82
050,17,159,"Illinois","Richland County",5,23,158,86,72
050,17,159,"Illinois","Richland County",5,24,148,76,72
050,17,159,"Illinois","Richland County",5,25,156,85,71
050,17,159,"Illinois","Richland County",5,26,160,83,77
050,17,159,"Illinois","Richland County",5,27,145,76,69
050,17,159,"Illinois","Richland County",5,28,149,76,73
050,17,159,"Illinois","Richland County",5,29,171,94,77
050,17,159,"Illinois","Richland County",5,30,187,86,101
050,17,159,"Illinois","Richland County",5,31,212,101,111
050,17,159,"Illinois","Richland County",5,32,186,96,90
050,17,159,"Illinois","Richland County",5,33,203,98,105
050,17,159,"Illinois","Richland County",5,34,193,103,90
050,17,159,"Illinois","Richland County",5,35,181,90,91
050,17,159,"Illinois","Richland County",5,36,172,83,89
050,17,159,"Illinois","Richland County",5,37,210,103,107
050,17,159,"Illinois","Richland County",5,38,202,100,102
050,17,159,"Illinois","Richland County",5,39,197,94,103
050,17,159,"Illinois","Richland County",5,40,188,89,99
050,17,159,"Illinois","Richland County",5,41,182,95,87
050,17,159,"Illinois","Richland County",5,42,188,97,91
050,17,159,"Illinois","Richland County",5,43,179,89,90
050,17,159,"Illinois","Richland County",5,44,200,103,97
050,17,159,"Illinois","Richland County",5,45,185,95,90
050,17,159,"Illinois","Richland County",5,46,176,98,78
050,17,159,"Illinois","Richland County",5,47,150,77,73
050,17,159,"Illinois","Richland County",5,48,190,98,92
050,17,159,"Illinois","Richland County",5,49,172,86,86
050,17,159,"Illinois","Richland County",5,50,179,84,95
050,17,159,"Illinois","Richland County",5,51,179,87,92
050,17,159,"Illinois","Richland County",5,52,208,104,104
050,17,159,"Illinois","Richland County",5,53,184,98,86
050,17,159,"Illinois","Richland County",5,54,188,98,90
050,17,159,"Illinois","Richland County",5,55,169,87,82
050,17,159,"Illinois","Richland County",5,56,178,90,88
050,17,159,"Illinois","Richland County",5,57,191,91,100
050,17,159,"Illinois","Richland County",5,58,205,94,111
050,17,159,"Illinois","Richland County",5,59,217,115,102
050,17,159,"Illinois","Richland County",5,60,225,114,111
050,17,159,"Illinois","Richland County",5,61,230,107,123
050,17,159,"Illinois","Richland County",5,62,235,109,126
050,17,159,"Illinois","Richland County",5,63,231,106,125
050,17,159,"Illinois","Richland County",5,64,234,115,119
050,17,159,"Illinois","Richland County",5,65,219,102,117
050,17,159,"Illinois","Richland County",5,66,224,116,108
050,17,159,"Illinois","Richland County",5,67,216,102,114
050,17,159,"Illinois","Richland County",5,68,204,97,107
050,17,159,"Illinois","Richland County",5,69,178,94,84
050,17,159,"Illinois","Richland County",5,70,173,90,83
050,17,159,"Illinois","Richland County",5,71,166,79,87
050,17,159,"Illinois","Richland County",5,72,176,81,95
050,17,159,"Illinois","Richland County",5,73,148,69,79
050,17,159,"Illinois","Richland County",5,74,141,65,76
050,17,159,"Illinois","Richland County",5,75,136,68,68
050,17,159,"Illinois","Richland County",5,76,132,68,64
050,17,159,"Illinois","Richland County",5,77,87,38,49
050,17,159,"Illinois","Richland County",5,78,105,46,59
050,17,159,"Illinois","Richland County",5,79,100,45,55
050,17,159,"Illinois","Richland County",5,80,109,42,67
050,17,159,"Illinois","Richland County",5,81,91,36,55
050,17,159,"Illinois","Richland County",5,82,87,38,49
050,17,159,"Illinois","Richland County",5,83,106,49,57
050,17,159,"Illinois","Richland County",5,84,77,40,37
050,17,159,"Illinois","Richland County",5,85,448,147,301
050,17,161,"Illinois","Rock Island County",1,0,1716,872,844
050,17,161,"Illinois","Rock Island County",1,1,1730,870,860
050,17,161,"Illinois","Rock Island County",1,2,1676,875,801
050,17,161,"Illinois","Rock Island County",1,3,1783,905,878
050,17,161,"Illinois","Rock Island County",1,4,1834,950,884
050,17,161,"Illinois","Rock Island County",1,5,1862,947,915
050,17,161,"Illinois","Rock Island County",1,6,1807,920,887
050,17,161,"Illinois","Rock Island County",1,7,1741,889,852
050,17,161,"Illinois","Rock Island County",1,8,1803,905,898
050,17,161,"Illinois","Rock Island County",1,9,1844,935,909
050,17,161,"Illinois","Rock Island County",1,10,1913,993,920
050,17,161,"Illinois","Rock Island County",1,11,1888,950,938
050,17,161,"Illinois","Rock Island County",1,12,1911,996,915
050,17,161,"Illinois","Rock Island County",1,13,1891,962,929
050,17,161,"Illinois","Rock Island County",1,14,1897,966,931
050,17,161,"Illinois","Rock Island County",1,15,1833,956,877
050,17,161,"Illinois","Rock Island County",1,16,1823,937,886
050,17,161,"Illinois","Rock Island County",1,17,1825,941,884
050,17,161,"Illinois","Rock Island County",1,18,1830,941,889
050,17,161,"Illinois","Rock Island County",1,19,1949,1004,945
050,17,161,"Illinois","Rock Island County",1,20,1964,991,973
050,17,161,"Illinois","Rock Island County",1,21,1834,935,899
050,17,161,"Illinois","Rock Island County",1,22,1623,823,800
050,17,161,"Illinois","Rock Island County",1,23,1641,829,812
050,17,161,"Illinois","Rock Island County",1,24,1672,839,833
050,17,161,"Illinois","Rock Island County",1,25,1683,820,863
050,17,161,"Illinois","Rock Island County",1,26,1757,861,896
050,17,161,"Illinois","Rock Island County",1,27,1750,883,867
050,17,161,"Illinois","Rock Island County",1,28,1828,905,923
050,17,161,"Illinois","Rock Island County",1,29,1826,901,925
050,17,161,"Illinois","Rock Island County",1,30,1778,892,886
050,17,161,"Illinois","Rock Island County",1,31,1753,878,875
050,17,161,"Illinois","Rock Island County",1,32,1722,886,836
050,17,161,"Illinois","Rock Island County",1,33,1755,921,834
050,17,161,"Illinois","Rock Island County",1,34,1703,900,803
050,17,161,"Illinois","Rock Island County",1,35,1693,856,837
050,17,161,"Illinois","Rock Island County",1,36,1759,953,806
050,17,161,"Illinois","Rock Island County",1,37,1805,926,879
050,17,161,"Illinois","Rock Island County",1,38,1862,961,901
050,17,161,"Illinois","Rock Island County",1,39,1820,941,879
050,17,161,"Illinois","Rock Island County",1,40,1844,936,908
050,17,161,"Illinois","Rock Island County",1,41,1734,870,864
050,17,161,"Illinois","Rock Island County",1,42,1681,878,803
050,17,161,"Illinois","Rock Island County",1,43,1655,871,784
050,17,161,"Illinois","Rock Island County",1,44,1647,835,812
050,17,161,"Illinois","Rock Island County",1,45,1644,817,827
050,17,161,"Illinois","Rock Island County",1,46,1559,754,805
050,17,161,"Illinois","Rock Island County",1,47,1546,814,732
050,17,161,"Illinois","Rock Island County",1,48,1682,877,805
050,17,161,"Illinois","Rock Island County",1,49,1828,935,893
050,17,161,"Illinois","Rock Island County",1,50,1658,855,803
050,17,161,"Illinois","Rock Island County",1,51,1647,833,814
050,17,161,"Illinois","Rock Island County",1,52,1636,822,814
050,17,161,"Illinois","Rock Island County",1,53,1663,836,827
050,17,161,"Illinois","Rock Island County",1,54,1713,858,855
050,17,161,"Illinois","Rock Island County",1,55,1788,876,912
050,17,161,"Illinois","Rock Island County",1,56,1858,937,921
050,17,161,"Illinois","Rock Island County",1,57,1898,954,944
050,17,161,"Illinois","Rock Island County",1,58,1927,939,988
050,17,161,"Illinois","Rock Island County",1,59,2037,995,1042
050,17,161,"Illinois","Rock Island County",1,60,1987,967,1020
050,17,161,"Illinois","Rock Island County",1,61,1941,932,1009
050,17,161,"Illinois","Rock Island County",1,62,2008,991,1017
050,17,161,"Illinois","Rock Island County",1,63,2050,1000,1050
050,17,161,"Illinois","Rock Island County",1,64,2048,979,1069
050,17,161,"Illinois","Rock Island County",1,65,1959,939,1020
050,17,161,"Illinois","Rock Island County",1,66,1889,932,957
050,17,161,"Illinois","Rock Island County",1,67,1848,863,985
050,17,161,"Illinois","Rock Island County",1,68,1732,822,910
050,17,161,"Illinois","Rock Island County",1,69,1636,758,878
050,17,161,"Illinois","Rock Island County",1,70,1577,753,824
050,17,161,"Illinois","Rock Island County",1,71,1583,729,854
050,17,161,"Illinois","Rock Island County",1,72,1604,734,870
050,17,161,"Illinois","Rock Island County",1,73,1536,715,821
050,17,161,"Illinois","Rock Island County",1,74,1075,494,581
050,17,161,"Illinois","Rock Island County",1,75,1080,505,575
050,17,161,"Illinois","Rock Island County",1,76,1043,494,549
050,17,161,"Illinois","Rock Island County",1,77,1052,488,564
050,17,161,"Illinois","Rock Island County",1,78,962,436,526
050,17,161,"Illinois","Rock Island County",1,79,867,410,457
050,17,161,"Illinois","Rock Island County",1,80,770,338,432
050,17,161,"Illinois","Rock Island County",1,81,760,316,444
050,17,161,"Illinois","Rock Island County",1,82,710,295,415
050,17,161,"Illinois","Rock Island County",1,83,628,249,379
050,17,161,"Illinois","Rock Island County",1,84,550,210,340
050,17,161,"Illinois","Rock Island County",1,85,3343,1159,2184
050,17,161,"Illinois","Rock Island County",2,0,1678,868,810
050,17,161,"Illinois","Rock Island County",2,1,1722,868,854
050,17,161,"Illinois","Rock Island County",2,2,1691,873,818
050,17,161,"Illinois","Rock Island County",2,3,1751,896,855
050,17,161,"Illinois","Rock Island County",2,4,1825,937,888
050,17,161,"Illinois","Rock Island County",2,5,1860,949,911
050,17,161,"Illinois","Rock Island County",2,6,1822,929,893
050,17,161,"Illinois","Rock Island County",2,7,1750,891,859
050,17,161,"Illinois","Rock Island County",2,8,1779,897,882
050,17,161,"Illinois","Rock Island County",2,9,1832,931,901
050,17,161,"Illinois","Rock Island County",2,10,1892,976,916
050,17,161,"Illinois","Rock Island County",2,11,1880,954,926
050,17,161,"Illinois","Rock Island County",2,12,1908,985,923
050,17,161,"Illinois","Rock Island County",2,13,1893,968,925
050,17,161,"Illinois","Rock Island County",2,14,1891,962,929
050,17,161,"Illinois","Rock Island County",2,15,1850,960,890
050,17,161,"Illinois","Rock Island County",2,16,1826,942,884
050,17,161,"Illinois","Rock Island County",2,17,1820,937,883
050,17,161,"Illinois","Rock Island County",2,18,1826,938,888
050,17,161,"Illinois","Rock Island County",2,19,1959,1009,950
050,17,161,"Illinois","Rock Island County",2,20,1985,1006,979
050,17,161,"Illinois","Rock Island County",2,21,1827,928,899
050,17,161,"Illinois","Rock Island County",2,22,1628,829,799
050,17,161,"Illinois","Rock Island County",2,23,1647,833,814
050,17,161,"Illinois","Rock Island County",2,24,1659,834,825
050,17,161,"Illinois","Rock Island County",2,25,1688,832,856
050,17,161,"Illinois","Rock Island County",2,26,1739,854,885
050,17,161,"Illinois","Rock Island County",2,27,1740,869,871
050,17,161,"Illinois","Rock Island County",2,28,1813,903,910
050,17,161,"Illinois","Rock Island County",2,29,1822,902,920
050,17,161,"Illinois","Rock Island County",2,30,1787,897,890
050,17,161,"Illinois","Rock Island County",2,31,1744,877,867
050,17,161,"Illinois","Rock Island County",2,32,1727,880,847
050,17,161,"Illinois","Rock Island County",2,33,1740,910,830
050,17,161,"Illinois","Rock Island County",2,34,1704,896,808
050,17,161,"Illinois","Rock Island County",2,35,1702,868,834
050,17,161,"Illinois","Rock Island County",2,36,1725,921,804
050,17,161,"Illinois","Rock Island County",2,37,1793,935,858
050,17,161,"Illinois","Rock Island County",2,38,1846,951,895
050,17,161,"Illinois","Rock Island County",2,39,1817,938,879
050,17,161,"Illinois","Rock Island County",2,40,1845,936,909
050,17,161,"Illinois","Rock Island County",2,41,1751,878,873
050,17,161,"Illinois","Rock Island County",2,42,1682,869,813
050,17,161,"Illinois","Rock Island County",2,43,1673,879,794
050,17,161,"Illinois","Rock Island County",2,44,1630,835,795
050,17,161,"Illinois","Rock Island County",2,45,1645,820,825
050,17,161,"Illinois","Rock Island County",2,46,1570,767,803
050,17,161,"Illinois","Rock Island County",2,47,1538,793,745
050,17,161,"Illinois","Rock Island County",2,48,1647,859,788
050,17,161,"Illinois","Rock Island County",2,49,1799,924,875
050,17,161,"Illinois","Rock Island County",2,50,1690,864,826
050,17,161,"Illinois","Rock Island County",2,51,1642,835,807
050,17,161,"Illinois","Rock Island County",2,52,1633,824,809
050,17,161,"Illinois","Rock Island County",2,53,1647,825,822
050,17,161,"Illinois","Rock Island County",2,54,1694,850,844
050,17,161,"Illinois","Rock Island County",2,55,1764,867,897
050,17,161,"Illinois","Rock Island County",2,56,1846,924,922
050,17,161,"Illinois","Rock Island County",2,57,1881,944,937
050,17,161,"Illinois","Rock Island County",2,58,1909,937,972
050,17,161,"Illinois","Rock Island County",2,59,2009,979,1030
050,17,161,"Illinois","Rock Island County",2,60,1984,964,1020
050,17,161,"Illinois","Rock Island County",2,61,1939,932,1007
050,17,161,"Illinois","Rock Island County",2,62,1980,970,1010
050,17,161,"Illinois","Rock Island County",2,63,2050,1003,1047
050,17,161,"Illinois","Rock Island County",2,64,2018,968,1050
050,17,161,"Illinois","Rock Island County",2,65,1971,939,1032
050,17,161,"Illinois","Rock Island County",2,66,1895,930,965
050,17,161,"Illinois","Rock Island County",2,67,1841,870,971
050,17,161,"Illinois","Rock Island County",2,68,1727,813,914
050,17,161,"Illinois","Rock Island County",2,69,1662,775,887
050,17,161,"Illinois","Rock Island County",2,70,1574,747,827
050,17,161,"Illinois","Rock Island County",2,71,1572,728,844
050,17,161,"Illinois","Rock Island County",2,72,1561,711,850
050,17,161,"Illinois","Rock Island County",2,73,1612,744,868
050,17,161,"Illinois","Rock Island County",2,74,1113,511,602
050,17,161,"Illinois","Rock Island County",2,75,1074,497,577
050,17,161,"Illinois","Rock Island County",2,76,1030,483,547
050,17,161,"Illinois","Rock Island County",2,77,1064,494,570
050,17,161,"Illinois","Rock Island County",2,78,956,436,520
050,17,161,"Illinois","Rock Island County",2,79,873,405,468
050,17,161,"Illinois","Rock Island County",2,80,788,353,435
050,17,161,"Illinois","Rock Island County",2,81,753,322,431
050,17,161,"Illinois","Rock Island County",2,82,715,296,419
050,17,161,"Illinois","Rock Island County",2,83,643,257,386
050,17,161,"Illinois","Rock Island County",2,84,559,217,342
050,17,161,"Illinois","Rock Island County",2,85,3323,1153,2170
050,17,161,"Illinois","Rock Island County",3,0,1523,749,774
050,17,161,"Illinois","Rock Island County",3,1,1669,851,818
050,17,161,"Illinois","Rock Island County",3,2,1705,847,858
050,17,161,"Illinois","Rock Island County",3,3,1682,875,807
050,17,161,"Illinois","Rock Island County",3,4,1732,869,863
050,17,161,"Illinois","Rock Island County",3,5,1812,913,899
050,17,161,"Illinois","Rock Island County",3,6,1840,945,895
050,17,161,"Illinois","Rock Island County",3,7,1807,916,891
050,17,161,"Illinois","Rock Island County",3,8,1767,898,869
050,17,161,"Illinois","Rock Island County",3,9,1783,896,887
050,17,161,"Illinois","Rock Island County",3,10,1820,908,912
050,17,161,"Illinois","Rock Island County",3,11,1891,972,919
050,17,161,"Illinois","Rock Island County",3,12,1846,932,914
050,17,161,"Illinois","Rock Island County",3,13,1912,978,934
050,17,161,"Illinois","Rock Island County",3,14,1863,954,909
050,17,161,"Illinois","Rock Island County",3,15,1889,963,926
050,17,161,"Illinois","Rock Island County",3,16,1821,958,863
050,17,161,"Illinois","Rock Island County",3,17,1828,935,893
050,17,161,"Illinois","Rock Island County",3,18,1832,936,896
050,17,161,"Illinois","Rock Island County",3,19,1923,993,930
050,17,161,"Illinois","Rock Island County",3,20,1996,1024,972
050,17,161,"Illinois","Rock Island County",3,21,1800,921,879
050,17,161,"Illinois","Rock Island County",3,22,1624,818,806
050,17,161,"Illinois","Rock Island County",3,23,1634,827,807
050,17,161,"Illinois","Rock Island County",3,24,1668,858,810
050,17,161,"Illinois","Rock Island County",3,25,1658,831,827
050,17,161,"Illinois","Rock Island County",3,26,1675,831,844
050,17,161,"Illinois","Rock Island County",3,27,1739,840,899
050,17,161,"Illinois","Rock Island County",3,28,1727,874,853
050,17,161,"Illinois","Rock Island County",3,29,1783,873,910
050,17,161,"Illinois","Rock Island County",3,30,1806,904,902
050,17,161,"Illinois","Rock Island County",3,31,1770,869,901
050,17,161,"Illinois","Rock Island County",3,32,1740,870,870
050,17,161,"Illinois","Rock Island County",3,33,1728,876,852
050,17,161,"Illinois","Rock Island County",3,34,1704,889,815
050,17,161,"Illinois","Rock Island County",3,35,1656,851,805
050,17,161,"Illinois","Rock Island County",3,36,1693,863,830
050,17,161,"Illinois","Rock Island County",3,37,1720,917,803
050,17,161,"Illinois","Rock Island County",3,38,1802,943,859
050,17,161,"Illinois","Rock Island County",3,39,1819,922,897
050,17,161,"Illinois","Rock Island County",3,40,1814,947,867
050,17,161,"Illinois","Rock Island County",3,41,1835,927,908
050,17,161,"Illinois","Rock Island County",3,42,1721,869,852
050,17,161,"Illinois","Rock Island County",3,43,1658,853,805
050,17,161,"Illinois","Rock Island County",3,44,1668,891,777
050,17,161,"Illinois","Rock Island County",3,45,1634,841,793
050,17,161,"Illinois","Rock Island County",3,46,1647,829,818
050,17,161,"Illinois","Rock Island County",3,47,1551,763,788
050,17,161,"Illinois","Rock Island County",3,48,1517,779,738
050,17,161,"Illinois","Rock Island County",3,49,1639,854,785
050,17,161,"Illinois","Rock Island County",3,50,1738,874,864
050,17,161,"Illinois","Rock Island County",3,51,1686,880,806
050,17,161,"Illinois","Rock Island County",3,52,1637,846,791
050,17,161,"Illinois","Rock Island County",3,53,1618,791,827
050,17,161,"Illinois","Rock Island County",3,54,1606,813,793
050,17,161,"Illinois","Rock Island County",3,55,1676,838,838
050,17,161,"Illinois","Rock Island County",3,56,1745,861,884
050,17,161,"Illinois","Rock Island County",3,57,1823,917,906
050,17,161,"Illinois","Rock Island County",3,58,1849,924,925
050,17,161,"Illinois","Rock Island County",3,59,1875,914,961
050,17,161,"Illinois","Rock Island County",3,60,1970,946,1024
050,17,161,"Illinois","Rock Island County",3,61,1954,948,1006
050,17,161,"Illinois","Rock Island County",3,62,1884,897,987
050,17,161,"Illinois","Rock Island County",3,63,1924,942,982
050,17,161,"Illinois","Rock Island County",3,64,1991,962,1029
050,17,161,"Illinois","Rock Island County",3,65,1965,938,1027
050,17,161,"Illinois","Rock Island County",3,66,1927,924,1003
050,17,161,"Illinois","Rock Island County",3,67,1858,911,947
050,17,161,"Illinois","Rock Island County",3,68,1772,834,938
050,17,161,"Illinois","Rock Island County",3,69,1668,784,884
050,17,161,"Illinois","Rock Island County",3,70,1603,748,855
050,17,161,"Illinois","Rock Island County",3,71,1521,722,799
050,17,161,"Illinois","Rock Island County",3,72,1512,692,820
050,17,161,"Illinois","Rock Island County",3,73,1491,671,820
050,17,161,"Illinois","Rock Island County",3,74,1557,714,843
050,17,161,"Illinois","Rock Island County",3,75,1063,486,577
050,17,161,"Illinois","Rock Island County",3,76,1023,462,561
050,17,161,"Illinois","Rock Island County",3,77,994,455,539
050,17,161,"Illinois","Rock Island County",3,78,1010,470,540
050,17,161,"Illinois","Rock Island County",3,79,892,389,503
050,17,161,"Illinois","Rock Island County",3,80,842,386,456
050,17,161,"Illinois","Rock Island County",3,81,736,337,399
050,17,161,"Illinois","Rock Island County",3,82,686,286,400
050,17,161,"Illinois","Rock Island County",3,83,677,268,409
050,17,161,"Illinois","Rock Island County",3,84,575,230,345
050,17,161,"Illinois","Rock Island County",3,85,3204,1114,2090
050,17,161,"Illinois","Rock Island County",4,0,1578,796,782
050,17,161,"Illinois","Rock Island County",4,1,1529,760,769
050,17,161,"Illinois","Rock Island County",4,2,1637,850,787
050,17,161,"Illinois","Rock Island County",4,3,1688,861,827
050,17,161,"Illinois","Rock Island County",4,4,1676,896,780
050,17,161,"Illinois","Rock Island County",4,5,1725,865,860
050,17,161,"Illinois","Rock Island County",4,6,1809,909,900
050,17,161,"Illinois","Rock Island County",4,7,1828,940,888
050,17,161,"Illinois","Rock Island County",4,8,1802,930,872
050,17,161,"Illinois","Rock Island County",4,9,1755,892,863
050,17,161,"Illinois","Rock Island County",4,10,1759,880,879
050,17,161,"Illinois","Rock Island County",4,11,1845,920,925
050,17,161,"Illinois","Rock Island County",4,12,1886,980,906
050,17,161,"Illinois","Rock Island County",4,13,1834,913,921
050,17,161,"Illinois","Rock Island County",4,14,1894,979,915
050,17,161,"Illinois","Rock Island County",4,15,1855,946,909
050,17,161,"Illinois","Rock Island County",4,16,1872,964,908
050,17,161,"Illinois","Rock Island County",4,17,1868,983,885
050,17,161,"Illinois","Rock Island County",4,18,1830,941,889
050,17,161,"Illinois","Rock Island County",4,19,1933,988,945
050,17,161,"Illinois","Rock Island County",4,20,1946,1000,946
050,17,161,"Illinois","Rock Island County",4,21,1799,937,862
050,17,161,"Illinois","Rock Island County",4,22,1582,822,760
050,17,161,"Illinois","Rock Island County",4,23,1621,818,803
050,17,161,"Illinois","Rock Island County",4,24,1637,829,808
050,17,161,"Illinois","Rock Island County",4,25,1636,838,798
050,17,161,"Illinois","Rock Island County",4,26,1604,793,811
050,17,161,"Illinois","Rock Island County",4,27,1610,779,831
050,17,161,"Illinois","Rock Island County",4,28,1763,865,898
050,17,161,"Illinois","Rock Island County",4,29,1699,853,846
050,17,161,"Illinois","Rock Island County",4,30,1755,859,896
050,17,161,"Illinois","Rock Island County",4,31,1782,873,909
050,17,161,"Illinois","Rock Island County",4,32,1714,847,867
050,17,161,"Illinois","Rock Island County",4,33,1719,857,862
050,17,161,"Illinois","Rock Island County",4,34,1697,841,856
050,17,161,"Illinois","Rock Island County",4,35,1639,833,806
050,17,161,"Illinois","Rock Island County",4,36,1682,864,818
050,17,161,"Illinois","Rock Island County",4,37,1694,866,828
050,17,161,"Illinois","Rock Island County",4,38,1704,908,796
050,17,161,"Illinois","Rock Island County",4,39,1804,945,859
050,17,161,"Illinois","Rock Island County",4,40,1803,913,890
050,17,161,"Illinois","Rock Island County",4,41,1822,938,884
050,17,161,"Illinois","Rock Island County",4,42,1806,920,886
050,17,161,"Illinois","Rock Island County",4,43,1682,853,829
050,17,161,"Illinois","Rock Island County",4,44,1670,858,812
050,17,161,"Illinois","Rock Island County",4,45,1629,844,785
050,17,161,"Illinois","Rock Island County",4,46,1614,840,774
050,17,161,"Illinois","Rock Island County",4,47,1627,810,817
050,17,161,"Illinois","Rock Island County",4,48,1525,752,773
050,17,161,"Illinois","Rock Island County",4,49,1517,780,737
050,17,161,"Illinois","Rock Island County",4,50,1607,822,785
050,17,161,"Illinois","Rock Island County",4,51,1737,874,863
050,17,161,"Illinois","Rock Island County",4,52,1662,869,793
050,17,161,"Illinois","Rock Island County",4,53,1617,822,795
050,17,161,"Illinois","Rock Island County",4,54,1575,778,797
050,17,161,"Illinois","Rock Island County",4,55,1581,801,780
050,17,161,"Illinois","Rock Island County",4,56,1662,834,828
050,17,161,"Illinois","Rock Island County",4,57,1741,859,882
050,17,161,"Illinois","Rock Island County",4,58,1777,886,891
050,17,161,"Illinois","Rock Island County",4,59,1823,913,910
050,17,161,"Illinois","Rock Island County",4,60,1848,897,951
050,17,161,"Illinois","Rock Island County",4,61,1910,917,993
050,17,161,"Illinois","Rock Island County",4,62,1931,924,1007
050,17,161,"Illinois","Rock Island County",4,63,1846,875,971
050,17,161,"Illinois","Rock Island County",4,64,1871,910,961
050,17,161,"Illinois","Rock Island County",4,65,1937,928,1009
050,17,161,"Illinois","Rock Island County",4,66,1919,914,1005
050,17,161,"Illinois","Rock Island County",4,67,1885,904,981
050,17,161,"Illinois","Rock Island County",4,68,1812,885,927
050,17,161,"Illinois","Rock Island County",4,69,1723,814,909
050,17,161,"Illinois","Rock Island County",4,70,1613,755,858
050,17,161,"Illinois","Rock Island County",4,71,1559,714,845
050,17,161,"Illinois","Rock Island County",4,72,1486,702,784
050,17,161,"Illinois","Rock Island County",4,73,1468,662,806
050,17,161,"Illinois","Rock Island County",4,74,1436,644,792
050,17,161,"Illinois","Rock Island County",4,75,1499,684,815
050,17,161,"Illinois","Rock Island County",4,76,1027,463,564
050,17,161,"Illinois","Rock Island County",4,77,990,453,537
050,17,161,"Illinois","Rock Island County",4,78,947,430,517
050,17,161,"Illinois","Rock Island County",4,79,955,438,517
050,17,161,"Illinois","Rock Island County",4,80,860,369,491
050,17,161,"Illinois","Rock Island County",4,81,799,368,431
050,17,161,"Illinois","Rock Island County",4,82,663,293,370
050,17,161,"Illinois","Rock Island County",4,83,636,257,379
050,17,161,"Illinois","Rock Island County",4,84,609,245,364
050,17,161,"Illinois","Rock Island County",4,85,3163,1091,2072
050,17,161,"Illinois","Rock Island County",5,0,1619,814,805
050,17,161,"Illinois","Rock Island County",5,1,1600,801,799
050,17,161,"Illinois","Rock Island County",5,2,1524,762,762
050,17,161,"Illinois","Rock Island County",5,3,1638,865,773
050,17,161,"Illinois","Rock Island County",5,4,1698,870,828
050,17,161,"Illinois","Rock Island County",5,5,1682,884,798
050,17,161,"Illinois","Rock Island County",5,6,1710,858,852
050,17,161,"Illinois","Rock Island County",5,7,1786,899,887
050,17,161,"Illinois","Rock Island County",5,8,1795,924,871
050,17,161,"Illinois","Rock Island County",5,9,1797,938,859
050,17,161,"Illinois","Rock Island County",5,10,1729,883,846
050,17,161,"Illinois","Rock Island County",5,11,1787,888,899
050,17,161,"Illinois","Rock Island County",5,12,1802,915,887
050,17,161,"Illinois","Rock Island County",5,13,1902,986,916
050,17,161,"Illinois","Rock Island County",5,14,1838,941,897
050,17,161,"Illinois","Rock Island County",5,15,1886,978,908
050,17,161,"Illinois","Rock Island County",5,16,1846,944,902
050,17,161,"Illinois","Rock Island County",5,17,1913,984,929
050,17,161,"Illinois","Rock Island County",5,18,1862,979,883
050,17,161,"Illinois","Rock Island County",5,19,1995,1035,960
050,17,161,"Illinois","Rock Island County",5,20,2002,1016,986
050,17,161,"Illinois","Rock Island County",5,21,1814,937,877
050,17,161,"Illinois","Rock Island County",5,22,1606,822,784
050,17,161,"Illinois","Rock Island County",5,23,1642,844,798
050,17,161,"Illinois","Rock Island County",5,24,1653,834,819
050,17,161,"Illinois","Rock Island County",5,25,1656,839,817
050,17,161,"Illinois","Rock Island County",5,26,1670,824,846
050,17,161,"Illinois","Rock Island County",5,27,1632,801,831
050,17,161,"Illinois","Rock Island County",5,28,1632,797,835
050,17,161,"Illinois","Rock Island County",5,29,1732,845,887
050,17,161,"Illinois","Rock Island County",5,30,1655,837,818
050,17,161,"Illinois","Rock Island County",5,31,1771,874,897
050,17,161,"Illinois","Rock Island County",5,32,1791,875,916
050,17,161,"Illinois","Rock Island County",5,33,1727,861,866
050,17,161,"Illinois","Rock Island County",5,34,1716,827,889
050,17,161,"Illinois","Rock Island County",5,35,1677,823,854
050,17,161,"Illinois","Rock Island County",5,36,1629,831,798
050,17,161,"Illinois","Rock Island County",5,37,1686,869,817
050,17,161,"Illinois","Rock Island County",5,38,1653,845,808
050,17,161,"Illinois","Rock Island County",5,39,1710,910,800
050,17,161,"Illinois","Rock Island County",5,40,1773,936,837
050,17,161,"Illinois","Rock Island County",5,41,1823,915,908
050,17,161,"Illinois","Rock Island County",5,42,1791,916,875
050,17,161,"Illinois","Rock Island County",5,43,1791,911,880
050,17,161,"Illinois","Rock Island County",5,44,1661,835,826
050,17,161,"Illinois","Rock Island County",5,45,1658,862,796
050,17,161,"Illinois","Rock Island County",5,46,1605,830,775
050,17,161,"Illinois","Rock Island County",5,47,1600,826,774
050,17,161,"Illinois","Rock Island County",5,48,1601,790,811
050,17,161,"Illinois","Rock Island County",5,49,1529,752,777
050,17,161,"Illinois","Rock Island County",5,50,1496,760,736
050,17,161,"Illinois","Rock Island County",5,51,1619,842,777
050,17,161,"Illinois","Rock Island County",5,52,1748,870,878
050,17,161,"Illinois","Rock Island County",5,53,1649,860,789
050,17,161,"Illinois","Rock Island County",5,54,1595,810,785
050,17,161,"Illinois","Rock Island County",5,55,1551,758,793
050,17,161,"Illinois","Rock Island County",5,56,1565,784,781
050,17,161,"Illinois","Rock Island County",5,57,1635,825,810
050,17,161,"Illinois","Rock Island County",5,58,1689,816,873
050,17,161,"Illinois","Rock Island County",5,59,1763,873,890
050,17,161,"Illinois","Rock Island County",5,60,1793,895,898
050,17,161,"Illinois","Rock Island County",5,61,1823,884,939
050,17,161,"Illinois","Rock Island County",5,62,1879,900,979
050,17,161,"Illinois","Rock Island County",5,63,1906,914,992
050,17,161,"Illinois","Rock Island County",5,64,1810,867,943
050,17,161,"Illinois","Rock Island County",5,65,1846,892,954
050,17,161,"Illinois","Rock Island County",5,66,1892,903,989
050,17,161,"Illinois","Rock Island County",5,67,1912,903,1009
050,17,161,"Illinois","Rock Island County",5,68,1838,874,964
050,17,161,"Illinois","Rock Island County",5,69,1776,866,910
050,17,161,"Illinois","Rock Island County",5,70,1683,791,892
050,17,161,"Illinois","Rock Island County",5,71,1569,718,851
050,17,161,"Illinois","Rock Island County",5,72,1534,705,829
050,17,161,"Illinois","Rock Island County",5,73,1442,673,769
050,17,161,"Illinois","Rock Island County",5,74,1417,631,786
050,17,161,"Illinois","Rock Island County",5,75,1392,625,767
050,17,161,"Illinois","Rock Island County",5,76,1440,650,790
050,17,161,"Illinois","Rock Island County",5,77,994,447,547
050,17,161,"Illinois","Rock Island County",5,78,955,433,522
050,17,161,"Illinois","Rock Island County",5,79,906,404,502
050,17,161,"Illinois","Rock Island County",5,80,912,414,498
050,17,161,"Illinois","Rock Island County",5,81,811,352,459
050,17,161,"Illinois","Rock Island County",5,82,729,325,404
050,17,161,"Illinois","Rock Island County",5,83,608,261,347
050,17,161,"Illinois","Rock Island County",5,84,571,239,332
050,17,161,"Illinois","Rock Island County",5,85,3193,1104,2089
050,17,163,"Illinois","St. Clair County",1,0,2924,1494,1430
050,17,163,"Illinois","St. Clair County",1,1,3024,1541,1483
050,17,163,"Illinois","St. Clair County",1,2,3229,1633,1596
050,17,163,"Illinois","St. Clair County",1,3,3197,1671,1526
050,17,163,"Illinois","St. Clair County",1,4,3420,1769,1651
050,17,163,"Illinois","St. Clair County",1,5,3408,1748,1660
050,17,163,"Illinois","St. Clair County",1,6,3336,1731,1605
050,17,163,"Illinois","St. Clair County",1,7,3317,1714,1603
050,17,163,"Illinois","St. Clair County",1,8,3268,1676,1592
050,17,163,"Illinois","St. Clair County",1,9,3330,1747,1583
050,17,163,"Illinois","St. Clair County",1,10,3472,1798,1674
050,17,163,"Illinois","St. Clair County",1,11,3636,1891,1745
050,17,163,"Illinois","St. Clair County",1,12,3643,1861,1782
050,17,163,"Illinois","St. Clair County",1,13,3622,1825,1797
050,17,163,"Illinois","St. Clair County",1,14,3524,1781,1743
050,17,163,"Illinois","St. Clair County",1,15,3511,1807,1704
050,17,163,"Illinois","St. Clair County",1,16,3461,1747,1714
050,17,163,"Illinois","St. Clair County",1,17,3420,1760,1660
050,17,163,"Illinois","St. Clair County",1,18,3261,1706,1555
050,17,163,"Illinois","St. Clair County",1,19,3023,1625,1398
050,17,163,"Illinois","St. Clair County",1,20,2873,1510,1363
050,17,163,"Illinois","St. Clair County",1,21,2884,1498,1386
050,17,163,"Illinois","St. Clair County",1,22,2930,1450,1480
050,17,163,"Illinois","St. Clair County",1,23,2990,1493,1497
050,17,163,"Illinois","St. Clair County",1,24,3024,1523,1501
050,17,163,"Illinois","St. Clair County",1,25,3135,1578,1557
050,17,163,"Illinois","St. Clair County",1,26,3343,1665,1678
050,17,163,"Illinois","St. Clair County",1,27,3378,1663,1715
050,17,163,"Illinois","St. Clair County",1,28,3372,1659,1713
050,17,163,"Illinois","St. Clair County",1,29,3389,1643,1746
050,17,163,"Illinois","St. Clair County",1,30,3321,1596,1725
050,17,163,"Illinois","St. Clair County",1,31,3258,1540,1718
050,17,163,"Illinois","St. Clair County",1,32,3307,1570,1737
050,17,163,"Illinois","St. Clair County",1,33,3281,1561,1720
050,17,163,"Illinois","St. Clair County",1,34,3403,1642,1761
050,17,163,"Illinois","St. Clair County",1,35,3331,1587,1744
050,17,163,"Illinois","St. Clair County",1,36,3389,1603,1786
050,17,163,"Illinois","St. Clair County",1,37,3480,1677,1803
050,17,163,"Illinois","St. Clair County",1,38,3558,1767,1791
050,17,163,"Illinois","St. Clair County",1,39,3595,1797,1798
050,17,163,"Illinois","St. Clair County",1,40,3513,1713,1800
050,17,163,"Illinois","St. Clair County",1,41,3265,1598,1667
050,17,163,"Illinois","St. Clair County",1,42,3194,1484,1710
050,17,163,"Illinois","St. Clair County",1,43,3073,1447,1626
050,17,163,"Illinois","St. Clair County",1,44,2982,1447,1535
050,17,163,"Illinois","St. Clair County",1,45,3049,1486,1563
050,17,163,"Illinois","St. Clair County",1,46,2996,1431,1565
050,17,163,"Illinois","St. Clair County",1,47,3048,1457,1591
050,17,163,"Illinois","St. Clair County",1,48,3205,1549,1656
050,17,163,"Illinois","St. Clair County",1,49,3346,1581,1765
050,17,163,"Illinois","St. Clair County",1,50,3161,1478,1683
050,17,163,"Illinois","St. Clair County",1,51,3050,1435,1615
050,17,163,"Illinois","St. Clair County",1,52,3078,1480,1598
050,17,163,"Illinois","St. Clair County",1,53,3267,1577,1690
050,17,163,"Illinois","St. Clair County",1,54,3433,1652,1781
050,17,163,"Illinois","St. Clair County",1,55,3549,1734,1815
050,17,163,"Illinois","St. Clair County",1,56,3702,1812,1890
050,17,163,"Illinois","St. Clair County",1,57,3683,1809,1874
050,17,163,"Illinois","St. Clair County",1,58,3704,1794,1910
050,17,163,"Illinois","St. Clair County",1,59,3709,1798,1911
050,17,163,"Illinois","St. Clair County",1,60,3599,1752,1847
050,17,163,"Illinois","St. Clair County",1,61,3605,1750,1855
050,17,163,"Illinois","St. Clair County",1,62,3653,1745,1908
050,17,163,"Illinois","St. Clair County",1,63,3498,1647,1851
050,17,163,"Illinois","St. Clair County",1,64,3320,1582,1738
050,17,163,"Illinois","St. Clair County",1,65,3239,1520,1719
050,17,163,"Illinois","St. Clair County",1,66,3040,1428,1612
050,17,163,"Illinois","St. Clair County",1,67,2855,1343,1512
050,17,163,"Illinois","St. Clair County",1,68,2831,1317,1514
050,17,163,"Illinois","St. Clair County",1,69,2534,1172,1362
050,17,163,"Illinois","St. Clair County",1,70,2389,1097,1292
050,17,163,"Illinois","St. Clair County",1,71,2295,1080,1215
050,17,163,"Illinois","St. Clair County",1,72,2266,1085,1181
050,17,163,"Illinois","St. Clair County",1,73,2250,1053,1197
050,17,163,"Illinois","St. Clair County",1,74,1569,682,887
050,17,163,"Illinois","St. Clair County",1,75,1541,690,851
050,17,163,"Illinois","St. Clair County",1,76,1461,658,803
050,17,163,"Illinois","St. Clair County",1,77,1451,637,814
050,17,163,"Illinois","St. Clair County",1,78,1296,566,730
050,17,163,"Illinois","St. Clair County",1,79,1130,484,646
050,17,163,"Illinois","St. Clair County",1,80,1054,437,617
050,17,163,"Illinois","St. Clair County",1,81,971,382,589
050,17,163,"Illinois","St. Clair County",1,82,930,354,576
050,17,163,"Illinois","St. Clair County",1,83,831,315,516
050,17,163,"Illinois","St. Clair County",1,84,759,290,469
050,17,163,"Illinois","St. Clair County",1,85,4771,1581,3190
050,17,163,"Illinois","St. Clair County",2,0,2901,1493,1408
050,17,163,"Illinois","St. Clair County",2,1,3003,1525,1478
050,17,163,"Illinois","St. Clair County",2,2,3187,1614,1573
050,17,163,"Illinois","St. Clair County",2,3,3194,1657,1537
050,17,163,"Illinois","St. Clair County",2,4,3370,1745,1625
050,17,163,"Illinois","St. Clair County",2,5,3407,1753,1654
050,17,163,"Illinois","St. Clair County",2,6,3348,1737,1611
050,17,163,"Illinois","St. Clair County",2,7,3316,1716,1600
050,17,163,"Illinois","St. Clair County",2,8,3273,1683,1590
050,17,163,"Illinois","St. Clair County",2,9,3306,1721,1585
050,17,163,"Illinois","St. Clair County",2,10,3425,1782,1643
050,17,163,"Illinois","St. Clair County",2,11,3570,1857,1713
050,17,163,"Illinois","St. Clair County",2,12,3652,1873,1779
050,17,163,"Illinois","St. Clair County",2,13,3619,1830,1789
050,17,163,"Illinois","St. Clair County",2,14,3534,1786,1748
050,17,163,"Illinois","St. Clair County",2,15,3499,1796,1703
050,17,163,"Illinois","St. Clair County",2,16,3464,1762,1702
050,17,163,"Illinois","St. Clair County",2,17,3421,1753,1668
050,17,163,"Illinois","St. Clair County",2,18,3214,1682,1532
050,17,163,"Illinois","St. Clair County",2,19,3036,1629,1407
050,17,163,"Illinois","St. Clair County",2,20,2900,1530,1370
050,17,163,"Illinois","St. Clair County",2,21,2870,1477,1393
050,17,163,"Illinois","St. Clair County",2,22,2933,1458,1475
050,17,163,"Illinois","St. Clair County",2,23,2977,1489,1488
050,17,163,"Illinois","St. Clair County",2,24,3003,1505,1498
050,17,163,"Illinois","St. Clair County",2,25,3111,1569,1542
050,17,163,"Illinois","St. Clair County",2,26,3296,1643,1653
050,17,163,"Illinois","St. Clair County",2,27,3360,1658,1702
050,17,163,"Illinois","St. Clair County",2,28,3368,1650,1718
050,17,163,"Illinois","St. Clair County",2,29,3373,1642,1731
050,17,163,"Illinois","St. Clair County",2,30,3345,1610,1735
050,17,163,"Illinois","St. Clair County",2,31,3272,1554,1718
050,17,163,"Illinois","St. Clair County",2,32,3285,1556,1729
050,17,163,"Illinois","St. Clair County",2,33,3294,1568,1726
050,17,163,"Illinois","St. Clair County",2,34,3375,1622,1753
050,17,163,"Illinois","St. Clair County",2,35,3373,1611,1762
050,17,163,"Illinois","St. Clair County",2,36,3348,1588,1760
050,17,163,"Illinois","St. Clair County",2,37,3463,1663,1800
050,17,163,"Illinois","St. Clair County",2,38,3546,1750,1796
050,17,163,"Illinois","St. Clair County",2,39,3558,1773,1785
050,17,163,"Illinois","St. Clair County",2,40,3537,1737,1800
050,17,163,"Illinois","St. Clair County",2,41,3313,1620,1693
050,17,163,"Illinois","St. Clair County",2,42,3184,1500,1684
050,17,163,"Illinois","St. Clair County",2,43,3117,1466,1651
050,17,163,"Illinois","St. Clair County",2,44,2970,1436,1534
050,17,163,"Illinois","St. Clair County",2,45,3042,1478,1564
050,17,163,"Illinois","St. Clair County",2,46,2988,1435,1553
050,17,163,"Illinois","St. Clair County",2,47,3017,1437,1580
050,17,163,"Illinois","St. Clair County",2,48,3152,1519,1633
050,17,163,"Illinois","St. Clair County",2,49,3326,1583,1743
050,17,163,"Illinois","St. Clair County",2,50,3194,1492,1702
050,17,163,"Illinois","St. Clair County",2,51,3061,1439,1622
050,17,163,"Illinois","St. Clair County",2,52,3058,1460,1598
050,17,163,"Illinois","St. Clair County",2,53,3205,1546,1659
050,17,163,"Illinois","St. Clair County",2,54,3371,1626,1745
050,17,163,"Illinois","St. Clair County",2,55,3510,1711,1799
050,17,163,"Illinois","St. Clair County",2,56,3662,1793,1869
050,17,163,"Illinois","St. Clair County",2,57,3671,1801,1870
050,17,163,"Illinois","St. Clair County",2,58,3678,1787,1891
050,17,163,"Illinois","St. Clair County",2,59,3705,1798,1907
050,17,163,"Illinois","St. Clair County",2,60,3603,1754,1849
050,17,163,"Illinois","St. Clair County",2,61,3585,1742,1843
050,17,163,"Illinois","St. Clair County",2,62,3620,1735,1885
050,17,163,"Illinois","St. Clair County",2,63,3552,1675,1877
050,17,163,"Illinois","St. Clair County",2,64,3325,1579,1746
050,17,163,"Illinois","St. Clair County",2,65,3237,1525,1712
050,17,163,"Illinois","St. Clair County",2,66,3066,1436,1630
050,17,163,"Illinois","St. Clair County",2,67,2884,1354,1530
050,17,163,"Illinois","St. Clair County",2,68,2800,1300,1500
050,17,163,"Illinois","St. Clair County",2,69,2612,1206,1406
050,17,163,"Illinois","St. Clair County",2,70,2407,1109,1298
050,17,163,"Illinois","St. Clair County",2,71,2309,1081,1228
050,17,163,"Illinois","St. Clair County",2,72,2213,1048,1165
050,17,163,"Illinois","St. Clair County",2,73,2325,1093,1232
050,17,163,"Illinois","St. Clair County",2,74,1622,718,904
050,17,163,"Illinois","St. Clair County",2,75,1539,679,860
050,17,163,"Illinois","St. Clair County",2,76,1452,654,798
050,17,163,"Illinois","St. Clair County",2,77,1462,646,816
050,17,163,"Illinois","St. Clair County",2,78,1299,565,734
050,17,163,"Illinois","St. Clair County",2,79,1150,490,660
050,17,163,"Illinois","St. Clair County",2,80,1049,442,607
050,17,163,"Illinois","St. Clair County",2,81,957,379,578
050,17,163,"Illinois","St. Clair County",2,82,925,351,574
050,17,163,"Illinois","St. Clair County",2,83,832,311,521
050,17,163,"Illinois","St. Clair County",2,84,762,291,471
050,17,163,"Illinois","St. Clair County",2,85,4707,1558,3149
050,17,163,"Illinois","St. Clair County",3,0,2772,1394,1378
050,17,163,"Illinois","St. Clair County",3,1,2895,1478,1417
050,17,163,"Illinois","St. Clair County",3,2,3008,1521,1487
050,17,163,"Illinois","St. Clair County",3,3,3176,1632,1544
050,17,163,"Illinois","St. Clair County",3,4,3219,1670,1549
050,17,163,"Illinois","St. Clair County",3,5,3371,1760,1611
050,17,163,"Illinois","St. Clair County",3,6,3379,1742,1637
050,17,163,"Illinois","St. Clair County",3,7,3296,1699,1597
050,17,163,"Illinois","St. Clair County",3,8,3366,1742,1624
050,17,163,"Illinois","St. Clair County",3,9,3269,1700,1569
050,17,163,"Illinois","St. Clair County",3,10,3295,1699,1596
050,17,163,"Illinois","St. Clair County",3,11,3456,1817,1639
050,17,163,"Illinois","St. Clair County",3,12,3572,1860,1712
050,17,163,"Illinois","St. Clair County",3,13,3611,1845,1766
050,17,163,"Illinois","St. Clair County",3,14,3579,1788,1791
050,17,163,"Illinois","St. Clair County",3,15,3509,1761,1748
050,17,163,"Illinois","St. Clair County",3,16,3457,1768,1689
050,17,163,"Illinois","St. Clair County",3,17,3472,1766,1706
050,17,163,"Illinois","St. Clair County",3,18,3117,1624,1493
050,17,163,"Illinois","St. Clair County",3,19,2975,1594,1381
050,17,163,"Illinois","St. Clair County",3,20,2868,1565,1303
050,17,163,"Illinois","St. Clair County",3,21,2879,1460,1419
050,17,163,"Illinois","St. Clair County",3,22,2964,1475,1489
050,17,163,"Illinois","St. Clair County",3,23,2968,1508,1460
050,17,163,"Illinois","St. Clair County",3,24,2965,1504,1461
050,17,163,"Illinois","St. Clair County",3,25,2966,1486,1480
050,17,163,"Illinois","St. Clair County",3,26,3054,1521,1533
050,17,163,"Illinois","St. Clair County",3,27,3219,1587,1632
050,17,163,"Illinois","St. Clair County",3,28,3326,1642,1684
050,17,163,"Illinois","St. Clair County",3,29,3348,1643,1705
050,17,163,"Illinois","St. Clair County",3,30,3361,1607,1754
050,17,163,"Illinois","St. Clair County",3,31,3283,1568,1715
050,17,163,"Illinois","St. Clair County",3,32,3250,1549,1701
050,17,163,"Illinois","St. Clair County",3,33,3279,1552,1727
050,17,163,"Illinois","St. Clair County",3,34,3328,1614,1714
050,17,163,"Illinois","St. Clair County",3,35,3421,1647,1774
050,17,163,"Illinois","St. Clair County",3,36,3427,1632,1795
050,17,163,"Illinois","St. Clair County",3,37,3378,1608,1770
050,17,163,"Illinois","St. Clair County",3,38,3437,1640,1797
050,17,163,"Illinois","St. Clair County",3,39,3578,1770,1808
050,17,163,"Illinois","St. Clair County",3,40,3475,1747,1728
050,17,163,"Illinois","St. Clair County",3,41,3513,1709,1804
050,17,163,"Illinois","St. Clair County",3,42,3274,1589,1685
050,17,163,"Illinois","St. Clair County",3,43,3164,1492,1672
050,17,163,"Illinois","St. Clair County",3,44,3111,1466,1645
050,17,163,"Illinois","St. Clair County",3,45,2947,1407,1540
050,17,163,"Illinois","St. Clair County",3,46,3005,1459,1546
050,17,163,"Illinois","St. Clair County",3,47,2942,1401,1541
050,17,163,"Illinois","St. Clair County",3,48,2985,1423,1562
050,17,163,"Illinois","St. Clair County",3,49,3123,1514,1609
050,17,163,"Illinois","St. Clair County",3,50,3279,1546,1733
050,17,163,"Illinois","St. Clair County",3,51,3130,1460,1670
050,17,163,"Illinois","St. Clair County",3,52,3009,1411,1598
050,17,163,"Illinois","St. Clair County",3,53,2958,1422,1536
050,17,163,"Illinois","St. Clair County",3,54,3171,1529,1642
050,17,163,"Illinois","St. Clair County",3,55,3329,1599,1730
050,17,163,"Illinois","St. Clair County",3,56,3478,1705,1773
050,17,163,"Illinois","St. Clair County",3,57,3604,1750,1854
050,17,163,"Illinois","St. Clair County",3,58,3577,1756,1821
050,17,163,"Illinois","St. Clair County",3,59,3611,1748,1863
050,17,163,"Illinois","St. Clair County",3,60,3669,1777,1892
050,17,163,"Illinois","St. Clair County",3,61,3525,1723,1802
050,17,163,"Illinois","St. Clair County",3,62,3476,1691,1785
050,17,163,"Illinois","St. Clair County",3,63,3528,1685,1843
050,17,163,"Illinois","St. Clair County",3,64,3447,1623,1824
050,17,163,"Illinois","St. Clair County",3,65,3254,1538,1716
050,17,163,"Illinois","St. Clair County",3,66,3145,1467,1678
050,17,163,"Illinois","St. Clair County",3,67,2999,1395,1604
050,17,163,"Illinois","St. Clair County",3,68,2808,1322,1486
050,17,163,"Illinois","St. Clair County",3,69,2709,1251,1458
050,17,163,"Illinois","St. Clair County",3,70,2528,1166,1362
050,17,163,"Illinois","St. Clair County",3,71,2327,1083,1244
050,17,163,"Illinois","St. Clair County",3,72,2236,1032,1204
050,17,163,"Illinois","St. Clair County",3,73,2134,1017,1117
050,17,163,"Illinois","St. Clair County",3,74,2254,1058,1196
050,17,163,"Illinois","St. Clair County",3,75,1565,682,883
050,17,163,"Illinois","St. Clair County",3,76,1455,639,816
050,17,163,"Illinois","St. Clair County",3,77,1387,613,774
050,17,163,"Illinois","St. Clair County",3,78,1392,605,787
050,17,163,"Illinois","St. Clair County",3,79,1236,528,708
050,17,163,"Illinois","St. Clair County",3,80,1080,453,627
050,17,163,"Illinois","St. Clair County",3,81,986,410,576
050,17,163,"Illinois","St. Clair County",3,82,882,345,537
050,17,163,"Illinois","St. Clair County",3,83,847,316,531
050,17,163,"Illinois","St. Clair County",3,84,777,294,483
050,17,163,"Illinois","St. Clair County",3,85,4534,1508,3026
050,17,163,"Illinois","St. Clair County",4,0,2471,1247,1224
050,17,163,"Illinois","St. Clair County",4,1,2787,1398,1389
050,17,163,"Illinois","St. Clair County",4,2,2925,1477,1448
050,17,163,"Illinois","St. Clair County",4,3,3004,1512,1492
050,17,163,"Illinois","St. Clair County",4,4,3177,1643,1534
050,17,163,"Illinois","St. Clair County",4,5,3203,1655,1548
050,17,163,"Illinois","St. Clair County",4,6,3312,1747,1565
050,17,163,"Illinois","St. Clair County",4,7,3395,1758,1637
050,17,163,"Illinois","St. Clair County",4,8,3236,1678,1558
050,17,163,"Illinois","St. Clair County",4,9,3310,1697,1613
050,17,163,"Illinois","St. Clair County",4,10,3229,1679,1550
050,17,163,"Illinois","St. Clair County",4,11,3271,1695,1576
050,17,163,"Illinois","St. Clair County",4,12,3383,1751,1632
050,17,163,"Illinois","St. Clair County",4,13,3494,1821,1673
050,17,163,"Illinois","St. Clair County",4,14,3593,1818,1775
050,17,163,"Illinois","St. Clair County",4,15,3544,1764,1780
050,17,163,"Illinois","St. Clair County",4,16,3453,1728,1725
050,17,163,"Illinois","St. Clair County",4,17,3433,1749,1684
050,17,163,"Illinois","St. Clair County",4,18,3186,1656,1530
050,17,163,"Illinois","St. Clair County",4,19,2824,1530,1294
050,17,163,"Illinois","St. Clair County",4,20,2786,1502,1284
050,17,163,"Illinois","St. Clair County",4,21,2900,1514,1386
050,17,163,"Illinois","St. Clair County",4,22,2915,1456,1459
050,17,163,"Illinois","St. Clair County",4,23,2952,1502,1450
050,17,163,"Illinois","St. Clair County",4,24,2938,1458,1480
050,17,163,"Illinois","St. Clair County",4,25,2940,1518,1422
050,17,163,"Illinois","St. Clair County",4,26,2943,1494,1449
050,17,163,"Illinois","St. Clair County",4,27,3065,1529,1536
050,17,163,"Illinois","St. Clair County",4,28,3212,1571,1641
050,17,163,"Illinois","St. Clair County",4,29,3267,1605,1662
050,17,163,"Illinois","St. Clair County",4,30,3310,1641,1669
050,17,163,"Illinois","St. Clair County",4,31,3301,1545,1756
050,17,163,"Illinois","St. Clair County",4,32,3245,1542,1703
050,17,163,"Illinois","St. Clair County",4,33,3275,1558,1717
050,17,163,"Illinois","St. Clair County",4,34,3306,1559,1747
050,17,163,"Illinois","St. Clair County",4,35,3314,1603,1711
050,17,163,"Illinois","St. Clair County",4,36,3403,1629,1774
050,17,163,"Illinois","St. Clair County",4,37,3443,1642,1801
050,17,163,"Illinois","St. Clair County",4,38,3352,1587,1765
050,17,163,"Illinois","St. Clair County",4,39,3421,1643,1778
050,17,163,"Illinois","St. Clair County",4,40,3475,1712,1763
050,17,163,"Illinois","St. Clair County",4,41,3401,1701,1700
050,17,163,"Illinois","St. Clair County",4,42,3457,1665,1792
050,17,163,"Illinois","St. Clair County",4,43,3251,1578,1673
050,17,163,"Illinois","St. Clair County",4,44,3140,1490,1650
050,17,163,"Illinois","St. Clair County",4,45,3081,1479,1602
050,17,163,"Illinois","St. Clair County",4,46,2883,1374,1509
050,17,163,"Illinois","St. Clair County",4,47,2948,1419,1529
050,17,163,"Illinois","St. Clair County",4,48,2876,1367,1509
050,17,163,"Illinois","St. Clair County",4,49,2970,1435,1535
050,17,163,"Illinois","St. Clair County",4,50,3090,1479,1611
050,17,163,"Illinois","St. Clair County",4,51,3253,1541,1712
050,17,163,"Illinois","St. Clair County",4,52,3078,1438,1640
050,17,163,"Illinois","St. Clair County",4,53,2935,1376,1559
050,17,163,"Illinois","St. Clair County",4,54,2954,1422,1532
050,17,163,"Illinois","St. Clair County",4,55,3121,1503,1618
050,17,163,"Illinois","St. Clair County",4,56,3298,1564,1734
050,17,163,"Illinois","St. Clair County",4,57,3402,1667,1735
050,17,163,"Illinois","St. Clair County",4,58,3509,1698,1811
050,17,163,"Illinois","St. Clair County",4,59,3531,1694,1837
050,17,163,"Illinois","St. Clair County",4,60,3530,1706,1824
050,17,163,"Illinois","St. Clair County",4,61,3590,1735,1855
050,17,163,"Illinois","St. Clair County",4,62,3450,1678,1772
050,17,163,"Illinois","St. Clair County",4,63,3364,1633,1731
050,17,163,"Illinois","St. Clair County",4,64,3437,1641,1796
050,17,163,"Illinois","St. Clair County",4,65,3367,1594,1773
050,17,163,"Illinois","St. Clair County",4,66,3157,1490,1667
050,17,163,"Illinois","St. Clair County",4,67,3084,1432,1652
050,17,163,"Illinois","St. Clair County",4,68,2938,1354,1584
050,17,163,"Illinois","St. Clair County",4,69,2739,1279,1460
050,17,163,"Illinois","St. Clair County",4,70,2619,1212,1407
050,17,163,"Illinois","St. Clair County",4,71,2467,1138,1329
050,17,163,"Illinois","St. Clair County",4,72,2246,1035,1211
050,17,163,"Illinois","St. Clair County",4,73,2156,981,1175
050,17,163,"Illinois","St. Clair County",4,74,2066,978,1088
050,17,163,"Illinois","St. Clair County",4,75,2194,1020,1174
050,17,163,"Illinois","St. Clair County",4,76,1490,650,840
050,17,163,"Illinois","St. Clair County",4,77,1399,604,795
050,17,163,"Illinois","St. Clair County",4,78,1317,569,748
050,17,163,"Illinois","St. Clair County",4,79,1346,579,767
050,17,163,"Illinois","St. Clair County",4,80,1163,485,678
050,17,163,"Illinois","St. Clair County",4,81,1028,423,605
050,17,163,"Illinois","St. Clair County",4,82,914,369,545
050,17,163,"Illinois","St. Clair County",4,83,808,306,502
050,17,163,"Illinois","St. Clair County",4,84,807,306,501
050,17,163,"Illinois","St. Clair County",4,85,4418,1470,2948
050,17,163,"Illinois","St. Clair County",5,0,2154,1085,1069
050,17,163,"Illinois","St. Clair County",5,1,2451,1224,1227
050,17,163,"Illinois","St. Clair County",5,2,2784,1386,1398
050,17,163,"Illinois","St. Clair County",5,3,2944,1466,1478
050,17,163,"Illinois","St. Clair County",5,4,3025,1508,1517
050,17,163,"Illinois","St. Clair County",5,5,3222,1647,1575
050,17,163,"Illinois","St. Clair County",5,6,3214,1666,1548
050,17,163,"Illinois","St. Clair County",5,7,3301,1735,1566
050,17,163,"Illinois","St. Clair County",5,8,3362,1759,1603
050,17,163,"Illinois","St. Clair County",5,9,3283,1670,1613
050,17,163,"Illinois","St. Clair County",5,10,3296,1710,1586
050,17,163,"Illinois","St. Clair County",5,11,3218,1665,1553
050,17,163,"Illinois","St. Clair County",5,12,3288,1688,1600
050,17,163,"Illinois","St. Clair County",5,13,3366,1750,1616
050,17,163,"Illinois","St. Clair County",5,14,3486,1796,1690
050,17,163,"Illinois","St. Clair County",5,15,3545,1801,1744
050,17,163,"Illinois","St. Clair County",5,16,3542,1773,1769
050,17,163,"Illinois","St. Clair County",5,17,3421,1705,1716
050,17,163,"Illinois","St. Clair County",5,18,3124,1638,1486
050,17,163,"Illinois","St. Clair County",5,19,2921,1581,1340
050,17,163,"Illinois","St. Clair County",5,20,2722,1483,1239
050,17,163,"Illinois","St. Clair County",5,21,2792,1460,1332
050,17,163,"Illinois","St. Clair County",5,22,2930,1471,1459
050,17,163,"Illinois","St. Clair County",5,23,2996,1504,1492
050,17,163,"Illinois","St. Clair County",5,24,2951,1513,1438
050,17,163,"Illinois","St. Clair County",5,25,2966,1495,1471
050,17,163,"Illinois","St. Clair County",5,26,2877,1467,1410
050,17,163,"Illinois","St. Clair County",5,27,2962,1487,1475
050,17,163,"Illinois","St. Clair County",5,28,3047,1493,1554
050,17,163,"Illinois","St. Clair County",5,29,3181,1573,1608
050,17,163,"Illinois","St. Clair County",5,30,3278,1592,1686
050,17,163,"Illinois","St. Clair County",5,31,3330,1643,1687
050,17,163,"Illinois","St. Clair County",5,32,3270,1559,1711
050,17,163,"Illinois","St. Clair County",5,33,3237,1527,1710
050,17,163,"Illinois","St. Clair County",5,34,3293,1543,1750
050,17,163,"Illinois","St. Clair County",5,35,3322,1575,1747
050,17,163,"Illinois","St. Clair County",5,36,3337,1602,1735
050,17,163,"Illinois","St. Clair County",5,37,3441,1635,1806
050,17,163,"Illinois","St. Clair County",5,38,3459,1653,1806
050,17,163,"Illinois","St. Clair County",5,39,3379,1595,1784
050,17,163,"Illinois","St. Clair County",5,40,3415,1639,1776
050,17,163,"Illinois","St. Clair County",5,41,3442,1697,1745
050,17,163,"Illinois","St. Clair County",5,42,3363,1683,1680
050,17,163,"Illinois","St. Clair County",5,43,3457,1676,1781
050,17,163,"Illinois","St. Clair County",5,44,3220,1560,1660
050,17,163,"Illinois","St. Clair County",5,45,3139,1481,1658
050,17,163,"Illinois","St. Clair County",5,46,3041,1445,1596
050,17,163,"Illinois","St. Clair County",5,47,2868,1374,1494
050,17,163,"Illinois","St. Clair County",5,48,2896,1384,1512
050,17,163,"Illinois","St. Clair County",5,49,2861,1365,1496
050,17,163,"Illinois","St. Clair County",5,50,2921,1403,1518
050,17,163,"Illinois","St. Clair County",5,51,3034,1463,1571
050,17,163,"Illinois","St. Clair County",5,52,3226,1515,1711
050,17,163,"Illinois","St. Clair County",5,53,3046,1418,1628
050,17,163,"Illinois","St. Clair County",5,54,2930,1369,1561
050,17,163,"Illinois","St. Clair County",5,55,2912,1405,1507
050,17,163,"Illinois","St. Clair County",5,56,3096,1486,1610
050,17,163,"Illinois","St. Clair County",5,57,3237,1545,1692
050,17,163,"Illinois","St. Clair County",5,58,3344,1631,1713
050,17,163,"Illinois","St. Clair County",5,59,3477,1674,1803
050,17,163,"Illinois","St. Clair County",5,60,3513,1692,1821
050,17,163,"Illinois","St. Clair County",5,61,3500,1688,1812
050,17,163,"Illinois","St. Clair County",5,62,3530,1694,1836
050,17,163,"Illinois","St. Clair County",5,63,3392,1645,1747
050,17,163,"Illinois","St. Clair County",5,64,3304,1583,1721
050,17,163,"Illinois","St. Clair County",5,65,3405,1624,1781
050,17,163,"Illinois","St. Clair County",5,66,3303,1557,1746
050,17,163,"Illinois","St. Clair County",5,67,3103,1463,1640
050,17,163,"Illinois","St. Clair County",5,68,3001,1380,1621
050,17,163,"Illinois","St. Clair County",5,69,2894,1322,1572
050,17,163,"Illinois","St. Clair County",5,70,2681,1262,1419
050,17,163,"Illinois","St. Clair County",5,71,2542,1180,1362
050,17,163,"Illinois","St. Clair County",5,72,2418,1114,1304
050,17,163,"Illinois","St. Clair County",5,73,2178,999,1179
050,17,163,"Illinois","St. Clair County",5,74,2092,952,1140
050,17,163,"Illinois","St. Clair County",5,75,1990,929,1061
050,17,163,"Illinois","St. Clair County",5,76,2097,967,1130
050,17,163,"Illinois","St. Clair County",5,77,1429,624,805
050,17,163,"Illinois","St. Clair County",5,78,1349,566,783
050,17,163,"Illinois","St. Clair County",5,79,1272,536,736
050,17,163,"Illinois","St. Clair County",5,80,1275,542,733
050,17,163,"Illinois","St. Clair County",5,81,1111,459,652
050,17,163,"Illinois","St. Clair County",5,82,958,387,571
050,17,163,"Illinois","St. Clair County",5,83,843,331,512
050,17,163,"Illinois","St. Clair County",5,84,771,298,473
050,17,163,"Illinois","St. Clair County",5,85,4425,1481,2944
050,17,165,"Illinois","Saline County",1,0,273,142,131
050,17,165,"Illinois","Saline County",1,1,286,153,133
050,17,165,"Illinois","Saline County",1,2,283,138,145
050,17,165,"Illinois","Saline County",1,3,295,151,144
050,17,165,"Illinois","Saline County",1,4,294,149,145
050,17,165,"Illinois","Saline County",1,5,313,146,167
050,17,165,"Illinois","Saline County",1,6,269,130,139
050,17,165,"Illinois","Saline County",1,7,266,135,131
050,17,165,"Illinois","Saline County",1,8,259,123,136
050,17,165,"Illinois","Saline County",1,9,261,145,116
050,17,165,"Illinois","Saline County",1,10,268,153,115
050,17,165,"Illinois","Saline County",1,11,263,133,130
050,17,165,"Illinois","Saline County",1,12,284,156,128
050,17,165,"Illinois","Saline County",1,13,272,136,136
050,17,165,"Illinois","Saline County",1,14,259,125,134
050,17,165,"Illinois","Saline County",1,15,273,142,131
050,17,165,"Illinois","Saline County",1,16,314,166,148
050,17,165,"Illinois","Saline County",1,17,302,163,139
050,17,165,"Illinois","Saline County",1,18,257,146,111
050,17,165,"Illinois","Saline County",1,19,185,103,82
050,17,165,"Illinois","Saline County",1,20,214,118,96
050,17,165,"Illinois","Saline County",1,21,230,120,110
050,17,165,"Illinois","Saline County",1,22,247,128,119
050,17,165,"Illinois","Saline County",1,23,253,118,135
050,17,165,"Illinois","Saline County",1,24,251,111,140
050,17,165,"Illinois","Saline County",1,25,241,119,122
050,17,165,"Illinois","Saline County",1,26,272,137,135
050,17,165,"Illinois","Saline County",1,27,298,160,138
050,17,165,"Illinois","Saline County",1,28,326,161,165
050,17,165,"Illinois","Saline County",1,29,311,152,159
050,17,165,"Illinois","Saline County",1,30,308,138,170
050,17,165,"Illinois","Saline County",1,31,274,132,142
050,17,165,"Illinois","Saline County",1,32,263,133,130
050,17,165,"Illinois","Saline County",1,33,273,145,128
050,17,165,"Illinois","Saline County",1,34,277,153,124
050,17,165,"Illinois","Saline County",1,35,297,147,150
050,17,165,"Illinois","Saline County",1,36,293,143,150
050,17,165,"Illinois","Saline County",1,37,271,118,153
050,17,165,"Illinois","Saline County",1,38,268,139,129
050,17,165,"Illinois","Saline County",1,39,300,153,147
050,17,165,"Illinois","Saline County",1,40,293,145,148
050,17,165,"Illinois","Saline County",1,41,268,127,141
050,17,165,"Illinois","Saline County",1,42,273,131,142
050,17,165,"Illinois","Saline County",1,43,269,131,138
050,17,165,"Illinois","Saline County",1,44,245,127,118
050,17,165,"Illinois","Saline County",1,45,259,117,142
050,17,165,"Illinois","Saline County",1,46,273,125,148
050,17,165,"Illinois","Saline County",1,47,285,144,141
050,17,165,"Illinois","Saline County",1,48,312,157,155
050,17,165,"Illinois","Saline County",1,49,339,173,166
050,17,165,"Illinois","Saline County",1,50,324,169,155
050,17,165,"Illinois","Saline County",1,51,301,160,141
050,17,165,"Illinois","Saline County",1,52,299,149,150
050,17,165,"Illinois","Saline County",1,53,336,175,161
050,17,165,"Illinois","Saline County",1,54,335,169,166
050,17,165,"Illinois","Saline County",1,55,350,169,181
050,17,165,"Illinois","Saline County",1,56,361,157,204
050,17,165,"Illinois","Saline County",1,57,348,176,172
050,17,165,"Illinois","Saline County",1,58,357,182,175
050,17,165,"Illinois","Saline County",1,59,345,162,183
050,17,165,"Illinois","Saline County",1,60,358,171,187
050,17,165,"Illinois","Saline County",1,61,351,165,186
050,17,165,"Illinois","Saline County",1,62,360,166,194
050,17,165,"Illinois","Saline County",1,63,359,169,190
050,17,165,"Illinois","Saline County",1,64,339,159,180
050,17,165,"Illinois","Saline County",1,65,307,147,160
050,17,165,"Illinois","Saline County",1,66,307,154,153
050,17,165,"Illinois","Saline County",1,67,329,162,167
050,17,165,"Illinois","Saline County",1,68,310,166,144
050,17,165,"Illinois","Saline County",1,69,280,138,142
050,17,165,"Illinois","Saline County",1,70,272,127,145
050,17,165,"Illinois","Saline County",1,71,251,117,134
050,17,165,"Illinois","Saline County",1,72,264,121,143
050,17,165,"Illinois","Saline County",1,73,280,129,151
050,17,165,"Illinois","Saline County",1,74,190,94,96
050,17,165,"Illinois","Saline County",1,75,198,101,97
050,17,165,"Illinois","Saline County",1,76,207,94,113
050,17,165,"Illinois","Saline County",1,77,191,86,105
050,17,165,"Illinois","Saline County",1,78,177,80,97
050,17,165,"Illinois","Saline County",1,79,156,64,92
050,17,165,"Illinois","Saline County",1,80,119,39,80
050,17,165,"Illinois","Saline County",1,81,135,56,79
050,17,165,"Illinois","Saline County",1,82,112,44,68
050,17,165,"Illinois","Saline County",1,83,104,33,71
050,17,165,"Illinois","Saline County",1,84,101,32,69
050,17,165,"Illinois","Saline County",1,85,600,228,372
050,17,165,"Illinois","Saline County",2,0,266,140,126
050,17,165,"Illinois","Saline County",2,1,281,149,132
050,17,165,"Illinois","Saline County",2,2,283,139,144
050,17,165,"Illinois","Saline County",2,3,287,146,141
050,17,165,"Illinois","Saline County",2,4,294,149,145
050,17,165,"Illinois","Saline County",2,5,307,147,160
050,17,165,"Illinois","Saline County",2,6,279,134,145
050,17,165,"Illinois","Saline County",2,7,263,131,132
050,17,165,"Illinois","Saline County",2,8,258,124,134
050,17,165,"Illinois","Saline County",2,9,259,140,119
050,17,165,"Illinois","Saline County",2,10,265,150,115
050,17,165,"Illinois","Saline County",2,11,266,139,127
050,17,165,"Illinois","Saline County",2,12,282,152,130
050,17,165,"Illinois","Saline County",2,13,272,139,133
050,17,165,"Illinois","Saline County",2,14,262,127,135
050,17,165,"Illinois","Saline County",2,15,272,140,132
050,17,165,"Illinois","Saline County",2,16,306,162,144
050,17,165,"Illinois","Saline County",2,17,307,165,142
050,17,165,"Illinois","Saline County",2,18,255,143,112
050,17,165,"Illinois","Saline County",2,19,191,106,85
050,17,165,"Illinois","Saline County",2,20,212,116,96
050,17,165,"Illinois","Saline County",2,21,228,120,108
050,17,165,"Illinois","Saline County",2,22,245,127,118
050,17,165,"Illinois","Saline County",2,23,252,119,133
050,17,165,"Illinois","Saline County",2,24,250,111,139
050,17,165,"Illinois","Saline County",2,25,242,117,125
050,17,165,"Illinois","Saline County",2,26,266,135,131
050,17,165,"Illinois","Saline County",2,27,292,156,136
050,17,165,"Illinois","Saline County",2,28,316,160,156
050,17,165,"Illinois","Saline County",2,29,313,153,160
050,17,165,"Illinois","Saline County",2,30,313,142,171
050,17,165,"Illinois","Saline County",2,31,278,131,147
050,17,165,"Illinois","Saline County",2,32,261,130,131
050,17,165,"Illinois","Saline County",2,33,266,140,126
050,17,165,"Illinois","Saline County",2,34,275,149,126
050,17,165,"Illinois","Saline County",2,35,292,147,145
050,17,165,"Illinois","Saline County",2,36,290,141,149
050,17,165,"Illinois","Saline County",2,37,275,123,152
050,17,165,"Illinois","Saline County",2,38,269,135,134
050,17,165,"Illinois","Saline County",2,39,290,148,142
050,17,165,"Illinois","Saline County",2,40,296,148,148
050,17,165,"Illinois","Saline County",2,41,274,131,143
050,17,165,"Illinois","Saline County",2,42,267,129,138
050,17,165,"Illinois","Saline County",2,43,271,132,139
050,17,165,"Illinois","Saline County",2,44,246,126,120
050,17,165,"Illinois","Saline County",2,45,258,119,139
050,17,165,"Illinois","Saline County",2,46,268,122,146
050,17,165,"Illinois","Saline County",2,47,282,139,143
050,17,165,"Illinois","Saline County",2,48,301,151,150
050,17,165,"Illinois","Saline County",2,49,332,171,161
050,17,165,"Illinois","Saline County",2,50,327,170,157
050,17,165,"Illinois","Saline County",2,51,303,160,143
050,17,165,"Illinois","Saline County",2,52,299,151,148
050,17,165,"Illinois","Saline County",2,53,328,171,157
050,17,165,"Illinois","Saline County",2,54,335,170,165
050,17,165,"Illinois","Saline County",2,55,346,168,178
050,17,165,"Illinois","Saline County",2,56,360,161,199
050,17,165,"Illinois","Saline County",2,57,348,171,177
050,17,165,"Illinois","Saline County",2,58,356,181,175
050,17,165,"Illinois","Saline County",2,59,348,166,182
050,17,165,"Illinois","Saline County",2,60,355,171,184
050,17,165,"Illinois","Saline County",2,61,354,165,189
050,17,165,"Illinois","Saline County",2,62,354,164,190
050,17,165,"Illinois","Saline County",2,63,360,170,190
050,17,165,"Illinois","Saline County",2,64,342,161,181
050,17,165,"Illinois","Saline County",2,65,315,151,164
050,17,165,"Illinois","Saline County",2,66,308,155,153
050,17,165,"Illinois","Saline County",2,67,322,159,163
050,17,165,"Illinois","Saline County",2,68,311,163,148
050,17,165,"Illinois","Saline County",2,69,284,143,141
050,17,165,"Illinois","Saline County",2,70,274,130,144
050,17,165,"Illinois","Saline County",2,71,253,117,136
050,17,165,"Illinois","Saline County",2,72,255,117,138
050,17,165,"Illinois","Saline County",2,73,288,132,156
050,17,165,"Illinois","Saline County",2,74,196,93,103
050,17,165,"Illinois","Saline County",2,75,195,100,95
050,17,165,"Illinois","Saline County",2,76,201,93,108
050,17,165,"Illinois","Saline County",2,77,196,89,107
050,17,165,"Illinois","Saline County",2,78,176,78,98
050,17,165,"Illinois","Saline County",2,79,156,65,91
050,17,165,"Illinois","Saline County",2,80,124,44,80
050,17,165,"Illinois","Saline County",2,81,130,50,80
050,17,165,"Illinois","Saline County",2,82,115,46,69
050,17,165,"Illinois","Saline County",2,83,105,35,70
050,17,165,"Illinois","Saline County",2,84,100,32,68
050,17,165,"Illinois","Saline County",2,85,596,221,375
050,17,165,"Illinois","Saline County",3,0,241,137,104
050,17,165,"Illinois","Saline County",3,1,268,147,121
050,17,165,"Illinois","Saline County",3,2,279,139,140
050,17,165,"Illinois","Saline County",3,3,268,133,135
050,17,165,"Illinois","Saline County",3,4,278,145,133
050,17,165,"Illinois","Saline County",3,5,282,151,131
050,17,165,"Illinois","Saline County",3,6,293,146,147
050,17,165,"Illinois","Saline County",3,7,286,128,158
050,17,165,"Illinois","Saline County",3,8,259,129,130
050,17,165,"Illinois","Saline County",3,9,263,134,129
050,17,165,"Illinois","Saline County",3,10,250,135,115
050,17,165,"Illinois","Saline County",3,11,265,148,117
050,17,165,"Illinois","Saline County",3,12,268,141,127
050,17,165,"Illinois","Saline County",3,13,283,148,135
050,17,165,"Illinois","Saline County",3,14,268,140,128
050,17,165,"Illinois","Saline County",3,15,267,136,131
050,17,165,"Illinois","Saline County",3,16,282,152,130
050,17,165,"Illinois","Saline County",3,17,299,164,135
050,17,165,"Illinois","Saline County",3,18,264,144,120
050,17,165,"Illinois","Saline County",3,19,202,114,88
050,17,165,"Illinois","Saline County",3,20,202,108,94
050,17,165,"Illinois","Saline County",3,21,229,122,107
050,17,165,"Illinois","Saline County",3,22,232,122,110
050,17,165,"Illinois","Saline County",3,23,252,128,124
050,17,165,"Illinois","Saline County",3,24,245,112,133
050,17,165,"Illinois","Saline County",3,25,249,118,131
050,17,165,"Illinois","Saline County",3,26,232,108,124
050,17,165,"Illinois","Saline County",3,27,273,144,129
050,17,165,"Illinois","Saline County",3,28,292,163,129
050,17,165,"Illinois","Saline County",3,29,305,146,159
050,17,165,"Illinois","Saline County",3,30,300,145,155
050,17,165,"Illinois","Saline County",3,31,302,143,159
050,17,165,"Illinois","Saline County",3,32,287,129,158
050,17,165,"Illinois","Saline County",3,33,260,131,129
050,17,165,"Illinois","Saline County",3,34,251,129,122
050,17,165,"Illinois","Saline County",3,35,276,149,127
050,17,165,"Illinois","Saline County",3,36,291,148,143
050,17,165,"Illinois","Saline County",3,37,284,138,146
050,17,165,"Illinois","Saline County",3,38,275,120,155
050,17,165,"Illinois","Saline County",3,39,263,133,130
050,17,165,"Illinois","Saline County",3,40,285,149,136
050,17,165,"Illinois","Saline County",3,41,296,145,151
050,17,165,"Illinois","Saline County",3,42,280,137,143
050,17,165,"Illinois","Saline County",3,43,265,127,138
050,17,165,"Illinois","Saline County",3,44,269,132,137
050,17,165,"Illinois","Saline County",3,45,239,119,120
050,17,165,"Illinois","Saline County",3,46,256,123,133
050,17,165,"Illinois","Saline County",3,47,267,124,143
050,17,165,"Illinois","Saline County",3,48,278,139,139
050,17,165,"Illinois","Saline County",3,49,299,155,144
050,17,165,"Illinois","Saline County",3,50,323,162,161
050,17,165,"Illinois","Saline County",3,51,321,163,158
050,17,165,"Illinois","Saline County",3,52,309,162,147
050,17,165,"Illinois","Saline County",3,53,300,158,142
050,17,165,"Illinois","Saline County",3,54,321,167,154
050,17,165,"Illinois","Saline County",3,55,329,169,160
050,17,165,"Illinois","Saline County",3,56,338,162,176
050,17,165,"Illinois","Saline County",3,57,356,162,194
050,17,165,"Illinois","Saline County",3,58,344,171,173
050,17,165,"Illinois","Saline County",3,59,361,186,175
050,17,165,"Illinois","Saline County",3,60,328,161,167
050,17,165,"Illinois","Saline County",3,61,353,161,192
050,17,165,"Illinois","Saline County",3,62,339,163,176
050,17,165,"Illinois","Saline County",3,63,355,167,188
050,17,165,"Illinois","Saline County",3,64,347,165,182
050,17,165,"Illinois","Saline County",3,65,333,155,178
050,17,165,"Illinois","Saline County",3,66,311,153,158
050,17,165,"Illinois","Saline County",3,67,300,152,148
050,17,165,"Illinois","Saline County",3,68,312,149,163
050,17,165,"Illinois","Saline County",3,69,293,150,143
050,17,165,"Illinois","Saline County",3,70,280,138,142
050,17,165,"Illinois","Saline County",3,71,261,125,136
050,17,165,"Illinois","Saline County",3,72,247,116,131
050,17,165,"Illinois","Saline County",3,73,245,112,133
050,17,165,"Illinois","Saline County",3,74,264,118,146
050,17,165,"Illinois","Saline County",3,75,190,98,92
050,17,165,"Illinois","Saline County",3,76,184,89,95
050,17,165,"Illinois","Saline County",3,77,184,83,101
050,17,165,"Illinois","Saline County",3,78,193,86,107
050,17,165,"Illinois","Saline County",3,79,156,68,88
050,17,165,"Illinois","Saline County",3,80,139,59,80
050,17,165,"Illinois","Saline County",3,81,128,45,83
050,17,165,"Illinois","Saline County",3,82,108,44,64
050,17,165,"Illinois","Saline County",3,83,107,40,67
050,17,165,"Illinois","Saline County",3,84,96,30,66
050,17,165,"Illinois","Saline County",3,85,562,197,365
050,17,165,"Illinois","Saline County",4,0,239,119,120
050,17,165,"Illinois","Saline County",4,1,248,140,108
050,17,165,"Illinois","Saline County",4,2,267,143,124
050,17,165,"Illinois","Saline County",4,3,263,128,135
050,17,165,"Illinois","Saline County",4,4,272,129,143
050,17,165,"Illinois","Saline County",4,5,273,139,134
050,17,165,"Illinois","Saline County",4,6,271,148,123
050,17,165,"Illinois","Saline County",4,7,291,146,145
050,17,165,"Illinois","Saline County",4,8,276,130,146
050,17,165,"Illinois","Saline County",4,9,250,120,130
050,17,165,"Illinois","Saline County",4,10,258,132,126
050,17,165,"Illinois","Saline County",4,11,242,136,106
050,17,165,"Illinois","Saline County",4,12,268,149,119
050,17,165,"Illinois","Saline County",4,13,268,141,127
050,17,165,"Illinois","Saline County",4,14,279,148,131
050,17,165,"Illinois","Saline County",4,15,278,150,128
050,17,165,"Illinois","Saline County",4,16,280,144,136
050,17,165,"Illinois","Saline County",4,17,274,143,131
050,17,165,"Illinois","Saline County",4,18,251,140,111
050,17,165,"Illinois","Saline County",4,19,207,110,97
050,17,165,"Illinois","Saline County",4,20,218,118,100
050,17,165,"Illinois","Saline County",4,21,210,112,98
050,17,165,"Illinois","Saline County",4,22,245,135,110
050,17,165,"Illinois","Saline County",4,23,239,125,114
050,17,165,"Illinois","Saline County",4,24,246,126,120
050,17,165,"Illinois","Saline County",4,25,239,104,135
050,17,165,"Illinois","Saline County",4,26,251,121,130
050,17,165,"Illinois","Saline County",4,27,243,111,132
050,17,165,"Illinois","Saline County",4,28,266,142,124
050,17,165,"Illinois","Saline County",4,29,290,160,130
050,17,165,"Illinois","Saline County",4,30,305,153,152
050,17,165,"Illinois","Saline County",4,31,293,139,154
050,17,165,"Illinois","Saline County",4,32,298,140,158
050,17,165,"Illinois","Saline County",4,33,285,129,156
050,17,165,"Illinois","Saline County",4,34,251,124,127
050,17,165,"Illinois","Saline County",4,35,248,128,120
050,17,165,"Illinois","Saline County",4,36,280,152,128
050,17,165,"Illinois","Saline County",4,37,285,147,138
050,17,165,"Illinois","Saline County",4,38,291,144,147
050,17,165,"Illinois","Saline County",4,39,265,118,147
050,17,165,"Illinois","Saline County",4,40,269,142,127
050,17,165,"Illinois","Saline County",4,41,292,153,139
050,17,165,"Illinois","Saline County",4,42,304,148,156
050,17,165,"Illinois","Saline County",4,43,282,139,143
050,17,165,"Illinois","Saline County",4,44,257,128,129
050,17,165,"Illinois","Saline County",4,45,261,125,136
050,17,165,"Illinois","Saline County",4,46,244,124,120
050,17,165,"Illinois","Saline County",4,47,262,125,137
050,17,165,"Illinois","Saline County",4,48,262,121,141
050,17,165,"Illinois","Saline County",4,49,274,142,132
050,17,165,"Illinois","Saline County",4,50,302,158,144
050,17,165,"Illinois","Saline County",4,51,314,155,159
050,17,165,"Illinois","Saline County",4,52,322,165,157
050,17,165,"Illinois","Saline County",4,53,312,165,147
050,17,165,"Illinois","Saline County",4,54,288,147,141
050,17,165,"Illinois","Saline County",4,55,317,164,153
050,17,165,"Illinois","Saline County",4,56,329,166,163
050,17,165,"Illinois","Saline County",4,57,321,153,168
050,17,165,"Illinois","Saline County",4,58,341,156,185
050,17,165,"Illinois","Saline County",4,59,325,163,162
050,17,165,"Illinois","Saline County",4,60,353,189,164
050,17,165,"Illinois","Saline County",4,61,334,154,180
050,17,165,"Illinois","Saline County",4,62,348,163,185
050,17,165,"Illinois","Saline County",4,63,335,161,174
050,17,165,"Illinois","Saline County",4,64,349,163,186
050,17,165,"Illinois","Saline County",4,65,339,158,181
050,17,165,"Illinois","Saline County",4,66,332,158,174
050,17,165,"Illinois","Saline County",4,67,304,153,151
050,17,165,"Illinois","Saline County",4,68,297,150,147
050,17,165,"Illinois","Saline County",4,69,305,144,161
050,17,165,"Illinois","Saline County",4,70,285,146,139
050,17,165,"Illinois","Saline County",4,71,269,132,137
050,17,165,"Illinois","Saline County",4,72,250,120,130
050,17,165,"Illinois","Saline County",4,73,241,116,125
050,17,165,"Illinois","Saline County",4,74,227,102,125
050,17,165,"Illinois","Saline County",4,75,251,115,136
050,17,165,"Illinois","Saline County",4,76,176,88,88
050,17,165,"Illinois","Saline County",4,77,171,83,88
050,17,165,"Illinois","Saline County",4,78,178,78,100
050,17,165,"Illinois","Saline County",4,79,184,78,106
050,17,165,"Illinois","Saline County",4,80,134,55,79
050,17,165,"Illinois","Saline County",4,81,143,59,84
050,17,165,"Illinois","Saline County",4,82,109,40,69
050,17,165,"Illinois","Saline County",4,83,100,37,63
050,17,165,"Illinois","Saline County",4,84,101,39,62
050,17,165,"Illinois","Saline County",4,85,556,185,371
050,17,165,"Illinois","Saline County",5,0,224,113,111
050,17,165,"Illinois","Saline County",5,1,232,113,119
050,17,165,"Illinois","Saline County",5,2,252,137,115
050,17,165,"Illinois","Saline County",5,3,267,141,126
050,17,165,"Illinois","Saline County",5,4,256,126,130
050,17,165,"Illinois","Saline County",5,5,271,131,140
050,17,165,"Illinois","Saline County",5,6,263,138,125
050,17,165,"Illinois","Saline County",5,7,277,149,128
050,17,165,"Illinois","Saline County",5,8,287,143,144
050,17,165,"Illinois","Saline County",5,9,272,130,142
050,17,165,"Illinois","Saline County",5,10,243,122,121
050,17,165,"Illinois","Saline County",5,11,251,122,129
050,17,165,"Illinois","Saline County",5,12,239,132,107
050,17,165,"Illinois","Saline County",5,13,261,147,114
050,17,165,"Illinois","Saline County",5,14,266,136,130
050,17,165,"Illinois","Saline County",5,15,286,155,131
050,17,165,"Illinois","Saline County",5,16,281,154,127
050,17,165,"Illinois","Saline County",5,17,282,149,133
050,17,165,"Illinois","Saline County",5,18,231,120,111
050,17,165,"Illinois","Saline County",5,19,201,111,90
050,17,165,"Illinois","Saline County",5,20,223,114,109
050,17,165,"Illinois","Saline County",5,21,233,126,107
050,17,165,"Illinois","Saline County",5,22,208,104,104
050,17,165,"Illinois","Saline County",5,23,265,146,119
050,17,165,"Illinois","Saline County",5,24,229,114,115
050,17,165,"Illinois","Saline County",5,25,239,125,114
050,17,165,"Illinois","Saline County",5,26,232,103,129
050,17,165,"Illinois","Saline County",5,27,263,126,137
050,17,165,"Illinois","Saline County",5,28,242,109,133
050,17,165,"Illinois","Saline County",5,29,266,144,122
050,17,165,"Illinois","Saline County",5,30,298,163,135
050,17,165,"Illinois","Saline County",5,31,297,149,148
050,17,165,"Illinois","Saline County",5,32,304,149,155
050,17,165,"Illinois","Saline County",5,33,309,144,165
050,17,165,"Illinois","Saline County",5,34,283,138,145
050,17,165,"Illinois","Saline County",5,35,246,122,124
050,17,165,"Illinois","Saline County",5,36,260,134,126
050,17,165,"Illinois","Saline County",5,37,277,141,136
050,17,165,"Illinois","Saline County",5,38,283,148,135
050,17,165,"Illinois","Saline County",5,39,289,135,154
050,17,165,"Illinois","Saline County",5,40,271,124,147
050,17,165,"Illinois","Saline County",5,41,263,128,135
050,17,165,"Illinois","Saline County",5,42,288,148,140
050,17,165,"Illinois","Saline County",5,43,315,153,162
050,17,165,"Illinois","Saline County",5,44,270,140,130
050,17,165,"Illinois","Saline County",5,45,252,122,130
050,17,165,"Illinois","Saline County",5,46,256,123,133
050,17,165,"Illinois","Saline County",5,47,255,126,129
050,17,165,"Illinois","Saline County",5,48,263,123,140
050,17,165,"Illinois","Saline County",5,49,260,125,135
050,17,165,"Illinois","Saline County",5,50,277,138,139
050,17,165,"Illinois","Saline County",5,51,294,150,144
050,17,165,"Illinois","Saline County",5,52,321,159,162
050,17,165,"Illinois","Saline County",5,53,319,170,149
050,17,165,"Illinois","Saline County",5,54,299,153,146
050,17,165,"Illinois","Saline County",5,55,286,149,137
050,17,165,"Illinois","Saline County",5,56,324,170,154
050,17,165,"Illinois","Saline County",5,57,321,164,157
050,17,165,"Illinois","Saline County",5,58,322,153,169
050,17,165,"Illinois","Saline County",5,59,333,152,181
050,17,165,"Illinois","Saline County",5,60,319,166,153
050,17,165,"Illinois","Saline County",5,61,350,181,169
050,17,165,"Illinois","Saline County",5,62,326,157,169
050,17,165,"Illinois","Saline County",5,63,351,163,188
050,17,165,"Illinois","Saline County",5,64,328,158,170
050,17,165,"Illinois","Saline County",5,65,344,159,185
050,17,165,"Illinois","Saline County",5,66,336,163,173
050,17,165,"Illinois","Saline County",5,67,324,155,169
050,17,165,"Illinois","Saline County",5,68,300,147,153
050,17,165,"Illinois","Saline County",5,69,281,140,141
050,17,165,"Illinois","Saline County",5,70,294,139,155
050,17,165,"Illinois","Saline County",5,71,279,140,139
050,17,165,"Illinois","Saline County",5,72,258,129,129
050,17,165,"Illinois","Saline County",5,73,245,120,125
050,17,165,"Illinois","Saline County",5,74,224,106,118
050,17,165,"Illinois","Saline County",5,75,221,104,117
050,17,165,"Illinois","Saline County",5,76,230,100,130
050,17,165,"Illinois","Saline County",5,77,161,84,77
050,17,165,"Illinois","Saline County",5,78,167,80,87
050,17,165,"Illinois","Saline County",5,79,166,69,97
050,17,165,"Illinois","Saline County",5,80,169,71,98
050,17,165,"Illinois","Saline County",5,81,135,55,80
050,17,165,"Illinois","Saline County",5,82,125,54,71
050,17,165,"Illinois","Saline County",5,83,99,34,65
050,17,165,"Illinois","Saline County",5,84,96,37,59
050,17,165,"Illinois","Saline County",5,85,568,185,383
050,17,167,"Illinois","Sangamon County",1,0,2179,1126,1053
050,17,167,"Illinois","Sangamon County",1,1,2240,1171,1069
050,17,167,"Illinois","Sangamon County",1,2,2268,1160,1108
050,17,167,"Illinois","Sangamon County",1,3,2257,1186,1071
050,17,167,"Illinois","Sangamon County",1,4,2305,1175,1130
050,17,167,"Illinois","Sangamon County",1,5,2297,1166,1131
050,17,167,"Illinois","Sangamon County",1,6,2284,1155,1129
050,17,167,"Illinois","Sangamon County",1,7,2326,1195,1131
050,17,167,"Illinois","Sangamon County",1,8,2371,1272,1099
050,17,167,"Illinois","Sangamon County",1,9,2462,1335,1127
050,17,167,"Illinois","Sangamon County",1,10,2504,1287,1217
050,17,167,"Illinois","Sangamon County",1,11,2539,1282,1257
050,17,167,"Illinois","Sangamon County",1,12,2639,1304,1335
050,17,167,"Illinois","Sangamon County",1,13,2650,1325,1325
050,17,167,"Illinois","Sangamon County",1,14,2614,1341,1273
050,17,167,"Illinois","Sangamon County",1,15,2662,1359,1303
050,17,167,"Illinois","Sangamon County",1,16,2677,1347,1330
050,17,167,"Illinois","Sangamon County",1,17,2598,1328,1270
050,17,167,"Illinois","Sangamon County",1,18,2324,1199,1125
050,17,167,"Illinois","Sangamon County",1,19,2075,1081,994
050,17,167,"Illinois","Sangamon County",1,20,2111,1057,1054
050,17,167,"Illinois","Sangamon County",1,21,2226,1089,1137
050,17,167,"Illinois","Sangamon County",1,22,2242,1113,1129
050,17,167,"Illinois","Sangamon County",1,23,2205,1118,1087
050,17,167,"Illinois","Sangamon County",1,24,2266,1134,1132
050,17,167,"Illinois","Sangamon County",1,25,2246,1084,1162
050,17,167,"Illinois","Sangamon County",1,26,2359,1133,1226
050,17,167,"Illinois","Sangamon County",1,27,2399,1150,1249
050,17,167,"Illinois","Sangamon County",1,28,2416,1153,1263
050,17,167,"Illinois","Sangamon County",1,29,2432,1149,1283
050,17,167,"Illinois","Sangamon County",1,30,2478,1193,1285
050,17,167,"Illinois","Sangamon County",1,31,2390,1145,1245
050,17,167,"Illinois","Sangamon County",1,32,2391,1102,1289
050,17,167,"Illinois","Sangamon County",1,33,2465,1223,1242
050,17,167,"Illinois","Sangamon County",1,34,2540,1242,1298
050,17,167,"Illinois","Sangamon County",1,35,2566,1237,1329
050,17,167,"Illinois","Sangamon County",1,36,2566,1224,1342
050,17,167,"Illinois","Sangamon County",1,37,2611,1224,1387
050,17,167,"Illinois","Sangamon County",1,38,2555,1236,1319
050,17,167,"Illinois","Sangamon County",1,39,2583,1259,1324
050,17,167,"Illinois","Sangamon County",1,40,2549,1215,1334
050,17,167,"Illinois","Sangamon County",1,41,2479,1224,1255
050,17,167,"Illinois","Sangamon County",1,42,2455,1248,1207
050,17,167,"Illinois","Sangamon County",1,43,2290,1158,1132
050,17,167,"Illinois","Sangamon County",1,44,2246,1110,1136
050,17,167,"Illinois","Sangamon County",1,45,2202,1047,1155
050,17,167,"Illinois","Sangamon County",1,46,2238,1093,1145
050,17,167,"Illinois","Sangamon County",1,47,2261,1082,1179
050,17,167,"Illinois","Sangamon County",1,48,2467,1226,1241
050,17,167,"Illinois","Sangamon County",1,49,2697,1317,1380
050,17,167,"Illinois","Sangamon County",1,50,2484,1230,1254
050,17,167,"Illinois","Sangamon County",1,51,2458,1226,1232
050,17,167,"Illinois","Sangamon County",1,52,2371,1154,1217
050,17,167,"Illinois","Sangamon County",1,53,2470,1212,1258
050,17,167,"Illinois","Sangamon County",1,54,2572,1281,1291
050,17,167,"Illinois","Sangamon County",1,55,2782,1383,1399
050,17,167,"Illinois","Sangamon County",1,56,2873,1404,1469
050,17,167,"Illinois","Sangamon County",1,57,2866,1385,1481
050,17,167,"Illinois","Sangamon County",1,58,2913,1421,1492
050,17,167,"Illinois","Sangamon County",1,59,2857,1422,1435
050,17,167,"Illinois","Sangamon County",1,60,2797,1334,1463
050,17,167,"Illinois","Sangamon County",1,61,2796,1329,1467
050,17,167,"Illinois","Sangamon County",1,62,2811,1349,1462
050,17,167,"Illinois","Sangamon County",1,63,2701,1279,1422
050,17,167,"Illinois","Sangamon County",1,64,2594,1197,1397
050,17,167,"Illinois","Sangamon County",1,65,2561,1198,1363
050,17,167,"Illinois","Sangamon County",1,66,2454,1150,1304
050,17,167,"Illinois","Sangamon County",1,67,2416,1133,1283
050,17,167,"Illinois","Sangamon County",1,68,2382,1105,1277
050,17,167,"Illinois","Sangamon County",1,69,2257,1031,1226
050,17,167,"Illinois","Sangamon County",1,70,2188,1022,1166
050,17,167,"Illinois","Sangamon County",1,71,2111,952,1159
050,17,167,"Illinois","Sangamon County",1,72,2074,919,1155
050,17,167,"Illinois","Sangamon County",1,73,1985,899,1086
050,17,167,"Illinois","Sangamon County",1,74,1337,585,752
050,17,167,"Illinois","Sangamon County",1,75,1340,594,746
050,17,167,"Illinois","Sangamon County",1,76,1295,565,730
050,17,167,"Illinois","Sangamon County",1,77,1266,542,724
050,17,167,"Illinois","Sangamon County",1,78,1112,467,645
050,17,167,"Illinois","Sangamon County",1,79,986,410,576
050,17,167,"Illinois","Sangamon County",1,80,901,359,542
050,17,167,"Illinois","Sangamon County",1,81,905,364,541
050,17,167,"Illinois","Sangamon County",1,82,792,315,477
050,17,167,"Illinois","Sangamon County",1,83,739,294,445
050,17,167,"Illinois","Sangamon County",1,84,636,256,380
050,17,167,"Illinois","Sangamon County",1,85,4057,1300,2757
050,17,167,"Illinois","Sangamon County",2,0,2166,1123,1043
050,17,167,"Illinois","Sangamon County",2,1,2222,1159,1063
050,17,167,"Illinois","Sangamon County",2,2,2264,1165,1099
050,17,167,"Illinois","Sangamon County",2,3,2257,1180,1077
050,17,167,"Illinois","Sangamon County",2,4,2301,1180,1121
050,17,167,"Illinois","Sangamon County",2,5,2304,1169,1135
050,17,167,"Illinois","Sangamon County",2,6,2295,1158,1137
050,17,167,"Illinois","Sangamon County",2,7,2310,1184,1126
050,17,167,"Illinois","Sangamon County",2,8,2357,1254,1103
050,17,167,"Illinois","Sangamon County",2,9,2436,1316,1120
050,17,167,"Illinois","Sangamon County",2,10,2489,1295,1194
050,17,167,"Illinois","Sangamon County",2,11,2524,1280,1244
050,17,167,"Illinois","Sangamon County",2,12,2630,1305,1325
050,17,167,"Illinois","Sangamon County",2,13,2648,1318,1330
050,17,167,"Illinois","Sangamon County",2,14,2619,1333,1286
050,17,167,"Illinois","Sangamon County",2,15,2652,1357,1295
050,17,167,"Illinois","Sangamon County",2,16,2681,1352,1329
050,17,167,"Illinois","Sangamon County",2,17,2617,1330,1287
050,17,167,"Illinois","Sangamon County",2,18,2305,1190,1115
050,17,167,"Illinois","Sangamon County",2,19,2070,1076,994
050,17,167,"Illinois","Sangamon County",2,20,2155,1083,1072
050,17,167,"Illinois","Sangamon County",2,21,2207,1083,1124
050,17,167,"Illinois","Sangamon County",2,22,2250,1113,1137
050,17,167,"Illinois","Sangamon County",2,23,2215,1118,1097
050,17,167,"Illinois","Sangamon County",2,24,2235,1123,1112
050,17,167,"Illinois","Sangamon County",2,25,2242,1094,1148
050,17,167,"Illinois","Sangamon County",2,26,2331,1124,1207
050,17,167,"Illinois","Sangamon County",2,27,2382,1147,1235
050,17,167,"Illinois","Sangamon County",2,28,2405,1149,1256
050,17,167,"Illinois","Sangamon County",2,29,2424,1148,1276
050,17,167,"Illinois","Sangamon County",2,30,2485,1192,1293
050,17,167,"Illinois","Sangamon County",2,31,2408,1154,1254
050,17,167,"Illinois","Sangamon County",2,32,2384,1109,1275
050,17,167,"Illinois","Sangamon County",2,33,2443,1193,1250
050,17,167,"Illinois","Sangamon County",2,34,2521,1236,1285
050,17,167,"Illinois","Sangamon County",2,35,2571,1243,1328
050,17,167,"Illinois","Sangamon County",2,36,2547,1216,1331
050,17,167,"Illinois","Sangamon County",2,37,2604,1227,1377
050,17,167,"Illinois","Sangamon County",2,38,2582,1241,1341
050,17,167,"Illinois","Sangamon County",2,39,2566,1243,1323
050,17,167,"Illinois","Sangamon County",2,40,2565,1231,1334
050,17,167,"Illinois","Sangamon County",2,41,2489,1219,1270
050,17,167,"Illinois","Sangamon County",2,42,2448,1234,1214
050,17,167,"Illinois","Sangamon County",2,43,2352,1192,1160
050,17,167,"Illinois","Sangamon County",2,44,2230,1109,1121
050,17,167,"Illinois","Sangamon County",2,45,2217,1065,1152
050,17,167,"Illinois","Sangamon County",2,46,2222,1079,1143
050,17,167,"Illinois","Sangamon County",2,47,2251,1084,1167
050,17,167,"Illinois","Sangamon County",2,48,2416,1192,1224
050,17,167,"Illinois","Sangamon County",2,49,2652,1301,1351
050,17,167,"Illinois","Sangamon County",2,50,2533,1249,1284
050,17,167,"Illinois","Sangamon County",2,51,2445,1216,1229
050,17,167,"Illinois","Sangamon County",2,52,2375,1161,1214
050,17,167,"Illinois","Sangamon County",2,53,2442,1193,1249
050,17,167,"Illinois","Sangamon County",2,54,2534,1258,1276
050,17,167,"Illinois","Sangamon County",2,55,2722,1354,1368
050,17,167,"Illinois","Sangamon County",2,56,2858,1405,1453
050,17,167,"Illinois","Sangamon County",2,57,2868,1388,1480
050,17,167,"Illinois","Sangamon County",2,58,2889,1408,1481
050,17,167,"Illinois","Sangamon County",2,59,2873,1419,1454
050,17,167,"Illinois","Sangamon County",2,60,2787,1343,1444
050,17,167,"Illinois","Sangamon County",2,61,2773,1319,1454
050,17,167,"Illinois","Sangamon County",2,62,2786,1332,1454
050,17,167,"Illinois","Sangamon County",2,63,2738,1297,1441
050,17,167,"Illinois","Sangamon County",2,64,2590,1198,1392
050,17,167,"Illinois","Sangamon County",2,65,2553,1189,1364
050,17,167,"Illinois","Sangamon County",2,66,2472,1157,1315
050,17,167,"Illinois","Sangamon County",2,67,2405,1126,1279
050,17,167,"Illinois","Sangamon County",2,68,2365,1100,1265
050,17,167,"Illinois","Sangamon County",2,69,2284,1047,1237
050,17,167,"Illinois","Sangamon County",2,70,2188,1020,1168
050,17,167,"Illinois","Sangamon County",2,71,2124,965,1159
050,17,167,"Illinois","Sangamon County",2,72,2035,905,1130
050,17,167,"Illinois","Sangamon County",2,73,2083,936,1147
050,17,167,"Illinois","Sangamon County",2,74,1401,618,783
050,17,167,"Illinois","Sangamon County",2,75,1339,588,751
050,17,167,"Illinois","Sangamon County",2,76,1281,560,721
050,17,167,"Illinois","Sangamon County",2,77,1294,560,734
050,17,167,"Illinois","Sangamon County",2,78,1117,466,651
050,17,167,"Illinois","Sangamon County",2,79,999,413,586
050,17,167,"Illinois","Sangamon County",2,80,903,364,539
050,17,167,"Illinois","Sangamon County",2,81,889,359,530
050,17,167,"Illinois","Sangamon County",2,82,816,320,496
050,17,167,"Illinois","Sangamon County",2,83,728,289,439
050,17,167,"Illinois","Sangamon County",2,84,646,259,387
050,17,167,"Illinois","Sangamon County",2,85,4063,1309,2754
050,17,167,"Illinois","Sangamon County",3,0,2067,1024,1043
050,17,167,"Illinois","Sangamon County",3,1,2211,1161,1050
050,17,167,"Illinois","Sangamon County",3,2,2254,1154,1100
050,17,167,"Illinois","Sangamon County",3,3,2273,1164,1109
050,17,167,"Illinois","Sangamon County",3,4,2271,1186,1085
050,17,167,"Illinois","Sangamon County",3,5,2318,1206,1112
050,17,167,"Illinois","Sangamon County",3,6,2281,1160,1121
050,17,167,"Illinois","Sangamon County",3,7,2269,1157,1112
050,17,167,"Illinois","Sangamon County",3,8,2292,1174,1118
050,17,167,"Illinois","Sangamon County",3,9,2371,1261,1110
050,17,167,"Illinois","Sangamon County",3,10,2438,1316,1122
050,17,167,"Illinois","Sangamon County",3,11,2468,1291,1177
050,17,167,"Illinois","Sangamon County",3,12,2518,1271,1247
050,17,167,"Illinois","Sangamon County",3,13,2614,1306,1308
050,17,167,"Illinois","Sangamon County",3,14,2624,1313,1311
050,17,167,"Illinois","Sangamon County",3,15,2572,1313,1259
050,17,167,"Illinois","Sangamon County",3,16,2649,1373,1276
050,17,167,"Illinois","Sangamon County",3,17,2678,1364,1314
050,17,167,"Illinois","Sangamon County",3,18,2323,1198,1125
050,17,167,"Illinois","Sangamon County",3,19,2021,1031,990
050,17,167,"Illinois","Sangamon County",3,20,2223,1130,1093
050,17,167,"Illinois","Sangamon County",3,21,2237,1115,1122
050,17,167,"Illinois","Sangamon County",3,22,2293,1125,1168
050,17,167,"Illinois","Sangamon County",3,23,2314,1142,1172
050,17,167,"Illinois","Sangamon County",3,24,2196,1089,1107
050,17,167,"Illinois","Sangamon County",3,25,2244,1140,1104
050,17,167,"Illinois","Sangamon County",3,26,2264,1088,1176
050,17,167,"Illinois","Sangamon County",3,27,2367,1142,1225
050,17,167,"Illinois","Sangamon County",3,28,2343,1123,1220
050,17,167,"Illinois","Sangamon County",3,29,2422,1149,1273
050,17,167,"Illinois","Sangamon County",3,30,2411,1159,1252
050,17,167,"Illinois","Sangamon County",3,31,2482,1173,1309
050,17,167,"Illinois","Sangamon County",3,32,2400,1149,1251
050,17,167,"Illinois","Sangamon County",3,33,2350,1106,1244
050,17,167,"Illinois","Sangamon County",3,34,2478,1204,1274
050,17,167,"Illinois","Sangamon County",3,35,2499,1212,1287
050,17,167,"Illinois","Sangamon County",3,36,2524,1225,1299
050,17,167,"Illinois","Sangamon County",3,37,2556,1222,1334
050,17,167,"Illinois","Sangamon County",3,38,2594,1227,1367
050,17,167,"Illinois","Sangamon County",3,39,2580,1232,1348
050,17,167,"Illinois","Sangamon County",3,40,2542,1229,1313
050,17,167,"Illinois","Sangamon County",3,41,2551,1234,1317
050,17,167,"Illinois","Sangamon County",3,42,2498,1236,1262
050,17,167,"Illinois","Sangamon County",3,43,2447,1220,1227
050,17,167,"Illinois","Sangamon County",3,44,2329,1174,1155
050,17,167,"Illinois","Sangamon County",3,45,2211,1098,1113
050,17,167,"Illinois","Sangamon County",3,46,2220,1064,1156
050,17,167,"Illinois","Sangamon County",3,47,2210,1077,1133
050,17,167,"Illinois","Sangamon County",3,48,2258,1096,1162
050,17,167,"Illinois","Sangamon County",3,49,2413,1186,1227
050,17,167,"Illinois","Sangamon County",3,50,2629,1293,1336
050,17,167,"Illinois","Sangamon County",3,51,2499,1231,1268
050,17,167,"Illinois","Sangamon County",3,52,2413,1180,1233
050,17,167,"Illinois","Sangamon County",3,53,2369,1166,1203
050,17,167,"Illinois","Sangamon County",3,54,2414,1174,1240
050,17,167,"Illinois","Sangamon County",3,55,2503,1254,1249
050,17,167,"Illinois","Sangamon County",3,56,2681,1312,1369
050,17,167,"Illinois","Sangamon County",3,57,2821,1388,1433
050,17,167,"Illinois","Sangamon County",3,58,2794,1348,1446
050,17,167,"Illinois","Sangamon County",3,59,2823,1372,1451
050,17,167,"Illinois","Sangamon County",3,60,2840,1394,1446
050,17,167,"Illinois","Sangamon County",3,61,2742,1337,1405
050,17,167,"Illinois","Sangamon County",3,62,2709,1289,1420
050,17,167,"Illinois","Sangamon County",3,63,2731,1297,1434
050,17,167,"Illinois","Sangamon County",3,64,2680,1260,1420
050,17,167,"Illinois","Sangamon County",3,65,2512,1164,1348
050,17,167,"Illinois","Sangamon County",3,66,2479,1147,1332
050,17,167,"Illinois","Sangamon County",3,67,2428,1128,1300
050,17,167,"Illinois","Sangamon County",3,68,2375,1107,1268
050,17,167,"Illinois","Sangamon County",3,69,2313,1075,1238
050,17,167,"Illinois","Sangamon County",3,70,2207,1004,1203
050,17,167,"Illinois","Sangamon County",3,71,2126,977,1149
050,17,167,"Illinois","Sangamon County",3,72,2061,925,1136
050,17,167,"Illinois","Sangamon County",3,73,1980,881,1099
050,17,167,"Illinois","Sangamon County",3,74,2019,894,1125
050,17,167,"Illinois","Sangamon County",3,75,1366,601,765
050,17,167,"Illinois","Sangamon County",3,76,1284,560,724
050,17,167,"Illinois","Sangamon County",3,77,1236,548,688
050,17,167,"Illinois","Sangamon County",3,78,1223,526,697
050,17,167,"Illinois","Sangamon County",3,79,1059,429,630
050,17,167,"Illinois","Sangamon County",3,80,944,387,557
050,17,167,"Illinois","Sangamon County",3,81,868,340,528
050,17,167,"Illinois","Sangamon County",3,82,842,331,511
050,17,167,"Illinois","Sangamon County",3,83,744,292,452
050,17,167,"Illinois","Sangamon County",3,84,673,262,411
050,17,167,"Illinois","Sangamon County",3,85,4016,1305,2711
050,17,167,"Illinois","Sangamon County",4,0,1898,942,956
050,17,167,"Illinois","Sangamon County",4,1,2093,1049,1044
050,17,167,"Illinois","Sangamon County",4,2,2228,1158,1070
050,17,167,"Illinois","Sangamon County",4,3,2237,1147,1090
050,17,167,"Illinois","Sangamon County",4,4,2308,1177,1131
050,17,167,"Illinois","Sangamon County",4,5,2251,1177,1074
050,17,167,"Illinois","Sangamon County",4,6,2345,1215,1130
050,17,167,"Illinois","Sangamon County",4,7,2283,1164,1119
050,17,167,"Illinois","Sangamon County",4,8,2253,1151,1102
050,17,167,"Illinois","Sangamon County",4,9,2295,1176,1119
050,17,167,"Illinois","Sangamon County",4,10,2378,1276,1102
050,17,167,"Illinois","Sangamon County",4,11,2433,1310,1123
050,17,167,"Illinois","Sangamon County",4,12,2479,1289,1190
050,17,167,"Illinois","Sangamon County",4,13,2511,1266,1245
050,17,167,"Illinois","Sangamon County",4,14,2601,1296,1305
050,17,167,"Illinois","Sangamon County",4,15,2626,1310,1316
050,17,167,"Illinois","Sangamon County",4,16,2575,1323,1252
050,17,167,"Illinois","Sangamon County",4,17,2638,1356,1282
050,17,167,"Illinois","Sangamon County",4,18,2360,1217,1143
050,17,167,"Illinois","Sangamon County",4,19,2011,1030,981
050,17,167,"Illinois","Sangamon County",4,20,2095,1054,1041
050,17,167,"Illinois","Sangamon County",4,21,2253,1135,1118
050,17,167,"Illinois","Sangamon County",4,22,2291,1144,1147
050,17,167,"Illinois","Sangamon County",4,23,2272,1120,1152
050,17,167,"Illinois","Sangamon County",4,24,2288,1140,1148
050,17,167,"Illinois","Sangamon County",4,25,2148,1056,1092
050,17,167,"Illinois","Sangamon County",4,26,2264,1148,1116
050,17,167,"Illinois","Sangamon County",4,27,2214,1053,1161
050,17,167,"Illinois","Sangamon County",4,28,2353,1139,1214
050,17,167,"Illinois","Sangamon County",4,29,2343,1132,1211
050,17,167,"Illinois","Sangamon County",4,30,2448,1173,1275
050,17,167,"Illinois","Sangamon County",4,31,2410,1151,1259
050,17,167,"Illinois","Sangamon County",4,32,2457,1144,1313
050,17,167,"Illinois","Sangamon County",4,33,2394,1142,1252
050,17,167,"Illinois","Sangamon County",4,34,2340,1090,1250
050,17,167,"Illinois","Sangamon County",4,35,2454,1177,1277
050,17,167,"Illinois","Sangamon County",4,36,2486,1214,1272
050,17,167,"Illinois","Sangamon County",4,37,2539,1228,1311
050,17,167,"Illinois","Sangamon County",4,38,2521,1218,1303
050,17,167,"Illinois","Sangamon County",4,39,2592,1206,1386
050,17,167,"Illinois","Sangamon County",4,40,2599,1239,1360
050,17,167,"Illinois","Sangamon County",4,41,2527,1229,1298
050,17,167,"Illinois","Sangamon County",4,42,2576,1256,1320
050,17,167,"Illinois","Sangamon County",4,43,2501,1238,1263
050,17,167,"Illinois","Sangamon County",4,44,2449,1225,1224
050,17,167,"Illinois","Sangamon County",4,45,2288,1144,1144
050,17,167,"Illinois","Sangamon County",4,46,2202,1103,1099
050,17,167,"Illinois","Sangamon County",4,47,2211,1054,1157
050,17,167,"Illinois","Sangamon County",4,48,2201,1076,1125
050,17,167,"Illinois","Sangamon County",4,49,2222,1077,1145
050,17,167,"Illinois","Sangamon County",4,50,2398,1174,1224
050,17,167,"Illinois","Sangamon County",4,51,2606,1272,1334
050,17,167,"Illinois","Sangamon County",4,52,2502,1215,1287
050,17,167,"Illinois","Sangamon County",4,53,2380,1176,1204
050,17,167,"Illinois","Sangamon County",4,54,2327,1139,1188
050,17,167,"Illinois","Sangamon County",4,55,2398,1167,1231
050,17,167,"Illinois","Sangamon County",4,56,2451,1225,1226
050,17,167,"Illinois","Sangamon County",4,57,2633,1287,1346
050,17,167,"Illinois","Sangamon County",4,58,2766,1349,1417
050,17,167,"Illinois","Sangamon County",4,59,2739,1304,1435
050,17,167,"Illinois","Sangamon County",4,60,2756,1324,1432
050,17,167,"Illinois","Sangamon County",4,61,2782,1358,1424
050,17,167,"Illinois","Sangamon County",4,62,2686,1305,1381
050,17,167,"Illinois","Sangamon County",4,63,2647,1249,1398
050,17,167,"Illinois","Sangamon County",4,64,2684,1277,1407
050,17,167,"Illinois","Sangamon County",4,65,2612,1242,1370
050,17,167,"Illinois","Sangamon County",4,66,2435,1127,1308
050,17,167,"Illinois","Sangamon County",4,67,2440,1124,1316
050,17,167,"Illinois","Sangamon County",4,68,2377,1100,1277
050,17,167,"Illinois","Sangamon County",4,69,2289,1061,1228
050,17,167,"Illinois","Sangamon County",4,70,2257,1043,1214
050,17,167,"Illinois","Sangamon County",4,71,2161,977,1184
050,17,167,"Illinois","Sangamon County",4,72,2070,937,1133
050,17,167,"Illinois","Sangamon County",4,73,2009,904,1105
050,17,167,"Illinois","Sangamon County",4,74,1914,843,1071
050,17,167,"Illinois","Sangamon County",4,75,1959,856,1103
050,17,167,"Illinois","Sangamon County",4,76,1327,575,752
050,17,167,"Illinois","Sangamon County",4,77,1232,538,694
050,17,167,"Illinois","Sangamon County",4,78,1188,524,664
050,17,167,"Illinois","Sangamon County",4,79,1161,494,667
050,17,167,"Illinois","Sangamon County",4,80,1019,412,607
050,17,167,"Illinois","Sangamon County",4,81,904,361,543
050,17,167,"Illinois","Sangamon County",4,82,829,323,506
050,17,167,"Illinois","Sangamon County",4,83,766,299,467
050,17,167,"Illinois","Sangamon County",4,84,692,272,420
050,17,167,"Illinois","Sangamon County",4,85,4014,1320,2694
050,17,167,"Illinois","Sangamon County",5,0,1839,910,929
050,17,167,"Illinois","Sangamon County",5,1,1941,968,973
050,17,167,"Illinois","Sangamon County",5,2,2092,1033,1059
050,17,167,"Illinois","Sangamon County",5,3,2231,1173,1058
050,17,167,"Illinois","Sangamon County",5,4,2211,1134,1077
050,17,167,"Illinois","Sangamon County",5,5,2315,1183,1132
050,17,167,"Illinois","Sangamon County",5,6,2288,1200,1088
050,17,167,"Illinois","Sangamon County",5,7,2339,1216,1123
050,17,167,"Illinois","Sangamon County",5,8,2271,1170,1101
050,17,167,"Illinois","Sangamon County",5,9,2270,1159,1111
050,17,167,"Illinois","Sangamon County",5,10,2314,1179,1135
050,17,167,"Illinois","Sangamon County",5,11,2339,1259,1080
050,17,167,"Illinois","Sangamon County",5,12,2426,1297,1129
050,17,167,"Illinois","Sangamon County",5,13,2470,1281,1189
050,17,167,"Illinois","Sangamon County",5,14,2498,1265,1233
050,17,167,"Illinois","Sangamon County",5,15,2590,1296,1294
050,17,167,"Illinois","Sangamon County",5,16,2624,1309,1315
050,17,167,"Illinois","Sangamon County",5,17,2554,1293,1261
050,17,167,"Illinois","Sangamon County",5,18,2334,1214,1120
050,17,167,"Illinois","Sangamon County",5,19,2052,1042,1010
050,17,167,"Illinois","Sangamon County",5,20,2170,1079,1091
050,17,167,"Illinois","Sangamon County",5,21,2183,1095,1088
050,17,167,"Illinois","Sangamon County",5,22,2371,1191,1180
050,17,167,"Illinois","Sangamon County",5,23,2324,1167,1157
050,17,167,"Illinois","Sangamon County",5,24,2227,1100,1127
050,17,167,"Illinois","Sangamon County",5,25,2238,1098,1140
050,17,167,"Illinois","Sangamon County",5,26,2146,1035,1111
050,17,167,"Illinois","Sangamon County",5,27,2273,1158,1115
050,17,167,"Illinois","Sangamon County",5,28,2228,1060,1168
050,17,167,"Illinois","Sangamon County",5,29,2343,1136,1207
050,17,167,"Illinois","Sangamon County",5,30,2351,1131,1220
050,17,167,"Illinois","Sangamon County",5,31,2451,1177,1274
050,17,167,"Illinois","Sangamon County",5,32,2391,1144,1247
050,17,167,"Illinois","Sangamon County",5,33,2459,1141,1318
050,17,167,"Illinois","Sangamon County",5,34,2364,1132,1232
050,17,167,"Illinois","Sangamon County",5,35,2320,1073,1247
050,17,167,"Illinois","Sangamon County",5,36,2452,1180,1272
050,17,167,"Illinois","Sangamon County",5,37,2491,1224,1267
050,17,167,"Illinois","Sangamon County",5,38,2516,1211,1305
050,17,167,"Illinois","Sangamon County",5,39,2478,1185,1293
050,17,167,"Illinois","Sangamon County",5,40,2609,1220,1389
050,17,167,"Illinois","Sangamon County",5,41,2604,1245,1359
050,17,167,"Illinois","Sangamon County",5,42,2520,1226,1294
050,17,167,"Illinois","Sangamon County",5,43,2565,1234,1331
050,17,167,"Illinois","Sangamon County",5,44,2483,1227,1256
050,17,167,"Illinois","Sangamon County",5,45,2432,1220,1212
050,17,167,"Illinois","Sangamon County",5,46,2294,1158,1136
050,17,167,"Illinois","Sangamon County",5,47,2212,1103,1109
050,17,167,"Illinois","Sangamon County",5,48,2193,1052,1141
050,17,167,"Illinois","Sangamon County",5,49,2176,1073,1103
050,17,167,"Illinois","Sangamon County",5,50,2215,1068,1147
050,17,167,"Illinois","Sangamon County",5,51,2393,1184,1209
050,17,167,"Illinois","Sangamon County",5,52,2592,1259,1333
050,17,167,"Illinois","Sangamon County",5,53,2503,1223,1280
050,17,167,"Illinois","Sangamon County",5,54,2346,1153,1193
050,17,167,"Illinois","Sangamon County",5,55,2304,1125,1179
050,17,167,"Illinois","Sangamon County",5,56,2376,1153,1223
050,17,167,"Illinois","Sangamon County",5,57,2432,1212,1220
050,17,167,"Illinois","Sangamon County",5,58,2584,1256,1328
050,17,167,"Illinois","Sangamon County",5,59,2750,1334,1416
050,17,167,"Illinois","Sangamon County",5,60,2696,1271,1425
050,17,167,"Illinois","Sangamon County",5,61,2707,1300,1407
050,17,167,"Illinois","Sangamon County",5,62,2723,1324,1399
050,17,167,"Illinois","Sangamon County",5,63,2656,1272,1384
050,17,167,"Illinois","Sangamon County",5,64,2621,1242,1379
050,17,167,"Illinois","Sangamon County",5,65,2629,1261,1368
050,17,167,"Illinois","Sangamon County",5,66,2538,1202,1336
050,17,167,"Illinois","Sangamon County",5,67,2422,1106,1316
050,17,167,"Illinois","Sangamon County",5,68,2409,1098,1311
050,17,167,"Illinois","Sangamon County",5,69,2316,1068,1248
050,17,167,"Illinois","Sangamon County",5,70,2235,1029,1206
050,17,167,"Illinois","Sangamon County",5,71,2187,1000,1187
050,17,167,"Illinois","Sangamon County",5,72,2122,952,1170
050,17,167,"Illinois","Sangamon County",5,73,2017,910,1107
050,17,167,"Illinois","Sangamon County",5,74,1967,879,1088
050,17,167,"Illinois","Sangamon County",5,75,1876,820,1056
050,17,167,"Illinois","Sangamon County",5,76,1906,830,1076
050,17,167,"Illinois","Sangamon County",5,77,1274,554,720
050,17,167,"Illinois","Sangamon County",5,78,1198,514,684
050,17,167,"Illinois","Sangamon County",5,79,1136,496,640
050,17,167,"Illinois","Sangamon County",5,80,1126,475,651
050,17,167,"Illinois","Sangamon County",5,81,974,386,588
050,17,167,"Illinois","Sangamon County",5,82,860,335,525
050,17,167,"Illinois","Sangamon County",5,83,761,300,461
050,17,167,"Illinois","Sangamon County",5,84,716,284,432
050,17,167,"Illinois","Sangamon County",5,85,4062,1331,2731
050,17,169,"Illinois","Schuyler County",1,0,62,32,30
050,17,169,"Illinois","Schuyler County",1,1,64,34,30
050,17,169,"Illinois","Schuyler County",1,2,59,25,34
050,17,169,"Illinois","Schuyler County",1,3,49,30,19
050,17,169,"Illinois","Schuyler County",1,4,59,34,25
050,17,169,"Illinois","Schuyler County",1,5,56,31,25
050,17,169,"Illinois","Schuyler County",1,6,53,27,26
050,17,169,"Illinois","Schuyler County",1,7,62,28,34
050,17,169,"Illinois","Schuyler County",1,8,73,35,38
050,17,169,"Illinois","Schuyler County",1,9,67,34,33
050,17,169,"Illinois","Schuyler County",1,10,74,36,38
050,17,169,"Illinois","Schuyler County",1,11,79,38,41
050,17,169,"Illinois","Schuyler County",1,12,87,42,45
050,17,169,"Illinois","Schuyler County",1,13,89,41,48
050,17,169,"Illinois","Schuyler County",1,14,74,35,39
050,17,169,"Illinois","Schuyler County",1,15,63,32,31
050,17,169,"Illinois","Schuyler County",1,16,74,32,42
050,17,169,"Illinois","Schuyler County",1,17,76,34,42
050,17,169,"Illinois","Schuyler County",1,18,77,38,39
050,17,169,"Illinois","Schuyler County",1,19,55,29,26
050,17,169,"Illinois","Schuyler County",1,20,52,27,25
050,17,169,"Illinois","Schuyler County",1,21,65,31,34
050,17,169,"Illinois","Schuyler County",1,22,67,36,31
050,17,169,"Illinois","Schuyler County",1,23,65,40,25
050,17,169,"Illinois","Schuyler County",1,24,69,39,30
050,17,169,"Illinois","Schuyler County",1,25,59,31,28
050,17,169,"Illinois","Schuyler County",1,26,65,36,29
050,17,169,"Illinois","Schuyler County",1,27,72,42,30
050,17,169,"Illinois","Schuyler County",1,28,84,47,37
050,17,169,"Illinois","Schuyler County",1,29,76,42,34
050,17,169,"Illinois","Schuyler County",1,30,72,46,26
050,17,169,"Illinois","Schuyler County",1,31,76,41,35
050,17,169,"Illinois","Schuyler County",1,32,87,48,39
050,17,169,"Illinois","Schuyler County",1,33,83,50,33
050,17,169,"Illinois","Schuyler County",1,34,83,45,38
050,17,169,"Illinois","Schuyler County",1,35,85,59,26
050,17,169,"Illinois","Schuyler County",1,36,77,42,35
050,17,169,"Illinois","Schuyler County",1,37,84,45,39
050,17,169,"Illinois","Schuyler County",1,38,97,55,42
050,17,169,"Illinois","Schuyler County",1,39,102,63,39
050,17,169,"Illinois","Schuyler County",1,40,89,55,34
050,17,169,"Illinois","Schuyler County",1,41,76,50,26
050,17,169,"Illinois","Schuyler County",1,42,95,64,31
050,17,169,"Illinois","Schuyler County",1,43,101,69,32
050,17,169,"Illinois","Schuyler County",1,44,76,44,32
050,17,169,"Illinois","Schuyler County",1,45,94,58,36
050,17,169,"Illinois","Schuyler County",1,46,101,61,40
050,17,169,"Illinois","Schuyler County",1,47,100,55,45
050,17,169,"Illinois","Schuyler County",1,48,98,49,49
050,17,169,"Illinois","Schuyler County",1,49,100,63,37
050,17,169,"Illinois","Schuyler County",1,50,102,61,41
050,17,169,"Illinois","Schuyler County",1,51,97,57,40
050,17,169,"Illinois","Schuyler County",1,52,103,66,37
050,17,169,"Illinois","Schuyler County",1,53,94,55,39
050,17,169,"Illinois","Schuyler County",1,54,108,65,43
050,17,169,"Illinois","Schuyler County",1,55,106,57,49
050,17,169,"Illinois","Schuyler County",1,56,103,51,52
050,17,169,"Illinois","Schuyler County",1,57,111,65,46
050,17,169,"Illinois","Schuyler County",1,58,101,58,43
050,17,169,"Illinois","Schuyler County",1,59,115,58,57
050,17,169,"Illinois","Schuyler County",1,60,96,45,51
050,17,169,"Illinois","Schuyler County",1,61,100,52,48
050,17,169,"Illinois","Schuyler County",1,62,100,57,43
050,17,169,"Illinois","Schuyler County",1,63,95,51,44
050,17,169,"Illinois","Schuyler County",1,64,99,53,46
050,17,169,"Illinois","Schuyler County",1,65,96,43,53
050,17,169,"Illinois","Schuyler County",1,66,108,55,53
050,17,169,"Illinois","Schuyler County",1,67,111,57,54
050,17,169,"Illinois","Schuyler County",1,68,99,45,54
050,17,169,"Illinois","Schuyler County",1,69,87,45,42
050,17,169,"Illinois","Schuyler County",1,70,80,41,39
050,17,169,"Illinois","Schuyler County",1,71,79,39,40
050,17,169,"Illinois","Schuyler County",1,72,80,46,34
050,17,169,"Illinois","Schuyler County",1,73,86,47,39
050,17,169,"Illinois","Schuyler County",1,74,59,28,31
050,17,169,"Illinois","Schuyler County",1,75,66,32,34
050,17,169,"Illinois","Schuyler County",1,76,63,37,26
050,17,169,"Illinois","Schuyler County",1,77,57,28,29
050,17,169,"Illinois","Schuyler County",1,78,47,20,27
050,17,169,"Illinois","Schuyler County",1,79,46,22,24
050,17,169,"Illinois","Schuyler County",1,80,43,25,18
050,17,169,"Illinois","Schuyler County",1,81,49,19,30
050,17,169,"Illinois","Schuyler County",1,82,37,13,24
050,17,169,"Illinois","Schuyler County",1,83,35,15,20
050,17,169,"Illinois","Schuyler County",1,84,36,13,23
050,17,169,"Illinois","Schuyler County",1,85,203,66,137
050,17,169,"Illinois","Schuyler County",2,0,63,36,27
050,17,169,"Illinois","Schuyler County",2,1,64,34,30
050,17,169,"Illinois","Schuyler County",2,2,59,26,33
050,17,169,"Illinois","Schuyler County",2,3,53,30,23
050,17,169,"Illinois","Schuyler County",2,4,56,32,24
050,17,169,"Illinois","Schuyler County",2,5,56,31,25
050,17,169,"Illinois","Schuyler County",2,6,54,29,25
050,17,169,"Illinois","Schuyler County",2,7,60,27,33
050,17,169,"Illinois","Schuyler County",2,8,68,32,36
050,17,169,"Illinois","Schuyler County",2,9,67,33,34
050,17,169,"Illinois","Schuyler County",2,10,72,35,37
050,17,169,"Illinois","Schuyler County",2,11,78,38,40
050,17,169,"Illinois","Schuyler County",2,12,85,41,44
050,17,169,"Illinois","Schuyler County",2,13,86,40,46
050,17,169,"Illinois","Schuyler County",2,14,76,36,40
050,17,169,"Illinois","Schuyler County",2,15,65,32,33
050,17,169,"Illinois","Schuyler County",2,16,71,32,39
050,17,169,"Illinois","Schuyler County",2,17,76,34,42
050,17,169,"Illinois","Schuyler County",2,18,72,35,37
050,17,169,"Illinois","Schuyler County",2,19,58,30,28
050,17,169,"Illinois","Schuyler County",2,20,54,27,27
050,17,169,"Illinois","Schuyler County",2,21,63,30,33
050,17,169,"Illinois","Schuyler County",2,22,66,35,31
050,17,169,"Illinois","Schuyler County",2,23,68,40,28
050,17,169,"Illinois","Schuyler County",2,24,67,38,29
050,17,169,"Illinois","Schuyler County",2,25,60,32,28
050,17,169,"Illinois","Schuyler County",2,26,64,35,29
050,17,169,"Illinois","Schuyler County",2,27,71,42,29
050,17,169,"Illinois","Schuyler County",2,28,78,44,34
050,17,169,"Illinois","Schuyler County",2,29,76,43,33
050,17,169,"Illinois","Schuyler County",2,30,73,45,28
050,17,169,"Illinois","Schuyler County",2,31,75,42,33
050,17,169,"Illinois","Schuyler County",2,32,85,46,39
050,17,169,"Illinois","Schuyler County",2,33,84,50,34
050,17,169,"Illinois","Schuyler County",2,34,83,45,38
050,17,169,"Illinois","Schuyler County",2,35,86,57,29
050,17,169,"Illinois","Schuyler County",2,36,75,43,32
050,17,169,"Illinois","Schuyler County",2,37,84,45,39
050,17,169,"Illinois","Schuyler County",2,38,98,56,42
050,17,169,"Illinois","Schuyler County",2,39,101,61,40
050,17,169,"Illinois","Schuyler County",2,40,92,56,36
050,17,169,"Illinois","Schuyler County",2,41,80,52,28
050,17,169,"Illinois","Schuyler County",2,42,91,61,30
050,17,169,"Illinois","Schuyler County",2,43,101,69,32
050,17,169,"Illinois","Schuyler County",2,44,75,44,31
050,17,169,"Illinois","Schuyler County",2,45,93,58,35
050,17,169,"Illinois","Schuyler County",2,46,97,58,39
050,17,169,"Illinois","Schuyler County",2,47,99,54,45
050,17,169,"Illinois","Schuyler County",2,48,99,52,47
050,17,169,"Illinois","Schuyler County",2,49,102,62,40
050,17,169,"Illinois","Schuyler County",2,50,101,60,41
050,17,169,"Illinois","Schuyler County",2,51,97,57,40
050,17,169,"Illinois","Schuyler County",2,52,103,65,38
050,17,169,"Illinois","Schuyler County",2,53,94,56,38
050,17,169,"Illinois","Schuyler County",2,54,105,64,41
050,17,169,"Illinois","Schuyler County",2,55,103,56,47
050,17,169,"Illinois","Schuyler County",2,56,104,53,51
050,17,169,"Illinois","Schuyler County",2,57,110,63,47
050,17,169,"Illinois","Schuyler County",2,58,101,57,44
050,17,169,"Illinois","Schuyler County",2,59,113,59,54
050,17,169,"Illinois","Schuyler County",2,60,98,46,52
050,17,169,"Illinois","Schuyler County",2,61,100,51,49
050,17,169,"Illinois","Schuyler County",2,62,98,55,43
050,17,169,"Illinois","Schuyler County",2,63,96,52,44
050,17,169,"Illinois","Schuyler County",2,64,97,52,45
050,17,169,"Illinois","Schuyler County",2,65,96,45,51
050,17,169,"Illinois","Schuyler County",2,66,105,52,53
050,17,169,"Illinois","Schuyler County",2,67,111,57,54
050,17,169,"Illinois","Schuyler County",2,68,99,45,54
050,17,169,"Illinois","Schuyler County",2,69,91,46,45
050,17,169,"Illinois","Schuyler County",2,70,81,42,39
050,17,169,"Illinois","Schuyler County",2,71,79,39,40
050,17,169,"Illinois","Schuyler County",2,72,78,44,34
050,17,169,"Illinois","Schuyler County",2,73,90,51,39
050,17,169,"Illinois","Schuyler County",2,74,60,29,31
050,17,169,"Illinois","Schuyler County",2,75,64,31,33
050,17,169,"Illinois","Schuyler County",2,76,63,35,28
050,17,169,"Illinois","Schuyler County",2,77,59,31,28
050,17,169,"Illinois","Schuyler County",2,78,46,20,26
050,17,169,"Illinois","Schuyler County",2,79,47,22,25
050,17,169,"Illinois","Schuyler County",2,80,43,24,19
050,17,169,"Illinois","Schuyler County",2,81,48,20,28
050,17,169,"Illinois","Schuyler County",2,82,39,14,25
050,17,169,"Illinois","Schuyler County",2,83,35,15,20
050,17,169,"Illinois","Schuyler County",2,84,33,12,21
050,17,169,"Illinois","Schuyler County",2,85,202,65,137
050,17,169,"Illinois","Schuyler County",3,0,64,32,32
050,17,169,"Illinois","Schuyler County",3,1,65,33,32
050,17,169,"Illinois","Schuyler County",3,2,65,33,32
050,17,169,"Illinois","Schuyler County",3,3,59,25,34
050,17,169,"Illinois","Schuyler County",3,4,60,34,26
050,17,169,"Illinois","Schuyler County",3,5,57,32,25
050,17,169,"Illinois","Schuyler County",3,6,65,35,30
050,17,169,"Illinois","Schuyler County",3,7,51,25,26
050,17,169,"Illinois","Schuyler County",3,8,62,28,34
050,17,169,"Illinois","Schuyler County",3,9,66,31,35
050,17,169,"Illinois","Schuyler County",3,10,63,31,32
050,17,169,"Illinois","Schuyler County",3,11,72,35,37
050,17,169,"Illinois","Schuyler County",3,12,80,39,41
050,17,169,"Illinois","Schuyler County",3,13,83,40,43
050,17,169,"Illinois","Schuyler County",3,14,88,39,49
050,17,169,"Illinois","Schuyler County",3,15,79,37,42
050,17,169,"Illinois","Schuyler County",3,16,62,29,33
050,17,169,"Illinois","Schuyler County",3,17,77,39,38
050,17,169,"Illinois","Schuyler County",3,18,71,35,36
050,17,169,"Illinois","Schuyler County",3,19,50,22,28
050,17,169,"Illinois","Schuyler County",3,20,57,29,28
050,17,169,"Illinois","Schuyler County",3,21,52,27,25
050,17,169,"Illinois","Schuyler County",3,22,62,30,32
050,17,169,"Illinois","Schuyler County",3,23,68,36,32
050,17,169,"Illinois","Schuyler County",3,24,59,34,25
050,17,169,"Illinois","Schuyler County",3,25,55,30,25
050,17,169,"Illinois","Schuyler County",3,26,65,37,28
050,17,169,"Illinois","Schuyler County",3,27,71,44,27
050,17,169,"Illinois","Schuyler County",3,28,66,44,22
050,17,169,"Illinois","Schuyler County",3,29,78,46,32
050,17,169,"Illinois","Schuyler County",3,30,81,45,36
050,17,169,"Illinois","Schuyler County",3,31,72,44,28
050,17,169,"Illinois","Schuyler County",3,32,82,49,33
050,17,169,"Illinois","Schuyler County",3,33,88,49,39
050,17,169,"Illinois","Schuyler County",3,34,81,45,36
050,17,169,"Illinois","Schuyler County",3,35,88,51,37
050,17,169,"Illinois","Schuyler County",3,36,77,47,30
050,17,169,"Illinois","Schuyler County",3,37,72,37,35
050,17,169,"Illinois","Schuyler County",3,38,99,60,39
050,17,169,"Illinois","Schuyler County",3,39,104,59,45
050,17,169,"Illinois","Schuyler County",3,40,97,55,42
050,17,169,"Illinois","Schuyler County",3,41,99,61,38
050,17,169,"Illinois","Schuyler County",3,42,89,59,30
050,17,169,"Illinois","Schuyler County",3,43,100,70,30
050,17,169,"Illinois","Schuyler County",3,44,80,52,28
050,17,169,"Illinois","Schuyler County",3,45,91,62,29
050,17,169,"Illinois","Schuyler County",3,46,83,51,32
050,17,169,"Illinois","Schuyler County",3,47,85,48,37
050,17,169,"Illinois","Schuyler County",3,48,96,52,44
050,17,169,"Illinois","Schuyler County",3,49,101,58,43
050,17,169,"Illinois","Schuyler County",3,50,89,53,36
050,17,169,"Illinois","Schuyler County",3,51,95,53,42
050,17,169,"Illinois","Schuyler County",3,52,107,67,40
050,17,169,"Illinois","Schuyler County",3,53,99,65,34
050,17,169,"Illinois","Schuyler County",3,54,103,68,35
050,17,169,"Illinois","Schuyler County",3,55,95,53,42
050,17,169,"Illinois","Schuyler County",3,56,106,57,49
050,17,169,"Illinois","Schuyler County",3,57,111,61,50
050,17,169,"Illinois","Schuyler County",3,58,102,56,46
050,17,169,"Illinois","Schuyler County",3,59,100,59,41
050,17,169,"Illinois","Schuyler County",3,60,97,45,52
050,17,169,"Illinois","Schuyler County",3,61,106,55,51
050,17,169,"Illinois","Schuyler County",3,62,99,51,48
050,17,169,"Illinois","Schuyler County",3,63,89,47,42
050,17,169,"Illinois","Schuyler County",3,64,100,55,45
050,17,169,"Illinois","Schuyler County",3,65,90,46,44
050,17,169,"Illinois","Schuyler County",3,66,99,48,51
050,17,169,"Illinois","Schuyler County",3,67,113,57,56
050,17,169,"Illinois","Schuyler County",3,68,103,52,51
050,17,169,"Illinois","Schuyler County",3,69,96,46,50
050,17,169,"Illinois","Schuyler County",3,70,86,44,42
050,17,169,"Illinois","Schuyler County",3,71,80,39,41
050,17,169,"Illinois","Schuyler County",3,72,81,39,42
050,17,169,"Illinois","Schuyler County",3,73,79,46,33
050,17,169,"Illinois","Schuyler County",3,74,86,48,38
050,17,169,"Illinois","Schuyler County",3,75,57,26,31
050,17,169,"Illinois","Schuyler County",3,76,64,31,33
050,17,169,"Illinois","Schuyler County",3,77,61,31,30
050,17,169,"Illinois","Schuyler County",3,78,58,31,27
050,17,169,"Illinois","Schuyler County",3,79,43,20,23
050,17,169,"Illinois","Schuyler County",3,80,46,23,23
050,17,169,"Illinois","Schuyler County",3,81,50,25,25
050,17,169,"Illinois","Schuyler County",3,82,37,16,21
050,17,169,"Illinois","Schuyler County",3,83,39,18,21
050,17,169,"Illinois","Schuyler County",3,84,29,12,17
050,17,169,"Illinois","Schuyler County",3,85,199,58,141
050,17,169,"Illinois","Schuyler County",4,0,65,33,32
050,17,169,"Illinois","Schuyler County",4,1,59,31,28
050,17,169,"Illinois","Schuyler County",4,2,68,36,32
050,17,169,"Illinois","Schuyler County",4,3,68,36,32
050,17,169,"Illinois","Schuyler County",4,4,58,24,34
050,17,169,"Illinois","Schuyler County",4,5,58,31,27
050,17,169,"Illinois","Schuyler County",4,6,63,40,23
050,17,169,"Illinois","Schuyler County",4,7,65,34,31
050,17,169,"Illinois","Schuyler County",4,8,55,27,28
050,17,169,"Illinois","Schuyler County",4,9,62,29,33
050,17,169,"Illinois","Schuyler County",4,10,69,33,36
050,17,169,"Illinois","Schuyler County",4,11,68,35,33
050,17,169,"Illinois","Schuyler County",4,12,70,37,33
050,17,169,"Illinois","Schuyler County",4,13,73,33,40
050,17,169,"Illinois","Schuyler County",4,14,80,36,44
050,17,169,"Illinois","Schuyler County",4,15,88,38,50
050,17,169,"Illinois","Schuyler County",4,16,76,35,41
050,17,169,"Illinois","Schuyler County",4,17,63,33,30
050,17,169,"Illinois","Schuyler County",4,18,67,35,32
050,17,169,"Illinois","Schuyler County",4,19,48,25,23
050,17,169,"Illinois","Schuyler County",4,20,49,23,26
050,17,169,"Illinois","Schuyler County",4,21,58,27,31
050,17,169,"Illinois","Schuyler County",4,22,62,34,28
050,17,169,"Illinois","Schuyler County",4,23,63,29,34
050,17,169,"Illinois","Schuyler County",4,24,61,31,30
050,17,169,"Illinois","Schuyler County",4,25,53,26,27
050,17,169,"Illinois","Schuyler County",4,26,62,37,25
050,17,169,"Illinois","Schuyler County",4,27,73,49,24
050,17,169,"Illinois","Schuyler County",4,28,68,40,28
050,17,169,"Illinois","Schuyler County",4,29,68,42,26
050,17,169,"Illinois","Schuyler County",4,30,66,38,28
050,17,169,"Illinois","Schuyler County",4,31,77,38,39
050,17,169,"Illinois","Schuyler County",4,32,77,51,26
050,17,169,"Illinois","Schuyler County",4,33,89,55,34
050,17,169,"Illinois","Schuyler County",4,34,85,45,40
050,17,169,"Illinois","Schuyler County",4,35,87,53,34
050,17,169,"Illinois","Schuyler County",4,36,86,46,40
050,17,169,"Illinois","Schuyler County",4,37,79,46,33
050,17,169,"Illinois","Schuyler County",4,38,81,49,32
050,17,169,"Illinois","Schuyler County",4,39,94,56,38
050,17,169,"Illinois","Schuyler County",4,40,94,51,43
050,17,169,"Illinois","Schuyler County",4,41,105,62,43
050,17,169,"Illinois","Schuyler County",4,42,104,68,36
050,17,169,"Illinois","Schuyler County",4,43,97,67,30
050,17,169,"Illinois","Schuyler County",4,44,87,58,29
050,17,169,"Illinois","Schuyler County",4,45,95,69,26
050,17,169,"Illinois","Schuyler County",4,46,86,56,30
050,17,169,"Illinois","Schuyler County",4,47,76,44,32
050,17,169,"Illinois","Schuyler County",4,48,87,49,38
050,17,169,"Illinois","Schuyler County",4,49,105,63,42
050,17,169,"Illinois","Schuyler County",4,50,93,51,42
050,17,169,"Illinois","Schuyler County",4,51,90,51,39
050,17,169,"Illinois","Schuyler County",4,52,98,55,43
050,17,169,"Illinois","Schuyler County",4,53,97,58,39
050,17,169,"Illinois","Schuyler County",4,54,106,74,32
050,17,169,"Illinois","Schuyler County",4,55,97,63,34
050,17,169,"Illinois","Schuyler County",4,56,94,54,40
050,17,169,"Illinois","Schuyler County",4,57,109,60,49
050,17,169,"Illinois","Schuyler County",4,58,98,49,49
050,17,169,"Illinois","Schuyler County",4,59,102,58,44
050,17,169,"Illinois","Schuyler County",4,60,85,47,38
050,17,169,"Illinois","Schuyler County",4,61,103,54,49
050,17,169,"Illinois","Schuyler County",4,62,104,54,50
050,17,169,"Illinois","Schuyler County",4,63,86,44,42
050,17,169,"Illinois","Schuyler County",4,64,94,50,44
050,17,169,"Illinois","Schuyler County",4,65,92,47,45
050,17,169,"Illinois","Schuyler County",4,66,89,46,43
050,17,169,"Illinois","Schuyler County",4,67,105,52,53
050,17,169,"Illinois","Schuyler County",4,68,100,50,50
050,17,169,"Illinois","Schuyler County",4,69,101,54,47
050,17,169,"Illinois","Schuyler County",4,70,91,42,49
050,17,169,"Illinois","Schuyler County",4,71,80,40,40
050,17,169,"Illinois","Schuyler County",4,72,79,38,41
050,17,169,"Illinois","Schuyler County",4,73,80,41,39
050,17,169,"Illinois","Schuyler County",4,74,73,42,31
050,17,169,"Illinois","Schuyler County",4,75,81,43,38
050,17,169,"Illinois","Schuyler County",4,76,55,26,29
050,17,169,"Illinois","Schuyler County",4,77,60,28,32
050,17,169,"Illinois","Schuyler County",4,78,58,28,30
050,17,169,"Illinois","Schuyler County",4,79,60,31,29
050,17,169,"Illinois","Schuyler County",4,80,39,18,21
050,17,169,"Illinois","Schuyler County",4,81,51,23,28
050,17,169,"Illinois","Schuyler County",4,82,43,20,23
050,17,169,"Illinois","Schuyler County",4,83,36,19,17
050,17,169,"Illinois","Schuyler County",4,84,31,14,17
050,17,169,"Illinois","Schuyler County",4,85,196,56,140
050,17,169,"Illinois","Schuyler County",5,0,65,33,32
050,17,169,"Illinois","Schuyler County",5,1,64,34,30
050,17,169,"Illinois","Schuyler County",5,2,60,34,26
050,17,169,"Illinois","Schuyler County",5,3,62,33,29
050,17,169,"Illinois","Schuyler County",5,4,59,31,28
050,17,169,"Illinois","Schuyler County",5,5,61,27,34
050,17,169,"Illinois","Schuyler County",5,6,57,32,25
050,17,169,"Illinois","Schuyler County",5,7,55,35,20
050,17,169,"Illinois","Schuyler County",5,8,65,34,31
050,17,169,"Illinois","Schuyler County",5,9,53,27,26
050,17,169,"Illinois","Schuyler County",5,10,61,31,30
050,17,169,"Illinois","Schuyler County",5,11,70,35,35
050,17,169,"Illinois","Schuyler County",5,12,68,36,32
050,17,169,"Illinois","Schuyler County",5,13,69,35,34
050,17,169,"Illinois","Schuyler County",5,14,79,39,40
050,17,169,"Illinois","Schuyler County",5,15,76,36,40
050,17,169,"Illinois","Schuyler County",5,16,91,38,53
050,17,169,"Illinois","Schuyler County",5,17,69,33,36
050,17,169,"Illinois","Schuyler County",5,18,53,29,24
050,17,169,"Illinois","Schuyler County",5,19,52,27,25
050,17,169,"Illinois","Schuyler County",5,20,54,27,27
050,17,169,"Illinois","Schuyler County",5,21,59,29,30
050,17,169,"Illinois","Schuyler County",5,22,65,33,32
050,17,169,"Illinois","Schuyler County",5,23,69,39,30
050,17,169,"Illinois","Schuyler County",5,24,69,29,40
050,17,169,"Illinois","Schuyler County",5,25,60,34,26
050,17,169,"Illinois","Schuyler County",5,26,64,35,29
050,17,169,"Illinois","Schuyler County",5,27,70,46,24
050,17,169,"Illinois","Schuyler County",5,28,70,47,23
050,17,169,"Illinois","Schuyler County",5,29,69,38,31
050,17,169,"Illinois","Schuyler County",5,30,69,43,26
050,17,169,"Illinois","Schuyler County",5,31,66,37,29
050,17,169,"Illinois","Schuyler County",5,32,81,44,37
050,17,169,"Illinois","Schuyler County",5,33,81,55,26
050,17,169,"Illinois","Schuyler County",5,34,81,51,30
050,17,169,"Illinois","Schuyler County",5,35,90,51,39
050,17,169,"Illinois","Schuyler County",5,36,78,43,35
050,17,169,"Illinois","Schuyler County",5,37,71,34,37
050,17,169,"Illinois","Schuyler County",5,38,93,60,33
050,17,169,"Illinois","Schuyler County",5,39,83,50,33
050,17,169,"Illinois","Schuyler County",5,40,91,52,39
050,17,169,"Illinois","Schuyler County",5,41,98,52,46
050,17,169,"Illinois","Schuyler County",5,42,104,64,40
050,17,169,"Illinois","Schuyler County",5,43,113,78,35
050,17,169,"Illinois","Schuyler County",5,44,76,50,26
050,17,169,"Illinois","Schuyler County",5,45,98,71,27
050,17,169,"Illinois","Schuyler County",5,46,88,63,25
050,17,169,"Illinois","Schuyler County",5,47,74,44,30
050,17,169,"Illinois","Schuyler County",5,48,81,49,32
050,17,169,"Illinois","Schuyler County",5,49,93,56,37
050,17,169,"Illinois","Schuyler County",5,50,102,56,46
050,17,169,"Illinois","Schuyler County",5,51,92,48,44
050,17,169,"Illinois","Schuyler County",5,52,99,58,41
050,17,169,"Illinois","Schuyler County",5,53,98,55,43
050,17,169,"Illinois","Schuyler County",5,54,109,67,42
050,17,169,"Illinois","Schuyler County",5,55,97,63,34
050,17,169,"Illinois","Schuyler County",5,56,98,66,32
050,17,169,"Illinois","Schuyler County",5,57,100,59,41
050,17,169,"Illinois","Schuyler County",5,58,100,51,49
050,17,169,"Illinois","Schuyler County",5,59,97,51,46
050,17,169,"Illinois","Schuyler County",5,60,87,45,42
050,17,169,"Illinois","Schuyler County",5,61,95,58,37
050,17,169,"Illinois","Schuyler County",5,62,102,55,47
050,17,169,"Illinois","Schuyler County",5,63,99,49,50
050,17,169,"Illinois","Schuyler County",5,64,87,47,40
050,17,169,"Illinois","Schuyler County",5,65,91,45,46
050,17,169,"Illinois","Schuyler County",5,66,91,47,44
050,17,169,"Illinois","Schuyler County",5,67,96,53,43
050,17,169,"Illinois","Schuyler County",5,68,95,42,53
050,17,169,"Illinois","Schuyler County",5,69,100,53,47
050,17,169,"Illinois","Schuyler County",5,70,95,50,45
050,17,169,"Illinois","Schuyler County",5,71,88,40,48
050,17,169,"Illinois","Schuyler County",5,72,80,39,41
050,17,169,"Illinois","Schuyler County",5,73,81,41,40
050,17,169,"Illinois","Schuyler County",5,74,79,38,41
050,17,169,"Illinois","Schuyler County",5,75,69,38,31
050,17,169,"Illinois","Schuyler County",5,76,81,44,37
050,17,169,"Illinois","Schuyler County",5,77,53,25,28
050,17,169,"Illinois","Schuyler County",5,78,56,26,30
050,17,169,"Illinois","Schuyler County",5,79,57,26,31
050,17,169,"Illinois","Schuyler County",5,80,57,31,26
050,17,169,"Illinois","Schuyler County",5,81,45,19,26
050,17,169,"Illinois","Schuyler County",5,82,43,18,25
050,17,169,"Illinois","Schuyler County",5,83,43,23,20
050,17,169,"Illinois","Schuyler County",5,84,29,14,15
050,17,169,"Illinois","Schuyler County",5,85,195,57,138
050,17,171,"Illinois","Scott County",1,0,40,21,19
050,17,171,"Illinois","Scott County",1,1,38,21,17
050,17,171,"Illinois","Scott County",1,2,55,26,29
050,17,171,"Illinois","Scott County",1,3,52,21,31
050,17,171,"Illinois","Scott County",1,4,55,28,27
050,17,171,"Illinois","Scott County",1,5,54,32,22
050,17,171,"Illinois","Scott County",1,6,49,32,17
050,17,171,"Illinois","Scott County",1,7,61,35,26
050,17,171,"Illinois","Scott County",1,8,65,34,31
050,17,171,"Illinois","Scott County",1,9,59,31,28
050,17,171,"Illinois","Scott County",1,10,49,32,17
050,17,171,"Illinois","Scott County",1,11,61,24,37
050,17,171,"Illinois","Scott County",1,12,77,37,40
050,17,171,"Illinois","Scott County",1,13,77,37,40
050,17,171,"Illinois","Scott County",1,14,76,33,43
050,17,171,"Illinois","Scott County",1,15,73,39,34
050,17,171,"Illinois","Scott County",1,16,64,38,26
050,17,171,"Illinois","Scott County",1,17,58,34,24
050,17,171,"Illinois","Scott County",1,18,49,31,18
050,17,171,"Illinois","Scott County",1,19,49,28,21
050,17,171,"Illinois","Scott County",1,20,46,23,23
050,17,171,"Illinois","Scott County",1,21,52,25,27
050,17,171,"Illinois","Scott County",1,22,57,23,34
050,17,171,"Illinois","Scott County",1,23,60,30,30
050,17,171,"Illinois","Scott County",1,24,45,24,21
050,17,171,"Illinois","Scott County",1,25,55,26,29
050,17,171,"Illinois","Scott County",1,26,64,29,35
050,17,171,"Illinois","Scott County",1,27,56,27,29
050,17,171,"Illinois","Scott County",1,28,54,24,30
050,17,171,"Illinois","Scott County",1,29,46,23,23
050,17,171,"Illinois","Scott County",1,30,44,20,24
050,17,171,"Illinois","Scott County",1,31,47,23,24
050,17,171,"Illinois","Scott County",1,32,45,23,22
050,17,171,"Illinois","Scott County",1,33,53,26,27
050,17,171,"Illinois","Scott County",1,34,55,24,31
050,17,171,"Illinois","Scott County",1,35,55,19,36
050,17,171,"Illinois","Scott County",1,36,59,25,34
050,17,171,"Illinois","Scott County",1,37,57,31,26
050,17,171,"Illinois","Scott County",1,38,57,27,30
050,17,171,"Illinois","Scott County",1,39,55,27,28
050,17,171,"Illinois","Scott County",1,40,57,28,29
050,17,171,"Illinois","Scott County",1,41,64,31,33
050,17,171,"Illinois","Scott County",1,42,72,37,35
050,17,171,"Illinois","Scott County",1,43,63,39,24
050,17,171,"Illinois","Scott County",1,44,58,30,28
050,17,171,"Illinois","Scott County",1,45,57,24,33
050,17,171,"Illinois","Scott County",1,46,57,26,31
050,17,171,"Illinois","Scott County",1,47,61,30,31
050,17,171,"Illinois","Scott County",1,48,64,28,36
050,17,171,"Illinois","Scott County",1,49,65,33,32
050,17,171,"Illinois","Scott County",1,50,58,34,24
050,17,171,"Illinois","Scott County",1,51,64,33,31
050,17,171,"Illinois","Scott County",1,52,57,30,27
050,17,171,"Illinois","Scott County",1,53,65,36,29
050,17,171,"Illinois","Scott County",1,54,58,28,30
050,17,171,"Illinois","Scott County",1,55,76,35,41
050,17,171,"Illinois","Scott County",1,56,89,43,46
050,17,171,"Illinois","Scott County",1,57,87,38,49
050,17,171,"Illinois","Scott County",1,58,85,43,42
050,17,171,"Illinois","Scott County",1,59,90,46,44
050,17,171,"Illinois","Scott County",1,60,83,47,36
050,17,171,"Illinois","Scott County",1,61,83,49,34
050,17,171,"Illinois","Scott County",1,62,83,50,33
050,17,171,"Illinois","Scott County",1,63,76,40,36
050,17,171,"Illinois","Scott County",1,64,76,40,36
050,17,171,"Illinois","Scott County",1,65,63,32,31
050,17,171,"Illinois","Scott County",1,66,61,33,28
050,17,171,"Illinois","Scott County",1,67,64,32,32
050,17,171,"Illinois","Scott County",1,68,63,28,35
050,17,171,"Illinois","Scott County",1,69,58,30,28
050,17,171,"Illinois","Scott County",1,70,53,24,29
050,17,171,"Illinois","Scott County",1,71,48,19,29
050,17,171,"Illinois","Scott County",1,72,44,21,23
050,17,171,"Illinois","Scott County",1,73,47,25,22
050,17,171,"Illinois","Scott County",1,74,35,12,23
050,17,171,"Illinois","Scott County",1,75,34,10,24
050,17,171,"Illinois","Scott County",1,76,35,15,20
050,17,171,"Illinois","Scott County",1,77,35,17,18
050,17,171,"Illinois","Scott County",1,78,41,17,24
050,17,171,"Illinois","Scott County",1,79,30,18,12
050,17,171,"Illinois","Scott County",1,80,36,16,20
050,17,171,"Illinois","Scott County",1,81,28,11,17
050,17,171,"Illinois","Scott County",1,82,26,13,13
050,17,171,"Illinois","Scott County",1,83,25,14,11
050,17,171,"Illinois","Scott County",1,84,27,15,12
050,17,171,"Illinois","Scott County",1,85,123,43,80
050,17,171,"Illinois","Scott County",2,0,40,21,19
050,17,171,"Illinois","Scott County",2,1,40,21,19
050,17,171,"Illinois","Scott County",2,2,50,24,26
050,17,171,"Illinois","Scott County",2,3,52,22,30
050,17,171,"Illinois","Scott County",2,4,56,27,29
050,17,171,"Illinois","Scott County",2,5,54,30,24
050,17,171,"Illinois","Scott County",2,6,52,33,19
050,17,171,"Illinois","Scott County",2,7,59,35,24
050,17,171,"Illinois","Scott County",2,8,63,33,30
050,17,171,"Illinois","Scott County",2,9,62,33,29
050,17,171,"Illinois","Scott County",2,10,52,32,20
050,17,171,"Illinois","Scott County",2,11,59,26,33
050,17,171,"Illinois","Scott County",2,12,73,34,39
050,17,171,"Illinois","Scott County",2,13,77,36,41
050,17,171,"Illinois","Scott County",2,14,77,35,42
050,17,171,"Illinois","Scott County",2,15,73,37,36
050,17,171,"Illinois","Scott County",2,16,68,39,29
050,17,171,"Illinois","Scott County",2,17,59,35,24
050,17,171,"Illinois","Scott County",2,18,49,30,19
050,17,171,"Illinois","Scott County",2,19,46,27,19
050,17,171,"Illinois","Scott County",2,20,48,25,23
050,17,171,"Illinois","Scott County",2,21,52,25,27
050,17,171,"Illinois","Scott County",2,22,56,23,33
050,17,171,"Illinois","Scott County",2,23,58,28,30
050,17,171,"Illinois","Scott County",2,24,48,25,23
050,17,171,"Illinois","Scott County",2,25,54,27,27
050,17,171,"Illinois","Scott County",2,26,59,27,32
050,17,171,"Illinois","Scott County",2,27,56,27,29
050,17,171,"Illinois","Scott County",2,28,55,25,30
050,17,171,"Illinois","Scott County",2,29,47,22,25
050,17,171,"Illinois","Scott County",2,30,44,21,23
050,17,171,"Illinois","Scott County",2,31,47,24,23
050,17,171,"Illinois","Scott County",2,32,46,23,23
050,17,171,"Illinois","Scott County",2,33,52,26,26
050,17,171,"Illinois","Scott County",2,34,54,25,29
050,17,171,"Illinois","Scott County",2,35,55,21,34
050,17,171,"Illinois","Scott County",2,36,58,24,34
050,17,171,"Illinois","Scott County",2,37,58,30,28
050,17,171,"Illinois","Scott County",2,38,58,28,30
050,17,171,"Illinois","Scott County",2,39,54,26,28
050,17,171,"Illinois","Scott County",2,40,57,28,29
050,17,171,"Illinois","Scott County",2,41,62,30,32
050,17,171,"Illinois","Scott County",2,42,71,36,35
050,17,171,"Illinois","Scott County",2,43,66,39,27
050,17,171,"Illinois","Scott County",2,44,57,30,27
050,17,171,"Illinois","Scott County",2,45,56,25,31
050,17,171,"Illinois","Scott County",2,46,58,26,32
050,17,171,"Illinois","Scott County",2,47,60,29,31
050,17,171,"Illinois","Scott County",2,48,64,29,35
050,17,171,"Illinois","Scott County",2,49,64,33,31
050,17,171,"Illinois","Scott County",2,50,60,34,26
050,17,171,"Illinois","Scott County",2,51,63,33,30
050,17,171,"Illinois","Scott County",2,52,58,31,27
050,17,171,"Illinois","Scott County",2,53,63,34,29
050,17,171,"Illinois","Scott County",2,54,59,30,29
050,17,171,"Illinois","Scott County",2,55,72,33,39
050,17,171,"Illinois","Scott County",2,56,85,41,44
050,17,171,"Illinois","Scott County",2,57,87,39,48
050,17,171,"Illinois","Scott County",2,58,86,42,44
050,17,171,"Illinois","Scott County",2,59,88,45,43
050,17,171,"Illinois","Scott County",2,60,85,47,38
050,17,171,"Illinois","Scott County",2,61,82,48,34
050,17,171,"Illinois","Scott County",2,62,83,50,33
050,17,171,"Illinois","Scott County",2,63,78,42,36
050,17,171,"Illinois","Scott County",2,64,75,40,35
050,17,171,"Illinois","Scott County",2,65,66,34,32
050,17,171,"Illinois","Scott County",2,66,62,33,29
050,17,171,"Illinois","Scott County",2,67,63,32,31
050,17,171,"Illinois","Scott County",2,68,63,29,34
050,17,171,"Illinois","Scott County",2,69,60,30,30
050,17,171,"Illinois","Scott County",2,70,52,24,28
050,17,171,"Illinois","Scott County",2,71,49,20,29
050,17,171,"Illinois","Scott County",2,72,44,20,24
050,17,171,"Illinois","Scott County",2,73,46,23,23
050,17,171,"Illinois","Scott County",2,74,36,14,22
050,17,171,"Illinois","Scott County",2,75,34,10,24
050,17,171,"Illinois","Scott County",2,76,35,14,21
050,17,171,"Illinois","Scott County",2,77,36,17,19
050,17,171,"Illinois","Scott County",2,78,38,16,22
050,17,171,"Illinois","Scott County",2,79,31,17,14
050,17,171,"Illinois","Scott County",2,80,35,17,18
050,17,171,"Illinois","Scott County",2,81,29,11,18
050,17,171,"Illinois","Scott County",2,82,27,13,14
050,17,171,"Illinois","Scott County",2,83,26,14,12
050,17,171,"Illinois","Scott County",2,84,27,15,12
050,17,171,"Illinois","Scott County",2,85,123,43,80
050,17,171,"Illinois","Scott County",3,0,39,21,18
050,17,171,"Illinois","Scott County",3,1,37,17,20
050,17,171,"Illinois","Scott County",3,2,44,23,21
050,17,171,"Illinois","Scott County",3,3,49,23,26
050,17,171,"Illinois","Scott County",3,4,50,20,30
050,17,171,"Illinois","Scott County",3,5,55,26,29
050,17,171,"Illinois","Scott County",3,6,53,33,20
050,17,171,"Illinois","Scott County",3,7,55,36,19
050,17,171,"Illinois","Scott County",3,8,50,29,21
050,17,171,"Illinois","Scott County",3,9,64,33,31
050,17,171,"Illinois","Scott County",3,10,65,37,28
050,17,171,"Illinois","Scott County",3,11,51,30,21
050,17,171,"Illinois","Scott County",3,12,53,24,29
050,17,171,"Illinois","Scott County",3,13,67,33,34
050,17,171,"Illinois","Scott County",3,14,79,37,42
050,17,171,"Illinois","Scott County",3,15,76,37,39
050,17,171,"Illinois","Scott County",3,16,69,34,35
050,17,171,"Illinois","Scott County",3,17,65,39,26
050,17,171,"Illinois","Scott County",3,18,46,30,16
050,17,171,"Illinois","Scott County",3,19,40,24,16
050,17,171,"Illinois","Scott County",3,20,50,28,22
050,17,171,"Illinois","Scott County",3,21,52,27,25
050,17,171,"Illinois","Scott County",3,22,57,24,33
050,17,171,"Illinois","Scott County",3,23,53,23,30
050,17,171,"Illinois","Scott County",3,24,58,31,27
050,17,171,"Illinois","Scott County",3,25,46,23,23
050,17,171,"Illinois","Scott County",3,26,46,23,23
050,17,171,"Illinois","Scott County",3,27,59,26,33
050,17,171,"Illinois","Scott County",3,28,60,33,27
050,17,171,"Illinois","Scott County",3,29,57,26,31
050,17,171,"Illinois","Scott County",3,30,49,20,29
050,17,171,"Illinois","Scott County",3,31,44,21,23
050,17,171,"Illinois","Scott County",3,32,50,28,22
050,17,171,"Illinois","Scott County",3,33,46,21,25
050,17,171,"Illinois","Scott County",3,34,52,26,26
050,17,171,"Illinois","Scott County",3,35,51,24,27
050,17,171,"Illinois","Scott County",3,36,49,19,30
050,17,171,"Illinois","Scott County",3,37,54,20,34
050,17,171,"Illinois","Scott County",3,38,57,32,25
050,17,171,"Illinois","Scott County",3,39,58,29,29
050,17,171,"Illinois","Scott County",3,40,51,26,25
050,17,171,"Illinois","Scott County",3,41,58,31,27
050,17,171,"Illinois","Scott County",3,42,62,30,32
050,17,171,"Illinois","Scott County",3,43,68,35,33
050,17,171,"Illinois","Scott County",3,44,63,39,24
050,17,171,"Illinois","Scott County",3,45,56,30,26
050,17,171,"Illinois","Scott County",3,46,53,25,28
050,17,171,"Illinois","Scott County",3,47,59,25,34
050,17,171,"Illinois","Scott County",3,48,61,29,32
050,17,171,"Illinois","Scott County",3,49,58,24,34
050,17,171,"Illinois","Scott County",3,50,65,32,33
050,17,171,"Illinois","Scott County",3,51,64,35,29
050,17,171,"Illinois","Scott County",3,52,60,31,29
050,17,171,"Illinois","Scott County",3,53,59,31,28
050,17,171,"Illinois","Scott County",3,54,59,34,25
050,17,171,"Illinois","Scott County",3,55,58,30,28
050,17,171,"Illinois","Scott County",3,56,72,33,39
050,17,171,"Illinois","Scott County",3,57,84,40,44
050,17,171,"Illinois","Scott County",3,58,88,37,51
050,17,171,"Illinois","Scott County",3,59,85,41,44
050,17,171,"Illinois","Scott County",3,60,86,43,43
050,17,171,"Illinois","Scott County",3,61,84,47,37
050,17,171,"Illinois","Scott County",3,62,80,46,34
050,17,171,"Illinois","Scott County",3,63,80,50,30
050,17,171,"Illinois","Scott County",3,64,79,44,35
050,17,171,"Illinois","Scott County",3,65,74,39,35
050,17,171,"Illinois","Scott County",3,66,62,31,31
050,17,171,"Illinois","Scott County",3,67,62,33,29
050,17,171,"Illinois","Scott County",3,68,62,32,30
050,17,171,"Illinois","Scott County",3,69,62,29,33
050,17,171,"Illinois","Scott County",3,70,61,30,31
050,17,171,"Illinois","Scott County",3,71,47,21,26
050,17,171,"Illinois","Scott County",3,72,47,18,29
050,17,171,"Illinois","Scott County",3,73,43,19,24
050,17,171,"Illinois","Scott County",3,74,46,22,24
050,17,171,"Illinois","Scott County",3,75,34,14,20
050,17,171,"Illinois","Scott County",3,76,37,10,27
050,17,171,"Illinois","Scott County",3,77,31,12,19
050,17,171,"Illinois","Scott County",3,78,37,17,20
050,17,171,"Illinois","Scott County",3,79,37,17,20
050,17,171,"Illinois","Scott County",3,80,31,16,15
050,17,171,"Illinois","Scott County",3,81,30,13,17
050,17,171,"Illinois","Scott County",3,82,29,11,18
050,17,171,"Illinois","Scott County",3,83,23,13,10
050,17,171,"Illinois","Scott County",3,84,24,13,11
050,17,171,"Illinois","Scott County",3,85,123,47,76
050,17,171,"Illinois","Scott County",4,0,34,17,17
050,17,171,"Illinois","Scott County",4,1,42,25,17
050,17,171,"Illinois","Scott County",4,2,39,19,20
050,17,171,"Illinois","Scott County",4,3,44,24,20
050,17,171,"Illinois","Scott County",4,4,46,21,25
050,17,171,"Illinois","Scott County",4,5,54,21,33
050,17,171,"Illinois","Scott County",4,6,55,27,28
050,17,171,"Illinois","Scott County",4,7,48,27,21
050,17,171,"Illinois","Scott County",4,8,49,31,18
050,17,171,"Illinois","Scott County",4,9,54,31,23
050,17,171,"Illinois","Scott County",4,10,64,32,32
050,17,171,"Illinois","Scott County",4,11,61,30,31
050,17,171,"Illinois","Scott County",4,12,57,30,27
050,17,171,"Illinois","Scott County",4,13,51,24,27
050,17,171,"Illinois","Scott County",4,14,66,33,33
050,17,171,"Illinois","Scott County",4,15,74,35,39
050,17,171,"Illinois","Scott County",4,16,71,34,37
050,17,171,"Illinois","Scott County",4,17,65,35,30
050,17,171,"Illinois","Scott County",4,18,54,33,21
050,17,171,"Illinois","Scott County",4,19,32,22,10
050,17,171,"Illinois","Scott County",4,20,42,28,14
050,17,171,"Illinois","Scott County",4,21,59,30,29
050,17,171,"Illinois","Scott County",4,22,56,24,32
050,17,171,"Illinois","Scott County",4,23,60,28,32
050,17,171,"Illinois","Scott County",4,24,53,25,28
050,17,171,"Illinois","Scott County",4,25,50,25,25
050,17,171,"Illinois","Scott County",4,26,48,28,20
050,17,171,"Illinois","Scott County",4,27,46,24,22
050,17,171,"Illinois","Scott County",4,28,57,26,31
050,17,171,"Illinois","Scott County",4,29,59,31,28
050,17,171,"Illinois","Scott County",4,30,53,22,31
050,17,171,"Illinois","Scott County",4,31,47,19,28
050,17,171,"Illinois","Scott County",4,32,44,22,22
050,17,171,"Illinois","Scott County",4,33,49,27,22
050,17,171,"Illinois","Scott County",4,34,51,23,28
050,17,171,"Illinois","Scott County",4,35,49,25,24
050,17,171,"Illinois","Scott County",4,36,49,23,26
050,17,171,"Illinois","Scott County",4,37,49,19,30
050,17,171,"Illinois","Scott County",4,38,56,20,36
050,17,171,"Illinois","Scott County",4,39,55,30,25
050,17,171,"Illinois","Scott County",4,40,60,32,28
050,17,171,"Illinois","Scott County",4,41,51,26,25
050,17,171,"Illinois","Scott County",4,42,59,31,28
050,17,171,"Illinois","Scott County",4,43,62,29,33
050,17,171,"Illinois","Scott County",4,44,68,32,36
050,17,171,"Illinois","Scott County",4,45,63,38,25
050,17,171,"Illinois","Scott County",4,46,56,30,26
050,17,171,"Illinois","Scott County",4,47,53,24,29
050,17,171,"Illinois","Scott County",4,48,60,26,34
050,17,171,"Illinois","Scott County",4,49,61,32,29
050,17,171,"Illinois","Scott County",4,50,58,24,34
050,17,171,"Illinois","Scott County",4,51,63,32,31
050,17,171,"Illinois","Scott County",4,52,61,35,26
050,17,171,"Illinois","Scott County",4,53,58,29,29
050,17,171,"Illinois","Scott County",4,54,55,31,24
050,17,171,"Illinois","Scott County",4,55,61,34,27
050,17,171,"Illinois","Scott County",4,56,54,30,24
050,17,171,"Illinois","Scott County",4,57,72,33,39
050,17,171,"Illinois","Scott County",4,58,86,42,44
050,17,171,"Illinois","Scott County",4,59,81,33,48
050,17,171,"Illinois","Scott County",4,60,85,41,44
050,17,171,"Illinois","Scott County",4,61,84,42,42
050,17,171,"Illinois","Scott County",4,62,84,48,36
050,17,171,"Illinois","Scott County",4,63,83,48,35
050,17,171,"Illinois","Scott County",4,64,80,50,30
050,17,171,"Illinois","Scott County",4,65,79,44,35
050,17,171,"Illinois","Scott County",4,66,71,36,35
050,17,171,"Illinois","Scott County",4,67,64,32,32
050,17,171,"Illinois","Scott County",4,68,59,31,28
050,17,171,"Illinois","Scott County",4,69,59,30,29
050,17,171,"Illinois","Scott County",4,70,61,28,33
050,17,171,"Illinois","Scott County",4,71,60,29,31
050,17,171,"Illinois","Scott County",4,72,42,17,25
050,17,171,"Illinois","Scott County",4,73,45,15,30
050,17,171,"Illinois","Scott County",4,74,39,18,21
050,17,171,"Illinois","Scott County",4,75,43,20,23
050,17,171,"Illinois","Scott County",4,76,38,15,23
050,17,171,"Illinois","Scott County",4,77,30,7,23
050,17,171,"Illinois","Scott County",4,78,33,12,21
050,17,171,"Illinois","Scott County",4,79,34,18,16
050,17,171,"Illinois","Scott County",4,80,38,17,21
050,17,171,"Illinois","Scott County",4,81,30,15,15
050,17,171,"Illinois","Scott County",4,82,28,12,16
050,17,171,"Illinois","Scott County",4,83,25,10,15
050,17,171,"Illinois","Scott County",4,84,19,8,11
050,17,171,"Illinois","Scott County",4,85,124,48,76
050,17,171,"Illinois","Scott County",5,0,34,16,18
050,17,171,"Illinois","Scott County",5,1,37,17,20
050,17,171,"Illinois","Scott County",5,2,45,24,21
050,17,171,"Illinois","Scott County",5,3,39,18,21
050,17,171,"Illinois","Scott County",5,4,44,22,22
050,17,171,"Illinois","Scott County",5,5,51,28,23
050,17,171,"Illinois","Scott County",5,6,58,22,36
050,17,171,"Illinois","Scott County",5,7,54,24,30
050,17,171,"Illinois","Scott County",5,8,52,30,22
050,17,171,"Illinois","Scott County",5,9,48,29,19
050,17,171,"Illinois","Scott County",5,10,53,31,22
050,17,171,"Illinois","Scott County",5,11,64,31,33
050,17,171,"Illinois","Scott County",5,12,57,30,27
050,17,171,"Illinois","Scott County",5,13,59,30,29
050,17,171,"Illinois","Scott County",5,14,49,26,23
050,17,171,"Illinois","Scott County",5,15,63,33,30
050,17,171,"Illinois","Scott County",5,16,73,37,36
050,17,171,"Illinois","Scott County",5,17,67,32,35
050,17,171,"Illinois","Scott County",5,18,50,30,20
050,17,171,"Illinois","Scott County",5,19,42,25,17
050,17,171,"Illinois","Scott County",5,20,35,21,14
050,17,171,"Illinois","Scott County",5,21,46,30,16
050,17,171,"Illinois","Scott County",5,22,55,30,25
050,17,171,"Illinois","Scott County",5,23,58,25,33
050,17,171,"Illinois","Scott County",5,24,66,30,36
050,17,171,"Illinois","Scott County",5,25,45,24,21
050,17,171,"Illinois","Scott County",5,26,48,25,23
050,17,171,"Illinois","Scott County",5,27,52,28,24
050,17,171,"Illinois","Scott County",5,28,42,23,19
050,17,171,"Illinois","Scott County",5,29,53,25,28
050,17,171,"Illinois","Scott County",5,30,59,30,29
050,17,171,"Illinois","Scott County",5,31,53,22,31
050,17,171,"Illinois","Scott County",5,32,51,19,32
050,17,171,"Illinois","Scott County",5,33,45,22,23
050,17,171,"Illinois","Scott County",5,34,50,27,23
050,17,171,"Illinois","Scott County",5,35,54,22,32
050,17,171,"Illinois","Scott County",5,36,48,24,24
050,17,171,"Illinois","Scott County",5,37,52,23,29
050,17,171,"Illinois","Scott County",5,38,48,18,30
050,17,171,"Illinois","Scott County",5,39,55,19,36
050,17,171,"Illinois","Scott County",5,40,57,32,25
050,17,171,"Illinois","Scott County",5,41,55,28,27
050,17,171,"Illinois","Scott County",5,42,50,27,23
050,17,171,"Illinois","Scott County",5,43,62,34,28
050,17,171,"Illinois","Scott County",5,44,60,26,34
050,17,171,"Illinois","Scott County",5,45,64,31,33
050,17,171,"Illinois","Scott County",5,46,61,36,25
050,17,171,"Illinois","Scott County",5,47,56,30,26
050,17,171,"Illinois","Scott County",5,48,54,25,29
050,17,171,"Illinois","Scott County",5,49,59,26,33
050,17,171,"Illinois","Scott County",5,50,62,31,31
050,17,171,"Illinois","Scott County",5,51,58,24,34
050,17,171,"Illinois","Scott County",5,52,63,33,30
050,17,171,"Illinois","Scott County",5,53,63,38,25
050,17,171,"Illinois","Scott County",5,54,58,29,29
050,17,171,"Illinois","Scott County",5,55,51,28,23
050,17,171,"Illinois","Scott County",5,56,60,33,27
050,17,171,"Illinois","Scott County",5,57,52,28,24
050,17,171,"Illinois","Scott County",5,58,70,32,38
050,17,171,"Illinois","Scott County",5,59,84,40,44
050,17,171,"Illinois","Scott County",5,60,82,33,49
050,17,171,"Illinois","Scott County",5,61,81,41,40
050,17,171,"Illinois","Scott County",5,62,86,43,43
050,17,171,"Illinois","Scott County",5,63,84,48,36
050,17,171,"Illinois","Scott County",5,64,80,46,34
050,17,171,"Illinois","Scott County",5,65,82,51,31
050,17,171,"Illinois","Scott County",5,66,78,41,37
050,17,171,"Illinois","Scott County",5,67,72,36,36
050,17,171,"Illinois","Scott County",5,68,62,30,32
050,17,171,"Illinois","Scott County",5,69,58,30,28
050,17,171,"Illinois","Scott County",5,70,60,31,29
050,17,171,"Illinois","Scott County",5,71,58,26,32
050,17,171,"Illinois","Scott County",5,72,59,27,32
050,17,171,"Illinois","Scott County",5,73,38,14,24
050,17,171,"Illinois","Scott County",5,74,43,14,29
050,17,171,"Illinois","Scott County",5,75,37,17,20
050,17,171,"Illinois","Scott County",5,76,46,22,24
050,17,171,"Illinois","Scott County",5,77,30,12,18
050,17,171,"Illinois","Scott County",5,78,31,7,24
050,17,171,"Illinois","Scott County",5,79,31,13,18
050,17,171,"Illinois","Scott County",5,80,31,17,14
050,17,171,"Illinois","Scott County",5,81,35,14,21
050,17,171,"Illinois","Scott County",5,82,24,14,10
050,17,171,"Illinois","Scott County",5,83,24,11,13
050,17,171,"Illinois","Scott County",5,84,21,5,16
050,17,171,"Illinois","Scott County",5,85,124,47,77
050,17,173,"Illinois","Shelby County",1,0,225,115,110
050,17,173,"Illinois","Shelby County",1,1,241,120,121
050,17,173,"Illinois","Shelby County",1,2,210,106,104
050,17,173,"Illinois","Shelby County",1,3,236,114,122
050,17,173,"Illinois","Shelby County",1,4,238,120,118
050,17,173,"Illinois","Shelby County",1,5,246,128,118
050,17,173,"Illinois","Shelby County",1,6,254,124,130
050,17,173,"Illinois","Shelby County",1,7,232,118,114
050,17,173,"Illinois","Shelby County",1,8,229,120,109
050,17,173,"Illinois","Shelby County",1,9,246,128,118
050,17,173,"Illinois","Shelby County",1,10,256,136,120
050,17,173,"Illinois","Shelby County",1,11,262,137,125
050,17,173,"Illinois","Shelby County",1,12,268,137,131
050,17,173,"Illinois","Shelby County",1,13,287,148,139
050,17,173,"Illinois","Shelby County",1,14,264,148,116
050,17,173,"Illinois","Shelby County",1,15,287,159,128
050,17,173,"Illinois","Shelby County",1,16,285,160,125
050,17,173,"Illinois","Shelby County",1,17,256,132,124
050,17,173,"Illinois","Shelby County",1,18,210,110,100
050,17,173,"Illinois","Shelby County",1,19,171,89,82
050,17,173,"Illinois","Shelby County",1,20,193,97,96
050,17,173,"Illinois","Shelby County",1,21,185,90,95
050,17,173,"Illinois","Shelby County",1,22,195,88,107
050,17,173,"Illinois","Shelby County",1,23,219,107,112
050,17,173,"Illinois","Shelby County",1,24,205,102,103
050,17,173,"Illinois","Shelby County",1,25,223,116,107
050,17,173,"Illinois","Shelby County",1,26,216,113,103
050,17,173,"Illinois","Shelby County",1,27,219,110,109
050,17,173,"Illinois","Shelby County",1,28,236,125,111
050,17,173,"Illinois","Shelby County",1,29,253,132,121
050,17,173,"Illinois","Shelby County",1,30,207,112,95
050,17,173,"Illinois","Shelby County",1,31,215,106,109
050,17,173,"Illinois","Shelby County",1,32,218,100,118
050,17,173,"Illinois","Shelby County",1,33,215,105,110
050,17,173,"Illinois","Shelby County",1,34,238,129,109
050,17,173,"Illinois","Shelby County",1,35,236,115,121
050,17,173,"Illinois","Shelby County",1,36,249,130,119
050,17,173,"Illinois","Shelby County",1,37,231,112,119
050,17,173,"Illinois","Shelby County",1,38,241,118,123
050,17,173,"Illinois","Shelby County",1,39,259,135,124
050,17,173,"Illinois","Shelby County",1,40,231,123,108
050,17,173,"Illinois","Shelby County",1,41,238,130,108
050,17,173,"Illinois","Shelby County",1,42,251,131,120
050,17,173,"Illinois","Shelby County",1,43,223,119,104
050,17,173,"Illinois","Shelby County",1,44,230,120,110
050,17,173,"Illinois","Shelby County",1,45,220,113,107
050,17,173,"Illinois","Shelby County",1,46,224,111,113
050,17,173,"Illinois","Shelby County",1,47,232,116,116
050,17,173,"Illinois","Shelby County",1,48,255,133,122
050,17,173,"Illinois","Shelby County",1,49,270,137,133
050,17,173,"Illinois","Shelby County",1,50,258,133,125
050,17,173,"Illinois","Shelby County",1,51,249,132,117
050,17,173,"Illinois","Shelby County",1,52,250,125,125
050,17,173,"Illinois","Shelby County",1,53,275,135,140
050,17,173,"Illinois","Shelby County",1,54,271,139,132
050,17,173,"Illinois","Shelby County",1,55,304,145,159
050,17,173,"Illinois","Shelby County",1,56,309,156,153
050,17,173,"Illinois","Shelby County",1,57,322,163,159
050,17,173,"Illinois","Shelby County",1,58,328,161,167
050,17,173,"Illinois","Shelby County",1,59,322,157,165
050,17,173,"Illinois","Shelby County",1,60,307,161,146
050,17,173,"Illinois","Shelby County",1,61,320,164,156
050,17,173,"Illinois","Shelby County",1,62,340,170,170
050,17,173,"Illinois","Shelby County",1,63,322,149,173
050,17,173,"Illinois","Shelby County",1,64,313,156,157
050,17,173,"Illinois","Shelby County",1,65,311,161,150
050,17,173,"Illinois","Shelby County",1,66,296,151,145
050,17,173,"Illinois","Shelby County",1,67,291,137,154
050,17,173,"Illinois","Shelby County",1,68,287,139,148
050,17,173,"Illinois","Shelby County",1,69,280,141,139
050,17,173,"Illinois","Shelby County",1,70,266,132,134
050,17,173,"Illinois","Shelby County",1,71,266,133,133
050,17,173,"Illinois","Shelby County",1,72,254,131,123
050,17,173,"Illinois","Shelby County",1,73,256,119,137
050,17,173,"Illinois","Shelby County",1,74,187,81,106
050,17,173,"Illinois","Shelby County",1,75,191,95,96
050,17,173,"Illinois","Shelby County",1,76,197,98,99
050,17,173,"Illinois","Shelby County",1,77,187,89,98
050,17,173,"Illinois","Shelby County",1,78,176,90,86
050,17,173,"Illinois","Shelby County",1,79,165,84,81
050,17,173,"Illinois","Shelby County",1,80,120,52,68
050,17,173,"Illinois","Shelby County",1,81,126,62,64
050,17,173,"Illinois","Shelby County",1,82,112,53,59
050,17,173,"Illinois","Shelby County",1,83,93,45,48
050,17,173,"Illinois","Shelby County",1,84,85,34,51
050,17,173,"Illinois","Shelby County",1,85,624,235,389
050,17,173,"Illinois","Shelby County",2,0,224,113,111
050,17,173,"Illinois","Shelby County",2,1,236,118,118
050,17,173,"Illinois","Shelby County",2,2,217,110,107
050,17,173,"Illinois","Shelby County",2,3,228,111,117
050,17,173,"Illinois","Shelby County",2,4,235,117,118
050,17,173,"Illinois","Shelby County",2,5,244,126,118
050,17,173,"Illinois","Shelby County",2,6,252,125,127
050,17,173,"Illinois","Shelby County",2,7,235,118,117
050,17,173,"Illinois","Shelby County",2,8,227,118,109
050,17,173,"Illinois","Shelby County",2,9,242,127,115
050,17,173,"Illinois","Shelby County",2,10,253,134,119
050,17,173,"Illinois","Shelby County",2,11,260,136,124
050,17,173,"Illinois","Shelby County",2,12,268,137,131
050,17,173,"Illinois","Shelby County",2,13,278,144,134
050,17,173,"Illinois","Shelby County",2,14,270,147,123
050,17,173,"Illinois","Shelby County",2,15,282,157,125
050,17,173,"Illinois","Shelby County",2,16,285,160,125
050,17,173,"Illinois","Shelby County",2,17,262,138,124
050,17,173,"Illinois","Shelby County",2,18,206,109,97
050,17,173,"Illinois","Shelby County",2,19,167,86,81
050,17,173,"Illinois","Shelby County",2,20,190,95,95
050,17,173,"Illinois","Shelby County",2,21,187,92,95
050,17,173,"Illinois","Shelby County",2,22,192,89,103
050,17,173,"Illinois","Shelby County",2,23,210,101,109
050,17,173,"Illinois","Shelby County",2,24,208,104,104
050,17,173,"Illinois","Shelby County",2,25,219,114,105
050,17,173,"Illinois","Shelby County",2,26,218,113,105
050,17,173,"Illinois","Shelby County",2,27,218,111,107
050,17,173,"Illinois","Shelby County",2,28,233,122,111
050,17,173,"Illinois","Shelby County",2,29,245,129,116
050,17,173,"Illinois","Shelby County",2,30,217,116,101
050,17,173,"Illinois","Shelby County",2,31,213,108,105
050,17,173,"Illinois","Shelby County",2,32,218,103,115
050,17,173,"Illinois","Shelby County",2,33,217,106,111
050,17,173,"Illinois","Shelby County",2,34,232,122,110
050,17,173,"Illinois","Shelby County",2,35,240,120,120
050,17,173,"Illinois","Shelby County",2,36,245,126,119
050,17,173,"Illinois","Shelby County",2,37,234,115,119
050,17,173,"Illinois","Shelby County",2,38,240,118,122
050,17,173,"Illinois","Shelby County",2,39,251,129,122
050,17,173,"Illinois","Shelby County",2,40,239,128,111
050,17,173,"Illinois","Shelby County",2,41,237,128,109
050,17,173,"Illinois","Shelby County",2,42,246,129,117
050,17,173,"Illinois","Shelby County",2,43,231,122,109
050,17,173,"Illinois","Shelby County",2,44,225,118,107
050,17,173,"Illinois","Shelby County",2,45,224,115,109
050,17,173,"Illinois","Shelby County",2,46,222,110,112
050,17,173,"Illinois","Shelby County",2,47,229,115,114
050,17,173,"Illinois","Shelby County",2,48,248,128,120
050,17,173,"Illinois","Shelby County",2,49,268,138,130
050,17,173,"Illinois","Shelby County",2,50,259,133,126
050,17,173,"Illinois","Shelby County",2,51,249,130,119
050,17,173,"Illinois","Shelby County",2,52,249,126,123
050,17,173,"Illinois","Shelby County",2,53,267,131,136
050,17,173,"Illinois","Shelby County",2,54,273,140,133
050,17,173,"Illinois","Shelby County",2,55,295,143,152
050,17,173,"Illinois","Shelby County",2,56,307,153,154
050,17,173,"Illinois","Shelby County",2,57,318,160,158
050,17,173,"Illinois","Shelby County",2,58,326,161,165
050,17,173,"Illinois","Shelby County",2,59,325,159,166
050,17,173,"Illinois","Shelby County",2,60,311,160,151
050,17,173,"Illinois","Shelby County",2,61,314,161,153
050,17,173,"Illinois","Shelby County",2,62,334,169,165
050,17,173,"Illinois","Shelby County",2,63,332,157,175
050,17,173,"Illinois","Shelby County",2,64,313,153,160
050,17,173,"Illinois","Shelby County",2,65,309,157,152
050,17,173,"Illinois","Shelby County",2,66,298,152,146
050,17,173,"Illinois","Shelby County",2,67,290,140,150
050,17,173,"Illinois","Shelby County",2,68,287,139,148
050,17,173,"Illinois","Shelby County",2,69,282,141,141
050,17,173,"Illinois","Shelby County",2,70,265,132,133
050,17,173,"Illinois","Shelby County",2,71,266,133,133
050,17,173,"Illinois","Shelby County",2,72,250,128,122
050,17,173,"Illinois","Shelby County",2,73,268,127,141
050,17,173,"Illinois","Shelby County",2,74,190,84,106
050,17,173,"Illinois","Shelby County",2,75,188,90,98
050,17,173,"Illinois","Shelby County",2,76,192,95,97
050,17,173,"Illinois","Shelby County",2,77,195,94,101
050,17,173,"Illinois","Shelby County",2,78,175,87,88
050,17,173,"Illinois","Shelby County",2,79,162,81,81
050,17,173,"Illinois","Shelby County",2,80,131,60,71
050,17,173,"Illinois","Shelby County",2,81,123,59,64
050,17,173,"Illinois","Shelby County",2,82,113,55,58
050,17,173,"Illinois","Shelby County",2,83,96,46,50
050,17,173,"Illinois","Shelby County",2,84,84,36,48
050,17,173,"Illinois","Shelby County",2,85,616,228,388
050,17,173,"Illinois","Shelby County",3,0,198,104,94
050,17,173,"Illinois","Shelby County",3,1,215,113,102
050,17,173,"Illinois","Shelby County",3,2,238,117,121
050,17,173,"Illinois","Shelby County",3,3,224,111,113
050,17,173,"Illinois","Shelby County",3,4,247,122,125
050,17,173,"Illinois","Shelby County",3,5,245,124,121
050,17,173,"Illinois","Shelby County",3,6,246,131,115
050,17,173,"Illinois","Shelby County",3,7,252,122,130
050,17,173,"Illinois","Shelby County",3,8,242,122,120
050,17,173,"Illinois","Shelby County",3,9,229,114,115
050,17,173,"Illinois","Shelby County",3,10,243,130,113
050,17,173,"Illinois","Shelby County",3,11,249,130,119
050,17,173,"Illinois","Shelby County",3,12,269,140,129
050,17,173,"Illinois","Shelby County",3,13,271,137,134
050,17,173,"Illinois","Shelby County",3,14,279,145,134
050,17,173,"Illinois","Shelby County",3,15,280,150,130
050,17,173,"Illinois","Shelby County",3,16,282,161,121
050,17,173,"Illinois","Shelby County",3,17,273,157,116
050,17,173,"Illinois","Shelby County",3,18,224,121,103
050,17,173,"Illinois","Shelby County",3,19,159,84,75
050,17,173,"Illinois","Shelby County",3,20,177,92,85
050,17,173,"Illinois","Shelby County",3,21,199,99,100
050,17,173,"Illinois","Shelby County",3,22,189,84,105
050,17,173,"Illinois","Shelby County",3,23,198,95,103
050,17,173,"Illinois","Shelby County",3,24,192,96,96
050,17,173,"Illinois","Shelby County",3,25,208,102,106
050,17,173,"Illinois","Shelby County",3,26,216,108,108
050,17,173,"Illinois","Shelby County",3,27,219,107,112
050,17,173,"Illinois","Shelby County",3,28,217,112,105
050,17,173,"Illinois","Shelby County",3,29,235,126,109
050,17,173,"Illinois","Shelby County",3,30,246,124,122
050,17,173,"Illinois","Shelby County",3,31,220,115,105
050,17,173,"Illinois","Shelby County",3,32,215,110,105
050,17,173,"Illinois","Shelby County",3,33,218,105,113
050,17,173,"Illinois","Shelby County",3,34,218,104,114
050,17,173,"Illinois","Shelby County",3,35,239,130,109
050,17,173,"Illinois","Shelby County",3,36,247,128,119
050,17,173,"Illinois","Shelby County",3,37,243,123,120
050,17,173,"Illinois","Shelby County",3,38,237,120,117
050,17,173,"Illinois","Shelby County",3,39,245,123,122
050,17,173,"Illinois","Shelby County",3,40,249,125,124
050,17,173,"Illinois","Shelby County",3,41,239,129,110
050,17,173,"Illinois","Shelby County",3,42,231,127,104
050,17,173,"Illinois","Shelby County",3,43,253,132,121
050,17,173,"Illinois","Shelby County",3,44,231,124,107
050,17,173,"Illinois","Shelby County",3,45,232,125,107
050,17,173,"Illinois","Shelby County",3,46,227,121,106
050,17,173,"Illinois","Shelby County",3,47,222,109,113
050,17,173,"Illinois","Shelby County",3,48,227,113,114
050,17,173,"Illinois","Shelby County",3,49,245,127,118
050,17,173,"Illinois","Shelby County",3,50,258,131,127
050,17,173,"Illinois","Shelby County",3,51,255,129,126
050,17,173,"Illinois","Shelby County",3,52,252,129,123
050,17,173,"Illinois","Shelby County",3,53,248,120,128
050,17,173,"Illinois","Shelby County",3,54,256,125,131
050,17,173,"Illinois","Shelby County",3,55,277,141,136
050,17,173,"Illinois","Shelby County",3,56,303,148,155
050,17,173,"Illinois","Shelby County",3,57,303,145,158
050,17,173,"Illinois","Shelby County",3,58,322,165,157
050,17,173,"Illinois","Shelby County",3,59,320,158,162
050,17,173,"Illinois","Shelby County",3,60,319,157,162
050,17,173,"Illinois","Shelby County",3,61,310,152,158
050,17,173,"Illinois","Shelby County",3,62,313,164,149
050,17,173,"Illinois","Shelby County",3,63,334,169,165
050,17,173,"Illinois","Shelby County",3,64,330,152,178
050,17,173,"Illinois","Shelby County",3,65,312,155,157
050,17,173,"Illinois","Shelby County",3,66,310,159,151
050,17,173,"Illinois","Shelby County",3,67,287,147,140
050,17,173,"Illinois","Shelby County",3,68,287,139,148
050,17,173,"Illinois","Shelby County",3,69,283,137,146
050,17,173,"Illinois","Shelby County",3,70,279,138,141
050,17,173,"Illinois","Shelby County",3,71,262,132,130
050,17,173,"Illinois","Shelby County",3,72,262,135,127
050,17,173,"Illinois","Shelby County",3,73,245,125,120
050,17,173,"Illinois","Shelby County",3,74,256,122,134
050,17,173,"Illinois","Shelby County",3,75,176,79,97
050,17,173,"Illinois","Shelby County",3,76,178,84,94
050,17,173,"Illinois","Shelby County",3,77,184,89,95
050,17,173,"Illinois","Shelby County",3,78,189,86,103
050,17,173,"Illinois","Shelby County",3,79,163,79,84
050,17,173,"Illinois","Shelby County",3,80,157,77,80
050,17,173,"Illinois","Shelby County",3,81,126,59,67
050,17,173,"Illinois","Shelby County",3,82,108,51,57
050,17,173,"Illinois","Shelby County",3,83,104,52,52
050,17,173,"Illinois","Shelby County",3,84,96,44,52
050,17,173,"Illinois","Shelby County",3,85,599,218,381
050,17,173,"Illinois","Shelby County",4,0,187,102,85
050,17,173,"Illinois","Shelby County",4,1,204,105,99
050,17,173,"Illinois","Shelby County",4,2,223,115,108
050,17,173,"Illinois","Shelby County",4,3,237,119,118
050,17,173,"Illinois","Shelby County",4,4,237,121,116
050,17,173,"Illinois","Shelby County",4,5,246,122,124
050,17,173,"Illinois","Shelby County",4,6,249,124,125
050,17,173,"Illinois","Shelby County",4,7,255,130,125
050,17,173,"Illinois","Shelby County",4,8,260,132,128
050,17,173,"Illinois","Shelby County",4,9,240,118,122
050,17,173,"Illinois","Shelby County",4,10,228,115,113
050,17,173,"Illinois","Shelby County",4,11,241,131,110
050,17,173,"Illinois","Shelby County",4,12,253,130,123
050,17,173,"Illinois","Shelby County",4,13,274,139,135
050,17,173,"Illinois","Shelby County",4,14,269,140,129
050,17,173,"Illinois","Shelby County",4,15,277,146,131
050,17,173,"Illinois","Shelby County",4,16,266,145,121
050,17,173,"Illinois","Shelby County",4,17,269,143,126
050,17,173,"Illinois","Shelby County",4,18,224,136,88
050,17,173,"Illinois","Shelby County",4,19,165,88,77
050,17,173,"Illinois","Shelby County",4,20,156,81,75
050,17,173,"Illinois","Shelby County",4,21,186,97,89
050,17,173,"Illinois","Shelby County",4,22,197,100,97
050,17,173,"Illinois","Shelby County",4,23,191,85,106
050,17,173,"Illinois","Shelby County",4,24,189,96,93
050,17,173,"Illinois","Shelby County",4,25,198,99,99
050,17,173,"Illinois","Shelby County",4,26,219,107,112
050,17,173,"Illinois","Shelby County",4,27,215,110,105
050,17,173,"Illinois","Shelby County",4,28,220,101,119
050,17,173,"Illinois","Shelby County",4,29,212,112,100
050,17,173,"Illinois","Shelby County",4,30,233,120,113
050,17,173,"Illinois","Shelby County",4,31,248,129,119
050,17,173,"Illinois","Shelby County",4,32,228,121,107
050,17,173,"Illinois","Shelby County",4,33,219,114,105
050,17,173,"Illinois","Shelby County",4,34,216,104,112
050,17,173,"Illinois","Shelby County",4,35,202,96,106
050,17,173,"Illinois","Shelby County",4,36,246,132,114
050,17,173,"Illinois","Shelby County",4,37,254,129,125
050,17,173,"Illinois","Shelby County",4,38,236,121,115
050,17,173,"Illinois","Shelby County",4,39,231,116,115
050,17,173,"Illinois","Shelby County",4,40,236,119,117
050,17,173,"Illinois","Shelby County",4,41,250,131,119
050,17,173,"Illinois","Shelby County",4,42,241,130,111
050,17,173,"Illinois","Shelby County",4,43,240,133,107
050,17,173,"Illinois","Shelby County",4,44,256,133,123
050,17,173,"Illinois","Shelby County",4,45,222,124,98
050,17,173,"Illinois","Shelby County",4,46,238,124,114
050,17,173,"Illinois","Shelby County",4,47,233,121,112
050,17,173,"Illinois","Shelby County",4,48,224,111,113
050,17,173,"Illinois","Shelby County",4,49,234,113,121
050,17,173,"Illinois","Shelby County",4,50,251,129,122
050,17,173,"Illinois","Shelby County",4,51,267,129,138
050,17,173,"Illinois","Shelby County",4,52,257,128,129
050,17,173,"Illinois","Shelby County",4,53,250,127,123
050,17,173,"Illinois","Shelby County",4,54,248,122,126
050,17,173,"Illinois","Shelby County",4,55,260,127,133
050,17,173,"Illinois","Shelby County",4,56,285,146,139
050,17,173,"Illinois","Shelby County",4,57,299,150,149
050,17,173,"Illinois","Shelby County",4,58,310,154,156
050,17,173,"Illinois","Shelby County",4,59,312,163,149
050,17,173,"Illinois","Shelby County",4,60,315,152,163
050,17,173,"Illinois","Shelby County",4,61,315,152,163
050,17,173,"Illinois","Shelby County",4,62,304,148,156
050,17,173,"Illinois","Shelby County",4,63,320,165,155
050,17,173,"Illinois","Shelby County",4,64,331,167,164
050,17,173,"Illinois","Shelby County",4,65,325,148,177
050,17,173,"Illinois","Shelby County",4,66,314,155,159
050,17,173,"Illinois","Shelby County",4,67,306,158,148
050,17,173,"Illinois","Shelby County",4,68,276,145,131
050,17,173,"Illinois","Shelby County",4,69,282,135,147
050,17,173,"Illinois","Shelby County",4,70,273,133,140
050,17,173,"Illinois","Shelby County",4,71,266,129,137
050,17,173,"Illinois","Shelby County",4,72,256,130,126
050,17,173,"Illinois","Shelby County",4,73,255,126,129
050,17,173,"Illinois","Shelby County",4,74,233,121,112
050,17,173,"Illinois","Shelby County",4,75,244,116,128
050,17,173,"Illinois","Shelby County",4,76,164,73,91
050,17,173,"Illinois","Shelby County",4,77,172,80,92
050,17,173,"Illinois","Shelby County",4,78,171,79,92
050,17,173,"Illinois","Shelby County",4,79,174,77,97
050,17,173,"Illinois","Shelby County",4,80,156,74,82
050,17,173,"Illinois","Shelby County",4,81,148,72,76
050,17,173,"Illinois","Shelby County",4,82,113,53,60
050,17,173,"Illinois","Shelby County",4,83,97,46,51
050,17,173,"Illinois","Shelby County",4,84,97,46,51
050,17,173,"Illinois","Shelby County",4,85,590,210,380
050,17,173,"Illinois","Shelby County",5,0,178,95,83
050,17,173,"Illinois","Shelby County",5,1,188,102,86
050,17,173,"Illinois","Shelby County",5,2,209,111,98
050,17,173,"Illinois","Shelby County",5,3,221,116,105
050,17,173,"Illinois","Shelby County",5,4,233,114,119
050,17,173,"Illinois","Shelby County",5,5,232,122,110
050,17,173,"Illinois","Shelby County",5,6,256,124,132
050,17,173,"Illinois","Shelby County",5,7,244,118,126
050,17,173,"Illinois","Shelby County",5,8,258,136,122
050,17,173,"Illinois","Shelby County",5,9,256,124,132
050,17,173,"Illinois","Shelby County",5,10,235,117,118
050,17,173,"Illinois","Shelby County",5,11,232,117,115
050,17,173,"Illinois","Shelby County",5,12,244,130,114
050,17,173,"Illinois","Shelby County",5,13,257,134,123
050,17,173,"Illinois","Shelby County",5,14,271,140,131
050,17,173,"Illinois","Shelby County",5,15,274,141,133
050,17,173,"Illinois","Shelby County",5,16,282,150,132
050,17,173,"Illinois","Shelby County",5,17,269,143,126
050,17,173,"Illinois","Shelby County",5,18,223,125,98
050,17,173,"Illinois","Shelby County",5,19,170,100,70
050,17,173,"Illinois","Shelby County",5,20,177,86,91
050,17,173,"Illinois","Shelby County",5,21,158,85,73
050,17,173,"Illinois","Shelby County",5,22,186,94,92
050,17,173,"Illinois","Shelby County",5,23,215,110,105
050,17,173,"Illinois","Shelby County",5,24,192,99,93
050,17,173,"Illinois","Shelby County",5,25,195,92,103
050,17,173,"Illinois","Shelby County",5,26,200,100,100
050,17,173,"Illinois","Shelby County",5,27,196,96,100
050,17,173,"Illinois","Shelby County",5,28,224,114,110
050,17,173,"Illinois","Shelby County",5,29,230,105,125
050,17,173,"Illinois","Shelby County",5,30,217,109,108
050,17,173,"Illinois","Shelby County",5,31,231,118,113
050,17,173,"Illinois","Shelby County",5,32,246,132,114
050,17,173,"Illinois","Shelby County",5,33,223,114,109
050,17,173,"Illinois","Shelby County",5,34,212,107,105
050,17,173,"Illinois","Shelby County",5,35,214,102,112
050,17,173,"Illinois","Shelby County",5,36,197,97,100
050,17,173,"Illinois","Shelby County",5,37,243,128,115
050,17,173,"Illinois","Shelby County",5,38,258,130,128
050,17,173,"Illinois","Shelby County",5,39,237,123,114
050,17,173,"Illinois","Shelby County",5,40,227,116,111
050,17,173,"Illinois","Shelby County",5,41,239,120,119
050,17,173,"Illinois","Shelby County",5,42,245,131,114
050,17,173,"Illinois","Shelby County",5,43,248,132,116
050,17,173,"Illinois","Shelby County",5,44,234,127,107
050,17,173,"Illinois","Shelby County",5,45,252,131,121
050,17,173,"Illinois","Shelby County",5,46,223,123,100
050,17,173,"Illinois","Shelby County",5,47,236,123,113
050,17,173,"Illinois","Shelby County",5,48,229,121,108
050,17,173,"Illinois","Shelby County",5,49,227,113,114
050,17,173,"Illinois","Shelby County",5,50,227,109,118
050,17,173,"Illinois","Shelby County",5,51,256,132,124
050,17,173,"Illinois","Shelby County",5,52,257,124,133
050,17,173,"Illinois","Shelby County",5,53,262,132,130
050,17,173,"Illinois","Shelby County",5,54,252,128,124
050,17,173,"Illinois","Shelby County",5,55,245,118,127
050,17,173,"Illinois","Shelby County",5,56,261,128,133
050,17,173,"Illinois","Shelby County",5,57,286,147,139
050,17,173,"Illinois","Shelby County",5,58,293,151,142
050,17,173,"Illinois","Shelby County",5,59,307,155,152
050,17,173,"Illinois","Shelby County",5,60,313,160,153
050,17,173,"Illinois","Shelby County",5,61,301,145,156
050,17,173,"Illinois","Shelby County",5,62,313,149,164
050,17,173,"Illinois","Shelby County",5,63,302,148,154
050,17,173,"Illinois","Shelby County",5,64,316,163,153
050,17,173,"Illinois","Shelby County",5,65,325,163,162
050,17,173,"Illinois","Shelby County",5,66,326,147,179
050,17,173,"Illinois","Shelby County",5,67,307,153,154
050,17,173,"Illinois","Shelby County",5,68,301,156,145
050,17,173,"Illinois","Shelby County",5,69,274,142,132
050,17,173,"Illinois","Shelby County",5,70,279,137,142
050,17,173,"Illinois","Shelby County",5,71,268,130,138
050,17,173,"Illinois","Shelby County",5,72,259,130,129
050,17,173,"Illinois","Shelby County",5,73,254,127,127
050,17,173,"Illinois","Shelby County",5,74,249,126,123
050,17,173,"Illinois","Shelby County",5,75,220,114,106
050,17,173,"Illinois","Shelby County",5,76,228,109,119
050,17,173,"Illinois","Shelby County",5,77,163,73,90
050,17,173,"Illinois","Shelby County",5,78,165,72,93
050,17,173,"Illinois","Shelby County",5,79,159,73,86
050,17,173,"Illinois","Shelby County",5,80,171,74,97
050,17,173,"Illinois","Shelby County",5,81,150,71,79
050,17,173,"Illinois","Shelby County",5,82,136,66,70
050,17,173,"Illinois","Shelby County",5,83,106,50,56
050,17,173,"Illinois","Shelby County",5,84,94,41,53
050,17,173,"Illinois","Shelby County",5,85,600,219,381
050,17,175,"Illinois","Stark County",1,0,50,26,24
050,17,175,"Illinois","Stark County",1,1,60,33,27
050,17,175,"Illinois","Stark County",1,2,55,35,20
050,17,175,"Illinois","Stark County",1,3,61,32,29
050,17,175,"Illinois","Stark County",1,4,68,29,39
050,17,175,"Illinois","Stark County",1,5,59,29,30
050,17,175,"Illinois","Stark County",1,6,67,32,35
050,17,175,"Illinois","Stark County",1,7,64,24,40
050,17,175,"Illinois","Stark County",1,8,65,32,33
050,17,175,"Illinois","Stark County",1,9,63,31,32
050,17,175,"Illinois","Stark County",1,10,77,34,43
050,17,175,"Illinois","Stark County",1,11,70,32,38
050,17,175,"Illinois","Stark County",1,12,76,38,38
050,17,175,"Illinois","Stark County",1,13,61,38,23
050,17,175,"Illinois","Stark County",1,14,64,39,25
050,17,175,"Illinois","Stark County",1,15,74,33,41
050,17,175,"Illinois","Stark County",1,16,68,34,34
050,17,175,"Illinois","Stark County",1,17,69,35,34
050,17,175,"Illinois","Stark County",1,18,55,29,26
050,17,175,"Illinois","Stark County",1,19,53,25,28
050,17,175,"Illinois","Stark County",1,20,56,27,29
050,17,175,"Illinois","Stark County",1,21,60,29,31
050,17,175,"Illinois","Stark County",1,22,54,25,29
050,17,175,"Illinois","Stark County",1,23,58,34,24
050,17,175,"Illinois","Stark County",1,24,57,35,22
050,17,175,"Illinois","Stark County",1,25,61,27,34
050,17,175,"Illinois","Stark County",1,26,61,30,31
050,17,175,"Illinois","Stark County",1,27,69,35,34
050,17,175,"Illinois","Stark County",1,28,54,31,23
050,17,175,"Illinois","Stark County",1,29,66,36,30
050,17,175,"Illinois","Stark County",1,30,49,24,25
050,17,175,"Illinois","Stark County",1,31,42,22,20
050,17,175,"Illinois","Stark County",1,32,37,20,17
050,17,175,"Illinois","Stark County",1,33,51,21,30
050,17,175,"Illinois","Stark County",1,34,55,24,31
050,17,175,"Illinois","Stark County",1,35,62,37,25
050,17,175,"Illinois","Stark County",1,36,48,28,20
050,17,175,"Illinois","Stark County",1,37,54,32,22
050,17,175,"Illinois","Stark County",1,38,58,27,31
050,17,175,"Illinois","Stark County",1,39,70,36,34
050,17,175,"Illinois","Stark County",1,40,64,31,33
050,17,175,"Illinois","Stark County",1,41,58,27,31
050,17,175,"Illinois","Stark County",1,42,66,31,35
050,17,175,"Illinois","Stark County",1,43,67,36,31
050,17,175,"Illinois","Stark County",1,44,65,37,28
050,17,175,"Illinois","Stark County",1,45,58,40,18
050,17,175,"Illinois","Stark County",1,46,65,32,33
050,17,175,"Illinois","Stark County",1,47,60,27,33
050,17,175,"Illinois","Stark County",1,48,62,30,32
050,17,175,"Illinois","Stark County",1,49,72,31,41
050,17,175,"Illinois","Stark County",1,50,69,35,34
050,17,175,"Illinois","Stark County",1,51,63,32,31
050,17,175,"Illinois","Stark County",1,52,65,30,35
050,17,175,"Illinois","Stark County",1,53,74,33,41
050,17,175,"Illinois","Stark County",1,54,72,41,31
050,17,175,"Illinois","Stark County",1,55,75,40,35
050,17,175,"Illinois","Stark County",1,56,80,42,38
050,17,175,"Illinois","Stark County",1,57,83,42,41
050,17,175,"Illinois","Stark County",1,58,83,41,42
050,17,175,"Illinois","Stark County",1,59,76,43,33
050,17,175,"Illinois","Stark County",1,60,69,37,32
050,17,175,"Illinois","Stark County",1,61,76,43,33
050,17,175,"Illinois","Stark County",1,62,86,47,39
050,17,175,"Illinois","Stark County",1,63,87,43,44
050,17,175,"Illinois","Stark County",1,64,100,50,50
050,17,175,"Illinois","Stark County",1,65,90,45,45
050,17,175,"Illinois","Stark County",1,66,85,37,48
050,17,175,"Illinois","Stark County",1,67,84,40,44
050,17,175,"Illinois","Stark County",1,68,72,34,38
050,17,175,"Illinois","Stark County",1,69,54,25,29
050,17,175,"Illinois","Stark County",1,70,61,31,30
050,17,175,"Illinois","Stark County",1,71,58,33,25
050,17,175,"Illinois","Stark County",1,72,64,31,33
050,17,175,"Illinois","Stark County",1,73,67,33,34
050,17,175,"Illinois","Stark County",1,74,46,24,22
050,17,175,"Illinois","Stark County",1,75,49,28,21
050,17,175,"Illinois","Stark County",1,76,42,17,25
050,17,175,"Illinois","Stark County",1,77,50,27,23
050,17,175,"Illinois","Stark County",1,78,44,20,24
050,17,175,"Illinois","Stark County",1,79,40,18,22
050,17,175,"Illinois","Stark County",1,80,33,17,16
050,17,175,"Illinois","Stark County",1,81,36,19,17
050,17,175,"Illinois","Stark County",1,82,29,19,10
050,17,175,"Illinois","Stark County",1,83,24,13,11
050,17,175,"Illinois","Stark County",1,84,27,13,14
050,17,175,"Illinois","Stark County",1,85,144,38,106
050,17,175,"Illinois","Stark County",2,0,53,27,26
050,17,175,"Illinois","Stark County",2,1,58,32,26
050,17,175,"Illinois","Stark County",2,2,57,35,22
050,17,175,"Illinois","Stark County",2,3,60,33,27
050,17,175,"Illinois","Stark County",2,4,67,29,38
050,17,175,"Illinois","Stark County",2,5,62,29,33
050,17,175,"Illinois","Stark County",2,6,67,32,35
050,17,175,"Illinois","Stark County",2,7,63,25,38
050,17,175,"Illinois","Stark County",2,8,63,29,34
050,17,175,"Illinois","Stark County",2,9,64,30,34
050,17,175,"Illinois","Stark County",2,10,74,33,41
050,17,175,"Illinois","Stark County",2,11,71,32,39
050,17,175,"Illinois","Stark County",2,12,72,35,37
050,17,175,"Illinois","Stark County",2,13,62,37,25
050,17,175,"Illinois","Stark County",2,14,63,38,25
050,17,175,"Illinois","Stark County",2,15,71,34,37
050,17,175,"Illinois","Stark County",2,16,70,34,36
050,17,175,"Illinois","Stark County",2,17,68,35,33
050,17,175,"Illinois","Stark County",2,18,54,28,26
050,17,175,"Illinois","Stark County",2,19,51,25,26
050,17,175,"Illinois","Stark County",2,20,57,27,30
050,17,175,"Illinois","Stark County",2,21,60,29,31
050,17,175,"Illinois","Stark County",2,22,56,27,29
050,17,175,"Illinois","Stark County",2,23,56,32,24
050,17,175,"Illinois","Stark County",2,24,60,35,25
050,17,175,"Illinois","Stark County",2,25,61,29,32
050,17,175,"Illinois","Stark County",2,26,61,30,31
050,17,175,"Illinois","Stark County",2,27,66,33,33
050,17,175,"Illinois","Stark County",2,28,59,33,26
050,17,175,"Illinois","Stark County",2,29,64,37,27
050,17,175,"Illinois","Stark County",2,30,52,27,25
050,17,175,"Illinois","Stark County",2,31,44,23,21
050,17,175,"Illinois","Stark County",2,32,39,21,18
050,17,175,"Illinois","Stark County",2,33,48,21,27
050,17,175,"Illinois","Stark County",2,34,53,23,30
050,17,175,"Illinois","Stark County",2,35,60,34,26
050,17,175,"Illinois","Stark County",2,36,52,30,22
050,17,175,"Illinois","Stark County",2,37,52,31,21
050,17,175,"Illinois","Stark County",2,38,60,30,30
050,17,175,"Illinois","Stark County",2,39,67,34,33
050,17,175,"Illinois","Stark County",2,40,66,32,34
050,17,175,"Illinois","Stark County",2,41,60,28,32
050,17,175,"Illinois","Stark County",2,42,66,31,35
050,17,175,"Illinois","Stark County",2,43,66,35,31
050,17,175,"Illinois","Stark County",2,44,65,36,29
050,17,175,"Illinois","Stark County",2,45,59,39,20
050,17,175,"Illinois","Stark County",2,46,64,34,30
050,17,175,"Illinois","Stark County",2,47,61,28,33
050,17,175,"Illinois","Stark County",2,48,62,30,32
050,17,175,"Illinois","Stark County",2,49,70,31,39
050,17,175,"Illinois","Stark County",2,50,70,34,36
050,17,175,"Illinois","Stark County",2,51,64,32,32
050,17,175,"Illinois","Stark County",2,52,64,31,33
050,17,175,"Illinois","Stark County",2,53,72,32,40
050,17,175,"Illinois","Stark County",2,54,73,40,33
050,17,175,"Illinois","Stark County",2,55,73,39,34
050,17,175,"Illinois","Stark County",2,56,79,41,38
050,17,175,"Illinois","Stark County",2,57,81,41,40
050,17,175,"Illinois","Stark County",2,58,83,41,42
050,17,175,"Illinois","Stark County",2,59,77,42,35
050,17,175,"Illinois","Stark County",2,60,70,38,32
050,17,175,"Illinois","Stark County",2,61,73,41,32
050,17,175,"Illinois","Stark County",2,62,82,45,37
050,17,175,"Illinois","Stark County",2,63,85,43,42
050,17,175,"Illinois","Stark County",2,64,97,49,48
050,17,175,"Illinois","Stark County",2,65,90,45,45
050,17,175,"Illinois","Stark County",2,66,85,38,47
050,17,175,"Illinois","Stark County",2,67,84,39,45
050,17,175,"Illinois","Stark County",2,68,72,34,38
050,17,175,"Illinois","Stark County",2,69,59,27,32
050,17,175,"Illinois","Stark County",2,70,58,29,29
050,17,175,"Illinois","Stark County",2,71,59,33,26
050,17,175,"Illinois","Stark County",2,72,62,31,31
050,17,175,"Illinois","Stark County",2,73,70,35,35
050,17,175,"Illinois","Stark County",2,74,48,24,24
050,17,175,"Illinois","Stark County",2,75,48,27,21
050,17,175,"Illinois","Stark County",2,76,44,20,24
050,17,175,"Illinois","Stark County",2,77,48,25,23
050,17,175,"Illinois","Stark County",2,78,45,21,24
050,17,175,"Illinois","Stark County",2,79,41,19,22
050,17,175,"Illinois","Stark County",2,80,34,17,17
050,17,175,"Illinois","Stark County",2,81,35,18,17
050,17,175,"Illinois","Stark County",2,82,30,19,11
050,17,175,"Illinois","Stark County",2,83,25,15,10
050,17,175,"Illinois","Stark County",2,84,26,12,14
050,17,175,"Illinois","Stark County",2,85,140,38,102
050,17,175,"Illinois","Stark County",3,0,60,32,28
050,17,175,"Illinois","Stark County",3,1,50,18,32
050,17,175,"Illinois","Stark County",3,2,55,32,23
050,17,175,"Illinois","Stark County",3,3,59,38,21
050,17,175,"Illinois","Stark County",3,4,55,29,26
050,17,175,"Illinois","Stark County",3,5,70,29,41
050,17,175,"Illinois","Stark County",3,6,62,30,32
050,17,175,"Illinois","Stark County",3,7,62,29,33
050,17,175,"Illinois","Stark County",3,8,63,25,38
050,17,175,"Illinois","Stark County",3,9,67,30,37
050,17,175,"Illinois","Stark County",3,10,62,37,25
050,17,175,"Illinois","Stark County",3,11,72,34,38
050,17,175,"Illinois","Stark County",3,12,67,29,38
050,17,175,"Illinois","Stark County",3,13,73,35,38
050,17,175,"Illinois","Stark County",3,14,61,36,25
050,17,175,"Illinois","Stark County",3,15,63,39,24
050,17,175,"Illinois","Stark County",3,16,66,32,34
050,17,175,"Illinois","Stark County",3,17,72,34,38
050,17,175,"Illinois","Stark County",3,18,53,27,26
050,17,175,"Illinois","Stark County",3,19,42,24,18
050,17,175,"Illinois","Stark County",3,20,51,27,24
050,17,175,"Illinois","Stark County",3,21,61,31,30
050,17,175,"Illinois","Stark County",3,22,66,30,36
050,17,175,"Illinois","Stark County",3,23,56,27,29
050,17,175,"Illinois","Stark County",3,24,61,38,23
050,17,175,"Illinois","Stark County",3,25,53,31,22
050,17,175,"Illinois","Stark County",3,26,52,26,26
050,17,175,"Illinois","Stark County",3,27,59,24,35
050,17,175,"Illinois","Stark County",3,28,61,34,27
050,17,175,"Illinois","Stark County",3,29,54,28,26
050,17,175,"Illinois","Stark County",3,30,62,36,26
050,17,175,"Illinois","Stark County",3,31,58,29,29
050,17,175,"Illinois","Stark County",3,32,47,25,22
050,17,175,"Illinois","Stark County",3,33,42,22,20
050,17,175,"Illinois","Stark County",3,34,51,25,26
050,17,175,"Illinois","Stark County",3,35,52,23,29
050,17,175,"Illinois","Stark County",3,36,66,37,29
050,17,175,"Illinois","Stark County",3,37,59,34,25
050,17,175,"Illinois","Stark County",3,38,47,30,17
050,17,175,"Illinois","Stark County",3,39,56,29,27
050,17,175,"Illinois","Stark County",3,40,63,31,32
050,17,175,"Illinois","Stark County",3,41,68,34,34
050,17,175,"Illinois","Stark County",3,42,59,28,31
050,17,175,"Illinois","Stark County",3,43,68,33,35
050,17,175,"Illinois","Stark County",3,44,63,32,31
050,17,175,"Illinois","Stark County",3,45,61,36,25
050,17,175,"Illinois","Stark County",3,46,60,41,19
050,17,175,"Illinois","Stark County",3,47,63,34,29
050,17,175,"Illinois","Stark County",3,48,53,25,28
050,17,175,"Illinois","Stark County",3,49,61,29,32
050,17,175,"Illinois","Stark County",3,50,72,32,40
050,17,175,"Illinois","Stark County",3,51,70,35,35
050,17,175,"Illinois","Stark County",3,52,65,32,33
050,17,175,"Illinois","Stark County",3,53,63,29,34
050,17,175,"Illinois","Stark County",3,54,75,32,43
050,17,175,"Illinois","Stark County",3,55,72,40,32
050,17,175,"Illinois","Stark County",3,56,70,36,34
050,17,175,"Illinois","Stark County",3,57,76,41,35
050,17,175,"Illinois","Stark County",3,58,77,40,37
050,17,175,"Illinois","Stark County",3,59,81,43,38
050,17,175,"Illinois","Stark County",3,60,74,40,34
050,17,175,"Illinois","Stark County",3,61,65,33,32
050,17,175,"Illinois","Stark County",3,62,73,41,32
050,17,175,"Illinois","Stark County",3,63,83,47,36
050,17,175,"Illinois","Stark County",3,64,88,46,42
050,17,175,"Illinois","Stark County",3,65,91,43,48
050,17,175,"Illinois","Stark County",3,66,89,44,45
050,17,175,"Illinois","Stark County",3,67,78,33,45
050,17,175,"Illinois","Stark County",3,68,79,39,40
050,17,175,"Illinois","Stark County",3,69,70,32,38
050,17,175,"Illinois","Stark County",3,70,57,25,32
050,17,175,"Illinois","Stark County",3,71,58,30,28
050,17,175,"Illinois","Stark County",3,72,58,33,25
050,17,175,"Illinois","Stark County",3,73,62,33,29
050,17,175,"Illinois","Stark County",3,74,60,29,31
050,17,175,"Illinois","Stark County",3,75,46,22,24
050,17,175,"Illinois","Stark County",3,76,47,26,21
050,17,175,"Illinois","Stark County",3,77,43,21,22
050,17,175,"Illinois","Stark County",3,78,43,21,22
050,17,175,"Illinois","Stark County",3,79,42,19,23
050,17,175,"Illinois","Stark County",3,80,31,17,14
050,17,175,"Illinois","Stark County",3,81,34,17,17
050,17,175,"Illinois","Stark County",3,82,29,15,14
050,17,175,"Illinois","Stark County",3,83,32,22,10
050,17,175,"Illinois","Stark County",3,84,25,10,15
050,17,175,"Illinois","Stark County",3,85,139,42,97
050,17,175,"Illinois","Stark County",4,0,46,26,20
050,17,175,"Illinois","Stark County",4,1,61,35,26
050,17,175,"Illinois","Stark County",4,2,60,22,38
050,17,175,"Illinois","Stark County",4,3,55,32,23
050,17,175,"Illinois","Stark County",4,4,60,37,23
050,17,175,"Illinois","Stark County",4,5,66,32,34
050,17,175,"Illinois","Stark County",4,6,67,28,39
050,17,175,"Illinois","Stark County",4,7,63,31,32
050,17,175,"Illinois","Stark County",4,8,64,33,31
050,17,175,"Illinois","Stark County",4,9,72,33,39
050,17,175,"Illinois","Stark County",4,10,68,31,37
050,17,175,"Illinois","Stark County",4,11,62,36,26
050,17,175,"Illinois","Stark County",4,12,72,33,39
050,17,175,"Illinois","Stark County",4,13,70,31,39
050,17,175,"Illinois","Stark County",4,14,75,36,39
050,17,175,"Illinois","Stark County",4,15,63,37,26
050,17,175,"Illinois","Stark County",4,16,69,41,28
050,17,175,"Illinois","Stark County",4,17,67,32,35
050,17,175,"Illinois","Stark County",4,18,58,30,28
050,17,175,"Illinois","Stark County",4,19,40,22,18
050,17,175,"Illinois","Stark County",4,20,43,24,19
050,17,175,"Illinois","Stark County",4,21,51,28,23
050,17,175,"Illinois","Stark County",4,22,63,33,30
050,17,175,"Illinois","Stark County",4,23,71,33,38
050,17,175,"Illinois","Stark County",4,24,61,31,30
050,17,175,"Illinois","Stark County",4,25,58,35,23
050,17,175,"Illinois","Stark County",4,26,50,29,21
050,17,175,"Illinois","Stark County",4,27,52,28,24
050,17,175,"Illinois","Stark County",4,28,71,28,43
050,17,175,"Illinois","Stark County",4,29,58,32,26
050,17,175,"Illinois","Stark County",4,30,54,26,28
050,17,175,"Illinois","Stark County",4,31,63,37,26
050,17,175,"Illinois","Stark County",4,32,54,30,24
050,17,175,"Illinois","Stark County",4,33,52,26,26
050,17,175,"Illinois","Stark County",4,34,42,21,21
050,17,175,"Illinois","Stark County",4,35,54,26,28
050,17,175,"Illinois","Stark County",4,36,58,29,29
050,17,175,"Illinois","Stark County",4,37,64,37,27
050,17,175,"Illinois","Stark County",4,38,59,32,27
050,17,175,"Illinois","Stark County",4,39,48,30,18
050,17,175,"Illinois","Stark County",4,40,58,30,28
050,17,175,"Illinois","Stark County",4,41,67,35,32
050,17,175,"Illinois","Stark County",4,42,64,30,34
050,17,175,"Illinois","Stark County",4,43,60,31,29
050,17,175,"Illinois","Stark County",4,44,68,33,35
050,17,175,"Illinois","Stark County",4,45,69,33,36
050,17,175,"Illinois","Stark County",4,46,63,37,26
050,17,175,"Illinois","Stark County",4,47,61,38,23
050,17,175,"Illinois","Stark County",4,48,62,34,28
050,17,175,"Illinois","Stark County",4,49,57,29,28
050,17,175,"Illinois","Stark County",4,50,65,33,32
050,17,175,"Illinois","Stark County",4,51,71,32,39
050,17,175,"Illinois","Stark County",4,52,62,31,31
050,17,175,"Illinois","Stark County",4,53,62,31,31
050,17,175,"Illinois","Stark County",4,54,67,31,36
050,17,175,"Illinois","Stark County",4,55,74,31,43
050,17,175,"Illinois","Stark County",4,56,70,40,30
050,17,175,"Illinois","Stark County",4,57,75,38,37
050,17,175,"Illinois","Stark County",4,58,77,39,38
050,17,175,"Illinois","Stark County",4,59,82,46,36
050,17,175,"Illinois","Stark County",4,60,78,42,36
050,17,175,"Illinois","Stark County",4,61,76,38,38
050,17,175,"Illinois","Stark County",4,62,62,32,30
050,17,175,"Illinois","Stark County",4,63,71,41,30
050,17,175,"Illinois","Stark County",4,64,82,45,37
050,17,175,"Illinois","Stark County",4,65,84,40,44
050,17,175,"Illinois","Stark County",4,66,86,43,43
050,17,175,"Illinois","Stark County",4,67,83,41,42
050,17,175,"Illinois","Stark County",4,68,76,33,43
050,17,175,"Illinois","Stark County",4,69,75,37,38
050,17,175,"Illinois","Stark County",4,70,67,30,37
050,17,175,"Illinois","Stark County",4,71,56,25,31
050,17,175,"Illinois","Stark County",4,72,55,28,27
050,17,175,"Illinois","Stark County",4,73,64,37,27
050,17,175,"Illinois","Stark County",4,74,55,28,27
050,17,175,"Illinois","Stark County",4,75,59,27,32
050,17,175,"Illinois","Stark County",4,76,42,18,24
050,17,175,"Illinois","Stark County",4,77,46,27,19
050,17,175,"Illinois","Stark County",4,78,40,17,23
050,17,175,"Illinois","Stark County",4,79,44,23,21
050,17,175,"Illinois","Stark County",4,80,36,18,18
050,17,175,"Illinois","Stark County",4,81,28,16,12
050,17,175,"Illinois","Stark County",4,82,28,15,13
050,17,175,"Illinois","Stark County",4,83,30,17,13
050,17,175,"Illinois","Stark County",4,84,33,18,15
050,17,175,"Illinois","Stark County",4,85,139,46,93
050,17,175,"Illinois","Stark County",5,0,44,25,19
050,17,175,"Illinois","Stark County",5,1,41,19,22
050,17,175,"Illinois","Stark County",5,2,63,39,24
050,17,175,"Illinois","Stark County",5,3,58,24,34
050,17,175,"Illinois","Stark County",5,4,57,34,23
050,17,175,"Illinois","Stark County",5,5,63,37,26
050,17,175,"Illinois","Stark County",5,6,64,31,33
050,17,175,"Illinois","Stark County",5,7,68,29,39
050,17,175,"Illinois","Stark County",5,8,64,32,32
050,17,175,"Illinois","Stark County",5,9,67,33,34
050,17,175,"Illinois","Stark County",5,10,68,29,39
050,17,175,"Illinois","Stark County",5,11,65,31,34
050,17,175,"Illinois","Stark County",5,12,61,35,26
050,17,175,"Illinois","Stark County",5,13,74,36,38
050,17,175,"Illinois","Stark County",5,14,70,31,39
050,17,175,"Illinois","Stark County",5,15,78,36,42
050,17,175,"Illinois","Stark County",5,16,60,35,25
050,17,175,"Illinois","Stark County",5,17,69,37,32
050,17,175,"Illinois","Stark County",5,18,57,28,29
050,17,175,"Illinois","Stark County",5,19,43,21,22
050,17,175,"Illinois","Stark County",5,20,39,22,17
050,17,175,"Illinois","Stark County",5,21,44,25,19
050,17,175,"Illinois","Stark County",5,22,51,30,21
050,17,175,"Illinois","Stark County",5,23,71,38,33
050,17,175,"Illinois","Stark County",5,24,73,38,35
050,17,175,"Illinois","Stark County",5,25,61,25,36
050,17,175,"Illinois","Stark County",5,26,54,33,21
050,17,175,"Illinois","Stark County",5,27,50,27,23
050,17,175,"Illinois","Stark County",5,28,57,32,25
050,17,175,"Illinois","Stark County",5,29,70,29,41
050,17,175,"Illinois","Stark County",5,30,65,36,29
050,17,175,"Illinois","Stark County",5,31,54,26,28
050,17,175,"Illinois","Stark County",5,32,61,33,28
050,17,175,"Illinois","Stark County",5,33,56,30,26
050,17,175,"Illinois","Stark County",5,34,53,26,27
050,17,175,"Illinois","Stark County",5,35,39,18,21
050,17,175,"Illinois","Stark County",5,36,56,26,30
050,17,175,"Illinois","Stark County",5,37,59,28,31
050,17,175,"Illinois","Stark County",5,38,63,37,26
050,17,175,"Illinois","Stark County",5,39,54,30,24
050,17,175,"Illinois","Stark County",5,40,42,28,14
050,17,175,"Illinois","Stark County",5,41,56,28,28
050,17,175,"Illinois","Stark County",5,42,69,36,33
050,17,175,"Illinois","Stark County",5,43,65,29,36
050,17,175,"Illinois","Stark County",5,44,61,31,30
050,17,175,"Illinois","Stark County",5,45,66,32,34
050,17,175,"Illinois","Stark County",5,46,66,32,34
050,17,175,"Illinois","Stark County",5,47,63,36,27
050,17,175,"Illinois","Stark County",5,48,59,38,21
050,17,175,"Illinois","Stark County",5,49,58,31,27
050,17,175,"Illinois","Stark County",5,50,55,28,27
050,17,175,"Illinois","Stark County",5,51,61,33,28
050,17,175,"Illinois","Stark County",5,52,72,32,40
050,17,175,"Illinois","Stark County",5,53,58,28,30
050,17,175,"Illinois","Stark County",5,54,60,29,31
050,17,175,"Illinois","Stark County",5,55,63,29,34
050,17,175,"Illinois","Stark County",5,56,76,34,42
050,17,175,"Illinois","Stark County",5,57,72,40,32
050,17,175,"Illinois","Stark County",5,58,75,37,38
050,17,175,"Illinois","Stark County",5,59,75,41,34
050,17,175,"Illinois","Stark County",5,60,76,43,33
050,17,175,"Illinois","Stark County",5,61,77,40,37
050,17,175,"Illinois","Stark County",5,62,75,38,37
050,17,175,"Illinois","Stark County",5,63,62,31,31
050,17,175,"Illinois","Stark County",5,64,72,41,31
050,17,175,"Illinois","Stark County",5,65,76,39,37
050,17,175,"Illinois","Stark County",5,66,78,37,41
050,17,175,"Illinois","Stark County",5,67,79,39,40
050,17,175,"Illinois","Stark County",5,68,77,39,38
050,17,175,"Illinois","Stark County",5,69,69,28,41
050,17,175,"Illinois","Stark County",5,70,72,35,37
050,17,175,"Illinois","Stark County",5,71,68,31,37
050,17,175,"Illinois","Stark County",5,72,54,24,30
050,17,175,"Illinois","Stark County",5,73,58,30,28
050,17,175,"Illinois","Stark County",5,74,57,33,24
050,17,175,"Illinois","Stark County",5,75,51,27,24
050,17,175,"Illinois","Stark County",5,76,55,25,30
050,17,175,"Illinois","Stark County",5,77,42,19,23
050,17,175,"Illinois","Stark County",5,78,44,25,19
050,17,175,"Illinois","Stark County",5,79,40,18,22
050,17,175,"Illinois","Stark County",5,80,37,22,15
050,17,175,"Illinois","Stark County",5,81,35,17,18
050,17,175,"Illinois","Stark County",5,82,22,14,8
050,17,175,"Illinois","Stark County",5,83,29,16,13
050,17,175,"Illinois","Stark County",5,84,33,15,18
050,17,175,"Illinois","Stark County",5,85,144,54,90
050,17,177,"Illinois","Stephenson County",1,0,473,244,229
050,17,177,"Illinois","Stephenson County",1,1,475,251,224
050,17,177,"Illinois","Stephenson County",1,2,489,248,241
050,17,177,"Illinois","Stephenson County",1,3,516,278,238
050,17,177,"Illinois","Stephenson County",1,4,535,268,267
050,17,177,"Illinois","Stephenson County",1,5,533,265,268
050,17,177,"Illinois","Stephenson County",1,6,484,250,234
050,17,177,"Illinois","Stephenson County",1,7,509,259,250
050,17,177,"Illinois","Stephenson County",1,8,518,268,250
050,17,177,"Illinois","Stephenson County",1,9,534,279,255
050,17,177,"Illinois","Stephenson County",1,10,553,259,294
050,17,177,"Illinois","Stephenson County",1,11,579,279,300
050,17,177,"Illinois","Stephenson County",1,12,594,307,287
050,17,177,"Illinois","Stephenson County",1,13,600,298,302
050,17,177,"Illinois","Stephenson County",1,14,558,284,274
050,17,177,"Illinois","Stephenson County",1,15,557,284,273
050,17,177,"Illinois","Stephenson County",1,16,576,302,274
050,17,177,"Illinois","Stephenson County",1,17,591,297,294
050,17,177,"Illinois","Stephenson County",1,18,504,277,227
050,17,177,"Illinois","Stephenson County",1,19,412,226,186
050,17,177,"Illinois","Stephenson County",1,20,425,223,202
050,17,177,"Illinois","Stephenson County",1,21,461,237,224
050,17,177,"Illinois","Stephenson County",1,22,484,238,246
050,17,177,"Illinois","Stephenson County",1,23,456,218,238
050,17,177,"Illinois","Stephenson County",1,24,488,253,235
050,17,177,"Illinois","Stephenson County",1,25,481,248,233
050,17,177,"Illinois","Stephenson County",1,26,435,223,212
050,17,177,"Illinois","Stephenson County",1,27,458,226,232
050,17,177,"Illinois","Stephenson County",1,28,481,216,265
050,17,177,"Illinois","Stephenson County",1,29,482,244,238
050,17,177,"Illinois","Stephenson County",1,30,467,248,219
050,17,177,"Illinois","Stephenson County",1,31,451,217,234
050,17,177,"Illinois","Stephenson County",1,32,449,214,235
050,17,177,"Illinois","Stephenson County",1,33,433,196,237
050,17,177,"Illinois","Stephenson County",1,34,465,220,245
050,17,177,"Illinois","Stephenson County",1,35,466,229,237
050,17,177,"Illinois","Stephenson County",1,36,486,250,236
050,17,177,"Illinois","Stephenson County",1,37,485,241,244
050,17,177,"Illinois","Stephenson County",1,38,500,248,252
050,17,177,"Illinois","Stephenson County",1,39,514,244,270
050,17,177,"Illinois","Stephenson County",1,40,470,231,239
050,17,177,"Illinois","Stephenson County",1,41,443,224,219
050,17,177,"Illinois","Stephenson County",1,42,443,230,213
050,17,177,"Illinois","Stephenson County",1,43,446,215,231
050,17,177,"Illinois","Stephenson County",1,44,421,190,231
050,17,177,"Illinois","Stephenson County",1,45,464,224,240
050,17,177,"Illinois","Stephenson County",1,46,470,237,233
050,17,177,"Illinois","Stephenson County",1,47,481,244,237
050,17,177,"Illinois","Stephenson County",1,48,483,240,243
050,17,177,"Illinois","Stephenson County",1,49,577,304,273
050,17,177,"Illinois","Stephenson County",1,50,572,286,286
050,17,177,"Illinois","Stephenson County",1,51,571,285,286
050,17,177,"Illinois","Stephenson County",1,52,554,275,279
050,17,177,"Illinois","Stephenson County",1,53,553,267,286
050,17,177,"Illinois","Stephenson County",1,54,586,295,291
050,17,177,"Illinois","Stephenson County",1,55,625,310,315
050,17,177,"Illinois","Stephenson County",1,56,686,339,347
050,17,177,"Illinois","Stephenson County",1,57,673,332,341
050,17,177,"Illinois","Stephenson County",1,58,672,326,346
050,17,177,"Illinois","Stephenson County",1,59,731,368,363
050,17,177,"Illinois","Stephenson County",1,60,743,369,374
050,17,177,"Illinois","Stephenson County",1,61,685,347,338
050,17,177,"Illinois","Stephenson County",1,62,667,329,338
050,17,177,"Illinois","Stephenson County",1,63,671,331,340
050,17,177,"Illinois","Stephenson County",1,64,696,347,349
050,17,177,"Illinois","Stephenson County",1,65,668,322,346
050,17,177,"Illinois","Stephenson County",1,66,677,330,347
050,17,177,"Illinois","Stephenson County",1,67,633,305,328
050,17,177,"Illinois","Stephenson County",1,68,594,285,309
050,17,177,"Illinois","Stephenson County",1,69,573,297,276
050,17,177,"Illinois","Stephenson County",1,70,552,270,282
050,17,177,"Illinois","Stephenson County",1,71,525,243,282
050,17,177,"Illinois","Stephenson County",1,72,531,257,274
050,17,177,"Illinois","Stephenson County",1,73,529,248,281
050,17,177,"Illinois","Stephenson County",1,74,368,156,212
050,17,177,"Illinois","Stephenson County",1,75,399,186,213
050,17,177,"Illinois","Stephenson County",1,76,396,192,204
050,17,177,"Illinois","Stephenson County",1,77,396,190,206
050,17,177,"Illinois","Stephenson County",1,78,319,139,180
050,17,177,"Illinois","Stephenson County",1,79,289,128,161
050,17,177,"Illinois","Stephenson County",1,80,301,121,180
050,17,177,"Illinois","Stephenson County",1,81,287,130,157
050,17,177,"Illinois","Stephenson County",1,82,279,119,160
050,17,177,"Illinois","Stephenson County",1,83,254,112,142
050,17,177,"Illinois","Stephenson County",1,84,216,86,130
050,17,177,"Illinois","Stephenson County",1,85,1505,497,1008
050,17,177,"Illinois","Stephenson County",2,0,461,237,224
050,17,177,"Illinois","Stephenson County",2,1,473,249,224
050,17,177,"Illinois","Stephenson County",2,2,490,252,238
050,17,177,"Illinois","Stephenson County",2,3,507,269,238
050,17,177,"Illinois","Stephenson County",2,4,532,271,261
050,17,177,"Illinois","Stephenson County",2,5,524,261,263
050,17,177,"Illinois","Stephenson County",2,6,493,251,242
050,17,177,"Illinois","Stephenson County",2,7,503,256,247
050,17,177,"Illinois","Stephenson County",2,8,517,267,250
050,17,177,"Illinois","Stephenson County",2,9,529,275,254
050,17,177,"Illinois","Stephenson County",2,10,546,263,283
050,17,177,"Illinois","Stephenson County",2,11,571,273,298
050,17,177,"Illinois","Stephenson County",2,12,591,301,290
050,17,177,"Illinois","Stephenson County",2,13,596,300,296
050,17,177,"Illinois","Stephenson County",2,14,565,285,280
050,17,177,"Illinois","Stephenson County",2,15,559,285,274
050,17,177,"Illinois","Stephenson County",2,16,572,298,274
050,17,177,"Illinois","Stephenson County",2,17,584,297,287
050,17,177,"Illinois","Stephenson County",2,18,500,269,231
050,17,177,"Illinois","Stephenson County",2,19,410,224,186
050,17,177,"Illinois","Stephenson County",2,20,429,226,203
050,17,177,"Illinois","Stephenson County",2,21,457,233,224
050,17,177,"Illinois","Stephenson County",2,22,480,238,242
050,17,177,"Illinois","Stephenson County",2,23,464,222,242
050,17,177,"Illinois","Stephenson County",2,24,477,243,234
050,17,177,"Illinois","Stephenson County",2,25,477,245,232
050,17,177,"Illinois","Stephenson County",2,26,448,230,218
050,17,177,"Illinois","Stephenson County",2,27,451,223,228
050,17,177,"Illinois","Stephenson County",2,28,476,218,258
050,17,177,"Illinois","Stephenson County",2,29,480,237,243
050,17,177,"Illinois","Stephenson County",2,30,472,248,224
050,17,177,"Illinois","Stephenson County",2,31,449,223,226
050,17,177,"Illinois","Stephenson County",2,32,446,212,234
050,17,177,"Illinois","Stephenson County",2,33,435,199,236
050,17,177,"Illinois","Stephenson County",2,34,458,215,243
050,17,177,"Illinois","Stephenson County",2,35,470,229,241
050,17,177,"Illinois","Stephenson County",2,36,478,244,234
050,17,177,"Illinois","Stephenson County",2,37,484,243,241
050,17,177,"Illinois","Stephenson County",2,38,495,247,248
050,17,177,"Illinois","Stephenson County",2,39,510,245,265
050,17,177,"Illinois","Stephenson County",2,40,486,237,249
050,17,177,"Illinois","Stephenson County",2,41,447,223,224
050,17,177,"Illinois","Stephenson County",2,42,437,226,211
050,17,177,"Illinois","Stephenson County",2,43,450,221,229
050,17,177,"Illinois","Stephenson County",2,44,423,195,228
050,17,177,"Illinois","Stephenson County",2,45,458,219,239
050,17,177,"Illinois","Stephenson County",2,46,467,233,234
050,17,177,"Illinois","Stephenson County",2,47,473,240,233
050,17,177,"Illinois","Stephenson County",2,48,480,240,240
050,17,177,"Illinois","Stephenson County",2,49,552,286,266
050,17,177,"Illinois","Stephenson County",2,50,573,290,283
050,17,177,"Illinois","Stephenson County",2,51,568,284,284
050,17,177,"Illinois","Stephenson County",2,52,558,277,281
050,17,177,"Illinois","Stephenson County",2,53,551,268,283
050,17,177,"Illinois","Stephenson County",2,54,576,287,289
050,17,177,"Illinois","Stephenson County",2,55,616,307,309
050,17,177,"Illinois","Stephenson County",2,56,673,332,341
050,17,177,"Illinois","Stephenson County",2,57,680,337,343
050,17,177,"Illinois","Stephenson County",2,58,672,328,344
050,17,177,"Illinois","Stephenson County",2,59,720,361,359
050,17,177,"Illinois","Stephenson County",2,60,738,368,370
050,17,177,"Illinois","Stephenson County",2,61,693,350,343
050,17,177,"Illinois","Stephenson County",2,62,667,330,337
050,17,177,"Illinois","Stephenson County",2,63,672,332,340
050,17,177,"Illinois","Stephenson County",2,64,689,343,346
050,17,177,"Illinois","Stephenson County",2,65,675,327,348
050,17,177,"Illinois","Stephenson County",2,66,675,328,347
050,17,177,"Illinois","Stephenson County",2,67,641,309,332
050,17,177,"Illinois","Stephenson County",2,68,597,287,310
050,17,177,"Illinois","Stephenson County",2,69,579,295,284
050,17,177,"Illinois","Stephenson County",2,70,556,274,282
050,17,177,"Illinois","Stephenson County",2,71,529,250,279
050,17,177,"Illinois","Stephenson County",2,72,517,246,271
050,17,177,"Illinois","Stephenson County",2,73,549,260,289
050,17,177,"Illinois","Stephenson County",2,74,380,165,215
050,17,177,"Illinois","Stephenson County",2,75,389,176,213
050,17,177,"Illinois","Stephenson County",2,76,388,186,202
050,17,177,"Illinois","Stephenson County",2,77,399,192,207
050,17,177,"Illinois","Stephenson County",2,78,325,146,179
050,17,177,"Illinois","Stephenson County",2,79,289,128,161
050,17,177,"Illinois","Stephenson County",2,80,298,123,175
050,17,177,"Illinois","Stephenson County",2,81,284,124,160
050,17,177,"Illinois","Stephenson County",2,82,281,121,160
050,17,177,"Illinois","Stephenson County",2,83,251,108,143
050,17,177,"Illinois","Stephenson County",2,84,217,85,132
050,17,177,"Illinois","Stephenson County",2,85,1506,500,1006
050,17,177,"Illinois","Stephenson County",3,0,445,235,210
050,17,177,"Illinois","Stephenson County",3,1,475,246,229
050,17,177,"Illinois","Stephenson County",3,2,488,255,233
050,17,177,"Illinois","Stephenson County",3,3,493,256,237
050,17,177,"Illinois","Stephenson County",3,4,500,263,237
050,17,177,"Illinois","Stephenson County",3,5,518,261,257
050,17,177,"Illinois","Stephenson County",3,6,527,265,262
050,17,177,"Illinois","Stephenson County",3,7,492,252,240
050,17,177,"Illinois","Stephenson County",3,8,503,249,254
050,17,177,"Illinois","Stephenson County",3,9,500,261,239
050,17,177,"Illinois","Stephenson County",3,10,527,270,257
050,17,177,"Illinois","Stephenson County",3,11,535,258,277
050,17,177,"Illinois","Stephenson County",3,12,571,280,291
050,17,177,"Illinois","Stephenson County",3,13,589,304,285
050,17,177,"Illinois","Stephenson County",3,14,575,286,289
050,17,177,"Illinois","Stephenson County",3,15,580,293,287
050,17,177,"Illinois","Stephenson County",3,16,545,278,267
050,17,177,"Illinois","Stephenson County",3,17,581,301,280
050,17,177,"Illinois","Stephenson County",3,18,498,268,230
050,17,177,"Illinois","Stephenson County",3,19,413,220,193
050,17,177,"Illinois","Stephenson County",3,20,442,235,207
050,17,177,"Illinois","Stephenson County",3,21,450,229,221
050,17,177,"Illinois","Stephenson County",3,22,473,242,231
050,17,177,"Illinois","Stephenson County",3,23,479,238,241
050,17,177,"Illinois","Stephenson County",3,24,457,220,237
050,17,177,"Illinois","Stephenson County",3,25,464,234,230
050,17,177,"Illinois","Stephenson County",3,26,473,242,231
050,17,177,"Illinois","Stephenson County",3,27,445,223,222
050,17,177,"Illinois","Stephenson County",3,28,451,211,240
050,17,177,"Illinois","Stephenson County",3,29,466,219,247
050,17,177,"Illinois","Stephenson County",3,30,490,247,243
050,17,177,"Illinois","Stephenson County",3,31,462,244,218
050,17,177,"Illinois","Stephenson County",3,32,438,219,219
050,17,177,"Illinois","Stephenson County",3,33,446,215,231
050,17,177,"Illinois","Stephenson County",3,34,438,206,232
050,17,177,"Illinois","Stephenson County",3,35,464,210,254
050,17,177,"Illinois","Stephenson County",3,36,464,230,234
050,17,177,"Illinois","Stephenson County",3,37,476,239,237
050,17,177,"Illinois","Stephenson County",3,38,484,241,243
050,17,177,"Illinois","Stephenson County",3,39,495,243,252
050,17,177,"Illinois","Stephenson County",3,40,508,248,260
050,17,177,"Illinois","Stephenson County",3,41,486,237,249
050,17,177,"Illinois","Stephenson County",3,42,452,230,222
050,17,177,"Illinois","Stephenson County",3,43,437,230,207
050,17,177,"Illinois","Stephenson County",3,44,449,227,222
050,17,177,"Illinois","Stephenson County",3,45,422,197,225
050,17,177,"Illinois","Stephenson County",3,46,450,219,231
050,17,177,"Illinois","Stephenson County",3,47,453,229,224
050,17,177,"Illinois","Stephenson County",3,48,473,247,226
050,17,177,"Illinois","Stephenson County",3,49,476,232,244
050,17,177,"Illinois","Stephenson County",3,50,536,277,259
050,17,177,"Illinois","Stephenson County",3,51,579,288,291
050,17,177,"Illinois","Stephenson County",3,52,570,278,292
050,17,177,"Illinois","Stephenson County",3,53,550,273,277
050,17,177,"Illinois","Stephenson County",3,54,544,269,275
050,17,177,"Illinois","Stephenson County",3,55,575,288,287
050,17,177,"Illinois","Stephenson County",3,56,612,303,309
050,17,177,"Illinois","Stephenson County",3,57,674,325,349
050,17,177,"Illinois","Stephenson County",3,58,668,329,339
050,17,177,"Illinois","Stephenson County",3,59,663,322,341
050,17,177,"Illinois","Stephenson County",3,60,707,354,353
050,17,177,"Illinois","Stephenson County",3,61,711,347,364
050,17,177,"Illinois","Stephenson County",3,62,682,344,338
050,17,177,"Illinois","Stephenson County",3,63,660,328,332
050,17,177,"Illinois","Stephenson County",3,64,667,330,337
050,17,177,"Illinois","Stephenson County",3,65,677,333,344
050,17,177,"Illinois","Stephenson County",3,66,670,322,348
050,17,177,"Illinois","Stephenson County",3,67,656,316,340
050,17,177,"Illinois","Stephenson County",3,68,631,305,326
050,17,177,"Illinois","Stephenson County",3,69,593,286,307
050,17,177,"Illinois","Stephenson County",3,70,570,284,286
050,17,177,"Illinois","Stephenson County",3,71,534,268,266
050,17,177,"Illinois","Stephenson County",3,72,514,239,275
050,17,177,"Illinois","Stephenson County",3,73,493,232,261
050,17,177,"Illinois","Stephenson County",3,74,534,252,282
050,17,177,"Illinois","Stephenson County",3,75,364,155,209
050,17,177,"Illinois","Stephenson County",3,76,380,168,212
050,17,177,"Illinois","Stephenson County",3,77,374,180,194
050,17,177,"Illinois","Stephenson County",3,78,365,177,188
050,17,177,"Illinois","Stephenson County",3,79,308,140,168
050,17,177,"Illinois","Stephenson County",3,80,272,110,162
050,17,177,"Illinois","Stephenson County",3,81,281,123,158
050,17,177,"Illinois","Stephenson County",3,82,265,115,150
050,17,177,"Illinois","Stephenson County",3,83,258,109,149
050,17,177,"Illinois","Stephenson County",3,84,223,82,141
050,17,177,"Illinois","Stephenson County",3,85,1484,490,994
050,17,177,"Illinois","Stephenson County",4,0,375,218,157
050,17,177,"Illinois","Stephenson County",4,1,447,240,207
050,17,177,"Illinois","Stephenson County",4,2,486,257,229
050,17,177,"Illinois","Stephenson County",4,3,505,269,236
050,17,177,"Illinois","Stephenson County",4,4,498,249,249
050,17,177,"Illinois","Stephenson County",4,5,505,264,241
050,17,177,"Illinois","Stephenson County",4,6,528,269,259
050,17,177,"Illinois","Stephenson County",4,7,517,264,253
050,17,177,"Illinois","Stephenson County",4,8,481,252,229
050,17,177,"Illinois","Stephenson County",4,9,506,254,252
050,17,177,"Illinois","Stephenson County",4,10,497,250,247
050,17,177,"Illinois","Stephenson County",4,11,529,279,250
050,17,177,"Illinois","Stephenson County",4,12,529,249,280
050,17,177,"Illinois","Stephenson County",4,13,559,270,289
050,17,177,"Illinois","Stephenson County",4,14,580,307,273
050,17,177,"Illinois","Stephenson County",4,15,571,288,283
050,17,177,"Illinois","Stephenson County",4,16,575,286,289
050,17,177,"Illinois","Stephenson County",4,17,554,279,275
050,17,177,"Illinois","Stephenson County",4,18,483,257,226
050,17,177,"Illinois","Stephenson County",4,19,386,199,187
050,17,177,"Illinois","Stephenson County",4,20,431,226,205
050,17,177,"Illinois","Stephenson County",4,21,440,228,212
050,17,177,"Illinois","Stephenson County",4,22,466,235,231
050,17,177,"Illinois","Stephenson County",4,23,444,226,218
050,17,177,"Illinois","Stephenson County",4,24,476,238,238
050,17,177,"Illinois","Stephenson County",4,25,465,226,239
050,17,177,"Illinois","Stephenson County",4,26,454,230,224
050,17,177,"Illinois","Stephenson County",4,27,480,239,241
050,17,177,"Illinois","Stephenson County",4,28,447,228,219
050,17,177,"Illinois","Stephenson County",4,29,449,209,240
050,17,177,"Illinois","Stephenson County",4,30,454,213,241
050,17,177,"Illinois","Stephenson County",4,31,484,247,237
050,17,177,"Illinois","Stephenson County",4,32,468,242,226
050,17,177,"Illinois","Stephenson County",4,33,447,223,224
050,17,177,"Illinois","Stephenson County",4,34,441,212,229
050,17,177,"Illinois","Stephenson County",4,35,441,202,239
050,17,177,"Illinois","Stephenson County",4,36,472,209,263
050,17,177,"Illinois","Stephenson County",4,37,468,235,233
050,17,177,"Illinois","Stephenson County",4,38,476,237,239
050,17,177,"Illinois","Stephenson County",4,39,487,245,242
050,17,177,"Illinois","Stephenson County",4,40,496,247,249
050,17,177,"Illinois","Stephenson County",4,41,505,247,258
050,17,177,"Illinois","Stephenson County",4,42,485,241,244
050,17,177,"Illinois","Stephenson County",4,43,446,223,223
050,17,177,"Illinois","Stephenson County",4,44,423,217,206
050,17,177,"Illinois","Stephenson County",4,45,440,221,219
050,17,177,"Illinois","Stephenson County",4,46,422,197,225
050,17,177,"Illinois","Stephenson County",4,47,440,210,230
050,17,177,"Illinois","Stephenson County",4,48,451,231,220
050,17,177,"Illinois","Stephenson County",4,49,480,245,235
050,17,177,"Illinois","Stephenson County",4,50,464,229,235
050,17,177,"Illinois","Stephenson County",4,51,544,277,267
050,17,177,"Illinois","Stephenson County",4,52,580,288,292
050,17,177,"Illinois","Stephenson County",4,53,553,276,277
050,17,177,"Illinois","Stephenson County",4,54,550,281,269
050,17,177,"Illinois","Stephenson County",4,55,544,270,274
050,17,177,"Illinois","Stephenson County",4,56,572,286,286
050,17,177,"Illinois","Stephenson County",4,57,606,299,307
050,17,177,"Illinois","Stephenson County",4,58,652,310,342
050,17,177,"Illinois","Stephenson County",4,59,673,330,343
050,17,177,"Illinois","Stephenson County",4,60,663,319,344
050,17,177,"Illinois","Stephenson County",4,61,693,351,342
050,17,177,"Illinois","Stephenson County",4,62,689,335,354
050,17,177,"Illinois","Stephenson County",4,63,674,334,340
050,17,177,"Illinois","Stephenson County",4,64,675,333,342
050,17,177,"Illinois","Stephenson County",4,65,665,324,341
050,17,177,"Illinois","Stephenson County",4,66,667,330,337
050,17,177,"Illinois","Stephenson County",4,67,658,314,344
050,17,177,"Illinois","Stephenson County",4,68,645,310,335
050,17,177,"Illinois","Stephenson County",4,69,616,302,314
050,17,177,"Illinois","Stephenson County",4,70,579,273,306
050,17,177,"Illinois","Stephenson County",4,71,543,281,262
050,17,177,"Illinois","Stephenson County",4,72,520,258,262
050,17,177,"Illinois","Stephenson County",4,73,488,223,265
050,17,177,"Illinois","Stephenson County",4,74,468,211,257
050,17,177,"Illinois","Stephenson County",4,75,524,247,277
050,17,177,"Illinois","Stephenson County",4,76,349,147,202
050,17,177,"Illinois","Stephenson County",4,77,376,163,213
050,17,177,"Illinois","Stephenson County",4,78,339,165,174
050,17,177,"Illinois","Stephenson County",4,79,333,167,166
050,17,177,"Illinois","Stephenson County",4,80,295,125,170
050,17,177,"Illinois","Stephenson County",4,81,246,104,142
050,17,177,"Illinois","Stephenson County",4,82,259,115,144
050,17,177,"Illinois","Stephenson County",4,83,247,111,136
050,17,177,"Illinois","Stephenson County",4,84,233,86,147
050,17,177,"Illinois","Stephenson County",4,85,1485,484,1001
050,17,177,"Illinois","Stephenson County",5,0,309,179,130
050,17,177,"Illinois","Stephenson County",5,1,382,228,154
050,17,177,"Illinois","Stephenson County",5,2,456,249,207
050,17,177,"Illinois","Stephenson County",5,3,478,247,231
050,17,177,"Illinois","Stephenson County",5,4,482,260,222
050,17,177,"Illinois","Stephenson County",5,5,491,251,240
050,17,177,"Illinois","Stephenson County",5,6,479,253,226
050,17,177,"Illinois","Stephenson County",5,7,535,273,262
050,17,177,"Illinois","Stephenson County",5,8,517,271,246
050,17,177,"Illinois","Stephenson County",5,9,491,253,238
050,17,177,"Illinois","Stephenson County",5,10,518,262,256
050,17,177,"Illinois","Stephenson County",5,11,514,258,256
050,17,177,"Illinois","Stephenson County",5,12,516,267,249
050,17,177,"Illinois","Stephenson County",5,13,536,252,284
050,17,177,"Illinois","Stephenson County",5,14,568,273,295
050,17,177,"Illinois","Stephenson County",5,15,581,301,280
050,17,177,"Illinois","Stephenson County",5,16,557,274,283
050,17,177,"Illinois","Stephenson County",5,17,568,282,286
050,17,177,"Illinois","Stephenson County",5,18,463,240,223
050,17,177,"Illinois","Stephenson County",5,19,375,197,178
050,17,177,"Illinois","Stephenson County",5,20,429,211,218
050,17,177,"Illinois","Stephenson County",5,21,438,221,217
050,17,177,"Illinois","Stephenson County",5,22,472,240,232
050,17,177,"Illinois","Stephenson County",5,23,474,239,235
050,17,177,"Illinois","Stephenson County",5,24,427,220,207
050,17,177,"Illinois","Stephenson County",5,25,471,238,233
050,17,177,"Illinois","Stephenson County",5,26,451,213,238
050,17,177,"Illinois","Stephenson County",5,27,433,223,210
050,17,177,"Illinois","Stephenson County",5,28,458,229,229
050,17,177,"Illinois","Stephenson County",5,29,434,227,207
050,17,177,"Illinois","Stephenson County",5,30,454,218,236
050,17,177,"Illinois","Stephenson County",5,31,460,216,244
050,17,177,"Illinois","Stephenson County",5,32,500,256,244
050,17,177,"Illinois","Stephenson County",5,33,458,235,223
050,17,177,"Illinois","Stephenson County",5,34,442,216,226
050,17,177,"Illinois","Stephenson County",5,35,444,213,231
050,17,177,"Illinois","Stephenson County",5,36,437,203,234
050,17,177,"Illinois","Stephenson County",5,37,468,211,257
050,17,177,"Illinois","Stephenson County",5,38,452,225,227
050,17,177,"Illinois","Stephenson County",5,39,474,233,241
050,17,177,"Illinois","Stephenson County",5,40,497,256,241
050,17,177,"Illinois","Stephenson County",5,41,494,244,250
050,17,177,"Illinois","Stephenson County",5,42,509,251,258
050,17,177,"Illinois","Stephenson County",5,43,490,242,248
050,17,177,"Illinois","Stephenson County",5,44,453,235,218
050,17,177,"Illinois","Stephenson County",5,45,432,226,206
050,17,177,"Illinois","Stephenson County",5,46,435,217,218
050,17,177,"Illinois","Stephenson County",5,47,424,202,222
050,17,177,"Illinois","Stephenson County",5,48,439,209,230
050,17,177,"Illinois","Stephenson County",5,49,453,230,223
050,17,177,"Illinois","Stephenson County",5,50,468,243,225
050,17,177,"Illinois","Stephenson County",5,51,463,227,236
050,17,177,"Illinois","Stephenson County",5,52,556,278,278
050,17,177,"Illinois","Stephenson County",5,53,565,279,286
050,17,177,"Illinois","Stephenson County",5,54,556,279,277
050,17,177,"Illinois","Stephenson County",5,55,551,281,270
050,17,177,"Illinois","Stephenson County",5,56,551,273,278
050,17,177,"Illinois","Stephenson County",5,57,585,288,297
050,17,177,"Illinois","Stephenson County",5,58,610,295,315
050,17,177,"Illinois","Stephenson County",5,59,655,311,344
050,17,177,"Illinois","Stephenson County",5,60,681,334,347
050,17,177,"Illinois","Stephenson County",5,61,652,312,340
050,17,177,"Illinois","Stephenson County",5,62,674,346,328
050,17,177,"Illinois","Stephenson County",5,63,672,328,344
050,17,177,"Illinois","Stephenson County",5,64,681,343,338
050,17,177,"Illinois","Stephenson County",5,65,666,327,339
050,17,177,"Illinois","Stephenson County",5,66,645,316,329
050,17,177,"Illinois","Stephenson County",5,67,641,319,322
050,17,177,"Illinois","Stephenson County",5,68,650,301,349
050,17,177,"Illinois","Stephenson County",5,69,643,311,332
050,17,177,"Illinois","Stephenson County",5,70,609,291,318
050,17,177,"Illinois","Stephenson County",5,71,555,268,287
050,17,177,"Illinois","Stephenson County",5,72,528,271,257
050,17,177,"Illinois","Stephenson County",5,73,497,247,250
050,17,177,"Illinois","Stephenson County",5,74,463,205,258
050,17,177,"Illinois","Stephenson County",5,75,453,205,248
050,17,177,"Illinois","Stephenson County",5,76,512,240,272
050,17,177,"Illinois","Stephenson County",5,77,346,146,200
050,17,177,"Illinois","Stephenson County",5,78,350,155,195
050,17,177,"Illinois","Stephenson County",5,79,316,157,159
050,17,177,"Illinois","Stephenson County",5,80,319,149,170
050,17,177,"Illinois","Stephenson County",5,81,270,122,148
050,17,177,"Illinois","Stephenson County",5,82,221,94,127
050,17,177,"Illinois","Stephenson County",5,83,242,108,134
050,17,177,"Illinois","Stephenson County",5,84,224,89,135
050,17,177,"Illinois","Stephenson County",5,85,1517,489,1028
050,17,179,"Illinois","Tazewell County",1,0,1342,689,653
050,17,179,"Illinois","Tazewell County",1,1,1383,736,647
050,17,179,"Illinois","Tazewell County",1,2,1421,761,660
050,17,179,"Illinois","Tazewell County",1,3,1471,753,718
050,17,179,"Illinois","Tazewell County",1,4,1544,798,746
050,17,179,"Illinois","Tazewell County",1,5,1570,826,744
050,17,179,"Illinois","Tazewell County",1,6,1659,889,770
050,17,179,"Illinois","Tazewell County",1,7,1597,838,759
050,17,179,"Illinois","Tazewell County",1,8,1623,819,804
050,17,179,"Illinois","Tazewell County",1,9,1709,833,876
050,17,179,"Illinois","Tazewell County",1,10,1694,835,859
050,17,179,"Illinois","Tazewell County",1,11,1792,915,877
050,17,179,"Illinois","Tazewell County",1,12,1824,921,903
050,17,179,"Illinois","Tazewell County",1,13,1839,948,891
050,17,179,"Illinois","Tazewell County",1,14,1855,956,899
050,17,179,"Illinois","Tazewell County",1,15,1835,919,916
050,17,179,"Illinois","Tazewell County",1,16,1875,938,937
050,17,179,"Illinois","Tazewell County",1,17,1788,894,894
050,17,179,"Illinois","Tazewell County",1,18,1502,795,707
050,17,179,"Illinois","Tazewell County",1,19,1159,622,537
050,17,179,"Illinois","Tazewell County",1,20,1225,655,570
050,17,179,"Illinois","Tazewell County",1,21,1267,663,604
050,17,179,"Illinois","Tazewell County",1,22,1336,688,648
050,17,179,"Illinois","Tazewell County",1,23,1396,712,684
050,17,179,"Illinois","Tazewell County",1,24,1378,704,674
050,17,179,"Illinois","Tazewell County",1,25,1416,746,670
050,17,179,"Illinois","Tazewell County",1,26,1376,685,691
050,17,179,"Illinois","Tazewell County",1,27,1493,756,737
050,17,179,"Illinois","Tazewell County",1,28,1566,779,787
050,17,179,"Illinois","Tazewell County",1,29,1601,817,784
050,17,179,"Illinois","Tazewell County",1,30,1580,802,778
050,17,179,"Illinois","Tazewell County",1,31,1494,763,731
050,17,179,"Illinois","Tazewell County",1,32,1546,797,749
050,17,179,"Illinois","Tazewell County",1,33,1581,816,765
050,17,179,"Illinois","Tazewell County",1,34,1668,852,816
050,17,179,"Illinois","Tazewell County",1,35,1713,873,840
050,17,179,"Illinois","Tazewell County",1,36,1703,884,819
050,17,179,"Illinois","Tazewell County",1,37,1731,867,864
050,17,179,"Illinois","Tazewell County",1,38,1852,936,916
050,17,179,"Illinois","Tazewell County",1,39,1776,927,849
050,17,179,"Illinois","Tazewell County",1,40,1787,917,870
050,17,179,"Illinois","Tazewell County",1,41,1729,856,873
050,17,179,"Illinois","Tazewell County",1,42,1702,889,813
050,17,179,"Illinois","Tazewell County",1,43,1662,872,790
050,17,179,"Illinois","Tazewell County",1,44,1681,844,837
050,17,179,"Illinois","Tazewell County",1,45,1642,832,810
050,17,179,"Illinois","Tazewell County",1,46,1556,774,782
050,17,179,"Illinois","Tazewell County",1,47,1548,765,783
050,17,179,"Illinois","Tazewell County",1,48,1688,838,850
050,17,179,"Illinois","Tazewell County",1,49,1799,894,905
050,17,179,"Illinois","Tazewell County",1,50,1711,865,846
050,17,179,"Illinois","Tazewell County",1,51,1654,858,796
050,17,179,"Illinois","Tazewell County",1,52,1582,807,775
050,17,179,"Illinois","Tazewell County",1,53,1648,810,838
050,17,179,"Illinois","Tazewell County",1,54,1631,812,819
050,17,179,"Illinois","Tazewell County",1,55,1715,856,859
050,17,179,"Illinois","Tazewell County",1,56,1776,892,884
050,17,179,"Illinois","Tazewell County",1,57,1822,906,916
050,17,179,"Illinois","Tazewell County",1,58,1884,924,960
050,17,179,"Illinois","Tazewell County",1,59,1874,932,942
050,17,179,"Illinois","Tazewell County",1,60,1828,896,932
050,17,179,"Illinois","Tazewell County",1,61,1854,894,960
050,17,179,"Illinois","Tazewell County",1,62,1830,869,961
050,17,179,"Illinois","Tazewell County",1,63,1764,876,888
050,17,179,"Illinois","Tazewell County",1,64,1759,857,902
050,17,179,"Illinois","Tazewell County",1,65,1731,833,898
050,17,179,"Illinois","Tazewell County",1,66,1648,797,851
050,17,179,"Illinois","Tazewell County",1,67,1596,756,840
050,17,179,"Illinois","Tazewell County",1,68,1562,754,808
050,17,179,"Illinois","Tazewell County",1,69,1432,677,755
050,17,179,"Illinois","Tazewell County",1,70,1379,664,715
050,17,179,"Illinois","Tazewell County",1,71,1352,634,718
050,17,179,"Illinois","Tazewell County",1,72,1373,628,745
050,17,179,"Illinois","Tazewell County",1,73,1426,669,757
050,17,179,"Illinois","Tazewell County",1,74,974,441,533
050,17,179,"Illinois","Tazewell County",1,75,936,431,505
050,17,179,"Illinois","Tazewell County",1,76,939,423,516
050,17,179,"Illinois","Tazewell County",1,77,940,433,507
050,17,179,"Illinois","Tazewell County",1,78,808,366,442
050,17,179,"Illinois","Tazewell County",1,79,742,308,434
050,17,179,"Illinois","Tazewell County",1,80,651,278,373
050,17,179,"Illinois","Tazewell County",1,81,655,279,376
050,17,179,"Illinois","Tazewell County",1,82,634,263,371
050,17,179,"Illinois","Tazewell County",1,83,574,223,351
050,17,179,"Illinois","Tazewell County",1,84,514,210,304
050,17,179,"Illinois","Tazewell County",1,85,3169,1128,2041
050,17,179,"Illinois","Tazewell County",2,0,1304,664,640
050,17,179,"Illinois","Tazewell County",2,1,1368,722,646
050,17,179,"Illinois","Tazewell County",2,2,1412,756,656
050,17,179,"Illinois","Tazewell County",2,3,1453,755,698
050,17,179,"Illinois","Tazewell County",2,4,1528,789,739
050,17,179,"Illinois","Tazewell County",2,5,1564,820,744
050,17,179,"Illinois","Tazewell County",2,6,1639,875,764
050,17,179,"Illinois","Tazewell County",2,7,1604,846,758
050,17,179,"Illinois","Tazewell County",2,8,1613,822,791
050,17,179,"Illinois","Tazewell County",2,9,1687,830,857
050,17,179,"Illinois","Tazewell County",2,10,1694,834,860
050,17,179,"Illinois","Tazewell County",2,11,1755,887,868
050,17,179,"Illinois","Tazewell County",2,12,1817,916,901
050,17,179,"Illinois","Tazewell County",2,13,1837,942,895
050,17,179,"Illinois","Tazewell County",2,14,1854,956,898
050,17,179,"Illinois","Tazewell County",2,15,1847,933,914
050,17,179,"Illinois","Tazewell County",2,16,1867,933,934
050,17,179,"Illinois","Tazewell County",2,17,1809,906,903
050,17,179,"Illinois","Tazewell County",2,18,1492,787,705
050,17,179,"Illinois","Tazewell County",2,19,1170,626,544
050,17,179,"Illinois","Tazewell County",2,20,1238,663,575
050,17,179,"Illinois","Tazewell County",2,21,1266,665,601
050,17,179,"Illinois","Tazewell County",2,22,1331,687,644
050,17,179,"Illinois","Tazewell County",2,23,1387,705,682
050,17,179,"Illinois","Tazewell County",2,24,1382,706,676
050,17,179,"Illinois","Tazewell County",2,25,1410,737,673
050,17,179,"Illinois","Tazewell County",2,26,1389,700,689
050,17,179,"Illinois","Tazewell County",2,27,1468,743,725
050,17,179,"Illinois","Tazewell County",2,28,1551,777,774
050,17,179,"Illinois","Tazewell County",2,29,1596,813,783
050,17,179,"Illinois","Tazewell County",2,30,1590,805,785
050,17,179,"Illinois","Tazewell County",2,31,1513,775,738
050,17,179,"Illinois","Tazewell County",2,32,1525,784,741
050,17,179,"Illinois","Tazewell County",2,33,1576,814,762
050,17,179,"Illinois","Tazewell County",2,34,1640,839,801
050,17,179,"Illinois","Tazewell County",2,35,1714,876,838
050,17,179,"Illinois","Tazewell County",2,36,1699,878,821
050,17,179,"Illinois","Tazewell County",2,37,1726,868,858
050,17,179,"Illinois","Tazewell County",2,38,1826,920,906
050,17,179,"Illinois","Tazewell County",2,39,1794,930,864
050,17,179,"Illinois","Tazewell County",2,40,1790,922,868
050,17,179,"Illinois","Tazewell County",2,41,1739,870,869
050,17,179,"Illinois","Tazewell County",2,42,1699,877,822
050,17,179,"Illinois","Tazewell County",2,43,1677,878,799
050,17,179,"Illinois","Tazewell County",2,44,1657,840,817
050,17,179,"Illinois","Tazewell County",2,45,1662,840,822
050,17,179,"Illinois","Tazewell County",2,46,1565,780,785
050,17,179,"Illinois","Tazewell County",2,47,1543,765,778
050,17,179,"Illinois","Tazewell County",2,48,1654,822,832
050,17,179,"Illinois","Tazewell County",2,49,1773,881,892
050,17,179,"Illinois","Tazewell County",2,50,1730,872,858
050,17,179,"Illinois","Tazewell County",2,51,1653,851,802
050,17,179,"Illinois","Tazewell County",2,52,1591,816,775
050,17,179,"Illinois","Tazewell County",2,53,1632,810,822
050,17,179,"Illinois","Tazewell County",2,54,1629,807,822
050,17,179,"Illinois","Tazewell County",2,55,1689,841,848
050,17,179,"Illinois","Tazewell County",2,56,1763,883,880
050,17,179,"Illinois","Tazewell County",2,57,1807,901,906
050,17,179,"Illinois","Tazewell County",2,58,1861,917,944
050,17,179,"Illinois","Tazewell County",2,59,1885,935,950
050,17,179,"Illinois","Tazewell County",2,60,1827,898,929
050,17,179,"Illinois","Tazewell County",2,61,1839,889,950
050,17,179,"Illinois","Tazewell County",2,62,1824,872,952
050,17,179,"Illinois","Tazewell County",2,63,1792,878,914
050,17,179,"Illinois","Tazewell County",2,64,1734,844,890
050,17,179,"Illinois","Tazewell County",2,65,1728,831,897
050,17,179,"Illinois","Tazewell County",2,66,1658,802,856
050,17,179,"Illinois","Tazewell County",2,67,1593,756,837
050,17,179,"Illinois","Tazewell County",2,68,1550,743,807
050,17,179,"Illinois","Tazewell County",2,69,1468,696,772
050,17,179,"Illinois","Tazewell County",2,70,1381,660,721
050,17,179,"Illinois","Tazewell County",2,71,1350,634,716
050,17,179,"Illinois","Tazewell County",2,72,1329,606,723
050,17,179,"Illinois","Tazewell County",2,73,1479,690,789
050,17,179,"Illinois","Tazewell County",2,74,1009,458,551
050,17,179,"Illinois","Tazewell County",2,75,942,430,512
050,17,179,"Illinois","Tazewell County",2,76,927,421,506
050,17,179,"Illinois","Tazewell County",2,77,956,441,515
050,17,179,"Illinois","Tazewell County",2,78,815,370,445
050,17,179,"Illinois","Tazewell County",2,79,747,317,430
050,17,179,"Illinois","Tazewell County",2,80,665,282,383
050,17,179,"Illinois","Tazewell County",2,81,644,273,371
050,17,179,"Illinois","Tazewell County",2,82,628,262,366
050,17,179,"Illinois","Tazewell County",2,83,577,224,353
050,17,179,"Illinois","Tazewell County",2,84,522,212,310
050,17,179,"Illinois","Tazewell County",2,85,3168,1127,2041
050,17,179,"Illinois","Tazewell County",3,0,1215,628,587
050,17,179,"Illinois","Tazewell County",3,1,1350,686,664
050,17,179,"Illinois","Tazewell County",3,2,1383,739,644
050,17,179,"Illinois","Tazewell County",3,3,1417,758,659
050,17,179,"Illinois","Tazewell County",3,4,1460,754,706
050,17,179,"Illinois","Tazewell County",3,5,1560,807,753
050,17,179,"Illinois","Tazewell County",3,6,1582,825,757
050,17,179,"Illinois","Tazewell County",3,7,1655,877,778
050,17,179,"Illinois","Tazewell County",3,8,1604,849,755
050,17,179,"Illinois","Tazewell County",3,9,1621,834,787
050,17,179,"Illinois","Tazewell County",3,10,1696,840,856
050,17,179,"Illinois","Tazewell County",3,11,1699,840,859
050,17,179,"Illinois","Tazewell County",3,12,1746,885,861
050,17,179,"Illinois","Tazewell County",3,13,1824,920,904
050,17,179,"Illinois","Tazewell County",3,14,1850,950,900
050,17,179,"Illinois","Tazewell County",3,15,1846,952,894
050,17,179,"Illinois","Tazewell County",3,16,1834,923,911
050,17,179,"Illinois","Tazewell County",3,17,1862,928,934
050,17,179,"Illinois","Tazewell County",3,18,1528,795,733
050,17,179,"Illinois","Tazewell County",3,19,1171,618,553
050,17,179,"Illinois","Tazewell County",3,20,1281,669,612
050,17,179,"Illinois","Tazewell County",3,21,1305,689,616
050,17,179,"Illinois","Tazewell County",3,22,1315,669,646
050,17,179,"Illinois","Tazewell County",3,23,1373,721,652
050,17,179,"Illinois","Tazewell County",3,24,1394,729,665
050,17,179,"Illinois","Tazewell County",3,25,1407,733,674
050,17,179,"Illinois","Tazewell County",3,26,1466,740,726
050,17,179,"Illinois","Tazewell County",3,27,1420,724,696
050,17,179,"Illinois","Tazewell County",3,28,1463,740,723
050,17,179,"Illinois","Tazewell County",3,29,1606,808,798
050,17,179,"Illinois","Tazewell County",3,30,1630,821,809
050,17,179,"Illinois","Tazewell County",3,31,1630,819,811
050,17,179,"Illinois","Tazewell County",3,32,1501,760,741
050,17,179,"Illinois","Tazewell County",3,33,1545,803,742
050,17,179,"Illinois","Tazewell County",3,34,1587,818,769
050,17,179,"Illinois","Tazewell County",3,35,1669,868,801
050,17,179,"Illinois","Tazewell County",3,36,1732,893,839
050,17,179,"Illinois","Tazewell County",3,37,1689,858,831
050,17,179,"Illinois","Tazewell County",3,38,1729,853,876
050,17,179,"Illinois","Tazewell County",3,39,1820,915,905
050,17,179,"Illinois","Tazewell County",3,40,1796,926,870
050,17,179,"Illinois","Tazewell County",3,41,1783,905,878
050,17,179,"Illinois","Tazewell County",3,42,1750,873,877
050,17,179,"Illinois","Tazewell County",3,43,1680,864,816
050,17,179,"Illinois","Tazewell County",3,44,1692,890,802
050,17,179,"Illinois","Tazewell County",3,45,1644,830,814
050,17,179,"Illinois","Tazewell County",3,46,1656,834,822
050,17,179,"Illinois","Tazewell County",3,47,1542,768,774
050,17,179,"Illinois","Tazewell County",3,48,1536,776,760
050,17,179,"Illinois","Tazewell County",3,49,1647,813,834
050,17,179,"Illinois","Tazewell County",3,50,1762,876,886
050,17,179,"Illinois","Tazewell County",3,51,1695,845,850
050,17,179,"Illinois","Tazewell County",3,52,1636,849,787
050,17,179,"Illinois","Tazewell County",3,53,1591,815,776
050,17,179,"Illinois","Tazewell County",3,54,1603,791,812
050,17,179,"Illinois","Tazewell County",3,55,1590,791,799
050,17,179,"Illinois","Tazewell County",3,56,1673,831,842
050,17,179,"Illinois","Tazewell County",3,57,1730,868,862
050,17,179,"Illinois","Tazewell County",3,58,1752,869,883
050,17,179,"Illinois","Tazewell County",3,59,1838,907,931
050,17,179,"Illinois","Tazewell County",3,60,1865,924,941
050,17,179,"Illinois","Tazewell County",3,61,1801,869,932
050,17,179,"Illinois","Tazewell County",3,62,1788,870,918
050,17,179,"Illinois","Tazewell County",3,63,1784,855,929
050,17,179,"Illinois","Tazewell County",3,64,1746,840,906
050,17,179,"Illinois","Tazewell County",3,65,1697,829,868
050,17,179,"Illinois","Tazewell County",3,66,1701,806,895
050,17,179,"Illinois","Tazewell County",3,67,1631,788,843
050,17,179,"Illinois","Tazewell County",3,68,1555,733,822
050,17,179,"Illinois","Tazewell County",3,69,1504,723,781
050,17,179,"Illinois","Tazewell County",3,70,1429,665,764
050,17,179,"Illinois","Tazewell County",3,71,1349,639,710
050,17,179,"Illinois","Tazewell County",3,72,1293,609,684
050,17,179,"Illinois","Tazewell County",3,73,1283,578,705
050,17,179,"Illinois","Tazewell County",3,74,1424,658,766
050,17,179,"Illinois","Tazewell County",3,75,968,436,532
050,17,179,"Illinois","Tazewell County",3,76,908,408,500
050,17,179,"Illinois","Tazewell County",3,77,882,402,480
050,17,179,"Illinois","Tazewell County",3,78,903,406,497
050,17,179,"Illinois","Tazewell County",3,79,784,353,431
050,17,179,"Illinois","Tazewell County",3,80,702,295,407
050,17,179,"Illinois","Tazewell County",3,81,613,246,367
050,17,179,"Illinois","Tazewell County",3,82,577,246,331
050,17,179,"Illinois","Tazewell County",3,83,587,233,354
050,17,179,"Illinois","Tazewell County",3,84,514,205,309
050,17,179,"Illinois","Tazewell County",3,85,3063,1087,1976
050,17,179,"Illinois","Tazewell County",4,0,1253,675,578
050,17,179,"Illinois","Tazewell County",4,1,1218,633,585
050,17,179,"Illinois","Tazewell County",4,2,1352,690,662
050,17,179,"Illinois","Tazewell County",4,3,1393,728,665
050,17,179,"Illinois","Tazewell County",4,4,1401,744,657
050,17,179,"Illinois","Tazewell County",4,5,1491,764,727
050,17,179,"Illinois","Tazewell County",4,6,1515,773,742
050,17,179,"Illinois","Tazewell County",4,7,1559,818,741
050,17,179,"Illinois","Tazewell County",4,8,1655,876,779
050,17,179,"Illinois","Tazewell County",4,9,1592,843,749
050,17,179,"Illinois","Tazewell County",4,10,1606,821,785
050,17,179,"Illinois","Tazewell County",4,11,1705,851,854
050,17,179,"Illinois","Tazewell County",4,12,1691,836,855
050,17,179,"Illinois","Tazewell County",4,13,1737,890,847
050,17,179,"Illinois","Tazewell County",4,14,1803,912,891
050,17,179,"Illinois","Tazewell County",4,15,1864,964,900
050,17,179,"Illinois","Tazewell County",4,16,1851,950,901
050,17,179,"Illinois","Tazewell County",4,17,1810,904,906
050,17,179,"Illinois","Tazewell County",4,18,1546,801,745
050,17,179,"Illinois","Tazewell County",4,19,1178,616,562
050,17,179,"Illinois","Tazewell County",4,20,1242,657,585
050,17,179,"Illinois","Tazewell County",4,21,1324,688,636
050,17,179,"Illinois","Tazewell County",4,22,1367,702,665
050,17,179,"Illinois","Tazewell County",4,23,1384,715,669
050,17,179,"Illinois","Tazewell County",4,24,1406,714,692
050,17,179,"Illinois","Tazewell County",4,25,1413,746,667
050,17,179,"Illinois","Tazewell County",4,26,1402,726,676
050,17,179,"Illinois","Tazewell County",4,27,1522,779,743
050,17,179,"Illinois","Tazewell County",4,28,1431,735,696
050,17,179,"Illinois","Tazewell County",4,29,1519,782,737
050,17,179,"Illinois","Tazewell County",4,30,1628,811,817
050,17,179,"Illinois","Tazewell County",4,31,1636,840,796
050,17,179,"Illinois","Tazewell County",4,32,1586,790,796
050,17,179,"Illinois","Tazewell County",4,33,1537,792,745
050,17,179,"Illinois","Tazewell County",4,34,1547,810,737
050,17,179,"Illinois","Tazewell County",4,35,1567,818,749
050,17,179,"Illinois","Tazewell County",4,36,1703,888,815
050,17,179,"Illinois","Tazewell County",4,37,1745,887,858
050,17,179,"Illinois","Tazewell County",4,38,1701,868,833
050,17,179,"Illinois","Tazewell County",4,39,1738,865,873
050,17,179,"Illinois","Tazewell County",4,40,1807,913,894
050,17,179,"Illinois","Tazewell County",4,41,1774,913,861
050,17,179,"Illinois","Tazewell County",4,42,1787,898,889
050,17,179,"Illinois","Tazewell County",4,43,1731,864,867
050,17,179,"Illinois","Tazewell County",4,44,1683,868,815
050,17,179,"Illinois","Tazewell County",4,45,1684,886,798
050,17,179,"Illinois","Tazewell County",4,46,1636,824,812
050,17,179,"Illinois","Tazewell County",4,47,1654,829,825
050,17,179,"Illinois","Tazewell County",4,48,1546,775,771
050,17,179,"Illinois","Tazewell County",4,49,1528,768,760
050,17,179,"Illinois","Tazewell County",4,50,1646,819,827
050,17,179,"Illinois","Tazewell County",4,51,1718,846,872
050,17,179,"Illinois","Tazewell County",4,52,1666,835,831
050,17,179,"Illinois","Tazewell County",4,53,1609,837,772
050,17,179,"Illinois","Tazewell County",4,54,1569,811,758
050,17,179,"Illinois","Tazewell County",4,55,1571,774,797
050,17,179,"Illinois","Tazewell County",4,56,1591,789,802
050,17,179,"Illinois","Tazewell County",4,57,1649,819,830
050,17,179,"Illinois","Tazewell County",4,58,1694,846,848
050,17,179,"Illinois","Tazewell County",4,59,1759,874,885
050,17,179,"Illinois","Tazewell County",4,60,1810,894,916
050,17,179,"Illinois","Tazewell County",4,61,1855,913,942
050,17,179,"Illinois","Tazewell County",4,62,1744,841,903
050,17,179,"Illinois","Tazewell County",4,63,1760,855,905
050,17,179,"Illinois","Tazewell County",4,64,1764,832,932
050,17,179,"Illinois","Tazewell County",4,65,1711,812,899
050,17,179,"Illinois","Tazewell County",4,66,1670,805,865
050,17,179,"Illinois","Tazewell County",4,67,1682,788,894
050,17,179,"Illinois","Tazewell County",4,68,1606,767,839
050,17,179,"Illinois","Tazewell County",4,69,1514,711,803
050,17,179,"Illinois","Tazewell County",4,70,1467,695,772
050,17,179,"Illinois","Tazewell County",4,71,1378,628,750
050,17,179,"Illinois","Tazewell County",4,72,1302,613,689
050,17,179,"Illinois","Tazewell County",4,73,1264,593,671
050,17,179,"Illinois","Tazewell County",4,74,1236,545,691
050,17,179,"Illinois","Tazewell County",4,75,1367,632,735
050,17,179,"Illinois","Tazewell County",4,76,939,419,520
050,17,179,"Illinois","Tazewell County",4,77,885,399,486
050,17,179,"Illinois","Tazewell County",4,78,831,372,459
050,17,179,"Illinois","Tazewell County",4,79,860,373,487
050,17,179,"Illinois","Tazewell County",4,80,733,329,404
050,17,179,"Illinois","Tazewell County",4,81,661,265,396
050,17,179,"Illinois","Tazewell County",4,82,566,227,339
050,17,179,"Illinois","Tazewell County",4,83,544,220,324
050,17,179,"Illinois","Tazewell County",4,84,538,218,320
050,17,179,"Illinois","Tazewell County",4,85,3003,1072,1931
050,17,179,"Illinois","Tazewell County",5,0,1193,642,551
050,17,179,"Illinois","Tazewell County",5,1,1263,670,593
050,17,179,"Illinois","Tazewell County",5,2,1250,639,611
050,17,179,"Illinois","Tazewell County",5,3,1379,702,677
050,17,179,"Illinois","Tazewell County",5,4,1418,742,676
050,17,179,"Illinois","Tazewell County",5,5,1399,738,661
050,17,179,"Illinois","Tazewell County",5,6,1487,756,731
050,17,179,"Illinois","Tazewell County",5,7,1539,795,744
050,17,179,"Illinois","Tazewell County",5,8,1593,840,753
050,17,179,"Illinois","Tazewell County",5,9,1664,877,787
050,17,179,"Illinois","Tazewell County",5,10,1597,843,754
050,17,179,"Illinois","Tazewell County",5,11,1622,835,787
050,17,179,"Illinois","Tazewell County",5,12,1691,838,853
050,17,179,"Illinois","Tazewell County",5,13,1690,852,838
050,17,179,"Illinois","Tazewell County",5,14,1763,905,858
050,17,179,"Illinois","Tazewell County",5,15,1813,924,889
050,17,179,"Illinois","Tazewell County",5,16,1850,961,889
050,17,179,"Illinois","Tazewell County",5,17,1850,962,888
050,17,179,"Illinois","Tazewell County",5,18,1515,787,728
050,17,179,"Illinois","Tazewell County",5,19,1218,632,586
050,17,179,"Illinois","Tazewell County",5,20,1266,651,615
050,17,179,"Illinois","Tazewell County",5,21,1301,684,617
050,17,179,"Illinois","Tazewell County",5,22,1417,723,694
050,17,179,"Illinois","Tazewell County",5,23,1474,748,726
050,17,179,"Illinois","Tazewell County",5,24,1463,767,696
050,17,179,"Illinois","Tazewell County",5,25,1461,757,704
050,17,179,"Illinois","Tazewell County",5,26,1414,745,669
050,17,179,"Illinois","Tazewell County",5,27,1455,763,692
050,17,179,"Illinois","Tazewell County",5,28,1540,796,744
050,17,179,"Illinois","Tazewell County",5,29,1491,770,721
050,17,179,"Illinois","Tazewell County",5,30,1562,810,752
050,17,179,"Illinois","Tazewell County",5,31,1616,815,801
050,17,179,"Illinois","Tazewell County",5,32,1646,832,814
050,17,179,"Illinois","Tazewell County",5,33,1639,815,824
050,17,179,"Illinois","Tazewell County",5,34,1559,800,759
050,17,179,"Illinois","Tazewell County",5,35,1583,833,750
050,17,179,"Illinois","Tazewell County",5,36,1564,826,738
050,17,179,"Illinois","Tazewell County",5,37,1711,892,819
050,17,179,"Illinois","Tazewell County",5,38,1757,887,870
050,17,179,"Illinois","Tazewell County",5,39,1681,858,823
050,17,179,"Illinois","Tazewell County",5,40,1755,880,875
050,17,179,"Illinois","Tazewell County",5,41,1783,894,889
050,17,179,"Illinois","Tazewell County",5,42,1771,906,865
050,17,179,"Illinois","Tazewell County",5,43,1753,871,882
050,17,179,"Illinois","Tazewell County",5,44,1721,857,864
050,17,179,"Illinois","Tazewell County",5,45,1704,875,829
050,17,179,"Illinois","Tazewell County",5,46,1686,881,805
050,17,179,"Illinois","Tazewell County",5,47,1638,826,812
050,17,179,"Illinois","Tazewell County",5,48,1633,826,807
050,17,179,"Illinois","Tazewell County",5,49,1520,754,766
050,17,179,"Illinois","Tazewell County",5,50,1533,761,772
050,17,179,"Illinois","Tazewell County",5,51,1624,804,820
050,17,179,"Illinois","Tazewell County",5,52,1697,835,862
050,17,179,"Illinois","Tazewell County",5,53,1676,845,831
050,17,179,"Illinois","Tazewell County",5,54,1580,810,770
050,17,179,"Illinois","Tazewell County",5,55,1551,800,751
050,17,179,"Illinois","Tazewell County",5,56,1566,778,788
050,17,179,"Illinois","Tazewell County",5,57,1577,779,798
050,17,179,"Illinois","Tazewell County",5,58,1634,810,824
050,17,179,"Illinois","Tazewell County",5,59,1696,851,845
050,17,179,"Illinois","Tazewell County",5,60,1760,875,885
050,17,179,"Illinois","Tazewell County",5,61,1773,861,912
050,17,179,"Illinois","Tazewell County",5,62,1824,895,929
050,17,179,"Illinois","Tazewell County",5,63,1704,815,889
050,17,179,"Illinois","Tazewell County",5,64,1742,837,905
050,17,179,"Illinois","Tazewell County",5,65,1746,816,930
050,17,179,"Illinois","Tazewell County",5,66,1698,791,907
050,17,179,"Illinois","Tazewell County",5,67,1647,794,853
050,17,179,"Illinois","Tazewell County",5,68,1657,771,886
050,17,179,"Illinois","Tazewell County",5,69,1566,747,819
050,17,179,"Illinois","Tazewell County",5,70,1465,676,789
050,17,179,"Illinois","Tazewell County",5,71,1434,677,757
050,17,179,"Illinois","Tazewell County",5,72,1334,602,732
050,17,179,"Illinois","Tazewell County",5,73,1272,597,675
050,17,179,"Illinois","Tazewell County",5,74,1211,559,652
050,17,179,"Illinois","Tazewell County",5,75,1196,522,674
050,17,179,"Illinois","Tazewell County",5,76,1331,603,728
050,17,179,"Illinois","Tazewell County",5,77,903,405,498
050,17,179,"Illinois","Tazewell County",5,78,856,378,478
050,17,179,"Illinois","Tazewell County",5,79,818,351,467
050,17,179,"Illinois","Tazewell County",5,80,807,351,456
050,17,179,"Illinois","Tazewell County",5,81,684,300,384
050,17,179,"Illinois","Tazewell County",5,82,608,242,366
050,17,179,"Illinois","Tazewell County",5,83,538,202,336
050,17,179,"Illinois","Tazewell County",5,84,495,207,288
050,17,179,"Illinois","Tazewell County",5,85,2980,1080,1900
050,17,181,"Illinois","Union County",1,0,178,89,89
050,17,181,"Illinois","Union County",1,1,187,92,95
050,17,181,"Illinois","Union County",1,2,203,104,99
050,17,181,"Illinois","Union County",1,3,163,81,82
050,17,181,"Illinois","Union County",1,4,191,92,99
050,17,181,"Illinois","Union County",1,5,201,99,102
050,17,181,"Illinois","Union County",1,6,192,97,95
050,17,181,"Illinois","Union County",1,7,187,100,87
050,17,181,"Illinois","Union County",1,8,181,96,85
050,17,181,"Illinois","Union County",1,9,184,96,88
050,17,181,"Illinois","Union County",1,10,184,91,93
050,17,181,"Illinois","Union County",1,11,198,98,100
050,17,181,"Illinois","Union County",1,12,224,117,107
050,17,181,"Illinois","Union County",1,13,221,113,108
050,17,181,"Illinois","Union County",1,14,219,111,108
050,17,181,"Illinois","Union County",1,15,235,112,123
050,17,181,"Illinois","Union County",1,16,243,125,118
050,17,181,"Illinois","Union County",1,17,233,121,112
050,17,181,"Illinois","Union County",1,18,201,107,94
050,17,181,"Illinois","Union County",1,19,159,81,78
050,17,181,"Illinois","Union County",1,20,148,78,70
050,17,181,"Illinois","Union County",1,21,162,85,77
050,17,181,"Illinois","Union County",1,22,151,82,69
050,17,181,"Illinois","Union County",1,23,164,85,79
050,17,181,"Illinois","Union County",1,24,154,81,73
050,17,181,"Illinois","Union County",1,25,169,90,79
050,17,181,"Illinois","Union County",1,26,195,104,91
050,17,181,"Illinois","Union County",1,27,185,93,92
050,17,181,"Illinois","Union County",1,28,202,102,100
050,17,181,"Illinois","Union County",1,29,227,127,100
050,17,181,"Illinois","Union County",1,30,224,118,106
050,17,181,"Illinois","Union County",1,31,194,93,101
050,17,181,"Illinois","Union County",1,32,191,101,90
050,17,181,"Illinois","Union County",1,33,199,103,96
050,17,181,"Illinois","Union County",1,34,201,112,89
050,17,181,"Illinois","Union County",1,35,195,100,95
050,17,181,"Illinois","Union County",1,36,205,108,97
050,17,181,"Illinois","Union County",1,37,199,106,93
050,17,181,"Illinois","Union County",1,38,206,114,92
050,17,181,"Illinois","Union County",1,39,212,107,105
050,17,181,"Illinois","Union County",1,40,204,111,93
050,17,181,"Illinois","Union County",1,41,196,103,93
050,17,181,"Illinois","Union County",1,42,168,89,79
050,17,181,"Illinois","Union County",1,43,205,106,99
050,17,181,"Illinois","Union County",1,44,206,105,101
050,17,181,"Illinois","Union County",1,45,229,115,114
050,17,181,"Illinois","Union County",1,46,227,117,110
050,17,181,"Illinois","Union County",1,47,198,106,92
050,17,181,"Illinois","Union County",1,48,232,124,108
050,17,181,"Illinois","Union County",1,49,231,119,112
050,17,181,"Illinois","Union County",1,50,227,118,109
050,17,181,"Illinois","Union County",1,51,213,113,100
050,17,181,"Illinois","Union County",1,52,223,124,99
050,17,181,"Illinois","Union County",1,53,230,119,111
050,17,181,"Illinois","Union County",1,54,227,115,112
050,17,181,"Illinois","Union County",1,55,229,110,119
050,17,181,"Illinois","Union County",1,56,271,133,138
050,17,181,"Illinois","Union County",1,57,257,127,130
050,17,181,"Illinois","Union County",1,58,243,124,119
050,17,181,"Illinois","Union County",1,59,266,141,125
050,17,181,"Illinois","Union County",1,60,258,136,122
050,17,181,"Illinois","Union County",1,61,247,131,116
050,17,181,"Illinois","Union County",1,62,256,138,118
050,17,181,"Illinois","Union County",1,63,253,123,130
050,17,181,"Illinois","Union County",1,64,252,116,136
050,17,181,"Illinois","Union County",1,65,258,133,125
050,17,181,"Illinois","Union County",1,66,232,124,108
050,17,181,"Illinois","Union County",1,67,248,136,112
050,17,181,"Illinois","Union County",1,68,221,108,113
050,17,181,"Illinois","Union County",1,69,205,98,107
050,17,181,"Illinois","Union County",1,70,195,95,100
050,17,181,"Illinois","Union County",1,71,197,88,109
050,17,181,"Illinois","Union County",1,72,188,90,98
050,17,181,"Illinois","Union County",1,73,203,100,103
050,17,181,"Illinois","Union County",1,74,156,72,84
050,17,181,"Illinois","Union County",1,75,144,59,85
050,17,181,"Illinois","Union County",1,76,154,70,84
050,17,181,"Illinois","Union County",1,77,159,69,90
050,17,181,"Illinois","Union County",1,78,149,68,81
050,17,181,"Illinois","Union County",1,79,103,52,51
050,17,181,"Illinois","Union County",1,80,97,50,47
050,17,181,"Illinois","Union County",1,81,105,53,52
050,17,181,"Illinois","Union County",1,82,109,55,54
050,17,181,"Illinois","Union County",1,83,106,58,48
050,17,181,"Illinois","Union County",1,84,75,36,39
050,17,181,"Illinois","Union County",1,85,420,157,263
050,17,181,"Illinois","Union County",2,0,179,91,88
050,17,181,"Illinois","Union County",2,1,184,91,93
050,17,181,"Illinois","Union County",2,2,197,99,98
050,17,181,"Illinois","Union County",2,3,171,85,86
050,17,181,"Illinois","Union County",2,4,187,90,97
050,17,181,"Illinois","Union County",2,5,199,97,102
050,17,181,"Illinois","Union County",2,6,195,98,97
050,17,181,"Illinois","Union County",2,7,188,98,90
050,17,181,"Illinois","Union County",2,8,181,97,84
050,17,181,"Illinois","Union County",2,9,184,96,88
050,17,181,"Illinois","Union County",2,10,185,92,93
050,17,181,"Illinois","Union County",2,11,194,96,98
050,17,181,"Illinois","Union County",2,12,219,113,106
050,17,181,"Illinois","Union County",2,13,221,114,107
050,17,181,"Illinois","Union County",2,14,218,111,107
050,17,181,"Illinois","Union County",2,15,230,110,120
050,17,181,"Illinois","Union County",2,16,241,121,120
050,17,181,"Illinois","Union County",2,17,235,121,114
050,17,181,"Illinois","Union County",2,18,199,105,94
050,17,181,"Illinois","Union County",2,19,162,85,77
050,17,181,"Illinois","Union County",2,20,155,81,74
050,17,181,"Illinois","Union County",2,21,161,85,76
050,17,181,"Illinois","Union County",2,22,158,84,74
050,17,181,"Illinois","Union County",2,23,161,86,75
050,17,181,"Illinois","Union County",2,24,156,80,76
050,17,181,"Illinois","Union County",2,25,168,90,78
050,17,181,"Illinois","Union County",2,26,187,99,88
050,17,181,"Illinois","Union County",2,27,184,94,90
050,17,181,"Illinois","Union County",2,28,197,99,98
050,17,181,"Illinois","Union County",2,29,223,123,100
050,17,181,"Illinois","Union County",2,30,224,118,106
050,17,181,"Illinois","Union County",2,31,200,99,101
050,17,181,"Illinois","Union County",2,32,190,97,93
050,17,181,"Illinois","Union County",2,33,198,104,94
050,17,181,"Illinois","Union County",2,34,200,110,90
050,17,181,"Illinois","Union County",2,35,196,101,95
050,17,181,"Illinois","Union County",2,36,201,106,95
050,17,181,"Illinois","Union County",2,37,200,105,95
050,17,181,"Illinois","Union County",2,38,205,114,91
050,17,181,"Illinois","Union County",2,39,211,111,100
050,17,181,"Illinois","Union County",2,40,208,110,98
050,17,181,"Illinois","Union County",2,41,198,105,93
050,17,181,"Illinois","Union County",2,42,172,91,81
050,17,181,"Illinois","Union County",2,43,199,103,96
050,17,181,"Illinois","Union County",2,44,205,103,102
050,17,181,"Illinois","Union County",2,45,227,115,112
050,17,181,"Illinois","Union County",2,46,228,118,110
050,17,181,"Illinois","Union County",2,47,199,105,94
050,17,181,"Illinois","Union County",2,48,226,123,103
050,17,181,"Illinois","Union County",2,49,231,121,110
050,17,181,"Illinois","Union County",2,50,228,119,109
050,17,181,"Illinois","Union County",2,51,212,112,100
050,17,181,"Illinois","Union County",2,52,221,121,100
050,17,181,"Illinois","Union County",2,53,229,119,110
050,17,181,"Illinois","Union County",2,54,223,113,110
050,17,181,"Illinois","Union County",2,55,228,111,117
050,17,181,"Illinois","Union County",2,56,260,127,133
050,17,181,"Illinois","Union County",2,57,258,126,132
050,17,181,"Illinois","Union County",2,58,244,123,121
050,17,181,"Illinois","Union County",2,59,266,139,127
050,17,181,"Illinois","Union County",2,60,260,138,122
050,17,181,"Illinois","Union County",2,61,247,130,117
050,17,181,"Illinois","Union County",2,62,253,135,118
050,17,181,"Illinois","Union County",2,63,257,130,127
050,17,181,"Illinois","Union County",2,64,249,116,133
050,17,181,"Illinois","Union County",2,65,255,128,127
050,17,181,"Illinois","Union County",2,66,236,124,112
050,17,181,"Illinois","Union County",2,67,244,134,110
050,17,181,"Illinois","Union County",2,68,221,110,111
050,17,181,"Illinois","Union County",2,69,210,100,110
050,17,181,"Illinois","Union County",2,70,194,93,101
050,17,181,"Illinois","Union County",2,71,198,90,108
050,17,181,"Illinois","Union County",2,72,184,87,97
050,17,181,"Illinois","Union County",2,73,202,101,101
050,17,181,"Illinois","Union County",2,74,150,71,79
050,17,181,"Illinois","Union County",2,75,145,60,85
050,17,181,"Illinois","Union County",2,76,152,67,85
050,17,181,"Illinois","Union County",2,77,159,71,88
050,17,181,"Illinois","Union County",2,78,145,65,80
050,17,181,"Illinois","Union County",2,79,110,54,56
050,17,181,"Illinois","Union County",2,80,99,51,48
050,17,181,"Illinois","Union County",2,81,99,49,50
050,17,181,"Illinois","Union County",2,82,109,55,54
050,17,181,"Illinois","Union County",2,83,104,56,48
050,17,181,"Illinois","Union County",2,84,80,39,41
050,17,181,"Illinois","Union County",2,85,416,158,258
050,17,181,"Illinois","Union County",3,0,156,70,86
050,17,181,"Illinois","Union County",3,1,181,94,87
050,17,181,"Illinois","Union County",3,2,193,89,104
050,17,181,"Illinois","Union County",3,3,198,101,97
050,17,181,"Illinois","Union County",3,4,171,83,88
050,17,181,"Illinois","Union County",3,5,182,90,92
050,17,181,"Illinois","Union County",3,6,197,100,97
050,17,181,"Illinois","Union County",3,7,186,91,95
050,17,181,"Illinois","Union County",3,8,183,99,84
050,17,181,"Illinois","Union County",3,9,192,103,89
050,17,181,"Illinois","Union County",3,10,181,91,90
050,17,181,"Illinois","Union County",3,11,178,91,87
050,17,181,"Illinois","Union County",3,12,193,97,96
050,17,181,"Illinois","Union County",3,13,209,107,102
050,17,181,"Illinois","Union County",3,14,223,112,111
050,17,181,"Illinois","Union County",3,15,210,104,106
050,17,181,"Illinois","Union County",3,16,226,109,117
050,17,181,"Illinois","Union County",3,17,230,118,112
050,17,181,"Illinois","Union County",3,18,203,112,91
050,17,181,"Illinois","Union County",3,19,151,83,68
050,17,181,"Illinois","Union County",3,20,165,85,80
050,17,181,"Illinois","Union County",3,21,162,86,76
050,17,181,"Illinois","Union County",3,22,154,78,76
050,17,181,"Illinois","Union County",3,23,156,84,72
050,17,181,"Illinois","Union County",3,24,154,82,72
050,17,181,"Illinois","Union County",3,25,162,79,83
050,17,181,"Illinois","Union County",3,26,169,91,78
050,17,181,"Illinois","Union County",3,27,187,101,86
050,17,181,"Illinois","Union County",3,28,178,90,88
050,17,181,"Illinois","Union County",3,29,209,99,110
050,17,181,"Illinois","Union County",3,30,217,115,102
050,17,181,"Illinois","Union County",3,31,228,127,101
050,17,181,"Illinois","Union County",3,32,192,96,96
050,17,181,"Illinois","Union County",3,33,188,92,96
050,17,181,"Illinois","Union County",3,34,187,101,86
050,17,181,"Illinois","Union County",3,35,203,107,96
050,17,181,"Illinois","Union County",3,36,203,109,94
050,17,181,"Illinois","Union County",3,37,191,98,93
050,17,181,"Illinois","Union County",3,38,197,110,87
050,17,181,"Illinois","Union County",3,39,213,117,96
050,17,181,"Illinois","Union County",3,40,199,101,98
050,17,181,"Illinois","Union County",3,41,212,114,98
050,17,181,"Illinois","Union County",3,42,193,101,92
050,17,181,"Illinois","Union County",3,43,175,97,78
050,17,181,"Illinois","Union County",3,44,188,98,90
050,17,181,"Illinois","Union County",3,45,212,109,103
050,17,181,"Illinois","Union County",3,46,240,125,115
050,17,181,"Illinois","Union County",3,47,205,98,107
050,17,181,"Illinois","Union County",3,48,207,110,97
050,17,181,"Illinois","Union County",3,49,213,117,96
050,17,181,"Illinois","Union County",3,50,236,125,111
050,17,181,"Illinois","Union County",3,51,223,111,112
050,17,181,"Illinois","Union County",3,52,224,115,109
050,17,181,"Illinois","Union County",3,53,228,123,105
050,17,181,"Illinois","Union County",3,54,223,117,106
050,17,181,"Illinois","Union County",3,55,223,111,112
050,17,181,"Illinois","Union County",3,56,228,115,113
050,17,181,"Illinois","Union County",3,57,254,120,134
050,17,181,"Illinois","Union County",3,58,254,125,129
050,17,181,"Illinois","Union County",3,59,246,122,124
050,17,181,"Illinois","Union County",3,60,249,136,113
050,17,181,"Illinois","Union County",3,61,249,131,118
050,17,181,"Illinois","Union County",3,62,245,126,119
050,17,181,"Illinois","Union County",3,63,248,133,115
050,17,181,"Illinois","Union County",3,64,239,119,120
050,17,181,"Illinois","Union County",3,65,242,115,127
050,17,181,"Illinois","Union County",3,66,258,126,132
050,17,181,"Illinois","Union County",3,67,231,124,107
050,17,181,"Illinois","Union County",3,68,226,120,106
050,17,181,"Illinois","Union County",3,69,226,113,113
050,17,181,"Illinois","Union County",3,70,207,96,111
050,17,181,"Illinois","Union County",3,71,192,89,103
050,17,181,"Illinois","Union County",3,72,190,91,99
050,17,181,"Illinois","Union County",3,73,175,83,92
050,17,181,"Illinois","Union County",3,74,195,97,98
050,17,181,"Illinois","Union County",3,75,141,69,72
050,17,181,"Illinois","Union County",3,76,141,57,84
050,17,181,"Illinois","Union County",3,77,140,60,80
050,17,181,"Illinois","Union County",3,78,149,64,85
050,17,181,"Illinois","Union County",3,79,134,57,77
050,17,181,"Illinois","Union County",3,80,110,57,53
050,17,181,"Illinois","Union County",3,81,89,42,47
050,17,181,"Illinois","Union County",3,82,91,40,51
050,17,181,"Illinois","Union County",3,83,108,56,52
050,17,181,"Illinois","Union County",3,84,90,43,47
050,17,181,"Illinois","Union County",3,85,415,173,242
050,17,181,"Illinois","Union County",4,0,150,76,74
050,17,181,"Illinois","Union County",4,1,163,78,85
050,17,181,"Illinois","Union County",4,2,184,94,90
050,17,181,"Illinois","Union County",4,3,187,86,101
050,17,181,"Illinois","Union County",4,4,206,103,103
050,17,181,"Illinois","Union County",4,5,177,87,90
050,17,181,"Illinois","Union County",4,6,185,91,94
050,17,181,"Illinois","Union County",4,7,200,99,101
050,17,181,"Illinois","Union County",4,8,182,87,95
050,17,181,"Illinois","Union County",4,9,192,102,90
050,17,181,"Illinois","Union County",4,10,190,103,87
050,17,181,"Illinois","Union County",4,11,184,95,89
050,17,181,"Illinois","Union County",4,12,191,91,100
050,17,181,"Illinois","Union County",4,13,194,93,101
050,17,181,"Illinois","Union County",4,14,216,111,105
050,17,181,"Illinois","Union County",4,15,215,110,105
050,17,181,"Illinois","Union County",4,16,209,100,109
050,17,181,"Illinois","Union County",4,17,223,107,116
050,17,181,"Illinois","Union County",4,18,195,100,95
050,17,181,"Illinois","Union County",4,19,158,92,66
050,17,181,"Illinois","Union County",4,20,155,83,72
050,17,181,"Illinois","Union County",4,21,167,89,78
050,17,181,"Illinois","Union County",4,22,180,88,92
050,17,181,"Illinois","Union County",4,23,167,91,76
050,17,181,"Illinois","Union County",4,24,158,86,72
050,17,181,"Illinois","Union County",4,25,162,91,71
050,17,181,"Illinois","Union County",4,26,157,75,82
050,17,181,"Illinois","Union County",4,27,163,87,76
050,17,181,"Illinois","Union County",4,28,178,97,81
050,17,181,"Illinois","Union County",4,29,170,85,85
050,17,181,"Illinois","Union County",4,30,205,93,112
050,17,181,"Illinois","Union County",4,31,212,120,92
050,17,181,"Illinois","Union County",4,32,228,123,105
050,17,181,"Illinois","Union County",4,33,190,95,95
050,17,181,"Illinois","Union County",4,34,183,89,94
050,17,181,"Illinois","Union County",4,35,190,100,90
050,17,181,"Illinois","Union County",4,36,214,116,98
050,17,181,"Illinois","Union County",4,37,201,98,103
050,17,181,"Illinois","Union County",4,38,201,110,91
050,17,181,"Illinois","Union County",4,39,210,116,94
050,17,181,"Illinois","Union County",4,40,205,107,98
050,17,181,"Illinois","Union County",4,41,201,102,99
050,17,181,"Illinois","Union County",4,42,204,110,94
050,17,181,"Illinois","Union County",4,43,204,108,96
050,17,181,"Illinois","Union County",4,44,172,96,76
050,17,181,"Illinois","Union County",4,45,195,102,93
050,17,181,"Illinois","Union County",4,46,228,119,109
050,17,181,"Illinois","Union County",4,47,214,106,108
050,17,181,"Illinois","Union County",4,48,214,105,109
050,17,181,"Illinois","Union County",4,49,196,107,89
050,17,181,"Illinois","Union County",4,50,218,126,92
050,17,181,"Illinois","Union County",4,51,230,120,110
050,17,181,"Illinois","Union County",4,52,228,114,114
050,17,181,"Illinois","Union County",4,53,223,116,107
050,17,181,"Illinois","Union County",4,54,218,119,99
050,17,181,"Illinois","Union County",4,55,213,112,101
050,17,181,"Illinois","Union County",4,56,218,110,108
050,17,181,"Illinois","Union County",4,57,222,109,113
050,17,181,"Illinois","Union County",4,58,237,112,125
050,17,181,"Illinois","Union County",4,59,254,117,137
050,17,181,"Illinois","Union County",4,60,245,124,121
050,17,181,"Illinois","Union County",4,61,248,138,110
050,17,181,"Illinois","Union County",4,62,246,128,118
050,17,181,"Illinois","Union County",4,63,241,130,111
050,17,181,"Illinois","Union County",4,64,234,123,111
050,17,181,"Illinois","Union County",4,65,228,112,116
050,17,181,"Illinois","Union County",4,66,243,113,130
050,17,181,"Illinois","Union County",4,67,257,125,132
050,17,181,"Illinois","Union County",4,68,214,109,105
050,17,181,"Illinois","Union County",4,69,232,121,111
050,17,181,"Illinois","Union County",4,70,217,105,112
050,17,181,"Illinois","Union County",4,71,198,91,107
050,17,181,"Illinois","Union County",4,72,186,90,96
050,17,181,"Illinois","Union County",4,73,180,84,96
050,17,181,"Illinois","Union County",4,74,161,78,83
050,17,181,"Illinois","Union County",4,75,184,92,92
050,17,181,"Illinois","Union County",4,76,140,67,73
050,17,181,"Illinois","Union County",4,77,134,54,80
050,17,181,"Illinois","Union County",4,78,125,53,72
050,17,181,"Illinois","Union County",4,79,142,60,82
050,17,181,"Illinois","Union County",4,80,131,58,73
050,17,181,"Illinois","Union County",4,81,103,51,52
050,17,181,"Illinois","Union County",4,82,81,41,40
050,17,181,"Illinois","Union County",4,83,84,38,46
050,17,181,"Illinois","Union County",4,84,97,45,52
050,17,181,"Illinois","Union County",4,85,435,191,244
050,17,181,"Illinois","Union County",5,0,138,71,67
050,17,181,"Illinois","Union County",5,1,140,72,68
050,17,181,"Illinois","Union County",5,2,165,78,87
050,17,181,"Illinois","Union County",5,3,173,88,85
050,17,181,"Illinois","Union County",5,4,182,84,98
050,17,181,"Illinois","Union County",5,5,204,101,103
050,17,181,"Illinois","Union County",5,6,179,87,92
050,17,181,"Illinois","Union County",5,7,185,87,98
050,17,181,"Illinois","Union County",5,8,201,99,102
050,17,181,"Illinois","Union County",5,9,186,89,97
050,17,181,"Illinois","Union County",5,10,194,108,86
050,17,181,"Illinois","Union County",5,11,200,108,92
050,17,181,"Illinois","Union County",5,12,197,99,98
050,17,181,"Illinois","Union County",5,13,198,95,103
050,17,181,"Illinois","Union County",5,14,206,101,105
050,17,181,"Illinois","Union County",5,15,220,114,106
050,17,181,"Illinois","Union County",5,16,221,112,109
050,17,181,"Illinois","Union County",5,17,204,102,102
050,17,181,"Illinois","Union County",5,18,186,96,90
050,17,181,"Illinois","Union County",5,19,151,83,68
050,17,181,"Illinois","Union County",5,20,157,89,68
050,17,181,"Illinois","Union County",5,21,179,98,81
050,17,181,"Illinois","Union County",5,22,180,91,89
050,17,181,"Illinois","Union County",5,23,178,89,89
050,17,181,"Illinois","Union County",5,24,161,90,71
050,17,181,"Illinois","Union County",5,25,160,96,64
050,17,181,"Illinois","Union County",5,26,154,84,70
050,17,181,"Illinois","Union County",5,27,157,77,80
050,17,181,"Illinois","Union County",5,28,165,91,74
050,17,181,"Illinois","Union County",5,29,185,104,81
050,17,181,"Illinois","Union County",5,30,168,76,92
050,17,181,"Illinois","Union County",5,31,196,94,102
050,17,181,"Illinois","Union County",5,32,208,113,95
050,17,181,"Illinois","Union County",5,33,228,123,105
050,17,181,"Illinois","Union County",5,34,192,93,99
050,17,181,"Illinois","Union County",5,35,187,89,98
050,17,181,"Illinois","Union County",5,36,201,111,90
050,17,181,"Illinois","Union County",5,37,207,105,102
050,17,181,"Illinois","Union County",5,38,197,101,96
050,17,181,"Illinois","Union County",5,39,208,116,92
050,17,181,"Illinois","Union County",5,40,194,106,88
050,17,181,"Illinois","Union County",5,41,206,109,97
050,17,181,"Illinois","Union County",5,42,193,93,100
050,17,181,"Illinois","Union County",5,43,209,116,93
050,17,181,"Illinois","Union County",5,44,197,104,93
050,17,181,"Illinois","Union County",5,45,176,98,78
050,17,181,"Illinois","Union County",5,46,218,116,102
050,17,181,"Illinois","Union County",5,47,212,105,107
050,17,181,"Illinois","Union County",5,48,227,117,110
050,17,181,"Illinois","Union County",5,49,215,104,111
050,17,181,"Illinois","Union County",5,50,201,112,89
050,17,181,"Illinois","Union County",5,51,213,117,96
050,17,181,"Illinois","Union County",5,52,233,123,110
050,17,181,"Illinois","Union County",5,53,237,120,117
050,17,181,"Illinois","Union County",5,54,216,113,103
050,17,181,"Illinois","Union County",5,55,219,116,103
050,17,181,"Illinois","Union County",5,56,215,119,96
050,17,181,"Illinois","Union County",5,57,213,104,109
050,17,181,"Illinois","Union County",5,58,207,104,103
050,17,181,"Illinois","Union County",5,59,244,115,129
050,17,181,"Illinois","Union County",5,60,254,120,134
050,17,181,"Illinois","Union County",5,61,241,122,119
050,17,181,"Illinois","Union County",5,62,245,132,113
050,17,181,"Illinois","Union County",5,63,245,132,113
050,17,181,"Illinois","Union County",5,64,229,116,113
050,17,181,"Illinois","Union County",5,65,223,118,105
050,17,181,"Illinois","Union County",5,66,230,109,121
050,17,181,"Illinois","Union County",5,67,250,120,130
050,17,181,"Illinois","Union County",5,68,241,112,129
050,17,181,"Illinois","Union County",5,69,219,110,109
050,17,181,"Illinois","Union County",5,70,221,115,106
050,17,181,"Illinois","Union County",5,71,217,102,115
050,17,181,"Illinois","Union County",5,72,190,92,98
050,17,181,"Illinois","Union County",5,73,177,83,94
050,17,181,"Illinois","Union County",5,74,174,80,94
050,17,181,"Illinois","Union County",5,75,154,76,78
050,17,181,"Illinois","Union County",5,76,179,89,90
050,17,181,"Illinois","Union County",5,77,129,65,64
050,17,181,"Illinois","Union County",5,78,121,47,74
050,17,181,"Illinois","Union County",5,79,117,48,69
050,17,181,"Illinois","Union County",5,80,134,61,73
050,17,181,"Illinois","Union County",5,81,122,51,71
050,17,181,"Illinois","Union County",5,82,95,48,47
050,17,181,"Illinois","Union County",5,83,79,42,37
050,17,181,"Illinois","Union County",5,84,70,26,44
050,17,181,"Illinois","Union County",5,85,468,207,261
050,17,183,"Illinois","Vermilion County",1,0,864,439,425
050,17,183,"Illinois","Vermilion County",1,1,891,449,442
050,17,183,"Illinois","Vermilion County",1,2,919,465,454
050,17,183,"Illinois","Vermilion County",1,3,937,474,463
050,17,183,"Illinois","Vermilion County",1,4,951,474,477
050,17,183,"Illinois","Vermilion County",1,5,962,512,450
050,17,183,"Illinois","Vermilion County",1,6,970,507,463
050,17,183,"Illinois","Vermilion County",1,7,947,478,469
050,17,183,"Illinois","Vermilion County",1,8,981,478,503
050,17,183,"Illinois","Vermilion County",1,9,1002,529,473
050,17,183,"Illinois","Vermilion County",1,10,977,506,471
050,17,183,"Illinois","Vermilion County",1,11,1031,508,523
050,17,183,"Illinois","Vermilion County",1,12,1042,539,503
050,17,183,"Illinois","Vermilion County",1,13,1046,554,492
050,17,183,"Illinois","Vermilion County",1,14,1044,550,494
050,17,183,"Illinois","Vermilion County",1,15,1036,549,487
050,17,183,"Illinois","Vermilion County",1,16,1004,516,488
050,17,183,"Illinois","Vermilion County",1,17,949,491,458
050,17,183,"Illinois","Vermilion County",1,18,840,441,399
050,17,183,"Illinois","Vermilion County",1,19,766,407,359
050,17,183,"Illinois","Vermilion County",1,20,796,431,365
050,17,183,"Illinois","Vermilion County",1,21,774,415,359
050,17,183,"Illinois","Vermilion County",1,22,820,419,401
050,17,183,"Illinois","Vermilion County",1,23,832,437,395
050,17,183,"Illinois","Vermilion County",1,24,816,427,389
050,17,183,"Illinois","Vermilion County",1,25,885,455,430
050,17,183,"Illinois","Vermilion County",1,26,853,445,408
050,17,183,"Illinois","Vermilion County",1,27,871,446,425
050,17,183,"Illinois","Vermilion County",1,28,895,462,433
050,17,183,"Illinois","Vermilion County",1,29,901,460,441
050,17,183,"Illinois","Vermilion County",1,30,871,446,425
050,17,183,"Illinois","Vermilion County",1,31,860,470,390
050,17,183,"Illinois","Vermilion County",1,32,800,417,383
050,17,183,"Illinois","Vermilion County",1,33,802,413,389
050,17,183,"Illinois","Vermilion County",1,34,866,433,433
050,17,183,"Illinois","Vermilion County",1,35,883,447,436
050,17,183,"Illinois","Vermilion County",1,36,900,448,452
050,17,183,"Illinois","Vermilion County",1,37,865,442,423
050,17,183,"Illinois","Vermilion County",1,38,881,451,430
050,17,183,"Illinois","Vermilion County",1,39,897,462,435
050,17,183,"Illinois","Vermilion County",1,40,854,422,432
050,17,183,"Illinois","Vermilion County",1,41,848,449,399
050,17,183,"Illinois","Vermilion County",1,42,854,464,390
050,17,183,"Illinois","Vermilion County",1,43,863,454,409
050,17,183,"Illinois","Vermilion County",1,44,815,425,390
050,17,183,"Illinois","Vermilion County",1,45,809,416,393
050,17,183,"Illinois","Vermilion County",1,46,821,432,389
050,17,183,"Illinois","Vermilion County",1,47,841,434,407
050,17,183,"Illinois","Vermilion County",1,48,892,468,424
050,17,183,"Illinois","Vermilion County",1,49,934,504,430
050,17,183,"Illinois","Vermilion County",1,50,868,431,437
050,17,183,"Illinois","Vermilion County",1,51,833,404,429
050,17,183,"Illinois","Vermilion County",1,52,835,410,425
050,17,183,"Illinois","Vermilion County",1,53,908,451,457
050,17,183,"Illinois","Vermilion County",1,54,938,463,475
050,17,183,"Illinois","Vermilion County",1,55,970,450,520
050,17,183,"Illinois","Vermilion County",1,56,998,474,524
050,17,183,"Illinois","Vermilion County",1,57,1051,537,514
050,17,183,"Illinois","Vermilion County",1,58,1103,570,533
050,17,183,"Illinois","Vermilion County",1,59,1065,533,532
050,17,183,"Illinois","Vermilion County",1,60,1084,557,527
050,17,183,"Illinois","Vermilion County",1,61,1063,539,524
050,17,183,"Illinois","Vermilion County",1,62,1055,516,539
050,17,183,"Illinois","Vermilion County",1,63,1069,511,558
050,17,183,"Illinois","Vermilion County",1,64,990,484,506
050,17,183,"Illinois","Vermilion County",1,65,981,503,478
050,17,183,"Illinois","Vermilion County",1,66,975,463,512
050,17,183,"Illinois","Vermilion County",1,67,970,463,507
050,17,183,"Illinois","Vermilion County",1,68,903,425,478
050,17,183,"Illinois","Vermilion County",1,69,810,372,438
050,17,183,"Illinois","Vermilion County",1,70,816,377,439
050,17,183,"Illinois","Vermilion County",1,71,817,377,440
050,17,183,"Illinois","Vermilion County",1,72,809,377,432
050,17,183,"Illinois","Vermilion County",1,73,812,398,414
050,17,183,"Illinois","Vermilion County",1,74,534,250,284
050,17,183,"Illinois","Vermilion County",1,75,532,268,264
050,17,183,"Illinois","Vermilion County",1,76,580,249,331
050,17,183,"Illinois","Vermilion County",1,77,609,277,332
050,17,183,"Illinois","Vermilion County",1,78,513,248,265
050,17,183,"Illinois","Vermilion County",1,79,470,218,252
050,17,183,"Illinois","Vermilion County",1,80,415,187,228
050,17,183,"Illinois","Vermilion County",1,81,403,173,230
050,17,183,"Illinois","Vermilion County",1,82,363,161,202
050,17,183,"Illinois","Vermilion County",1,83,308,124,184
050,17,183,"Illinois","Vermilion County",1,84,293,121,172
050,17,183,"Illinois","Vermilion County",1,85,1703,637,1066
050,17,183,"Illinois","Vermilion County",2,0,858,435,423
050,17,183,"Illinois","Vermilion County",2,1,880,445,435
050,17,183,"Illinois","Vermilion County",2,2,912,464,448
050,17,183,"Illinois","Vermilion County",2,3,927,470,457
050,17,183,"Illinois","Vermilion County",2,4,951,478,473
050,17,183,"Illinois","Vermilion County",2,5,962,504,458
050,17,183,"Illinois","Vermilion County",2,6,972,511,461
050,17,183,"Illinois","Vermilion County",2,7,952,485,467
050,17,183,"Illinois","Vermilion County",2,8,968,477,491
050,17,183,"Illinois","Vermilion County",2,9,990,512,478
050,17,183,"Illinois","Vermilion County",2,10,977,508,469
050,17,183,"Illinois","Vermilion County",2,11,1011,506,505
050,17,183,"Illinois","Vermilion County",2,12,1038,530,508
050,17,183,"Illinois","Vermilion County",2,13,1040,548,492
050,17,183,"Illinois","Vermilion County",2,14,1044,553,491
050,17,183,"Illinois","Vermilion County",2,15,1037,549,488
050,17,183,"Illinois","Vermilion County",2,16,1011,525,486
050,17,183,"Illinois","Vermilion County",2,17,959,493,466
050,17,183,"Illinois","Vermilion County",2,18,831,440,391
050,17,183,"Illinois","Vermilion County",2,19,748,396,352
050,17,183,"Illinois","Vermilion County",2,20,806,433,373
050,17,183,"Illinois","Vermilion County",2,21,786,422,364
050,17,183,"Illinois","Vermilion County",2,22,814,416,398
050,17,183,"Illinois","Vermilion County",2,23,834,434,400
050,17,183,"Illinois","Vermilion County",2,24,815,426,389
050,17,183,"Illinois","Vermilion County",2,25,862,448,414
050,17,183,"Illinois","Vermilion County",2,26,863,449,414
050,17,183,"Illinois","Vermilion County",2,27,864,442,422
050,17,183,"Illinois","Vermilion County",2,28,891,463,428
050,17,183,"Illinois","Vermilion County",2,29,896,459,437
050,17,183,"Illinois","Vermilion County",2,30,882,452,430
050,17,183,"Illinois","Vermilion County",2,31,854,457,397
050,17,183,"Illinois","Vermilion County",2,32,806,422,384
050,17,183,"Illinois","Vermilion County",2,33,803,416,387
050,17,183,"Illinois","Vermilion County",2,34,846,422,424
050,17,183,"Illinois","Vermilion County",2,35,880,441,439
050,17,183,"Illinois","Vermilion County",2,36,885,444,441
050,17,183,"Illinois","Vermilion County",2,37,871,445,426
050,17,183,"Illinois","Vermilion County",2,38,879,455,424
050,17,183,"Illinois","Vermilion County",2,39,887,456,431
050,17,183,"Illinois","Vermilion County",2,40,867,430,437
050,17,183,"Illinois","Vermilion County",2,41,847,442,405
050,17,183,"Illinois","Vermilion County",2,42,844,457,387
050,17,183,"Illinois","Vermilion County",2,43,868,461,407
050,17,183,"Illinois","Vermilion County",2,44,817,425,392
050,17,183,"Illinois","Vermilion County",2,45,808,417,391
050,17,183,"Illinois","Vermilion County",2,46,808,423,385
050,17,183,"Illinois","Vermilion County",2,47,827,426,401
050,17,183,"Illinois","Vermilion County",2,48,886,467,419
050,17,183,"Illinois","Vermilion County",2,49,922,495,427
050,17,183,"Illinois","Vermilion County",2,50,883,447,436
050,17,183,"Illinois","Vermilion County",2,51,833,405,428
050,17,183,"Illinois","Vermilion County",2,52,830,408,422
050,17,183,"Illinois","Vermilion County",2,53,892,442,450
050,17,183,"Illinois","Vermilion County",2,54,925,456,469
050,17,183,"Illinois","Vermilion County",2,55,958,450,508
050,17,183,"Illinois","Vermilion County",2,56,991,468,523
050,17,183,"Illinois","Vermilion County",2,57,1040,525,515
050,17,183,"Illinois","Vermilion County",2,58,1086,560,526
050,17,183,"Illinois","Vermilion County",2,59,1074,543,531
050,17,183,"Illinois","Vermilion County",2,60,1078,554,524
050,17,183,"Illinois","Vermilion County",2,61,1058,538,520
050,17,183,"Illinois","Vermilion County",2,62,1046,515,531
050,17,183,"Illinois","Vermilion County",2,63,1071,516,555
050,17,183,"Illinois","Vermilion County",2,64,996,483,513
050,17,183,"Illinois","Vermilion County",2,65,975,496,479
050,17,183,"Illinois","Vermilion County",2,66,971,470,501
050,17,183,"Illinois","Vermilion County",2,67,964,460,504
050,17,183,"Illinois","Vermilion County",2,68,904,427,477
050,17,183,"Illinois","Vermilion County",2,69,835,386,449
050,17,183,"Illinois","Vermilion County",2,70,806,372,434
050,17,183,"Illinois","Vermilion County",2,71,814,377,437
050,17,183,"Illinois","Vermilion County",2,72,789,363,426
050,17,183,"Illinois","Vermilion County",2,73,841,408,433
050,17,183,"Illinois","Vermilion County",2,74,560,264,296
050,17,183,"Illinois","Vermilion County",2,75,535,266,269
050,17,183,"Illinois","Vermilion County",2,76,560,249,311
050,17,183,"Illinois","Vermilion County",2,77,611,274,337
050,17,183,"Illinois","Vermilion County",2,78,514,245,269
050,17,183,"Illinois","Vermilion County",2,79,476,222,254
050,17,183,"Illinois","Vermilion County",2,80,423,191,232
050,17,183,"Illinois","Vermilion County",2,81,400,173,227
050,17,183,"Illinois","Vermilion County",2,82,370,163,207
050,17,183,"Illinois","Vermilion County",2,83,313,128,185
050,17,183,"Illinois","Vermilion County",2,84,290,119,171
050,17,183,"Illinois","Vermilion County",2,85,1711,637,1074
050,17,183,"Illinois","Vermilion County",3,0,836,441,395
050,17,183,"Illinois","Vermilion County",3,1,875,443,432
050,17,183,"Illinois","Vermilion County",3,2,874,444,430
050,17,183,"Illinois","Vermilion County",3,3,900,460,440
050,17,183,"Illinois","Vermilion County",3,4,906,448,458
050,17,183,"Illinois","Vermilion County",3,5,923,463,460
050,17,183,"Illinois","Vermilion County",3,6,936,489,447
050,17,183,"Illinois","Vermilion County",3,7,958,489,469
050,17,183,"Illinois","Vermilion County",3,8,952,484,468
050,17,183,"Illinois","Vermilion County",3,9,946,471,475
050,17,183,"Illinois","Vermilion County",3,10,1000,519,481
050,17,183,"Illinois","Vermilion County",3,11,977,498,479
050,17,183,"Illinois","Vermilion County",3,12,989,495,494
050,17,183,"Illinois","Vermilion County",3,13,1033,527,506
050,17,183,"Illinois","Vermilion County",3,14,1047,552,495
050,17,183,"Illinois","Vermilion County",3,15,1020,533,487
050,17,183,"Illinois","Vermilion County",3,16,1036,549,487
050,17,183,"Illinois","Vermilion County",3,17,973,504,469
050,17,183,"Illinois","Vermilion County",3,18,841,442,399
050,17,183,"Illinois","Vermilion County",3,19,690,377,313
050,17,183,"Illinois","Vermilion County",3,20,797,427,370
050,17,183,"Illinois","Vermilion County",3,21,831,445,386
050,17,183,"Illinois","Vermilion County",3,22,811,429,382
050,17,183,"Illinois","Vermilion County",3,23,838,418,420
050,17,183,"Illinois","Vermilion County",3,24,829,440,389
050,17,183,"Illinois","Vermilion County",3,25,830,446,384
050,17,183,"Illinois","Vermilion County",3,26,865,447,418
050,17,183,"Illinois","Vermilion County",3,27,880,447,433
050,17,183,"Illinois","Vermilion County",3,28,857,460,397
050,17,183,"Illinois","Vermilion County",3,29,898,482,416
050,17,183,"Illinois","Vermilion County",3,30,890,467,423
050,17,183,"Illinois","Vermilion County",3,31,892,466,426
050,17,183,"Illinois","Vermilion County",3,32,826,433,393
050,17,183,"Illinois","Vermilion County",3,33,798,417,381
050,17,183,"Illinois","Vermilion County",3,34,777,389,388
050,17,183,"Illinois","Vermilion County",3,35,860,434,426
050,17,183,"Illinois","Vermilion County",3,36,877,450,427
050,17,183,"Illinois","Vermilion County",3,37,879,444,435
050,17,183,"Illinois","Vermilion County",3,38,883,455,428
050,17,183,"Illinois","Vermilion County",3,39,882,452,430
050,17,183,"Illinois","Vermilion County",3,40,885,444,441
050,17,183,"Illinois","Vermilion County",3,41,872,451,421
050,17,183,"Illinois","Vermilion County",3,42,853,441,412
050,17,183,"Illinois","Vermilion County",3,43,829,447,382
050,17,183,"Illinois","Vermilion County",3,44,865,458,407
050,17,183,"Illinois","Vermilion County",3,45,792,414,378
050,17,183,"Illinois","Vermilion County",3,46,807,422,385
050,17,183,"Illinois","Vermilion County",3,47,798,413,385
050,17,183,"Illinois","Vermilion County",3,48,840,451,389
050,17,183,"Illinois","Vermilion County",3,49,849,439,410
050,17,183,"Illinois","Vermilion County",3,50,900,477,423
050,17,183,"Illinois","Vermilion County",3,51,861,435,426
050,17,183,"Illinois","Vermilion County",3,52,828,400,428
050,17,183,"Illinois","Vermilion County",3,53,831,412,419
050,17,183,"Illinois","Vermilion County",3,54,887,436,451
050,17,183,"Illinois","Vermilion County",3,55,906,441,465
050,17,183,"Illinois","Vermilion County",3,56,932,442,490
050,17,183,"Illinois","Vermilion County",3,57,983,465,518
050,17,183,"Illinois","Vermilion County",3,58,1007,512,495
050,17,183,"Illinois","Vermilion County",3,59,1059,548,511
050,17,183,"Illinois","Vermilion County",3,60,1049,539,510
050,17,183,"Illinois","Vermilion County",3,61,1062,548,514
050,17,183,"Illinois","Vermilion County",3,62,1022,516,506
050,17,183,"Illinois","Vermilion County",3,63,1031,512,519
050,17,183,"Illinois","Vermilion County",3,64,1028,487,541
050,17,183,"Illinois","Vermilion County",3,65,962,466,496
050,17,183,"Illinois","Vermilion County",3,66,955,485,470
050,17,183,"Illinois","Vermilion County",3,67,960,468,492
050,17,183,"Illinois","Vermilion County",3,68,918,432,486
050,17,183,"Illinois","Vermilion County",3,69,872,406,466
050,17,183,"Illinois","Vermilion County",3,70,802,368,434
050,17,183,"Illinois","Vermilion County",3,71,777,350,427
050,17,183,"Illinois","Vermilion County",3,72,779,354,425
050,17,183,"Illinois","Vermilion County",3,73,751,345,406
050,17,183,"Illinois","Vermilion County",3,74,811,382,429
050,17,183,"Illinois","Vermilion County",3,75,539,257,282
050,17,183,"Illinois","Vermilion County",3,76,512,247,265
050,17,183,"Illinois","Vermilion County",3,77,536,242,294
050,17,183,"Illinois","Vermilion County",3,78,565,252,313
050,17,183,"Illinois","Vermilion County",3,79,499,236,263
050,17,183,"Illinois","Vermilion County",3,80,438,204,234
050,17,183,"Illinois","Vermilion County",3,81,382,165,217
050,17,183,"Illinois","Vermilion County",3,82,362,153,209
050,17,183,"Illinois","Vermilion County",3,83,343,146,197
050,17,183,"Illinois","Vermilion County",3,84,270,110,160
050,17,183,"Illinois","Vermilion County",3,85,1643,608,1035
050,17,183,"Illinois","Vermilion County",4,0,845,419,426
050,17,183,"Illinois","Vermilion County",4,1,861,441,420
050,17,183,"Illinois","Vermilion County",4,2,855,443,412
050,17,183,"Illinois","Vermilion County",4,3,882,446,436
050,17,183,"Illinois","Vermilion County",4,4,901,475,426
050,17,183,"Illinois","Vermilion County",4,5,895,456,439
050,17,183,"Illinois","Vermilion County",4,6,936,467,469
050,17,183,"Illinois","Vermilion County",4,7,913,474,439
050,17,183,"Illinois","Vermilion County",4,8,940,477,463
050,17,183,"Illinois","Vermilion County",4,9,934,480,454
050,17,183,"Illinois","Vermilion County",4,10,930,457,473
050,17,183,"Illinois","Vermilion County",4,11,967,503,464
050,17,183,"Illinois","Vermilion County",4,12,951,489,462
050,17,183,"Illinois","Vermilion County",4,13,981,483,498
050,17,183,"Illinois","Vermilion County",4,14,1033,544,489
050,17,183,"Illinois","Vermilion County",4,15,1037,555,482
050,17,183,"Illinois","Vermilion County",4,16,998,520,478
050,17,183,"Illinois","Vermilion County",4,17,1032,543,489
050,17,183,"Illinois","Vermilion County",4,18,835,453,382
050,17,183,"Illinois","Vermilion County",4,19,658,352,306
050,17,183,"Illinois","Vermilion County",4,20,737,402,335
050,17,183,"Illinois","Vermilion County",4,21,816,434,382
050,17,183,"Illinois","Vermilion County",4,22,852,448,404
050,17,183,"Illinois","Vermilion County",4,23,823,433,390
050,17,183,"Illinois","Vermilion County",4,24,835,410,425
050,17,183,"Illinois","Vermilion County",4,25,815,441,374
050,17,183,"Illinois","Vermilion County",4,26,821,445,376
050,17,183,"Illinois","Vermilion County",4,27,863,447,416
050,17,183,"Illinois","Vermilion County",4,28,909,479,430
050,17,183,"Illinois","Vermilion County",4,29,856,443,413
050,17,183,"Illinois","Vermilion County",4,30,869,473,396
050,17,183,"Illinois","Vermilion County",4,31,887,466,421
050,17,183,"Illinois","Vermilion County",4,32,870,452,418
050,17,183,"Illinois","Vermilion County",4,33,825,445,380
050,17,183,"Illinois","Vermilion County",4,34,781,400,381
050,17,183,"Illinois","Vermilion County",4,35,786,400,386
050,17,183,"Illinois","Vermilion County",4,36,862,432,430
050,17,183,"Illinois","Vermilion County",4,37,851,426,425
050,17,183,"Illinois","Vermilion County",4,38,888,449,439
050,17,183,"Illinois","Vermilion County",4,39,866,442,424
050,17,183,"Illinois","Vermilion County",4,40,851,423,428
050,17,183,"Illinois","Vermilion County",4,41,897,458,439
050,17,183,"Illinois","Vermilion County",4,42,858,440,418
050,17,183,"Illinois","Vermilion County",4,43,849,440,409
050,17,183,"Illinois","Vermilion County",4,44,808,436,372
050,17,183,"Illinois","Vermilion County",4,45,852,451,401
050,17,183,"Illinois","Vermilion County",4,46,797,418,379
050,17,183,"Illinois","Vermilion County",4,47,788,410,378
050,17,183,"Illinois","Vermilion County",4,48,805,422,383
050,17,183,"Illinois","Vermilion County",4,49,802,432,370
050,17,183,"Illinois","Vermilion County",4,50,838,430,408
050,17,183,"Illinois","Vermilion County",4,51,884,465,419
050,17,183,"Illinois","Vermilion County",4,52,843,429,414
050,17,183,"Illinois","Vermilion County",4,53,812,392,420
050,17,183,"Illinois","Vermilion County",4,54,815,397,418
050,17,183,"Illinois","Vermilion County",4,55,850,407,443
050,17,183,"Illinois","Vermilion County",4,56,885,423,462
050,17,183,"Illinois","Vermilion County",4,57,943,454,489
050,17,183,"Illinois","Vermilion County",4,58,958,449,509
050,17,183,"Illinois","Vermilion County",4,59,997,495,502
050,17,183,"Illinois","Vermilion County",4,60,1058,546,512
050,17,183,"Illinois","Vermilion County",4,61,1037,532,505
050,17,183,"Illinois","Vermilion County",4,62,1006,517,489
050,17,183,"Illinois","Vermilion County",4,63,994,501,493
050,17,183,"Illinois","Vermilion County",4,64,976,478,498
050,17,183,"Illinois","Vermilion County",4,65,1002,472,530
050,17,183,"Illinois","Vermilion County",4,66,935,448,487
050,17,183,"Illinois","Vermilion County",4,67,942,477,465
050,17,183,"Illinois","Vermilion County",4,68,915,442,473
050,17,183,"Illinois","Vermilion County",4,69,894,417,477
050,17,183,"Illinois","Vermilion County",4,70,830,382,448
050,17,183,"Illinois","Vermilion County",4,71,776,356,420
050,17,183,"Illinois","Vermilion County",4,72,738,331,407
050,17,183,"Illinois","Vermilion County",4,73,732,331,401
050,17,183,"Illinois","Vermilion County",4,74,717,320,397
050,17,183,"Illinois","Vermilion County",4,75,771,366,405
050,17,183,"Illinois","Vermilion County",4,76,515,242,273
050,17,183,"Illinois","Vermilion County",4,77,489,240,249
050,17,183,"Illinois","Vermilion County",4,78,486,215,271
050,17,183,"Illinois","Vermilion County",4,79,530,235,295
050,17,183,"Illinois","Vermilion County",4,80,451,214,237
050,17,183,"Illinois","Vermilion County",4,81,405,187,218
050,17,183,"Illinois","Vermilion County",4,82,362,156,206
050,17,183,"Illinois","Vermilion County",4,83,330,133,197
050,17,183,"Illinois","Vermilion County",4,84,312,136,176
050,17,183,"Illinois","Vermilion County",4,85,1572,572,1000
050,17,183,"Illinois","Vermilion County",5,0,842,418,424
050,17,183,"Illinois","Vermilion County",5,1,850,435,415
050,17,183,"Illinois","Vermilion County",5,2,875,453,422
050,17,183,"Illinois","Vermilion County",5,3,857,436,421
050,17,183,"Illinois","Vermilion County",5,4,846,433,413
050,17,183,"Illinois","Vermilion County",5,5,896,467,429
050,17,183,"Illinois","Vermilion County",5,6,893,449,444
050,17,183,"Illinois","Vermilion County",5,7,936,482,454
050,17,183,"Illinois","Vermilion County",5,8,916,486,430
050,17,183,"Illinois","Vermilion County",5,9,961,490,471
050,17,183,"Illinois","Vermilion County",5,10,948,488,460
050,17,183,"Illinois","Vermilion County",5,11,947,466,481
050,17,183,"Illinois","Vermilion County",5,12,975,497,478
050,17,183,"Illinois","Vermilion County",5,13,941,490,451
050,17,183,"Illinois","Vermilion County",5,14,993,488,505
050,17,183,"Illinois","Vermilion County",5,15,1056,554,502
050,17,183,"Illinois","Vermilion County",5,16,1026,546,480
050,17,183,"Illinois","Vermilion County",5,17,989,515,474
050,17,183,"Illinois","Vermilion County",5,18,890,489,401
050,17,183,"Illinois","Vermilion County",5,19,672,363,309
050,17,183,"Illinois","Vermilion County",5,20,724,384,340
050,17,183,"Illinois","Vermilion County",5,21,768,412,356
050,17,183,"Illinois","Vermilion County",5,22,837,434,403
050,17,183,"Illinois","Vermilion County",5,23,887,471,416
050,17,183,"Illinois","Vermilion County",5,24,818,440,378
050,17,183,"Illinois","Vermilion County",5,25,844,432,412
050,17,183,"Illinois","Vermilion County",5,26,806,426,380
050,17,183,"Illinois","Vermilion County",5,27,801,432,369
050,17,183,"Illinois","Vermilion County",5,28,874,473,401
050,17,183,"Illinois","Vermilion County",5,29,915,479,436
050,17,183,"Illinois","Vermilion County",5,30,864,444,420
050,17,183,"Illinois","Vermilion County",5,31,871,466,405
050,17,183,"Illinois","Vermilion County",5,32,860,445,415
050,17,183,"Illinois","Vermilion County",5,33,882,452,430
050,17,183,"Illinois","Vermilion County",5,34,809,429,380
050,17,183,"Illinois","Vermilion County",5,35,820,417,403
050,17,183,"Illinois","Vermilion County",5,36,783,395,388
050,17,183,"Illinois","Vermilion County",5,37,847,419,428
050,17,183,"Illinois","Vermilion County",5,38,855,427,428
050,17,183,"Illinois","Vermilion County",5,39,884,447,437
050,17,183,"Illinois","Vermilion County",5,40,844,412,432
050,17,183,"Illinois","Vermilion County",5,41,858,443,415
050,17,183,"Illinois","Vermilion County",5,42,894,452,442
050,17,183,"Illinois","Vermilion County",5,43,868,440,428
050,17,183,"Illinois","Vermilion County",5,44,837,425,412
050,17,183,"Illinois","Vermilion County",5,45,800,426,374
050,17,183,"Illinois","Vermilion County",5,46,849,450,399
050,17,183,"Illinois","Vermilion County",5,47,771,399,372
050,17,183,"Illinois","Vermilion County",5,48,816,432,384
050,17,183,"Illinois","Vermilion County",5,49,784,401,383
050,17,183,"Illinois","Vermilion County",5,50,790,418,372
050,17,183,"Illinois","Vermilion County",5,51,823,420,403
050,17,183,"Illinois","Vermilion County",5,52,873,467,406
050,17,183,"Illinois","Vermilion County",5,53,835,430,405
050,17,183,"Illinois","Vermilion County",5,54,802,382,420
050,17,183,"Illinois","Vermilion County",5,55,797,383,414
050,17,183,"Illinois","Vermilion County",5,56,822,388,434
050,17,183,"Illinois","Vermilion County",5,57,889,431,458
050,17,183,"Illinois","Vermilion County",5,58,917,435,482
050,17,183,"Illinois","Vermilion County",5,59,933,429,504
050,17,183,"Illinois","Vermilion County",5,60,979,492,487
050,17,183,"Illinois","Vermilion County",5,61,1038,532,506
050,17,183,"Illinois","Vermilion County",5,62,1009,515,494
050,17,183,"Illinois","Vermilion County",5,63,998,512,486
050,17,183,"Illinois","Vermilion County",5,64,969,488,481
050,17,183,"Illinois","Vermilion County",5,65,946,461,485
050,17,183,"Illinois","Vermilion County",5,66,975,453,522
050,17,183,"Illinois","Vermilion County",5,67,929,446,483
050,17,183,"Illinois","Vermilion County",5,68,899,447,452
050,17,183,"Illinois","Vermilion County",5,69,890,434,456
050,17,183,"Illinois","Vermilion County",5,70,856,399,457
050,17,183,"Illinois","Vermilion County",5,71,800,360,440
050,17,183,"Illinois","Vermilion County",5,72,741,337,404
050,17,183,"Illinois","Vermilion County",5,73,712,322,390
050,17,183,"Illinois","Vermilion County",5,74,711,316,395
050,17,183,"Illinois","Vermilion County",5,75,687,313,374
050,17,183,"Illinois","Vermilion County",5,76,746,349,397
050,17,183,"Illinois","Vermilion County",5,77,496,236,260
050,17,183,"Illinois","Vermilion County",5,78,446,215,231
050,17,183,"Illinois","Vermilion County",5,79,466,203,263
050,17,183,"Illinois","Vermilion County",5,80,492,218,274
050,17,183,"Illinois","Vermilion County",5,81,414,192,222
050,17,183,"Illinois","Vermilion County",5,82,376,173,203
050,17,183,"Illinois","Vermilion County",5,83,330,140,190
050,17,183,"Illinois","Vermilion County",5,84,298,121,177
050,17,183,"Illinois","Vermilion County",5,85,1589,585,1004
050,17,185,"Illinois","Wabash County",1,0,135,70,65
050,17,185,"Illinois","Wabash County",1,1,141,71,70
050,17,185,"Illinois","Wabash County",1,2,131,62,69
050,17,185,"Illinois","Wabash County",1,3,127,65,62
050,17,185,"Illinois","Wabash County",1,4,131,67,64
050,17,185,"Illinois","Wabash County",1,5,118,72,46
050,17,185,"Illinois","Wabash County",1,6,132,79,53
050,17,185,"Illinois","Wabash County",1,7,143,86,57
050,17,185,"Illinois","Wabash County",1,8,150,75,75
050,17,185,"Illinois","Wabash County",1,9,133,64,69
050,17,185,"Illinois","Wabash County",1,10,123,55,68
050,17,185,"Illinois","Wabash County",1,11,141,74,67
050,17,185,"Illinois","Wabash County",1,12,154,86,68
050,17,185,"Illinois","Wabash County",1,13,144,73,71
050,17,185,"Illinois","Wabash County",1,14,147,81,66
050,17,185,"Illinois","Wabash County",1,15,151,76,75
050,17,185,"Illinois","Wabash County",1,16,137,73,64
050,17,185,"Illinois","Wabash County",1,17,139,69,70
050,17,185,"Illinois","Wabash County",1,18,158,87,71
050,17,185,"Illinois","Wabash County",1,19,154,73,81
050,17,185,"Illinois","Wabash County",1,20,142,71,71
050,17,185,"Illinois","Wabash County",1,21,141,76,65
050,17,185,"Illinois","Wabash County",1,22,120,60,60
050,17,185,"Illinois","Wabash County",1,23,118,54,64
050,17,185,"Illinois","Wabash County",1,24,124,60,64
050,17,185,"Illinois","Wabash County",1,25,113,62,51
050,17,185,"Illinois","Wabash County",1,26,118,63,55
050,17,185,"Illinois","Wabash County",1,27,119,68,51
050,17,185,"Illinois","Wabash County",1,28,146,80,66
050,17,185,"Illinois","Wabash County",1,29,153,83,70
050,17,185,"Illinois","Wabash County",1,30,141,71,70
050,17,185,"Illinois","Wabash County",1,31,116,56,60
050,17,185,"Illinois","Wabash County",1,32,113,57,56
050,17,185,"Illinois","Wabash County",1,33,116,55,61
050,17,185,"Illinois","Wabash County",1,34,126,58,68
050,17,185,"Illinois","Wabash County",1,35,126,63,63
050,17,185,"Illinois","Wabash County",1,36,130,65,65
050,17,185,"Illinois","Wabash County",1,37,124,63,61
050,17,185,"Illinois","Wabash County",1,38,126,69,57
050,17,185,"Illinois","Wabash County",1,39,143,79,64
050,17,185,"Illinois","Wabash County",1,40,138,80,58
050,17,185,"Illinois","Wabash County",1,41,119,72,47
050,17,185,"Illinois","Wabash County",1,42,124,59,65
050,17,185,"Illinois","Wabash County",1,43,123,60,63
050,17,185,"Illinois","Wabash County",1,44,112,64,48
050,17,185,"Illinois","Wabash County",1,45,126,72,54
050,17,185,"Illinois","Wabash County",1,46,132,72,60
050,17,185,"Illinois","Wabash County",1,47,129,65,64
050,17,185,"Illinois","Wabash County",1,48,131,61,70
050,17,185,"Illinois","Wabash County",1,49,137,53,84
050,17,185,"Illinois","Wabash County",1,50,122,54,68
050,17,185,"Illinois","Wabash County",1,51,137,67,70
050,17,185,"Illinois","Wabash County",1,52,117,59,58
050,17,185,"Illinois","Wabash County",1,53,119,61,58
050,17,185,"Illinois","Wabash County",1,54,130,69,61
050,17,185,"Illinois","Wabash County",1,55,143,76,67
050,17,185,"Illinois","Wabash County",1,56,164,83,81
050,17,185,"Illinois","Wabash County",1,57,175,83,92
050,17,185,"Illinois","Wabash County",1,58,186,92,94
050,17,185,"Illinois","Wabash County",1,59,168,93,75
050,17,185,"Illinois","Wabash County",1,60,165,87,78
050,17,185,"Illinois","Wabash County",1,61,184,88,96
050,17,185,"Illinois","Wabash County",1,62,187,93,94
050,17,185,"Illinois","Wabash County",1,63,181,88,93
050,17,185,"Illinois","Wabash County",1,64,172,83,89
050,17,185,"Illinois","Wabash County",1,65,165,74,91
050,17,185,"Illinois","Wabash County",1,66,160,74,86
050,17,185,"Illinois","Wabash County",1,67,160,78,82
050,17,185,"Illinois","Wabash County",1,68,140,76,64
050,17,185,"Illinois","Wabash County",1,69,131,72,59
050,17,185,"Illinois","Wabash County",1,70,151,76,75
050,17,185,"Illinois","Wabash County",1,71,137,75,62
050,17,185,"Illinois","Wabash County",1,72,112,58,54
050,17,185,"Illinois","Wabash County",1,73,124,59,65
050,17,185,"Illinois","Wabash County",1,74,88,39,49
050,17,185,"Illinois","Wabash County",1,75,91,40,51
050,17,185,"Illinois","Wabash County",1,76,91,39,52
050,17,185,"Illinois","Wabash County",1,77,83,38,45
050,17,185,"Illinois","Wabash County",1,78,66,34,32
050,17,185,"Illinois","Wabash County",1,79,68,34,34
050,17,185,"Illinois","Wabash County",1,80,60,30,30
050,17,185,"Illinois","Wabash County",1,81,63,33,30
050,17,185,"Illinois","Wabash County",1,82,58,22,36
050,17,185,"Illinois","Wabash County",1,83,44,15,29
050,17,185,"Illinois","Wabash County",1,84,49,23,26
050,17,185,"Illinois","Wabash County",1,85,356,116,240
050,17,185,"Illinois","Wabash County",2,0,126,64,62
050,17,185,"Illinois","Wabash County",2,1,137,69,68
050,17,185,"Illinois","Wabash County",2,2,133,63,70
050,17,185,"Illinois","Wabash County",2,3,127,64,63
050,17,185,"Illinois","Wabash County",2,4,128,66,62
050,17,185,"Illinois","Wabash County",2,5,121,72,49
050,17,185,"Illinois","Wabash County",2,6,128,78,50
050,17,185,"Illinois","Wabash County",2,7,142,85,57
050,17,185,"Illinois","Wabash County",2,8,146,77,69
050,17,185,"Illinois","Wabash County",2,9,136,65,71
050,17,185,"Illinois","Wabash County",2,10,125,57,68
050,17,185,"Illinois","Wabash County",2,11,136,69,67
050,17,185,"Illinois","Wabash County",2,12,153,84,69
050,17,185,"Illinois","Wabash County",2,13,147,77,70
050,17,185,"Illinois","Wabash County",2,14,146,79,67
050,17,185,"Illinois","Wabash County",2,15,151,78,73
050,17,185,"Illinois","Wabash County",2,16,137,71,66
050,17,185,"Illinois","Wabash County",2,17,139,70,69
050,17,185,"Illinois","Wabash County",2,18,153,82,71
050,17,185,"Illinois","Wabash County",2,19,158,77,81
050,17,185,"Illinois","Wabash County",2,20,142,71,71
050,17,185,"Illinois","Wabash County",2,21,138,73,65
050,17,185,"Illinois","Wabash County",2,22,125,65,60
050,17,185,"Illinois","Wabash County",2,23,118,56,62
050,17,185,"Illinois","Wabash County",2,24,122,58,64
050,17,185,"Illinois","Wabash County",2,25,115,62,53
050,17,185,"Illinois","Wabash County",2,26,115,61,54
050,17,185,"Illinois","Wabash County",2,27,117,65,52
050,17,185,"Illinois","Wabash County",2,28,136,75,61
050,17,185,"Illinois","Wabash County",2,29,149,81,68
050,17,185,"Illinois","Wabash County",2,30,142,72,70
050,17,185,"Illinois","Wabash County",2,31,120,59,61
050,17,185,"Illinois","Wabash County",2,32,113,56,57
050,17,185,"Illinois","Wabash County",2,33,115,55,60
050,17,185,"Illinois","Wabash County",2,34,122,57,65
050,17,185,"Illinois","Wabash County",2,35,125,61,64
050,17,185,"Illinois","Wabash County",2,36,127,64,63
050,17,185,"Illinois","Wabash County",2,37,125,63,62
050,17,185,"Illinois","Wabash County",2,38,125,67,58
050,17,185,"Illinois","Wabash County",2,39,139,76,63
050,17,185,"Illinois","Wabash County",2,40,138,79,59
050,17,185,"Illinois","Wabash County",2,41,123,73,50
050,17,185,"Illinois","Wabash County",2,42,121,61,60
050,17,185,"Illinois","Wabash County",2,43,123,60,63
050,17,185,"Illinois","Wabash County",2,44,111,61,50
050,17,185,"Illinois","Wabash County",2,45,123,70,53
050,17,185,"Illinois","Wabash County",2,46,131,72,59
050,17,185,"Illinois","Wabash County",2,47,128,65,63
050,17,185,"Illinois","Wabash County",2,48,130,61,69
050,17,185,"Illinois","Wabash County",2,49,135,55,80
050,17,185,"Illinois","Wabash County",2,50,126,53,73
050,17,185,"Illinois","Wabash County",2,51,133,63,70
050,17,185,"Illinois","Wabash County",2,52,120,59,61
050,17,185,"Illinois","Wabash County",2,53,120,61,59
050,17,185,"Illinois","Wabash County",2,54,127,67,60
050,17,185,"Illinois","Wabash County",2,55,140,74,66
050,17,185,"Illinois","Wabash County",2,56,158,81,77
050,17,185,"Illinois","Wabash County",2,57,174,84,90
050,17,185,"Illinois","Wabash County",2,58,182,90,92
050,17,185,"Illinois","Wabash County",2,59,173,92,81
050,17,185,"Illinois","Wabash County",2,60,167,89,78
050,17,185,"Illinois","Wabash County",2,61,177,87,90
050,17,185,"Illinois","Wabash County",2,62,186,91,95
050,17,185,"Illinois","Wabash County",2,63,182,89,93
050,17,185,"Illinois","Wabash County",2,64,174,84,90
050,17,185,"Illinois","Wabash County",2,65,167,76,91
050,17,185,"Illinois","Wabash County",2,66,161,74,87
050,17,185,"Illinois","Wabash County",2,67,160,77,83
050,17,185,"Illinois","Wabash County",2,68,144,76,68
050,17,185,"Illinois","Wabash County",2,69,134,73,61
050,17,185,"Illinois","Wabash County",2,70,145,75,70
050,17,185,"Illinois","Wabash County",2,71,141,76,65
050,17,185,"Illinois","Wabash County",2,72,115,61,54
050,17,185,"Illinois","Wabash County",2,73,128,62,66
050,17,185,"Illinois","Wabash County",2,74,92,41,51
050,17,185,"Illinois","Wabash County",2,75,89,39,50
050,17,185,"Illinois","Wabash County",2,76,88,37,51
050,17,185,"Illinois","Wabash County",2,77,87,40,47
050,17,185,"Illinois","Wabash County",2,78,68,34,34
050,17,185,"Illinois","Wabash County",2,79,65,33,32
050,17,185,"Illinois","Wabash County",2,80,64,32,32
050,17,185,"Illinois","Wabash County",2,81,61,31,30
050,17,185,"Illinois","Wabash County",2,82,57,22,35
050,17,185,"Illinois","Wabash County",2,83,47,16,31
050,17,185,"Illinois","Wabash County",2,84,45,20,25
050,17,185,"Illinois","Wabash County",2,85,359,118,241
050,17,185,"Illinois","Wabash County",3,0,113,54,59
050,17,185,"Illinois","Wabash County",3,1,120,59,61
050,17,185,"Illinois","Wabash County",3,2,124,64,60
050,17,185,"Illinois","Wabash County",3,3,128,61,67
050,17,185,"Illinois","Wabash County",3,4,123,60,63
050,17,185,"Illinois","Wabash County",3,5,137,73,64
050,17,185,"Illinois","Wabash County",3,6,127,71,56
050,17,185,"Illinois","Wabash County",3,7,136,83,53
050,17,185,"Illinois","Wabash County",3,8,142,82,60
050,17,185,"Illinois","Wabash County",3,9,142,75,67
050,17,185,"Illinois","Wabash County",3,10,133,65,68
050,17,185,"Illinois","Wabash County",3,11,128,60,68
050,17,185,"Illinois","Wabash County",3,12,136,66,70
050,17,185,"Illinois","Wabash County",3,13,157,84,73
050,17,185,"Illinois","Wabash County",3,14,140,68,72
050,17,185,"Illinois","Wabash County",3,15,147,79,68
050,17,185,"Illinois","Wabash County",3,16,151,72,79
050,17,185,"Illinois","Wabash County",3,17,132,70,62
050,17,185,"Illinois","Wabash County",3,18,157,81,76
050,17,185,"Illinois","Wabash County",3,19,165,84,81
050,17,185,"Illinois","Wabash County",3,20,143,72,71
050,17,185,"Illinois","Wabash County",3,21,128,64,64
050,17,185,"Illinois","Wabash County",3,22,133,71,62
050,17,185,"Illinois","Wabash County",3,23,118,64,54
050,17,185,"Illinois","Wabash County",3,24,115,59,56
050,17,185,"Illinois","Wabash County",3,25,122,60,62
050,17,185,"Illinois","Wabash County",3,26,107,59,48
050,17,185,"Illinois","Wabash County",3,27,114,59,55
050,17,185,"Illinois","Wabash County",3,28,115,64,51
050,17,185,"Illinois","Wabash County",3,29,130,68,62
050,17,185,"Illinois","Wabash County",3,30,146,78,68
050,17,185,"Illinois","Wabash County",3,31,151,74,77
050,17,185,"Illinois","Wabash County",3,32,124,60,64
050,17,185,"Illinois","Wabash County",3,33,120,63,57
050,17,185,"Illinois","Wabash County",3,34,114,55,59
050,17,185,"Illinois","Wabash County",3,35,116,51,65
050,17,185,"Illinois","Wabash County",3,36,123,57,66
050,17,185,"Illinois","Wabash County",3,37,123,61,62
050,17,185,"Illinois","Wabash County",3,38,119,59,60
050,17,185,"Illinois","Wabash County",3,39,131,67,64
050,17,185,"Illinois","Wabash County",3,40,137,76,61
050,17,185,"Illinois","Wabash County",3,41,138,79,59
050,17,185,"Illinois","Wabash County",3,42,126,75,51
050,17,185,"Illinois","Wabash County",3,43,120,62,58
050,17,185,"Illinois","Wabash County",3,44,127,63,64
050,17,185,"Illinois","Wabash County",3,45,112,61,51
050,17,185,"Illinois","Wabash County",3,46,127,74,53
050,17,185,"Illinois","Wabash County",3,47,131,74,57
050,17,185,"Illinois","Wabash County",3,48,127,60,67
050,17,185,"Illinois","Wabash County",3,49,122,57,65
050,17,185,"Illinois","Wabash County",3,50,132,56,76
050,17,185,"Illinois","Wabash County",3,51,130,57,73
050,17,185,"Illinois","Wabash County",3,52,122,58,64
050,17,185,"Illinois","Wabash County",3,53,114,57,57
050,17,185,"Illinois","Wabash County",3,54,115,59,56
050,17,185,"Illinois","Wabash County",3,55,130,66,64
050,17,185,"Illinois","Wabash County",3,56,136,72,64
050,17,185,"Illinois","Wabash County",3,57,154,78,76
050,17,185,"Illinois","Wabash County",3,58,169,81,88
050,17,185,"Illinois","Wabash County",3,59,176,86,90
050,17,185,"Illinois","Wabash County",3,60,169,88,81
050,17,185,"Illinois","Wabash County",3,61,164,87,77
050,17,185,"Illinois","Wabash County",3,62,167,83,84
050,17,185,"Illinois","Wabash County",3,63,184,90,94
050,17,185,"Illinois","Wabash County",3,64,181,89,92
050,17,185,"Illinois","Wabash County",3,65,172,83,89
050,17,185,"Illinois","Wabash County",3,66,163,73,90
050,17,185,"Illinois","Wabash County",3,67,154,71,83
050,17,185,"Illinois","Wabash County",3,68,162,80,82
050,17,185,"Illinois","Wabash County",3,69,143,75,68
050,17,185,"Illinois","Wabash County",3,70,127,67,60
050,17,185,"Illinois","Wabash County",3,71,145,74,71
050,17,185,"Illinois","Wabash County",3,72,133,70,63
050,17,185,"Illinois","Wabash County",3,73,112,59,53
050,17,185,"Illinois","Wabash County",3,74,124,60,64
050,17,185,"Illinois","Wabash County",3,75,90,38,52
050,17,185,"Illinois","Wabash County",3,76,83,36,47
050,17,185,"Illinois","Wabash County",3,77,86,35,51
050,17,185,"Illinois","Wabash County",3,78,85,40,45
050,17,185,"Illinois","Wabash County",3,79,63,34,29
050,17,185,"Illinois","Wabash County",3,80,62,30,32
050,17,185,"Illinois","Wabash County",3,81,61,31,30
050,17,185,"Illinois","Wabash County",3,82,60,26,34
050,17,185,"Illinois","Wabash County",3,83,54,21,33
050,17,185,"Illinois","Wabash County",3,84,41,17,24
050,17,185,"Illinois","Wabash County",3,85,348,107,241
050,17,185,"Illinois","Wabash County",4,0,71,40,31
050,17,185,"Illinois","Wabash County",4,1,110,52,58
050,17,185,"Illinois","Wabash County",4,2,113,52,61
050,17,185,"Illinois","Wabash County",4,3,132,71,61
050,17,185,"Illinois","Wabash County",4,4,130,59,71
050,17,185,"Illinois","Wabash County",4,5,131,66,65
050,17,185,"Illinois","Wabash County",4,6,141,75,66
050,17,185,"Illinois","Wabash County",4,7,127,69,58
050,17,185,"Illinois","Wabash County",4,8,129,80,49
050,17,185,"Illinois","Wabash County",4,9,146,80,66
050,17,185,"Illinois","Wabash County",4,10,139,72,67
050,17,185,"Illinois","Wabash County",4,11,130,59,71
050,17,185,"Illinois","Wabash County",4,12,132,60,72
050,17,185,"Illinois","Wabash County",4,13,131,63,68
050,17,185,"Illinois","Wabash County",4,14,153,80,73
050,17,185,"Illinois","Wabash County",4,15,141,70,71
050,17,185,"Illinois","Wabash County",4,16,150,85,65
050,17,185,"Illinois","Wabash County",4,17,155,77,78
050,17,185,"Illinois","Wabash County",4,18,141,75,66
050,17,185,"Illinois","Wabash County",4,19,162,79,83
050,17,185,"Illinois","Wabash County",4,20,141,74,67
050,17,185,"Illinois","Wabash County",4,21,131,69,62
050,17,185,"Illinois","Wabash County",4,22,121,60,61
050,17,185,"Illinois","Wabash County",4,23,120,69,51
050,17,185,"Illinois","Wabash County",4,24,123,64,59
050,17,185,"Illinois","Wabash County",4,25,107,60,47
050,17,185,"Illinois","Wabash County",4,26,124,61,63
050,17,185,"Illinois","Wabash County",4,27,109,61,48
050,17,185,"Illinois","Wabash County",4,28,116,60,56
050,17,185,"Illinois","Wabash County",4,29,109,56,53
050,17,185,"Illinois","Wabash County",4,30,129,67,62
050,17,185,"Illinois","Wabash County",4,31,140,78,62
050,17,185,"Illinois","Wabash County",4,32,149,70,79
050,17,185,"Illinois","Wabash County",4,33,123,62,61
050,17,185,"Illinois","Wabash County",4,34,122,65,57
050,17,185,"Illinois","Wabash County",4,35,112,56,56
050,17,185,"Illinois","Wabash County",4,36,114,51,63
050,17,185,"Illinois","Wabash County",4,37,123,58,65
050,17,185,"Illinois","Wabash County",4,38,127,65,62
050,17,185,"Illinois","Wabash County",4,39,119,59,60
050,17,185,"Illinois","Wabash County",4,40,132,66,66
050,17,185,"Illinois","Wabash County",4,41,133,72,61
050,17,185,"Illinois","Wabash County",4,42,132,74,58
050,17,185,"Illinois","Wabash County",4,43,130,76,54
050,17,185,"Illinois","Wabash County",4,44,120,62,58
050,17,185,"Illinois","Wabash County",4,45,125,61,64
050,17,185,"Illinois","Wabash County",4,46,114,62,52
050,17,185,"Illinois","Wabash County",4,47,129,74,55
050,17,185,"Illinois","Wabash County",4,48,125,75,50
050,17,185,"Illinois","Wabash County",4,49,123,57,66
050,17,185,"Illinois","Wabash County",4,50,124,56,68
050,17,185,"Illinois","Wabash County",4,51,133,59,74
050,17,185,"Illinois","Wabash County",4,52,127,57,70
050,17,185,"Illinois","Wabash County",4,53,121,59,62
050,17,185,"Illinois","Wabash County",4,54,112,56,56
050,17,185,"Illinois","Wabash County",4,55,116,59,57
050,17,185,"Illinois","Wabash County",4,56,122,64,58
050,17,185,"Illinois","Wabash County",4,57,135,73,62
050,17,185,"Illinois","Wabash County",4,58,154,78,76
050,17,185,"Illinois","Wabash County",4,59,166,79,87
050,17,185,"Illinois","Wabash County",4,60,174,85,89
050,17,185,"Illinois","Wabash County",4,61,165,85,80
050,17,185,"Illinois","Wabash County",4,62,161,86,75
050,17,185,"Illinois","Wabash County",4,63,167,84,83
050,17,185,"Illinois","Wabash County",4,64,178,85,93
050,17,185,"Illinois","Wabash County",4,65,176,85,91
050,17,185,"Illinois","Wabash County",4,66,164,79,85
050,17,185,"Illinois","Wabash County",4,67,155,70,85
050,17,185,"Illinois","Wabash County",4,68,146,65,81
050,17,185,"Illinois","Wabash County",4,69,161,78,83
050,17,185,"Illinois","Wabash County",4,70,137,70,67
050,17,185,"Illinois","Wabash County",4,71,120,62,58
050,17,185,"Illinois","Wabash County",4,72,139,72,67
050,17,185,"Illinois","Wabash County",4,73,128,65,63
050,17,185,"Illinois","Wabash County",4,74,112,57,55
050,17,185,"Illinois","Wabash County",4,75,122,59,63
050,17,185,"Illinois","Wabash County",4,76,82,36,46
050,17,185,"Illinois","Wabash County",4,77,81,34,47
050,17,185,"Illinois","Wabash County",4,78,81,35,46
050,17,185,"Illinois","Wabash County",4,79,81,39,42
050,17,185,"Illinois","Wabash County",4,80,61,32,29
050,17,185,"Illinois","Wabash County",4,81,60,31,29
050,17,185,"Illinois","Wabash County",4,82,61,27,34
050,17,185,"Illinois","Wabash County",4,83,55,25,30
050,17,185,"Illinois","Wabash County",4,84,48,21,27
050,17,185,"Illinois","Wabash County",4,85,329,96,233
050,17,185,"Illinois","Wabash County",5,0,39,19,20
050,17,185,"Illinois","Wabash County",5,1,74,41,33
050,17,185,"Illinois","Wabash County",5,2,112,54,58
050,17,185,"Illinois","Wabash County",5,3,115,54,61
050,17,185,"Illinois","Wabash County",5,4,142,74,68
050,17,185,"Illinois","Wabash County",5,5,139,59,80
050,17,185,"Illinois","Wabash County",5,6,130,67,63
050,17,185,"Illinois","Wabash County",5,7,140,80,60
050,17,185,"Illinois","Wabash County",5,8,122,69,53
050,17,185,"Illinois","Wabash County",5,9,127,77,50
050,17,185,"Illinois","Wabash County",5,10,146,83,63
050,17,185,"Illinois","Wabash County",5,11,148,82,66
050,17,185,"Illinois","Wabash County",5,12,130,61,69
050,17,185,"Illinois","Wabash County",5,13,129,61,68
050,17,185,"Illinois","Wabash County",5,14,135,68,67
050,17,185,"Illinois","Wabash County",5,15,153,79,74
050,17,185,"Illinois","Wabash County",5,16,129,63,66
050,17,185,"Illinois","Wabash County",5,17,153,86,67
050,17,185,"Illinois","Wabash County",5,18,165,84,81
050,17,185,"Illinois","Wabash County",5,19,143,75,68
050,17,185,"Illinois","Wabash County",5,20,144,74,70
050,17,185,"Illinois","Wabash County",5,21,132,69,63
050,17,185,"Illinois","Wabash County",5,22,129,69,60
050,17,185,"Illinois","Wabash County",5,23,120,61,59
050,17,185,"Illinois","Wabash County",5,24,120,67,53
050,17,185,"Illinois","Wabash County",5,25,115,61,54
050,17,185,"Illinois","Wabash County",5,26,114,64,50
050,17,185,"Illinois","Wabash County",5,27,124,62,62
050,17,185,"Illinois","Wabash County",5,28,117,64,53
050,17,185,"Illinois","Wabash County",5,29,120,65,55
050,17,185,"Illinois","Wabash County",5,30,111,60,51
050,17,185,"Illinois","Wabash County",5,31,129,72,57
050,17,185,"Illinois","Wabash County",5,32,137,75,62
050,17,185,"Illinois","Wabash County",5,33,146,70,76
050,17,185,"Illinois","Wabash County",5,34,114,55,59
050,17,185,"Illinois","Wabash County",5,35,128,68,60
050,17,185,"Illinois","Wabash County",5,36,120,57,63
050,17,185,"Illinois","Wabash County",5,37,117,52,65
050,17,185,"Illinois","Wabash County",5,38,128,62,66
050,17,185,"Illinois","Wabash County",5,39,123,63,60
050,17,185,"Illinois","Wabash County",5,40,121,59,62
050,17,185,"Illinois","Wabash County",5,41,128,65,63
050,17,185,"Illinois","Wabash County",5,42,130,68,62
050,17,185,"Illinois","Wabash County",5,43,140,85,55
050,17,185,"Illinois","Wabash County",5,44,130,77,53
050,17,185,"Illinois","Wabash County",5,45,118,60,58
050,17,185,"Illinois","Wabash County",5,46,123,62,61
050,17,185,"Illinois","Wabash County",5,47,117,61,56
050,17,185,"Illinois","Wabash County",5,48,127,72,55
050,17,185,"Illinois","Wabash County",5,49,126,75,51
050,17,185,"Illinois","Wabash County",5,50,122,56,66
050,17,185,"Illinois","Wabash County",5,51,122,55,67
050,17,185,"Illinois","Wabash County",5,52,132,59,73
050,17,185,"Illinois","Wabash County",5,53,125,56,69
050,17,185,"Illinois","Wabash County",5,54,115,54,61
050,17,185,"Illinois","Wabash County",5,55,114,57,57
050,17,185,"Illinois","Wabash County",5,56,113,60,53
050,17,185,"Illinois","Wabash County",5,57,124,65,59
050,17,185,"Illinois","Wabash County",5,58,133,71,62
050,17,185,"Illinois","Wabash County",5,59,155,79,76
050,17,185,"Illinois","Wabash County",5,60,169,79,90
050,17,185,"Illinois","Wabash County",5,61,173,84,89
050,17,185,"Illinois","Wabash County",5,62,167,86,81
050,17,185,"Illinois","Wabash County",5,63,157,82,75
050,17,185,"Illinois","Wabash County",5,64,164,82,82
050,17,185,"Illinois","Wabash County",5,65,175,86,89
050,17,185,"Illinois","Wabash County",5,66,173,82,91
050,17,185,"Illinois","Wabash County",5,67,153,74,79
050,17,185,"Illinois","Wabash County",5,68,152,69,83
050,17,185,"Illinois","Wabash County",5,69,145,64,81
050,17,185,"Illinois","Wabash County",5,70,158,77,81
050,17,185,"Illinois","Wabash County",5,71,129,65,64
050,17,185,"Illinois","Wabash County",5,72,117,60,57
050,17,185,"Illinois","Wabash County",5,73,135,69,66
050,17,185,"Illinois","Wabash County",5,74,131,65,66
050,17,185,"Illinois","Wabash County",5,75,107,55,52
050,17,185,"Illinois","Wabash County",5,76,113,56,57
050,17,185,"Illinois","Wabash County",5,77,81,34,47
050,17,185,"Illinois","Wabash County",5,78,77,34,43
050,17,185,"Illinois","Wabash County",5,79,77,34,43
050,17,185,"Illinois","Wabash County",5,80,76,35,41
050,17,185,"Illinois","Wabash County",5,81,59,33,26
050,17,185,"Illinois","Wabash County",5,82,57,27,30
050,17,185,"Illinois","Wabash County",5,83,56,26,30
050,17,185,"Illinois","Wabash County",5,84,50,26,24
050,17,185,"Illinois","Wabash County",5,85,317,90,227
050,17,187,"Illinois","Warren County",1,0,199,101,98
050,17,187,"Illinois","Warren County",1,1,211,104,107
050,17,187,"Illinois","Warren County",1,2,193,96,97
050,17,187,"Illinois","Warren County",1,3,216,114,102
050,17,187,"Illinois","Warren County",1,4,207,94,113
050,17,187,"Illinois","Warren County",1,5,193,106,87
050,17,187,"Illinois","Warren County",1,6,204,105,99
050,17,187,"Illinois","Warren County",1,7,216,125,91
050,17,187,"Illinois","Warren County",1,8,206,118,88
050,17,187,"Illinois","Warren County",1,9,179,96,83
050,17,187,"Illinois","Warren County",1,10,203,108,95
050,17,187,"Illinois","Warren County",1,11,216,97,119
050,17,187,"Illinois","Warren County",1,12,203,105,98
050,17,187,"Illinois","Warren County",1,13,233,108,125
050,17,187,"Illinois","Warren County",1,14,221,105,116
050,17,187,"Illinois","Warren County",1,15,189,97,92
050,17,187,"Illinois","Warren County",1,16,195,95,100
050,17,187,"Illinois","Warren County",1,17,209,105,104
050,17,187,"Illinois","Warren County",1,18,301,140,161
050,17,187,"Illinois","Warren County",1,19,397,196,201
050,17,187,"Illinois","Warren County",1,20,356,173,183
050,17,187,"Illinois","Warren County",1,21,326,171,155
050,17,187,"Illinois","Warren County",1,22,257,135,122
050,17,187,"Illinois","Warren County",1,23,177,96,81
050,17,187,"Illinois","Warren County",1,24,172,87,85
050,17,187,"Illinois","Warren County",1,25,191,99,92
050,17,187,"Illinois","Warren County",1,26,180,92,88
050,17,187,"Illinois","Warren County",1,27,167,84,83
050,17,187,"Illinois","Warren County",1,28,166,84,82
050,17,187,"Illinois","Warren County",1,29,178,97,81
050,17,187,"Illinois","Warren County",1,30,183,98,85
050,17,187,"Illinois","Warren County",1,31,182,95,87
050,17,187,"Illinois","Warren County",1,32,172,80,92
050,17,187,"Illinois","Warren County",1,33,172,83,89
050,17,187,"Illinois","Warren County",1,34,192,91,101
050,17,187,"Illinois","Warren County",1,35,194,107,87
050,17,187,"Illinois","Warren County",1,36,177,93,84
050,17,187,"Illinois","Warren County",1,37,170,78,92
050,17,187,"Illinois","Warren County",1,38,188,92,96
050,17,187,"Illinois","Warren County",1,39,214,116,98
050,17,187,"Illinois","Warren County",1,40,211,108,103
050,17,187,"Illinois","Warren County",1,41,177,92,85
050,17,187,"Illinois","Warren County",1,42,172,96,76
050,17,187,"Illinois","Warren County",1,43,178,95,83
050,17,187,"Illinois","Warren County",1,44,199,94,105
050,17,187,"Illinois","Warren County",1,45,176,91,85
050,17,187,"Illinois","Warren County",1,46,188,92,96
050,17,187,"Illinois","Warren County",1,47,201,105,96
050,17,187,"Illinois","Warren County",1,48,185,98,87
050,17,187,"Illinois","Warren County",1,49,194,95,99
050,17,187,"Illinois","Warren County",1,50,181,88,93
050,17,187,"Illinois","Warren County",1,51,188,91,97
050,17,187,"Illinois","Warren County",1,52,185,91,94
050,17,187,"Illinois","Warren County",1,53,195,99,96
050,17,187,"Illinois","Warren County",1,54,182,100,82
050,17,187,"Illinois","Warren County",1,55,214,104,110
050,17,187,"Illinois","Warren County",1,56,213,114,99
050,17,187,"Illinois","Warren County",1,57,225,115,110
050,17,187,"Illinois","Warren County",1,58,222,99,123
050,17,187,"Illinois","Warren County",1,59,240,111,129
050,17,187,"Illinois","Warren County",1,60,234,114,120
050,17,187,"Illinois","Warren County",1,61,232,112,120
050,17,187,"Illinois","Warren County",1,62,238,113,125
050,17,187,"Illinois","Warren County",1,63,217,113,104
050,17,187,"Illinois","Warren County",1,64,210,112,98
050,17,187,"Illinois","Warren County",1,65,242,121,121
050,17,187,"Illinois","Warren County",1,66,229,117,112
050,17,187,"Illinois","Warren County",1,67,210,105,105
050,17,187,"Illinois","Warren County",1,68,217,105,112
050,17,187,"Illinois","Warren County",1,69,203,102,101
050,17,187,"Illinois","Warren County",1,70,185,95,90
050,17,187,"Illinois","Warren County",1,71,175,84,91
050,17,187,"Illinois","Warren County",1,72,182,89,93
050,17,187,"Illinois","Warren County",1,73,187,91,96
050,17,187,"Illinois","Warren County",1,74,119,56,63
050,17,187,"Illinois","Warren County",1,75,118,60,58
050,17,187,"Illinois","Warren County",1,76,132,66,66
050,17,187,"Illinois","Warren County",1,77,124,63,61
050,17,187,"Illinois","Warren County",1,78,120,54,66
050,17,187,"Illinois","Warren County",1,79,109,48,61
050,17,187,"Illinois","Warren County",1,80,81,35,46
050,17,187,"Illinois","Warren County",1,81,93,37,56
050,17,187,"Illinois","Warren County",1,82,106,48,58
050,17,187,"Illinois","Warren County",1,83,89,40,49
050,17,187,"Illinois","Warren County",1,84,70,34,36
050,17,187,"Illinois","Warren County",1,85,380,125,255
050,17,187,"Illinois","Warren County",2,0,229,116,113
050,17,187,"Illinois","Warren County",2,1,206,102,104
050,17,187,"Illinois","Warren County",2,2,197,98,99
050,17,187,"Illinois","Warren County",2,3,208,108,100
050,17,187,"Illinois","Warren County",2,4,210,100,110
050,17,187,"Illinois","Warren County",2,5,198,104,94
050,17,187,"Illinois","Warren County",2,6,199,106,93
050,17,187,"Illinois","Warren County",2,7,211,121,90
050,17,187,"Illinois","Warren County",2,8,208,120,88
050,17,187,"Illinois","Warren County",2,9,186,101,85
050,17,187,"Illinois","Warren County",2,10,197,103,94
050,17,187,"Illinois","Warren County",2,11,211,99,112
050,17,187,"Illinois","Warren County",2,12,209,105,104
050,17,187,"Illinois","Warren County",2,13,226,108,118
050,17,187,"Illinois","Warren County",2,14,223,105,118
050,17,187,"Illinois","Warren County",2,15,196,99,97
050,17,187,"Illinois","Warren County",2,16,196,96,100
050,17,187,"Illinois","Warren County",2,17,205,102,103
050,17,187,"Illinois","Warren County",2,18,294,138,156
050,17,187,"Illinois","Warren County",2,19,395,193,202
050,17,187,"Illinois","Warren County",2,20,359,175,184
050,17,187,"Illinois","Warren County",2,21,326,169,157
050,17,187,"Illinois","Warren County",2,22,257,137,120
050,17,187,"Illinois","Warren County",2,23,183,100,83
050,17,187,"Illinois","Warren County",2,24,171,87,84
050,17,187,"Illinois","Warren County",2,25,184,94,90
050,17,187,"Illinois","Warren County",2,26,182,93,89
050,17,187,"Illinois","Warren County",2,27,172,88,84
050,17,187,"Illinois","Warren County",2,28,166,84,82
050,17,187,"Illinois","Warren County",2,29,174,93,81
050,17,187,"Illinois","Warren County",2,30,184,99,85
050,17,187,"Illinois","Warren County",2,31,181,95,86
050,17,187,"Illinois","Warren County",2,32,176,84,92
050,17,187,"Illinois","Warren County",2,33,172,83,89
050,17,187,"Illinois","Warren County",2,34,185,88,97
050,17,187,"Illinois","Warren County",2,35,193,102,91
050,17,187,"Illinois","Warren County",2,36,178,95,83
050,17,187,"Illinois","Warren County",2,37,172,82,90
050,17,187,"Illinois","Warren County",2,38,185,89,96
050,17,187,"Illinois","Warren County",2,39,206,110,96
050,17,187,"Illinois","Warren County",2,40,213,110,103
050,17,187,"Illinois","Warren County",2,41,185,96,89
050,17,187,"Illinois","Warren County",2,42,172,94,78
050,17,187,"Illinois","Warren County",2,43,179,97,82
050,17,187,"Illinois","Warren County",2,44,193,93,100
050,17,187,"Illinois","Warren County",2,45,183,93,90
050,17,187,"Illinois","Warren County",2,46,182,90,92
050,17,187,"Illinois","Warren County",2,47,197,101,96
050,17,187,"Illinois","Warren County",2,48,187,99,88
050,17,187,"Illinois","Warren County",2,49,194,98,96
050,17,187,"Illinois","Warren County",2,50,185,90,95
050,17,187,"Illinois","Warren County",2,51,186,90,96
050,17,187,"Illinois","Warren County",2,52,186,91,95
050,17,187,"Illinois","Warren County",2,53,190,96,94
050,17,187,"Illinois","Warren County",2,54,188,102,86
050,17,187,"Illinois","Warren County",2,55,206,103,103
050,17,187,"Illinois","Warren County",2,56,214,112,102
050,17,187,"Illinois","Warren County",2,57,222,115,107
050,17,187,"Illinois","Warren County",2,58,221,103,118
050,17,187,"Illinois","Warren County",2,59,232,107,125
050,17,187,"Illinois","Warren County",2,60,235,113,122
050,17,187,"Illinois","Warren County",2,61,230,111,119
050,17,187,"Illinois","Warren County",2,62,235,112,123
050,17,187,"Illinois","Warren County",2,63,221,113,108
050,17,187,"Illinois","Warren County",2,64,209,110,99
050,17,187,"Illinois","Warren County",2,65,234,119,115
050,17,187,"Illinois","Warren County",2,66,232,118,114
050,17,187,"Illinois","Warren County",2,67,214,107,107
050,17,187,"Illinois","Warren County",2,68,212,103,109
050,17,187,"Illinois","Warren County",2,69,207,102,105
050,17,187,"Illinois","Warren County",2,70,186,94,92
050,17,187,"Illinois","Warren County",2,71,174,85,89
050,17,187,"Illinois","Warren County",2,72,177,86,91
050,17,187,"Illinois","Warren County",2,73,193,94,99
050,17,187,"Illinois","Warren County",2,74,125,59,66
050,17,187,"Illinois","Warren County",2,75,116,58,58
050,17,187,"Illinois","Warren County",2,76,126,63,63
050,17,187,"Illinois","Warren County",2,77,128,66,62
050,17,187,"Illinois","Warren County",2,78,117,54,63
050,17,187,"Illinois","Warren County",2,79,108,48,60
050,17,187,"Illinois","Warren County",2,80,86,37,49
050,17,187,"Illinois","Warren County",2,81,87,34,53
050,17,187,"Illinois","Warren County",2,82,101,44,57
050,17,187,"Illinois","Warren County",2,83,92,42,50
050,17,187,"Illinois","Warren County",2,84,73,35,38
050,17,187,"Illinois","Warren County",2,85,378,130,248
050,17,187,"Illinois","Warren County",3,0,188,95,93
050,17,187,"Illinois","Warren County",3,1,226,122,104
050,17,187,"Illinois","Warren County",3,2,190,95,95
050,17,187,"Illinois","Warren County",3,3,201,100,101
050,17,187,"Illinois","Warren County",3,4,208,108,100
050,17,187,"Illinois","Warren County",3,5,204,92,112
050,17,187,"Illinois","Warren County",3,6,199,106,93
050,17,187,"Illinois","Warren County",3,7,200,110,90
050,17,187,"Illinois","Warren County",3,8,204,116,88
050,17,187,"Illinois","Warren County",3,9,210,121,89
050,17,187,"Illinois","Warren County",3,10,177,95,82
050,17,187,"Illinois","Warren County",3,11,196,104,92
050,17,187,"Illinois","Warren County",3,12,206,95,111
050,17,187,"Illinois","Warren County",3,13,210,105,105
050,17,187,"Illinois","Warren County",3,14,224,110,114
050,17,187,"Illinois","Warren County",3,15,220,102,118
050,17,187,"Illinois","Warren County",3,16,203,100,103
050,17,187,"Illinois","Warren County",3,17,186,92,94
050,17,187,"Illinois","Warren County",3,18,288,135,153
050,17,187,"Illinois","Warren County",3,19,381,188,193
050,17,187,"Illinois","Warren County",3,20,345,165,180
050,17,187,"Illinois","Warren County",3,21,329,162,167
050,17,187,"Illinois","Warren County",3,22,254,135,119
050,17,187,"Illinois","Warren County",3,23,184,102,82
050,17,187,"Illinois","Warren County",3,24,161,81,80
050,17,187,"Illinois","Warren County",3,25,167,86,81
050,17,187,"Illinois","Warren County",3,26,174,88,86
050,17,187,"Illinois","Warren County",3,27,177,91,86
050,17,187,"Illinois","Warren County",3,28,163,84,79
050,17,187,"Illinois","Warren County",3,29,156,72,84
050,17,187,"Illinois","Warren County",3,30,172,95,77
050,17,187,"Illinois","Warren County",3,31,176,99,77
050,17,187,"Illinois","Warren County",3,32,184,98,86
050,17,187,"Illinois","Warren County",3,33,173,87,86
050,17,187,"Illinois","Warren County",3,34,179,84,95
050,17,187,"Illinois","Warren County",3,35,187,88,99
050,17,187,"Illinois","Warren County",3,36,199,110,89
050,17,187,"Illinois","Warren County",3,37,173,92,81
050,17,187,"Illinois","Warren County",3,38,179,86,93
050,17,187,"Illinois","Warren County",3,39,179,82,97
050,17,187,"Illinois","Warren County",3,40,208,113,95
050,17,187,"Illinois","Warren County",3,41,220,111,109
050,17,187,"Illinois","Warren County",3,42,191,102,89
050,17,187,"Illinois","Warren County",3,43,170,90,80
050,17,187,"Illinois","Warren County",3,44,183,99,84
050,17,187,"Illinois","Warren County",3,45,185,89,96
050,17,187,"Illinois","Warren County",3,46,183,95,88
050,17,187,"Illinois","Warren County",3,47,175,85,90
050,17,187,"Illinois","Warren County",3,48,192,99,93
050,17,187,"Illinois","Warren County",3,49,186,99,87
050,17,187,"Illinois","Warren County",3,50,192,95,97
050,17,187,"Illinois","Warren County",3,51,186,91,95
050,17,187,"Illinois","Warren County",3,52,182,88,94
050,17,187,"Illinois","Warren County",3,53,188,93,95
050,17,187,"Illinois","Warren County",3,54,185,95,90
050,17,187,"Illinois","Warren County",3,55,192,99,93
050,17,187,"Illinois","Warren County",3,56,205,101,104
050,17,187,"Illinois","Warren County",3,57,209,107,102
050,17,187,"Illinois","Warren County",3,58,217,111,106
050,17,187,"Illinois","Warren County",3,59,223,105,118
050,17,187,"Illinois","Warren County",3,60,235,108,127
050,17,187,"Illinois","Warren County",3,61,235,113,122
050,17,187,"Illinois","Warren County",3,62,234,112,122
050,17,187,"Illinois","Warren County",3,63,230,113,117
050,17,187,"Illinois","Warren County",3,64,209,106,103
050,17,187,"Illinois","Warren County",3,65,207,108,99
050,17,187,"Illinois","Warren County",3,66,225,112,113
050,17,187,"Illinois","Warren County",3,67,227,115,112
050,17,187,"Illinois","Warren County",3,68,211,106,105
050,17,187,"Illinois","Warren County",3,69,200,98,102
050,17,187,"Illinois","Warren County",3,70,205,101,104
050,17,187,"Illinois","Warren County",3,71,181,92,89
050,17,187,"Illinois","Warren County",3,72,167,82,85
050,17,187,"Illinois","Warren County",3,73,165,79,86
050,17,187,"Illinois","Warren County",3,74,181,89,92
050,17,187,"Illinois","Warren County",3,75,117,50,67
050,17,187,"Illinois","Warren County",3,76,106,52,54
050,17,187,"Illinois","Warren County",3,77,118,61,57
050,17,187,"Illinois","Warren County",3,78,118,59,59
050,17,187,"Illinois","Warren County",3,79,107,49,58
050,17,187,"Illinois","Warren County",3,80,101,47,54
050,17,187,"Illinois","Warren County",3,81,77,32,45
050,17,187,"Illinois","Warren County",3,82,77,25,52
050,17,187,"Illinois","Warren County",3,83,85,36,49
050,17,187,"Illinois","Warren County",3,84,83,36,47
050,17,187,"Illinois","Warren County",3,85,380,140,240
050,17,187,"Illinois","Warren County",4,0,196,92,104
050,17,187,"Illinois","Warren County",4,1,188,95,93
050,17,187,"Illinois","Warren County",4,2,221,121,100
050,17,187,"Illinois","Warren County",4,3,194,99,95
050,17,187,"Illinois","Warren County",4,4,203,102,101
050,17,187,"Illinois","Warren County",4,5,212,104,108
050,17,187,"Illinois","Warren County",4,6,207,96,111
050,17,187,"Illinois","Warren County",4,7,208,111,97
050,17,187,"Illinois","Warren County",4,8,193,104,89
050,17,187,"Illinois","Warren County",4,9,193,111,82
050,17,187,"Illinois","Warren County",4,10,197,113,84
050,17,187,"Illinois","Warren County",4,11,175,95,80
050,17,187,"Illinois","Warren County",4,12,192,97,95
050,17,187,"Illinois","Warren County",4,13,201,94,107
050,17,187,"Illinois","Warren County",4,14,210,101,109
050,17,187,"Illinois","Warren County",4,15,230,114,116
050,17,187,"Illinois","Warren County",4,16,228,106,122
050,17,187,"Illinois","Warren County",4,17,200,98,102
050,17,187,"Illinois","Warren County",4,18,277,133,144
050,17,187,"Illinois","Warren County",4,19,369,180,189
050,17,187,"Illinois","Warren County",4,20,326,160,166
050,17,187,"Illinois","Warren County",4,21,322,157,165
050,17,187,"Illinois","Warren County",4,22,245,124,121
050,17,187,"Illinois","Warren County",4,23,185,96,89
050,17,187,"Illinois","Warren County",4,24,169,96,73
050,17,187,"Illinois","Warren County",4,25,156,78,78
050,17,187,"Illinois","Warren County",4,26,158,81,77
050,17,187,"Illinois","Warren County",4,27,189,100,89
050,17,187,"Illinois","Warren County",4,28,169,89,80
050,17,187,"Illinois","Warren County",4,29,169,83,86
050,17,187,"Illinois","Warren County",4,30,149,62,87
050,17,187,"Illinois","Warren County",4,31,170,91,79
050,17,187,"Illinois","Warren County",4,32,169,87,82
050,17,187,"Illinois","Warren County",4,33,182,102,80
050,17,187,"Illinois","Warren County",4,34,166,84,82
050,17,187,"Illinois","Warren County",4,35,171,84,87
050,17,187,"Illinois","Warren County",4,36,190,96,94
050,17,187,"Illinois","Warren County",4,37,189,108,81
050,17,187,"Illinois","Warren County",4,38,179,98,81
050,17,187,"Illinois","Warren County",4,39,183,87,96
050,17,187,"Illinois","Warren County",4,40,182,87,95
050,17,187,"Illinois","Warren County",4,41,205,118,87
050,17,187,"Illinois","Warren County",4,42,211,106,105
050,17,187,"Illinois","Warren County",4,43,190,97,93
050,17,187,"Illinois","Warren County",4,44,159,86,73
050,17,187,"Illinois","Warren County",4,45,172,95,77
050,17,187,"Illinois","Warren County",4,46,179,85,94
050,17,187,"Illinois","Warren County",4,47,185,99,86
050,17,187,"Illinois","Warren County",4,48,179,85,94
050,17,187,"Illinois","Warren County",4,49,187,93,94
050,17,187,"Illinois","Warren County",4,50,179,100,79
050,17,187,"Illinois","Warren County",4,51,183,93,90
050,17,187,"Illinois","Warren County",4,52,187,93,94
050,17,187,"Illinois","Warren County",4,53,181,85,96
050,17,187,"Illinois","Warren County",4,54,191,94,97
050,17,187,"Illinois","Warren County",4,55,187,94,93
050,17,187,"Illinois","Warren County",4,56,185,95,90
050,17,187,"Illinois","Warren County",4,57,199,99,100
050,17,187,"Illinois","Warren County",4,58,207,105,102
050,17,187,"Illinois","Warren County",4,59,217,110,107
050,17,187,"Illinois","Warren County",4,60,222,110,112
050,17,187,"Illinois","Warren County",4,61,227,103,124
050,17,187,"Illinois","Warren County",4,62,236,111,125
050,17,187,"Illinois","Warren County",4,63,231,109,122
050,17,187,"Illinois","Warren County",4,64,227,111,116
050,17,187,"Illinois","Warren County",4,65,204,102,102
050,17,187,"Illinois","Warren County",4,66,204,106,98
050,17,187,"Illinois","Warren County",4,67,224,109,115
050,17,187,"Illinois","Warren County",4,68,219,113,106
050,17,187,"Illinois","Warren County",4,69,205,104,101
050,17,187,"Illinois","Warren County",4,70,198,96,102
050,17,187,"Illinois","Warren County",4,71,195,95,100
050,17,187,"Illinois","Warren County",4,72,175,89,86
050,17,187,"Illinois","Warren County",4,73,154,75,79
050,17,187,"Illinois","Warren County",4,74,160,78,82
050,17,187,"Illinois","Warren County",4,75,171,85,86
050,17,187,"Illinois","Warren County",4,76,105,43,62
050,17,187,"Illinois","Warren County",4,77,104,51,53
050,17,187,"Illinois","Warren County",4,78,107,55,52
050,17,187,"Illinois","Warren County",4,79,110,54,56
050,17,187,"Illinois","Warren County",4,80,97,47,50
050,17,187,"Illinois","Warren County",4,81,97,43,54
050,17,187,"Illinois","Warren County",4,82,72,26,46
050,17,187,"Illinois","Warren County",4,83,64,24,40
050,17,187,"Illinois","Warren County",4,84,72,28,44
050,17,187,"Illinois","Warren County",4,85,385,150,235
050,17,187,"Illinois","Warren County",5,0,194,92,102
050,17,187,"Illinois","Warren County",5,1,185,90,95
050,17,187,"Illinois","Warren County",5,2,183,97,86
050,17,187,"Illinois","Warren County",5,3,214,116,98
050,17,187,"Illinois","Warren County",5,4,195,101,94
050,17,187,"Illinois","Warren County",5,5,200,98,102
050,17,187,"Illinois","Warren County",5,6,218,107,111
050,17,187,"Illinois","Warren County",5,7,206,97,109
050,17,187,"Illinois","Warren County",5,8,205,110,95
050,17,187,"Illinois","Warren County",5,9,193,109,84
050,17,187,"Illinois","Warren County",5,10,191,108,83
050,17,187,"Illinois","Warren County",5,11,202,118,84
050,17,187,"Illinois","Warren County",5,12,177,93,84
050,17,187,"Illinois","Warren County",5,13,193,97,96
050,17,187,"Illinois","Warren County",5,14,203,98,105
050,17,187,"Illinois","Warren County",5,15,206,100,106
050,17,187,"Illinois","Warren County",5,16,228,117,111
050,17,187,"Illinois","Warren County",5,17,227,105,122
050,17,187,"Illinois","Warren County",5,18,278,133,145
050,17,187,"Illinois","Warren County",5,19,374,187,187
050,17,187,"Illinois","Warren County",5,20,320,156,164
050,17,187,"Illinois","Warren County",5,21,298,143,155
050,17,187,"Illinois","Warren County",5,22,250,123,127
050,17,187,"Illinois","Warren County",5,23,175,89,86
050,17,187,"Illinois","Warren County",5,24,180,94,86
050,17,187,"Illinois","Warren County",5,25,158,90,68
050,17,187,"Illinois","Warren County",5,26,145,71,74
050,17,187,"Illinois","Warren County",5,27,171,89,82
050,17,187,"Illinois","Warren County",5,28,187,98,89
050,17,187,"Illinois","Warren County",5,29,175,96,79
050,17,187,"Illinois","Warren County",5,30,163,78,85
050,17,187,"Illinois","Warren County",5,31,150,63,87
050,17,187,"Illinois","Warren County",5,32,167,91,76
050,17,187,"Illinois","Warren County",5,33,168,84,84
050,17,187,"Illinois","Warren County",5,34,169,94,75
050,17,187,"Illinois","Warren County",5,35,169,87,82
050,17,187,"Illinois","Warren County",5,36,170,83,87
050,17,187,"Illinois","Warren County",5,37,192,95,97
050,17,187,"Illinois","Warren County",5,38,186,106,80
050,17,187,"Illinois","Warren County",5,39,175,92,83
050,17,187,"Illinois","Warren County",5,40,173,81,92
050,17,187,"Illinois","Warren County",5,41,177,80,97
050,17,187,"Illinois","Warren County",5,42,204,117,87
050,17,187,"Illinois","Warren County",5,43,206,105,101
050,17,187,"Illinois","Warren County",5,44,197,102,95
050,17,187,"Illinois","Warren County",5,45,154,86,68
050,17,187,"Illinois","Warren County",5,46,169,92,77
050,17,187,"Illinois","Warren County",5,47,175,81,94
050,17,187,"Illinois","Warren County",5,48,191,101,90
050,17,187,"Illinois","Warren County",5,49,182,87,95
050,17,187,"Illinois","Warren County",5,50,183,96,87
050,17,187,"Illinois","Warren County",5,51,178,98,80
050,17,187,"Illinois","Warren County",5,52,186,97,89
050,17,187,"Illinois","Warren County",5,53,190,93,97
050,17,187,"Illinois","Warren County",5,54,182,89,93
050,17,187,"Illinois","Warren County",5,55,186,92,94
050,17,187,"Illinois","Warren County",5,56,180,91,89
050,17,187,"Illinois","Warren County",5,57,190,99,91
050,17,187,"Illinois","Warren County",5,58,198,99,99
050,17,187,"Illinois","Warren County",5,59,206,101,105
050,17,187,"Illinois","Warren County",5,60,218,110,108
050,17,187,"Illinois","Warren County",5,61,216,106,110
050,17,187,"Illinois","Warren County",5,62,223,102,121
050,17,187,"Illinois","Warren County",5,63,225,109,116
050,17,187,"Illinois","Warren County",5,64,229,108,121
050,17,187,"Illinois","Warren County",5,65,220,108,112
050,17,187,"Illinois","Warren County",5,66,197,100,97
050,17,187,"Illinois","Warren County",5,67,194,103,91
050,17,187,"Illinois","Warren County",5,68,215,104,111
050,17,187,"Illinois","Warren County",5,69,211,110,101
050,17,187,"Illinois","Warren County",5,70,199,101,98
050,17,187,"Illinois","Warren County",5,71,189,92,97
050,17,187,"Illinois","Warren County",5,72,190,94,96
050,17,187,"Illinois","Warren County",5,73,167,86,81
050,17,187,"Illinois","Warren County",5,74,142,72,70
050,17,187,"Illinois","Warren County",5,75,158,76,82
050,17,187,"Illinois","Warren County",5,76,152,74,78
050,17,187,"Illinois","Warren County",5,77,102,43,59
050,17,187,"Illinois","Warren County",5,78,99,48,51
050,17,187,"Illinois","Warren County",5,79,99,50,49
050,17,187,"Illinois","Warren County",5,80,96,52,44
050,17,187,"Illinois","Warren County",5,81,91,42,49
050,17,187,"Illinois","Warren County",5,82,91,37,54
050,17,187,"Illinois","Warren County",5,83,61,23,38
050,17,187,"Illinois","Warren County",5,84,52,17,35
050,17,187,"Illinois","Warren County",5,85,402,164,238
050,17,189,"Illinois","Washington County",1,0,147,76,71
050,17,189,"Illinois","Washington County",1,1,160,84,76
050,17,189,"Illinois","Washington County",1,2,140,72,68
050,17,189,"Illinois","Washington County",1,3,152,74,78
050,17,189,"Illinois","Washington County",1,4,158,78,80
050,17,189,"Illinois","Washington County",1,5,163,82,81
050,17,189,"Illinois","Washington County",1,6,160,80,80
050,17,189,"Illinois","Washington County",1,7,167,82,85
050,17,189,"Illinois","Washington County",1,8,148,75,73
050,17,189,"Illinois","Washington County",1,9,140,70,70
050,17,189,"Illinois","Washington County",1,10,133,63,70
050,17,189,"Illinois","Washington County",1,11,169,77,92
050,17,189,"Illinois","Washington County",1,12,163,78,85
050,17,189,"Illinois","Washington County",1,13,183,94,89
050,17,189,"Illinois","Washington County",1,14,196,99,97
050,17,189,"Illinois","Washington County",1,15,192,98,94
050,17,189,"Illinois","Washington County",1,16,195,100,95
050,17,189,"Illinois","Washington County",1,17,180,87,93
050,17,189,"Illinois","Washington County",1,18,166,92,74
050,17,189,"Illinois","Washington County",1,19,117,60,57
050,17,189,"Illinois","Washington County",1,20,116,53,63
050,17,189,"Illinois","Washington County",1,21,118,61,57
050,17,189,"Illinois","Washington County",1,22,127,71,56
050,17,189,"Illinois","Washington County",1,23,131,66,65
050,17,189,"Illinois","Washington County",1,24,138,73,65
050,17,189,"Illinois","Washington County",1,25,134,65,69
050,17,189,"Illinois","Washington County",1,26,149,72,77
050,17,189,"Illinois","Washington County",1,27,140,71,69
050,17,189,"Illinois","Washington County",1,28,152,86,66
050,17,189,"Illinois","Washington County",1,29,167,84,83
050,17,189,"Illinois","Washington County",1,30,157,74,83
050,17,189,"Illinois","Washington County",1,31,160,76,84
050,17,189,"Illinois","Washington County",1,32,168,85,83
050,17,189,"Illinois","Washington County",1,33,162,88,74
050,17,189,"Illinois","Washington County",1,34,170,85,85
050,17,189,"Illinois","Washington County",1,35,149,69,80
050,17,189,"Illinois","Washington County",1,36,147,77,70
050,17,189,"Illinois","Washington County",1,37,152,80,72
050,17,189,"Illinois","Washington County",1,38,156,88,68
050,17,189,"Illinois","Washington County",1,39,167,83,84
050,17,189,"Illinois","Washington County",1,40,189,95,94
050,17,189,"Illinois","Washington County",1,41,175,89,86
050,17,189,"Illinois","Washington County",1,42,172,83,89
050,17,189,"Illinois","Washington County",1,43,166,83,83
050,17,189,"Illinois","Washington County",1,44,161,84,77
050,17,189,"Illinois","Washington County",1,45,164,86,78
050,17,189,"Illinois","Washington County",1,46,155,90,65
050,17,189,"Illinois","Washington County",1,47,153,85,68
050,17,189,"Illinois","Washington County",1,48,168,86,82
050,17,189,"Illinois","Washington County",1,49,197,101,96
050,17,189,"Illinois","Washington County",1,50,174,83,91
050,17,189,"Illinois","Washington County",1,51,169,88,81
050,17,189,"Illinois","Washington County",1,52,171,86,85
050,17,189,"Illinois","Washington County",1,53,161,82,79
050,17,189,"Illinois","Washington County",1,54,190,98,92
050,17,189,"Illinois","Washington County",1,55,207,108,99
050,17,189,"Illinois","Washington County",1,56,210,105,105
050,17,189,"Illinois","Washington County",1,57,226,111,115
050,17,189,"Illinois","Washington County",1,58,226,115,111
050,17,189,"Illinois","Washington County",1,59,220,108,112
050,17,189,"Illinois","Washington County",1,60,223,112,111
050,17,189,"Illinois","Washington County",1,61,232,118,114
050,17,189,"Illinois","Washington County",1,62,232,121,111
050,17,189,"Illinois","Washington County",1,63,207,109,98
050,17,189,"Illinois","Washington County",1,64,202,107,95
050,17,189,"Illinois","Washington County",1,65,196,111,85
050,17,189,"Illinois","Washington County",1,66,195,109,86
050,17,189,"Illinois","Washington County",1,67,190,99,91
050,17,189,"Illinois","Washington County",1,68,186,101,85
050,17,189,"Illinois","Washington County",1,69,164,93,71
050,17,189,"Illinois","Washington County",1,70,140,77,63
050,17,189,"Illinois","Washington County",1,71,131,62,69
050,17,189,"Illinois","Washington County",1,72,148,73,75
050,17,189,"Illinois","Washington County",1,73,142,73,69
050,17,189,"Illinois","Washington County",1,74,106,50,56
050,17,189,"Illinois","Washington County",1,75,110,51,59
050,17,189,"Illinois","Washington County",1,76,116,49,67
050,17,189,"Illinois","Washington County",1,77,95,43,52
050,17,189,"Illinois","Washington County",1,78,84,39,45
050,17,189,"Illinois","Washington County",1,79,89,38,51
050,17,189,"Illinois","Washington County",1,80,86,39,47
050,17,189,"Illinois","Washington County",1,81,86,36,50
050,17,189,"Illinois","Washington County",1,82,75,35,40
050,17,189,"Illinois","Washington County",1,83,57,27,30
050,17,189,"Illinois","Washington County",1,84,58,24,34
050,17,189,"Illinois","Washington County",1,85,365,150,215
050,17,189,"Illinois","Washington County",2,0,152,80,72
050,17,189,"Illinois","Washington County",2,1,155,81,74
050,17,189,"Illinois","Washington County",2,2,146,76,70
050,17,189,"Illinois","Washington County",2,3,147,73,74
050,17,189,"Illinois","Washington County",2,4,157,77,80
050,17,189,"Illinois","Washington County",2,5,161,81,80
050,17,189,"Illinois","Washington County",2,6,160,79,81
050,17,189,"Illinois","Washington County",2,7,163,80,83
050,17,189,"Illinois","Washington County",2,8,149,74,75
050,17,189,"Illinois","Washington County",2,9,140,69,71
050,17,189,"Illinois","Washington County",2,10,134,64,70
050,17,189,"Illinois","Washington County",2,11,159,72,87
050,17,189,"Illinois","Washington County",2,12,166,78,88
050,17,189,"Illinois","Washington County",2,13,178,90,88
050,17,189,"Illinois","Washington County",2,14,192,96,96
050,17,189,"Illinois","Washington County",2,15,196,100,96
050,17,189,"Illinois","Washington County",2,16,196,99,97
050,17,189,"Illinois","Washington County",2,17,187,92,95
050,17,189,"Illinois","Washington County",2,18,160,87,73
050,17,189,"Illinois","Washington County",2,19,118,61,57
050,17,189,"Illinois","Washington County",2,20,119,55,64
050,17,189,"Illinois","Washington County",2,21,119,60,59
050,17,189,"Illinois","Washington County",2,22,126,69,57
050,17,189,"Illinois","Washington County",2,23,129,67,62
050,17,189,"Illinois","Washington County",2,24,134,71,63
050,17,189,"Illinois","Washington County",2,25,137,68,69
050,17,189,"Illinois","Washington County",2,26,145,71,74
050,17,189,"Illinois","Washington County",2,27,140,71,69
050,17,189,"Illinois","Washington County",2,28,150,83,67
050,17,189,"Illinois","Washington County",2,29,162,83,79
050,17,189,"Illinois","Washington County",2,30,159,76,83
050,17,189,"Illinois","Washington County",2,31,159,76,83
050,17,189,"Illinois","Washington County",2,32,166,83,83
050,17,189,"Illinois","Washington County",2,33,166,89,77
050,17,189,"Illinois","Washington County",2,34,168,85,83
050,17,189,"Illinois","Washington County",2,35,154,72,82
050,17,189,"Illinois","Washington County",2,36,144,74,70
050,17,189,"Illinois","Washington County",2,37,151,79,72
050,17,189,"Illinois","Washington County",2,38,153,86,67
050,17,189,"Illinois","Washington County",2,39,165,84,81
050,17,189,"Illinois","Washington County",2,40,184,92,92
050,17,189,"Illinois","Washington County",2,41,175,88,87
050,17,189,"Illinois","Washington County",2,42,172,84,88
050,17,189,"Illinois","Washington County",2,43,169,84,85
050,17,189,"Illinois","Washington County",2,44,161,83,78
050,17,189,"Illinois","Washington County",2,45,163,86,77
050,17,189,"Illinois","Washington County",2,46,156,89,67
050,17,189,"Illinois","Washington County",2,47,151,85,66
050,17,189,"Illinois","Washington County",2,48,166,87,79
050,17,189,"Illinois","Washington County",2,49,190,97,93
050,17,189,"Illinois","Washington County",2,50,181,89,92
050,17,189,"Illinois","Washington County",2,51,172,88,84
050,17,189,"Illinois","Washington County",2,52,169,85,84
050,17,189,"Illinois","Washington County",2,53,164,84,80
050,17,189,"Illinois","Washington County",2,54,183,95,88
050,17,189,"Illinois","Washington County",2,55,202,105,97
050,17,189,"Illinois","Washington County",2,56,212,106,106
050,17,189,"Illinois","Washington County",2,57,222,110,112
050,17,189,"Illinois","Washington County",2,58,225,113,112
050,17,189,"Illinois","Washington County",2,59,220,109,111
050,17,189,"Illinois","Washington County",2,60,222,110,112
050,17,189,"Illinois","Washington County",2,61,231,117,114
050,17,189,"Illinois","Washington County",2,62,231,120,111
050,17,189,"Illinois","Washington County",2,63,212,110,102
050,17,189,"Illinois","Washington County",2,64,202,107,95
050,17,189,"Illinois","Washington County",2,65,196,110,86
050,17,189,"Illinois","Washington County",2,66,194,109,85
050,17,189,"Illinois","Washington County",2,67,190,100,90
050,17,189,"Illinois","Washington County",2,68,183,99,84
050,17,189,"Illinois","Washington County",2,69,171,96,75
050,17,189,"Illinois","Washington County",2,70,144,80,64
050,17,189,"Illinois","Washington County",2,71,132,65,67
050,17,189,"Illinois","Washington County",2,72,140,68,72
050,17,189,"Illinois","Washington County",2,73,151,77,74
050,17,189,"Illinois","Washington County",2,74,108,52,56
050,17,189,"Illinois","Washington County",2,75,109,51,58
050,17,189,"Illinois","Washington County",2,76,114,48,66
050,17,189,"Illinois","Washington County",2,77,97,43,54
050,17,189,"Illinois","Washington County",2,78,86,40,46
050,17,189,"Illinois","Washington County",2,79,87,37,50
050,17,189,"Illinois","Washington County",2,80,85,38,47
050,17,189,"Illinois","Washington County",2,81,82,37,45
050,17,189,"Illinois","Washington County",2,82,75,33,42
050,17,189,"Illinois","Washington County",2,83,61,28,33
050,17,189,"Illinois","Washington County",2,84,57,25,32
050,17,189,"Illinois","Washington County",2,85,364,149,215
050,17,189,"Illinois","Washington County",3,0,126,69,57
050,17,189,"Illinois","Washington County",3,1,160,86,74
050,17,189,"Illinois","Washington County",3,2,148,76,72
050,17,189,"Illinois","Washington County",3,3,152,85,67
050,17,189,"Illinois","Washington County",3,4,148,79,69
050,17,189,"Illinois","Washington County",3,5,152,77,75
050,17,189,"Illinois","Washington County",3,6,147,77,70
050,17,189,"Illinois","Washington County",3,7,171,83,88
050,17,189,"Illinois","Washington County",3,8,163,77,86
050,17,189,"Illinois","Washington County",3,9,152,77,75
050,17,189,"Illinois","Washington County",3,10,134,62,72
050,17,189,"Illinois","Washington County",3,11,142,68,74
050,17,189,"Illinois","Washington County",3,12,159,71,88
050,17,189,"Illinois","Washington County",3,13,152,73,79
050,17,189,"Illinois","Washington County",3,14,179,94,85
050,17,189,"Illinois","Washington County",3,15,199,102,97
050,17,189,"Illinois","Washington County",3,16,191,97,94
050,17,189,"Illinois","Washington County",3,17,197,102,95
050,17,189,"Illinois","Washington County",3,18,159,88,71
050,17,189,"Illinois","Washington County",3,19,114,61,53
050,17,189,"Illinois","Washington County",3,20,129,66,63
050,17,189,"Illinois","Washington County",3,21,124,57,67
050,17,189,"Illinois","Washington County",3,22,121,57,64
050,17,189,"Illinois","Washington County",3,23,122,68,54
050,17,189,"Illinois","Washington County",3,24,131,71,60
050,17,189,"Illinois","Washington County",3,25,134,72,62
050,17,189,"Illinois","Washington County",3,26,137,67,70
050,17,189,"Illinois","Washington County",3,27,144,75,69
050,17,189,"Illinois","Washington County",3,28,138,65,73
050,17,189,"Illinois","Washington County",3,29,148,77,71
050,17,189,"Illinois","Washington County",3,30,171,84,87
050,17,189,"Illinois","Washington County",3,31,161,78,83
050,17,189,"Illinois","Washington County",3,32,158,78,80
050,17,189,"Illinois","Washington County",3,33,168,89,79
050,17,189,"Illinois","Washington County",3,34,171,95,76
050,17,189,"Illinois","Washington County",3,35,173,91,82
050,17,189,"Illinois","Washington County",3,36,154,73,81
050,17,189,"Illinois","Washington County",3,37,151,78,73
050,17,189,"Illinois","Washington County",3,38,151,77,74
050,17,189,"Illinois","Washington County",3,39,156,84,72
050,17,189,"Illinois","Washington County",3,40,171,87,84
050,17,189,"Illinois","Washington County",3,41,183,93,90
050,17,189,"Illinois","Washington County",3,42,171,84,87
050,17,189,"Illinois","Washington County",3,43,180,92,88
050,17,189,"Illinois","Washington County",3,44,174,85,89
050,17,189,"Illinois","Washington County",3,45,151,78,73
050,17,189,"Illinois","Washington County",3,46,166,90,76
050,17,189,"Illinois","Washington County",3,47,158,90,68
050,17,189,"Illinois","Washington County",3,48,145,83,62
050,17,189,"Illinois","Washington County",3,49,160,84,76
050,17,189,"Illinois","Washington County",3,50,197,100,97
050,17,189,"Illinois","Washington County",3,51,189,93,96
050,17,189,"Illinois","Washington County",3,52,171,86,85
050,17,189,"Illinois","Washington County",3,53,170,84,86
050,17,189,"Illinois","Washington County",3,54,159,81,78
050,17,189,"Illinois","Washington County",3,55,181,93,88
050,17,189,"Illinois","Washington County",3,56,195,101,94
050,17,189,"Illinois","Washington County",3,57,214,108,106
050,17,189,"Illinois","Washington County",3,58,217,104,113
050,17,189,"Illinois","Washington County",3,59,220,110,110
050,17,189,"Illinois","Washington County",3,60,219,108,111
050,17,189,"Illinois","Washington County",3,61,221,110,111
050,17,189,"Illinois","Washington County",3,62,229,117,112
050,17,189,"Illinois","Washington County",3,63,227,117,110
050,17,189,"Illinois","Washington County",3,64,210,110,100
050,17,189,"Illinois","Washington County",3,65,201,107,94
050,17,189,"Illinois","Washington County",3,66,196,108,88
050,17,189,"Illinois","Washington County",3,67,189,107,82
050,17,189,"Illinois","Washington County",3,68,185,98,87
050,17,189,"Illinois","Washington County",3,69,185,99,86
050,17,189,"Illinois","Washington County",3,70,168,95,73
050,17,189,"Illinois","Washington County",3,71,142,79,63
050,17,189,"Illinois","Washington County",3,72,128,62,66
050,17,189,"Illinois","Washington County",3,73,136,66,70
050,17,189,"Illinois","Washington County",3,74,146,73,73
050,17,189,"Illinois","Washington County",3,75,101,50,51
050,17,189,"Illinois","Washington County",3,76,112,49,63
050,17,189,"Illinois","Washington County",3,77,100,43,57
050,17,189,"Illinois","Washington County",3,78,96,41,55
050,17,189,"Illinois","Washington County",3,79,76,31,45
050,17,189,"Illinois","Washington County",3,80,74,31,43
050,17,189,"Illinois","Washington County",3,81,83,38,45
050,17,189,"Illinois","Washington County",3,82,80,36,44
050,17,189,"Illinois","Washington County",3,83,70,29,41
050,17,189,"Illinois","Washington County",3,84,57,26,31
050,17,189,"Illinois","Washington County",3,85,350,142,208
050,17,189,"Illinois","Washington County",4,0,115,61,54
050,17,189,"Illinois","Washington County",4,1,137,77,60
050,17,189,"Illinois","Washington County",4,2,156,80,76
050,17,189,"Illinois","Washington County",4,3,155,84,71
050,17,189,"Illinois","Washington County",4,4,151,81,70
050,17,189,"Illinois","Washington County",4,5,142,79,63
050,17,189,"Illinois","Washington County",4,6,152,76,76
050,17,189,"Illinois","Washington County",4,7,155,83,72
050,17,189,"Illinois","Washington County",4,8,171,87,84
050,17,189,"Illinois","Washington County",4,9,163,79,84
050,17,189,"Illinois","Washington County",4,10,155,77,78
050,17,189,"Illinois","Washington County",4,11,149,68,81
050,17,189,"Illinois","Washington County",4,12,142,67,75
050,17,189,"Illinois","Washington County",4,13,167,77,90
050,17,189,"Illinois","Washington County",4,14,156,75,81
050,17,189,"Illinois","Washington County",4,15,186,96,90
050,17,189,"Illinois","Washington County",4,16,187,91,96
050,17,189,"Illinois","Washington County",4,17,199,100,99
050,17,189,"Illinois","Washington County",4,18,167,93,74
050,17,189,"Illinois","Washington County",4,19,125,66,59
050,17,189,"Illinois","Washington County",4,20,114,58,56
050,17,189,"Illinois","Washington County",4,21,126,64,62
050,17,189,"Illinois","Washington County",4,22,124,60,64
050,17,189,"Illinois","Washington County",4,23,117,60,57
050,17,189,"Illinois","Washington County",4,24,126,68,58
050,17,189,"Illinois","Washington County",4,25,130,71,59
050,17,189,"Illinois","Washington County",4,26,144,80,64
050,17,189,"Illinois","Washington County",4,27,138,74,64
050,17,189,"Illinois","Washington County",4,28,144,74,70
050,17,189,"Illinois","Washington County",4,29,137,64,73
050,17,189,"Illinois","Washington County",4,30,149,77,72
050,17,189,"Illinois","Washington County",4,31,171,87,84
050,17,189,"Illinois","Washington County",4,32,172,84,88
050,17,189,"Illinois","Washington County",4,33,159,78,81
050,17,189,"Illinois","Washington County",4,34,168,89,79
050,17,189,"Illinois","Washington County",4,35,172,93,79
050,17,189,"Illinois","Washington County",4,36,183,95,88
050,17,189,"Illinois","Washington County",4,37,150,73,77
050,17,189,"Illinois","Washington County",4,38,149,73,76
050,17,189,"Illinois","Washington County",4,39,153,77,76
050,17,189,"Illinois","Washington County",4,40,160,89,71
050,17,189,"Illinois","Washington County",4,41,173,86,87
050,17,189,"Illinois","Washington County",4,42,179,92,87
050,17,189,"Illinois","Washington County",4,43,174,87,87
050,17,189,"Illinois","Washington County",4,44,176,89,87
050,17,189,"Illinois","Washington County",4,45,177,88,89
050,17,189,"Illinois","Washington County",4,46,156,82,74
050,17,189,"Illinois","Washington County",4,47,159,84,75
050,17,189,"Illinois","Washington County",4,48,165,91,74
050,17,189,"Illinois","Washington County",4,49,141,80,61
050,17,189,"Illinois","Washington County",4,50,159,81,78
050,17,189,"Illinois","Washington County",4,51,195,99,96
050,17,189,"Illinois","Washington County",4,52,189,88,101
050,17,189,"Illinois","Washington County",4,53,168,86,82
050,17,189,"Illinois","Washington County",4,54,168,84,84
050,17,189,"Illinois","Washington County",4,55,159,81,78
050,17,189,"Illinois","Washington County",4,56,179,93,86
050,17,189,"Illinois","Washington County",4,57,196,103,93
050,17,189,"Illinois","Washington County",4,58,213,106,107
050,17,189,"Illinois","Washington County",4,59,209,100,109
050,17,189,"Illinois","Washington County",4,60,226,116,110
050,17,189,"Illinois","Washington County",4,61,216,107,109
050,17,189,"Illinois","Washington County",4,62,220,112,108
050,17,189,"Illinois","Washington County",4,63,231,115,116
050,17,189,"Illinois","Washington County",4,64,224,112,112
050,17,189,"Illinois","Washington County",4,65,207,109,98
050,17,189,"Illinois","Washington County",4,66,199,103,96
050,17,189,"Illinois","Washington County",4,67,192,107,85
050,17,189,"Illinois","Washington County",4,68,194,111,83
050,17,189,"Illinois","Washington County",4,69,185,99,86
050,17,189,"Illinois","Washington County",4,70,180,94,86
050,17,189,"Illinois","Washington County",4,71,162,92,70
050,17,189,"Illinois","Washington County",4,72,142,78,64
050,17,189,"Illinois","Washington County",4,73,117,58,59
050,17,189,"Illinois","Washington County",4,74,135,65,70
050,17,189,"Illinois","Washington County",4,75,143,73,70
050,17,189,"Illinois","Washington County",4,76,104,46,58
050,17,189,"Illinois","Washington County",4,77,98,44,54
050,17,189,"Illinois","Washington County",4,78,96,39,57
050,17,189,"Illinois","Washington County",4,79,92,34,58
050,17,189,"Illinois","Washington County",4,80,71,33,38
050,17,189,"Illinois","Washington County",4,81,70,28,42
050,17,189,"Illinois","Washington County",4,82,77,36,41
050,17,189,"Illinois","Washington County",4,83,72,30,42
050,17,189,"Illinois","Washington County",4,84,71,29,42
050,17,189,"Illinois","Washington County",4,85,348,144,204
050,17,189,"Illinois","Washington County",5,0,107,57,50
050,17,189,"Illinois","Washington County",5,1,109,63,46
050,17,189,"Illinois","Washington County",5,2,127,73,54
050,17,189,"Illinois","Washington County",5,3,151,75,76
050,17,189,"Illinois","Washington County",5,4,161,83,78
050,17,189,"Illinois","Washington County",5,5,146,81,65
050,17,189,"Illinois","Washington County",5,6,132,75,57
050,17,189,"Illinois","Washington County",5,7,158,80,78
050,17,189,"Illinois","Washington County",5,8,159,85,74
050,17,189,"Illinois","Washington County",5,9,177,86,91
050,17,189,"Illinois","Washington County",5,10,160,77,83
050,17,189,"Illinois","Washington County",5,11,154,79,75
050,17,189,"Illinois","Washington County",5,12,147,66,81
050,17,189,"Illinois","Washington County",5,13,145,69,76
050,17,189,"Illinois","Washington County",5,14,171,80,91
050,17,189,"Illinois","Washington County",5,15,158,72,86
050,17,189,"Illinois","Washington County",5,16,175,93,82
050,17,189,"Illinois","Washington County",5,17,194,98,96
050,17,189,"Illinois","Washington County",5,18,167,93,74
050,17,189,"Illinois","Washington County",5,19,130,72,58
050,17,189,"Illinois","Washington County",5,20,129,67,62
050,17,189,"Illinois","Washington County",5,21,125,62,63
050,17,189,"Illinois","Washington County",5,22,142,65,77
050,17,189,"Illinois","Washington County",5,23,137,69,68
050,17,189,"Illinois","Washington County",5,24,116,60,56
050,17,189,"Illinois","Washington County",5,25,131,76,55
050,17,189,"Illinois","Washington County",5,26,132,80,52
050,17,189,"Illinois","Washington County",5,27,145,77,68
050,17,189,"Illinois","Washington County",5,28,133,70,63
050,17,189,"Illinois","Washington County",5,29,141,70,71
050,17,189,"Illinois","Washington County",5,30,138,66,72
050,17,189,"Illinois","Washington County",5,31,151,86,65
050,17,189,"Illinois","Washington County",5,32,175,88,87
050,17,189,"Illinois","Washington County",5,33,175,89,86
050,17,189,"Illinois","Washington County",5,34,164,84,80
050,17,189,"Illinois","Washington County",5,35,169,91,78
050,17,189,"Illinois","Washington County",5,36,167,90,77
050,17,189,"Illinois","Washington County",5,37,183,94,89
050,17,189,"Illinois","Washington County",5,38,153,76,77
050,17,189,"Illinois","Washington County",5,39,147,68,79
050,17,189,"Illinois","Washington County",5,40,149,75,74
050,17,189,"Illinois","Washington County",5,41,158,88,70
050,17,189,"Illinois","Washington County",5,42,169,84,85
050,17,189,"Illinois","Washington County",5,43,185,90,95
050,17,189,"Illinois","Washington County",5,44,163,79,84
050,17,189,"Illinois","Washington County",5,45,173,89,84
050,17,189,"Illinois","Washington County",5,46,189,95,94
050,17,189,"Illinois","Washington County",5,47,163,85,78
050,17,189,"Illinois","Washington County",5,48,155,81,74
050,17,189,"Illinois","Washington County",5,49,157,88,69
050,17,189,"Illinois","Washington County",5,50,146,81,65
050,17,189,"Illinois","Washington County",5,51,161,85,76
050,17,189,"Illinois","Washington County",5,52,192,92,100
050,17,189,"Illinois","Washington County",5,53,185,84,101
050,17,189,"Illinois","Washington County",5,54,171,91,80
050,17,189,"Illinois","Washington County",5,55,160,79,81
050,17,189,"Illinois","Washington County",5,56,165,82,83
050,17,189,"Illinois","Washington County",5,57,174,90,84
050,17,189,"Illinois","Washington County",5,58,203,105,98
050,17,189,"Illinois","Washington County",5,59,217,108,109
050,17,189,"Illinois","Washington County",5,60,213,97,116
050,17,189,"Illinois","Washington County",5,61,223,114,109
050,17,189,"Illinois","Washington County",5,62,213,108,105
050,17,189,"Illinois","Washington County",5,63,214,108,106
050,17,189,"Illinois","Washington County",5,64,219,108,111
050,17,189,"Illinois","Washington County",5,65,221,108,113
050,17,189,"Illinois","Washington County",5,66,204,107,97
050,17,189,"Illinois","Washington County",5,67,192,101,91
050,17,189,"Illinois","Washington County",5,68,189,106,83
050,17,189,"Illinois","Washington County",5,69,197,111,86
050,17,189,"Illinois","Washington County",5,70,177,92,85
050,17,189,"Illinois","Washington County",5,71,176,92,84
050,17,189,"Illinois","Washington County",5,72,160,91,69
050,17,189,"Illinois","Washington County",5,73,137,76,61
050,17,189,"Illinois","Washington County",5,74,116,56,60
050,17,189,"Illinois","Washington County",5,75,131,66,65
050,17,189,"Illinois","Washington County",5,76,144,68,76
050,17,189,"Illinois","Washington County",5,77,95,45,50
050,17,189,"Illinois","Washington County",5,78,99,43,56
050,17,189,"Illinois","Washington County",5,79,88,32,56
050,17,189,"Illinois","Washington County",5,80,83,35,48
050,17,189,"Illinois","Washington County",5,81,66,31,35
050,17,189,"Illinois","Washington County",5,82,64,25,39
050,17,189,"Illinois","Washington County",5,83,67,29,38
050,17,189,"Illinois","Washington County",5,84,70,30,40
050,17,189,"Illinois","Washington County",5,85,362,149,213
050,17,191,"Illinois","Wayne County",1,0,201,100,101
050,17,191,"Illinois","Wayne County",1,1,195,93,102
050,17,191,"Illinois","Wayne County",1,2,180,87,93
050,17,191,"Illinois","Wayne County",1,3,189,91,98
050,17,191,"Illinois","Wayne County",1,4,211,99,112
050,17,191,"Illinois","Wayne County",1,5,203,98,105
050,17,191,"Illinois","Wayne County",1,6,214,115,99
050,17,191,"Illinois","Wayne County",1,7,192,94,98
050,17,191,"Illinois","Wayne County",1,8,211,106,105
050,17,191,"Illinois","Wayne County",1,9,199,91,108
050,17,191,"Illinois","Wayne County",1,10,195,100,95
050,17,191,"Illinois","Wayne County",1,11,218,121,97
050,17,191,"Illinois","Wayne County",1,12,216,114,102
050,17,191,"Illinois","Wayne County",1,13,217,104,113
050,17,191,"Illinois","Wayne County",1,14,198,107,91
050,17,191,"Illinois","Wayne County",1,15,219,113,106
050,17,191,"Illinois","Wayne County",1,16,216,107,109
050,17,191,"Illinois","Wayne County",1,17,209,105,104
050,17,191,"Illinois","Wayne County",1,18,178,93,85
050,17,191,"Illinois","Wayne County",1,19,143,70,73
050,17,191,"Illinois","Wayne County",1,20,158,87,71
050,17,191,"Illinois","Wayne County",1,21,141,76,65
050,17,191,"Illinois","Wayne County",1,22,159,83,76
050,17,191,"Illinois","Wayne County",1,23,150,73,77
050,17,191,"Illinois","Wayne County",1,24,152,76,76
050,17,191,"Illinois","Wayne County",1,25,167,81,86
050,17,191,"Illinois","Wayne County",1,26,176,95,81
050,17,191,"Illinois","Wayne County",1,27,181,98,83
050,17,191,"Illinois","Wayne County",1,28,185,105,80
050,17,191,"Illinois","Wayne County",1,29,186,96,90
050,17,191,"Illinois","Wayne County",1,30,185,93,92
050,17,191,"Illinois","Wayne County",1,31,171,82,89
050,17,191,"Illinois","Wayne County",1,32,184,91,93
050,17,191,"Illinois","Wayne County",1,33,175,94,81
050,17,191,"Illinois","Wayne County",1,34,171,96,75
050,17,191,"Illinois","Wayne County",1,35,167,88,79
050,17,191,"Illinois","Wayne County",1,36,182,94,88
050,17,191,"Illinois","Wayne County",1,37,181,90,91
050,17,191,"Illinois","Wayne County",1,38,172,84,88
050,17,191,"Illinois","Wayne County",1,39,196,90,106
050,17,191,"Illinois","Wayne County",1,40,212,109,103
050,17,191,"Illinois","Wayne County",1,41,233,99,134
050,17,191,"Illinois","Wayne County",1,42,202,100,102
050,17,191,"Illinois","Wayne County",1,43,153,76,77
050,17,191,"Illinois","Wayne County",1,44,162,87,75
050,17,191,"Illinois","Wayne County",1,45,177,88,89
050,17,191,"Illinois","Wayne County",1,46,179,90,89
050,17,191,"Illinois","Wayne County",1,47,185,93,92
050,17,191,"Illinois","Wayne County",1,48,186,95,91
050,17,191,"Illinois","Wayne County",1,49,218,105,113
050,17,191,"Illinois","Wayne County",1,50,190,93,97
050,17,191,"Illinois","Wayne County",1,51,177,92,85
050,17,191,"Illinois","Wayne County",1,52,197,105,92
050,17,191,"Illinois","Wayne County",1,53,205,102,103
050,17,191,"Illinois","Wayne County",1,54,221,109,112
050,17,191,"Illinois","Wayne County",1,55,210,104,106
050,17,191,"Illinois","Wayne County",1,56,222,108,114
050,17,191,"Illinois","Wayne County",1,57,238,122,116
050,17,191,"Illinois","Wayne County",1,58,239,119,120
050,17,191,"Illinois","Wayne County",1,59,247,121,126
050,17,191,"Illinois","Wayne County",1,60,234,122,112
050,17,191,"Illinois","Wayne County",1,61,243,132,111
050,17,191,"Illinois","Wayne County",1,62,236,126,110
050,17,191,"Illinois","Wayne County",1,63,228,115,113
050,17,191,"Illinois","Wayne County",1,64,223,113,110
050,17,191,"Illinois","Wayne County",1,65,231,118,113
050,17,191,"Illinois","Wayne County",1,66,209,102,107
050,17,191,"Illinois","Wayne County",1,67,198,97,101
050,17,191,"Illinois","Wayne County",1,68,194,97,97
050,17,191,"Illinois","Wayne County",1,69,199,89,110
050,17,191,"Illinois","Wayne County",1,70,192,95,97
050,17,191,"Illinois","Wayne County",1,71,175,87,88
050,17,191,"Illinois","Wayne County",1,72,185,89,96
050,17,191,"Illinois","Wayne County",1,73,181,86,95
050,17,191,"Illinois","Wayne County",1,74,144,71,73
050,17,191,"Illinois","Wayne County",1,75,140,64,76
050,17,191,"Illinois","Wayne County",1,76,152,64,88
050,17,191,"Illinois","Wayne County",1,77,140,61,79
050,17,191,"Illinois","Wayne County",1,78,125,59,66
050,17,191,"Illinois","Wayne County",1,79,118,54,64
050,17,191,"Illinois","Wayne County",1,80,112,51,61
050,17,191,"Illinois","Wayne County",1,81,115,57,58
050,17,191,"Illinois","Wayne County",1,82,112,52,60
050,17,191,"Illinois","Wayne County",1,83,91,41,50
050,17,191,"Illinois","Wayne County",1,84,78,37,41
050,17,191,"Illinois","Wayne County",1,85,422,154,268
050,17,191,"Illinois","Wayne County",2,0,182,89,93
050,17,191,"Illinois","Wayne County",2,1,194,94,100
050,17,191,"Illinois","Wayne County",2,2,182,88,94
050,17,191,"Illinois","Wayne County",2,3,184,89,95
050,17,191,"Illinois","Wayne County",2,4,206,97,109
050,17,191,"Illinois","Wayne County",2,5,207,99,108
050,17,191,"Illinois","Wayne County",2,6,211,111,100
050,17,191,"Illinois","Wayne County",2,7,197,99,98
050,17,191,"Illinois","Wayne County",2,8,205,103,102
050,17,191,"Illinois","Wayne County",2,9,200,93,107
050,17,191,"Illinois","Wayne County",2,10,195,98,97
050,17,191,"Illinois","Wayne County",2,11,211,115,96
050,17,191,"Illinois","Wayne County",2,12,216,114,102
050,17,191,"Illinois","Wayne County",2,13,217,107,110
050,17,191,"Illinois","Wayne County",2,14,205,108,97
050,17,191,"Illinois","Wayne County",2,15,213,111,102
050,17,191,"Illinois","Wayne County",2,16,215,108,107
050,17,191,"Illinois","Wayne County",2,17,209,104,105
050,17,191,"Illinois","Wayne County",2,18,179,94,85
050,17,191,"Illinois","Wayne County",2,19,145,72,73
050,17,191,"Illinois","Wayne County",2,20,156,84,72
050,17,191,"Illinois","Wayne County",2,21,146,79,67
050,17,191,"Illinois","Wayne County",2,22,154,81,73
050,17,191,"Illinois","Wayne County",2,23,154,77,77
050,17,191,"Illinois","Wayne County",2,24,152,75,77
050,17,191,"Illinois","Wayne County",2,25,166,81,85
050,17,191,"Illinois","Wayne County",2,26,175,92,83
050,17,191,"Illinois","Wayne County",2,27,180,98,82
050,17,191,"Illinois","Wayne County",2,28,182,102,80
050,17,191,"Illinois","Wayne County",2,29,185,97,88
050,17,191,"Illinois","Wayne County",2,30,188,94,94
050,17,191,"Illinois","Wayne County",2,31,175,86,89
050,17,191,"Illinois","Wayne County",2,32,180,89,91
050,17,191,"Illinois","Wayne County",2,33,176,92,84
050,17,191,"Illinois","Wayne County",2,34,171,95,76
050,17,191,"Illinois","Wayne County",2,35,169,90,79
050,17,191,"Illinois","Wayne County",2,36,177,92,85
050,17,191,"Illinois","Wayne County",2,37,182,92,90
050,17,191,"Illinois","Wayne County",2,38,176,86,90
050,17,191,"Illinois","Wayne County",2,39,188,88,100
050,17,191,"Illinois","Wayne County",2,40,210,106,104
050,17,191,"Illinois","Wayne County",2,41,229,102,127
050,17,191,"Illinois","Wayne County",2,42,206,99,107
050,17,191,"Illinois","Wayne County",2,43,163,82,81
050,17,191,"Illinois","Wayne County",2,44,160,84,76
050,17,191,"Illinois","Wayne County",2,45,174,88,86
050,17,191,"Illinois","Wayne County",2,46,179,89,90
050,17,191,"Illinois","Wayne County",2,47,183,92,91
050,17,191,"Illinois","Wayne County",2,48,188,95,93
050,17,191,"Illinois","Wayne County",2,49,211,103,108
050,17,191,"Illinois","Wayne County",2,50,196,96,100
050,17,191,"Illinois","Wayne County",2,51,179,92,87
050,17,191,"Illinois","Wayne County",2,52,191,101,90
050,17,191,"Illinois","Wayne County",2,53,202,102,100
050,17,191,"Illinois","Wayne County",2,54,217,108,109
050,17,191,"Illinois","Wayne County",2,55,214,105,109
050,17,191,"Illinois","Wayne County",2,56,219,107,112
050,17,191,"Illinois","Wayne County",2,57,234,119,115
050,17,191,"Illinois","Wayne County",2,58,239,120,119
050,17,191,"Illinois","Wayne County",2,59,245,121,124
050,17,191,"Illinois","Wayne County",2,60,235,121,114
050,17,191,"Illinois","Wayne County",2,61,239,130,109
050,17,191,"Illinois","Wayne County",2,62,235,125,110
050,17,191,"Illinois","Wayne County",2,63,230,119,111
050,17,191,"Illinois","Wayne County",2,64,221,112,109
050,17,191,"Illinois","Wayne County",2,65,227,115,112
050,17,191,"Illinois","Wayne County",2,66,213,106,107
050,17,191,"Illinois","Wayne County",2,67,198,97,101
050,17,191,"Illinois","Wayne County",2,68,192,95,97
050,17,191,"Illinois","Wayne County",2,69,198,91,107
050,17,191,"Illinois","Wayne County",2,70,191,91,100
050,17,191,"Illinois","Wayne County",2,71,179,89,90
050,17,191,"Illinois","Wayne County",2,72,182,89,93
050,17,191,"Illinois","Wayne County",2,73,187,90,97
050,17,191,"Illinois","Wayne County",2,74,142,69,73
050,17,191,"Illinois","Wayne County",2,75,139,65,74
050,17,191,"Illinois","Wayne County",2,76,146,62,84
050,17,191,"Illinois","Wayne County",2,77,144,62,82
050,17,191,"Illinois","Wayne County",2,78,125,58,67
050,17,191,"Illinois","Wayne County",2,79,119,54,65
050,17,191,"Illinois","Wayne County",2,80,111,51,60
050,17,191,"Illinois","Wayne County",2,81,113,55,58
050,17,191,"Illinois","Wayne County",2,82,112,53,59
050,17,191,"Illinois","Wayne County",2,83,93,43,50
050,17,191,"Illinois","Wayne County",2,84,83,39,44
050,17,191,"Illinois","Wayne County",2,85,428,159,269
050,17,191,"Illinois","Wayne County",3,0,179,89,90
050,17,191,"Illinois","Wayne County",3,1,195,97,98
050,17,191,"Illinois","Wayne County",3,2,194,94,100
050,17,191,"Illinois","Wayne County",3,3,180,86,94
050,17,191,"Illinois","Wayne County",3,4,190,98,92
050,17,191,"Illinois","Wayne County",3,5,202,95,107
050,17,191,"Illinois","Wayne County",3,6,209,104,105
050,17,191,"Illinois","Wayne County",3,7,199,104,95
050,17,191,"Illinois","Wayne County",3,8,205,104,101
050,17,191,"Illinois","Wayne County",3,9,198,100,98
050,17,191,"Illinois","Wayne County",3,10,199,95,104
050,17,191,"Illinois","Wayne County",3,11,202,106,96
050,17,191,"Illinois","Wayne County",3,12,205,108,97
050,17,191,"Illinois","Wayne County",3,13,218,117,101
050,17,191,"Illinois","Wayne County",3,14,213,109,104
050,17,191,"Illinois","Wayne County",3,15,198,106,92
050,17,191,"Illinois","Wayne County",3,16,205,108,97
050,17,191,"Illinois","Wayne County",3,17,216,110,106
050,17,191,"Illinois","Wayne County",3,18,170,87,83
050,17,191,"Illinois","Wayne County",3,19,142,76,66
050,17,191,"Illinois","Wayne County",3,20,162,82,80
050,17,191,"Illinois","Wayne County",3,21,152,82,70
050,17,191,"Illinois","Wayne County",3,22,154,82,72
050,17,191,"Illinois","Wayne County",3,23,150,82,68
050,17,191,"Illinois","Wayne County",3,24,158,80,78
050,17,191,"Illinois","Wayne County",3,25,149,67,82
050,17,191,"Illinois","Wayne County",3,26,163,79,84
050,17,191,"Illinois","Wayne County",3,27,178,103,75
050,17,191,"Illinois","Wayne County",3,28,186,97,89
050,17,191,"Illinois","Wayne County",3,29,178,97,81
050,17,191,"Illinois","Wayne County",3,30,182,95,87
050,17,191,"Illinois","Wayne County",3,31,187,92,95
050,17,191,"Illinois","Wayne County",3,32,179,91,88
050,17,191,"Illinois","Wayne County",3,33,173,84,89
050,17,191,"Illinois","Wayne County",3,34,177,94,83
050,17,191,"Illinois","Wayne County",3,35,174,95,79
050,17,191,"Illinois","Wayne County",3,36,176,95,81
050,17,191,"Illinois","Wayne County",3,37,171,94,77
050,17,191,"Illinois","Wayne County",3,38,182,91,91
050,17,191,"Illinois","Wayne County",3,39,173,89,84
050,17,191,"Illinois","Wayne County",3,40,181,82,99
050,17,191,"Illinois","Wayne County",3,41,211,103,108
050,17,191,"Illinois","Wayne County",3,42,225,100,125
050,17,191,"Illinois","Wayne County",3,43,189,93,96
050,17,191,"Illinois","Wayne County",3,44,164,78,86
050,17,191,"Illinois","Wayne County",3,45,153,81,72
050,17,191,"Illinois","Wayne County",3,46,181,91,90
050,17,191,"Illinois","Wayne County",3,47,181,91,90
050,17,191,"Illinois","Wayne County",3,48,183,92,91
050,17,191,"Illinois","Wayne County",3,49,192,95,97
050,17,191,"Illinois","Wayne County",3,50,207,101,106
050,17,191,"Illinois","Wayne County",3,51,195,95,100
050,17,191,"Illinois","Wayne County",3,52,175,91,84
050,17,191,"Illinois","Wayne County",3,53,190,101,89
050,17,191,"Illinois","Wayne County",3,54,195,101,94
050,17,191,"Illinois","Wayne County",3,55,221,108,113
050,17,191,"Illinois","Wayne County",3,56,208,104,104
050,17,191,"Illinois","Wayne County",3,57,215,106,109
050,17,191,"Illinois","Wayne County",3,58,239,121,118
050,17,191,"Illinois","Wayne County",3,59,237,122,115
050,17,191,"Illinois","Wayne County",3,60,249,122,127
050,17,191,"Illinois","Wayne County",3,61,225,118,107
050,17,191,"Illinois","Wayne County",3,62,233,122,111
050,17,191,"Illinois","Wayne County",3,63,235,127,108
050,17,191,"Illinois","Wayne County",3,64,225,115,110
050,17,191,"Illinois","Wayne County",3,65,213,110,103
050,17,191,"Illinois","Wayne County",3,66,231,116,115
050,17,191,"Illinois","Wayne County",3,67,209,101,108
050,17,191,"Illinois","Wayne County",3,68,198,95,103
050,17,191,"Illinois","Wayne County",3,69,188,94,94
050,17,191,"Illinois","Wayne County",3,70,185,84,101
050,17,191,"Illinois","Wayne County",3,71,183,86,97
050,17,191,"Illinois","Wayne County",3,72,184,92,92
050,17,191,"Illinois","Wayne County",3,73,173,87,86
050,17,191,"Illinois","Wayne County",3,74,175,80,95
050,17,191,"Illinois","Wayne County",3,75,133,65,68
050,17,191,"Illinois","Wayne County",3,76,136,61,75
050,17,191,"Illinois","Wayne County",3,77,138,61,77
050,17,191,"Illinois","Wayne County",3,78,132,55,77
050,17,191,"Illinois","Wayne County",3,79,123,55,68
050,17,191,"Illinois","Wayne County",3,80,111,49,62
050,17,191,"Illinois","Wayne County",3,81,102,46,56
050,17,191,"Illinois","Wayne County",3,82,95,43,52
050,17,191,"Illinois","Wayne County",3,83,100,51,49
050,17,191,"Illinois","Wayne County",3,84,91,37,54
050,17,191,"Illinois","Wayne County",3,85,424,165,259
050,17,191,"Illinois","Wayne County",4,0,157,72,85
050,17,191,"Illinois","Wayne County",4,1,174,92,82
050,17,191,"Illinois","Wayne County",4,2,193,97,96
050,17,191,"Illinois","Wayne County",4,3,187,89,98
050,17,191,"Illinois","Wayne County",4,4,183,88,95
050,17,191,"Illinois","Wayne County",4,5,183,92,91
050,17,191,"Illinois","Wayne County",4,6,197,92,105
050,17,191,"Illinois","Wayne County",4,7,212,104,108
050,17,191,"Illinois","Wayne County",4,8,202,105,97
050,17,191,"Illinois","Wayne County",4,9,194,94,100
050,17,191,"Illinois","Wayne County",4,10,196,97,99
050,17,191,"Illinois","Wayne County",4,11,193,89,104
050,17,191,"Illinois","Wayne County",4,12,197,105,92
050,17,191,"Illinois","Wayne County",4,13,209,111,98
050,17,191,"Illinois","Wayne County",4,14,218,119,99
050,17,191,"Illinois","Wayne County",4,15,214,104,110
050,17,191,"Illinois","Wayne County",4,16,206,116,90
050,17,191,"Illinois","Wayne County",4,17,204,110,94
050,17,191,"Illinois","Wayne County",4,18,175,92,83
050,17,191,"Illinois","Wayne County",4,19,138,71,67
050,17,191,"Illinois","Wayne County",4,20,164,92,72
050,17,191,"Illinois","Wayne County",4,21,152,76,76
050,17,191,"Illinois","Wayne County",4,22,165,90,75
050,17,191,"Illinois","Wayne County",4,23,163,85,78
050,17,191,"Illinois","Wayne County",4,24,158,85,73
050,17,191,"Illinois","Wayne County",4,25,165,81,84
050,17,191,"Illinois","Wayne County",4,26,154,75,79
050,17,191,"Illinois","Wayne County",4,27,163,81,82
050,17,191,"Illinois","Wayne County",4,28,173,92,81
050,17,191,"Illinois","Wayne County",4,29,190,95,95
050,17,191,"Illinois","Wayne County",4,30,181,96,85
050,17,191,"Illinois","Wayne County",4,31,179,96,83
050,17,191,"Illinois","Wayne County",4,32,184,94,90
050,17,191,"Illinois","Wayne County",4,33,171,84,87
050,17,191,"Illinois","Wayne County",4,34,177,90,87
050,17,191,"Illinois","Wayne County",4,35,180,94,86
050,17,191,"Illinois","Wayne County",4,36,170,92,78
050,17,191,"Illinois","Wayne County",4,37,168,87,81
050,17,191,"Illinois","Wayne County",4,38,171,96,75
050,17,191,"Illinois","Wayne County",4,39,197,99,98
050,17,191,"Illinois","Wayne County",4,40,173,87,86
050,17,191,"Illinois","Wayne County",4,41,189,84,105
050,17,191,"Illinois","Wayne County",4,42,210,105,105
050,17,191,"Illinois","Wayne County",4,43,214,95,119
050,17,191,"Illinois","Wayne County",4,44,193,96,97
050,17,191,"Illinois","Wayne County",4,45,161,80,81
050,17,191,"Illinois","Wayne County",4,46,159,86,73
050,17,191,"Illinois","Wayne County",4,47,174,88,86
050,17,191,"Illinois","Wayne County",4,48,179,92,87
050,17,191,"Illinois","Wayne County",4,49,190,95,95
050,17,191,"Illinois","Wayne County",4,50,190,94,96
050,17,191,"Illinois","Wayne County",4,51,213,101,112
050,17,191,"Illinois","Wayne County",4,52,199,94,105
050,17,191,"Illinois","Wayne County",4,53,179,93,86
050,17,191,"Illinois","Wayne County",4,54,190,101,89
050,17,191,"Illinois","Wayne County",4,55,201,104,97
050,17,191,"Illinois","Wayne County",4,56,218,107,111
050,17,191,"Illinois","Wayne County",4,57,211,107,104
050,17,191,"Illinois","Wayne County",4,58,210,102,108
050,17,191,"Illinois","Wayne County",4,59,231,119,112
050,17,191,"Illinois","Wayne County",4,60,238,125,113
050,17,191,"Illinois","Wayne County",4,61,248,124,124
050,17,191,"Illinois","Wayne County",4,62,225,116,109
050,17,191,"Illinois","Wayne County",4,63,231,117,114
050,17,191,"Illinois","Wayne County",4,64,227,123,104
050,17,191,"Illinois","Wayne County",4,65,223,116,107
050,17,191,"Illinois","Wayne County",4,66,221,114,107
050,17,191,"Illinois","Wayne County",4,67,215,105,110
050,17,191,"Illinois","Wayne County",4,68,198,96,102
050,17,191,"Illinois","Wayne County",4,69,193,91,102
050,17,191,"Illinois","Wayne County",4,70,182,93,89
050,17,191,"Illinois","Wayne County",4,71,177,79,98
050,17,191,"Illinois","Wayne County",4,72,184,85,99
050,17,191,"Illinois","Wayne County",4,73,176,86,90
050,17,191,"Illinois","Wayne County",4,74,172,83,89
050,17,191,"Illinois","Wayne County",4,75,170,73,97
050,17,191,"Illinois","Wayne County",4,76,131,65,66
050,17,191,"Illinois","Wayne County",4,77,129,61,68
050,17,191,"Illinois","Wayne County",4,78,127,53,74
050,17,191,"Illinois","Wayne County",4,79,128,52,76
050,17,191,"Illinois","Wayne County",4,80,111,54,57
050,17,191,"Illinois","Wayne County",4,81,103,47,56
050,17,191,"Illinois","Wayne County",4,82,91,40,51
050,17,191,"Illinois","Wayne County",4,83,84,39,45
050,17,191,"Illinois","Wayne County",4,84,98,46,52
050,17,191,"Illinois","Wayne County",4,85,420,160,260
050,17,191,"Illinois","Wayne County",5,0,136,63,73
050,17,191,"Illinois","Wayne County",5,1,166,80,86
050,17,191,"Illinois","Wayne County",5,2,175,88,87
050,17,191,"Illinois","Wayne County",5,3,205,103,102
050,17,191,"Illinois","Wayne County",5,4,199,97,102
050,17,191,"Illinois","Wayne County",5,5,179,89,90
050,17,191,"Illinois","Wayne County",5,6,186,98,88
050,17,191,"Illinois","Wayne County",5,7,206,98,108
050,17,191,"Illinois","Wayne County",5,8,215,106,109
050,17,191,"Illinois","Wayne County",5,9,196,104,92
050,17,191,"Illinois","Wayne County",5,10,202,102,100
050,17,191,"Illinois","Wayne County",5,11,194,94,100
050,17,191,"Illinois","Wayne County",5,12,195,92,103
050,17,191,"Illinois","Wayne County",5,13,195,102,93
050,17,191,"Illinois","Wayne County",5,14,201,102,99
050,17,191,"Illinois","Wayne County",5,15,219,122,97
050,17,191,"Illinois","Wayne County",5,16,212,111,101
050,17,191,"Illinois","Wayne County",5,17,211,119,92
050,17,191,"Illinois","Wayne County",5,18,164,92,72
050,17,191,"Illinois","Wayne County",5,19,142,79,63
050,17,191,"Illinois","Wayne County",5,20,160,85,75
050,17,191,"Illinois","Wayne County",5,21,168,88,80
050,17,191,"Illinois","Wayne County",5,22,159,76,83
050,17,191,"Illinois","Wayne County",5,23,158,87,71
050,17,191,"Illinois","Wayne County",5,24,156,81,75
050,17,191,"Illinois","Wayne County",5,25,156,86,70
050,17,191,"Illinois","Wayne County",5,26,160,81,79
050,17,191,"Illinois","Wayne County",5,27,166,77,89
050,17,191,"Illinois","Wayne County",5,28,179,87,92
050,17,191,"Illinois","Wayne County",5,29,174,91,83
050,17,191,"Illinois","Wayne County",5,30,192,96,96
050,17,191,"Illinois","Wayne County",5,31,180,94,86
050,17,191,"Illinois","Wayne County",5,32,187,106,81
050,17,191,"Illinois","Wayne County",5,33,181,96,85
050,17,191,"Illinois","Wayne County",5,34,169,83,86
050,17,191,"Illinois","Wayne County",5,35,179,91,88
050,17,191,"Illinois","Wayne County",5,36,176,90,86
050,17,191,"Illinois","Wayne County",5,37,172,94,78
050,17,191,"Illinois","Wayne County",5,38,169,87,82
050,17,191,"Illinois","Wayne County",5,39,183,102,81
050,17,191,"Illinois","Wayne County",5,40,186,94,92
050,17,191,"Illinois","Wayne County",5,41,174,83,91
050,17,191,"Illinois","Wayne County",5,42,188,84,104
050,17,191,"Illinois","Wayne County",5,43,206,104,102
050,17,191,"Illinois","Wayne County",5,44,218,102,116
050,17,191,"Illinois","Wayne County",5,45,194,96,98
050,17,191,"Illinois","Wayne County",5,46,158,79,79
050,17,191,"Illinois","Wayne County",5,47,154,84,70
050,17,191,"Illinois","Wayne County",5,48,177,90,87
050,17,191,"Illinois","Wayne County",5,49,173,90,83
050,17,191,"Illinois","Wayne County",5,50,195,101,94
050,17,191,"Illinois","Wayne County",5,51,192,97,95
050,17,191,"Illinois","Wayne County",5,52,211,102,109
050,17,191,"Illinois","Wayne County",5,53,191,89,102
050,17,191,"Illinois","Wayne County",5,54,176,91,85
050,17,191,"Illinois","Wayne County",5,55,194,103,91
050,17,191,"Illinois","Wayne County",5,56,197,103,94
050,17,191,"Illinois","Wayne County",5,57,216,110,106
050,17,191,"Illinois","Wayne County",5,58,206,103,103
050,17,191,"Illinois","Wayne County",5,59,206,101,105
050,17,191,"Illinois","Wayne County",5,60,231,121,110
050,17,191,"Illinois","Wayne County",5,61,230,125,105
050,17,191,"Illinois","Wayne County",5,62,243,121,122
050,17,191,"Illinois","Wayne County",5,63,227,118,109
050,17,191,"Illinois","Wayne County",5,64,229,116,113
050,17,191,"Illinois","Wayne County",5,65,229,125,104
050,17,191,"Illinois","Wayne County",5,66,229,119,110
050,17,191,"Illinois","Wayne County",5,67,213,108,105
050,17,191,"Illinois","Wayne County",5,68,212,106,106
050,17,191,"Illinois","Wayne County",5,69,198,96,102
050,17,191,"Illinois","Wayne County",5,70,184,91,93
050,17,191,"Illinois","Wayne County",5,71,170,83,87
050,17,191,"Illinois","Wayne County",5,72,181,82,99
050,17,191,"Illinois","Wayne County",5,73,174,80,94
050,17,191,"Illinois","Wayne County",5,74,169,79,90
050,17,191,"Illinois","Wayne County",5,75,163,77,86
050,17,191,"Illinois","Wayne County",5,76,168,72,96
050,17,191,"Illinois","Wayne County",5,77,125,65,60
050,17,191,"Illinois","Wayne County",5,78,119,54,65
050,17,191,"Illinois","Wayne County",5,79,122,48,74
050,17,191,"Illinois","Wayne County",5,80,119,51,68
050,17,191,"Illinois","Wayne County",5,81,105,51,54
050,17,191,"Illinois","Wayne County",5,82,92,42,50
050,17,191,"Illinois","Wayne County",5,83,78,36,42
050,17,191,"Illinois","Wayne County",5,84,80,34,46
050,17,191,"Illinois","Wayne County",5,85,437,173,264
050,17,193,"Illinois","White County",1,0,119,62,57
050,17,193,"Illinois","White County",1,1,129,70,59
050,17,193,"Illinois","White County",1,2,159,97,62
050,17,193,"Illinois","White County",1,3,158,87,71
050,17,193,"Illinois","White County",1,4,167,86,81
050,17,193,"Illinois","White County",1,5,170,89,81
050,17,193,"Illinois","White County",1,6,160,88,72
050,17,193,"Illinois","White County",1,7,161,82,79
050,17,193,"Illinois","White County",1,8,182,87,95
050,17,193,"Illinois","White County",1,9,188,88,100
050,17,193,"Illinois","White County",1,10,186,94,92
050,17,193,"Illinois","White County",1,11,183,88,95
050,17,193,"Illinois","White County",1,12,192,95,97
050,17,193,"Illinois","White County",1,13,195,96,99
050,17,193,"Illinois","White County",1,14,168,85,83
050,17,193,"Illinois","White County",1,15,168,83,85
050,17,193,"Illinois","White County",1,16,163,84,79
050,17,193,"Illinois","White County",1,17,157,84,73
050,17,193,"Illinois","White County",1,18,143,71,72
050,17,193,"Illinois","White County",1,19,113,59,54
050,17,193,"Illinois","White County",1,20,114,66,48
050,17,193,"Illinois","White County",1,21,112,57,55
050,17,193,"Illinois","White County",1,22,121,60,61
050,17,193,"Illinois","White County",1,23,118,65,53
050,17,193,"Illinois","White County",1,24,142,72,70
050,17,193,"Illinois","White County",1,25,146,69,77
050,17,193,"Illinois","White County",1,26,127,66,61
050,17,193,"Illinois","White County",1,27,132,63,69
050,17,193,"Illinois","White County",1,28,150,75,75
050,17,193,"Illinois","White County",1,29,153,70,83
050,17,193,"Illinois","White County",1,30,137,74,63
050,17,193,"Illinois","White County",1,31,153,83,70
050,17,193,"Illinois","White County",1,32,146,68,78
050,17,193,"Illinois","White County",1,33,143,71,72
050,17,193,"Illinois","White County",1,34,161,84,77
050,17,193,"Illinois","White County",1,35,163,85,78
050,17,193,"Illinois","White County",1,36,165,80,85
050,17,193,"Illinois","White County",1,37,160,78,82
050,17,193,"Illinois","White County",1,38,187,98,89
050,17,193,"Illinois","White County",1,39,194,103,91
050,17,193,"Illinois","White County",1,40,162,77,85
050,17,193,"Illinois","White County",1,41,146,71,75
050,17,193,"Illinois","White County",1,42,155,71,84
050,17,193,"Illinois","White County",1,43,174,85,89
050,17,193,"Illinois","White County",1,44,160,79,81
050,17,193,"Illinois","White County",1,45,150,74,76
050,17,193,"Illinois","White County",1,46,139,70,69
050,17,193,"Illinois","White County",1,47,138,72,66
050,17,193,"Illinois","White County",1,48,145,74,71
050,17,193,"Illinois","White County",1,49,158,75,83
050,17,193,"Illinois","White County",1,50,177,86,91
050,17,193,"Illinois","White County",1,51,166,83,83
050,17,193,"Illinois","White County",1,52,158,89,69
050,17,193,"Illinois","White County",1,53,155,77,78
050,17,193,"Illinois","White County",1,54,196,100,96
050,17,193,"Illinois","White County",1,55,203,102,101
050,17,193,"Illinois","White County",1,56,186,92,94
050,17,193,"Illinois","White County",1,57,204,101,103
050,17,193,"Illinois","White County",1,58,234,121,113
050,17,193,"Illinois","White County",1,59,219,108,111
050,17,193,"Illinois","White County",1,60,218,107,111
050,17,193,"Illinois","White County",1,61,212,102,110
050,17,193,"Illinois","White County",1,62,208,110,98
050,17,193,"Illinois","White County",1,63,208,109,99
050,17,193,"Illinois","White County",1,64,197,96,101
050,17,193,"Illinois","White County",1,65,220,98,122
050,17,193,"Illinois","White County",1,66,186,84,102
050,17,193,"Illinois","White County",1,67,173,80,93
050,17,193,"Illinois","White County",1,68,176,85,91
050,17,193,"Illinois","White County",1,69,141,71,70
050,17,193,"Illinois","White County",1,70,152,73,79
050,17,193,"Illinois","White County",1,71,164,80,84
050,17,193,"Illinois","White County",1,72,172,90,82
050,17,193,"Illinois","White County",1,73,156,67,89
050,17,193,"Illinois","White County",1,74,118,53,65
050,17,193,"Illinois","White County",1,75,119,52,67
050,17,193,"Illinois","White County",1,76,111,52,59
050,17,193,"Illinois","White County",1,77,126,70,56
050,17,193,"Illinois","White County",1,78,109,52,57
050,17,193,"Illinois","White County",1,79,92,36,56
050,17,193,"Illinois","White County",1,80,81,34,47
050,17,193,"Illinois","White County",1,81,100,43,57
050,17,193,"Illinois","White County",1,82,107,42,65
050,17,193,"Illinois","White County",1,83,95,40,55
050,17,193,"Illinois","White County",1,84,91,37,54
050,17,193,"Illinois","White County",1,85,530,184,346
050,17,193,"Illinois","White County",2,0,113,59,54
050,17,193,"Illinois","White County",2,1,127,68,59
050,17,193,"Illinois","White County",2,2,152,91,61
050,17,193,"Illinois","White County",2,3,158,89,69
050,17,193,"Illinois","White County",2,4,163,86,77
050,17,193,"Illinois","White County",2,5,170,89,81
050,17,193,"Illinois","White County",2,6,162,89,73
050,17,193,"Illinois","White County",2,7,161,85,76
050,17,193,"Illinois","White County",2,8,175,85,90
050,17,193,"Illinois","White County",2,9,184,87,97
050,17,193,"Illinois","White County",2,10,186,92,94
050,17,193,"Illinois","White County",2,11,182,88,94
050,17,193,"Illinois","White County",2,12,191,94,97
050,17,193,"Illinois","White County",2,13,194,95,99
050,17,193,"Illinois","White County",2,14,173,86,87
050,17,193,"Illinois","White County",2,15,169,84,85
050,17,193,"Illinois","White County",2,16,164,83,81
050,17,193,"Illinois","White County",2,17,156,83,73
050,17,193,"Illinois","White County",2,18,139,72,67
050,17,193,"Illinois","White County",2,19,111,58,53
050,17,193,"Illinois","White County",2,20,115,65,50
050,17,193,"Illinois","White County",2,21,112,58,54
050,17,193,"Illinois","White County",2,22,121,60,61
050,17,193,"Illinois","White County",2,23,122,66,56
050,17,193,"Illinois","White County",2,24,137,71,66
050,17,193,"Illinois","White County",2,25,147,71,76
050,17,193,"Illinois","White County",2,26,132,66,66
050,17,193,"Illinois","White County",2,27,131,64,67
050,17,193,"Illinois","White County",2,28,147,72,75
050,17,193,"Illinois","White County",2,29,150,71,79
050,17,193,"Illinois","White County",2,30,140,74,66
050,17,193,"Illinois","White County",2,31,147,80,67
050,17,193,"Illinois","White County",2,32,145,70,75
050,17,193,"Illinois","White County",2,33,143,70,73
050,17,193,"Illinois","White County",2,34,158,81,77
050,17,193,"Illinois","White County",2,35,165,86,79
050,17,193,"Illinois","White County",2,36,162,79,83
050,17,193,"Illinois","White County",2,37,163,80,83
050,17,193,"Illinois","White County",2,38,181,93,88
050,17,193,"Illinois","White County",2,39,190,100,90
050,17,193,"Illinois","White County",2,40,170,83,87
050,17,193,"Illinois","White County",2,41,149,73,76
050,17,193,"Illinois","White County",2,42,152,71,81
050,17,193,"Illinois","White County",2,43,170,82,88
050,17,193,"Illinois","White County",2,44,161,80,81
050,17,193,"Illinois","White County",2,45,153,77,76
050,17,193,"Illinois","White County",2,46,141,71,70
050,17,193,"Illinois","White County",2,47,138,72,66
050,17,193,"Illinois","White County",2,48,141,72,69
050,17,193,"Illinois","White County",2,49,155,75,80
050,17,193,"Illinois","White County",2,50,172,83,89
050,17,193,"Illinois","White County",2,51,168,84,84
050,17,193,"Illinois","White County",2,52,158,87,71
050,17,193,"Illinois","White County",2,53,154,79,75
050,17,193,"Illinois","White County",2,54,186,95,91
050,17,193,"Illinois","White County",2,55,201,101,100
050,17,193,"Illinois","White County",2,56,189,93,96
050,17,193,"Illinois","White County",2,57,199,98,101
050,17,193,"Illinois","White County",2,58,228,117,111
050,17,193,"Illinois","White County",2,59,223,111,112
050,17,193,"Illinois","White County",2,60,217,106,111
050,17,193,"Illinois","White County",2,61,212,103,109
050,17,193,"Illinois","White County",2,62,210,108,102
050,17,193,"Illinois","White County",2,63,211,110,101
050,17,193,"Illinois","White County",2,64,196,97,99
050,17,193,"Illinois","White County",2,65,215,99,116
050,17,193,"Illinois","White County",2,66,193,86,107
050,17,193,"Illinois","White County",2,67,174,81,93
050,17,193,"Illinois","White County",2,68,174,82,92
050,17,193,"Illinois","White County",2,69,147,73,74
050,17,193,"Illinois","White County",2,70,147,72,75
050,17,193,"Illinois","White County",2,71,159,78,81
050,17,193,"Illinois","White County",2,72,163,82,81
050,17,193,"Illinois","White County",2,73,168,75,93
050,17,193,"Illinois","White County",2,74,118,53,65
050,17,193,"Illinois","White County",2,75,120,53,67
050,17,193,"Illinois","White County",2,76,109,50,59
050,17,193,"Illinois","White County",2,77,124,68,56
050,17,193,"Illinois","White County",2,78,108,53,55
050,17,193,"Illinois","White County",2,79,93,38,55
050,17,193,"Illinois","White County",2,80,82,35,47
050,17,193,"Illinois","White County",2,81,94,38,56
050,17,193,"Illinois","White County",2,82,106,41,65
050,17,193,"Illinois","White County",2,83,98,41,57
050,17,193,"Illinois","White County",2,84,92,40,52
050,17,193,"Illinois","White County",2,85,532,184,348
050,17,193,"Illinois","White County",3,0,125,72,53
050,17,193,"Illinois","White County",3,1,118,60,58
050,17,193,"Illinois","White County",3,2,127,70,57
050,17,193,"Illinois","White County",3,3,150,92,58
050,17,193,"Illinois","White County",3,4,155,83,72
050,17,193,"Illinois","White County",3,5,167,86,81
050,17,193,"Illinois","White County",3,6,179,92,87
050,17,193,"Illinois","White County",3,7,165,93,72
050,17,193,"Illinois","White County",3,8,158,81,77
050,17,193,"Illinois","White County",3,9,181,87,94
050,17,193,"Illinois","White County",3,10,192,92,100
050,17,193,"Illinois","White County",3,11,184,96,88
050,17,193,"Illinois","White County",3,12,185,89,96
050,17,193,"Illinois","White County",3,13,186,97,89
050,17,193,"Illinois","White County",3,14,199,98,101
050,17,193,"Illinois","White County",3,15,182,89,93
050,17,193,"Illinois","White County",3,16,173,91,82
050,17,193,"Illinois","White County",3,17,166,82,84
050,17,193,"Illinois","White County",3,18,128,69,59
050,17,193,"Illinois","White County",3,19,115,60,55
050,17,193,"Illinois","White County",3,20,123,57,66
050,17,193,"Illinois","White County",3,21,130,71,59
050,17,193,"Illinois","White County",3,22,125,62,63
050,17,193,"Illinois","White County",3,23,126,67,59
050,17,193,"Illinois","White County",3,24,122,61,61
050,17,193,"Illinois","White County",3,25,137,73,64
050,17,193,"Illinois","White County",3,26,149,75,74
050,17,193,"Illinois","White County",3,27,137,65,72
050,17,193,"Illinois","White County",3,28,132,62,70
050,17,193,"Illinois","White County",3,29,144,73,71
050,17,193,"Illinois","White County",3,30,152,75,77
050,17,193,"Illinois","White County",3,31,143,73,70
050,17,193,"Illinois","White County",3,32,139,79,60
050,17,193,"Illinois","White County",3,33,157,77,80
050,17,193,"Illinois","White County",3,34,151,74,77
050,17,193,"Illinois","White County",3,35,153,81,72
050,17,193,"Illinois","White County",3,36,169,88,81
050,17,193,"Illinois","White County",3,37,164,83,81
050,17,193,"Illinois","White County",3,38,162,76,86
050,17,193,"Illinois","White County",3,39,185,94,91
050,17,193,"Illinois","White County",3,40,190,101,89
050,17,193,"Illinois","White County",3,41,169,84,85
050,17,193,"Illinois","White County",3,42,153,77,76
050,17,193,"Illinois","White County",3,43,156,71,85
050,17,193,"Illinois","White County",3,44,167,78,89
050,17,193,"Illinois","White County",3,45,168,84,84
050,17,193,"Illinois","White County",3,46,149,73,76
050,17,193,"Illinois","White County",3,47,146,70,76
050,17,193,"Illinois","White County",3,48,131,67,64
050,17,193,"Illinois","White County",3,49,150,77,73
050,17,193,"Illinois","White County",3,50,148,72,76
050,17,193,"Illinois","White County",3,51,169,82,87
050,17,193,"Illinois","White County",3,52,175,88,87
050,17,193,"Illinois","White County",3,53,150,85,65
050,17,193,"Illinois","White County",3,54,163,87,76
050,17,193,"Illinois","White County",3,55,192,100,92
050,17,193,"Illinois","White County",3,56,194,94,100
050,17,193,"Illinois","White County",3,57,192,95,97
050,17,193,"Illinois","White County",3,58,203,104,99
050,17,193,"Illinois","White County",3,59,220,111,109
050,17,193,"Illinois","White County",3,60,220,108,112
050,17,193,"Illinois","White County",3,61,215,105,110
050,17,193,"Illinois","White County",3,62,221,109,112
050,17,193,"Illinois","White County",3,63,205,102,103
050,17,193,"Illinois","White County",3,64,210,106,104
050,17,193,"Illinois","White County",3,65,191,94,97
050,17,193,"Illinois","White County",3,66,210,96,114
050,17,193,"Illinois","White County",3,67,180,79,101
050,17,193,"Illinois","White County",3,68,173,81,92
050,17,193,"Illinois","White County",3,69,157,71,86
050,17,193,"Illinois","White County",3,70,147,73,74
050,17,193,"Illinois","White County",3,71,134,66,68
050,17,193,"Illinois","White County",3,72,146,70,76
050,17,193,"Illinois","White County",3,73,160,75,85
050,17,193,"Illinois","White County",3,74,154,74,80
050,17,193,"Illinois","White County",3,75,121,52,69
050,17,193,"Illinois","White County",3,76,107,44,63
050,17,193,"Illinois","White County",3,77,102,51,51
050,17,193,"Illinois","White County",3,78,117,57,60
050,17,193,"Illinois","White County",3,79,100,46,54
050,17,193,"Illinois","White County",3,80,77,39,38
050,17,193,"Illinois","White County",3,81,71,22,49
050,17,193,"Illinois","White County",3,82,94,38,56
050,17,193,"Illinois","White County",3,83,106,43,63
050,17,193,"Illinois","White County",3,84,96,47,49
050,17,193,"Illinois","White County",3,85,524,176,348
050,17,193,"Illinois","White County",4,0,112,61,51
050,17,193,"Illinois","White County",4,1,116,73,43
050,17,193,"Illinois","White County",4,2,128,66,62
050,17,193,"Illinois","White County",4,3,141,78,63
050,17,193,"Illinois","White County",4,4,154,90,64
050,17,193,"Illinois","White County",4,5,163,91,72
050,17,193,"Illinois","White County",4,6,164,85,79
050,17,193,"Illinois","White County",4,7,179,91,88
050,17,193,"Illinois","White County",4,8,165,96,69
050,17,193,"Illinois","White County",4,9,157,81,76
050,17,193,"Illinois","White County",4,10,174,82,92
050,17,193,"Illinois","White County",4,11,190,89,101
050,17,193,"Illinois","White County",4,12,187,100,87
050,17,193,"Illinois","White County",4,13,186,93,93
050,17,193,"Illinois","White County",4,14,190,99,91
050,17,193,"Illinois","White County",4,15,200,95,105
050,17,193,"Illinois","White County",4,16,174,84,90
050,17,193,"Illinois","White County",4,17,177,90,87
050,17,193,"Illinois","White County",4,18,137,73,64
050,17,193,"Illinois","White County",4,19,95,50,45
050,17,193,"Illinois","White County",4,20,114,60,54
050,17,193,"Illinois","White County",4,21,126,60,66
050,17,193,"Illinois","White County",4,22,138,71,67
050,17,193,"Illinois","White County",4,23,128,70,58
050,17,193,"Illinois","White County",4,24,130,70,60
050,17,193,"Illinois","White County",4,25,134,68,66
050,17,193,"Illinois","White County",4,26,134,74,60
050,17,193,"Illinois","White County",4,27,154,78,76
050,17,193,"Illinois","White County",4,28,143,70,73
050,17,193,"Illinois","White County",4,29,138,65,73
050,17,193,"Illinois","White County",4,30,143,71,72
050,17,193,"Illinois","White County",4,31,156,73,83
050,17,193,"Illinois","White County",4,32,132,71,61
050,17,193,"Illinois","White County",4,33,130,73,57
050,17,193,"Illinois","White County",4,34,156,76,80
050,17,193,"Illinois","White County",4,35,155,78,77
050,17,193,"Illinois","White County",4,36,153,81,72
050,17,193,"Illinois","White County",4,37,165,85,80
050,17,193,"Illinois","White County",4,38,165,80,85
050,17,193,"Illinois","White County",4,39,157,79,78
050,17,193,"Illinois","White County",4,40,185,93,92
050,17,193,"Illinois","White County",4,41,198,104,94
050,17,193,"Illinois","White County",4,42,171,87,84
050,17,193,"Illinois","White County",4,43,151,79,72
050,17,193,"Illinois","White County",4,44,165,75,90
050,17,193,"Illinois","White County",4,45,167,78,89
050,17,193,"Illinois","White County",4,46,161,80,81
050,17,193,"Illinois","White County",4,47,161,77,84
050,17,193,"Illinois","White County",4,48,138,67,71
050,17,193,"Illinois","White County",4,49,128,66,62
050,17,193,"Illinois","White County",4,50,144,72,72
050,17,193,"Illinois","White County",4,51,150,74,76
050,17,193,"Illinois","White County",4,52,173,81,92
050,17,193,"Illinois","White County",4,53,167,87,80
050,17,193,"Illinois","White County",4,54,159,93,66
050,17,193,"Illinois","White County",4,55,156,83,73
050,17,193,"Illinois","White County",4,56,185,94,91
050,17,193,"Illinois","White County",4,57,190,94,96
050,17,193,"Illinois","White County",4,58,203,102,101
050,17,193,"Illinois","White County",4,59,195,98,97
050,17,193,"Illinois","White County",4,60,218,109,109
050,17,193,"Illinois","White County",4,61,210,106,104
050,17,193,"Illinois","White County",4,62,218,107,111
050,17,193,"Illinois","White County",4,63,223,103,120
050,17,193,"Illinois","White County",4,64,192,95,97
050,17,193,"Illinois","White County",4,65,208,104,104
050,17,193,"Illinois","White County",4,66,187,91,96
050,17,193,"Illinois","White County",4,67,189,85,104
050,17,193,"Illinois","White County",4,68,176,78,98
050,17,193,"Illinois","White County",4,69,161,76,85
050,17,193,"Illinois","White County",4,70,152,69,83
050,17,193,"Illinois","White County",4,71,138,67,71
050,17,193,"Illinois","White County",4,72,121,58,63
050,17,193,"Illinois","White County",4,73,146,68,78
050,17,193,"Illinois","White County",4,74,147,73,74
050,17,193,"Illinois","White County",4,75,158,75,83
050,17,193,"Illinois","White County",4,76,111,47,64
050,17,193,"Illinois","White County",4,77,102,48,54
050,17,193,"Illinois","White County",4,78,94,41,53
050,17,193,"Illinois","White County",4,79,113,53,60
050,17,193,"Illinois","White County",4,80,86,46,40
050,17,193,"Illinois","White County",4,81,68,27,41
050,17,193,"Illinois","White County",4,82,69,19,50
050,17,193,"Illinois","White County",4,83,91,37,54
050,17,193,"Illinois","White County",4,84,104,48,56
050,17,193,"Illinois","White County",4,85,526,177,349
050,17,193,"Illinois","White County",5,0,85,46,39
050,17,193,"Illinois","White County",5,1,123,67,56
050,17,193,"Illinois","White County",5,2,116,74,42
050,17,193,"Illinois","White County",5,3,130,70,60
050,17,193,"Illinois","White County",5,4,143,79,64
050,17,193,"Illinois","White County",5,5,148,86,62
050,17,193,"Illinois","White County",5,6,153,82,71
050,17,193,"Illinois","White County",5,7,160,83,77
050,17,193,"Illinois","White County",5,8,172,93,79
050,17,193,"Illinois","White County",5,9,160,90,70
050,17,193,"Illinois","White County",5,10,161,83,78
050,17,193,"Illinois","White County",5,11,176,85,91
050,17,193,"Illinois","White County",5,12,192,91,101
050,17,193,"Illinois","White County",5,13,183,98,85
050,17,193,"Illinois","White County",5,14,181,88,93
050,17,193,"Illinois","White County",5,15,190,97,93
050,17,193,"Illinois","White County",5,16,201,99,102
050,17,193,"Illinois","White County",5,17,173,85,88
050,17,193,"Illinois","White County",5,18,138,73,65
050,17,193,"Illinois","White County",5,19,102,54,48
050,17,193,"Illinois","White County",5,20,113,58,55
050,17,193,"Illinois","White County",5,21,121,62,59
050,17,193,"Illinois","White County",5,22,138,67,71
050,17,193,"Illinois","White County",5,23,149,78,71
050,17,193,"Illinois","White County",5,24,127,73,54
050,17,193,"Illinois","White County",5,25,134,67,67
050,17,193,"Illinois","White County",5,26,137,68,69
050,17,193,"Illinois","White County",5,27,134,71,63
050,17,193,"Illinois","White County",5,28,151,80,71
050,17,193,"Illinois","White County",5,29,139,69,70
050,17,193,"Illinois","White County",5,30,139,70,69
050,17,193,"Illinois","White County",5,31,151,75,76
050,17,193,"Illinois","White County",5,32,158,76,82
050,17,193,"Illinois","White County",5,33,134,71,63
050,17,193,"Illinois","White County",5,34,134,74,60
050,17,193,"Illinois","White County",5,35,163,80,83
050,17,193,"Illinois","White County",5,36,150,75,75
050,17,193,"Illinois","White County",5,37,152,81,71
050,17,193,"Illinois","White County",5,38,166,85,81
050,17,193,"Illinois","White County",5,39,155,78,77
050,17,193,"Illinois","White County",5,40,157,79,78
050,17,193,"Illinois","White County",5,41,179,90,89
050,17,193,"Illinois","White County",5,42,197,109,88
050,17,193,"Illinois","White County",5,43,173,89,84
050,17,193,"Illinois","White County",5,44,158,82,76
050,17,193,"Illinois","White County",5,45,159,73,86
050,17,193,"Illinois","White County",5,46,165,76,89
050,17,193,"Illinois","White County",5,47,169,85,84
050,17,193,"Illinois","White County",5,48,149,72,77
050,17,193,"Illinois","White County",5,49,137,68,69
050,17,193,"Illinois","White County",5,50,125,61,64
050,17,193,"Illinois","White County",5,51,143,66,77
050,17,193,"Illinois","White County",5,52,151,75,76
050,17,193,"Illinois","White County",5,53,173,79,94
050,17,193,"Illinois","White County",5,54,179,95,84
050,17,193,"Illinois","White County",5,55,156,90,66
050,17,193,"Illinois","White County",5,56,153,79,74
050,17,193,"Illinois","White County",5,57,184,92,92
050,17,193,"Illinois","White County",5,58,194,101,93
050,17,193,"Illinois","White County",5,59,196,94,102
050,17,193,"Illinois","White County",5,60,192,97,95
050,17,193,"Illinois","White County",5,61,207,101,106
050,17,193,"Illinois","White County",5,62,216,113,103
050,17,193,"Illinois","White County",5,63,211,103,108
050,17,193,"Illinois","White County",5,64,211,94,117
050,17,193,"Illinois","White County",5,65,188,93,95
050,17,193,"Illinois","White County",5,66,201,100,101
050,17,193,"Illinois","White County",5,67,175,86,89
050,17,193,"Illinois","White County",5,68,187,85,102
050,17,193,"Illinois","White County",5,69,165,72,93
050,17,193,"Illinois","White County",5,70,160,75,85
050,17,193,"Illinois","White County",5,71,144,63,81
050,17,193,"Illinois","White County",5,72,131,63,68
050,17,193,"Illinois","White County",5,73,127,58,69
050,17,193,"Illinois","White County",5,74,136,70,66
050,17,193,"Illinois","White County",5,75,153,73,80
050,17,193,"Illinois","White County",5,76,143,65,78
050,17,193,"Illinois","White County",5,77,104,50,54
050,17,193,"Illinois","White County",5,78,95,40,55
050,17,193,"Illinois","White County",5,79,90,37,53
050,17,193,"Illinois","White County",5,80,91,48,43
050,17,193,"Illinois","White County",5,81,79,36,43
050,17,193,"Illinois","White County",5,82,69,24,45
050,17,193,"Illinois","White County",5,83,70,21,49
050,17,193,"Illinois","White County",5,84,88,42,46
050,17,193,"Illinois","White County",5,85,539,183,356
050,17,195,"Illinois","Whiteside County",1,0,592,297,295
050,17,195,"Illinois","Whiteside County",1,1,610,293,317
050,17,195,"Illinois","Whiteside County",1,2,620,304,316
050,17,195,"Illinois","Whiteside County",1,3,657,342,315
050,17,195,"Illinois","Whiteside County",1,4,645,330,315
050,17,195,"Illinois","Whiteside County",1,5,639,319,320
050,17,195,"Illinois","Whiteside County",1,6,635,329,306
050,17,195,"Illinois","Whiteside County",1,7,651,332,319
050,17,195,"Illinois","Whiteside County",1,8,666,364,302
050,17,195,"Illinois","Whiteside County",1,9,697,355,342
050,17,195,"Illinois","Whiteside County",1,10,722,366,356
050,17,195,"Illinois","Whiteside County",1,11,734,382,352
050,17,195,"Illinois","Whiteside County",1,12,763,392,371
050,17,195,"Illinois","Whiteside County",1,13,744,389,355
050,17,195,"Illinois","Whiteside County",1,14,725,372,353
050,17,195,"Illinois","Whiteside County",1,15,728,366,362
050,17,195,"Illinois","Whiteside County",1,16,756,383,373
050,17,195,"Illinois","Whiteside County",1,17,737,364,373
050,17,195,"Illinois","Whiteside County",1,18,643,348,295
050,17,195,"Illinois","Whiteside County",1,19,562,318,244
050,17,195,"Illinois","Whiteside County",1,20,584,311,273
050,17,195,"Illinois","Whiteside County",1,21,573,300,273
050,17,195,"Illinois","Whiteside County",1,22,598,296,302
050,17,195,"Illinois","Whiteside County",1,23,619,302,317
050,17,195,"Illinois","Whiteside County",1,24,608,311,297
050,17,195,"Illinois","Whiteside County",1,25,574,288,286
050,17,195,"Illinois","Whiteside County",1,26,593,305,288
050,17,195,"Illinois","Whiteside County",1,27,615,318,297
050,17,195,"Illinois","Whiteside County",1,28,656,340,316
050,17,195,"Illinois","Whiteside County",1,29,662,327,335
050,17,195,"Illinois","Whiteside County",1,30,656,341,315
050,17,195,"Illinois","Whiteside County",1,31,612,322,290
050,17,195,"Illinois","Whiteside County",1,32,580,280,300
050,17,195,"Illinois","Whiteside County",1,33,605,293,312
050,17,195,"Illinois","Whiteside County",1,34,615,316,299
050,17,195,"Illinois","Whiteside County",1,35,617,305,312
050,17,195,"Illinois","Whiteside County",1,36,611,298,313
050,17,195,"Illinois","Whiteside County",1,37,617,308,309
050,17,195,"Illinois","Whiteside County",1,38,639,317,322
050,17,195,"Illinois","Whiteside County",1,39,638,323,315
050,17,195,"Illinois","Whiteside County",1,40,600,317,283
050,17,195,"Illinois","Whiteside County",1,41,616,324,292
050,17,195,"Illinois","Whiteside County",1,42,602,320,282
050,17,195,"Illinois","Whiteside County",1,43,573,283,290
050,17,195,"Illinois","Whiteside County",1,44,625,313,312
050,17,195,"Illinois","Whiteside County",1,45,655,319,336
050,17,195,"Illinois","Whiteside County",1,46,621,318,303
050,17,195,"Illinois","Whiteside County",1,47,661,348,313
050,17,195,"Illinois","Whiteside County",1,48,712,371,341
050,17,195,"Illinois","Whiteside County",1,49,763,381,382
050,17,195,"Illinois","Whiteside County",1,50,709,366,343
050,17,195,"Illinois","Whiteside County",1,51,702,365,337
050,17,195,"Illinois","Whiteside County",1,52,679,340,339
050,17,195,"Illinois","Whiteside County",1,53,707,348,359
050,17,195,"Illinois","Whiteside County",1,54,702,348,354
050,17,195,"Illinois","Whiteside County",1,55,780,394,386
050,17,195,"Illinois","Whiteside County",1,56,790,398,392
050,17,195,"Illinois","Whiteside County",1,57,795,397,398
050,17,195,"Illinois","Whiteside County",1,58,834,405,429
050,17,195,"Illinois","Whiteside County",1,59,866,419,447
050,17,195,"Illinois","Whiteside County",1,60,827,419,408
050,17,195,"Illinois","Whiteside County",1,61,817,420,397
050,17,195,"Illinois","Whiteside County",1,62,867,432,435
050,17,195,"Illinois","Whiteside County",1,63,838,405,433
050,17,195,"Illinois","Whiteside County",1,64,850,426,424
050,17,195,"Illinois","Whiteside County",1,65,780,381,399
050,17,195,"Illinois","Whiteside County",1,66,790,386,404
050,17,195,"Illinois","Whiteside County",1,67,756,382,374
050,17,195,"Illinois","Whiteside County",1,68,732,359,373
050,17,195,"Illinois","Whiteside County",1,69,690,351,339
050,17,195,"Illinois","Whiteside County",1,70,649,321,328
050,17,195,"Illinois","Whiteside County",1,71,632,302,330
050,17,195,"Illinois","Whiteside County",1,72,639,316,323
050,17,195,"Illinois","Whiteside County",1,73,610,280,330
050,17,195,"Illinois","Whiteside County",1,74,426,184,242
050,17,195,"Illinois","Whiteside County",1,75,466,217,249
050,17,195,"Illinois","Whiteside County",1,76,458,223,235
050,17,195,"Illinois","Whiteside County",1,77,432,194,238
050,17,195,"Illinois","Whiteside County",1,78,367,163,204
050,17,195,"Illinois","Whiteside County",1,79,355,162,193
050,17,195,"Illinois","Whiteside County",1,80,334,161,173
050,17,195,"Illinois","Whiteside County",1,81,327,153,174
050,17,195,"Illinois","Whiteside County",1,82,295,138,157
050,17,195,"Illinois","Whiteside County",1,83,267,117,150
050,17,195,"Illinois","Whiteside County",1,84,234,98,136
050,17,195,"Illinois","Whiteside County",1,85,1466,524,942
050,17,195,"Illinois","Whiteside County",2,0,607,303,304
050,17,195,"Illinois","Whiteside County",2,1,602,293,309
050,17,195,"Illinois","Whiteside County",2,2,620,303,317
050,17,195,"Illinois","Whiteside County",2,3,646,330,316
050,17,195,"Illinois","Whiteside County",2,4,646,331,315
050,17,195,"Illinois","Whiteside County",2,5,642,321,321
050,17,195,"Illinois","Whiteside County",2,6,635,326,309
050,17,195,"Illinois","Whiteside County",2,7,646,330,316
050,17,195,"Illinois","Whiteside County",2,8,661,354,307
050,17,195,"Illinois","Whiteside County",2,9,687,353,334
050,17,195,"Illinois","Whiteside County",2,10,711,360,351
050,17,195,"Illinois","Whiteside County",2,11,728,379,349
050,17,195,"Illinois","Whiteside County",2,12,760,393,367
050,17,195,"Illinois","Whiteside County",2,13,744,388,356
050,17,195,"Illinois","Whiteside County",2,14,726,375,351
050,17,195,"Illinois","Whiteside County",2,15,729,368,361
050,17,195,"Illinois","Whiteside County",2,16,748,379,369
050,17,195,"Illinois","Whiteside County",2,17,742,371,371
050,17,195,"Illinois","Whiteside County",2,18,645,343,302
050,17,195,"Illinois","Whiteside County",2,19,559,315,244
050,17,195,"Illinois","Whiteside County",2,20,592,319,273
050,17,195,"Illinois","Whiteside County",2,21,570,297,273
050,17,195,"Illinois","Whiteside County",2,22,596,299,297
050,17,195,"Illinois","Whiteside County",2,23,614,301,313
050,17,195,"Illinois","Whiteside County",2,24,604,305,299
050,17,195,"Illinois","Whiteside County",2,25,577,291,286
050,17,195,"Illinois","Whiteside County",2,26,587,301,286
050,17,195,"Illinois","Whiteside County",2,27,602,310,292
050,17,195,"Illinois","Whiteside County",2,28,646,335,311
050,17,195,"Illinois","Whiteside County",2,29,658,330,328
050,17,195,"Illinois","Whiteside County",2,30,662,339,323
050,17,195,"Illinois","Whiteside County",2,31,624,326,298
050,17,195,"Illinois","Whiteside County",2,32,585,287,298
050,17,195,"Illinois","Whiteside County",2,33,598,290,308
050,17,195,"Illinois","Whiteside County",2,34,612,309,303
050,17,195,"Illinois","Whiteside County",2,35,620,309,311
050,17,195,"Illinois","Whiteside County",2,36,607,299,308
050,17,195,"Illinois","Whiteside County",2,37,613,303,310
050,17,195,"Illinois","Whiteside County",2,38,636,313,323
050,17,195,"Illinois","Whiteside County",2,39,639,322,317
050,17,195,"Illinois","Whiteside County",2,40,612,319,293
050,17,195,"Illinois","Whiteside County",2,41,611,322,289
050,17,195,"Illinois","Whiteside County",2,42,598,319,279
050,17,195,"Illinois","Whiteside County",2,43,581,294,287
050,17,195,"Illinois","Whiteside County",2,44,608,305,303
050,17,195,"Illinois","Whiteside County",2,45,652,321,331
050,17,195,"Illinois","Whiteside County",2,46,626,317,309
050,17,195,"Illinois","Whiteside County",2,47,650,340,310
050,17,195,"Illinois","Whiteside County",2,48,697,364,333
050,17,195,"Illinois","Whiteside County",2,49,753,383,370
050,17,195,"Illinois","Whiteside County",2,50,717,366,351
050,17,195,"Illinois","Whiteside County",2,51,702,366,336
050,17,195,"Illinois","Whiteside County",2,52,680,339,341
050,17,195,"Illinois","Whiteside County",2,53,702,348,354
050,17,195,"Illinois","Whiteside County",2,54,695,344,351
050,17,195,"Illinois","Whiteside County",2,55,763,382,381
050,17,195,"Illinois","Whiteside County",2,56,789,400,389
050,17,195,"Illinois","Whiteside County",2,57,790,395,395
050,17,195,"Illinois","Whiteside County",2,58,823,402,421
050,17,195,"Illinois","Whiteside County",2,59,858,415,443
050,17,195,"Illinois","Whiteside County",2,60,831,416,415
050,17,195,"Illinois","Whiteside County",2,61,818,419,399
050,17,195,"Illinois","Whiteside County",2,62,851,425,426
050,17,195,"Illinois","Whiteside County",2,63,847,411,436
050,17,195,"Illinois","Whiteside County",2,64,842,417,425
050,17,195,"Illinois","Whiteside County",2,65,793,388,405
050,17,195,"Illinois","Whiteside County",2,66,789,385,404
050,17,195,"Illinois","Whiteside County",2,67,759,380,379
050,17,195,"Illinois","Whiteside County",2,68,732,362,370
050,17,195,"Illinois","Whiteside County",2,69,701,352,349
050,17,195,"Illinois","Whiteside County",2,70,649,323,326
050,17,195,"Illinois","Whiteside County",2,71,633,305,328
050,17,195,"Illinois","Whiteside County",2,72,621,303,318
050,17,195,"Illinois","Whiteside County",2,73,646,303,343
050,17,195,"Illinois","Whiteside County",2,74,441,194,247
050,17,195,"Illinois","Whiteside County",2,75,453,205,248
050,17,195,"Illinois","Whiteside County",2,76,449,217,232
050,17,195,"Illinois","Whiteside County",2,77,443,202,241
050,17,195,"Illinois","Whiteside County",2,78,373,164,209
050,17,195,"Illinois","Whiteside County",2,79,354,161,193
050,17,195,"Illinois","Whiteside County",2,80,333,155,178
050,17,195,"Illinois","Whiteside County",2,81,322,150,172
050,17,195,"Illinois","Whiteside County",2,82,298,139,159
050,17,195,"Illinois","Whiteside County",2,83,266,117,149
050,17,195,"Illinois","Whiteside County",2,84,237,102,135
050,17,195,"Illinois","Whiteside County",2,85,1451,520,931
050,17,195,"Illinois","Whiteside County",3,0,582,299,283
050,17,195,"Illinois","Whiteside County",3,1,609,296,313
050,17,195,"Illinois","Whiteside County",3,2,596,300,296
050,17,195,"Illinois","Whiteside County",3,3,633,301,332
050,17,195,"Illinois","Whiteside County",3,4,657,334,323
050,17,195,"Illinois","Whiteside County",3,5,647,333,314
050,17,195,"Illinois","Whiteside County",3,6,649,330,319
050,17,195,"Illinois","Whiteside County",3,7,649,329,320
050,17,195,"Illinois","Whiteside County",3,8,651,334,317
050,17,195,"Illinois","Whiteside County",3,9,672,353,319
050,17,195,"Illinois","Whiteside County",3,10,683,350,333
050,17,195,"Illinois","Whiteside County",3,11,732,375,357
050,17,195,"Illinois","Whiteside County",3,12,746,393,353
050,17,195,"Illinois","Whiteside County",3,13,757,386,371
050,17,195,"Illinois","Whiteside County",3,14,742,380,362
050,17,195,"Illinois","Whiteside County",3,15,715,370,345
050,17,195,"Illinois","Whiteside County",3,16,728,365,363
050,17,195,"Illinois","Whiteside County",3,17,749,384,365
050,17,195,"Illinois","Whiteside County",3,18,659,347,312
050,17,195,"Illinois","Whiteside County",3,19,531,287,244
050,17,195,"Illinois","Whiteside County",3,20,581,313,268
050,17,195,"Illinois","Whiteside County",3,21,601,319,282
050,17,195,"Illinois","Whiteside County",3,22,612,324,288
050,17,195,"Illinois","Whiteside County",3,23,615,312,303
050,17,195,"Illinois","Whiteside County",3,24,619,308,311
050,17,195,"Illinois","Whiteside County",3,25,578,301,277
050,17,195,"Illinois","Whiteside County",3,26,610,303,307
050,17,195,"Illinois","Whiteside County",3,27,605,306,299
050,17,195,"Illinois","Whiteside County",3,28,608,317,291
050,17,195,"Illinois","Whiteside County",3,29,647,337,310
050,17,195,"Illinois","Whiteside County",3,30,659,334,325
050,17,195,"Illinois","Whiteside County",3,31,683,351,332
050,17,195,"Illinois","Whiteside County",3,32,626,329,297
050,17,195,"Illinois","Whiteside County",3,33,590,294,296
050,17,195,"Illinois","Whiteside County",3,34,602,295,307
050,17,195,"Illinois","Whiteside County",3,35,633,324,309
050,17,195,"Illinois","Whiteside County",3,36,635,312,323
050,17,195,"Illinois","Whiteside County",3,37,592,291,301
050,17,195,"Illinois","Whiteside County",3,38,606,290,316
050,17,195,"Illinois","Whiteside County",3,39,644,315,329
050,17,195,"Illinois","Whiteside County",3,40,638,322,316
050,17,195,"Illinois","Whiteside County",3,41,618,321,297
050,17,195,"Illinois","Whiteside County",3,42,608,317,291
050,17,195,"Illinois","Whiteside County",3,43,580,307,273
050,17,195,"Illinois","Whiteside County",3,44,587,291,296
050,17,195,"Illinois","Whiteside County",3,45,611,310,301
050,17,195,"Illinois","Whiteside County",3,46,647,322,325
050,17,195,"Illinois","Whiteside County",3,47,620,314,306
050,17,195,"Illinois","Whiteside County",3,48,649,336,313
050,17,195,"Illinois","Whiteside County",3,49,695,367,328
050,17,195,"Illinois","Whiteside County",3,50,742,372,370
050,17,195,"Illinois","Whiteside County",3,51,725,373,352
050,17,195,"Illinois","Whiteside County",3,52,691,354,337
050,17,195,"Illinois","Whiteside County",3,53,689,352,337
050,17,195,"Illinois","Whiteside County",3,54,690,337,353
050,17,195,"Illinois","Whiteside County",3,55,687,341,346
050,17,195,"Illinois","Whiteside County",3,56,759,382,377
050,17,195,"Illinois","Whiteside County",3,57,768,384,384
050,17,195,"Illinois","Whiteside County",3,58,784,389,395
050,17,195,"Illinois","Whiteside County",3,59,801,394,407
050,17,195,"Illinois","Whiteside County",3,60,843,408,435
050,17,195,"Illinois","Whiteside County",3,61,815,402,413
050,17,195,"Illinois","Whiteside County",3,62,796,405,391
050,17,195,"Illinois","Whiteside County",3,63,831,421,410
050,17,195,"Illinois","Whiteside County",3,64,823,392,431
050,17,195,"Illinois","Whiteside County",3,65,825,406,419
050,17,195,"Illinois","Whiteside County",3,66,776,377,399
050,17,195,"Illinois","Whiteside County",3,67,765,371,394
050,17,195,"Illinois","Whiteside County",3,68,741,375,366
050,17,195,"Illinois","Whiteside County",3,69,724,359,365
050,17,195,"Illinois","Whiteside County",3,70,677,335,342
050,17,195,"Illinois","Whiteside County",3,71,627,315,312
050,17,195,"Illinois","Whiteside County",3,72,612,293,319
050,17,195,"Illinois","Whiteside County",3,73,588,288,300
050,17,195,"Illinois","Whiteside County",3,74,634,296,338
050,17,195,"Illinois","Whiteside County",3,75,429,186,243
050,17,195,"Illinois","Whiteside County",3,76,433,195,238
050,17,195,"Illinois","Whiteside County",3,77,424,201,223
050,17,195,"Illinois","Whiteside County",3,78,430,193,237
050,17,195,"Illinois","Whiteside County",3,79,339,142,197
050,17,195,"Illinois","Whiteside County",3,80,324,140,184
050,17,195,"Illinois","Whiteside County",3,81,310,143,167
050,17,195,"Illinois","Whiteside County",3,82,295,133,162
050,17,195,"Illinois","Whiteside County",3,83,275,118,157
050,17,195,"Illinois","Whiteside County",3,84,243,112,131
050,17,195,"Illinois","Whiteside County",3,85,1401,497,904
050,17,195,"Illinois","Whiteside County",4,0,528,256,272
050,17,195,"Illinois","Whiteside County",4,1,588,300,288
050,17,195,"Illinois","Whiteside County",4,2,610,297,313
050,17,195,"Illinois","Whiteside County",4,3,593,306,287
050,17,195,"Illinois","Whiteside County",4,4,641,303,338
050,17,195,"Illinois","Whiteside County",4,5,658,338,320
050,17,195,"Illinois","Whiteside County",4,6,647,335,312
050,17,195,"Illinois","Whiteside County",4,7,643,330,313
050,17,195,"Illinois","Whiteside County",4,8,665,334,331
050,17,195,"Illinois","Whiteside County",4,9,652,337,315
050,17,195,"Illinois","Whiteside County",4,10,682,356,326
050,17,195,"Illinois","Whiteside County",4,11,672,345,327
050,17,195,"Illinois","Whiteside County",4,12,721,376,345
050,17,195,"Illinois","Whiteside County",4,13,741,390,351
050,17,195,"Illinois","Whiteside County",4,14,757,380,377
050,17,195,"Illinois","Whiteside County",4,15,723,380,343
050,17,195,"Illinois","Whiteside County",4,16,711,363,348
050,17,195,"Illinois","Whiteside County",4,17,708,359,349
050,17,195,"Illinois","Whiteside County",4,18,631,340,291
050,17,195,"Illinois","Whiteside County",4,19,527,285,242
050,17,195,"Illinois","Whiteside County",4,20,526,278,248
050,17,195,"Illinois","Whiteside County",4,21,557,302,255
050,17,195,"Illinois","Whiteside County",4,22,627,326,301
050,17,195,"Illinois","Whiteside County",4,23,597,318,279
050,17,195,"Illinois","Whiteside County",4,24,591,302,289
050,17,195,"Illinois","Whiteside County",4,25,595,302,293
050,17,195,"Illinois","Whiteside County",4,26,607,328,279
050,17,195,"Illinois","Whiteside County",4,27,600,294,306
050,17,195,"Illinois","Whiteside County",4,28,614,303,311
050,17,195,"Illinois","Whiteside County",4,29,598,321,277
050,17,195,"Illinois","Whiteside County",4,30,636,338,298
050,17,195,"Illinois","Whiteside County",4,31,678,340,338
050,17,195,"Illinois","Whiteside County",4,32,677,342,335
050,17,195,"Illinois","Whiteside County",4,33,629,325,304
050,17,195,"Illinois","Whiteside County",4,34,595,295,300
050,17,195,"Illinois","Whiteside County",4,35,605,297,308
050,17,195,"Illinois","Whiteside County",4,36,651,341,310
050,17,195,"Illinois","Whiteside County",4,37,620,310,310
050,17,195,"Illinois","Whiteside County",4,38,594,283,311
050,17,195,"Illinois","Whiteside County",4,39,609,293,316
050,17,195,"Illinois","Whiteside County",4,40,629,314,315
050,17,195,"Illinois","Whiteside County",4,41,632,313,319
050,17,195,"Illinois","Whiteside County",4,42,619,327,292
050,17,195,"Illinois","Whiteside County",4,43,594,308,286
050,17,195,"Illinois","Whiteside County",4,44,583,304,279
050,17,195,"Illinois","Whiteside County",4,45,600,302,298
050,17,195,"Illinois","Whiteside County",4,46,611,309,302
050,17,195,"Illinois","Whiteside County",4,47,635,316,319
050,17,195,"Illinois","Whiteside County",4,48,611,307,304
050,17,195,"Illinois","Whiteside County",4,49,628,326,302
050,17,195,"Illinois","Whiteside County",4,50,676,354,322
050,17,195,"Illinois","Whiteside County",4,51,736,375,361
050,17,195,"Illinois","Whiteside County",4,52,708,363,345
050,17,195,"Illinois","Whiteside County",4,53,680,354,326
050,17,195,"Illinois","Whiteside County",4,54,675,333,342
050,17,195,"Illinois","Whiteside County",4,55,677,332,345
050,17,195,"Illinois","Whiteside County",4,56,679,341,338
050,17,195,"Illinois","Whiteside County",4,57,739,364,375
050,17,195,"Illinois","Whiteside County",4,58,757,382,375
050,17,195,"Illinois","Whiteside County",4,59,768,386,382
050,17,195,"Illinois","Whiteside County",4,60,782,382,400
050,17,195,"Illinois","Whiteside County",4,61,815,391,424
050,17,195,"Illinois","Whiteside County",4,62,802,390,412
050,17,195,"Illinois","Whiteside County",4,63,788,403,385
050,17,195,"Illinois","Whiteside County",4,64,815,409,406
050,17,195,"Illinois","Whiteside County",4,65,810,386,424
050,17,195,"Illinois","Whiteside County",4,66,815,401,414
050,17,195,"Illinois","Whiteside County",4,67,756,367,389
050,17,195,"Illinois","Whiteside County",4,68,741,362,379
050,17,195,"Illinois","Whiteside County",4,69,737,368,369
050,17,195,"Illinois","Whiteside County",4,70,703,349,354
050,17,195,"Illinois","Whiteside County",4,71,651,319,332
050,17,195,"Illinois","Whiteside County",4,72,589,298,291
050,17,195,"Illinois","Whiteside County",4,73,577,270,307
050,17,195,"Illinois","Whiteside County",4,74,572,279,293
050,17,195,"Illinois","Whiteside County",4,75,608,275,333
050,17,195,"Illinois","Whiteside County",4,76,417,185,232
050,17,195,"Illinois","Whiteside County",4,77,413,182,231
050,17,195,"Illinois","Whiteside County",4,78,401,185,216
050,17,195,"Illinois","Whiteside County",4,79,400,179,221
050,17,195,"Illinois","Whiteside County",4,80,318,128,190
050,17,195,"Illinois","Whiteside County",4,81,309,130,179
050,17,195,"Illinois","Whiteside County",4,82,285,130,155
050,17,195,"Illinois","Whiteside County",4,83,267,114,153
050,17,195,"Illinois","Whiteside County",4,84,246,100,146
050,17,195,"Illinois","Whiteside County",4,85,1397,505,892
050,17,195,"Illinois","Whiteside County",5,0,533,259,274
050,17,195,"Illinois","Whiteside County",5,1,530,249,281
050,17,195,"Illinois","Whiteside County",5,2,606,313,293
050,17,195,"Illinois","Whiteside County",5,3,634,306,328
050,17,195,"Illinois","Whiteside County",5,4,611,315,296
050,17,195,"Illinois","Whiteside County",5,5,659,329,330
050,17,195,"Illinois","Whiteside County",5,6,665,341,324
050,17,195,"Illinois","Whiteside County",5,7,670,347,323
050,17,195,"Illinois","Whiteside County",5,8,657,341,316
050,17,195,"Illinois","Whiteside County",5,9,664,342,322
050,17,195,"Illinois","Whiteside County",5,10,667,344,323
050,17,195,"Illinois","Whiteside County",5,11,692,363,329
050,17,195,"Illinois","Whiteside County",5,12,669,346,323
050,17,195,"Illinois","Whiteside County",5,13,726,382,344
050,17,195,"Illinois","Whiteside County",5,14,730,380,350
050,17,195,"Illinois","Whiteside County",5,15,766,381,385
050,17,195,"Illinois","Whiteside County",5,16,732,391,341
050,17,195,"Illinois","Whiteside County",5,17,714,373,341
050,17,195,"Illinois","Whiteside County",5,18,620,325,295
050,17,195,"Illinois","Whiteside County",5,19,537,295,242
050,17,195,"Illinois","Whiteside County",5,20,559,285,274
050,17,195,"Illinois","Whiteside County",5,21,523,267,256
050,17,195,"Illinois","Whiteside County",5,22,584,314,270
050,17,195,"Illinois","Whiteside County",5,23,637,342,295
050,17,195,"Illinois","Whiteside County",5,24,611,336,275
050,17,195,"Illinois","Whiteside County",5,25,585,283,302
050,17,195,"Illinois","Whiteside County",5,26,609,305,304
050,17,195,"Illinois","Whiteside County",5,27,570,303,267
050,17,195,"Illinois","Whiteside County",5,28,613,302,311
050,17,195,"Illinois","Whiteside County",5,29,611,302,309
050,17,195,"Illinois","Whiteside County",5,30,611,318,293
050,17,195,"Illinois","Whiteside County",5,31,663,363,300
050,17,195,"Illinois","Whiteside County",5,32,681,341,340
050,17,195,"Illinois","Whiteside County",5,33,667,339,328
050,17,195,"Illinois","Whiteside County",5,34,629,328,301
050,17,195,"Illinois","Whiteside County",5,35,602,295,307
050,17,195,"Illinois","Whiteside County",5,36,619,309,310
050,17,195,"Illinois","Whiteside County",5,37,666,348,318
050,17,195,"Illinois","Whiteside County",5,38,636,314,322
050,17,195,"Illinois","Whiteside County",5,39,610,297,313
050,17,195,"Illinois","Whiteside County",5,40,602,284,318
050,17,195,"Illinois","Whiteside County",5,41,624,313,311
050,17,195,"Illinois","Whiteside County",5,42,626,310,316
050,17,195,"Illinois","Whiteside County",5,43,613,324,289
050,17,195,"Illinois","Whiteside County",5,44,605,310,295
050,17,195,"Illinois","Whiteside County",5,45,583,300,283
050,17,195,"Illinois","Whiteside County",5,46,606,309,297
050,17,195,"Illinois","Whiteside County",5,47,632,322,310
050,17,195,"Illinois","Whiteside County",5,48,631,315,316
050,17,195,"Illinois","Whiteside County",5,49,609,307,302
050,17,195,"Illinois","Whiteside County",5,50,618,322,296
050,17,195,"Illinois","Whiteside County",5,51,677,358,319
050,17,195,"Illinois","Whiteside County",5,52,738,370,368
050,17,195,"Illinois","Whiteside County",5,53,706,365,341
050,17,195,"Illinois","Whiteside County",5,54,668,348,320
050,17,195,"Illinois","Whiteside County",5,55,674,324,350
050,17,195,"Illinois","Whiteside County",5,56,677,336,341
050,17,195,"Illinois","Whiteside County",5,57,664,326,338
050,17,195,"Illinois","Whiteside County",5,58,732,366,366
050,17,195,"Illinois","Whiteside County",5,59,744,379,365
050,17,195,"Illinois","Whiteside County",5,60,744,376,368
050,17,195,"Illinois","Whiteside County",5,61,768,376,392
050,17,195,"Illinois","Whiteside County",5,62,800,378,422
050,17,195,"Illinois","Whiteside County",5,63,795,386,409
050,17,195,"Illinois","Whiteside County",5,64,777,389,388
050,17,195,"Illinois","Whiteside County",5,65,801,401,400
050,17,195,"Illinois","Whiteside County",5,66,807,389,418
050,17,195,"Illinois","Whiteside County",5,67,804,395,409
050,17,195,"Illinois","Whiteside County",5,68,737,361,376
050,17,195,"Illinois","Whiteside County",5,69,738,358,380
050,17,195,"Illinois","Whiteside County",5,70,708,351,357
050,17,195,"Illinois","Whiteside County",5,71,684,336,348
050,17,195,"Illinois","Whiteside County",5,72,638,314,324
050,17,195,"Illinois","Whiteside County",5,73,560,283,277
050,17,195,"Illinois","Whiteside County",5,74,560,263,297
050,17,195,"Illinois","Whiteside County",5,75,541,257,284
050,17,195,"Illinois","Whiteside County",5,76,587,268,319
050,17,195,"Illinois","Whiteside County",5,77,396,173,223
050,17,195,"Illinois","Whiteside County",5,78,400,170,230
050,17,195,"Illinois","Whiteside County",5,79,373,170,203
050,17,195,"Illinois","Whiteside County",5,80,385,172,213
050,17,195,"Illinois","Whiteside County",5,81,304,117,187
050,17,195,"Illinois","Whiteside County",5,82,285,118,167
050,17,195,"Illinois","Whiteside County",5,83,260,114,146
050,17,195,"Illinois","Whiteside County",5,84,236,99,137
050,17,195,"Illinois","Whiteside County",5,85,1413,512,901
050,17,197,"Illinois","Will County",1,0,7113,3612,3501
050,17,197,"Illinois","Will County",1,1,7509,3783,3726
050,17,197,"Illinois","Will County",1,2,7822,3925,3897
050,17,197,"Illinois","Will County",1,3,8216,4125,4091
050,17,197,"Illinois","Will County",1,4,8675,4393,4282
050,17,197,"Illinois","Will County",1,5,8778,4457,4321
050,17,197,"Illinois","Will County",1,6,8636,4413,4223
050,17,197,"Illinois","Will County",1,7,8922,4619,4303
050,17,197,"Illinois","Will County",1,8,9140,4678,4462
050,17,197,"Illinois","Will County",1,9,9295,4766,4529
050,17,197,"Illinois","Will County",1,10,9937,5054,4883
050,17,197,"Illinois","Will County",1,11,10288,5240,5048
050,17,197,"Illinois","Will County",1,12,10919,5514,5405
050,17,197,"Illinois","Will County",1,13,11014,5557,5457
050,17,197,"Illinois","Will County",1,14,11029,5647,5382
050,17,197,"Illinois","Will County",1,15,11127,5736,5391
050,17,197,"Illinois","Will County",1,16,11285,5800,5485
050,17,197,"Illinois","Will County",1,17,11261,5783,5478
050,17,197,"Illinois","Will County",1,18,10039,5227,4812
050,17,197,"Illinois","Will County",1,19,8828,4665,4163
050,17,197,"Illinois","Will County",1,20,8929,4653,4276
050,17,197,"Illinois","Will County",1,21,8904,4628,4276
050,17,197,"Illinois","Will County",1,22,8901,4603,4298
050,17,197,"Illinois","Will County",1,23,8778,4507,4271
050,17,197,"Illinois","Will County",1,24,8586,4338,4248
050,17,197,"Illinois","Will County",1,25,8269,4226,4043
050,17,197,"Illinois","Will County",1,26,8229,4233,3996
050,17,197,"Illinois","Will County",1,27,8402,4215,4187
050,17,197,"Illinois","Will County",1,28,8186,4152,4034
050,17,197,"Illinois","Will County",1,29,8170,4159,4011
050,17,197,"Illinois","Will County",1,30,8140,4129,4011
050,17,197,"Illinois","Will County",1,31,7840,3980,3860
050,17,197,"Illinois","Will County",1,32,8162,4118,4044
050,17,197,"Illinois","Will County",1,33,8225,4176,4049
050,17,197,"Illinois","Will County",1,34,8554,4322,4232
050,17,197,"Illinois","Will County",1,35,8861,4502,4359
050,17,197,"Illinois","Will County",1,36,9082,4534,4548
050,17,197,"Illinois","Will County",1,37,9317,4630,4687
050,17,197,"Illinois","Will County",1,38,9500,4698,4802
050,17,197,"Illinois","Will County",1,39,9586,4800,4786
050,17,197,"Illinois","Will County",1,40,9830,4881,4949
050,17,197,"Illinois","Will County",1,41,9490,4685,4805
050,17,197,"Illinois","Will County",1,42,9503,4719,4784
050,17,197,"Illinois","Will County",1,43,9525,4711,4814
050,17,197,"Illinois","Will County",1,44,9502,4716,4786
050,17,197,"Illinois","Will County",1,45,9685,4859,4826
050,17,197,"Illinois","Will County",1,46,9600,4813,4787
050,17,197,"Illinois","Will County",1,47,9995,5034,4961
050,17,197,"Illinois","Will County",1,48,10484,5218,5266
050,17,197,"Illinois","Will County",1,49,11066,5569,5497
050,17,197,"Illinois","Will County",1,50,10725,5384,5341
050,17,197,"Illinois","Will County",1,51,10287,5161,5126
050,17,197,"Illinois","Will County",1,52,9900,4973,4927
050,17,197,"Illinois","Will County",1,53,10055,5070,4985
050,17,197,"Illinois","Will County",1,54,10032,5087,4945
050,17,197,"Illinois","Will County",1,55,10116,5147,4969
050,17,197,"Illinois","Will County",1,56,10082,5123,4959
050,17,197,"Illinois","Will County",1,57,9963,4985,4978
050,17,197,"Illinois","Will County",1,58,9621,4823,4798
050,17,197,"Illinois","Will County",1,59,9280,4671,4609
050,17,197,"Illinois","Will County",1,60,8887,4454,4433
050,17,197,"Illinois","Will County",1,61,8860,4442,4418
050,17,197,"Illinois","Will County",1,62,8505,4220,4285
050,17,197,"Illinois","Will County",1,63,7915,3952,3963
050,17,197,"Illinois","Will County",1,64,7529,3755,3774
050,17,197,"Illinois","Will County",1,65,7218,3572,3646
050,17,197,"Illinois","Will County",1,66,6727,3318,3409
050,17,197,"Illinois","Will County",1,67,6565,3198,3367
050,17,197,"Illinois","Will County",1,68,6231,3019,3212
050,17,197,"Illinois","Will County",1,69,5847,2725,3122
050,17,197,"Illinois","Will County",1,70,5585,2584,3001
050,17,197,"Illinois","Will County",1,71,5420,2503,2917
050,17,197,"Illinois","Will County",1,72,5539,2613,2926
050,17,197,"Illinois","Will County",1,73,5451,2578,2873
050,17,197,"Illinois","Will County",1,74,3822,1755,2067
050,17,197,"Illinois","Will County",1,75,3704,1707,1997
050,17,197,"Illinois","Will County",1,76,3693,1715,1978
050,17,197,"Illinois","Will County",1,77,3726,1687,2039
050,17,197,"Illinois","Will County",1,78,3129,1404,1725
050,17,197,"Illinois","Will County",1,79,2529,1093,1436
050,17,197,"Illinois","Will County",1,80,2325,975,1350
050,17,197,"Illinois","Will County",1,81,2285,955,1330
050,17,197,"Illinois","Will County",1,82,2012,840,1172
050,17,197,"Illinois","Will County",1,83,1760,711,1049
050,17,197,"Illinois","Will County",1,84,1661,649,1012
050,17,197,"Illinois","Will County",1,85,9178,3130,6048
050,17,197,"Illinois","Will County",2,0,7101,3633,3468
050,17,197,"Illinois","Will County",2,1,7448,3758,3690
050,17,197,"Illinois","Will County",2,2,7786,3904,3882
050,17,197,"Illinois","Will County",2,3,8123,4076,4047
050,17,197,"Illinois","Will County",2,4,8623,4357,4266
050,17,197,"Illinois","Will County",2,5,8777,4454,4323
050,17,197,"Illinois","Will County",2,6,8701,4444,4257
050,17,197,"Illinois","Will County",2,7,8861,4565,4296
050,17,197,"Illinois","Will County",2,8,9063,4646,4417
050,17,197,"Illinois","Will County",2,9,9262,4749,4513
050,17,197,"Illinois","Will County",2,10,9796,4987,4809
050,17,197,"Illinois","Will County",2,11,10177,5179,4998
050,17,197,"Illinois","Will County",2,12,10807,5464,5343
050,17,197,"Illinois","Will County",2,13,10969,5537,5432
050,17,197,"Illinois","Will County",2,14,11021,5624,5397
050,17,197,"Illinois","Will County",2,15,11099,5712,5387
050,17,197,"Illinois","Will County",2,16,11259,5791,5468
050,17,197,"Illinois","Will County",2,17,11264,5782,5482
050,17,197,"Illinois","Will County",2,18,9963,5193,4770
050,17,197,"Illinois","Will County",2,19,8853,4657,4196
050,17,197,"Illinois","Will County",2,20,9049,4718,4331
050,17,197,"Illinois","Will County",2,21,8914,4625,4289
050,17,197,"Illinois","Will County",2,22,8880,4590,4290
050,17,197,"Illinois","Will County",2,23,8775,4512,4263
050,17,197,"Illinois","Will County",2,24,8551,4339,4212
050,17,197,"Illinois","Will County",2,25,8293,4225,4068
050,17,197,"Illinois","Will County",2,26,8235,4220,4015
050,17,197,"Illinois","Will County",2,27,8347,4208,4139
050,17,197,"Illinois","Will County",2,28,8246,4174,4072
050,17,197,"Illinois","Will County",2,29,8200,4162,4038
050,17,197,"Illinois","Will County",2,30,8224,4172,4052
050,17,197,"Illinois","Will County",2,31,7939,4028,3911
050,17,197,"Illinois","Will County",2,32,8120,4101,4019
050,17,197,"Illinois","Will County",2,33,8241,4186,4055
050,17,197,"Illinois","Will County",2,34,8523,4318,4205
050,17,197,"Illinois","Will County",2,35,8894,4520,4374
050,17,197,"Illinois","Will County",2,36,9007,4519,4488
050,17,197,"Illinois","Will County",2,37,9297,4620,4677
050,17,197,"Illinois","Will County",2,38,9490,4695,4795
050,17,197,"Illinois","Will County",2,39,9548,4770,4778
050,17,197,"Illinois","Will County",2,40,9851,4911,4940
050,17,197,"Illinois","Will County",2,41,9565,4724,4841
050,17,197,"Illinois","Will County",2,42,9458,4694,4764
050,17,197,"Illinois","Will County",2,43,9556,4730,4826
050,17,197,"Illinois","Will County",2,44,9428,4681,4747
050,17,197,"Illinois","Will County",2,45,9671,4840,4831
050,17,197,"Illinois","Will County",2,46,9576,4807,4769
050,17,197,"Illinois","Will County",2,47,9834,4943,4891
050,17,197,"Illinois","Will County",2,48,10342,5165,5177
050,17,197,"Illinois","Will County",2,49,10934,5490,5444
050,17,197,"Illinois","Will County",2,50,10785,5424,5361
050,17,197,"Illinois","Will County",2,51,10292,5165,5127
050,17,197,"Illinois","Will County",2,52,9950,4995,4955
050,17,197,"Illinois","Will County",2,53,9968,5018,4950
050,17,197,"Illinois","Will County",2,54,9982,5057,4925
050,17,197,"Illinois","Will County",2,55,10055,5107,4948
050,17,197,"Illinois","Will County",2,56,10095,5128,4967
050,17,197,"Illinois","Will County",2,57,9940,4984,4956
050,17,197,"Illinois","Will County",2,58,9636,4831,4805
050,17,197,"Illinois","Will County",2,59,9343,4697,4646
050,17,197,"Illinois","Will County",2,60,8944,4494,4450
050,17,197,"Illinois","Will County",2,61,8798,4404,4394
050,17,197,"Illinois","Will County",2,62,8529,4242,4287
050,17,197,"Illinois","Will County",2,63,8083,4029,4054
050,17,197,"Illinois","Will County",2,64,7536,3752,3784
050,17,197,"Illinois","Will County",2,65,7246,3593,3653
050,17,197,"Illinois","Will County",2,66,6802,3358,3444
050,17,197,"Illinois","Will County",2,67,6554,3199,3355
050,17,197,"Illinois","Will County",2,68,6241,3029,3212
050,17,197,"Illinois","Will County",2,69,5941,2792,3149
050,17,197,"Illinois","Will County",2,70,5610,2604,3006
050,17,197,"Illinois","Will County",2,71,5422,2497,2925
050,17,197,"Illinois","Will County",2,72,5395,2527,2868
050,17,197,"Illinois","Will County",2,73,5674,2677,2997
050,17,197,"Illinois","Will County",2,74,3962,1838,2124
050,17,197,"Illinois","Will County",2,75,3720,1708,2012
050,17,197,"Illinois","Will County",2,76,3627,1676,1951
050,17,197,"Illinois","Will County",2,77,3757,1707,2050
050,17,197,"Illinois","Will County",2,78,3178,1423,1755
050,17,197,"Illinois","Will County",2,79,2615,1134,1481
050,17,197,"Illinois","Will County",2,80,2344,984,1360
050,17,197,"Illinois","Will County",2,81,2229,929,1300
050,17,197,"Illinois","Will County",2,82,2051,850,1201
050,17,197,"Illinois","Will County",2,83,1781,717,1064
050,17,197,"Illinois","Will County",2,84,1627,641,986
050,17,197,"Illinois","Will County",2,85,9173,3142,6031
050,17,197,"Illinois","Will County",3,0,6809,3413,3396
050,17,197,"Illinois","Will County",3,1,7386,3773,3613
050,17,197,"Illinois","Will County",3,2,7717,3936,3781
050,17,197,"Illinois","Will County",3,3,8043,4108,3935
050,17,197,"Illinois","Will County",3,4,8231,4147,4084
050,17,197,"Illinois","Will County",3,5,8786,4456,4330
050,17,197,"Illinois","Will County",3,6,8871,4532,4339
050,17,197,"Illinois","Will County",3,7,8829,4499,4330
050,17,197,"Illinois","Will County",3,8,8902,4599,4303
050,17,197,"Illinois","Will County",3,9,9186,4693,4493
050,17,197,"Illinois","Will County",3,10,9347,4783,4564
050,17,197,"Illinois","Will County",3,11,9778,4976,4802
050,17,197,"Illinois","Will County",3,12,10243,5232,5011
050,17,197,"Illinois","Will County",3,13,10864,5507,5357
050,17,197,"Illinois","Will County",3,14,10902,5496,5406
050,17,197,"Illinois","Will County",3,15,11067,5620,5447
050,17,197,"Illinois","Will County",3,16,11105,5730,5375
050,17,197,"Illinois","Will County",3,17,11253,5801,5452
050,17,197,"Illinois","Will County",3,18,10055,5282,4773
050,17,197,"Illinois","Will County",3,19,8784,4608,4176
050,17,197,"Illinois","Will County",3,20,9179,4825,4354
050,17,197,"Illinois","Will County",3,21,9235,4802,4433
050,17,197,"Illinois","Will County",3,22,9027,4618,4409
050,17,197,"Illinois","Will County",3,23,8795,4586,4209
050,17,197,"Illinois","Will County",3,24,8657,4500,4157
050,17,197,"Illinois","Will County",3,25,8399,4233,4166
050,17,197,"Illinois","Will County",3,26,8311,4244,4067
050,17,197,"Illinois","Will County",3,27,8287,4252,4035
050,17,197,"Illinois","Will County",3,28,8365,4229,4136
050,17,197,"Illinois","Will County",3,29,8418,4242,4176
050,17,197,"Illinois","Will County",3,30,8500,4291,4209
050,17,197,"Illinois","Will County",3,31,8494,4295,4199
050,17,197,"Illinois","Will County",3,32,8238,4190,4048
050,17,197,"Illinois","Will County",3,33,8440,4273,4167
050,17,197,"Illinois","Will County",3,34,8511,4326,4185
050,17,197,"Illinois","Will County",3,35,8770,4448,4322
050,17,197,"Illinois","Will County",3,36,9179,4684,4495
050,17,197,"Illinois","Will County",3,37,9189,4597,4592
050,17,197,"Illinois","Will County",3,38,9467,4725,4742
050,17,197,"Illinois","Will County",3,39,9634,4786,4848
050,17,197,"Illinois","Will County",3,40,9699,4862,4837
050,17,197,"Illinois","Will County",3,41,9916,4956,4960
050,17,197,"Illinois","Will County",3,42,9688,4809,4879
050,17,197,"Illinois","Will County",3,43,9494,4715,4779
050,17,197,"Illinois","Will County",3,44,9550,4769,4781
050,17,197,"Illinois","Will County",3,45,9440,4680,4760
050,17,197,"Illinois","Will County",3,46,9707,4881,4826
050,17,197,"Illinois","Will County",3,47,9488,4777,4711
050,17,197,"Illinois","Will County",3,48,9765,4941,4824
050,17,197,"Illinois","Will County",3,49,10284,5122,5162
050,17,197,"Illinois","Will County",3,50,10869,5455,5414
050,17,197,"Illinois","Will County",3,51,10718,5389,5329
050,17,197,"Illinois","Will County",3,52,10169,5119,5050
050,17,197,"Illinois","Will County",3,53,9810,4928,4882
050,17,197,"Illinois","Will County",3,54,9781,4940,4841
050,17,197,"Illinois","Will County",3,55,9809,4973,4836
050,17,197,"Illinois","Will County",3,56,9897,5025,4872
050,17,197,"Illinois","Will County",3,57,9923,5015,4908
050,17,197,"Illinois","Will County",3,58,9640,4831,4809
050,17,197,"Illinois","Will County",3,59,9436,4735,4701
050,17,197,"Illinois","Will County",3,60,9104,4583,4521
050,17,197,"Illinois","Will County",3,61,8768,4397,4371
050,17,197,"Illinois","Will County",3,62,8583,4277,4306
050,17,197,"Illinois","Will County",3,63,8387,4169,4218
050,17,197,"Illinois","Will County",3,64,7847,3868,3979
050,17,197,"Illinois","Will County",3,65,7434,3701,3733
050,17,197,"Illinois","Will County",3,66,7080,3506,3574
050,17,197,"Illinois","Will County",3,67,6694,3279,3415
050,17,197,"Illinois","Will County",3,68,6442,3140,3302
050,17,197,"Illinois","Will County",3,69,6112,2947,3165
050,17,197,"Illinois","Will County",3,70,5777,2701,3076
050,17,197,"Illinois","Will County",3,71,5476,2516,2960
050,17,197,"Illinois","Will County",3,72,5257,2406,2851
050,17,197,"Illinois","Will County",3,73,5238,2425,2813
050,17,197,"Illinois","Will County",3,74,5550,2593,2957
050,17,197,"Illinois","Will County",3,75,3819,1740,2079
050,17,197,"Illinois","Will County",3,76,3606,1649,1957
050,17,197,"Illinois","Will County",3,77,3456,1577,1879
050,17,197,"Illinois","Will County",3,78,3617,1626,1991
050,17,197,"Illinois","Will County",3,79,3024,1324,1700
050,17,197,"Illinois","Will County",3,80,2462,1052,1410
050,17,197,"Illinois","Will County",3,81,2166,888,1278
050,17,197,"Illinois","Will County",3,82,2084,846,1238
050,17,197,"Illinois","Will County",3,83,1922,772,1150
050,17,197,"Illinois","Will County",3,84,1632,644,988
050,17,197,"Illinois","Will County",3,85,9303,3228,6075
050,17,197,"Illinois","Will County",4,0,6895,3492,3403
050,17,197,"Illinois","Will County",4,1,7259,3689,3570
050,17,197,"Illinois","Will County",4,2,7592,3915,3677
050,17,197,"Illinois","Will County",4,3,7983,4102,3881
050,17,197,"Illinois","Will County",4,4,8296,4216,4080
050,17,197,"Illinois","Will County",4,5,8405,4248,4157
050,17,197,"Illinois","Will County",4,6,8950,4558,4392
050,17,197,"Illinois","Will County",4,7,8988,4586,4402
050,17,197,"Illinois","Will County",4,8,8942,4546,4396
050,17,197,"Illinois","Will County",4,9,8976,4613,4363
050,17,197,"Illinois","Will County",4,10,9297,4744,4553
050,17,197,"Illinois","Will County",4,11,9396,4802,4594
050,17,197,"Illinois","Will County",4,12,9897,5020,4877
050,17,197,"Illinois","Will County",4,13,10282,5230,5052
050,17,197,"Illinois","Will County",4,14,10868,5507,5361
050,17,197,"Illinois","Will County",4,15,10897,5495,5402
050,17,197,"Illinois","Will County",4,16,10977,5565,5412
050,17,197,"Illinois","Will County",4,17,11067,5734,5333
050,17,197,"Illinois","Will County",4,18,9892,5189,4703
050,17,197,"Illinois","Will County",4,19,8551,4522,4029
050,17,197,"Illinois","Will County",4,20,8892,4667,4225
050,17,197,"Illinois","Will County",4,21,9126,4756,4370
050,17,197,"Illinois","Will County",4,22,9273,4780,4493
050,17,197,"Illinois","Will County",4,23,8702,4467,4235
050,17,197,"Illinois","Will County",4,24,8446,4397,4049
050,17,197,"Illinois","Will County",4,25,8282,4323,3959
050,17,197,"Illinois","Will County",4,26,8095,4118,3977
050,17,197,"Illinois","Will County",4,27,8084,4116,3968
050,17,197,"Illinois","Will County",4,28,8284,4230,4054
050,17,197,"Illinois","Will County",4,29,8387,4218,4169
050,17,197,"Illinois","Will County",4,30,8548,4279,4269
050,17,197,"Illinois","Will County",4,31,8703,4396,4307
050,17,197,"Illinois","Will County",4,32,8726,4389,4337
050,17,197,"Illinois","Will County",4,33,8466,4287,4179
050,17,197,"Illinois","Will County",4,34,8693,4407,4286
050,17,197,"Illinois","Will County",4,35,8782,4485,4297
050,17,197,"Illinois","Will County",4,36,9048,4556,4492
050,17,197,"Illinois","Will County",4,37,9360,4779,4581
050,17,197,"Illinois","Will County",4,38,9362,4677,4685
050,17,197,"Illinois","Will County",4,39,9636,4786,4850
050,17,197,"Illinois","Will County",4,40,9805,4898,4907
050,17,197,"Illinois","Will County",4,41,9770,4906,4864
050,17,197,"Illinois","Will County",4,42,9978,5016,4962
050,17,197,"Illinois","Will County",4,43,9683,4804,4879
050,17,197,"Illinois","Will County",4,44,9522,4754,4768
050,17,197,"Illinois","Will County",4,45,9572,4787,4785
050,17,197,"Illinois","Will County",4,46,9380,4657,4723
050,17,197,"Illinois","Will County",4,47,9634,4845,4789
050,17,197,"Illinois","Will County",4,48,9400,4723,4677
050,17,197,"Illinois","Will County",4,49,9606,4824,4782
050,17,197,"Illinois","Will County",4,50,10180,5067,5113
050,17,197,"Illinois","Will County",4,51,10685,5357,5328
050,17,197,"Illinois","Will County",4,52,10526,5279,5247
050,17,197,"Illinois","Will County",4,53,9913,4991,4922
050,17,197,"Illinois","Will County",4,54,9627,4870,4757
050,17,197,"Illinois","Will County",4,55,9484,4782,4702
050,17,197,"Illinois","Will County",4,56,9639,4894,4745
050,17,197,"Illinois","Will County",4,57,9697,4890,4807
050,17,197,"Illinois","Will County",4,58,9648,4867,4781
050,17,197,"Illinois","Will County",4,59,9450,4734,4716
050,17,197,"Illinois","Will County",4,60,9184,4620,4564
050,17,197,"Illinois","Will County",4,61,8861,4428,4433
050,17,197,"Illinois","Will County",4,62,8506,4236,4270
050,17,197,"Illinois","Will County",4,63,8395,4190,4205
050,17,197,"Illinois","Will County",4,64,8102,3981,4121
050,17,197,"Illinois","Will County",4,65,7669,3771,3898
050,17,197,"Illinois","Will County",4,66,7201,3562,3639
050,17,197,"Illinois","Will County",4,67,6967,3443,3524
050,17,197,"Illinois","Will County",4,68,6548,3167,3381
050,17,197,"Illinois","Will County",4,69,6289,3046,3243
050,17,197,"Illinois","Will County",4,70,5928,2850,3078
050,17,197,"Illinois","Will County",4,71,5644,2618,3026
050,17,197,"Illinois","Will County",4,72,5345,2435,2910
050,17,197,"Illinois","Will County",4,73,5131,2318,2813
050,17,197,"Illinois","Will County",4,74,5105,2363,2742
050,17,197,"Illinois","Will County",4,75,5370,2483,2887
050,17,197,"Illinois","Will County",4,76,3733,1691,2042
050,17,197,"Illinois","Will County",4,77,3446,1559,1887
050,17,197,"Illinois","Will County",4,78,3331,1504,1827
050,17,197,"Illinois","Will County",4,79,3446,1523,1923
050,17,197,"Illinois","Will County",4,80,2890,1247,1643
050,17,197,"Illinois","Will County",4,81,2307,978,1329
050,17,197,"Illinois","Will County",4,82,2006,814,1192
050,17,197,"Illinois","Will County",4,83,1946,768,1178
050,17,197,"Illinois","Will County",4,84,1774,707,1067
050,17,197,"Illinois","Will County",4,85,9418,3286,6132
050,17,197,"Illinois","Will County",5,0,6889,3488,3401
050,17,197,"Illinois","Will County",5,1,7226,3691,3535
050,17,197,"Illinois","Will County",5,2,7484,3797,3687
050,17,197,"Illinois","Will County",5,3,7885,4063,3822
050,17,197,"Illinois","Will County",5,4,8182,4203,3979
050,17,197,"Illinois","Will County",5,5,8469,4278,4191
050,17,197,"Illinois","Will County",5,6,8558,4364,4194
050,17,197,"Illinois","Will County",5,7,9112,4608,4504
050,17,197,"Illinois","Will County",5,8,9093,4637,4456
050,17,197,"Illinois","Will County",5,9,9015,4583,4432
050,17,197,"Illinois","Will County",5,10,9140,4687,4453
050,17,197,"Illinois","Will County",5,11,9374,4776,4598
050,17,197,"Illinois","Will County",5,12,9495,4851,4644
050,17,197,"Illinois","Will County",5,13,10049,5089,4960
050,17,197,"Illinois","Will County",5,14,10333,5246,5087
050,17,197,"Illinois","Will County",5,15,10875,5518,5357
050,17,197,"Illinois","Will County",5,16,10892,5507,5385
050,17,197,"Illinois","Will County",5,17,11030,5587,5443
050,17,197,"Illinois","Will County",5,18,9779,5160,4619
050,17,197,"Illinois","Will County",5,19,8625,4574,4051
050,17,197,"Illinois","Will County",5,20,8911,4681,4230
050,17,197,"Illinois","Will County",5,21,9143,4725,4418
050,17,197,"Illinois","Will County",5,22,9187,4722,4465
050,17,197,"Illinois","Will County",5,23,9130,4688,4442
050,17,197,"Illinois","Will County",5,24,8480,4357,4123
050,17,197,"Illinois","Will County",5,25,8171,4322,3849
050,17,197,"Illinois","Will County",5,26,8196,4276,3920
050,17,197,"Illinois","Will County",5,27,8048,4046,4002
050,17,197,"Illinois","Will County",5,28,8150,4112,4038
050,17,197,"Illinois","Will County",5,29,8320,4217,4103
050,17,197,"Illinois","Will County",5,30,8525,4288,4237
050,17,197,"Illinois","Will County",5,31,8691,4336,4355
050,17,197,"Illinois","Will County",5,32,8924,4456,4468
050,17,197,"Illinois","Will County",5,33,8943,4451,4492
050,17,197,"Illinois","Will County",5,34,8681,4408,4273
050,17,197,"Illinois","Will County",5,35,8941,4543,4398
050,17,197,"Illinois","Will County",5,36,9000,4581,4419
050,17,197,"Illinois","Will County",5,37,9202,4637,4565
050,17,197,"Illinois","Will County",5,38,9542,4830,4712
050,17,197,"Illinois","Will County",5,39,9481,4741,4740
050,17,197,"Illinois","Will County",5,40,9779,4913,4866
050,17,197,"Illinois","Will County",5,41,9881,4940,4941
050,17,197,"Illinois","Will County",5,42,9844,4957,4887
050,17,197,"Illinois","Will County",5,43,10033,5028,5005
050,17,197,"Illinois","Will County",5,44,9710,4829,4881
050,17,197,"Illinois","Will County",5,45,9575,4774,4801
050,17,197,"Illinois","Will County",5,46,9556,4769,4787
050,17,197,"Illinois","Will County",5,47,9403,4685,4718
050,17,197,"Illinois","Will County",5,48,9546,4801,4745
050,17,197,"Illinois","Will County",5,49,9234,4651,4583
050,17,197,"Illinois","Will County",5,50,9552,4802,4750
050,17,197,"Illinois","Will County",5,51,10077,5013,5064
050,17,197,"Illinois","Will County",5,52,10593,5300,5293
050,17,197,"Illinois","Will County",5,53,10383,5229,5154
050,17,197,"Illinois","Will County",5,54,9793,4923,4870
050,17,197,"Illinois","Will County",5,55,9525,4820,4705
050,17,197,"Illinois","Will County",5,56,9371,4701,4670
050,17,197,"Illinois","Will County",5,57,9496,4808,4688
050,17,197,"Illinois","Will County",5,58,9459,4764,4695
050,17,197,"Illinois","Will County",5,59,9453,4753,4700
050,17,197,"Illinois","Will County",5,60,9301,4681,4620
050,17,197,"Illinois","Will County",5,61,9008,4487,4521
050,17,197,"Illinois","Will County",5,62,8654,4315,4339
050,17,197,"Illinois","Will County",5,63,8360,4162,4198
050,17,197,"Illinois","Will County",5,64,8226,4065,4161
050,17,197,"Illinois","Will County",5,65,7963,3890,4073
050,17,197,"Illinois","Will County",5,66,7505,3675,3830
050,17,197,"Illinois","Will County",5,67,7108,3481,3627
050,17,197,"Illinois","Will County",5,68,6855,3387,3468
050,17,197,"Illinois","Will County",5,69,6439,3088,3351
050,17,197,"Illinois","Will County",5,70,6149,2975,3174
050,17,197,"Illinois","Will County",5,71,5815,2776,3039
050,17,197,"Illinois","Will County",5,72,5539,2568,2971
050,17,197,"Illinois","Will County",5,73,5276,2378,2898
050,17,197,"Illinois","Will County",5,74,5061,2271,2790
050,17,197,"Illinois","Will County",5,75,4970,2266,2704
050,17,197,"Illinois","Will County",5,76,5245,2415,2830
050,17,197,"Illinois","Will County",5,77,3580,1606,1974
050,17,197,"Illinois","Will County",5,78,3327,1502,1825
050,17,197,"Illinois","Will County",5,79,3192,1417,1775
050,17,197,"Illinois","Will County",5,80,3327,1449,1878
050,17,197,"Illinois","Will County",5,81,2733,1175,1558
050,17,197,"Illinois","Will County",5,82,2191,916,1275
050,17,197,"Illinois","Will County",5,83,1889,748,1141
050,17,197,"Illinois","Will County",5,84,1818,709,1109
050,17,197,"Illinois","Will County",5,85,9763,3446,6317
050,17,199,"Illinois","Williamson County",1,0,693,355,338
050,17,199,"Illinois","Williamson County",1,1,721,375,346
050,17,199,"Illinois","Williamson County",1,2,770,433,337
050,17,199,"Illinois","Williamson County",1,3,774,405,369
050,17,199,"Illinois","Williamson County",1,4,845,437,408
050,17,199,"Illinois","Williamson County",1,5,828,423,405
050,17,199,"Illinois","Williamson County",1,6,810,438,372
050,17,199,"Illinois","Williamson County",1,7,800,420,380
050,17,199,"Illinois","Williamson County",1,8,809,425,384
050,17,199,"Illinois","Williamson County",1,9,810,422,388
050,17,199,"Illinois","Williamson County",1,10,831,443,388
050,17,199,"Illinois","Williamson County",1,11,840,451,389
050,17,199,"Illinois","Williamson County",1,12,888,454,434
050,17,199,"Illinois","Williamson County",1,13,830,429,401
050,17,199,"Illinois","Williamson County",1,14,835,438,397
050,17,199,"Illinois","Williamson County",1,15,865,451,414
050,17,199,"Illinois","Williamson County",1,16,869,469,400
050,17,199,"Illinois","Williamson County",1,17,869,418,451
050,17,199,"Illinois","Williamson County",1,18,695,352,343
050,17,199,"Illinois","Williamson County",1,19,553,288,265
050,17,199,"Illinois","Williamson County",1,20,600,333,267
050,17,199,"Illinois","Williamson County",1,21,641,346,295
050,17,199,"Illinois","Williamson County",1,22,652,332,320
050,17,199,"Illinois","Williamson County",1,23,664,344,320
050,17,199,"Illinois","Williamson County",1,24,736,385,351
050,17,199,"Illinois","Williamson County",1,25,763,396,367
050,17,199,"Illinois","Williamson County",1,26,801,408,393
050,17,199,"Illinois","Williamson County",1,27,811,412,399
050,17,199,"Illinois","Williamson County",1,28,855,436,419
050,17,199,"Illinois","Williamson County",1,29,905,473,432
050,17,199,"Illinois","Williamson County",1,30,894,465,429
050,17,199,"Illinois","Williamson County",1,31,899,454,445
050,17,199,"Illinois","Williamson County",1,32,868,444,424
050,17,199,"Illinois","Williamson County",1,33,879,479,400
050,17,199,"Illinois","Williamson County",1,34,867,454,413
050,17,199,"Illinois","Williamson County",1,35,901,480,421
050,17,199,"Illinois","Williamson County",1,36,869,433,436
050,17,199,"Illinois","Williamson County",1,37,915,469,446
050,17,199,"Illinois","Williamson County",1,38,933,490,443
050,17,199,"Illinois","Williamson County",1,39,942,495,447
050,17,199,"Illinois","Williamson County",1,40,950,474,476
050,17,199,"Illinois","Williamson County",1,41,886,461,425
050,17,199,"Illinois","Williamson County",1,42,855,461,394
050,17,199,"Illinois","Williamson County",1,43,819,429,390
050,17,199,"Illinois","Williamson County",1,44,803,418,385
050,17,199,"Illinois","Williamson County",1,45,837,433,404
050,17,199,"Illinois","Williamson County",1,46,794,409,385
050,17,199,"Illinois","Williamson County",1,47,841,437,404
050,17,199,"Illinois","Williamson County",1,48,881,454,427
050,17,199,"Illinois","Williamson County",1,49,963,505,458
050,17,199,"Illinois","Williamson County",1,50,865,432,433
050,17,199,"Illinois","Williamson County",1,51,803,417,386
050,17,199,"Illinois","Williamson County",1,52,826,410,416
050,17,199,"Illinois","Williamson County",1,53,789,414,375
050,17,199,"Illinois","Williamson County",1,54,841,442,399
050,17,199,"Illinois","Williamson County",1,55,900,431,469
050,17,199,"Illinois","Williamson County",1,56,914,452,462
050,17,199,"Illinois","Williamson County",1,57,931,459,472
050,17,199,"Illinois","Williamson County",1,58,952,474,478
050,17,199,"Illinois","Williamson County",1,59,964,481,483
050,17,199,"Illinois","Williamson County",1,60,958,457,501
050,17,199,"Illinois","Williamson County",1,61,920,446,474
050,17,199,"Illinois","Williamson County",1,62,904,458,446
050,17,199,"Illinois","Williamson County",1,63,921,452,469
050,17,199,"Illinois","Williamson County",1,64,885,437,448
050,17,199,"Illinois","Williamson County",1,65,839,402,437
050,17,199,"Illinois","Williamson County",1,66,816,399,417
050,17,199,"Illinois","Williamson County",1,67,823,384,439
050,17,199,"Illinois","Williamson County",1,68,787,374,413
050,17,199,"Illinois","Williamson County",1,69,712,342,370
050,17,199,"Illinois","Williamson County",1,70,706,349,357
050,17,199,"Illinois","Williamson County",1,71,720,328,392
050,17,199,"Illinois","Williamson County",1,72,766,369,397
050,17,199,"Illinois","Williamson County",1,73,800,385,415
050,17,199,"Illinois","Williamson County",1,74,523,242,281
050,17,199,"Illinois","Williamson County",1,75,557,243,314
050,17,199,"Illinois","Williamson County",1,76,546,233,313
050,17,199,"Illinois","Williamson County",1,77,489,222,267
050,17,199,"Illinois","Williamson County",1,78,458,209,249
050,17,199,"Illinois","Williamson County",1,79,419,180,239
050,17,199,"Illinois","Williamson County",1,80,379,155,224
050,17,199,"Illinois","Williamson County",1,81,363,146,217
050,17,199,"Illinois","Williamson County",1,82,318,134,184
050,17,199,"Illinois","Williamson County",1,83,272,103,169
050,17,199,"Illinois","Williamson County",1,84,257,100,157
050,17,199,"Illinois","Williamson County",1,85,1270,465,805
050,17,199,"Illinois","Williamson County",2,0,681,344,337
050,17,199,"Illinois","Williamson County",2,1,710,370,340
050,17,199,"Illinois","Williamson County",2,2,755,416,339
050,17,199,"Illinois","Williamson County",2,3,769,410,359
050,17,199,"Illinois","Williamson County",2,4,829,429,400
050,17,199,"Illinois","Williamson County",2,5,836,429,407
050,17,199,"Illinois","Williamson County",2,6,814,436,378
050,17,199,"Illinois","Williamson County",2,7,799,424,375
050,17,199,"Illinois","Williamson County",2,8,802,420,382
050,17,199,"Illinois","Williamson County",2,9,807,418,389
050,17,199,"Illinois","Williamson County",2,10,831,442,389
050,17,199,"Illinois","Williamson County",2,11,836,450,386
050,17,199,"Illinois","Williamson County",2,12,880,456,424
050,17,199,"Illinois","Williamson County",2,13,840,433,407
050,17,199,"Illinois","Williamson County",2,14,842,439,403
050,17,199,"Illinois","Williamson County",2,15,857,448,409
050,17,199,"Illinois","Williamson County",2,16,869,464,405
050,17,199,"Illinois","Williamson County",2,17,868,429,439
050,17,199,"Illinois","Williamson County",2,18,700,351,349
050,17,199,"Illinois","Williamson County",2,19,563,291,272
050,17,199,"Illinois","Williamson County",2,20,608,331,277
050,17,199,"Illinois","Williamson County",2,21,637,343,294
050,17,199,"Illinois","Williamson County",2,22,652,335,317
050,17,199,"Illinois","Williamson County",2,23,679,350,329
050,17,199,"Illinois","Williamson County",2,24,728,380,348
050,17,199,"Illinois","Williamson County",2,25,763,401,362
050,17,199,"Illinois","Williamson County",2,26,797,409,388
050,17,199,"Illinois","Williamson County",2,27,808,412,396
050,17,199,"Illinois","Williamson County",2,28,843,433,410
050,17,199,"Illinois","Williamson County",2,29,896,466,430
050,17,199,"Illinois","Williamson County",2,30,906,469,437
050,17,199,"Illinois","Williamson County",2,31,890,450,440
050,17,199,"Illinois","Williamson County",2,32,873,445,428
050,17,199,"Illinois","Williamson County",2,33,877,471,406
050,17,199,"Illinois","Williamson County",2,34,870,460,410
050,17,199,"Illinois","Williamson County",2,35,893,474,419
050,17,199,"Illinois","Williamson County",2,36,874,444,430
050,17,199,"Illinois","Williamson County",2,37,914,467,447
050,17,199,"Illinois","Williamson County",2,38,930,484,446
050,17,199,"Illinois","Williamson County",2,39,934,489,445
050,17,199,"Illinois","Williamson County",2,40,952,478,474
050,17,199,"Illinois","Williamson County",2,41,899,466,433
050,17,199,"Illinois","Williamson County",2,42,853,453,400
050,17,199,"Illinois","Williamson County",2,43,833,440,393
050,17,199,"Illinois","Williamson County",2,44,793,412,381
050,17,199,"Illinois","Williamson County",2,45,833,435,398
050,17,199,"Illinois","Williamson County",2,46,794,408,386
050,17,199,"Illinois","Williamson County",2,47,840,439,401
050,17,199,"Illinois","Williamson County",2,48,865,445,420
050,17,199,"Illinois","Williamson County",2,49,946,495,451
050,17,199,"Illinois","Williamson County",2,50,883,445,438
050,17,199,"Illinois","Williamson County",2,51,820,421,399
050,17,199,"Illinois","Williamson County",2,52,814,407,407
050,17,199,"Illinois","Williamson County",2,53,792,410,382
050,17,199,"Illinois","Williamson County",2,54,826,436,390
050,17,199,"Illinois","Williamson County",2,55,879,427,452
050,17,199,"Illinois","Williamson County",2,56,922,455,467
050,17,199,"Illinois","Williamson County",2,57,928,457,471
050,17,199,"Illinois","Williamson County",2,58,941,467,474
050,17,199,"Illinois","Williamson County",2,59,961,479,482
050,17,199,"Illinois","Williamson County",2,60,955,462,493
050,17,199,"Illinois","Williamson County",2,61,923,445,478
050,17,199,"Illinois","Williamson County",2,62,907,454,453
050,17,199,"Illinois","Williamson County",2,63,924,456,468
050,17,199,"Illinois","Williamson County",2,64,887,438,449
050,17,199,"Illinois","Williamson County",2,65,849,408,441
050,17,199,"Illinois","Williamson County",2,66,820,400,420
050,17,199,"Illinois","Williamson County",2,67,818,385,433
050,17,199,"Illinois","Williamson County",2,68,791,373,418
050,17,199,"Illinois","Williamson County",2,69,732,351,381
050,17,199,"Illinois","Williamson County",2,70,702,344,358
050,17,199,"Illinois","Williamson County",2,71,714,334,380
050,17,199,"Illinois","Williamson County",2,72,739,350,389
050,17,199,"Illinois","Williamson County",2,73,826,397,429
050,17,199,"Illinois","Williamson County",2,74,542,253,289
050,17,199,"Illinois","Williamson County",2,75,548,242,306
050,17,199,"Illinois","Williamson County",2,76,540,233,307
050,17,199,"Illinois","Williamson County",2,77,515,230,285
050,17,199,"Illinois","Williamson County",2,78,453,205,248
050,17,199,"Illinois","Williamson County",2,79,421,184,237
050,17,199,"Illinois","Williamson County",2,80,380,156,224
050,17,199,"Illinois","Williamson County",2,81,362,146,216
050,17,199,"Illinois","Williamson County",2,82,328,135,193
050,17,199,"Illinois","Williamson County",2,83,277,107,170
050,17,199,"Illinois","Williamson County",2,84,252,99,153
050,17,199,"Illinois","Williamson County",2,85,1275,464,811
050,17,199,"Illinois","Williamson County",3,0,651,329,322
050,17,199,"Illinois","Williamson County",3,1,714,364,350
050,17,199,"Illinois","Williamson County",3,2,713,386,327
050,17,199,"Illinois","Williamson County",3,3,752,403,349
050,17,199,"Illinois","Williamson County",3,4,768,406,362
050,17,199,"Illinois","Williamson County",3,5,841,431,410
050,17,199,"Illinois","Williamson County",3,6,820,410,410
050,17,199,"Illinois","Williamson County",3,7,813,434,379
050,17,199,"Illinois","Williamson County",3,8,813,430,383
050,17,199,"Illinois","Williamson County",3,9,818,423,395
050,17,199,"Illinois","Williamson County",3,10,814,433,381
050,17,199,"Illinois","Williamson County",3,11,835,455,380
050,17,199,"Illinois","Williamson County",3,12,848,445,403
050,17,199,"Illinois","Williamson County",3,13,882,450,432
050,17,199,"Illinois","Williamson County",3,14,842,431,411
050,17,199,"Illinois","Williamson County",3,15,835,434,401
050,17,199,"Illinois","Williamson County",3,16,851,450,401
050,17,199,"Illinois","Williamson County",3,17,867,468,399
050,17,199,"Illinois","Williamson County",3,18,724,370,354
050,17,199,"Illinois","Williamson County",3,19,572,284,288
050,17,199,"Illinois","Williamson County",3,20,614,327,287
050,17,199,"Illinois","Williamson County",3,21,651,347,304
050,17,199,"Illinois","Williamson County",3,22,652,335,317
050,17,199,"Illinois","Williamson County",3,23,716,364,352
050,17,199,"Illinois","Williamson County",3,24,699,372,327
050,17,199,"Illinois","Williamson County",3,25,763,397,366
050,17,199,"Illinois","Williamson County",3,26,780,404,376
050,17,199,"Illinois","Williamson County",3,27,776,397,379
050,17,199,"Illinois","Williamson County",3,28,796,413,383
050,17,199,"Illinois","Williamson County",3,29,856,436,420
050,17,199,"Illinois","Williamson County",3,30,885,464,421
050,17,199,"Illinois","Williamson County",3,31,902,454,448
050,17,199,"Illinois","Williamson County",3,32,909,467,442
050,17,199,"Illinois","Williamson County",3,33,889,467,422
050,17,199,"Illinois","Williamson County",3,34,857,456,401
050,17,199,"Illinois","Williamson County",3,35,867,452,415
050,17,199,"Illinois","Williamson County",3,36,889,473,416
050,17,199,"Illinois","Williamson County",3,37,895,467,428
050,17,199,"Illinois","Williamson County",3,38,892,443,449
050,17,199,"Illinois","Williamson County",3,39,889,471,418
050,17,199,"Illinois","Williamson County",3,40,929,479,450
050,17,199,"Illinois","Williamson County",3,41,961,494,467
050,17,199,"Illinois","Williamson County",3,42,865,431,434
050,17,199,"Illinois","Williamson County",3,43,861,456,405
050,17,199,"Illinois","Williamson County",3,44,816,427,389
050,17,199,"Illinois","Williamson County",3,45,816,425,391
050,17,199,"Illinois","Williamson County",3,46,810,408,402
050,17,199,"Illinois","Williamson County",3,47,829,445,384
050,17,199,"Illinois","Williamson County",3,48,814,423,391
050,17,199,"Illinois","Williamson County",3,49,864,443,421
050,17,199,"Illinois","Williamson County",3,50,913,471,442
050,17,199,"Illinois","Williamson County",3,51,889,447,442
050,17,199,"Illinois","Williamson County",3,52,805,407,398
050,17,199,"Illinois","Williamson County",3,53,808,395,413
050,17,199,"Illinois","Williamson County",3,54,808,429,379
050,17,199,"Illinois","Williamson County",3,55,788,399,389
050,17,199,"Illinois","Williamson County",3,56,925,459,466
050,17,199,"Illinois","Williamson County",3,57,896,440,456
050,17,199,"Illinois","Williamson County",3,58,931,456,475
050,17,199,"Illinois","Williamson County",3,59,939,466,473
050,17,199,"Illinois","Williamson County",3,60,968,479,489
050,17,199,"Illinois","Williamson County",3,61,946,466,480
050,17,199,"Illinois","Williamson County",3,62,903,432,471
050,17,199,"Illinois","Williamson County",3,63,887,440,447
050,17,199,"Illinois","Williamson County",3,64,895,447,448
050,17,199,"Illinois","Williamson County",3,65,876,425,451
050,17,199,"Illinois","Williamson County",3,66,823,392,431
050,17,199,"Illinois","Williamson County",3,67,805,388,417
050,17,199,"Illinois","Williamson County",3,68,814,384,430
050,17,199,"Illinois","Williamson County",3,69,762,361,401
050,17,199,"Illinois","Williamson County",3,70,715,345,370
050,17,199,"Illinois","Williamson County",3,71,697,333,364
050,17,199,"Illinois","Williamson County",3,72,677,318,359
050,17,199,"Illinois","Williamson County",3,73,719,335,384
050,17,199,"Illinois","Williamson County",3,74,789,381,408
050,17,199,"Illinois","Williamson County",3,75,530,247,283
050,17,199,"Illinois","Williamson County",3,76,528,229,299
050,17,199,"Illinois","Williamson County",3,77,518,227,291
050,17,199,"Illinois","Williamson County",3,78,494,216,278
050,17,199,"Illinois","Williamson County",3,79,438,200,238
050,17,199,"Illinois","Williamson County",3,80,388,168,220
050,17,199,"Illinois","Williamson County",3,81,356,145,211
050,17,199,"Illinois","Williamson County",3,82,334,135,199
050,17,199,"Illinois","Williamson County",3,83,298,114,184
050,17,199,"Illinois","Williamson County",3,84,237,93,144
050,17,199,"Illinois","Williamson County",3,85,1269,476,793
050,17,199,"Illinois","Williamson County",4,0,630,309,321
050,17,199,"Illinois","Williamson County",4,1,619,323,296
050,17,199,"Illinois","Williamson County",4,2,715,364,351
050,17,199,"Illinois","Williamson County",4,3,710,381,329
050,17,199,"Illinois","Williamson County",4,4,744,400,344
050,17,199,"Illinois","Williamson County",4,5,755,397,358
050,17,199,"Illinois","Williamson County",4,6,838,427,411
050,17,199,"Illinois","Williamson County",4,7,836,427,409
050,17,199,"Illinois","Williamson County",4,8,814,429,385
050,17,199,"Illinois","Williamson County",4,9,820,435,385
050,17,199,"Illinois","Williamson County",4,10,798,410,388
050,17,199,"Illinois","Williamson County",4,11,819,435,384
050,17,199,"Illinois","Williamson County",4,12,843,451,392
050,17,199,"Illinois","Williamson County",4,13,838,443,395
050,17,199,"Illinois","Williamson County",4,14,882,454,428
050,17,199,"Illinois","Williamson County",4,15,846,429,417
050,17,199,"Illinois","Williamson County",4,16,830,426,404
050,17,199,"Illinois","Williamson County",4,17,880,461,419
050,17,199,"Illinois","Williamson County",4,18,727,403,324
050,17,199,"Illinois","Williamson County",4,19,556,287,269
050,17,199,"Illinois","Williamson County",4,20,611,317,294
050,17,199,"Illinois","Williamson County",4,21,636,337,299
050,17,199,"Illinois","Williamson County",4,22,642,340,302
050,17,199,"Illinois","Williamson County",4,23,697,355,342
050,17,199,"Illinois","Williamson County",4,24,721,367,354
050,17,199,"Illinois","Williamson County",4,25,736,392,344
050,17,199,"Illinois","Williamson County",4,26,737,374,363
050,17,199,"Illinois","Williamson County",4,27,783,418,365
050,17,199,"Illinois","Williamson County",4,28,792,414,378
050,17,199,"Illinois","Williamson County",4,29,789,408,381
050,17,199,"Illinois","Williamson County",4,30,843,443,400
050,17,199,"Illinois","Williamson County",4,31,858,443,415
050,17,199,"Illinois","Williamson County",4,32,929,470,459
050,17,199,"Illinois","Williamson County",4,33,914,484,430
050,17,199,"Illinois","Williamson County",4,34,887,461,426
050,17,199,"Illinois","Williamson County",4,35,856,448,408
050,17,199,"Illinois","Williamson County",4,36,866,452,414
050,17,199,"Illinois","Williamson County",4,37,899,477,422
050,17,199,"Illinois","Williamson County",4,38,881,456,425
050,17,199,"Illinois","Williamson County",4,39,885,438,447
050,17,199,"Illinois","Williamson County",4,40,880,460,420
050,17,199,"Illinois","Williamson County",4,41,937,487,450
050,17,199,"Illinois","Williamson County",4,42,945,475,470
050,17,199,"Illinois","Williamson County",4,43,852,430,422
050,17,199,"Illinois","Williamson County",4,44,852,441,411
050,17,199,"Illinois","Williamson County",4,45,812,427,385
050,17,199,"Illinois","Williamson County",4,46,782,400,382
050,17,199,"Illinois","Williamson County",4,47,843,437,406
050,17,199,"Illinois","Williamson County",4,48,817,428,389
050,17,199,"Illinois","Williamson County",4,49,830,446,384
050,17,199,"Illinois","Williamson County",4,50,845,425,420
050,17,199,"Illinois","Williamson County",4,51,918,470,448
050,17,199,"Illinois","Williamson County",4,52,904,442,462
050,17,199,"Illinois","Williamson County",4,53,805,405,400
050,17,199,"Illinois","Williamson County",4,54,818,407,411
050,17,199,"Illinois","Williamson County",4,55,773,399,374
050,17,199,"Illinois","Williamson County",4,56,814,418,396
050,17,199,"Illinois","Williamson County",4,57,902,433,469
050,17,199,"Illinois","Williamson County",4,58,895,435,460
050,17,199,"Illinois","Williamson County",4,59,917,450,467
050,17,199,"Illinois","Williamson County",4,60,938,463,475
050,17,199,"Illinois","Williamson County",4,61,965,484,481
050,17,199,"Illinois","Williamson County",4,62,936,453,483
050,17,199,"Illinois","Williamson County",4,63,867,408,459
050,17,199,"Illinois","Williamson County",4,64,856,430,426
050,17,199,"Illinois","Williamson County",4,65,884,433,451
050,17,199,"Illinois","Williamson County",4,66,878,424,454
050,17,199,"Illinois","Williamson County",4,67,828,393,435
050,17,199,"Illinois","Williamson County",4,68,798,391,407
050,17,199,"Illinois","Williamson County",4,69,797,381,416
050,17,199,"Illinois","Williamson County",4,70,748,345,403
050,17,199,"Illinois","Williamson County",4,71,713,332,381
050,17,199,"Illinois","Williamson County",4,72,672,320,352
050,17,199,"Illinois","Williamson County",4,73,656,306,350
050,17,199,"Illinois","Williamson County",4,74,704,327,377
050,17,199,"Illinois","Williamson County",4,75,777,378,399
050,17,199,"Illinois","Williamson County",4,76,509,236,273
050,17,199,"Illinois","Williamson County",4,77,494,211,283
050,17,199,"Illinois","Williamson County",4,78,495,211,284
050,17,199,"Illinois","Williamson County",4,79,481,208,273
050,17,199,"Illinois","Williamson County",4,80,401,181,220
050,17,199,"Illinois","Williamson County",4,81,363,154,209
050,17,199,"Illinois","Williamson County",4,82,333,133,200
050,17,199,"Illinois","Williamson County",4,83,303,119,184
050,17,199,"Illinois","Williamson County",4,84,264,107,157
050,17,199,"Illinois","Williamson County",4,85,1281,484,797
050,17,199,"Illinois","Williamson County",5,0,622,305,317
050,17,199,"Illinois","Williamson County",5,1,649,333,316
050,17,199,"Illinois","Williamson County",5,2,627,316,311
050,17,199,"Illinois","Williamson County",5,3,705,365,340
050,17,199,"Illinois","Williamson County",5,4,716,389,327
050,17,199,"Illinois","Williamson County",5,5,734,402,332
050,17,199,"Illinois","Williamson County",5,6,772,417,355
050,17,199,"Illinois","Williamson County",5,7,863,424,439
050,17,199,"Illinois","Williamson County",5,8,826,421,405
050,17,199,"Illinois","Williamson County",5,9,827,445,382
050,17,199,"Illinois","Williamson County",5,10,817,430,387
050,17,199,"Illinois","Williamson County",5,11,805,409,396
050,17,199,"Illinois","Williamson County",5,12,822,434,388
050,17,199,"Illinois","Williamson County",5,13,842,461,381
050,17,199,"Illinois","Williamson County",5,14,834,437,397
050,17,199,"Illinois","Williamson County",5,15,886,464,422
050,17,199,"Illinois","Williamson County",5,16,838,421,417
050,17,199,"Illinois","Williamson County",5,17,838,430,408
050,17,199,"Illinois","Williamson County",5,18,721,392,329
050,17,199,"Illinois","Williamson County",5,19,559,319,240
050,17,199,"Illinois","Williamson County",5,20,619,314,305
050,17,199,"Illinois","Williamson County",5,21,644,334,310
050,17,199,"Illinois","Williamson County",5,22,665,341,324
050,17,199,"Illinois","Williamson County",5,23,691,373,318
050,17,199,"Illinois","Williamson County",5,24,703,364,339
050,17,199,"Illinois","Williamson County",5,25,774,396,378
050,17,199,"Illinois","Williamson County",5,26,792,423,369
050,17,199,"Illinois","Williamson County",5,27,760,381,379
050,17,199,"Illinois","Williamson County",5,28,787,434,353
050,17,199,"Illinois","Williamson County",5,29,814,424,390
050,17,199,"Illinois","Williamson County",5,30,828,421,407
050,17,199,"Illinois","Williamson County",5,31,844,432,412
050,17,199,"Illinois","Williamson County",5,32,897,467,430
050,17,199,"Illinois","Williamson County",5,33,933,477,456
050,17,199,"Illinois","Williamson County",5,34,900,482,418
050,17,199,"Illinois","Williamson County",5,35,869,450,419
050,17,199,"Illinois","Williamson County",5,36,857,447,410
050,17,199,"Illinois","Williamson County",5,37,880,476,404
050,17,199,"Illinois","Williamson County",5,38,894,474,420
050,17,199,"Illinois","Williamson County",5,39,885,466,419
050,17,199,"Illinois","Williamson County",5,40,864,415,449
050,17,199,"Illinois","Williamson County",5,41,908,485,423
050,17,199,"Illinois","Williamson County",5,42,918,471,447
050,17,199,"Illinois","Williamson County",5,43,934,467,467
050,17,199,"Illinois","Williamson County",5,44,839,416,423
050,17,199,"Illinois","Williamson County",5,45,866,457,409
050,17,199,"Illinois","Williamson County",5,46,785,399,386
050,17,199,"Illinois","Williamson County",5,47,828,436,392
050,17,199,"Illinois","Williamson County",5,48,841,433,408
050,17,199,"Illinois","Williamson County",5,49,818,430,388
050,17,199,"Illinois","Williamson County",5,50,812,413,399
050,17,199,"Illinois","Williamson County",5,51,865,439,426
050,17,199,"Illinois","Williamson County",5,52,928,459,469
050,17,199,"Illinois","Williamson County",5,53,912,447,465
050,17,199,"Illinois","Williamson County",5,54,826,429,397
050,17,199,"Illinois","Williamson County",5,55,800,377,423
050,17,199,"Illinois","Williamson County",5,56,798,420,378
050,17,199,"Illinois","Williamson County",5,57,787,390,397
050,17,199,"Illinois","Williamson County",5,58,895,432,463
050,17,199,"Illinois","Williamson County",5,59,889,426,463
050,17,199,"Illinois","Williamson County",5,60,910,454,456
050,17,199,"Illinois","Williamson County",5,61,943,470,473
050,17,199,"Illinois","Williamson County",5,62,950,468,482
050,17,199,"Illinois","Williamson County",5,63,919,435,484
050,17,199,"Illinois","Williamson County",5,64,857,408,449
050,17,199,"Illinois","Williamson County",5,65,838,411,427
050,17,199,"Illinois","Williamson County",5,66,876,426,450
050,17,199,"Illinois","Williamson County",5,67,877,421,456
050,17,199,"Illinois","Williamson County",5,68,823,392,431
050,17,199,"Illinois","Williamson County",5,69,780,378,402
050,17,199,"Illinois","Williamson County",5,70,780,370,410
050,17,199,"Illinois","Williamson County",5,71,737,330,407
050,17,199,"Illinois","Williamson County",5,72,695,326,369
050,17,199,"Illinois","Williamson County",5,73,659,312,347
050,17,199,"Illinois","Williamson County",5,74,632,297,335
050,17,199,"Illinois","Williamson County",5,75,703,326,377
050,17,199,"Illinois","Williamson County",5,76,751,356,395
050,17,199,"Illinois","Williamson County",5,77,485,226,259
050,17,199,"Illinois","Williamson County",5,78,476,200,276
050,17,199,"Illinois","Williamson County",5,79,479,198,281
050,17,199,"Illinois","Williamson County",5,80,442,189,253
050,17,199,"Illinois","Williamson County",5,81,373,162,211
050,17,199,"Illinois","Williamson County",5,82,343,144,199
050,17,199,"Illinois","Williamson County",5,83,308,117,191
050,17,199,"Illinois","Williamson County",5,84,279,115,164
050,17,199,"Illinois","Williamson County",5,85,1339,513,826
050,17,201,"Illinois","Winnebago County",1,0,3439,1759,1680
050,17,201,"Illinois","Winnebago County",1,1,3438,1733,1705
050,17,201,"Illinois","Winnebago County",1,2,3595,1841,1754
050,17,201,"Illinois","Winnebago County",1,3,3645,1868,1777
050,17,201,"Illinois","Winnebago County",1,4,3816,1970,1846
050,17,201,"Illinois","Winnebago County",1,5,3729,1898,1831
050,17,201,"Illinois","Winnebago County",1,6,3604,1851,1753
050,17,201,"Illinois","Winnebago County",1,7,3605,1840,1765
050,17,201,"Illinois","Winnebago County",1,8,3567,1859,1708
050,17,201,"Illinois","Winnebago County",1,9,3744,1923,1821
050,17,201,"Illinois","Winnebago County",1,10,3781,1934,1847
050,17,201,"Illinois","Winnebago County",1,11,3936,2040,1896
050,17,201,"Illinois","Winnebago County",1,12,4073,2086,1987
050,17,201,"Illinois","Winnebago County",1,13,4045,2071,1974
050,17,201,"Illinois","Winnebago County",1,14,3863,1976,1887
050,17,201,"Illinois","Winnebago County",1,15,3899,2039,1860
050,17,201,"Illinois","Winnebago County",1,16,3967,2061,1906
050,17,201,"Illinois","Winnebago County",1,17,3973,2012,1961
050,17,201,"Illinois","Winnebago County",1,18,3532,1812,1720
050,17,201,"Illinois","Winnebago County",1,19,2996,1550,1446
050,17,201,"Illinois","Winnebago County",1,20,3272,1678,1594
050,17,201,"Illinois","Winnebago County",1,21,3314,1656,1658
050,17,201,"Illinois","Winnebago County",1,22,3371,1686,1685
050,17,201,"Illinois","Winnebago County",1,23,3408,1667,1741
050,17,201,"Illinois","Winnebago County",1,24,3566,1717,1849
050,17,201,"Illinois","Winnebago County",1,25,3547,1720,1827
050,17,201,"Illinois","Winnebago County",1,26,3570,1787,1783
050,17,201,"Illinois","Winnebago County",1,27,3620,1776,1844
050,17,201,"Illinois","Winnebago County",1,28,3739,1835,1904
050,17,201,"Illinois","Winnebago County",1,29,3741,1838,1903
050,17,201,"Illinois","Winnebago County",1,30,3721,1804,1917
050,17,201,"Illinois","Winnebago County",1,31,3474,1657,1817
050,17,201,"Illinois","Winnebago County",1,32,3288,1589,1699
050,17,201,"Illinois","Winnebago County",1,33,3392,1671,1721
050,17,201,"Illinois","Winnebago County",1,34,3567,1758,1809
050,17,201,"Illinois","Winnebago County",1,35,3488,1722,1766
050,17,201,"Illinois","Winnebago County",1,36,3351,1649,1702
050,17,201,"Illinois","Winnebago County",1,37,3452,1675,1777
050,17,201,"Illinois","Winnebago County",1,38,3458,1720,1738
050,17,201,"Illinois","Winnebago County",1,39,3492,1686,1806
050,17,201,"Illinois","Winnebago County",1,40,3486,1711,1775
050,17,201,"Illinois","Winnebago County",1,41,3348,1624,1724
050,17,201,"Illinois","Winnebago County",1,42,3263,1598,1665
050,17,201,"Illinois","Winnebago County",1,43,3145,1555,1590
050,17,201,"Illinois","Winnebago County",1,44,3165,1568,1597
050,17,201,"Illinois","Winnebago County",1,45,3234,1569,1665
050,17,201,"Illinois","Winnebago County",1,46,3219,1595,1624
050,17,201,"Illinois","Winnebago County",1,47,3368,1687,1681
050,17,201,"Illinois","Winnebago County",1,48,3625,1803,1822
050,17,201,"Illinois","Winnebago County",1,49,3872,1948,1924
050,17,201,"Illinois","Winnebago County",1,50,3754,1931,1823
050,17,201,"Illinois","Winnebago County",1,51,3627,1804,1823
050,17,201,"Illinois","Winnebago County",1,52,3476,1718,1758
050,17,201,"Illinois","Winnebago County",1,53,3458,1664,1794
050,17,201,"Illinois","Winnebago County",1,54,3604,1746,1858
050,17,201,"Illinois","Winnebago County",1,55,3868,1919,1949
050,17,201,"Illinois","Winnebago County",1,56,3989,2020,1969
050,17,201,"Illinois","Winnebago County",1,57,3967,1960,2007
050,17,201,"Illinois","Winnebago County",1,58,4067,1991,2076
050,17,201,"Illinois","Winnebago County",1,59,4077,2000,2077
050,17,201,"Illinois","Winnebago County",1,60,3959,1999,1960
050,17,201,"Illinois","Winnebago County",1,61,3829,1883,1946
050,17,201,"Illinois","Winnebago County",1,62,3833,1879,1954
050,17,201,"Illinois","Winnebago County",1,63,3767,1821,1946
050,17,201,"Illinois","Winnebago County",1,64,3615,1765,1850
050,17,201,"Illinois","Winnebago County",1,65,3541,1714,1827
050,17,201,"Illinois","Winnebago County",1,66,3484,1660,1824
050,17,201,"Illinois","Winnebago County",1,67,3401,1626,1775
050,17,201,"Illinois","Winnebago County",1,68,3299,1555,1744
050,17,201,"Illinois","Winnebago County",1,69,2955,1423,1532
050,17,201,"Illinois","Winnebago County",1,70,2789,1330,1459
050,17,201,"Illinois","Winnebago County",1,71,2802,1305,1497
050,17,201,"Illinois","Winnebago County",1,72,2842,1325,1517
050,17,201,"Illinois","Winnebago County",1,73,2843,1314,1529
050,17,201,"Illinois","Winnebago County",1,74,1964,903,1061
050,17,201,"Illinois","Winnebago County",1,75,1986,901,1085
050,17,201,"Illinois","Winnebago County",1,76,2028,949,1079
050,17,201,"Illinois","Winnebago County",1,77,1985,924,1061
050,17,201,"Illinois","Winnebago County",1,78,1679,756,923
050,17,201,"Illinois","Winnebago County",1,79,1499,652,847
050,17,201,"Illinois","Winnebago County",1,80,1322,565,757
050,17,201,"Illinois","Winnebago County",1,81,1210,509,701
050,17,201,"Illinois","Winnebago County",1,82,1180,510,670
050,17,201,"Illinois","Winnebago County",1,83,998,440,558
050,17,201,"Illinois","Winnebago County",1,84,979,407,572
050,17,201,"Illinois","Winnebago County",1,85,5858,2028,3830
050,17,201,"Illinois","Winnebago County",2,0,3392,1727,1665
050,17,201,"Illinois","Winnebago County",2,1,3437,1735,1702
050,17,201,"Illinois","Winnebago County",2,2,3558,1814,1744
050,17,201,"Illinois","Winnebago County",2,3,3630,1854,1776
050,17,201,"Illinois","Winnebago County",2,4,3795,1955,1840
050,17,201,"Illinois","Winnebago County",2,5,3752,1919,1833
050,17,201,"Illinois","Winnebago County",2,6,3636,1865,1771
050,17,201,"Illinois","Winnebago County",2,7,3601,1843,1758
050,17,201,"Illinois","Winnebago County",2,8,3569,1849,1720
050,17,201,"Illinois","Winnebago County",2,9,3686,1901,1785
050,17,201,"Illinois","Winnebago County",2,10,3766,1933,1833
050,17,201,"Illinois","Winnebago County",2,11,3886,2009,1877
050,17,201,"Illinois","Winnebago County",2,12,4055,2084,1971
050,17,201,"Illinois","Winnebago County",2,13,4042,2071,1971
050,17,201,"Illinois","Winnebago County",2,14,3901,1995,1906
050,17,201,"Illinois","Winnebago County",2,15,3891,2021,1870
050,17,201,"Illinois","Winnebago County",2,16,3955,2056,1899
050,17,201,"Illinois","Winnebago County",2,17,3970,2016,1954
050,17,201,"Illinois","Winnebago County",2,18,3506,1801,1705
050,17,201,"Illinois","Winnebago County",2,19,3023,1558,1465
050,17,201,"Illinois","Winnebago County",2,20,3284,1684,1600
050,17,201,"Illinois","Winnebago County",2,21,3331,1671,1660
050,17,201,"Illinois","Winnebago County",2,22,3383,1687,1696
050,17,201,"Illinois","Winnebago County",2,23,3417,1678,1739
050,17,201,"Illinois","Winnebago County",2,24,3518,1703,1815
050,17,201,"Illinois","Winnebago County",2,25,3561,1729,1832
050,17,201,"Illinois","Winnebago County",2,26,3571,1771,1800
050,17,201,"Illinois","Winnebago County",2,27,3598,1769,1829
050,17,201,"Illinois","Winnebago County",2,28,3706,1820,1886
050,17,201,"Illinois","Winnebago County",2,29,3734,1831,1903
050,17,201,"Illinois","Winnebago County",2,30,3740,1815,1925
050,17,201,"Illinois","Winnebago County",2,31,3523,1684,1839
050,17,201,"Illinois","Winnebago County",2,32,3328,1600,1728
050,17,201,"Illinois","Winnebago County",2,33,3363,1647,1716
050,17,201,"Illinois","Winnebago County",2,34,3523,1738,1785
050,17,201,"Illinois","Winnebago County",2,35,3505,1727,1778
050,17,201,"Illinois","Winnebago County",2,36,3353,1652,1701
050,17,201,"Illinois","Winnebago County",2,37,3421,1668,1753
050,17,201,"Illinois","Winnebago County",2,38,3461,1712,1749
050,17,201,"Illinois","Winnebago County",2,39,3465,1691,1774
050,17,201,"Illinois","Winnebago County",2,40,3500,1713,1787
050,17,201,"Illinois","Winnebago County",2,41,3359,1637,1722
050,17,201,"Illinois","Winnebago County",2,42,3260,1594,1666
050,17,201,"Illinois","Winnebago County",2,43,3180,1569,1611
050,17,201,"Illinois","Winnebago County",2,44,3126,1547,1579
050,17,201,"Illinois","Winnebago County",2,45,3221,1569,1652
050,17,201,"Illinois","Winnebago County",2,46,3205,1580,1625
050,17,201,"Illinois","Winnebago County",2,47,3319,1654,1665
050,17,201,"Illinois","Winnebago County",2,48,3554,1777,1777
050,17,201,"Illinois","Winnebago County",2,49,3817,1914,1903
050,17,201,"Illinois","Winnebago County",2,50,3776,1928,1848
050,17,201,"Illinois","Winnebago County",2,51,3638,1824,1814
050,17,201,"Illinois","Winnebago County",2,52,3500,1735,1765
050,17,201,"Illinois","Winnebago County",2,53,3454,1672,1782
050,17,201,"Illinois","Winnebago County",2,54,3543,1715,1828
050,17,201,"Illinois","Winnebago County",2,55,3792,1872,1920
050,17,201,"Illinois","Winnebago County",2,56,3959,1997,1962
050,17,201,"Illinois","Winnebago County",2,57,3955,1960,1995
050,17,201,"Illinois","Winnebago County",2,58,4028,1972,2056
050,17,201,"Illinois","Winnebago County",2,59,4077,1995,2082
050,17,201,"Illinois","Winnebago County",2,60,3964,1982,1982
050,17,201,"Illinois","Winnebago County",2,61,3838,1897,1941
050,17,201,"Illinois","Winnebago County",2,62,3810,1861,1949
050,17,201,"Illinois","Winnebago County",2,63,3792,1840,1952
050,17,201,"Illinois","Winnebago County",2,64,3603,1753,1850
050,17,201,"Illinois","Winnebago County",2,65,3535,1713,1822
050,17,201,"Illinois","Winnebago County",2,66,3480,1663,1817
050,17,201,"Illinois","Winnebago County",2,67,3396,1625,1771
050,17,201,"Illinois","Winnebago County",2,68,3279,1550,1729
050,17,201,"Illinois","Winnebago County",2,69,3037,1452,1585
050,17,201,"Illinois","Winnebago County",2,70,2805,1342,1463
050,17,201,"Illinois","Winnebago County",2,71,2786,1305,1481
050,17,201,"Illinois","Winnebago County",2,72,2778,1294,1484
050,17,201,"Illinois","Winnebago County",2,73,2961,1377,1584
050,17,201,"Illinois","Winnebago County",2,74,2029,930,1099
050,17,201,"Illinois","Winnebago County",2,75,1971,899,1072
050,17,201,"Illinois","Winnebago County",2,76,1982,921,1061
050,17,201,"Illinois","Winnebago County",2,77,2015,937,1078
050,17,201,"Illinois","Winnebago County",2,78,1698,771,927
050,17,201,"Illinois","Winnebago County",2,79,1514,665,849
050,17,201,"Illinois","Winnebago County",2,80,1344,571,773
050,17,201,"Illinois","Winnebago County",2,81,1213,520,693
050,17,201,"Illinois","Winnebago County",2,82,1168,494,674
050,17,201,"Illinois","Winnebago County",2,83,1010,440,570
050,17,201,"Illinois","Winnebago County",2,84,970,409,561
050,17,201,"Illinois","Winnebago County",2,85,5839,2023,3816
050,17,201,"Illinois","Winnebago County",3,0,3194,1686,1508
050,17,201,"Illinois","Winnebago County",3,1,3409,1713,1696
050,17,201,"Illinois","Winnebago County",3,2,3446,1745,1701
050,17,201,"Illinois","Winnebago County",3,3,3610,1827,1783
050,17,201,"Illinois","Winnebago County",3,4,3668,1885,1783
050,17,201,"Illinois","Winnebago County",3,5,3793,1948,1845
050,17,201,"Illinois","Winnebago County",3,6,3760,1929,1831
050,17,201,"Illinois","Winnebago County",3,7,3611,1831,1780
050,17,201,"Illinois","Winnebago County",3,8,3613,1843,1770
050,17,201,"Illinois","Winnebago County",3,9,3563,1822,1741
050,17,201,"Illinois","Winnebago County",3,10,3691,1916,1775
050,17,201,"Illinois","Winnebago County",3,11,3793,1939,1854
050,17,201,"Illinois","Winnebago County",3,12,3876,1993,1883
050,17,201,"Illinois","Winnebago County",3,13,4033,2078,1955
050,17,201,"Illinois","Winnebago County",3,14,4002,2053,1949
050,17,201,"Illinois","Winnebago County",3,15,3889,1972,1917
050,17,201,"Illinois","Winnebago County",3,16,3887,2030,1857
050,17,201,"Illinois","Winnebago County",3,17,3935,2037,1898
050,17,201,"Illinois","Winnebago County",3,18,3495,1831,1664
050,17,201,"Illinois","Winnebago County",3,19,2984,1526,1458
050,17,201,"Illinois","Winnebago County",3,20,3208,1640,1568
050,17,201,"Illinois","Winnebago County",3,21,3395,1715,1680
050,17,201,"Illinois","Winnebago County",3,22,3476,1734,1742
050,17,201,"Illinois","Winnebago County",3,23,3483,1752,1731
050,17,201,"Illinois","Winnebago County",3,24,3407,1698,1709
050,17,201,"Illinois","Winnebago County",3,25,3525,1720,1805
050,17,201,"Illinois","Winnebago County",3,26,3486,1679,1807
050,17,201,"Illinois","Winnebago County",3,27,3534,1724,1810
050,17,201,"Illinois","Winnebago County",3,28,3621,1774,1847
050,17,201,"Illinois","Winnebago County",3,29,3707,1814,1893
050,17,201,"Illinois","Winnebago County",3,30,3752,1826,1926
050,17,201,"Illinois","Winnebago County",3,31,3708,1795,1913
050,17,201,"Illinois","Winnebago County",3,32,3556,1704,1852
050,17,201,"Illinois","Winnebago County",3,33,3340,1599,1741
050,17,201,"Illinois","Winnebago County",3,34,3414,1692,1722
050,17,201,"Illinois","Winnebago County",3,35,3420,1677,1743
050,17,201,"Illinois","Winnebago County",3,36,3490,1705,1785
050,17,201,"Illinois","Winnebago County",3,37,3373,1661,1712
050,17,201,"Illinois","Winnebago County",3,38,3405,1651,1754
050,17,201,"Illinois","Winnebago County",3,39,3465,1714,1751
050,17,201,"Illinois","Winnebago County",3,40,3449,1681,1768
050,17,201,"Illinois","Winnebago County",3,41,3463,1709,1754
050,17,201,"Illinois","Winnebago County",3,42,3343,1642,1701
050,17,201,"Illinois","Winnebago County",3,43,3243,1587,1656
050,17,201,"Illinois","Winnebago County",3,44,3155,1544,1611
050,17,201,"Illinois","Winnebago County",3,45,3114,1538,1576
050,17,201,"Illinois","Winnebago County",3,46,3213,1574,1639
050,17,201,"Illinois","Winnebago County",3,47,3175,1549,1626
050,17,201,"Illinois","Winnebago County",3,48,3276,1646,1630
050,17,201,"Illinois","Winnebago County",3,49,3538,1766,1772
050,17,201,"Illinois","Winnebago County",3,50,3770,1889,1881
050,17,201,"Illinois","Winnebago County",3,51,3712,1877,1835
050,17,201,"Illinois","Winnebago County",3,52,3574,1791,1783
050,17,201,"Illinois","Winnebago County",3,53,3424,1690,1734
050,17,201,"Illinois","Winnebago County",3,54,3393,1655,1738
050,17,201,"Illinois","Winnebago County",3,55,3485,1686,1799
050,17,201,"Illinois","Winnebago County",3,56,3731,1827,1904
050,17,201,"Illinois","Winnebago County",3,57,3868,1933,1935
050,17,201,"Illinois","Winnebago County",3,58,3870,1906,1964
050,17,201,"Illinois","Winnebago County",3,59,3946,1923,2023
050,17,201,"Illinois","Winnebago County",3,60,3989,1933,2056
050,17,201,"Illinois","Winnebago County",3,61,3903,1953,1950
050,17,201,"Illinois","Winnebago County",3,62,3754,1842,1912
050,17,201,"Illinois","Winnebago County",3,63,3740,1806,1934
050,17,201,"Illinois","Winnebago County",3,64,3673,1790,1883
050,17,201,"Illinois","Winnebago County",3,65,3501,1707,1794
050,17,201,"Illinois","Winnebago County",3,66,3428,1656,1772
050,17,201,"Illinois","Winnebago County",3,67,3391,1609,1782
050,17,201,"Illinois","Winnebago County",3,68,3298,1560,1738
050,17,201,"Illinois","Winnebago County",3,69,3209,1516,1693
050,17,201,"Illinois","Winnebago County",3,70,2930,1381,1549
050,17,201,"Illinois","Winnebago County",3,71,2722,1298,1424
050,17,201,"Illinois","Winnebago County",3,72,2711,1262,1449
050,17,201,"Illinois","Winnebago County",3,73,2675,1247,1428
050,17,201,"Illinois","Winnebago County",3,74,2825,1311,1514
050,17,201,"Illinois","Winnebago County",3,75,1949,883,1066
050,17,201,"Illinois","Winnebago County",3,76,1879,854,1025
050,17,201,"Illinois","Winnebago County",3,77,1909,892,1017
050,17,201,"Illinois","Winnebago County",3,78,1911,880,1031
050,17,201,"Illinois","Winnebago County",3,79,1591,713,878
050,17,201,"Illinois","Winnebago County",3,80,1409,602,807
050,17,201,"Illinois","Winnebago County",3,81,1258,528,730
050,17,201,"Illinois","Winnebago County",3,82,1154,479,675
050,17,201,"Illinois","Winnebago County",3,83,1054,436,618
050,17,201,"Illinois","Winnebago County",3,84,942,406,536
050,17,201,"Illinois","Winnebago County",3,85,5769,2004,3765
050,17,201,"Illinois","Winnebago County",4,0,3189,1651,1538
050,17,201,"Illinois","Winnebago County",4,1,3262,1691,1571
050,17,201,"Illinois","Winnebago County",4,2,3488,1764,1724
050,17,201,"Illinois","Winnebago County",4,3,3524,1778,1746
050,17,201,"Illinois","Winnebago County",4,4,3620,1836,1784
050,17,201,"Illinois","Winnebago County",4,5,3669,1891,1778
050,17,201,"Illinois","Winnebago County",4,6,3770,1945,1825
050,17,201,"Illinois","Winnebago County",4,7,3790,1934,1856
050,17,201,"Illinois","Winnebago County",4,8,3645,1845,1800
050,17,201,"Illinois","Winnebago County",4,9,3557,1815,1742
050,17,201,"Illinois","Winnebago County",4,10,3579,1833,1746
050,17,201,"Illinois","Winnebago County",4,11,3667,1879,1788
050,17,201,"Illinois","Winnebago County",4,12,3761,1911,1850
050,17,201,"Illinois","Winnebago County",4,13,3833,1969,1864
050,17,201,"Illinois","Winnebago County",4,14,4039,2087,1952
050,17,201,"Illinois","Winnebago County",4,15,3973,2013,1960
050,17,201,"Illinois","Winnebago County",4,16,3870,1972,1898
050,17,201,"Illinois","Winnebago County",4,17,3862,2002,1860
050,17,201,"Illinois","Winnebago County",4,18,3419,1786,1633
050,17,201,"Illinois","Winnebago County",4,19,2982,1540,1442
050,17,201,"Illinois","Winnebago County",4,20,3154,1607,1547
050,17,201,"Illinois","Winnebago County",4,21,3271,1641,1630
050,17,201,"Illinois","Winnebago County",4,22,3504,1752,1752
050,17,201,"Illinois","Winnebago County",4,23,3563,1775,1788
050,17,201,"Illinois","Winnebago County",4,24,3487,1742,1745
050,17,201,"Illinois","Winnebago County",4,25,3377,1681,1696
050,17,201,"Illinois","Winnebago County",4,26,3515,1707,1808
050,17,201,"Illinois","Winnebago County",4,27,3439,1657,1782
050,17,201,"Illinois","Winnebago County",4,28,3554,1733,1821
050,17,201,"Illinois","Winnebago County",4,29,3608,1774,1834
050,17,201,"Illinois","Winnebago County",4,30,3641,1784,1857
050,17,201,"Illinois","Winnebago County",4,31,3716,1806,1910
050,17,201,"Illinois","Winnebago County",4,32,3745,1813,1932
050,17,201,"Illinois","Winnebago County",4,33,3532,1695,1837
050,17,201,"Illinois","Winnebago County",4,34,3370,1639,1731
050,17,201,"Illinois","Winnebago County",4,35,3358,1621,1737
050,17,201,"Illinois","Winnebago County",4,36,3413,1674,1739
050,17,201,"Illinois","Winnebago County",4,37,3495,1694,1801
050,17,201,"Illinois","Winnebago County",4,38,3355,1645,1710
050,17,201,"Illinois","Winnebago County",4,39,3377,1652,1725
050,17,201,"Illinois","Winnebago County",4,40,3402,1674,1728
050,17,201,"Illinois","Winnebago County",4,41,3423,1655,1768
050,17,201,"Illinois","Winnebago County",4,42,3446,1696,1750
050,17,201,"Illinois","Winnebago County",4,43,3318,1653,1665
050,17,201,"Illinois","Winnebago County",4,44,3224,1584,1640
050,17,201,"Illinois","Winnebago County",4,45,3104,1532,1572
050,17,201,"Illinois","Winnebago County",4,46,3106,1540,1566
050,17,201,"Illinois","Winnebago County",4,47,3175,1558,1617
050,17,201,"Illinois","Winnebago County",4,48,3129,1554,1575
050,17,201,"Illinois","Winnebago County",4,49,3231,1595,1636
050,17,201,"Illinois","Winnebago County",4,50,3492,1748,1744
050,17,201,"Illinois","Winnebago County",4,51,3694,1836,1858
050,17,201,"Illinois","Winnebago County",4,52,3675,1863,1812
050,17,201,"Illinois","Winnebago County",4,53,3511,1745,1766
050,17,201,"Illinois","Winnebago County",4,54,3409,1679,1730
050,17,201,"Illinois","Winnebago County",4,55,3373,1644,1729
050,17,201,"Illinois","Winnebago County",4,56,3452,1698,1754
050,17,201,"Illinois","Winnebago County",4,57,3654,1780,1874
050,17,201,"Illinois","Winnebago County",4,58,3803,1887,1916
050,17,201,"Illinois","Winnebago County",4,59,3785,1868,1917
050,17,201,"Illinois","Winnebago County",4,60,3869,1878,1991
050,17,201,"Illinois","Winnebago County",4,61,3919,1887,2032
050,17,201,"Illinois","Winnebago County",4,62,3827,1903,1924
050,17,201,"Illinois","Winnebago County",4,63,3634,1761,1873
050,17,201,"Illinois","Winnebago County",4,64,3644,1767,1877
050,17,201,"Illinois","Winnebago County",4,65,3571,1730,1841
050,17,201,"Illinois","Winnebago County",4,66,3388,1636,1752
050,17,201,"Illinois","Winnebago County",4,67,3301,1592,1709
050,17,201,"Illinois","Winnebago County",4,68,3266,1543,1723
050,17,201,"Illinois","Winnebago County",4,69,3196,1494,1702
050,17,201,"Illinois","Winnebago County",4,70,3104,1454,1650
050,17,201,"Illinois","Winnebago County",4,71,2856,1342,1514
050,17,201,"Illinois","Winnebago County",4,72,2659,1256,1403
050,17,201,"Illinois","Winnebago County",4,73,2619,1222,1397
050,17,201,"Illinois","Winnebago County",4,74,2575,1203,1372
050,17,201,"Illinois","Winnebago County",4,75,2719,1264,1455
050,17,201,"Illinois","Winnebago County",4,76,1884,850,1034
050,17,201,"Illinois","Winnebago County",4,77,1809,816,993
050,17,201,"Illinois","Winnebago County",4,78,1813,846,967
050,17,201,"Illinois","Winnebago County",4,79,1787,813,974
050,17,201,"Illinois","Winnebago County",4,80,1490,650,840
050,17,201,"Illinois","Winnebago County",4,81,1343,576,767
050,17,201,"Illinois","Winnebago County",4,82,1187,491,696
050,17,201,"Illinois","Winnebago County",4,83,1062,439,623
050,17,201,"Illinois","Winnebago County",4,84,977,396,581
050,17,201,"Illinois","Winnebago County",4,85,5664,1978,3686
050,17,201,"Illinois","Winnebago County",5,0,3151,1629,1522
050,17,201,"Illinois","Winnebago County",5,1,3239,1661,1578
050,17,201,"Illinois","Winnebago County",5,2,3272,1709,1563
050,17,201,"Illinois","Winnebago County",5,3,3472,1747,1725
050,17,201,"Illinois","Winnebago County",5,4,3520,1778,1742
050,17,201,"Illinois","Winnebago County",5,5,3628,1848,1780
050,17,201,"Illinois","Winnebago County",5,6,3700,1930,1770
050,17,201,"Illinois","Winnebago County",5,7,3769,1944,1825
050,17,201,"Illinois","Winnebago County",5,8,3797,1934,1863
050,17,201,"Illinois","Winnebago County",5,9,3624,1858,1766
050,17,201,"Illinois","Winnebago County",5,10,3524,1801,1723
050,17,201,"Illinois","Winnebago County",5,11,3578,1809,1769
050,17,201,"Illinois","Winnebago County",5,12,3688,1889,1799
050,17,201,"Illinois","Winnebago County",5,13,3732,1917,1815
050,17,201,"Illinois","Winnebago County",5,14,3800,1960,1840
050,17,201,"Illinois","Winnebago County",5,15,4036,2102,1934
050,17,201,"Illinois","Winnebago County",5,16,4025,2049,1976
050,17,201,"Illinois","Winnebago County",5,17,3873,1958,1915
050,17,201,"Illinois","Winnebago County",5,18,3396,1797,1599
050,17,201,"Illinois","Winnebago County",5,19,2964,1527,1437
050,17,201,"Illinois","Winnebago County",5,20,3197,1637,1560
050,17,201,"Illinois","Winnebago County",5,21,3320,1680,1640
050,17,201,"Illinois","Winnebago County",5,22,3434,1719,1715
050,17,201,"Illinois","Winnebago County",5,23,3575,1782,1793
050,17,201,"Illinois","Winnebago County",5,24,3554,1770,1784
050,17,201,"Illinois","Winnebago County",5,25,3501,1757,1744
050,17,201,"Illinois","Winnebago County",5,26,3390,1708,1682
050,17,201,"Illinois","Winnebago County",5,27,3457,1666,1791
050,17,201,"Illinois","Winnebago County",5,28,3433,1644,1789
050,17,201,"Illinois","Winnebago County",5,29,3527,1750,1777
050,17,201,"Illinois","Winnebago County",5,30,3560,1750,1810
050,17,201,"Illinois","Winnebago County",5,31,3650,1788,1862
050,17,201,"Illinois","Winnebago County",5,32,3740,1828,1912
050,17,201,"Illinois","Winnebago County",5,33,3706,1804,1902
050,17,201,"Illinois","Winnebago County",5,34,3572,1717,1855
050,17,201,"Illinois","Winnebago County",5,35,3329,1600,1729
050,17,201,"Illinois","Winnebago County",5,36,3358,1638,1720
050,17,201,"Illinois","Winnebago County",5,37,3418,1671,1747
050,17,201,"Illinois","Winnebago County",5,38,3504,1697,1807
050,17,201,"Illinois","Winnebago County",5,39,3357,1648,1709
050,17,201,"Illinois","Winnebago County",5,40,3354,1637,1717
050,17,201,"Illinois","Winnebago County",5,41,3407,1680,1727
050,17,201,"Illinois","Winnebago County",5,42,3386,1632,1754
050,17,201,"Illinois","Winnebago County",5,43,3427,1670,1757
050,17,201,"Illinois","Winnebago County",5,44,3303,1638,1665
050,17,201,"Illinois","Winnebago County",5,45,3207,1577,1630
050,17,201,"Illinois","Winnebago County",5,46,3070,1518,1552
050,17,201,"Illinois","Winnebago County",5,47,3098,1528,1570
050,17,201,"Illinois","Winnebago County",5,48,3161,1565,1596
050,17,201,"Illinois","Winnebago County",5,49,3101,1535,1566
050,17,201,"Illinois","Winnebago County",5,50,3230,1587,1643
050,17,201,"Illinois","Winnebago County",5,51,3448,1726,1722
050,17,201,"Illinois","Winnebago County",5,52,3671,1831,1840
050,17,201,"Illinois","Winnebago County",5,53,3640,1839,1801
050,17,201,"Illinois","Winnebago County",5,54,3486,1725,1761
050,17,201,"Illinois","Winnebago County",5,55,3380,1669,1711
050,17,201,"Illinois","Winnebago County",5,56,3339,1640,1699
050,17,201,"Illinois","Winnebago County",5,57,3391,1661,1730
050,17,201,"Illinois","Winnebago County",5,58,3600,1748,1852
050,17,201,"Illinois","Winnebago County",5,59,3746,1856,1890
050,17,201,"Illinois","Winnebago County",5,60,3735,1841,1894
050,17,201,"Illinois","Winnebago County",5,61,3806,1838,1968
050,17,201,"Illinois","Winnebago County",5,62,3856,1840,2016
050,17,201,"Illinois","Winnebago County",5,63,3741,1848,1893
050,17,201,"Illinois","Winnebago County",5,64,3584,1747,1837
050,17,201,"Illinois","Winnebago County",5,65,3574,1715,1859
050,17,201,"Illinois","Winnebago County",5,66,3521,1691,1830
050,17,201,"Illinois","Winnebago County",5,67,3302,1597,1705
050,17,201,"Illinois","Winnebago County",5,68,3223,1549,1674
050,17,201,"Illinois","Winnebago County",5,69,3207,1512,1695
050,17,201,"Illinois","Winnebago County",5,70,3096,1436,1660
050,17,201,"Illinois","Winnebago County",5,71,3050,1423,1627
050,17,201,"Illinois","Winnebago County",5,72,2802,1309,1493
050,17,201,"Illinois","Winnebago County",5,73,2572,1217,1355
050,17,201,"Illinois","Winnebago County",5,74,2544,1177,1367
050,17,201,"Illinois","Winnebago County",5,75,2488,1154,1334
050,17,201,"Illinois","Winnebago County",5,76,2642,1219,1423
050,17,201,"Illinois","Winnebago County",5,77,1802,816,986
050,17,201,"Illinois","Winnebago County",5,78,1720,767,953
050,17,201,"Illinois","Winnebago County",5,79,1710,786,924
050,17,201,"Illinois","Winnebago County",5,80,1687,755,932
050,17,201,"Illinois","Winnebago County",5,81,1403,615,788
050,17,201,"Illinois","Winnebago County",5,82,1275,530,745
050,17,201,"Illinois","Winnebago County",5,83,1094,447,647
050,17,201,"Illinois","Winnebago County",5,84,995,397,598
050,17,201,"Illinois","Winnebago County",5,85,5678,1992,3686
050,17,203,"Illinois","Woodford County",1,0,407,210,197
050,17,203,"Illinois","Woodford County",1,1,420,219,201
050,17,203,"Illinois","Woodford County",1,2,443,215,228
050,17,203,"Illinois","Woodford County",1,3,449,228,221
050,17,203,"Illinois","Woodford County",1,4,452,247,205
050,17,203,"Illinois","Woodford County",1,5,478,250,228
050,17,203,"Illinois","Woodford County",1,6,501,261,240
050,17,203,"Illinois","Woodford County",1,7,503,273,230
050,17,203,"Illinois","Woodford County",1,8,520,266,254
050,17,203,"Illinois","Woodford County",1,9,546,283,263
050,17,203,"Illinois","Woodford County",1,10,588,292,296
050,17,203,"Illinois","Woodford County",1,11,565,299,266
050,17,203,"Illinois","Woodford County",1,12,575,311,264
050,17,203,"Illinois","Woodford County",1,13,586,296,290
050,17,203,"Illinois","Woodford County",1,14,584,299,285
050,17,203,"Illinois","Woodford County",1,15,567,305,262
050,17,203,"Illinois","Woodford County",1,16,596,303,293
050,17,203,"Illinois","Woodford County",1,17,579,293,286
050,17,203,"Illinois","Woodford County",1,18,520,290,230
050,17,203,"Illinois","Woodford County",1,19,477,249,228
050,17,203,"Illinois","Woodford County",1,20,459,238,221
050,17,203,"Illinois","Woodford County",1,21,463,232,231
050,17,203,"Illinois","Woodford County",1,22,455,243,212
050,17,203,"Illinois","Woodford County",1,23,404,205,199
050,17,203,"Illinois","Woodford County",1,24,360,184,176
050,17,203,"Illinois","Woodford County",1,25,353,178,175
050,17,203,"Illinois","Woodford County",1,26,342,176,166
050,17,203,"Illinois","Woodford County",1,27,386,197,189
050,17,203,"Illinois","Woodford County",1,28,396,197,199
050,17,203,"Illinois","Woodford County",1,29,394,207,187
050,17,203,"Illinois","Woodford County",1,30,427,224,203
050,17,203,"Illinois","Woodford County",1,31,404,210,194
050,17,203,"Illinois","Woodford County",1,32,400,205,195
050,17,203,"Illinois","Woodford County",1,33,403,201,202
050,17,203,"Illinois","Woodford County",1,34,442,206,236
050,17,203,"Illinois","Woodford County",1,35,446,229,217
050,17,203,"Illinois","Woodford County",1,36,496,246,250
050,17,203,"Illinois","Woodford County",1,37,519,248,271
050,17,203,"Illinois","Woodford County",1,38,514,245,269
050,17,203,"Illinois","Woodford County",1,39,532,260,272
050,17,203,"Illinois","Woodford County",1,40,510,258,252
050,17,203,"Illinois","Woodford County",1,41,482,247,235
050,17,203,"Illinois","Woodford County",1,42,479,231,248
050,17,203,"Illinois","Woodford County",1,43,468,237,231
050,17,203,"Illinois","Woodford County",1,44,451,230,221
050,17,203,"Illinois","Woodford County",1,45,453,242,211
050,17,203,"Illinois","Woodford County",1,46,429,229,200
050,17,203,"Illinois","Woodford County",1,47,417,208,209
050,17,203,"Illinois","Woodford County",1,48,469,237,232
050,17,203,"Illinois","Woodford County",1,49,503,249,254
050,17,203,"Illinois","Woodford County",1,50,454,224,230
050,17,203,"Illinois","Woodford County",1,51,477,244,233
050,17,203,"Illinois","Woodford County",1,52,479,253,226
050,17,203,"Illinois","Woodford County",1,53,498,257,241
050,17,203,"Illinois","Woodford County",1,54,489,246,243
050,17,203,"Illinois","Woodford County",1,55,529,268,261
050,17,203,"Illinois","Woodford County",1,56,525,271,254
050,17,203,"Illinois","Woodford County",1,57,552,276,276
050,17,203,"Illinois","Woodford County",1,58,585,307,278
050,17,203,"Illinois","Woodford County",1,59,557,279,278
050,17,203,"Illinois","Woodford County",1,60,531,261,270
050,17,203,"Illinois","Woodford County",1,61,532,261,271
050,17,203,"Illinois","Woodford County",1,62,538,268,270
050,17,203,"Illinois","Woodford County",1,63,544,277,267
050,17,203,"Illinois","Woodford County",1,64,525,273,252
050,17,203,"Illinois","Woodford County",1,65,516,265,251
050,17,203,"Illinois","Woodford County",1,66,489,244,245
050,17,203,"Illinois","Woodford County",1,67,480,245,235
050,17,203,"Illinois","Woodford County",1,68,469,232,237
050,17,203,"Illinois","Woodford County",1,69,399,198,201
050,17,203,"Illinois","Woodford County",1,70,389,202,187
050,17,203,"Illinois","Woodford County",1,71,368,196,172
050,17,203,"Illinois","Woodford County",1,72,352,179,173
050,17,203,"Illinois","Woodford County",1,73,368,180,188
050,17,203,"Illinois","Woodford County",1,74,234,115,119
050,17,203,"Illinois","Woodford County",1,75,237,111,126
050,17,203,"Illinois","Woodford County",1,76,253,117,136
050,17,203,"Illinois","Woodford County",1,77,270,124,146
050,17,203,"Illinois","Woodford County",1,78,216,98,118
050,17,203,"Illinois","Woodford County",1,79,200,84,116
050,17,203,"Illinois","Woodford County",1,80,169,66,103
050,17,203,"Illinois","Woodford County",1,81,165,73,92
050,17,203,"Illinois","Woodford County",1,82,183,79,104
050,17,203,"Illinois","Woodford County",1,83,158,65,93
050,17,203,"Illinois","Woodford County",1,84,125,56,69
050,17,203,"Illinois","Woodford County",1,85,998,348,650
050,17,203,"Illinois","Woodford County",2,0,400,216,184
050,17,203,"Illinois","Woodford County",2,1,416,215,201
050,17,203,"Illinois","Woodford County",2,2,437,215,222
050,17,203,"Illinois","Woodford County",2,3,446,224,222
050,17,203,"Illinois","Woodford County",2,4,454,243,211
050,17,203,"Illinois","Woodford County",2,5,477,252,225
050,17,203,"Illinois","Woodford County",2,6,501,263,238
050,17,203,"Illinois","Woodford County",2,7,503,271,232
050,17,203,"Illinois","Woodford County",2,8,519,270,249
050,17,203,"Illinois","Woodford County",2,9,543,279,264
050,17,203,"Illinois","Woodford County",2,10,579,289,290
050,17,203,"Illinois","Woodford County",2,11,571,296,275
050,17,203,"Illinois","Woodford County",2,12,580,312,268
050,17,203,"Illinois","Woodford County",2,13,581,297,284
050,17,203,"Illinois","Woodford County",2,14,581,296,285
050,17,203,"Illinois","Woodford County",2,15,571,303,268
050,17,203,"Illinois","Woodford County",2,16,589,303,286
050,17,203,"Illinois","Woodford County",2,17,580,294,286
050,17,203,"Illinois","Woodford County",2,18,517,283,234
050,17,203,"Illinois","Woodford County",2,19,474,249,225
050,17,203,"Illinois","Woodford County",2,20,467,243,224
050,17,203,"Illinois","Woodford County",2,21,467,237,230
050,17,203,"Illinois","Woodford County",2,22,448,236,212
050,17,203,"Illinois","Woodford County",2,23,402,205,197
050,17,203,"Illinois","Woodford County",2,24,366,186,180
050,17,203,"Illinois","Woodford County",2,25,351,177,174
050,17,203,"Illinois","Woodford County",2,26,347,178,169
050,17,203,"Illinois","Woodford County",2,27,374,191,183
050,17,203,"Illinois","Woodford County",2,28,393,198,195
050,17,203,"Illinois","Woodford County",2,29,400,208,192
050,17,203,"Illinois","Woodford County",2,30,425,223,202
050,17,203,"Illinois","Woodford County",2,31,412,215,197
050,17,203,"Illinois","Woodford County",2,32,403,208,195
050,17,203,"Illinois","Woodford County",2,33,405,205,200
050,17,203,"Illinois","Woodford County",2,34,434,205,229
050,17,203,"Illinois","Woodford County",2,35,452,227,225
050,17,203,"Illinois","Woodford County",2,36,481,240,241
050,17,203,"Illinois","Woodford County",2,37,513,247,266
050,17,203,"Illinois","Woodford County",2,38,517,247,270
050,17,203,"Illinois","Woodford County",2,39,525,255,270
050,17,203,"Illinois","Woodford County",2,40,517,260,257
050,17,203,"Illinois","Woodford County",2,41,489,249,240
050,17,203,"Illinois","Woodford County",2,42,478,234,244
050,17,203,"Illinois","Woodford County",2,43,472,237,235
050,17,203,"Illinois","Woodford County",2,44,450,228,222
050,17,203,"Illinois","Woodford County",2,45,454,240,214
050,17,203,"Illinois","Woodford County",2,46,429,229,200
050,17,203,"Illinois","Woodford County",2,47,418,212,206
050,17,203,"Illinois","Woodford County",2,48,461,232,229
050,17,203,"Illinois","Woodford County",2,49,496,248,248
050,17,203,"Illinois","Woodford County",2,50,466,229,237
050,17,203,"Illinois","Woodford County",2,51,466,234,232
050,17,203,"Illinois","Woodford County",2,52,478,251,227
050,17,203,"Illinois","Woodford County",2,53,491,255,236
050,17,203,"Illinois","Woodford County",2,54,489,248,241
050,17,203,"Illinois","Woodford County",2,55,519,263,256
050,17,203,"Illinois","Woodford County",2,56,523,270,253
050,17,203,"Illinois","Woodford County",2,57,542,273,269
050,17,203,"Illinois","Woodford County",2,58,577,299,278
050,17,203,"Illinois","Woodford County",2,59,564,286,278
050,17,203,"Illinois","Woodford County",2,60,535,264,271
050,17,203,"Illinois","Woodford County",2,61,526,258,268
050,17,203,"Illinois","Woodford County",2,62,533,261,272
050,17,203,"Illinois","Woodford County",2,63,542,274,268
050,17,203,"Illinois","Woodford County",2,64,524,270,254
050,17,203,"Illinois","Woodford County",2,65,512,262,250
050,17,203,"Illinois","Woodford County",2,66,495,250,245
050,17,203,"Illinois","Woodford County",2,67,476,241,235
050,17,203,"Illinois","Woodford County",2,68,465,233,232
050,17,203,"Illinois","Woodford County",2,69,418,207,211
050,17,203,"Illinois","Woodford County",2,70,387,200,187
050,17,203,"Illinois","Woodford County",2,71,368,195,173
050,17,203,"Illinois","Woodford County",2,72,346,178,168
050,17,203,"Illinois","Woodford County",2,73,382,190,192
050,17,203,"Illinois","Woodford County",2,74,248,122,126
050,17,203,"Illinois","Woodford County",2,75,236,112,124
050,17,203,"Illinois","Woodford County",2,76,245,114,131
050,17,203,"Illinois","Woodford County",2,77,270,123,147
050,17,203,"Illinois","Woodford County",2,78,220,101,119
050,17,203,"Illinois","Woodford County",2,79,204,86,118
050,17,203,"Illinois","Woodford County",2,80,173,69,104
050,17,203,"Illinois","Woodford County",2,81,164,71,93
050,17,203,"Illinois","Woodford County",2,82,180,78,102
050,17,203,"Illinois","Woodford County",2,83,164,67,97
050,17,203,"Illinois","Woodford County",2,84,128,60,68
050,17,203,"Illinois","Woodford County",2,85,992,347,645
050,17,203,"Illinois","Woodford County",3,0,372,193,179
050,17,203,"Illinois","Woodford County",3,1,398,203,195
050,17,203,"Illinois","Woodford County",3,2,439,237,202
050,17,203,"Illinois","Woodford County",3,3,460,228,232
050,17,203,"Illinois","Woodford County",3,4,447,227,220
050,17,203,"Illinois","Woodford County",3,5,462,244,218
050,17,203,"Illinois","Woodford County",3,6,491,250,241
050,17,203,"Illinois","Woodford County",3,7,492,264,228
050,17,203,"Illinois","Woodford County",3,8,505,266,239
050,17,203,"Illinois","Woodford County",3,9,537,274,263
050,17,203,"Illinois","Woodford County",3,10,528,272,256
050,17,203,"Illinois","Woodford County",3,11,573,292,281
050,17,203,"Illinois","Woodford County",3,12,570,300,270
050,17,203,"Illinois","Woodford County",3,13,579,316,263
050,17,203,"Illinois","Woodford County",3,14,572,300,272
050,17,203,"Illinois","Woodford County",3,15,584,290,294
050,17,203,"Illinois","Woodford County",3,16,574,299,275
050,17,203,"Illinois","Woodford County",3,17,582,296,286
050,17,203,"Illinois","Woodford County",3,18,504,266,238
050,17,203,"Illinois","Woodford County",3,19,456,238,218
050,17,203,"Illinois","Woodford County",3,20,475,247,228
050,17,203,"Illinois","Woodford County",3,21,476,248,228
050,17,203,"Illinois","Woodford County",3,22,463,237,226
050,17,203,"Illinois","Woodford County",3,23,400,210,190
050,17,203,"Illinois","Woodford County",3,24,392,191,201
050,17,203,"Illinois","Woodford County",3,25,368,196,172
050,17,203,"Illinois","Woodford County",3,26,348,182,166
050,17,203,"Illinois","Woodford County",3,27,342,169,173
050,17,203,"Illinois","Woodford County",3,28,386,199,187
050,17,203,"Illinois","Woodford County",3,29,385,174,211
050,17,203,"Illinois","Woodford County",3,30,397,216,181
050,17,203,"Illinois","Woodford County",3,31,434,221,213
050,17,203,"Illinois","Woodford County",3,32,447,238,209
050,17,203,"Illinois","Woodford County",3,33,411,216,195
050,17,203,"Illinois","Woodford County",3,34,411,204,207
050,17,203,"Illinois","Woodford County",3,35,426,207,219
050,17,203,"Illinois","Woodford County",3,36,447,231,216
050,17,203,"Illinois","Woodford County",3,37,479,229,250
050,17,203,"Illinois","Woodford County",3,38,521,254,267
050,17,203,"Illinois","Woodford County",3,39,523,247,276
050,17,203,"Illinois","Woodford County",3,40,536,272,264
050,17,203,"Illinois","Woodford County",3,41,520,258,262
050,17,203,"Illinois","Woodford County",3,42,505,257,248
050,17,203,"Illinois","Woodford County",3,43,472,238,234
050,17,203,"Illinois","Woodford County",3,44,478,238,240
050,17,203,"Illinois","Woodford County",3,45,461,235,226
050,17,203,"Illinois","Woodford County",3,46,438,228,210
050,17,203,"Illinois","Woodford County",3,47,432,232,200
050,17,203,"Illinois","Woodford County",3,48,419,215,204
050,17,203,"Illinois","Woodford County",3,49,444,223,221
050,17,203,"Illinois","Woodford County",3,50,495,243,252
050,17,203,"Illinois","Woodford County",3,51,452,218,234
050,17,203,"Illinois","Woodford County",3,52,469,233,236
050,17,203,"Illinois","Woodford County",3,53,470,249,221
050,17,203,"Illinois","Woodford County",3,54,491,255,236
050,17,203,"Illinois","Woodford County",3,55,477,242,235
050,17,203,"Illinois","Woodford County",3,56,503,254,249
050,17,203,"Illinois","Woodford County",3,57,516,268,248
050,17,203,"Illinois","Woodford County",3,58,528,268,260
050,17,203,"Illinois","Woodford County",3,59,573,296,277
050,17,203,"Illinois","Woodford County",3,60,570,284,286
050,17,203,"Illinois","Woodford County",3,61,537,257,280
050,17,203,"Illinois","Woodford County",3,62,534,265,269
050,17,203,"Illinois","Woodford County",3,63,535,258,277
050,17,203,"Illinois","Woodford County",3,64,520,264,256
050,17,203,"Illinois","Woodford County",3,65,510,260,250
050,17,203,"Illinois","Woodford County",3,66,506,259,247
050,17,203,"Illinois","Woodford County",3,67,481,238,243
050,17,203,"Illinois","Woodford County",3,68,469,239,230
050,17,203,"Illinois","Woodford County",3,69,460,227,233
050,17,203,"Illinois","Woodford County",3,70,408,198,210
050,17,203,"Illinois","Woodford County",3,71,377,193,184
050,17,203,"Illinois","Woodford County",3,72,352,186,166
050,17,203,"Illinois","Woodford County",3,73,329,170,159
050,17,203,"Illinois","Woodford County",3,74,371,185,186
050,17,203,"Illinois","Woodford County",3,75,239,113,126
050,17,203,"Illinois","Woodford County",3,76,234,109,125
050,17,203,"Illinois","Woodford County",3,77,234,110,124
050,17,203,"Illinois","Woodford County",3,78,246,114,132
050,17,203,"Illinois","Woodford County",3,79,214,93,121
050,17,203,"Illinois","Woodford County",3,80,189,77,112
050,17,203,"Illinois","Woodford County",3,81,160,64,96
050,17,203,"Illinois","Woodford County",3,82,152,61,91
050,17,203,"Illinois","Woodford County",3,83,174,72,102
050,17,203,"Illinois","Woodford County",3,84,139,65,74
050,17,203,"Illinois","Woodford County",3,85,945,325,620
050,17,203,"Illinois","Woodford County",4,0,394,201,193
050,17,203,"Illinois","Woodford County",4,1,393,201,192
050,17,203,"Illinois","Woodford County",4,2,422,216,206
050,17,203,"Illinois","Woodford County",4,3,458,242,216
050,17,203,"Illinois","Woodford County",4,4,487,237,250
050,17,203,"Illinois","Woodford County",4,5,446,231,215
050,17,203,"Illinois","Woodford County",4,6,481,259,222
050,17,203,"Illinois","Woodford County",4,7,501,257,244
050,17,203,"Illinois","Woodford County",4,8,514,275,239
050,17,203,"Illinois","Woodford County",4,9,509,258,251
050,17,203,"Illinois","Woodford County",4,10,540,279,261
050,17,203,"Illinois","Woodford County",4,11,546,281,265
050,17,203,"Illinois","Woodford County",4,12,581,290,291
050,17,203,"Illinois","Woodford County",4,13,561,286,275
050,17,203,"Illinois","Woodford County",4,14,579,312,267
050,17,203,"Illinois","Woodford County",4,15,562,295,267
050,17,203,"Illinois","Woodford County",4,16,572,280,292
050,17,203,"Illinois","Woodford County",4,17,575,306,269
050,17,203,"Illinois","Woodford County",4,18,520,281,239
050,17,203,"Illinois","Woodford County",4,19,421,217,204
050,17,203,"Illinois","Woodford County",4,20,445,231,214
050,17,203,"Illinois","Woodford County",4,21,467,247,220
050,17,203,"Illinois","Woodford County",4,22,461,247,214
050,17,203,"Illinois","Woodford County",4,23,417,217,200
050,17,203,"Illinois","Woodford County",4,24,372,186,186
050,17,203,"Illinois","Woodford County",4,25,374,189,185
050,17,203,"Illinois","Woodford County",4,26,388,197,191
050,17,203,"Illinois","Woodford County",4,27,353,185,168
050,17,203,"Illinois","Woodford County",4,28,341,173,168
050,17,203,"Illinois","Woodford County",4,29,398,211,187
050,17,203,"Illinois","Woodford County",4,30,408,192,216
050,17,203,"Illinois","Woodford County",4,31,400,208,192
050,17,203,"Illinois","Woodford County",4,32,453,227,226
050,17,203,"Illinois","Woodford County",4,33,457,242,215
050,17,203,"Illinois","Woodford County",4,34,427,222,205
050,17,203,"Illinois","Woodford County",4,35,429,210,219
050,17,203,"Illinois","Woodford County",4,36,446,219,227
050,17,203,"Illinois","Woodford County",4,37,472,251,221
050,17,203,"Illinois","Woodford County",4,38,481,229,252
050,17,203,"Illinois","Woodford County",4,39,536,262,274
050,17,203,"Illinois","Woodford County",4,40,519,237,282
050,17,203,"Illinois","Woodford County",4,41,533,270,263
050,17,203,"Illinois","Woodford County",4,42,524,263,261
050,17,203,"Illinois","Woodford County",4,43,506,266,240
050,17,203,"Illinois","Woodford County",4,44,465,238,227
050,17,203,"Illinois","Woodford County",4,45,471,237,234
050,17,203,"Illinois","Woodford County",4,46,454,238,216
050,17,203,"Illinois","Woodford County",4,47,433,224,209
050,17,203,"Illinois","Woodford County",4,48,422,224,198
050,17,203,"Illinois","Woodford County",4,49,407,211,196
050,17,203,"Illinois","Woodford County",4,50,446,223,223
050,17,203,"Illinois","Woodford County",4,51,487,239,248
050,17,203,"Illinois","Woodford County",4,52,451,213,238
050,17,203,"Illinois","Woodford County",4,53,475,241,234
050,17,203,"Illinois","Woodford County",4,54,471,252,219
050,17,203,"Illinois","Woodford County",4,55,478,245,233
050,17,203,"Illinois","Woodford County",4,56,476,238,238
050,17,203,"Illinois","Woodford County",4,57,502,254,248
050,17,203,"Illinois","Woodford County",4,58,514,268,246
050,17,203,"Illinois","Woodford County",4,59,521,267,254
050,17,203,"Illinois","Woodford County",4,60,568,291,277
050,17,203,"Illinois","Woodford County",4,61,562,282,280
050,17,203,"Illinois","Woodford County",4,62,526,251,275
050,17,203,"Illinois","Woodford County",4,63,522,258,264
050,17,203,"Illinois","Woodford County",4,64,516,243,273
050,17,203,"Illinois","Woodford County",4,65,507,260,247
050,17,203,"Illinois","Woodford County",4,66,498,253,245
050,17,203,"Illinois","Woodford County",4,67,488,246,242
050,17,203,"Illinois","Woodford County",4,68,477,241,236
050,17,203,"Illinois","Woodford County",4,69,453,230,223
050,17,203,"Illinois","Woodford County",4,70,447,220,227
050,17,203,"Illinois","Woodford County",4,71,397,191,206
050,17,203,"Illinois","Woodford County",4,72,359,184,175
050,17,203,"Illinois","Woodford County",4,73,342,179,163
050,17,203,"Illinois","Woodford County",4,74,318,165,153
050,17,203,"Illinois","Woodford County",4,75,358,173,185
050,17,203,"Illinois","Woodford County",4,76,238,111,127
050,17,203,"Illinois","Woodford County",4,77,232,107,125
050,17,203,"Illinois","Woodford County",4,78,212,99,113
050,17,203,"Illinois","Woodford County",4,79,243,108,135
050,17,203,"Illinois","Woodford County",4,80,198,86,112
050,17,203,"Illinois","Woodford County",4,81,185,80,105
050,17,203,"Illinois","Woodford County",4,82,152,59,93
050,17,203,"Illinois","Woodford County",4,83,144,48,96
050,17,203,"Illinois","Woodford County",4,84,153,70,83
050,17,203,"Illinois","Woodford County",4,85,940,322,618
050,17,203,"Illinois","Woodford County",5,0,389,197,192
050,17,203,"Illinois","Woodford County",5,1,406,220,186
050,17,203,"Illinois","Woodford County",5,2,408,210,198
050,17,203,"Illinois","Woodford County",5,3,428,223,205
050,17,203,"Illinois","Woodford County",5,4,457,238,219
050,17,203,"Illinois","Woodford County",5,5,507,242,265
050,17,203,"Illinois","Woodford County",5,6,455,229,226
050,17,203,"Illinois","Woodford County",5,7,485,262,223
050,17,203,"Illinois","Woodford County",5,8,508,255,253
050,17,203,"Illinois","Woodford County",5,9,516,274,242
050,17,203,"Illinois","Woodford County",5,10,533,272,261
050,17,203,"Illinois","Woodford County",5,11,528,273,255
050,17,203,"Illinois","Woodford County",5,12,557,286,271
050,17,203,"Illinois","Woodford County",5,13,584,293,291
050,17,203,"Illinois","Woodford County",5,14,564,289,275
050,17,203,"Illinois","Woodford County",5,15,577,310,267
050,17,203,"Illinois","Woodford County",5,16,565,297,268
050,17,203,"Illinois","Woodford County",5,17,584,288,296
050,17,203,"Illinois","Woodford County",5,18,507,281,226
050,17,203,"Illinois","Woodford County",5,19,439,223,216
050,17,203,"Illinois","Woodford County",5,20,425,210,215
050,17,203,"Illinois","Woodford County",5,21,476,246,230
050,17,203,"Illinois","Woodford County",5,22,455,249,206
050,17,203,"Illinois","Woodford County",5,23,433,219,214
050,17,203,"Illinois","Woodford County",5,24,398,197,201
050,17,203,"Illinois","Woodford County",5,25,367,186,181
050,17,203,"Illinois","Woodford County",5,26,382,198,184
050,17,203,"Illinois","Woodford County",5,27,395,203,192
050,17,203,"Illinois","Woodford County",5,28,361,171,190
050,17,203,"Illinois","Woodford County",5,29,340,173,167
050,17,203,"Illinois","Woodford County",5,30,423,227,196
050,17,203,"Illinois","Woodford County",5,31,421,201,220
050,17,203,"Illinois","Woodford County",5,32,425,219,206
050,17,203,"Illinois","Woodford County",5,33,457,223,234
050,17,203,"Illinois","Woodford County",5,34,453,241,212
050,17,203,"Illinois","Woodford County",5,35,456,234,222
050,17,203,"Illinois","Woodford County",5,36,454,225,229
050,17,203,"Illinois","Woodford County",5,37,463,229,234
050,17,203,"Illinois","Woodford County",5,38,472,247,225
050,17,203,"Illinois","Woodford County",5,39,486,224,262
050,17,203,"Illinois","Woodford County",5,40,545,269,276
050,17,203,"Illinois","Woodford County",5,41,524,234,290
050,17,203,"Illinois","Woodford County",5,42,543,272,271
050,17,203,"Illinois","Woodford County",5,43,533,271,262
050,17,203,"Illinois","Woodford County",5,44,506,270,236
050,17,203,"Illinois","Woodford County",5,45,457,233,224
050,17,203,"Illinois","Woodford County",5,46,460,233,227
050,17,203,"Illinois","Woodford County",5,47,456,237,219
050,17,203,"Illinois","Woodford County",5,48,430,222,208
050,17,203,"Illinois","Woodford County",5,49,407,220,187
050,17,203,"Illinois","Woodford County",5,50,410,209,201
050,17,203,"Illinois","Woodford County",5,51,433,214,219
050,17,203,"Illinois","Woodford County",5,52,500,243,257
050,17,203,"Illinois","Woodford County",5,53,464,217,247
050,17,203,"Illinois","Woodford County",5,54,479,245,234
050,17,203,"Illinois","Woodford County",5,55,463,254,209
050,17,203,"Illinois","Woodford County",5,56,480,240,240
050,17,203,"Illinois","Woodford County",5,57,474,235,239
050,17,203,"Illinois","Woodford County",5,58,508,255,253
050,17,203,"Illinois","Woodford County",5,59,506,262,244
050,17,203,"Illinois","Woodford County",5,60,515,264,251
050,17,203,"Illinois","Woodford County",5,61,562,287,275
050,17,203,"Illinois","Woodford County",5,62,555,275,280
050,17,203,"Illinois","Woodford County",5,63,521,249,272
050,17,203,"Illinois","Woodford County",5,64,508,249,259
050,17,203,"Illinois","Woodford County",5,65,509,237,272
050,17,203,"Illinois","Woodford County",5,66,494,257,237
050,17,203,"Illinois","Woodford County",5,67,486,247,239
050,17,203,"Illinois","Woodford County",5,68,493,251,242
050,17,203,"Illinois","Woodford County",5,69,457,235,222
050,17,203,"Illinois","Woodford County",5,70,444,221,223
050,17,203,"Illinois","Woodford County",5,71,431,210,221
050,17,203,"Illinois","Woodford County",5,72,385,186,199
050,17,203,"Illinois","Woodford County",5,73,353,180,173
050,17,203,"Illinois","Woodford County",5,74,331,173,158
050,17,203,"Illinois","Woodford County",5,75,310,157,153
050,17,203,"Illinois","Woodford County",5,76,349,171,178
050,17,203,"Illinois","Woodford County",5,77,231,105,126
050,17,203,"Illinois","Woodford County",5,78,209,98,111
050,17,203,"Illinois","Woodford County",5,79,207,93,114
050,17,203,"Illinois","Woodford County",5,80,229,102,127
050,17,203,"Illinois","Woodford County",5,81,192,85,107
050,17,203,"Illinois","Woodford County",5,82,180,79,101
050,17,203,"Illinois","Woodford County",5,83,145,47,98
050,17,203,"Illinois","Woodford County",5,84,123,51,72
050,17,203,"Illinois","Woodford County",5,85,949,320,629

