"SUMLEV","STATE","COUNTY","STNAME","CTYNAME","YEAR","AGE","TOT_POP","TOT_MALE","TOT_FEMALE"
050,51,001,"Virginia","Accomack County",1,0,349,179,170
050,51,001,"Virginia","Accomack County",1,1,370,181,189
050,51,001,"Virginia","Accomack County",1,2,389,183,206
050,51,001,"Virginia","Accomack County",1,3,360,204,156
050,51,001,"Virginia","Accomack County",1,4,377,203,174
050,51,001,"Virginia","Accomack County",1,5,358,191,167
050,51,001,"Virginia","Accomack County",1,6,359,185,174
050,51,001,"Virginia","Accomack County",1,7,360,188,172
050,51,001,"Virginia","Accomack County",1,8,418,215,203
050,51,001,"Virginia","Accomack County",1,9,436,238,198
050,51,001,"Virginia","Accomack County",1,10,400,217,183
050,51,001,"Virginia","Accomack County",1,11,423,216,207
050,51,001,"Virginia","Accomack County",1,12,430,223,207
050,51,001,"Virginia","Accomack County",1,13,417,207,210
050,51,001,"Virginia","Accomack County",1,14,426,222,204
050,51,001,"Virginia","Accomack County",1,15,396,221,175
050,51,001,"Virginia","Accomack County",1,16,392,221,171
050,51,001,"Virginia","Accomack County",1,17,388,209,179
050,51,001,"Virginia","Accomack County",1,18,360,184,176
050,51,001,"Virginia","Accomack County",1,19,319,165,154
050,51,001,"Virginia","Accomack County",1,20,309,163,146
050,51,001,"Virginia","Accomack County",1,21,292,162,130
050,51,001,"Virginia","Accomack County",1,22,319,181,138
050,51,001,"Virginia","Accomack County",1,23,312,164,148
050,51,001,"Virginia","Accomack County",1,24,279,146,133
050,51,001,"Virginia","Accomack County",1,25,307,171,136
050,51,001,"Virginia","Accomack County",1,26,325,173,152
050,51,001,"Virginia","Accomack County",1,27,348,172,176
050,51,001,"Virginia","Accomack County",1,28,376,183,193
050,51,001,"Virginia","Accomack County",1,29,380,167,213
050,51,001,"Virginia","Accomack County",1,30,367,169,198
050,51,001,"Virginia","Accomack County",1,31,364,183,181
050,51,001,"Virginia","Accomack County",1,32,362,197,165
050,51,001,"Virginia","Accomack County",1,33,370,188,182
050,51,001,"Virginia","Accomack County",1,34,333,160,173
050,51,001,"Virginia","Accomack County",1,35,324,155,169
050,51,001,"Virginia","Accomack County",1,36,338,161,177
050,51,001,"Virginia","Accomack County",1,37,334,153,181
050,51,001,"Virginia","Accomack County",1,38,338,171,167
050,51,001,"Virginia","Accomack County",1,39,356,184,172
050,51,001,"Virginia","Accomack County",1,40,373,194,179
050,51,001,"Virginia","Accomack County",1,41,354,170,184
050,51,001,"Virginia","Accomack County",1,42,327,157,170
050,51,001,"Virginia","Accomack County",1,43,321,158,163
050,51,001,"Virginia","Accomack County",1,44,337,157,180
050,51,001,"Virginia","Accomack County",1,45,341,161,180
050,51,001,"Virginia","Accomack County",1,46,351,173,178
050,51,001,"Virginia","Accomack County",1,47,360,184,176
050,51,001,"Virginia","Accomack County",1,48,382,202,180
050,51,001,"Virginia","Accomack County",1,49,403,205,198
050,51,001,"Virginia","Accomack County",1,50,393,185,208
050,51,001,"Virginia","Accomack County",1,51,403,211,192
050,51,001,"Virginia","Accomack County",1,52,418,205,213
050,51,001,"Virginia","Accomack County",1,53,418,201,217
050,51,001,"Virginia","Accomack County",1,54,452,210,242
050,51,001,"Virginia","Accomack County",1,55,476,220,256
050,51,001,"Virginia","Accomack County",1,56,474,232,242
050,51,001,"Virginia","Accomack County",1,57,476,227,249
050,51,001,"Virginia","Accomack County",1,58,486,232,254
050,51,001,"Virginia","Accomack County",1,59,526,261,265
050,51,001,"Virginia","Accomack County",1,60,526,242,284
050,51,001,"Virginia","Accomack County",1,61,532,247,285
050,51,001,"Virginia","Accomack County",1,62,577,284,293
050,51,001,"Virginia","Accomack County",1,63,603,294,309
050,51,001,"Virginia","Accomack County",1,64,598,288,310
050,51,001,"Virginia","Accomack County",1,65,575,273,302
050,51,001,"Virginia","Accomack County",1,66,581,288,293
050,51,001,"Virginia","Accomack County",1,67,538,254,284
050,51,001,"Virginia","Accomack County",1,68,516,245,271
050,51,001,"Virginia","Accomack County",1,69,469,226,243
050,51,001,"Virginia","Accomack County",1,70,452,215,237
050,51,001,"Virginia","Accomack County",1,71,448,209,239
050,51,001,"Virginia","Accomack County",1,72,457,222,235
050,51,001,"Virginia","Accomack County",1,73,451,211,240
050,51,001,"Virginia","Accomack County",1,74,342,146,196
050,51,001,"Virginia","Accomack County",1,75,344,161,183
050,51,001,"Virginia","Accomack County",1,76,336,164,172
050,51,001,"Virginia","Accomack County",1,77,318,149,169
050,51,001,"Virginia","Accomack County",1,78,265,113,152
050,51,001,"Virginia","Accomack County",1,79,245,112,133
050,51,001,"Virginia","Accomack County",1,80,206,106,100
050,51,001,"Virginia","Accomack County",1,81,211,99,112
050,51,001,"Virginia","Accomack County",1,82,186,78,108
050,51,001,"Virginia","Accomack County",1,83,150,73,77
050,51,001,"Virginia","Accomack County",1,84,134,57,77
050,51,001,"Virginia","Accomack County",1,85,827,332,495
050,51,001,"Virginia","Accomack County",2,0,355,181,174
050,51,001,"Virginia","Accomack County",2,1,364,180,184
050,51,001,"Virginia","Accomack County",2,2,382,184,198
050,51,001,"Virginia","Accomack County",2,3,362,197,165
050,51,001,"Virginia","Accomack County",2,4,371,203,168
050,51,001,"Virginia","Accomack County",2,5,361,194,167
050,51,001,"Virginia","Accomack County",2,6,359,188,171
050,51,001,"Virginia","Accomack County",2,7,360,188,172
050,51,001,"Virginia","Accomack County",2,8,400,208,192
050,51,001,"Virginia","Accomack County",2,9,433,235,198
050,51,001,"Virginia","Accomack County",2,10,409,224,185
050,51,001,"Virginia","Accomack County",2,11,416,216,200
050,51,001,"Virginia","Accomack County",2,12,430,222,208
050,51,001,"Virginia","Accomack County",2,13,422,213,209
050,51,001,"Virginia","Accomack County",2,14,420,217,203
050,51,001,"Virginia","Accomack County",2,15,402,221,181
050,51,001,"Virginia","Accomack County",2,16,391,221,170
050,51,001,"Virginia","Accomack County",2,17,392,212,180
050,51,001,"Virginia","Accomack County",2,18,354,186,168
050,51,001,"Virginia","Accomack County",2,19,318,165,153
050,51,001,"Virginia","Accomack County",2,20,312,165,147
050,51,001,"Virginia","Accomack County",2,21,300,165,135
050,51,001,"Virginia","Accomack County",2,22,318,180,138
050,51,001,"Virginia","Accomack County",2,23,314,167,147
050,51,001,"Virginia","Accomack County",2,24,282,147,135
050,51,001,"Virginia","Accomack County",2,25,302,166,136
050,51,001,"Virginia","Accomack County",2,26,319,171,148
050,51,001,"Virginia","Accomack County",2,27,344,174,170
050,51,001,"Virginia","Accomack County",2,28,368,178,190
050,51,001,"Virginia","Accomack County",2,29,383,173,210
050,51,001,"Virginia","Accomack County",2,30,374,171,203
050,51,001,"Virginia","Accomack County",2,31,361,177,184
050,51,001,"Virginia","Accomack County",2,32,361,192,169
050,51,001,"Virginia","Accomack County",2,33,363,187,176
050,51,001,"Virginia","Accomack County",2,34,338,163,175
050,51,001,"Virginia","Accomack County",2,35,329,156,173
050,51,001,"Virginia","Accomack County",2,36,332,157,175
050,51,001,"Virginia","Accomack County",2,37,334,153,181
050,51,001,"Virginia","Accomack County",2,38,339,168,171
050,51,001,"Virginia","Accomack County",2,39,350,180,170
050,51,001,"Virginia","Accomack County",2,40,374,192,182
050,51,001,"Virginia","Accomack County",2,41,358,174,184
050,51,001,"Virginia","Accomack County",2,42,330,159,171
050,51,001,"Virginia","Accomack County",2,43,326,160,166
050,51,001,"Virginia","Accomack County",2,44,328,155,173
050,51,001,"Virginia","Accomack County",2,45,338,159,179
050,51,001,"Virginia","Accomack County",2,46,347,169,178
050,51,001,"Virginia","Accomack County",2,47,357,181,176
050,51,001,"Virginia","Accomack County",2,48,379,197,182
050,51,001,"Virginia","Accomack County",2,49,399,203,196
050,51,001,"Virginia","Accomack County",2,50,393,191,202
050,51,001,"Virginia","Accomack County",2,51,398,203,195
050,51,001,"Virginia","Accomack County",2,52,413,205,208
050,51,001,"Virginia","Accomack County",2,53,416,203,213
050,51,001,"Virginia","Accomack County",2,54,442,206,236
050,51,001,"Virginia","Accomack County",2,55,472,217,255
050,51,001,"Virginia","Accomack County",2,56,476,231,245
050,51,001,"Virginia","Accomack County",2,57,478,231,247
050,51,001,"Virginia","Accomack County",2,58,488,231,257
050,51,001,"Virginia","Accomack County",2,59,518,254,264
050,51,001,"Virginia","Accomack County",2,60,525,245,280
050,51,001,"Virginia","Accomack County",2,61,535,248,287
050,51,001,"Virginia","Accomack County",2,62,569,277,292
050,51,001,"Virginia","Accomack County",2,63,604,296,308
050,51,001,"Virginia","Accomack County",2,64,598,290,308
050,51,001,"Virginia","Accomack County",2,65,583,280,303
050,51,001,"Virginia","Accomack County",2,66,584,287,297
050,51,001,"Virginia","Accomack County",2,67,550,261,289
050,51,001,"Virginia","Accomack County",2,68,514,242,272
050,51,001,"Virginia","Accomack County",2,69,485,232,253
050,51,001,"Virginia","Accomack County",2,70,452,213,239
050,51,001,"Virginia","Accomack County",2,71,449,210,239
050,51,001,"Virginia","Accomack County",2,72,442,212,230
050,51,001,"Virginia","Accomack County",2,73,470,222,248
050,51,001,"Virginia","Accomack County",2,74,342,149,193
050,51,001,"Virginia","Accomack County",2,75,343,158,185
050,51,001,"Virginia","Accomack County",2,76,330,160,170
050,51,001,"Virginia","Accomack County",2,77,329,157,172
050,51,001,"Virginia","Accomack County",2,78,268,120,148
050,51,001,"Virginia","Accomack County",2,79,244,109,135
050,51,001,"Virginia","Accomack County",2,80,211,104,107
050,51,001,"Virginia","Accomack County",2,81,203,95,108
050,51,001,"Virginia","Accomack County",2,82,189,83,106
050,51,001,"Virginia","Accomack County",2,83,156,74,82
050,51,001,"Virginia","Accomack County",2,84,131,59,72
050,51,001,"Virginia","Accomack County",2,85,832,338,494
050,51,001,"Virginia","Accomack County",3,0,337,157,180
050,51,001,"Virginia","Accomack County",3,1,350,181,169
050,51,001,"Virginia","Accomack County",3,2,363,185,178
050,51,001,"Virginia","Accomack County",3,3,375,189,186
050,51,001,"Virginia","Accomack County",3,4,368,196,172
050,51,001,"Virginia","Accomack County",3,5,379,212,167
050,51,001,"Virginia","Accomack County",3,6,363,196,167
050,51,001,"Virginia","Accomack County",3,7,363,192,171
050,51,001,"Virginia","Accomack County",3,8,363,183,180
050,51,001,"Virginia","Accomack County",3,9,407,215,192
050,51,001,"Virginia","Accomack County",3,10,438,231,207
050,51,001,"Virginia","Accomack County",3,11,391,205,186
050,51,001,"Virginia","Accomack County",3,12,419,217,202
050,51,001,"Virginia","Accomack County",3,13,421,219,202
050,51,001,"Virginia","Accomack County",3,14,423,210,213
050,51,001,"Virginia","Accomack County",3,15,410,209,201
050,51,001,"Virginia","Accomack County",3,16,400,211,189
050,51,001,"Virginia","Accomack County",3,17,387,220,167
050,51,001,"Virginia","Accomack County",3,18,346,186,160
050,51,001,"Virginia","Accomack County",3,19,309,161,148
050,51,001,"Virginia","Accomack County",3,20,325,163,162
050,51,001,"Virginia","Accomack County",3,21,333,177,156
050,51,001,"Virginia","Accomack County",3,22,298,164,134
050,51,001,"Virginia","Accomack County",3,23,318,183,135
050,51,001,"Virginia","Accomack County",3,24,318,169,149
050,51,001,"Virginia","Accomack County",3,25,295,157,138
050,51,001,"Virginia","Accomack County",3,26,306,157,149
050,51,001,"Virginia","Accomack County",3,27,320,166,154
050,51,001,"Virginia","Accomack County",3,28,334,159,175
050,51,001,"Virginia","Accomack County",3,29,380,182,198
050,51,001,"Virginia","Accomack County",3,30,389,179,210
050,51,001,"Virginia","Accomack County",3,31,367,167,200
050,51,001,"Virginia","Accomack County",3,32,362,177,185
050,51,001,"Virginia","Accomack County",3,33,355,191,164
050,51,001,"Virginia","Accomack County",3,34,353,180,173
050,51,001,"Virginia","Accomack County",3,35,345,172,173
050,51,001,"Virginia","Accomack County",3,36,319,152,167
050,51,001,"Virginia","Accomack County",3,37,328,154,174
050,51,001,"Virginia","Accomack County",3,38,338,158,180
050,51,001,"Virginia","Accomack County",3,39,343,169,174
050,51,001,"Virginia","Accomack County",3,40,352,181,171
050,51,001,"Virginia","Accomack County",3,41,372,191,181
050,51,001,"Virginia","Accomack County",3,42,349,165,184
050,51,001,"Virginia","Accomack County",3,43,335,168,167
050,51,001,"Virginia","Accomack County",3,44,315,154,161
050,51,001,"Virginia","Accomack County",3,45,325,152,173
050,51,001,"Virginia","Accomack County",3,46,337,160,177
050,51,001,"Virginia","Accomack County",3,47,348,161,187
050,51,001,"Virginia","Accomack County",3,48,344,173,171
050,51,001,"Virginia","Accomack County",3,49,381,197,184
050,51,001,"Virginia","Accomack County",3,50,421,215,206
050,51,001,"Virginia","Accomack County",3,51,393,192,201
050,51,001,"Virginia","Accomack County",3,52,387,192,195
050,51,001,"Virginia","Accomack County",3,53,420,211,209
050,51,001,"Virginia","Accomack County",3,54,418,198,220
050,51,001,"Virginia","Accomack County",3,55,441,203,238
050,51,001,"Virginia","Accomack County",3,56,480,220,260
050,51,001,"Virginia","Accomack County",3,57,491,232,259
050,51,001,"Virginia","Accomack County",3,58,470,219,251
050,51,001,"Virginia","Accomack County",3,59,491,237,254
050,51,001,"Virginia","Accomack County",3,60,532,259,273
050,51,001,"Virginia","Accomack County",3,61,543,257,286
050,51,001,"Virginia","Accomack County",3,62,546,255,291
050,51,001,"Virginia","Accomack County",3,63,578,281,297
050,51,001,"Virginia","Accomack County",3,64,611,301,310
050,51,001,"Virginia","Accomack County",3,65,614,288,326
050,51,001,"Virginia","Accomack County",3,66,586,281,305
050,51,001,"Virginia","Accomack County",3,67,583,281,302
050,51,001,"Virginia","Accomack County",3,68,547,252,295
050,51,001,"Virginia","Accomack County",3,69,499,237,262
050,51,001,"Virginia","Accomack County",3,70,481,231,250
050,51,001,"Virginia","Accomack County",3,71,446,214,232
050,51,001,"Virginia","Accomack County",3,72,441,205,236
050,51,001,"Virginia","Accomack County",3,73,428,211,217
050,51,001,"Virginia","Accomack County",3,74,454,216,238
050,51,001,"Virginia","Accomack County",3,75,344,147,197
050,51,001,"Virginia","Accomack County",3,76,331,147,184
050,51,001,"Virginia","Accomack County",3,77,325,155,170
050,51,001,"Virginia","Accomack County",3,78,300,141,159
050,51,001,"Virginia","Accomack County",3,79,255,113,142
050,51,001,"Virginia","Accomack County",3,80,224,97,127
050,51,001,"Virginia","Accomack County",3,81,200,95,105
050,51,001,"Virginia","Accomack County",3,82,193,88,105
050,51,001,"Virginia","Accomack County",3,83,172,75,97
050,51,001,"Virginia","Accomack County",3,84,133,69,64
050,51,001,"Virginia","Accomack County",3,85,836,342,494
050,51,001,"Virginia","Accomack County",4,0,353,162,191
050,51,001,"Virginia","Accomack County",4,1,329,155,174
050,51,001,"Virginia","Accomack County",4,2,348,176,172
050,51,001,"Virginia","Accomack County",4,3,336,173,163
050,51,001,"Virginia","Accomack County",4,4,365,184,181
050,51,001,"Virginia","Accomack County",4,5,355,196,159
050,51,001,"Virginia","Accomack County",4,6,373,201,172
050,51,001,"Virginia","Accomack County",4,7,348,187,161
050,51,001,"Virginia","Accomack County",4,8,359,189,170
050,51,001,"Virginia","Accomack County",4,9,346,178,168
050,51,001,"Virginia","Accomack County",4,10,400,212,188
050,51,001,"Virginia","Accomack County",4,11,432,228,204
050,51,001,"Virginia","Accomack County",4,12,390,198,192
050,51,001,"Virginia","Accomack County",4,13,411,209,202
050,51,001,"Virginia","Accomack County",4,14,429,224,205
050,51,001,"Virginia","Accomack County",4,15,421,207,214
050,51,001,"Virginia","Accomack County",4,16,389,201,188
050,51,001,"Virginia","Accomack County",4,17,418,222,196
050,51,001,"Virginia","Accomack County",4,18,355,209,146
050,51,001,"Virginia","Accomack County",4,19,293,161,132
050,51,001,"Virginia","Accomack County",4,20,311,165,146
050,51,001,"Virginia","Accomack County",4,21,344,174,170
050,51,001,"Virginia","Accomack County",4,22,341,182,159
050,51,001,"Virginia","Accomack County",4,23,307,166,141
050,51,001,"Virginia","Accomack County",4,24,310,179,131
050,51,001,"Virginia","Accomack County",4,25,334,188,146
050,51,001,"Virginia","Accomack County",4,26,295,154,141
050,51,001,"Virginia","Accomack County",4,27,309,167,142
050,51,001,"Virginia","Accomack County",4,28,301,154,147
050,51,001,"Virginia","Accomack County",4,29,343,176,167
050,51,001,"Virginia","Accomack County",4,30,378,187,191
050,51,001,"Virginia","Accomack County",4,31,382,180,202
050,51,001,"Virginia","Accomack County",4,32,364,163,201
050,51,001,"Virginia","Accomack County",4,33,348,165,183
050,51,001,"Virginia","Accomack County",4,34,340,179,161
050,51,001,"Virginia","Accomack County",4,35,357,186,171
050,51,001,"Virginia","Accomack County",4,36,341,163,178
050,51,001,"Virginia","Accomack County",4,37,318,150,168
050,51,001,"Virginia","Accomack County",4,38,320,156,164
050,51,001,"Virginia","Accomack County",4,39,332,158,174
050,51,001,"Virginia","Accomack County",4,40,337,164,173
050,51,001,"Virginia","Accomack County",4,41,325,165,160
050,51,001,"Virginia","Accomack County",4,42,359,175,184
050,51,001,"Virginia","Accomack County",4,43,360,178,182
050,51,001,"Virginia","Accomack County",4,44,326,163,163
050,51,001,"Virginia","Accomack County",4,45,314,147,167
050,51,001,"Virginia","Accomack County",4,46,323,150,173
050,51,001,"Virginia","Accomack County",4,47,337,162,175
050,51,001,"Virginia","Accomack County",4,48,351,162,189
050,51,001,"Virginia","Accomack County",4,49,347,171,176
050,51,001,"Virginia","Accomack County",4,50,390,198,192
050,51,001,"Virginia","Accomack County",4,51,427,219,208
050,51,001,"Virginia","Accomack County",4,52,395,187,208
050,51,001,"Virginia","Accomack County",4,53,394,201,193
050,51,001,"Virginia","Accomack County",4,54,421,210,211
050,51,001,"Virginia","Accomack County",4,55,422,194,228
050,51,001,"Virginia","Accomack County",4,56,442,203,239
050,51,001,"Virginia","Accomack County",4,57,481,223,258
050,51,001,"Virginia","Accomack County",4,58,489,229,260
050,51,001,"Virginia","Accomack County",4,59,477,227,250
050,51,001,"Virginia","Accomack County",4,60,500,248,252
050,51,001,"Virginia","Accomack County",4,61,549,270,279
050,51,001,"Virginia","Accomack County",4,62,537,252,285
050,51,001,"Virginia","Accomack County",4,63,554,255,299
050,51,001,"Virginia","Accomack County",4,64,605,299,306
050,51,001,"Virginia","Accomack County",4,65,616,293,323
050,51,001,"Virginia","Accomack County",4,66,613,288,325
050,51,001,"Virginia","Accomack County",4,67,582,284,298
050,51,001,"Virginia","Accomack County",4,68,583,283,300
050,51,001,"Virginia","Accomack County",4,69,544,254,290
050,51,001,"Virginia","Accomack County",4,70,491,235,256
050,51,001,"Virginia","Accomack County",4,71,471,231,240
050,51,001,"Virginia","Accomack County",4,72,436,203,233
050,51,001,"Virginia","Accomack County",4,73,427,200,227
050,51,001,"Virginia","Accomack County",4,74,406,198,208
050,51,001,"Virginia","Accomack County",4,75,449,213,236
050,51,001,"Virginia","Accomack County",4,76,335,141,194
050,51,001,"Virginia","Accomack County",4,77,322,142,180
050,51,001,"Virginia","Accomack County",4,78,308,148,160
050,51,001,"Virginia","Accomack County",4,79,292,140,152
050,51,001,"Virginia","Accomack County",4,80,232,104,128
050,51,001,"Virginia","Accomack County",4,81,213,86,127
050,51,001,"Virginia","Accomack County",4,82,185,85,100
050,51,001,"Virginia","Accomack County",4,83,177,78,99
050,51,001,"Virginia","Accomack County",4,84,144,62,82
050,51,001,"Virginia","Accomack County",4,85,810,343,467
050,51,001,"Virginia","Accomack County",5,0,355,166,189
050,51,001,"Virginia","Accomack County",5,1,353,160,193
050,51,001,"Virginia","Accomack County",5,2,330,159,171
050,51,001,"Virginia","Accomack County",5,3,335,168,167
050,51,001,"Virginia","Accomack County",5,4,335,173,162
050,51,001,"Virginia","Accomack County",5,5,356,171,185
050,51,001,"Virginia","Accomack County",5,6,348,189,159
050,51,001,"Virginia","Accomack County",5,7,370,198,172
050,51,001,"Virginia","Accomack County",5,8,360,194,166
050,51,001,"Virginia","Accomack County",5,9,345,182,163
050,51,001,"Virginia","Accomack County",5,10,360,189,171
050,51,001,"Virginia","Accomack County",5,11,392,207,185
050,51,001,"Virginia","Accomack County",5,12,446,244,202
050,51,001,"Virginia","Accomack County",5,13,386,195,191
050,51,001,"Virginia","Accomack County",5,14,406,206,200
050,51,001,"Virginia","Accomack County",5,15,439,231,208
050,51,001,"Virginia","Accomack County",5,16,416,211,205
050,51,001,"Virginia","Accomack County",5,17,420,220,200
050,51,001,"Virginia","Accomack County",5,18,379,214,165
050,51,001,"Virginia","Accomack County",5,19,305,187,118
050,51,001,"Virginia","Accomack County",5,20,305,170,135
050,51,001,"Virginia","Accomack County",5,21,320,170,150
050,51,001,"Virginia","Accomack County",5,22,359,182,177
050,51,001,"Virginia","Accomack County",5,23,329,172,157
050,51,001,"Virginia","Accomack County",5,24,301,160,141
050,51,001,"Virginia","Accomack County",5,25,325,188,137
050,51,001,"Virginia","Accomack County",5,26,311,179,132
050,51,001,"Virginia","Accomack County",5,27,292,155,137
050,51,001,"Virginia","Accomack County",5,28,293,155,138
050,51,001,"Virginia","Accomack County",5,29,319,170,149
050,51,001,"Virginia","Accomack County",5,30,339,172,167
050,51,001,"Virginia","Accomack County",5,31,375,189,186
050,51,001,"Virginia","Accomack County",5,32,368,176,192
050,51,001,"Virginia","Accomack County",5,33,361,168,193
050,51,001,"Virginia","Accomack County",5,34,349,172,177
050,51,001,"Virginia","Accomack County",5,35,343,175,168
050,51,001,"Virginia","Accomack County",5,36,372,194,178
050,51,001,"Virginia","Accomack County",5,37,334,156,178
050,51,001,"Virginia","Accomack County",5,38,313,145,168
050,51,001,"Virginia","Accomack County",5,39,330,159,171
050,51,001,"Virginia","Accomack County",5,40,327,155,172
050,51,001,"Virginia","Accomack County",5,41,335,166,169
050,51,001,"Virginia","Accomack County",5,42,335,172,163
050,51,001,"Virginia","Accomack County",5,43,376,187,189
050,51,001,"Virginia","Accomack County",5,44,359,169,190
050,51,001,"Virginia","Accomack County",5,45,323,157,166
050,51,001,"Virginia","Accomack County",5,46,315,149,166
050,51,001,"Virginia","Accomack County",5,47,318,146,172
050,51,001,"Virginia","Accomack County",5,48,336,159,177
050,51,001,"Virginia","Accomack County",5,49,352,170,182
050,51,001,"Virginia","Accomack County",5,50,361,183,178
050,51,001,"Virginia","Accomack County",5,51,396,198,198
050,51,001,"Virginia","Accomack County",5,52,417,207,210
050,51,001,"Virginia","Accomack County",5,53,407,198,209
050,51,001,"Virginia","Accomack County",5,54,399,201,198
050,51,001,"Virginia","Accomack County",5,55,422,206,216
050,51,001,"Virginia","Accomack County",5,56,418,192,226
050,51,001,"Virginia","Accomack County",5,57,452,205,247
050,51,001,"Virginia","Accomack County",5,58,491,224,267
050,51,001,"Virginia","Accomack County",5,59,499,232,267
050,51,001,"Virginia","Accomack County",5,60,477,220,257
050,51,001,"Virginia","Accomack County",5,61,500,247,253
050,51,001,"Virginia","Accomack County",5,62,544,267,277
050,51,001,"Virginia","Accomack County",5,63,551,252,299
050,51,001,"Virginia","Accomack County",5,64,561,264,297
050,51,001,"Virginia","Accomack County",5,65,613,303,310
050,51,001,"Virginia","Accomack County",5,66,626,292,334
050,51,001,"Virginia","Accomack County",5,67,600,284,316
050,51,001,"Virginia","Accomack County",5,68,587,288,299
050,51,001,"Virginia","Accomack County",5,69,580,278,302
050,51,001,"Virginia","Accomack County",5,70,535,251,284
050,51,001,"Virginia","Accomack County",5,71,488,236,252
050,51,001,"Virginia","Accomack County",5,72,458,224,234
050,51,001,"Virginia","Accomack County",5,73,423,197,226
050,51,001,"Virginia","Accomack County",5,74,404,187,217
050,51,001,"Virginia","Accomack County",5,75,407,199,208
050,51,001,"Virginia","Accomack County",5,76,444,206,238
050,51,001,"Virginia","Accomack County",5,77,320,135,185
050,51,001,"Virginia","Accomack County",5,78,307,136,171
050,51,001,"Virginia","Accomack County",5,79,302,149,153
050,51,001,"Virginia","Accomack County",5,80,272,133,139
050,51,001,"Virginia","Accomack County",5,81,213,91,122
050,51,001,"Virginia","Accomack County",5,82,193,72,121
050,51,001,"Virginia","Accomack County",5,83,170,79,91
050,51,001,"Virginia","Accomack County",5,84,147,64,83
050,51,001,"Virginia","Accomack County",5,85,805,341,464
050,51,003,"Virginia","Albemarle County",1,0,1127,571,556
050,51,003,"Virginia","Albemarle County",1,1,1163,591,572
050,51,003,"Virginia","Albemarle County",1,2,1197,610,587
050,51,003,"Virginia","Albemarle County",1,3,1191,602,589
050,51,003,"Virginia","Albemarle County",1,4,1243,618,625
050,51,003,"Virginia","Albemarle County",1,5,1321,668,653
050,51,003,"Virginia","Albemarle County",1,6,1278,649,629
050,51,003,"Virginia","Albemarle County",1,7,1197,621,576
050,51,003,"Virginia","Albemarle County",1,8,1233,623,610
050,51,003,"Virginia","Albemarle County",1,9,1249,659,590
050,51,003,"Virginia","Albemarle County",1,10,1325,685,640
050,51,003,"Virginia","Albemarle County",1,11,1331,707,624
050,51,003,"Virginia","Albemarle County",1,12,1352,677,675
050,51,003,"Virginia","Albemarle County",1,13,1308,654,654
050,51,003,"Virginia","Albemarle County",1,14,1247,659,588
050,51,003,"Virginia","Albemarle County",1,15,1295,664,631
050,51,003,"Virginia","Albemarle County",1,16,1315,672,643
050,51,003,"Virginia","Albemarle County",1,17,1343,673,670
050,51,003,"Virginia","Albemarle County",1,18,2535,1147,1388
050,51,003,"Virginia","Albemarle County",1,19,3310,1548,1762
050,51,003,"Virginia","Albemarle County",1,20,1956,982,974
050,51,003,"Virginia","Albemarle County",1,21,1485,741,744
050,51,003,"Virginia","Albemarle County",1,22,1404,710,694
050,51,003,"Virginia","Albemarle County",1,23,1224,596,628
050,51,003,"Virginia","Albemarle County",1,24,1286,596,690
050,51,003,"Virginia","Albemarle County",1,25,1352,640,712
050,51,003,"Virginia","Albemarle County",1,26,1401,660,741
050,51,003,"Virginia","Albemarle County",1,27,1465,682,783
050,51,003,"Virginia","Albemarle County",1,28,1450,683,767
050,51,003,"Virginia","Albemarle County",1,29,1487,732,755
050,51,003,"Virginia","Albemarle County",1,30,1419,702,717
050,51,003,"Virginia","Albemarle County",1,31,1392,721,671
050,51,003,"Virginia","Albemarle County",1,32,1451,720,731
050,51,003,"Virginia","Albemarle County",1,33,1428,689,739
050,51,003,"Virginia","Albemarle County",1,34,1445,707,738
050,51,003,"Virginia","Albemarle County",1,35,1451,746,705
050,51,003,"Virginia","Albemarle County",1,36,1435,701,734
050,51,003,"Virginia","Albemarle County",1,37,1450,736,714
050,51,003,"Virginia","Albemarle County",1,38,1428,737,691
050,51,003,"Virginia","Albemarle County",1,39,1419,709,710
050,51,003,"Virginia","Albemarle County",1,40,1343,648,695
050,51,003,"Virginia","Albemarle County",1,41,1264,650,614
050,51,003,"Virginia","Albemarle County",1,42,1313,634,679
050,51,003,"Virginia","Albemarle County",1,43,1312,663,649
050,51,003,"Virginia","Albemarle County",1,44,1200,605,595
050,51,003,"Virginia","Albemarle County",1,45,1171,587,584
050,51,003,"Virginia","Albemarle County",1,46,1146,572,574
050,51,003,"Virginia","Albemarle County",1,47,1178,592,586
050,51,003,"Virginia","Albemarle County",1,48,1280,629,651
050,51,003,"Virginia","Albemarle County",1,49,1362,678,684
050,51,003,"Virginia","Albemarle County",1,50,1341,670,671
050,51,003,"Virginia","Albemarle County",1,51,1340,634,706
050,51,003,"Virginia","Albemarle County",1,52,1255,616,639
050,51,003,"Virginia","Albemarle County",1,53,1339,650,689
050,51,003,"Virginia","Albemarle County",1,54,1329,646,683
050,51,003,"Virginia","Albemarle County",1,55,1313,624,689
050,51,003,"Virginia","Albemarle County",1,56,1406,656,750
050,51,003,"Virginia","Albemarle County",1,57,1399,644,755
050,51,003,"Virginia","Albemarle County",1,58,1454,666,788
050,51,003,"Virginia","Albemarle County",1,59,1468,693,775
050,51,003,"Virginia","Albemarle County",1,60,1435,678,757
050,51,003,"Virginia","Albemarle County",1,61,1498,705,793
050,51,003,"Virginia","Albemarle County",1,62,1494,682,812
050,51,003,"Virginia","Albemarle County",1,63,1475,662,813
050,51,003,"Virginia","Albemarle County",1,64,1433,668,765
050,51,003,"Virginia","Albemarle County",1,65,1401,643,758
050,51,003,"Virginia","Albemarle County",1,66,1383,638,745
050,51,003,"Virginia","Albemarle County",1,67,1371,641,730
050,51,003,"Virginia","Albemarle County",1,68,1375,637,738
050,51,003,"Virginia","Albemarle County",1,69,1234,569,665
050,51,003,"Virginia","Albemarle County",1,70,1218,561,657
050,51,003,"Virginia","Albemarle County",1,71,1189,533,656
050,51,003,"Virginia","Albemarle County",1,72,1161,536,625
050,51,003,"Virginia","Albemarle County",1,73,1165,538,627
050,51,003,"Virginia","Albemarle County",1,74,817,383,434
050,51,003,"Virginia","Albemarle County",1,75,804,358,446
050,51,003,"Virginia","Albemarle County",1,76,804,376,428
050,51,003,"Virginia","Albemarle County",1,77,811,356,455
050,51,003,"Virginia","Albemarle County",1,78,677,293,384
050,51,003,"Virginia","Albemarle County",1,79,655,293,362
050,51,003,"Virginia","Albemarle County",1,80,581,266,315
050,51,003,"Virginia","Albemarle County",1,81,548,234,314
050,51,003,"Virginia","Albemarle County",1,82,532,228,304
050,51,003,"Virginia","Albemarle County",1,83,468,191,277
050,51,003,"Virginia","Albemarle County",1,84,445,180,265
050,51,003,"Virginia","Albemarle County",1,85,2820,978,1842
050,51,003,"Virginia","Albemarle County",2,0,1053,525,528
050,51,003,"Virginia","Albemarle County",2,1,1154,583,571
050,51,003,"Virginia","Albemarle County",2,2,1188,604,584
050,51,003,"Virginia","Albemarle County",2,3,1190,600,590
050,51,003,"Virginia","Albemarle County",2,4,1240,618,622
050,51,003,"Virginia","Albemarle County",2,5,1308,659,649
050,51,003,"Virginia","Albemarle County",2,6,1295,658,637
050,51,003,"Virginia","Albemarle County",2,7,1217,627,590
050,51,003,"Virginia","Albemarle County",2,8,1220,621,599
050,51,003,"Virginia","Albemarle County",2,9,1250,653,597
050,51,003,"Virginia","Albemarle County",2,10,1305,678,627
050,51,003,"Virginia","Albemarle County",2,11,1322,699,623
050,51,003,"Virginia","Albemarle County",2,12,1356,690,666
050,51,003,"Virginia","Albemarle County",2,13,1319,661,658
050,51,003,"Virginia","Albemarle County",2,14,1263,658,605
050,51,003,"Virginia","Albemarle County",2,15,1289,666,623
050,51,003,"Virginia","Albemarle County",2,16,1313,673,640
050,51,003,"Virginia","Albemarle County",2,17,1345,677,668
050,51,003,"Virginia","Albemarle County",2,18,2529,1138,1391
050,51,003,"Virginia","Albemarle County",2,19,3303,1545,1758
050,51,003,"Virginia","Albemarle County",2,20,1977,990,987
050,51,003,"Virginia","Albemarle County",2,21,1488,742,746
050,51,003,"Virginia","Albemarle County",2,22,1390,701,689
050,51,003,"Virginia","Albemarle County",2,23,1248,611,637
050,51,003,"Virginia","Albemarle County",2,24,1280,604,676
050,51,003,"Virginia","Albemarle County",2,25,1342,632,710
050,51,003,"Virginia","Albemarle County",2,26,1403,659,744
050,51,003,"Virginia","Albemarle County",2,27,1448,681,767
050,51,003,"Virginia","Albemarle County",2,28,1448,687,761
050,51,003,"Virginia","Albemarle County",2,29,1470,719,751
050,51,003,"Virginia","Albemarle County",2,30,1439,711,728
050,51,003,"Virginia","Albemarle County",2,31,1387,706,681
050,51,003,"Virginia","Albemarle County",2,32,1430,715,715
050,51,003,"Virginia","Albemarle County",2,33,1433,696,737
050,51,003,"Virginia","Albemarle County",2,34,1443,701,742
050,51,003,"Virginia","Albemarle County",2,35,1462,735,727
050,51,003,"Virginia","Albemarle County",2,36,1436,714,722
050,51,003,"Virginia","Albemarle County",2,37,1453,735,718
050,51,003,"Virginia","Albemarle County",2,38,1446,745,701
050,51,003,"Virginia","Albemarle County",2,39,1420,712,708
050,51,003,"Virginia","Albemarle County",2,40,1369,670,699
050,51,003,"Virginia","Albemarle County",2,41,1284,648,636
050,51,003,"Virginia","Albemarle County",2,42,1295,638,657
050,51,003,"Virginia","Albemarle County",2,43,1314,655,659
050,51,003,"Virginia","Albemarle County",2,44,1218,614,604
050,51,003,"Virginia","Albemarle County",2,45,1184,592,592
050,51,003,"Virginia","Albemarle County",2,46,1150,573,577
050,51,003,"Virginia","Albemarle County",2,47,1170,584,586
050,51,003,"Virginia","Albemarle County",2,48,1254,619,635
050,51,003,"Virginia","Albemarle County",2,49,1352,672,680
050,51,003,"Virginia","Albemarle County",2,50,1339,668,671
050,51,003,"Virginia","Albemarle County",2,51,1334,642,692
050,51,003,"Virginia","Albemarle County",2,52,1279,622,657
050,51,003,"Virginia","Albemarle County",2,53,1312,640,672
050,51,003,"Virginia","Albemarle County",2,54,1327,644,683
050,51,003,"Virginia","Albemarle County",2,55,1316,628,688
050,51,003,"Virginia","Albemarle County",2,56,1385,650,735
050,51,003,"Virginia","Albemarle County",2,57,1410,650,760
050,51,003,"Virginia","Albemarle County",2,58,1439,660,779
050,51,003,"Virginia","Albemarle County",2,59,1462,680,782
050,51,003,"Virginia","Albemarle County",2,60,1443,684,759
050,51,003,"Virginia","Albemarle County",2,61,1473,695,778
050,51,003,"Virginia","Albemarle County",2,62,1489,683,806
050,51,003,"Virginia","Albemarle County",2,63,1491,672,819
050,51,003,"Virginia","Albemarle County",2,64,1440,665,775
050,51,003,"Virginia","Albemarle County",2,65,1412,650,762
050,51,003,"Virginia","Albemarle County",2,66,1389,642,747
050,51,003,"Virginia","Albemarle County",2,67,1370,639,731
050,51,003,"Virginia","Albemarle County",2,68,1371,634,737
050,51,003,"Virginia","Albemarle County",2,69,1283,594,689
050,51,003,"Virginia","Albemarle County",2,70,1222,560,662
050,51,003,"Virginia","Albemarle County",2,71,1190,535,655
050,51,003,"Virginia","Albemarle County",2,72,1154,529,625
050,51,003,"Virginia","Albemarle County",2,73,1222,567,655
050,51,003,"Virginia","Albemarle County",2,74,849,392,457
050,51,003,"Virginia","Albemarle County",2,75,813,367,446
050,51,003,"Virginia","Albemarle County",2,76,793,366,427
050,51,003,"Virginia","Albemarle County",2,77,825,366,459
050,51,003,"Virginia","Albemarle County",2,78,694,300,394
050,51,003,"Virginia","Albemarle County",2,79,661,294,367
050,51,003,"Virginia","Albemarle County",2,80,596,274,322
050,51,003,"Virginia","Albemarle County",2,81,549,239,310
050,51,003,"Virginia","Albemarle County",2,82,539,227,312
050,51,003,"Virginia","Albemarle County",2,83,471,192,279
050,51,003,"Virginia","Albemarle County",2,84,450,180,270
050,51,003,"Virginia","Albemarle County",2,85,2826,978,1848
050,51,003,"Virginia","Albemarle County",3,0,1031,536,495
050,51,003,"Virginia","Albemarle County",3,1,1126,557,569
050,51,003,"Virginia","Albemarle County",3,2,1146,558,588
050,51,003,"Virginia","Albemarle County",3,3,1195,617,578
050,51,003,"Virginia","Albemarle County",3,4,1227,620,607
050,51,003,"Virginia","Albemarle County",3,5,1255,649,606
050,51,003,"Virginia","Albemarle County",3,6,1340,688,652
050,51,003,"Virginia","Albemarle County",3,7,1287,657,630
050,51,003,"Virginia","Albemarle County",3,8,1206,623,583
050,51,003,"Virginia","Albemarle County",3,9,1232,627,605
050,51,003,"Virginia","Albemarle County",3,10,1274,666,608
050,51,003,"Virginia","Albemarle County",3,11,1286,677,609
050,51,003,"Virginia","Albemarle County",3,12,1316,694,622
050,51,003,"Virginia","Albemarle County",3,13,1342,683,659
050,51,003,"Virginia","Albemarle County",3,14,1348,678,670
050,51,003,"Virginia","Albemarle County",3,15,1278,678,600
050,51,003,"Virginia","Albemarle County",3,16,1302,673,629
050,51,003,"Virginia","Albemarle County",3,17,1330,687,643
050,51,003,"Virginia","Albemarle County",3,18,2590,1157,1433
050,51,003,"Virginia","Albemarle County",3,19,3334,1564,1770
050,51,003,"Virginia","Albemarle County",3,20,1999,1002,997
050,51,003,"Virginia","Albemarle County",3,21,1504,738,766
050,51,003,"Virginia","Albemarle County",3,22,1356,660,696
050,51,003,"Virginia","Albemarle County",3,23,1304,638,666
050,51,003,"Virginia","Albemarle County",3,24,1365,684,681
050,51,003,"Virginia","Albemarle County",3,25,1319,614,705
050,51,003,"Virginia","Albemarle County",3,26,1327,626,701
050,51,003,"Virginia","Albemarle County",3,27,1528,731,797
050,51,003,"Virginia","Albemarle County",3,28,1465,718,747
050,51,003,"Virginia","Albemarle County",3,29,1501,739,762
050,51,003,"Virginia","Albemarle County",3,30,1484,720,764
050,51,003,"Virginia","Albemarle County",3,31,1455,712,743
050,51,003,"Virginia","Albemarle County",3,32,1397,720,677
050,51,003,"Virginia","Albemarle County",3,33,1449,713,736
050,51,003,"Virginia","Albemarle County",3,34,1474,700,774
050,51,003,"Virginia","Albemarle County",3,35,1482,704,778
050,51,003,"Virginia","Albemarle County",3,36,1519,770,749
050,51,003,"Virginia","Albemarle County",3,37,1437,720,717
050,51,003,"Virginia","Albemarle County",3,38,1499,738,761
050,51,003,"Virginia","Albemarle County",3,39,1416,729,687
050,51,003,"Virginia","Albemarle County",3,40,1453,718,735
050,51,003,"Virginia","Albemarle County",3,41,1374,678,696
050,51,003,"Virginia","Albemarle County",3,42,1310,657,653
050,51,003,"Virginia","Albemarle County",3,43,1287,616,671
050,51,003,"Virginia","Albemarle County",3,44,1310,654,656
050,51,003,"Virginia","Albemarle County",3,45,1231,622,609
050,51,003,"Virginia","Albemarle County",3,46,1185,584,601
050,51,003,"Virginia","Albemarle County",3,47,1166,579,587
050,51,003,"Virginia","Albemarle County",3,48,1177,582,595
050,51,003,"Virginia","Albemarle County",3,49,1263,624,639
050,51,003,"Virginia","Albemarle County",3,50,1367,680,687
050,51,003,"Virginia","Albemarle County",3,51,1358,680,678
050,51,003,"Virginia","Albemarle County",3,52,1332,648,684
050,51,003,"Virginia","Albemarle County",3,53,1280,629,651
050,51,003,"Virginia","Albemarle County",3,54,1316,636,680
050,51,003,"Virginia","Albemarle County",3,55,1328,638,690
050,51,003,"Virginia","Albemarle County",3,56,1305,623,682
050,51,003,"Virginia","Albemarle County",3,57,1384,648,736
050,51,003,"Virginia","Albemarle County",3,58,1419,655,764
050,51,003,"Virginia","Albemarle County",3,59,1431,641,790
050,51,003,"Virginia","Albemarle County",3,60,1469,679,790
050,51,003,"Virginia","Albemarle County",3,61,1455,691,764
050,51,003,"Virginia","Albemarle County",3,62,1433,675,758
050,51,003,"Virginia","Albemarle County",3,63,1478,682,796
050,51,003,"Virginia","Albemarle County",3,64,1508,666,842
050,51,003,"Virginia","Albemarle County",3,65,1428,653,775
050,51,003,"Virginia","Albemarle County",3,66,1419,667,752
050,51,003,"Virginia","Albemarle County",3,67,1383,635,748
050,51,003,"Virginia","Albemarle County",3,68,1376,630,746
050,51,003,"Virginia","Albemarle County",3,69,1349,628,721
050,51,003,"Virginia","Albemarle County",3,70,1261,574,687
050,51,003,"Virginia","Albemarle County",3,71,1188,538,650
050,51,003,"Virginia","Albemarle County",3,72,1178,531,647
050,51,003,"Virginia","Albemarle County",3,73,1149,526,623
050,51,003,"Virginia","Albemarle County",3,74,1231,566,665
050,51,003,"Virginia","Albemarle County",3,75,857,387,470
050,51,003,"Virginia","Albemarle County",3,76,798,355,443
050,51,003,"Virginia","Albemarle County",3,77,797,365,432
050,51,003,"Virginia","Albemarle County",3,78,797,348,449
050,51,003,"Virginia","Albemarle County",3,79,700,300,400
050,51,003,"Virginia","Albemarle County",3,80,641,297,344
050,51,003,"Virginia","Albemarle County",3,81,564,248,316
050,51,003,"Virginia","Albemarle County",3,82,544,222,322
050,51,003,"Virginia","Albemarle County",3,83,513,225,288
050,51,003,"Virginia","Albemarle County",3,84,463,182,281
050,51,003,"Virginia","Albemarle County",3,85,2902,1016,1886
050,51,003,"Virginia","Albemarle County",4,0,1034,510,524
050,51,003,"Virginia","Albemarle County",4,1,1032,509,523
050,51,003,"Virginia","Albemarle County",4,2,1170,583,587
050,51,003,"Virginia","Albemarle County",4,3,1163,559,604
050,51,003,"Virginia","Albemarle County",4,4,1222,634,588
050,51,003,"Virginia","Albemarle County",4,5,1237,629,608
050,51,003,"Virginia","Albemarle County",4,6,1273,653,620
050,51,003,"Virginia","Albemarle County",4,7,1353,697,656
050,51,003,"Virginia","Albemarle County",4,8,1287,645,642
050,51,003,"Virginia","Albemarle County",4,9,1245,643,602
050,51,003,"Virginia","Albemarle County",4,10,1207,612,595
050,51,003,"Virginia","Albemarle County",4,11,1279,664,615
050,51,003,"Virginia","Albemarle County",4,12,1281,681,600
050,51,003,"Virginia","Albemarle County",4,13,1295,685,610
050,51,003,"Virginia","Albemarle County",4,14,1368,698,670
050,51,003,"Virginia","Albemarle County",4,15,1335,672,663
050,51,003,"Virginia","Albemarle County",4,16,1284,682,602
050,51,003,"Virginia","Albemarle County",4,17,1351,690,661
050,51,003,"Virginia","Albemarle County",4,18,2541,1157,1384
050,51,003,"Virginia","Albemarle County",4,19,3269,1521,1748
050,51,003,"Virginia","Albemarle County",4,20,1979,1004,975
050,51,003,"Virginia","Albemarle County",4,21,1514,755,759
050,51,003,"Virginia","Albemarle County",4,22,1390,675,715
050,51,003,"Virginia","Albemarle County",4,23,1265,596,669
050,51,003,"Virginia","Albemarle County",4,24,1341,656,685
050,51,003,"Virginia","Albemarle County",4,25,1376,679,697
050,51,003,"Virginia","Albemarle County",4,26,1342,640,702
050,51,003,"Virginia","Albemarle County",4,27,1350,649,701
050,51,003,"Virginia","Albemarle County",4,28,1508,739,769
050,51,003,"Virginia","Albemarle County",4,29,1453,717,736
050,51,003,"Virginia","Albemarle County",4,30,1475,727,748
050,51,003,"Virginia","Albemarle County",4,31,1459,700,759
050,51,003,"Virginia","Albemarle County",4,32,1485,722,763
050,51,003,"Virginia","Albemarle County",4,33,1426,726,700
050,51,003,"Virginia","Albemarle County",4,34,1493,735,758
050,51,003,"Virginia","Albemarle County",4,35,1525,745,780
050,51,003,"Virginia","Albemarle County",4,36,1503,714,789
050,51,003,"Virginia","Albemarle County",4,37,1516,749,767
050,51,003,"Virginia","Albemarle County",4,38,1484,751,733
050,51,003,"Virginia","Albemarle County",4,39,1505,746,759
050,51,003,"Virginia","Albemarle County",4,40,1430,731,699
050,51,003,"Virginia","Albemarle County",4,41,1465,723,742
050,51,003,"Virginia","Albemarle County",4,42,1395,691,704
050,51,003,"Virginia","Albemarle County",4,43,1320,656,664
050,51,003,"Virginia","Albemarle County",4,44,1273,609,664
050,51,003,"Virginia","Albemarle County",4,45,1283,635,648
050,51,003,"Virginia","Albemarle County",4,46,1235,608,627
050,51,003,"Virginia","Albemarle County",4,47,1177,568,609
050,51,003,"Virginia","Albemarle County",4,48,1166,571,595
050,51,003,"Virginia","Albemarle County",4,49,1181,584,597
050,51,003,"Virginia","Albemarle County",4,50,1250,628,622
050,51,003,"Virginia","Albemarle County",4,51,1356,686,670
050,51,003,"Virginia","Albemarle County",4,52,1398,693,705
050,51,003,"Virginia","Albemarle County",4,53,1325,659,666
050,51,003,"Virginia","Albemarle County",4,54,1269,630,639
050,51,003,"Virginia","Albemarle County",4,55,1334,645,689
050,51,003,"Virginia","Albemarle County",4,56,1331,629,702
050,51,003,"Virginia","Albemarle County",4,57,1301,618,683
050,51,003,"Virginia","Albemarle County",4,58,1405,658,747
050,51,003,"Virginia","Albemarle County",4,59,1419,652,767
050,51,003,"Virginia","Albemarle County",4,60,1424,638,786
050,51,003,"Virginia","Albemarle County",4,61,1480,679,801
050,51,003,"Virginia","Albemarle County",4,62,1483,696,787
050,51,003,"Virginia","Albemarle County",4,63,1452,685,767
050,51,003,"Virginia","Albemarle County",4,64,1491,681,810
050,51,003,"Virginia","Albemarle County",4,65,1512,667,845
050,51,003,"Virginia","Albemarle County",4,66,1448,689,759
050,51,003,"Virginia","Albemarle County",4,67,1427,662,765
050,51,003,"Virginia","Albemarle County",4,68,1385,621,764
050,51,003,"Virginia","Albemarle County",4,69,1361,635,726
050,51,003,"Virginia","Albemarle County",4,70,1338,612,726
050,51,003,"Virginia","Albemarle County",4,71,1238,561,677
050,51,003,"Virginia","Albemarle County",4,72,1192,543,649
050,51,003,"Virginia","Albemarle County",4,73,1175,536,639
050,51,003,"Virginia","Albemarle County",4,74,1157,528,629
050,51,003,"Virginia","Albemarle County",4,75,1235,564,671
050,51,003,"Virginia","Albemarle County",4,76,837,373,464
050,51,003,"Virginia","Albemarle County",4,77,799,357,442
050,51,003,"Virginia","Albemarle County",4,78,772,348,424
050,51,003,"Virginia","Albemarle County",4,79,812,349,463
050,51,003,"Virginia","Albemarle County",4,80,686,304,382
050,51,003,"Virginia","Albemarle County",4,81,602,264,338
050,51,003,"Virginia","Albemarle County",4,82,574,237,337
050,51,003,"Virginia","Albemarle County",4,83,520,219,301
050,51,003,"Virginia","Albemarle County",4,84,503,213,290
050,51,003,"Virginia","Albemarle County",4,85,3014,1091,1923
050,51,003,"Virginia","Albemarle County",5,0,1032,507,525
050,51,003,"Virginia","Albemarle County",5,1,1060,540,520
050,51,003,"Virginia","Albemarle County",5,2,1040,506,534
050,51,003,"Virginia","Albemarle County",5,3,1203,613,590
050,51,003,"Virginia","Albemarle County",5,4,1185,553,632
050,51,003,"Virginia","Albemarle County",5,5,1200,623,577
050,51,003,"Virginia","Albemarle County",5,6,1254,646,608
050,51,003,"Virginia","Albemarle County",5,7,1283,667,616
050,51,003,"Virginia","Albemarle County",5,8,1336,682,654
050,51,003,"Virginia","Albemarle County",5,9,1298,640,658
050,51,003,"Virginia","Albemarle County",5,10,1210,625,585
050,51,003,"Virginia","Albemarle County",5,11,1184,609,575
050,51,003,"Virginia","Albemarle County",5,12,1260,652,608
050,51,003,"Virginia","Albemarle County",5,13,1261,676,585
050,51,003,"Virginia","Albemarle County",5,14,1276,669,607
050,51,003,"Virginia","Albemarle County",5,15,1362,703,659
050,51,003,"Virginia","Albemarle County",5,16,1332,662,670
050,51,003,"Virginia","Albemarle County",5,17,1318,705,613
050,51,003,"Virginia","Albemarle County",5,18,2538,1149,1389
050,51,003,"Virginia","Albemarle County",5,19,3282,1543,1739
050,51,003,"Virginia","Albemarle County",5,20,1980,992,988
050,51,003,"Virginia","Albemarle County",5,21,1548,776,772
050,51,003,"Virginia","Albemarle County",5,22,1419,692,727
050,51,003,"Virginia","Albemarle County",5,23,1257,593,664
050,51,003,"Virginia","Albemarle County",5,24,1280,612,668
050,51,003,"Virginia","Albemarle County",5,25,1433,697,736
050,51,003,"Virginia","Albemarle County",5,26,1379,683,696
050,51,003,"Virginia","Albemarle County",5,27,1371,676,695
050,51,003,"Virginia","Albemarle County",5,28,1340,651,689
050,51,003,"Virginia","Albemarle County",5,29,1509,750,759
050,51,003,"Virginia","Albemarle County",5,30,1435,691,744
050,51,003,"Virginia","Albemarle County",5,31,1414,685,729
050,51,003,"Virginia","Albemarle County",5,32,1480,709,771
050,51,003,"Virginia","Albemarle County",5,33,1532,769,763
050,51,003,"Virginia","Albemarle County",5,34,1487,758,729
050,51,003,"Virginia","Albemarle County",5,35,1543,750,793
050,51,003,"Virginia","Albemarle County",5,36,1540,754,786
050,51,003,"Virginia","Albemarle County",5,37,1511,719,792
050,51,003,"Virginia","Albemarle County",5,38,1505,748,757
050,51,003,"Virginia","Albemarle County",5,39,1462,743,719
050,51,003,"Virginia","Albemarle County",5,40,1511,741,770
050,51,003,"Virginia","Albemarle County",5,41,1438,725,713
050,51,003,"Virginia","Albemarle County",5,42,1473,727,746
050,51,003,"Virginia","Albemarle County",5,43,1400,686,714
050,51,003,"Virginia","Albemarle County",5,44,1306,656,650
050,51,003,"Virginia","Albemarle County",5,45,1271,603,668
050,51,003,"Virginia","Albemarle County",5,46,1282,637,645
050,51,003,"Virginia","Albemarle County",5,47,1247,611,636
050,51,003,"Virginia","Albemarle County",5,48,1190,572,618
050,51,003,"Virginia","Albemarle County",5,49,1167,574,593
050,51,003,"Virginia","Albemarle County",5,50,1182,583,599
050,51,003,"Virginia","Albemarle County",5,51,1264,634,630
050,51,003,"Virginia","Albemarle County",5,52,1374,696,678
050,51,003,"Virginia","Albemarle County",5,53,1382,682,700
050,51,003,"Virginia","Albemarle County",5,54,1333,667,666
050,51,003,"Virginia","Albemarle County",5,55,1286,636,650
050,51,003,"Virginia","Albemarle County",5,56,1338,640,698
050,51,003,"Virginia","Albemarle County",5,57,1330,620,710
050,51,003,"Virginia","Albemarle County",5,58,1310,627,683
050,51,003,"Virginia","Albemarle County",5,59,1390,642,748
050,51,003,"Virginia","Albemarle County",5,60,1436,657,779
050,51,003,"Virginia","Albemarle County",5,61,1434,639,795
050,51,003,"Virginia","Albemarle County",5,62,1443,657,786
050,51,003,"Virginia","Albemarle County",5,63,1481,694,787
050,51,003,"Virginia","Albemarle County",5,64,1467,696,771
050,51,003,"Virginia","Albemarle County",5,65,1520,689,831
050,51,003,"Virginia","Albemarle County",5,66,1518,677,841
050,51,003,"Virginia","Albemarle County",5,67,1435,672,763
050,51,003,"Virginia","Albemarle County",5,68,1447,663,784
050,51,003,"Virginia","Albemarle County",5,69,1372,634,738
050,51,003,"Virginia","Albemarle County",5,70,1388,644,744
050,51,003,"Virginia","Albemarle County",5,71,1322,598,724
050,51,003,"Virginia","Albemarle County",5,72,1234,559,675
050,51,003,"Virginia","Albemarle County",5,73,1187,538,649
050,51,003,"Virginia","Albemarle County",5,74,1178,532,646
050,51,003,"Virginia","Albemarle County",5,75,1158,528,630
050,51,003,"Virginia","Albemarle County",5,76,1221,559,662
050,51,003,"Virginia","Albemarle County",5,77,840,374,466
050,51,003,"Virginia","Albemarle County",5,78,770,336,434
050,51,003,"Virginia","Albemarle County",5,79,766,345,421
050,51,003,"Virginia","Albemarle County",5,80,792,342,450
050,51,003,"Virginia","Albemarle County",5,81,654,280,374
050,51,003,"Virginia","Albemarle County",5,82,600,249,351
050,51,003,"Virginia","Albemarle County",5,83,542,232,310
050,51,003,"Virginia","Albemarle County",5,84,506,205,301
050,51,003,"Virginia","Albemarle County",5,85,3152,1172,1980
050,51,005,"Virginia","Alleghany County",1,0,120,60,60
050,51,005,"Virginia","Alleghany County",1,1,126,63,63
050,51,005,"Virginia","Alleghany County",1,2,146,72,74
050,51,005,"Virginia","Alleghany County",1,3,135,66,69
050,51,005,"Virginia","Alleghany County",1,4,148,73,75
050,51,005,"Virginia","Alleghany County",1,5,144,72,72
050,51,005,"Virginia","Alleghany County",1,6,136,70,66
050,51,005,"Virginia","Alleghany County",1,7,161,82,79
050,51,005,"Virginia","Alleghany County",1,8,158,84,74
050,51,005,"Virginia","Alleghany County",1,9,151,84,67
050,51,005,"Virginia","Alleghany County",1,10,162,83,79
050,51,005,"Virginia","Alleghany County",1,11,162,81,81
050,51,005,"Virginia","Alleghany County",1,12,160,85,75
050,51,005,"Virginia","Alleghany County",1,13,167,97,70
050,51,005,"Virginia","Alleghany County",1,14,196,112,84
050,51,005,"Virginia","Alleghany County",1,15,199,106,93
050,51,005,"Virginia","Alleghany County",1,16,186,109,77
050,51,005,"Virginia","Alleghany County",1,17,182,97,85
050,51,005,"Virginia","Alleghany County",1,18,160,76,84
050,51,005,"Virginia","Alleghany County",1,19,142,73,69
050,51,005,"Virginia","Alleghany County",1,20,141,71,70
050,51,005,"Virginia","Alleghany County",1,21,161,81,80
050,51,005,"Virginia","Alleghany County",1,22,163,93,70
050,51,005,"Virginia","Alleghany County",1,23,169,91,78
050,51,005,"Virginia","Alleghany County",1,24,151,79,72
050,51,005,"Virginia","Alleghany County",1,25,171,84,87
050,51,005,"Virginia","Alleghany County",1,26,167,83,84
050,51,005,"Virginia","Alleghany County",1,27,148,73,75
050,51,005,"Virginia","Alleghany County",1,28,158,77,81
050,51,005,"Virginia","Alleghany County",1,29,169,83,86
050,51,005,"Virginia","Alleghany County",1,30,165,85,80
050,51,005,"Virginia","Alleghany County",1,31,144,74,70
050,51,005,"Virginia","Alleghany County",1,32,124,58,66
050,51,005,"Virginia","Alleghany County",1,33,127,57,70
050,51,005,"Virginia","Alleghany County",1,34,150,79,71
050,51,005,"Virginia","Alleghany County",1,35,150,73,77
050,51,005,"Virginia","Alleghany County",1,36,134,64,70
050,51,005,"Virginia","Alleghany County",1,37,139,67,72
050,51,005,"Virginia","Alleghany County",1,38,149,75,74
050,51,005,"Virginia","Alleghany County",1,39,148,70,78
050,51,005,"Virginia","Alleghany County",1,40,172,80,92
050,51,005,"Virginia","Alleghany County",1,41,155,79,76
050,51,005,"Virginia","Alleghany County",1,42,152,78,74
050,51,005,"Virginia","Alleghany County",1,43,150,79,71
050,51,005,"Virginia","Alleghany County",1,44,141,69,72
050,51,005,"Virginia","Alleghany County",1,45,156,74,82
050,51,005,"Virginia","Alleghany County",1,46,164,82,82
050,51,005,"Virginia","Alleghany County",1,47,182,86,96
050,51,005,"Virginia","Alleghany County",1,48,206,95,111
050,51,005,"Virginia","Alleghany County",1,49,226,115,111
050,51,005,"Virginia","Alleghany County",1,50,222,107,115
050,51,005,"Virginia","Alleghany County",1,51,212,112,100
050,51,005,"Virginia","Alleghany County",1,52,217,119,98
050,51,005,"Virginia","Alleghany County",1,53,226,112,114
050,51,005,"Virginia","Alleghany County",1,54,235,120,115
050,51,005,"Virginia","Alleghany County",1,55,241,122,119
050,51,005,"Virginia","Alleghany County",1,56,239,115,124
050,51,005,"Virginia","Alleghany County",1,57,239,119,120
050,51,005,"Virginia","Alleghany County",1,58,237,118,119
050,51,005,"Virginia","Alleghany County",1,59,240,122,118
050,51,005,"Virginia","Alleghany County",1,60,238,110,128
050,51,005,"Virginia","Alleghany County",1,61,232,113,119
050,51,005,"Virginia","Alleghany County",1,62,252,115,137
050,51,005,"Virginia","Alleghany County",1,63,233,112,121
050,51,005,"Virginia","Alleghany County",1,64,235,110,125
050,51,005,"Virginia","Alleghany County",1,65,237,118,119
050,51,005,"Virginia","Alleghany County",1,66,230,113,117
050,51,005,"Virginia","Alleghany County",1,67,198,97,101
050,51,005,"Virginia","Alleghany County",1,68,219,115,104
050,51,005,"Virginia","Alleghany County",1,69,213,111,102
050,51,005,"Virginia","Alleghany County",1,70,198,102,96
050,51,005,"Virginia","Alleghany County",1,71,214,107,107
050,51,005,"Virginia","Alleghany County",1,72,241,103,138
050,51,005,"Virginia","Alleghany County",1,73,238,110,128
050,51,005,"Virginia","Alleghany County",1,74,160,73,87
050,51,005,"Virginia","Alleghany County",1,75,168,77,91
050,51,005,"Virginia","Alleghany County",1,76,175,79,96
050,51,005,"Virginia","Alleghany County",1,77,163,73,90
050,51,005,"Virginia","Alleghany County",1,78,152,68,84
050,51,005,"Virginia","Alleghany County",1,79,139,69,70
050,51,005,"Virginia","Alleghany County",1,80,117,58,59
050,51,005,"Virginia","Alleghany County",1,81,114,52,62
050,51,005,"Virginia","Alleghany County",1,82,97,44,53
050,51,005,"Virginia","Alleghany County",1,83,81,34,47
050,51,005,"Virginia","Alleghany County",1,84,75,31,44
050,51,005,"Virginia","Alleghany County",1,85,411,124,287
050,51,005,"Virginia","Alleghany County",2,0,134,68,66
050,51,005,"Virginia","Alleghany County",2,1,124,62,62
050,51,005,"Virginia","Alleghany County",2,2,142,71,71
050,51,005,"Virginia","Alleghany County",2,3,139,70,69
050,51,005,"Virginia","Alleghany County",2,4,148,73,75
050,51,005,"Virginia","Alleghany County",2,5,146,72,74
050,51,005,"Virginia","Alleghany County",2,6,138,70,68
050,51,005,"Virginia","Alleghany County",2,7,156,80,76
050,51,005,"Virginia","Alleghany County",2,8,158,84,74
050,51,005,"Virginia","Alleghany County",2,9,153,84,69
050,51,005,"Virginia","Alleghany County",2,10,161,84,77
050,51,005,"Virginia","Alleghany County",2,11,160,81,79
050,51,005,"Virginia","Alleghany County",2,12,159,83,76
050,51,005,"Virginia","Alleghany County",2,13,166,95,71
050,51,005,"Virginia","Alleghany County",2,14,191,110,81
050,51,005,"Virginia","Alleghany County",2,15,199,109,90
050,51,005,"Virginia","Alleghany County",2,16,189,108,81
050,51,005,"Virginia","Alleghany County",2,17,184,100,84
050,51,005,"Virginia","Alleghany County",2,18,153,74,79
050,51,005,"Virginia","Alleghany County",2,19,136,68,68
050,51,005,"Virginia","Alleghany County",2,20,145,73,72
050,51,005,"Virginia","Alleghany County",2,21,158,80,78
050,51,005,"Virginia","Alleghany County",2,22,166,92,74
050,51,005,"Virginia","Alleghany County",2,23,169,91,78
050,51,005,"Virginia","Alleghany County",2,24,156,82,74
050,51,005,"Virginia","Alleghany County",2,25,165,83,82
050,51,005,"Virginia","Alleghany County",2,26,169,83,86
050,51,005,"Virginia","Alleghany County",2,27,152,75,77
050,51,005,"Virginia","Alleghany County",2,28,155,75,80
050,51,005,"Virginia","Alleghany County",2,29,164,80,84
050,51,005,"Virginia","Alleghany County",2,30,165,84,81
050,51,005,"Virginia","Alleghany County",2,31,149,77,72
050,51,005,"Virginia","Alleghany County",2,32,129,62,67
050,51,005,"Virginia","Alleghany County",2,33,125,57,68
050,51,005,"Virginia","Alleghany County",2,34,146,75,71
050,51,005,"Virginia","Alleghany County",2,35,150,73,77
050,51,005,"Virginia","Alleghany County",2,36,139,67,72
050,51,005,"Virginia","Alleghany County",2,37,139,66,73
050,51,005,"Virginia","Alleghany County",2,38,145,71,74
050,51,005,"Virginia","Alleghany County",2,39,148,71,77
050,51,005,"Virginia","Alleghany County",2,40,166,77,89
050,51,005,"Virginia","Alleghany County",2,41,156,78,78
050,51,005,"Virginia","Alleghany County",2,42,150,77,73
050,51,005,"Virginia","Alleghany County",2,43,151,79,72
050,51,005,"Virginia","Alleghany County",2,44,141,70,71
050,51,005,"Virginia","Alleghany County",2,45,151,73,78
050,51,005,"Virginia","Alleghany County",2,46,162,80,82
050,51,005,"Virginia","Alleghany County",2,47,176,85,91
050,51,005,"Virginia","Alleghany County",2,48,201,94,107
050,51,005,"Virginia","Alleghany County",2,49,221,110,111
050,51,005,"Virginia","Alleghany County",2,50,223,109,114
050,51,005,"Virginia","Alleghany County",2,51,212,111,101
050,51,005,"Virginia","Alleghany County",2,52,216,118,98
050,51,005,"Virginia","Alleghany County",2,53,222,115,107
050,51,005,"Virginia","Alleghany County",2,54,234,119,115
050,51,005,"Virginia","Alleghany County",2,55,238,121,117
050,51,005,"Virginia","Alleghany County",2,56,240,117,123
050,51,005,"Virginia","Alleghany County",2,57,240,118,122
050,51,005,"Virginia","Alleghany County",2,58,237,119,118
050,51,005,"Virginia","Alleghany County",2,59,238,119,119
050,51,005,"Virginia","Alleghany County",2,60,239,114,125
050,51,005,"Virginia","Alleghany County",2,61,235,112,123
050,51,005,"Virginia","Alleghany County",2,62,244,112,132
050,51,005,"Virginia","Alleghany County",2,63,241,115,126
050,51,005,"Virginia","Alleghany County",2,64,233,110,123
050,51,005,"Virginia","Alleghany County",2,65,235,115,120
050,51,005,"Virginia","Alleghany County",2,66,229,113,116
050,51,005,"Virginia","Alleghany County",2,67,204,100,104
050,51,005,"Virginia","Alleghany County",2,68,213,110,103
050,51,005,"Virginia","Alleghany County",2,69,213,111,102
050,51,005,"Virginia","Alleghany County",2,70,201,105,96
050,51,005,"Virginia","Alleghany County",2,71,207,103,104
050,51,005,"Virginia","Alleghany County",2,72,230,101,129
050,51,005,"Virginia","Alleghany County",2,73,248,114,134
050,51,005,"Virginia","Alleghany County",2,74,165,76,89
050,51,005,"Virginia","Alleghany County",2,75,164,74,90
050,51,005,"Virginia","Alleghany County",2,76,169,77,92
050,51,005,"Virginia","Alleghany County",2,77,169,76,93
050,51,005,"Virginia","Alleghany County",2,78,154,68,86
050,51,005,"Virginia","Alleghany County",2,79,140,68,72
050,51,005,"Virginia","Alleghany County",2,80,121,59,62
050,51,005,"Virginia","Alleghany County",2,81,112,50,62
050,51,005,"Virginia","Alleghany County",2,82,99,46,53
050,51,005,"Virginia","Alleghany County",2,83,83,36,47
050,51,005,"Virginia","Alleghany County",2,84,75,32,43
050,51,005,"Virginia","Alleghany County",2,85,412,124,288
050,51,005,"Virginia","Alleghany County",3,0,105,49,56
050,51,005,"Virginia","Alleghany County",3,1,136,67,69
050,51,005,"Virginia","Alleghany County",3,2,133,64,69
050,51,005,"Virginia","Alleghany County",3,3,130,63,67
050,51,005,"Virginia","Alleghany County",3,4,143,68,75
050,51,005,"Virginia","Alleghany County",3,5,145,76,69
050,51,005,"Virginia","Alleghany County",3,6,151,72,79
050,51,005,"Virginia","Alleghany County",3,7,154,77,77
050,51,005,"Virginia","Alleghany County",3,8,152,77,75
050,51,005,"Virginia","Alleghany County",3,9,153,82,71
050,51,005,"Virginia","Alleghany County",3,10,146,78,68
050,51,005,"Virginia","Alleghany County",3,11,158,78,80
050,51,005,"Virginia","Alleghany County",3,12,156,76,80
050,51,005,"Virginia","Alleghany County",3,13,153,80,73
050,51,005,"Virginia","Alleghany County",3,14,169,94,75
050,51,005,"Virginia","Alleghany County",3,15,184,107,77
050,51,005,"Virginia","Alleghany County",3,16,193,105,88
050,51,005,"Virginia","Alleghany County",3,17,191,109,82
050,51,005,"Virginia","Alleghany County",3,18,153,81,72
050,51,005,"Virginia","Alleghany County",3,19,120,54,66
050,51,005,"Virginia","Alleghany County",3,20,156,76,80
050,51,005,"Virginia","Alleghany County",3,21,157,77,80
050,51,005,"Virginia","Alleghany County",3,22,162,76,86
050,51,005,"Virginia","Alleghany County",3,23,170,90,80
050,51,005,"Virginia","Alleghany County",3,24,157,84,73
050,51,005,"Virginia","Alleghany County",3,25,156,86,70
050,51,005,"Virginia","Alleghany County",3,26,158,79,79
050,51,005,"Virginia","Alleghany County",3,27,165,85,80
050,51,005,"Virginia","Alleghany County",3,28,154,73,81
050,51,005,"Virginia","Alleghany County",3,29,150,74,76
050,51,005,"Virginia","Alleghany County",3,30,166,83,83
050,51,005,"Virginia","Alleghany County",3,31,165,86,79
050,51,005,"Virginia","Alleghany County",3,32,150,80,70
050,51,005,"Virginia","Alleghany County",3,33,129,64,65
050,51,005,"Virginia","Alleghany County",3,34,131,62,69
050,51,005,"Virginia","Alleghany County",3,35,155,83,72
050,51,005,"Virginia","Alleghany County",3,36,153,73,80
050,51,005,"Virginia","Alleghany County",3,37,140,68,72
050,51,005,"Virginia","Alleghany County",3,38,136,65,71
050,51,005,"Virginia","Alleghany County",3,39,140,65,75
050,51,005,"Virginia","Alleghany County",3,40,141,69,72
050,51,005,"Virginia","Alleghany County",3,41,169,81,88
050,51,005,"Virginia","Alleghany County",3,42,158,80,78
050,51,005,"Virginia","Alleghany County",3,43,153,75,78
050,51,005,"Virginia","Alleghany County",3,44,148,78,70
050,51,005,"Virginia","Alleghany County",3,45,148,76,72
050,51,005,"Virginia","Alleghany County",3,46,150,75,75
050,51,005,"Virginia","Alleghany County",3,47,155,73,82
050,51,005,"Virginia","Alleghany County",3,48,183,91,92
050,51,005,"Virginia","Alleghany County",3,49,198,93,105
050,51,005,"Virginia","Alleghany County",3,50,224,114,110
050,51,005,"Virginia","Alleghany County",3,51,216,109,107
050,51,005,"Virginia","Alleghany County",3,52,212,113,99
050,51,005,"Virginia","Alleghany County",3,53,210,110,100
050,51,005,"Virginia","Alleghany County",3,54,221,116,105
050,51,005,"Virginia","Alleghany County",3,55,246,123,123
050,51,005,"Virginia","Alleghany County",3,56,234,113,121
050,51,005,"Virginia","Alleghany County",3,57,242,118,124
050,51,005,"Virginia","Alleghany County",3,58,240,124,116
050,51,005,"Virginia","Alleghany County",3,59,230,113,117
050,51,005,"Virginia","Alleghany County",3,60,242,123,119
050,51,005,"Virginia","Alleghany County",3,61,239,109,130
050,51,005,"Virginia","Alleghany County",3,62,220,102,118
050,51,005,"Virginia","Alleghany County",3,63,242,110,132
050,51,005,"Virginia","Alleghany County",3,64,236,115,121
050,51,005,"Virginia","Alleghany County",3,65,225,104,121
050,51,005,"Virginia","Alleghany County",3,66,228,109,119
050,51,005,"Virginia","Alleghany County",3,67,229,110,119
050,51,005,"Virginia","Alleghany County",3,68,199,93,106
050,51,005,"Virginia","Alleghany County",3,69,206,103,103
050,51,005,"Virginia","Alleghany County",3,70,210,108,102
050,51,005,"Virginia","Alleghany County",3,71,194,101,93
050,51,005,"Virginia","Alleghany County",3,72,209,100,109
050,51,005,"Virginia","Alleghany County",3,73,223,101,122
050,51,005,"Virginia","Alleghany County",3,74,232,108,124
050,51,005,"Virginia","Alleghany County",3,75,156,70,86
050,51,005,"Virginia","Alleghany County",3,76,157,71,86
050,51,005,"Virginia","Alleghany County",3,77,164,73,91
050,51,005,"Virginia","Alleghany County",3,78,166,75,91
050,51,005,"Virginia","Alleghany County",3,79,143,65,78
050,51,005,"Virginia","Alleghany County",3,80,133,66,67
050,51,005,"Virginia","Alleghany County",3,81,111,50,61
050,51,005,"Virginia","Alleghany County",3,82,98,44,54
050,51,005,"Virginia","Alleghany County",3,83,95,44,51
050,51,005,"Virginia","Alleghany County",3,84,70,29,41
050,51,005,"Virginia","Alleghany County",3,85,408,125,283
050,51,005,"Virginia","Alleghany County",4,0,78,35,43
050,51,005,"Virginia","Alleghany County",4,1,101,52,49
050,51,005,"Virginia","Alleghany County",4,2,131,63,68
050,51,005,"Virginia","Alleghany County",4,3,139,67,72
050,51,005,"Virginia","Alleghany County",4,4,140,65,75
050,51,005,"Virginia","Alleghany County",4,5,143,67,76
050,51,005,"Virginia","Alleghany County",4,6,142,74,68
050,51,005,"Virginia","Alleghany County",4,7,148,74,74
050,51,005,"Virginia","Alleghany County",4,8,145,78,67
050,51,005,"Virginia","Alleghany County",4,9,155,79,76
050,51,005,"Virginia","Alleghany County",4,10,157,83,74
050,51,005,"Virginia","Alleghany County",4,11,142,75,67
050,51,005,"Virginia","Alleghany County",4,12,158,81,77
050,51,005,"Virginia","Alleghany County",4,13,162,82,80
050,51,005,"Virginia","Alleghany County",4,14,158,88,70
050,51,005,"Virginia","Alleghany County",4,15,174,104,70
050,51,005,"Virginia","Alleghany County",4,16,172,96,76
050,51,005,"Virginia","Alleghany County",4,17,194,109,85
050,51,005,"Virginia","Alleghany County",4,18,163,96,67
050,51,005,"Virginia","Alleghany County",4,19,119,61,58
050,51,005,"Virginia","Alleghany County",4,20,128,61,67
050,51,005,"Virginia","Alleghany County",4,21,152,70,82
050,51,005,"Virginia","Alleghany County",4,22,160,76,84
050,51,005,"Virginia","Alleghany County",4,23,171,79,92
050,51,005,"Virginia","Alleghany County",4,24,170,90,80
050,51,005,"Virginia","Alleghany County",4,25,153,85,68
050,51,005,"Virginia","Alleghany County",4,26,150,86,64
050,51,005,"Virginia","Alleghany County",4,27,154,76,78
050,51,005,"Virginia","Alleghany County",4,28,167,84,83
050,51,005,"Virginia","Alleghany County",4,29,143,68,75
050,51,005,"Virginia","Alleghany County",4,30,145,72,73
050,51,005,"Virginia","Alleghany County",4,31,170,87,83
050,51,005,"Virginia","Alleghany County",4,32,150,78,72
050,51,005,"Virginia","Alleghany County",4,33,143,74,69
050,51,005,"Virginia","Alleghany County",4,34,132,66,66
050,51,005,"Virginia","Alleghany County",4,35,127,57,70
050,51,005,"Virginia","Alleghany County",4,36,157,83,74
050,51,005,"Virginia","Alleghany County",4,37,154,77,77
050,51,005,"Virginia","Alleghany County",4,38,140,66,74
050,51,005,"Virginia","Alleghany County",4,39,139,69,70
050,51,005,"Virginia","Alleghany County",4,40,135,65,70
050,51,005,"Virginia","Alleghany County",4,41,147,71,76
050,51,005,"Virginia","Alleghany County",4,42,164,79,85
050,51,005,"Virginia","Alleghany County",4,43,163,79,84
050,51,005,"Virginia","Alleghany County",4,44,153,77,76
050,51,005,"Virginia","Alleghany County",4,45,149,77,72
050,51,005,"Virginia","Alleghany County",4,46,158,82,76
050,51,005,"Virginia","Alleghany County",4,47,148,73,75
050,51,005,"Virginia","Alleghany County",4,48,157,77,80
050,51,005,"Virginia","Alleghany County",4,49,178,90,88
050,51,005,"Virginia","Alleghany County",4,50,198,95,103
050,51,005,"Virginia","Alleghany County",4,51,222,115,107
050,51,005,"Virginia","Alleghany County",4,52,217,110,107
050,51,005,"Virginia","Alleghany County",4,53,208,106,102
050,51,005,"Virginia","Alleghany County",4,54,208,108,100
050,51,005,"Virginia","Alleghany County",4,55,223,119,104
050,51,005,"Virginia","Alleghany County",4,56,241,115,126
050,51,005,"Virginia","Alleghany County",4,57,237,116,121
050,51,005,"Virginia","Alleghany County",4,58,235,117,118
050,51,005,"Virginia","Alleghany County",4,59,233,118,115
050,51,005,"Virginia","Alleghany County",4,60,228,113,115
050,51,005,"Virginia","Alleghany County",4,61,244,121,123
050,51,005,"Virginia","Alleghany County",4,62,224,104,120
050,51,005,"Virginia","Alleghany County",4,63,221,100,121
050,51,005,"Virginia","Alleghany County",4,64,245,111,134
050,51,005,"Virginia","Alleghany County",4,65,235,111,124
050,51,005,"Virginia","Alleghany County",4,66,221,103,118
050,51,005,"Virginia","Alleghany County",4,67,225,108,117
050,51,005,"Virginia","Alleghany County",4,68,229,108,121
050,51,005,"Virginia","Alleghany County",4,69,191,88,103
050,51,005,"Virginia","Alleghany County",4,70,197,97,100
050,51,005,"Virginia","Alleghany County",4,71,206,103,103
050,51,005,"Virginia","Alleghany County",4,72,195,99,96
050,51,005,"Virginia","Alleghany County",4,73,197,99,98
050,51,005,"Virginia","Alleghany County",4,74,208,94,114
050,51,005,"Virginia","Alleghany County",4,75,214,104,110
050,51,005,"Virginia","Alleghany County",4,76,144,65,79
050,51,005,"Virginia","Alleghany County",4,77,153,69,84
050,51,005,"Virginia","Alleghany County",4,78,165,71,94
050,51,005,"Virginia","Alleghany County",4,79,156,71,85
050,51,005,"Virginia","Alleghany County",4,80,127,58,69
050,51,005,"Virginia","Alleghany County",4,81,127,61,66
050,51,005,"Virginia","Alleghany County",4,82,99,46,53
050,51,005,"Virginia","Alleghany County",4,83,90,40,50
050,51,005,"Virginia","Alleghany County",4,84,82,37,45
050,51,005,"Virginia","Alleghany County",4,85,392,121,271
050,51,005,"Virginia","Alleghany County",5,0,77,34,43
050,51,005,"Virginia","Alleghany County",5,1,84,36,48
050,51,005,"Virginia","Alleghany County",5,2,111,63,48
050,51,005,"Virginia","Alleghany County",5,3,135,63,72
050,51,005,"Virginia","Alleghany County",5,4,140,69,71
050,51,005,"Virginia","Alleghany County",5,5,143,66,77
050,51,005,"Virginia","Alleghany County",5,6,140,65,75
050,51,005,"Virginia","Alleghany County",5,7,146,80,66
050,51,005,"Virginia","Alleghany County",5,8,149,74,75
050,51,005,"Virginia","Alleghany County",5,9,146,78,68
050,51,005,"Virginia","Alleghany County",5,10,152,78,74
050,51,005,"Virginia","Alleghany County",5,11,157,84,73
050,51,005,"Virginia","Alleghany County",5,12,153,77,76
050,51,005,"Virginia","Alleghany County",5,13,155,81,74
050,51,005,"Virginia","Alleghany County",5,14,167,88,79
050,51,005,"Virginia","Alleghany County",5,15,159,88,71
050,51,005,"Virginia","Alleghany County",5,16,177,107,70
050,51,005,"Virginia","Alleghany County",5,17,182,102,80
050,51,005,"Virginia","Alleghany County",5,18,159,89,70
050,51,005,"Virginia","Alleghany County",5,19,132,78,54
050,51,005,"Virginia","Alleghany County",5,20,122,61,61
050,51,005,"Virginia","Alleghany County",5,21,134,65,69
050,51,005,"Virginia","Alleghany County",5,22,162,69,93
050,51,005,"Virginia","Alleghany County",5,23,155,77,78
050,51,005,"Virginia","Alleghany County",5,24,163,79,84
050,51,005,"Virginia","Alleghany County",5,25,169,93,76
050,51,005,"Virginia","Alleghany County",5,26,149,88,61
050,51,005,"Virginia","Alleghany County",5,27,171,101,70
050,51,005,"Virginia","Alleghany County",5,28,162,76,86
050,51,005,"Virginia","Alleghany County",5,29,176,80,96
050,51,005,"Virginia","Alleghany County",5,30,149,71,78
050,51,005,"Virginia","Alleghany County",5,31,151,77,74
050,51,005,"Virginia","Alleghany County",5,32,170,85,85
050,51,005,"Virginia","Alleghany County",5,33,156,84,72
050,51,005,"Virginia","Alleghany County",5,34,143,75,68
050,51,005,"Virginia","Alleghany County",5,35,139,73,66
050,51,005,"Virginia","Alleghany County",5,36,126,54,72
050,51,005,"Virginia","Alleghany County",5,37,168,89,79
050,51,005,"Virginia","Alleghany County",5,38,150,72,78
050,51,005,"Virginia","Alleghany County",5,39,136,65,71
050,51,005,"Virginia","Alleghany County",5,40,140,70,70
050,51,005,"Virginia","Alleghany County",5,41,136,63,73
050,51,005,"Virginia","Alleghany County",5,42,146,70,76
050,51,005,"Virginia","Alleghany County",5,43,164,78,86
050,51,005,"Virginia","Alleghany County",5,44,168,82,86
050,51,005,"Virginia","Alleghany County",5,45,148,76,72
050,51,005,"Virginia","Alleghany County",5,46,152,77,75
050,51,005,"Virginia","Alleghany County",5,47,158,79,79
050,51,005,"Virginia","Alleghany County",5,48,158,82,76
050,51,005,"Virginia","Alleghany County",5,49,152,74,78
050,51,005,"Virginia","Alleghany County",5,50,178,90,88
050,51,005,"Virginia","Alleghany County",5,51,203,99,104
050,51,005,"Virginia","Alleghany County",5,52,222,117,105
050,51,005,"Virginia","Alleghany County",5,53,224,113,111
050,51,005,"Virginia","Alleghany County",5,54,198,100,98
050,51,005,"Virginia","Alleghany County",5,55,207,103,104
050,51,005,"Virginia","Alleghany County",5,56,216,114,102
050,51,005,"Virginia","Alleghany County",5,57,242,113,129
050,51,005,"Virginia","Alleghany County",5,58,231,111,120
050,51,005,"Virginia","Alleghany County",5,59,238,119,119
050,51,005,"Virginia","Alleghany County",5,60,232,121,111
050,51,005,"Virginia","Alleghany County",5,61,229,111,118
050,51,005,"Virginia","Alleghany County",5,62,227,112,115
050,51,005,"Virginia","Alleghany County",5,63,223,107,116
050,51,005,"Virginia","Alleghany County",5,64,218,101,117
050,51,005,"Virginia","Alleghany County",5,65,241,107,134
050,51,005,"Virginia","Alleghany County",5,66,226,107,119
050,51,005,"Virginia","Alleghany County",5,67,219,102,117
050,51,005,"Virginia","Alleghany County",5,68,222,106,116
050,51,005,"Virginia","Alleghany County",5,69,221,102,119
050,51,005,"Virginia","Alleghany County",5,70,187,85,102
050,51,005,"Virginia","Alleghany County",5,71,186,88,98
050,51,005,"Virginia","Alleghany County",5,72,208,100,108
050,51,005,"Virginia","Alleghany County",5,73,188,100,88
050,51,005,"Virginia","Alleghany County",5,74,184,91,93
050,51,005,"Virginia","Alleghany County",5,75,190,89,101
050,51,005,"Virginia","Alleghany County",5,76,199,97,102
050,51,005,"Virginia","Alleghany County",5,77,146,64,82
050,51,005,"Virginia","Alleghany County",5,78,153,67,86
050,51,005,"Virginia","Alleghany County",5,79,155,68,87
050,51,005,"Virginia","Alleghany County",5,80,141,66,75
050,51,005,"Virginia","Alleghany County",5,81,118,54,64
050,51,005,"Virginia","Alleghany County",5,82,108,54,54
050,51,005,"Virginia","Alleghany County",5,83,92,43,49
050,51,005,"Virginia","Alleghany County",5,84,79,34,45
050,51,005,"Virginia","Alleghany County",5,85,407,130,277
050,51,007,"Virginia","Amelia County",1,0,133,69,64
050,51,007,"Virginia","Amelia County",1,1,138,76,62
050,51,007,"Virginia","Amelia County",1,2,137,79,58
050,51,007,"Virginia","Amelia County",1,3,132,70,62
050,51,007,"Virginia","Amelia County",1,4,148,85,63
050,51,007,"Virginia","Amelia County",1,5,160,87,73
050,51,007,"Virginia","Amelia County",1,6,140,76,64
050,51,007,"Virginia","Amelia County",1,7,157,82,75
050,51,007,"Virginia","Amelia County",1,8,148,75,73
050,51,007,"Virginia","Amelia County",1,9,147,71,76
050,51,007,"Virginia","Amelia County",1,10,155,82,73
050,51,007,"Virginia","Amelia County",1,11,158,84,74
050,51,007,"Virginia","Amelia County",1,12,177,78,99
050,51,007,"Virginia","Amelia County",1,13,168,87,81
050,51,007,"Virginia","Amelia County",1,14,160,80,80
050,51,007,"Virginia","Amelia County",1,15,167,77,90
050,51,007,"Virginia","Amelia County",1,16,155,84,71
050,51,007,"Virginia","Amelia County",1,17,164,88,76
050,51,007,"Virginia","Amelia County",1,18,151,84,67
050,51,007,"Virginia","Amelia County",1,19,118,63,55
050,51,007,"Virginia","Amelia County",1,20,127,60,67
050,51,007,"Virginia","Amelia County",1,21,128,63,65
050,51,007,"Virginia","Amelia County",1,22,134,73,61
050,51,007,"Virginia","Amelia County",1,23,125,62,63
050,51,007,"Virginia","Amelia County",1,24,127,66,61
050,51,007,"Virginia","Amelia County",1,25,145,80,65
050,51,007,"Virginia","Amelia County",1,26,148,73,75
050,51,007,"Virginia","Amelia County",1,27,135,64,71
050,51,007,"Virginia","Amelia County",1,28,140,62,78
050,51,007,"Virginia","Amelia County",1,29,156,78,78
050,51,007,"Virginia","Amelia County",1,30,185,97,88
050,51,007,"Virginia","Amelia County",1,31,144,68,76
050,51,007,"Virginia","Amelia County",1,32,145,68,77
050,51,007,"Virginia","Amelia County",1,33,142,68,74
050,51,007,"Virginia","Amelia County",1,34,158,76,82
050,51,007,"Virginia","Amelia County",1,35,158,81,77
050,51,007,"Virginia","Amelia County",1,36,144,81,63
050,51,007,"Virginia","Amelia County",1,37,157,77,80
050,51,007,"Virginia","Amelia County",1,38,136,79,57
050,51,007,"Virginia","Amelia County",1,39,142,72,70
050,51,007,"Virginia","Amelia County",1,40,154,80,74
050,51,007,"Virginia","Amelia County",1,41,131,70,61
050,51,007,"Virginia","Amelia County",1,42,138,67,71
050,51,007,"Virginia","Amelia County",1,43,159,78,81
050,51,007,"Virginia","Amelia County",1,44,140,68,72
050,51,007,"Virginia","Amelia County",1,45,148,70,78
050,51,007,"Virginia","Amelia County",1,46,143,70,73
050,51,007,"Virginia","Amelia County",1,47,151,73,78
050,51,007,"Virginia","Amelia County",1,48,161,71,90
050,51,007,"Virginia","Amelia County",1,49,190,94,96
050,51,007,"Virginia","Amelia County",1,50,177,89,88
050,51,007,"Virginia","Amelia County",1,51,199,109,90
050,51,007,"Virginia","Amelia County",1,52,187,97,90
050,51,007,"Virginia","Amelia County",1,53,184,87,97
050,51,007,"Virginia","Amelia County",1,54,178,78,100
050,51,007,"Virginia","Amelia County",1,55,214,109,105
050,51,007,"Virginia","Amelia County",1,56,226,116,110
050,51,007,"Virginia","Amelia County",1,57,229,112,117
050,51,007,"Virginia","Amelia County",1,58,225,115,110
050,51,007,"Virginia","Amelia County",1,59,243,122,121
050,51,007,"Virginia","Amelia County",1,60,240,117,123
050,51,007,"Virginia","Amelia County",1,61,246,121,125
050,51,007,"Virginia","Amelia County",1,62,232,114,118
050,51,007,"Virginia","Amelia County",1,63,230,114,116
050,51,007,"Virginia","Amelia County",1,64,217,115,102
050,51,007,"Virginia","Amelia County",1,65,196,110,86
050,51,007,"Virginia","Amelia County",1,66,166,86,80
050,51,007,"Virginia","Amelia County",1,67,169,85,84
050,51,007,"Virginia","Amelia County",1,68,153,75,78
050,51,007,"Virginia","Amelia County",1,69,143,63,80
050,51,007,"Virginia","Amelia County",1,70,146,66,80
050,51,007,"Virginia","Amelia County",1,71,165,87,78
050,51,007,"Virginia","Amelia County",1,72,168,89,79
050,51,007,"Virginia","Amelia County",1,73,154,83,71
050,51,007,"Virginia","Amelia County",1,74,106,51,55
050,51,007,"Virginia","Amelia County",1,75,101,49,52
050,51,007,"Virginia","Amelia County",1,76,116,60,56
050,51,007,"Virginia","Amelia County",1,77,110,47,63
050,51,007,"Virginia","Amelia County",1,78,97,47,50
050,51,007,"Virginia","Amelia County",1,79,85,34,51
050,51,007,"Virginia","Amelia County",1,80,81,38,43
050,51,007,"Virginia","Amelia County",1,81,67,35,32
050,51,007,"Virginia","Amelia County",1,82,59,24,35
050,51,007,"Virginia","Amelia County",1,83,47,16,31
050,51,007,"Virginia","Amelia County",1,84,44,14,30
050,51,007,"Virginia","Amelia County",1,85,256,77,179
050,51,007,"Virginia","Amelia County",2,0,143,71,72
050,51,007,"Virginia","Amelia County",2,1,135,75,60
050,51,007,"Virginia","Amelia County",2,2,138,79,59
050,51,007,"Virginia","Amelia County",2,3,133,73,60
050,51,007,"Virginia","Amelia County",2,4,145,82,63
050,51,007,"Virginia","Amelia County",2,5,155,85,70
050,51,007,"Virginia","Amelia County",2,6,146,79,67
050,51,007,"Virginia","Amelia County",2,7,151,80,71
050,51,007,"Virginia","Amelia County",2,8,148,76,72
050,51,007,"Virginia","Amelia County",2,9,147,73,74
050,51,007,"Virginia","Amelia County",2,10,153,80,73
050,51,007,"Virginia","Amelia County",2,11,157,82,75
050,51,007,"Virginia","Amelia County",2,12,173,81,92
050,51,007,"Virginia","Amelia County",2,13,167,83,84
050,51,007,"Virginia","Amelia County",2,14,162,82,80
050,51,007,"Virginia","Amelia County",2,15,165,78,87
050,51,007,"Virginia","Amelia County",2,16,157,82,75
050,51,007,"Virginia","Amelia County",2,17,161,87,74
050,51,007,"Virginia","Amelia County",2,18,147,81,66
050,51,007,"Virginia","Amelia County",2,19,120,65,55
050,51,007,"Virginia","Amelia County",2,20,129,62,67
050,51,007,"Virginia","Amelia County",2,21,130,63,67
050,51,007,"Virginia","Amelia County",2,22,133,71,62
050,51,007,"Virginia","Amelia County",2,23,126,63,63
050,51,007,"Virginia","Amelia County",2,24,126,65,61
050,51,007,"Virginia","Amelia County",2,25,142,78,64
050,51,007,"Virginia","Amelia County",2,26,149,76,73
050,51,007,"Virginia","Amelia County",2,27,137,66,71
050,51,007,"Virginia","Amelia County",2,28,139,62,77
050,51,007,"Virginia","Amelia County",2,29,155,77,78
050,51,007,"Virginia","Amelia County",2,30,175,91,84
050,51,007,"Virginia","Amelia County",2,31,152,73,79
050,51,007,"Virginia","Amelia County",2,32,145,68,77
050,51,007,"Virginia","Amelia County",2,33,142,67,75
050,51,007,"Virginia","Amelia County",2,34,154,73,81
050,51,007,"Virginia","Amelia County",2,35,160,82,78
050,51,007,"Virginia","Amelia County",2,36,147,81,66
050,51,007,"Virginia","Amelia County",2,37,154,79,75
050,51,007,"Virginia","Amelia County",2,38,142,80,62
050,51,007,"Virginia","Amelia County",2,39,140,75,65
050,51,007,"Virginia","Amelia County",2,40,151,77,74
050,51,007,"Virginia","Amelia County",2,41,136,71,65
050,51,007,"Virginia","Amelia County",2,42,139,70,69
050,51,007,"Virginia","Amelia County",2,43,156,76,80
050,51,007,"Virginia","Amelia County",2,44,144,71,73
050,51,007,"Virginia","Amelia County",2,45,147,69,78
050,51,007,"Virginia","Amelia County",2,46,144,70,74
050,51,007,"Virginia","Amelia County",2,47,150,72,78
050,51,007,"Virginia","Amelia County",2,48,159,71,88
050,51,007,"Virginia","Amelia County",2,49,185,91,94
050,51,007,"Virginia","Amelia County",2,50,181,91,90
050,51,007,"Virginia","Amelia County",2,51,189,101,88
050,51,007,"Virginia","Amelia County",2,52,191,101,90
050,51,007,"Virginia","Amelia County",2,53,182,86,96
050,51,007,"Virginia","Amelia County",2,54,180,80,100
050,51,007,"Virginia","Amelia County",2,55,205,101,104
050,51,007,"Virginia","Amelia County",2,56,223,114,109
050,51,007,"Virginia","Amelia County",2,57,230,113,117
050,51,007,"Virginia","Amelia County",2,58,227,114,113
050,51,007,"Virginia","Amelia County",2,59,241,122,119
050,51,007,"Virginia","Amelia County",2,60,243,119,124
050,51,007,"Virginia","Amelia County",2,61,243,119,124
050,51,007,"Virginia","Amelia County",2,62,232,114,118
050,51,007,"Virginia","Amelia County",2,63,231,116,115
050,51,007,"Virginia","Amelia County",2,64,220,116,104
050,51,007,"Virginia","Amelia County",2,65,200,112,88
050,51,007,"Virginia","Amelia County",2,66,173,92,81
050,51,007,"Virginia","Amelia County",2,67,165,84,81
050,51,007,"Virginia","Amelia County",2,68,155,77,78
050,51,007,"Virginia","Amelia County",2,69,145,66,79
050,51,007,"Virginia","Amelia County",2,70,148,67,81
050,51,007,"Virginia","Amelia County",2,71,159,80,79
050,51,007,"Virginia","Amelia County",2,72,167,88,79
050,51,007,"Virginia","Amelia County",2,73,163,87,76
050,51,007,"Virginia","Amelia County",2,74,112,55,57
050,51,007,"Virginia","Amelia County",2,75,101,50,51
050,51,007,"Virginia","Amelia County",2,76,110,56,54
050,51,007,"Virginia","Amelia County",2,77,112,50,62
050,51,007,"Virginia","Amelia County",2,78,97,45,52
050,51,007,"Virginia","Amelia County",2,79,88,37,51
050,51,007,"Virginia","Amelia County",2,80,80,36,44
050,51,007,"Virginia","Amelia County",2,81,70,36,34
050,51,007,"Virginia","Amelia County",2,82,61,26,35
050,51,007,"Virginia","Amelia County",2,83,49,18,31
050,51,007,"Virginia","Amelia County",2,84,45,15,30
050,51,007,"Virginia","Amelia County",2,85,258,77,181
050,51,007,"Virginia","Amelia County",3,0,127,71,56
050,51,007,"Virginia","Amelia County",3,1,164,86,78
050,51,007,"Virginia","Amelia County",3,2,146,77,69
050,51,007,"Virginia","Amelia County",3,3,142,82,60
050,51,007,"Virginia","Amelia County",3,4,142,77,65
050,51,007,"Virginia","Amelia County",3,5,149,87,62
050,51,007,"Virginia","Amelia County",3,6,154,85,69
050,51,007,"Virginia","Amelia County",3,7,135,73,62
050,51,007,"Virginia","Amelia County",3,8,149,77,72
050,51,007,"Virginia","Amelia County",3,9,140,73,67
050,51,007,"Virginia","Amelia County",3,10,148,74,74
050,51,007,"Virginia","Amelia County",3,11,152,73,79
050,51,007,"Virginia","Amelia County",3,12,152,73,79
050,51,007,"Virginia","Amelia County",3,13,174,81,93
050,51,007,"Virginia","Amelia County",3,14,165,85,80
050,51,007,"Virginia","Amelia County",3,15,163,86,77
050,51,007,"Virginia","Amelia County",3,16,166,77,89
050,51,007,"Virginia","Amelia County",3,17,162,84,78
050,51,007,"Virginia","Amelia County",3,18,136,77,59
050,51,007,"Virginia","Amelia County",3,19,117,62,55
050,51,007,"Virginia","Amelia County",3,20,126,68,58
050,51,007,"Virginia","Amelia County",3,21,141,68,73
050,51,007,"Virginia","Amelia County",3,22,141,65,76
050,51,007,"Virginia","Amelia County",3,23,135,72,63
050,51,007,"Virginia","Amelia County",3,24,132,64,68
050,51,007,"Virginia","Amelia County",3,25,144,77,67
050,51,007,"Virginia","Amelia County",3,26,144,77,67
050,51,007,"Virginia","Amelia County",3,27,157,82,75
050,51,007,"Virginia","Amelia County",3,28,133,62,71
050,51,007,"Virginia","Amelia County",3,29,142,66,76
050,51,007,"Virginia","Amelia County",3,30,169,84,85
050,51,007,"Virginia","Amelia County",3,31,165,82,83
050,51,007,"Virginia","Amelia County",3,32,152,71,81
050,51,007,"Virginia","Amelia County",3,33,146,70,76
050,51,007,"Virginia","Amelia County",3,34,150,75,75
050,51,007,"Virginia","Amelia County",3,35,159,81,78
050,51,007,"Virginia","Amelia County",3,36,161,79,82
050,51,007,"Virginia","Amelia County",3,37,150,81,69
050,51,007,"Virginia","Amelia County",3,38,154,77,77
050,51,007,"Virginia","Amelia County",3,39,144,80,64
050,51,007,"Virginia","Amelia County",3,40,134,68,66
050,51,007,"Virginia","Amelia County",3,41,149,76,73
050,51,007,"Virginia","Amelia County",3,42,140,71,69
050,51,007,"Virginia","Amelia County",3,43,136,68,68
050,51,007,"Virginia","Amelia County",3,44,154,75,79
050,51,007,"Virginia","Amelia County",3,45,138,64,74
050,51,007,"Virginia","Amelia County",3,46,148,77,71
050,51,007,"Virginia","Amelia County",3,47,149,75,74
050,51,007,"Virginia","Amelia County",3,48,152,73,79
050,51,007,"Virginia","Amelia County",3,49,163,76,87
050,51,007,"Virginia","Amelia County",3,50,179,85,94
050,51,007,"Virginia","Amelia County",3,51,186,93,93
050,51,007,"Virginia","Amelia County",3,52,177,93,84
050,51,007,"Virginia","Amelia County",3,53,187,96,91
050,51,007,"Virginia","Amelia County",3,54,182,84,98
050,51,007,"Virginia","Amelia County",3,55,182,84,98
050,51,007,"Virginia","Amelia County",3,56,209,108,101
050,51,007,"Virginia","Amelia County",3,57,229,117,112
050,51,007,"Virginia","Amelia County",3,58,230,114,116
050,51,007,"Virginia","Amelia County",3,59,230,111,119
050,51,007,"Virginia","Amelia County",3,60,241,121,120
050,51,007,"Virginia","Amelia County",3,61,242,116,126
050,51,007,"Virginia","Amelia County",3,62,234,117,117
050,51,007,"Virginia","Amelia County",3,63,224,109,115
050,51,007,"Virginia","Amelia County",3,64,232,117,115
050,51,007,"Virginia","Amelia County",3,65,220,116,104
050,51,007,"Virginia","Amelia County",3,66,192,109,83
050,51,007,"Virginia","Amelia County",3,67,168,90,78
050,51,007,"Virginia","Amelia County",3,68,165,83,82
050,51,007,"Virginia","Amelia County",3,69,156,78,78
050,51,007,"Virginia","Amelia County",3,70,146,67,79
050,51,007,"Virginia","Amelia County",3,71,143,63,80
050,51,007,"Virginia","Amelia County",3,72,155,76,79
050,51,007,"Virginia","Amelia County",3,73,152,77,75
050,51,007,"Virginia","Amelia County",3,74,167,87,80
050,51,007,"Virginia","Amelia County",3,75,102,53,49
050,51,007,"Virginia","Amelia County",3,76,100,47,53
050,51,007,"Virginia","Amelia County",3,77,109,56,53
050,51,007,"Virginia","Amelia County",3,78,100,45,55
050,51,007,"Virginia","Amelia County",3,79,95,43,52
050,51,007,"Virginia","Amelia County",3,80,79,31,48
050,51,007,"Virginia","Amelia County",3,81,74,33,41
050,51,007,"Virginia","Amelia County",3,82,69,34,35
050,51,007,"Virginia","Amelia County",3,83,57,25,32
050,51,007,"Virginia","Amelia County",3,84,54,19,35
050,51,007,"Virginia","Amelia County",3,85,248,73,175
050,51,007,"Virginia","Amelia County",4,0,120,66,54
050,51,007,"Virginia","Amelia County",4,1,139,76,63
050,51,007,"Virginia","Amelia County",4,2,180,93,87
050,51,007,"Virginia","Amelia County",4,3,140,68,72
050,51,007,"Virginia","Amelia County",4,4,158,95,63
050,51,007,"Virginia","Amelia County",4,5,145,79,66
050,51,007,"Virginia","Amelia County",4,6,152,89,63
050,51,007,"Virginia","Amelia County",4,7,153,85,68
050,51,007,"Virginia","Amelia County",4,8,135,71,64
050,51,007,"Virginia","Amelia County",4,9,152,78,74
050,51,007,"Virginia","Amelia County",4,10,142,74,68
050,51,007,"Virginia","Amelia County",4,11,151,76,75
050,51,007,"Virginia","Amelia County",4,12,164,83,81
050,51,007,"Virginia","Amelia County",4,13,163,76,87
050,51,007,"Virginia","Amelia County",4,14,183,85,98
050,51,007,"Virginia","Amelia County",4,15,171,91,80
050,51,007,"Virginia","Amelia County",4,16,158,80,78
050,51,007,"Virginia","Amelia County",4,17,170,80,90
050,51,007,"Virginia","Amelia County",4,18,136,75,61
050,51,007,"Virginia","Amelia County",4,19,105,62,43
050,51,007,"Virginia","Amelia County",4,20,107,54,53
050,51,007,"Virginia","Amelia County",4,21,133,71,62
050,51,007,"Virginia","Amelia County",4,22,142,67,75
050,51,007,"Virginia","Amelia County",4,23,137,62,75
050,51,007,"Virginia","Amelia County",4,24,147,79,68
050,51,007,"Virginia","Amelia County",4,25,133,63,70
050,51,007,"Virginia","Amelia County",4,26,149,72,77
050,51,007,"Virginia","Amelia County",4,27,143,78,65
050,51,007,"Virginia","Amelia County",4,28,164,74,90
050,51,007,"Virginia","Amelia County",4,29,139,69,70
050,51,007,"Virginia","Amelia County",4,30,146,66,80
050,51,007,"Virginia","Amelia County",4,31,181,90,91
050,51,007,"Virginia","Amelia County",4,32,172,91,81
050,51,007,"Virginia","Amelia County",4,33,157,67,90
050,51,007,"Virginia","Amelia County",4,34,163,79,84
050,51,007,"Virginia","Amelia County",4,35,155,79,76
050,51,007,"Virginia","Amelia County",4,36,167,82,85
050,51,007,"Virginia","Amelia County",4,37,158,78,80
050,51,007,"Virginia","Amelia County",4,38,156,83,73
050,51,007,"Virginia","Amelia County",4,39,155,79,76
050,51,007,"Virginia","Amelia County",4,40,150,82,68
050,51,007,"Virginia","Amelia County",4,41,144,75,69
050,51,007,"Virginia","Amelia County",4,42,149,77,72
050,51,007,"Virginia","Amelia County",4,43,144,71,73
050,51,007,"Virginia","Amelia County",4,44,139,70,69
050,51,007,"Virginia","Amelia County",4,45,149,67,82
050,51,007,"Virginia","Amelia County",4,46,138,66,72
050,51,007,"Virginia","Amelia County",4,47,147,80,67
050,51,007,"Virginia","Amelia County",4,48,146,67,79
050,51,007,"Virginia","Amelia County",4,49,146,72,74
050,51,007,"Virginia","Amelia County",4,50,162,71,91
050,51,007,"Virginia","Amelia County",4,51,190,97,93
050,51,007,"Virginia","Amelia County",4,52,171,85,86
050,51,007,"Virginia","Amelia County",4,53,170,90,80
050,51,007,"Virginia","Amelia County",4,54,196,101,95
050,51,007,"Virginia","Amelia County",4,55,179,82,97
050,51,007,"Virginia","Amelia County",4,56,175,81,94
050,51,007,"Virginia","Amelia County",4,57,209,108,101
050,51,007,"Virginia","Amelia County",4,58,228,115,113
050,51,007,"Virginia","Amelia County",4,59,232,117,115
050,51,007,"Virginia","Amelia County",4,60,229,116,113
050,51,007,"Virginia","Amelia County",4,61,244,116,128
050,51,007,"Virginia","Amelia County",4,62,232,113,119
050,51,007,"Virginia","Amelia County",4,63,226,113,113
050,51,007,"Virginia","Amelia County",4,64,224,106,118
050,51,007,"Virginia","Amelia County",4,65,226,116,110
050,51,007,"Virginia","Amelia County",4,66,214,115,99
050,51,007,"Virginia","Amelia County",4,67,190,106,84
050,51,007,"Virginia","Amelia County",4,68,167,93,74
050,51,007,"Virginia","Amelia County",4,69,165,81,84
050,51,007,"Virginia","Amelia County",4,70,156,77,79
050,51,007,"Virginia","Amelia County",4,71,140,66,74
050,51,007,"Virginia","Amelia County",4,72,139,60,79
050,51,007,"Virginia","Amelia County",4,73,145,69,76
050,51,007,"Virginia","Amelia County",4,74,155,74,81
050,51,007,"Virginia","Amelia County",4,75,152,82,70
050,51,007,"Virginia","Amelia County",4,76,100,51,49
050,51,007,"Virginia","Amelia County",4,77,98,47,51
050,51,007,"Virginia","Amelia County",4,78,96,50,46
050,51,007,"Virginia","Amelia County",4,79,101,45,56
050,51,007,"Virginia","Amelia County",4,80,87,41,46
050,51,007,"Virginia","Amelia County",4,81,72,28,44
050,51,007,"Virginia","Amelia County",4,82,71,30,41
050,51,007,"Virginia","Amelia County",4,83,61,29,32
050,51,007,"Virginia","Amelia County",4,84,60,25,35
050,51,007,"Virginia","Amelia County",4,85,233,73,160
050,51,007,"Virginia","Amelia County",5,0,122,68,54
050,51,007,"Virginia","Amelia County",5,1,135,78,57
050,51,007,"Virginia","Amelia County",5,2,146,80,66
050,51,007,"Virginia","Amelia County",5,3,189,94,95
050,51,007,"Virginia","Amelia County",5,4,153,78,75
050,51,007,"Virginia","Amelia County",5,5,157,96,61
050,51,007,"Virginia","Amelia County",5,6,163,91,72
050,51,007,"Virginia","Amelia County",5,7,157,94,63
050,51,007,"Virginia","Amelia County",5,8,150,81,69
050,51,007,"Virginia","Amelia County",5,9,149,79,70
050,51,007,"Virginia","Amelia County",5,10,151,77,74
050,51,007,"Virginia","Amelia County",5,11,147,79,68
050,51,007,"Virginia","Amelia County",5,12,149,76,73
050,51,007,"Virginia","Amelia County",5,13,160,81,79
050,51,007,"Virginia","Amelia County",5,14,163,78,85
050,51,007,"Virginia","Amelia County",5,15,182,87,95
050,51,007,"Virginia","Amelia County",5,16,170,86,84
050,51,007,"Virginia","Amelia County",5,17,161,84,77
050,51,007,"Virginia","Amelia County",5,18,146,74,72
050,51,007,"Virginia","Amelia County",5,19,107,56,51
050,51,007,"Virginia","Amelia County",5,20,114,61,53
050,51,007,"Virginia","Amelia County",5,21,114,62,52
050,51,007,"Virginia","Amelia County",5,22,137,71,66
050,51,007,"Virginia","Amelia County",5,23,148,71,77
050,51,007,"Virginia","Amelia County",5,24,140,68,72
050,51,007,"Virginia","Amelia County",5,25,152,83,69
050,51,007,"Virginia","Amelia County",5,26,138,67,71
050,51,007,"Virginia","Amelia County",5,27,152,73,79
050,51,007,"Virginia","Amelia County",5,28,152,77,75
050,51,007,"Virginia","Amelia County",5,29,182,86,96
050,51,007,"Virginia","Amelia County",5,30,137,70,67
050,51,007,"Virginia","Amelia County",5,31,163,72,91
050,51,007,"Virginia","Amelia County",5,32,176,88,88
050,51,007,"Virginia","Amelia County",5,33,169,90,79
050,51,007,"Virginia","Amelia County",5,34,154,70,84
050,51,007,"Virginia","Amelia County",5,35,164,85,79
050,51,007,"Virginia","Amelia County",5,36,157,82,75
050,51,007,"Virginia","Amelia County",5,37,173,85,88
050,51,007,"Virginia","Amelia County",5,38,164,82,82
050,51,007,"Virginia","Amelia County",5,39,160,83,77
050,51,007,"Virginia","Amelia County",5,40,159,79,80
050,51,007,"Virginia","Amelia County",5,41,145,77,68
050,51,007,"Virginia","Amelia County",5,42,147,76,71
050,51,007,"Virginia","Amelia County",5,43,157,81,76
050,51,007,"Virginia","Amelia County",5,44,145,71,74
050,51,007,"Virginia","Amelia County",5,45,138,66,72
050,51,007,"Virginia","Amelia County",5,46,151,68,83
050,51,007,"Virginia","Amelia County",5,47,140,66,74
050,51,007,"Virginia","Amelia County",5,48,147,81,66
050,51,007,"Virginia","Amelia County",5,49,143,64,79
050,51,007,"Virginia","Amelia County",5,50,144,68,76
050,51,007,"Virginia","Amelia County",5,51,164,74,90
050,51,007,"Virginia","Amelia County",5,52,190,93,97
050,51,007,"Virginia","Amelia County",5,53,173,79,94
050,51,007,"Virginia","Amelia County",5,54,172,92,80
050,51,007,"Virginia","Amelia County",5,55,192,100,92
050,51,007,"Virginia","Amelia County",5,56,185,85,100
050,51,007,"Virginia","Amelia County",5,57,181,81,100
050,51,007,"Virginia","Amelia County",5,58,211,106,105
050,51,007,"Virginia","Amelia County",5,59,231,114,117
050,51,007,"Virginia","Amelia County",5,60,234,117,117
050,51,007,"Virginia","Amelia County",5,61,233,115,118
050,51,007,"Virginia","Amelia County",5,62,235,113,122
050,51,007,"Virginia","Amelia County",5,63,237,113,124
050,51,007,"Virginia","Amelia County",5,64,223,112,111
050,51,007,"Virginia","Amelia County",5,65,221,104,117
050,51,007,"Virginia","Amelia County",5,66,220,112,108
050,51,007,"Virginia","Amelia County",5,67,219,117,102
050,51,007,"Virginia","Amelia County",5,68,188,107,81
050,51,007,"Virginia","Amelia County",5,69,161,86,75
050,51,007,"Virginia","Amelia County",5,70,165,80,85
050,51,007,"Virginia","Amelia County",5,71,149,74,75
050,51,007,"Virginia","Amelia County",5,72,139,62,77
050,51,007,"Virginia","Amelia County",5,73,126,54,72
050,51,007,"Virginia","Amelia County",5,74,139,64,75
050,51,007,"Virginia","Amelia County",5,75,145,69,76
050,51,007,"Virginia","Amelia County",5,76,143,76,67
050,51,007,"Virginia","Amelia County",5,77,99,50,49
050,51,007,"Virginia","Amelia County",5,78,89,44,45
050,51,007,"Virginia","Amelia County",5,79,93,48,45
050,51,007,"Virginia","Amelia County",5,80,92,41,51
050,51,007,"Virginia","Amelia County",5,81,80,38,42
050,51,007,"Virginia","Amelia County",5,82,68,25,43
050,51,007,"Virginia","Amelia County",5,83,62,26,36
050,51,007,"Virginia","Amelia County",5,84,65,30,35
050,51,007,"Virginia","Amelia County",5,85,237,79,158
050,51,009,"Virginia","Amherst County",1,0,309,160,149
050,51,009,"Virginia","Amherst County",1,1,309,169,140
050,51,009,"Virginia","Amherst County",1,2,354,181,173
050,51,009,"Virginia","Amherst County",1,3,324,175,149
050,51,009,"Virginia","Amherst County",1,4,360,190,170
050,51,009,"Virginia","Amherst County",1,5,358,191,167
050,51,009,"Virginia","Amherst County",1,6,333,173,160
050,51,009,"Virginia","Amherst County",1,7,325,172,153
050,51,009,"Virginia","Amherst County",1,8,347,189,158
050,51,009,"Virginia","Amherst County",1,9,355,204,151
050,51,009,"Virginia","Amherst County",1,10,358,169,189
050,51,009,"Virginia","Amherst County",1,11,369,185,184
050,51,009,"Virginia","Amherst County",1,12,389,203,186
050,51,009,"Virginia","Amherst County",1,13,391,206,185
050,51,009,"Virginia","Amherst County",1,14,372,175,197
050,51,009,"Virginia","Amherst County",1,15,367,170,197
050,51,009,"Virginia","Amherst County",1,16,356,178,178
050,51,009,"Virginia","Amherst County",1,17,331,176,155
050,51,009,"Virginia","Amherst County",1,18,377,179,198
050,51,009,"Virginia","Amherst County",1,19,429,173,256
050,51,009,"Virginia","Amherst County",1,20,424,164,260
050,51,009,"Virginia","Amherst County",1,21,409,176,233
050,51,009,"Virginia","Amherst County",1,22,381,157,224
050,51,009,"Virginia","Amherst County",1,23,364,173,191
050,51,009,"Virginia","Amherst County",1,24,329,163,166
050,51,009,"Virginia","Amherst County",1,25,341,170,171
050,51,009,"Virginia","Amherst County",1,26,360,186,174
050,51,009,"Virginia","Amherst County",1,27,348,185,163
050,51,009,"Virginia","Amherst County",1,28,341,167,174
050,51,009,"Virginia","Amherst County",1,29,364,165,199
050,51,009,"Virginia","Amherst County",1,30,378,181,197
050,51,009,"Virginia","Amherst County",1,31,374,171,203
050,51,009,"Virginia","Amherst County",1,32,344,169,175
050,51,009,"Virginia","Amherst County",1,33,345,177,168
050,51,009,"Virginia","Amherst County",1,34,372,182,190
050,51,009,"Virginia","Amherst County",1,35,347,166,181
050,51,009,"Virginia","Amherst County",1,36,326,156,170
050,51,009,"Virginia","Amherst County",1,37,346,170,176
050,51,009,"Virginia","Amherst County",1,38,343,170,173
050,51,009,"Virginia","Amherst County",1,39,344,170,174
050,51,009,"Virginia","Amherst County",1,40,329,163,166
050,51,009,"Virginia","Amherst County",1,41,332,158,174
050,51,009,"Virginia","Amherst County",1,42,336,168,168
050,51,009,"Virginia","Amherst County",1,43,318,155,163
050,51,009,"Virginia","Amherst County",1,44,302,146,156
050,51,009,"Virginia","Amherst County",1,45,330,154,176
050,51,009,"Virginia","Amherst County",1,46,347,164,183
050,51,009,"Virginia","Amherst County",1,47,392,197,195
050,51,009,"Virginia","Amherst County",1,48,423,206,217
050,51,009,"Virginia","Amherst County",1,49,439,225,214
050,51,009,"Virginia","Amherst County",1,50,397,191,206
050,51,009,"Virginia","Amherst County",1,51,404,191,213
050,51,009,"Virginia","Amherst County",1,52,420,195,225
050,51,009,"Virginia","Amherst County",1,53,409,199,210
050,51,009,"Virginia","Amherst County",1,54,455,234,221
050,51,009,"Virginia","Amherst County",1,55,484,236,248
050,51,009,"Virginia","Amherst County",1,56,454,222,232
050,51,009,"Virginia","Amherst County",1,57,490,225,265
050,51,009,"Virginia","Amherst County",1,58,507,239,268
050,51,009,"Virginia","Amherst County",1,59,488,227,261
050,51,009,"Virginia","Amherst County",1,60,473,222,251
050,51,009,"Virginia","Amherst County",1,61,480,234,246
050,51,009,"Virginia","Amherst County",1,62,472,240,232
050,51,009,"Virginia","Amherst County",1,63,440,222,218
050,51,009,"Virginia","Amherst County",1,64,443,200,243
050,51,009,"Virginia","Amherst County",1,65,401,190,211
050,51,009,"Virginia","Amherst County",1,66,423,198,225
050,51,009,"Virginia","Amherst County",1,67,424,205,219
050,51,009,"Virginia","Amherst County",1,68,405,179,226
050,51,009,"Virginia","Amherst County",1,69,374,178,196
050,51,009,"Virginia","Amherst County",1,70,380,166,214
050,51,009,"Virginia","Amherst County",1,71,393,190,203
050,51,009,"Virginia","Amherst County",1,72,387,184,203
050,51,009,"Virginia","Amherst County",1,73,385,178,207
050,51,009,"Virginia","Amherst County",1,74,268,129,139
050,51,009,"Virginia","Amherst County",1,75,281,135,146
050,51,009,"Virginia","Amherst County",1,76,266,127,139
050,51,009,"Virginia","Amherst County",1,77,279,126,153
050,51,009,"Virginia","Amherst County",1,78,247,112,135
050,51,009,"Virginia","Amherst County",1,79,212,80,132
050,51,009,"Virginia","Amherst County",1,80,218,101,117
050,51,009,"Virginia","Amherst County",1,81,181,78,103
050,51,009,"Virginia","Amherst County",1,82,136,57,79
050,51,009,"Virginia","Amherst County",1,83,129,52,77
050,51,009,"Virginia","Amherst County",1,84,139,68,71
050,51,009,"Virginia","Amherst County",1,85,725,227,498
050,51,009,"Virginia","Amherst County",2,0,292,154,138
050,51,009,"Virginia","Amherst County",2,1,313,171,142
050,51,009,"Virginia","Amherst County",2,2,343,178,165
050,51,009,"Virginia","Amherst County",2,3,330,174,156
050,51,009,"Virginia","Amherst County",2,4,355,188,167
050,51,009,"Virginia","Amherst County",2,5,358,191,167
050,51,009,"Virginia","Amherst County",2,6,340,177,163
050,51,009,"Virginia","Amherst County",2,7,329,174,155
050,51,009,"Virginia","Amherst County",2,8,344,187,157
050,51,009,"Virginia","Amherst County",2,9,352,200,152
050,51,009,"Virginia","Amherst County",2,10,358,177,181
050,51,009,"Virginia","Amherst County",2,11,366,181,185
050,51,009,"Virginia","Amherst County",2,12,387,201,186
050,51,009,"Virginia","Amherst County",2,13,391,205,186
050,51,009,"Virginia","Amherst County",2,14,375,180,195
050,51,009,"Virginia","Amherst County",2,15,368,171,197
050,51,009,"Virginia","Amherst County",2,16,358,177,181
050,51,009,"Virginia","Amherst County",2,17,336,176,160
050,51,009,"Virginia","Amherst County",2,18,373,178,195
050,51,009,"Virginia","Amherst County",2,19,416,163,253
050,51,009,"Virginia","Amherst County",2,20,433,172,261
050,51,009,"Virginia","Amherst County",2,21,408,171,237
050,51,009,"Virginia","Amherst County",2,22,385,162,223
050,51,009,"Virginia","Amherst County",2,23,356,169,187
050,51,009,"Virginia","Amherst County",2,24,333,163,170
050,51,009,"Virginia","Amherst County",2,25,341,171,170
050,51,009,"Virginia","Amherst County",2,26,359,185,174
050,51,009,"Virginia","Amherst County",2,27,353,187,166
050,51,009,"Virginia","Amherst County",2,28,343,169,174
050,51,009,"Virginia","Amherst County",2,29,363,168,195
050,51,009,"Virginia","Amherst County",2,30,383,182,201
050,51,009,"Virginia","Amherst County",2,31,374,174,200
050,51,009,"Virginia","Amherst County",2,32,348,168,180
050,51,009,"Virginia","Amherst County",2,33,346,176,170
050,51,009,"Virginia","Amherst County",2,34,367,183,184
050,51,009,"Virginia","Amherst County",2,35,354,170,184
050,51,009,"Virginia","Amherst County",2,36,330,158,172
050,51,009,"Virginia","Amherst County",2,37,341,168,173
050,51,009,"Virginia","Amherst County",2,38,348,172,176
050,51,009,"Virginia","Amherst County",2,39,342,169,173
050,51,009,"Virginia","Amherst County",2,40,336,166,170
050,51,009,"Virginia","Amherst County",2,41,329,158,171
050,51,009,"Virginia","Amherst County",2,42,333,166,167
050,51,009,"Virginia","Amherst County",2,43,326,159,167
050,51,009,"Virginia","Amherst County",2,44,302,147,155
050,51,009,"Virginia","Amherst County",2,45,325,154,171
050,51,009,"Virginia","Amherst County",2,46,339,159,180
050,51,009,"Virginia","Amherst County",2,47,379,186,193
050,51,009,"Virginia","Amherst County",2,48,413,203,210
050,51,009,"Virginia","Amherst County",2,49,438,222,216
050,51,009,"Virginia","Amherst County",2,50,408,198,210
050,51,009,"Virginia","Amherst County",2,51,401,191,210
050,51,009,"Virginia","Amherst County",2,52,416,193,223
050,51,009,"Virginia","Amherst County",2,53,413,198,215
050,51,009,"Virginia","Amherst County",2,54,441,224,217
050,51,009,"Virginia","Amherst County",2,55,475,235,240
050,51,009,"Virginia","Amherst County",2,56,463,227,236
050,51,009,"Virginia","Amherst County",2,57,483,224,259
050,51,009,"Virginia","Amherst County",2,58,501,236,265
050,51,009,"Virginia","Amherst County",2,59,492,231,261
050,51,009,"Virginia","Amherst County",2,60,477,222,255
050,51,009,"Virginia","Amherst County",2,61,476,228,248
050,51,009,"Virginia","Amherst County",2,62,471,238,233
050,51,009,"Virginia","Amherst County",2,63,453,228,225
050,51,009,"Virginia","Amherst County",2,64,439,204,235
050,51,009,"Virginia","Amherst County",2,65,411,194,217
050,51,009,"Virginia","Amherst County",2,66,417,195,222
050,51,009,"Virginia","Amherst County",2,67,419,200,219
050,51,009,"Virginia","Amherst County",2,68,404,182,222
050,51,009,"Virginia","Amherst County",2,69,385,180,205
050,51,009,"Virginia","Amherst County",2,70,381,170,211
050,51,009,"Virginia","Amherst County",2,71,386,181,205
050,51,009,"Virginia","Amherst County",2,72,381,181,200
050,51,009,"Virginia","Amherst County",2,73,400,185,215
050,51,009,"Virginia","Amherst County",2,74,277,131,146
050,51,009,"Virginia","Amherst County",2,75,282,135,147
050,51,009,"Virginia","Amherst County",2,76,266,127,139
050,51,009,"Virginia","Amherst County",2,77,279,128,151
050,51,009,"Virginia","Amherst County",2,78,246,110,136
050,51,009,"Virginia","Amherst County",2,79,218,87,131
050,51,009,"Virginia","Amherst County",2,80,215,95,120
050,51,009,"Virginia","Amherst County",2,81,187,81,106
050,51,009,"Virginia","Amherst County",2,82,146,62,84
050,51,009,"Virginia","Amherst County",2,83,130,53,77
050,51,009,"Virginia","Amherst County",2,84,136,64,72
050,51,009,"Virginia","Amherst County",2,85,726,229,497
050,51,009,"Virginia","Amherst County",3,0,309,158,151
050,51,009,"Virginia","Amherst County",3,1,302,157,145
050,51,009,"Virginia","Amherst County",3,2,328,177,151
050,51,009,"Virginia","Amherst County",3,3,374,189,185
050,51,009,"Virginia","Amherst County",3,4,325,172,153
050,51,009,"Virginia","Amherst County",3,5,359,192,167
050,51,009,"Virginia","Amherst County",3,6,354,192,162
050,51,009,"Virginia","Amherst County",3,7,344,178,166
050,51,009,"Virginia","Amherst County",3,8,334,169,165
050,51,009,"Virginia","Amherst County",3,9,336,180,156
050,51,009,"Virginia","Amherst County",3,10,355,201,154
050,51,009,"Virginia","Amherst County",3,11,355,182,173
050,51,009,"Virginia","Amherst County",3,12,385,188,197
050,51,009,"Virginia","Amherst County",3,13,385,198,187
050,51,009,"Virginia","Amherst County",3,14,394,209,185
050,51,009,"Virginia","Amherst County",3,15,371,179,192
050,51,009,"Virginia","Amherst County",3,16,371,178,193
050,51,009,"Virginia","Amherst County",3,17,353,174,179
050,51,009,"Virginia","Amherst County",3,18,368,169,199
050,51,009,"Virginia","Amherst County",3,19,396,158,238
050,51,009,"Virginia","Amherst County",3,20,447,183,264
050,51,009,"Virginia","Amherst County",3,21,418,173,245
050,51,009,"Virginia","Amherst County",3,22,379,171,208
050,51,009,"Virginia","Amherst County",3,23,325,160,165
050,51,009,"Virginia","Amherst County",3,24,334,168,166
050,51,009,"Virginia","Amherst County",3,25,331,156,175
050,51,009,"Virginia","Amherst County",3,26,316,163,153
050,51,009,"Virginia","Amherst County",3,27,361,182,179
050,51,009,"Virginia","Amherst County",3,28,336,182,154
050,51,009,"Virginia","Amherst County",3,29,349,164,185
050,51,009,"Virginia","Amherst County",3,30,389,190,199
050,51,009,"Virginia","Amherst County",3,31,410,188,222
050,51,009,"Virginia","Amherst County",3,32,393,184,209
050,51,009,"Virginia","Amherst County",3,33,375,176,199
050,51,009,"Virginia","Amherst County",3,34,366,179,187
050,51,009,"Virginia","Amherst County",3,35,375,187,188
050,51,009,"Virginia","Amherst County",3,36,374,189,185
050,51,009,"Virginia","Amherst County",3,37,328,155,173
050,51,009,"Virginia","Amherst County",3,38,344,164,180
050,51,009,"Virginia","Amherst County",3,39,351,170,181
050,51,009,"Virginia","Amherst County",3,40,351,172,179
050,51,009,"Virginia","Amherst County",3,41,340,173,167
050,51,009,"Virginia","Amherst County",3,42,322,153,169
050,51,009,"Virginia","Amherst County",3,43,338,172,166
050,51,009,"Virginia","Amherst County",3,44,318,157,161
050,51,009,"Virginia","Amherst County",3,45,287,144,143
050,51,009,"Virginia","Amherst County",3,46,329,152,177
050,51,009,"Virginia","Amherst County",3,47,346,164,182
050,51,009,"Virginia","Amherst County",3,48,374,184,190
050,51,009,"Virginia","Amherst County",3,49,401,191,210
050,51,009,"Virginia","Amherst County",3,50,437,223,214
050,51,009,"Virginia","Amherst County",3,51,399,192,207
050,51,009,"Virginia","Amherst County",3,52,393,189,204
050,51,009,"Virginia","Amherst County",3,53,409,187,222
050,51,009,"Virginia","Amherst County",3,54,417,200,217
050,51,009,"Virginia","Amherst County",3,55,444,231,213
050,51,009,"Virginia","Amherst County",3,56,464,225,239
050,51,009,"Virginia","Amherst County",3,57,459,222,237
050,51,009,"Virginia","Amherst County",3,58,463,212,251
050,51,009,"Virginia","Amherst County",3,59,513,246,267
050,51,009,"Virginia","Amherst County",3,60,487,228,259
050,51,009,"Virginia","Amherst County",3,61,473,219,254
050,51,009,"Virginia","Amherst County",3,62,464,216,248
050,51,009,"Virginia","Amherst County",3,63,473,241,232
050,51,009,"Virginia","Amherst County",3,64,448,228,220
050,51,009,"Virginia","Amherst County",3,65,436,201,235
050,51,009,"Virginia","Amherst County",3,66,413,196,217
050,51,009,"Virginia","Amherst County",3,67,416,200,216
050,51,009,"Virginia","Amherst County",3,68,423,203,220
050,51,009,"Virginia","Amherst County",3,69,401,182,219
050,51,009,"Virginia","Amherst County",3,70,385,177,208
050,51,009,"Virginia","Amherst County",3,71,373,172,201
050,51,009,"Virginia","Amherst County",3,72,368,172,196
050,51,009,"Virginia","Amherst County",3,73,377,177,200
050,51,009,"Virginia","Amherst County",3,74,387,184,203
050,51,009,"Virginia","Amherst County",3,75,263,124,139
050,51,009,"Virginia","Amherst County",3,76,273,132,141
050,51,009,"Virginia","Amherst County",3,77,250,114,136
050,51,009,"Virginia","Amherst County",3,78,267,120,147
050,51,009,"Virginia","Amherst County",3,79,236,102,134
050,51,009,"Virginia","Amherst County",3,80,209,87,122
050,51,009,"Virginia","Amherst County",3,81,202,83,119
050,51,009,"Virginia","Amherst County",3,82,173,73,100
050,51,009,"Virginia","Amherst County",3,83,135,53,82
050,51,009,"Virginia","Amherst County",3,84,127,49,78
050,51,009,"Virginia","Amherst County",3,85,723,237,486
050,51,009,"Virginia","Amherst County",4,0,283,155,128
050,51,009,"Virginia","Amherst County",4,1,320,162,158
050,51,009,"Virginia","Amherst County",4,2,316,164,152
050,51,009,"Virginia","Amherst County",4,3,337,186,151
050,51,009,"Virginia","Amherst County",4,4,385,187,198
050,51,009,"Virginia","Amherst County",4,5,325,173,152
050,51,009,"Virginia","Amherst County",4,6,360,193,167
050,51,009,"Virginia","Amherst County",4,7,357,194,163
050,51,009,"Virginia","Amherst County",4,8,340,176,164
050,51,009,"Virginia","Amherst County",4,9,349,173,176
050,51,009,"Virginia","Amherst County",4,10,328,178,150
050,51,009,"Virginia","Amherst County",4,11,360,205,155
050,51,009,"Virginia","Amherst County",4,12,350,180,170
050,51,009,"Virginia","Amherst County",4,13,374,186,188
050,51,009,"Virginia","Amherst County",4,14,379,190,189
050,51,009,"Virginia","Amherst County",4,15,385,199,186
050,51,009,"Virginia","Amherst County",4,16,370,179,191
050,51,009,"Virginia","Amherst County",4,17,376,180,196
050,51,009,"Virginia","Amherst County",4,18,381,170,211
050,51,009,"Virginia","Amherst County",4,19,387,141,246
050,51,009,"Virginia","Amherst County",4,20,418,173,245
050,51,009,"Virginia","Amherst County",4,21,425,177,248
050,51,009,"Virginia","Amherst County",4,22,392,169,223
050,51,009,"Virginia","Amherst County",4,23,345,173,172
050,51,009,"Virginia","Amherst County",4,24,350,176,174
050,51,009,"Virginia","Amherst County",4,25,345,175,170
050,51,009,"Virginia","Amherst County",4,26,330,160,170
050,51,009,"Virginia","Amherst County",4,27,333,174,159
050,51,009,"Virginia","Amherst County",4,28,363,188,175
050,51,009,"Virginia","Amherst County",4,29,335,179,156
050,51,009,"Virginia","Amherst County",4,30,342,159,183
050,51,009,"Virginia","Amherst County",4,31,401,198,203
050,51,009,"Virginia","Amherst County",4,32,413,185,228
050,51,009,"Virginia","Amherst County",4,33,398,187,211
050,51,009,"Virginia","Amherst County",4,34,365,169,196
050,51,009,"Virginia","Amherst County",4,35,371,185,186
050,51,009,"Virginia","Amherst County",4,36,381,192,189
050,51,009,"Virginia","Amherst County",4,37,377,188,189
050,51,009,"Virginia","Amherst County",4,38,328,154,174
050,51,009,"Virginia","Amherst County",4,39,356,173,183
050,51,009,"Virginia","Amherst County",4,40,363,177,186
050,51,009,"Virginia","Amherst County",4,41,352,167,185
050,51,009,"Virginia","Amherst County",4,42,342,171,171
050,51,009,"Virginia","Amherst County",4,43,316,148,168
050,51,009,"Virginia","Amherst County",4,44,328,167,161
050,51,009,"Virginia","Amherst County",4,45,315,157,158
050,51,009,"Virginia","Amherst County",4,46,292,146,146
050,51,009,"Virginia","Amherst County",4,47,322,151,171
050,51,009,"Virginia","Amherst County",4,48,349,165,184
050,51,009,"Virginia","Amherst County",4,49,372,190,182
050,51,009,"Virginia","Amherst County",4,50,398,190,208
050,51,009,"Virginia","Amherst County",4,51,427,212,215
050,51,009,"Virginia","Amherst County",4,52,404,194,210
050,51,009,"Virginia","Amherst County",4,53,390,189,201
050,51,009,"Virginia","Amherst County",4,54,419,193,226
050,51,009,"Virginia","Amherst County",4,55,423,205,218
050,51,009,"Virginia","Amherst County",4,56,446,234,212
050,51,009,"Virginia","Amherst County",4,57,480,235,245
050,51,009,"Virginia","Amherst County",4,58,447,215,232
050,51,009,"Virginia","Amherst County",4,59,467,216,251
050,51,009,"Virginia","Amherst County",4,60,506,241,265
050,51,009,"Virginia","Amherst County",4,61,497,239,258
050,51,009,"Virginia","Amherst County",4,62,475,223,252
050,51,009,"Virginia","Amherst County",4,63,469,221,248
050,51,009,"Virginia","Amherst County",4,64,468,243,225
050,51,009,"Virginia","Amherst County",4,65,446,226,220
050,51,009,"Virginia","Amherst County",4,66,448,205,243
050,51,009,"Virginia","Amherst County",4,67,416,196,220
050,51,009,"Virginia","Amherst County",4,68,417,194,223
050,51,009,"Virginia","Amherst County",4,69,408,199,209
050,51,009,"Virginia","Amherst County",4,70,396,177,219
050,51,009,"Virginia","Amherst County",4,71,377,174,203
050,51,009,"Virginia","Amherst County",4,72,365,174,191
050,51,009,"Virginia","Amherst County",4,73,360,167,193
050,51,009,"Virginia","Amherst County",4,74,364,172,192
050,51,009,"Virginia","Amherst County",4,75,376,180,196
050,51,009,"Virginia","Amherst County",4,76,258,119,139
050,51,009,"Virginia","Amherst County",4,77,262,123,139
050,51,009,"Virginia","Amherst County",4,78,227,104,123
050,51,009,"Virginia","Amherst County",4,79,249,107,142
050,51,009,"Virginia","Amherst County",4,80,229,102,127
050,51,009,"Virginia","Amherst County",4,81,193,74,119
050,51,009,"Virginia","Amherst County",4,82,187,77,110
050,51,009,"Virginia","Amherst County",4,83,164,65,99
050,51,009,"Virginia","Amherst County",4,84,125,48,77
050,51,009,"Virginia","Amherst County",4,85,708,233,475
050,51,009,"Virginia","Amherst County",5,0,273,151,122
050,51,009,"Virginia","Amherst County",5,1,304,158,146
050,51,009,"Virginia","Amherst County",5,2,339,164,175
050,51,009,"Virginia","Amherst County",5,3,322,160,162
050,51,009,"Virginia","Amherst County",5,4,333,179,154
050,51,009,"Virginia","Amherst County",5,5,392,194,198
050,51,009,"Virginia","Amherst County",5,6,341,176,165
050,51,009,"Virginia","Amherst County",5,7,366,192,174
050,51,009,"Virginia","Amherst County",5,8,345,189,156
050,51,009,"Virginia","Amherst County",5,9,355,187,168
050,51,009,"Virginia","Amherst County",5,10,337,166,171
050,51,009,"Virginia","Amherst County",5,11,332,181,151
050,51,009,"Virginia","Amherst County",5,12,351,200,151
050,51,009,"Virginia","Amherst County",5,13,340,179,161
050,51,009,"Virginia","Amherst County",5,14,369,182,187
050,51,009,"Virginia","Amherst County",5,15,369,190,179
050,51,009,"Virginia","Amherst County",5,16,378,198,180
050,51,009,"Virginia","Amherst County",5,17,360,178,182
050,51,009,"Virginia","Amherst County",5,18,394,171,223
050,51,009,"Virginia","Amherst County",5,19,386,141,245
050,51,009,"Virginia","Amherst County",5,20,400,146,254
050,51,009,"Virginia","Amherst County",5,21,403,170,233
050,51,009,"Virginia","Amherst County",5,22,395,170,225
050,51,009,"Virginia","Amherst County",5,23,354,174,180
050,51,009,"Virginia","Amherst County",5,24,350,185,165
050,51,009,"Virginia","Amherst County",5,25,356,186,170
050,51,009,"Virginia","Amherst County",5,26,343,172,171
050,51,009,"Virginia","Amherst County",5,27,329,155,174
050,51,009,"Virginia","Amherst County",5,28,336,180,156
050,51,009,"Virginia","Amherst County",5,29,380,196,184
050,51,009,"Virginia","Amherst County",5,30,348,183,165
050,51,009,"Virginia","Amherst County",5,31,358,171,187
050,51,009,"Virginia","Amherst County",5,32,401,199,202
050,51,009,"Virginia","Amherst County",5,33,400,179,221
050,51,009,"Virginia","Amherst County",5,34,415,195,220
050,51,009,"Virginia","Amherst County",5,35,361,175,186
050,51,009,"Virginia","Amherst County",5,36,370,184,186
050,51,009,"Virginia","Amherst County",5,37,375,185,190
050,51,009,"Virginia","Amherst County",5,38,368,181,187
050,51,009,"Virginia","Amherst County",5,39,345,164,181
050,51,009,"Virginia","Amherst County",5,40,346,173,173
050,51,009,"Virginia","Amherst County",5,41,362,174,188
050,51,009,"Virginia","Amherst County",5,42,357,168,189
050,51,009,"Virginia","Amherst County",5,43,336,168,168
050,51,009,"Virginia","Amherst County",5,44,322,153,169
050,51,009,"Virginia","Amherst County",5,45,334,169,165
050,51,009,"Virginia","Amherst County",5,46,317,161,156
050,51,009,"Virginia","Amherst County",5,47,296,151,145
050,51,009,"Virginia","Amherst County",5,48,320,150,170
050,51,009,"Virginia","Amherst County",5,49,337,153,184
050,51,009,"Virginia","Amherst County",5,50,379,194,185
050,51,009,"Virginia","Amherst County",5,51,405,192,213
050,51,009,"Virginia","Amherst County",5,52,416,215,201
050,51,009,"Virginia","Amherst County",5,53,397,192,205
050,51,009,"Virginia","Amherst County",5,54,395,189,206
050,51,009,"Virginia","Amherst County",5,55,416,188,228
050,51,009,"Virginia","Amherst County",5,56,432,213,219
050,51,009,"Virginia","Amherst County",5,57,442,238,204
050,51,009,"Virginia","Amherst County",5,58,489,239,250
050,51,009,"Virginia","Amherst County",5,59,447,214,233
050,51,009,"Virginia","Amherst County",5,60,453,203,250
050,51,009,"Virginia","Amherst County",5,61,503,240,263
050,51,009,"Virginia","Amherst County",5,62,483,231,252
050,51,009,"Virginia","Amherst County",5,63,468,215,253
050,51,009,"Virginia","Amherst County",5,64,458,216,242
050,51,009,"Virginia","Amherst County",5,65,473,247,226
050,51,009,"Virginia","Amherst County",5,66,436,219,217
050,51,009,"Virginia","Amherst County",5,67,445,207,238
050,51,009,"Virginia","Amherst County",5,68,418,192,226
050,51,009,"Virginia","Amherst County",5,69,414,194,220
050,51,009,"Virginia","Amherst County",5,70,399,192,207
050,51,009,"Virginia","Amherst County",5,71,387,172,215
050,51,009,"Virginia","Amherst County",5,72,361,167,194
050,51,009,"Virginia","Amherst County",5,73,357,168,189
050,51,009,"Virginia","Amherst County",5,74,344,162,182
050,51,009,"Virginia","Amherst County",5,75,361,169,192
050,51,009,"Virginia","Amherst County",5,76,370,173,197
050,51,009,"Virginia","Amherst County",5,77,243,110,133
050,51,009,"Virginia","Amherst County",5,78,243,114,129
050,51,009,"Virginia","Amherst County",5,79,210,92,118
050,51,009,"Virginia","Amherst County",5,80,235,104,131
050,51,009,"Virginia","Amherst County",5,81,216,91,125
050,51,009,"Virginia","Amherst County",5,82,180,67,113
050,51,009,"Virginia","Amherst County",5,83,174,69,105
050,51,009,"Virginia","Amherst County",5,84,153,61,92
050,51,009,"Virginia","Amherst County",5,85,694,228,466
050,51,011,"Virginia","Appomattox County",1,0,199,101,98
050,51,011,"Virginia","Appomattox County",1,1,206,101,105
050,51,011,"Virginia","Appomattox County",1,2,193,91,102
050,51,011,"Virginia","Appomattox County",1,3,192,103,89
050,51,011,"Virginia","Appomattox County",1,4,196,90,106
050,51,011,"Virginia","Appomattox County",1,5,185,99,86
050,51,011,"Virginia","Appomattox County",1,6,175,100,75
050,51,011,"Virginia","Appomattox County",1,7,200,115,85
050,51,011,"Virginia","Appomattox County",1,8,197,101,96
050,51,011,"Virginia","Appomattox County",1,9,171,88,83
050,51,011,"Virginia","Appomattox County",1,10,198,90,108
050,51,011,"Virginia","Appomattox County",1,11,205,104,101
050,51,011,"Virginia","Appomattox County",1,12,190,94,96
050,51,011,"Virginia","Appomattox County",1,13,189,91,98
050,51,011,"Virginia","Appomattox County",1,14,190,91,99
050,51,011,"Virginia","Appomattox County",1,15,202,112,90
050,51,011,"Virginia","Appomattox County",1,16,218,110,108
050,51,011,"Virginia","Appomattox County",1,17,190,86,104
050,51,011,"Virginia","Appomattox County",1,18,163,82,81
050,51,011,"Virginia","Appomattox County",1,19,142,79,63
050,51,011,"Virginia","Appomattox County",1,20,167,87,80
050,51,011,"Virginia","Appomattox County",1,21,163,83,80
050,51,011,"Virginia","Appomattox County",1,22,160,73,87
050,51,011,"Virginia","Appomattox County",1,23,177,87,90
050,51,011,"Virginia","Appomattox County",1,24,182,94,88
050,51,011,"Virginia","Appomattox County",1,25,200,104,96
050,51,011,"Virginia","Appomattox County",1,26,193,94,99
050,51,011,"Virginia","Appomattox County",1,27,191,96,95
050,51,011,"Virginia","Appomattox County",1,28,199,108,91
050,51,011,"Virginia","Appomattox County",1,29,192,97,95
050,51,011,"Virginia","Appomattox County",1,30,198,92,106
050,51,011,"Virginia","Appomattox County",1,31,191,97,94
050,51,011,"Virginia","Appomattox County",1,32,201,107,94
050,51,011,"Virginia","Appomattox County",1,33,198,92,106
050,51,011,"Virginia","Appomattox County",1,34,189,79,110
050,51,011,"Virginia","Appomattox County",1,35,191,85,106
050,51,011,"Virginia","Appomattox County",1,36,197,101,96
050,51,011,"Virginia","Appomattox County",1,37,205,104,101
050,51,011,"Virginia","Appomattox County",1,38,202,104,98
050,51,011,"Virginia","Appomattox County",1,39,193,96,97
050,51,011,"Virginia","Appomattox County",1,40,190,93,97
050,51,011,"Virginia","Appomattox County",1,41,178,90,88
050,51,011,"Virginia","Appomattox County",1,42,191,98,93
050,51,011,"Virginia","Appomattox County",1,43,166,78,88
050,51,011,"Virginia","Appomattox County",1,44,146,76,70
050,51,011,"Virginia","Appomattox County",1,45,172,85,87
050,51,011,"Virginia","Appomattox County",1,46,190,100,90
050,51,011,"Virginia","Appomattox County",1,47,204,106,98
050,51,011,"Virginia","Appomattox County",1,48,208,104,104
050,51,011,"Virginia","Appomattox County",1,49,234,120,114
050,51,011,"Virginia","Appomattox County",1,50,213,106,107
050,51,011,"Virginia","Appomattox County",1,51,188,101,87
050,51,011,"Virginia","Appomattox County",1,52,199,96,103
050,51,011,"Virginia","Appomattox County",1,53,195,98,97
050,51,011,"Virginia","Appomattox County",1,54,205,101,104
050,51,011,"Virginia","Appomattox County",1,55,220,102,118
050,51,011,"Virginia","Appomattox County",1,56,227,111,116
050,51,011,"Virginia","Appomattox County",1,57,232,118,114
050,51,011,"Virginia","Appomattox County",1,58,242,116,126
050,51,011,"Virginia","Appomattox County",1,59,242,117,125
050,51,011,"Virginia","Appomattox County",1,60,222,105,117
050,51,011,"Virginia","Appomattox County",1,61,253,118,135
050,51,011,"Virginia","Appomattox County",1,62,258,126,132
050,51,011,"Virginia","Appomattox County",1,63,243,119,124
050,51,011,"Virginia","Appomattox County",1,64,206,101,105
050,51,011,"Virginia","Appomattox County",1,65,205,95,110
050,51,011,"Virginia","Appomattox County",1,66,225,97,128
050,51,011,"Virginia","Appomattox County",1,67,215,94,121
050,51,011,"Virginia","Appomattox County",1,68,187,82,105
050,51,011,"Virginia","Appomattox County",1,69,168,81,87
050,51,011,"Virginia","Appomattox County",1,70,189,91,98
050,51,011,"Virginia","Appomattox County",1,71,190,97,93
050,51,011,"Virginia","Appomattox County",1,72,193,97,96
050,51,011,"Virginia","Appomattox County",1,73,192,91,101
050,51,011,"Virginia","Appomattox County",1,74,143,67,76
050,51,011,"Virginia","Appomattox County",1,75,149,72,77
050,51,011,"Virginia","Appomattox County",1,76,143,73,70
050,51,011,"Virginia","Appomattox County",1,77,139,70,69
050,51,011,"Virginia","Appomattox County",1,78,131,63,68
050,51,011,"Virginia","Appomattox County",1,79,121,52,69
050,51,011,"Virginia","Appomattox County",1,80,98,44,54
050,51,011,"Virginia","Appomattox County",1,81,95,41,54
050,51,011,"Virginia","Appomattox County",1,82,82,36,46
050,51,011,"Virginia","Appomattox County",1,83,53,20,33
050,51,011,"Virginia","Appomattox County",1,84,59,33,26
050,51,011,"Virginia","Appomattox County",1,85,325,114,211
050,51,011,"Virginia","Appomattox County",2,0,193,99,94
050,51,011,"Virginia","Appomattox County",2,1,202,100,102
050,51,011,"Virginia","Appomattox County",2,2,198,95,103
050,51,011,"Virginia","Appomattox County",2,3,196,102,94
050,51,011,"Virginia","Appomattox County",2,4,196,94,102
050,51,011,"Virginia","Appomattox County",2,5,191,99,92
050,51,011,"Virginia","Appomattox County",2,6,181,102,79
050,51,011,"Virginia","Appomattox County",2,7,195,112,83
050,51,011,"Virginia","Appomattox County",2,8,195,103,92
050,51,011,"Virginia","Appomattox County",2,9,178,91,87
050,51,011,"Virginia","Appomattox County",2,10,193,90,103
050,51,011,"Virginia","Appomattox County",2,11,201,99,102
050,51,011,"Virginia","Appomattox County",2,12,195,97,98
050,51,011,"Virginia","Appomattox County",2,13,189,91,98
050,51,011,"Virginia","Appomattox County",2,14,190,93,97
050,51,011,"Virginia","Appomattox County",2,15,200,108,92
050,51,011,"Virginia","Appomattox County",2,16,216,111,105
050,51,011,"Virginia","Appomattox County",2,17,198,93,105
050,51,011,"Virginia","Appomattox County",2,18,160,79,81
050,51,011,"Virginia","Appomattox County",2,19,143,77,66
050,51,011,"Virginia","Appomattox County",2,20,165,86,79
050,51,011,"Virginia","Appomattox County",2,21,165,84,81
050,51,011,"Virginia","Appomattox County",2,22,163,77,86
050,51,011,"Virginia","Appomattox County",2,23,174,84,90
050,51,011,"Virginia","Appomattox County",2,24,185,95,90
050,51,011,"Virginia","Appomattox County",2,25,197,103,94
050,51,011,"Virginia","Appomattox County",2,26,195,97,98
050,51,011,"Virginia","Appomattox County",2,27,194,98,96
050,51,011,"Virginia","Appomattox County",2,28,197,106,91
050,51,011,"Virginia","Appomattox County",2,29,196,101,95
050,51,011,"Virginia","Appomattox County",2,30,200,96,104
050,51,011,"Virginia","Appomattox County",2,31,192,95,97
050,51,011,"Virginia","Appomattox County",2,32,198,103,95
050,51,011,"Virginia","Appomattox County",2,33,202,97,105
050,51,011,"Virginia","Appomattox County",2,34,191,81,110
050,51,011,"Virginia","Appomattox County",2,35,194,86,108
050,51,011,"Virginia","Appomattox County",2,36,195,97,98
050,51,011,"Virginia","Appomattox County",2,37,204,104,100
050,51,011,"Virginia","Appomattox County",2,38,202,103,99
050,51,011,"Virginia","Appomattox County",2,39,194,98,96
050,51,011,"Virginia","Appomattox County",2,40,193,95,98
050,51,011,"Virginia","Appomattox County",2,41,181,90,91
050,51,011,"Virginia","Appomattox County",2,42,187,95,92
050,51,011,"Virginia","Appomattox County",2,43,174,84,90
050,51,011,"Virginia","Appomattox County",2,44,151,76,75
050,51,011,"Virginia","Appomattox County",2,45,166,84,82
050,51,011,"Virginia","Appomattox County",2,46,186,97,89
050,51,011,"Virginia","Appomattox County",2,47,200,104,96
050,51,011,"Virginia","Appomattox County",2,48,207,104,103
050,51,011,"Virginia","Appomattox County",2,49,227,116,111
050,51,011,"Virginia","Appomattox County",2,50,218,111,107
050,51,011,"Virginia","Appomattox County",2,51,193,102,91
050,51,011,"Virginia","Appomattox County",2,52,198,98,100
050,51,011,"Virginia","Appomattox County",2,53,197,99,98
050,51,011,"Virginia","Appomattox County",2,54,200,99,101
050,51,011,"Virginia","Appomattox County",2,55,216,101,115
050,51,011,"Virginia","Appomattox County",2,56,227,109,118
050,51,011,"Virginia","Appomattox County",2,57,233,118,115
050,51,011,"Virginia","Appomattox County",2,58,239,116,123
050,51,011,"Virginia","Appomattox County",2,59,242,117,125
050,51,011,"Virginia","Appomattox County",2,60,225,107,118
050,51,011,"Virginia","Appomattox County",2,61,244,114,130
050,51,011,"Virginia","Appomattox County",2,62,255,123,132
050,51,011,"Virginia","Appomattox County",2,63,249,122,127
050,51,011,"Virginia","Appomattox County",2,64,215,106,109
050,51,011,"Virginia","Appomattox County",2,65,205,96,109
050,51,011,"Virginia","Appomattox County",2,66,222,97,125
050,51,011,"Virginia","Appomattox County",2,67,215,94,121
050,51,011,"Virginia","Appomattox County",2,68,193,85,108
050,51,011,"Virginia","Appomattox County",2,69,172,82,90
050,51,011,"Virginia","Appomattox County",2,70,184,89,95
050,51,011,"Virginia","Appomattox County",2,71,189,95,94
050,51,011,"Virginia","Appomattox County",2,72,190,96,94
050,51,011,"Virginia","Appomattox County",2,73,199,95,104
050,51,011,"Virginia","Appomattox County",2,74,145,68,77
050,51,011,"Virginia","Appomattox County",2,75,146,71,75
050,51,011,"Virginia","Appomattox County",2,76,139,70,69
050,51,011,"Virginia","Appomattox County",2,77,144,73,71
050,51,011,"Virginia","Appomattox County",2,78,130,63,67
050,51,011,"Virginia","Appomattox County",2,79,120,54,66
050,51,011,"Virginia","Appomattox County",2,80,105,46,59
050,51,011,"Virginia","Appomattox County",2,81,91,40,51
050,51,011,"Virginia","Appomattox County",2,82,85,37,48
050,51,011,"Virginia","Appomattox County",2,83,57,23,34
050,51,011,"Virginia","Appomattox County",2,84,56,30,26
050,51,011,"Virginia","Appomattox County",2,85,331,117,214
050,51,011,"Virginia","Appomattox County",3,0,199,104,95
050,51,011,"Virginia","Appomattox County",3,1,212,115,97
050,51,011,"Virginia","Appomattox County",3,2,207,100,107
050,51,011,"Virginia","Appomattox County",3,3,207,102,105
050,51,011,"Virginia","Appomattox County",3,4,196,97,99
050,51,011,"Virginia","Appomattox County",3,5,209,102,107
050,51,011,"Virginia","Appomattox County",3,6,196,100,96
050,51,011,"Virginia","Appomattox County",3,7,182,100,82
050,51,011,"Virginia","Appomattox County",3,8,191,111,80
050,51,011,"Virginia","Appomattox County",3,9,198,102,96
050,51,011,"Virginia","Appomattox County",3,10,195,98,97
050,51,011,"Virginia","Appomattox County",3,11,193,84,109
050,51,011,"Virginia","Appomattox County",3,12,205,98,107
050,51,011,"Virginia","Appomattox County",3,13,197,101,96
050,51,011,"Virginia","Appomattox County",3,14,188,89,99
050,51,011,"Virginia","Appomattox County",3,15,196,98,98
050,51,011,"Virginia","Appomattox County",3,16,183,96,87
050,51,011,"Virginia","Appomattox County",3,17,214,109,105
050,51,011,"Virginia","Appomattox County",3,18,167,82,85
050,51,011,"Virginia","Appomattox County",3,19,133,66,67
050,51,011,"Virginia","Appomattox County",3,20,158,84,74
050,51,011,"Virginia","Appomattox County",3,21,170,81,89
050,51,011,"Virginia","Appomattox County",3,22,169,84,85
050,51,011,"Virginia","Appomattox County",3,23,175,84,91
050,51,011,"Virginia","Appomattox County",3,24,182,86,96
050,51,011,"Virginia","Appomattox County",3,25,207,108,99
050,51,011,"Virginia","Appomattox County",3,26,195,110,85
050,51,011,"Virginia","Appomattox County",3,27,191,93,98
050,51,011,"Virginia","Appomattox County",3,28,207,102,105
050,51,011,"Virginia","Appomattox County",3,29,203,103,100
050,51,011,"Virginia","Appomattox County",3,30,215,109,106
050,51,011,"Virginia","Appomattox County",3,31,201,103,98
050,51,011,"Virginia","Appomattox County",3,32,186,94,92
050,51,011,"Virginia","Appomattox County",3,33,217,114,103
050,51,011,"Virginia","Appomattox County",3,34,211,100,111
050,51,011,"Virginia","Appomattox County",3,35,188,76,112
050,51,011,"Virginia","Appomattox County",3,36,194,87,107
050,51,011,"Virginia","Appomattox County",3,37,200,103,97
050,51,011,"Virginia","Appomattox County",3,38,200,104,96
050,51,011,"Virginia","Appomattox County",3,39,196,98,98
050,51,011,"Virginia","Appomattox County",3,40,203,104,99
050,51,011,"Virginia","Appomattox County",3,41,194,94,100
050,51,011,"Virginia","Appomattox County",3,42,179,86,93
050,51,011,"Virginia","Appomattox County",3,43,182,96,86
050,51,011,"Virginia","Appomattox County",3,44,179,87,92
050,51,011,"Virginia","Appomattox County",3,45,152,77,75
050,51,011,"Virginia","Appomattox County",3,46,160,79,81
050,51,011,"Virginia","Appomattox County",3,47,194,96,98
050,51,011,"Virginia","Appomattox County",3,48,207,110,97
050,51,011,"Virginia","Appomattox County",3,49,199,105,94
050,51,011,"Virginia","Appomattox County",3,50,234,119,115
050,51,011,"Virginia","Appomattox County",3,51,227,117,110
050,51,011,"Virginia","Appomattox County",3,52,197,104,93
050,51,011,"Virginia","Appomattox County",3,53,198,97,101
050,51,011,"Virginia","Appomattox County",3,54,193,94,99
050,51,011,"Virginia","Appomattox County",3,55,208,99,109
050,51,011,"Virginia","Appomattox County",3,56,214,101,113
050,51,011,"Virginia","Appomattox County",3,57,229,110,119
050,51,011,"Virginia","Appomattox County",3,58,236,122,114
050,51,011,"Virginia","Appomattox County",3,59,250,123,127
050,51,011,"Virginia","Appomattox County",3,60,245,115,130
050,51,011,"Virginia","Appomattox County",3,61,223,105,118
050,51,011,"Virginia","Appomattox County",3,62,250,116,134
050,51,011,"Virginia","Appomattox County",3,63,247,116,131
050,51,011,"Virginia","Appomattox County",3,64,262,132,130
050,51,011,"Virginia","Appomattox County",3,65,214,107,107
050,51,011,"Virginia","Appomattox County",3,66,203,93,110
050,51,011,"Virginia","Appomattox County",3,67,220,97,123
050,51,011,"Virginia","Appomattox County",3,68,209,93,116
050,51,011,"Virginia","Appomattox County",3,69,198,85,113
050,51,011,"Virginia","Appomattox County",3,70,166,76,90
050,51,011,"Virginia","Appomattox County",3,71,179,85,94
050,51,011,"Virginia","Appomattox County",3,72,188,96,92
050,51,011,"Virginia","Appomattox County",3,73,185,90,95
050,51,011,"Virginia","Appomattox County",3,74,198,95,103
050,51,011,"Virginia","Appomattox County",3,75,141,65,76
050,51,011,"Virginia","Appomattox County",3,76,140,68,72
050,51,011,"Virginia","Appomattox County",3,77,134,66,68
050,51,011,"Virginia","Appomattox County",3,78,141,71,70
050,51,011,"Virginia","Appomattox County",3,79,130,62,68
050,51,011,"Virginia","Appomattox County",3,80,113,49,64
050,51,011,"Virginia","Appomattox County",3,81,89,35,54
050,51,011,"Virginia","Appomattox County",3,82,89,37,52
050,51,011,"Virginia","Appomattox County",3,83,81,34,47
050,51,011,"Virginia","Appomattox County",3,84,55,23,32
050,51,011,"Virginia","Appomattox County",3,85,330,130,200
050,51,011,"Virginia","Appomattox County",4,0,191,105,86
050,51,011,"Virginia","Appomattox County",4,1,218,121,97
050,51,011,"Virginia","Appomattox County",4,2,210,113,97
050,51,011,"Virginia","Appomattox County",4,3,216,102,114
050,51,011,"Virginia","Appomattox County",4,4,219,113,106
050,51,011,"Virginia","Appomattox County",4,5,208,106,102
050,51,011,"Virginia","Appomattox County",4,6,215,103,112
050,51,011,"Virginia","Appomattox County",4,7,203,106,97
050,51,011,"Virginia","Appomattox County",4,8,200,113,87
050,51,011,"Virginia","Appomattox County",4,9,202,116,86
050,51,011,"Virginia","Appomattox County",4,10,200,107,93
050,51,011,"Virginia","Appomattox County",4,11,200,96,104
050,51,011,"Virginia","Appomattox County",4,12,202,88,114
050,51,011,"Virginia","Appomattox County",4,13,205,100,105
050,51,011,"Virginia","Appomattox County",4,14,197,105,92
050,51,011,"Virginia","Appomattox County",4,15,189,89,100
050,51,011,"Virginia","Appomattox County",4,16,202,99,103
050,51,011,"Virginia","Appomattox County",4,17,191,102,89
050,51,011,"Virginia","Appomattox County",4,18,186,96,90
050,51,011,"Virginia","Appomattox County",4,19,130,64,66
050,51,011,"Virginia","Appomattox County",4,20,145,76,69
050,51,011,"Virginia","Appomattox County",4,21,158,83,75
050,51,011,"Virginia","Appomattox County",4,22,182,82,100
050,51,011,"Virginia","Appomattox County",4,23,165,86,79
050,51,011,"Virginia","Appomattox County",4,24,175,90,85
050,51,011,"Virginia","Appomattox County",4,25,183,90,93
050,51,011,"Virginia","Appomattox County",4,26,211,109,102
050,51,011,"Virginia","Appomattox County",4,27,197,107,90
050,51,011,"Virginia","Appomattox County",4,28,199,98,101
050,51,011,"Virginia","Appomattox County",4,29,226,114,112
050,51,011,"Virginia","Appomattox County",4,30,221,109,112
050,51,011,"Virginia","Appomattox County",4,31,223,116,107
050,51,011,"Virginia","Appomattox County",4,32,212,109,103
050,51,011,"Virginia","Appomattox County",4,33,186,94,92
050,51,011,"Virginia","Appomattox County",4,34,225,125,100
050,51,011,"Virginia","Appomattox County",4,35,221,109,112
050,51,011,"Virginia","Appomattox County",4,36,196,82,114
050,51,011,"Virginia","Appomattox County",4,37,202,87,115
050,51,011,"Virginia","Appomattox County",4,38,205,108,97
050,51,011,"Virginia","Appomattox County",4,39,207,109,98
050,51,011,"Virginia","Appomattox County",4,40,203,103,100
050,51,011,"Virginia","Appomattox County",4,41,203,108,95
050,51,011,"Virginia","Appomattox County",4,42,189,90,99
050,51,011,"Virginia","Appomattox County",4,43,195,90,105
050,51,011,"Virginia","Appomattox County",4,44,184,99,85
050,51,011,"Virginia","Appomattox County",4,45,185,85,100
050,51,011,"Virginia","Appomattox County",4,46,150,75,75
050,51,011,"Virginia","Appomattox County",4,47,166,81,85
050,51,011,"Virginia","Appomattox County",4,48,202,99,103
050,51,011,"Virginia","Appomattox County",4,49,211,113,98
050,51,011,"Virginia","Appomattox County",4,50,199,103,96
050,51,011,"Virginia","Appomattox County",4,51,242,125,117
050,51,011,"Virginia","Appomattox County",4,52,224,114,110
050,51,011,"Virginia","Appomattox County",4,53,195,105,90
050,51,011,"Virginia","Appomattox County",4,54,200,96,104
050,51,011,"Virginia","Appomattox County",4,55,206,99,107
050,51,011,"Virginia","Appomattox County",4,56,204,99,105
050,51,011,"Virginia","Appomattox County",4,57,219,104,115
050,51,011,"Virginia","Appomattox County",4,58,231,114,117
050,51,011,"Virginia","Appomattox County",4,59,250,131,119
050,51,011,"Virginia","Appomattox County",4,60,246,118,128
050,51,011,"Virginia","Appomattox County",4,61,248,113,135
050,51,011,"Virginia","Appomattox County",4,62,215,102,113
050,51,011,"Virginia","Appomattox County",4,63,252,115,137
050,51,011,"Virginia","Appomattox County",4,64,247,119,128
050,51,011,"Virginia","Appomattox County",4,65,265,131,134
050,51,011,"Virginia","Appomattox County",4,66,212,104,108
050,51,011,"Virginia","Appomattox County",4,67,204,93,111
050,51,011,"Virginia","Appomattox County",4,68,215,95,120
050,51,011,"Virginia","Appomattox County",4,69,201,89,112
050,51,011,"Virginia","Appomattox County",4,70,201,86,115
050,51,011,"Virginia","Appomattox County",4,71,161,74,87
050,51,011,"Virginia","Appomattox County",4,72,173,82,91
050,51,011,"Virginia","Appomattox County",4,73,182,92,90
050,51,011,"Virginia","Appomattox County",4,74,180,88,92
050,51,011,"Virginia","Appomattox County",4,75,192,89,103
050,51,011,"Virginia","Appomattox County",4,76,137,62,75
050,51,011,"Virginia","Appomattox County",4,77,129,63,66
050,51,011,"Virginia","Appomattox County",4,78,130,65,65
050,51,011,"Virginia","Appomattox County",4,79,132,65,67
050,51,011,"Virginia","Appomattox County",4,80,122,57,65
050,51,011,"Virginia","Appomattox County",4,81,105,45,60
050,51,011,"Virginia","Appomattox County",4,82,89,36,53
050,51,011,"Virginia","Appomattox County",4,83,81,33,48
050,51,011,"Virginia","Appomattox County",4,84,79,34,45
050,51,011,"Virginia","Appomattox County",4,85,324,136,188
050,51,011,"Virginia","Appomattox County",5,0,186,102,84
050,51,011,"Virginia","Appomattox County",5,1,197,103,94
050,51,011,"Virginia","Appomattox County",5,2,225,128,97
050,51,011,"Virginia","Appomattox County",5,3,207,118,89
050,51,011,"Virginia","Appomattox County",5,4,199,90,109
050,51,011,"Virginia","Appomattox County",5,5,215,111,104
050,51,011,"Virginia","Appomattox County",5,6,212,111,101
050,51,011,"Virginia","Appomattox County",5,7,227,110,117
050,51,011,"Virginia","Appomattox County",5,8,209,111,98
050,51,011,"Virginia","Appomattox County",5,9,207,119,88
050,51,011,"Virginia","Appomattox County",5,10,202,118,84
050,51,011,"Virginia","Appomattox County",5,11,200,106,94
050,51,011,"Virginia","Appomattox County",5,12,210,101,109
050,51,011,"Virginia","Appomattox County",5,13,205,89,116
050,51,011,"Virginia","Appomattox County",5,14,213,104,109
050,51,011,"Virginia","Appomattox County",5,15,198,107,91
050,51,011,"Virginia","Appomattox County",5,16,191,86,105
050,51,011,"Virginia","Appomattox County",5,17,205,97,108
050,51,011,"Virginia","Appomattox County",5,18,162,89,73
050,51,011,"Virginia","Appomattox County",5,19,144,73,71
050,51,011,"Virginia","Appomattox County",5,20,138,67,71
050,51,011,"Virginia","Appomattox County",5,21,146,80,66
050,51,011,"Virginia","Appomattox County",5,22,170,91,79
050,51,011,"Virginia","Appomattox County",5,23,176,78,98
050,51,011,"Virginia","Appomattox County",5,24,167,83,84
050,51,011,"Virginia","Appomattox County",5,25,177,87,90
050,51,011,"Virginia","Appomattox County",5,26,194,106,88
050,51,011,"Virginia","Appomattox County",5,27,221,124,97
050,51,011,"Virginia","Appomattox County",5,28,210,112,98
050,51,011,"Virginia","Appomattox County",5,29,202,97,105
050,51,011,"Virginia","Appomattox County",5,30,230,119,111
050,51,011,"Virginia","Appomattox County",5,31,229,109,120
050,51,011,"Virginia","Appomattox County",5,32,227,120,107
050,51,011,"Virginia","Appomattox County",5,33,232,123,109
050,51,011,"Virginia","Appomattox County",5,34,192,93,99
050,51,011,"Virginia","Appomattox County",5,35,225,125,100
050,51,011,"Virginia","Appomattox County",5,36,220,113,107
050,51,011,"Virginia","Appomattox County",5,37,193,81,112
050,51,011,"Virginia","Appomattox County",5,38,208,93,115
050,51,011,"Virginia","Appomattox County",5,39,209,110,99
050,51,011,"Virginia","Appomattox County",5,40,208,112,96
050,51,011,"Virginia","Appomattox County",5,41,198,99,99
050,51,011,"Virginia","Appomattox County",5,42,200,106,94
050,51,011,"Virginia","Appomattox County",5,43,197,95,102
050,51,011,"Virginia","Appomattox County",5,44,188,88,100
050,51,011,"Virginia","Appomattox County",5,45,192,103,89
050,51,011,"Virginia","Appomattox County",5,46,190,89,101
050,51,011,"Virginia","Appomattox County",5,47,146,77,69
050,51,011,"Virginia","Appomattox County",5,48,176,84,92
050,51,011,"Virginia","Appomattox County",5,49,204,99,105
050,51,011,"Virginia","Appomattox County",5,50,212,112,100
050,51,011,"Virginia","Appomattox County",5,51,207,106,101
050,51,011,"Virginia","Appomattox County",5,52,235,119,116
050,51,011,"Virginia","Appomattox County",5,53,216,111,105
050,51,011,"Virginia","Appomattox County",5,54,201,108,93
050,51,011,"Virginia","Appomattox County",5,55,195,93,102
050,51,011,"Virginia","Appomattox County",5,56,212,102,110
050,51,011,"Virginia","Appomattox County",5,57,218,107,111
050,51,011,"Virginia","Appomattox County",5,58,224,106,118
050,51,011,"Virginia","Appomattox County",5,59,240,123,117
050,51,011,"Virginia","Appomattox County",5,60,247,130,117
050,51,011,"Virginia","Appomattox County",5,61,246,119,127
050,51,011,"Virginia","Appomattox County",5,62,250,110,140
050,51,011,"Virginia","Appomattox County",5,63,215,100,115
050,51,011,"Virginia","Appomattox County",5,64,254,117,137
050,51,011,"Virginia","Appomattox County",5,65,253,122,131
050,51,011,"Virginia","Appomattox County",5,66,261,130,131
050,51,011,"Virginia","Appomattox County",5,67,207,103,104
050,51,011,"Virginia","Appomattox County",5,68,203,94,109
050,51,011,"Virginia","Appomattox County",5,69,219,99,120
050,51,011,"Virginia","Appomattox County",5,70,199,88,111
050,51,011,"Virginia","Appomattox County",5,71,196,84,112
050,51,011,"Virginia","Appomattox County",5,72,158,73,85
050,51,011,"Virginia","Appomattox County",5,73,166,78,88
050,51,011,"Virginia","Appomattox County",5,74,172,87,85
050,51,011,"Virginia","Appomattox County",5,75,171,82,89
050,51,011,"Virginia","Appomattox County",5,76,186,88,98
050,51,011,"Virginia","Appomattox County",5,77,131,59,72
050,51,011,"Virginia","Appomattox County",5,78,123,61,62
050,51,011,"Virginia","Appomattox County",5,79,125,63,62
050,51,011,"Virginia","Appomattox County",5,80,122,57,65
050,51,011,"Virginia","Appomattox County",5,81,112,52,60
050,51,011,"Virginia","Appomattox County",5,82,103,44,59
050,51,011,"Virginia","Appomattox County",5,83,85,33,52
050,51,011,"Virginia","Appomattox County",5,84,74,30,44
050,51,011,"Virginia","Appomattox County",5,85,347,154,193
050,51,013,"Virginia","Arlington County",1,0,2750,1412,1338
050,51,013,"Virginia","Arlington County",1,1,2647,1352,1295
050,51,013,"Virginia","Arlington County",1,2,2611,1318,1293
050,51,013,"Virginia","Arlington County",1,3,2644,1345,1299
050,51,013,"Virginia","Arlington County",1,4,2664,1358,1306
050,51,013,"Virginia","Arlington County",1,5,2612,1326,1286
050,51,013,"Virginia","Arlington County",1,6,2554,1328,1226
050,51,013,"Virginia","Arlington County",1,7,2530,1328,1202
050,51,013,"Virginia","Arlington County",1,8,2403,1226,1177
050,51,013,"Virginia","Arlington County",1,9,2325,1198,1127
050,51,013,"Virginia","Arlington County",1,10,2306,1219,1087
050,51,013,"Virginia","Arlington County",1,11,2332,1192,1140
050,51,013,"Virginia","Arlington County",1,12,2365,1208,1157
050,51,013,"Virginia","Arlington County",1,13,2293,1167,1126
050,51,013,"Virginia","Arlington County",1,14,2241,1125,1116
050,51,013,"Virginia","Arlington County",1,15,2271,1201,1070
050,51,013,"Virginia","Arlington County",1,16,2190,1108,1082
050,51,013,"Virginia","Arlington County",1,17,2032,1038,994
050,51,013,"Virginia","Arlington County",1,18,1850,945,905
050,51,013,"Virginia","Arlington County",1,19,1746,881,865
050,51,013,"Virginia","Arlington County",1,20,1769,894,875
050,51,013,"Virginia","Arlington County",1,21,1862,991,871
050,51,013,"Virginia","Arlington County",1,22,2445,1221,1224
050,51,013,"Virginia","Arlington County",1,23,4597,2219,2378
050,51,013,"Virginia","Arlington County",1,24,5668,2768,2900
050,51,013,"Virginia","Arlington County",1,25,6096,3004,3092
050,51,013,"Virginia","Arlington County",1,26,6192,3076,3116
050,51,013,"Virginia","Arlington County",1,27,5916,2956,2960
050,51,013,"Virginia","Arlington County",1,28,5709,2825,2884
050,51,013,"Virginia","Arlington County",1,29,5570,2834,2736
050,51,013,"Virginia","Arlington County",1,30,5365,2755,2610
050,51,013,"Virginia","Arlington County",1,31,5212,2655,2557
050,51,013,"Virginia","Arlington County",1,32,4993,2473,2520
050,51,013,"Virginia","Arlington County",1,33,4938,2494,2444
050,51,013,"Virginia","Arlington County",1,34,4766,2479,2287
050,51,013,"Virginia","Arlington County",1,35,4703,2387,2316
050,51,013,"Virginia","Arlington County",1,36,4436,2253,2183
050,51,013,"Virginia","Arlington County",1,37,4379,2296,2083
050,51,013,"Virginia","Arlington County",1,38,4269,2156,2113
050,51,013,"Virginia","Arlington County",1,39,4071,2038,2033
050,51,013,"Virginia","Arlington County",1,40,3784,1874,1910
050,51,013,"Virginia","Arlington County",1,41,3686,1843,1843
050,51,013,"Virginia","Arlington County",1,42,3593,1804,1789
050,51,013,"Virginia","Arlington County",1,43,3505,1733,1772
050,51,013,"Virginia","Arlington County",1,44,3316,1716,1600
050,51,013,"Virginia","Arlington County",1,45,3253,1653,1600
050,51,013,"Virginia","Arlington County",1,46,3163,1617,1546
050,51,013,"Virginia","Arlington County",1,47,3119,1556,1563
050,51,013,"Virginia","Arlington County",1,48,3195,1623,1572
050,51,013,"Virginia","Arlington County",1,49,3274,1703,1571
050,51,013,"Virginia","Arlington County",1,50,3167,1647,1520
050,51,013,"Virginia","Arlington County",1,51,2925,1524,1401
050,51,013,"Virginia","Arlington County",1,52,2743,1419,1324
050,51,013,"Virginia","Arlington County",1,53,2708,1453,1255
050,51,013,"Virginia","Arlington County",1,54,2676,1428,1248
050,51,013,"Virginia","Arlington County",1,55,2748,1430,1318
050,51,013,"Virginia","Arlington County",1,56,2721,1449,1272
050,51,013,"Virginia","Arlington County",1,57,2603,1386,1217
050,51,013,"Virginia","Arlington County",1,58,2475,1298,1177
050,51,013,"Virginia","Arlington County",1,59,2436,1292,1144
050,51,013,"Virginia","Arlington County",1,60,2363,1228,1135
050,51,013,"Virginia","Arlington County",1,61,2300,1178,1122
050,51,013,"Virginia","Arlington County",1,62,2130,1069,1061
050,51,013,"Virginia","Arlington County",1,63,2080,1045,1035
050,51,013,"Virginia","Arlington County",1,64,1984,946,1038
050,51,013,"Virginia","Arlington County",1,65,1991,958,1033
050,51,013,"Virginia","Arlington County",1,66,1874,907,967
050,51,013,"Virginia","Arlington County",1,67,1776,866,910
050,51,013,"Virginia","Arlington County",1,68,1760,856,904
050,51,013,"Virginia","Arlington County",1,69,1688,812,876
050,51,013,"Virginia","Arlington County",1,70,1601,751,850
050,51,013,"Virginia","Arlington County",1,71,1479,711,768
050,51,013,"Virginia","Arlington County",1,72,1468,711,757
050,51,013,"Virginia","Arlington County",1,73,1503,711,792
050,51,013,"Virginia","Arlington County",1,74,1085,530,555
050,51,013,"Virginia","Arlington County",1,75,1071,499,572
050,51,013,"Virginia","Arlington County",1,76,1007,451,556
050,51,013,"Virginia","Arlington County",1,77,929,399,530
050,51,013,"Virginia","Arlington County",1,78,762,345,417
050,51,013,"Virginia","Arlington County",1,79,726,341,385
050,51,013,"Virginia","Arlington County",1,80,634,291,343
050,51,013,"Virginia","Arlington County",1,81,571,252,319
050,51,013,"Virginia","Arlington County",1,82,521,233,288
050,51,013,"Virginia","Arlington County",1,83,455,201,254
050,51,013,"Virginia","Arlington County",1,84,444,183,261
050,51,013,"Virginia","Arlington County",1,85,3028,1146,1882
050,51,013,"Virginia","Arlington County",2,0,2723,1392,1331
050,51,013,"Virginia","Arlington County",2,1,2616,1337,1279
050,51,013,"Virginia","Arlington County",2,2,2590,1311,1279
050,51,013,"Virginia","Arlington County",2,3,2613,1328,1285
050,51,013,"Virginia","Arlington County",2,4,2654,1353,1301
050,51,013,"Virginia","Arlington County",2,5,2613,1329,1284
050,51,013,"Virginia","Arlington County",2,6,2559,1323,1236
050,51,013,"Virginia","Arlington County",2,7,2522,1319,1203
050,51,013,"Virginia","Arlington County",2,8,2423,1245,1178
050,51,013,"Virginia","Arlington County",2,9,2334,1203,1131
050,51,013,"Virginia","Arlington County",2,10,2305,1209,1096
050,51,013,"Virginia","Arlington County",2,11,2315,1192,1123
050,51,013,"Virginia","Arlington County",2,12,2364,1206,1158
050,51,013,"Virginia","Arlington County",2,13,2307,1173,1134
050,51,013,"Virginia","Arlington County",2,14,2252,1130,1122
050,51,013,"Virginia","Arlington County",2,15,2266,1181,1085
050,51,013,"Virginia","Arlington County",2,16,2218,1139,1079
050,51,013,"Virginia","Arlington County",2,17,2074,1056,1018
050,51,013,"Virginia","Arlington County",2,18,1868,952,916
050,51,013,"Virginia","Arlington County",2,19,1757,888,869
050,51,013,"Virginia","Arlington County",2,20,1798,912,886
050,51,013,"Virginia","Arlington County",2,21,1955,1021,934
050,51,013,"Virginia","Arlington County",2,22,2729,1360,1369
050,51,013,"Virginia","Arlington County",2,23,4433,2159,2274
050,51,013,"Virginia","Arlington County",2,24,5570,2723,2847
050,51,013,"Virginia","Arlington County",2,25,6056,2979,3077
050,51,013,"Virginia","Arlington County",2,26,6163,3066,3097
050,51,013,"Virginia","Arlington County",2,27,5928,2968,2960
050,51,013,"Virginia","Arlington County",2,28,5716,2847,2869
050,51,013,"Virginia","Arlington County",2,29,5556,2806,2750
050,51,013,"Virginia","Arlington County",2,30,5391,2763,2628
050,51,013,"Virginia","Arlington County",2,31,5150,2626,2524
050,51,013,"Virginia","Arlington County",2,32,4955,2471,2484
050,51,013,"Virginia","Arlington County",2,33,4868,2450,2418
050,51,013,"Virginia","Arlington County",2,34,4742,2450,2292
050,51,013,"Virginia","Arlington County",2,35,4689,2393,2296
050,51,013,"Virginia","Arlington County",2,36,4427,2253,2174
050,51,013,"Virginia","Arlington County",2,37,4360,2264,2096
050,51,013,"Virginia","Arlington County",2,38,4260,2164,2096
050,51,013,"Virginia","Arlington County",2,39,4047,2027,2020
050,51,013,"Virginia","Arlington County",2,40,3846,1910,1936
050,51,013,"Virginia","Arlington County",2,41,3684,1840,1844
050,51,013,"Virginia","Arlington County",2,42,3583,1793,1790
050,51,013,"Virginia","Arlington County",2,43,3522,1747,1775
050,51,013,"Virginia","Arlington County",2,44,3327,1702,1625
050,51,013,"Virginia","Arlington County",2,45,3279,1671,1608
050,51,013,"Virginia","Arlington County",2,46,3170,1618,1552
050,51,013,"Virginia","Arlington County",2,47,3112,1568,1544
050,51,013,"Virginia","Arlington County",2,48,3165,1601,1564
050,51,013,"Virginia","Arlington County",2,49,3257,1681,1576
050,51,013,"Virginia","Arlington County",2,50,3190,1653,1537
050,51,013,"Virginia","Arlington County",2,51,2970,1545,1425
050,51,013,"Virginia","Arlington County",2,52,2780,1441,1339
050,51,013,"Virginia","Arlington County",2,53,2712,1444,1268
050,51,013,"Virginia","Arlington County",2,54,2680,1431,1249
050,51,013,"Virginia","Arlington County",2,55,2723,1424,1299
050,51,013,"Virginia","Arlington County",2,56,2716,1441,1275
050,51,013,"Virginia","Arlington County",2,57,2619,1395,1224
050,51,013,"Virginia","Arlington County",2,58,2497,1315,1182
050,51,013,"Virginia","Arlington County",2,59,2439,1288,1151
050,51,013,"Virginia","Arlington County",2,60,2377,1243,1134
050,51,013,"Virginia","Arlington County",2,61,2298,1175,1123
050,51,013,"Virginia","Arlington County",2,62,2152,1091,1061
050,51,013,"Virginia","Arlington County",2,63,2090,1052,1038
050,51,013,"Virginia","Arlington County",2,64,1987,962,1025
050,51,013,"Virginia","Arlington County",2,65,1974,949,1025
050,51,013,"Virginia","Arlington County",2,66,1891,911,980
050,51,013,"Virginia","Arlington County",2,67,1776,864,912
050,51,013,"Virginia","Arlington County",2,68,1736,846,890
050,51,013,"Virginia","Arlington County",2,69,1701,820,881
050,51,013,"Virginia","Arlington County",2,70,1601,751,850
050,51,013,"Virginia","Arlington County",2,71,1506,719,787
050,51,013,"Virginia","Arlington County",2,72,1435,691,744
050,51,013,"Virginia","Arlington County",2,73,1545,740,805
050,51,013,"Virginia","Arlington County",2,74,1119,540,579
050,51,013,"Virginia","Arlington County",2,75,1071,503,568
050,51,013,"Virginia","Arlington County",2,76,1004,452,552
050,51,013,"Virginia","Arlington County",2,77,956,415,541
050,51,013,"Virginia","Arlington County",2,78,780,353,427
050,51,013,"Virginia","Arlington County",2,79,724,332,392
050,51,013,"Virginia","Arlington County",2,80,647,297,350
050,51,013,"Virginia","Arlington County",2,81,569,255,314
050,51,013,"Virginia","Arlington County",2,82,530,236,294
050,51,013,"Virginia","Arlington County",2,83,463,205,258
050,51,013,"Virginia","Arlington County",2,84,437,181,256
050,51,013,"Virginia","Arlington County",2,85,3008,1134,1874
050,51,013,"Virginia","Arlington County",3,0,2434,1213,1221
050,51,013,"Virginia","Arlington County",3,1,2358,1144,1214
050,51,013,"Virginia","Arlington County",3,2,2354,1198,1156
050,51,013,"Virginia","Arlington County",3,3,2385,1190,1195
050,51,013,"Virginia","Arlington County",3,4,2420,1216,1204
050,51,013,"Virginia","Arlington County",3,5,2560,1327,1233
050,51,013,"Virginia","Arlington County",3,6,2506,1307,1199
050,51,013,"Virginia","Arlington County",3,7,2497,1299,1198
050,51,013,"Virginia","Arlington County",3,8,2430,1269,1161
050,51,013,"Virginia","Arlington County",3,9,2346,1210,1136
050,51,013,"Virginia","Arlington County",3,10,2286,1183,1103
050,51,013,"Virginia","Arlington County",3,11,2245,1174,1071
050,51,013,"Virginia","Arlington County",3,12,2271,1169,1102
050,51,013,"Virginia","Arlington County",3,13,2320,1180,1140
050,51,013,"Virginia","Arlington County",3,14,2297,1171,1126
050,51,013,"Virginia","Arlington County",3,15,2226,1128,1098
050,51,013,"Virginia","Arlington County",3,16,2269,1186,1083
050,51,013,"Virginia","Arlington County",3,17,2247,1154,1093
050,51,013,"Virginia","Arlington County",3,18,1920,972,948
050,51,013,"Virginia","Arlington County",3,19,1701,848,853
050,51,013,"Virginia","Arlington County",3,20,1859,984,875
050,51,013,"Virginia","Arlington County",3,21,1902,978,924
050,51,013,"Virginia","Arlington County",3,22,2183,1080,1103
050,51,013,"Virginia","Arlington County",3,23,4202,2099,2103
050,51,013,"Virginia","Arlington County",3,24,5458,2723,2735
050,51,013,"Virginia","Arlington County",3,25,5883,2943,2940
050,51,013,"Virginia","Arlington County",3,26,5961,2954,3007
050,51,013,"Virginia","Arlington County",3,27,5952,2969,2983
050,51,013,"Virginia","Arlington County",3,28,5601,2864,2737
050,51,013,"Virginia","Arlington County",3,29,5277,2681,2596
050,51,013,"Virginia","Arlington County",3,30,4960,2483,2477
050,51,013,"Virginia","Arlington County",3,31,4895,2525,2370
050,51,013,"Virginia","Arlington County",3,32,4653,2419,2234
050,51,013,"Virginia","Arlington County",3,33,4496,2226,2270
050,51,013,"Virginia","Arlington County",3,34,4451,2272,2179
050,51,013,"Virginia","Arlington County",3,35,4306,2193,2113
050,51,013,"Virginia","Arlington County",3,36,4286,2197,2089
050,51,013,"Virginia","Arlington County",3,37,4068,2072,1996
050,51,013,"Virginia","Arlington County",3,38,4092,2149,1943
050,51,013,"Virginia","Arlington County",3,39,3919,1969,1950
050,51,013,"Virginia","Arlington County",3,40,3839,1915,1924
050,51,013,"Virginia","Arlington County",3,41,3591,1781,1810
050,51,013,"Virginia","Arlington County",3,42,3561,1813,1748
050,51,013,"Virginia","Arlington County",3,43,3457,1731,1726
050,51,013,"Virginia","Arlington County",3,44,3415,1707,1708
050,51,013,"Virginia","Arlington County",3,45,3189,1617,1572
050,51,013,"Virginia","Arlington County",3,46,3176,1613,1563
050,51,013,"Virginia","Arlington County",3,47,3082,1560,1522
050,51,013,"Virginia","Arlington County",3,48,3072,1542,1530
050,51,013,"Virginia","Arlington County",3,49,3047,1539,1508
050,51,013,"Virginia","Arlington County",3,50,3179,1626,1553
050,51,013,"Virginia","Arlington County",3,51,3130,1612,1518
050,51,013,"Virginia","Arlington County",3,52,2888,1500,1388
050,51,013,"Virginia","Arlington County",3,53,2697,1413,1284
050,51,013,"Virginia","Arlington County",3,54,2696,1433,1263
050,51,013,"Virginia","Arlington County",3,55,2610,1372,1238
050,51,013,"Virginia","Arlington County",3,56,2649,1372,1277
050,51,013,"Virginia","Arlington County",3,57,2590,1343,1247
050,51,013,"Virginia","Arlington County",3,58,2549,1361,1188
050,51,013,"Virginia","Arlington County",3,59,2398,1266,1132
050,51,013,"Virginia","Arlington County",3,60,2361,1249,1112
050,51,013,"Virginia","Arlington County",3,61,2276,1184,1092
050,51,013,"Virginia","Arlington County",3,62,2186,1106,1080
050,51,013,"Virginia","Arlington County",3,63,2056,1031,1025
050,51,013,"Virginia","Arlington County",3,64,2024,1020,1004
050,51,013,"Virginia","Arlington County",3,65,1879,906,973
050,51,013,"Virginia","Arlington County",3,66,1868,892,976
050,51,013,"Virginia","Arlington County",3,67,1856,884,972
050,51,013,"Virginia","Arlington County",3,68,1729,832,897
050,51,013,"Virginia","Arlington County",3,69,1675,816,859
050,51,013,"Virginia","Arlington County",3,70,1682,808,874
050,51,013,"Virginia","Arlington County",3,71,1550,732,818
050,51,013,"Virginia","Arlington County",3,72,1454,690,764
050,51,013,"Virginia","Arlington County",3,73,1419,677,742
050,51,013,"Virginia","Arlington County",3,74,1488,716,772
050,51,013,"Virginia","Arlington County",3,75,1096,524,572
050,51,013,"Virginia","Arlington County",3,76,1055,490,565
050,51,013,"Virginia","Arlington County",3,77,968,426,542
050,51,013,"Virginia","Arlington County",3,78,936,410,526
050,51,013,"Virginia","Arlington County",3,79,743,334,409
050,51,013,"Virginia","Arlington County",3,80,689,304,385
050,51,013,"Virginia","Arlington County",3,81,611,277,334
050,51,013,"Virginia","Arlington County",3,82,540,236,304
050,51,013,"Virginia","Arlington County",3,83,499,226,273
050,51,013,"Virginia","Arlington County",3,84,434,189,245
050,51,013,"Virginia","Arlington County",3,85,3071,1156,1915
050,51,013,"Virginia","Arlington County",4,0,2569,1329,1240
050,51,013,"Virginia","Arlington County",4,1,2174,1063,1111
050,51,013,"Virginia","Arlington County",4,2,2208,1076,1132
050,51,013,"Virginia","Arlington County",4,3,2297,1179,1118
050,51,013,"Virginia","Arlington County",4,4,2319,1177,1142
050,51,013,"Virginia","Arlington County",4,5,2397,1194,1203
050,51,013,"Virginia","Arlington County",4,6,2530,1301,1229
050,51,013,"Virginia","Arlington County",4,7,2442,1282,1160
050,51,013,"Virginia","Arlington County",4,8,2416,1260,1156
050,51,013,"Virginia","Arlington County",4,9,2438,1276,1162
050,51,013,"Virginia","Arlington County",4,10,2342,1217,1125
050,51,013,"Virginia","Arlington County",4,11,2278,1171,1107
050,51,013,"Virginia","Arlington County",4,12,2241,1162,1079
050,51,013,"Virginia","Arlington County",4,13,2257,1167,1090
050,51,013,"Virginia","Arlington County",4,14,2382,1221,1161
050,51,013,"Virginia","Arlington County",4,15,2358,1216,1142
050,51,013,"Virginia","Arlington County",4,16,2256,1135,1121
050,51,013,"Virginia","Arlington County",4,17,2279,1188,1091
050,51,013,"Virginia","Arlington County",4,18,2032,1045,987
050,51,013,"Virginia","Arlington County",4,19,1686,826,860
050,51,013,"Virginia","Arlington County",4,20,1762,890,872
050,51,013,"Virginia","Arlington County",4,21,1889,985,904
050,51,013,"Virginia","Arlington County",4,22,2352,1131,1221
050,51,013,"Virginia","Arlington County",4,23,4026,1955,2071
050,51,013,"Virginia","Arlington County",4,24,5479,2779,2700
050,51,013,"Virginia","Arlington County",4,25,6206,3125,3081
050,51,013,"Virginia","Arlington County",4,26,6125,3057,3068
050,51,013,"Virginia","Arlington County",4,27,5996,3058,2938
050,51,013,"Virginia","Arlington County",4,28,5674,2833,2841
050,51,013,"Virginia","Arlington County",4,29,5520,2830,2690
050,51,013,"Virginia","Arlington County",4,30,5057,2576,2481
050,51,013,"Virginia","Arlington County",4,31,4780,2444,2336
050,51,013,"Virginia","Arlington County",4,32,4507,2365,2142
050,51,013,"Virginia","Arlington County",4,33,4412,2312,2100
050,51,013,"Virginia","Arlington County",4,34,4191,2091,2100
050,51,013,"Virginia","Arlington County",4,35,4207,2117,2090
050,51,013,"Virginia","Arlington County",4,36,4074,2019,2055
050,51,013,"Virginia","Arlington County",4,37,4067,2075,1992
050,51,013,"Virginia","Arlington County",4,38,3861,2001,1860
050,51,013,"Virginia","Arlington County",4,39,3832,1960,1872
050,51,013,"Virginia","Arlington County",4,40,3764,1892,1872
050,51,013,"Virginia","Arlington County",4,41,3712,1842,1870
050,51,013,"Virginia","Arlington County",4,42,3560,1780,1780
050,51,013,"Virginia","Arlington County",4,43,3468,1762,1706
050,51,013,"Virginia","Arlington County",4,44,3416,1711,1705
050,51,013,"Virginia","Arlington County",4,45,3308,1642,1666
050,51,013,"Virginia","Arlington County",4,46,3126,1577,1549
050,51,013,"Virginia","Arlington County",4,47,3066,1552,1514
050,51,013,"Virginia","Arlington County",4,48,3054,1541,1513
050,51,013,"Virginia","Arlington County",4,49,2984,1492,1492
050,51,013,"Virginia","Arlington County",4,50,2951,1502,1449
050,51,013,"Virginia","Arlington County",4,51,3106,1568,1538
050,51,013,"Virginia","Arlington County",4,52,3044,1558,1486
050,51,013,"Virginia","Arlington County",4,53,2880,1474,1406
050,51,013,"Virginia","Arlington County",4,54,2662,1379,1283
050,51,013,"Virginia","Arlington County",4,55,2600,1365,1235
050,51,013,"Virginia","Arlington County",4,56,2575,1355,1220
050,51,013,"Virginia","Arlington County",4,57,2615,1347,1268
050,51,013,"Virginia","Arlington County",4,58,2504,1309,1195
050,51,013,"Virginia","Arlington County",4,59,2453,1309,1144
050,51,013,"Virginia","Arlington County",4,60,2306,1225,1081
050,51,013,"Virginia","Arlington County",4,61,2231,1164,1067
050,51,013,"Virginia","Arlington County",4,62,2138,1098,1040
050,51,013,"Virginia","Arlington County",4,63,2108,1075,1033
050,51,013,"Virginia","Arlington County",4,64,1964,980,984
050,51,013,"Virginia","Arlington County",4,65,1944,978,966
050,51,013,"Virginia","Arlington County",4,66,1793,845,948
050,51,013,"Virginia","Arlington County",4,67,1828,874,954
050,51,013,"Virginia","Arlington County",4,68,1788,842,946
050,51,013,"Virginia","Arlington County",4,69,1688,802,886
050,51,013,"Virginia","Arlington County",4,70,1668,817,851
050,51,013,"Virginia","Arlington County",4,71,1635,776,859
050,51,013,"Virginia","Arlington County",4,72,1516,709,807
050,51,013,"Virginia","Arlington County",4,73,1421,678,743
050,51,013,"Virginia","Arlington County",4,74,1376,654,722
050,51,013,"Virginia","Arlington County",4,75,1443,689,754
050,51,013,"Virginia","Arlington County",4,76,1053,505,548
050,51,013,"Virginia","Arlington County",4,77,1029,462,567
050,51,013,"Virginia","Arlington County",4,78,945,422,523
050,51,013,"Virginia","Arlington County",4,79,908,396,512
050,51,013,"Virginia","Arlington County",4,80,720,323,397
050,51,013,"Virginia","Arlington County",4,81,674,297,377
050,51,013,"Virginia","Arlington County",4,82,582,261,321
050,51,013,"Virginia","Arlington County",4,83,513,233,280
050,51,013,"Virginia","Arlington County",4,84,469,200,269
050,51,013,"Virginia","Arlington County",4,85,3172,1197,1975
050,51,013,"Virginia","Arlington County",5,0,2641,1359,1282
050,51,013,"Virginia","Arlington County",5,1,2316,1211,1105
050,51,013,"Virginia","Arlington County",5,2,2066,1010,1056
050,51,013,"Virginia","Arlington County",5,3,2144,1049,1095
050,51,013,"Virginia","Arlington County",5,4,2221,1138,1083
050,51,013,"Virginia","Arlington County",5,5,2272,1153,1119
050,51,013,"Virginia","Arlington County",5,6,2391,1213,1178
050,51,013,"Virginia","Arlington County",5,7,2484,1285,1199
050,51,013,"Virginia","Arlington County",5,8,2433,1279,1154
050,51,013,"Virginia","Arlington County",5,9,2431,1280,1151
050,51,013,"Virginia","Arlington County",5,10,2426,1278,1148
050,51,013,"Virginia","Arlington County",5,11,2318,1202,1116
050,51,013,"Virginia","Arlington County",5,12,2275,1173,1102
050,51,013,"Virginia","Arlington County",5,13,2257,1164,1093
050,51,013,"Virginia","Arlington County",5,14,2319,1185,1134
050,51,013,"Virginia","Arlington County",5,15,2425,1254,1171
050,51,013,"Virginia","Arlington County",5,16,2367,1238,1129
050,51,013,"Virginia","Arlington County",5,17,2269,1144,1125
050,51,013,"Virginia","Arlington County",5,18,2093,1089,1004
050,51,013,"Virginia","Arlington County",5,19,1837,929,908
050,51,013,"Virginia","Arlington County",5,20,1838,918,920
050,51,013,"Virginia","Arlington County",5,21,1897,968,929
050,51,013,"Virginia","Arlington County",5,22,2360,1155,1205
050,51,013,"Virginia","Arlington County",5,23,4132,2001,2131
050,51,013,"Virginia","Arlington County",5,24,5302,2660,2642
050,51,013,"Virginia","Arlington County",5,25,6089,3107,2982
050,51,013,"Virginia","Arlington County",5,26,6365,3231,3134
050,51,013,"Virginia","Arlington County",5,27,6086,3044,3042
050,51,013,"Virginia","Arlington County",5,28,5781,2942,2839
050,51,013,"Virginia","Arlington County",5,29,5423,2734,2689
050,51,013,"Virginia","Arlington County",5,30,5286,2706,2580
050,51,013,"Virginia","Arlington County",5,31,4687,2379,2308
050,51,013,"Virginia","Arlington County",5,32,4423,2257,2166
050,51,013,"Virginia","Arlington County",5,33,4324,2256,2068
050,51,013,"Virginia","Arlington County",5,34,4145,2155,1990
050,51,013,"Virginia","Arlington County",5,35,3945,1955,1990
050,51,013,"Virginia","Arlington County",5,36,3963,1991,1972
050,51,013,"Virginia","Arlington County",5,37,3885,1931,1954
050,51,013,"Virginia","Arlington County",5,38,3905,1973,1932
050,51,013,"Virginia","Arlington County",5,39,3706,1926,1780
050,51,013,"Virginia","Arlington County",5,40,3675,1891,1784
050,51,013,"Virginia","Arlington County",5,41,3602,1768,1834
050,51,013,"Virginia","Arlington County",5,42,3616,1784,1832
050,51,013,"Virginia","Arlington County",5,43,3445,1730,1715
050,51,013,"Virginia","Arlington County",5,44,3383,1714,1669
050,51,013,"Virginia","Arlington County",5,45,3318,1645,1673
050,51,013,"Virginia","Arlington County",5,46,3300,1610,1690
050,51,013,"Virginia","Arlington County",5,47,3063,1541,1522
050,51,013,"Virginia","Arlington County",5,48,3007,1527,1480
050,51,013,"Virginia","Arlington County",5,49,2980,1500,1480
050,51,013,"Virginia","Arlington County",5,50,2980,1481,1499
050,51,013,"Virginia","Arlington County",5,51,2885,1457,1428
050,51,013,"Virginia","Arlington County",5,52,3055,1540,1515
050,51,013,"Virginia","Arlington County",5,53,2965,1512,1453
050,51,013,"Virginia","Arlington County",5,54,2848,1450,1398
050,51,013,"Virginia","Arlington County",5,55,2599,1346,1253
050,51,013,"Virginia","Arlington County",5,56,2534,1330,1204
050,51,013,"Virginia","Arlington County",5,57,2496,1320,1176
050,51,013,"Virginia","Arlington County",5,58,2554,1314,1240
050,51,013,"Virginia","Arlington County",5,59,2444,1274,1170
050,51,013,"Virginia","Arlington County",5,60,2361,1274,1087
050,51,013,"Virginia","Arlington County",5,61,2230,1170,1060
050,51,013,"Virginia","Arlington County",5,62,2138,1116,1022
050,51,013,"Virginia","Arlington County",5,63,2064,1059,1005
050,51,013,"Virginia","Arlington County",5,64,2016,1025,991
050,51,013,"Virginia","Arlington County",5,65,1859,924,935
050,51,013,"Virginia","Arlington County",5,66,1871,935,936
050,51,013,"Virginia","Arlington County",5,67,1758,828,930
050,51,013,"Virginia","Arlington County",5,68,1800,865,935
050,51,013,"Virginia","Arlington County",5,69,1738,811,927
050,51,013,"Virginia","Arlington County",5,70,1666,781,885
050,51,013,"Virginia","Arlington County",5,71,1636,802,834
050,51,013,"Virginia","Arlington County",5,72,1599,755,844
050,51,013,"Virginia","Arlington County",5,73,1480,699,781
050,51,013,"Virginia","Arlington County",5,74,1377,660,717
050,51,013,"Virginia","Arlington County",5,75,1364,643,721
050,51,013,"Virginia","Arlington County",5,76,1406,656,750
050,51,013,"Virginia","Arlington County",5,77,1040,500,540
050,51,013,"Virginia","Arlington County",5,78,989,441,548
050,51,013,"Virginia","Arlington County",5,79,906,401,505
050,51,013,"Virginia","Arlington County",5,80,885,381,504
050,51,013,"Virginia","Arlington County",5,81,684,306,378
050,51,013,"Virginia","Arlington County",5,82,640,281,359
050,51,013,"Virginia","Arlington County",5,83,557,256,301
050,51,013,"Virginia","Arlington County",5,84,493,216,277
050,51,013,"Virginia","Arlington County",5,85,3329,1260,2069
050,51,015,"Virginia","Augusta County",1,0,642,329,313
050,51,015,"Virginia","Augusta County",1,1,740,369,371
050,51,015,"Virginia","Augusta County",1,2,758,372,386
050,51,015,"Virginia","Augusta County",1,3,752,361,391
050,51,015,"Virginia","Augusta County",1,4,787,391,396
050,51,015,"Virginia","Augusta County",1,5,761,382,379
050,51,015,"Virginia","Augusta County",1,6,791,402,389
050,51,015,"Virginia","Augusta County",1,7,764,395,369
050,51,015,"Virginia","Augusta County",1,8,803,400,403
050,51,015,"Virginia","Augusta County",1,9,801,399,402
050,51,015,"Virginia","Augusta County",1,10,831,435,396
050,51,015,"Virginia","Augusta County",1,11,853,445,408
050,51,015,"Virginia","Augusta County",1,12,938,486,452
050,51,015,"Virginia","Augusta County",1,13,920,484,436
050,51,015,"Virginia","Augusta County",1,14,915,470,445
050,51,015,"Virginia","Augusta County",1,15,953,490,463
050,51,015,"Virginia","Augusta County",1,16,961,494,467
050,51,015,"Virginia","Augusta County",1,17,939,475,464
050,51,015,"Virginia","Augusta County",1,18,819,460,359
050,51,015,"Virginia","Augusta County",1,19,760,429,331
050,51,015,"Virginia","Augusta County",1,20,777,433,344
050,51,015,"Virginia","Augusta County",1,21,785,437,348
050,51,015,"Virginia","Augusta County",1,22,801,439,362
050,51,015,"Virginia","Augusta County",1,23,840,448,392
050,51,015,"Virginia","Augusta County",1,24,846,483,363
050,51,015,"Virginia","Augusta County",1,25,872,486,386
050,51,015,"Virginia","Augusta County",1,26,881,472,409
050,51,015,"Virginia","Augusta County",1,27,908,481,427
050,51,015,"Virginia","Augusta County",1,28,945,514,431
050,51,015,"Virginia","Augusta County",1,29,918,509,409
050,51,015,"Virginia","Augusta County",1,30,922,488,434
050,51,015,"Virginia","Augusta County",1,31,950,500,450
050,51,015,"Virginia","Augusta County",1,32,887,489,398
050,51,015,"Virginia","Augusta County",1,33,861,463,398
050,51,015,"Virginia","Augusta County",1,34,906,458,448
050,51,015,"Virginia","Augusta County",1,35,922,497,425
050,51,015,"Virginia","Augusta County",1,36,931,494,437
050,51,015,"Virginia","Augusta County",1,37,926,488,438
050,51,015,"Virginia","Augusta County",1,38,937,510,427
050,51,015,"Virginia","Augusta County",1,39,968,509,459
050,51,015,"Virginia","Augusta County",1,40,905,476,429
050,51,015,"Virginia","Augusta County",1,41,945,520,425
050,51,015,"Virginia","Augusta County",1,42,917,479,438
050,51,015,"Virginia","Augusta County",1,43,860,449,411
050,51,015,"Virginia","Augusta County",1,44,849,456,393
050,51,015,"Virginia","Augusta County",1,45,859,461,398
050,51,015,"Virginia","Augusta County",1,46,934,477,457
050,51,015,"Virginia","Augusta County",1,47,977,499,478
050,51,015,"Virginia","Augusta County",1,48,1039,541,498
050,51,015,"Virginia","Augusta County",1,49,1089,580,509
050,51,015,"Virginia","Augusta County",1,50,1056,531,525
050,51,015,"Virginia","Augusta County",1,51,1060,533,527
050,51,015,"Virginia","Augusta County",1,52,1042,557,485
050,51,015,"Virginia","Augusta County",1,53,1071,549,522
050,51,015,"Virginia","Augusta County",1,54,1123,557,566
050,51,015,"Virginia","Augusta County",1,55,1208,583,625
050,51,015,"Virginia","Augusta County",1,56,1233,627,606
050,51,015,"Virginia","Augusta County",1,57,1269,649,620
050,51,015,"Virginia","Augusta County",1,58,1226,630,596
050,51,015,"Virginia","Augusta County",1,59,1236,637,599
050,51,015,"Virginia","Augusta County",1,60,1144,575,569
050,51,015,"Virginia","Augusta County",1,61,1184,591,593
050,51,015,"Virginia","Augusta County",1,62,1188,597,591
050,51,015,"Virginia","Augusta County",1,63,1126,536,590
050,51,015,"Virginia","Augusta County",1,64,1113,532,581
050,51,015,"Virginia","Augusta County",1,65,1076,522,554
050,51,015,"Virginia","Augusta County",1,66,1102,558,544
050,51,015,"Virginia","Augusta County",1,67,1025,507,518
050,51,015,"Virginia","Augusta County",1,68,1021,502,519
050,51,015,"Virginia","Augusta County",1,69,919,443,476
050,51,015,"Virginia","Augusta County",1,70,927,439,488
050,51,015,"Virginia","Augusta County",1,71,939,450,489
050,51,015,"Virginia","Augusta County",1,72,923,443,480
050,51,015,"Virginia","Augusta County",1,73,982,476,506
050,51,015,"Virginia","Augusta County",1,74,714,332,382
050,51,015,"Virginia","Augusta County",1,75,687,332,355
050,51,015,"Virginia","Augusta County",1,76,682,329,353
050,51,015,"Virginia","Augusta County",1,77,693,344,349
050,51,015,"Virginia","Augusta County",1,78,618,304,314
050,51,015,"Virginia","Augusta County",1,79,554,265,289
050,51,015,"Virginia","Augusta County",1,80,461,220,241
050,51,015,"Virginia","Augusta County",1,81,447,218,229
050,51,015,"Virginia","Augusta County",1,82,381,171,210
050,51,015,"Virginia","Augusta County",1,83,348,135,213
050,51,015,"Virginia","Augusta County",1,84,322,126,196
050,51,015,"Virginia","Augusta County",1,85,1740,716,1024
050,51,015,"Virginia","Augusta County",2,0,598,302,296
050,51,015,"Virginia","Augusta County",2,1,719,361,358
050,51,015,"Virginia","Augusta County",2,2,761,375,386
050,51,015,"Virginia","Augusta County",2,3,762,366,396
050,51,015,"Virginia","Augusta County",2,4,789,388,401
050,51,015,"Virginia","Augusta County",2,5,778,392,386
050,51,015,"Virginia","Augusta County",2,6,787,400,387
050,51,015,"Virginia","Augusta County",2,7,776,399,377
050,51,015,"Virginia","Augusta County",2,8,798,401,397
050,51,015,"Virginia","Augusta County",2,9,805,403,402
050,51,015,"Virginia","Augusta County",2,10,823,424,399
050,51,015,"Virginia","Augusta County",2,11,848,442,406
050,51,015,"Virginia","Augusta County",2,12,920,476,444
050,51,015,"Virginia","Augusta County",2,13,925,483,442
050,51,015,"Virginia","Augusta County",2,14,920,475,445
050,51,015,"Virginia","Augusta County",2,15,945,486,459
050,51,015,"Virginia","Augusta County",2,16,960,491,469
050,51,015,"Virginia","Augusta County",2,17,941,478,463
050,51,015,"Virginia","Augusta County",2,18,819,452,367
050,51,015,"Virginia","Augusta County",2,19,761,432,329
050,51,015,"Virginia","Augusta County",2,20,790,440,350
050,51,015,"Virginia","Augusta County",2,21,788,440,348
050,51,015,"Virginia","Augusta County",2,22,808,442,366
050,51,015,"Virginia","Augusta County",2,23,838,453,385
050,51,015,"Virginia","Augusta County",2,24,850,478,372
050,51,015,"Virginia","Augusta County",2,25,880,495,385
050,51,015,"Virginia","Augusta County",2,26,884,473,411
050,51,015,"Virginia","Augusta County",2,27,898,477,421
050,51,015,"Virginia","Augusta County",2,28,943,512,431
050,51,015,"Virginia","Augusta County",2,29,925,506,419
050,51,015,"Virginia","Augusta County",2,30,931,496,435
050,51,015,"Virginia","Augusta County",2,31,954,504,450
050,51,015,"Virginia","Augusta County",2,32,903,492,411
050,51,015,"Virginia","Augusta County",2,33,870,467,403
050,51,015,"Virginia","Augusta County",2,34,900,463,437
050,51,015,"Virginia","Augusta County",2,35,930,495,435
050,51,015,"Virginia","Augusta County",2,36,923,491,432
050,51,015,"Virginia","Augusta County",2,37,938,496,442
050,51,015,"Virginia","Augusta County",2,38,936,502,434
050,51,015,"Virginia","Augusta County",2,39,961,510,451
050,51,015,"Virginia","Augusta County",2,40,930,490,440
050,51,015,"Virginia","Augusta County",2,41,938,514,424
050,51,015,"Virginia","Augusta County",2,42,920,486,434
050,51,015,"Virginia","Augusta County",2,43,881,461,420
050,51,015,"Virginia","Augusta County",2,44,850,458,392
050,51,015,"Virginia","Augusta County",2,45,855,455,400
050,51,015,"Virginia","Augusta County",2,46,915,470,445
050,51,015,"Virginia","Augusta County",2,47,960,487,473
050,51,015,"Virginia","Augusta County",2,48,1027,536,491
050,51,015,"Virginia","Augusta County",2,49,1077,566,511
050,51,015,"Virginia","Augusta County",2,50,1063,542,521
050,51,015,"Virginia","Augusta County",2,51,1055,531,524
050,51,015,"Virginia","Augusta County",2,52,1049,554,495
050,51,015,"Virginia","Augusta County",2,53,1060,548,512
050,51,015,"Virginia","Augusta County",2,54,1115,559,556
050,51,015,"Virginia","Augusta County",2,55,1186,576,610
050,51,015,"Virginia","Augusta County",2,56,1233,621,612
050,51,015,"Virginia","Augusta County",2,57,1261,645,616
050,51,015,"Virginia","Augusta County",2,58,1236,633,603
050,51,015,"Virginia","Augusta County",2,59,1241,637,604
050,51,015,"Virginia","Augusta County",2,60,1159,584,575
050,51,015,"Virginia","Augusta County",2,61,1170,581,589
050,51,015,"Virginia","Augusta County",2,62,1184,593,591
050,51,015,"Virginia","Augusta County",2,63,1150,554,596
050,51,015,"Virginia","Augusta County",2,64,1101,523,578
050,51,015,"Virginia","Augusta County",2,65,1086,526,560
050,51,015,"Virginia","Augusta County",2,66,1095,548,547
050,51,015,"Virginia","Augusta County",2,67,1042,520,522
050,51,015,"Virginia","Augusta County",2,68,1007,495,512
050,51,015,"Virginia","Augusta County",2,69,949,459,490
050,51,015,"Virginia","Augusta County",2,70,924,438,486
050,51,015,"Virginia","Augusta County",2,71,933,444,489
050,51,015,"Virginia","Augusta County",2,72,906,433,473
050,51,015,"Virginia","Augusta County",2,73,1018,494,524
050,51,015,"Virginia","Augusta County",2,74,730,343,387
050,51,015,"Virginia","Augusta County",2,75,689,330,359
050,51,015,"Virginia","Augusta County",2,76,672,325,347
050,51,015,"Virginia","Augusta County",2,77,707,348,359
050,51,015,"Virginia","Augusta County",2,78,614,301,313
050,51,015,"Virginia","Augusta County",2,79,563,272,291
050,51,015,"Virginia","Augusta County",2,80,480,228,252
050,51,015,"Virginia","Augusta County",2,81,446,217,229
050,51,015,"Virginia","Augusta County",2,82,393,179,214
050,51,015,"Virginia","Augusta County",2,83,346,139,207
050,51,015,"Virginia","Augusta County",2,84,320,125,195
050,51,015,"Virginia","Augusta County",2,85,1753,717,1036
050,51,015,"Virginia","Augusta County",3,0,495,257,238
050,51,015,"Virginia","Augusta County",3,1,623,311,312
050,51,015,"Virginia","Augusta County",3,2,723,353,370
050,51,015,"Virginia","Augusta County",3,3,773,382,391
050,51,015,"Virginia","Augusta County",3,4,768,372,396
050,51,015,"Virginia","Augusta County",3,5,803,401,402
050,51,015,"Virginia","Augusta County",3,6,795,406,389
050,51,015,"Virginia","Augusta County",3,7,792,400,392
050,51,015,"Virginia","Augusta County",3,8,793,397,396
050,51,015,"Virginia","Augusta County",3,9,809,401,408
050,51,015,"Virginia","Augusta County",3,10,811,404,407
050,51,015,"Virginia","Augusta County",3,11,847,433,414
050,51,015,"Virginia","Augusta County",3,12,863,444,419
050,51,015,"Virginia","Augusta County",3,13,945,487,458
050,51,015,"Virginia","Augusta County",3,14,932,480,452
050,51,015,"Virginia","Augusta County",3,15,940,492,448
050,51,015,"Virginia","Augusta County",3,16,942,482,460
050,51,015,"Virginia","Augusta County",3,17,958,491,467
050,51,015,"Virginia","Augusta County",3,18,840,454,386
050,51,015,"Virginia","Augusta County",3,19,734,418,316
050,51,015,"Virginia","Augusta County",3,20,805,451,354
050,51,015,"Virginia","Augusta County",3,21,812,454,358
050,51,015,"Virginia","Augusta County",3,22,802,439,363
050,51,015,"Virginia","Augusta County",3,23,821,443,378
050,51,015,"Virginia","Augusta County",3,24,872,480,392
050,51,015,"Virginia","Augusta County",3,25,907,506,401
050,51,015,"Virginia","Augusta County",3,26,853,480,373
050,51,015,"Virginia","Augusta County",3,27,874,468,406
050,51,015,"Virginia","Augusta County",3,28,949,508,441
050,51,015,"Virginia","Augusta County",3,29,934,503,431
050,51,015,"Virginia","Augusta County",3,30,933,497,436
050,51,015,"Virginia","Augusta County",3,31,964,522,442
050,51,015,"Virginia","Augusta County",3,32,944,504,440
050,51,015,"Virginia","Augusta County",3,33,895,489,406
050,51,015,"Virginia","Augusta County",3,34,890,487,403
050,51,015,"Virginia","Augusta County",3,35,927,488,439
050,51,015,"Virginia","Augusta County",3,36,944,502,442
050,51,015,"Virginia","Augusta County",3,37,948,519,429
050,51,015,"Virginia","Augusta County",3,38,960,498,462
050,51,015,"Virginia","Augusta County",3,39,972,521,451
050,51,015,"Virginia","Augusta County",3,40,968,501,467
050,51,015,"Virginia","Augusta County",3,41,952,506,446
050,51,015,"Virginia","Augusta County",3,42,953,521,432
050,51,015,"Virginia","Augusta County",3,43,927,490,437
050,51,015,"Virginia","Augusta County",3,44,900,477,423
050,51,015,"Virginia","Augusta County",3,45,829,430,399
050,51,015,"Virginia","Augusta County",3,46,884,465,419
050,51,015,"Virginia","Augusta County",3,47,907,471,436
050,51,015,"Virginia","Augusta County",3,48,973,502,471
050,51,015,"Virginia","Augusta County",3,49,1018,521,497
050,51,015,"Virginia","Augusta County",3,50,1081,568,513
050,51,015,"Virginia","Augusta County",3,51,1056,539,517
050,51,015,"Virginia","Augusta County",3,52,1068,547,521
050,51,015,"Virginia","Augusta County",3,53,1028,534,494
050,51,015,"Virginia","Augusta County",3,54,1063,549,514
050,51,015,"Virginia","Augusta County",3,55,1086,536,550
050,51,015,"Virginia","Augusta County",3,56,1199,593,606
050,51,015,"Virginia","Augusta County",3,57,1218,603,615
050,51,015,"Virginia","Augusta County",3,58,1257,633,624
050,51,015,"Virginia","Augusta County",3,59,1224,630,594
050,51,015,"Virginia","Augusta County",3,60,1238,641,597
050,51,015,"Virginia","Augusta County",3,61,1156,574,582
050,51,015,"Virginia","Augusta County",3,62,1162,587,575
050,51,015,"Virginia","Augusta County",3,63,1168,579,589
050,51,015,"Virginia","Augusta County",3,64,1145,546,599
050,51,015,"Virginia","Augusta County",3,65,1085,511,574
050,51,015,"Virginia","Augusta County",3,66,1073,508,565
050,51,015,"Virginia","Augusta County",3,67,1101,550,551
050,51,015,"Virginia","Augusta County",3,68,1034,512,522
050,51,015,"Virginia","Augusta County",3,69,981,483,498
050,51,015,"Virginia","Augusta County",3,70,946,463,483
050,51,015,"Virginia","Augusta County",3,71,908,428,480
050,51,015,"Virginia","Augusta County",3,72,923,434,489
050,51,015,"Virginia","Augusta County",3,73,879,419,460
050,51,015,"Virginia","Augusta County",3,74,997,481,516
050,51,015,"Virginia","Augusta County",3,75,708,324,384
050,51,015,"Virginia","Augusta County",3,76,658,307,351
050,51,015,"Virginia","Augusta County",3,77,643,307,336
050,51,015,"Virginia","Augusta County",3,78,680,334,346
050,51,015,"Virginia","Augusta County",3,79,585,281,304
050,51,015,"Virginia","Augusta County",3,80,544,263,281
050,51,015,"Virginia","Augusta County",3,81,467,213,254
050,51,015,"Virginia","Augusta County",3,82,401,193,208
050,51,015,"Virginia","Augusta County",3,83,378,166,212
050,51,015,"Virginia","Augusta County",3,84,319,123,196
050,51,015,"Virginia","Augusta County",3,85,1802,718,1084
050,51,015,"Virginia","Augusta County",4,0,507,259,248
050,51,015,"Virginia","Augusta County",4,1,536,274,262
050,51,015,"Virginia","Augusta County",4,2,663,326,337
050,51,015,"Virginia","Augusta County",4,3,729,367,362
050,51,015,"Virginia","Augusta County",4,4,797,389,408
050,51,015,"Virginia","Augusta County",4,5,768,370,398
050,51,015,"Virginia","Augusta County",4,6,817,408,409
050,51,015,"Virginia","Augusta County",4,7,798,397,401
050,51,015,"Virginia","Augusta County",4,8,763,390,373
050,51,015,"Virginia","Augusta County",4,9,808,405,403
050,51,015,"Virginia","Augusta County",4,10,812,399,413
050,51,015,"Virginia","Augusta County",4,11,801,399,402
050,51,015,"Virginia","Augusta County",4,12,859,447,412
050,51,015,"Virginia","Augusta County",4,13,873,457,416
050,51,015,"Virginia","Augusta County",4,14,945,489,456
050,51,015,"Virginia","Augusta County",4,15,933,476,457
050,51,015,"Virginia","Augusta County",4,16,958,501,457
050,51,015,"Virginia","Augusta County",4,17,947,485,462
050,51,015,"Virginia","Augusta County",4,18,853,453,400
050,51,015,"Virginia","Augusta County",4,19,728,410,318
050,51,015,"Virginia","Augusta County",4,20,752,434,318
050,51,015,"Virginia","Augusta County",4,21,831,469,362
050,51,015,"Virginia","Augusta County",4,22,860,474,386
050,51,015,"Virginia","Augusta County",4,23,851,473,378
050,51,015,"Virginia","Augusta County",4,24,831,458,373
050,51,015,"Virginia","Augusta County",4,25,901,495,406
050,51,015,"Virginia","Augusta County",4,26,887,492,395
050,51,015,"Virginia","Augusta County",4,27,880,480,400
050,51,015,"Virginia","Augusta County",4,28,924,499,425
050,51,015,"Virginia","Augusta County",4,29,938,490,448
050,51,015,"Virginia","Augusta County",4,30,935,508,427
050,51,015,"Virginia","Augusta County",4,31,967,529,438
050,51,015,"Virginia","Augusta County",4,32,976,529,447
050,51,015,"Virginia","Augusta County",4,33,970,505,465
050,51,015,"Virginia","Augusta County",4,34,915,497,418
050,51,015,"Virginia","Augusta County",4,35,942,507,435
050,51,015,"Virginia","Augusta County",4,36,924,480,444
050,51,015,"Virginia","Augusta County",4,37,956,500,456
050,51,015,"Virginia","Augusta County",4,38,949,514,435
050,51,015,"Virginia","Augusta County",4,39,979,505,474
050,51,015,"Virginia","Augusta County",4,40,962,510,452
050,51,015,"Virginia","Augusta County",4,41,987,523,464
050,51,015,"Virginia","Augusta County",4,42,968,514,454
050,51,015,"Virginia","Augusta County",4,43,954,526,428
050,51,015,"Virginia","Augusta County",4,44,930,508,422
050,51,015,"Virginia","Augusta County",4,45,884,448,436
050,51,015,"Virginia","Augusta County",4,46,847,430,417
050,51,015,"Virginia","Augusta County",4,47,890,459,431
050,51,015,"Virginia","Augusta County",4,48,927,497,430
050,51,015,"Virginia","Augusta County",4,49,945,473,472
050,51,015,"Virginia","Augusta County",4,50,1028,526,502
050,51,015,"Virginia","Augusta County",4,51,1065,563,502
050,51,015,"Virginia","Augusta County",4,52,1066,546,520
050,51,015,"Virginia","Augusta County",4,53,1059,534,525
050,51,015,"Virginia","Augusta County",4,54,1046,552,494
050,51,015,"Virginia","Augusta County",4,55,1055,541,514
050,51,015,"Virginia","Augusta County",4,56,1087,545,542
050,51,015,"Virginia","Augusta County",4,57,1197,595,602
050,51,015,"Virginia","Augusta County",4,58,1222,599,623
050,51,015,"Virginia","Augusta County",4,59,1249,625,624
050,51,015,"Virginia","Augusta County",4,60,1221,625,596
050,51,015,"Virginia","Augusta County",4,61,1233,626,607
050,51,015,"Virginia","Augusta County",4,62,1151,575,576
050,51,015,"Virginia","Augusta County",4,63,1136,579,557
050,51,015,"Virginia","Augusta County",4,64,1176,582,594
050,51,015,"Virginia","Augusta County",4,65,1138,549,589
050,51,015,"Virginia","Augusta County",4,66,1077,499,578
050,51,015,"Virginia","Augusta County",4,67,1056,494,562
050,51,015,"Virginia","Augusta County",4,68,1096,539,557
050,51,015,"Virginia","Augusta County",4,69,1012,500,512
050,51,015,"Virginia","Augusta County",4,70,957,471,486
050,51,015,"Virginia","Augusta County",4,71,931,454,477
050,51,015,"Virginia","Augusta County",4,72,889,413,476
050,51,015,"Virginia","Augusta County",4,73,914,431,483
050,51,015,"Virginia","Augusta County",4,74,866,412,454
050,51,015,"Virginia","Augusta County",4,75,979,465,514
050,51,015,"Virginia","Augusta County",4,76,679,313,366
050,51,015,"Virginia","Augusta County",4,77,641,298,343
050,51,015,"Virginia","Augusta County",4,78,617,296,321
050,51,015,"Virginia","Augusta County",4,79,649,313,336
050,51,015,"Virginia","Augusta County",4,80,564,269,295
050,51,015,"Virginia","Augusta County",4,81,521,245,276
050,51,015,"Virginia","Augusta County",4,82,426,196,230
050,51,015,"Virginia","Augusta County",4,83,385,184,201
050,51,015,"Virginia","Augusta County",4,84,352,146,206
050,51,015,"Virginia","Augusta County",4,85,1842,707,1135
050,51,015,"Virginia","Augusta County",5,0,507,259,248
050,51,015,"Virginia","Augusta County",5,1,510,248,262
050,51,015,"Virginia","Augusta County",5,2,556,280,276
050,51,015,"Virginia","Augusta County",5,3,682,334,348
050,51,015,"Virginia","Augusta County",5,4,761,383,378
050,51,015,"Virginia","Augusta County",5,5,819,405,414
050,51,015,"Virginia","Augusta County",5,6,797,380,417
050,51,015,"Virginia","Augusta County",5,7,823,414,409
050,51,015,"Virginia","Augusta County",5,8,808,402,406
050,51,015,"Virginia","Augusta County",5,9,752,380,372
050,51,015,"Virginia","Augusta County",5,10,796,402,394
050,51,015,"Virginia","Augusta County",5,11,827,413,414
050,51,015,"Virginia","Augusta County",5,12,804,398,406
050,51,015,"Virginia","Augusta County",5,13,867,444,423
050,51,015,"Virginia","Augusta County",5,14,886,463,423
050,51,015,"Virginia","Augusta County",5,15,949,487,462
050,51,015,"Virginia","Augusta County",5,16,927,474,453
050,51,015,"Virginia","Augusta County",5,17,943,500,443
050,51,015,"Virginia","Augusta County",5,18,819,438,381
050,51,015,"Virginia","Augusta County",5,19,751,424,327
050,51,015,"Virginia","Augusta County",5,20,780,440,340
050,51,015,"Virginia","Augusta County",5,21,785,454,331
050,51,015,"Virginia","Augusta County",5,22,862,479,383
050,51,015,"Virginia","Augusta County",5,23,896,487,409
050,51,015,"Virginia","Augusta County",5,24,876,487,389
050,51,015,"Virginia","Augusta County",5,25,876,484,392
050,51,015,"Virginia","Augusta County",5,26,882,480,402
050,51,015,"Virginia","Augusta County",5,27,893,488,405
050,51,015,"Virginia","Augusta County",5,28,932,520,412
050,51,015,"Virginia","Augusta County",5,29,901,470,431
050,51,015,"Virginia","Augusta County",5,30,922,481,441
050,51,015,"Virginia","Augusta County",5,31,1015,551,464
050,51,015,"Virginia","Augusta County",5,32,987,539,448
050,51,015,"Virginia","Augusta County",5,33,1022,554,468
050,51,015,"Virginia","Augusta County",5,34,1006,535,471
050,51,015,"Virginia","Augusta County",5,35,947,526,421
050,51,015,"Virginia","Augusta County",5,36,964,518,446
050,51,015,"Virginia","Augusta County",5,37,959,507,452
050,51,015,"Virginia","Augusta County",5,38,959,494,465
050,51,015,"Virginia","Augusta County",5,39,953,523,430
050,51,015,"Virginia","Augusta County",5,40,964,496,468
050,51,015,"Virginia","Augusta County",5,41,969,521,448
050,51,015,"Virginia","Augusta County",5,42,990,525,465
050,51,015,"Virginia","Augusta County",5,43,969,518,451
050,51,015,"Virginia","Augusta County",5,44,981,540,441
050,51,015,"Virginia","Augusta County",5,45,921,491,430
050,51,015,"Virginia","Augusta County",5,46,912,464,448
050,51,015,"Virginia","Augusta County",5,47,834,422,412
050,51,015,"Virginia","Augusta County",5,48,902,477,425
050,51,015,"Virginia","Augusta County",5,49,892,466,426
050,51,015,"Virginia","Augusta County",5,50,958,474,484
050,51,015,"Virginia","Augusta County",5,51,1042,533,509
050,51,015,"Virginia","Augusta County",5,52,1071,576,495
050,51,015,"Virginia","Augusta County",5,53,1057,530,527
050,51,015,"Virginia","Augusta County",5,54,1073,540,533
050,51,015,"Virginia","Augusta County",5,55,1028,535,493
050,51,015,"Virginia","Augusta County",5,56,1065,555,510
050,51,015,"Virginia","Augusta County",5,57,1081,535,546
050,51,015,"Virginia","Augusta County",5,58,1205,596,609
050,51,015,"Virginia","Augusta County",5,59,1211,599,612
050,51,015,"Virginia","Augusta County",5,60,1232,623,609
050,51,015,"Virginia","Augusta County",5,61,1224,617,607
050,51,015,"Virginia","Augusta County",5,62,1227,627,600
050,51,015,"Virginia","Augusta County",5,63,1122,552,570
050,51,015,"Virginia","Augusta County",5,64,1149,584,565
050,51,015,"Virginia","Augusta County",5,65,1166,580,586
050,51,015,"Virginia","Augusta County",5,66,1140,539,601
050,51,015,"Virginia","Augusta County",5,67,1072,493,579
050,51,015,"Virginia","Augusta County",5,68,1053,484,569
050,51,015,"Virginia","Augusta County",5,69,1090,541,549
050,51,015,"Virginia","Augusta County",5,70,996,488,508
050,51,015,"Virginia","Augusta County",5,71,943,460,483
050,51,015,"Virginia","Augusta County",5,72,917,446,471
050,51,015,"Virginia","Augusta County",5,73,872,410,462
050,51,015,"Virginia","Augusta County",5,74,916,421,495
050,51,015,"Virginia","Augusta County",5,75,855,400,455
050,51,015,"Virginia","Augusta County",5,76,940,454,486
050,51,015,"Virginia","Augusta County",5,77,663,302,361
050,51,015,"Virginia","Augusta County",5,78,614,289,325
050,51,015,"Virginia","Augusta County",5,79,598,274,324
050,51,015,"Virginia","Augusta County",5,80,638,307,331
050,51,015,"Virginia","Augusta County",5,81,538,252,286
050,51,015,"Virginia","Augusta County",5,82,474,227,247
050,51,015,"Virginia","Augusta County",5,83,415,186,229
050,51,015,"Virginia","Augusta County",5,84,359,164,195
050,51,015,"Virginia","Augusta County",5,85,1908,723,1185
050,51,017,"Virginia","Bath County",1,0,42,22,20
050,51,017,"Virginia","Bath County",1,1,35,17,18
050,51,017,"Virginia","Bath County",1,2,35,16,19
050,51,017,"Virginia","Bath County",1,3,29,14,15
050,51,017,"Virginia","Bath County",1,4,36,19,17
050,51,017,"Virginia","Bath County",1,5,36,20,16
050,51,017,"Virginia","Bath County",1,6,37,15,22
050,51,017,"Virginia","Bath County",1,7,48,18,30
050,51,017,"Virginia","Bath County",1,8,31,16,15
050,51,017,"Virginia","Bath County",1,9,39,16,23
050,51,017,"Virginia","Bath County",1,10,31,15,16
050,51,017,"Virginia","Bath County",1,11,33,17,16
050,51,017,"Virginia","Bath County",1,12,36,18,18
050,51,017,"Virginia","Bath County",1,13,35,14,21
050,51,017,"Virginia","Bath County",1,14,29,13,16
050,51,017,"Virginia","Bath County",1,15,38,18,20
050,51,017,"Virginia","Bath County",1,16,39,20,19
050,51,017,"Virginia","Bath County",1,17,34,20,14
050,51,017,"Virginia","Bath County",1,18,39,22,17
050,51,017,"Virginia","Bath County",1,19,28,14,14
050,51,017,"Virginia","Bath County",1,20,36,21,15
050,51,017,"Virginia","Bath County",1,21,38,16,22
050,51,017,"Virginia","Bath County",1,22,39,19,20
050,51,017,"Virginia","Bath County",1,23,35,17,18
050,51,017,"Virginia","Bath County",1,24,38,20,18
050,51,017,"Virginia","Bath County",1,25,42,22,20
050,51,017,"Virginia","Bath County",1,26,40,17,23
050,51,017,"Virginia","Bath County",1,27,40,23,17
050,51,017,"Virginia","Bath County",1,28,39,22,17
050,51,017,"Virginia","Bath County",1,29,50,29,21
050,51,017,"Virginia","Bath County",1,30,41,23,18
050,51,017,"Virginia","Bath County",1,31,48,21,27
050,51,017,"Virginia","Bath County",1,32,54,25,29
050,51,017,"Virginia","Bath County",1,33,41,26,15
050,51,017,"Virginia","Bath County",1,34,43,19,24
050,51,017,"Virginia","Bath County",1,35,37,22,15
050,51,017,"Virginia","Bath County",1,36,39,24,15
050,51,017,"Virginia","Bath County",1,37,33,18,15
050,51,017,"Virginia","Bath County",1,38,39,19,20
050,51,017,"Virginia","Bath County",1,39,37,21,16
050,51,017,"Virginia","Bath County",1,40,40,21,19
050,51,017,"Virginia","Bath County",1,41,38,16,22
050,51,017,"Virginia","Bath County",1,42,46,22,24
050,51,017,"Virginia","Bath County",1,43,41,20,21
050,51,017,"Virginia","Bath County",1,44,46,25,21
050,51,017,"Virginia","Bath County",1,45,44,27,17
050,51,017,"Virginia","Bath County",1,46,47,26,21
050,51,017,"Virginia","Bath County",1,47,47,26,21
050,51,017,"Virginia","Bath County",1,48,59,27,32
050,51,017,"Virginia","Bath County",1,49,65,28,37
050,51,017,"Virginia","Bath County",1,50,57,28,29
050,51,017,"Virginia","Bath County",1,51,59,34,25
050,51,017,"Virginia","Bath County",1,52,63,40,23
050,51,017,"Virginia","Bath County",1,53,76,38,38
050,51,017,"Virginia","Bath County",1,54,69,38,31
050,51,017,"Virginia","Bath County",1,55,69,35,34
050,51,017,"Virginia","Bath County",1,56,72,37,35
050,51,017,"Virginia","Bath County",1,57,81,43,38
050,51,017,"Virginia","Bath County",1,58,79,41,38
050,51,017,"Virginia","Bath County",1,59,70,38,32
050,51,017,"Virginia","Bath County",1,60,61,33,28
050,51,017,"Virginia","Bath County",1,61,66,35,31
050,51,017,"Virginia","Bath County",1,62,70,28,42
050,51,017,"Virginia","Bath County",1,63,86,43,43
050,51,017,"Virginia","Bath County",1,64,71,38,33
050,51,017,"Virginia","Bath County",1,65,63,37,26
050,51,017,"Virginia","Bath County",1,66,70,37,33
050,51,017,"Virginia","Bath County",1,67,63,30,33
050,51,017,"Virginia","Bath County",1,68,67,32,35
050,51,017,"Virginia","Bath County",1,69,62,34,28
050,51,017,"Virginia","Bath County",1,70,67,35,32
050,51,017,"Virginia","Bath County",1,71,68,36,32
050,51,017,"Virginia","Bath County",1,72,82,46,36
050,51,017,"Virginia","Bath County",1,73,75,35,40
050,51,017,"Virginia","Bath County",1,74,51,19,32
050,51,017,"Virginia","Bath County",1,75,52,25,27
050,51,017,"Virginia","Bath County",1,76,45,26,19
050,51,017,"Virginia","Bath County",1,77,42,22,20
050,51,017,"Virginia","Bath County",1,78,35,18,17
050,51,017,"Virginia","Bath County",1,79,42,21,21
050,51,017,"Virginia","Bath County",1,80,43,22,21
050,51,017,"Virginia","Bath County",1,81,34,16,18
050,51,017,"Virginia","Bath County",1,82,25,9,16
050,51,017,"Virginia","Bath County",1,83,21,14,7
050,51,017,"Virginia","Bath County",1,84,20,10,10
050,51,017,"Virginia","Bath County",1,85,136,66,70
050,51,017,"Virginia","Bath County",2,0,42,23,19
050,51,017,"Virginia","Bath County",2,1,37,18,19
050,51,017,"Virginia","Bath County",2,2,35,16,19
050,51,017,"Virginia","Bath County",2,3,30,14,16
050,51,017,"Virginia","Bath County",2,4,33,17,16
050,51,017,"Virginia","Bath County",2,5,35,19,16
050,51,017,"Virginia","Bath County",2,6,35,15,20
050,51,017,"Virginia","Bath County",2,7,46,18,28
050,51,017,"Virginia","Bath County",2,8,35,16,19
050,51,017,"Virginia","Bath County",2,9,36,15,21
050,51,017,"Virginia","Bath County",2,10,33,15,18
050,51,017,"Virginia","Bath County",2,11,32,16,16
050,51,017,"Virginia","Bath County",2,12,35,18,17
050,51,017,"Virginia","Bath County",2,13,36,15,21
050,51,017,"Virginia","Bath County",2,14,30,13,17
050,51,017,"Virginia","Bath County",2,15,36,16,20
050,51,017,"Virginia","Bath County",2,16,38,19,19
050,51,017,"Virginia","Bath County",2,17,35,20,15
050,51,017,"Virginia","Bath County",2,18,37,21,16
050,51,017,"Virginia","Bath County",2,19,30,15,15
050,51,017,"Virginia","Bath County",2,20,35,19,16
050,51,017,"Virginia","Bath County",2,21,38,17,21
050,51,017,"Virginia","Bath County",2,22,40,19,21
050,51,017,"Virginia","Bath County",2,23,33,16,17
050,51,017,"Virginia","Bath County",2,24,37,19,18
050,51,017,"Virginia","Bath County",2,25,40,21,19
050,51,017,"Virginia","Bath County",2,26,41,19,22
050,51,017,"Virginia","Bath County",2,27,39,21,18
050,51,017,"Virginia","Bath County",2,28,39,22,17
050,51,017,"Virginia","Bath County",2,29,47,27,20
050,51,017,"Virginia","Bath County",2,30,42,24,18
050,51,017,"Virginia","Bath County",2,31,48,22,26
050,51,017,"Virginia","Bath County",2,32,52,24,28
050,51,017,"Virginia","Bath County",2,33,44,25,19
050,51,017,"Virginia","Bath County",2,34,43,21,22
050,51,017,"Virginia","Bath County",2,35,39,22,17
050,51,017,"Virginia","Bath County",2,36,38,23,15
050,51,017,"Virginia","Bath County",2,37,35,20,15
050,51,017,"Virginia","Bath County",2,38,36,18,18
050,51,017,"Virginia","Bath County",2,39,38,21,17
050,51,017,"Virginia","Bath County",2,40,40,21,19
050,51,017,"Virginia","Bath County",2,41,39,17,22
050,51,017,"Virginia","Bath County",2,42,45,21,24
050,51,017,"Virginia","Bath County",2,43,44,21,23
050,51,017,"Virginia","Bath County",2,44,44,24,20
050,51,017,"Virginia","Bath County",2,45,44,26,18
050,51,017,"Virginia","Bath County",2,46,46,26,20
050,51,017,"Virginia","Bath County",2,47,47,26,21
050,51,017,"Virginia","Bath County",2,48,57,27,30
050,51,017,"Virginia","Bath County",2,49,63,28,35
050,51,017,"Virginia","Bath County",2,50,59,28,31
050,51,017,"Virginia","Bath County",2,51,57,31,26
050,51,017,"Virginia","Bath County",2,52,61,38,23
050,51,017,"Virginia","Bath County",2,53,73,37,36
050,51,017,"Virginia","Bath County",2,54,70,38,32
050,51,017,"Virginia","Bath County",2,55,68,35,33
050,51,017,"Virginia","Bath County",2,56,72,37,35
050,51,017,"Virginia","Bath County",2,57,78,41,37
050,51,017,"Virginia","Bath County",2,58,78,41,37
050,51,017,"Virginia","Bath County",2,59,72,39,33
050,51,017,"Virginia","Bath County",2,60,63,34,29
050,51,017,"Virginia","Bath County",2,61,65,34,31
050,51,017,"Virginia","Bath County",2,62,69,30,39
050,51,017,"Virginia","Bath County",2,63,83,40,43
050,51,017,"Virginia","Bath County",2,64,74,39,35
050,51,017,"Virginia","Bath County",2,65,64,36,28
050,51,017,"Virginia","Bath County",2,66,69,37,32
050,51,017,"Virginia","Bath County",2,67,66,32,34
050,51,017,"Virginia","Bath County",2,68,64,30,34
050,51,017,"Virginia","Bath County",2,69,63,33,30
050,51,017,"Virginia","Bath County",2,70,66,35,31
050,51,017,"Virginia","Bath County",2,71,67,36,31
050,51,017,"Virginia","Bath County",2,72,78,43,35
050,51,017,"Virginia","Bath County",2,73,80,39,41
050,51,017,"Virginia","Bath County",2,74,52,21,31
050,51,017,"Virginia","Bath County",2,75,52,24,28
050,51,017,"Virginia","Bath County",2,76,44,24,20
050,51,017,"Virginia","Bath County",2,77,45,24,21
050,51,017,"Virginia","Bath County",2,78,33,18,15
050,51,017,"Virginia","Bath County",2,79,39,19,20
050,51,017,"Virginia","Bath County",2,80,42,21,21
050,51,017,"Virginia","Bath County",2,81,35,17,18
050,51,017,"Virginia","Bath County",2,82,27,9,18
050,51,017,"Virginia","Bath County",2,83,21,13,8
050,51,017,"Virginia","Bath County",2,84,20,11,9
050,51,017,"Virginia","Bath County",2,85,137,66,71
050,51,017,"Virginia","Bath County",3,0,38,19,19
050,51,017,"Virginia","Bath County",3,1,44,28,16
050,51,017,"Virginia","Bath County",3,2,38,20,18
050,51,017,"Virginia","Bath County",3,3,39,18,21
050,51,017,"Virginia","Bath County",3,4,27,14,13
050,51,017,"Virginia","Bath County",3,5,31,17,14
050,51,017,"Virginia","Bath County",3,6,35,18,17
050,51,017,"Virginia","Bath County",3,7,35,15,20
050,51,017,"Virginia","Bath County",3,8,44,17,27
050,51,017,"Virginia","Bath County",3,9,35,17,18
050,51,017,"Virginia","Bath County",3,10,38,16,22
050,51,017,"Virginia","Bath County",3,11,33,14,19
050,51,017,"Virginia","Bath County",3,12,26,14,12
050,51,017,"Virginia","Bath County",3,13,37,19,18
050,51,017,"Virginia","Bath County",3,14,33,13,20
050,51,017,"Virginia","Bath County",3,15,33,14,19
050,51,017,"Virginia","Bath County",3,16,37,17,20
050,51,017,"Virginia","Bath County",3,17,40,21,19
050,51,017,"Virginia","Bath County",3,18,30,18,12
050,51,017,"Virginia","Bath County",3,19,28,17,11
050,51,017,"Virginia","Bath County",3,20,32,15,17
050,51,017,"Virginia","Bath County",3,21,35,18,17
050,51,017,"Virginia","Bath County",3,22,36,17,19
050,51,017,"Virginia","Bath County",3,23,40,19,21
050,51,017,"Virginia","Bath County",3,24,37,16,21
050,51,017,"Virginia","Bath County",3,25,30,18,12
050,51,017,"Virginia","Bath County",3,26,40,22,18
050,51,017,"Virginia","Bath County",3,27,36,16,20
050,51,017,"Virginia","Bath County",3,28,34,19,15
050,51,017,"Virginia","Bath County",3,29,37,19,18
050,51,017,"Virginia","Bath County",3,30,50,31,19
050,51,017,"Virginia","Bath County",3,31,41,21,20
050,51,017,"Virginia","Bath County",3,32,44,21,23
050,51,017,"Virginia","Bath County",3,33,51,22,29
050,51,017,"Virginia","Bath County",3,34,43,25,18
050,51,017,"Virginia","Bath County",3,35,39,20,19
050,51,017,"Virginia","Bath County",3,36,36,20,16
050,51,017,"Virginia","Bath County",3,37,38,25,13
050,51,017,"Virginia","Bath County",3,38,36,21,15
050,51,017,"Virginia","Bath County",3,39,39,20,19
050,51,017,"Virginia","Bath County",3,40,38,21,17
050,51,017,"Virginia","Bath County",3,41,39,19,20
050,51,017,"Virginia","Bath County",3,42,35,16,19
050,51,017,"Virginia","Bath County",3,43,42,19,23
050,51,017,"Virginia","Bath County",3,44,39,18,21
050,51,017,"Virginia","Bath County",3,45,41,23,18
050,51,017,"Virginia","Bath County",3,46,37,21,16
050,51,017,"Virginia","Bath County",3,47,46,28,18
050,51,017,"Virginia","Bath County",3,48,46,27,19
050,51,017,"Virginia","Bath County",3,49,61,26,35
050,51,017,"Virginia","Bath County",3,50,59,28,31
050,51,017,"Virginia","Bath County",3,51,57,27,30
050,51,017,"Virginia","Bath County",3,52,53,28,25
050,51,017,"Virginia","Bath County",3,53,66,39,27
050,51,017,"Virginia","Bath County",3,54,70,34,36
050,51,017,"Virginia","Bath County",3,55,69,37,32
050,51,017,"Virginia","Bath County",3,56,67,35,32
050,51,017,"Virginia","Bath County",3,57,73,35,38
050,51,017,"Virginia","Bath County",3,58,75,39,36
050,51,017,"Virginia","Bath County",3,59,74,36,38
050,51,017,"Virginia","Bath County",3,60,70,38,32
050,51,017,"Virginia","Bath County",3,61,62,34,28
050,51,017,"Virginia","Bath County",3,62,68,35,33
050,51,017,"Virginia","Bath County",3,63,73,33,40
050,51,017,"Virginia","Bath County",3,64,82,42,40
050,51,017,"Virginia","Bath County",3,65,79,39,40
050,51,017,"Virginia","Bath County",3,66,62,36,26
050,51,017,"Virginia","Bath County",3,67,71,39,32
050,51,017,"Virginia","Bath County",3,68,62,30,32
050,51,017,"Virginia","Bath County",3,69,62,29,33
050,51,017,"Virginia","Bath County",3,70,62,33,29
050,51,017,"Virginia","Bath County",3,71,63,34,29
050,51,017,"Virginia","Bath County",3,72,66,36,30
050,51,017,"Virginia","Bath County",3,73,74,40,34
050,51,017,"Virginia","Bath County",3,74,75,37,38
050,51,017,"Virginia","Bath County",3,75,50,19,31
050,51,017,"Virginia","Bath County",3,76,43,19,24
050,51,017,"Virginia","Bath County",3,77,46,26,20
050,51,017,"Virginia","Bath County",3,78,43,23,20
050,51,017,"Virginia","Bath County",3,79,35,20,15
050,51,017,"Virginia","Bath County",3,80,36,17,19
050,51,017,"Virginia","Bath County",3,81,39,20,19
050,51,017,"Virginia","Bath County",3,82,37,15,22
050,51,017,"Virginia","Bath County",3,83,20,8,12
050,51,017,"Virginia","Bath County",3,84,20,13,7
050,51,017,"Virginia","Bath County",3,85,128,65,63
050,51,017,"Virginia","Bath County",4,0,40,17,23
050,51,017,"Virginia","Bath County",4,1,44,23,21
050,51,017,"Virginia","Bath County",4,2,48,29,19
050,51,017,"Virginia","Bath County",4,3,39,21,18
050,51,017,"Virginia","Bath County",4,4,37,18,19
050,51,017,"Virginia","Bath County",4,5,29,14,15
050,51,017,"Virginia","Bath County",4,6,34,19,15
050,51,017,"Virginia","Bath County",4,7,38,19,19
050,51,017,"Virginia","Bath County",4,8,37,16,21
050,51,017,"Virginia","Bath County",4,9,44,18,26
050,51,017,"Virginia","Bath County",4,10,30,12,18
050,51,017,"Virginia","Bath County",4,11,38,16,22
050,51,017,"Virginia","Bath County",4,12,35,16,19
050,51,017,"Virginia","Bath County",4,13,25,13,12
050,51,017,"Virginia","Bath County",4,14,36,18,18
050,51,017,"Virginia","Bath County",4,15,32,14,18
050,51,017,"Virginia","Bath County",4,16,33,16,17
050,51,017,"Virginia","Bath County",4,17,38,18,20
050,51,017,"Virginia","Bath County",4,18,34,19,15
050,51,017,"Virginia","Bath County",4,19,18,12,6
050,51,017,"Virginia","Bath County",4,20,32,19,13
050,51,017,"Virginia","Bath County",4,21,36,17,19
050,51,017,"Virginia","Bath County",4,22,34,19,15
050,51,017,"Virginia","Bath County",4,23,39,20,19
050,51,017,"Virginia","Bath County",4,24,38,16,22
050,51,017,"Virginia","Bath County",4,25,33,16,17
050,51,017,"Virginia","Bath County",4,26,32,18,14
050,51,017,"Virginia","Bath County",4,27,33,16,17
050,51,017,"Virginia","Bath County",4,28,32,14,18
050,51,017,"Virginia","Bath County",4,29,35,19,16
050,51,017,"Virginia","Bath County",4,30,47,27,20
050,51,017,"Virginia","Bath County",4,31,51,30,21
050,51,017,"Virginia","Bath County",4,32,47,26,21
050,51,017,"Virginia","Bath County",4,33,40,19,21
050,51,017,"Virginia","Bath County",4,34,49,21,28
050,51,017,"Virginia","Bath County",4,35,44,24,20
050,51,017,"Virginia","Bath County",4,36,41,20,21
050,51,017,"Virginia","Bath County",4,37,36,18,18
050,51,017,"Virginia","Bath County",4,38,39,26,13
050,51,017,"Virginia","Bath County",4,39,32,18,14
050,51,017,"Virginia","Bath County",4,40,40,20,20
050,51,017,"Virginia","Bath County",4,41,38,21,17
050,51,017,"Virginia","Bath County",4,42,41,20,21
050,51,017,"Virginia","Bath County",4,43,37,16,21
050,51,017,"Virginia","Bath County",4,44,42,20,22
050,51,017,"Virginia","Bath County",4,45,40,19,21
050,51,017,"Virginia","Bath County",4,46,39,22,17
050,51,017,"Virginia","Bath County",4,47,41,25,16
050,51,017,"Virginia","Bath County",4,48,41,24,17
050,51,017,"Virginia","Bath County",4,49,47,27,20
050,51,017,"Virginia","Bath County",4,50,56,26,30
050,51,017,"Virginia","Bath County",4,51,61,29,32
050,51,017,"Virginia","Bath County",4,52,54,26,28
050,51,017,"Virginia","Bath County",4,53,51,27,24
050,51,017,"Virginia","Bath County",4,54,60,36,24
050,51,017,"Virginia","Bath County",4,55,66,32,34
050,51,017,"Virginia","Bath County",4,56,67,38,29
050,51,017,"Virginia","Bath County",4,57,69,34,35
050,51,017,"Virginia","Bath County",4,58,73,36,37
050,51,017,"Virginia","Bath County",4,59,70,36,34
050,51,017,"Virginia","Bath County",4,60,69,33,36
050,51,017,"Virginia","Bath County",4,61,76,42,34
050,51,017,"Virginia","Bath County",4,62,61,34,27
050,51,017,"Virginia","Bath County",4,63,66,36,30
050,51,017,"Virginia","Bath County",4,64,70,31,39
050,51,017,"Virginia","Bath County",4,65,80,41,39
050,51,017,"Virginia","Bath County",4,66,84,41,43
050,51,017,"Virginia","Bath County",4,67,63,37,26
050,51,017,"Virginia","Bath County",4,68,73,40,33
050,51,017,"Virginia","Bath County",4,69,61,28,33
050,51,017,"Virginia","Bath County",4,70,59,29,30
050,51,017,"Virginia","Bath County",4,71,64,34,30
050,51,017,"Virginia","Bath County",4,72,68,36,32
050,51,017,"Virginia","Bath County",4,73,60,33,27
050,51,017,"Virginia","Bath County",4,74,71,38,33
050,51,017,"Virginia","Bath County",4,75,74,38,36
050,51,017,"Virginia","Bath County",4,76,50,20,30
050,51,017,"Virginia","Bath County",4,77,41,20,21
050,51,017,"Virginia","Bath County",4,78,42,24,18
050,51,017,"Virginia","Bath County",4,79,43,22,21
050,51,017,"Virginia","Bath County",4,80,32,17,15
050,51,017,"Virginia","Bath County",4,81,33,16,17
050,51,017,"Virginia","Bath County",4,82,42,19,23
050,51,017,"Virginia","Bath County",4,83,30,15,15
050,51,017,"Virginia","Bath County",4,84,17,8,9
050,51,017,"Virginia","Bath County",4,85,120,61,59
050,51,017,"Virginia","Bath County",5,0,42,18,24
050,51,017,"Virginia","Bath County",5,1,41,19,22
050,51,017,"Virginia","Bath County",5,2,43,22,21
050,51,017,"Virginia","Bath County",5,3,50,28,22
050,51,017,"Virginia","Bath County",5,4,40,22,18
050,51,017,"Virginia","Bath County",5,5,38,19,19
050,51,017,"Virginia","Bath County",5,6,27,13,14
050,51,017,"Virginia","Bath County",5,7,35,21,14
050,51,017,"Virginia","Bath County",5,8,39,18,21
050,51,017,"Virginia","Bath County",5,9,40,18,22
050,51,017,"Virginia","Bath County",5,10,41,19,22
050,51,017,"Virginia","Bath County",5,11,31,12,19
050,51,017,"Virginia","Bath County",5,12,39,18,21
050,51,017,"Virginia","Bath County",5,13,38,17,21
050,51,017,"Virginia","Bath County",5,14,25,13,12
050,51,017,"Virginia","Bath County",5,15,39,20,19
050,51,017,"Virginia","Bath County",5,16,32,13,19
050,51,017,"Virginia","Bath County",5,17,33,16,17
050,51,017,"Virginia","Bath County",5,18,30,16,14
050,51,017,"Virginia","Bath County",5,19,27,14,13
050,51,017,"Virginia","Bath County",5,20,22,15,7
050,51,017,"Virginia","Bath County",5,21,31,19,12
050,51,017,"Virginia","Bath County",5,22,40,17,23
050,51,017,"Virginia","Bath County",5,23,34,17,17
050,51,017,"Virginia","Bath County",5,24,38,19,19
050,51,017,"Virginia","Bath County",5,25,40,15,25
050,51,017,"Virginia","Bath County",5,26,34,16,18
050,51,017,"Virginia","Bath County",5,27,29,13,16
050,51,017,"Virginia","Bath County",5,28,36,17,19
050,51,017,"Virginia","Bath County",5,29,34,12,22
050,51,017,"Virginia","Bath County",5,30,34,16,18
050,51,017,"Virginia","Bath County",5,31,44,25,19
050,51,017,"Virginia","Bath County",5,32,53,31,22
050,51,017,"Virginia","Bath County",5,33,49,26,23
050,51,017,"Virginia","Bath County",5,34,40,21,19
050,51,017,"Virginia","Bath County",5,35,48,22,26
050,51,017,"Virginia","Bath County",5,36,42,24,18
050,51,017,"Virginia","Bath County",5,37,43,20,23
050,51,017,"Virginia","Bath County",5,38,35,18,17
050,51,017,"Virginia","Bath County",5,39,36,25,11
050,51,017,"Virginia","Bath County",5,40,30,16,14
050,51,017,"Virginia","Bath County",5,41,37,18,19
050,51,017,"Virginia","Bath County",5,42,40,22,18
050,51,017,"Virginia","Bath County",5,43,45,23,22
050,51,017,"Virginia","Bath County",5,44,37,16,21
050,51,017,"Virginia","Bath County",5,45,39,16,23
050,51,017,"Virginia","Bath County",5,46,38,18,20
050,51,017,"Virginia","Bath County",5,47,41,24,17
050,51,017,"Virginia","Bath County",5,48,41,23,18
050,51,017,"Virginia","Bath County",5,49,41,22,19
050,51,017,"Virginia","Bath County",5,50,45,27,18
050,51,017,"Virginia","Bath County",5,51,58,26,32
050,51,017,"Virginia","Bath County",5,52,63,27,36
050,51,017,"Virginia","Bath County",5,53,53,27,26
050,51,017,"Virginia","Bath County",5,54,49,25,24
050,51,017,"Virginia","Bath County",5,55,58,36,22
050,51,017,"Virginia","Bath County",5,56,69,32,37
050,51,017,"Virginia","Bath County",5,57,68,38,30
050,51,017,"Virginia","Bath County",5,58,69,36,33
050,51,017,"Virginia","Bath County",5,59,72,34,38
050,51,017,"Virginia","Bath County",5,60,70,35,35
050,51,017,"Virginia","Bath County",5,61,70,34,36
050,51,017,"Virginia","Bath County",5,62,76,42,34
050,51,017,"Virginia","Bath County",5,63,67,38,29
050,51,017,"Virginia","Bath County",5,64,67,37,30
050,51,017,"Virginia","Bath County",5,65,67,29,38
050,51,017,"Virginia","Bath County",5,66,80,41,39
050,51,017,"Virginia","Bath County",5,67,79,39,40
050,51,017,"Virginia","Bath County",5,68,69,40,29
050,51,017,"Virginia","Bath County",5,69,73,40,33
050,51,017,"Virginia","Bath County",5,70,58,27,31
050,51,017,"Virginia","Bath County",5,71,57,28,29
050,51,017,"Virginia","Bath County",5,72,69,36,33
050,51,017,"Virginia","Bath County",5,73,63,33,30
050,51,017,"Virginia","Bath County",5,74,55,31,24
050,51,017,"Virginia","Bath County",5,75,69,36,33
050,51,017,"Virginia","Bath County",5,76,71,36,35
050,51,017,"Virginia","Bath County",5,77,50,21,29
050,51,017,"Virginia","Bath County",5,78,39,18,21
050,51,017,"Virginia","Bath County",5,79,42,23,19
050,51,017,"Virginia","Bath County",5,80,38,17,21
050,51,017,"Virginia","Bath County",5,81,29,16,13
050,51,017,"Virginia","Bath County",5,82,36,14,22
050,51,017,"Virginia","Bath County",5,83,36,19,17
050,51,017,"Virginia","Bath County",5,84,28,15,13
050,51,017,"Virginia","Bath County",5,85,108,57,51
050,51,019,"Virginia","Bedford County",1,0,675,343,332
050,51,019,"Virginia","Bedford County",1,1,690,335,355
050,51,019,"Virginia","Bedford County",1,2,751,374,377
050,51,019,"Virginia","Bedford County",1,3,761,374,387
050,51,019,"Virginia","Bedford County",1,4,790,377,413
050,51,019,"Virginia","Bedford County",1,5,832,414,418
050,51,019,"Virginia","Bedford County",1,6,836,434,402
050,51,019,"Virginia","Bedford County",1,7,878,470,408
050,51,019,"Virginia","Bedford County",1,8,853,443,410
050,51,019,"Virginia","Bedford County",1,9,905,447,458
050,51,019,"Virginia","Bedford County",1,10,890,444,446
050,51,019,"Virginia","Bedford County",1,11,930,496,434
050,51,019,"Virginia","Bedford County",1,12,955,493,462
050,51,019,"Virginia","Bedford County",1,13,985,495,490
050,51,019,"Virginia","Bedford County",1,14,985,491,494
050,51,019,"Virginia","Bedford County",1,15,995,499,496
050,51,019,"Virginia","Bedford County",1,16,1048,532,516
050,51,019,"Virginia","Bedford County",1,17,1049,541,508
050,51,019,"Virginia","Bedford County",1,18,871,454,417
050,51,019,"Virginia","Bedford County",1,19,709,371,338
050,51,019,"Virginia","Bedford County",1,20,753,383,370
050,51,019,"Virginia","Bedford County",1,21,769,379,390
050,51,019,"Virginia","Bedford County",1,22,870,419,451
050,51,019,"Virginia","Bedford County",1,23,893,458,435
050,51,019,"Virginia","Bedford County",1,24,850,441,409
050,51,019,"Virginia","Bedford County",1,25,829,439,390
050,51,019,"Virginia","Bedford County",1,26,780,411,369
050,51,019,"Virginia","Bedford County",1,27,831,416,415
050,51,019,"Virginia","Bedford County",1,28,840,420,420
050,51,019,"Virginia","Bedford County",1,29,842,418,424
050,51,019,"Virginia","Bedford County",1,30,818,411,407
050,51,019,"Virginia","Bedford County",1,31,825,407,418
050,51,019,"Virginia","Bedford County",1,32,777,401,376
050,51,019,"Virginia","Bedford County",1,33,817,413,404
050,51,019,"Virginia","Bedford County",1,34,842,414,428
050,51,019,"Virginia","Bedford County",1,35,820,416,404
050,51,019,"Virginia","Bedford County",1,36,767,378,389
050,51,019,"Virginia","Bedford County",1,37,841,402,439
050,51,019,"Virginia","Bedford County",1,38,822,410,412
050,51,019,"Virginia","Bedford County",1,39,807,423,384
050,51,019,"Virginia","Bedford County",1,40,829,406,423
050,51,019,"Virginia","Bedford County",1,41,819,402,417
050,51,019,"Virginia","Bedford County",1,42,865,442,423
050,51,019,"Virginia","Bedford County",1,43,789,398,391
050,51,019,"Virginia","Bedford County",1,44,865,412,453
050,51,019,"Virginia","Bedford County",1,45,900,450,450
050,51,019,"Virginia","Bedford County",1,46,898,441,457
050,51,019,"Virginia","Bedford County",1,47,996,492,504
050,51,019,"Virginia","Bedford County",1,48,1105,541,564
050,51,019,"Virginia","Bedford County",1,49,1221,598,623
050,51,019,"Virginia","Bedford County",1,50,1168,579,589
050,51,019,"Virginia","Bedford County",1,51,1121,554,567
050,51,019,"Virginia","Bedford County",1,52,1109,557,552
050,51,019,"Virginia","Bedford County",1,53,1101,555,546
050,51,019,"Virginia","Bedford County",1,54,1156,566,590
050,51,019,"Virginia","Bedford County",1,55,1300,638,662
050,51,019,"Virginia","Bedford County",1,56,1350,672,678
050,51,019,"Virginia","Bedford County",1,57,1296,638,658
050,51,019,"Virginia","Bedford County",1,58,1348,665,683
050,51,019,"Virginia","Bedford County",1,59,1342,665,677
050,51,019,"Virginia","Bedford County",1,60,1367,682,685
050,51,019,"Virginia","Bedford County",1,61,1351,677,674
050,51,019,"Virginia","Bedford County",1,62,1324,662,662
050,51,019,"Virginia","Bedford County",1,63,1317,672,645
050,51,019,"Virginia","Bedford County",1,64,1276,623,653
050,51,019,"Virginia","Bedford County",1,65,1250,608,642
050,51,019,"Virginia","Bedford County",1,66,1182,600,582
050,51,019,"Virginia","Bedford County",1,67,1156,585,571
050,51,019,"Virginia","Bedford County",1,68,1164,575,589
050,51,019,"Virginia","Bedford County",1,69,1053,512,541
050,51,019,"Virginia","Bedford County",1,70,1005,505,500
050,51,019,"Virginia","Bedford County",1,71,1011,497,514
050,51,019,"Virginia","Bedford County",1,72,1006,478,528
050,51,019,"Virginia","Bedford County",1,73,1036,517,519
050,51,019,"Virginia","Bedford County",1,74,730,365,365
050,51,019,"Virginia","Bedford County",1,75,701,336,365
050,51,019,"Virginia","Bedford County",1,76,737,349,388
050,51,019,"Virginia","Bedford County",1,77,759,339,420
050,51,019,"Virginia","Bedford County",1,78,603,285,318
050,51,019,"Virginia","Bedford County",1,79,513,242,271
050,51,019,"Virginia","Bedford County",1,80,473,211,262
050,51,019,"Virginia","Bedford County",1,81,433,196,237
050,51,019,"Virginia","Bedford County",1,82,384,180,204
050,51,019,"Virginia","Bedford County",1,83,332,155,177
050,51,019,"Virginia","Bedford County",1,84,284,125,159
050,51,019,"Virginia","Bedford County",1,85,1659,660,999
050,51,019,"Virginia","Bedford County",2,0,656,329,327
050,51,019,"Virginia","Bedford County",2,1,688,338,350
050,51,019,"Virginia","Bedford County",2,2,745,368,377
050,51,019,"Virginia","Bedford County",2,3,762,375,387
050,51,019,"Virginia","Bedford County",2,4,792,383,409
050,51,019,"Virginia","Bedford County",2,5,825,407,418
050,51,019,"Virginia","Bedford County",2,6,837,431,406
050,51,019,"Virginia","Bedford County",2,7,870,463,407
050,51,019,"Virginia","Bedford County",2,8,859,447,412
050,51,019,"Virginia","Bedford County",2,9,886,440,446
050,51,019,"Virginia","Bedford County",2,10,893,444,449
050,51,019,"Virginia","Bedford County",2,11,922,484,438
050,51,019,"Virginia","Bedford County",2,12,957,497,460
050,51,019,"Virginia","Bedford County",2,13,984,498,486
050,51,019,"Virginia","Bedford County",2,14,989,492,497
050,51,019,"Virginia","Bedford County",2,15,999,499,500
050,51,019,"Virginia","Bedford County",2,16,1043,528,515
050,51,019,"Virginia","Bedford County",2,17,1055,540,515
050,51,019,"Virginia","Bedford County",2,18,868,455,413
050,51,019,"Virginia","Bedford County",2,19,709,372,337
050,51,019,"Virginia","Bedford County",2,20,766,391,375
050,51,019,"Virginia","Bedford County",2,21,781,385,396
050,51,019,"Virginia","Bedford County",2,22,858,416,442
050,51,019,"Virginia","Bedford County",2,23,888,449,439
050,51,019,"Virginia","Bedford County",2,24,859,448,411
050,51,019,"Virginia","Bedford County",2,25,829,440,389
050,51,019,"Virginia","Bedford County",2,26,795,418,377
050,51,019,"Virginia","Bedford County",2,27,822,418,404
050,51,019,"Virginia","Bedford County",2,28,845,422,423
050,51,019,"Virginia","Bedford County",2,29,844,421,423
050,51,019,"Virginia","Bedford County",2,30,837,416,421
050,51,019,"Virginia","Bedford County",2,31,826,410,416
050,51,019,"Virginia","Bedford County",2,32,793,407,386
050,51,019,"Virginia","Bedford County",2,33,807,411,396
050,51,019,"Virginia","Bedford County",2,34,845,419,426
050,51,019,"Virginia","Bedford County",2,35,833,420,413
050,51,019,"Virginia","Bedford County",2,36,777,385,392
050,51,019,"Virginia","Bedford County",2,37,825,394,431
050,51,019,"Virginia","Bedford County",2,38,829,412,417
050,51,019,"Virginia","Bedford County",2,39,813,422,391
050,51,019,"Virginia","Bedford County",2,40,827,412,415
050,51,019,"Virginia","Bedford County",2,41,822,403,419
050,51,019,"Virginia","Bedford County",2,42,847,429,418
050,51,019,"Virginia","Bedford County",2,43,815,411,404
050,51,019,"Virginia","Bedford County",2,44,839,404,435
050,51,019,"Virginia","Bedford County",2,45,899,444,455
050,51,019,"Virginia","Bedford County",2,46,899,444,455
050,51,019,"Virginia","Bedford County",2,47,965,476,489
050,51,019,"Virginia","Bedford County",2,48,1080,532,548
050,51,019,"Virginia","Bedford County",2,49,1203,589,614
050,51,019,"Virginia","Bedford County",2,50,1186,586,600
050,51,019,"Virginia","Bedford County",2,51,1129,560,569
050,51,019,"Virginia","Bedford County",2,52,1112,557,555
050,51,019,"Virginia","Bedford County",2,53,1099,555,544
050,51,019,"Virginia","Bedford County",2,54,1139,562,577
050,51,019,"Virginia","Bedford County",2,55,1267,622,645
050,51,019,"Virginia","Bedford County",2,56,1343,666,677
050,51,019,"Virginia","Bedford County",2,57,1319,652,667
050,51,019,"Virginia","Bedford County",2,58,1341,662,679
050,51,019,"Virginia","Bedford County",2,59,1352,670,682
050,51,019,"Virginia","Bedford County",2,60,1360,677,683
050,51,019,"Virginia","Bedford County",2,61,1357,678,679
050,51,019,"Virginia","Bedford County",2,62,1330,664,666
050,51,019,"Virginia","Bedford County",2,63,1327,673,654
050,51,019,"Virginia","Bedford County",2,64,1277,629,648
050,51,019,"Virginia","Bedford County",2,65,1257,613,644
050,51,019,"Virginia","Bedford County",2,66,1206,606,600
050,51,019,"Virginia","Bedford County",2,67,1159,588,571
050,51,019,"Virginia","Bedford County",2,68,1154,570,584
050,51,019,"Virginia","Bedford County",2,69,1085,531,554
050,51,019,"Virginia","Bedford County",2,70,1011,507,504
050,51,019,"Virginia","Bedford County",2,71,998,496,502
050,51,019,"Virginia","Bedford County",2,72,991,478,513
050,51,019,"Virginia","Bedford County",2,73,1076,532,544
050,51,019,"Virginia","Bedford County",2,74,752,377,375
050,51,019,"Virginia","Bedford County",2,75,704,340,364
050,51,019,"Virginia","Bedford County",2,76,721,342,379
050,51,019,"Virginia","Bedford County",2,77,765,345,420
050,51,019,"Virginia","Bedford County",2,78,618,284,334
050,51,019,"Virginia","Bedford County",2,79,518,243,275
050,51,019,"Virginia","Bedford County",2,80,480,216,264
050,51,019,"Virginia","Bedford County",2,81,435,197,238
050,51,019,"Virginia","Bedford County",2,82,391,183,208
050,51,019,"Virginia","Bedford County",2,83,337,155,182
050,51,019,"Virginia","Bedford County",2,84,289,129,160
050,51,019,"Virginia","Bedford County",2,85,1667,665,1002
050,51,019,"Virginia","Bedford County",3,0,618,319,299
050,51,019,"Virginia","Bedford County",3,1,658,344,314
050,51,019,"Virginia","Bedford County",3,2,738,372,366
050,51,019,"Virginia","Bedford County",3,3,793,390,403
050,51,019,"Virginia","Bedford County",3,4,785,394,391
050,51,019,"Virginia","Bedford County",3,5,813,405,408
050,51,019,"Virginia","Bedford County",3,6,833,399,434
050,51,019,"Virginia","Bedford County",3,7,849,436,413
050,51,019,"Virginia","Bedford County",3,8,893,482,411
050,51,019,"Virginia","Bedford County",3,9,901,463,438
050,51,019,"Virginia","Bedford County",3,10,887,443,444
050,51,019,"Virginia","Bedford County",3,11,915,453,462
050,51,019,"Virginia","Bedford County",3,12,945,496,449
050,51,019,"Virginia","Bedford County",3,13,985,506,479
050,51,019,"Virginia","Bedford County",3,14,1001,504,497
050,51,019,"Virginia","Bedford County",3,15,996,501,495
050,51,019,"Virginia","Bedford County",3,16,1013,491,522
050,51,019,"Virginia","Bedford County",3,17,1052,539,513
050,51,019,"Virginia","Bedford County",3,18,903,473,430
050,51,019,"Virginia","Bedford County",3,19,717,390,327
050,51,019,"Virginia","Bedford County",3,20,771,402,369
050,51,019,"Virginia","Bedford County",3,21,814,420,394
050,51,019,"Virginia","Bedford County",3,22,840,413,427
050,51,019,"Virginia","Bedford County",3,23,865,426,439
050,51,019,"Virginia","Bedford County",3,24,908,467,441
050,51,019,"Virginia","Bedford County",3,25,862,432,430
050,51,019,"Virginia","Bedford County",3,26,844,448,396
050,51,019,"Virginia","Bedford County",3,27,827,427,400
050,51,019,"Virginia","Bedford County",3,28,841,427,414
050,51,019,"Virginia","Bedford County",3,29,866,430,436
050,51,019,"Virginia","Bedford County",3,30,845,403,442
050,51,019,"Virginia","Bedford County",3,31,840,421,419
050,51,019,"Virginia","Bedford County",3,32,860,443,417
050,51,019,"Virginia","Bedford County",3,33,797,413,384
050,51,019,"Virginia","Bedford County",3,34,856,426,430
050,51,019,"Virginia","Bedford County",3,35,879,420,459
050,51,019,"Virginia","Bedford County",3,36,858,426,432
050,51,019,"Virginia","Bedford County",3,37,793,390,403
050,51,019,"Virginia","Bedford County",3,38,835,406,429
050,51,019,"Virginia","Bedford County",3,39,851,419,432
050,51,019,"Virginia","Bedford County",3,40,817,418,399
050,51,019,"Virginia","Bedford County",3,41,841,414,427
050,51,019,"Virginia","Bedford County",3,42,840,416,424
050,51,019,"Virginia","Bedford County",3,43,895,458,437
050,51,019,"Virginia","Bedford County",3,44,825,418,407
050,51,019,"Virginia","Bedford County",3,45,850,400,450
050,51,019,"Virginia","Bedford County",3,46,899,451,448
050,51,019,"Virginia","Bedford County",3,47,921,454,467
050,51,019,"Virginia","Bedford County",3,48,981,480,501
050,51,019,"Virginia","Bedford County",3,49,1091,531,560
050,51,019,"Virginia","Bedford County",3,50,1207,587,620
050,51,019,"Virginia","Bedford County",3,51,1178,583,595
050,51,019,"Virginia","Bedford County",3,52,1162,584,578
050,51,019,"Virginia","Bedford County",3,53,1111,548,563
050,51,019,"Virginia","Bedford County",3,54,1105,558,547
050,51,019,"Virginia","Bedford County",3,55,1145,555,590
050,51,019,"Virginia","Bedford County",3,56,1264,624,640
050,51,019,"Virginia","Bedford County",3,57,1366,678,688
050,51,019,"Virginia","Bedford County",3,58,1327,657,670
050,51,019,"Virginia","Bedford County",3,59,1368,676,692
050,51,019,"Virginia","Bedford County",3,60,1362,678,684
050,51,019,"Virginia","Bedford County",3,61,1349,661,688
050,51,019,"Virginia","Bedford County",3,62,1371,676,695
050,51,019,"Virginia","Bedford County",3,63,1328,672,656
050,51,019,"Virginia","Bedford County",3,64,1358,676,682
050,51,019,"Virginia","Bedford County",3,65,1304,640,664
050,51,019,"Virginia","Bedford County",3,66,1264,616,648
050,51,019,"Virginia","Bedford County",3,67,1207,606,601
050,51,019,"Virginia","Bedford County",3,68,1143,578,565
050,51,019,"Virginia","Bedford County",3,69,1126,554,572
050,51,019,"Virginia","Bedford County",3,70,1070,526,544
050,51,019,"Virginia","Bedford County",3,71,974,487,487
050,51,019,"Virginia","Bedford County",3,72,980,488,492
050,51,019,"Virginia","Bedford County",3,73,950,445,505
050,51,019,"Virginia","Bedford County",3,74,1056,521,535
050,51,019,"Virginia","Bedford County",3,75,729,364,365
050,51,019,"Virginia","Bedford County",3,76,678,325,353
050,51,019,"Virginia","Bedford County",3,77,687,315,372
050,51,019,"Virginia","Bedford County",3,78,717,322,395
050,51,019,"Virginia","Bedford County",3,79,582,266,316
050,51,019,"Virginia","Bedford County",3,80,502,227,275
050,51,019,"Virginia","Bedford County",3,81,464,206,258
050,51,019,"Virginia","Bedford County",3,82,407,191,216
050,51,019,"Virginia","Bedford County",3,83,350,158,192
050,51,019,"Virginia","Bedford County",3,84,282,127,155
050,51,019,"Virginia","Bedford County",3,85,1662,662,1000
050,51,019,"Virginia","Bedford County",4,0,651,324,327
050,51,019,"Virginia","Bedford County",4,1,623,320,303
050,51,019,"Virginia","Bedford County",4,2,710,377,333
050,51,019,"Virginia","Bedford County",4,3,781,391,390
050,51,019,"Virginia","Bedford County",4,4,819,387,432
050,51,019,"Virginia","Bedford County",4,5,819,425,394
050,51,019,"Virginia","Bedford County",4,6,855,434,421
050,51,019,"Virginia","Bedford County",4,7,857,411,446
050,51,019,"Virginia","Bedford County",4,8,889,459,430
050,51,019,"Virginia","Bedford County",4,9,906,490,416
050,51,019,"Virginia","Bedford County",4,10,904,465,439
050,51,019,"Virginia","Bedford County",4,11,912,460,452
050,51,019,"Virginia","Bedford County",4,12,956,474,482
050,51,019,"Virginia","Bedford County",4,13,952,506,446
050,51,019,"Virginia","Bedford County",4,14,989,504,485
050,51,019,"Virginia","Bedford County",4,15,1039,518,521
050,51,019,"Virginia","Bedford County",4,16,1006,515,491
050,51,019,"Virginia","Bedford County",4,17,1013,477,536
050,51,019,"Virginia","Bedford County",4,18,873,457,416
050,51,019,"Virginia","Bedford County",4,19,717,385,332
050,51,019,"Virginia","Bedford County",4,20,739,389,350
050,51,019,"Virginia","Bedford County",4,21,796,406,390
050,51,019,"Virginia","Bedford County",4,22,862,449,413
050,51,019,"Virginia","Bedford County",4,23,854,415,439
050,51,019,"Virginia","Bedford County",4,24,843,432,411
050,51,019,"Virginia","Bedford County",4,25,868,445,423
050,51,019,"Virginia","Bedford County",4,26,838,421,417
050,51,019,"Virginia","Bedford County",4,27,818,427,391
050,51,019,"Virginia","Bedford County",4,28,844,429,415
050,51,019,"Virginia","Bedford County",4,29,853,444,409
050,51,019,"Virginia","Bedford County",4,30,885,432,453
050,51,019,"Virginia","Bedford County",4,31,881,430,451
050,51,019,"Virginia","Bedford County",4,32,871,447,424
050,51,019,"Virginia","Bedford County",4,33,889,448,441
050,51,019,"Virginia","Bedford County",4,34,843,438,405
050,51,019,"Virginia","Bedford County",4,35,867,431,436
050,51,019,"Virginia","Bedford County",4,36,897,425,472
050,51,019,"Virginia","Bedford County",4,37,874,438,436
050,51,019,"Virginia","Bedford County",4,38,845,422,423
050,51,019,"Virginia","Bedford County",4,39,871,421,450
050,51,019,"Virginia","Bedford County",4,40,881,425,456
050,51,019,"Virginia","Bedford County",4,41,822,430,392
050,51,019,"Virginia","Bedford County",4,42,870,428,442
050,51,019,"Virginia","Bedford County",4,43,839,422,417
050,51,019,"Virginia","Bedford County",4,44,923,471,452
050,51,019,"Virginia","Bedford County",4,45,845,422,423
050,51,019,"Virginia","Bedford County",4,46,874,424,450
050,51,019,"Virginia","Bedford County",4,47,895,450,445
050,51,019,"Virginia","Bedford County",4,48,935,467,468
050,51,019,"Virginia","Bedford County",4,49,998,484,514
050,51,019,"Virginia","Bedford County",4,50,1082,527,555
050,51,019,"Virginia","Bedford County",4,51,1217,589,628
050,51,019,"Virginia","Bedford County",4,52,1186,587,599
050,51,019,"Virginia","Bedford County",4,53,1167,591,576
050,51,019,"Virginia","Bedford County",4,54,1102,550,552
050,51,019,"Virginia","Bedford County",4,55,1116,562,554
050,51,019,"Virginia","Bedford County",4,56,1163,557,606
050,51,019,"Virginia","Bedford County",4,57,1293,638,655
050,51,019,"Virginia","Bedford County",4,58,1368,684,684
050,51,019,"Virginia","Bedford County",4,59,1313,643,670
050,51,019,"Virginia","Bedford County",4,60,1375,662,713
050,51,019,"Virginia","Bedford County",4,61,1359,683,676
050,51,019,"Virginia","Bedford County",4,62,1356,663,693
050,51,019,"Virginia","Bedford County",4,63,1356,681,675
050,51,019,"Virginia","Bedford County",4,64,1356,689,667
050,51,019,"Virginia","Bedford County",4,65,1364,680,684
050,51,019,"Virginia","Bedford County",4,66,1306,644,662
050,51,019,"Virginia","Bedford County",4,67,1274,629,645
050,51,019,"Virginia","Bedford County",4,68,1199,590,609
050,51,019,"Virginia","Bedford County",4,69,1104,560,544
050,51,019,"Virginia","Bedford County",4,70,1120,549,571
050,51,019,"Virginia","Bedford County",4,71,1046,520,526
050,51,019,"Virginia","Bedford County",4,72,966,493,473
050,51,019,"Virginia","Bedford County",4,73,950,471,479
050,51,019,"Virginia","Bedford County",4,74,922,427,495
050,51,019,"Virginia","Bedford County",4,75,1013,499,514
050,51,019,"Virginia","Bedford County",4,76,712,358,354
050,51,019,"Virginia","Bedford County",4,77,645,303,342
050,51,019,"Virginia","Bedford County",4,78,657,305,352
050,51,019,"Virginia","Bedford County",4,79,679,298,381
050,51,019,"Virginia","Bedford County",4,80,551,241,310
050,51,019,"Virginia","Bedford County",4,81,469,211,258
050,51,019,"Virginia","Bedford County",4,82,421,186,235
050,51,019,"Virginia","Bedford County",4,83,369,174,195
050,51,019,"Virginia","Bedford County",4,84,305,131,174
050,51,019,"Virginia","Bedford County",4,85,1669,677,992
050,51,019,"Virginia","Bedford County",5,0,637,316,321
050,51,019,"Virginia","Bedford County",5,1,710,353,357
050,51,019,"Virginia","Bedford County",5,2,690,355,335
050,51,019,"Virginia","Bedford County",5,3,735,373,362
050,51,019,"Virginia","Bedford County",5,4,809,398,411
050,51,019,"Virginia","Bedford County",5,5,851,404,447
050,51,019,"Virginia","Bedford County",5,6,866,455,411
050,51,019,"Virginia","Bedford County",5,7,877,438,439
050,51,019,"Virginia","Bedford County",5,8,865,414,451
050,51,019,"Virginia","Bedford County",5,9,917,479,438
050,51,019,"Virginia","Bedford County",5,10,905,490,415
050,51,019,"Virginia","Bedford County",5,11,926,474,452
050,51,019,"Virginia","Bedford County",5,12,935,470,465
050,51,019,"Virginia","Bedford County",5,13,961,473,488
050,51,019,"Virginia","Bedford County",5,14,984,532,452
050,51,019,"Virginia","Bedford County",5,15,1005,506,499
050,51,019,"Virginia","Bedford County",5,16,1051,531,520
050,51,019,"Virginia","Bedford County",5,17,1039,534,505
050,51,019,"Virginia","Bedford County",5,18,875,440,435
050,51,019,"Virginia","Bedford County",5,19,695,370,325
050,51,019,"Virginia","Bedford County",5,20,807,421,386
050,51,019,"Virginia","Bedford County",5,21,768,380,388
050,51,019,"Virginia","Bedford County",5,22,834,427,407
050,51,019,"Virginia","Bedford County",5,23,867,448,419
050,51,019,"Virginia","Bedford County",5,24,823,393,430
050,51,019,"Virginia","Bedford County",5,25,820,424,396
050,51,019,"Virginia","Bedford County",5,26,848,444,404
050,51,019,"Virginia","Bedford County",5,27,831,429,402
050,51,019,"Virginia","Bedford County",5,28,869,460,409
050,51,019,"Virginia","Bedford County",5,29,855,440,415
050,51,019,"Virginia","Bedford County",5,30,886,458,428
050,51,019,"Virginia","Bedford County",5,31,914,446,468
050,51,019,"Virginia","Bedford County",5,32,938,466,472
050,51,019,"Virginia","Bedford County",5,33,896,452,444
050,51,019,"Virginia","Bedford County",5,34,902,463,439
050,51,019,"Virginia","Bedford County",5,35,862,436,426
050,51,019,"Virginia","Bedford County",5,36,888,442,446
050,51,019,"Virginia","Bedford County",5,37,947,457,490
050,51,019,"Virginia","Bedford County",5,38,922,459,463
050,51,019,"Virginia","Bedford County",5,39,856,437,419
050,51,019,"Virginia","Bedford County",5,40,875,416,459
050,51,019,"Virginia","Bedford County",5,41,893,430,463
050,51,019,"Virginia","Bedford County",5,42,841,442,399
050,51,019,"Virginia","Bedford County",5,43,899,442,457
050,51,019,"Virginia","Bedford County",5,44,848,429,419
050,51,019,"Virginia","Bedford County",5,45,948,483,465
050,51,019,"Virginia","Bedford County",5,46,875,436,439
050,51,019,"Virginia","Bedford County",5,47,881,423,458
050,51,019,"Virginia","Bedford County",5,48,919,458,461
050,51,019,"Virginia","Bedford County",5,49,958,479,479
050,51,019,"Virginia","Bedford County",5,50,997,482,515
050,51,019,"Virginia","Bedford County",5,51,1076,524,552
050,51,019,"Virginia","Bedford County",5,52,1244,610,634
050,51,019,"Virginia","Bedford County",5,53,1175,589,586
050,51,019,"Virginia","Bedford County",5,54,1160,594,566
050,51,019,"Virginia","Bedford County",5,55,1100,554,546
050,51,019,"Virginia","Bedford County",5,56,1123,567,556
050,51,019,"Virginia","Bedford County",5,57,1169,569,600
050,51,019,"Virginia","Bedford County",5,58,1310,655,655
050,51,019,"Virginia","Bedford County",5,59,1361,665,696
050,51,019,"Virginia","Bedford County",5,60,1306,646,660
050,51,019,"Virginia","Bedford County",5,61,1358,649,709
050,51,019,"Virginia","Bedford County",5,62,1350,677,673
050,51,019,"Virginia","Bedford County",5,63,1360,659,701
050,51,019,"Virginia","Bedford County",5,64,1363,683,680
050,51,019,"Virginia","Bedford County",5,65,1346,688,658
050,51,019,"Virginia","Bedford County",5,66,1375,686,689
050,51,019,"Virginia","Bedford County",5,67,1301,645,656
050,51,019,"Virginia","Bedford County",5,68,1264,621,643
050,51,019,"Virginia","Bedford County",5,69,1187,587,600
050,51,019,"Virginia","Bedford County",5,70,1104,556,548
050,51,019,"Virginia","Bedford County",5,71,1099,529,570
050,51,019,"Virginia","Bedford County",5,72,1053,525,528
050,51,019,"Virginia","Bedford County",5,73,943,478,465
050,51,019,"Virginia","Bedford County",5,74,926,459,467
050,51,019,"Virginia","Bedford County",5,75,896,416,480
050,51,019,"Virginia","Bedford County",5,76,984,483,501
050,51,019,"Virginia","Bedford County",5,77,688,341,347
050,51,019,"Virginia","Bedford County",5,78,617,287,330
050,51,019,"Virginia","Bedford County",5,79,628,290,338
050,51,019,"Virginia","Bedford County",5,80,654,269,385
050,51,019,"Virginia","Bedford County",5,81,532,232,300
050,51,019,"Virginia","Bedford County",5,82,429,201,228
050,51,019,"Virginia","Bedford County",5,83,388,167,221
050,51,019,"Virginia","Bedford County",5,84,341,157,184
050,51,019,"Virginia","Bedford County",5,85,1715,695,1020
050,51,021,"Virginia","Bland County",1,0,45,22,23
050,51,021,"Virginia","Bland County",1,1,42,21,21
050,51,021,"Virginia","Bland County",1,2,39,21,18
050,51,021,"Virginia","Bland County",1,3,49,24,25
050,51,021,"Virginia","Bland County",1,4,58,25,33
050,51,021,"Virginia","Bland County",1,5,50,24,26
050,51,021,"Virginia","Bland County",1,6,47,24,23
050,51,021,"Virginia","Bland County",1,7,51,28,23
050,51,021,"Virginia","Bland County",1,8,54,28,26
050,51,021,"Virginia","Bland County",1,9,39,19,20
050,51,021,"Virginia","Bland County",1,10,51,27,24
050,51,021,"Virginia","Bland County",1,11,61,32,29
050,51,021,"Virginia","Bland County",1,12,52,27,25
050,51,021,"Virginia","Bland County",1,13,57,25,32
050,51,021,"Virginia","Bland County",1,14,65,31,34
050,51,021,"Virginia","Bland County",1,15,70,36,34
050,51,021,"Virginia","Bland County",1,16,57,29,28
050,51,021,"Virginia","Bland County",1,17,62,32,30
050,51,021,"Virginia","Bland County",1,18,59,36,23
050,51,021,"Virginia","Bland County",1,19,46,25,21
050,51,021,"Virginia","Bland County",1,20,45,22,23
050,51,021,"Virginia","Bland County",1,21,44,23,21
050,51,021,"Virginia","Bland County",1,22,58,30,28
050,51,021,"Virginia","Bland County",1,23,73,46,27
050,51,021,"Virginia","Bland County",1,24,67,45,22
050,51,021,"Virginia","Bland County",1,25,73,49,24
050,51,021,"Virginia","Bland County",1,26,81,47,34
050,51,021,"Virginia","Bland County",1,27,77,44,33
050,51,021,"Virginia","Bland County",1,28,77,47,30
050,51,021,"Virginia","Bland County",1,29,88,55,33
050,51,021,"Virginia","Bland County",1,30,82,52,30
050,51,021,"Virginia","Bland County",1,31,82,55,27
050,51,021,"Virginia","Bland County",1,32,71,46,25
050,51,021,"Virginia","Bland County",1,33,66,43,23
050,51,021,"Virginia","Bland County",1,34,69,47,22
050,51,021,"Virginia","Bland County",1,35,68,48,20
050,51,021,"Virginia","Bland County",1,36,75,53,22
050,51,021,"Virginia","Bland County",1,37,79,49,30
050,51,021,"Virginia","Bland County",1,38,77,51,26
050,51,021,"Virginia","Bland County",1,39,85,52,33
050,51,021,"Virginia","Bland County",1,40,92,62,30
050,51,021,"Virginia","Bland County",1,41,74,49,25
050,51,021,"Virginia","Bland County",1,42,100,67,33
050,51,021,"Virginia","Bland County",1,43,96,60,36
050,51,021,"Virginia","Bland County",1,44,69,44,25
050,51,021,"Virginia","Bland County",1,45,82,54,28
050,51,021,"Virginia","Bland County",1,46,93,56,37
050,51,021,"Virginia","Bland County",1,47,113,73,40
050,51,021,"Virginia","Bland County",1,48,91,55,36
050,51,021,"Virginia","Bland County",1,49,99,57,42
050,51,021,"Virginia","Bland County",1,50,103,63,40
050,51,021,"Virginia","Bland County",1,51,93,59,34
050,51,021,"Virginia","Bland County",1,52,92,55,37
050,51,021,"Virginia","Bland County",1,53,108,62,46
050,51,021,"Virginia","Bland County",1,54,95,54,41
050,51,021,"Virginia","Bland County",1,55,86,44,42
050,51,021,"Virginia","Bland County",1,56,89,45,44
050,51,021,"Virginia","Bland County",1,57,88,48,40
050,51,021,"Virginia","Bland County",1,58,85,42,43
050,51,021,"Virginia","Bland County",1,59,92,42,50
050,51,021,"Virginia","Bland County",1,60,94,45,49
050,51,021,"Virginia","Bland County",1,61,85,39,46
050,51,021,"Virginia","Bland County",1,62,86,42,44
050,51,021,"Virginia","Bland County",1,63,95,52,43
050,51,021,"Virginia","Bland County",1,64,95,47,48
050,51,021,"Virginia","Bland County",1,65,97,38,59
050,51,021,"Virginia","Bland County",1,66,95,39,56
050,51,021,"Virginia","Bland County",1,67,84,44,40
050,51,021,"Virginia","Bland County",1,68,95,49,46
050,51,021,"Virginia","Bland County",1,69,92,49,43
050,51,021,"Virginia","Bland County",1,70,89,50,39
050,51,021,"Virginia","Bland County",1,71,81,43,38
050,51,021,"Virginia","Bland County",1,72,81,38,43
050,51,021,"Virginia","Bland County",1,73,102,49,53
050,51,021,"Virginia","Bland County",1,74,62,32,30
050,51,021,"Virginia","Bland County",1,75,57,31,26
050,51,021,"Virginia","Bland County",1,76,62,28,34
050,51,021,"Virginia","Bland County",1,77,67,36,31
050,51,021,"Virginia","Bland County",1,78,60,30,30
050,51,021,"Virginia","Bland County",1,79,51,26,25
050,51,021,"Virginia","Bland County",1,80,45,22,23
050,51,021,"Virginia","Bland County",1,81,39,18,21
050,51,021,"Virginia","Bland County",1,82,37,17,20
050,51,021,"Virginia","Bland County",1,83,36,18,18
050,51,021,"Virginia","Bland County",1,84,21,9,12
050,51,021,"Virginia","Bland County",1,85,134,47,87
050,51,021,"Virginia","Bland County",2,0,41,20,21
050,51,021,"Virginia","Bland County",2,1,41,20,21
050,51,021,"Virginia","Bland County",2,2,40,21,19
050,51,021,"Virginia","Bland County",2,3,47,23,24
050,51,021,"Virginia","Bland County",2,4,55,25,30
050,51,021,"Virginia","Bland County",2,5,52,24,28
050,51,021,"Virginia","Bland County",2,6,48,24,24
050,51,021,"Virginia","Bland County",2,7,50,27,23
050,51,021,"Virginia","Bland County",2,8,52,27,25
050,51,021,"Virginia","Bland County",2,9,43,21,22
050,51,021,"Virginia","Bland County",2,10,50,26,24
050,51,021,"Virginia","Bland County",2,11,60,31,29
050,51,021,"Virginia","Bland County",2,12,52,27,25
050,51,021,"Virginia","Bland County",2,13,55,25,30
050,51,021,"Virginia","Bland County",2,14,63,29,34
050,51,021,"Virginia","Bland County",2,15,70,36,34
050,51,021,"Virginia","Bland County",2,16,61,32,29
050,51,021,"Virginia","Bland County",2,17,62,32,30
050,51,021,"Virginia","Bland County",2,18,57,34,23
050,51,021,"Virginia","Bland County",2,19,45,25,20
050,51,021,"Virginia","Bland County",2,20,46,23,23
050,51,021,"Virginia","Bland County",2,21,45,23,22
050,51,021,"Virginia","Bland County",2,22,55,28,27
050,51,021,"Virginia","Bland County",2,23,73,45,28
050,51,021,"Virginia","Bland County",2,24,68,45,23
050,51,021,"Virginia","Bland County",2,25,71,48,23
050,51,021,"Virginia","Bland County",2,26,79,48,31
050,51,021,"Virginia","Bland County",2,27,79,46,33
050,51,021,"Virginia","Bland County",2,28,74,44,30
050,51,021,"Virginia","Bland County",2,29,84,53,31
050,51,021,"Virginia","Bland County",2,30,83,52,31
050,51,021,"Virginia","Bland County",2,31,82,55,27
050,51,021,"Virginia","Bland County",2,32,72,46,26
050,51,021,"Virginia","Bland County",2,33,66,43,23
050,51,021,"Virginia","Bland County",2,34,70,47,23
050,51,021,"Virginia","Bland County",2,35,68,47,21
050,51,021,"Virginia","Bland County",2,36,72,51,21
050,51,021,"Virginia","Bland County",2,37,79,51,28
050,51,021,"Virginia","Bland County",2,38,77,50,27
050,51,021,"Virginia","Bland County",2,39,84,52,32
050,51,021,"Virginia","Bland County",2,40,94,62,32
050,51,021,"Virginia","Bland County",2,41,75,49,26
050,51,021,"Virginia","Bland County",2,42,98,67,31
050,51,021,"Virginia","Bland County",2,43,96,61,35
050,51,021,"Virginia","Bland County",2,44,73,46,27
050,51,021,"Virginia","Bland County",2,45,82,54,28
050,51,021,"Virginia","Bland County",2,46,87,53,34
050,51,021,"Virginia","Bland County",2,47,109,70,39
050,51,021,"Virginia","Bland County",2,48,92,56,36
050,51,021,"Virginia","Bland County",2,49,97,57,40
050,51,021,"Virginia","Bland County",2,50,105,64,41
050,51,021,"Virginia","Bland County",2,51,94,58,36
050,51,021,"Virginia","Bland County",2,52,92,56,36
050,51,021,"Virginia","Bland County",2,53,103,59,44
050,51,021,"Virginia","Bland County",2,54,97,55,42
050,51,021,"Virginia","Bland County",2,55,89,47,42
050,51,021,"Virginia","Bland County",2,56,87,44,43
050,51,021,"Virginia","Bland County",2,57,87,48,39
050,51,021,"Virginia","Bland County",2,58,84,42,42
050,51,021,"Virginia","Bland County",2,59,91,42,49
050,51,021,"Virginia","Bland County",2,60,95,46,49
050,51,021,"Virginia","Bland County",2,61,86,39,47
050,51,021,"Virginia","Bland County",2,62,85,41,44
050,51,021,"Virginia","Bland County",2,63,94,51,43
050,51,021,"Virginia","Bland County",2,64,95,49,46
050,51,021,"Virginia","Bland County",2,65,96,39,57
050,51,021,"Virginia","Bland County",2,66,95,39,56
050,51,021,"Virginia","Bland County",2,67,87,44,43
050,51,021,"Virginia","Bland County",2,68,91,47,44
050,51,021,"Virginia","Bland County",2,69,94,50,44
050,51,021,"Virginia","Bland County",2,70,89,49,40
050,51,021,"Virginia","Bland County",2,71,83,44,39
050,51,021,"Virginia","Bland County",2,72,78,38,40
050,51,021,"Virginia","Bland County",2,73,101,48,53
050,51,021,"Virginia","Bland County",2,74,67,33,34
050,51,021,"Virginia","Bland County",2,75,59,32,27
050,51,021,"Virginia","Bland County",2,76,61,29,32
050,51,021,"Virginia","Bland County",2,77,67,35,32
050,51,021,"Virginia","Bland County",2,78,60,31,29
050,51,021,"Virginia","Bland County",2,79,54,27,27
050,51,021,"Virginia","Bland County",2,80,45,21,24
050,51,021,"Virginia","Bland County",2,81,40,19,21
050,51,021,"Virginia","Bland County",2,82,38,18,20
050,51,021,"Virginia","Bland County",2,83,36,18,18
050,51,021,"Virginia","Bland County",2,84,23,11,12
050,51,021,"Virginia","Bland County",2,85,134,47,87
050,51,021,"Virginia","Bland County",3,0,37,15,22
050,51,021,"Virginia","Bland County",3,1,43,22,21
050,51,021,"Virginia","Bland County",3,2,41,20,21
050,51,021,"Virginia","Bland County",3,3,40,21,19
050,51,021,"Virginia","Bland County",3,4,47,22,25
050,51,021,"Virginia","Bland County",3,5,55,25,30
050,51,021,"Virginia","Bland County",3,6,52,23,29
050,51,021,"Virginia","Bland County",3,7,45,23,22
050,51,021,"Virginia","Bland County",3,8,48,26,22
050,51,021,"Virginia","Bland County",3,9,48,26,22
050,51,021,"Virginia","Bland County",3,10,42,20,22
050,51,021,"Virginia","Bland County",3,11,46,23,23
050,51,021,"Virginia","Bland County",3,12,61,31,30
050,51,021,"Virginia","Bland County",3,13,49,28,21
050,51,021,"Virginia","Bland County",3,14,49,24,25
050,51,021,"Virginia","Bland County",3,15,64,30,34
050,51,021,"Virginia","Bland County",3,16,68,36,32
050,51,021,"Virginia","Bland County",3,17,58,30,28
050,51,021,"Virginia","Bland County",3,18,54,28,26
050,51,021,"Virginia","Bland County",3,19,44,27,17
050,51,021,"Virginia","Bland County",3,20,54,29,25
050,51,021,"Virginia","Bland County",3,21,52,24,28
050,51,021,"Virginia","Bland County",3,22,45,26,19
050,51,021,"Virginia","Bland County",3,23,62,36,26
050,51,021,"Virginia","Bland County",3,24,69,43,26
050,51,021,"Virginia","Bland County",3,25,67,49,18
050,51,021,"Virginia","Bland County",3,26,76,53,23
050,51,021,"Virginia","Bland County",3,27,85,59,26
050,51,021,"Virginia","Bland County",3,28,71,36,35
050,51,021,"Virginia","Bland County",3,29,75,49,26
050,51,021,"Virginia","Bland County",3,30,79,48,31
050,51,021,"Virginia","Bland County",3,31,89,57,32
050,51,021,"Virginia","Bland County",3,32,77,49,28
050,51,021,"Virginia","Bland County",3,33,70,45,25
050,51,021,"Virginia","Bland County",3,34,74,50,24
050,51,021,"Virginia","Bland County",3,35,64,42,22
050,51,021,"Virginia","Bland County",3,36,60,43,17
050,51,021,"Virginia","Bland County",3,37,78,57,21
050,51,021,"Virginia","Bland County",3,38,76,50,26
050,51,021,"Virginia","Bland County",3,39,82,54,28
050,51,021,"Virginia","Bland County",3,40,88,57,31
050,51,021,"Virginia","Bland County",3,41,77,48,29
050,51,021,"Virginia","Bland County",3,42,89,61,28
050,51,021,"Virginia","Bland County",3,43,91,59,32
050,51,021,"Virginia","Bland County",3,44,85,49,36
050,51,021,"Virginia","Bland County",3,45,87,57,30
050,51,021,"Virginia","Bland County",3,46,78,48,30
050,51,021,"Virginia","Bland County",3,47,92,60,32
050,51,021,"Virginia","Bland County",3,48,99,61,38
050,51,021,"Virginia","Bland County",3,49,92,57,35
050,51,021,"Virginia","Bland County",3,50,109,64,45
050,51,021,"Virginia","Bland County",3,51,96,56,40
050,51,021,"Virginia","Bland County",3,52,93,59,34
050,51,021,"Virginia","Bland County",3,53,90,52,38
050,51,021,"Virginia","Bland County",3,54,104,60,44
050,51,021,"Virginia","Bland County",3,55,97,57,40
050,51,021,"Virginia","Bland County",3,56,88,45,43
050,51,021,"Virginia","Bland County",3,57,85,43,42
050,51,021,"Virginia","Bland County",3,58,81,43,38
050,51,021,"Virginia","Bland County",3,59,86,40,46
050,51,021,"Virginia","Bland County",3,60,91,44,47
050,51,021,"Virginia","Bland County",3,61,90,42,48
050,51,021,"Virginia","Bland County",3,62,85,40,45
050,51,021,"Virginia","Bland County",3,63,90,45,45
050,51,021,"Virginia","Bland County",3,64,97,51,46
050,51,021,"Virginia","Bland County",3,65,100,49,51
050,51,021,"Virginia","Bland County",3,66,93,39,54
050,51,021,"Virginia","Bland County",3,67,100,42,58
050,51,021,"Virginia","Bland County",3,68,84,43,41
050,51,021,"Virginia","Bland County",3,69,88,46,42
050,51,021,"Virginia","Bland County",3,70,94,50,44
050,51,021,"Virginia","Bland County",3,71,84,46,38
050,51,021,"Virginia","Bland County",3,72,82,43,39
050,51,021,"Virginia","Bland County",3,73,77,37,40
050,51,021,"Virginia","Bland County",3,74,96,45,51
050,51,021,"Virginia","Bland County",3,75,64,33,31
050,51,021,"Virginia","Bland County",3,76,57,29,28
050,51,021,"Virginia","Bland County",3,77,59,30,29
050,51,021,"Virginia","Bland County",3,78,61,32,29
050,51,021,"Virginia","Bland County",3,79,56,28,28
050,51,021,"Virginia","Bland County",3,80,49,25,24
050,51,021,"Virginia","Bland County",3,81,42,20,22
050,51,021,"Virginia","Bland County",3,82,33,16,17
050,51,021,"Virginia","Bland County",3,83,37,18,19
050,51,021,"Virginia","Bland County",3,84,32,16,16
050,51,021,"Virginia","Bland County",3,85,133,45,88
050,51,021,"Virginia","Bland County",4,0,36,15,21
050,51,021,"Virginia","Bland County",4,1,37,14,23
050,51,021,"Virginia","Bland County",4,2,35,18,17
050,51,021,"Virginia","Bland County",4,3,38,17,21
050,51,021,"Virginia","Bland County",4,4,39,20,19
050,51,021,"Virginia","Bland County",4,5,50,23,27
050,51,021,"Virginia","Bland County",4,6,53,25,28
050,51,021,"Virginia","Bland County",4,7,55,25,30
050,51,021,"Virginia","Bland County",4,8,47,22,25
050,51,021,"Virginia","Bland County",4,9,51,27,24
050,51,021,"Virginia","Bland County",4,10,44,24,20
050,51,021,"Virginia","Bland County",4,11,44,20,24
050,51,021,"Virginia","Bland County",4,12,44,21,23
050,51,021,"Virginia","Bland County",4,13,62,32,30
050,51,021,"Virginia","Bland County",4,14,53,33,20
050,51,021,"Virginia","Bland County",4,15,52,23,29
050,51,021,"Virginia","Bland County",4,16,61,28,33
050,51,021,"Virginia","Bland County",4,17,70,38,32
050,51,021,"Virginia","Bland County",4,18,48,24,24
050,51,021,"Virginia","Bland County",4,19,44,23,21
050,51,021,"Virginia","Bland County",4,20,45,28,17
050,51,021,"Virginia","Bland County",4,21,54,28,26
050,51,021,"Virginia","Bland County",4,22,56,25,31
050,51,021,"Virginia","Bland County",4,23,54,36,18
050,51,021,"Virginia","Bland County",4,24,61,35,26
050,51,021,"Virginia","Bland County",4,25,66,45,21
050,51,021,"Virginia","Bland County",4,26,70,52,18
050,51,021,"Virginia","Bland County",4,27,80,58,22
050,51,021,"Virginia","Bland County",4,28,76,50,26
050,51,021,"Virginia","Bland County",4,29,73,43,30
050,51,021,"Virginia","Bland County",4,30,70,43,27
050,51,021,"Virginia","Bland County",4,31,84,54,30
050,51,021,"Virginia","Bland County",4,32,82,49,33
050,51,021,"Virginia","Bland County",4,33,78,50,28
050,51,021,"Virginia","Bland County",4,34,82,54,28
050,51,021,"Virginia","Bland County",4,35,64,41,23
050,51,021,"Virginia","Bland County",4,36,68,42,26
050,51,021,"Virginia","Bland County",4,37,64,46,18
050,51,021,"Virginia","Bland County",4,38,79,59,20
050,51,021,"Virginia","Bland County",4,39,80,53,27
050,51,021,"Virginia","Bland County",4,40,92,63,29
050,51,021,"Virginia","Bland County",4,41,82,47,35
050,51,021,"Virginia","Bland County",4,42,92,62,30
050,51,021,"Virginia","Bland County",4,43,82,53,29
050,51,021,"Virginia","Bland County",4,44,84,52,32
050,51,021,"Virginia","Bland County",4,45,98,61,37
050,51,021,"Virginia","Bland County",4,46,72,45,27
050,51,021,"Virginia","Bland County",4,47,90,59,31
050,51,021,"Virginia","Bland County",4,48,79,48,31
050,51,021,"Virginia","Bland County",4,49,100,59,41
050,51,021,"Virginia","Bland County",4,50,95,58,37
050,51,021,"Virginia","Bland County",4,51,103,57,46
050,51,021,"Virginia","Bland County",4,52,97,57,40
050,51,021,"Virginia","Bland County",4,53,89,56,33
050,51,021,"Virginia","Bland County",4,54,88,53,35
050,51,021,"Virginia","Bland County",4,55,106,62,44
050,51,021,"Virginia","Bland County",4,56,91,51,40
050,51,021,"Virginia","Bland County",4,57,88,45,43
050,51,021,"Virginia","Bland County",4,58,72,36,36
050,51,021,"Virginia","Bland County",4,59,79,40,39
050,51,021,"Virginia","Bland County",4,60,85,41,44
050,51,021,"Virginia","Bland County",4,61,94,47,47
050,51,021,"Virginia","Bland County",4,62,92,44,48
050,51,021,"Virginia","Bland County",4,63,84,40,44
050,51,021,"Virginia","Bland County",4,64,88,44,44
050,51,021,"Virginia","Bland County",4,65,104,53,51
050,51,021,"Virginia","Bland County",4,66,96,47,49
050,51,021,"Virginia","Bland County",4,67,96,39,57
050,51,021,"Virginia","Bland County",4,68,98,42,56
050,51,021,"Virginia","Bland County",4,69,82,41,41
050,51,021,"Virginia","Bland County",4,70,85,45,40
050,51,021,"Virginia","Bland County",4,71,92,46,46
050,51,021,"Virginia","Bland County",4,72,89,48,41
050,51,021,"Virginia","Bland County",4,73,81,42,39
050,51,021,"Virginia","Bland County",4,74,76,36,40
050,51,021,"Virginia","Bland County",4,75,92,44,48
050,51,021,"Virginia","Bland County",4,76,64,31,33
050,51,021,"Virginia","Bland County",4,77,57,30,27
050,51,021,"Virginia","Bland County",4,78,53,26,27
050,51,021,"Virginia","Bland County",4,79,60,30,30
050,51,021,"Virginia","Bland County",4,80,48,23,25
050,51,021,"Virginia","Bland County",4,81,48,26,22
050,51,021,"Virginia","Bland County",4,82,38,17,21
050,51,021,"Virginia","Bland County",4,83,35,18,17
050,51,021,"Virginia","Bland County",4,84,33,17,16
050,51,021,"Virginia","Bland County",4,85,140,50,90
050,51,021,"Virginia","Bland County",5,0,32,14,18
050,51,021,"Virginia","Bland County",5,1,40,15,25
050,51,021,"Virginia","Bland County",5,2,43,18,25
050,51,021,"Virginia","Bland County",5,3,37,19,18
050,51,021,"Virginia","Bland County",5,4,43,19,24
050,51,021,"Virginia","Bland County",5,5,43,23,20
050,51,021,"Virginia","Bland County",5,6,51,22,29
050,51,021,"Virginia","Bland County",5,7,58,30,28
050,51,021,"Virginia","Bland County",5,8,57,24,33
050,51,021,"Virginia","Bland County",5,9,52,26,26
050,51,021,"Virginia","Bland County",5,10,55,31,24
050,51,021,"Virginia","Bland County",5,11,46,26,20
050,51,021,"Virginia","Bland County",5,12,44,22,22
050,51,021,"Virginia","Bland County",5,13,48,27,21
050,51,021,"Virginia","Bland County",5,14,60,27,33
050,51,021,"Virginia","Bland County",5,15,54,33,21
050,51,021,"Virginia","Bland County",5,16,52,24,28
050,51,021,"Virginia","Bland County",5,17,62,29,33
050,51,021,"Virginia","Bland County",5,18,62,33,29
050,51,021,"Virginia","Bland County",5,19,38,20,18
050,51,021,"Virginia","Bland County",5,20,51,28,23
050,51,021,"Virginia","Bland County",5,21,51,31,20
050,51,021,"Virginia","Bland County",5,22,59,32,27
050,51,021,"Virginia","Bland County",5,23,69,35,34
050,51,021,"Virginia","Bland County",5,24,54,34,20
050,51,021,"Virginia","Bland County",5,25,64,39,25
050,51,021,"Virginia","Bland County",5,26,75,52,23
050,51,021,"Virginia","Bland County",5,27,79,59,20
050,51,021,"Virginia","Bland County",5,28,72,49,23
050,51,021,"Virginia","Bland County",5,29,80,55,25
050,51,021,"Virginia","Bland County",5,30,79,42,37
050,51,021,"Virginia","Bland County",5,31,80,51,29
050,51,021,"Virginia","Bland County",5,32,85,55,30
050,51,021,"Virginia","Bland County",5,33,84,51,33
050,51,021,"Virginia","Bland County",5,34,81,53,28
050,51,021,"Virginia","Bland County",5,35,76,47,29
050,51,021,"Virginia","Bland County",5,36,66,42,24
050,51,021,"Virginia","Bland County",5,37,70,48,22
050,51,021,"Virginia","Bland County",5,38,60,45,15
050,51,021,"Virginia","Bland County",5,39,76,56,20
050,51,021,"Virginia","Bland County",5,40,84,54,30
050,51,021,"Virginia","Bland County",5,41,83,49,34
050,51,021,"Virginia","Bland County",5,42,100,63,37
050,51,021,"Virginia","Bland County",5,43,84,53,31
050,51,021,"Virginia","Bland County",5,44,73,44,29
050,51,021,"Virginia","Bland County",5,45,92,62,30
050,51,021,"Virginia","Bland County",5,46,87,50,37
050,51,021,"Virginia","Bland County",5,47,90,61,29
050,51,021,"Virginia","Bland County",5,48,78,48,30
050,51,021,"Virginia","Bland County",5,49,83,52,31
050,51,021,"Virginia","Bland County",5,50,107,65,42
050,51,021,"Virginia","Bland County",5,51,96,55,41
050,51,021,"Virginia","Bland County",5,52,102,56,46
050,51,021,"Virginia","Bland County",5,53,97,55,42
050,51,021,"Virginia","Bland County",5,54,89,57,32
050,51,021,"Virginia","Bland County",5,55,91,54,37
050,51,021,"Virginia","Bland County",5,56,104,57,47
050,51,021,"Virginia","Bland County",5,57,90,50,40
050,51,021,"Virginia","Bland County",5,58,78,38,40
050,51,021,"Virginia","Bland County",5,59,67,33,34
050,51,021,"Virginia","Bland County",5,60,80,41,39
050,51,021,"Virginia","Bland County",5,61,83,41,42
050,51,021,"Virginia","Bland County",5,62,97,50,47
050,51,021,"Virginia","Bland County",5,63,94,42,52
050,51,021,"Virginia","Bland County",5,64,86,38,48
050,51,021,"Virginia","Bland County",5,65,93,46,47
050,51,021,"Virginia","Bland County",5,66,102,51,51
050,51,021,"Virginia","Bland County",5,67,96,47,49
050,51,021,"Virginia","Bland County",5,68,92,37,55
050,51,021,"Virginia","Bland County",5,69,97,42,55
050,51,021,"Virginia","Bland County",5,70,84,42,42
050,51,021,"Virginia","Bland County",5,71,81,42,39
050,51,021,"Virginia","Bland County",5,72,93,47,46
050,51,021,"Virginia","Bland County",5,73,88,46,42
050,51,021,"Virginia","Bland County",5,74,77,39,38
050,51,021,"Virginia","Bland County",5,75,72,33,39
050,51,021,"Virginia","Bland County",5,76,89,42,47
050,51,021,"Virginia","Bland County",5,77,62,32,30
050,51,021,"Virginia","Bland County",5,78,53,28,25
050,51,021,"Virginia","Bland County",5,79,49,22,27
050,51,021,"Virginia","Bland County",5,80,51,23,28
050,51,021,"Virginia","Bland County",5,81,43,22,21
050,51,021,"Virginia","Bland County",5,82,44,23,21
050,51,021,"Virginia","Bland County",5,83,37,18,19
050,51,021,"Virginia","Bland County",5,84,31,17,14
050,51,021,"Virginia","Bland County",5,85,142,56,86
050,51,023,"Virginia","Botetourt County",1,0,251,128,123
050,51,023,"Virginia","Botetourt County",1,1,282,145,137
050,51,023,"Virginia","Botetourt County",1,2,288,156,132
050,51,023,"Virginia","Botetourt County",1,3,317,169,148
050,51,023,"Virginia","Botetourt County",1,4,331,177,154
050,51,023,"Virginia","Botetourt County",1,5,313,159,154
050,51,023,"Virginia","Botetourt County",1,6,333,172,161
050,51,023,"Virginia","Botetourt County",1,7,344,182,162
050,51,023,"Virginia","Botetourt County",1,8,331,172,159
050,51,023,"Virginia","Botetourt County",1,9,344,175,169
050,51,023,"Virginia","Botetourt County",1,10,382,186,196
050,51,023,"Virginia","Botetourt County",1,11,390,184,206
050,51,023,"Virginia","Botetourt County",1,12,397,182,215
050,51,023,"Virginia","Botetourt County",1,13,413,209,204
050,51,023,"Virginia","Botetourt County",1,14,412,230,182
050,51,023,"Virginia","Botetourt County",1,15,420,208,212
050,51,023,"Virginia","Botetourt County",1,16,452,236,216
050,51,023,"Virginia","Botetourt County",1,17,432,216,216
050,51,023,"Virginia","Botetourt County",1,18,359,186,173
050,51,023,"Virginia","Botetourt County",1,19,279,155,124
050,51,023,"Virginia","Botetourt County",1,20,309,164,145
050,51,023,"Virginia","Botetourt County",1,21,326,165,161
050,51,023,"Virginia","Botetourt County",1,22,334,170,164
050,51,023,"Virginia","Botetourt County",1,23,322,163,159
050,51,023,"Virginia","Botetourt County",1,24,334,180,154
050,51,023,"Virginia","Botetourt County",1,25,303,159,144
050,51,023,"Virginia","Botetourt County",1,26,305,150,155
050,51,023,"Virginia","Botetourt County",1,27,298,160,138
050,51,023,"Virginia","Botetourt County",1,28,295,168,127
050,51,023,"Virginia","Botetourt County",1,29,298,159,139
050,51,023,"Virginia","Botetourt County",1,30,338,168,170
050,51,023,"Virginia","Botetourt County",1,31,334,162,172
050,51,023,"Virginia","Botetourt County",1,32,340,167,173
050,51,023,"Virginia","Botetourt County",1,33,344,171,173
050,51,023,"Virginia","Botetourt County",1,34,355,182,173
050,51,023,"Virginia","Botetourt County",1,35,377,201,176
050,51,023,"Virginia","Botetourt County",1,36,364,193,171
050,51,023,"Virginia","Botetourt County",1,37,371,194,177
050,51,023,"Virginia","Botetourt County",1,38,348,179,169
050,51,023,"Virginia","Botetourt County",1,39,373,188,185
050,51,023,"Virginia","Botetourt County",1,40,388,186,202
050,51,023,"Virginia","Botetourt County",1,41,369,188,181
050,51,023,"Virginia","Botetourt County",1,42,357,175,182
050,51,023,"Virginia","Botetourt County",1,43,322,151,171
050,51,023,"Virginia","Botetourt County",1,44,354,174,180
050,51,023,"Virginia","Botetourt County",1,45,384,205,179
050,51,023,"Virginia","Botetourt County",1,46,410,210,200
050,51,023,"Virginia","Botetourt County",1,47,442,217,225
050,51,023,"Virginia","Botetourt County",1,48,503,256,247
050,51,023,"Virginia","Botetourt County",1,49,512,274,238
050,51,023,"Virginia","Botetourt County",1,50,476,253,223
050,51,023,"Virginia","Botetourt County",1,51,478,239,239
050,51,023,"Virginia","Botetourt County",1,52,509,244,265
050,51,023,"Virginia","Botetourt County",1,53,519,255,264
050,51,023,"Virginia","Botetourt County",1,54,551,270,281
050,51,023,"Virginia","Botetourt County",1,55,562,278,284
050,51,023,"Virginia","Botetourt County",1,56,575,287,288
050,51,023,"Virginia","Botetourt County",1,57,570,283,287
050,51,023,"Virginia","Botetourt County",1,58,585,286,299
050,51,023,"Virginia","Botetourt County",1,59,565,280,285
050,51,023,"Virginia","Botetourt County",1,60,551,282,269
050,51,023,"Virginia","Botetourt County",1,61,527,262,265
050,51,023,"Virginia","Botetourt County",1,62,545,277,268
050,51,023,"Virginia","Botetourt County",1,63,554,277,277
050,51,023,"Virginia","Botetourt County",1,64,516,268,248
050,51,023,"Virginia","Botetourt County",1,65,507,258,249
050,51,023,"Virginia","Botetourt County",1,66,478,241,237
050,51,023,"Virginia","Botetourt County",1,67,505,260,245
050,51,023,"Virginia","Botetourt County",1,68,507,248,259
050,51,023,"Virginia","Botetourt County",1,69,472,235,237
050,51,023,"Virginia","Botetourt County",1,70,484,237,247
050,51,023,"Virginia","Botetourt County",1,71,456,218,238
050,51,023,"Virginia","Botetourt County",1,72,470,229,241
050,51,023,"Virginia","Botetourt County",1,73,447,225,222
050,51,023,"Virginia","Botetourt County",1,74,327,160,167
050,51,023,"Virginia","Botetourt County",1,75,314,144,170
050,51,023,"Virginia","Botetourt County",1,76,305,158,147
050,51,023,"Virginia","Botetourt County",1,77,301,146,155
050,51,023,"Virginia","Botetourt County",1,78,250,110,140
050,51,023,"Virginia","Botetourt County",1,79,227,96,131
050,51,023,"Virginia","Botetourt County",1,80,223,101,122
050,51,023,"Virginia","Botetourt County",1,81,203,85,118
050,51,023,"Virginia","Botetourt County",1,82,184,77,107
050,51,023,"Virginia","Botetourt County",1,83,158,69,89
050,51,023,"Virginia","Botetourt County",1,84,131,56,75
050,51,023,"Virginia","Botetourt County",1,85,784,274,510
050,51,023,"Virginia","Botetourt County",2,0,250,131,119
050,51,023,"Virginia","Botetourt County",2,1,276,143,133
050,51,023,"Virginia","Botetourt County",2,2,289,156,133
050,51,023,"Virginia","Botetourt County",2,3,313,169,144
050,51,023,"Virginia","Botetourt County",2,4,329,177,152
050,51,023,"Virginia","Botetourt County",2,5,320,165,155
050,51,023,"Virginia","Botetourt County",2,6,333,172,161
050,51,023,"Virginia","Botetourt County",2,7,345,181,164
050,51,023,"Virginia","Botetourt County",2,8,335,174,161
050,51,023,"Virginia","Botetourt County",2,9,346,176,170
050,51,023,"Virginia","Botetourt County",2,10,374,185,189
050,51,023,"Virginia","Botetourt County",2,11,389,184,205
050,51,023,"Virginia","Botetourt County",2,12,398,184,214
050,51,023,"Virginia","Botetourt County",2,13,409,203,206
050,51,023,"Virginia","Botetourt County",2,14,411,224,187
050,51,023,"Virginia","Botetourt County",2,15,419,216,203
050,51,023,"Virginia","Botetourt County",2,16,445,230,215
050,51,023,"Virginia","Botetourt County",2,17,436,220,216
050,51,023,"Virginia","Botetourt County",2,18,355,183,172
050,51,023,"Virginia","Botetourt County",2,19,285,155,130
050,51,023,"Virginia","Botetourt County",2,20,311,166,145
050,51,023,"Virginia","Botetourt County",2,21,322,164,158
050,51,023,"Virginia","Botetourt County",2,22,328,166,162
050,51,023,"Virginia","Botetourt County",2,23,328,167,161
050,51,023,"Virginia","Botetourt County",2,24,331,175,156
050,51,023,"Virginia","Botetourt County",2,25,314,164,150
050,51,023,"Virginia","Botetourt County",2,26,304,153,151
050,51,023,"Virginia","Botetourt County",2,27,297,157,140
050,51,023,"Virginia","Botetourt County",2,28,298,168,130
050,51,023,"Virginia","Botetourt County",2,29,302,161,141
050,51,023,"Virginia","Botetourt County",2,30,337,169,168
050,51,023,"Virginia","Botetourt County",2,31,335,163,172
050,51,023,"Virginia","Botetourt County",2,32,341,169,172
050,51,023,"Virginia","Botetourt County",2,33,344,169,175
050,51,023,"Virginia","Botetourt County",2,34,355,181,174
050,51,023,"Virginia","Botetourt County",2,35,376,198,178
050,51,023,"Virginia","Botetourt County",2,36,367,196,171
050,51,023,"Virginia","Botetourt County",2,37,373,196,177
050,51,023,"Virginia","Botetourt County",2,38,356,184,172
050,51,023,"Virginia","Botetourt County",2,39,369,187,182
050,51,023,"Virginia","Botetourt County",2,40,388,188,200
050,51,023,"Virginia","Botetourt County",2,41,377,189,188
050,51,023,"Virginia","Botetourt County",2,42,358,176,182
050,51,023,"Virginia","Botetourt County",2,43,336,159,177
050,51,023,"Virginia","Botetourt County",2,44,344,167,177
050,51,023,"Virginia","Botetourt County",2,45,385,203,182
050,51,023,"Virginia","Botetourt County",2,46,402,206,196
050,51,023,"Virginia","Botetourt County",2,47,435,215,220
050,51,023,"Virginia","Botetourt County",2,48,490,247,243
050,51,023,"Virginia","Botetourt County",2,49,509,269,240
050,51,023,"Virginia","Botetourt County",2,50,484,258,226
050,51,023,"Virginia","Botetourt County",2,51,479,242,237
050,51,023,"Virginia","Botetourt County",2,52,501,241,260
050,51,023,"Virginia","Botetourt County",2,53,517,251,266
050,51,023,"Virginia","Botetourt County",2,54,541,267,274
050,51,023,"Virginia","Botetourt County",2,55,558,275,283
050,51,023,"Virginia","Botetourt County",2,56,576,287,289
050,51,023,"Virginia","Botetourt County",2,57,572,284,288
050,51,023,"Virginia","Botetourt County",2,58,581,285,296
050,51,023,"Virginia","Botetourt County",2,59,570,283,287
050,51,023,"Virginia","Botetourt County",2,60,555,280,275
050,51,023,"Virginia","Botetourt County",2,61,532,265,267
050,51,023,"Virginia","Botetourt County",2,62,538,272,266
050,51,023,"Virginia","Botetourt County",2,63,553,277,276
050,51,023,"Virginia","Botetourt County",2,64,519,266,253
050,51,023,"Virginia","Botetourt County",2,65,510,263,247
050,51,023,"Virginia","Botetourt County",2,66,484,244,240
050,51,023,"Virginia","Botetourt County",2,67,499,257,242
050,51,023,"Virginia","Botetourt County",2,68,504,250,254
050,51,023,"Virginia","Botetourt County",2,69,481,239,242
050,51,023,"Virginia","Botetourt County",2,70,480,235,245
050,51,023,"Virginia","Botetourt County",2,71,464,222,242
050,51,023,"Virginia","Botetourt County",2,72,458,223,235
050,51,023,"Virginia","Botetourt County",2,73,479,238,241
050,51,023,"Virginia","Botetourt County",2,74,332,163,169
050,51,023,"Virginia","Botetourt County",2,75,316,149,167
050,51,023,"Virginia","Botetourt County",2,76,306,155,151
050,51,023,"Virginia","Botetourt County",2,77,305,149,156
050,51,023,"Virginia","Botetourt County",2,78,255,117,138
050,51,023,"Virginia","Botetourt County",2,79,228,97,131
050,51,023,"Virginia","Botetourt County",2,80,221,100,121
050,51,023,"Virginia","Botetourt County",2,81,201,86,115
050,51,023,"Virginia","Botetourt County",2,82,189,77,112
050,51,023,"Virginia","Botetourt County",2,83,163,72,91
050,51,023,"Virginia","Botetourt County",2,84,135,58,77
050,51,023,"Virginia","Botetourt County",2,85,788,276,512
050,51,023,"Virginia","Botetourt County",3,0,237,145,92
050,51,023,"Virginia","Botetourt County",3,1,272,141,131
050,51,023,"Virginia","Botetourt County",3,2,293,152,141
050,51,023,"Virginia","Botetourt County",3,3,303,167,136
050,51,023,"Virginia","Botetourt County",3,4,332,166,166
050,51,023,"Virginia","Botetourt County",3,5,363,201,162
050,51,023,"Virginia","Botetourt County",3,6,336,182,154
050,51,023,"Virginia","Botetourt County",3,7,332,168,164
050,51,023,"Virginia","Botetourt County",3,8,355,188,167
050,51,023,"Virginia","Botetourt County",3,9,343,173,170
050,51,023,"Virginia","Botetourt County",3,10,369,193,176
050,51,023,"Virginia","Botetourt County",3,11,376,183,193
050,51,023,"Virginia","Botetourt County",3,12,393,185,208
050,51,023,"Virginia","Botetourt County",3,13,395,177,218
050,51,023,"Virginia","Botetourt County",3,14,397,201,196
050,51,023,"Virginia","Botetourt County",3,15,410,222,188
050,51,023,"Virginia","Botetourt County",3,16,430,224,206
050,51,023,"Virginia","Botetourt County",3,17,440,224,216
050,51,023,"Virginia","Botetourt County",3,18,379,193,186
050,51,023,"Virginia","Botetourt County",3,19,281,146,135
050,51,023,"Virginia","Botetourt County",3,20,300,162,138
050,51,023,"Virginia","Botetourt County",3,21,322,167,155
050,51,023,"Virginia","Botetourt County",3,22,324,156,168
050,51,023,"Virginia","Botetourt County",3,23,349,181,168
050,51,023,"Virginia","Botetourt County",3,24,334,174,160
050,51,023,"Virginia","Botetourt County",3,25,324,167,157
050,51,023,"Virginia","Botetourt County",3,26,320,160,160
050,51,023,"Virginia","Botetourt County",3,27,289,143,146
050,51,023,"Virginia","Botetourt County",3,28,330,164,166
050,51,023,"Virginia","Botetourt County",3,29,319,176,143
050,51,023,"Virginia","Botetourt County",3,30,317,173,144
050,51,023,"Virginia","Botetourt County",3,31,355,172,183
050,51,023,"Virginia","Botetourt County",3,32,380,188,192
050,51,023,"Virginia","Botetourt County",3,33,372,178,194
050,51,023,"Virginia","Botetourt County",3,34,363,181,182
050,51,023,"Virginia","Botetourt County",3,35,365,194,171
050,51,023,"Virginia","Botetourt County",3,36,405,211,194
050,51,023,"Virginia","Botetourt County",3,37,369,202,167
050,51,023,"Virginia","Botetourt County",3,38,405,216,189
050,51,023,"Virginia","Botetourt County",3,39,376,197,179
050,51,023,"Virginia","Botetourt County",3,40,369,182,187
050,51,023,"Virginia","Botetourt County",3,41,400,196,204
050,51,023,"Virginia","Botetourt County",3,42,378,193,185
050,51,023,"Virginia","Botetourt County",3,43,368,183,185
050,51,023,"Virginia","Botetourt County",3,44,343,168,175
050,51,023,"Virginia","Botetourt County",3,45,366,180,186
050,51,023,"Virginia","Botetourt County",3,46,392,194,198
050,51,023,"Virginia","Botetourt County",3,47,413,218,195
050,51,023,"Virginia","Botetourt County",3,48,433,210,223
050,51,023,"Virginia","Botetourt County",3,49,495,254,241
050,51,023,"Virginia","Botetourt County",3,50,517,268,249
050,51,023,"Virginia","Botetourt County",3,51,491,269,222
050,51,023,"Virginia","Botetourt County",3,52,486,241,245
050,51,023,"Virginia","Botetourt County",3,53,487,238,249
050,51,023,"Virginia","Botetourt County",3,54,523,249,274
050,51,023,"Virginia","Botetourt County",3,55,541,271,270
050,51,023,"Virginia","Botetourt County",3,56,564,283,281
050,51,023,"Virginia","Botetourt County",3,57,578,285,293
050,51,023,"Virginia","Botetourt County",3,58,573,288,285
050,51,023,"Virginia","Botetourt County",3,59,584,282,302
050,51,023,"Virginia","Botetourt County",3,60,566,286,280
050,51,023,"Virginia","Botetourt County",3,61,553,282,271
050,51,023,"Virginia","Botetourt County",3,62,514,256,258
050,51,023,"Virginia","Botetourt County",3,63,552,285,267
050,51,023,"Virginia","Botetourt County",3,64,542,265,277
050,51,023,"Virginia","Botetourt County",3,65,526,266,260
050,51,023,"Virginia","Botetourt County",3,66,510,264,246
050,51,023,"Virginia","Botetourt County",3,67,487,243,244
050,51,023,"Virginia","Botetourt County",3,68,491,250,241
050,51,023,"Virginia","Botetourt County",3,69,496,246,250
050,51,023,"Virginia","Botetourt County",3,70,476,238,238
050,51,023,"Virginia","Botetourt County",3,71,462,225,237
050,51,023,"Virginia","Botetourt County",3,72,452,213,239
050,51,023,"Virginia","Botetourt County",3,73,457,219,238
050,51,023,"Virginia","Botetourt County",3,74,460,223,237
050,51,023,"Virginia","Botetourt County",3,75,326,160,166
050,51,023,"Virginia","Botetourt County",3,76,309,149,160
050,51,023,"Virginia","Botetourt County",3,77,292,136,156
050,51,023,"Virginia","Botetourt County",3,78,288,146,142
050,51,023,"Virginia","Botetourt County",3,79,233,106,127
050,51,023,"Virginia","Botetourt County",3,80,216,92,124
050,51,023,"Virginia","Botetourt County",3,81,208,91,117
050,51,023,"Virginia","Botetourt County",3,82,196,78,118
050,51,023,"Virginia","Botetourt County",3,83,171,75,96
050,51,023,"Virginia","Botetourt County",3,84,152,62,90
050,51,023,"Virginia","Botetourt County",3,85,808,286,522
050,51,023,"Virginia","Botetourt County",4,0,259,137,122
050,51,023,"Virginia","Botetourt County",4,1,252,148,104
050,51,023,"Virginia","Botetourt County",4,2,291,146,145
050,51,023,"Virginia","Botetourt County",4,3,309,166,143
050,51,023,"Virginia","Botetourt County",4,4,306,165,141
050,51,023,"Virginia","Botetourt County",4,5,344,172,172
050,51,023,"Virginia","Botetourt County",4,6,375,200,175
050,51,023,"Virginia","Botetourt County",4,7,343,186,157
050,51,023,"Virginia","Botetourt County",4,8,351,176,175
050,51,023,"Virginia","Botetourt County",4,9,362,193,169
050,51,023,"Virginia","Botetourt County",4,10,348,178,170
050,51,023,"Virginia","Botetourt County",4,11,384,194,190
050,51,023,"Virginia","Botetourt County",4,12,377,182,195
050,51,023,"Virginia","Botetourt County",4,13,391,183,208
050,51,023,"Virginia","Botetourt County",4,14,396,171,225
050,51,023,"Virginia","Botetourt County",4,15,394,200,194
050,51,023,"Virginia","Botetourt County",4,16,403,219,184
050,51,023,"Virginia","Botetourt County",4,17,421,222,199
050,51,023,"Virginia","Botetourt County",4,18,359,189,170
050,51,023,"Virginia","Botetourt County",4,19,294,152,142
050,51,023,"Virginia","Botetourt County",4,20,314,159,155
050,51,023,"Virginia","Botetourt County",4,21,317,165,152
050,51,023,"Virginia","Botetourt County",4,22,358,174,184
050,51,023,"Virginia","Botetourt County",4,23,335,167,168
050,51,023,"Virginia","Botetourt County",4,24,341,177,164
050,51,023,"Virginia","Botetourt County",4,25,343,170,173
050,51,023,"Virginia","Botetourt County",4,26,313,170,143
050,51,023,"Virginia","Botetourt County",4,27,320,160,160
050,51,023,"Virginia","Botetourt County",4,28,317,158,159
050,51,023,"Virginia","Botetourt County",4,29,341,170,171
050,51,023,"Virginia","Botetourt County",4,30,318,172,146
050,51,023,"Virginia","Botetourt County",4,31,325,179,146
050,51,023,"Virginia","Botetourt County",4,32,384,186,198
050,51,023,"Virginia","Botetourt County",4,33,382,193,189
050,51,023,"Virginia","Botetourt County",4,34,394,198,196
050,51,023,"Virginia","Botetourt County",4,35,381,189,192
050,51,023,"Virginia","Botetourt County",4,36,386,204,182
050,51,023,"Virginia","Botetourt County",4,37,408,221,187
050,51,023,"Virginia","Botetourt County",4,38,359,196,163
050,51,023,"Virginia","Botetourt County",4,39,406,213,193
050,51,023,"Virginia","Botetourt County",4,40,388,201,187
050,51,023,"Virginia","Botetourt County",4,41,376,185,191
050,51,023,"Virginia","Botetourt County",4,42,405,199,206
050,51,023,"Virginia","Botetourt County",4,43,390,200,190
050,51,023,"Virginia","Botetourt County",4,44,372,189,183
050,51,023,"Virginia","Botetourt County",4,45,361,182,179
050,51,023,"Virginia","Botetourt County",4,46,359,170,189
050,51,023,"Virginia","Botetourt County",4,47,395,196,199
050,51,023,"Virginia","Botetourt County",4,48,416,220,196
050,51,023,"Virginia","Botetourt County",4,49,431,208,223
050,51,023,"Virginia","Botetourt County",4,50,494,255,239
050,51,023,"Virginia","Botetourt County",4,51,527,273,254
050,51,023,"Virginia","Botetourt County",4,52,477,254,223
050,51,023,"Virginia","Botetourt County",4,53,488,242,246
050,51,023,"Virginia","Botetourt County",4,54,494,243,251
050,51,023,"Virginia","Botetourt County",4,55,526,251,275
050,51,023,"Virginia","Botetourt County",4,56,547,275,272
050,51,023,"Virginia","Botetourt County",4,57,558,280,278
050,51,023,"Virginia","Botetourt County",4,58,575,279,296
050,51,023,"Virginia","Botetourt County",4,59,571,284,287
050,51,023,"Virginia","Botetourt County",4,60,578,281,297
050,51,023,"Virginia","Botetourt County",4,61,563,286,277
050,51,023,"Virginia","Botetourt County",4,62,530,267,263
050,51,023,"Virginia","Botetourt County",4,63,527,260,267
050,51,023,"Virginia","Botetourt County",4,64,528,267,261
050,51,023,"Virginia","Botetourt County",4,65,544,260,284
050,51,023,"Virginia","Botetourt County",4,66,536,274,262
050,51,023,"Virginia","Botetourt County",4,67,498,253,245
050,51,023,"Virginia","Botetourt County",4,68,480,237,243
050,51,023,"Virginia","Botetourt County",4,69,479,239,240
050,51,023,"Virginia","Botetourt County",4,70,491,247,244
050,51,023,"Virginia","Botetourt County",4,71,464,235,229
050,51,023,"Virginia","Botetourt County",4,72,462,222,240
050,51,023,"Virginia","Botetourt County",4,73,452,214,238
050,51,023,"Virginia","Botetourt County",4,74,433,203,230
050,51,023,"Virginia","Botetourt County",4,75,451,211,240
050,51,023,"Virginia","Botetourt County",4,76,314,156,158
050,51,023,"Virginia","Botetourt County",4,77,290,136,154
050,51,023,"Virginia","Botetourt County",4,78,276,128,148
050,51,023,"Virginia","Botetourt County",4,79,276,139,137
050,51,023,"Virginia","Botetourt County",4,80,216,101,115
050,51,023,"Virginia","Botetourt County",4,81,190,76,114
050,51,023,"Virginia","Botetourt County",4,82,202,82,120
050,51,023,"Virginia","Botetourt County",4,83,173,78,95
050,51,023,"Virginia","Botetourt County",4,84,158,70,88
050,51,023,"Virginia","Botetourt County",4,85,838,293,545
050,51,023,"Virginia","Botetourt County",5,0,260,138,122
050,51,023,"Virginia","Botetourt County",5,1,264,135,129
050,51,023,"Virginia","Botetourt County",5,2,269,145,124
050,51,023,"Virginia","Botetourt County",5,3,307,153,154
050,51,023,"Virginia","Botetourt County",5,4,309,166,143
050,51,023,"Virginia","Botetourt County",5,5,309,165,144
050,51,023,"Virginia","Botetourt County",5,6,338,170,168
050,51,023,"Virginia","Botetourt County",5,7,383,206,177
050,51,023,"Virginia","Botetourt County",5,8,349,188,161
050,51,023,"Virginia","Botetourt County",5,9,358,178,180
050,51,023,"Virginia","Botetourt County",5,10,380,200,180
050,51,023,"Virginia","Botetourt County",5,11,366,180,186
050,51,023,"Virginia","Botetourt County",5,12,393,201,192
050,51,023,"Virginia","Botetourt County",5,13,386,184,202
050,51,023,"Virginia","Botetourt County",5,14,401,188,213
050,51,023,"Virginia","Botetourt County",5,15,400,179,221
050,51,023,"Virginia","Botetourt County",5,16,413,205,208
050,51,023,"Virginia","Botetourt County",5,17,407,218,189
050,51,023,"Virginia","Botetourt County",5,18,345,186,159
050,51,023,"Virginia","Botetourt County",5,19,279,148,131
050,51,023,"Virginia","Botetourt County",5,20,318,163,155
050,51,023,"Virginia","Botetourt County",5,21,325,159,166
050,51,023,"Virginia","Botetourt County",5,22,312,163,149
050,51,023,"Virginia","Botetourt County",5,23,347,162,185
050,51,023,"Virginia","Botetourt County",5,24,336,175,161
050,51,023,"Virginia","Botetourt County",5,25,309,161,148
050,51,023,"Virginia","Botetourt County",5,26,326,158,168
050,51,023,"Virginia","Botetourt County",5,27,344,185,159
050,51,023,"Virginia","Botetourt County",5,28,322,155,167
050,51,023,"Virginia","Botetourt County",5,29,310,159,151
050,51,023,"Virginia","Botetourt County",5,30,332,165,167
050,51,023,"Virginia","Botetourt County",5,31,341,187,154
050,51,023,"Virginia","Botetourt County",5,32,371,209,162
050,51,023,"Virginia","Botetourt County",5,33,397,183,214
050,51,023,"Virginia","Botetourt County",5,34,390,191,199
050,51,023,"Virginia","Botetourt County",5,35,392,198,194
050,51,023,"Virginia","Botetourt County",5,36,392,208,184
050,51,023,"Virginia","Botetourt County",5,37,390,205,185
050,51,023,"Virginia","Botetourt County",5,38,407,216,191
050,51,023,"Virginia","Botetourt County",5,39,373,204,169
050,51,023,"Virginia","Botetourt County",5,40,403,211,192
050,51,023,"Virginia","Botetourt County",5,41,396,203,193
050,51,023,"Virginia","Botetourt County",5,42,376,178,198
050,51,023,"Virginia","Botetourt County",5,43,423,205,218
050,51,023,"Virginia","Botetourt County",5,44,381,195,186
050,51,023,"Virginia","Botetourt County",5,45,390,200,190
050,51,023,"Virginia","Botetourt County",5,46,353,173,180
050,51,023,"Virginia","Botetourt County",5,47,352,169,183
050,51,023,"Virginia","Botetourt County",5,48,386,193,193
050,51,023,"Virginia","Botetourt County",5,49,415,219,196
050,51,023,"Virginia","Botetourt County",5,50,433,214,219
050,51,023,"Virginia","Botetourt County",5,51,494,256,238
050,51,023,"Virginia","Botetourt County",5,52,544,274,270
050,51,023,"Virginia","Botetourt County",5,53,486,255,231
050,51,023,"Virginia","Botetourt County",5,54,500,250,250
050,51,023,"Virginia","Botetourt County",5,55,488,242,246
050,51,023,"Virginia","Botetourt County",5,56,519,248,271
050,51,023,"Virginia","Botetourt County",5,57,550,279,271
050,51,023,"Virginia","Botetourt County",5,58,575,296,279
050,51,023,"Virginia","Botetourt County",5,59,571,279,292
050,51,023,"Virginia","Botetourt County",5,60,571,282,289
050,51,023,"Virginia","Botetourt County",5,61,568,283,285
050,51,023,"Virginia","Botetourt County",5,62,570,284,286
050,51,023,"Virginia","Botetourt County",5,63,535,272,263
050,51,023,"Virginia","Botetourt County",5,64,504,250,254
050,51,023,"Virginia","Botetourt County",5,65,532,265,267
050,51,023,"Virginia","Botetourt County",5,66,532,250,282
050,51,023,"Virginia","Botetourt County",5,67,522,263,259
050,51,023,"Virginia","Botetourt County",5,68,493,254,239
050,51,023,"Virginia","Botetourt County",5,69,461,227,234
050,51,023,"Virginia","Botetourt County",5,70,463,232,231
050,51,023,"Virginia","Botetourt County",5,71,464,234,230
050,51,023,"Virginia","Botetourt County",5,72,459,231,228
050,51,023,"Virginia","Botetourt County",5,73,462,221,241
050,51,023,"Virginia","Botetourt County",5,74,428,195,233
050,51,023,"Virginia","Botetourt County",5,75,425,194,231
050,51,023,"Virginia","Botetourt County",5,76,444,210,234
050,51,023,"Virginia","Botetourt County",5,77,303,147,156
050,51,023,"Virginia","Botetourt County",5,78,279,129,150
050,51,023,"Virginia","Botetourt County",5,79,263,122,141
050,51,023,"Virginia","Botetourt County",5,80,260,134,126
050,51,023,"Virginia","Botetourt County",5,81,198,90,108
050,51,023,"Virginia","Botetourt County",5,82,187,67,120
050,51,023,"Virginia","Botetourt County",5,83,190,85,105
050,51,023,"Virginia","Botetourt County",5,84,160,73,87
050,51,023,"Virginia","Botetourt County",5,85,867,313,554
050,51,025,"Virginia","Brunswick County",1,0,125,63,62
050,51,025,"Virginia","Brunswick County",1,1,139,80,59
050,51,025,"Virginia","Brunswick County",1,2,144,81,63
050,51,025,"Virginia","Brunswick County",1,3,134,68,66
050,51,025,"Virginia","Brunswick County",1,4,140,63,77
050,51,025,"Virginia","Brunswick County",1,5,145,59,86
050,51,025,"Virginia","Brunswick County",1,6,133,73,60
050,51,025,"Virginia","Brunswick County",1,7,134,63,71
050,51,025,"Virginia","Brunswick County",1,8,147,63,84
050,51,025,"Virginia","Brunswick County",1,9,132,69,63
050,51,025,"Virginia","Brunswick County",1,10,135,73,62
050,51,025,"Virginia","Brunswick County",1,11,141,73,68
050,51,025,"Virginia","Brunswick County",1,12,149,69,80
050,51,025,"Virginia","Brunswick County",1,13,156,74,82
050,51,025,"Virginia","Brunswick County",1,14,156,92,64
050,51,025,"Virginia","Brunswick County",1,15,163,91,72
050,51,025,"Virginia","Brunswick County",1,16,172,92,80
050,51,025,"Virginia","Brunswick County",1,17,172,95,77
050,51,025,"Virginia","Brunswick County",1,18,163,84,79
050,51,025,"Virginia","Brunswick County",1,19,150,85,65
050,51,025,"Virginia","Brunswick County",1,20,169,112,57
050,51,025,"Virginia","Brunswick County",1,21,196,117,79
050,51,025,"Virginia","Brunswick County",1,22,220,142,78
050,51,025,"Virginia","Brunswick County",1,23,231,151,80
050,51,025,"Virginia","Brunswick County",1,24,225,140,85
050,51,025,"Virginia","Brunswick County",1,25,232,150,82
050,51,025,"Virginia","Brunswick County",1,26,224,148,76
050,51,025,"Virginia","Brunswick County",1,27,255,184,71
050,51,025,"Virginia","Brunswick County",1,28,196,126,70
050,51,025,"Virginia","Brunswick County",1,29,233,167,66
050,51,025,"Virginia","Brunswick County",1,30,217,138,79
050,51,025,"Virginia","Brunswick County",1,31,232,156,76
050,51,025,"Virginia","Brunswick County",1,32,244,176,68
050,51,025,"Virginia","Brunswick County",1,33,200,135,65
050,51,025,"Virginia","Brunswick County",1,34,174,107,67
050,51,025,"Virginia","Brunswick County",1,35,184,104,80
050,51,025,"Virginia","Brunswick County",1,36,186,106,80
050,51,025,"Virginia","Brunswick County",1,37,196,121,75
050,51,025,"Virginia","Brunswick County",1,38,199,120,79
050,51,025,"Virginia","Brunswick County",1,39,190,113,77
050,51,025,"Virginia","Brunswick County",1,40,202,109,93
050,51,025,"Virginia","Brunswick County",1,41,178,98,80
050,51,025,"Virginia","Brunswick County",1,42,174,109,65
050,51,025,"Virginia","Brunswick County",1,43,199,116,83
050,51,025,"Virginia","Brunswick County",1,44,192,115,77
050,51,025,"Virginia","Brunswick County",1,45,175,103,72
050,51,025,"Virginia","Brunswick County",1,46,186,111,75
050,51,025,"Virginia","Brunswick County",1,47,178,101,77
050,51,025,"Virginia","Brunswick County",1,48,186,88,98
050,51,025,"Virginia","Brunswick County",1,49,205,109,96
050,51,025,"Virginia","Brunswick County",1,50,203,103,100
050,51,025,"Virginia","Brunswick County",1,51,183,102,81
050,51,025,"Virginia","Brunswick County",1,52,185,89,96
050,51,025,"Virginia","Brunswick County",1,53,201,100,101
050,51,025,"Virginia","Brunswick County",1,54,224,115,109
050,51,025,"Virginia","Brunswick County",1,55,251,121,130
050,51,025,"Virginia","Brunswick County",1,56,233,113,120
050,51,025,"Virginia","Brunswick County",1,57,227,115,112
050,51,025,"Virginia","Brunswick County",1,58,244,133,111
050,51,025,"Virginia","Brunswick County",1,59,240,105,135
050,51,025,"Virginia","Brunswick County",1,60,254,120,134
050,51,025,"Virginia","Brunswick County",1,61,237,107,130
050,51,025,"Virginia","Brunswick County",1,62,258,126,132
050,51,025,"Virginia","Brunswick County",1,63,236,109,127
050,51,025,"Virginia","Brunswick County",1,64,237,121,116
050,51,025,"Virginia","Brunswick County",1,65,223,105,118
050,51,025,"Virginia","Brunswick County",1,66,227,100,127
050,51,025,"Virginia","Brunswick County",1,67,240,110,130
050,51,025,"Virginia","Brunswick County",1,68,224,112,112
050,51,025,"Virginia","Brunswick County",1,69,207,96,111
050,51,025,"Virginia","Brunswick County",1,70,205,102,103
050,51,025,"Virginia","Brunswick County",1,71,205,94,111
050,51,025,"Virginia","Brunswick County",1,72,190,89,101
050,51,025,"Virginia","Brunswick County",1,73,188,98,90
050,51,025,"Virginia","Brunswick County",1,74,135,67,68
050,51,025,"Virginia","Brunswick County",1,75,128,55,73
050,51,025,"Virginia","Brunswick County",1,76,136,58,78
050,51,025,"Virginia","Brunswick County",1,77,133,55,78
050,51,025,"Virginia","Brunswick County",1,78,125,62,63
050,51,025,"Virginia","Brunswick County",1,79,111,51,60
050,51,025,"Virginia","Brunswick County",1,80,91,40,51
050,51,025,"Virginia","Brunswick County",1,81,81,41,40
050,51,025,"Virginia","Brunswick County",1,82,84,34,50
050,51,025,"Virginia","Brunswick County",1,83,83,32,51
050,51,025,"Virginia","Brunswick County",1,84,74,31,43
050,51,025,"Virginia","Brunswick County",1,85,335,118,217
050,51,025,"Virginia","Brunswick County",2,0,127,67,60
050,51,025,"Virginia","Brunswick County",2,1,135,75,60
050,51,025,"Virginia","Brunswick County",2,2,143,82,61
050,51,025,"Virginia","Brunswick County",2,3,134,70,64
050,51,025,"Virginia","Brunswick County",2,4,140,65,75
050,51,025,"Virginia","Brunswick County",2,5,143,61,82
050,51,025,"Virginia","Brunswick County",2,6,133,68,65
050,51,025,"Virginia","Brunswick County",2,7,130,64,66
050,51,025,"Virginia","Brunswick County",2,8,141,62,79
050,51,025,"Virginia","Brunswick County",2,9,136,67,69
050,51,025,"Virginia","Brunswick County",2,10,134,71,63
050,51,025,"Virginia","Brunswick County",2,11,137,71,66
050,51,025,"Virginia","Brunswick County",2,12,148,70,78
050,51,025,"Virginia","Brunswick County",2,13,154,73,81
050,51,025,"Virginia","Brunswick County",2,14,154,87,67
050,51,025,"Virginia","Brunswick County",2,15,159,90,69
050,51,025,"Virginia","Brunswick County",2,16,170,91,79
050,51,025,"Virginia","Brunswick County",2,17,171,94,77
050,51,025,"Virginia","Brunswick County",2,18,157,82,75
050,51,025,"Virginia","Brunswick County",2,19,154,87,67
050,51,025,"Virginia","Brunswick County",2,20,171,110,61
050,51,025,"Virginia","Brunswick County",2,21,193,117,76
050,51,025,"Virginia","Brunswick County",2,22,220,140,80
050,51,025,"Virginia","Brunswick County",2,23,233,152,81
050,51,025,"Virginia","Brunswick County",2,24,227,143,84
050,51,025,"Virginia","Brunswick County",2,25,231,150,81
050,51,025,"Virginia","Brunswick County",2,26,225,148,77
050,51,025,"Virginia","Brunswick County",2,27,251,181,70
050,51,025,"Virginia","Brunswick County",2,28,202,131,71
050,51,025,"Virginia","Brunswick County",2,29,234,167,67
050,51,025,"Virginia","Brunswick County",2,30,213,136,77
050,51,025,"Virginia","Brunswick County",2,31,231,156,75
050,51,025,"Virginia","Brunswick County",2,32,245,175,70
050,51,025,"Virginia","Brunswick County",2,33,206,139,67
050,51,025,"Virginia","Brunswick County",2,34,176,111,65
050,51,025,"Virginia","Brunswick County",2,35,186,106,80
050,51,025,"Virginia","Brunswick County",2,36,181,101,80
050,51,025,"Virginia","Brunswick County",2,37,197,120,77
050,51,025,"Virginia","Brunswick County",2,38,200,120,80
050,51,025,"Virginia","Brunswick County",2,39,191,114,77
050,51,025,"Virginia","Brunswick County",2,40,201,109,92
050,51,025,"Virginia","Brunswick County",2,41,180,99,81
050,51,025,"Virginia","Brunswick County",2,42,171,104,67
050,51,025,"Virginia","Brunswick County",2,43,200,119,81
050,51,025,"Virginia","Brunswick County",2,44,188,112,76
050,51,025,"Virginia","Brunswick County",2,45,177,103,74
050,51,025,"Virginia","Brunswick County",2,46,182,109,73
050,51,025,"Virginia","Brunswick County",2,47,178,102,76
050,51,025,"Virginia","Brunswick County",2,48,184,89,95
050,51,025,"Virginia","Brunswick County",2,49,202,106,96
050,51,025,"Virginia","Brunswick County",2,50,202,102,100
050,51,025,"Virginia","Brunswick County",2,51,188,104,84
050,51,025,"Virginia","Brunswick County",2,52,182,90,92
050,51,025,"Virginia","Brunswick County",2,53,202,98,104
050,51,025,"Virginia","Brunswick County",2,54,220,111,109
050,51,025,"Virginia","Brunswick County",2,55,244,119,125
050,51,025,"Virginia","Brunswick County",2,56,238,115,123
050,51,025,"Virginia","Brunswick County",2,57,226,110,116
050,51,025,"Virginia","Brunswick County",2,58,242,130,112
050,51,025,"Virginia","Brunswick County",2,59,241,111,130
050,51,025,"Virginia","Brunswick County",2,60,250,117,133
050,51,025,"Virginia","Brunswick County",2,61,241,111,130
050,51,025,"Virginia","Brunswick County",2,62,248,118,130
050,51,025,"Virginia","Brunswick County",2,63,243,114,129
050,51,025,"Virginia","Brunswick County",2,64,235,118,117
050,51,025,"Virginia","Brunswick County",2,65,224,107,117
050,51,025,"Virginia","Brunswick County",2,66,225,99,126
050,51,025,"Virginia","Brunswick County",2,67,235,107,128
050,51,025,"Virginia","Brunswick County",2,68,225,110,115
050,51,025,"Virginia","Brunswick County",2,69,212,102,110
050,51,025,"Virginia","Brunswick County",2,70,205,101,104
050,51,025,"Virginia","Brunswick County",2,71,207,98,109
050,51,025,"Virginia","Brunswick County",2,72,192,89,103
050,51,025,"Virginia","Brunswick County",2,73,196,100,96
050,51,025,"Virginia","Brunswick County",2,74,136,67,69
050,51,025,"Virginia","Brunswick County",2,75,130,57,73
050,51,025,"Virginia","Brunswick County",2,76,131,55,76
050,51,025,"Virginia","Brunswick County",2,77,137,58,79
050,51,025,"Virginia","Brunswick County",2,78,120,58,62
050,51,025,"Virginia","Brunswick County",2,79,115,54,61
050,51,025,"Virginia","Brunswick County",2,80,95,43,52
050,51,025,"Virginia","Brunswick County",2,81,81,39,42
050,51,025,"Virginia","Brunswick County",2,82,82,35,47
050,51,025,"Virginia","Brunswick County",2,83,82,31,51
050,51,025,"Virginia","Brunswick County",2,84,75,31,44
050,51,025,"Virginia","Brunswick County",2,85,339,121,218
050,51,025,"Virginia","Brunswick County",3,0,139,71,68
050,51,025,"Virginia","Brunswick County",3,1,138,73,65
050,51,025,"Virginia","Brunswick County",3,2,142,80,62
050,51,025,"Virginia","Brunswick County",3,3,130,78,52
050,51,025,"Virginia","Brunswick County",3,4,144,73,71
050,51,025,"Virginia","Brunswick County",3,5,145,73,72
050,51,025,"Virginia","Brunswick County",3,6,148,61,87
050,51,025,"Virginia","Brunswick County",3,7,134,72,62
050,51,025,"Virginia","Brunswick County",3,8,137,67,70
050,51,025,"Virginia","Brunswick County",3,9,145,68,77
050,51,025,"Virginia","Brunswick County",3,10,132,62,70
050,51,025,"Virginia","Brunswick County",3,11,130,71,59
050,51,025,"Virginia","Brunswick County",3,12,145,71,74
050,51,025,"Virginia","Brunswick County",3,13,143,67,76
050,51,025,"Virginia","Brunswick County",3,14,158,76,82
050,51,025,"Virginia","Brunswick County",3,15,157,91,66
050,51,025,"Virginia","Brunswick County",3,16,165,94,71
050,51,025,"Virginia","Brunswick County",3,17,170,91,79
050,51,025,"Virginia","Brunswick County",3,18,150,84,66
050,51,025,"Virginia","Brunswick County",3,19,155,89,66
050,51,025,"Virginia","Brunswick County",3,20,185,116,69
050,51,025,"Virginia","Brunswick County",3,21,189,123,66
050,51,025,"Virginia","Brunswick County",3,22,205,131,74
050,51,025,"Virginia","Brunswick County",3,23,239,158,81
050,51,025,"Virginia","Brunswick County",3,24,222,144,78
050,51,025,"Virginia","Brunswick County",3,25,246,162,84
050,51,025,"Virginia","Brunswick County",3,26,232,156,76
050,51,025,"Virginia","Brunswick County",3,27,257,178,79
050,51,025,"Virginia","Brunswick County",3,28,234,154,80
050,51,025,"Virginia","Brunswick County",3,29,237,172,65
050,51,025,"Virginia","Brunswick County",3,30,211,139,72
050,51,025,"Virginia","Brunswick County",3,31,246,172,74
050,51,025,"Virginia","Brunswick County",3,32,246,174,72
050,51,025,"Virginia","Brunswick County",3,33,208,145,63
050,51,025,"Virginia","Brunswick County",3,34,201,131,70
050,51,025,"Virginia","Brunswick County",3,35,185,113,72
050,51,025,"Virginia","Brunswick County",3,36,182,104,78
050,51,025,"Virginia","Brunswick County",3,37,185,106,79
050,51,025,"Virginia","Brunswick County",3,38,186,111,75
050,51,025,"Virginia","Brunswick County",3,39,212,128,84
050,51,025,"Virginia","Brunswick County",3,40,202,116,86
050,51,025,"Virginia","Brunswick County",3,41,196,107,89
050,51,025,"Virginia","Brunswick County",3,42,174,95,79
050,51,025,"Virginia","Brunswick County",3,43,198,124,74
050,51,025,"Virginia","Brunswick County",3,44,189,115,74
050,51,025,"Virginia","Brunswick County",3,45,192,111,81
050,51,025,"Virginia","Brunswick County",3,46,182,107,75
050,51,025,"Virginia","Brunswick County",3,47,176,105,71
050,51,025,"Virginia","Brunswick County",3,48,172,91,81
050,51,025,"Virginia","Brunswick County",3,49,176,87,89
050,51,025,"Virginia","Brunswick County",3,50,198,95,103
050,51,025,"Virginia","Brunswick County",3,51,201,108,93
050,51,025,"Virginia","Brunswick County",3,52,184,95,89
050,51,025,"Virginia","Brunswick County",3,53,195,108,87
050,51,025,"Virginia","Brunswick County",3,54,202,97,105
050,51,025,"Virginia","Brunswick County",3,55,223,110,113
050,51,025,"Virginia","Brunswick County",3,56,255,123,132
050,51,025,"Virginia","Brunswick County",3,57,234,109,125
050,51,025,"Virginia","Brunswick County",3,58,233,117,116
050,51,025,"Virginia","Brunswick County",3,59,226,115,111
050,51,025,"Virginia","Brunswick County",3,60,250,118,132
050,51,025,"Virginia","Brunswick County",3,61,258,123,135
050,51,025,"Virginia","Brunswick County",3,62,245,108,137
050,51,025,"Virginia","Brunswick County",3,63,245,114,131
050,51,025,"Virginia","Brunswick County",3,64,256,117,139
050,51,025,"Virginia","Brunswick County",3,65,236,121,115
050,51,025,"Virginia","Brunswick County",3,66,220,104,116
050,51,025,"Virginia","Brunswick County",3,67,225,97,128
050,51,025,"Virginia","Brunswick County",3,68,223,107,116
050,51,025,"Virginia","Brunswick County",3,69,224,108,116
050,51,025,"Virginia","Brunswick County",3,70,209,103,106
050,51,025,"Virginia","Brunswick County",3,71,194,93,101
050,51,025,"Virginia","Brunswick County",3,72,207,96,111
050,51,025,"Virginia","Brunswick County",3,73,177,82,95
050,51,025,"Virginia","Brunswick County",3,74,184,94,90
050,51,025,"Virginia","Brunswick County",3,75,131,61,70
050,51,025,"Virginia","Brunswick County",3,76,118,49,69
050,51,025,"Virginia","Brunswick County",3,77,125,51,74
050,51,025,"Virginia","Brunswick County",3,78,133,53,80
050,51,025,"Virginia","Brunswick County",3,79,106,49,57
050,51,025,"Virginia","Brunswick County",3,80,116,53,63
050,51,025,"Virginia","Brunswick County",3,81,86,37,49
050,51,025,"Virginia","Brunswick County",3,82,73,37,36
050,51,025,"Virginia","Brunswick County",3,83,76,31,45
050,51,025,"Virginia","Brunswick County",3,84,74,27,47
050,51,025,"Virginia","Brunswick County",3,85,345,128,217
050,51,025,"Virginia","Brunswick County",4,0,117,54,63
050,51,025,"Virginia","Brunswick County",4,1,142,79,63
050,51,025,"Virginia","Brunswick County",4,2,139,77,62
050,51,025,"Virginia","Brunswick County",4,3,143,81,62
050,51,025,"Virginia","Brunswick County",4,4,131,74,57
050,51,025,"Virginia","Brunswick County",4,5,139,67,72
050,51,025,"Virginia","Brunswick County",4,6,147,71,76
050,51,025,"Virginia","Brunswick County",4,7,145,62,83
050,51,025,"Virginia","Brunswick County",4,8,135,74,61
050,51,025,"Virginia","Brunswick County",4,9,129,63,66
050,51,025,"Virginia","Brunswick County",4,10,148,72,76
050,51,025,"Virginia","Brunswick County",4,11,138,62,76
050,51,025,"Virginia","Brunswick County",4,12,128,66,62
050,51,025,"Virginia","Brunswick County",4,13,143,73,70
050,51,025,"Virginia","Brunswick County",4,14,145,71,74
050,51,025,"Virginia","Brunswick County",4,15,160,80,80
050,51,025,"Virginia","Brunswick County",4,16,158,91,67
050,51,025,"Virginia","Brunswick County",4,17,165,90,75
050,51,025,"Virginia","Brunswick County",4,18,154,89,65
050,51,025,"Virginia","Brunswick County",4,19,153,95,58
050,51,025,"Virginia","Brunswick County",4,20,166,103,63
050,51,025,"Virginia","Brunswick County",4,21,198,125,73
050,51,025,"Virginia","Brunswick County",4,22,212,131,81
050,51,025,"Virginia","Brunswick County",4,23,212,135,77
050,51,025,"Virginia","Brunswick County",4,24,226,151,75
050,51,025,"Virginia","Brunswick County",4,25,231,153,78
050,51,025,"Virginia","Brunswick County",4,26,223,145,78
050,51,025,"Virginia","Brunswick County",4,27,264,182,82
050,51,025,"Virginia","Brunswick County",4,28,225,143,82
050,51,025,"Virginia","Brunswick County",4,29,264,185,79
050,51,025,"Virginia","Brunswick County",4,30,196,129,67
050,51,025,"Virginia","Brunswick County",4,31,229,158,71
050,51,025,"Virginia","Brunswick County",4,32,266,184,82
050,51,025,"Virginia","Brunswick County",4,33,214,138,76
050,51,025,"Virginia","Brunswick County",4,34,200,139,61
050,51,025,"Virginia","Brunswick County",4,35,216,141,75
050,51,025,"Virginia","Brunswick County",4,36,177,103,74
050,51,025,"Virginia","Brunswick County",4,37,191,111,80
050,51,025,"Virginia","Brunswick County",4,38,183,99,84
050,51,025,"Virginia","Brunswick County",4,39,191,118,73
050,51,025,"Virginia","Brunswick County",4,40,215,129,86
050,51,025,"Virginia","Brunswick County",4,41,190,106,84
050,51,025,"Virginia","Brunswick County",4,42,186,100,86
050,51,025,"Virginia","Brunswick County",4,43,204,118,86
050,51,025,"Virginia","Brunswick County",4,44,187,121,66
050,51,025,"Virginia","Brunswick County",4,45,184,105,79
050,51,025,"Virginia","Brunswick County",4,46,187,109,78
050,51,025,"Virginia","Brunswick County",4,47,174,99,75
050,51,025,"Virginia","Brunswick County",4,48,172,95,77
050,51,025,"Virginia","Brunswick County",4,49,168,97,71
050,51,025,"Virginia","Brunswick County",4,50,172,74,98
050,51,025,"Virginia","Brunswick County",4,51,195,106,89
050,51,025,"Virginia","Brunswick County",4,52,193,95,98
050,51,025,"Virginia","Brunswick County",4,53,191,98,93
050,51,025,"Virginia","Brunswick County",4,54,203,115,88
050,51,025,"Virginia","Brunswick County",4,55,205,95,110
050,51,025,"Virginia","Brunswick County",4,56,218,110,108
050,51,025,"Virginia","Brunswick County",4,57,238,113,125
050,51,025,"Virginia","Brunswick County",4,58,246,114,132
050,51,025,"Virginia","Brunswick County",4,59,217,103,114
050,51,025,"Virginia","Brunswick County",4,60,224,113,111
050,51,025,"Virginia","Brunswick County",4,61,252,120,132
050,51,025,"Virginia","Brunswick County",4,62,243,112,131
050,51,025,"Virginia","Brunswick County",4,63,233,98,135
050,51,025,"Virginia","Brunswick County",4,64,259,122,137
050,51,025,"Virginia","Brunswick County",4,65,251,117,134
050,51,025,"Virginia","Brunswick County",4,66,229,115,114
050,51,025,"Virginia","Brunswick County",4,67,214,99,115
050,51,025,"Virginia","Brunswick County",4,68,218,93,125
050,51,025,"Virginia","Brunswick County",4,69,223,105,118
050,51,025,"Virginia","Brunswick County",4,70,220,107,113
050,51,025,"Virginia","Brunswick County",4,71,205,99,106
050,51,025,"Virginia","Brunswick County",4,72,185,86,99
050,51,025,"Virginia","Brunswick County",4,73,193,89,104
050,51,025,"Virginia","Brunswick County",4,74,169,78,91
050,51,025,"Virginia","Brunswick County",4,75,171,85,86
050,51,025,"Virginia","Brunswick County",4,76,123,57,66
050,51,025,"Virginia","Brunswick County",4,77,111,43,68
050,51,025,"Virginia","Brunswick County",4,78,124,48,76
050,51,025,"Virginia","Brunswick County",4,79,119,46,73
050,51,025,"Virginia","Brunswick County",4,80,105,45,60
050,51,025,"Virginia","Brunswick County",4,81,108,46,62
050,51,025,"Virginia","Brunswick County",4,82,81,38,43
050,51,025,"Virginia","Brunswick County",4,83,61,29,32
050,51,025,"Virginia","Brunswick County",4,84,64,25,39
050,51,025,"Virginia","Brunswick County",4,85,358,133,225
050,51,025,"Virginia","Brunswick County",5,0,115,52,63
050,51,025,"Virginia","Brunswick County",5,1,112,56,56
050,51,025,"Virginia","Brunswick County",5,2,136,69,67
050,51,025,"Virginia","Brunswick County",5,3,143,73,70
050,51,025,"Virginia","Brunswick County",5,4,146,79,67
050,51,025,"Virginia","Brunswick County",5,5,137,83,54
050,51,025,"Virginia","Brunswick County",5,6,136,69,67
050,51,025,"Virginia","Brunswick County",5,7,157,71,86
050,51,025,"Virginia","Brunswick County",5,8,133,58,75
050,51,025,"Virginia","Brunswick County",5,9,132,65,67
050,51,025,"Virginia","Brunswick County",5,10,131,65,66
050,51,025,"Virginia","Brunswick County",5,11,143,67,76
050,51,025,"Virginia","Brunswick County",5,12,138,61,77
050,51,025,"Virginia","Brunswick County",5,13,134,64,70
050,51,025,"Virginia","Brunswick County",5,14,144,76,68
050,51,025,"Virginia","Brunswick County",5,15,139,67,72
050,51,025,"Virginia","Brunswick County",5,16,154,73,81
050,51,025,"Virginia","Brunswick County",5,17,152,88,64
050,51,025,"Virginia","Brunswick County",5,18,143,83,60
050,51,025,"Virginia","Brunswick County",5,19,157,98,59
050,51,025,"Virginia","Brunswick County",5,20,169,107,62
050,51,025,"Virginia","Brunswick County",5,21,176,109,67
050,51,025,"Virginia","Brunswick County",5,22,221,142,79
050,51,025,"Virginia","Brunswick County",5,23,228,144,84
050,51,025,"Virginia","Brunswick County",5,24,212,132,80
050,51,025,"Virginia","Brunswick County",5,25,242,161,81
050,51,025,"Virginia","Brunswick County",5,26,231,145,86
050,51,025,"Virginia","Brunswick County",5,27,258,175,83
050,51,025,"Virginia","Brunswick County",5,28,225,150,75
050,51,025,"Virginia","Brunswick County",5,29,243,170,73
050,51,025,"Virginia","Brunswick County",5,30,230,148,82
050,51,025,"Virginia","Brunswick County",5,31,203,140,63
050,51,025,"Virginia","Brunswick County",5,32,246,173,73
050,51,025,"Virginia","Brunswick County",5,33,244,161,83
050,51,025,"Virginia","Brunswick County",5,34,200,129,71
050,51,025,"Virginia","Brunswick County",5,35,205,138,67
050,51,025,"Virginia","Brunswick County",5,36,199,127,72
050,51,025,"Virginia","Brunswick County",5,37,186,114,72
050,51,025,"Virginia","Brunswick County",5,38,187,105,82
050,51,025,"Virginia","Brunswick County",5,39,188,101,87
050,51,025,"Virginia","Brunswick County",5,40,196,118,78
050,51,025,"Virginia","Brunswick County",5,41,208,125,83
050,51,025,"Virginia","Brunswick County",5,42,177,95,82
050,51,025,"Virginia","Brunswick County",5,43,213,119,94
050,51,025,"Virginia","Brunswick County",5,44,188,109,79
050,51,025,"Virginia","Brunswick County",5,45,184,113,71
050,51,025,"Virginia","Brunswick County",5,46,187,107,80
050,51,025,"Virginia","Brunswick County",5,47,186,110,76
050,51,025,"Virginia","Brunswick County",5,48,165,85,80
050,51,025,"Virginia","Brunswick County",5,49,171,94,77
050,51,025,"Virginia","Brunswick County",5,50,160,84,76
050,51,025,"Virginia","Brunswick County",5,51,170,80,90
050,51,025,"Virginia","Brunswick County",5,52,188,99,89
050,51,025,"Virginia","Brunswick County",5,53,202,101,101
050,51,025,"Virginia","Brunswick County",5,54,193,96,97
050,51,025,"Virginia","Brunswick County",5,55,198,108,90
050,51,025,"Virginia","Brunswick County",5,56,217,105,112
050,51,025,"Virginia","Brunswick County",5,57,210,99,111
050,51,025,"Virginia","Brunswick County",5,58,243,119,124
050,51,025,"Virginia","Brunswick County",5,59,231,97,134
050,51,025,"Virginia","Brunswick County",5,60,218,107,111
050,51,025,"Virginia","Brunswick County",5,61,235,121,114
050,51,025,"Virginia","Brunswick County",5,62,241,110,131
050,51,025,"Virginia","Brunswick County",5,63,238,105,133
050,51,025,"Virginia","Brunswick County",5,64,237,101,136
050,51,025,"Virginia","Brunswick County",5,65,257,125,132
050,51,025,"Virginia","Brunswick County",5,66,255,116,139
050,51,025,"Virginia","Brunswick County",5,67,227,109,118
050,51,025,"Virginia","Brunswick County",5,68,210,98,112
050,51,025,"Virginia","Brunswick County",5,69,215,93,122
050,51,025,"Virginia","Brunswick County",5,70,217,103,114
050,51,025,"Virginia","Brunswick County",5,71,217,107,110
050,51,025,"Virginia","Brunswick County",5,72,197,94,103
050,51,025,"Virginia","Brunswick County",5,73,173,81,92
050,51,025,"Virginia","Brunswick County",5,74,188,88,100
050,51,025,"Virginia","Brunswick County",5,75,158,72,86
050,51,025,"Virginia","Brunswick County",5,76,168,83,85
050,51,025,"Virginia","Brunswick County",5,77,117,52,65
050,51,025,"Virginia","Brunswick County",5,78,106,38,68
050,51,025,"Virginia","Brunswick County",5,79,112,42,70
050,51,025,"Virginia","Brunswick County",5,80,115,42,73
050,51,025,"Virginia","Brunswick County",5,81,97,38,59
050,51,025,"Virginia","Brunswick County",5,82,106,48,58
050,51,025,"Virginia","Brunswick County",5,83,68,28,40
050,51,025,"Virginia","Brunswick County",5,84,48,22,26
050,51,025,"Virginia","Brunswick County",5,85,367,139,228
050,51,027,"Virginia","Buchanan County",1,0,164,83,81
050,51,027,"Virginia","Buchanan County",1,1,176,90,86
050,51,027,"Virginia","Buchanan County",1,2,168,88,80
050,51,027,"Virginia","Buchanan County",1,3,157,79,78
050,51,027,"Virginia","Buchanan County",1,4,157,71,86
050,51,027,"Virginia","Buchanan County",1,5,171,94,77
050,51,027,"Virginia","Buchanan County",1,6,179,91,88
050,51,027,"Virginia","Buchanan County",1,7,202,106,96
050,51,027,"Virginia","Buchanan County",1,8,186,92,94
050,51,027,"Virginia","Buchanan County",1,9,200,104,96
050,51,027,"Virginia","Buchanan County",1,10,198,99,99
050,51,027,"Virginia","Buchanan County",1,11,224,116,108
050,51,027,"Virginia","Buchanan County",1,12,216,117,99
050,51,027,"Virginia","Buchanan County",1,13,217,113,104
050,51,027,"Virginia","Buchanan County",1,14,235,120,115
050,51,027,"Virginia","Buchanan County",1,15,223,115,108
050,51,027,"Virginia","Buchanan County",1,16,219,109,110
050,51,027,"Virginia","Buchanan County",1,17,228,111,117
050,51,027,"Virginia","Buchanan County",1,18,184,86,98
050,51,027,"Virginia","Buchanan County",1,19,164,79,85
050,51,027,"Virginia","Buchanan County",1,20,164,92,72
050,51,027,"Virginia","Buchanan County",1,21,171,90,81
050,51,027,"Virginia","Buchanan County",1,22,197,102,95
050,51,027,"Virginia","Buchanan County",1,23,218,118,100
050,51,027,"Virginia","Buchanan County",1,24,219,121,98
050,51,027,"Virginia","Buchanan County",1,25,240,149,91
050,51,027,"Virginia","Buchanan County",1,26,236,160,76
050,51,027,"Virginia","Buchanan County",1,27,225,137,88
050,51,027,"Virginia","Buchanan County",1,28,212,119,93
050,51,027,"Virginia","Buchanan County",1,29,243,140,103
050,51,027,"Virginia","Buchanan County",1,30,224,131,93
050,51,027,"Virginia","Buchanan County",1,31,246,145,101
050,51,027,"Virginia","Buchanan County",1,32,246,156,90
050,51,027,"Virginia","Buchanan County",1,33,225,131,94
050,51,027,"Virginia","Buchanan County",1,34,224,127,97
050,51,027,"Virginia","Buchanan County",1,35,209,112,97
050,51,027,"Virginia","Buchanan County",1,36,219,114,105
050,51,027,"Virginia","Buchanan County",1,37,230,123,107
050,51,027,"Virginia","Buchanan County",1,38,244,138,106
050,51,027,"Virginia","Buchanan County",1,39,247,144,103
050,51,027,"Virginia","Buchanan County",1,40,250,137,113
050,51,027,"Virginia","Buchanan County",1,41,249,128,121
050,51,027,"Virginia","Buchanan County",1,42,259,153,106
050,51,027,"Virginia","Buchanan County",1,43,250,141,109
050,51,027,"Virginia","Buchanan County",1,44,235,130,105
050,51,027,"Virginia","Buchanan County",1,45,251,136,115
050,51,027,"Virginia","Buchanan County",1,46,274,153,121
050,51,027,"Virginia","Buchanan County",1,47,267,144,123
050,51,027,"Virginia","Buchanan County",1,48,293,149,144
050,51,027,"Virginia","Buchanan County",1,49,324,169,155
050,51,027,"Virginia","Buchanan County",1,50,284,146,138
050,51,027,"Virginia","Buchanan County",1,51,293,157,136
050,51,027,"Virginia","Buchanan County",1,52,298,161,137
050,51,027,"Virginia","Buchanan County",1,53,310,158,152
050,51,027,"Virginia","Buchanan County",1,54,290,143,147
050,51,027,"Virginia","Buchanan County",1,55,313,161,152
050,51,027,"Virginia","Buchanan County",1,56,321,162,159
050,51,027,"Virginia","Buchanan County",1,57,315,158,157
050,51,027,"Virginia","Buchanan County",1,58,321,162,159
050,51,027,"Virginia","Buchanan County",1,59,323,168,155
050,51,027,"Virginia","Buchanan County",1,60,329,166,163
050,51,027,"Virginia","Buchanan County",1,61,324,166,158
050,51,027,"Virginia","Buchanan County",1,62,358,188,170
050,51,027,"Virginia","Buchanan County",1,63,353,177,176
050,51,027,"Virginia","Buchanan County",1,64,318,155,163
050,51,027,"Virginia","Buchanan County",1,65,308,150,158
050,51,027,"Virginia","Buchanan County",1,66,276,136,140
050,51,027,"Virginia","Buchanan County",1,67,280,135,145
050,51,027,"Virginia","Buchanan County",1,68,295,139,156
050,51,027,"Virginia","Buchanan County",1,69,279,128,151
050,51,027,"Virginia","Buchanan County",1,70,258,125,133
050,51,027,"Virginia","Buchanan County",1,71,276,130,146
050,51,027,"Virginia","Buchanan County",1,72,247,112,135
050,51,027,"Virginia","Buchanan County",1,73,269,119,150
050,51,027,"Virginia","Buchanan County",1,74,211,92,119
050,51,027,"Virginia","Buchanan County",1,75,200,95,105
050,51,027,"Virginia","Buchanan County",1,76,187,97,90
050,51,027,"Virginia","Buchanan County",1,77,191,99,92
050,51,027,"Virginia","Buchanan County",1,78,156,65,91
050,51,027,"Virginia","Buchanan County",1,79,159,67,92
050,51,027,"Virginia","Buchanan County",1,80,145,65,80
050,51,027,"Virginia","Buchanan County",1,81,121,55,66
050,51,027,"Virginia","Buchanan County",1,82,122,47,75
050,51,027,"Virginia","Buchanan County",1,83,114,42,72
050,51,027,"Virginia","Buchanan County",1,84,113,41,72
050,51,027,"Virginia","Buchanan County",1,85,427,164,263
050,51,027,"Virginia","Buchanan County",2,0,173,90,83
050,51,027,"Virginia","Buchanan County",2,1,172,88,84
050,51,027,"Virginia","Buchanan County",2,2,170,88,82
050,51,027,"Virginia","Buchanan County",2,3,157,79,78
050,51,027,"Virginia","Buchanan County",2,4,155,72,83
050,51,027,"Virginia","Buchanan County",2,5,167,88,79
050,51,027,"Virginia","Buchanan County",2,6,175,91,84
050,51,027,"Virginia","Buchanan County",2,7,193,100,93
050,51,027,"Virginia","Buchanan County",2,8,188,97,91
050,51,027,"Virginia","Buchanan County",2,9,197,101,96
050,51,027,"Virginia","Buchanan County",2,10,198,101,97
050,51,027,"Virginia","Buchanan County",2,11,219,113,106
050,51,027,"Virginia","Buchanan County",2,12,217,117,100
050,51,027,"Virginia","Buchanan County",2,13,215,113,102
050,51,027,"Virginia","Buchanan County",2,14,231,120,111
050,51,027,"Virginia","Buchanan County",2,15,226,116,110
050,51,027,"Virginia","Buchanan County",2,16,219,109,110
050,51,027,"Virginia","Buchanan County",2,17,226,112,114
050,51,027,"Virginia","Buchanan County",2,18,183,86,97
050,51,027,"Virginia","Buchanan County",2,19,161,78,83
050,51,027,"Virginia","Buchanan County",2,20,169,91,78
050,51,027,"Virginia","Buchanan County",2,21,170,90,80
050,51,027,"Virginia","Buchanan County",2,22,195,101,94
050,51,027,"Virginia","Buchanan County",2,23,218,118,100
050,51,027,"Virginia","Buchanan County",2,24,220,122,98
050,51,027,"Virginia","Buchanan County",2,25,236,145,91
050,51,027,"Virginia","Buchanan County",2,26,238,158,80
050,51,027,"Virginia","Buchanan County",2,27,222,138,84
050,51,027,"Virginia","Buchanan County",2,28,213,122,91
050,51,027,"Virginia","Buchanan County",2,29,237,137,100
050,51,027,"Virginia","Buchanan County",2,30,227,129,98
050,51,027,"Virginia","Buchanan County",2,31,242,144,98
050,51,027,"Virginia","Buchanan County",2,32,244,153,91
050,51,027,"Virginia","Buchanan County",2,33,226,133,93
050,51,027,"Virginia","Buchanan County",2,34,225,129,96
050,51,027,"Virginia","Buchanan County",2,35,210,112,98
050,51,027,"Virginia","Buchanan County",2,36,214,112,102
050,51,027,"Virginia","Buchanan County",2,37,229,123,106
050,51,027,"Virginia","Buchanan County",2,38,242,135,107
050,51,027,"Virginia","Buchanan County",2,39,243,141,102
050,51,027,"Virginia","Buchanan County",2,40,249,139,110
050,51,027,"Virginia","Buchanan County",2,41,242,124,118
050,51,027,"Virginia","Buchanan County",2,42,261,151,110
050,51,027,"Virginia","Buchanan County",2,43,251,142,109
050,51,027,"Virginia","Buchanan County",2,44,233,130,103
050,51,027,"Virginia","Buchanan County",2,45,249,137,112
050,51,027,"Virginia","Buchanan County",2,46,266,148,118
050,51,027,"Virginia","Buchanan County",2,47,268,145,123
050,51,027,"Virginia","Buchanan County",2,48,282,144,138
050,51,027,"Virginia","Buchanan County",2,49,316,165,151
050,51,027,"Virginia","Buchanan County",2,50,291,148,143
050,51,027,"Virginia","Buchanan County",2,51,290,154,136
050,51,027,"Virginia","Buchanan County",2,52,291,157,134
050,51,027,"Virginia","Buchanan County",2,53,304,157,147
050,51,027,"Virginia","Buchanan County",2,54,294,147,147
050,51,027,"Virginia","Buchanan County",2,55,308,157,151
050,51,027,"Virginia","Buchanan County",2,56,317,161,156
050,51,027,"Virginia","Buchanan County",2,57,315,158,157
050,51,027,"Virginia","Buchanan County",2,58,316,159,157
050,51,027,"Virginia","Buchanan County",2,59,322,167,155
050,51,027,"Virginia","Buchanan County",2,60,323,164,159
050,51,027,"Virginia","Buchanan County",2,61,326,167,159
050,51,027,"Virginia","Buchanan County",2,62,347,181,166
050,51,027,"Virginia","Buchanan County",2,63,354,178,176
050,51,027,"Virginia","Buchanan County",2,64,322,158,164
050,51,027,"Virginia","Buchanan County",2,65,308,150,158
050,51,027,"Virginia","Buchanan County",2,66,283,140,143
050,51,027,"Virginia","Buchanan County",2,67,276,133,143
050,51,027,"Virginia","Buchanan County",2,68,291,138,153
050,51,027,"Virginia","Buchanan County",2,69,279,129,150
050,51,027,"Virginia","Buchanan County",2,70,260,125,135
050,51,027,"Virginia","Buchanan County",2,71,267,126,141
050,51,027,"Virginia","Buchanan County",2,72,247,113,134
050,51,027,"Virginia","Buchanan County",2,73,275,124,151
050,51,027,"Virginia","Buchanan County",2,74,209,93,116
050,51,027,"Virginia","Buchanan County",2,75,200,92,108
050,51,027,"Virginia","Buchanan County",2,76,187,95,92
050,51,027,"Virginia","Buchanan County",2,77,195,101,94
050,51,027,"Virginia","Buchanan County",2,78,159,71,88
050,51,027,"Virginia","Buchanan County",2,79,155,64,91
050,51,027,"Virginia","Buchanan County",2,80,141,61,80
050,51,027,"Virginia","Buchanan County",2,81,123,56,67
050,51,027,"Virginia","Buchanan County",2,82,122,49,73
050,51,027,"Virginia","Buchanan County",2,83,115,43,72
050,51,027,"Virginia","Buchanan County",2,84,112,42,70
050,51,027,"Virginia","Buchanan County",2,85,442,169,273
050,51,027,"Virginia","Buchanan County",3,0,146,72,74
050,51,027,"Virginia","Buchanan County",3,1,166,85,81
050,51,027,"Virginia","Buchanan County",3,2,167,86,81
050,51,027,"Virginia","Buchanan County",3,3,169,91,78
050,51,027,"Virginia","Buchanan County",3,4,155,81,74
050,51,027,"Virginia","Buchanan County",3,5,156,73,83
050,51,027,"Virginia","Buchanan County",3,6,175,93,82
050,51,027,"Virginia","Buchanan County",3,7,174,86,88
050,51,027,"Virginia","Buchanan County",3,8,188,97,91
050,51,027,"Virginia","Buchanan County",3,9,183,93,90
050,51,027,"Virginia","Buchanan County",3,10,197,102,95
050,51,027,"Virginia","Buchanan County",3,11,215,110,105
050,51,027,"Virginia","Buchanan County",3,12,210,111,99
050,51,027,"Virginia","Buchanan County",3,13,210,114,96
050,51,027,"Virginia","Buchanan County",3,14,217,115,102
050,51,027,"Virginia","Buchanan County",3,15,231,115,116
050,51,027,"Virginia","Buchanan County",3,16,215,107,108
050,51,027,"Virginia","Buchanan County",3,17,212,109,103
050,51,027,"Virginia","Buchanan County",3,18,184,88,96
050,51,027,"Virginia","Buchanan County",3,19,149,74,75
050,51,027,"Virginia","Buchanan County",3,20,169,86,83
050,51,027,"Virginia","Buchanan County",3,21,177,93,84
050,51,027,"Virginia","Buchanan County",3,22,183,94,89
050,51,027,"Virginia","Buchanan County",3,23,223,127,96
050,51,027,"Virginia","Buchanan County",3,24,212,115,97
050,51,027,"Virginia","Buchanan County",3,25,232,123,109
050,51,027,"Virginia","Buchanan County",3,26,232,143,89
050,51,027,"Virginia","Buchanan County",3,27,223,140,83
050,51,027,"Virginia","Buchanan County",3,28,201,124,77
050,51,027,"Virginia","Buchanan County",3,29,232,142,90
050,51,027,"Virginia","Buchanan County",3,30,212,117,95
050,51,027,"Virginia","Buchanan County",3,31,233,141,92
050,51,027,"Virginia","Buchanan County",3,32,238,142,96
050,51,027,"Virginia","Buchanan County",3,33,228,140,88
050,51,027,"Virginia","Buchanan County",3,34,230,137,93
050,51,027,"Virginia","Buchanan County",3,35,216,118,98
050,51,027,"Virginia","Buchanan County",3,36,203,106,97
050,51,027,"Virginia","Buchanan County",3,37,225,124,101
050,51,027,"Virginia","Buchanan County",3,38,231,127,104
050,51,027,"Virginia","Buchanan County",3,39,237,131,106
050,51,027,"Virginia","Buchanan County",3,40,245,145,100
050,51,027,"Virginia","Buchanan County",3,41,238,128,110
050,51,027,"Virginia","Buchanan County",3,42,264,147,117
050,51,027,"Virginia","Buchanan County",3,43,254,143,111
050,51,027,"Virginia","Buchanan County",3,44,247,137,110
050,51,027,"Virginia","Buchanan County",3,45,244,142,102
050,51,027,"Virginia","Buchanan County",3,46,239,129,110
050,51,027,"Virginia","Buchanan County",3,47,264,150,114
050,51,027,"Virginia","Buchanan County",3,48,245,127,118
050,51,027,"Virginia","Buchanan County",3,49,278,144,134
050,51,027,"Virginia","Buchanan County",3,50,303,156,147
050,51,027,"Virginia","Buchanan County",3,51,294,153,141
050,51,027,"Virginia","Buchanan County",3,52,287,147,140
050,51,027,"Virginia","Buchanan County",3,53,289,157,132
050,51,027,"Virginia","Buchanan County",3,54,303,157,146
050,51,027,"Virginia","Buchanan County",3,55,283,143,140
050,51,027,"Virginia","Buchanan County",3,56,296,149,147
050,51,027,"Virginia","Buchanan County",3,57,309,155,154
050,51,027,"Virginia","Buchanan County",3,58,311,158,153
050,51,027,"Virginia","Buchanan County",3,59,305,153,152
050,51,027,"Virginia","Buchanan County",3,60,309,159,150
050,51,027,"Virginia","Buchanan County",3,61,317,159,158
050,51,027,"Virginia","Buchanan County",3,62,315,158,157
050,51,027,"Virginia","Buchanan County",3,63,338,179,159
050,51,027,"Virginia","Buchanan County",3,64,344,172,172
050,51,027,"Virginia","Buchanan County",3,65,313,150,163
050,51,027,"Virginia","Buchanan County",3,66,312,151,161
050,51,027,"Virginia","Buchanan County",3,67,269,130,139
050,51,027,"Virginia","Buchanan County",3,68,271,126,145
050,51,027,"Virginia","Buchanan County",3,69,282,135,147
050,51,027,"Virginia","Buchanan County",3,70,274,131,143
050,51,027,"Virginia","Buchanan County",3,71,254,120,134
050,51,027,"Virginia","Buchanan County",3,72,250,115,135
050,51,027,"Virginia","Buchanan County",3,73,236,111,125
050,51,027,"Virginia","Buchanan County",3,74,270,123,147
050,51,027,"Virginia","Buchanan County",3,75,192,84,108
050,51,027,"Virginia","Buchanan County",3,76,193,88,105
050,51,027,"Virginia","Buchanan County",3,77,173,87,86
050,51,027,"Virginia","Buchanan County",3,78,180,94,86
050,51,027,"Virginia","Buchanan County",3,79,146,63,83
050,51,027,"Virginia","Buchanan County",3,80,141,56,85
050,51,027,"Virginia","Buchanan County",3,81,128,56,72
050,51,027,"Virginia","Buchanan County",3,82,115,54,61
050,51,027,"Virginia","Buchanan County",3,83,114,45,69
050,51,027,"Virginia","Buchanan County",3,84,106,37,69
050,51,027,"Virginia","Buchanan County",3,85,480,184,296
050,51,027,"Virginia","Buchanan County",4,0,175,89,86
050,51,027,"Virginia","Buchanan County",4,1,143,64,79
050,51,027,"Virginia","Buchanan County",4,2,171,89,82
050,51,027,"Virginia","Buchanan County",4,3,161,82,79
050,51,027,"Virginia","Buchanan County",4,4,165,90,75
050,51,027,"Virginia","Buchanan County",4,5,161,83,78
050,51,027,"Virginia","Buchanan County",4,6,154,72,82
050,51,027,"Virginia","Buchanan County",4,7,167,89,78
050,51,027,"Virginia","Buchanan County",4,8,170,88,82
050,51,027,"Virginia","Buchanan County",4,9,181,93,88
050,51,027,"Virginia","Buchanan County",4,10,182,95,87
050,51,027,"Virginia","Buchanan County",4,11,203,104,99
050,51,027,"Virginia","Buchanan County",4,12,208,109,99
050,51,027,"Virginia","Buchanan County",4,13,204,107,97
050,51,027,"Virginia","Buchanan County",4,14,211,118,93
050,51,027,"Virginia","Buchanan County",4,15,218,108,110
050,51,027,"Virginia","Buchanan County",4,16,234,116,118
050,51,027,"Virginia","Buchanan County",4,17,221,111,110
050,51,027,"Virginia","Buchanan County",4,18,172,88,84
050,51,027,"Virginia","Buchanan County",4,19,143,69,74
050,51,027,"Virginia","Buchanan County",4,20,162,83,79
050,51,027,"Virginia","Buchanan County",4,21,175,87,88
050,51,027,"Virginia","Buchanan County",4,22,189,100,89
050,51,027,"Virginia","Buchanan County",4,23,205,113,92
050,51,027,"Virginia","Buchanan County",4,24,217,123,94
050,51,027,"Virginia","Buchanan County",4,25,228,127,101
050,51,027,"Virginia","Buchanan County",4,26,225,128,97
050,51,027,"Virginia","Buchanan County",4,27,210,126,84
050,51,027,"Virginia","Buchanan County",4,28,216,135,81
050,51,027,"Virginia","Buchanan County",4,29,203,132,71
050,51,027,"Virginia","Buchanan County",4,30,209,120,89
050,51,027,"Virginia","Buchanan County",4,31,225,128,97
050,51,027,"Virginia","Buchanan County",4,32,226,136,90
050,51,027,"Virginia","Buchanan County",4,33,223,131,92
050,51,027,"Virginia","Buchanan County",4,34,231,143,88
050,51,027,"Virginia","Buchanan County",4,35,214,128,86
050,51,027,"Virginia","Buchanan County",4,36,212,116,96
050,51,027,"Virginia","Buchanan County",4,37,211,113,98
050,51,027,"Virginia","Buchanan County",4,38,227,129,98
050,51,027,"Virginia","Buchanan County",4,39,215,117,98
050,51,027,"Virginia","Buchanan County",4,40,233,128,105
050,51,027,"Virginia","Buchanan County",4,41,233,131,102
050,51,027,"Virginia","Buchanan County",4,42,251,146,105
050,51,027,"Virginia","Buchanan County",4,43,245,133,112
050,51,027,"Virginia","Buchanan County",4,44,241,136,105
050,51,027,"Virginia","Buchanan County",4,45,244,137,107
050,51,027,"Virginia","Buchanan County",4,46,240,140,100
050,51,027,"Virginia","Buchanan County",4,47,239,131,108
050,51,027,"Virginia","Buchanan County",4,48,242,129,113
050,51,027,"Virginia","Buchanan County",4,49,246,130,116
050,51,027,"Virginia","Buchanan County",4,50,271,135,136
050,51,027,"Virginia","Buchanan County",4,51,310,165,145
050,51,027,"Virginia","Buchanan County",4,52,292,151,141
050,51,027,"Virginia","Buchanan County",4,53,282,147,135
050,51,027,"Virginia","Buchanan County",4,54,281,151,130
050,51,027,"Virginia","Buchanan County",4,55,296,154,142
050,51,027,"Virginia","Buchanan County",4,56,273,134,139
050,51,027,"Virginia","Buchanan County",4,57,273,133,140
050,51,027,"Virginia","Buchanan County",4,58,300,150,150
050,51,027,"Virginia","Buchanan County",4,59,301,152,149
050,51,027,"Virginia","Buchanan County",4,60,290,145,145
050,51,027,"Virginia","Buchanan County",4,61,307,158,149
050,51,027,"Virginia","Buchanan County",4,62,298,147,151
050,51,027,"Virginia","Buchanan County",4,63,300,151,149
050,51,027,"Virginia","Buchanan County",4,64,328,174,154
050,51,027,"Virginia","Buchanan County",4,65,332,166,166
050,51,027,"Virginia","Buchanan County",4,66,304,143,161
050,51,027,"Virginia","Buchanan County",4,67,294,136,158
050,51,027,"Virginia","Buchanan County",4,68,250,121,129
050,51,027,"Virginia","Buchanan County",4,69,252,119,133
050,51,027,"Virginia","Buchanan County",4,70,270,133,137
050,51,027,"Virginia","Buchanan County",4,71,259,126,133
050,51,027,"Virginia","Buchanan County",4,72,242,109,133
050,51,027,"Virginia","Buchanan County",4,73,242,112,130
050,51,027,"Virginia","Buchanan County",4,74,229,109,120
050,51,027,"Virginia","Buchanan County",4,75,245,112,133
050,51,027,"Virginia","Buchanan County",4,76,180,80,100
050,51,027,"Virginia","Buchanan County",4,77,179,78,101
050,51,027,"Virginia","Buchanan County",4,78,156,78,78
050,51,027,"Virginia","Buchanan County",4,79,169,88,81
050,51,027,"Virginia","Buchanan County",4,80,132,53,79
050,51,027,"Virginia","Buchanan County",4,81,131,54,77
050,51,027,"Virginia","Buchanan County",4,82,117,49,68
050,51,027,"Virginia","Buchanan County",4,83,109,48,61
050,51,027,"Virginia","Buchanan County",4,84,103,41,62
050,51,027,"Virginia","Buchanan County",4,85,505,188,317
050,51,027,"Virginia","Buchanan County",5,0,173,90,83
050,51,027,"Virginia","Buchanan County",5,1,177,90,87
050,51,027,"Virginia","Buchanan County",5,2,144,66,78
050,51,027,"Virginia","Buchanan County",5,3,171,89,82
050,51,027,"Virginia","Buchanan County",5,4,165,84,81
050,51,027,"Virginia","Buchanan County",5,5,169,93,76
050,51,027,"Virginia","Buchanan County",5,6,160,82,78
050,51,027,"Virginia","Buchanan County",5,7,156,71,85
050,51,027,"Virginia","Buchanan County",5,8,161,87,74
050,51,027,"Virginia","Buchanan County",5,9,175,89,86
050,51,027,"Virginia","Buchanan County",5,10,187,95,92
050,51,027,"Virginia","Buchanan County",5,11,192,100,92
050,51,027,"Virginia","Buchanan County",5,12,200,108,92
050,51,027,"Virginia","Buchanan County",5,13,200,104,96
050,51,027,"Virginia","Buchanan County",5,14,204,113,91
050,51,027,"Virginia","Buchanan County",5,15,200,106,94
050,51,027,"Virginia","Buchanan County",5,16,214,104,110
050,51,027,"Virginia","Buchanan County",5,17,233,116,117
050,51,027,"Virginia","Buchanan County",5,18,168,83,85
050,51,027,"Virginia","Buchanan County",5,19,141,75,66
050,51,027,"Virginia","Buchanan County",5,20,163,88,75
050,51,027,"Virginia","Buchanan County",5,21,163,81,82
050,51,027,"Virginia","Buchanan County",5,22,177,93,84
050,51,027,"Virginia","Buchanan County",5,23,211,117,94
050,51,027,"Virginia","Buchanan County",5,24,220,131,89
050,51,027,"Virginia","Buchanan County",5,25,216,128,88
050,51,027,"Virginia","Buchanan County",5,26,227,132,95
050,51,027,"Virginia","Buchanan County",5,27,211,120,91
050,51,027,"Virginia","Buchanan County",5,28,201,121,80
050,51,027,"Virginia","Buchanan County",5,29,240,155,85
050,51,027,"Virginia","Buchanan County",5,30,192,115,77
050,51,027,"Virginia","Buchanan County",5,31,227,139,88
050,51,027,"Virginia","Buchanan County",5,32,229,125,104
050,51,027,"Virginia","Buchanan County",5,33,211,121,90
050,51,027,"Virginia","Buchanan County",5,34,229,137,92
050,51,027,"Virginia","Buchanan County",5,35,212,127,85
050,51,027,"Virginia","Buchanan County",5,36,202,116,86
050,51,027,"Virginia","Buchanan County",5,37,214,117,97
050,51,027,"Virginia","Buchanan County",5,38,219,123,96
050,51,027,"Virginia","Buchanan County",5,39,226,127,99
050,51,027,"Virginia","Buchanan County",5,40,218,118,100
050,51,027,"Virginia","Buchanan County",5,41,225,113,112
050,51,027,"Virginia","Buchanan County",5,42,254,152,102
050,51,027,"Virginia","Buchanan County",5,43,240,137,103
050,51,027,"Virginia","Buchanan County",5,44,240,126,114
050,51,027,"Virginia","Buchanan County",5,45,252,144,108
050,51,027,"Virginia","Buchanan County",5,46,245,138,107
050,51,027,"Virginia","Buchanan County",5,47,229,135,94
050,51,027,"Virginia","Buchanan County",5,48,230,116,114
050,51,027,"Virginia","Buchanan County",5,49,238,126,112
050,51,027,"Virginia","Buchanan County",5,50,231,121,110
050,51,027,"Virginia","Buchanan County",5,51,273,137,136
050,51,027,"Virginia","Buchanan County",5,52,308,159,149
050,51,027,"Virginia","Buchanan County",5,53,286,148,138
050,51,027,"Virginia","Buchanan County",5,54,276,145,131
050,51,027,"Virginia","Buchanan County",5,55,282,154,128
050,51,027,"Virginia","Buchanan County",5,56,295,150,145
050,51,027,"Virginia","Buchanan County",5,57,258,123,135
050,51,027,"Virginia","Buchanan County",5,58,273,134,139
050,51,027,"Virginia","Buchanan County",5,59,284,140,144
050,51,027,"Virginia","Buchanan County",5,60,288,142,146
050,51,027,"Virginia","Buchanan County",5,61,288,145,143
050,51,027,"Virginia","Buchanan County",5,62,296,151,145
050,51,027,"Virginia","Buchanan County",5,63,293,143,150
050,51,027,"Virginia","Buchanan County",5,64,291,145,146
050,51,027,"Virginia","Buchanan County",5,65,316,165,151
050,51,027,"Virginia","Buchanan County",5,66,333,165,168
050,51,027,"Virginia","Buchanan County",5,67,291,133,158
050,51,027,"Virginia","Buchanan County",5,68,275,128,147
050,51,027,"Virginia","Buchanan County",5,69,244,119,125
050,51,027,"Virginia","Buchanan County",5,70,242,119,123
050,51,027,"Virginia","Buchanan County",5,71,259,129,130
050,51,027,"Virginia","Buchanan County",5,72,243,114,129
050,51,027,"Virginia","Buchanan County",5,73,237,109,128
050,51,027,"Virginia","Buchanan County",5,74,233,110,123
050,51,027,"Virginia","Buchanan County",5,75,204,95,109
050,51,027,"Virginia","Buchanan County",5,76,233,107,126
050,51,027,"Virginia","Buchanan County",5,77,162,71,91
050,51,027,"Virginia","Buchanan County",5,78,161,73,88
050,51,027,"Virginia","Buchanan County",5,79,146,72,74
050,51,027,"Virginia","Buchanan County",5,80,160,80,80
050,51,027,"Virginia","Buchanan County",5,81,118,49,69
050,51,027,"Virginia","Buchanan County",5,82,117,46,71
050,51,027,"Virginia","Buchanan County",5,83,109,42,67
050,51,027,"Virginia","Buchanan County",5,84,96,42,54
050,51,027,"Virginia","Buchanan County",5,85,535,196,339
050,51,029,"Virginia","Buckingham County",1,0,143,73,70
050,51,029,"Virginia","Buckingham County",1,1,159,79,80
050,51,029,"Virginia","Buckingham County",1,2,145,76,69
050,51,029,"Virginia","Buckingham County",1,3,159,92,67
050,51,029,"Virginia","Buckingham County",1,4,148,85,63
050,51,029,"Virginia","Buckingham County",1,5,146,79,67
050,51,029,"Virginia","Buckingham County",1,6,174,91,83
050,51,029,"Virginia","Buckingham County",1,7,178,95,83
050,51,029,"Virginia","Buckingham County",1,8,170,84,86
050,51,029,"Virginia","Buckingham County",1,9,181,86,95
050,51,029,"Virginia","Buckingham County",1,10,186,89,97
050,51,029,"Virginia","Buckingham County",1,11,199,95,104
050,51,029,"Virginia","Buckingham County",1,12,218,110,108
050,51,029,"Virginia","Buckingham County",1,13,188,96,92
050,51,029,"Virginia","Buckingham County",1,14,169,89,80
050,51,029,"Virginia","Buckingham County",1,15,162,88,74
050,51,029,"Virginia","Buckingham County",1,16,170,85,85
050,51,029,"Virginia","Buckingham County",1,17,179,106,73
050,51,029,"Virginia","Buckingham County",1,18,161,93,68
050,51,029,"Virginia","Buckingham County",1,19,130,74,56
050,51,029,"Virginia","Buckingham County",1,20,160,98,62
050,51,029,"Virginia","Buckingham County",1,21,162,95,67
050,51,029,"Virginia","Buckingham County",1,22,155,92,63
050,51,029,"Virginia","Buckingham County",1,23,203,124,79
050,51,029,"Virginia","Buckingham County",1,24,195,122,73
050,51,029,"Virginia","Buckingham County",1,25,215,142,73
050,51,029,"Virginia","Buckingham County",1,26,204,128,76
050,51,029,"Virginia","Buckingham County",1,27,234,150,84
050,51,029,"Virginia","Buckingham County",1,28,224,146,78
050,51,029,"Virginia","Buckingham County",1,29,241,151,90
050,51,029,"Virginia","Buckingham County",1,30,240,149,91
050,51,029,"Virginia","Buckingham County",1,31,240,149,91
050,51,029,"Virginia","Buckingham County",1,32,231,139,92
050,51,029,"Virginia","Buckingham County",1,33,236,144,92
050,51,029,"Virginia","Buckingham County",1,34,248,152,96
050,51,029,"Virginia","Buckingham County",1,35,238,161,77
050,51,029,"Virginia","Buckingham County",1,36,217,129,88
050,51,029,"Virginia","Buckingham County",1,37,218,142,76
050,51,029,"Virginia","Buckingham County",1,38,199,119,80
050,51,029,"Virginia","Buckingham County",1,39,226,137,89
050,51,029,"Virginia","Buckingham County",1,40,225,138,87
050,51,029,"Virginia","Buckingham County",1,41,229,156,73
050,51,029,"Virginia","Buckingham County",1,42,219,143,76
050,51,029,"Virginia","Buckingham County",1,43,210,124,86
050,51,029,"Virginia","Buckingham County",1,44,235,156,79
050,51,029,"Virginia","Buckingham County",1,45,211,137,74
050,51,029,"Virginia","Buckingham County",1,46,213,125,88
050,51,029,"Virginia","Buckingham County",1,47,216,124,92
050,51,029,"Virginia","Buckingham County",1,48,222,129,93
050,51,029,"Virginia","Buckingham County",1,49,232,148,84
050,51,029,"Virginia","Buckingham County",1,50,244,154,90
050,51,029,"Virginia","Buckingham County",1,51,246,142,104
050,51,029,"Virginia","Buckingham County",1,52,220,132,88
050,51,029,"Virginia","Buckingham County",1,53,235,141,94
050,51,029,"Virginia","Buckingham County",1,54,255,135,120
050,51,029,"Virginia","Buckingham County",1,55,250,123,127
050,51,029,"Virginia","Buckingham County",1,56,247,131,116
050,51,029,"Virginia","Buckingham County",1,57,236,130,106
050,51,029,"Virginia","Buckingham County",1,58,258,139,119
050,51,029,"Virginia","Buckingham County",1,59,252,119,133
050,51,029,"Virginia","Buckingham County",1,60,256,148,108
050,51,029,"Virginia","Buckingham County",1,61,248,132,116
050,51,029,"Virginia","Buckingham County",1,62,244,121,123
050,51,029,"Virginia","Buckingham County",1,63,250,122,128
050,51,029,"Virginia","Buckingham County",1,64,224,112,112
050,51,029,"Virginia","Buckingham County",1,65,234,119,115
050,51,029,"Virginia","Buckingham County",1,66,207,95,112
050,51,029,"Virginia","Buckingham County",1,67,221,103,118
050,51,029,"Virginia","Buckingham County",1,68,205,103,102
050,51,029,"Virginia","Buckingham County",1,69,215,102,113
050,51,029,"Virginia","Buckingham County",1,70,223,108,115
050,51,029,"Virginia","Buckingham County",1,71,196,95,101
050,51,029,"Virginia","Buckingham County",1,72,196,98,98
050,51,029,"Virginia","Buckingham County",1,73,204,96,108
050,51,029,"Virginia","Buckingham County",1,74,131,61,70
050,51,029,"Virginia","Buckingham County",1,75,127,59,68
050,51,029,"Virginia","Buckingham County",1,76,125,66,59
050,51,029,"Virginia","Buckingham County",1,77,125,55,70
050,51,029,"Virginia","Buckingham County",1,78,100,51,49
050,51,029,"Virginia","Buckingham County",1,79,99,50,49
050,51,029,"Virginia","Buckingham County",1,80,95,39,56
050,51,029,"Virginia","Buckingham County",1,81,90,40,50
050,51,029,"Virginia","Buckingham County",1,82,76,29,47
050,51,029,"Virginia","Buckingham County",1,83,64,23,41
050,51,029,"Virginia","Buckingham County",1,84,63,29,34
050,51,029,"Virginia","Buckingham County",1,85,307,109,198
050,51,029,"Virginia","Buckingham County",2,0,136,66,70
050,51,029,"Virginia","Buckingham County",2,1,154,76,78
050,51,029,"Virginia","Buckingham County",2,2,152,79,73
050,51,029,"Virginia","Buckingham County",2,3,156,88,68
050,51,029,"Virginia","Buckingham County",2,4,150,87,63
050,51,029,"Virginia","Buckingham County",2,5,147,81,66
050,51,029,"Virginia","Buckingham County",2,6,167,88,79
050,51,029,"Virginia","Buckingham County",2,7,177,94,83
050,51,029,"Virginia","Buckingham County",2,8,172,86,86
050,51,029,"Virginia","Buckingham County",2,9,181,86,95
050,51,029,"Virginia","Buckingham County",2,10,185,89,96
050,51,029,"Virginia","Buckingham County",2,11,195,94,101
050,51,029,"Virginia","Buckingham County",2,12,211,106,105
050,51,029,"Virginia","Buckingham County",2,13,194,99,95
050,51,029,"Virginia","Buckingham County",2,14,174,90,84
050,51,029,"Virginia","Buckingham County",2,15,163,88,75
050,51,029,"Virginia","Buckingham County",2,16,167,85,82
050,51,029,"Virginia","Buckingham County",2,17,178,101,77
050,51,029,"Virginia","Buckingham County",2,18,156,91,65
050,51,029,"Virginia","Buckingham County",2,19,134,78,56
050,51,029,"Virginia","Buckingham County",2,20,163,100,63
050,51,029,"Virginia","Buckingham County",2,21,162,97,65
050,51,029,"Virginia","Buckingham County",2,22,159,94,65
050,51,029,"Virginia","Buckingham County",2,23,195,119,76
050,51,029,"Virginia","Buckingham County",2,24,198,125,73
050,51,029,"Virginia","Buckingham County",2,25,213,140,73
050,51,029,"Virginia","Buckingham County",2,26,205,130,75
050,51,029,"Virginia","Buckingham County",2,27,227,145,82
050,51,029,"Virginia","Buckingham County",2,28,229,149,80
050,51,029,"Virginia","Buckingham County",2,29,239,149,90
050,51,029,"Virginia","Buckingham County",2,30,247,155,92
050,51,029,"Virginia","Buckingham County",2,31,239,147,92
050,51,029,"Virginia","Buckingham County",2,32,236,142,94
050,51,029,"Virginia","Buckingham County",2,33,238,144,94
050,51,029,"Virginia","Buckingham County",2,34,245,151,94
050,51,029,"Virginia","Buckingham County",2,35,243,160,83
050,51,029,"Virginia","Buckingham County",2,36,217,133,84
050,51,029,"Virginia","Buckingham County",2,37,222,142,80
050,51,029,"Virginia","Buckingham County",2,38,200,121,79
050,51,029,"Virginia","Buckingham County",2,39,223,136,87
050,51,029,"Virginia","Buckingham County",2,40,229,141,88
050,51,029,"Virginia","Buckingham County",2,41,231,155,76
050,51,029,"Virginia","Buckingham County",2,42,223,148,75
050,51,029,"Virginia","Buckingham County",2,43,207,123,84
050,51,029,"Virginia","Buckingham County",2,44,234,154,80
050,51,029,"Virginia","Buckingham County",2,45,211,136,75
050,51,029,"Virginia","Buckingham County",2,46,213,128,85
050,51,029,"Virginia","Buckingham County",2,47,215,125,90
050,51,029,"Virginia","Buckingham County",2,48,219,127,92
050,51,029,"Virginia","Buckingham County",2,49,234,148,86
050,51,029,"Virginia","Buckingham County",2,50,240,151,89
050,51,029,"Virginia","Buckingham County",2,51,241,142,99
050,51,029,"Virginia","Buckingham County",2,52,225,133,92
050,51,029,"Virginia","Buckingham County",2,53,233,140,93
050,51,029,"Virginia","Buckingham County",2,54,249,135,114
050,51,029,"Virginia","Buckingham County",2,55,251,124,127
050,51,029,"Virginia","Buckingham County",2,56,248,130,118
050,51,029,"Virginia","Buckingham County",2,57,234,127,107
050,51,029,"Virginia","Buckingham County",2,58,253,136,117
050,51,029,"Virginia","Buckingham County",2,59,251,121,130
050,51,029,"Virginia","Buckingham County",2,60,257,142,115
050,51,029,"Virginia","Buckingham County",2,61,247,134,113
050,51,029,"Virginia","Buckingham County",2,62,243,120,123
050,51,029,"Virginia","Buckingham County",2,63,250,123,127
050,51,029,"Virginia","Buckingham County",2,64,227,111,116
050,51,029,"Virginia","Buckingham County",2,65,229,118,111
050,51,029,"Virginia","Buckingham County",2,66,212,100,112
050,51,029,"Virginia","Buckingham County",2,67,221,103,118
050,51,029,"Virginia","Buckingham County",2,68,205,102,103
050,51,029,"Virginia","Buckingham County",2,69,214,103,111
050,51,029,"Virginia","Buckingham County",2,70,219,106,113
050,51,029,"Virginia","Buckingham County",2,71,200,95,105
050,51,029,"Virginia","Buckingham County",2,72,192,97,95
050,51,029,"Virginia","Buckingham County",2,73,209,98,111
050,51,029,"Virginia","Buckingham County",2,74,139,65,74
050,51,029,"Virginia","Buckingham County",2,75,128,60,68
050,51,029,"Virginia","Buckingham County",2,76,124,63,61
050,51,029,"Virginia","Buckingham County",2,77,128,58,70
050,51,029,"Virginia","Buckingham County",2,78,99,48,51
050,51,029,"Virginia","Buckingham County",2,79,98,49,49
050,51,029,"Virginia","Buckingham County",2,80,92,39,53
050,51,029,"Virginia","Buckingham County",2,81,91,40,51
050,51,029,"Virginia","Buckingham County",2,82,77,30,47
050,51,029,"Virginia","Buckingham County",2,83,66,24,42
050,51,029,"Virginia","Buckingham County",2,84,63,28,35
050,51,029,"Virginia","Buckingham County",2,85,308,111,197
050,51,029,"Virginia","Buckingham County",3,0,136,69,67
050,51,029,"Virginia","Buckingham County",3,1,134,69,65
050,51,029,"Virginia","Buckingham County",3,2,156,83,73
050,51,029,"Virginia","Buckingham County",3,3,157,81,76
050,51,029,"Virginia","Buckingham County",3,4,155,90,65
050,51,029,"Virginia","Buckingham County",3,5,160,89,71
050,51,029,"Virginia","Buckingham County",3,6,139,77,62
050,51,029,"Virginia","Buckingham County",3,7,169,89,80
050,51,029,"Virginia","Buckingham County",3,8,175,91,84
050,51,029,"Virginia","Buckingham County",3,9,174,89,85
050,51,029,"Virginia","Buckingham County",3,10,180,87,93
050,51,029,"Virginia","Buckingham County",3,11,189,91,98
050,51,029,"Virginia","Buckingham County",3,12,188,90,98
050,51,029,"Virginia","Buckingham County",3,13,226,117,109
050,51,029,"Virginia","Buckingham County",3,14,197,100,97
050,51,029,"Virginia","Buckingham County",3,15,168,80,88
050,51,029,"Virginia","Buckingham County",3,16,163,88,75
050,51,029,"Virginia","Buckingham County",3,17,173,86,87
050,51,029,"Virginia","Buckingham County",3,18,148,87,61
050,51,029,"Virginia","Buckingham County",3,19,139,84,55
050,51,029,"Virginia","Buckingham County",3,20,165,106,59
050,51,029,"Virginia","Buckingham County",3,21,174,107,67
050,51,029,"Virginia","Buckingham County",3,22,168,100,68
050,51,029,"Virginia","Buckingham County",3,23,180,115,65
050,51,029,"Virginia","Buckingham County",3,24,196,122,74
050,51,029,"Virginia","Buckingham County",3,25,199,130,69
050,51,029,"Virginia","Buckingham County",3,26,204,125,79
050,51,029,"Virginia","Buckingham County",3,27,206,133,73
050,51,029,"Virginia","Buckingham County",3,28,241,154,87
050,51,029,"Virginia","Buckingham County",3,29,240,159,81
050,51,029,"Virginia","Buckingham County",3,30,250,161,89
050,51,029,"Virginia","Buckingham County",3,31,234,145,89
050,51,029,"Virginia","Buckingham County",3,32,235,146,89
050,51,029,"Virginia","Buckingham County",3,33,252,155,97
050,51,029,"Virginia","Buckingham County",3,34,242,149,93
050,51,029,"Virginia","Buckingham County",3,35,250,153,97
050,51,029,"Virginia","Buckingham County",3,36,230,147,83
050,51,029,"Virginia","Buckingham County",3,37,236,149,87
050,51,029,"Virginia","Buckingham County",3,38,219,136,83
050,51,029,"Virginia","Buckingham County",3,39,205,131,74
050,51,029,"Virginia","Buckingham County",3,40,234,145,89
050,51,029,"Virginia","Buckingham County",3,41,240,152,88
050,51,029,"Virginia","Buckingham County",3,42,236,163,73
050,51,029,"Virginia","Buckingham County",3,43,195,121,74
050,51,029,"Virginia","Buckingham County",3,44,253,160,93
050,51,029,"Virginia","Buckingham County",3,45,217,138,79
050,51,029,"Virginia","Buckingham County",3,46,219,140,79
050,51,029,"Virginia","Buckingham County",3,47,219,135,84
050,51,029,"Virginia","Buckingham County",3,48,219,126,93
050,51,029,"Virginia","Buckingham County",3,49,237,143,94
050,51,029,"Virginia","Buckingham County",3,50,225,137,88
050,51,029,"Virginia","Buckingham County",3,51,235,145,90
050,51,029,"Virginia","Buckingham County",3,52,235,138,97
050,51,029,"Virginia","Buckingham County",3,53,239,144,95
050,51,029,"Virginia","Buckingham County",3,54,235,141,94
050,51,029,"Virginia","Buckingham County",3,55,230,120,110
050,51,029,"Virginia","Buckingham County",3,56,266,136,130
050,51,029,"Virginia","Buckingham County",3,57,258,138,120
050,51,029,"Virginia","Buckingham County",3,58,235,128,107
050,51,029,"Virginia","Buckingham County",3,59,249,130,119
050,51,029,"Virginia","Buckingham County",3,60,257,127,130
050,51,029,"Virginia","Buckingham County",3,61,249,134,115
050,51,029,"Virginia","Buckingham County",3,62,238,125,113
050,51,029,"Virginia","Buckingham County",3,63,244,123,121
050,51,029,"Virginia","Buckingham County",3,64,238,112,126
050,51,029,"Virginia","Buckingham County",3,65,223,116,107
050,51,029,"Virginia","Buckingham County",3,66,226,112,114
050,51,029,"Virginia","Buckingham County",3,67,220,105,115
050,51,029,"Virginia","Buckingham County",3,68,210,99,111
050,51,029,"Virginia","Buckingham County",3,69,207,104,103
050,51,029,"Virginia","Buckingham County",3,70,206,98,108
050,51,029,"Virginia","Buckingham County",3,71,204,93,111
050,51,029,"Virginia","Buckingham County",3,72,203,96,107
050,51,029,"Virginia","Buckingham County",3,73,190,97,93
050,51,029,"Virginia","Buckingham County",3,74,199,96,103
050,51,029,"Virginia","Buckingham County",3,75,131,63,68
050,51,029,"Virginia","Buckingham County",3,76,123,58,65
050,51,029,"Virginia","Buckingham County",3,77,118,60,58
050,51,029,"Virginia","Buckingham County",3,78,120,54,66
050,51,029,"Virginia","Buckingham County",3,79,94,44,50
050,51,029,"Virginia","Buckingham County",3,80,91,42,49
050,51,029,"Virginia","Buckingham County",3,81,91,39,52
050,51,029,"Virginia","Buckingham County",3,82,87,39,48
050,51,029,"Virginia","Buckingham County",3,83,73,29,44
050,51,029,"Virginia","Buckingham County",3,84,63,24,39
050,51,029,"Virginia","Buckingham County",3,85,317,117,200
050,51,029,"Virginia","Buckingham County",4,0,132,58,74
050,51,029,"Virginia","Buckingham County",4,1,151,78,73
050,51,029,"Virginia","Buckingham County",4,2,139,67,72
050,51,029,"Virginia","Buckingham County",4,3,157,84,73
050,51,029,"Virginia","Buckingham County",4,4,162,82,80
050,51,029,"Virginia","Buckingham County",4,5,149,81,68
050,51,029,"Virginia","Buckingham County",4,6,164,92,72
050,51,029,"Virginia","Buckingham County",4,7,153,82,71
050,51,029,"Virginia","Buckingham County",4,8,165,84,81
050,51,029,"Virginia","Buckingham County",4,9,166,91,75
050,51,029,"Virginia","Buckingham County",4,10,176,89,87
050,51,029,"Virginia","Buckingham County",4,11,170,83,87
050,51,029,"Virginia","Buckingham County",4,12,191,90,101
050,51,029,"Virginia","Buckingham County",4,13,181,88,93
050,51,029,"Virginia","Buckingham County",4,14,226,120,106
050,51,029,"Virginia","Buckingham County",4,15,195,98,97
050,51,029,"Virginia","Buckingham County",4,16,173,85,88
050,51,029,"Virginia","Buckingham County",4,17,168,90,78
050,51,029,"Virginia","Buckingham County",4,18,132,69,63
050,51,029,"Virginia","Buckingham County",4,19,134,86,48
050,51,029,"Virginia","Buckingham County",4,20,170,108,62
050,51,029,"Virginia","Buckingham County",4,21,159,102,57
050,51,029,"Virginia","Buckingham County",4,22,179,102,77
050,51,029,"Virginia","Buckingham County",4,23,187,117,70
050,51,029,"Virginia","Buckingham County",4,24,191,128,63
050,51,029,"Virginia","Buckingham County",4,25,209,137,72
050,51,029,"Virginia","Buckingham County",4,26,188,116,72
050,51,029,"Virginia","Buckingham County",4,27,210,129,81
050,51,029,"Virginia","Buckingham County",4,28,214,142,72
050,51,029,"Virginia","Buckingham County",4,29,239,158,81
050,51,029,"Virginia","Buckingham County",4,30,242,161,81
050,51,029,"Virginia","Buckingham County",4,31,246,149,97
050,51,029,"Virginia","Buckingham County",4,32,243,150,93
050,51,029,"Virginia","Buckingham County",4,33,254,158,96
050,51,029,"Virginia","Buckingham County",4,34,252,156,96
050,51,029,"Virginia","Buckingham County",4,35,250,145,105
050,51,029,"Virginia","Buckingham County",4,36,232,141,91
050,51,029,"Virginia","Buckingham County",4,37,245,158,87
050,51,029,"Virginia","Buckingham County",4,38,243,144,99
050,51,029,"Virginia","Buckingham County",4,39,223,142,81
050,51,029,"Virginia","Buckingham County",4,40,214,141,73
050,51,029,"Virginia","Buckingham County",4,41,244,157,87
050,51,029,"Virginia","Buckingham County",4,42,250,165,85
050,51,029,"Virginia","Buckingham County",4,43,215,139,76
050,51,029,"Virginia","Buckingham County",4,44,216,139,77
050,51,029,"Virginia","Buckingham County",4,45,224,135,89
050,51,029,"Virginia","Buckingham County",4,46,211,135,76
050,51,029,"Virginia","Buckingham County",4,47,217,137,80
050,51,029,"Virginia","Buckingham County",4,48,210,129,81
050,51,029,"Virginia","Buckingham County",4,49,235,141,94
050,51,029,"Virginia","Buckingham County",4,50,227,127,100
050,51,029,"Virginia","Buckingham County",4,51,215,124,91
050,51,029,"Virginia","Buckingham County",4,52,238,150,88
050,51,029,"Virginia","Buckingham County",4,53,245,147,98
050,51,029,"Virginia","Buckingham County",4,54,238,140,98
050,51,029,"Virginia","Buckingham County",4,55,223,126,97
050,51,029,"Virginia","Buckingham County",4,56,237,127,110
050,51,029,"Virginia","Buckingham County",4,57,266,136,130
050,51,029,"Virginia","Buckingham County",4,58,265,139,126
050,51,029,"Virginia","Buckingham County",4,59,230,117,113
050,51,029,"Virginia","Buckingham County",4,60,247,134,113
050,51,029,"Virginia","Buckingham County",4,61,251,121,130
050,51,029,"Virginia","Buckingham County",4,62,250,130,120
050,51,029,"Virginia","Buckingham County",4,63,240,126,114
050,51,029,"Virginia","Buckingham County",4,64,236,112,124
050,51,029,"Virginia","Buckingham County",4,65,236,117,119
050,51,029,"Virginia","Buckingham County",4,66,224,120,104
050,51,029,"Virginia","Buckingham County",4,67,226,112,114
050,51,029,"Virginia","Buckingham County",4,68,211,104,107
050,51,029,"Virginia","Buckingham County",4,69,217,102,115
050,51,029,"Virginia","Buckingham County",4,70,191,96,95
050,51,029,"Virginia","Buckingham County",4,71,195,86,109
050,51,029,"Virginia","Buckingham County",4,72,205,94,111
050,51,029,"Virginia","Buckingham County",4,73,198,93,105
050,51,029,"Virginia","Buckingham County",4,74,183,93,90
050,51,029,"Virginia","Buckingham County",4,75,193,97,96
050,51,029,"Virginia","Buckingham County",4,76,129,58,71
050,51,029,"Virginia","Buckingham County",4,77,115,54,61
050,51,029,"Virginia","Buckingham County",4,78,108,55,53
050,51,029,"Virginia","Buckingham County",4,79,116,51,65
050,51,029,"Virginia","Buckingham County",4,80,84,38,46
050,51,029,"Virginia","Buckingham County",4,81,83,38,45
050,51,029,"Virginia","Buckingham County",4,82,81,36,45
050,51,029,"Virginia","Buckingham County",4,83,82,36,46
050,51,029,"Virginia","Buckingham County",4,84,73,31,42
050,51,029,"Virginia","Buckingham County",4,85,334,124,210
050,51,029,"Virginia","Buckingham County",5,0,133,59,74
050,51,029,"Virginia","Buckingham County",5,1,122,53,69
050,51,029,"Virginia","Buckingham County",5,2,148,74,74
050,51,029,"Virginia","Buckingham County",5,3,138,68,70
050,51,029,"Virginia","Buckingham County",5,4,158,87,71
050,51,029,"Virginia","Buckingham County",5,5,159,81,78
050,51,029,"Virginia","Buckingham County",5,6,154,86,68
050,51,029,"Virginia","Buckingham County",5,7,164,93,71
050,51,029,"Virginia","Buckingham County",5,8,159,82,77
050,51,029,"Virginia","Buckingham County",5,9,165,81,84
050,51,029,"Virginia","Buckingham County",5,10,165,92,73
050,51,029,"Virginia","Buckingham County",5,11,174,90,84
050,51,029,"Virginia","Buckingham County",5,12,172,85,87
050,51,029,"Virginia","Buckingham County",5,13,193,92,101
050,51,029,"Virginia","Buckingham County",5,14,195,99,96
050,51,029,"Virginia","Buckingham County",5,15,218,117,101
050,51,029,"Virginia","Buckingham County",5,16,192,98,94
050,51,029,"Virginia","Buckingham County",5,17,172,81,91
050,51,029,"Virginia","Buckingham County",5,18,144,76,68
050,51,029,"Virginia","Buckingham County",5,19,116,64,52
050,51,029,"Virginia","Buckingham County",5,20,161,108,53
050,51,029,"Virginia","Buckingham County",5,21,179,109,70
050,51,029,"Virginia","Buckingham County",5,22,167,103,64
050,51,029,"Virginia","Buckingham County",5,23,197,122,75
050,51,029,"Virginia","Buckingham County",5,24,197,125,72
050,51,029,"Virginia","Buckingham County",5,25,194,135,59
050,51,029,"Virginia","Buckingham County",5,26,201,124,77
050,51,029,"Virginia","Buckingham County",5,27,190,113,77
050,51,029,"Virginia","Buckingham County",5,28,207,132,75
050,51,029,"Virginia","Buckingham County",5,29,227,148,79
050,51,029,"Virginia","Buckingham County",5,30,253,170,83
050,51,029,"Virginia","Buckingham County",5,31,240,156,84
050,51,029,"Virginia","Buckingham County",5,32,253,154,99
050,51,029,"Virginia","Buckingham County",5,33,238,152,86
050,51,029,"Virginia","Buckingham County",5,34,258,166,92
050,51,029,"Virginia","Buckingham County",5,35,256,155,101
050,51,029,"Virginia","Buckingham County",5,36,247,142,105
050,51,029,"Virginia","Buckingham County",5,37,239,147,92
050,51,029,"Virginia","Buckingham County",5,38,245,147,98
050,51,029,"Virginia","Buckingham County",5,39,256,157,99
050,51,029,"Virginia","Buckingham County",5,40,224,143,81
050,51,029,"Virginia","Buckingham County",5,41,218,148,70
050,51,029,"Virginia","Buckingham County",5,42,257,170,87
050,51,029,"Virginia","Buckingham County",5,43,225,137,88
050,51,029,"Virginia","Buckingham County",5,44,243,161,82
050,51,029,"Virginia","Buckingham County",5,45,197,119,78
050,51,029,"Virginia","Buckingham County",5,46,229,132,97
050,51,029,"Virginia","Buckingham County",5,47,216,137,79
050,51,029,"Virginia","Buckingham County",5,48,204,128,76
050,51,029,"Virginia","Buckingham County",5,49,230,147,83
050,51,029,"Virginia","Buckingham County",5,50,213,123,90
050,51,029,"Virginia","Buckingham County",5,51,222,125,97
050,51,029,"Virginia","Buckingham County",5,52,202,122,80
050,51,029,"Virginia","Buckingham County",5,53,251,159,92
050,51,029,"Virginia","Buckingham County",5,54,242,141,101
050,51,029,"Virginia","Buckingham County",5,55,220,123,97
050,51,029,"Virginia","Buckingham County",5,56,223,129,94
050,51,029,"Virginia","Buckingham County",5,57,228,118,110
050,51,029,"Virginia","Buckingham County",5,58,264,135,129
050,51,029,"Virginia","Buckingham County",5,59,254,128,126
050,51,029,"Virginia","Buckingham County",5,60,234,125,109
050,51,029,"Virginia","Buckingham County",5,61,243,124,119
050,51,029,"Virginia","Buckingham County",5,62,246,115,131
050,51,029,"Virginia","Buckingham County",5,63,249,135,114
050,51,029,"Virginia","Buckingham County",5,64,230,113,117
050,51,029,"Virginia","Buckingham County",5,65,237,118,119
050,51,029,"Virginia","Buckingham County",5,66,232,117,115
050,51,029,"Virginia","Buckingham County",5,67,228,124,104
050,51,029,"Virginia","Buckingham County",5,68,211,105,106
050,51,029,"Virginia","Buckingham County",5,69,217,108,109
050,51,029,"Virginia","Buckingham County",5,70,205,97,108
050,51,029,"Virginia","Buckingham County",5,71,179,87,92
050,51,029,"Virginia","Buckingham County",5,72,193,85,108
050,51,029,"Virginia","Buckingham County",5,73,202,92,110
050,51,029,"Virginia","Buckingham County",5,74,186,85,101
050,51,029,"Virginia","Buckingham County",5,75,179,93,86
050,51,029,"Virginia","Buckingham County",5,76,187,94,93
050,51,029,"Virginia","Buckingham County",5,77,127,58,69
050,51,029,"Virginia","Buckingham County",5,78,105,50,55
050,51,029,"Virginia","Buckingham County",5,79,108,55,53
050,51,029,"Virginia","Buckingham County",5,80,113,49,64
050,51,029,"Virginia","Buckingham County",5,81,76,33,43
050,51,029,"Virginia","Buckingham County",5,82,75,35,40
050,51,029,"Virginia","Buckingham County",5,83,78,34,44
050,51,029,"Virginia","Buckingham County",5,84,77,34,43
050,51,029,"Virginia","Buckingham County",5,85,353,137,216
050,51,031,"Virginia","Campbell County",1,0,558,285,273
050,51,031,"Virginia","Campbell County",1,1,631,317,314
050,51,031,"Virginia","Campbell County",1,2,663,317,346
050,51,031,"Virginia","Campbell County",1,3,622,290,332
050,51,031,"Virginia","Campbell County",1,4,576,295,281
050,51,031,"Virginia","Campbell County",1,5,587,285,302
050,51,031,"Virginia","Campbell County",1,6,587,290,297
050,51,031,"Virginia","Campbell County",1,7,594,315,279
050,51,031,"Virginia","Campbell County",1,8,626,330,296
050,51,031,"Virginia","Campbell County",1,9,632,314,318
050,51,031,"Virginia","Campbell County",1,10,615,301,314
050,51,031,"Virginia","Campbell County",1,11,632,318,314
050,51,031,"Virginia","Campbell County",1,12,648,338,310
050,51,031,"Virginia","Campbell County",1,13,663,323,340
050,51,031,"Virginia","Campbell County",1,14,631,307,324
050,51,031,"Virginia","Campbell County",1,15,616,320,296
050,51,031,"Virginia","Campbell County",1,16,631,321,310
050,51,031,"Virginia","Campbell County",1,17,667,340,327
050,51,031,"Virginia","Campbell County",1,18,575,297,278
050,51,031,"Virginia","Campbell County",1,19,484,261,223
050,51,031,"Virginia","Campbell County",1,20,538,287,251
050,51,031,"Virginia","Campbell County",1,21,579,301,278
050,51,031,"Virginia","Campbell County",1,22,669,354,315
050,51,031,"Virginia","Campbell County",1,23,692,334,358
050,51,031,"Virginia","Campbell County",1,24,709,339,370
050,51,031,"Virginia","Campbell County",1,25,732,360,372
050,51,031,"Virginia","Campbell County",1,26,725,365,360
050,51,031,"Virginia","Campbell County",1,27,736,364,372
050,51,031,"Virginia","Campbell County",1,28,725,368,357
050,51,031,"Virginia","Campbell County",1,29,771,388,383
050,51,031,"Virginia","Campbell County",1,30,776,391,385
050,51,031,"Virginia","Campbell County",1,31,741,379,362
050,51,031,"Virginia","Campbell County",1,32,721,368,353
050,51,031,"Virginia","Campbell County",1,33,679,341,338
050,51,031,"Virginia","Campbell County",1,34,692,359,333
050,51,031,"Virginia","Campbell County",1,35,655,338,317
050,51,031,"Virginia","Campbell County",1,36,610,330,280
050,51,031,"Virginia","Campbell County",1,37,654,354,300
050,51,031,"Virginia","Campbell County",1,38,624,315,309
050,51,031,"Virginia","Campbell County",1,39,632,306,326
050,51,031,"Virginia","Campbell County",1,40,638,322,316
050,51,031,"Virginia","Campbell County",1,41,644,324,320
050,51,031,"Virginia","Campbell County",1,42,587,293,294
050,51,031,"Virginia","Campbell County",1,43,631,315,316
050,51,031,"Virginia","Campbell County",1,44,630,310,320
050,51,031,"Virginia","Campbell County",1,45,652,336,316
050,51,031,"Virginia","Campbell County",1,46,632,311,321
050,51,031,"Virginia","Campbell County",1,47,667,317,350
050,51,031,"Virginia","Campbell County",1,48,713,344,369
050,51,031,"Virginia","Campbell County",1,49,778,397,381
050,51,031,"Virginia","Campbell County",1,50,759,382,377
050,51,031,"Virginia","Campbell County",1,51,745,358,387
050,51,031,"Virginia","Campbell County",1,52,720,350,370
050,51,031,"Virginia","Campbell County",1,53,715,358,357
050,51,031,"Virginia","Campbell County",1,54,739,367,372
050,51,031,"Virginia","Campbell County",1,55,793,397,396
050,51,031,"Virginia","Campbell County",1,56,827,401,426
050,51,031,"Virginia","Campbell County",1,57,837,396,441
050,51,031,"Virginia","Campbell County",1,58,824,376,448
050,51,031,"Virginia","Campbell County",1,59,842,407,435
050,51,031,"Virginia","Campbell County",1,60,816,400,416
050,51,031,"Virginia","Campbell County",1,61,805,385,420
050,51,031,"Virginia","Campbell County",1,62,853,423,430
050,51,031,"Virginia","Campbell County",1,63,805,410,395
050,51,031,"Virginia","Campbell County",1,64,791,395,396
050,51,031,"Virginia","Campbell County",1,65,763,357,406
050,51,031,"Virginia","Campbell County",1,66,709,337,372
050,51,031,"Virginia","Campbell County",1,67,681,321,360
050,51,031,"Virginia","Campbell County",1,68,640,301,339
050,51,031,"Virginia","Campbell County",1,69,615,269,346
050,51,031,"Virginia","Campbell County",1,70,641,296,345
050,51,031,"Virginia","Campbell County",1,71,618,295,323
050,51,031,"Virginia","Campbell County",1,72,661,300,361
050,51,031,"Virginia","Campbell County",1,73,647,278,369
050,51,031,"Virginia","Campbell County",1,74,488,213,275
050,51,031,"Virginia","Campbell County",1,75,498,228,270
050,51,031,"Virginia","Campbell County",1,76,470,210,260
050,51,031,"Virginia","Campbell County",1,77,432,200,232
050,51,031,"Virginia","Campbell County",1,78,366,159,207
050,51,031,"Virginia","Campbell County",1,79,339,158,181
050,51,031,"Virginia","Campbell County",1,80,332,144,188
050,51,031,"Virginia","Campbell County",1,81,293,131,162
050,51,031,"Virginia","Campbell County",1,82,267,112,155
050,51,031,"Virginia","Campbell County",1,83,252,100,152
050,51,031,"Virginia","Campbell County",1,84,238,97,141
050,51,031,"Virginia","Campbell County",1,85,1408,505,903
050,51,031,"Virginia","Campbell County",2,0,525,272,253
050,51,031,"Virginia","Campbell County",2,1,612,308,304
050,51,031,"Virginia","Campbell County",2,2,658,317,341
050,51,031,"Virginia","Campbell County",2,3,631,295,336
050,51,031,"Virginia","Campbell County",2,4,592,295,297
050,51,031,"Virginia","Campbell County",2,5,584,286,298
050,51,031,"Virginia","Campbell County",2,6,587,289,298
050,51,031,"Virginia","Campbell County",2,7,595,312,283
050,51,031,"Virginia","Campbell County",2,8,619,327,292
050,51,031,"Virginia","Campbell County",2,9,633,319,314
050,51,031,"Virginia","Campbell County",2,10,623,307,316
050,51,031,"Virginia","Campbell County",2,11,622,311,311
050,51,031,"Virginia","Campbell County",2,12,647,333,314
050,51,031,"Virginia","Campbell County",2,13,655,326,329
050,51,031,"Virginia","Campbell County",2,14,637,312,325
050,51,031,"Virginia","Campbell County",2,15,621,317,304
050,51,031,"Virginia","Campbell County",2,16,629,323,306
050,51,031,"Virginia","Campbell County",2,17,659,337,322
050,51,031,"Virginia","Campbell County",2,18,570,295,275
050,51,031,"Virginia","Campbell County",2,19,485,259,226
050,51,031,"Virginia","Campbell County",2,20,546,292,254
050,51,031,"Virginia","Campbell County",2,21,579,304,275
050,51,031,"Virginia","Campbell County",2,22,662,347,315
050,51,031,"Virginia","Campbell County",2,23,694,342,352
050,51,031,"Virginia","Campbell County",2,24,700,335,365
050,51,031,"Virginia","Campbell County",2,25,722,353,369
050,51,031,"Virginia","Campbell County",2,26,725,362,363
050,51,031,"Virginia","Campbell County",2,27,729,360,369
050,51,031,"Virginia","Campbell County",2,28,725,364,361
050,51,031,"Virginia","Campbell County",2,29,758,381,377
050,51,031,"Virginia","Campbell County",2,30,773,387,386
050,51,031,"Virginia","Campbell County",2,31,750,382,368
050,51,031,"Virginia","Campbell County",2,32,719,368,351
050,51,031,"Virginia","Campbell County",2,33,686,348,338
050,51,031,"Virginia","Campbell County",2,34,688,353,335
050,51,031,"Virginia","Campbell County",2,35,665,344,321
050,51,031,"Virginia","Campbell County",2,36,618,332,286
050,51,031,"Virginia","Campbell County",2,37,646,351,295
050,51,031,"Virginia","Campbell County",2,38,631,323,308
050,51,031,"Virginia","Campbell County",2,39,627,305,322
050,51,031,"Virginia","Campbell County",2,40,643,321,322
050,51,031,"Virginia","Campbell County",2,41,644,324,320
050,51,031,"Virginia","Campbell County",2,42,595,299,296
050,51,031,"Virginia","Campbell County",2,43,628,312,316
050,51,031,"Virginia","Campbell County",2,44,624,309,315
050,51,031,"Virginia","Campbell County",2,45,651,331,320
050,51,031,"Virginia","Campbell County",2,46,632,316,316
050,51,031,"Virginia","Campbell County",2,47,657,314,343
050,51,031,"Virginia","Campbell County",2,48,700,337,363
050,51,031,"Virginia","Campbell County",2,49,768,388,380
050,51,031,"Virginia","Campbell County",2,50,768,387,381
050,51,031,"Virginia","Campbell County",2,51,743,360,383
050,51,031,"Virginia","Campbell County",2,52,723,352,371
050,51,031,"Virginia","Campbell County",2,53,712,355,357
050,51,031,"Virginia","Campbell County",2,54,729,363,366
050,51,031,"Virginia","Campbell County",2,55,778,390,388
050,51,031,"Virginia","Campbell County",2,56,821,402,419
050,51,031,"Virginia","Campbell County",2,57,831,395,436
050,51,031,"Virginia","Campbell County",2,58,827,378,449
050,51,031,"Virginia","Campbell County",2,59,842,398,444
050,51,031,"Virginia","Campbell County",2,60,815,399,416
050,51,031,"Virginia","Campbell County",2,61,805,387,418
050,51,031,"Virginia","Campbell County",2,62,841,413,428
050,51,031,"Virginia","Campbell County",2,63,822,416,406
050,51,031,"Virginia","Campbell County",2,64,785,395,390
050,51,031,"Virginia","Campbell County",2,65,766,364,402
050,51,031,"Virginia","Campbell County",2,66,723,341,382
050,51,031,"Virginia","Campbell County",2,67,680,322,358
050,51,031,"Virginia","Campbell County",2,68,643,302,341
050,51,031,"Virginia","Campbell County",2,69,628,278,350
050,51,031,"Virginia","Campbell County",2,70,631,290,341
050,51,031,"Virginia","Campbell County",2,71,621,294,327
050,51,031,"Virginia","Campbell County",2,72,640,294,346
050,51,031,"Virginia","Campbell County",2,73,679,294,385
050,51,031,"Virginia","Campbell County",2,74,490,211,279
050,51,031,"Virginia","Campbell County",2,75,498,225,273
050,51,031,"Virginia","Campbell County",2,76,466,208,258
050,51,031,"Virginia","Campbell County",2,77,451,208,243
050,51,031,"Virginia","Campbell County",2,78,372,163,209
050,51,031,"Virginia","Campbell County",2,79,336,153,183
050,51,031,"Virginia","Campbell County",2,80,335,148,187
050,51,031,"Virginia","Campbell County",2,81,289,129,160
050,51,031,"Virginia","Campbell County",2,82,268,114,154
050,51,031,"Virginia","Campbell County",2,83,255,100,155
050,51,031,"Virginia","Campbell County",2,84,236,96,140
050,51,031,"Virginia","Campbell County",2,85,1421,509,912
050,51,031,"Virginia","Campbell County",3,0,353,175,178
050,51,031,"Virginia","Campbell County",3,1,518,258,260
050,51,031,"Virginia","Campbell County",3,2,613,308,305
050,51,031,"Virginia","Campbell County",3,3,635,305,330
050,51,031,"Virginia","Campbell County",3,4,648,312,336
050,51,031,"Virginia","Campbell County",3,5,610,303,307
050,51,031,"Virginia","Campbell County",3,6,589,290,299
050,51,031,"Virginia","Campbell County",3,7,592,290,302
050,51,031,"Virginia","Campbell County",3,8,602,314,288
050,51,031,"Virginia","Campbell County",3,9,623,333,290
050,51,031,"Virginia","Campbell County",3,10,636,318,318
050,51,031,"Virginia","Campbell County",3,11,632,313,319
050,51,031,"Virginia","Campbell County",3,12,610,303,307
050,51,031,"Virginia","Campbell County",3,13,652,340,312
050,51,031,"Virginia","Campbell County",3,14,655,336,319
050,51,031,"Virginia","Campbell County",3,15,657,326,331
050,51,031,"Virginia","Campbell County",3,16,625,332,293
050,51,031,"Virginia","Campbell County",3,17,640,332,308
050,51,031,"Virginia","Campbell County",3,18,561,294,267
050,51,031,"Virginia","Campbell County",3,19,473,238,235
050,51,031,"Virginia","Campbell County",3,20,524,277,247
050,51,031,"Virginia","Campbell County",3,21,589,299,290
050,51,031,"Virginia","Campbell County",3,22,648,348,300
050,51,031,"Virginia","Campbell County",3,23,676,344,332
050,51,031,"Virginia","Campbell County",3,24,660,330,330
050,51,031,"Virginia","Campbell County",3,25,717,347,370
050,51,031,"Virginia","Campbell County",3,26,713,352,361
050,51,031,"Virginia","Campbell County",3,27,713,347,366
050,51,031,"Virginia","Campbell County",3,28,696,347,349
050,51,031,"Virginia","Campbell County",3,29,728,365,363
050,51,031,"Virginia","Campbell County",3,30,751,369,382
050,51,031,"Virginia","Campbell County",3,31,787,401,386
050,51,031,"Virginia","Campbell County",3,32,754,385,369
050,51,031,"Virginia","Campbell County",3,33,722,375,347
050,51,031,"Virginia","Campbell County",3,34,675,335,340
050,51,031,"Virginia","Campbell County",3,35,675,342,333
050,51,031,"Virginia","Campbell County",3,36,658,332,326
050,51,031,"Virginia","Campbell County",3,37,656,356,300
050,51,031,"Virginia","Campbell County",3,38,653,348,305
050,51,031,"Virginia","Campbell County",3,39,634,320,314
050,51,031,"Virginia","Campbell County",3,40,626,311,315
050,51,031,"Virginia","Campbell County",3,41,641,319,322
050,51,031,"Virginia","Campbell County",3,42,645,316,329
050,51,031,"Virginia","Campbell County",3,43,612,311,301
050,51,031,"Virginia","Campbell County",3,44,635,317,318
050,51,031,"Virginia","Campbell County",3,45,635,322,313
050,51,031,"Virginia","Campbell County",3,46,642,326,316
050,51,031,"Virginia","Campbell County",3,47,616,297,319
050,51,031,"Virginia","Campbell County",3,48,651,314,337
050,51,031,"Virginia","Campbell County",3,49,689,338,351
050,51,031,"Virginia","Campbell County",3,50,769,384,385
050,51,031,"Virginia","Campbell County",3,51,777,383,394
050,51,031,"Virginia","Campbell County",3,52,735,351,384
050,51,031,"Virginia","Campbell County",3,53,716,358,358
050,51,031,"Virginia","Campbell County",3,54,705,341,364
050,51,031,"Virginia","Campbell County",3,55,741,373,368
050,51,031,"Virginia","Campbell County",3,56,773,388,385
050,51,031,"Virginia","Campbell County",3,57,832,412,420
050,51,031,"Virginia","Campbell County",3,58,824,388,436
050,51,031,"Virginia","Campbell County",3,59,839,376,463
050,51,031,"Virginia","Campbell County",3,60,848,409,439
050,51,031,"Virginia","Campbell County",3,61,822,406,416
050,51,031,"Virginia","Campbell County",3,62,796,384,412
050,51,031,"Virginia","Campbell County",3,63,834,407,427
050,51,031,"Virginia","Campbell County",3,64,794,403,391
050,51,031,"Virginia","Campbell County",3,65,778,394,384
050,51,031,"Virginia","Campbell County",3,66,751,351,400
050,51,031,"Virginia","Campbell County",3,67,711,333,378
050,51,031,"Virginia","Campbell County",3,68,658,311,347
050,51,031,"Virginia","Campbell County",3,69,629,290,339
050,51,031,"Virginia","Campbell County",3,70,607,267,340
050,51,031,"Virginia","Campbell County",3,71,598,274,324
050,51,031,"Virginia","Campbell County",3,72,615,294,321
050,51,031,"Virginia","Campbell County",3,73,618,277,341
050,51,031,"Virginia","Campbell County",3,74,658,281,377
050,51,031,"Virginia","Campbell County",3,75,466,198,268
050,51,031,"Virginia","Campbell County",3,76,467,208,259
050,51,031,"Virginia","Campbell County",3,77,444,198,246
050,51,031,"Virginia","Campbell County",3,78,424,190,234
050,51,031,"Virginia","Campbell County",3,79,350,155,195
050,51,031,"Virginia","Campbell County",3,80,333,147,186
050,51,031,"Virginia","Campbell County",3,81,305,142,163
050,51,031,"Virginia","Campbell County",3,82,275,121,154
050,51,031,"Virginia","Campbell County",3,83,256,102,154
050,51,031,"Virginia","Campbell County",3,84,232,92,140
050,51,031,"Virginia","Campbell County",3,85,1419,505,914
050,51,031,"Virginia","Campbell County",4,0,382,201,181
050,51,031,"Virginia","Campbell County",4,1,397,211,186
050,51,031,"Virginia","Campbell County",4,2,526,264,262
050,51,031,"Virginia","Campbell County",4,3,599,308,291
050,51,031,"Virginia","Campbell County",4,4,641,331,310
050,51,031,"Virginia","Campbell County",4,5,651,306,345
050,51,031,"Virginia","Campbell County",4,6,602,302,300
050,51,031,"Virginia","Campbell County",4,7,581,287,294
050,51,031,"Virginia","Campbell County",4,8,582,282,300
050,51,031,"Virginia","Campbell County",4,9,606,315,291
050,51,031,"Virginia","Campbell County",4,10,622,328,294
050,51,031,"Virginia","Campbell County",4,11,636,310,326
050,51,031,"Virginia","Campbell County",4,12,624,310,314
050,51,031,"Virginia","Campbell County",4,13,616,302,314
050,51,031,"Virginia","Campbell County",4,14,663,350,313
050,51,031,"Virginia","Campbell County",4,15,659,343,316
050,51,031,"Virginia","Campbell County",4,16,656,316,340
050,51,031,"Virginia","Campbell County",4,17,616,322,294
050,51,031,"Virginia","Campbell County",4,18,542,288,254
050,51,031,"Virginia","Campbell County",4,19,454,231,223
050,51,031,"Virginia","Campbell County",4,20,516,263,253
050,51,031,"Virginia","Campbell County",4,21,575,290,285
050,51,031,"Virginia","Campbell County",4,22,631,319,312
050,51,031,"Virginia","Campbell County",4,23,681,350,331
050,51,031,"Virginia","Campbell County",4,24,700,364,336
050,51,031,"Virginia","Campbell County",4,25,645,339,306
050,51,031,"Virginia","Campbell County",4,26,733,353,380
050,51,031,"Virginia","Campbell County",4,27,708,369,339
050,51,031,"Virginia","Campbell County",4,28,715,364,351
050,51,031,"Virginia","Campbell County",4,29,675,321,354
050,51,031,"Virginia","Campbell County",4,30,730,372,358
050,51,031,"Virginia","Campbell County",4,31,756,375,381
050,51,031,"Virginia","Campbell County",4,32,777,392,385
050,51,031,"Virginia","Campbell County",4,33,737,365,372
050,51,031,"Virginia","Campbell County",4,34,722,362,360
050,51,031,"Virginia","Campbell County",4,35,674,332,342
050,51,031,"Virginia","Campbell County",4,36,684,349,335
050,51,031,"Virginia","Campbell County",4,37,668,341,327
050,51,031,"Virginia","Campbell County",4,38,635,342,293
050,51,031,"Virginia","Campbell County",4,39,649,342,307
050,51,031,"Virginia","Campbell County",4,40,642,327,315
050,51,031,"Virginia","Campbell County",4,41,630,307,323
050,51,031,"Virginia","Campbell County",4,42,644,334,310
050,51,031,"Virginia","Campbell County",4,43,631,303,328
050,51,031,"Virginia","Campbell County",4,44,613,308,305
050,51,031,"Virginia","Campbell County",4,45,626,315,311
050,51,031,"Virginia","Campbell County",4,46,617,319,298
050,51,031,"Virginia","Campbell County",4,47,647,322,325
050,51,031,"Virginia","Campbell County",4,48,623,300,323
050,51,031,"Virginia","Campbell County",4,49,661,322,339
050,51,031,"Virginia","Campbell County",4,50,689,343,346
050,51,031,"Virginia","Campbell County",4,51,774,397,377
050,51,031,"Virginia","Campbell County",4,52,773,370,403
050,51,031,"Virginia","Campbell County",4,53,733,348,385
050,51,031,"Virginia","Campbell County",4,54,722,361,361
050,51,031,"Virginia","Campbell County",4,55,721,357,364
050,51,031,"Virginia","Campbell County",4,56,734,365,369
050,51,031,"Virginia","Campbell County",4,57,767,380,387
050,51,031,"Virginia","Campbell County",4,58,832,402,430
050,51,031,"Virginia","Campbell County",4,59,814,387,427
050,51,031,"Virginia","Campbell County",4,60,815,374,441
050,51,031,"Virginia","Campbell County",4,61,847,395,452
050,51,031,"Virginia","Campbell County",4,62,822,409,413
050,51,031,"Virginia","Campbell County",4,63,774,362,412
050,51,031,"Virginia","Campbell County",4,64,825,399,426
050,51,031,"Virginia","Campbell County",4,65,796,408,388
050,51,031,"Virginia","Campbell County",4,66,761,377,384
050,51,031,"Virginia","Campbell County",4,67,735,350,385
050,51,031,"Virginia","Campbell County",4,68,708,328,380
050,51,031,"Virginia","Campbell County",4,69,648,290,358
050,51,031,"Virginia","Campbell County",4,70,615,283,332
050,51,031,"Virginia","Campbell County",4,71,577,249,328
050,51,031,"Virginia","Campbell County",4,72,592,280,312
050,51,031,"Virginia","Campbell County",4,73,589,272,317
050,51,031,"Virginia","Campbell County",4,74,600,264,336
050,51,031,"Virginia","Campbell County",4,75,642,274,368
050,51,031,"Virginia","Campbell County",4,76,443,187,256
050,51,031,"Virginia","Campbell County",4,77,434,195,239
050,51,031,"Virginia","Campbell County",4,78,412,177,235
050,51,031,"Virginia","Campbell County",4,79,404,182,222
050,51,031,"Virginia","Campbell County",4,80,344,145,199
050,51,031,"Virginia","Campbell County",4,81,306,140,166
050,51,031,"Virginia","Campbell County",4,82,280,128,152
050,51,031,"Virginia","Campbell County",4,83,268,114,154
050,51,031,"Virginia","Campbell County",4,84,231,99,132
050,51,031,"Virginia","Campbell County",4,85,1438,503,935
050,51,031,"Virginia","Campbell County",5,0,363,190,173
050,51,031,"Virginia","Campbell County",5,1,425,206,219
050,51,031,"Virginia","Campbell County",5,2,422,215,207
050,51,031,"Virginia","Campbell County",5,3,545,281,264
050,51,031,"Virginia","Campbell County",5,4,612,319,293
050,51,031,"Virginia","Campbell County",5,5,630,318,312
050,51,031,"Virginia","Campbell County",5,6,647,307,340
050,51,031,"Virginia","Campbell County",5,7,601,309,292
050,51,031,"Virginia","Campbell County",5,8,597,296,301
050,51,031,"Virginia","Campbell County",5,9,581,281,300
050,51,031,"Virginia","Campbell County",5,10,620,313,307
050,51,031,"Virginia","Campbell County",5,11,607,319,288
050,51,031,"Virginia","Campbell County",5,12,627,316,311
050,51,031,"Virginia","Campbell County",5,13,630,317,313
050,51,031,"Virginia","Campbell County",5,14,626,302,324
050,51,031,"Virginia","Campbell County",5,15,670,357,313
050,51,031,"Virginia","Campbell County",5,16,674,353,321
050,51,031,"Virginia","Campbell County",5,17,659,315,344
050,51,031,"Virginia","Campbell County",5,18,518,283,235
050,51,031,"Virginia","Campbell County",5,19,459,244,215
050,51,031,"Virginia","Campbell County",5,20,519,262,257
050,51,031,"Virginia","Campbell County",5,21,576,289,287
050,51,031,"Virginia","Campbell County",5,22,656,327,329
050,51,031,"Virginia","Campbell County",5,23,682,336,346
050,51,031,"Virginia","Campbell County",5,24,680,360,320
050,51,031,"Virginia","Campbell County",5,25,690,352,338
050,51,031,"Virginia","Campbell County",5,26,667,346,321
050,51,031,"Virginia","Campbell County",5,27,719,345,374
050,51,031,"Virginia","Campbell County",5,28,717,350,367
050,51,031,"Virginia","Campbell County",5,29,710,363,347
050,51,031,"Virginia","Campbell County",5,30,688,322,366
050,51,031,"Virginia","Campbell County",5,31,763,388,375
050,51,031,"Virginia","Campbell County",5,32,750,371,379
050,51,031,"Virginia","Campbell County",5,33,777,381,396
050,51,031,"Virginia","Campbell County",5,34,730,352,378
050,51,031,"Virginia","Campbell County",5,35,722,356,366
050,51,031,"Virginia","Campbell County",5,36,686,344,342
050,51,031,"Virginia","Campbell County",5,37,673,336,337
050,51,031,"Virginia","Campbell County",5,38,673,348,325
050,51,031,"Virginia","Campbell County",5,39,644,343,301
050,51,031,"Virginia","Campbell County",5,40,653,337,316
050,51,031,"Virginia","Campbell County",5,41,654,335,319
050,51,031,"Virginia","Campbell County",5,42,647,319,328
050,51,031,"Virginia","Campbell County",5,43,669,343,326
050,51,031,"Virginia","Campbell County",5,44,622,308,314
050,51,031,"Virginia","Campbell County",5,45,613,307,306
050,51,031,"Virginia","Campbell County",5,46,618,314,304
050,51,031,"Virginia","Campbell County",5,47,615,324,291
050,51,031,"Virginia","Campbell County",5,48,657,330,327
050,51,031,"Virginia","Campbell County",5,49,619,304,315
050,51,031,"Virginia","Campbell County",5,50,661,315,346
050,51,031,"Virginia","Campbell County",5,51,684,337,347
050,51,031,"Virginia","Campbell County",5,52,780,385,395
050,51,031,"Virginia","Campbell County",5,53,785,375,410
050,51,031,"Virginia","Campbell County",5,54,755,352,403
050,51,031,"Virginia","Campbell County",5,55,749,381,368
050,51,031,"Virginia","Campbell County",5,56,718,347,371
050,51,031,"Virginia","Campbell County",5,57,721,366,355
050,51,031,"Virginia","Campbell County",5,58,769,364,405
050,51,031,"Virginia","Campbell County",5,59,854,414,440
050,51,031,"Virginia","Campbell County",5,60,823,389,434
050,51,031,"Virginia","Campbell County",5,61,831,384,447
050,51,031,"Virginia","Campbell County",5,62,835,395,440
050,51,031,"Virginia","Campbell County",5,63,824,408,416
050,51,031,"Virginia","Campbell County",5,64,783,364,419
050,51,031,"Virginia","Campbell County",5,65,835,404,431
050,51,031,"Virginia","Campbell County",5,66,777,394,383
050,51,031,"Virginia","Campbell County",5,67,743,365,378
050,51,031,"Virginia","Campbell County",5,68,712,335,377
050,51,031,"Virginia","Campbell County",5,69,700,320,380
050,51,031,"Virginia","Campbell County",5,70,634,283,351
050,51,031,"Virginia","Campbell County",5,71,582,271,311
050,51,031,"Virginia","Campbell County",5,72,571,250,321
050,51,031,"Virginia","Campbell County",5,73,567,256,311
050,51,031,"Virginia","Campbell County",5,74,567,259,308
050,51,031,"Virginia","Campbell County",5,75,585,259,326
050,51,031,"Virginia","Campbell County",5,76,611,261,350
050,51,031,"Virginia","Campbell County",5,77,427,183,244
050,51,031,"Virginia","Campbell County",5,78,404,177,227
050,51,031,"Virginia","Campbell County",5,79,399,172,227
050,51,031,"Virginia","Campbell County",5,80,384,169,215
050,51,031,"Virginia","Campbell County",5,81,311,134,177
050,51,031,"Virginia","Campbell County",5,82,289,130,159
050,51,031,"Virginia","Campbell County",5,83,276,123,153
050,51,031,"Virginia","Campbell County",5,84,247,111,136
050,51,031,"Virginia","Campbell County",5,85,1475,531,944
050,51,033,"Virginia","Caroline County",1,0,337,177,160
050,51,033,"Virginia","Caroline County",1,1,384,209,175
050,51,033,"Virginia","Caroline County",1,2,381,194,187
050,51,033,"Virginia","Caroline County",1,3,388,188,200
050,51,033,"Virginia","Caroline County",1,4,424,215,209
050,51,033,"Virginia","Caroline County",1,5,439,232,207
050,51,033,"Virginia","Caroline County",1,6,420,217,203
050,51,033,"Virginia","Caroline County",1,7,424,215,209
050,51,033,"Virginia","Caroline County",1,8,412,209,203
050,51,033,"Virginia","Caroline County",1,9,407,207,200
050,51,033,"Virginia","Caroline County",1,10,401,192,209
050,51,033,"Virginia","Caroline County",1,11,373,188,185
050,51,033,"Virginia","Caroline County",1,12,405,217,188
050,51,033,"Virginia","Caroline County",1,13,410,209,201
050,51,033,"Virginia","Caroline County",1,14,408,203,205
050,51,033,"Virginia","Caroline County",1,15,362,190,172
050,51,033,"Virginia","Caroline County",1,16,372,182,190
050,51,033,"Virginia","Caroline County",1,17,368,181,187
050,51,033,"Virginia","Caroline County",1,18,313,158,155
050,51,033,"Virginia","Caroline County",1,19,258,134,124
050,51,033,"Virginia","Caroline County",1,20,273,143,130
050,51,033,"Virginia","Caroline County",1,21,299,158,141
050,51,033,"Virginia","Caroline County",1,22,305,153,152
050,51,033,"Virginia","Caroline County",1,23,324,160,164
050,51,033,"Virginia","Caroline County",1,24,341,170,171
050,51,033,"Virginia","Caroline County",1,25,351,175,176
050,51,033,"Virginia","Caroline County",1,26,369,182,187
050,51,033,"Virginia","Caroline County",1,27,422,196,226
050,51,033,"Virginia","Caroline County",1,28,443,222,221
050,51,033,"Virginia","Caroline County",1,29,416,213,203
050,51,033,"Virginia","Caroline County",1,30,450,224,226
050,51,033,"Virginia","Caroline County",1,31,445,243,202
050,51,033,"Virginia","Caroline County",1,32,429,227,202
050,51,033,"Virginia","Caroline County",1,33,451,226,225
050,51,033,"Virginia","Caroline County",1,34,469,238,231
050,51,033,"Virginia","Caroline County",1,35,427,227,200
050,51,033,"Virginia","Caroline County",1,36,384,188,196
050,51,033,"Virginia","Caroline County",1,37,422,231,191
050,51,033,"Virginia","Caroline County",1,38,431,248,183
050,51,033,"Virginia","Caroline County",1,39,402,221,181
050,51,033,"Virginia","Caroline County",1,40,386,202,184
050,51,033,"Virginia","Caroline County",1,41,366,169,197
050,51,033,"Virginia","Caroline County",1,42,406,203,203
050,51,033,"Virginia","Caroline County",1,43,390,201,189
050,51,033,"Virginia","Caroline County",1,44,382,198,184
050,51,033,"Virginia","Caroline County",1,45,381,208,173
050,51,033,"Virginia","Caroline County",1,46,333,168,165
050,51,033,"Virginia","Caroline County",1,47,369,197,172
050,51,033,"Virginia","Caroline County",1,48,425,216,209
050,51,033,"Virginia","Caroline County",1,49,432,218,214
050,51,033,"Virginia","Caroline County",1,50,407,210,197
050,51,033,"Virginia","Caroline County",1,51,402,209,193
050,51,033,"Virginia","Caroline County",1,52,403,200,203
050,51,033,"Virginia","Caroline County",1,53,389,189,200
050,51,033,"Virginia","Caroline County",1,54,410,207,203
050,51,033,"Virginia","Caroline County",1,55,436,228,208
050,51,033,"Virginia","Caroline County",1,56,437,209,228
050,51,033,"Virginia","Caroline County",1,57,417,218,199
050,51,033,"Virginia","Caroline County",1,58,443,233,210
050,51,033,"Virginia","Caroline County",1,59,456,228,228
050,51,033,"Virginia","Caroline County",1,60,476,225,251
050,51,033,"Virginia","Caroline County",1,61,440,206,234
050,51,033,"Virginia","Caroline County",1,62,451,204,247
050,51,033,"Virginia","Caroline County",1,63,399,190,209
050,51,033,"Virginia","Caroline County",1,64,397,185,212
050,51,033,"Virginia","Caroline County",1,65,377,185,192
050,51,033,"Virginia","Caroline County",1,66,352,177,175
050,51,033,"Virginia","Caroline County",1,67,337,168,169
050,51,033,"Virginia","Caroline County",1,68,345,155,190
050,51,033,"Virginia","Caroline County",1,69,321,154,167
050,51,033,"Virginia","Caroline County",1,70,319,148,171
050,51,033,"Virginia","Caroline County",1,71,312,148,164
050,51,033,"Virginia","Caroline County",1,72,291,141,150
050,51,033,"Virginia","Caroline County",1,73,285,134,151
050,51,033,"Virginia","Caroline County",1,74,212,97,115
050,51,033,"Virginia","Caroline County",1,75,215,111,104
050,51,033,"Virginia","Caroline County",1,76,208,94,114
050,51,033,"Virginia","Caroline County",1,77,213,93,120
050,51,033,"Virginia","Caroline County",1,78,173,73,100
050,51,033,"Virginia","Caroline County",1,79,155,65,90
050,51,033,"Virginia","Caroline County",1,80,135,61,74
050,51,033,"Virginia","Caroline County",1,81,115,52,63
050,51,033,"Virginia","Caroline County",1,82,111,39,72
050,51,033,"Virginia","Caroline County",1,83,82,33,49
050,51,033,"Virginia","Caroline County",1,84,78,20,58
050,51,033,"Virginia","Caroline County",1,85,473,156,317
050,51,033,"Virginia","Caroline County",2,0,349,184,165
050,51,033,"Virginia","Caroline County",2,1,374,203,171
050,51,033,"Virginia","Caroline County",2,2,383,199,184
050,51,033,"Virginia","Caroline County",2,3,386,190,196
050,51,033,"Virginia","Caroline County",2,4,417,210,207
050,51,033,"Virginia","Caroline County",2,5,434,227,207
050,51,033,"Virginia","Caroline County",2,6,425,220,205
050,51,033,"Virginia","Caroline County",2,7,420,215,205
050,51,033,"Virginia","Caroline County",2,8,411,209,202
050,51,033,"Virginia","Caroline County",2,9,403,203,200
050,51,033,"Virginia","Caroline County",2,10,397,191,206
050,51,033,"Virginia","Caroline County",2,11,376,188,188
050,51,033,"Virginia","Caroline County",2,12,400,210,190
050,51,033,"Virginia","Caroline County",2,13,409,211,198
050,51,033,"Virginia","Caroline County",2,14,409,204,205
050,51,033,"Virginia","Caroline County",2,15,374,192,182
050,51,033,"Virginia","Caroline County",2,16,368,183,185
050,51,033,"Virginia","Caroline County",2,17,368,180,188
050,51,033,"Virginia","Caroline County",2,18,312,157,155
050,51,033,"Virginia","Caroline County",2,19,260,133,127
050,51,033,"Virginia","Caroline County",2,20,279,146,133
050,51,033,"Virginia","Caroline County",2,21,298,157,141
050,51,033,"Virginia","Caroline County",2,22,314,158,156
050,51,033,"Virginia","Caroline County",2,23,323,160,163
050,51,033,"Virginia","Caroline County",2,24,342,173,169
050,51,033,"Virginia","Caroline County",2,25,354,176,178
050,51,033,"Virginia","Caroline County",2,26,374,185,189
050,51,033,"Virginia","Caroline County",2,27,412,194,218
050,51,033,"Virginia","Caroline County",2,28,436,216,220
050,51,033,"Virginia","Caroline County",2,29,424,216,208
050,51,033,"Virginia","Caroline County",2,30,449,228,221
050,51,033,"Virginia","Caroline County",2,31,450,241,209
050,51,033,"Virginia","Caroline County",2,32,433,230,203
050,51,033,"Virginia","Caroline County",2,33,445,225,220
050,51,033,"Virginia","Caroline County",2,34,464,235,229
050,51,033,"Virginia","Caroline County",2,35,441,232,209
050,51,033,"Virginia","Caroline County",2,36,393,196,197
050,51,033,"Virginia","Caroline County",2,37,417,224,193
050,51,033,"Virginia","Caroline County",2,38,437,250,187
050,51,033,"Virginia","Caroline County",2,39,403,224,179
050,51,033,"Virginia","Caroline County",2,40,392,207,185
050,51,033,"Virginia","Caroline County",2,41,369,175,194
050,51,033,"Virginia","Caroline County",2,42,389,189,200
050,51,033,"Virginia","Caroline County",2,43,402,208,194
050,51,033,"Virginia","Caroline County",2,44,376,194,182
050,51,033,"Virginia","Caroline County",2,45,381,206,175
050,51,033,"Virginia","Caroline County",2,46,338,174,164
050,51,033,"Virginia","Caroline County",2,47,356,186,170
050,51,033,"Virginia","Caroline County",2,48,413,213,200
050,51,033,"Virginia","Caroline County",2,49,433,219,214
050,51,033,"Virginia","Caroline County",2,50,415,214,201
050,51,033,"Virginia","Caroline County",2,51,401,207,194
050,51,033,"Virginia","Caroline County",2,52,397,198,199
050,51,033,"Virginia","Caroline County",2,53,390,191,199
050,51,033,"Virginia","Caroline County",2,54,403,201,202
050,51,033,"Virginia","Caroline County",2,55,435,226,209
050,51,033,"Virginia","Caroline County",2,56,437,209,228
050,51,033,"Virginia","Caroline County",2,57,423,215,208
050,51,033,"Virginia","Caroline County",2,58,437,230,207
050,51,033,"Virginia","Caroline County",2,59,450,227,223
050,51,033,"Virginia","Caroline County",2,60,471,226,245
050,51,033,"Virginia","Caroline County",2,61,449,210,239
050,51,033,"Virginia","Caroline County",2,62,444,202,242
050,51,033,"Virginia","Caroline County",2,63,413,194,219
050,51,033,"Virginia","Caroline County",2,64,396,185,211
050,51,033,"Virginia","Caroline County",2,65,384,186,198
050,51,033,"Virginia","Caroline County",2,66,356,179,177
050,51,033,"Virginia","Caroline County",2,67,339,168,171
050,51,033,"Virginia","Caroline County",2,68,337,155,182
050,51,033,"Virginia","Caroline County",2,69,326,154,172
050,51,033,"Virginia","Caroline County",2,70,317,149,168
050,51,033,"Virginia","Caroline County",2,71,310,146,164
050,51,033,"Virginia","Caroline County",2,72,289,139,150
050,51,033,"Virginia","Caroline County",2,73,294,140,154
050,51,033,"Virginia","Caroline County",2,74,215,99,116
050,51,033,"Virginia","Caroline County",2,75,213,106,107
050,51,033,"Virginia","Caroline County",2,76,209,98,111
050,51,033,"Virginia","Caroline County",2,77,217,94,123
050,51,033,"Virginia","Caroline County",2,78,179,76,103
050,51,033,"Virginia","Caroline County",2,79,160,68,92
050,51,033,"Virginia","Caroline County",2,80,139,61,78
050,51,033,"Virginia","Caroline County",2,81,117,54,63
050,51,033,"Virginia","Caroline County",2,82,112,41,71
050,51,033,"Virginia","Caroline County",2,83,87,33,54
050,51,033,"Virginia","Caroline County",2,84,80,24,56
050,51,033,"Virginia","Caroline County",2,85,468,155,313
050,51,033,"Virginia","Caroline County",3,0,333,177,156
050,51,033,"Virginia","Caroline County",3,1,347,191,156
050,51,033,"Virginia","Caroline County",3,2,382,202,180
050,51,033,"Virginia","Caroline County",3,3,377,198,179
050,51,033,"Virginia","Caroline County",3,4,403,208,195
050,51,033,"Virginia","Caroline County",3,5,422,211,211
050,51,033,"Virginia","Caroline County",3,6,440,236,204
050,51,033,"Virginia","Caroline County",3,7,424,217,207
050,51,033,"Virginia","Caroline County",3,8,412,216,196
050,51,033,"Virginia","Caroline County",3,9,418,209,209
050,51,033,"Virginia","Caroline County",3,10,404,211,193
050,51,033,"Virginia","Caroline County",3,11,399,196,203
050,51,033,"Virginia","Caroline County",3,12,408,199,209
050,51,033,"Virginia","Caroline County",3,13,408,214,194
050,51,033,"Virginia","Caroline County",3,14,407,205,202
050,51,033,"Virginia","Caroline County",3,15,398,204,194
050,51,033,"Virginia","Caroline County",3,16,373,186,187
050,51,033,"Virginia","Caroline County",3,17,372,194,178
050,51,033,"Virginia","Caroline County",3,18,318,159,159
050,51,033,"Virginia","Caroline County",3,19,266,129,137
050,51,033,"Virginia","Caroline County",3,20,277,129,148
050,51,033,"Virginia","Caroline County",3,21,298,156,142
050,51,033,"Virginia","Caroline County",3,22,322,166,156
050,51,033,"Virginia","Caroline County",3,23,329,163,166
050,51,033,"Virginia","Caroline County",3,24,356,183,173
050,51,033,"Virginia","Caroline County",3,25,375,187,188
050,51,033,"Virginia","Caroline County",3,26,392,191,201
050,51,033,"Virginia","Caroline County",3,27,404,200,204
050,51,033,"Virginia","Caroline County",3,28,424,202,222
050,51,033,"Virginia","Caroline County",3,29,473,234,239
050,51,033,"Virginia","Caroline County",3,30,460,239,221
050,51,033,"Virginia","Caroline County",3,31,484,250,234
050,51,033,"Virginia","Caroline County",3,32,450,232,218
050,51,033,"Virginia","Caroline County",3,33,439,233,206
050,51,033,"Virginia","Caroline County",3,34,425,202,223
050,51,033,"Virginia","Caroline County",3,35,470,243,227
050,51,033,"Virginia","Caroline County",3,36,445,225,220
050,51,033,"Virginia","Caroline County",3,37,410,211,199
050,51,033,"Virginia","Caroline County",3,38,428,236,192
050,51,033,"Virginia","Caroline County",3,39,436,246,190
050,51,033,"Virginia","Caroline County",3,40,415,228,187
050,51,033,"Virginia","Caroline County",3,41,385,204,181
050,51,033,"Virginia","Caroline County",3,42,366,170,196
050,51,033,"Virginia","Caroline County",3,43,414,214,200
050,51,033,"Virginia","Caroline County",3,44,391,198,193
050,51,033,"Virginia","Caroline County",3,45,382,211,171
050,51,033,"Virginia","Caroline County",3,46,390,192,198
050,51,033,"Virginia","Caroline County",3,47,345,187,158
050,51,033,"Virginia","Caroline County",3,48,364,196,168
050,51,033,"Virginia","Caroline County",3,49,418,207,211
050,51,033,"Virginia","Caroline County",3,50,440,220,220
050,51,033,"Virginia","Caroline County",3,51,420,216,204
050,51,033,"Virginia","Caroline County",3,52,405,204,201
050,51,033,"Virginia","Caroline County",3,53,419,214,205
050,51,033,"Virginia","Caroline County",3,54,395,190,205
050,51,033,"Virginia","Caroline County",3,55,418,215,203
050,51,033,"Virginia","Caroline County",3,56,420,213,207
050,51,033,"Virginia","Caroline County",3,57,442,208,234
050,51,033,"Virginia","Caroline County",3,58,434,219,215
050,51,033,"Virginia","Caroline County",3,59,437,224,213
050,51,033,"Virginia","Caroline County",3,60,457,225,232
050,51,033,"Virginia","Caroline County",3,61,463,216,247
050,51,033,"Virginia","Caroline County",3,62,450,216,234
050,51,033,"Virginia","Caroline County",3,63,428,202,226
050,51,033,"Virginia","Caroline County",3,64,411,195,216
050,51,033,"Virginia","Caroline County",3,65,397,192,205
050,51,033,"Virginia","Caroline County",3,66,383,181,202
050,51,033,"Virginia","Caroline County",3,67,343,172,171
050,51,033,"Virginia","Caroline County",3,68,339,166,173
050,51,033,"Virginia","Caroline County",3,69,326,143,183
050,51,033,"Virginia","Caroline County",3,70,314,148,166
050,51,033,"Virginia","Caroline County",3,71,300,142,158
050,51,033,"Virginia","Caroline County",3,72,297,139,158
050,51,033,"Virginia","Caroline County",3,73,279,132,147
050,51,033,"Virginia","Caroline County",3,74,278,132,146
050,51,033,"Virginia","Caroline County",3,75,205,92,113
050,51,033,"Virginia","Caroline County",3,76,208,102,106
050,51,033,"Virginia","Caroline County",3,77,213,99,114
050,51,033,"Virginia","Caroline County",3,78,203,87,116
050,51,033,"Virginia","Caroline County",3,79,165,71,94
050,51,033,"Virginia","Caroline County",3,80,140,58,82
050,51,033,"Virginia","Caroline County",3,81,131,60,71
050,51,033,"Virginia","Caroline County",3,82,115,55,60
050,51,033,"Virginia","Caroline County",3,83,101,35,66
050,51,033,"Virginia","Caroline County",3,84,83,29,54
050,51,033,"Virginia","Caroline County",3,85,468,147,321
050,51,033,"Virginia","Caroline County",4,0,349,187,162
050,51,033,"Virginia","Caroline County",4,1,312,171,141
050,51,033,"Virginia","Caroline County",4,2,353,201,152
050,51,033,"Virginia","Caroline County",4,3,382,203,179
050,51,033,"Virginia","Caroline County",4,4,412,225,187
050,51,033,"Virginia","Caroline County",4,5,417,214,203
050,51,033,"Virginia","Caroline County",4,6,422,209,213
050,51,033,"Virginia","Caroline County",4,7,448,234,214
050,51,033,"Virginia","Caroline County",4,8,432,216,216
050,51,033,"Virginia","Caroline County",4,9,401,210,191
050,51,033,"Virginia","Caroline County",4,10,422,212,210
050,51,033,"Virginia","Caroline County",4,11,420,216,204
050,51,033,"Virginia","Caroline County",4,12,425,200,225
050,51,033,"Virginia","Caroline County",4,13,411,195,216
050,51,033,"Virginia","Caroline County",4,14,426,231,195
050,51,033,"Virginia","Caroline County",4,15,423,213,210
050,51,033,"Virginia","Caroline County",4,16,413,214,199
050,51,033,"Virginia","Caroline County",4,17,368,187,181
050,51,033,"Virginia","Caroline County",4,18,329,179,150
050,51,033,"Virginia","Caroline County",4,19,265,136,129
050,51,033,"Virginia","Caroline County",4,20,268,132,136
050,51,033,"Virginia","Caroline County",4,21,302,136,166
050,51,033,"Virginia","Caroline County",4,22,330,171,159
050,51,033,"Virginia","Caroline County",4,23,336,169,167
050,51,033,"Virginia","Caroline County",4,24,371,188,183
050,51,033,"Virginia","Caroline County",4,25,381,194,187
050,51,033,"Virginia","Caroline County",4,26,396,210,186
050,51,033,"Virginia","Caroline County",4,27,412,207,205
050,51,033,"Virginia","Caroline County",4,28,416,208,208
050,51,033,"Virginia","Caroline County",4,29,439,216,223
050,51,033,"Virginia","Caroline County",4,30,509,264,245
050,51,033,"Virginia","Caroline County",4,31,467,236,231
050,51,033,"Virginia","Caroline County",4,32,472,242,230
050,51,033,"Virginia","Caroline County",4,33,459,232,227
050,51,033,"Virginia","Caroline County",4,34,445,236,209
050,51,033,"Virginia","Caroline County",4,35,427,203,224
050,51,033,"Virginia","Caroline County",4,36,473,249,224
050,51,033,"Virginia","Caroline County",4,37,457,228,229
050,51,033,"Virginia","Caroline County",4,38,431,231,200
050,51,033,"Virginia","Caroline County",4,39,438,234,204
050,51,033,"Virginia","Caroline County",4,40,440,240,200
050,51,033,"Virginia","Caroline County",4,41,407,218,189
050,51,033,"Virginia","Caroline County",4,42,381,209,172
050,51,033,"Virginia","Caroline County",4,43,389,192,197
050,51,033,"Virginia","Caroline County",4,44,391,186,205
050,51,033,"Virginia","Caroline County",4,45,403,220,183
050,51,033,"Virginia","Caroline County",4,46,383,208,175
050,51,033,"Virginia","Caroline County",4,47,393,201,192
050,51,033,"Virginia","Caroline County",4,48,346,191,155
050,51,033,"Virginia","Caroline County",4,49,365,193,172
050,51,033,"Virginia","Caroline County",4,50,416,199,217
050,51,033,"Virginia","Caroline County",4,51,449,223,226
050,51,033,"Virginia","Caroline County",4,52,425,217,208
050,51,033,"Virginia","Caroline County",4,53,413,205,208
050,51,033,"Virginia","Caroline County",4,54,436,220,216
050,51,033,"Virginia","Caroline County",4,55,412,204,208
050,51,033,"Virginia","Caroline County",4,56,428,209,219
050,51,033,"Virginia","Caroline County",4,57,415,205,210
050,51,033,"Virginia","Caroline County",4,58,444,213,231
050,51,033,"Virginia","Caroline County",4,59,439,219,220
050,51,033,"Virginia","Caroline County",4,60,442,228,214
050,51,033,"Virginia","Caroline County",4,61,464,221,243
050,51,033,"Virginia","Caroline County",4,62,453,214,239
050,51,033,"Virginia","Caroline County",4,63,448,207,241
050,51,033,"Virginia","Caroline County",4,64,424,196,228
050,51,033,"Virginia","Caroline County",4,65,410,191,219
050,51,033,"Virginia","Caroline County",4,66,396,194,202
050,51,033,"Virginia","Caroline County",4,67,379,176,203
050,51,033,"Virginia","Caroline County",4,68,342,172,170
050,51,033,"Virginia","Caroline County",4,69,332,164,168
050,51,033,"Virginia","Caroline County",4,70,325,142,183
050,51,033,"Virginia","Caroline County",4,71,300,139,161
050,51,033,"Virginia","Caroline County",4,72,296,139,157
050,51,033,"Virginia","Caroline County",4,73,297,140,157
050,51,033,"Virginia","Caroline County",4,74,268,126,142
050,51,033,"Virginia","Caroline County",4,75,265,127,138
050,51,033,"Virginia","Caroline County",4,76,201,90,111
050,51,033,"Virginia","Caroline County",4,77,199,95,104
050,51,033,"Virginia","Caroline County",4,78,198,92,106
050,51,033,"Virginia","Caroline County",4,79,191,80,111
050,51,033,"Virginia","Caroline County",4,80,150,64,86
050,51,033,"Virginia","Caroline County",4,81,129,54,75
050,51,033,"Virginia","Caroline County",4,82,126,58,68
050,51,033,"Virginia","Caroline County",4,83,112,52,60
050,51,033,"Virginia","Caroline County",4,84,91,29,62
050,51,033,"Virginia","Caroline County",4,85,468,144,324
050,51,033,"Virginia","Caroline County",5,0,349,186,163
050,51,033,"Virginia","Caroline County",5,1,355,187,168
050,51,033,"Virginia","Caroline County",5,2,327,181,146
050,51,033,"Virginia","Caroline County",5,3,365,212,153
050,51,033,"Virginia","Caroline County",5,4,411,216,195
050,51,033,"Virginia","Caroline County",5,5,425,230,195
050,51,033,"Virginia","Caroline County",5,6,429,219,210
050,51,033,"Virginia","Caroline County",5,7,436,219,217
050,51,033,"Virginia","Caroline County",5,8,458,233,225
050,51,033,"Virginia","Caroline County",5,9,438,208,230
050,51,033,"Virginia","Caroline County",5,10,422,232,190
050,51,033,"Virginia","Caroline County",5,11,427,224,203
050,51,033,"Virginia","Caroline County",5,12,446,221,225
050,51,033,"Virginia","Caroline County",5,13,436,199,237
050,51,033,"Virginia","Caroline County",5,14,432,210,222
050,51,033,"Virginia","Caroline County",5,15,438,239,199
050,51,033,"Virginia","Caroline County",5,16,424,204,220
050,51,033,"Virginia","Caroline County",5,17,418,223,195
050,51,033,"Virginia","Caroline County",5,18,325,175,150
050,51,033,"Virginia","Caroline County",5,19,262,137,125
050,51,033,"Virginia","Caroline County",5,20,283,142,141
050,51,033,"Virginia","Caroline County",5,21,307,152,155
050,51,033,"Virginia","Caroline County",5,22,309,144,165
050,51,033,"Virginia","Caroline County",5,23,338,167,171
050,51,033,"Virginia","Caroline County",5,24,362,182,180
050,51,033,"Virginia","Caroline County",5,25,393,198,195
050,51,033,"Virginia","Caroline County",5,26,417,212,205
050,51,033,"Virginia","Caroline County",5,27,407,219,188
050,51,033,"Virginia","Caroline County",5,28,447,223,224
050,51,033,"Virginia","Caroline County",5,29,413,196,217
050,51,033,"Virginia","Caroline County",5,30,499,257,242
050,51,033,"Virginia","Caroline County",5,31,533,269,264
050,51,033,"Virginia","Caroline County",5,32,471,243,228
050,51,033,"Virginia","Caroline County",5,33,484,246,238
050,51,033,"Virginia","Caroline County",5,34,487,248,239
050,51,033,"Virginia","Caroline County",5,35,484,251,233
050,51,033,"Virginia","Caroline County",5,36,425,204,221
050,51,033,"Virginia","Caroline County",5,37,486,259,227
050,51,033,"Virginia","Caroline County",5,38,476,239,237
050,51,033,"Virginia","Caroline County",5,39,448,236,212
050,51,033,"Virginia","Caroline County",5,40,434,230,204
050,51,033,"Virginia","Caroline County",5,41,423,228,195
050,51,033,"Virginia","Caroline County",5,42,415,218,197
050,51,033,"Virginia","Caroline County",5,43,421,240,181
050,51,033,"Virginia","Caroline County",5,44,391,183,208
050,51,033,"Virginia","Caroline County",5,45,407,201,206
050,51,033,"Virginia","Caroline County",5,46,414,223,191
050,51,033,"Virginia","Caroline County",5,47,383,200,183
050,51,033,"Virginia","Caroline County",5,48,398,211,187
050,51,033,"Virginia","Caroline County",5,49,346,184,162
050,51,033,"Virginia","Caroline County",5,50,359,188,171
050,51,033,"Virginia","Caroline County",5,51,409,200,209
050,51,033,"Virginia","Caroline County",5,52,444,220,224
050,51,033,"Virginia","Caroline County",5,53,432,228,204
050,51,033,"Virginia","Caroline County",5,54,417,205,212
050,51,033,"Virginia","Caroline County",5,55,458,236,222
050,51,033,"Virginia","Caroline County",5,56,389,187,202
050,51,033,"Virginia","Caroline County",5,57,441,212,229
050,51,033,"Virginia","Caroline County",5,58,416,210,206
050,51,033,"Virginia","Caroline County",5,59,440,213,227
050,51,033,"Virginia","Caroline County",5,60,438,220,218
050,51,033,"Virginia","Caroline County",5,61,449,231,218
050,51,033,"Virginia","Caroline County",5,62,455,219,236
050,51,033,"Virginia","Caroline County",5,63,448,215,233
050,51,033,"Virginia","Caroline County",5,64,448,207,241
050,51,033,"Virginia","Caroline County",5,65,438,207,231
050,51,033,"Virginia","Caroline County",5,66,412,198,214
050,51,033,"Virginia","Caroline County",5,67,389,187,202
050,51,033,"Virginia","Caroline County",5,68,368,174,194
050,51,033,"Virginia","Caroline County",5,69,338,169,169
050,51,033,"Virginia","Caroline County",5,70,333,164,169
050,51,033,"Virginia","Caroline County",5,71,316,137,179
050,51,033,"Virginia","Caroline County",5,72,290,136,154
050,51,033,"Virginia","Caroline County",5,73,287,137,150
050,51,033,"Virginia","Caroline County",5,74,286,130,156
050,51,033,"Virginia","Caroline County",5,75,262,122,140
050,51,033,"Virginia","Caroline County",5,76,256,123,133
050,51,033,"Virginia","Caroline County",5,77,195,85,110
050,51,033,"Virginia","Caroline County",5,78,183,87,96
050,51,033,"Virginia","Caroline County",5,79,183,87,96
050,51,033,"Virginia","Caroline County",5,80,171,69,102
050,51,033,"Virginia","Caroline County",5,81,143,60,83
050,51,033,"Virginia","Caroline County",5,82,127,54,73
050,51,033,"Virginia","Caroline County",5,83,117,52,65
050,51,033,"Virginia","Caroline County",5,84,104,48,56
050,51,033,"Virginia","Caroline County",5,85,475,140,335
050,51,035,"Virginia","Carroll County",1,0,232,123,109
050,51,035,"Virginia","Carroll County",1,1,237,119,118
050,51,035,"Virginia","Carroll County",1,2,254,119,135
050,51,035,"Virginia","Carroll County",1,3,258,140,118
050,51,035,"Virginia","Carroll County",1,4,279,160,119
050,51,035,"Virginia","Carroll County",1,5,289,145,144
050,51,035,"Virginia","Carroll County",1,6,263,124,139
050,51,035,"Virginia","Carroll County",1,7,273,146,127
050,51,035,"Virginia","Carroll County",1,8,282,142,140
050,51,035,"Virginia","Carroll County",1,9,286,145,141
050,51,035,"Virginia","Carroll County",1,10,309,158,151
050,51,035,"Virginia","Carroll County",1,11,313,165,148
050,51,035,"Virginia","Carroll County",1,12,344,186,158
050,51,035,"Virginia","Carroll County",1,13,337,179,158
050,51,035,"Virginia","Carroll County",1,14,321,162,159
050,51,035,"Virginia","Carroll County",1,15,316,154,162
050,51,035,"Virginia","Carroll County",1,16,319,152,167
050,51,035,"Virginia","Carroll County",1,17,332,161,171
050,51,035,"Virginia","Carroll County",1,18,305,160,145
050,51,035,"Virginia","Carroll County",1,19,228,118,110
050,51,035,"Virginia","Carroll County",1,20,261,136,125
050,51,035,"Virginia","Carroll County",1,21,273,151,122
050,51,035,"Virginia","Carroll County",1,22,261,141,120
050,51,035,"Virginia","Carroll County",1,23,282,150,132
050,51,035,"Virginia","Carroll County",1,24,300,154,146
050,51,035,"Virginia","Carroll County",1,25,267,139,128
050,51,035,"Virginia","Carroll County",1,26,266,128,138
050,51,035,"Virginia","Carroll County",1,27,288,143,145
050,51,035,"Virginia","Carroll County",1,28,288,150,138
050,51,035,"Virginia","Carroll County",1,29,306,138,168
050,51,035,"Virginia","Carroll County",1,30,308,140,168
050,51,035,"Virginia","Carroll County",1,31,301,158,143
050,51,035,"Virginia","Carroll County",1,32,313,158,155
050,51,035,"Virginia","Carroll County",1,33,287,156,131
050,51,035,"Virginia","Carroll County",1,34,297,163,134
050,51,035,"Virginia","Carroll County",1,35,289,146,143
050,51,035,"Virginia","Carroll County",1,36,287,139,148
050,51,035,"Virginia","Carroll County",1,37,299,160,139
050,51,035,"Virginia","Carroll County",1,38,282,144,138
050,51,035,"Virginia","Carroll County",1,39,301,156,145
050,51,035,"Virginia","Carroll County",1,40,297,145,152
050,51,035,"Virginia","Carroll County",1,41,286,148,138
050,51,035,"Virginia","Carroll County",1,42,290,154,136
050,51,035,"Virginia","Carroll County",1,43,328,162,166
050,51,035,"Virginia","Carroll County",1,44,332,164,168
050,51,035,"Virginia","Carroll County",1,45,365,202,163
050,51,035,"Virginia","Carroll County",1,46,361,187,174
050,51,035,"Virginia","Carroll County",1,47,380,183,197
050,51,035,"Virginia","Carroll County",1,48,411,194,217
050,51,035,"Virginia","Carroll County",1,49,411,207,204
050,51,035,"Virginia","Carroll County",1,50,424,213,211
050,51,035,"Virginia","Carroll County",1,51,390,201,189
050,51,035,"Virginia","Carroll County",1,52,411,223,188
050,51,035,"Virginia","Carroll County",1,53,424,216,208
050,51,035,"Virginia","Carroll County",1,54,452,227,225
050,51,035,"Virginia","Carroll County",1,55,441,224,217
050,51,035,"Virginia","Carroll County",1,56,469,234,235
050,51,035,"Virginia","Carroll County",1,57,459,222,237
050,51,035,"Virginia","Carroll County",1,58,502,248,254
050,51,035,"Virginia","Carroll County",1,59,483,243,240
050,51,035,"Virginia","Carroll County",1,60,443,229,214
050,51,035,"Virginia","Carroll County",1,61,486,242,244
050,51,035,"Virginia","Carroll County",1,62,456,219,237
050,51,035,"Virginia","Carroll County",1,63,459,230,229
050,51,035,"Virginia","Carroll County",1,64,449,225,224
050,51,035,"Virginia","Carroll County",1,65,457,223,234
050,51,035,"Virginia","Carroll County",1,66,492,232,260
050,51,035,"Virginia","Carroll County",1,67,488,244,244
050,51,035,"Virginia","Carroll County",1,68,494,247,247
050,51,035,"Virginia","Carroll County",1,69,435,226,209
050,51,035,"Virginia","Carroll County",1,70,409,201,208
050,51,035,"Virginia","Carroll County",1,71,395,195,200
050,51,035,"Virginia","Carroll County",1,72,443,212,231
050,51,035,"Virginia","Carroll County",1,73,440,214,226
050,51,035,"Virginia","Carroll County",1,74,290,142,148
050,51,035,"Virginia","Carroll County",1,75,293,144,149
050,51,035,"Virginia","Carroll County",1,76,308,143,165
050,51,035,"Virginia","Carroll County",1,77,307,139,168
050,51,035,"Virginia","Carroll County",1,78,277,137,140
050,51,035,"Virginia","Carroll County",1,79,244,122,122
050,51,035,"Virginia","Carroll County",1,80,222,104,118
050,51,035,"Virginia","Carroll County",1,81,186,96,90
050,51,035,"Virginia","Carroll County",1,82,162,71,91
050,51,035,"Virginia","Carroll County",1,83,153,67,86
050,51,035,"Virginia","Carroll County",1,84,147,56,91
050,51,035,"Virginia","Carroll County",1,85,774,278,496
050,51,035,"Virginia","Carroll County",2,0,234,125,109
050,51,035,"Virginia","Carroll County",2,1,236,119,117
050,51,035,"Virginia","Carroll County",2,2,252,119,133
050,51,035,"Virginia","Carroll County",2,3,260,136,124
050,51,035,"Virginia","Carroll County",2,4,279,158,121
050,51,035,"Virginia","Carroll County",2,5,287,149,138
050,51,035,"Virginia","Carroll County",2,6,269,131,138
050,51,035,"Virginia","Carroll County",2,7,271,141,130
050,51,035,"Virginia","Carroll County",2,8,280,144,136
050,51,035,"Virginia","Carroll County",2,9,284,143,141
050,51,035,"Virginia","Carroll County",2,10,303,155,148
050,51,035,"Virginia","Carroll County",2,11,310,162,148
050,51,035,"Virginia","Carroll County",2,12,341,182,159
050,51,035,"Virginia","Carroll County",2,13,336,180,156
050,51,035,"Virginia","Carroll County",2,14,323,164,159
050,51,035,"Virginia","Carroll County",2,15,317,155,162
050,51,035,"Virginia","Carroll County",2,16,319,152,167
050,51,035,"Virginia","Carroll County",2,17,328,159,169
050,51,035,"Virginia","Carroll County",2,18,296,154,142
050,51,035,"Virginia","Carroll County",2,19,234,119,115
050,51,035,"Virginia","Carroll County",2,20,260,135,125
050,51,035,"Virginia","Carroll County",2,21,272,149,123
050,51,035,"Virginia","Carroll County",2,22,268,144,124
050,51,035,"Virginia","Carroll County",2,23,283,151,132
050,51,035,"Virginia","Carroll County",2,24,294,153,141
050,51,035,"Virginia","Carroll County",2,25,276,143,133
050,51,035,"Virginia","Carroll County",2,26,267,131,136
050,51,035,"Virginia","Carroll County",2,27,281,139,142
050,51,035,"Virginia","Carroll County",2,28,285,146,139
050,51,035,"Virginia","Carroll County",2,29,300,139,161
050,51,035,"Virginia","Carroll County",2,30,310,140,170
050,51,035,"Virginia","Carroll County",2,31,304,153,151
050,51,035,"Virginia","Carroll County",2,32,306,155,151
050,51,035,"Virginia","Carroll County",2,33,291,157,134
050,51,035,"Virginia","Carroll County",2,34,298,163,135
050,51,035,"Virginia","Carroll County",2,35,295,152,143
050,51,035,"Virginia","Carroll County",2,36,288,141,147
050,51,035,"Virginia","Carroll County",2,37,298,156,142
050,51,035,"Virginia","Carroll County",2,38,288,149,139
050,51,035,"Virginia","Carroll County",2,39,297,153,144
050,51,035,"Virginia","Carroll County",2,40,298,148,150
050,51,035,"Virginia","Carroll County",2,41,289,147,142
050,51,035,"Virginia","Carroll County",2,42,288,151,137
050,51,035,"Virginia","Carroll County",2,43,323,162,161
050,51,035,"Virginia","Carroll County",2,44,327,162,165
050,51,035,"Virginia","Carroll County",2,45,361,196,165
050,51,035,"Virginia","Carroll County",2,46,360,189,171
050,51,035,"Virginia","Carroll County",2,47,374,183,191
050,51,035,"Virginia","Carroll County",2,48,404,193,211
050,51,035,"Virginia","Carroll County",2,49,415,206,209
050,51,035,"Virginia","Carroll County",2,50,422,212,210
050,51,035,"Virginia","Carroll County",2,51,398,204,194
050,51,035,"Virginia","Carroll County",2,52,405,216,189
050,51,035,"Virginia","Carroll County",2,53,423,217,206
050,51,035,"Virginia","Carroll County",2,54,444,223,221
050,51,035,"Virginia","Carroll County",2,55,445,225,220
050,51,035,"Virginia","Carroll County",2,56,464,232,232
050,51,035,"Virginia","Carroll County",2,57,461,224,237
050,51,035,"Virginia","Carroll County",2,58,493,243,250
050,51,035,"Virginia","Carroll County",2,59,485,244,241
050,51,035,"Virginia","Carroll County",2,60,457,234,223
050,51,035,"Virginia","Carroll County",2,61,473,237,236
050,51,035,"Virginia","Carroll County",2,62,463,226,237
050,51,035,"Virginia","Carroll County",2,63,466,232,234
050,51,035,"Virginia","Carroll County",2,64,447,224,223
050,51,035,"Virginia","Carroll County",2,65,457,225,232
050,51,035,"Virginia","Carroll County",2,66,484,227,257
050,51,035,"Virginia","Carroll County",2,67,490,242,248
050,51,035,"Virginia","Carroll County",2,68,487,243,244
050,51,035,"Virginia","Carroll County",2,69,453,232,221
050,51,035,"Virginia","Carroll County",2,70,414,207,207
050,51,035,"Virginia","Carroll County",2,71,400,197,203
050,51,035,"Virginia","Carroll County",2,72,424,205,219
050,51,035,"Virginia","Carroll County",2,73,460,223,237
050,51,035,"Virginia","Carroll County",2,74,306,149,157
050,51,035,"Virginia","Carroll County",2,75,291,142,149
050,51,035,"Virginia","Carroll County",2,76,300,140,160
050,51,035,"Virginia","Carroll County",2,77,316,144,172
050,51,035,"Virginia","Carroll County",2,78,277,134,143
050,51,035,"Virginia","Carroll County",2,79,246,122,124
050,51,035,"Virginia","Carroll County",2,80,223,106,117
050,51,035,"Virginia","Carroll County",2,81,189,95,94
050,51,035,"Virginia","Carroll County",2,82,165,77,88
050,51,035,"Virginia","Carroll County",2,83,151,67,84
050,51,035,"Virginia","Carroll County",2,84,145,57,88
050,51,035,"Virginia","Carroll County",2,85,765,273,492
050,51,035,"Virginia","Carroll County",3,0,235,124,111
050,51,035,"Virginia","Carroll County",3,1,241,138,103
050,51,035,"Virginia","Carroll County",3,2,240,119,121
050,51,035,"Virginia","Carroll County",3,3,249,112,137
050,51,035,"Virginia","Carroll County",3,4,254,130,124
050,51,035,"Virginia","Carroll County",3,5,287,159,128
050,51,035,"Virginia","Carroll County",3,6,288,145,143
050,51,035,"Virginia","Carroll County",3,7,271,134,137
050,51,035,"Virginia","Carroll County",3,8,270,138,132
050,51,035,"Virginia","Carroll County",3,9,282,146,136
050,51,035,"Virginia","Carroll County",3,10,276,138,138
050,51,035,"Virginia","Carroll County",3,11,297,153,144
050,51,035,"Virginia","Carroll County",3,12,303,161,142
050,51,035,"Virginia","Carroll County",3,13,335,177,158
050,51,035,"Virginia","Carroll County",3,14,336,183,153
050,51,035,"Virginia","Carroll County",3,15,330,170,160
050,51,035,"Virginia","Carroll County",3,16,314,155,159
050,51,035,"Virginia","Carroll County",3,17,312,152,160
050,51,035,"Virginia","Carroll County",3,18,270,133,137
050,51,035,"Virginia","Carroll County",3,19,233,122,111
050,51,035,"Virginia","Carroll County",3,20,251,127,124
050,51,035,"Virginia","Carroll County",3,21,276,144,132
050,51,035,"Virginia","Carroll County",3,22,291,160,131
050,51,035,"Virginia","Carroll County",3,23,278,152,126
050,51,035,"Virginia","Carroll County",3,24,300,160,140
050,51,035,"Virginia","Carroll County",3,25,301,162,139
050,51,035,"Virginia","Carroll County",3,26,286,146,140
050,51,035,"Virginia","Carroll County",3,27,257,122,135
050,51,035,"Virginia","Carroll County",3,28,272,130,142
050,51,035,"Virginia","Carroll County",3,29,300,155,145
050,51,035,"Virginia","Carroll County",3,30,306,148,158
050,51,035,"Virginia","Carroll County",3,31,316,147,169
050,51,035,"Virginia","Carroll County",3,32,315,151,164
050,51,035,"Virginia","Carroll County",3,33,308,156,152
050,51,035,"Virginia","Carroll County",3,34,280,148,132
050,51,035,"Virginia","Carroll County",3,35,293,164,129
050,51,035,"Virginia","Carroll County",3,36,296,156,140
050,51,035,"Virginia","Carroll County",3,37,290,142,148
050,51,035,"Virginia","Carroll County",3,38,300,157,143
050,51,035,"Virginia","Carroll County",3,39,292,154,138
050,51,035,"Virginia","Carroll County",3,40,305,157,148
050,51,035,"Virginia","Carroll County",3,41,300,151,149
050,51,035,"Virginia","Carroll County",3,42,281,140,141
050,51,035,"Virginia","Carroll County",3,43,292,156,136
050,51,035,"Virginia","Carroll County",3,44,321,158,163
050,51,035,"Virginia","Carroll County",3,45,333,159,174
050,51,035,"Virginia","Carroll County",3,46,357,196,161
050,51,035,"Virginia","Carroll County",3,47,349,182,167
050,51,035,"Virginia","Carroll County",3,48,374,182,192
050,51,035,"Virginia","Carroll County",3,49,396,187,209
050,51,035,"Virginia","Carroll County",3,50,418,209,209
050,51,035,"Virginia","Carroll County",3,51,435,221,214
050,51,035,"Virginia","Carroll County",3,52,405,208,197
050,51,035,"Virginia","Carroll County",3,53,405,216,189
050,51,035,"Virginia","Carroll County",3,54,432,222,210
050,51,035,"Virginia","Carroll County",3,55,442,217,225
050,51,035,"Virginia","Carroll County",3,56,452,229,223
050,51,035,"Virginia","Carroll County",3,57,472,237,235
050,51,035,"Virginia","Carroll County",3,58,468,224,244
050,51,035,"Virginia","Carroll County",3,59,486,242,244
050,51,035,"Virginia","Carroll County",3,60,497,246,251
050,51,035,"Virginia","Carroll County",3,61,469,236,233
050,51,035,"Virginia","Carroll County",3,62,475,239,236
050,51,035,"Virginia","Carroll County",3,63,476,234,242
050,51,035,"Virginia","Carroll County",3,64,475,233,242
050,51,035,"Virginia","Carroll County",3,65,448,222,226
050,51,035,"Virginia","Carroll County",3,66,455,227,228
050,51,035,"Virginia","Carroll County",3,67,485,226,259
050,51,035,"Virginia","Carroll County",3,68,488,249,239
050,51,035,"Virginia","Carroll County",3,69,479,236,243
050,51,035,"Virginia","Carroll County",3,70,446,231,215
050,51,035,"Virginia","Carroll County",3,71,404,203,201
050,51,035,"Virginia","Carroll County",3,72,390,190,200
050,51,035,"Virginia","Carroll County",3,73,407,194,213
050,51,035,"Virginia","Carroll County",3,74,441,208,233
050,51,035,"Virginia","Carroll County",3,75,293,145,148
050,51,035,"Virginia","Carroll County",3,76,286,138,148
050,51,035,"Virginia","Carroll County",3,77,286,133,153
050,51,035,"Virginia","Carroll County",3,78,296,133,163
050,51,035,"Virginia","Carroll County",3,79,270,131,139
050,51,035,"Virginia","Carroll County",3,80,235,110,125
050,51,035,"Virginia","Carroll County",3,81,217,102,115
050,51,035,"Virginia","Carroll County",3,82,171,86,85
050,51,035,"Virginia","Carroll County",3,83,149,72,77
050,51,035,"Virginia","Carroll County",3,84,137,59,78
050,51,035,"Virginia","Carroll County",3,85,769,286,483
050,51,035,"Virginia","Carroll County",4,0,258,134,124
050,51,035,"Virginia","Carroll County",4,1,245,131,114
050,51,035,"Virginia","Carroll County",4,2,253,142,111
050,51,035,"Virginia","Carroll County",4,3,238,117,121
050,51,035,"Virginia","Carroll County",4,4,248,117,131
050,51,035,"Virginia","Carroll County",4,5,247,124,123
050,51,035,"Virginia","Carroll County",4,6,286,161,125
050,51,035,"Virginia","Carroll County",4,7,298,149,149
050,51,035,"Virginia","Carroll County",4,8,278,138,140
050,51,035,"Virginia","Carroll County",4,9,283,149,134
050,51,035,"Virginia","Carroll County",4,10,279,139,140
050,51,035,"Virginia","Carroll County",4,11,297,150,147
050,51,035,"Virginia","Carroll County",4,12,304,154,150
050,51,035,"Virginia","Carroll County",4,13,300,160,140
050,51,035,"Virginia","Carroll County",4,14,340,176,164
050,51,035,"Virginia","Carroll County",4,15,338,183,155
050,51,035,"Virginia","Carroll County",4,16,335,166,169
050,51,035,"Virginia","Carroll County",4,17,307,151,156
050,51,035,"Virginia","Carroll County",4,18,271,140,131
050,51,035,"Virginia","Carroll County",4,19,207,101,106
050,51,035,"Virginia","Carroll County",4,20,236,123,113
050,51,035,"Virginia","Carroll County",4,21,253,127,126
050,51,035,"Virginia","Carroll County",4,22,297,153,144
050,51,035,"Virginia","Carroll County",4,23,304,166,138
050,51,035,"Virginia","Carroll County",4,24,295,162,133
050,51,035,"Virginia","Carroll County",4,25,296,159,137
050,51,035,"Virginia","Carroll County",4,26,293,162,131
050,51,035,"Virginia","Carroll County",4,27,281,140,141
050,51,035,"Virginia","Carroll County",4,28,257,123,134
050,51,035,"Virginia","Carroll County",4,29,270,129,141
050,51,035,"Virginia","Carroll County",4,30,298,156,142
050,51,035,"Virginia","Carroll County",4,31,323,150,173
050,51,035,"Virginia","Carroll County",4,32,336,156,180
050,51,035,"Virginia","Carroll County",4,33,324,163,161
050,51,035,"Virginia","Carroll County",4,34,319,164,155
050,51,035,"Virginia","Carroll County",4,35,264,137,127
050,51,035,"Virginia","Carroll County",4,36,283,155,128
050,51,035,"Virginia","Carroll County",4,37,298,157,141
050,51,035,"Virginia","Carroll County",4,38,283,144,139
050,51,035,"Virginia","Carroll County",4,39,296,152,144
050,51,035,"Virginia","Carroll County",4,40,300,153,147
050,51,035,"Virginia","Carroll County",4,41,302,156,146
050,51,035,"Virginia","Carroll County",4,42,302,144,158
050,51,035,"Virginia","Carroll County",4,43,281,141,140
050,51,035,"Virginia","Carroll County",4,44,312,165,147
050,51,035,"Virginia","Carroll County",4,45,337,166,171
050,51,035,"Virginia","Carroll County",4,46,330,157,173
050,51,035,"Virginia","Carroll County",4,47,355,191,164
050,51,035,"Virginia","Carroll County",4,48,360,188,172
050,51,035,"Virginia","Carroll County",4,49,370,180,190
050,51,035,"Virginia","Carroll County",4,50,394,190,204
050,51,035,"Virginia","Carroll County",4,51,412,206,206
050,51,035,"Virginia","Carroll County",4,52,439,221,218
050,51,035,"Virginia","Carroll County",4,53,410,211,199
050,51,035,"Virginia","Carroll County",4,54,419,223,196
050,51,035,"Virginia","Carroll County",4,55,436,220,216
050,51,035,"Virginia","Carroll County",4,56,454,223,231
050,51,035,"Virginia","Carroll County",4,57,457,229,228
050,51,035,"Virginia","Carroll County",4,58,466,232,234
050,51,035,"Virginia","Carroll County",4,59,467,220,247
050,51,035,"Virginia","Carroll County",4,60,491,245,246
050,51,035,"Virginia","Carroll County",4,61,503,245,258
050,51,035,"Virginia","Carroll County",4,62,473,239,234
050,51,035,"Virginia","Carroll County",4,63,482,246,236
050,51,035,"Virginia","Carroll County",4,64,462,229,233
050,51,035,"Virginia","Carroll County",4,65,485,243,242
050,51,035,"Virginia","Carroll County",4,66,449,219,230
050,51,035,"Virginia","Carroll County",4,67,456,225,231
050,51,035,"Virginia","Carroll County",4,68,489,231,258
050,51,035,"Virginia","Carroll County",4,69,474,240,234
050,51,035,"Virginia","Carroll County",4,70,476,237,239
050,51,035,"Virginia","Carroll County",4,71,437,228,209
050,51,035,"Virginia","Carroll County",4,72,397,199,198
050,51,035,"Virginia","Carroll County",4,73,375,186,189
050,51,035,"Virginia","Carroll County",4,74,403,192,211
050,51,035,"Virginia","Carroll County",4,75,418,195,223
050,51,035,"Virginia","Carroll County",4,76,283,139,144
050,51,035,"Virginia","Carroll County",4,77,270,131,139
050,51,035,"Virginia","Carroll County",4,78,270,123,147
050,51,035,"Virginia","Carroll County",4,79,282,131,151
050,51,035,"Virginia","Carroll County",4,80,258,122,136
050,51,035,"Virginia","Carroll County",4,81,227,106,121
050,51,035,"Virginia","Carroll County",4,82,197,93,104
050,51,035,"Virginia","Carroll County",4,83,166,84,82
050,51,035,"Virginia","Carroll County",4,84,126,62,64
050,51,035,"Virginia","Carroll County",4,85,748,280,468
050,51,035,"Virginia","Carroll County",5,0,267,136,131
050,51,035,"Virginia","Carroll County",5,1,271,145,126
050,51,035,"Virginia","Carroll County",5,2,251,132,119
050,51,035,"Virginia","Carroll County",5,3,245,141,104
050,51,035,"Virginia","Carroll County",5,4,250,119,131
050,51,035,"Virginia","Carroll County",5,5,250,119,131
050,51,035,"Virginia","Carroll County",5,6,253,130,123
050,51,035,"Virginia","Carroll County",5,7,280,159,121
050,51,035,"Virginia","Carroll County",5,8,295,142,153
050,51,035,"Virginia","Carroll County",5,9,281,142,139
050,51,035,"Virginia","Carroll County",5,10,300,155,145
050,51,035,"Virginia","Carroll County",5,11,299,150,149
050,51,035,"Virginia","Carroll County",5,12,292,149,143
050,51,035,"Virginia","Carroll County",5,13,309,159,150
050,51,035,"Virginia","Carroll County",5,14,309,166,143
050,51,035,"Virginia","Carroll County",5,15,345,176,169
050,51,035,"Virginia","Carroll County",5,16,341,187,154
050,51,035,"Virginia","Carroll County",5,17,327,157,170
050,51,035,"Virginia","Carroll County",5,18,254,125,129
050,51,035,"Virginia","Carroll County",5,19,214,109,105
050,51,035,"Virginia","Carroll County",5,20,219,106,113
050,51,035,"Virginia","Carroll County",5,21,257,133,124
050,51,035,"Virginia","Carroll County",5,22,278,138,140
050,51,035,"Virginia","Carroll County",5,23,322,161,161
050,51,035,"Virginia","Carroll County",5,24,309,172,137
050,51,035,"Virginia","Carroll County",5,25,308,170,138
050,51,035,"Virginia","Carroll County",5,26,295,155,140
050,51,035,"Virginia","Carroll County",5,27,297,162,135
050,51,035,"Virginia","Carroll County",5,28,291,139,152
050,51,035,"Virginia","Carroll County",5,29,258,127,131
050,51,035,"Virginia","Carroll County",5,30,272,134,138
050,51,035,"Virginia","Carroll County",5,31,304,159,145
050,51,035,"Virginia","Carroll County",5,32,321,153,168
050,51,035,"Virginia","Carroll County",5,33,338,162,176
050,51,035,"Virginia","Carroll County",5,34,317,153,164
050,51,035,"Virginia","Carroll County",5,35,332,170,162
050,51,035,"Virginia","Carroll County",5,36,260,128,132
050,51,035,"Virginia","Carroll County",5,37,292,163,129
050,51,035,"Virginia","Carroll County",5,38,305,159,146
050,51,035,"Virginia","Carroll County",5,39,284,142,142
050,51,035,"Virginia","Carroll County",5,40,297,151,146
050,51,035,"Virginia","Carroll County",5,41,310,163,147
050,51,035,"Virginia","Carroll County",5,42,298,155,143
050,51,035,"Virginia","Carroll County",5,43,314,155,159
050,51,035,"Virginia","Carroll County",5,44,282,143,139
050,51,035,"Virginia","Carroll County",5,45,302,154,148
050,51,035,"Virginia","Carroll County",5,46,337,163,174
050,51,035,"Virginia","Carroll County",5,47,341,166,175
050,51,035,"Virginia","Carroll County",5,48,368,195,173
050,51,035,"Virginia","Carroll County",5,49,372,191,181
050,51,035,"Virginia","Carroll County",5,50,366,179,187
050,51,035,"Virginia","Carroll County",5,51,400,192,208
050,51,035,"Virginia","Carroll County",5,52,419,207,212
050,51,035,"Virginia","Carroll County",5,53,442,218,224
050,51,035,"Virginia","Carroll County",5,54,417,212,205
050,51,035,"Virginia","Carroll County",5,55,417,225,192
050,51,035,"Virginia","Carroll County",5,56,439,226,213
050,51,035,"Virginia","Carroll County",5,57,464,228,236
050,51,035,"Virginia","Carroll County",5,58,462,228,234
050,51,035,"Virginia","Carroll County",5,59,457,224,233
050,51,035,"Virginia","Carroll County",5,60,473,224,249
050,51,035,"Virginia","Carroll County",5,61,494,243,251
050,51,035,"Virginia","Carroll County",5,62,505,241,264
050,51,035,"Virginia","Carroll County",5,63,467,235,232
050,51,035,"Virginia","Carroll County",5,64,485,245,240
050,51,035,"Virginia","Carroll County",5,65,476,240,236
050,51,035,"Virginia","Carroll County",5,66,479,242,237
050,51,035,"Virginia","Carroll County",5,67,445,210,235
050,51,035,"Virginia","Carroll County",5,68,456,228,228
050,51,035,"Virginia","Carroll County",5,69,476,220,256
050,51,035,"Virginia","Carroll County",5,70,472,244,228
050,51,035,"Virginia","Carroll County",5,71,473,237,236
050,51,035,"Virginia","Carroll County",5,72,431,224,207
050,51,035,"Virginia","Carroll County",5,73,385,191,194
050,51,035,"Virginia","Carroll County",5,74,371,184,187
050,51,035,"Virginia","Carroll County",5,75,382,181,201
050,51,035,"Virginia","Carroll County",5,76,406,193,213
050,51,035,"Virginia","Carroll County",5,77,269,134,135
050,51,035,"Virginia","Carroll County",5,78,247,121,126
050,51,035,"Virginia","Carroll County",5,79,257,120,137
050,51,035,"Virginia","Carroll County",5,80,265,117,148
050,51,035,"Virginia","Carroll County",5,81,252,117,135
050,51,035,"Virginia","Carroll County",5,82,209,98,111
050,51,035,"Virginia","Carroll County",5,83,188,92,96
050,51,035,"Virginia","Carroll County",5,84,142,72,70
050,51,035,"Virginia","Carroll County",5,85,738,288,450
050,51,036,"Virginia","Charles City County",1,0,54,28,26
050,51,036,"Virginia","Charles City County",1,1,52,30,22
050,51,036,"Virginia","Charles City County",1,2,55,37,18
050,51,036,"Virginia","Charles City County",1,3,46,20,26
050,51,036,"Virginia","Charles City County",1,4,51,21,30
050,51,036,"Virginia","Charles City County",1,5,60,22,38
050,51,036,"Virginia","Charles City County",1,6,60,33,27
050,51,036,"Virginia","Charles City County",1,7,56,33,23
050,51,036,"Virginia","Charles City County",1,8,49,26,23
050,51,036,"Virginia","Charles City County",1,9,48,22,26
050,51,036,"Virginia","Charles City County",1,10,58,26,32
050,51,036,"Virginia","Charles City County",1,11,50,22,28
050,51,036,"Virginia","Charles City County",1,12,56,22,34
050,51,036,"Virginia","Charles City County",1,13,56,30,26
050,51,036,"Virginia","Charles City County",1,14,62,29,33
050,51,036,"Virginia","Charles City County",1,15,60,33,27
050,51,036,"Virginia","Charles City County",1,16,61,37,24
050,51,036,"Virginia","Charles City County",1,17,67,35,32
050,51,036,"Virginia","Charles City County",1,18,57,31,26
050,51,036,"Virginia","Charles City County",1,19,58,32,26
050,51,036,"Virginia","Charles City County",1,20,59,31,28
050,51,036,"Virginia","Charles City County",1,21,66,35,31
050,51,036,"Virginia","Charles City County",1,22,66,36,30
050,51,036,"Virginia","Charles City County",1,23,70,38,32
050,51,036,"Virginia","Charles City County",1,24,59,28,31
050,51,036,"Virginia","Charles City County",1,25,64,30,34
050,51,036,"Virginia","Charles City County",1,26,78,40,38
050,51,036,"Virginia","Charles City County",1,27,79,40,39
050,51,036,"Virginia","Charles City County",1,28,84,40,44
050,51,036,"Virginia","Charles City County",1,29,76,37,39
050,51,036,"Virginia","Charles City County",1,30,66,31,35
050,51,036,"Virginia","Charles City County",1,31,66,37,29
050,51,036,"Virginia","Charles City County",1,32,65,35,30
050,51,036,"Virginia","Charles City County",1,33,69,34,35
050,51,036,"Virginia","Charles City County",1,34,64,32,32
050,51,036,"Virginia","Charles City County",1,35,65,34,31
050,51,036,"Virginia","Charles City County",1,36,57,30,27
050,51,036,"Virginia","Charles City County",1,37,79,36,43
050,51,036,"Virginia","Charles City County",1,38,70,30,40
050,51,036,"Virginia","Charles City County",1,39,62,28,34
050,51,036,"Virginia","Charles City County",1,40,61,33,28
050,51,036,"Virginia","Charles City County",1,41,52,26,26
050,51,036,"Virginia","Charles City County",1,42,71,34,37
050,51,036,"Virginia","Charles City County",1,43,68,30,38
050,51,036,"Virginia","Charles City County",1,44,57,27,30
050,51,036,"Virginia","Charles City County",1,45,62,32,30
050,51,036,"Virginia","Charles City County",1,46,68,30,38
050,51,036,"Virginia","Charles City County",1,47,82,40,42
050,51,036,"Virginia","Charles City County",1,48,92,46,46
050,51,036,"Virginia","Charles City County",1,49,85,47,38
050,51,036,"Virginia","Charles City County",1,50,92,44,48
050,51,036,"Virginia","Charles City County",1,51,114,58,56
050,51,036,"Virginia","Charles City County",1,52,100,51,49
050,51,036,"Virginia","Charles City County",1,53,101,49,52
050,51,036,"Virginia","Charles City County",1,54,113,55,58
050,51,036,"Virginia","Charles City County",1,55,133,58,75
050,51,036,"Virginia","Charles City County",1,56,140,69,71
050,51,036,"Virginia","Charles City County",1,57,145,75,70
050,51,036,"Virginia","Charles City County",1,58,141,68,73
050,51,036,"Virginia","Charles City County",1,59,142,71,71
050,51,036,"Virginia","Charles City County",1,60,138,69,69
050,51,036,"Virginia","Charles City County",1,61,139,67,72
050,51,036,"Virginia","Charles City County",1,62,130,67,63
050,51,036,"Virginia","Charles City County",1,63,120,57,63
050,51,036,"Virginia","Charles City County",1,64,108,52,56
050,51,036,"Virginia","Charles City County",1,65,118,57,61
050,51,036,"Virginia","Charles City County",1,66,120,58,62
050,51,036,"Virginia","Charles City County",1,67,123,59,64
050,51,036,"Virginia","Charles City County",1,68,113,50,63
050,51,036,"Virginia","Charles City County",1,69,104,44,60
050,51,036,"Virginia","Charles City County",1,70,93,44,49
050,51,036,"Virginia","Charles City County",1,71,110,61,49
050,51,036,"Virginia","Charles City County",1,72,109,58,51
050,51,036,"Virginia","Charles City County",1,73,113,61,52
050,51,036,"Virginia","Charles City County",1,74,68,36,32
050,51,036,"Virginia","Charles City County",1,75,74,36,38
050,51,036,"Virginia","Charles City County",1,76,70,34,36
050,51,036,"Virginia","Charles City County",1,77,75,33,42
050,51,036,"Virginia","Charles City County",1,78,53,22,31
050,51,036,"Virginia","Charles City County",1,79,44,20,24
050,51,036,"Virginia","Charles City County",1,80,42,14,28
050,51,036,"Virginia","Charles City County",1,81,42,18,24
050,51,036,"Virginia","Charles City County",1,82,35,11,24
050,51,036,"Virginia","Charles City County",1,83,34,15,19
050,51,036,"Virginia","Charles City County",1,84,31,15,16
050,51,036,"Virginia","Charles City County",1,85,166,54,112
050,51,036,"Virginia","Charles City County",2,0,58,31,27
050,51,036,"Virginia","Charles City County",2,1,53,30,23
050,51,036,"Virginia","Charles City County",2,2,52,33,19
050,51,036,"Virginia","Charles City County",2,3,47,23,24
050,51,036,"Virginia","Charles City County",2,4,49,20,29
050,51,036,"Virginia","Charles City County",2,5,55,21,34
050,51,036,"Virginia","Charles City County",2,6,62,32,30
050,51,036,"Virginia","Charles City County",2,7,56,32,24
050,51,036,"Virginia","Charles City County",2,8,50,27,23
050,51,036,"Virginia","Charles City County",2,9,47,22,25
050,51,036,"Virginia","Charles City County",2,10,57,27,30
050,51,036,"Virginia","Charles City County",2,11,52,23,29
050,51,036,"Virginia","Charles City County",2,12,55,23,32
050,51,036,"Virginia","Charles City County",2,13,55,28,27
050,51,036,"Virginia","Charles City County",2,14,61,29,32
050,51,036,"Virginia","Charles City County",2,15,62,32,30
050,51,036,"Virginia","Charles City County",2,16,60,36,24
050,51,036,"Virginia","Charles City County",2,17,64,35,29
050,51,036,"Virginia","Charles City County",2,18,58,31,27
050,51,036,"Virginia","Charles City County",2,19,54,29,25
050,51,036,"Virginia","Charles City County",2,20,60,32,28
050,51,036,"Virginia","Charles City County",2,21,64,34,30
050,51,036,"Virginia","Charles City County",2,22,64,34,30
050,51,036,"Virginia","Charles City County",2,23,68,37,31
050,51,036,"Virginia","Charles City County",2,24,61,31,30
050,51,036,"Virginia","Charles City County",2,25,65,31,34
050,51,036,"Virginia","Charles City County",2,26,72,38,34
050,51,036,"Virginia","Charles City County",2,27,80,40,40
050,51,036,"Virginia","Charles City County",2,28,83,39,44
050,51,036,"Virginia","Charles City County",2,29,78,37,41
050,51,036,"Virginia","Charles City County",2,30,66,31,35
050,51,036,"Virginia","Charles City County",2,31,66,36,30
050,51,036,"Virginia","Charles City County",2,32,64,35,29
050,51,036,"Virginia","Charles City County",2,33,68,34,34
050,51,036,"Virginia","Charles City County",2,34,64,31,33
050,51,036,"Virginia","Charles City County",2,35,65,35,30
050,51,036,"Virginia","Charles City County",2,36,58,30,28
050,51,036,"Virginia","Charles City County",2,37,71,33,38
050,51,036,"Virginia","Charles City County",2,38,72,32,40
050,51,036,"Virginia","Charles City County",2,39,65,30,35
050,51,036,"Virginia","Charles City County",2,40,62,31,31
050,51,036,"Virginia","Charles City County",2,41,54,27,27
050,51,036,"Virginia","Charles City County",2,42,68,33,35
050,51,036,"Virginia","Charles City County",2,43,70,31,39
050,51,036,"Virginia","Charles City County",2,44,59,27,32
050,51,036,"Virginia","Charles City County",2,45,63,32,31
050,51,036,"Virginia","Charles City County",2,46,67,30,37
050,51,036,"Virginia","Charles City County",2,47,79,39,40
050,51,036,"Virginia","Charles City County",2,48,90,46,44
050,51,036,"Virginia","Charles City County",2,49,88,47,41
050,51,036,"Virginia","Charles City County",2,50,92,45,47
050,51,036,"Virginia","Charles City County",2,51,108,55,53
050,51,036,"Virginia","Charles City County",2,52,103,53,50
050,51,036,"Virginia","Charles City County",2,53,100,50,50
050,51,036,"Virginia","Charles City County",2,54,109,52,57
050,51,036,"Virginia","Charles City County",2,55,128,57,71
050,51,036,"Virginia","Charles City County",2,56,140,68,72
050,51,036,"Virginia","Charles City County",2,57,144,73,71
050,51,036,"Virginia","Charles City County",2,58,141,69,72
050,51,036,"Virginia","Charles City County",2,59,142,70,72
050,51,036,"Virginia","Charles City County",2,60,137,68,69
050,51,036,"Virginia","Charles City County",2,61,137,67,70
050,51,036,"Virginia","Charles City County",2,62,134,68,66
050,51,036,"Virginia","Charles City County",2,63,123,60,63
050,51,036,"Virginia","Charles City County",2,64,109,52,57
050,51,036,"Virginia","Charles City County",2,65,115,55,60
050,51,036,"Virginia","Charles City County",2,66,119,57,62
050,51,036,"Virginia","Charles City County",2,67,121,58,63
050,51,036,"Virginia","Charles City County",2,68,114,51,63
050,51,036,"Virginia","Charles City County",2,69,107,46,61
050,51,036,"Virginia","Charles City County",2,70,95,45,50
050,51,036,"Virginia","Charles City County",2,71,104,56,48
050,51,036,"Virginia","Charles City County",2,72,108,58,50
050,51,036,"Virginia","Charles City County",2,73,114,62,52
050,51,036,"Virginia","Charles City County",2,74,76,40,36
050,51,036,"Virginia","Charles City County",2,75,72,35,37
050,51,036,"Virginia","Charles City County",2,76,67,33,34
050,51,036,"Virginia","Charles City County",2,77,75,33,42
050,51,036,"Virginia","Charles City County",2,78,55,23,32
050,51,036,"Virginia","Charles City County",2,79,44,21,23
050,51,036,"Virginia","Charles City County",2,80,42,16,26
050,51,036,"Virginia","Charles City County",2,81,40,17,23
050,51,036,"Virginia","Charles City County",2,82,36,12,24
050,51,036,"Virginia","Charles City County",2,83,34,14,20
050,51,036,"Virginia","Charles City County",2,84,32,15,17
050,51,036,"Virginia","Charles City County",2,85,168,56,112
050,51,036,"Virginia","Charles City County",3,0,28,14,14
050,51,036,"Virginia","Charles City County",3,1,54,29,25
050,51,036,"Virginia","Charles City County",3,2,49,27,22
050,51,036,"Virginia","Charles City County",3,3,47,30,17
050,51,036,"Virginia","Charles City County",3,4,49,29,20
050,51,036,"Virginia","Charles City County",3,5,47,22,25
050,51,036,"Virginia","Charles City County",3,6,46,16,30
050,51,036,"Virginia","Charles City County",3,7,59,29,30
050,51,036,"Virginia","Charles City County",3,8,49,25,24
050,51,036,"Virginia","Charles City County",3,9,48,25,23
050,51,036,"Virginia","Charles City County",3,10,50,23,27
050,51,036,"Virginia","Charles City County",3,11,60,27,33
050,51,036,"Virginia","Charles City County",3,12,56,25,31
050,51,036,"Virginia","Charles City County",3,13,53,22,31
050,51,036,"Virginia","Charles City County",3,14,58,29,29
050,51,036,"Virginia","Charles City County",3,15,64,32,32
050,51,036,"Virginia","Charles City County",3,16,61,31,30
050,51,036,"Virginia","Charles City County",3,17,60,38,22
050,51,036,"Virginia","Charles City County",3,18,61,37,24
050,51,036,"Virginia","Charles City County",3,19,46,26,20
050,51,036,"Virginia","Charles City County",3,20,57,29,28
050,51,036,"Virginia","Charles City County",3,21,67,34,33
050,51,036,"Virginia","Charles City County",3,22,65,36,29
050,51,036,"Virginia","Charles City County",3,23,52,29,23
050,51,036,"Virginia","Charles City County",3,24,62,33,29
050,51,036,"Virginia","Charles City County",3,25,61,30,31
050,51,036,"Virginia","Charles City County",3,26,67,29,38
050,51,036,"Virginia","Charles City County",3,27,70,37,33
050,51,036,"Virginia","Charles City County",3,28,76,39,37
050,51,036,"Virginia","Charles City County",3,29,78,38,40
050,51,036,"Virginia","Charles City County",3,30,70,35,35
050,51,036,"Virginia","Charles City County",3,31,62,31,31
050,51,036,"Virginia","Charles City County",3,32,59,35,24
050,51,036,"Virginia","Charles City County",3,33,64,37,27
050,51,036,"Virginia","Charles City County",3,34,58,26,32
050,51,036,"Virginia","Charles City County",3,35,64,32,32
050,51,036,"Virginia","Charles City County",3,36,64,35,29
050,51,036,"Virginia","Charles City County",3,37,58,30,28
050,51,036,"Virginia","Charles City County",3,38,72,37,35
050,51,036,"Virginia","Charles City County",3,39,70,32,38
050,51,036,"Virginia","Charles City County",3,40,71,32,39
050,51,036,"Virginia","Charles City County",3,41,64,34,30
050,51,036,"Virginia","Charles City County",3,42,51,23,28
050,51,036,"Virginia","Charles City County",3,43,66,32,34
050,51,036,"Virginia","Charles City County",3,44,66,30,36
050,51,036,"Virginia","Charles City County",3,45,60,26,34
050,51,036,"Virginia","Charles City County",3,46,66,31,35
050,51,036,"Virginia","Charles City County",3,47,67,28,39
050,51,036,"Virginia","Charles City County",3,48,81,40,41
050,51,036,"Virginia","Charles City County",3,49,91,47,44
050,51,036,"Virginia","Charles City County",3,50,89,50,39
050,51,036,"Virginia","Charles City County",3,51,92,47,45
050,51,036,"Virginia","Charles City County",3,52,117,56,61
050,51,036,"Virginia","Charles City County",3,53,100,49,51
050,51,036,"Virginia","Charles City County",3,54,109,53,56
050,51,036,"Virginia","Charles City County",3,55,115,54,61
050,51,036,"Virginia","Charles City County",3,56,127,59,68
050,51,036,"Virginia","Charles City County",3,57,140,71,69
050,51,036,"Virginia","Charles City County",3,58,143,72,71
050,51,036,"Virginia","Charles City County",3,59,138,67,71
050,51,036,"Virginia","Charles City County",3,60,139,70,69
050,51,036,"Virginia","Charles City County",3,61,137,68,69
050,51,036,"Virginia","Charles City County",3,62,130,62,68
050,51,036,"Virginia","Charles City County",3,63,133,66,67
050,51,036,"Virginia","Charles City County",3,64,115,56,59
050,51,036,"Virginia","Charles City County",3,65,107,51,56
050,51,036,"Virginia","Charles City County",3,66,116,58,58
050,51,036,"Virginia","Charles City County",3,67,118,58,60
050,51,036,"Virginia","Charles City County",3,68,121,59,62
050,51,036,"Virginia","Charles City County",3,69,107,47,60
050,51,036,"Virginia","Charles City County",3,70,106,44,62
050,51,036,"Virginia","Charles City County",3,71,94,44,50
050,51,036,"Virginia","Charles City County",3,72,102,55,47
050,51,036,"Virginia","Charles City County",3,73,106,55,51
050,51,036,"Virginia","Charles City County",3,74,108,61,47
050,51,036,"Virginia","Charles City County",3,75,70,38,32
050,51,036,"Virginia","Charles City County",3,76,68,32,36
050,51,036,"Virginia","Charles City County",3,77,63,31,32
050,51,036,"Virginia","Charles City County",3,78,72,33,39
050,51,036,"Virginia","Charles City County",3,79,53,21,32
050,51,036,"Virginia","Charles City County",3,80,42,19,23
050,51,036,"Virginia","Charles City County",3,81,42,16,26
050,51,036,"Virginia","Charles City County",3,82,38,15,23
050,51,036,"Virginia","Charles City County",3,83,34,13,21
050,51,036,"Virginia","Charles City County",3,84,33,14,19
050,51,036,"Virginia","Charles City County",3,85,160,53,107
050,51,036,"Virginia","Charles City County",4,0,37,19,18
050,51,036,"Virginia","Charles City County",4,1,26,14,12
050,51,036,"Virginia","Charles City County",4,2,53,30,23
050,51,036,"Virginia","Charles City County",4,3,54,36,18
050,51,036,"Virginia","Charles City County",4,4,51,30,21
050,51,036,"Virginia","Charles City County",4,5,53,32,21
050,51,036,"Virginia","Charles City County",4,6,52,25,27
050,51,036,"Virginia","Charles City County",4,7,47,16,31
050,51,036,"Virginia","Charles City County",4,8,60,30,30
050,51,036,"Virginia","Charles City County",4,9,51,28,23
050,51,036,"Virginia","Charles City County",4,10,50,27,23
050,51,036,"Virginia","Charles City County",4,11,52,24,28
050,51,036,"Virginia","Charles City County",4,12,64,31,33
050,51,036,"Virginia","Charles City County",4,13,56,25,31
050,51,036,"Virginia","Charles City County",4,14,53,22,31
050,51,036,"Virginia","Charles City County",4,15,56,31,25
050,51,036,"Virginia","Charles City County",4,16,59,29,30
050,51,036,"Virginia","Charles City County",4,17,61,31,30
050,51,036,"Virginia","Charles City County",4,18,58,32,26
050,51,036,"Virginia","Charles City County",4,19,54,31,23
050,51,036,"Virginia","Charles City County",4,20,45,24,21
050,51,036,"Virginia","Charles City County",4,21,59,29,30
050,51,036,"Virginia","Charles City County",4,22,70,38,32
050,51,036,"Virginia","Charles City County",4,23,68,38,30
050,51,036,"Virginia","Charles City County",4,24,52,30,22
050,51,036,"Virginia","Charles City County",4,25,75,40,35
050,51,036,"Virginia","Charles City County",4,26,70,34,36
050,51,036,"Virginia","Charles City County",4,27,66,26,40
050,51,036,"Virginia","Charles City County",4,28,72,40,32
050,51,036,"Virginia","Charles City County",4,29,78,39,39
050,51,036,"Virginia","Charles City County",4,30,67,35,32
050,51,036,"Virginia","Charles City County",4,31,81,41,40
050,51,036,"Virginia","Charles City County",4,32,67,34,33
050,51,036,"Virginia","Charles City County",4,33,61,37,24
050,51,036,"Virginia","Charles City County",4,34,67,38,29
050,51,036,"Virginia","Charles City County",4,35,57,25,32
050,51,036,"Virginia","Charles City County",4,36,62,31,31
050,51,036,"Virginia","Charles City County",4,37,62,37,25
050,51,036,"Virginia","Charles City County",4,38,48,22,26
050,51,036,"Virginia","Charles City County",4,39,73,38,35
050,51,036,"Virginia","Charles City County",4,40,68,32,36
050,51,036,"Virginia","Charles City County",4,41,73,35,38
050,51,036,"Virginia","Charles City County",4,42,66,32,34
050,51,036,"Virginia","Charles City County",4,43,51,22,29
050,51,036,"Virginia","Charles City County",4,44,67,34,33
050,51,036,"Virginia","Charles City County",4,45,62,28,34
050,51,036,"Virginia","Charles City County",4,46,57,24,33
050,51,036,"Virginia","Charles City County",4,47,62,31,31
050,51,036,"Virginia","Charles City County",4,48,66,28,38
050,51,036,"Virginia","Charles City County",4,49,83,40,43
050,51,036,"Virginia","Charles City County",4,50,94,46,48
050,51,036,"Virginia","Charles City County",4,51,88,48,40
050,51,036,"Virginia","Charles City County",4,52,95,50,45
050,51,036,"Virginia","Charles City County",4,53,110,52,58
050,51,036,"Virginia","Charles City County",4,54,102,50,52
050,51,036,"Virginia","Charles City County",4,55,109,54,55
050,51,036,"Virginia","Charles City County",4,56,117,57,60
050,51,036,"Virginia","Charles City County",4,57,129,57,72
050,51,036,"Virginia","Charles City County",4,58,136,71,65
050,51,036,"Virginia","Charles City County",4,59,141,70,71
050,51,036,"Virginia","Charles City County",4,60,134,67,67
050,51,036,"Virginia","Charles City County",4,61,140,71,69
050,51,036,"Virginia","Charles City County",4,62,143,70,73
050,51,036,"Virginia","Charles City County",4,63,129,62,67
050,51,036,"Virginia","Charles City County",4,64,127,64,63
050,51,036,"Virginia","Charles City County",4,65,123,61,62
050,51,036,"Virginia","Charles City County",4,66,104,51,53
050,51,036,"Virginia","Charles City County",4,67,116,57,59
050,51,036,"Virginia","Charles City County",4,68,119,59,60
050,51,036,"Virginia","Charles City County",4,69,113,56,57
050,51,036,"Virginia","Charles City County",4,70,102,45,57
050,51,036,"Virginia","Charles City County",4,71,107,44,63
050,51,036,"Virginia","Charles City County",4,72,89,42,47
050,51,036,"Virginia","Charles City County",4,73,100,54,46
050,51,036,"Virginia","Charles City County",4,74,100,54,46
050,51,036,"Virginia","Charles City County",4,75,105,59,46
050,51,036,"Virginia","Charles City County",4,76,67,35,32
050,51,036,"Virginia","Charles City County",4,77,66,30,36
050,51,036,"Virginia","Charles City County",4,78,58,29,29
050,51,036,"Virginia","Charles City County",4,79,67,31,36
050,51,036,"Virginia","Charles City County",4,80,49,18,31
050,51,036,"Virginia","Charles City County",4,81,37,15,22
050,51,036,"Virginia","Charles City County",4,82,39,15,24
050,51,036,"Virginia","Charles City County",4,83,34,14,20
050,51,036,"Virginia","Charles City County",4,84,28,11,17
050,51,036,"Virginia","Charles City County",4,85,149,47,102
050,51,036,"Virginia","Charles City County",5,0,37,19,18
050,51,036,"Virginia","Charles City County",5,1,42,21,21
050,51,036,"Virginia","Charles City County",5,2,40,25,15
050,51,036,"Virginia","Charles City County",5,3,59,34,25
050,51,036,"Virginia","Charles City County",5,4,58,35,23
050,51,036,"Virginia","Charles City County",5,5,57,29,28
050,51,036,"Virginia","Charles City County",5,6,53,30,23
050,51,036,"Virginia","Charles City County",5,7,48,21,27
050,51,036,"Virginia","Charles City County",5,8,44,16,28
050,51,036,"Virginia","Charles City County",5,9,58,27,31
050,51,036,"Virginia","Charles City County",5,10,50,30,20
050,51,036,"Virginia","Charles City County",5,11,55,32,23
050,51,036,"Virginia","Charles City County",5,12,55,25,30
050,51,036,"Virginia","Charles City County",5,13,60,30,30
050,51,036,"Virginia","Charles City County",5,14,52,23,29
050,51,036,"Virginia","Charles City County",5,15,57,28,29
050,51,036,"Virginia","Charles City County",5,16,61,32,29
050,51,036,"Virginia","Charles City County",5,17,67,37,30
050,51,036,"Virginia","Charles City County",5,18,58,32,26
050,51,036,"Virginia","Charles City County",5,19,48,26,22
050,51,036,"Virginia","Charles City County",5,20,52,30,22
050,51,036,"Virginia","Charles City County",5,21,50,28,22
050,51,036,"Virginia","Charles City County",5,22,57,32,25
050,51,036,"Virginia","Charles City County",5,23,76,42,34
050,51,036,"Virginia","Charles City County",5,24,67,38,29
050,51,036,"Virginia","Charles City County",5,25,58,31,27
050,51,036,"Virginia","Charles City County",5,26,74,40,34
050,51,036,"Virginia","Charles City County",5,27,76,40,36
050,51,036,"Virginia","Charles City County",5,28,71,30,41
050,51,036,"Virginia","Charles City County",5,29,73,40,33
050,51,036,"Virginia","Charles City County",5,30,81,39,42
050,51,036,"Virginia","Charles City County",5,31,73,41,32
050,51,036,"Virginia","Charles City County",5,32,85,44,41
050,51,036,"Virginia","Charles City County",5,33,67,35,32
050,51,036,"Virginia","Charles City County",5,34,63,37,26
050,51,036,"Virginia","Charles City County",5,35,67,38,29
050,51,036,"Virginia","Charles City County",5,36,59,28,31
050,51,036,"Virginia","Charles City County",5,37,62,29,33
050,51,036,"Virginia","Charles City County",5,38,67,40,27
050,51,036,"Virginia","Charles City County",5,39,50,23,27
050,51,036,"Virginia","Charles City County",5,40,73,37,36
050,51,036,"Virginia","Charles City County",5,41,66,33,33
050,51,036,"Virginia","Charles City County",5,42,76,36,40
050,51,036,"Virginia","Charles City County",5,43,62,31,31
050,51,036,"Virginia","Charles City County",5,44,59,27,32
050,51,036,"Virginia","Charles City County",5,45,62,31,31
050,51,036,"Virginia","Charles City County",5,46,64,31,33
050,51,036,"Virginia","Charles City County",5,47,57,25,32
050,51,036,"Virginia","Charles City County",5,48,60,28,32
050,51,036,"Virginia","Charles City County",5,49,71,32,39
050,51,036,"Virginia","Charles City County",5,50,88,42,46
050,51,036,"Virginia","Charles City County",5,51,91,43,48
050,51,036,"Virginia","Charles City County",5,52,92,48,44
050,51,036,"Virginia","Charles City County",5,53,94,48,46
050,51,036,"Virginia","Charles City County",5,54,111,55,56
050,51,036,"Virginia","Charles City County",5,55,100,50,50
050,51,036,"Virginia","Charles City County",5,56,109,53,56
050,51,036,"Virginia","Charles City County",5,57,119,56,63
050,51,036,"Virginia","Charles City County",5,58,132,59,73
050,51,036,"Virginia","Charles City County",5,59,144,74,70
050,51,036,"Virginia","Charles City County",5,60,137,66,71
050,51,036,"Virginia","Charles City County",5,61,131,65,66
050,51,036,"Virginia","Charles City County",5,62,141,70,71
050,51,036,"Virginia","Charles City County",5,63,147,72,75
050,51,036,"Virginia","Charles City County",5,64,128,62,66
050,51,036,"Virginia","Charles City County",5,65,129,67,62
050,51,036,"Virginia","Charles City County",5,66,126,65,61
050,51,036,"Virginia","Charles City County",5,67,105,52,53
050,51,036,"Virginia","Charles City County",5,68,116,57,59
050,51,036,"Virginia","Charles City County",5,69,103,49,54
050,51,036,"Virginia","Charles City County",5,70,112,56,56
050,51,036,"Virginia","Charles City County",5,71,99,42,57
050,51,036,"Virginia","Charles City County",5,72,106,43,63
050,51,036,"Virginia","Charles City County",5,73,89,42,47
050,51,036,"Virginia","Charles City County",5,74,94,53,41
050,51,036,"Virginia","Charles City County",5,75,98,54,44
050,51,036,"Virginia","Charles City County",5,76,104,58,46
050,51,036,"Virginia","Charles City County",5,77,63,33,30
050,51,036,"Virginia","Charles City County",5,78,59,27,32
050,51,036,"Virginia","Charles City County",5,79,55,27,28
050,51,036,"Virginia","Charles City County",5,80,62,28,34
050,51,036,"Virginia","Charles City County",5,81,42,14,28
050,51,036,"Virginia","Charles City County",5,82,35,14,21
050,51,036,"Virginia","Charles City County",5,83,36,14,22
050,51,036,"Virginia","Charles City County",5,84,34,14,20
050,51,036,"Virginia","Charles City County",5,85,142,41,101
050,51,037,"Virginia","Charlotte County",1,0,129,68,61
050,51,037,"Virginia","Charlotte County",1,1,120,58,62
050,51,037,"Virginia","Charlotte County",1,2,129,71,58
050,51,037,"Virginia","Charlotte County",1,3,132,74,58
050,51,037,"Virginia","Charlotte County",1,4,127,72,55
050,51,037,"Virginia","Charlotte County",1,5,150,83,67
050,51,037,"Virginia","Charlotte County",1,6,130,61,69
050,51,037,"Virginia","Charlotte County",1,7,144,78,66
050,51,037,"Virginia","Charlotte County",1,8,126,66,60
050,51,037,"Virginia","Charlotte County",1,9,127,69,58
050,51,037,"Virginia","Charlotte County",1,10,134,79,55
050,51,037,"Virginia","Charlotte County",1,11,157,82,75
050,51,037,"Virginia","Charlotte County",1,12,141,72,69
050,51,037,"Virginia","Charlotte County",1,13,132,63,69
050,51,037,"Virginia","Charlotte County",1,14,142,76,66
050,51,037,"Virginia","Charlotte County",1,15,157,80,77
050,51,037,"Virginia","Charlotte County",1,16,151,75,76
050,51,037,"Virginia","Charlotte County",1,17,128,66,62
050,51,037,"Virginia","Charlotte County",1,18,128,62,66
050,51,037,"Virginia","Charlotte County",1,19,102,58,44
050,51,037,"Virginia","Charlotte County",1,20,119,62,57
050,51,037,"Virginia","Charlotte County",1,21,114,63,51
050,51,037,"Virginia","Charlotte County",1,22,123,60,63
050,51,037,"Virginia","Charlotte County",1,23,132,67,65
050,51,037,"Virginia","Charlotte County",1,24,108,61,47
050,51,037,"Virginia","Charlotte County",1,25,126,68,58
050,51,037,"Virginia","Charlotte County",1,26,124,64,60
050,51,037,"Virginia","Charlotte County",1,27,135,70,65
050,51,037,"Virginia","Charlotte County",1,28,125,67,58
050,51,037,"Virginia","Charlotte County",1,29,116,55,61
050,51,037,"Virginia","Charlotte County",1,30,111,58,53
050,51,037,"Virginia","Charlotte County",1,31,112,56,56
050,51,037,"Virginia","Charlotte County",1,32,116,62,54
050,51,037,"Virginia","Charlotte County",1,33,117,69,48
050,51,037,"Virginia","Charlotte County",1,34,116,49,67
050,51,037,"Virginia","Charlotte County",1,35,110,53,57
050,51,037,"Virginia","Charlotte County",1,36,108,51,57
050,51,037,"Virginia","Charlotte County",1,37,110,55,55
050,51,037,"Virginia","Charlotte County",1,38,116,61,55
050,51,037,"Virginia","Charlotte County",1,39,115,54,61
050,51,037,"Virginia","Charlotte County",1,40,108,50,58
050,51,037,"Virginia","Charlotte County",1,41,123,66,57
050,51,037,"Virginia","Charlotte County",1,42,123,64,59
050,51,037,"Virginia","Charlotte County",1,43,117,54,63
050,51,037,"Virginia","Charlotte County",1,44,123,58,65
050,51,037,"Virginia","Charlotte County",1,45,121,60,61
050,51,037,"Virginia","Charlotte County",1,46,119,49,70
050,51,037,"Virginia","Charlotte County",1,47,128,60,68
050,51,037,"Virginia","Charlotte County",1,48,138,69,69
050,51,037,"Virginia","Charlotte County",1,49,167,77,90
050,51,037,"Virginia","Charlotte County",1,50,147,81,66
050,51,037,"Virginia","Charlotte County",1,51,138,68,70
050,51,037,"Virginia","Charlotte County",1,52,150,78,72
050,51,037,"Virginia","Charlotte County",1,53,165,79,86
050,51,037,"Virginia","Charlotte County",1,54,156,68,88
050,51,037,"Virginia","Charlotte County",1,55,174,84,90
050,51,037,"Virginia","Charlotte County",1,56,188,101,87
050,51,037,"Virginia","Charlotte County",1,57,190,96,94
050,51,037,"Virginia","Charlotte County",1,58,197,109,88
050,51,037,"Virginia","Charlotte County",1,59,199,104,95
050,51,037,"Virginia","Charlotte County",1,60,193,101,92
050,51,037,"Virginia","Charlotte County",1,61,203,102,101
050,51,037,"Virginia","Charlotte County",1,62,200,93,107
050,51,037,"Virginia","Charlotte County",1,63,193,91,102
050,51,037,"Virginia","Charlotte County",1,64,181,90,91
050,51,037,"Virginia","Charlotte County",1,65,173,86,87
050,51,037,"Virginia","Charlotte County",1,66,155,75,80
050,51,037,"Virginia","Charlotte County",1,67,151,70,81
050,51,037,"Virginia","Charlotte County",1,68,156,76,80
050,51,037,"Virginia","Charlotte County",1,69,129,61,68
050,51,037,"Virginia","Charlotte County",1,70,153,76,77
050,51,037,"Virginia","Charlotte County",1,71,146,67,79
050,51,037,"Virginia","Charlotte County",1,72,148,74,74
050,51,037,"Virginia","Charlotte County",1,73,151,74,77
050,51,037,"Virginia","Charlotte County",1,74,98,52,46
050,51,037,"Virginia","Charlotte County",1,75,99,41,58
050,51,037,"Virginia","Charlotte County",1,76,110,57,53
050,51,037,"Virginia","Charlotte County",1,77,112,60,52
050,51,037,"Virginia","Charlotte County",1,78,97,48,49
050,51,037,"Virginia","Charlotte County",1,79,76,35,41
050,51,037,"Virginia","Charlotte County",1,80,78,29,49
050,51,037,"Virginia","Charlotte County",1,81,70,27,43
050,51,037,"Virginia","Charlotte County",1,82,56,26,30
050,51,037,"Virginia","Charlotte County",1,83,48,27,21
050,51,037,"Virginia","Charlotte County",1,84,57,25,32
050,51,037,"Virginia","Charlotte County",1,85,290,82,208
050,51,037,"Virginia","Charlotte County",2,0,140,66,74
050,51,037,"Virginia","Charlotte County",2,1,121,60,61
050,51,037,"Virginia","Charlotte County",2,2,127,68,59
050,51,037,"Virginia","Charlotte County",2,3,132,74,58
050,51,037,"Virginia","Charlotte County",2,4,131,74,57
050,51,037,"Virginia","Charlotte County",2,5,144,81,63
050,51,037,"Virginia","Charlotte County",2,6,136,68,68
050,51,037,"Virginia","Charlotte County",2,7,140,75,65
050,51,037,"Virginia","Charlotte County",2,8,130,68,62
050,51,037,"Virginia","Charlotte County",2,9,127,69,58
050,51,037,"Virginia","Charlotte County",2,10,135,78,57
050,51,037,"Virginia","Charlotte County",2,11,150,80,70
050,51,037,"Virginia","Charlotte County",2,12,144,73,71
050,51,037,"Virginia","Charlotte County",2,13,134,65,69
050,51,037,"Virginia","Charlotte County",2,14,139,72,67
050,51,037,"Virginia","Charlotte County",2,15,155,80,75
050,51,037,"Virginia","Charlotte County",2,16,152,76,76
050,51,037,"Virginia","Charlotte County",2,17,134,68,66
050,51,037,"Virginia","Charlotte County",2,18,120,60,60
050,51,037,"Virginia","Charlotte County",2,19,102,54,48
050,51,037,"Virginia","Charlotte County",2,20,117,62,55
050,51,037,"Virginia","Charlotte County",2,21,116,62,54
050,51,037,"Virginia","Charlotte County",2,22,123,61,62
050,51,037,"Virginia","Charlotte County",2,23,129,66,63
050,51,037,"Virginia","Charlotte County",2,24,114,64,50
050,51,037,"Virginia","Charlotte County",2,25,124,68,56
050,51,037,"Virginia","Charlotte County",2,26,125,65,60
050,51,037,"Virginia","Charlotte County",2,27,132,68,64
050,51,037,"Virginia","Charlotte County",2,28,127,66,61
050,51,037,"Virginia","Charlotte County",2,29,117,58,59
050,51,037,"Virginia","Charlotte County",2,30,114,57,57
050,51,037,"Virginia","Charlotte County",2,31,111,55,56
050,51,037,"Virginia","Charlotte County",2,32,113,61,52
050,51,037,"Virginia","Charlotte County",2,33,116,67,49
050,51,037,"Virginia","Charlotte County",2,34,115,54,61
050,51,037,"Virginia","Charlotte County",2,35,114,53,61
050,51,037,"Virginia","Charlotte County",2,36,109,51,58
050,51,037,"Virginia","Charlotte County",2,37,110,55,55
050,51,037,"Virginia","Charlotte County",2,38,115,59,56
050,51,037,"Virginia","Charlotte County",2,39,115,56,59
050,51,037,"Virginia","Charlotte County",2,40,111,52,59
050,51,037,"Virginia","Charlotte County",2,41,119,63,56
050,51,037,"Virginia","Charlotte County",2,42,120,63,57
050,51,037,"Virginia","Charlotte County",2,43,122,59,63
050,51,037,"Virginia","Charlotte County",2,44,121,57,64
050,51,037,"Virginia","Charlotte County",2,45,123,60,63
050,51,037,"Virginia","Charlotte County",2,46,117,50,67
050,51,037,"Virginia","Charlotte County",2,47,127,58,69
050,51,037,"Virginia","Charlotte County",2,48,136,66,70
050,51,037,"Virginia","Charlotte County",2,49,161,76,85
050,51,037,"Virginia","Charlotte County",2,50,151,80,71
050,51,037,"Virginia","Charlotte County",2,51,139,71,68
050,51,037,"Virginia","Charlotte County",2,52,148,77,71
050,51,037,"Virginia","Charlotte County",2,53,160,78,82
050,51,037,"Virginia","Charlotte County",2,54,157,69,88
050,51,037,"Virginia","Charlotte County",2,55,171,80,91
050,51,037,"Virginia","Charlotte County",2,56,185,97,88
050,51,037,"Virginia","Charlotte County",2,57,191,99,92
050,51,037,"Virginia","Charlotte County",2,58,197,108,89
050,51,037,"Virginia","Charlotte County",2,59,199,106,93
050,51,037,"Virginia","Charlotte County",2,60,196,103,93
050,51,037,"Virginia","Charlotte County",2,61,202,102,100
050,51,037,"Virginia","Charlotte County",2,62,199,94,105
050,51,037,"Virginia","Charlotte County",2,63,197,93,104
050,51,037,"Virginia","Charlotte County",2,64,182,89,93
050,51,037,"Virginia","Charlotte County",2,65,174,87,87
050,51,037,"Virginia","Charlotte County",2,66,159,76,83
050,51,037,"Virginia","Charlotte County",2,67,151,71,80
050,51,037,"Virginia","Charlotte County",2,68,154,74,80
050,51,037,"Virginia","Charlotte County",2,69,136,65,71
050,51,037,"Virginia","Charlotte County",2,70,147,72,75
050,51,037,"Virginia","Charlotte County",2,71,146,68,78
050,51,037,"Virginia","Charlotte County",2,72,145,71,74
050,51,037,"Virginia","Charlotte County",2,73,154,75,79
050,51,037,"Virginia","Charlotte County",2,74,106,55,51
050,51,037,"Virginia","Charlotte County",2,75,97,41,56
050,51,037,"Virginia","Charlotte County",2,76,103,51,52
050,51,037,"Virginia","Charlotte County",2,77,111,57,54
050,51,037,"Virginia","Charlotte County",2,78,101,51,50
050,51,037,"Virginia","Charlotte County",2,79,76,35,41
050,51,037,"Virginia","Charlotte County",2,80,78,31,47
050,51,037,"Virginia","Charlotte County",2,81,69,27,42
050,51,037,"Virginia","Charlotte County",2,82,59,26,33
050,51,037,"Virginia","Charlotte County",2,83,49,25,24
050,51,037,"Virginia","Charlotte County",2,84,51,23,28
050,51,037,"Virginia","Charlotte County",2,85,296,87,209
050,51,037,"Virginia","Charlotte County",3,0,151,85,66
050,51,037,"Virginia","Charlotte County",3,1,143,61,82
050,51,037,"Virginia","Charlotte County",3,2,112,58,54
050,51,037,"Virginia","Charlotte County",3,3,124,61,63
050,51,037,"Virginia","Charlotte County",3,4,132,75,57
050,51,037,"Virginia","Charlotte County",3,5,134,68,66
050,51,037,"Virginia","Charlotte County",3,6,148,79,69
050,51,037,"Virginia","Charlotte County",3,7,130,64,66
050,51,037,"Virginia","Charlotte County",3,8,141,80,61
050,51,037,"Virginia","Charlotte County",3,9,135,68,67
050,51,037,"Virginia","Charlotte County",3,10,125,69,56
050,51,037,"Virginia","Charlotte County",3,11,144,83,61
050,51,037,"Virginia","Charlotte County",3,12,152,80,72
050,51,037,"Virginia","Charlotte County",3,13,140,72,68
050,51,037,"Virginia","Charlotte County",3,14,128,64,64
050,51,037,"Virginia","Charlotte County",3,15,136,69,67
050,51,037,"Virginia","Charlotte County",3,16,154,78,76
050,51,037,"Virginia","Charlotte County",3,17,159,83,76
050,51,037,"Virginia","Charlotte County",3,18,119,63,56
050,51,037,"Virginia","Charlotte County",3,19,108,55,53
050,51,037,"Virginia","Charlotte County",3,20,112,61,51
050,51,037,"Virginia","Charlotte County",3,21,121,60,61
050,51,037,"Virginia","Charlotte County",3,22,127,69,58
050,51,037,"Virginia","Charlotte County",3,23,115,54,61
050,51,037,"Virginia","Charlotte County",3,24,130,69,61
050,51,037,"Virginia","Charlotte County",3,25,119,72,47
050,51,037,"Virginia","Charlotte County",3,26,123,66,57
050,51,037,"Virginia","Charlotte County",3,27,132,71,61
050,51,037,"Virginia","Charlotte County",3,28,129,66,63
050,51,037,"Virginia","Charlotte County",3,29,121,66,55
050,51,037,"Virginia","Charlotte County",3,30,120,60,60
050,51,037,"Virginia","Charlotte County",3,31,116,56,60
050,51,037,"Virginia","Charlotte County",3,32,115,57,58
050,51,037,"Virginia","Charlotte County",3,33,119,65,54
050,51,037,"Virginia","Charlotte County",3,34,112,62,50
050,51,037,"Virginia","Charlotte County",3,35,120,58,62
050,51,037,"Virginia","Charlotte County",3,36,118,52,66
050,51,037,"Virginia","Charlotte County",3,37,101,47,54
050,51,037,"Virginia","Charlotte County",3,38,106,52,54
050,51,037,"Virginia","Charlotte County",3,39,115,59,56
050,51,037,"Virginia","Charlotte County",3,40,113,55,58
050,51,037,"Virginia","Charlotte County",3,41,112,53,59
050,51,037,"Virginia","Charlotte County",3,42,119,64,55
050,51,037,"Virginia","Charlotte County",3,43,118,63,55
050,51,037,"Virginia","Charlotte County",3,44,123,58,65
050,51,037,"Virginia","Charlotte County",3,45,117,53,64
050,51,037,"Virginia","Charlotte County",3,46,122,58,64
050,51,037,"Virginia","Charlotte County",3,47,116,53,63
050,51,037,"Virginia","Charlotte County",3,48,123,58,65
050,51,037,"Virginia","Charlotte County",3,49,134,63,71
050,51,037,"Virginia","Charlotte County",3,50,157,74,83
050,51,037,"Virginia","Charlotte County",3,51,150,74,76
050,51,037,"Virginia","Charlotte County",3,52,143,77,66
050,51,037,"Virginia","Charlotte County",3,53,150,77,73
050,51,037,"Virginia","Charlotte County",3,54,163,81,82
050,51,037,"Virginia","Charlotte County",3,55,158,69,89
050,51,037,"Virginia","Charlotte County",3,56,175,80,95
050,51,037,"Virginia","Charlotte County",3,57,192,102,90
050,51,037,"Virginia","Charlotte County",3,58,188,98,90
050,51,037,"Virginia","Charlotte County",3,59,200,107,93
050,51,037,"Virginia","Charlotte County",3,60,200,108,92
050,51,037,"Virginia","Charlotte County",3,61,190,98,92
050,51,037,"Virginia","Charlotte County",3,62,192,95,97
050,51,037,"Virginia","Charlotte County",3,63,194,93,101
050,51,037,"Virginia","Charlotte County",3,64,188,88,100
050,51,037,"Virginia","Charlotte County",3,65,177,86,91
050,51,037,"Virginia","Charlotte County",3,66,173,86,87
050,51,037,"Virginia","Charlotte County",3,67,155,73,82
050,51,037,"Virginia","Charlotte County",3,68,152,70,82
050,51,037,"Virginia","Charlotte County",3,69,151,74,77
050,51,037,"Virginia","Charlotte County",3,70,135,62,73
050,51,037,"Virginia","Charlotte County",3,71,144,66,78
050,51,037,"Virginia","Charlotte County",3,72,139,67,72
050,51,037,"Virginia","Charlotte County",3,73,136,66,70
050,51,037,"Virginia","Charlotte County",3,74,154,77,77
050,51,037,"Virginia","Charlotte County",3,75,98,47,51
050,51,037,"Virginia","Charlotte County",3,76,91,39,52
050,51,037,"Virginia","Charlotte County",3,77,96,47,49
050,51,037,"Virginia","Charlotte County",3,78,110,55,55
050,51,037,"Virginia","Charlotte County",3,79,87,46,41
050,51,037,"Virginia","Charlotte County",3,80,72,31,41
050,51,037,"Virginia","Charlotte County",3,81,73,30,43
050,51,037,"Virginia","Charlotte County",3,82,60,20,40
050,51,037,"Virginia","Charlotte County",3,83,54,26,28
050,51,037,"Virginia","Charlotte County",3,84,43,21,22
050,51,037,"Virginia","Charlotte County",3,85,276,76,200
050,51,037,"Virginia","Charlotte County",4,0,146,81,65
050,51,037,"Virginia","Charlotte County",4,1,144,81,63
050,51,037,"Virginia","Charlotte County",4,2,136,58,78
050,51,037,"Virginia","Charlotte County",4,3,112,57,55
050,51,037,"Virginia","Charlotte County",4,4,130,63,67
050,51,037,"Virginia","Charlotte County",4,5,140,78,62
050,51,037,"Virginia","Charlotte County",4,6,133,71,62
050,51,037,"Virginia","Charlotte County",4,7,146,80,66
050,51,037,"Virginia","Charlotte County",4,8,127,68,59
050,51,037,"Virginia","Charlotte County",4,9,144,80,64
050,51,037,"Virginia","Charlotte County",4,10,138,73,65
050,51,037,"Virginia","Charlotte County",4,11,124,68,56
050,51,037,"Virginia","Charlotte County",4,12,149,85,64
050,51,037,"Virginia","Charlotte County",4,13,156,80,76
050,51,037,"Virginia","Charlotte County",4,14,143,75,68
050,51,037,"Virginia","Charlotte County",4,15,135,67,68
050,51,037,"Virginia","Charlotte County",4,16,136,68,68
050,51,037,"Virginia","Charlotte County",4,17,153,76,77
050,51,037,"Virginia","Charlotte County",4,18,135,73,62
050,51,037,"Virginia","Charlotte County",4,19,96,53,43
050,51,037,"Virginia","Charlotte County",4,20,108,55,53
050,51,037,"Virginia","Charlotte County",4,21,112,59,53
050,51,037,"Virginia","Charlotte County",4,22,118,56,62
050,51,037,"Virginia","Charlotte County",4,23,118,64,54
050,51,037,"Virginia","Charlotte County",4,24,114,56,58
050,51,037,"Virginia","Charlotte County",4,25,127,68,59
050,51,037,"Virginia","Charlotte County",4,26,121,71,50
050,51,037,"Virginia","Charlotte County",4,27,120,67,53
050,51,037,"Virginia","Charlotte County",4,28,114,67,47
050,51,037,"Virginia","Charlotte County",4,29,121,58,63
050,51,037,"Virginia","Charlotte County",4,30,118,63,55
050,51,037,"Virginia","Charlotte County",4,31,126,58,68
050,51,037,"Virginia","Charlotte County",4,32,120,57,63
050,51,037,"Virginia","Charlotte County",4,33,112,52,60
050,51,037,"Virginia","Charlotte County",4,34,120,65,55
050,51,037,"Virginia","Charlotte County",4,35,116,62,54
050,51,037,"Virginia","Charlotte County",4,36,117,52,65
050,51,037,"Virginia","Charlotte County",4,37,120,58,62
050,51,037,"Virginia","Charlotte County",4,38,100,42,58
050,51,037,"Virginia","Charlotte County",4,39,112,53,59
050,51,037,"Virginia","Charlotte County",4,40,122,60,62
050,51,037,"Virginia","Charlotte County",4,41,116,60,56
050,51,037,"Virginia","Charlotte County",4,42,108,47,61
050,51,037,"Virginia","Charlotte County",4,43,119,63,56
050,51,037,"Virginia","Charlotte County",4,44,114,64,50
050,51,037,"Virginia","Charlotte County",4,45,119,57,62
050,51,037,"Virginia","Charlotte County",4,46,120,58,62
050,51,037,"Virginia","Charlotte County",4,47,117,55,62
050,51,037,"Virginia","Charlotte County",4,48,112,55,57
050,51,037,"Virginia","Charlotte County",4,49,126,59,67
050,51,037,"Virginia","Charlotte County",4,50,138,64,74
050,51,037,"Virginia","Charlotte County",4,51,151,72,79
050,51,037,"Virginia","Charlotte County",4,52,159,81,78
050,51,037,"Virginia","Charlotte County",4,53,135,71,64
050,51,037,"Virginia","Charlotte County",4,54,148,76,72
050,51,037,"Virginia","Charlotte County",4,55,163,81,82
050,51,037,"Virginia","Charlotte County",4,56,160,73,87
050,51,037,"Virginia","Charlotte County",4,57,169,78,91
050,51,037,"Virginia","Charlotte County",4,58,191,102,89
050,51,037,"Virginia","Charlotte County",4,59,201,103,98
050,51,037,"Virginia","Charlotte County",4,60,202,105,97
050,51,037,"Virginia","Charlotte County",4,61,202,108,94
050,51,037,"Virginia","Charlotte County",4,62,190,94,96
050,51,037,"Virginia","Charlotte County",4,63,194,95,99
050,51,037,"Virginia","Charlotte County",4,64,182,86,96
050,51,037,"Virginia","Charlotte County",4,65,187,87,100
050,51,037,"Virginia","Charlotte County",4,66,172,82,90
050,51,037,"Virginia","Charlotte County",4,67,171,82,89
050,51,037,"Virginia","Charlotte County",4,68,152,72,80
050,51,037,"Virginia","Charlotte County",4,69,145,69,76
050,51,037,"Virginia","Charlotte County",4,70,154,73,81
050,51,037,"Virginia","Charlotte County",4,71,129,58,71
050,51,037,"Virginia","Charlotte County",4,72,137,62,75
050,51,037,"Virginia","Charlotte County",4,73,130,63,67
050,51,037,"Virginia","Charlotte County",4,74,136,66,70
050,51,037,"Virginia","Charlotte County",4,75,142,65,77
050,51,037,"Virginia","Charlotte County",4,76,91,43,48
050,51,037,"Virginia","Charlotte County",4,77,89,37,52
050,51,037,"Virginia","Charlotte County",4,78,87,42,45
050,51,037,"Virginia","Charlotte County",4,79,100,50,50
050,51,037,"Virginia","Charlotte County",4,80,77,41,36
050,51,037,"Virginia","Charlotte County",4,81,68,31,37
050,51,037,"Virginia","Charlotte County",4,82,67,27,40
050,51,037,"Virginia","Charlotte County",4,83,57,19,38
050,51,037,"Virginia","Charlotte County",4,84,47,21,26
050,51,037,"Virginia","Charlotte County",4,85,247,71,176
050,51,037,"Virginia","Charlotte County",5,0,145,80,65
050,51,037,"Virginia","Charlotte County",5,1,143,73,70
050,51,037,"Virginia","Charlotte County",5,2,141,77,64
050,51,037,"Virginia","Charlotte County",5,3,138,55,83
050,51,037,"Virginia","Charlotte County",5,4,114,60,54
050,51,037,"Virginia","Charlotte County",5,5,132,66,66
050,51,037,"Virginia","Charlotte County",5,6,145,82,63
050,51,037,"Virginia","Charlotte County",5,7,133,76,57
050,51,037,"Virginia","Charlotte County",5,8,150,90,60
050,51,037,"Virginia","Charlotte County",5,9,132,70,62
050,51,037,"Virginia","Charlotte County",5,10,141,74,67
050,51,037,"Virginia","Charlotte County",5,11,140,74,66
050,51,037,"Virginia","Charlotte County",5,12,123,67,56
050,51,037,"Virginia","Charlotte County",5,13,150,87,63
050,51,037,"Virginia","Charlotte County",5,14,156,81,75
050,51,037,"Virginia","Charlotte County",5,15,150,81,69
050,51,037,"Virginia","Charlotte County",5,16,139,70,69
050,51,037,"Virginia","Charlotte County",5,17,138,69,69
050,51,037,"Virginia","Charlotte County",5,18,133,71,62
050,51,037,"Virginia","Charlotte County",5,19,99,54,45
050,51,037,"Virginia","Charlotte County",5,20,98,57,41
050,51,037,"Virginia","Charlotte County",5,21,116,60,56
050,51,037,"Virginia","Charlotte County",5,22,117,59,58
050,51,037,"Virginia","Charlotte County",5,23,116,53,63
050,51,037,"Virginia","Charlotte County",5,24,123,66,57
050,51,037,"Virginia","Charlotte County",5,25,117,59,58
050,51,037,"Virginia","Charlotte County",5,26,119,62,57
050,51,037,"Virginia","Charlotte County",5,27,117,70,47
050,51,037,"Virginia","Charlotte County",5,28,113,60,53
050,51,037,"Virginia","Charlotte County",5,29,109,64,45
050,51,037,"Virginia","Charlotte County",5,30,126,61,65
050,51,037,"Virginia","Charlotte County",5,31,129,64,65
050,51,037,"Virginia","Charlotte County",5,32,119,54,65
050,51,037,"Virginia","Charlotte County",5,33,118,59,59
050,51,037,"Virginia","Charlotte County",5,34,115,56,59
050,51,037,"Virginia","Charlotte County",5,35,130,75,55
050,51,037,"Virginia","Charlotte County",5,36,112,58,54
050,51,037,"Virginia","Charlotte County",5,37,114,50,64
050,51,037,"Virginia","Charlotte County",5,38,116,54,62
050,51,037,"Virginia","Charlotte County",5,39,112,48,64
050,51,037,"Virginia","Charlotte County",5,40,113,55,58
050,51,037,"Virginia","Charlotte County",5,41,128,68,60
050,51,037,"Virginia","Charlotte County",5,42,113,56,57
050,51,037,"Virginia","Charlotte County",5,43,106,46,60
050,51,037,"Virginia","Charlotte County",5,44,120,68,52
050,51,037,"Virginia","Charlotte County",5,45,113,61,52
050,51,037,"Virginia","Charlotte County",5,46,123,63,60
050,51,037,"Virginia","Charlotte County",5,47,113,55,58
050,51,037,"Virginia","Charlotte County",5,48,112,52,60
050,51,037,"Virginia","Charlotte County",5,49,106,51,55
050,51,037,"Virginia","Charlotte County",5,50,122,55,67
050,51,037,"Virginia","Charlotte County",5,51,137,63,74
050,51,037,"Virginia","Charlotte County",5,52,153,73,80
050,51,037,"Virginia","Charlotte County",5,53,160,80,80
050,51,037,"Virginia","Charlotte County",5,54,137,76,61
050,51,037,"Virginia","Charlotte County",5,55,149,77,72
050,51,037,"Virginia","Charlotte County",5,56,162,80,82
050,51,037,"Virginia","Charlotte County",5,57,157,73,84
050,51,037,"Virginia","Charlotte County",5,58,173,81,92
050,51,037,"Virginia","Charlotte County",5,59,189,101,88
050,51,037,"Virginia","Charlotte County",5,60,202,103,99
050,51,037,"Virginia","Charlotte County",5,61,200,103,97
050,51,037,"Virginia","Charlotte County",5,62,192,99,93
050,51,037,"Virginia","Charlotte County",5,63,193,98,95
050,51,037,"Virginia","Charlotte County",5,64,191,90,101
050,51,037,"Virginia","Charlotte County",5,65,177,85,92
050,51,037,"Virginia","Charlotte County",5,66,183,86,97
050,51,037,"Virginia","Charlotte County",5,67,167,78,89
050,51,037,"Virginia","Charlotte County",5,68,173,81,92
050,51,037,"Virginia","Charlotte County",5,69,143,68,75
050,51,037,"Virginia","Charlotte County",5,70,146,69,77
050,51,037,"Virginia","Charlotte County",5,71,147,67,80
050,51,037,"Virginia","Charlotte County",5,72,124,56,68
050,51,037,"Virginia","Charlotte County",5,73,127,56,71
050,51,037,"Virginia","Charlotte County",5,74,128,63,65
050,51,037,"Virginia","Charlotte County",5,75,126,52,74
050,51,037,"Virginia","Charlotte County",5,76,133,60,73
050,51,037,"Virginia","Charlotte County",5,77,85,39,46
050,51,037,"Virginia","Charlotte County",5,78,83,34,49
050,51,037,"Virginia","Charlotte County",5,79,76,38,38
050,51,037,"Virginia","Charlotte County",5,80,90,45,45
050,51,037,"Virginia","Charlotte County",5,81,74,40,34
050,51,037,"Virginia","Charlotte County",5,82,61,27,34
050,51,037,"Virginia","Charlotte County",5,83,66,25,41
050,51,037,"Virginia","Charlotte County",5,84,49,14,35
050,51,037,"Virginia","Charlotte County",5,85,236,70,166
050,51,041,"Virginia","Chesterfield County",1,0,4012,2041,1971
050,51,041,"Virginia","Chesterfield County",1,1,4258,2183,2075
050,51,041,"Virginia","Chesterfield County",1,2,4431,2314,2117
050,51,041,"Virginia","Chesterfield County",1,3,4585,2332,2253
050,51,041,"Virginia","Chesterfield County",1,4,4672,2361,2311
050,51,041,"Virginia","Chesterfield County",1,5,4683,2451,2232
050,51,041,"Virginia","Chesterfield County",1,6,4709,2469,2240
050,51,041,"Virginia","Chesterfield County",1,7,4750,2437,2313
050,51,041,"Virginia","Chesterfield County",1,8,4752,2508,2244
050,51,041,"Virginia","Chesterfield County",1,9,4879,2528,2351
050,51,041,"Virginia","Chesterfield County",1,10,5038,2574,2464
050,51,041,"Virginia","Chesterfield County",1,11,5051,2575,2476
050,51,041,"Virginia","Chesterfield County",1,12,5187,2636,2551
050,51,041,"Virginia","Chesterfield County",1,13,5307,2670,2637
050,51,041,"Virginia","Chesterfield County",1,14,5217,2630,2587
050,51,041,"Virginia","Chesterfield County",1,15,5231,2707,2524
050,51,041,"Virginia","Chesterfield County",1,16,5430,2816,2614
050,51,041,"Virginia","Chesterfield County",1,17,5326,2759,2567
050,51,041,"Virginia","Chesterfield County",1,18,5228,2658,2570
050,51,041,"Virginia","Chesterfield County",1,19,4639,2292,2347
050,51,041,"Virginia","Chesterfield County",1,20,4481,2208,2273
050,51,041,"Virginia","Chesterfield County",1,21,4307,2126,2181
050,51,041,"Virginia","Chesterfield County",1,22,4265,2058,2207
050,51,041,"Virginia","Chesterfield County",1,23,4115,1996,2119
050,51,041,"Virginia","Chesterfield County",1,24,4040,1982,2058
050,51,041,"Virginia","Chesterfield County",1,25,4038,1973,2065
050,51,041,"Virginia","Chesterfield County",1,26,4211,2036,2175
050,51,041,"Virginia","Chesterfield County",1,27,4224,2093,2131
050,51,041,"Virginia","Chesterfield County",1,28,4209,2048,2161
050,51,041,"Virginia","Chesterfield County",1,29,4270,2045,2225
050,51,041,"Virginia","Chesterfield County",1,30,4398,2063,2335
050,51,041,"Virginia","Chesterfield County",1,31,4432,2100,2332
050,51,041,"Virginia","Chesterfield County",1,32,4525,2182,2343
050,51,041,"Virginia","Chesterfield County",1,33,4704,2308,2396
050,51,041,"Virginia","Chesterfield County",1,34,4913,2385,2528
050,51,041,"Virginia","Chesterfield County",1,35,4818,2336,2482
050,51,041,"Virginia","Chesterfield County",1,36,4890,2384,2506
050,51,041,"Virginia","Chesterfield County",1,37,5111,2466,2645
050,51,041,"Virginia","Chesterfield County",1,38,5097,2451,2646
050,51,041,"Virginia","Chesterfield County",1,39,5127,2515,2612
050,51,041,"Virginia","Chesterfield County",1,40,5094,2477,2617
050,51,041,"Virginia","Chesterfield County",1,41,5064,2401,2663
050,51,041,"Virginia","Chesterfield County",1,42,5065,2390,2675
050,51,041,"Virginia","Chesterfield County",1,43,4776,2269,2507
050,51,041,"Virginia","Chesterfield County",1,44,4567,2195,2372
050,51,041,"Virginia","Chesterfield County",1,45,4750,2283,2467
050,51,041,"Virginia","Chesterfield County",1,46,4576,2194,2382
050,51,041,"Virginia","Chesterfield County",1,47,4744,2300,2444
050,51,041,"Virginia","Chesterfield County",1,48,5091,2514,2577
050,51,041,"Virginia","Chesterfield County",1,49,5368,2591,2777
050,51,041,"Virginia","Chesterfield County",1,50,5117,2488,2629
050,51,041,"Virginia","Chesterfield County",1,51,4873,2322,2551
050,51,041,"Virginia","Chesterfield County",1,52,4673,2248,2425
050,51,041,"Virginia","Chesterfield County",1,53,4792,2380,2412
050,51,041,"Virginia","Chesterfield County",1,54,4834,2353,2481
050,51,041,"Virginia","Chesterfield County",1,55,5022,2415,2607
050,51,041,"Virginia","Chesterfield County",1,56,5026,2430,2596
050,51,041,"Virginia","Chesterfield County",1,57,4979,2355,2624
050,51,041,"Virginia","Chesterfield County",1,58,4992,2397,2595
050,51,041,"Virginia","Chesterfield County",1,59,4824,2317,2507
050,51,041,"Virginia","Chesterfield County",1,60,4684,2215,2469
050,51,041,"Virginia","Chesterfield County",1,61,4607,2132,2475
050,51,041,"Virginia","Chesterfield County",1,62,4629,2170,2459
050,51,041,"Virginia","Chesterfield County",1,63,4455,2101,2354
050,51,041,"Virginia","Chesterfield County",1,64,4366,1983,2383
050,51,041,"Virginia","Chesterfield County",1,65,4302,1982,2320
050,51,041,"Virginia","Chesterfield County",1,66,4047,1881,2166
050,51,041,"Virginia","Chesterfield County",1,67,3827,1788,2039
050,51,041,"Virginia","Chesterfield County",1,68,3734,1703,2031
050,51,041,"Virginia","Chesterfield County",1,69,3586,1632,1954
050,51,041,"Virginia","Chesterfield County",1,70,3475,1621,1854
050,51,041,"Virginia","Chesterfield County",1,71,3298,1535,1763
050,51,041,"Virginia","Chesterfield County",1,72,3477,1578,1899
050,51,041,"Virginia","Chesterfield County",1,73,3501,1590,1911
050,51,041,"Virginia","Chesterfield County",1,74,2308,1063,1245
050,51,041,"Virginia","Chesterfield County",1,75,2198,1016,1182
050,51,041,"Virginia","Chesterfield County",1,76,2164,1005,1159
050,51,041,"Virginia","Chesterfield County",1,77,2122,950,1172
050,51,041,"Virginia","Chesterfield County",1,78,1820,833,987
050,51,041,"Virginia","Chesterfield County",1,79,1498,655,843
050,51,041,"Virginia","Chesterfield County",1,80,1295,570,725
050,51,041,"Virginia","Chesterfield County",1,81,1213,532,681
050,51,041,"Virginia","Chesterfield County",1,82,1101,445,656
050,51,041,"Virginia","Chesterfield County",1,83,927,377,550
050,51,041,"Virginia","Chesterfield County",1,84,842,331,511
050,51,041,"Virginia","Chesterfield County",1,85,4798,1639,3159
050,51,041,"Virginia","Chesterfield County",2,0,4024,2055,1969
050,51,041,"Virginia","Chesterfield County",2,1,4241,2170,2071
050,51,041,"Virginia","Chesterfield County",2,2,4441,2304,2137
050,51,041,"Virginia","Chesterfield County",2,3,4575,2336,2239
050,51,041,"Virginia","Chesterfield County",2,4,4701,2379,2322
050,51,041,"Virginia","Chesterfield County",2,5,4718,2450,2268
050,51,041,"Virginia","Chesterfield County",2,6,4736,2481,2255
050,51,041,"Virginia","Chesterfield County",2,7,4757,2454,2303
050,51,041,"Virginia","Chesterfield County",2,8,4770,2498,2272
050,51,041,"Virginia","Chesterfield County",2,9,4876,2537,2339
050,51,041,"Virginia","Chesterfield County",2,10,5022,2574,2448
050,51,041,"Virginia","Chesterfield County",2,11,5043,2571,2472
050,51,041,"Virginia","Chesterfield County",2,12,5199,2640,2559
050,51,041,"Virginia","Chesterfield County",2,13,5303,2674,2629
050,51,041,"Virginia","Chesterfield County",2,14,5257,2648,2609
050,51,041,"Virginia","Chesterfield County",2,15,5250,2701,2549
050,51,041,"Virginia","Chesterfield County",2,16,5417,2811,2606
050,51,041,"Virginia","Chesterfield County",2,17,5367,2787,2580
050,51,041,"Virginia","Chesterfield County",2,18,5204,2642,2562
050,51,041,"Virginia","Chesterfield County",2,19,4686,2310,2376
050,51,041,"Virginia","Chesterfield County",2,20,4540,2245,2295
050,51,041,"Virginia","Chesterfield County",2,21,4304,2125,2179
050,51,041,"Virginia","Chesterfield County",2,22,4259,2070,2189
050,51,041,"Virginia","Chesterfield County",2,23,4143,1999,2144
050,51,041,"Virginia","Chesterfield County",2,24,4038,1975,2063
050,51,041,"Virginia","Chesterfield County",2,25,4058,1988,2070
050,51,041,"Virginia","Chesterfield County",2,26,4193,2034,2159
050,51,041,"Virginia","Chesterfield County",2,27,4236,2081,2155
050,51,041,"Virginia","Chesterfield County",2,28,4234,2069,2165
050,51,041,"Virginia","Chesterfield County",2,29,4297,2057,2240
050,51,041,"Virginia","Chesterfield County",2,30,4436,2090,2346
050,51,041,"Virginia","Chesterfield County",2,31,4465,2113,2352
050,51,041,"Virginia","Chesterfield County",2,32,4543,2178,2365
050,51,041,"Virginia","Chesterfield County",2,33,4708,2301,2407
050,51,041,"Virginia","Chesterfield County",2,34,4902,2384,2518
050,51,041,"Virginia","Chesterfield County",2,35,4907,2383,2524
050,51,041,"Virginia","Chesterfield County",2,36,4882,2380,2502
050,51,041,"Virginia","Chesterfield County",2,37,5100,2468,2632
050,51,041,"Virginia","Chesterfield County",2,38,5153,2478,2675
050,51,041,"Virginia","Chesterfield County",2,39,5137,2512,2625
050,51,041,"Virginia","Chesterfield County",2,40,5155,2516,2639
050,51,041,"Virginia","Chesterfield County",2,41,5075,2415,2660
050,51,041,"Virginia","Chesterfield County",2,42,5062,2393,2669
050,51,041,"Virginia","Chesterfield County",2,43,4881,2320,2561
050,51,041,"Virginia","Chesterfield County",2,44,4586,2198,2388
050,51,041,"Virginia","Chesterfield County",2,45,4736,2276,2460
050,51,041,"Virginia","Chesterfield County",2,46,4608,2207,2401
050,51,041,"Virginia","Chesterfield County",2,47,4699,2273,2426
050,51,041,"Virginia","Chesterfield County",2,48,5002,2462,2540
050,51,041,"Virginia","Chesterfield County",2,49,5316,2582,2734
050,51,041,"Virginia","Chesterfield County",2,50,5192,2516,2676
050,51,041,"Virginia","Chesterfield County",2,51,4904,2345,2559
050,51,041,"Virginia","Chesterfield County",2,52,4722,2272,2450
050,51,041,"Virginia","Chesterfield County",2,53,4766,2354,2412
050,51,041,"Virginia","Chesterfield County",2,54,4812,2356,2456
050,51,041,"Virginia","Chesterfield County",2,55,4980,2402,2578
050,51,041,"Virginia","Chesterfield County",2,56,5036,2425,2611
050,51,041,"Virginia","Chesterfield County",2,57,4985,2369,2616
050,51,041,"Virginia","Chesterfield County",2,58,4961,2371,2590
050,51,041,"Virginia","Chesterfield County",2,59,4867,2337,2530
050,51,041,"Virginia","Chesterfield County",2,60,4696,2229,2467
050,51,041,"Virginia","Chesterfield County",2,61,4611,2145,2466
050,51,041,"Virginia","Chesterfield County",2,62,4608,2156,2452
050,51,041,"Virginia","Chesterfield County",2,63,4529,2128,2401
050,51,041,"Virginia","Chesterfield County",2,64,4347,1987,2360
050,51,041,"Virginia","Chesterfield County",2,65,4296,1969,2327
050,51,041,"Virginia","Chesterfield County",2,66,4111,1902,2209
050,51,041,"Virginia","Chesterfield County",2,67,3849,1794,2055
050,51,041,"Virginia","Chesterfield County",2,68,3726,1707,2019
050,51,041,"Virginia","Chesterfield County",2,69,3633,1653,1980
050,51,041,"Virginia","Chesterfield County",2,70,3482,1615,1867
050,51,041,"Virginia","Chesterfield County",2,71,3340,1552,1788
050,51,041,"Virginia","Chesterfield County",2,72,3376,1535,1841
050,51,041,"Virginia","Chesterfield County",2,73,3626,1642,1984
050,51,041,"Virginia","Chesterfield County",2,74,2432,1116,1316
050,51,041,"Virginia","Chesterfield County",2,75,2226,1026,1200
050,51,041,"Virginia","Chesterfield County",2,76,2134,990,1144
050,51,041,"Virginia","Chesterfield County",2,77,2158,975,1183
050,51,041,"Virginia","Chesterfield County",2,78,1847,836,1011
050,51,041,"Virginia","Chesterfield County",2,79,1545,677,868
050,51,041,"Virginia","Chesterfield County",2,80,1328,585,743
050,51,041,"Virginia","Chesterfield County",2,81,1214,537,677
050,51,041,"Virginia","Chesterfield County",2,82,1121,453,668
050,51,041,"Virginia","Chesterfield County",2,83,951,380,571
050,51,041,"Virginia","Chesterfield County",2,84,844,330,514
050,51,041,"Virginia","Chesterfield County",2,85,4814,1655,3159
050,51,041,"Virginia","Chesterfield County",3,0,3890,1963,1927
050,51,041,"Virginia","Chesterfield County",3,1,4199,2117,2082
050,51,041,"Virginia","Chesterfield County",3,2,4479,2290,2189
050,51,041,"Virginia","Chesterfield County",3,3,4585,2384,2201
050,51,041,"Virginia","Chesterfield County",3,4,4747,2403,2344
050,51,041,"Virginia","Chesterfield County",3,5,4825,2442,2383
050,51,041,"Virginia","Chesterfield County",3,6,4850,2516,2334
050,51,041,"Virginia","Chesterfield County",3,7,4937,2550,2387
050,51,041,"Virginia","Chesterfield County",3,8,4847,2528,2319
050,51,041,"Virginia","Chesterfield County",3,9,4903,2560,2343
050,51,041,"Virginia","Chesterfield County",3,10,4985,2607,2378
050,51,041,"Virginia","Chesterfield County",3,11,5120,2606,2514
050,51,041,"Virginia","Chesterfield County",3,12,5161,2624,2537
050,51,041,"Virginia","Chesterfield County",3,13,5278,2681,2597
050,51,041,"Virginia","Chesterfield County",3,14,5455,2767,2688
050,51,041,"Virginia","Chesterfield County",3,15,5330,2678,2652
050,51,041,"Virginia","Chesterfield County",3,16,5352,2791,2561
050,51,041,"Virginia","Chesterfield County",3,17,5456,2831,2625
050,51,041,"Virginia","Chesterfield County",3,18,5232,2624,2608
050,51,041,"Virginia","Chesterfield County",3,19,4633,2256,2377
050,51,041,"Virginia","Chesterfield County",3,20,4596,2285,2311
050,51,041,"Virginia","Chesterfield County",3,21,4355,2169,2186
050,51,041,"Virginia","Chesterfield County",3,22,4259,2120,2139
050,51,041,"Virginia","Chesterfield County",3,23,4217,2073,2144
050,51,041,"Virginia","Chesterfield County",3,24,4085,1994,2091
050,51,041,"Virginia","Chesterfield County",3,25,4098,2016,2082
050,51,041,"Virginia","Chesterfield County",3,26,4136,2018,2118
050,51,041,"Virginia","Chesterfield County",3,27,4222,2054,2168
050,51,041,"Virginia","Chesterfield County",3,28,4381,2119,2262
050,51,041,"Virginia","Chesterfield County",3,29,4438,2155,2283
050,51,041,"Virginia","Chesterfield County",3,30,4569,2187,2382
050,51,041,"Virginia","Chesterfield County",3,31,4684,2167,2517
050,51,041,"Virginia","Chesterfield County",3,32,4708,2228,2480
050,51,041,"Virginia","Chesterfield County",3,33,4795,2294,2501
050,51,041,"Virginia","Chesterfield County",3,34,4952,2418,2534
050,51,041,"Virginia","Chesterfield County",3,35,5115,2471,2644
050,51,041,"Virginia","Chesterfield County",3,36,5158,2489,2669
050,51,041,"Virginia","Chesterfield County",3,37,5067,2465,2602
050,51,041,"Virginia","Chesterfield County",3,38,5287,2532,2755
050,51,041,"Virginia","Chesterfield County",3,39,5274,2534,2740
050,51,041,"Virginia","Chesterfield County",3,40,5338,2637,2701
050,51,041,"Virginia","Chesterfield County",3,41,5299,2565,2734
050,51,041,"Virginia","Chesterfield County",3,42,5149,2468,2681
050,51,041,"Virginia","Chesterfield County",3,43,5123,2444,2679
050,51,041,"Virginia","Chesterfield County",3,44,4921,2348,2573
050,51,041,"Virginia","Chesterfield County",3,45,4631,2224,2407
050,51,041,"Virginia","Chesterfield County",3,46,4727,2281,2446
050,51,041,"Virginia","Chesterfield County",3,47,4641,2231,2410
050,51,041,"Virginia","Chesterfield County",3,48,4763,2317,2446
050,51,041,"Virginia","Chesterfield County",3,49,4979,2460,2519
050,51,041,"Virginia","Chesterfield County",3,50,5278,2562,2716
050,51,041,"Virginia","Chesterfield County",3,51,5171,2509,2662
050,51,041,"Virginia","Chesterfield County",3,52,4868,2331,2537
050,51,041,"Virginia","Chesterfield County",3,53,4701,2243,2458
050,51,041,"Virginia","Chesterfield County",3,54,4736,2326,2410
050,51,041,"Virginia","Chesterfield County",3,55,4780,2324,2456
050,51,041,"Virginia","Chesterfield County",3,56,4925,2371,2554
050,51,041,"Virginia","Chesterfield County",3,57,5013,2396,2617
050,51,041,"Virginia","Chesterfield County",3,58,4903,2319,2584
050,51,041,"Virginia","Chesterfield County",3,59,4887,2332,2555
050,51,041,"Virginia","Chesterfield County",3,60,4816,2303,2513
050,51,041,"Virginia","Chesterfield County",3,61,4690,2216,2474
050,51,041,"Virginia","Chesterfield County",3,62,4551,2112,2439
050,51,041,"Virginia","Chesterfield County",3,63,4573,2139,2434
050,51,041,"Virginia","Chesterfield County",3,64,4469,2105,2364
050,51,041,"Virginia","Chesterfield County",3,65,4241,1931,2310
050,51,041,"Virginia","Chesterfield County",3,66,4231,1921,2310
050,51,041,"Virginia","Chesterfield County",3,67,4067,1871,2196
050,51,041,"Virginia","Chesterfield County",3,68,3844,1774,2070
050,51,041,"Virginia","Chesterfield County",3,69,3683,1682,2001
050,51,041,"Virginia","Chesterfield County",3,70,3569,1624,1945
050,51,041,"Virginia","Chesterfield County",3,71,3448,1589,1859
050,51,041,"Virginia","Chesterfield County",3,72,3310,1516,1794
050,51,041,"Virginia","Chesterfield County",3,73,3342,1506,1836
050,51,041,"Virginia","Chesterfield County",3,74,3516,1588,1928
050,51,041,"Virginia","Chesterfield County",3,75,2361,1085,1276
050,51,041,"Virginia","Chesterfield County",3,76,2153,996,1157
050,51,041,"Virginia","Chesterfield County",3,77,2086,949,1137
050,51,041,"Virginia","Chesterfield County",3,78,2094,941,1153
050,51,041,"Virginia","Chesterfield County",3,79,1767,784,983
050,51,041,"Virginia","Chesterfield County",3,80,1461,641,820
050,51,041,"Virginia","Chesterfield County",3,81,1262,564,698
050,51,041,"Virginia","Chesterfield County",3,82,1153,486,667
050,51,041,"Virginia","Chesterfield County",3,83,1080,437,643
050,51,041,"Virginia","Chesterfield County",3,84,884,337,547
050,51,041,"Virginia","Chesterfield County",3,85,4787,1636,3151
050,51,041,"Virginia","Chesterfield County",4,0,4078,2073,2005
050,51,041,"Virginia","Chesterfield County",4,1,4189,2164,2025
050,51,041,"Virginia","Chesterfield County",4,2,4420,2230,2190
050,51,041,"Virginia","Chesterfield County",4,3,4649,2343,2306
050,51,041,"Virginia","Chesterfield County",4,4,4795,2443,2352
050,51,041,"Virginia","Chesterfield County",4,5,4910,2448,2462
050,51,041,"Virginia","Chesterfield County",4,6,5031,2526,2505
050,51,041,"Virginia","Chesterfield County",4,7,5007,2591,2416
050,51,041,"Virginia","Chesterfield County",4,8,5057,2624,2433
050,51,041,"Virginia","Chesterfield County",4,9,5003,2610,2393
050,51,041,"Virginia","Chesterfield County",4,10,4994,2626,2368
050,51,041,"Virginia","Chesterfield County",4,11,5085,2660,2425
050,51,041,"Virginia","Chesterfield County",4,12,5254,2654,2600
050,51,041,"Virginia","Chesterfield County",4,13,5290,2691,2599
050,51,041,"Virginia","Chesterfield County",4,14,5442,2774,2668
050,51,041,"Virginia","Chesterfield County",4,15,5561,2813,2748
050,51,041,"Virginia","Chesterfield County",4,16,5540,2811,2729
050,51,041,"Virginia","Chesterfield County",4,17,5417,2812,2605
050,51,041,"Virginia","Chesterfield County",4,18,5291,2707,2584
050,51,041,"Virginia","Chesterfield County",4,19,4657,2253,2404
050,51,041,"Virginia","Chesterfield County",4,20,4564,2247,2317
050,51,041,"Virginia","Chesterfield County",4,21,4496,2267,2229
050,51,041,"Virginia","Chesterfield County",4,22,4402,2224,2178
050,51,041,"Virginia","Chesterfield County",4,23,4269,2135,2134
050,51,041,"Virginia","Chesterfield County",4,24,4222,2069,2153
050,51,041,"Virginia","Chesterfield County",4,25,4156,2017,2139
050,51,041,"Virginia","Chesterfield County",4,26,4172,2037,2135
050,51,041,"Virginia","Chesterfield County",4,27,4251,2050,2201
050,51,041,"Virginia","Chesterfield County",4,28,4420,2116,2304
050,51,041,"Virginia","Chesterfield County",4,29,4563,2196,2367
050,51,041,"Virginia","Chesterfield County",4,30,4675,2244,2431
050,51,041,"Virginia","Chesterfield County",4,31,4838,2301,2537
050,51,041,"Virginia","Chesterfield County",4,32,4977,2298,2679
050,51,041,"Virginia","Chesterfield County",4,33,5008,2383,2625
050,51,041,"Virginia","Chesterfield County",4,34,5114,2471,2643
050,51,041,"Virginia","Chesterfield County",4,35,5176,2522,2654
050,51,041,"Virginia","Chesterfield County",4,36,5387,2606,2781
050,51,041,"Virginia","Chesterfield County",4,37,5341,2553,2788
050,51,041,"Virginia","Chesterfield County",4,38,5245,2544,2701
050,51,041,"Virginia","Chesterfield County",4,39,5488,2649,2839
050,51,041,"Virginia","Chesterfield County",4,40,5397,2612,2785
050,51,041,"Virginia","Chesterfield County",4,41,5500,2696,2804
050,51,041,"Virginia","Chesterfield County",4,42,5454,2653,2801
050,51,041,"Virginia","Chesterfield County",4,43,5219,2535,2684
050,51,041,"Virginia","Chesterfield County",4,44,5161,2501,2660
050,51,041,"Virginia","Chesterfield County",4,45,4973,2387,2586
050,51,041,"Virginia","Chesterfield County",4,46,4668,2239,2429
050,51,041,"Virginia","Chesterfield County",4,47,4780,2318,2462
050,51,041,"Virginia","Chesterfield County",4,48,4639,2232,2407
050,51,041,"Virginia","Chesterfield County",4,49,4729,2284,2445
050,51,041,"Virginia","Chesterfield County",4,50,4954,2451,2503
050,51,041,"Virginia","Chesterfield County",4,51,5285,2586,2699
050,51,041,"Virginia","Chesterfield County",4,52,5155,2507,2648
050,51,041,"Virginia","Chesterfield County",4,53,4884,2345,2539
050,51,041,"Virginia","Chesterfield County",4,54,4645,2203,2442
050,51,041,"Virginia","Chesterfield County",4,55,4704,2304,2400
050,51,041,"Virginia","Chesterfield County",4,56,4742,2306,2436
050,51,041,"Virginia","Chesterfield County",4,57,4914,2352,2562
050,51,041,"Virginia","Chesterfield County",4,58,4968,2351,2617
050,51,041,"Virginia","Chesterfield County",4,59,4902,2321,2581
050,51,041,"Virginia","Chesterfield County",4,60,4883,2327,2556
050,51,041,"Virginia","Chesterfield County",4,61,4756,2256,2500
050,51,041,"Virginia","Chesterfield County",4,62,4653,2187,2466
050,51,041,"Virginia","Chesterfield County",4,63,4499,2087,2412
050,51,041,"Virginia","Chesterfield County",4,64,4541,2117,2424
050,51,041,"Virginia","Chesterfield County",4,65,4431,2078,2353
050,51,041,"Virginia","Chesterfield County",4,66,4186,1894,2292
050,51,041,"Virginia","Chesterfield County",4,67,4180,1904,2276
050,51,041,"Virginia","Chesterfield County",4,68,4052,1843,2209
050,51,041,"Virginia","Chesterfield County",4,69,3804,1742,2062
050,51,041,"Virginia","Chesterfield County",4,70,3652,1664,1988
050,51,041,"Virginia","Chesterfield County",4,71,3520,1587,1933
050,51,041,"Virginia","Chesterfield County",4,72,3411,1553,1858
050,51,041,"Virginia","Chesterfield County",4,73,3274,1493,1781
050,51,041,"Virginia","Chesterfield County",4,74,3236,1455,1781
050,51,041,"Virginia","Chesterfield County",4,75,3427,1535,1892
050,51,041,"Virginia","Chesterfield County",4,76,2322,1058,1264
050,51,041,"Virginia","Chesterfield County",4,77,2108,944,1164
050,51,041,"Virginia","Chesterfield County",4,78,2042,924,1118
050,51,041,"Virginia","Chesterfield County",4,79,1999,878,1121
050,51,041,"Virginia","Chesterfield County",4,80,1692,755,937
050,51,041,"Virginia","Chesterfield County",4,81,1380,621,759
050,51,041,"Virginia","Chesterfield County",4,82,1194,510,684
050,51,041,"Virginia","Chesterfield County",4,83,1106,454,652
050,51,041,"Virginia","Chesterfield County",4,84,995,393,602
050,51,041,"Virginia","Chesterfield County",4,85,4840,1675,3165
050,51,041,"Virginia","Chesterfield County",5,0,4079,2071,2008
050,51,041,"Virginia","Chesterfield County",5,1,4355,2228,2127
050,51,041,"Virginia","Chesterfield County",5,2,4370,2238,2132
050,51,041,"Virginia","Chesterfield County",5,3,4598,2342,2256
050,51,041,"Virginia","Chesterfield County",5,4,4890,2459,2431
050,51,041,"Virginia","Chesterfield County",5,5,4928,2504,2424
050,51,041,"Virginia","Chesterfield County",5,6,5044,2510,2534
050,51,041,"Virginia","Chesterfield County",5,7,5192,2586,2606
050,51,041,"Virginia","Chesterfield County",5,8,5139,2652,2487
050,51,041,"Virginia","Chesterfield County",5,9,5129,2661,2468
050,51,041,"Virginia","Chesterfield County",5,10,5063,2632,2431
050,51,041,"Virginia","Chesterfield County",5,11,5032,2652,2380
050,51,041,"Virginia","Chesterfield County",5,12,5161,2695,2466
050,51,041,"Virginia","Chesterfield County",5,13,5297,2699,2598
050,51,041,"Virginia","Chesterfield County",5,14,5389,2755,2634
050,51,041,"Virginia","Chesterfield County",5,15,5478,2815,2663
050,51,041,"Virginia","Chesterfield County",5,16,5604,2864,2740
050,51,041,"Virginia","Chesterfield County",5,17,5604,2847,2757
050,51,041,"Virginia","Chesterfield County",5,18,5213,2634,2579
050,51,041,"Virginia","Chesterfield County",5,19,4702,2324,2378
050,51,041,"Virginia","Chesterfield County",5,20,4587,2242,2345
050,51,041,"Virginia","Chesterfield County",5,21,4491,2233,2258
050,51,041,"Virginia","Chesterfield County",5,22,4571,2347,2224
050,51,041,"Virginia","Chesterfield County",5,23,4428,2236,2192
050,51,041,"Virginia","Chesterfield County",5,24,4257,2157,2100
050,51,041,"Virginia","Chesterfield County",5,25,4195,2059,2136
050,51,041,"Virginia","Chesterfield County",5,26,4183,2026,2157
050,51,041,"Virginia","Chesterfield County",5,27,4288,2053,2235
050,51,041,"Virginia","Chesterfield County",5,28,4316,2090,2226
050,51,041,"Virginia","Chesterfield County",5,29,4482,2122,2360
050,51,041,"Virginia","Chesterfield County",5,30,4704,2229,2475
050,51,041,"Virginia","Chesterfield County",5,31,4868,2343,2525
050,51,041,"Virginia","Chesterfield County",5,32,5098,2434,2664
050,51,041,"Virginia","Chesterfield County",5,33,5204,2410,2794
050,51,041,"Virginia","Chesterfield County",5,34,5234,2483,2751
050,51,041,"Virginia","Chesterfield County",5,35,5244,2536,2708
050,51,041,"Virginia","Chesterfield County",5,36,5428,2648,2780
050,51,041,"Virginia","Chesterfield County",5,37,5597,2704,2893
050,51,041,"Virginia","Chesterfield County",5,38,5501,2642,2859
050,51,041,"Virginia","Chesterfield County",5,39,5319,2549,2770
050,51,041,"Virginia","Chesterfield County",5,40,5567,2700,2867
050,51,041,"Virginia","Chesterfield County",5,41,5515,2710,2805
050,51,041,"Virginia","Chesterfield County",5,42,5604,2722,2882
050,51,041,"Virginia","Chesterfield County",5,43,5509,2683,2826
050,51,041,"Virginia","Chesterfield County",5,44,5266,2551,2715
050,51,041,"Virginia","Chesterfield County",5,45,5226,2564,2662
050,51,041,"Virginia","Chesterfield County",5,46,4986,2389,2597
050,51,041,"Virginia","Chesterfield County",5,47,4708,2282,2426
050,51,041,"Virginia","Chesterfield County",5,48,4838,2347,2491
050,51,041,"Virginia","Chesterfield County",5,49,4605,2221,2384
050,51,041,"Virginia","Chesterfield County",5,50,4720,2279,2441
050,51,041,"Virginia","Chesterfield County",5,51,4910,2462,2448
050,51,041,"Virginia","Chesterfield County",5,52,5249,2568,2681
050,51,041,"Virginia","Chesterfield County",5,53,5170,2503,2667
050,51,041,"Virginia","Chesterfield County",5,54,4874,2358,2516
050,51,041,"Virginia","Chesterfield County",5,55,4669,2215,2454
050,51,041,"Virginia","Chesterfield County",5,56,4667,2274,2393
050,51,041,"Virginia","Chesterfield County",5,57,4708,2285,2423
050,51,041,"Virginia","Chesterfield County",5,58,4900,2328,2572
050,51,041,"Virginia","Chesterfield County",5,59,4983,2358,2625
050,51,041,"Virginia","Chesterfield County",5,60,4863,2293,2570
050,51,041,"Virginia","Chesterfield County",5,61,4873,2315,2558
050,51,041,"Virginia","Chesterfield County",5,62,4709,2239,2470
050,51,041,"Virginia","Chesterfield County",5,63,4582,2126,2456
050,51,041,"Virginia","Chesterfield County",5,64,4479,2070,2409
050,51,041,"Virginia","Chesterfield County",5,65,4506,2104,2402
050,51,041,"Virginia","Chesterfield County",5,66,4389,2053,2336
050,51,041,"Virginia","Chesterfield County",5,67,4134,1863,2271
050,51,041,"Virginia","Chesterfield County",5,68,4141,1878,2263
050,51,041,"Virginia","Chesterfield County",5,69,4004,1811,2193
050,51,041,"Virginia","Chesterfield County",5,70,3790,1717,2073
050,51,041,"Virginia","Chesterfield County",5,71,3622,1631,1991
050,51,041,"Virginia","Chesterfield County",5,72,3508,1560,1948
050,51,041,"Virginia","Chesterfield County",5,73,3349,1519,1830
050,51,041,"Virginia","Chesterfield County",5,74,3184,1439,1745
050,51,041,"Virginia","Chesterfield County",5,75,3147,1405,1742
050,51,041,"Virginia","Chesterfield County",5,76,3330,1491,1839
050,51,041,"Virginia","Chesterfield County",5,77,2271,1024,1247
050,51,041,"Virginia","Chesterfield County",5,78,2046,920,1126
050,51,041,"Virginia","Chesterfield County",5,79,1974,880,1094
050,51,041,"Virginia","Chesterfield County",5,80,1912,853,1059
050,51,041,"Virginia","Chesterfield County",5,81,1638,742,896
050,51,041,"Virginia","Chesterfield County",5,82,1304,564,740
050,51,041,"Virginia","Chesterfield County",5,83,1140,481,659
050,51,041,"Virginia","Chesterfield County",5,84,1041,414,627
050,51,041,"Virginia","Chesterfield County",5,85,5004,1736,3268
050,51,043,"Virginia","Clarke County",1,0,126,64,62
050,51,043,"Virginia","Clarke County",1,1,110,55,55
050,51,043,"Virginia","Clarke County",1,2,102,53,49
050,51,043,"Virginia","Clarke County",1,3,127,63,64
050,51,043,"Virginia","Clarke County",1,4,143,77,66
050,51,043,"Virginia","Clarke County",1,5,144,84,60
050,51,043,"Virginia","Clarke County",1,6,138,68,70
050,51,043,"Virginia","Clarke County",1,7,128,62,66
050,51,043,"Virginia","Clarke County",1,8,148,66,82
050,51,043,"Virginia","Clarke County",1,9,159,79,80
050,51,043,"Virginia","Clarke County",1,10,160,81,79
050,51,043,"Virginia","Clarke County",1,11,179,93,86
050,51,043,"Virginia","Clarke County",1,12,202,101,101
050,51,043,"Virginia","Clarke County",1,13,192,95,97
050,51,043,"Virginia","Clarke County",1,14,213,105,108
050,51,043,"Virginia","Clarke County",1,15,215,108,107
050,51,043,"Virginia","Clarke County",1,16,201,105,96
050,51,043,"Virginia","Clarke County",1,17,183,93,90
050,51,043,"Virginia","Clarke County",1,18,174,91,83
050,51,043,"Virginia","Clarke County",1,19,140,66,74
050,51,043,"Virginia","Clarke County",1,20,152,77,75
050,51,043,"Virginia","Clarke County",1,21,156,81,75
050,51,043,"Virginia","Clarke County",1,22,155,74,81
050,51,043,"Virginia","Clarke County",1,23,149,69,80
050,51,043,"Virginia","Clarke County",1,24,137,76,61
050,51,043,"Virginia","Clarke County",1,25,148,71,77
050,51,043,"Virginia","Clarke County",1,26,139,76,63
050,51,043,"Virginia","Clarke County",1,27,139,66,73
050,51,043,"Virginia","Clarke County",1,28,140,74,66
050,51,043,"Virginia","Clarke County",1,29,136,68,68
050,51,043,"Virginia","Clarke County",1,30,120,55,65
050,51,043,"Virginia","Clarke County",1,31,123,59,64
050,51,043,"Virginia","Clarke County",1,32,139,72,67
050,51,043,"Virginia","Clarke County",1,33,145,74,71
050,51,043,"Virginia","Clarke County",1,34,159,88,71
050,51,043,"Virginia","Clarke County",1,35,132,69,63
050,51,043,"Virginia","Clarke County",1,36,151,73,78
050,51,043,"Virginia","Clarke County",1,37,161,77,84
050,51,043,"Virginia","Clarke County",1,38,174,98,76
050,51,043,"Virginia","Clarke County",1,39,154,75,79
050,51,043,"Virginia","Clarke County",1,40,168,76,92
050,51,043,"Virginia","Clarke County",1,41,143,68,75
050,51,043,"Virginia","Clarke County",1,42,165,84,81
050,51,043,"Virginia","Clarke County",1,43,181,93,88
050,51,043,"Virginia","Clarke County",1,44,162,81,81
050,51,043,"Virginia","Clarke County",1,45,163,76,87
050,51,043,"Virginia","Clarke County",1,46,150,73,77
050,51,043,"Virginia","Clarke County",1,47,176,90,86
050,51,043,"Virginia","Clarke County",1,48,200,108,92
050,51,043,"Virginia","Clarke County",1,49,206,101,105
050,51,043,"Virginia","Clarke County",1,50,206,98,108
050,51,043,"Virginia","Clarke County",1,51,239,115,124
050,51,043,"Virginia","Clarke County",1,52,246,125,121
050,51,043,"Virginia","Clarke County",1,53,265,125,140
050,51,043,"Virginia","Clarke County",1,54,260,135,125
050,51,043,"Virginia","Clarke County",1,55,252,135,117
050,51,043,"Virginia","Clarke County",1,56,263,148,115
050,51,043,"Virginia","Clarke County",1,57,261,130,131
050,51,043,"Virginia","Clarke County",1,58,256,129,127
050,51,043,"Virginia","Clarke County",1,59,267,132,135
050,51,043,"Virginia","Clarke County",1,60,264,132,132
050,51,043,"Virginia","Clarke County",1,61,268,145,123
050,51,043,"Virginia","Clarke County",1,62,261,127,134
050,51,043,"Virginia","Clarke County",1,63,244,124,120
050,51,043,"Virginia","Clarke County",1,64,228,115,113
050,51,043,"Virginia","Clarke County",1,65,206,100,106
050,51,043,"Virginia","Clarke County",1,66,200,87,113
050,51,043,"Virginia","Clarke County",1,67,207,101,106
050,51,043,"Virginia","Clarke County",1,68,211,116,95
050,51,043,"Virginia","Clarke County",1,69,198,105,93
050,51,043,"Virginia","Clarke County",1,70,193,103,90
050,51,043,"Virginia","Clarke County",1,71,180,90,90
050,51,043,"Virginia","Clarke County",1,72,203,103,100
050,51,043,"Virginia","Clarke County",1,73,188,89,99
050,51,043,"Virginia","Clarke County",1,74,136,60,76
050,51,043,"Virginia","Clarke County",1,75,122,62,60
050,51,043,"Virginia","Clarke County",1,76,117,62,55
050,51,043,"Virginia","Clarke County",1,77,129,70,59
050,51,043,"Virginia","Clarke County",1,78,113,43,70
050,51,043,"Virginia","Clarke County",1,79,87,35,52
050,51,043,"Virginia","Clarke County",1,80,78,32,46
050,51,043,"Virginia","Clarke County",1,81,85,40,45
050,51,043,"Virginia","Clarke County",1,82,78,40,38
050,51,043,"Virginia","Clarke County",1,83,65,29,36
050,51,043,"Virginia","Clarke County",1,84,53,24,29
050,51,043,"Virginia","Clarke County",1,85,351,116,235
050,51,043,"Virginia","Clarke County",2,0,131,67,64
050,51,043,"Virginia","Clarke County",2,1,114,58,56
050,51,043,"Virginia","Clarke County",2,2,104,53,51
050,51,043,"Virginia","Clarke County",2,3,122,61,61
050,51,043,"Virginia","Clarke County",2,4,141,75,66
050,51,043,"Virginia","Clarke County",2,5,142,81,61
050,51,043,"Virginia","Clarke County",2,6,138,71,67
050,51,043,"Virginia","Clarke County",2,7,132,65,67
050,51,043,"Virginia","Clarke County",2,8,145,66,79
050,51,043,"Virginia","Clarke County",2,9,158,76,82
050,51,043,"Virginia","Clarke County",2,10,163,81,82
050,51,043,"Virginia","Clarke County",2,11,176,92,84
050,51,043,"Virginia","Clarke County",2,12,196,98,98
050,51,043,"Virginia","Clarke County",2,13,197,99,98
050,51,043,"Virginia","Clarke County",2,14,209,102,107
050,51,043,"Virginia","Clarke County",2,15,214,107,107
050,51,043,"Virginia","Clarke County",2,16,200,102,98
050,51,043,"Virginia","Clarke County",2,17,189,97,92
050,51,043,"Virginia","Clarke County",2,18,166,88,78
050,51,043,"Virginia","Clarke County",2,19,141,68,73
050,51,043,"Virginia","Clarke County",2,20,154,76,78
050,51,043,"Virginia","Clarke County",2,21,155,79,76
050,51,043,"Virginia","Clarke County",2,22,156,75,81
050,51,043,"Virginia","Clarke County",2,23,151,71,80
050,51,043,"Virginia","Clarke County",2,24,140,74,66
050,51,043,"Virginia","Clarke County",2,25,144,71,73
050,51,043,"Virginia","Clarke County",2,26,142,75,67
050,51,043,"Virginia","Clarke County",2,27,140,69,71
050,51,043,"Virginia","Clarke County",2,28,141,73,68
050,51,043,"Virginia","Clarke County",2,29,139,69,70
050,51,043,"Virginia","Clarke County",2,30,129,61,68
050,51,043,"Virginia","Clarke County",2,31,125,60,65
050,51,043,"Virginia","Clarke County",2,32,134,69,65
050,51,043,"Virginia","Clarke County",2,33,145,74,71
050,51,043,"Virginia","Clarke County",2,34,156,84,72
050,51,043,"Virginia","Clarke County",2,35,141,75,66
050,51,043,"Virginia","Clarke County",2,36,145,70,75
050,51,043,"Virginia","Clarke County",2,37,159,77,82
050,51,043,"Virginia","Clarke County",2,38,168,90,78
050,51,043,"Virginia","Clarke County",2,39,160,81,79
050,51,043,"Virginia","Clarke County",2,40,165,76,89
050,51,043,"Virginia","Clarke County",2,41,151,72,79
050,51,043,"Virginia","Clarke County",2,42,163,82,81
050,51,043,"Virginia","Clarke County",2,43,179,91,88
050,51,043,"Virginia","Clarke County",2,44,162,81,81
050,51,043,"Virginia","Clarke County",2,45,164,79,85
050,51,043,"Virginia","Clarke County",2,46,151,73,78
050,51,043,"Virginia","Clarke County",2,47,169,86,83
050,51,043,"Virginia","Clarke County",2,48,195,104,91
050,51,043,"Virginia","Clarke County",2,49,205,104,101
050,51,043,"Virginia","Clarke County",2,50,208,99,109
050,51,043,"Virginia","Clarke County",2,51,230,111,119
050,51,043,"Virginia","Clarke County",2,52,242,121,121
050,51,043,"Virginia","Clarke County",2,53,263,127,136
050,51,043,"Virginia","Clarke County",2,54,259,132,127
050,51,043,"Virginia","Clarke County",2,55,253,135,118
050,51,043,"Virginia","Clarke County",2,56,261,144,117
050,51,043,"Virginia","Clarke County",2,57,260,134,126
050,51,043,"Virginia","Clarke County",2,58,257,130,127
050,51,043,"Virginia","Clarke County",2,59,267,131,136
050,51,043,"Virginia","Clarke County",2,60,264,132,132
050,51,043,"Virginia","Clarke County",2,61,263,141,122
050,51,043,"Virginia","Clarke County",2,62,264,133,131
050,51,043,"Virginia","Clarke County",2,63,251,126,125
050,51,043,"Virginia","Clarke County",2,64,230,117,113
050,51,043,"Virginia","Clarke County",2,65,212,104,108
050,51,043,"Virginia","Clarke County",2,66,204,91,113
050,51,043,"Virginia","Clarke County",2,67,205,98,107
050,51,043,"Virginia","Clarke County",2,68,208,110,98
050,51,043,"Virginia","Clarke County",2,69,205,109,96
050,51,043,"Virginia","Clarke County",2,70,194,104,90
050,51,043,"Virginia","Clarke County",2,71,182,92,90
050,51,043,"Virginia","Clarke County",2,72,194,98,96
050,51,043,"Virginia","Clarke County",2,73,202,97,105
050,51,043,"Virginia","Clarke County",2,74,141,63,78
050,51,043,"Virginia","Clarke County",2,75,125,62,63
050,51,043,"Virginia","Clarke County",2,76,117,61,56
050,51,043,"Virginia","Clarke County",2,77,130,71,59
050,51,043,"Virginia","Clarke County",2,78,115,48,67
050,51,043,"Virginia","Clarke County",2,79,91,36,55
050,51,043,"Virginia","Clarke County",2,80,80,33,47
050,51,043,"Virginia","Clarke County",2,81,83,37,46
050,51,043,"Virginia","Clarke County",2,82,77,39,38
050,51,043,"Virginia","Clarke County",2,83,68,32,36
050,51,043,"Virginia","Clarke County",2,84,54,26,28
050,51,043,"Virginia","Clarke County",2,85,349,113,236
050,51,043,"Virginia","Clarke County",3,0,142,62,80
050,51,043,"Virginia","Clarke County",3,1,126,61,65
050,51,043,"Virginia","Clarke County",3,2,111,57,54
050,51,043,"Virginia","Clarke County",3,3,104,53,51
050,51,043,"Virginia","Clarke County",3,4,130,65,65
050,51,043,"Virginia","Clarke County",3,5,153,75,78
050,51,043,"Virginia","Clarke County",3,6,147,81,66
050,51,043,"Virginia","Clarke County",3,7,154,77,77
050,51,043,"Virginia","Clarke County",3,8,134,72,62
050,51,043,"Virginia","Clarke County",3,9,141,67,74
050,51,043,"Virginia","Clarke County",3,10,173,80,93
050,51,043,"Virginia","Clarke County",3,11,172,83,89
050,51,043,"Virginia","Clarke County",3,12,183,96,87
050,51,043,"Virginia","Clarke County",3,13,205,105,100
050,51,043,"Virginia","Clarke County",3,14,196,93,103
050,51,043,"Virginia","Clarke County",3,15,210,104,106
050,51,043,"Virginia","Clarke County",3,16,211,101,110
050,51,043,"Virginia","Clarke County",3,17,209,106,103
050,51,043,"Virginia","Clarke County",3,18,161,89,72
050,51,043,"Virginia","Clarke County",3,19,139,76,63
050,51,043,"Virginia","Clarke County",3,20,142,67,75
050,51,043,"Virginia","Clarke County",3,21,159,75,84
050,51,043,"Virginia","Clarke County",3,22,160,86,74
050,51,043,"Virginia","Clarke County",3,23,161,83,78
050,51,043,"Virginia","Clarke County",3,24,142,68,74
050,51,043,"Virginia","Clarke County",3,25,145,72,73
050,51,043,"Virginia","Clarke County",3,26,147,74,73
050,51,043,"Virginia","Clarke County",3,27,147,84,63
050,51,043,"Virginia","Clarke County",3,28,151,86,65
050,51,043,"Virginia","Clarke County",3,29,140,74,66
050,51,043,"Virginia","Clarke County",3,30,151,77,74
050,51,043,"Virginia","Clarke County",3,31,126,57,69
050,51,043,"Virginia","Clarke County",3,32,125,56,69
050,51,043,"Virginia","Clarke County",3,33,131,67,64
050,51,043,"Virginia","Clarke County",3,34,148,74,74
050,51,043,"Virginia","Clarke County",3,35,165,86,79
050,51,043,"Virginia","Clarke County",3,36,146,76,70
050,51,043,"Virginia","Clarke County",3,37,145,77,68
050,51,043,"Virginia","Clarke County",3,38,180,83,97
050,51,043,"Virginia","Clarke County",3,39,180,94,86
050,51,043,"Virginia","Clarke County",3,40,165,81,84
050,51,043,"Virginia","Clarke County",3,41,175,77,98
050,51,043,"Virginia","Clarke County",3,42,166,80,86
050,51,043,"Virginia","Clarke County",3,43,172,91,81
050,51,043,"Virginia","Clarke County",3,44,176,88,88
050,51,043,"Virginia","Clarke County",3,45,158,81,77
050,51,043,"Virginia","Clarke County",3,46,178,91,87
050,51,043,"Virginia","Clarke County",3,47,160,78,82
050,51,043,"Virginia","Clarke County",3,48,167,83,84
050,51,043,"Virginia","Clarke County",3,49,192,109,83
050,51,043,"Virginia","Clarke County",3,50,210,109,101
050,51,043,"Virginia","Clarke County",3,51,200,99,101
050,51,043,"Virginia","Clarke County",3,52,237,120,117
050,51,043,"Virginia","Clarke County",3,53,244,117,127
050,51,043,"Virginia","Clarke County",3,54,261,126,135
050,51,043,"Virginia","Clarke County",3,55,251,126,125
050,51,043,"Virginia","Clarke County",3,56,249,130,119
050,51,043,"Virginia","Clarke County",3,57,254,141,113
050,51,043,"Virginia","Clarke County",3,58,262,138,124
050,51,043,"Virginia","Clarke County",3,59,253,129,124
050,51,043,"Virginia","Clarke County",3,60,249,121,128
050,51,043,"Virginia","Clarke County",3,61,254,131,123
050,51,043,"Virginia","Clarke County",3,62,264,140,124
050,51,043,"Virginia","Clarke County",3,63,263,136,127
050,51,043,"Virginia","Clarke County",3,64,253,126,127
050,51,043,"Virginia","Clarke County",3,65,229,116,113
050,51,043,"Virginia","Clarke County",3,66,209,102,107
050,51,043,"Virginia","Clarke County",3,67,196,91,105
050,51,043,"Virginia","Clarke County",3,68,194,90,104
050,51,043,"Virginia","Clarke County",3,69,215,113,102
050,51,043,"Virginia","Clarke County",3,70,205,106,99
050,51,043,"Virginia","Clarke County",3,71,195,102,93
050,51,043,"Virginia","Clarke County",3,72,179,91,88
050,51,043,"Virginia","Clarke County",3,73,184,90,94
050,51,043,"Virginia","Clarke County",3,74,203,99,104
050,51,043,"Virginia","Clarke County",3,75,132,59,73
050,51,043,"Virginia","Clarke County",3,76,118,58,60
050,51,043,"Virginia","Clarke County",3,77,106,58,48
050,51,043,"Virginia","Clarke County",3,78,138,70,68
050,51,043,"Virginia","Clarke County",3,79,102,43,59
050,51,043,"Virginia","Clarke County",3,80,88,36,52
050,51,043,"Virginia","Clarke County",3,81,79,29,50
050,51,043,"Virginia","Clarke County",3,82,70,31,39
050,51,043,"Virginia","Clarke County",3,83,80,37,43
050,51,043,"Virginia","Clarke County",3,84,63,30,33
050,51,043,"Virginia","Clarke County",3,85,350,112,238
050,51,043,"Virginia","Clarke County",4,0,158,73,85
050,51,043,"Virginia","Clarke County",4,1,152,64,88
050,51,043,"Virginia","Clarke County",4,2,128,61,67
050,51,043,"Virginia","Clarke County",4,3,121,61,60
050,51,043,"Virginia","Clarke County",4,4,122,56,66
050,51,043,"Virginia","Clarke County",4,5,156,76,80
050,51,043,"Virginia","Clarke County",4,6,165,84,81
050,51,043,"Virginia","Clarke County",4,7,151,82,69
050,51,043,"Virginia","Clarke County",4,8,168,82,86
050,51,043,"Virginia","Clarke County",4,9,136,71,65
050,51,043,"Virginia","Clarke County",4,10,142,66,76
050,51,043,"Virginia","Clarke County",4,11,182,85,97
050,51,043,"Virginia","Clarke County",4,12,172,87,85
050,51,043,"Virginia","Clarke County",4,13,193,100,93
050,51,043,"Virginia","Clarke County",4,14,208,108,100
050,51,043,"Virginia","Clarke County",4,15,213,102,111
050,51,043,"Virginia","Clarke County",4,16,199,98,101
050,51,043,"Virginia","Clarke County",4,17,221,110,111
050,51,043,"Virginia","Clarke County",4,18,176,92,84
050,51,043,"Virginia","Clarke County",4,19,128,68,60
050,51,043,"Virginia","Clarke County",4,20,157,81,76
050,51,043,"Virginia","Clarke County",4,21,154,70,84
050,51,043,"Virginia","Clarke County",4,22,158,73,85
050,51,043,"Virginia","Clarke County",4,23,150,75,75
050,51,043,"Virginia","Clarke County",4,24,142,74,68
050,51,043,"Virginia","Clarke County",4,25,139,67,72
050,51,043,"Virginia","Clarke County",4,26,161,80,81
050,51,043,"Virginia","Clarke County",4,27,157,86,71
050,51,043,"Virginia","Clarke County",4,28,159,91,68
050,51,043,"Virginia","Clarke County",4,29,149,79,70
050,51,043,"Virginia","Clarke County",4,30,143,73,70
050,51,043,"Virginia","Clarke County",4,31,160,76,84
050,51,043,"Virginia","Clarke County",4,32,135,59,76
050,51,043,"Virginia","Clarke County",4,33,138,62,76
050,51,043,"Virginia","Clarke County",4,34,138,70,68
050,51,043,"Virginia","Clarke County",4,35,174,83,91
050,51,043,"Virginia","Clarke County",4,36,175,103,72
050,51,043,"Virginia","Clarke County",4,37,161,85,76
050,51,043,"Virginia","Clarke County",4,38,156,88,68
050,51,043,"Virginia","Clarke County",4,39,193,90,103
050,51,043,"Virginia","Clarke County",4,40,203,105,98
050,51,043,"Virginia","Clarke County",4,41,184,88,96
050,51,043,"Virginia","Clarke County",4,42,173,78,95
050,51,043,"Virginia","Clarke County",4,43,169,82,87
050,51,043,"Virginia","Clarke County",4,44,176,93,83
050,51,043,"Virginia","Clarke County",4,45,178,96,82
050,51,043,"Virginia","Clarke County",4,46,164,81,83
050,51,043,"Virginia","Clarke County",4,47,184,94,90
050,51,043,"Virginia","Clarke County",4,48,173,87,86
050,51,043,"Virginia","Clarke County",4,49,176,83,93
050,51,043,"Virginia","Clarke County",4,50,199,112,87
050,51,043,"Virginia","Clarke County",4,51,202,105,97
050,51,043,"Virginia","Clarke County",4,52,199,99,100
050,51,043,"Virginia","Clarke County",4,53,252,128,124
050,51,043,"Virginia","Clarke County",4,54,239,121,118
050,51,043,"Virginia","Clarke County",4,55,254,124,130
050,51,043,"Virginia","Clarke County",4,56,252,128,124
050,51,043,"Virginia","Clarke County",4,57,254,129,125
050,51,043,"Virginia","Clarke County",4,58,252,136,116
050,51,043,"Virginia","Clarke County",4,59,275,148,127
050,51,043,"Virginia","Clarke County",4,60,249,126,123
050,51,043,"Virginia","Clarke County",4,61,249,118,131
050,51,043,"Virginia","Clarke County",4,62,245,126,119
050,51,043,"Virginia","Clarke County",4,63,256,132,124
050,51,043,"Virginia","Clarke County",4,64,255,134,121
050,51,043,"Virginia","Clarke County",4,65,251,125,126
050,51,043,"Virginia","Clarke County",4,66,232,111,121
050,51,043,"Virginia","Clarke County",4,67,211,102,109
050,51,043,"Virginia","Clarke County",4,68,189,86,103
050,51,043,"Virginia","Clarke County",4,69,200,92,108
050,51,043,"Virginia","Clarke County",4,70,212,108,104
050,51,043,"Virginia","Clarke County",4,71,204,106,98
050,51,043,"Virginia","Clarke County",4,72,200,104,96
050,51,043,"Virginia","Clarke County",4,73,174,85,89
050,51,043,"Virginia","Clarke County",4,74,187,91,96
050,51,043,"Virginia","Clarke County",4,75,200,96,104
050,51,043,"Virginia","Clarke County",4,76,128,56,72
050,51,043,"Virginia","Clarke County",4,77,114,53,61
050,51,043,"Virginia","Clarke County",4,78,119,57,62
050,51,043,"Virginia","Clarke County",4,79,133,68,65
050,51,043,"Virginia","Clarke County",4,80,104,44,60
050,51,043,"Virginia","Clarke County",4,81,84,32,52
050,51,043,"Virginia","Clarke County",4,82,66,22,44
050,51,043,"Virginia","Clarke County",4,83,67,25,42
050,51,043,"Virginia","Clarke County",4,84,73,37,36
050,51,043,"Virginia","Clarke County",4,85,381,131,250
050,51,043,"Virginia","Clarke County",5,0,159,73,86
050,51,043,"Virginia","Clarke County",5,1,148,75,73
050,51,043,"Virginia","Clarke County",5,2,138,59,79
050,51,043,"Virginia","Clarke County",5,3,122,64,58
050,51,043,"Virginia","Clarke County",5,4,124,60,64
050,51,043,"Virginia","Clarke County",5,5,134,56,78
050,51,043,"Virginia","Clarke County",5,6,160,77,83
050,51,043,"Virginia","Clarke County",5,7,163,89,74
050,51,043,"Virginia","Clarke County",5,8,150,81,69
050,51,043,"Virginia","Clarke County",5,9,171,85,86
050,51,043,"Virginia","Clarke County",5,10,148,82,66
050,51,043,"Virginia","Clarke County",5,11,162,73,89
050,51,043,"Virginia","Clarke County",5,12,188,89,99
050,51,043,"Virginia","Clarke County",5,13,178,96,82
050,51,043,"Virginia","Clarke County",5,14,191,100,91
050,51,043,"Virginia","Clarke County",5,15,218,112,106
050,51,043,"Virginia","Clarke County",5,16,207,96,111
050,51,043,"Virginia","Clarke County",5,17,214,105,109
050,51,043,"Virginia","Clarke County",5,18,188,104,84
050,51,043,"Virginia","Clarke County",5,19,142,75,67
050,51,043,"Virginia","Clarke County",5,20,142,74,68
050,51,043,"Virginia","Clarke County",5,21,166,81,85
050,51,043,"Virginia","Clarke County",5,22,164,81,83
050,51,043,"Virginia","Clarke County",5,23,145,72,73
050,51,043,"Virginia","Clarke County",5,24,144,77,67
050,51,043,"Virginia","Clarke County",5,25,134,68,66
050,51,043,"Virginia","Clarke County",5,26,136,64,72
050,51,043,"Virginia","Clarke County",5,27,171,82,89
050,51,043,"Virginia","Clarke County",5,28,155,88,67
050,51,043,"Virginia","Clarke County",5,29,154,86,68
050,51,043,"Virginia","Clarke County",5,30,158,82,76
050,51,043,"Virginia","Clarke County",5,31,142,71,71
050,51,043,"Virginia","Clarke County",5,32,167,84,83
050,51,043,"Virginia","Clarke County",5,33,147,69,78
050,51,043,"Virginia","Clarke County",5,34,142,70,72
050,51,043,"Virginia","Clarke County",5,35,141,68,73
050,51,043,"Virginia","Clarke County",5,36,184,81,103
050,51,043,"Virginia","Clarke County",5,37,166,88,78
050,51,043,"Virginia","Clarke County",5,38,169,87,82
050,51,043,"Virginia","Clarke County",5,39,164,94,70
050,51,043,"Virginia","Clarke County",5,40,199,89,110
050,51,043,"Virginia","Clarke County",5,41,213,112,101
050,51,043,"Virginia","Clarke County",5,42,197,94,103
050,51,043,"Virginia","Clarke County",5,43,179,82,97
050,51,043,"Virginia","Clarke County",5,44,168,81,87
050,51,043,"Virginia","Clarke County",5,45,178,94,84
050,51,043,"Virginia","Clarke County",5,46,181,93,88
050,51,043,"Virginia","Clarke County",5,47,173,86,87
050,51,043,"Virginia","Clarke County",5,48,196,105,91
050,51,043,"Virginia","Clarke County",5,49,177,89,88
050,51,043,"Virginia","Clarke County",5,50,187,90,97
050,51,043,"Virginia","Clarke County",5,51,199,111,88
050,51,043,"Virginia","Clarke County",5,52,205,106,99
050,51,043,"Virginia","Clarke County",5,53,200,101,99
050,51,043,"Virginia","Clarke County",5,54,244,126,118
050,51,043,"Virginia","Clarke County",5,55,256,133,123
050,51,043,"Virginia","Clarke County",5,56,260,120,140
050,51,043,"Virginia","Clarke County",5,57,256,130,126
050,51,043,"Virginia","Clarke County",5,58,257,130,127
050,51,043,"Virginia","Clarke County",5,59,244,131,113
050,51,043,"Virginia","Clarke County",5,60,277,157,120
050,51,043,"Virginia","Clarke County",5,61,244,123,121
050,51,043,"Virginia","Clarke County",5,62,235,113,122
050,51,043,"Virginia","Clarke County",5,63,239,125,114
050,51,043,"Virginia","Clarke County",5,64,253,137,116
050,51,043,"Virginia","Clarke County",5,65,257,133,124
050,51,043,"Virginia","Clarke County",5,66,239,119,120
050,51,043,"Virginia","Clarke County",5,67,229,113,116
050,51,043,"Virginia","Clarke County",5,68,212,98,114
050,51,043,"Virginia","Clarke County",5,69,187,85,102
050,51,043,"Virginia","Clarke County",5,70,201,92,109
050,51,043,"Virginia","Clarke County",5,71,212,105,107
050,51,043,"Virginia","Clarke County",5,72,195,99,96
050,51,043,"Virginia","Clarke County",5,73,195,103,92
050,51,043,"Virginia","Clarke County",5,74,178,87,91
050,51,043,"Virginia","Clarke County",5,75,181,88,93
050,51,043,"Virginia","Clarke County",5,76,194,95,99
050,51,043,"Virginia","Clarke County",5,77,119,53,66
050,51,043,"Virginia","Clarke County",5,78,120,49,71
050,51,043,"Virginia","Clarke County",5,79,106,49,57
050,51,043,"Virginia","Clarke County",5,80,127,65,62
050,51,043,"Virginia","Clarke County",5,81,91,35,56
050,51,043,"Virginia","Clarke County",5,82,69,24,45
050,51,043,"Virginia","Clarke County",5,83,65,19,46
050,51,043,"Virginia","Clarke County",5,84,59,24,35
050,51,043,"Virginia","Clarke County",5,85,417,154,263
050,51,045,"Virginia","Craig County",1,0,38,20,18
050,51,045,"Virginia","Craig County",1,1,37,20,17
050,51,045,"Virginia","Craig County",1,2,38,16,22
050,51,045,"Virginia","Craig County",1,3,35,18,17
050,51,045,"Virginia","Craig County",1,4,50,22,28
050,51,045,"Virginia","Craig County",1,5,40,17,23
050,51,045,"Virginia","Craig County",1,6,42,21,21
050,51,045,"Virginia","Craig County",1,7,46,26,20
050,51,045,"Virginia","Craig County",1,8,35,18,17
050,51,045,"Virginia","Craig County",1,9,33,15,18
050,51,045,"Virginia","Craig County",1,10,58,28,30
050,51,045,"Virginia","Craig County",1,11,59,34,25
050,51,045,"Virginia","Craig County",1,12,55,27,28
050,51,045,"Virginia","Craig County",1,13,53,30,23
050,51,045,"Virginia","Craig County",1,14,56,32,24
050,51,045,"Virginia","Craig County",1,15,59,31,28
050,51,045,"Virginia","Craig County",1,16,63,33,30
050,51,045,"Virginia","Craig County",1,17,53,27,26
050,51,045,"Virginia","Craig County",1,18,50,21,29
050,51,045,"Virginia","Craig County",1,19,44,21,23
050,51,045,"Virginia","Craig County",1,20,49,29,20
050,51,045,"Virginia","Craig County",1,21,41,20,21
050,51,045,"Virginia","Craig County",1,22,51,23,28
050,51,045,"Virginia","Craig County",1,23,51,25,26
050,51,045,"Virginia","Craig County",1,24,63,29,34
050,51,045,"Virginia","Craig County",1,25,49,26,23
050,51,045,"Virginia","Craig County",1,26,48,27,21
050,51,045,"Virginia","Craig County",1,27,51,29,22
050,51,045,"Virginia","Craig County",1,28,50,24,26
050,51,045,"Virginia","Craig County",1,29,52,29,23
050,51,045,"Virginia","Craig County",1,30,52,27,25
050,51,045,"Virginia","Craig County",1,31,54,29,25
050,51,045,"Virginia","Craig County",1,32,55,32,23
050,51,045,"Virginia","Craig County",1,33,44,20,24
050,51,045,"Virginia","Craig County",1,34,40,18,22
050,51,045,"Virginia","Craig County",1,35,40,26,14
050,51,045,"Virginia","Craig County",1,36,47,26,21
050,51,045,"Virginia","Craig County",1,37,47,21,26
050,51,045,"Virginia","Craig County",1,38,41,21,20
050,51,045,"Virginia","Craig County",1,39,44,19,25
050,51,045,"Virginia","Craig County",1,40,46,24,22
050,51,045,"Virginia","Craig County",1,41,49,24,25
050,51,045,"Virginia","Craig County",1,42,53,25,28
050,51,045,"Virginia","Craig County",1,43,58,28,30
050,51,045,"Virginia","Craig County",1,44,50,24,26
050,51,045,"Virginia","Craig County",1,45,56,29,27
050,51,045,"Virginia","Craig County",1,46,61,34,27
050,51,045,"Virginia","Craig County",1,47,67,36,31
050,51,045,"Virginia","Craig County",1,48,82,42,40
050,51,045,"Virginia","Craig County",1,49,69,32,37
050,51,045,"Virginia","Craig County",1,50,65,29,36
050,51,045,"Virginia","Craig County",1,51,68,34,34
050,51,045,"Virginia","Craig County",1,52,77,39,38
050,51,045,"Virginia","Craig County",1,53,79,46,33
050,51,045,"Virginia","Craig County",1,54,75,44,31
050,51,045,"Virginia","Craig County",1,55,84,44,40
050,51,045,"Virginia","Craig County",1,56,99,49,50
050,51,045,"Virginia","Craig County",1,57,79,38,41
050,51,045,"Virginia","Craig County",1,58,85,43,42
050,51,045,"Virginia","Craig County",1,59,94,52,42
050,51,045,"Virginia","Craig County",1,60,91,49,42
050,51,045,"Virginia","Craig County",1,61,81,41,40
050,51,045,"Virginia","Craig County",1,62,93,41,52
050,51,045,"Virginia","Craig County",1,63,76,42,34
050,51,045,"Virginia","Craig County",1,64,77,44,33
050,51,045,"Virginia","Craig County",1,65,75,35,40
050,51,045,"Virginia","Craig County",1,66,81,40,41
050,51,045,"Virginia","Craig County",1,67,72,39,33
050,51,045,"Virginia","Craig County",1,68,86,41,45
050,51,045,"Virginia","Craig County",1,69,62,31,31
050,51,045,"Virginia","Craig County",1,70,64,34,30
050,51,045,"Virginia","Craig County",1,71,68,38,30
050,51,045,"Virginia","Craig County",1,72,75,37,38
050,51,045,"Virginia","Craig County",1,73,63,29,34
050,51,045,"Virginia","Craig County",1,74,47,21,26
050,51,045,"Virginia","Craig County",1,75,48,22,26
050,51,045,"Virginia","Craig County",1,76,50,31,19
050,51,045,"Virginia","Craig County",1,77,45,26,19
050,51,045,"Virginia","Craig County",1,78,37,15,22
050,51,045,"Virginia","Craig County",1,79,32,14,18
050,51,045,"Virginia","Craig County",1,80,31,12,19
050,51,045,"Virginia","Craig County",1,81,30,14,16
050,51,045,"Virginia","Craig County",1,82,17,7,10
050,51,045,"Virginia","Craig County",1,83,27,8,19
050,51,045,"Virginia","Craig County",1,84,21,8,13
050,51,045,"Virginia","Craig County",1,85,134,44,90
050,51,045,"Virginia","Craig County",2,0,36,17,19
050,51,045,"Virginia","Craig County",2,1,36,19,17
050,51,045,"Virginia","Craig County",2,2,36,16,20
050,51,045,"Virginia","Craig County",2,3,35,17,18
050,51,045,"Virginia","Craig County",2,4,47,21,26
050,51,045,"Virginia","Craig County",2,5,42,18,24
050,51,045,"Virginia","Craig County",2,6,42,20,22
050,51,045,"Virginia","Craig County",2,7,46,26,20
050,51,045,"Virginia","Craig County",2,8,38,20,18
050,51,045,"Virginia","Craig County",2,9,33,16,17
050,51,045,"Virginia","Craig County",2,10,53,25,28
050,51,045,"Virginia","Craig County",2,11,58,33,25
050,51,045,"Virginia","Craig County",2,12,57,29,28
050,51,045,"Virginia","Craig County",2,13,53,29,24
050,51,045,"Virginia","Craig County",2,14,55,31,24
050,51,045,"Virginia","Craig County",2,15,57,30,27
050,51,045,"Virginia","Craig County",2,16,62,33,29
050,51,045,"Virginia","Craig County",2,17,56,28,28
050,51,045,"Virginia","Craig County",2,18,48,21,27
050,51,045,"Virginia","Craig County",2,19,44,21,23
050,51,045,"Virginia","Craig County",2,20,48,27,21
050,51,045,"Virginia","Craig County",2,21,44,22,22
050,51,045,"Virginia","Craig County",2,22,50,23,27
050,51,045,"Virginia","Craig County",2,23,50,24,26
050,51,045,"Virginia","Craig County",2,24,60,28,32
050,51,045,"Virginia","Craig County",2,25,52,27,25
050,51,045,"Virginia","Craig County",2,26,47,26,21
050,51,045,"Virginia","Craig County",2,27,50,28,22
050,51,045,"Virginia","Craig County",2,28,50,25,25
050,51,045,"Virginia","Craig County",2,29,52,28,24
050,51,045,"Virginia","Craig County",2,30,53,28,25
050,51,045,"Virginia","Craig County",2,31,52,27,25
050,51,045,"Virginia","Craig County",2,32,53,30,23
050,51,045,"Virginia","Craig County",2,33,45,22,23
050,51,045,"Virginia","Craig County",2,34,40,18,22
050,51,045,"Virginia","Craig County",2,35,41,25,16
050,51,045,"Virginia","Craig County",2,36,46,26,20
050,51,045,"Virginia","Craig County",2,37,46,23,23
050,51,045,"Virginia","Craig County",2,38,42,21,21
050,51,045,"Virginia","Craig County",2,39,44,20,24
050,51,045,"Virginia","Craig County",2,40,45,23,22
050,51,045,"Virginia","Craig County",2,41,48,24,24
050,51,045,"Virginia","Craig County",2,42,52,25,27
050,51,045,"Virginia","Craig County",2,43,57,28,29
050,51,045,"Virginia","Craig County",2,44,52,25,27
050,51,045,"Virginia","Craig County",2,45,56,29,27
050,51,045,"Virginia","Craig County",2,46,59,32,27
050,51,045,"Virginia","Craig County",2,47,65,35,30
050,51,045,"Virginia","Craig County",2,48,79,40,39
050,51,045,"Virginia","Craig County",2,49,72,35,37
050,51,045,"Virginia","Craig County",2,50,67,30,37
050,51,045,"Virginia","Craig County",2,51,68,33,35
050,51,045,"Virginia","Craig County",2,52,74,37,37
050,51,045,"Virginia","Craig County",2,53,79,44,35
050,51,045,"Virginia","Craig County",2,54,76,44,32
050,51,045,"Virginia","Craig County",2,55,83,45,38
050,51,045,"Virginia","Craig County",2,56,96,48,48
050,51,045,"Virginia","Craig County",2,57,85,42,43
050,51,045,"Virginia","Craig County",2,58,83,42,41
050,51,045,"Virginia","Craig County",2,59,92,50,42
050,51,045,"Virginia","Craig County",2,60,91,49,42
050,51,045,"Virginia","Craig County",2,61,82,43,39
050,51,045,"Virginia","Craig County",2,62,89,41,48
050,51,045,"Virginia","Craig County",2,63,81,42,39
050,51,045,"Virginia","Craig County",2,64,76,43,33
050,51,045,"Virginia","Craig County",2,65,74,36,38
050,51,045,"Virginia","Craig County",2,66,79,39,40
050,51,045,"Virginia","Craig County",2,67,74,39,35
050,51,045,"Virginia","Craig County",2,68,81,39,42
050,51,045,"Virginia","Craig County",2,69,68,34,34
050,51,045,"Virginia","Craig County",2,70,63,33,30
050,51,045,"Virginia","Craig County",2,71,68,38,30
050,51,045,"Virginia","Craig County",2,72,72,36,36
050,51,045,"Virginia","Craig County",2,73,70,33,37
050,51,045,"Virginia","Craig County",2,74,48,22,26
050,51,045,"Virginia","Craig County",2,75,48,22,26
050,51,045,"Virginia","Craig County",2,76,48,28,20
050,51,045,"Virginia","Craig County",2,77,47,28,19
050,51,045,"Virginia","Craig County",2,78,38,17,21
050,51,045,"Virginia","Craig County",2,79,33,14,19
050,51,045,"Virginia","Craig County",2,80,31,12,19
050,51,045,"Virginia","Craig County",2,81,30,14,16
050,51,045,"Virginia","Craig County",2,82,20,9,11
050,51,045,"Virginia","Craig County",2,83,25,8,17
050,51,045,"Virginia","Craig County",2,84,21,7,14
050,51,045,"Virginia","Craig County",2,85,131,44,87
050,51,045,"Virginia","Craig County",3,0,42,18,24
050,51,045,"Virginia","Craig County",3,1,39,23,16
050,51,045,"Virginia","Craig County",3,2,37,19,18
050,51,045,"Virginia","Craig County",3,3,38,20,18
050,51,045,"Virginia","Craig County",3,4,35,16,19
050,51,045,"Virginia","Craig County",3,5,52,21,31
050,51,045,"Virginia","Craig County",3,6,48,19,29
050,51,045,"Virginia","Craig County",3,7,49,24,25
050,51,045,"Virginia","Craig County",3,8,50,26,24
050,51,045,"Virginia","Craig County",3,9,36,21,15
050,51,045,"Virginia","Craig County",3,10,39,21,18
050,51,045,"Virginia","Craig County",3,11,48,21,27
050,51,045,"Virginia","Craig County",3,12,53,31,22
050,51,045,"Virginia","Craig County",3,13,57,26,31
050,51,045,"Virginia","Craig County",3,14,52,30,22
050,51,045,"Virginia","Craig County",3,15,50,28,22
050,51,045,"Virginia","Craig County",3,16,53,27,26
050,51,045,"Virginia","Craig County",3,17,62,32,30
050,51,045,"Virginia","Craig County",3,18,40,24,16
050,51,045,"Virginia","Craig County",3,19,39,16,23
050,51,045,"Virginia","Craig County",3,20,49,24,25
050,51,045,"Virginia","Craig County",3,21,45,25,20
050,51,045,"Virginia","Craig County",3,22,50,25,25
050,51,045,"Virginia","Craig County",3,23,51,27,24
050,51,045,"Virginia","Craig County",3,24,46,23,23
050,51,045,"Virginia","Craig County",3,25,48,22,26
050,51,045,"Virginia","Craig County",3,26,62,31,31
050,51,045,"Virginia","Craig County",3,27,48,28,20
050,51,045,"Virginia","Craig County",3,28,55,27,28
050,51,045,"Virginia","Craig County",3,29,56,27,29
050,51,045,"Virginia","Craig County",3,30,51,27,24
050,51,045,"Virginia","Craig County",3,31,57,32,25
050,51,045,"Virginia","Craig County",3,32,50,26,24
050,51,045,"Virginia","Craig County",3,33,60,35,25
050,51,045,"Virginia","Craig County",3,34,52,28,24
050,51,045,"Virginia","Craig County",3,35,40,20,20
050,51,045,"Virginia","Craig County",3,36,44,27,17
050,51,045,"Virginia","Craig County",3,37,51,27,24
050,51,045,"Virginia","Craig County",3,38,43,23,20
050,51,045,"Virginia","Craig County",3,39,46,25,21
050,51,045,"Virginia","Craig County",3,40,45,20,25
050,51,045,"Virginia","Craig County",3,41,44,24,20
050,51,045,"Virginia","Craig County",3,42,47,23,24
050,51,045,"Virginia","Craig County",3,43,53,24,29
050,51,045,"Virginia","Craig County",3,44,61,29,32
050,51,045,"Virginia","Craig County",3,45,51,25,26
050,51,045,"Virginia","Craig County",3,46,56,29,27
050,51,045,"Virginia","Craig County",3,47,58,30,28
050,51,045,"Virginia","Craig County",3,48,66,35,31
050,51,045,"Virginia","Craig County",3,49,76,37,39
050,51,045,"Virginia","Craig County",3,50,76,39,37
050,51,045,"Virginia","Craig County",3,51,65,29,36
050,51,045,"Virginia","Craig County",3,52,69,35,34
050,51,045,"Virginia","Craig County",3,53,77,42,35
050,51,045,"Virginia","Craig County",3,54,76,43,33
050,51,045,"Virginia","Craig County",3,55,76,44,32
050,51,045,"Virginia","Craig County",3,56,81,44,37
050,51,045,"Virginia","Craig County",3,57,98,50,48
050,51,045,"Virginia","Craig County",3,58,84,42,42
050,51,045,"Virginia","Craig County",3,59,83,44,39
050,51,045,"Virginia","Craig County",3,60,85,45,40
050,51,045,"Virginia","Craig County",3,61,90,49,41
050,51,045,"Virginia","Craig County",3,62,86,43,43
050,51,045,"Virginia","Craig County",3,63,87,41,46
050,51,045,"Virginia","Craig County",3,64,82,42,40
050,51,045,"Virginia","Craig County",3,65,78,45,33
050,51,045,"Virginia","Craig County",3,66,72,36,36
050,51,045,"Virginia","Craig County",3,67,78,38,40
050,51,045,"Virginia","Craig County",3,68,74,37,37
050,51,045,"Virginia","Craig County",3,69,79,36,43
050,51,045,"Virginia","Craig County",3,70,64,31,33
050,51,045,"Virginia","Craig County",3,71,59,30,29
050,51,045,"Virginia","Craig County",3,72,67,38,29
050,51,045,"Virginia","Craig County",3,73,71,35,36
050,51,045,"Virginia","Craig County",3,74,66,29,37
050,51,045,"Virginia","Craig County",3,75,47,22,25
050,51,045,"Virginia","Craig County",3,76,43,19,24
050,51,045,"Virginia","Craig County",3,77,47,28,19
050,51,045,"Virginia","Craig County",3,78,43,24,19
050,51,045,"Virginia","Craig County",3,79,35,15,20
050,51,045,"Virginia","Craig County",3,80,32,14,18
050,51,045,"Virginia","Craig County",3,81,29,12,17
050,51,045,"Virginia","Craig County",3,82,28,12,16
050,51,045,"Virginia","Craig County",3,83,20,9,11
050,51,045,"Virginia","Craig County",3,84,24,8,16
050,51,045,"Virginia","Craig County",3,85,135,45,90
050,51,045,"Virginia","Craig County",4,0,45,17,28
050,51,045,"Virginia","Craig County",4,1,43,21,22
050,51,045,"Virginia","Craig County",4,2,32,18,14
050,51,045,"Virginia","Craig County",4,3,34,18,16
050,51,045,"Virginia","Craig County",4,4,37,19,18
050,51,045,"Virginia","Craig County",4,5,34,14,20
050,51,045,"Virginia","Craig County",4,6,49,18,31
050,51,045,"Virginia","Craig County",4,7,43,18,25
050,51,045,"Virginia","Craig County",4,8,46,22,24
050,51,045,"Virginia","Craig County",4,9,47,24,23
050,51,045,"Virginia","Craig County",4,10,37,21,16
050,51,045,"Virginia","Craig County",4,11,37,20,17
050,51,045,"Virginia","Craig County",4,12,52,23,29
050,51,045,"Virginia","Craig County",4,13,54,29,25
050,51,045,"Virginia","Craig County",4,14,58,26,32
050,51,045,"Virginia","Craig County",4,15,50,29,21
050,51,045,"Virginia","Craig County",4,16,48,28,20
050,51,045,"Virginia","Craig County",4,17,52,25,27
050,51,045,"Virginia","Craig County",4,18,48,25,23
050,51,045,"Virginia","Craig County",4,19,33,19,14
050,51,045,"Virginia","Craig County",4,20,38,16,22
050,51,045,"Virginia","Craig County",4,21,57,29,28
050,51,045,"Virginia","Craig County",4,22,50,27,23
050,51,045,"Virginia","Craig County",4,23,56,27,29
050,51,045,"Virginia","Craig County",4,24,47,23,24
050,51,045,"Virginia","Craig County",4,25,51,27,24
050,51,045,"Virginia","Craig County",4,26,51,20,31
050,51,045,"Virginia","Craig County",4,27,62,30,32
050,51,045,"Virginia","Craig County",4,28,43,28,15
050,51,045,"Virginia","Craig County",4,29,53,28,25
050,51,045,"Virginia","Craig County",4,30,59,30,29
050,51,045,"Virginia","Craig County",4,31,49,26,23
050,51,045,"Virginia","Craig County",4,32,53,29,24
050,51,045,"Virginia","Craig County",4,33,46,22,24
050,51,045,"Virginia","Craig County",4,34,61,36,25
050,51,045,"Virginia","Craig County",4,35,55,30,25
050,51,045,"Virginia","Craig County",4,36,44,24,20
050,51,045,"Virginia","Craig County",4,37,44,27,17
050,51,045,"Virginia","Craig County",4,38,49,27,22
050,51,045,"Virginia","Craig County",4,39,42,22,20
050,51,045,"Virginia","Craig County",4,40,47,25,22
050,51,045,"Virginia","Craig County",4,41,47,21,26
050,51,045,"Virginia","Craig County",4,42,50,24,26
050,51,045,"Virginia","Craig County",4,43,50,26,24
050,51,045,"Virginia","Craig County",4,44,52,25,27
050,51,045,"Virginia","Craig County",4,45,62,30,32
050,51,045,"Virginia","Craig County",4,46,50,24,26
050,51,045,"Virginia","Craig County",4,47,58,31,27
050,51,045,"Virginia","Craig County",4,48,58,29,29
050,51,045,"Virginia","Craig County",4,49,69,35,34
050,51,045,"Virginia","Craig County",4,50,72,37,35
050,51,045,"Virginia","Craig County",4,51,80,44,36
050,51,045,"Virginia","Craig County",4,52,70,35,35
050,51,045,"Virginia","Craig County",4,53,73,35,38
050,51,045,"Virginia","Craig County",4,54,76,41,35
050,51,045,"Virginia","Craig County",4,55,75,42,33
050,51,045,"Virginia","Craig County",4,56,75,45,30
050,51,045,"Virginia","Craig County",4,57,80,44,36
050,51,045,"Virginia","Craig County",4,58,98,50,48
050,51,045,"Virginia","Craig County",4,59,86,43,43
050,51,045,"Virginia","Craig County",4,60,78,38,40
050,51,045,"Virginia","Craig County",4,61,86,45,41
050,51,045,"Virginia","Craig County",4,62,90,50,40
050,51,045,"Virginia","Craig County",4,63,85,43,42
050,51,045,"Virginia","Craig County",4,64,86,42,44
050,51,045,"Virginia","Craig County",4,65,81,42,39
050,51,045,"Virginia","Craig County",4,66,79,48,31
050,51,045,"Virginia","Craig County",4,67,73,36,37
050,51,045,"Virginia","Craig County",4,68,78,37,41
050,51,045,"Virginia","Craig County",4,69,70,35,35
050,51,045,"Virginia","Craig County",4,70,78,36,42
050,51,045,"Virginia","Craig County",4,71,58,26,32
050,51,045,"Virginia","Craig County",4,72,59,29,30
050,51,045,"Virginia","Craig County",4,73,64,35,29
050,51,045,"Virginia","Craig County",4,74,70,36,34
050,51,045,"Virginia","Craig County",4,75,66,30,36
050,51,045,"Virginia","Craig County",4,76,44,19,25
050,51,045,"Virginia","Craig County",4,77,39,17,22
050,51,045,"Virginia","Craig County",4,78,45,26,19
050,51,045,"Virginia","Craig County",4,79,39,20,19
050,51,045,"Virginia","Craig County",4,80,33,16,17
050,51,045,"Virginia","Craig County",4,81,30,13,17
050,51,045,"Virginia","Craig County",4,82,25,10,15
050,51,045,"Virginia","Craig County",4,83,29,13,16
050,51,045,"Virginia","Craig County",4,84,19,8,11
050,51,045,"Virginia","Craig County",4,85,137,47,90
050,51,045,"Virginia","Craig County",5,0,43,15,28
050,51,045,"Virginia","Craig County",5,1,49,20,29
050,51,045,"Virginia","Craig County",5,2,43,21,22
050,51,045,"Virginia","Craig County",5,3,38,23,15
050,51,045,"Virginia","Craig County",5,4,35,17,18
050,51,045,"Virginia","Craig County",5,5,33,15,18
050,51,045,"Virginia","Craig County",5,6,34,15,19
050,51,045,"Virginia","Craig County",5,7,50,19,31
050,51,045,"Virginia","Craig County",5,8,46,17,29
050,51,045,"Virginia","Craig County",5,9,51,26,25
050,51,045,"Virginia","Craig County",5,10,49,21,28
050,51,045,"Virginia","Craig County",5,11,41,24,17
050,51,045,"Virginia","Craig County",5,12,36,17,19
050,51,045,"Virginia","Craig County",5,13,49,22,27
050,51,045,"Virginia","Craig County",5,14,52,28,24
050,51,045,"Virginia","Craig County",5,15,52,23,29
050,51,045,"Virginia","Craig County",5,16,49,29,20
050,51,045,"Virginia","Craig County",5,17,52,30,22
050,51,045,"Virginia","Craig County",5,18,41,23,18
050,51,045,"Virginia","Craig County",5,19,41,22,19
050,51,045,"Virginia","Craig County",5,20,35,21,14
050,51,045,"Virginia","Craig County",5,21,42,16,26
050,51,045,"Virginia","Craig County",5,22,55,27,28
050,51,045,"Virginia","Craig County",5,23,54,28,26
050,51,045,"Virginia","Craig County",5,24,49,24,25
050,51,045,"Virginia","Craig County",5,25,45,21,24
050,51,045,"Virginia","Craig County",5,26,52,28,24
050,51,045,"Virginia","Craig County",5,27,48,20,28
050,51,045,"Virginia","Craig County",5,28,64,28,36
050,51,045,"Virginia","Craig County",5,29,42,27,15
050,51,045,"Virginia","Craig County",5,30,52,26,26
050,51,045,"Virginia","Craig County",5,31,59,31,28
050,51,045,"Virginia","Craig County",5,32,48,22,26
050,51,045,"Virginia","Craig County",5,33,52,29,23
050,51,045,"Virginia","Craig County",5,34,47,23,24
050,51,045,"Virginia","Craig County",5,35,64,38,26
050,51,045,"Virginia","Craig County",5,36,60,33,27
050,51,045,"Virginia","Craig County",5,37,41,21,20
050,51,045,"Virginia","Craig County",5,38,41,26,15
050,51,045,"Virginia","Craig County",5,39,49,26,23
050,51,045,"Virginia","Craig County",5,40,44,24,20
050,51,045,"Virginia","Craig County",5,41,47,25,22
050,51,045,"Virginia","Craig County",5,42,44,20,24
050,51,045,"Virginia","Craig County",5,43,48,22,26
050,51,045,"Virginia","Craig County",5,44,51,26,25
050,51,045,"Virginia","Craig County",5,45,53,25,28
050,51,045,"Virginia","Craig County",5,46,62,30,32
050,51,045,"Virginia","Craig County",5,47,52,23,29
050,51,045,"Virginia","Craig County",5,48,58,30,28
050,51,045,"Virginia","Craig County",5,49,57,28,29
050,51,045,"Virginia","Craig County",5,50,70,36,34
050,51,045,"Virginia","Craig County",5,51,72,38,34
050,51,045,"Virginia","Craig County",5,52,81,43,38
050,51,045,"Virginia","Craig County",5,53,68,32,36
050,51,045,"Virginia","Craig County",5,54,68,35,33
050,51,045,"Virginia","Craig County",5,55,75,41,34
050,51,045,"Virginia","Craig County",5,56,80,47,33
050,51,045,"Virginia","Craig County",5,57,74,44,30
050,51,045,"Virginia","Craig County",5,58,77,43,34
050,51,045,"Virginia","Craig County",5,59,98,49,49
050,51,045,"Virginia","Craig County",5,60,80,37,43
050,51,045,"Virginia","Craig County",5,61,79,39,40
050,51,045,"Virginia","Craig County",5,62,84,44,40
050,51,045,"Virginia","Craig County",5,63,90,50,40
050,51,045,"Virginia","Craig County",5,64,83,42,41
050,51,045,"Virginia","Craig County",5,65,86,43,43
050,51,045,"Virginia","Craig County",5,66,83,44,39
050,51,045,"Virginia","Craig County",5,67,75,43,32
050,51,045,"Virginia","Craig County",5,68,72,35,37
050,51,045,"Virginia","Craig County",5,69,76,36,40
050,51,045,"Virginia","Craig County",5,70,66,33,33
050,51,045,"Virginia","Craig County",5,71,72,32,40
050,51,045,"Virginia","Craig County",5,72,57,26,31
050,51,045,"Virginia","Craig County",5,73,60,29,31
050,51,045,"Virginia","Craig County",5,74,65,36,29
050,51,045,"Virginia","Craig County",5,75,72,36,36
050,51,045,"Virginia","Craig County",5,76,66,30,36
050,51,045,"Virginia","Craig County",5,77,44,19,25
050,51,045,"Virginia","Craig County",5,78,42,19,23
050,51,045,"Virginia","Craig County",5,79,43,24,19
050,51,045,"Virginia","Craig County",5,80,41,23,18
050,51,045,"Virginia","Craig County",5,81,30,15,15
050,51,045,"Virginia","Craig County",5,82,28,11,17
050,51,045,"Virginia","Craig County",5,83,23,9,14
050,51,045,"Virginia","Craig County",5,84,28,12,16
050,51,045,"Virginia","Craig County",5,85,136,49,87
050,51,047,"Virginia","Culpeper County",1,0,645,332,313
050,51,047,"Virginia","Culpeper County",1,1,669,354,315
050,51,047,"Virginia","Culpeper County",1,2,709,356,353
050,51,047,"Virginia","Culpeper County",1,3,727,353,374
050,51,047,"Virginia","Culpeper County",1,4,689,339,350
050,51,047,"Virginia","Culpeper County",1,5,714,353,361
050,51,047,"Virginia","Culpeper County",1,6,769,362,407
050,51,047,"Virginia","Culpeper County",1,7,735,374,361
050,51,047,"Virginia","Culpeper County",1,8,724,368,356
050,51,047,"Virginia","Culpeper County",1,9,693,338,355
050,51,047,"Virginia","Culpeper County",1,10,732,357,375
050,51,047,"Virginia","Culpeper County",1,11,785,375,410
050,51,047,"Virginia","Culpeper County",1,12,802,397,405
050,51,047,"Virginia","Culpeper County",1,13,801,405,396
050,51,047,"Virginia","Culpeper County",1,14,804,400,404
050,51,047,"Virginia","Culpeper County",1,15,782,376,406
050,51,047,"Virginia","Culpeper County",1,16,780,401,379
050,51,047,"Virginia","Culpeper County",1,17,736,367,369
050,51,047,"Virginia","Culpeper County",1,18,662,342,320
050,51,047,"Virginia","Culpeper County",1,19,561,296,265
050,51,047,"Virginia","Culpeper County",1,20,565,289,276
050,51,047,"Virginia","Culpeper County",1,21,527,250,277
050,51,047,"Virginia","Culpeper County",1,22,532,272,260
050,51,047,"Virginia","Culpeper County",1,23,576,299,277
050,51,047,"Virginia","Culpeper County",1,24,567,276,291
050,51,047,"Virginia","Culpeper County",1,25,555,278,277
050,51,047,"Virginia","Culpeper County",1,26,594,302,292
050,51,047,"Virginia","Culpeper County",1,27,601,330,271
050,51,047,"Virginia","Culpeper County",1,28,581,298,283
050,51,047,"Virginia","Culpeper County",1,29,611,305,306
050,51,047,"Virginia","Culpeper County",1,30,629,329,300
050,51,047,"Virginia","Culpeper County",1,31,635,332,303
050,51,047,"Virginia","Culpeper County",1,32,628,301,327
050,51,047,"Virginia","Culpeper County",1,33,633,313,320
050,51,047,"Virginia","Culpeper County",1,34,679,336,343
050,51,047,"Virginia","Culpeper County",1,35,676,335,341
050,51,047,"Virginia","Culpeper County",1,36,656,338,318
050,51,047,"Virginia","Culpeper County",1,37,717,385,332
050,51,047,"Virginia","Culpeper County",1,38,705,358,347
050,51,047,"Virginia","Culpeper County",1,39,707,377,330
050,51,047,"Virginia","Culpeper County",1,40,702,367,335
050,51,047,"Virginia","Culpeper County",1,41,668,346,322
050,51,047,"Virginia","Culpeper County",1,42,726,380,346
050,51,047,"Virginia","Culpeper County",1,43,672,344,328
050,51,047,"Virginia","Culpeper County",1,44,633,325,308
050,51,047,"Virginia","Culpeper County",1,45,602,304,298
050,51,047,"Virginia","Culpeper County",1,46,635,333,302
050,51,047,"Virginia","Culpeper County",1,47,653,341,312
050,51,047,"Virginia","Culpeper County",1,48,696,367,329
050,51,047,"Virginia","Culpeper County",1,49,710,383,327
050,51,047,"Virginia","Culpeper County",1,50,677,352,325
050,51,047,"Virginia","Culpeper County",1,51,682,360,322
050,51,047,"Virginia","Culpeper County",1,52,687,360,327
050,51,047,"Virginia","Culpeper County",1,53,668,346,322
050,51,047,"Virginia","Culpeper County",1,54,707,364,343
050,51,047,"Virginia","Culpeper County",1,55,797,387,410
050,51,047,"Virginia","Culpeper County",1,56,792,386,406
050,51,047,"Virginia","Culpeper County",1,57,774,410,364
050,51,047,"Virginia","Culpeper County",1,58,738,391,347
050,51,047,"Virginia","Culpeper County",1,59,737,377,360
050,51,047,"Virginia","Culpeper County",1,60,706,351,355
050,51,047,"Virginia","Culpeper County",1,61,675,341,334
050,51,047,"Virginia","Culpeper County",1,62,669,314,355
050,51,047,"Virginia","Culpeper County",1,63,633,301,332
050,51,047,"Virginia","Culpeper County",1,64,625,299,326
050,51,047,"Virginia","Culpeper County",1,65,591,282,309
050,51,047,"Virginia","Culpeper County",1,66,567,272,295
050,51,047,"Virginia","Culpeper County",1,67,575,288,287
050,51,047,"Virginia","Culpeper County",1,68,536,262,274
050,51,047,"Virginia","Culpeper County",1,69,493,248,245
050,51,047,"Virginia","Culpeper County",1,70,507,252,255
050,51,047,"Virginia","Culpeper County",1,71,516,244,272
050,51,047,"Virginia","Culpeper County",1,72,487,221,266
050,51,047,"Virginia","Culpeper County",1,73,460,214,246
050,51,047,"Virginia","Culpeper County",1,74,350,165,185
050,51,047,"Virginia","Culpeper County",1,75,341,151,190
050,51,047,"Virginia","Culpeper County",1,76,371,169,202
050,51,047,"Virginia","Culpeper County",1,77,328,159,169
050,51,047,"Virginia","Culpeper County",1,78,285,139,146
050,51,047,"Virginia","Culpeper County",1,79,254,119,135
050,51,047,"Virginia","Culpeper County",1,80,227,99,128
050,51,047,"Virginia","Culpeper County",1,81,211,102,109
050,51,047,"Virginia","Culpeper County",1,82,192,95,97
050,51,047,"Virginia","Culpeper County",1,83,165,72,93
050,51,047,"Virginia","Culpeper County",1,84,142,57,85
050,51,047,"Virginia","Culpeper County",1,85,795,303,492
050,51,047,"Virginia","Culpeper County",2,0,664,337,327
050,51,047,"Virginia","Culpeper County",2,1,669,352,317
050,51,047,"Virginia","Culpeper County",2,2,703,356,347
050,51,047,"Virginia","Culpeper County",2,3,722,353,369
050,51,047,"Virginia","Culpeper County",2,4,704,348,356
050,51,047,"Virginia","Culpeper County",2,5,715,353,362
050,51,047,"Virginia","Culpeper County",2,6,756,360,396
050,51,047,"Virginia","Culpeper County",2,7,747,373,374
050,51,047,"Virginia","Culpeper County",2,8,730,372,358
050,51,047,"Virginia","Culpeper County",2,9,703,347,356
050,51,047,"Virginia","Culpeper County",2,10,727,354,373
050,51,047,"Virginia","Culpeper County",2,11,771,371,400
050,51,047,"Virginia","Culpeper County",2,12,801,395,406
050,51,047,"Virginia","Culpeper County",2,13,799,404,395
050,51,047,"Virginia","Culpeper County",2,14,805,403,402
050,51,047,"Virginia","Culpeper County",2,15,798,388,410
050,51,047,"Virginia","Culpeper County",2,16,784,396,388
050,51,047,"Virginia","Culpeper County",2,17,749,375,374
050,51,047,"Virginia","Culpeper County",2,18,654,338,316
050,51,047,"Virginia","Culpeper County",2,19,563,293,270
050,51,047,"Virginia","Culpeper County",2,20,576,295,281
050,51,047,"Virginia","Culpeper County",2,21,539,262,277
050,51,047,"Virginia","Culpeper County",2,22,539,270,269
050,51,047,"Virginia","Culpeper County",2,23,572,295,277
050,51,047,"Virginia","Culpeper County",2,24,573,284,289
050,51,047,"Virginia","Culpeper County",2,25,564,281,283
050,51,047,"Virginia","Culpeper County",2,26,590,300,290
050,51,047,"Virginia","Culpeper County",2,27,598,323,275
050,51,047,"Virginia","Culpeper County",2,28,593,309,284
050,51,047,"Virginia","Culpeper County",2,29,610,310,300
050,51,047,"Virginia","Culpeper County",2,30,634,330,304
050,51,047,"Virginia","Culpeper County",2,31,635,331,304
050,51,047,"Virginia","Culpeper County",2,32,634,310,324
050,51,047,"Virginia","Culpeper County",2,33,633,312,321
050,51,047,"Virginia","Culpeper County",2,34,673,332,341
050,51,047,"Virginia","Culpeper County",2,35,678,336,342
050,51,047,"Virginia","Culpeper County",2,36,657,335,322
050,51,047,"Virginia","Culpeper County",2,37,703,372,331
050,51,047,"Virginia","Culpeper County",2,38,714,367,347
050,51,047,"Virginia","Culpeper County",2,39,710,374,336
050,51,047,"Virginia","Culpeper County",2,40,708,372,336
050,51,047,"Virginia","Culpeper County",2,41,680,354,326
050,51,047,"Virginia","Culpeper County",2,42,711,372,339
050,51,047,"Virginia","Culpeper County",2,43,688,354,334
050,51,047,"Virginia","Culpeper County",2,44,637,329,308
050,51,047,"Virginia","Culpeper County",2,45,612,310,302
050,51,047,"Virginia","Culpeper County",2,46,626,325,301
050,51,047,"Virginia","Culpeper County",2,47,651,339,312
050,51,047,"Virginia","Culpeper County",2,48,689,363,326
050,51,047,"Virginia","Culpeper County",2,49,710,379,331
050,51,047,"Virginia","Culpeper County",2,50,690,361,329
050,51,047,"Virginia","Culpeper County",2,51,677,357,320
050,51,047,"Virginia","Culpeper County",2,52,684,359,325
050,51,047,"Virginia","Culpeper County",2,53,673,347,326
050,51,047,"Virginia","Culpeper County",2,54,694,356,338
050,51,047,"Virginia","Culpeper County",2,55,775,381,394
050,51,047,"Virginia","Culpeper County",2,56,796,389,407
050,51,047,"Virginia","Culpeper County",2,57,774,404,370
050,51,047,"Virginia","Culpeper County",2,58,749,395,354
050,51,047,"Virginia","Culpeper County",2,59,745,384,361
050,51,047,"Virginia","Culpeper County",2,60,716,357,359
050,51,047,"Virginia","Culpeper County",2,61,688,347,341
050,51,047,"Virginia","Culpeper County",2,62,670,319,351
050,51,047,"Virginia","Culpeper County",2,63,647,306,341
050,51,047,"Virginia","Culpeper County",2,64,628,301,327
050,51,047,"Virginia","Culpeper County",2,65,595,284,311
050,51,047,"Virginia","Culpeper County",2,66,573,274,299
050,51,047,"Virginia","Culpeper County",2,67,571,284,287
050,51,047,"Virginia","Culpeper County",2,68,541,267,274
050,51,047,"Virginia","Culpeper County",2,69,504,252,252
050,51,047,"Virginia","Culpeper County",2,70,501,247,254
050,51,047,"Virginia","Culpeper County",2,71,512,245,267
050,51,047,"Virginia","Culpeper County",2,72,485,222,263
050,51,047,"Virginia","Culpeper County",2,73,489,226,263
050,51,047,"Virginia","Culpeper County",2,74,354,168,186
050,51,047,"Virginia","Culpeper County",2,75,342,151,191
050,51,047,"Virginia","Culpeper County",2,76,365,164,201
050,51,047,"Virginia","Culpeper County",2,77,335,159,176
050,51,047,"Virginia","Culpeper County",2,78,285,138,147
050,51,047,"Virginia","Culpeper County",2,79,262,125,137
050,51,047,"Virginia","Culpeper County",2,80,226,98,128
050,51,047,"Virginia","Culpeper County",2,81,210,100,110
050,51,047,"Virginia","Culpeper County",2,82,195,96,99
050,51,047,"Virginia","Culpeper County",2,83,166,73,93
050,51,047,"Virginia","Culpeper County",2,84,144,57,87
050,51,047,"Virginia","Culpeper County",2,85,806,309,497
050,51,047,"Virginia","Culpeper County",3,0,669,343,326
050,51,047,"Virginia","Culpeper County",3,1,669,358,311
050,51,047,"Virginia","Culpeper County",3,2,691,355,336
050,51,047,"Virginia","Culpeper County",3,3,707,356,351
050,51,047,"Virginia","Culpeper County",3,4,741,350,391
050,51,047,"Virginia","Culpeper County",3,5,739,370,369
050,51,047,"Virginia","Culpeper County",3,6,741,372,369
050,51,047,"Virginia","Culpeper County",3,7,788,377,411
050,51,047,"Virginia","Culpeper County",3,8,774,393,381
050,51,047,"Virginia","Culpeper County",3,9,752,390,362
050,51,047,"Virginia","Culpeper County",3,10,713,347,366
050,51,047,"Virginia","Culpeper County",3,11,765,369,396
050,51,047,"Virginia","Culpeper County",3,12,775,379,396
050,51,047,"Virginia","Culpeper County",3,13,821,404,417
050,51,047,"Virginia","Culpeper County",3,14,819,403,416
050,51,047,"Virginia","Culpeper County",3,15,820,404,416
050,51,047,"Virginia","Culpeper County",3,16,816,402,414
050,51,047,"Virginia","Culpeper County",3,17,779,397,382
050,51,047,"Virginia","Culpeper County",3,18,667,337,330
050,51,047,"Virginia","Culpeper County",3,19,542,271,271
050,51,047,"Virginia","Culpeper County",3,20,605,310,295
050,51,047,"Virginia","Culpeper County",3,21,595,312,283
050,51,047,"Virginia","Culpeper County",3,22,547,262,285
050,51,047,"Virginia","Culpeper County",3,23,569,278,291
050,51,047,"Virginia","Culpeper County",3,24,588,304,284
050,51,047,"Virginia","Culpeper County",3,25,589,297,292
050,51,047,"Virginia","Culpeper County",3,26,532,271,261
050,51,047,"Virginia","Culpeper County",3,27,610,308,302
050,51,047,"Virginia","Culpeper County",3,28,612,312,300
050,51,047,"Virginia","Culpeper County",3,29,636,336,300
050,51,047,"Virginia","Culpeper County",3,30,632,319,313
050,51,047,"Virginia","Culpeper County",3,31,668,349,319
050,51,047,"Virginia","Culpeper County",3,32,668,358,310
050,51,047,"Virginia","Culpeper County",3,33,626,302,324
050,51,047,"Virginia","Culpeper County",3,34,647,318,329
050,51,047,"Virginia","Culpeper County",3,35,685,354,331
050,51,047,"Virginia","Culpeper County",3,36,717,362,355
050,51,047,"Virginia","Culpeper County",3,37,667,342,325
050,51,047,"Virginia","Culpeper County",3,38,706,371,335
050,51,047,"Virginia","Culpeper County",3,39,740,396,344
050,51,047,"Virginia","Culpeper County",3,40,725,385,340
050,51,047,"Virginia","Culpeper County",3,41,739,392,347
050,51,047,"Virginia","Culpeper County",3,42,727,378,349
050,51,047,"Virginia","Culpeper County",3,43,725,374,351
050,51,047,"Virginia","Culpeper County",3,44,694,358,336
050,51,047,"Virginia","Culpeper County",3,45,642,329,313
050,51,047,"Virginia","Culpeper County",3,46,645,321,324
050,51,047,"Virginia","Culpeper County",3,47,635,334,301
050,51,047,"Virginia","Culpeper County",3,48,652,352,300
050,51,047,"Virginia","Culpeper County",3,49,670,337,333
050,51,047,"Virginia","Culpeper County",3,50,706,380,326
050,51,047,"Virginia","Culpeper County",3,51,702,366,336
050,51,047,"Virginia","Culpeper County",3,52,689,366,323
050,51,047,"Virginia","Culpeper County",3,53,681,357,324
050,51,047,"Virginia","Culpeper County",3,54,649,336,313
050,51,047,"Virginia","Culpeper County",3,55,692,344,348
050,51,047,"Virginia","Culpeper County",3,56,799,387,412
050,51,047,"Virginia","Culpeper County",3,57,800,398,402
050,51,047,"Virginia","Culpeper County",3,58,752,388,364
050,51,047,"Virginia","Culpeper County",3,59,736,382,354
050,51,047,"Virginia","Culpeper County",3,60,743,383,360
050,51,047,"Virginia","Culpeper County",3,61,716,364,352
050,51,047,"Virginia","Culpeper County",3,62,686,346,340
050,51,047,"Virginia","Culpeper County",3,63,668,318,350
050,51,047,"Virginia","Culpeper County",3,64,663,316,347
050,51,047,"Virginia","Culpeper County",3,65,615,295,320
050,51,047,"Virginia","Culpeper County",3,66,593,282,311
050,51,047,"Virginia","Culpeper County",3,67,581,281,300
050,51,047,"Virginia","Culpeper County",3,68,556,282,274
050,51,047,"Virginia","Culpeper County",3,69,539,264,275
050,51,047,"Virginia","Culpeper County",3,70,502,251,251
050,51,047,"Virginia","Culpeper County",3,71,497,247,250
050,51,047,"Virginia","Culpeper County",3,72,484,227,257
050,51,047,"Virginia","Culpeper County",3,73,480,219,261
050,51,047,"Virginia","Culpeper County",3,74,478,222,256
050,51,047,"Virginia","Culpeper County",3,75,350,159,191
050,51,047,"Virginia","Culpeper County",3,76,358,159,199
050,51,047,"Virginia","Culpeper County",3,77,341,159,182
050,51,047,"Virginia","Culpeper County",3,78,319,152,167
050,51,047,"Virginia","Culpeper County",3,79,290,141,149
050,51,047,"Virginia","Culpeper County",3,80,250,119,131
050,51,047,"Virginia","Culpeper County",3,81,219,91,128
050,51,047,"Virginia","Culpeper County",3,82,219,110,109
050,51,047,"Virginia","Culpeper County",3,83,177,81,96
050,51,047,"Virginia","Culpeper County",3,84,158,67,91
050,51,047,"Virginia","Culpeper County",3,85,803,318,485
050,51,047,"Virginia","Culpeper County",4,0,664,337,327
050,51,047,"Virginia","Culpeper County",4,1,665,337,328
050,51,047,"Virginia","Culpeper County",4,2,700,372,328
050,51,047,"Virginia","Culpeper County",4,3,693,349,344
050,51,047,"Virginia","Culpeper County",4,4,684,340,344
050,51,047,"Virginia","Culpeper County",4,5,765,364,401
050,51,047,"Virginia","Culpeper County",4,6,743,369,374
050,51,047,"Virginia","Culpeper County",4,7,744,375,369
050,51,047,"Virginia","Culpeper County",4,8,809,389,420
050,51,047,"Virginia","Culpeper County",4,9,765,406,359
050,51,047,"Virginia","Culpeper County",4,10,771,401,370
050,51,047,"Virginia","Culpeper County",4,11,719,351,368
050,51,047,"Virginia","Culpeper County",4,12,787,379,408
050,51,047,"Virginia","Culpeper County",4,13,782,384,398
050,51,047,"Virginia","Culpeper County",4,14,840,414,426
050,51,047,"Virginia","Culpeper County",4,15,813,397,416
050,51,047,"Virginia","Culpeper County",4,16,837,413,424
050,51,047,"Virginia","Culpeper County",4,17,820,408,412
050,51,047,"Virginia","Culpeper County",4,18,681,360,321
050,51,047,"Virginia","Culpeper County",4,19,554,279,275
050,51,047,"Virginia","Culpeper County",4,20,588,286,302
050,51,047,"Virginia","Culpeper County",4,21,628,321,307
050,51,047,"Virginia","Culpeper County",4,22,614,308,306
050,51,047,"Virginia","Culpeper County",4,23,578,283,295
050,51,047,"Virginia","Culpeper County",4,24,556,287,269
050,51,047,"Virginia","Culpeper County",4,25,584,310,274
050,51,047,"Virginia","Culpeper County",4,26,610,323,287
050,51,047,"Virginia","Culpeper County",4,27,543,268,275
050,51,047,"Virginia","Culpeper County",4,28,617,320,297
050,51,047,"Virginia","Culpeper County",4,29,634,334,300
050,51,047,"Virginia","Culpeper County",4,30,622,318,304
050,51,047,"Virginia","Culpeper County",4,31,651,340,311
050,51,047,"Virginia","Culpeper County",4,32,689,350,339
050,51,047,"Virginia","Culpeper County",4,33,694,372,322
050,51,047,"Virginia","Culpeper County",4,34,648,303,345
050,51,047,"Virginia","Culpeper County",4,35,656,336,320
050,51,047,"Virginia","Culpeper County",4,36,732,381,351
050,51,047,"Virginia","Culpeper County",4,37,742,380,362
050,51,047,"Virginia","Culpeper County",4,38,687,349,338
050,51,047,"Virginia","Culpeper County",4,39,714,376,338
050,51,047,"Virginia","Culpeper County",4,40,759,408,351
050,51,047,"Virginia","Culpeper County",4,41,730,388,342
050,51,047,"Virginia","Culpeper County",4,42,758,408,350
050,51,047,"Virginia","Culpeper County",4,43,715,358,357
050,51,047,"Virginia","Culpeper County",4,44,736,385,351
050,51,047,"Virginia","Culpeper County",4,45,709,362,347
050,51,047,"Virginia","Culpeper County",4,46,647,333,314
050,51,047,"Virginia","Culpeper County",4,47,649,329,320
050,51,047,"Virginia","Culpeper County",4,48,637,340,297
050,51,047,"Virginia","Culpeper County",4,49,643,335,308
050,51,047,"Virginia","Culpeper County",4,50,673,337,336
050,51,047,"Virginia","Culpeper County",4,51,710,370,340
050,51,047,"Virginia","Culpeper County",4,52,691,360,331
050,51,047,"Virginia","Culpeper County",4,53,668,356,312
050,51,047,"Virginia","Culpeper County",4,54,655,348,307
050,51,047,"Virginia","Culpeper County",4,55,635,328,307
050,51,047,"Virginia","Culpeper County",4,56,692,343,349
050,51,047,"Virginia","Culpeper County",4,57,781,386,395
050,51,047,"Virginia","Culpeper County",4,58,771,369,402
050,51,047,"Virginia","Culpeper County",4,59,760,400,360
050,51,047,"Virginia","Culpeper County",4,60,752,390,362
050,51,047,"Virginia","Culpeper County",4,61,738,378,360
050,51,047,"Virginia","Culpeper County",4,62,713,354,359
050,51,047,"Virginia","Culpeper County",4,63,686,343,343
050,51,047,"Virginia","Culpeper County",4,64,660,313,347
050,51,047,"Virginia","Culpeper County",4,65,669,314,355
050,51,047,"Virginia","Culpeper County",4,66,611,292,319
050,51,047,"Virginia","Culpeper County",4,67,587,276,311
050,51,047,"Virginia","Culpeper County",4,68,574,278,296
050,51,047,"Virginia","Culpeper County",4,69,535,259,276
050,51,047,"Virginia","Culpeper County",4,70,524,253,271
050,51,047,"Virginia","Culpeper County",4,71,485,244,241
050,51,047,"Virginia","Culpeper County",4,72,473,232,241
050,51,047,"Virginia","Culpeper County",4,73,489,229,260
050,51,047,"Virginia","Culpeper County",4,74,471,216,255
050,51,047,"Virginia","Culpeper County",4,75,455,207,248
050,51,047,"Virginia","Culpeper County",4,76,354,157,197
050,51,047,"Virginia","Culpeper County",4,77,337,157,180
050,51,047,"Virginia","Culpeper County",4,78,330,150,180
050,51,047,"Virginia","Culpeper County",4,79,316,150,166
050,51,047,"Virginia","Culpeper County",4,80,275,127,148
050,51,047,"Virginia","Culpeper County",4,81,234,109,125
050,51,047,"Virginia","Culpeper County",4,82,217,96,121
050,51,047,"Virginia","Culpeper County",4,83,204,95,109
050,51,047,"Virginia","Culpeper County",4,84,171,75,96
050,51,047,"Virginia","Culpeper County",4,85,788,316,472
050,51,047,"Virginia","Culpeper County",5,0,660,334,326
050,51,047,"Virginia","Culpeper County",5,1,668,334,334
050,51,047,"Virginia","Culpeper County",5,2,683,342,341
050,51,047,"Virginia","Culpeper County",5,3,722,375,347
050,51,047,"Virginia","Culpeper County",5,4,704,358,346
050,51,047,"Virginia","Culpeper County",5,5,687,341,346
050,51,047,"Virginia","Culpeper County",5,6,749,361,388
050,51,047,"Virginia","Culpeper County",5,7,781,403,378
050,51,047,"Virginia","Culpeper County",5,8,761,377,384
050,51,047,"Virginia","Culpeper County",5,9,831,402,429
050,51,047,"Virginia","Culpeper County",5,10,777,414,363
050,51,047,"Virginia","Culpeper County",5,11,786,412,374
050,51,047,"Virginia","Culpeper County",5,12,725,351,374
050,51,047,"Virginia","Culpeper County",5,13,804,387,417
050,51,047,"Virginia","Culpeper County",5,14,808,390,418
050,51,047,"Virginia","Culpeper County",5,15,854,413,441
050,51,047,"Virginia","Culpeper County",5,16,828,412,416
050,51,047,"Virginia","Culpeper County",5,17,851,416,435
050,51,047,"Virginia","Culpeper County",5,18,719,369,350
050,51,047,"Virginia","Culpeper County",5,19,548,289,259
050,51,047,"Virginia","Culpeper County",5,20,596,294,302
050,51,047,"Virginia","Culpeper County",5,21,607,293,314
050,51,047,"Virginia","Culpeper County",5,22,651,330,321
050,51,047,"Virginia","Culpeper County",5,23,626,318,308
050,51,047,"Virginia","Culpeper County",5,24,581,293,288
050,51,047,"Virginia","Culpeper County",5,25,540,277,263
050,51,047,"Virginia","Culpeper County",5,26,603,318,285
050,51,047,"Virginia","Culpeper County",5,27,617,321,296
050,51,047,"Virginia","Culpeper County",5,28,535,268,267
050,51,047,"Virginia","Culpeper County",5,29,642,333,309
050,51,047,"Virginia","Culpeper County",5,30,627,329,298
050,51,047,"Virginia","Culpeper County",5,31,665,344,321
050,51,047,"Virginia","Culpeper County",5,32,658,341,317
050,51,047,"Virginia","Culpeper County",5,33,693,345,348
050,51,047,"Virginia","Culpeper County",5,34,700,369,331
050,51,047,"Virginia","Culpeper County",5,35,674,321,353
050,51,047,"Virginia","Culpeper County",5,36,685,366,319
050,51,047,"Virginia","Culpeper County",5,37,750,388,362
050,51,047,"Virginia","Culpeper County",5,38,750,376,374
050,51,047,"Virginia","Culpeper County",5,39,704,362,342
050,51,047,"Virginia","Culpeper County",5,40,716,371,345
050,51,047,"Virginia","Culpeper County",5,41,754,405,349
050,51,047,"Virginia","Culpeper County",5,42,737,404,333
050,51,047,"Virginia","Culpeper County",5,43,739,393,346
050,51,047,"Virginia","Culpeper County",5,44,720,366,354
050,51,047,"Virginia","Culpeper County",5,45,728,380,348
050,51,047,"Virginia","Culpeper County",5,46,731,378,353
050,51,047,"Virginia","Culpeper County",5,47,651,340,311
050,51,047,"Virginia","Culpeper County",5,48,649,330,319
050,51,047,"Virginia","Culpeper County",5,49,617,318,299
050,51,047,"Virginia","Culpeper County",5,50,642,339,303
050,51,047,"Virginia","Culpeper County",5,51,685,341,344
050,51,047,"Virginia","Culpeper County",5,52,730,376,354
050,51,047,"Virginia","Culpeper County",5,53,693,357,336
050,51,047,"Virginia","Culpeper County",5,54,673,360,313
050,51,047,"Virginia","Culpeper County",5,55,652,342,310
050,51,047,"Virginia","Culpeper County",5,56,637,327,310
050,51,047,"Virginia","Culpeper County",5,57,691,343,348
050,51,047,"Virginia","Culpeper County",5,58,778,378,400
050,51,047,"Virginia","Culpeper County",5,59,764,369,395
050,51,047,"Virginia","Culpeper County",5,60,765,397,368
050,51,047,"Virginia","Culpeper County",5,61,744,388,356
050,51,047,"Virginia","Culpeper County",5,62,729,373,356
050,51,047,"Virginia","Culpeper County",5,63,713,356,357
050,51,047,"Virginia","Culpeper County",5,64,706,355,351
050,51,047,"Virginia","Culpeper County",5,65,654,300,354
050,51,047,"Virginia","Culpeper County",5,66,669,310,359
050,51,047,"Virginia","Culpeper County",5,67,608,302,306
050,51,047,"Virginia","Culpeper County",5,68,581,274,307
050,51,047,"Virginia","Culpeper County",5,69,579,273,306
050,51,047,"Virginia","Culpeper County",5,70,525,249,276
050,51,047,"Virginia","Culpeper County",5,71,515,249,266
050,51,047,"Virginia","Culpeper County",5,72,460,222,238
050,51,047,"Virginia","Culpeper County",5,73,467,228,239
050,51,047,"Virginia","Culpeper County",5,74,478,228,250
050,51,047,"Virginia","Culpeper County",5,75,453,201,252
050,51,047,"Virginia","Culpeper County",5,76,466,211,255
050,51,047,"Virginia","Culpeper County",5,77,330,152,178
050,51,047,"Virginia","Culpeper County",5,78,325,149,176
050,51,047,"Virginia","Culpeper County",5,79,331,146,185
050,51,047,"Virginia","Culpeper County",5,80,304,144,160
050,51,047,"Virginia","Culpeper County",5,81,272,116,156
050,51,047,"Virginia","Culpeper County",5,82,230,113,117
050,51,047,"Virginia","Culpeper County",5,83,203,84,119
050,51,047,"Virginia","Culpeper County",5,84,199,91,108
050,51,047,"Virginia","Culpeper County",5,85,830,341,489
050,51,049,"Virginia","Cumberland County",1,0,98,52,46
050,51,049,"Virginia","Cumberland County",1,1,112,58,54
050,51,049,"Virginia","Cumberland County",1,2,88,44,44
050,51,049,"Virginia","Cumberland County",1,3,104,46,58
050,51,049,"Virginia","Cumberland County",1,4,103,52,51
050,51,049,"Virginia","Cumberland County",1,5,105,51,54
050,51,049,"Virginia","Cumberland County",1,6,109,51,58
050,51,049,"Virginia","Cumberland County",1,7,98,53,45
050,51,049,"Virginia","Cumberland County",1,8,97,46,51
050,51,049,"Virginia","Cumberland County",1,9,100,52,48
050,51,049,"Virginia","Cumberland County",1,10,113,59,54
050,51,049,"Virginia","Cumberland County",1,11,109,54,55
050,51,049,"Virginia","Cumberland County",1,12,118,56,62
050,51,049,"Virginia","Cumberland County",1,13,113,53,60
050,51,049,"Virginia","Cumberland County",1,14,117,63,54
050,51,049,"Virginia","Cumberland County",1,15,108,58,50
050,51,049,"Virginia","Cumberland County",1,16,106,53,53
050,51,049,"Virginia","Cumberland County",1,17,112,58,54
050,51,049,"Virginia","Cumberland County",1,18,100,48,52
050,51,049,"Virginia","Cumberland County",1,19,97,48,49
050,51,049,"Virginia","Cumberland County",1,20,93,46,47
050,51,049,"Virginia","Cumberland County",1,21,94,46,48
050,51,049,"Virginia","Cumberland County",1,22,91,43,48
050,51,049,"Virginia","Cumberland County",1,23,91,40,51
050,51,049,"Virginia","Cumberland County",1,24,107,48,59
050,51,049,"Virginia","Cumberland County",1,25,117,58,59
050,51,049,"Virginia","Cumberland County",1,26,118,56,62
050,51,049,"Virginia","Cumberland County",1,27,110,52,58
050,51,049,"Virginia","Cumberland County",1,28,120,57,63
050,51,049,"Virginia","Cumberland County",1,29,129,66,63
050,51,049,"Virginia","Cumberland County",1,30,109,53,56
050,51,049,"Virginia","Cumberland County",1,31,119,54,65
050,51,049,"Virginia","Cumberland County",1,32,101,43,58
050,51,049,"Virginia","Cumberland County",1,33,114,53,61
050,51,049,"Virginia","Cumberland County",1,34,111,65,46
050,51,049,"Virginia","Cumberland County",1,35,93,54,39
050,51,049,"Virginia","Cumberland County",1,36,94,46,48
050,51,049,"Virginia","Cumberland County",1,37,101,50,51
050,51,049,"Virginia","Cumberland County",1,38,97,53,44
050,51,049,"Virginia","Cumberland County",1,39,102,49,53
050,51,049,"Virginia","Cumberland County",1,40,98,44,54
050,51,049,"Virginia","Cumberland County",1,41,109,44,65
050,51,049,"Virginia","Cumberland County",1,42,93,40,53
050,51,049,"Virginia","Cumberland County",1,43,98,48,50
050,51,049,"Virginia","Cumberland County",1,44,94,48,46
050,51,049,"Virginia","Cumberland County",1,45,96,40,56
050,51,049,"Virginia","Cumberland County",1,46,105,48,57
050,51,049,"Virginia","Cumberland County",1,47,104,50,54
050,51,049,"Virginia","Cumberland County",1,48,113,54,59
050,51,049,"Virginia","Cumberland County",1,49,139,69,70
050,51,049,"Virginia","Cumberland County",1,50,131,66,65
050,51,049,"Virginia","Cumberland County",1,51,128,59,69
050,51,049,"Virginia","Cumberland County",1,52,138,69,69
050,51,049,"Virginia","Cumberland County",1,53,148,71,77
050,51,049,"Virginia","Cumberland County",1,54,141,73,68
050,51,049,"Virginia","Cumberland County",1,55,157,79,78
050,51,049,"Virginia","Cumberland County",1,56,183,96,87
050,51,049,"Virginia","Cumberland County",1,57,170,95,75
050,51,049,"Virginia","Cumberland County",1,58,168,85,83
050,51,049,"Virginia","Cumberland County",1,59,157,77,80
050,51,049,"Virginia","Cumberland County",1,60,161,81,80
050,51,049,"Virginia","Cumberland County",1,61,149,75,74
050,51,049,"Virginia","Cumberland County",1,62,130,63,67
050,51,049,"Virginia","Cumberland County",1,63,139,68,71
050,51,049,"Virginia","Cumberland County",1,64,144,73,71
050,51,049,"Virginia","Cumberland County",1,65,130,62,68
050,51,049,"Virginia","Cumberland County",1,66,134,58,76
050,51,049,"Virginia","Cumberland County",1,67,126,52,74
050,51,049,"Virginia","Cumberland County",1,68,133,57,76
050,51,049,"Virginia","Cumberland County",1,69,119,57,62
050,51,049,"Virginia","Cumberland County",1,70,132,72,60
050,51,049,"Virginia","Cumberland County",1,71,134,65,69
050,51,049,"Virginia","Cumberland County",1,72,138,65,73
050,51,049,"Virginia","Cumberland County",1,73,151,73,78
050,51,049,"Virginia","Cumberland County",1,74,99,47,52
050,51,049,"Virginia","Cumberland County",1,75,89,47,42
050,51,049,"Virginia","Cumberland County",1,76,82,39,43
050,51,049,"Virginia","Cumberland County",1,77,88,44,44
050,51,049,"Virginia","Cumberland County",1,78,82,39,43
050,51,049,"Virginia","Cumberland County",1,79,67,30,37
050,51,049,"Virginia","Cumberland County",1,80,66,37,29
050,51,049,"Virginia","Cumberland County",1,81,58,21,37
050,51,049,"Virginia","Cumberland County",1,82,41,16,25
050,51,049,"Virginia","Cumberland County",1,83,40,15,25
050,51,049,"Virginia","Cumberland County",1,84,39,16,23
050,51,049,"Virginia","Cumberland County",1,85,217,83,134
050,51,049,"Virginia","Cumberland County",2,0,93,47,46
050,51,049,"Virginia","Cumberland County",2,1,106,55,51
050,51,049,"Virginia","Cumberland County",2,2,96,48,48
050,51,049,"Virginia","Cumberland County",2,3,99,45,54
050,51,049,"Virginia","Cumberland County",2,4,105,51,54
050,51,049,"Virginia","Cumberland County",2,5,106,51,55
050,51,049,"Virginia","Cumberland County",2,6,106,49,57
050,51,049,"Virginia","Cumberland County",2,7,98,50,48
050,51,049,"Virginia","Cumberland County",2,8,97,47,50
050,51,049,"Virginia","Cumberland County",2,9,98,50,48
050,51,049,"Virginia","Cumberland County",2,10,111,59,52
050,51,049,"Virginia","Cumberland County",2,11,111,57,54
050,51,049,"Virginia","Cumberland County",2,12,117,56,61
050,51,049,"Virginia","Cumberland County",2,13,116,55,61
050,51,049,"Virginia","Cumberland County",2,14,116,61,55
050,51,049,"Virginia","Cumberland County",2,15,111,59,52
050,51,049,"Virginia","Cumberland County",2,16,105,54,51
050,51,049,"Virginia","Cumberland County",2,17,111,58,53
050,51,049,"Virginia","Cumberland County",2,18,100,49,51
050,51,049,"Virginia","Cumberland County",2,19,94,46,48
050,51,049,"Virginia","Cumberland County",2,20,97,47,50
050,51,049,"Virginia","Cumberland County",2,21,94,45,49
050,51,049,"Virginia","Cumberland County",2,22,91,43,48
050,51,049,"Virginia","Cumberland County",2,23,92,39,53
050,51,049,"Virginia","Cumberland County",2,24,105,47,58
050,51,049,"Virginia","Cumberland County",2,25,115,55,60
050,51,049,"Virginia","Cumberland County",2,26,116,55,61
050,51,049,"Virginia","Cumberland County",2,27,111,52,59
050,51,049,"Virginia","Cumberland County",2,28,120,57,63
050,51,049,"Virginia","Cumberland County",2,29,124,62,62
050,51,049,"Virginia","Cumberland County",2,30,113,57,56
050,51,049,"Virginia","Cumberland County",2,31,117,54,63
050,51,049,"Virginia","Cumberland County",2,32,105,46,59
050,51,049,"Virginia","Cumberland County",2,33,111,52,59
050,51,049,"Virginia","Cumberland County",2,34,110,62,48
050,51,049,"Virginia","Cumberland County",2,35,99,58,41
050,51,049,"Virginia","Cumberland County",2,36,95,48,47
050,51,049,"Virginia","Cumberland County",2,37,99,49,50
050,51,049,"Virginia","Cumberland County",2,38,99,53,46
050,51,049,"Virginia","Cumberland County",2,39,102,51,51
050,51,049,"Virginia","Cumberland County",2,40,99,46,53
050,51,049,"Virginia","Cumberland County",2,41,107,44,63
050,51,049,"Virginia","Cumberland County",2,42,98,43,55
050,51,049,"Virginia","Cumberland County",2,43,97,47,50
050,51,049,"Virginia","Cumberland County",2,44,95,48,47
050,51,049,"Virginia","Cumberland County",2,45,95,41,54
050,51,049,"Virginia","Cumberland County",2,46,104,47,57
050,51,049,"Virginia","Cumberland County",2,47,105,49,56
050,51,049,"Virginia","Cumberland County",2,48,112,53,59
050,51,049,"Virginia","Cumberland County",2,49,134,67,67
050,51,049,"Virginia","Cumberland County",2,50,134,67,67
050,51,049,"Virginia","Cumberland County",2,51,129,61,68
050,51,049,"Virginia","Cumberland County",2,52,135,66,69
050,51,049,"Virginia","Cumberland County",2,53,146,71,75
050,51,049,"Virginia","Cumberland County",2,54,142,72,70
050,51,049,"Virginia","Cumberland County",2,55,155,78,77
050,51,049,"Virginia","Cumberland County",2,56,177,92,85
050,51,049,"Virginia","Cumberland County",2,57,173,96,77
050,51,049,"Virginia","Cumberland County",2,58,166,86,80
050,51,049,"Virginia","Cumberland County",2,59,161,79,82
050,51,049,"Virginia","Cumberland County",2,60,159,81,78
050,51,049,"Virginia","Cumberland County",2,61,148,74,74
050,51,049,"Virginia","Cumberland County",2,62,133,64,69
050,51,049,"Virginia","Cumberland County",2,63,139,67,72
050,51,049,"Virginia","Cumberland County",2,64,141,71,70
050,51,049,"Virginia","Cumberland County",2,65,134,65,69
050,51,049,"Virginia","Cumberland County",2,66,131,58,73
050,51,049,"Virginia","Cumberland County",2,67,124,54,70
050,51,049,"Virginia","Cumberland County",2,68,131,55,76
050,51,049,"Virginia","Cumberland County",2,69,124,58,66
050,51,049,"Virginia","Cumberland County",2,70,129,70,59
050,51,049,"Virginia","Cumberland County",2,71,132,67,65
050,51,049,"Virginia","Cumberland County",2,72,134,64,70
050,51,049,"Virginia","Cumberland County",2,73,154,74,80
050,51,049,"Virginia","Cumberland County",2,74,105,50,55
050,51,049,"Virginia","Cumberland County",2,75,93,48,45
050,51,049,"Virginia","Cumberland County",2,76,81,40,41
050,51,049,"Virginia","Cumberland County",2,77,88,43,45
050,51,049,"Virginia","Cumberland County",2,78,80,39,41
050,51,049,"Virginia","Cumberland County",2,79,70,32,38
050,51,049,"Virginia","Cumberland County",2,80,67,36,31
050,51,049,"Virginia","Cumberland County",2,81,57,22,35
050,51,049,"Virginia","Cumberland County",2,82,44,17,27
050,51,049,"Virginia","Cumberland County",2,83,39,16,23
050,51,049,"Virginia","Cumberland County",2,84,39,16,23
050,51,049,"Virginia","Cumberland County",2,85,215,81,134
050,51,049,"Virginia","Cumberland County",3,0,76,36,40
050,51,049,"Virginia","Cumberland County",3,1,105,52,53
050,51,049,"Virginia","Cumberland County",3,2,110,55,55
050,51,049,"Virginia","Cumberland County",3,3,92,41,51
050,51,049,"Virginia","Cumberland County",3,4,108,48,60
050,51,049,"Virginia","Cumberland County",3,5,106,52,54
050,51,049,"Virginia","Cumberland County",3,6,113,52,61
050,51,049,"Virginia","Cumberland County",3,7,100,47,53
050,51,049,"Virginia","Cumberland County",3,8,106,55,51
050,51,049,"Virginia","Cumberland County",3,9,92,46,46
050,51,049,"Virginia","Cumberland County",3,10,96,50,46
050,51,049,"Virginia","Cumberland County",3,11,109,57,52
050,51,049,"Virginia","Cumberland County",3,12,117,59,58
050,51,049,"Virginia","Cumberland County",3,13,115,58,57
050,51,049,"Virginia","Cumberland County",3,14,110,52,58
050,51,049,"Virginia","Cumberland County",3,15,121,68,53
050,51,049,"Virginia","Cumberland County",3,16,113,60,53
050,51,049,"Virginia","Cumberland County",3,17,97,49,48
050,51,049,"Virginia","Cumberland County",3,18,98,50,48
050,51,049,"Virginia","Cumberland County",3,19,86,43,43
050,51,049,"Virginia","Cumberland County",3,20,96,47,49
050,51,049,"Virginia","Cumberland County",3,21,108,53,55
050,51,049,"Virginia","Cumberland County",3,22,103,48,55
050,51,049,"Virginia","Cumberland County",3,23,100,47,53
050,51,049,"Virginia","Cumberland County",3,24,92,44,48
050,51,049,"Virginia","Cumberland County",3,25,103,46,57
050,51,049,"Virginia","Cumberland County",3,26,121,61,60
050,51,049,"Virginia","Cumberland County",3,27,109,56,53
050,51,049,"Virginia","Cumberland County",3,28,113,57,56
050,51,049,"Virginia","Cumberland County",3,29,116,56,60
050,51,049,"Virginia","Cumberland County",3,30,126,61,65
050,51,049,"Virginia","Cumberland County",3,31,112,55,57
050,51,049,"Virginia","Cumberland County",3,32,117,52,65
050,51,049,"Virginia","Cumberland County",3,33,101,43,58
050,51,049,"Virginia","Cumberland County",3,34,109,49,60
050,51,049,"Virginia","Cumberland County",3,35,108,62,46
050,51,049,"Virginia","Cumberland County",3,36,100,60,40
050,51,049,"Virginia","Cumberland County",3,37,89,44,45
050,51,049,"Virginia","Cumberland County",3,38,105,50,55
050,51,049,"Virginia","Cumberland County",3,39,96,50,46
050,51,049,"Virginia","Cumberland County",3,40,99,46,53
050,51,049,"Virginia","Cumberland County",3,41,112,53,59
050,51,049,"Virginia","Cumberland County",3,42,115,49,66
050,51,049,"Virginia","Cumberland County",3,43,104,47,57
050,51,049,"Virginia","Cumberland County",3,44,93,46,47
050,51,049,"Virginia","Cumberland County",3,45,90,47,43
050,51,049,"Virginia","Cumberland County",3,46,95,40,55
050,51,049,"Virginia","Cumberland County",3,47,98,45,53
050,51,049,"Virginia","Cumberland County",3,48,105,50,55
050,51,049,"Virginia","Cumberland County",3,49,118,59,59
050,51,049,"Virginia","Cumberland County",3,50,136,65,71
050,51,049,"Virginia","Cumberland County",3,51,140,70,70
050,51,049,"Virginia","Cumberland County",3,52,131,59,72
050,51,049,"Virginia","Cumberland County",3,53,136,64,72
050,51,049,"Virginia","Cumberland County",3,54,141,71,70
050,51,049,"Virginia","Cumberland County",3,55,144,73,71
050,51,049,"Virginia","Cumberland County",3,56,156,76,80
050,51,049,"Virginia","Cumberland County",3,57,173,88,85
050,51,049,"Virginia","Cumberland County",3,58,170,92,78
050,51,049,"Virginia","Cumberland County",3,59,160,84,76
050,51,049,"Virginia","Cumberland County",3,60,174,85,89
050,51,049,"Virginia","Cumberland County",3,61,158,81,77
050,51,049,"Virginia","Cumberland County",3,62,144,71,73
050,51,049,"Virginia","Cumberland County",3,63,133,63,70
050,51,049,"Virginia","Cumberland County",3,64,142,67,75
050,51,049,"Virginia","Cumberland County",3,65,141,71,70
050,51,049,"Virginia","Cumberland County",3,66,136,64,72
050,51,049,"Virginia","Cumberland County",3,67,131,58,73
050,51,049,"Virginia","Cumberland County",3,68,121,54,67
050,51,049,"Virginia","Cumberland County",3,69,133,55,78
050,51,049,"Virginia","Cumberland County",3,70,122,58,64
050,51,049,"Virginia","Cumberland County",3,71,128,71,57
050,51,049,"Virginia","Cumberland County",3,72,131,65,66
050,51,049,"Virginia","Cumberland County",3,73,133,65,68
050,51,049,"Virginia","Cumberland County",3,74,148,68,80
050,51,049,"Virginia","Cumberland County",3,75,103,48,55
050,51,049,"Virginia","Cumberland County",3,76,89,47,42
050,51,049,"Virginia","Cumberland County",3,77,78,39,39
050,51,049,"Virginia","Cumberland County",3,78,82,39,43
050,51,049,"Virginia","Cumberland County",3,79,77,39,38
050,51,049,"Virginia","Cumberland County",3,80,70,32,38
050,51,049,"Virginia","Cumberland County",3,81,65,36,29
050,51,049,"Virginia","Cumberland County",3,82,50,20,30
050,51,049,"Virginia","Cumberland County",3,83,44,18,26
050,51,049,"Virginia","Cumberland County",3,84,36,14,22
050,51,049,"Virginia","Cumberland County",3,85,224,84,140
050,51,049,"Virginia","Cumberland County",4,0,82,41,41
050,51,049,"Virginia","Cumberland County",4,1,81,39,42
050,51,049,"Virginia","Cumberland County",4,2,117,58,59
050,51,049,"Virginia","Cumberland County",4,3,112,58,54
050,51,049,"Virginia","Cumberland County",4,4,94,40,54
050,51,049,"Virginia","Cumberland County",4,5,105,51,54
050,51,049,"Virginia","Cumberland County",4,6,106,55,51
050,51,049,"Virginia","Cumberland County",4,7,115,55,60
050,51,049,"Virginia","Cumberland County",4,8,96,44,52
050,51,049,"Virginia","Cumberland County",4,9,108,56,52
050,51,049,"Virginia","Cumberland County",4,10,100,50,50
050,51,049,"Virginia","Cumberland County",4,11,97,51,46
050,51,049,"Virginia","Cumberland County",4,12,115,61,54
050,51,049,"Virginia","Cumberland County",4,13,121,60,61
050,51,049,"Virginia","Cumberland County",4,14,118,60,58
050,51,049,"Virginia","Cumberland County",4,15,119,59,60
050,51,049,"Virginia","Cumberland County",4,16,115,63,52
050,51,049,"Virginia","Cumberland County",4,17,108,58,50
050,51,049,"Virginia","Cumberland County",4,18,92,50,42
050,51,049,"Virginia","Cumberland County",4,19,77,40,37
050,51,049,"Virginia","Cumberland County",4,20,90,43,47
050,51,049,"Virginia","Cumberland County",4,21,96,49,47
050,51,049,"Virginia","Cumberland County",4,22,110,54,56
050,51,049,"Virginia","Cumberland County",4,23,110,54,56
050,51,049,"Virginia","Cumberland County",4,24,102,47,55
050,51,049,"Virginia","Cumberland County",4,25,84,40,44
050,51,049,"Virginia","Cumberland County",4,26,104,50,54
050,51,049,"Virginia","Cumberland County",4,27,116,61,55
050,51,049,"Virginia","Cumberland County",4,28,114,53,61
050,51,049,"Virginia","Cumberland County",4,29,111,56,55
050,51,049,"Virginia","Cumberland County",4,30,118,55,63
050,51,049,"Virginia","Cumberland County",4,31,136,66,70
050,51,049,"Virginia","Cumberland County",4,32,113,59,54
050,51,049,"Virginia","Cumberland County",4,33,117,53,64
050,51,049,"Virginia","Cumberland County",4,34,105,50,55
050,51,049,"Virginia","Cumberland County",4,35,108,54,54
050,51,049,"Virginia","Cumberland County",4,36,110,62,48
050,51,049,"Virginia","Cumberland County",4,37,96,57,39
050,51,049,"Virginia","Cumberland County",4,38,89,45,44
050,51,049,"Virginia","Cumberland County",4,39,99,46,53
050,51,049,"Virginia","Cumberland County",4,40,91,50,41
050,51,049,"Virginia","Cumberland County",4,41,105,47,58
050,51,049,"Virginia","Cumberland County",4,42,115,57,58
050,51,049,"Virginia","Cumberland County",4,43,118,50,68
050,51,049,"Virginia","Cumberland County",4,44,103,43,60
050,51,049,"Virginia","Cumberland County",4,45,102,50,52
050,51,049,"Virginia","Cumberland County",4,46,90,51,39
050,51,049,"Virginia","Cumberland County",4,47,101,46,55
050,51,049,"Virginia","Cumberland County",4,48,103,46,57
050,51,049,"Virginia","Cumberland County",4,49,106,51,55
050,51,049,"Virginia","Cumberland County",4,50,115,55,60
050,51,049,"Virginia","Cumberland County",4,51,137,66,71
050,51,049,"Virginia","Cumberland County",4,52,141,72,69
050,51,049,"Virginia","Cumberland County",4,53,130,58,72
050,51,049,"Virginia","Cumberland County",4,54,142,68,74
050,51,049,"Virginia","Cumberland County",4,55,146,72,74
050,51,049,"Virginia","Cumberland County",4,56,139,69,70
050,51,049,"Virginia","Cumberland County",4,57,165,78,87
050,51,049,"Virginia","Cumberland County",4,58,166,85,81
050,51,049,"Virginia","Cumberland County",4,59,169,92,77
050,51,049,"Virginia","Cumberland County",4,60,160,80,80
050,51,049,"Virginia","Cumberland County",4,61,169,80,89
050,51,049,"Virginia","Cumberland County",4,62,157,77,80
050,51,049,"Virginia","Cumberland County",4,63,142,72,70
050,51,049,"Virginia","Cumberland County",4,64,134,61,73
050,51,049,"Virginia","Cumberland County",4,65,138,66,72
050,51,049,"Virginia","Cumberland County",4,66,146,75,71
050,51,049,"Virginia","Cumberland County",4,67,143,68,75
050,51,049,"Virginia","Cumberland County",4,68,129,60,69
050,51,049,"Virginia","Cumberland County",4,69,123,54,69
050,51,049,"Virginia","Cumberland County",4,70,131,54,77
050,51,049,"Virginia","Cumberland County",4,71,121,58,63
050,51,049,"Virginia","Cumberland County",4,72,127,70,57
050,51,049,"Virginia","Cumberland County",4,73,130,63,67
050,51,049,"Virginia","Cumberland County",4,74,126,59,67
050,51,049,"Virginia","Cumberland County",4,75,144,65,79
050,51,049,"Virginia","Cumberland County",4,76,102,47,55
050,51,049,"Virginia","Cumberland County",4,77,84,45,39
050,51,049,"Virginia","Cumberland County",4,78,76,38,38
050,51,049,"Virginia","Cumberland County",4,79,79,40,39
050,51,049,"Virginia","Cumberland County",4,80,76,39,37
050,51,049,"Virginia","Cumberland County",4,81,68,32,36
050,51,049,"Virginia","Cumberland County",4,82,59,33,26
050,51,049,"Virginia","Cumberland County",4,83,45,18,27
050,51,049,"Virginia","Cumberland County",4,84,38,13,25
050,51,049,"Virginia","Cumberland County",4,85,214,78,136
050,51,049,"Virginia","Cumberland County",5,0,83,41,42
050,51,049,"Virginia","Cumberland County",5,1,87,49,38
050,51,049,"Virginia","Cumberland County",5,2,88,46,42
050,51,049,"Virginia","Cumberland County",5,3,118,61,57
050,51,049,"Virginia","Cumberland County",5,4,111,57,54
050,51,049,"Virginia","Cumberland County",5,5,106,50,56
050,51,049,"Virginia","Cumberland County",5,6,109,55,54
050,51,049,"Virginia","Cumberland County",5,7,112,56,56
050,51,049,"Virginia","Cumberland County",5,8,118,55,63
050,51,049,"Virginia","Cumberland County",5,9,107,52,55
050,51,049,"Virginia","Cumberland County",5,10,115,54,61
050,51,049,"Virginia","Cumberland County",5,11,107,52,55
050,51,049,"Virginia","Cumberland County",5,12,108,56,52
050,51,049,"Virginia","Cumberland County",5,13,115,66,49
050,51,049,"Virginia","Cumberland County",5,14,122,60,62
050,51,049,"Virginia","Cumberland County",5,15,121,61,60
050,51,049,"Virginia","Cumberland County",5,16,118,58,60
050,51,049,"Virginia","Cumberland County",5,17,114,62,52
050,51,049,"Virginia","Cumberland County",5,18,99,51,48
050,51,049,"Virginia","Cumberland County",5,19,74,38,36
050,51,049,"Virginia","Cumberland County",5,20,81,39,42
050,51,049,"Virginia","Cumberland County",5,21,90,44,46
050,51,049,"Virginia","Cumberland County",5,22,100,47,53
050,51,049,"Virginia","Cumberland County",5,23,112,55,57
050,51,049,"Virginia","Cumberland County",5,24,117,61,56
050,51,049,"Virginia","Cumberland County",5,25,104,43,61
050,51,049,"Virginia","Cumberland County",5,26,98,49,49
050,51,049,"Virginia","Cumberland County",5,27,117,56,61
050,51,049,"Virginia","Cumberland County",5,28,118,60,58
050,51,049,"Virginia","Cumberland County",5,29,121,58,63
050,51,049,"Virginia","Cumberland County",5,30,112,55,57
050,51,049,"Virginia","Cumberland County",5,31,115,54,61
050,51,049,"Virginia","Cumberland County",5,32,132,62,70
050,51,049,"Virginia","Cumberland County",5,33,108,53,55
050,51,049,"Virginia","Cumberland County",5,34,135,60,75
050,51,049,"Virginia","Cumberland County",5,35,104,50,54
050,51,049,"Virginia","Cumberland County",5,36,110,54,56
050,51,049,"Virginia","Cumberland County",5,37,115,60,55
050,51,049,"Virginia","Cumberland County",5,38,101,58,43
050,51,049,"Virginia","Cumberland County",5,39,94,46,48
050,51,049,"Virginia","Cumberland County",5,40,105,52,53
050,51,049,"Virginia","Cumberland County",5,41,95,52,43
050,51,049,"Virginia","Cumberland County",5,42,104,48,56
050,51,049,"Virginia","Cumberland County",5,43,121,57,64
050,51,049,"Virginia","Cumberland County",5,44,118,51,67
050,51,049,"Virginia","Cumberland County",5,45,100,38,62
050,51,049,"Virginia","Cumberland County",5,46,103,49,54
050,51,049,"Virginia","Cumberland County",5,47,91,52,39
050,51,049,"Virginia","Cumberland County",5,48,109,50,59
050,51,049,"Virginia","Cumberland County",5,49,110,49,61
050,51,049,"Virginia","Cumberland County",5,50,105,52,53
050,51,049,"Virginia","Cumberland County",5,51,119,54,65
050,51,049,"Virginia","Cumberland County",5,52,138,69,69
050,51,049,"Virginia","Cumberland County",5,53,136,68,68
050,51,049,"Virginia","Cumberland County",5,54,130,58,72
050,51,049,"Virginia","Cumberland County",5,55,140,68,72
050,51,049,"Virginia","Cumberland County",5,56,144,67,77
050,51,049,"Virginia","Cumberland County",5,57,146,72,74
050,51,049,"Virginia","Cumberland County",5,58,163,77,86
050,51,049,"Virginia","Cumberland County",5,59,163,82,81
050,51,049,"Virginia","Cumberland County",5,60,172,93,79
050,51,049,"Virginia","Cumberland County",5,61,159,80,79
050,51,049,"Virginia","Cumberland County",5,62,169,82,87
050,51,049,"Virginia","Cumberland County",5,63,158,82,76
050,51,049,"Virginia","Cumberland County",5,64,137,66,71
050,51,049,"Virginia","Cumberland County",5,65,133,61,72
050,51,049,"Virginia","Cumberland County",5,66,136,64,72
050,51,049,"Virginia","Cumberland County",5,67,152,77,75
050,51,049,"Virginia","Cumberland County",5,68,136,67,69
050,51,049,"Virginia","Cumberland County",5,69,126,57,69
050,51,049,"Virginia","Cumberland County",5,70,119,53,66
050,51,049,"Virginia","Cumberland County",5,71,129,54,75
050,51,049,"Virginia","Cumberland County",5,72,119,56,63
050,51,049,"Virginia","Cumberland County",5,73,127,71,56
050,51,049,"Virginia","Cumberland County",5,74,120,58,62
050,51,049,"Virginia","Cumberland County",5,75,124,56,68
050,51,049,"Virginia","Cumberland County",5,76,142,63,79
050,51,049,"Virginia","Cumberland County",5,77,96,43,53
050,51,049,"Virginia","Cumberland County",5,78,83,44,39
050,51,049,"Virginia","Cumberland County",5,79,73,39,34
050,51,049,"Virginia","Cumberland County",5,80,77,37,40
050,51,049,"Virginia","Cumberland County",5,81,75,40,35
050,51,049,"Virginia","Cumberland County",5,82,60,28,32
050,51,049,"Virginia","Cumberland County",5,83,57,34,23
050,51,049,"Virginia","Cumberland County",5,84,38,13,25
050,51,049,"Virginia","Cumberland County",5,85,205,70,135
050,51,051,"Virginia","Dickenson County",1,0,113,58,55
050,51,051,"Virginia","Dickenson County",1,1,115,61,54
050,51,051,"Virginia","Dickenson County",1,2,134,72,62
050,51,051,"Virginia","Dickenson County",1,3,141,72,69
050,51,051,"Virginia","Dickenson County",1,4,145,70,75
050,51,051,"Virginia","Dickenson County",1,5,147,77,70
050,51,051,"Virginia","Dickenson County",1,6,153,78,75
050,51,051,"Virginia","Dickenson County",1,7,165,86,79
050,51,051,"Virginia","Dickenson County",1,8,169,102,67
050,51,051,"Virginia","Dickenson County",1,9,159,85,74
050,51,051,"Virginia","Dickenson County",1,10,143,78,65
050,51,051,"Virginia","Dickenson County",1,11,163,81,82
050,51,051,"Virginia","Dickenson County",1,12,193,98,95
050,51,051,"Virginia","Dickenson County",1,13,170,97,73
050,51,051,"Virginia","Dickenson County",1,14,168,88,80
050,51,051,"Virginia","Dickenson County",1,15,157,81,76
050,51,051,"Virginia","Dickenson County",1,16,179,98,81
050,51,051,"Virginia","Dickenson County",1,17,175,92,83
050,51,051,"Virginia","Dickenson County",1,18,147,78,69
050,51,051,"Virginia","Dickenson County",1,19,112,66,46
050,51,051,"Virginia","Dickenson County",1,20,117,58,59
050,51,051,"Virginia","Dickenson County",1,21,130,65,65
050,51,051,"Virginia","Dickenson County",1,22,141,67,74
050,51,051,"Virginia","Dickenson County",1,23,130,67,63
050,51,051,"Virginia","Dickenson County",1,24,138,75,63
050,51,051,"Virginia","Dickenson County",1,25,135,75,60
050,51,051,"Virginia","Dickenson County",1,26,144,73,71
050,51,051,"Virginia","Dickenson County",1,27,153,83,70
050,51,051,"Virginia","Dickenson County",1,28,158,81,77
050,51,051,"Virginia","Dickenson County",1,29,171,90,81
050,51,051,"Virginia","Dickenson County",1,30,148,80,68
050,51,051,"Virginia","Dickenson County",1,31,151,73,78
050,51,051,"Virginia","Dickenson County",1,32,149,78,71
050,51,051,"Virginia","Dickenson County",1,33,141,70,71
050,51,051,"Virginia","Dickenson County",1,34,159,82,77
050,51,051,"Virginia","Dickenson County",1,35,152,82,70
050,51,051,"Virginia","Dickenson County",1,36,158,82,76
050,51,051,"Virginia","Dickenson County",1,37,154,81,73
050,51,051,"Virginia","Dickenson County",1,38,185,92,93
050,51,051,"Virginia","Dickenson County",1,39,192,106,86
050,51,051,"Virginia","Dickenson County",1,40,173,90,83
050,51,051,"Virginia","Dickenson County",1,41,184,99,85
050,51,051,"Virginia","Dickenson County",1,42,183,97,86
050,51,051,"Virginia","Dickenson County",1,43,178,101,77
050,51,051,"Virginia","Dickenson County",1,44,182,101,81
050,51,051,"Virginia","Dickenson County",1,45,165,83,82
050,51,051,"Virginia","Dickenson County",1,46,177,90,87
050,51,051,"Virginia","Dickenson County",1,47,176,96,80
050,51,051,"Virginia","Dickenson County",1,48,192,103,89
050,51,051,"Virginia","Dickenson County",1,49,190,108,82
050,51,051,"Virginia","Dickenson County",1,50,188,106,82
050,51,051,"Virginia","Dickenson County",1,51,163,80,83
050,51,051,"Virginia","Dickenson County",1,52,174,94,80
050,51,051,"Virginia","Dickenson County",1,53,190,101,89
050,51,051,"Virginia","Dickenson County",1,54,178,94,84
050,51,051,"Virginia","Dickenson County",1,55,195,108,87
050,51,051,"Virginia","Dickenson County",1,56,205,106,99
050,51,051,"Virginia","Dickenson County",1,57,197,106,91
050,51,051,"Virginia","Dickenson County",1,58,229,113,116
050,51,051,"Virginia","Dickenson County",1,59,221,104,117
050,51,051,"Virginia","Dickenson County",1,60,212,100,112
050,51,051,"Virginia","Dickenson County",1,61,218,111,107
050,51,051,"Virginia","Dickenson County",1,62,217,111,106
050,51,051,"Virginia","Dickenson County",1,63,210,109,101
050,51,051,"Virginia","Dickenson County",1,64,209,115,94
050,51,051,"Virginia","Dickenson County",1,65,213,112,101
050,51,051,"Virginia","Dickenson County",1,66,212,106,106
050,51,051,"Virginia","Dickenson County",1,67,201,101,100
050,51,051,"Virginia","Dickenson County",1,68,210,100,110
050,51,051,"Virginia","Dickenson County",1,69,183,81,102
050,51,051,"Virginia","Dickenson County",1,70,189,90,99
050,51,051,"Virginia","Dickenson County",1,71,186,94,92
050,51,051,"Virginia","Dickenson County",1,72,198,94,104
050,51,051,"Virginia","Dickenson County",1,73,192,91,101
050,51,051,"Virginia","Dickenson County",1,74,143,67,76
050,51,051,"Virginia","Dickenson County",1,75,155,75,80
050,51,051,"Virginia","Dickenson County",1,76,130,71,59
050,51,051,"Virginia","Dickenson County",1,77,146,77,69
050,51,051,"Virginia","Dickenson County",1,78,103,56,47
050,51,051,"Virginia","Dickenson County",1,79,101,49,52
050,51,051,"Virginia","Dickenson County",1,80,102,48,54
050,51,051,"Virginia","Dickenson County",1,81,93,40,53
050,51,051,"Virginia","Dickenson County",1,82,81,39,42
050,51,051,"Virginia","Dickenson County",1,83,67,29,38
050,51,051,"Virginia","Dickenson County",1,84,52,21,31
050,51,051,"Virginia","Dickenson County",1,85,311,99,212
050,51,051,"Virginia","Dickenson County",2,0,110,59,51
050,51,051,"Virginia","Dickenson County",2,1,113,60,53
050,51,051,"Virginia","Dickenson County",2,2,128,69,59
050,51,051,"Virginia","Dickenson County",2,3,139,72,67
050,51,051,"Virginia","Dickenson County",2,4,145,72,73
050,51,051,"Virginia","Dickenson County",2,5,145,75,70
050,51,051,"Virginia","Dickenson County",2,6,151,76,75
050,51,051,"Virginia","Dickenson County",2,7,161,84,77
050,51,051,"Virginia","Dickenson County",2,8,165,97,68
050,51,051,"Virginia","Dickenson County",2,9,161,90,71
050,51,051,"Virginia","Dickenson County",2,10,145,79,66
050,51,051,"Virginia","Dickenson County",2,11,160,81,79
050,51,051,"Virginia","Dickenson County",2,12,184,94,90
050,51,051,"Virginia","Dickenson County",2,13,175,97,78
050,51,051,"Virginia","Dickenson County",2,14,168,91,77
050,51,051,"Virginia","Dickenson County",2,15,160,83,77
050,51,051,"Virginia","Dickenson County",2,16,174,94,80
050,51,051,"Virginia","Dickenson County",2,17,176,94,82
050,51,051,"Virginia","Dickenson County",2,18,145,79,66
050,51,051,"Virginia","Dickenson County",2,19,114,65,49
050,51,051,"Virginia","Dickenson County",2,20,119,61,58
050,51,051,"Virginia","Dickenson County",2,21,130,65,65
050,51,051,"Virginia","Dickenson County",2,22,139,66,73
050,51,051,"Virginia","Dickenson County",2,23,134,68,66
050,51,051,"Virginia","Dickenson County",2,24,134,73,61
050,51,051,"Virginia","Dickenson County",2,25,138,77,61
050,51,051,"Virginia","Dickenson County",2,26,146,76,70
050,51,051,"Virginia","Dickenson County",2,27,147,77,70
050,51,051,"Virginia","Dickenson County",2,28,157,82,75
050,51,051,"Virginia","Dickenson County",2,29,166,86,80
050,51,051,"Virginia","Dickenson County",2,30,154,83,71
050,51,051,"Virginia","Dickenson County",2,31,148,73,75
050,51,051,"Virginia","Dickenson County",2,32,150,78,72
050,51,051,"Virginia","Dickenson County",2,33,140,71,69
050,51,051,"Virginia","Dickenson County",2,34,155,79,76
050,51,051,"Virginia","Dickenson County",2,35,154,83,71
050,51,051,"Virginia","Dickenson County",2,36,155,80,75
050,51,051,"Virginia","Dickenson County",2,37,155,81,74
050,51,051,"Virginia","Dickenson County",2,38,180,92,88
050,51,051,"Virginia","Dickenson County",2,39,188,101,87
050,51,051,"Virginia","Dickenson County",2,40,177,93,84
050,51,051,"Virginia","Dickenson County",2,41,181,96,85
050,51,051,"Virginia","Dickenson County",2,42,186,100,86
050,51,051,"Virginia","Dickenson County",2,43,179,99,80
050,51,051,"Virginia","Dickenson County",2,44,180,102,78
050,51,051,"Virginia","Dickenson County",2,45,169,86,83
050,51,051,"Virginia","Dickenson County",2,46,175,89,86
050,51,051,"Virginia","Dickenson County",2,47,173,94,79
050,51,051,"Virginia","Dickenson County",2,48,188,101,87
050,51,051,"Virginia","Dickenson County",2,49,190,107,83
050,51,051,"Virginia","Dickenson County",2,50,189,107,82
050,51,051,"Virginia","Dickenson County",2,51,168,86,82
050,51,051,"Virginia","Dickenson County",2,52,170,90,80
050,51,051,"Virginia","Dickenson County",2,53,185,98,87
050,51,051,"Virginia","Dickenson County",2,54,180,96,84
050,51,051,"Virginia","Dickenson County",2,55,188,102,86
050,51,051,"Virginia","Dickenson County",2,56,202,107,95
050,51,051,"Virginia","Dickenson County",2,57,197,106,91
050,51,051,"Virginia","Dickenson County",2,58,220,109,111
050,51,051,"Virginia","Dickenson County",2,59,225,107,118
050,51,051,"Virginia","Dickenson County",2,60,214,101,113
050,51,051,"Virginia","Dickenson County",2,61,208,103,105
050,51,051,"Virginia","Dickenson County",2,62,217,110,107
050,51,051,"Virginia","Dickenson County",2,63,212,108,104
050,51,051,"Virginia","Dickenson County",2,64,208,113,95
050,51,051,"Virginia","Dickenson County",2,65,212,112,100
050,51,051,"Virginia","Dickenson County",2,66,212,107,105
050,51,051,"Virginia","Dickenson County",2,67,202,102,100
050,51,051,"Virginia","Dickenson County",2,68,206,100,106
050,51,051,"Virginia","Dickenson County",2,69,191,86,105
050,51,051,"Virginia","Dickenson County",2,70,188,89,99
050,51,051,"Virginia","Dickenson County",2,71,184,90,94
050,51,051,"Virginia","Dickenson County",2,72,193,93,100
050,51,051,"Virginia","Dickenson County",2,73,203,96,107
050,51,051,"Virginia","Dickenson County",2,74,145,68,77
050,51,051,"Virginia","Dickenson County",2,75,151,72,79
050,51,051,"Virginia","Dickenson County",2,76,133,71,62
050,51,051,"Virginia","Dickenson County",2,77,144,77,67
050,51,051,"Virginia","Dickenson County",2,78,110,60,50
050,51,051,"Virginia","Dickenson County",2,79,99,49,50
050,51,051,"Virginia","Dickenson County",2,80,102,48,54
050,51,051,"Virginia","Dickenson County",2,81,92,42,50
050,51,051,"Virginia","Dickenson County",2,82,84,38,46
050,51,051,"Virginia","Dickenson County",2,83,69,31,38
050,51,051,"Virginia","Dickenson County",2,84,53,22,31
050,51,051,"Virginia","Dickenson County",2,85,312,102,210
050,51,051,"Virginia","Dickenson County",3,0,112,58,54
050,51,051,"Virginia","Dickenson County",3,1,109,62,47
050,51,051,"Virginia","Dickenson County",3,2,122,65,57
050,51,051,"Virginia","Dickenson County",3,3,124,66,58
050,51,051,"Virginia","Dickenson County",3,4,138,66,72
050,51,051,"Virginia","Dickenson County",3,5,145,69,76
050,51,051,"Virginia","Dickenson County",3,6,144,68,76
050,51,051,"Virginia","Dickenson County",3,7,145,75,70
050,51,051,"Virginia","Dickenson County",3,8,156,80,76
050,51,051,"Virginia","Dickenson County",3,9,170,102,68
050,51,051,"Virginia","Dickenson County",3,10,159,84,75
050,51,051,"Virginia","Dickenson County",3,11,139,74,65
050,51,051,"Virginia","Dickenson County",3,12,160,77,83
050,51,051,"Virginia","Dickenson County",3,13,172,85,87
050,51,051,"Virginia","Dickenson County",3,14,166,89,77
050,51,051,"Virginia","Dickenson County",3,15,168,91,77
050,51,051,"Virginia","Dickenson County",3,16,159,82,77
050,51,051,"Virginia","Dickenson County",3,17,177,92,85
050,51,051,"Virginia","Dickenson County",3,18,151,83,68
050,51,051,"Virginia","Dickenson County",3,19,119,65,54
050,51,051,"Virginia","Dickenson County",3,20,116,65,51
050,51,051,"Virginia","Dickenson County",3,21,127,66,61
050,51,051,"Virginia","Dickenson County",3,22,137,67,70
050,51,051,"Virginia","Dickenson County",3,23,132,69,63
050,51,051,"Virginia","Dickenson County",3,24,120,64,56
050,51,051,"Virginia","Dickenson County",3,25,126,73,53
050,51,051,"Virginia","Dickenson County",3,26,136,75,61
050,51,051,"Virginia","Dickenson County",3,27,143,72,71
050,51,051,"Virginia","Dickenson County",3,28,146,78,68
050,51,051,"Virginia","Dickenson County",3,29,162,81,81
050,51,051,"Virginia","Dickenson County",3,30,167,85,82
050,51,051,"Virginia","Dickenson County",3,31,150,82,68
050,51,051,"Virginia","Dickenson County",3,32,154,81,73
050,51,051,"Virginia","Dickenson County",3,33,150,77,73
050,51,051,"Virginia","Dickenson County",3,34,141,73,68
050,51,051,"Virginia","Dickenson County",3,35,143,74,69
050,51,051,"Virginia","Dickenson County",3,36,156,78,78
050,51,051,"Virginia","Dickenson County",3,37,155,85,70
050,51,051,"Virginia","Dickenson County",3,38,161,89,72
050,51,051,"Virginia","Dickenson County",3,39,174,84,90
050,51,051,"Virginia","Dickenson County",3,40,186,97,89
050,51,051,"Virginia","Dickenson County",3,41,168,87,81
050,51,051,"Virginia","Dickenson County",3,42,184,101,83
050,51,051,"Virginia","Dickenson County",3,43,184,96,88
050,51,051,"Virginia","Dickenson County",3,44,190,102,88
050,51,051,"Virginia","Dickenson County",3,45,163,90,73
050,51,051,"Virginia","Dickenson County",3,46,176,93,83
050,51,051,"Virginia","Dickenson County",3,47,176,89,87
050,51,051,"Virginia","Dickenson County",3,48,174,96,78
050,51,051,"Virginia","Dickenson County",3,49,188,100,88
050,51,051,"Virginia","Dickenson County",3,50,193,110,83
050,51,051,"Virginia","Dickenson County",3,51,185,104,81
050,51,051,"Virginia","Dickenson County",3,52,179,91,88
050,51,051,"Virginia","Dickenson County",3,53,166,90,76
050,51,051,"Virginia","Dickenson County",3,54,185,101,84
050,51,051,"Virginia","Dickenson County",3,55,174,89,85
050,51,051,"Virginia","Dickenson County",3,56,185,102,83
050,51,051,"Virginia","Dickenson County",3,57,204,109,95
050,51,051,"Virginia","Dickenson County",3,58,189,99,90
050,51,051,"Virginia","Dickenson County",3,59,219,111,108
050,51,051,"Virginia","Dickenson County",3,60,207,103,104
050,51,051,"Virginia","Dickenson County",3,61,207,97,110
050,51,051,"Virginia","Dickenson County",3,62,201,100,101
050,51,051,"Virginia","Dickenson County",3,63,209,102,107
050,51,051,"Virginia","Dickenson County",3,64,207,106,101
050,51,051,"Virginia","Dickenson County",3,65,201,107,94
050,51,051,"Virginia","Dickenson County",3,66,209,106,103
050,51,051,"Virginia","Dickenson County",3,67,199,102,97
050,51,051,"Virginia","Dickenson County",3,68,199,102,97
050,51,051,"Virginia","Dickenson County",3,69,207,100,107
050,51,051,"Virginia","Dickenson County",3,70,188,89,99
050,51,051,"Virginia","Dickenson County",3,71,180,83,97
050,51,051,"Virginia","Dickenson County",3,72,185,87,98
050,51,051,"Virginia","Dickenson County",3,73,181,85,96
050,51,051,"Virginia","Dickenson County",3,74,200,97,103
050,51,051,"Virginia","Dickenson County",3,75,143,68,75
050,51,051,"Virginia","Dickenson County",3,76,144,69,75
050,51,051,"Virginia","Dickenson County",3,77,125,66,59
050,51,051,"Virginia","Dickenson County",3,78,136,73,63
050,51,051,"Virginia","Dickenson County",3,79,108,58,50
050,51,051,"Virginia","Dickenson County",3,80,94,45,49
050,51,051,"Virginia","Dickenson County",3,81,96,46,50
050,51,051,"Virginia","Dickenson County",3,82,90,40,50
050,51,051,"Virginia","Dickenson County",3,83,80,35,45
050,51,051,"Virginia","Dickenson County",3,84,65,31,34
050,51,051,"Virginia","Dickenson County",3,85,300,105,195
050,51,051,"Virginia","Dickenson County",4,0,109,50,59
050,51,051,"Virginia","Dickenson County",4,1,110,60,50
050,51,051,"Virginia","Dickenson County",4,2,110,61,49
050,51,051,"Virginia","Dickenson County",4,3,121,62,59
050,51,051,"Virginia","Dickenson County",4,4,130,71,59
050,51,051,"Virginia","Dickenson County",4,5,141,68,73
050,51,051,"Virginia","Dickenson County",4,6,148,74,74
050,51,051,"Virginia","Dickenson County",4,7,149,74,75
050,51,051,"Virginia","Dickenson County",4,8,142,71,71
050,51,051,"Virginia","Dickenson County",4,9,160,87,73
050,51,051,"Virginia","Dickenson County",4,10,170,103,67
050,51,051,"Virginia","Dickenson County",4,11,167,87,80
050,51,051,"Virginia","Dickenson County",4,12,143,75,68
050,51,051,"Virginia","Dickenson County",4,13,157,79,78
050,51,051,"Virginia","Dickenson County",4,14,171,87,84
050,51,051,"Virginia","Dickenson County",4,15,165,90,75
050,51,051,"Virginia","Dickenson County",4,16,172,87,85
050,51,051,"Virginia","Dickenson County",4,17,165,88,77
050,51,051,"Virginia","Dickenson County",4,18,152,85,67
050,51,051,"Virginia","Dickenson County",4,19,117,66,51
050,51,051,"Virginia","Dickenson County",4,20,124,61,63
050,51,051,"Virginia","Dickenson County",4,21,129,73,56
050,51,051,"Virginia","Dickenson County",4,22,129,71,58
050,51,051,"Virginia","Dickenson County",4,23,129,66,63
050,51,051,"Virginia","Dickenson County",4,24,133,67,66
050,51,051,"Virginia","Dickenson County",4,25,127,74,53
050,51,051,"Virginia","Dickenson County",4,26,116,63,53
050,51,051,"Virginia","Dickenson County",4,27,129,75,54
050,51,051,"Virginia","Dickenson County",4,28,144,73,71
050,51,051,"Virginia","Dickenson County",4,29,149,75,74
050,51,051,"Virginia","Dickenson County",4,30,163,84,79
050,51,051,"Virginia","Dickenson County",4,31,161,79,82
050,51,051,"Virginia","Dickenson County",4,32,156,88,68
050,51,051,"Virginia","Dickenson County",4,33,148,74,74
050,51,051,"Virginia","Dickenson County",4,34,156,78,78
050,51,051,"Virginia","Dickenson County",4,35,135,71,64
050,51,051,"Virginia","Dickenson County",4,36,141,69,72
050,51,051,"Virginia","Dickenson County",4,37,148,78,70
050,51,051,"Virginia","Dickenson County",4,38,159,89,70
050,51,051,"Virginia","Dickenson County",4,39,151,78,73
050,51,051,"Virginia","Dickenson County",4,40,175,88,87
050,51,051,"Virginia","Dickenson County",4,41,182,99,83
050,51,051,"Virginia","Dickenson County",4,42,181,99,82
050,51,051,"Virginia","Dickenson County",4,43,183,103,80
050,51,051,"Virginia","Dickenson County",4,44,192,101,91
050,51,051,"Virginia","Dickenson County",4,45,182,89,93
050,51,051,"Virginia","Dickenson County",4,46,161,95,66
050,51,051,"Virginia","Dickenson County",4,47,176,94,82
050,51,051,"Virginia","Dickenson County",4,48,179,91,88
050,51,051,"Virginia","Dickenson County",4,49,166,88,78
050,51,051,"Virginia","Dickenson County",4,50,194,103,91
050,51,051,"Virginia","Dickenson County",4,51,189,111,78
050,51,051,"Virginia","Dickenson County",4,52,190,106,84
050,51,051,"Virginia","Dickenson County",4,53,172,85,87
050,51,051,"Virginia","Dickenson County",4,54,163,88,75
050,51,051,"Virginia","Dickenson County",4,55,178,94,84
050,51,051,"Virginia","Dickenson County",4,56,172,93,79
050,51,051,"Virginia","Dickenson County",4,57,188,105,83
050,51,051,"Virginia","Dickenson County",4,58,199,105,94
050,51,051,"Virginia","Dickenson County",4,59,186,100,86
050,51,051,"Virginia","Dickenson County",4,60,216,108,108
050,51,051,"Virginia","Dickenson County",4,61,200,99,101
050,51,051,"Virginia","Dickenson County",4,62,205,94,111
050,51,051,"Virginia","Dickenson County",4,63,198,97,101
050,51,051,"Virginia","Dickenson County",4,64,208,103,105
050,51,051,"Virginia","Dickenson County",4,65,206,103,103
050,51,051,"Virginia","Dickenson County",4,66,202,103,99
050,51,051,"Virginia","Dickenson County",4,67,197,101,96
050,51,051,"Virginia","Dickenson County",4,68,192,96,96
050,51,051,"Virginia","Dickenson County",4,69,195,100,95
050,51,051,"Virginia","Dickenson County",4,70,202,96,106
050,51,051,"Virginia","Dickenson County",4,71,178,81,97
050,51,051,"Virginia","Dickenson County",4,72,178,81,97
050,51,051,"Virginia","Dickenson County",4,73,173,83,90
050,51,051,"Virginia","Dickenson County",4,74,183,86,97
050,51,051,"Virginia","Dickenson County",4,75,197,96,101
050,51,051,"Virginia","Dickenson County",4,76,138,68,70
050,51,051,"Virginia","Dickenson County",4,77,133,60,73
050,51,051,"Virginia","Dickenson County",4,78,112,59,53
050,51,051,"Virginia","Dickenson County",4,79,131,71,60
050,51,051,"Virginia","Dickenson County",4,80,106,55,51
050,51,051,"Virginia","Dickenson County",4,81,88,44,44
050,51,051,"Virginia","Dickenson County",4,82,95,44,51
050,51,051,"Virginia","Dickenson County",4,83,84,37,47
050,51,051,"Virginia","Dickenson County",4,84,72,31,41
050,51,051,"Virginia","Dickenson County",4,85,310,115,195
050,51,051,"Virginia","Dickenson County",5,0,118,55,63
050,51,051,"Virginia","Dickenson County",5,1,112,52,60
050,51,051,"Virginia","Dickenson County",5,2,115,60,55
050,51,051,"Virginia","Dickenson County",5,3,110,65,45
050,51,051,"Virginia","Dickenson County",5,4,132,70,62
050,51,051,"Virginia","Dickenson County",5,5,131,73,58
050,51,051,"Virginia","Dickenson County",5,6,151,72,79
050,51,051,"Virginia","Dickenson County",5,7,151,75,76
050,51,051,"Virginia","Dickenson County",5,8,146,73,73
050,51,051,"Virginia","Dickenson County",5,9,144,70,74
050,51,051,"Virginia","Dickenson County",5,10,157,83,74
050,51,051,"Virginia","Dickenson County",5,11,171,102,69
050,51,051,"Virginia","Dickenson County",5,12,163,84,79
050,51,051,"Virginia","Dickenson County",5,13,145,72,73
050,51,051,"Virginia","Dickenson County",5,14,164,81,83
050,51,051,"Virginia","Dickenson County",5,15,168,83,85
050,51,051,"Virginia","Dickenson County",5,16,161,88,73
050,51,051,"Virginia","Dickenson County",5,17,166,88,78
050,51,051,"Virginia","Dickenson County",5,18,133,74,59
050,51,051,"Virginia","Dickenson County",5,19,115,64,51
050,51,051,"Virginia","Dickenson County",5,20,115,64,51
050,51,051,"Virginia","Dickenson County",5,21,141,73,68
050,51,051,"Virginia","Dickenson County",5,22,143,80,63
050,51,051,"Virginia","Dickenson County",5,23,116,65,51
050,51,051,"Virginia","Dickenson County",5,24,123,54,69
050,51,051,"Virginia","Dickenson County",5,25,140,70,70
050,51,051,"Virginia","Dickenson County",5,26,133,75,58
050,51,051,"Virginia","Dickenson County",5,27,129,68,61
050,51,051,"Virginia","Dickenson County",5,28,132,79,53
050,51,051,"Virginia","Dickenson County",5,29,138,68,70
050,51,051,"Virginia","Dickenson County",5,30,140,74,66
050,51,051,"Virginia","Dickenson County",5,31,172,84,88
050,51,051,"Virginia","Dickenson County",5,32,164,84,80
050,51,051,"Virginia","Dickenson County",5,33,159,86,73
050,51,051,"Virginia","Dickenson County",5,34,155,79,76
050,51,051,"Virginia","Dickenson County",5,35,150,73,77
050,51,051,"Virginia","Dickenson County",5,36,141,68,73
050,51,051,"Virginia","Dickenson County",5,37,148,75,73
050,51,051,"Virginia","Dickenson County",5,38,156,83,73
050,51,051,"Virginia","Dickenson County",5,39,151,81,70
050,51,051,"Virginia","Dickenson County",5,40,145,73,72
050,51,051,"Virginia","Dickenson County",5,41,178,90,88
050,51,051,"Virginia","Dickenson County",5,42,186,103,83
050,51,051,"Virginia","Dickenson County",5,43,175,93,82
050,51,051,"Virginia","Dickenson County",5,44,189,107,82
050,51,051,"Virginia","Dickenson County",5,45,179,89,90
050,51,051,"Virginia","Dickenson County",5,46,182,92,90
050,51,051,"Virginia","Dickenson County",5,47,163,94,69
050,51,051,"Virginia","Dickenson County",5,48,172,97,75
050,51,051,"Virginia","Dickenson County",5,49,177,88,89
050,51,051,"Virginia","Dickenson County",5,50,174,95,79
050,51,051,"Virginia","Dickenson County",5,51,186,98,88
050,51,051,"Virginia","Dickenson County",5,52,194,111,83
050,51,051,"Virginia","Dickenson County",5,53,183,102,81
050,51,051,"Virginia","Dickenson County",5,54,169,85,84
050,51,051,"Virginia","Dickenson County",5,55,157,83,74
050,51,051,"Virginia","Dickenson County",5,56,174,94,80
050,51,051,"Virginia","Dickenson County",5,57,174,94,80
050,51,051,"Virginia","Dickenson County",5,58,178,97,81
050,51,051,"Virginia","Dickenson County",5,59,197,102,95
050,51,051,"Virginia","Dickenson County",5,60,181,97,84
050,51,051,"Virginia","Dickenson County",5,61,211,106,105
050,51,051,"Virginia","Dickenson County",5,62,197,95,102
050,51,051,"Virginia","Dickenson County",5,63,202,89,113
050,51,051,"Virginia","Dickenson County",5,64,193,96,97
050,51,051,"Virginia","Dickenson County",5,65,204,98,106
050,51,051,"Virginia","Dickenson County",5,66,206,101,105
050,51,051,"Virginia","Dickenson County",5,67,190,102,88
050,51,051,"Virginia","Dickenson County",5,68,194,100,94
050,51,051,"Virginia","Dickenson County",5,69,193,96,97
050,51,051,"Virginia","Dickenson County",5,70,197,101,96
050,51,051,"Virginia","Dickenson County",5,71,189,85,104
050,51,051,"Virginia","Dickenson County",5,72,182,83,99
050,51,051,"Virginia","Dickenson County",5,73,165,74,91
050,51,051,"Virginia","Dickenson County",5,74,173,85,88
050,51,051,"Virginia","Dickenson County",5,75,177,84,93
050,51,051,"Virginia","Dickenson County",5,76,194,97,97
050,51,051,"Virginia","Dickenson County",5,77,130,62,68
050,51,051,"Virginia","Dickenson County",5,78,117,52,65
050,51,051,"Virginia","Dickenson County",5,79,104,57,47
050,51,051,"Virginia","Dickenson County",5,80,131,69,62
050,51,051,"Virginia","Dickenson County",5,81,97,52,45
050,51,051,"Virginia","Dickenson County",5,82,87,42,45
050,51,051,"Virginia","Dickenson County",5,83,89,40,49
050,51,051,"Virginia","Dickenson County",5,84,75,33,42
050,51,051,"Virginia","Dickenson County",5,85,331,127,204
050,51,053,"Virginia","Dinwiddie County",1,0,238,121,117
050,51,053,"Virginia","Dinwiddie County",1,1,296,146,150
050,51,053,"Virginia","Dinwiddie County",1,2,282,139,143
050,51,053,"Virginia","Dinwiddie County",1,3,338,174,164
050,51,053,"Virginia","Dinwiddie County",1,4,347,182,165
050,51,053,"Virginia","Dinwiddie County",1,5,336,175,161
050,51,053,"Virginia","Dinwiddie County",1,6,350,182,168
050,51,053,"Virginia","Dinwiddie County",1,7,348,155,193
050,51,053,"Virginia","Dinwiddie County",1,8,326,163,163
050,51,053,"Virginia","Dinwiddie County",1,9,325,167,158
050,51,053,"Virginia","Dinwiddie County",1,10,304,166,138
050,51,053,"Virginia","Dinwiddie County",1,11,333,172,161
050,51,053,"Virginia","Dinwiddie County",1,12,355,179,176
050,51,053,"Virginia","Dinwiddie County",1,13,342,175,167
050,51,053,"Virginia","Dinwiddie County",1,14,332,168,164
050,51,053,"Virginia","Dinwiddie County",1,15,349,170,179
050,51,053,"Virginia","Dinwiddie County",1,16,358,197,161
050,51,053,"Virginia","Dinwiddie County",1,17,333,180,153
050,51,053,"Virginia","Dinwiddie County",1,18,299,164,135
050,51,053,"Virginia","Dinwiddie County",1,19,241,130,111
050,51,053,"Virginia","Dinwiddie County",1,20,245,117,128
050,51,053,"Virginia","Dinwiddie County",1,21,253,133,120
050,51,053,"Virginia","Dinwiddie County",1,22,287,146,141
050,51,053,"Virginia","Dinwiddie County",1,23,307,159,148
050,51,053,"Virginia","Dinwiddie County",1,24,301,152,149
050,51,053,"Virginia","Dinwiddie County",1,25,310,150,160
050,51,053,"Virginia","Dinwiddie County",1,26,361,174,187
050,51,053,"Virginia","Dinwiddie County",1,27,388,188,200
050,51,053,"Virginia","Dinwiddie County",1,28,364,185,179
050,51,053,"Virginia","Dinwiddie County",1,29,366,187,179
050,51,053,"Virginia","Dinwiddie County",1,30,369,190,179
050,51,053,"Virginia","Dinwiddie County",1,31,368,181,187
050,51,053,"Virginia","Dinwiddie County",1,32,372,193,179
050,51,053,"Virginia","Dinwiddie County",1,33,359,169,190
050,51,053,"Virginia","Dinwiddie County",1,34,372,193,179
050,51,053,"Virginia","Dinwiddie County",1,35,346,173,173
050,51,053,"Virginia","Dinwiddie County",1,36,300,159,141
050,51,053,"Virginia","Dinwiddie County",1,37,320,161,159
050,51,053,"Virginia","Dinwiddie County",1,38,321,155,166
050,51,053,"Virginia","Dinwiddie County",1,39,314,157,157
050,51,053,"Virginia","Dinwiddie County",1,40,323,156,167
050,51,053,"Virginia","Dinwiddie County",1,41,294,138,156
050,51,053,"Virginia","Dinwiddie County",1,42,304,138,166
050,51,053,"Virginia","Dinwiddie County",1,43,309,145,164
050,51,053,"Virginia","Dinwiddie County",1,44,327,164,163
050,51,053,"Virginia","Dinwiddie County",1,45,310,153,157
050,51,053,"Virginia","Dinwiddie County",1,46,299,152,147
050,51,053,"Virginia","Dinwiddie County",1,47,347,169,178
050,51,053,"Virginia","Dinwiddie County",1,48,386,206,180
050,51,053,"Virginia","Dinwiddie County",1,49,419,207,212
050,51,053,"Virginia","Dinwiddie County",1,50,398,199,199
050,51,053,"Virginia","Dinwiddie County",1,51,380,196,184
050,51,053,"Virginia","Dinwiddie County",1,52,390,194,196
050,51,053,"Virginia","Dinwiddie County",1,53,439,225,214
050,51,053,"Virginia","Dinwiddie County",1,54,446,228,218
050,51,053,"Virginia","Dinwiddie County",1,55,490,245,245
050,51,053,"Virginia","Dinwiddie County",1,56,497,246,251
050,51,053,"Virginia","Dinwiddie County",1,57,447,223,224
050,51,053,"Virginia","Dinwiddie County",1,58,465,235,230
050,51,053,"Virginia","Dinwiddie County",1,59,438,221,217
050,51,053,"Virginia","Dinwiddie County",1,60,433,218,215
050,51,053,"Virginia","Dinwiddie County",1,61,448,230,218
050,51,053,"Virginia","Dinwiddie County",1,62,449,215,234
050,51,053,"Virginia","Dinwiddie County",1,63,411,194,217
050,51,053,"Virginia","Dinwiddie County",1,64,357,171,186
050,51,053,"Virginia","Dinwiddie County",1,65,370,184,186
050,51,053,"Virginia","Dinwiddie County",1,66,361,168,193
050,51,053,"Virginia","Dinwiddie County",1,67,351,170,181
050,51,053,"Virginia","Dinwiddie County",1,68,317,149,168
050,51,053,"Virginia","Dinwiddie County",1,69,306,137,169
050,51,053,"Virginia","Dinwiddie County",1,70,312,145,167
050,51,053,"Virginia","Dinwiddie County",1,71,295,136,159
050,51,053,"Virginia","Dinwiddie County",1,72,289,159,130
050,51,053,"Virginia","Dinwiddie County",1,73,267,139,128
050,51,053,"Virginia","Dinwiddie County",1,74,193,94,99
050,51,053,"Virginia","Dinwiddie County",1,75,207,94,113
050,51,053,"Virginia","Dinwiddie County",1,76,228,94,134
050,51,053,"Virginia","Dinwiddie County",1,77,195,92,103
050,51,053,"Virginia","Dinwiddie County",1,78,172,70,102
050,51,053,"Virginia","Dinwiddie County",1,79,169,76,93
050,51,053,"Virginia","Dinwiddie County",1,80,140,68,72
050,51,053,"Virginia","Dinwiddie County",1,81,128,55,73
050,51,053,"Virginia","Dinwiddie County",1,82,112,46,66
050,51,053,"Virginia","Dinwiddie County",1,83,108,35,73
050,51,053,"Virginia","Dinwiddie County",1,84,99,35,64
050,51,053,"Virginia","Dinwiddie County",1,85,461,158,303
050,51,053,"Virginia","Dinwiddie County",2,0,223,113,110
050,51,053,"Virginia","Dinwiddie County",2,1,284,142,142
050,51,053,"Virginia","Dinwiddie County",2,2,291,144,147
050,51,053,"Virginia","Dinwiddie County",2,3,325,165,160
050,51,053,"Virginia","Dinwiddie County",2,4,348,181,167
050,51,053,"Virginia","Dinwiddie County",2,5,341,181,160
050,51,053,"Virginia","Dinwiddie County",2,6,347,180,167
050,51,053,"Virginia","Dinwiddie County",2,7,348,162,186
050,51,053,"Virginia","Dinwiddie County",2,8,329,160,169
050,51,053,"Virginia","Dinwiddie County",2,9,321,164,157
050,51,053,"Virginia","Dinwiddie County",2,10,310,165,145
050,51,053,"Virginia","Dinwiddie County",2,11,323,167,156
050,51,053,"Virginia","Dinwiddie County",2,12,353,180,173
050,51,053,"Virginia","Dinwiddie County",2,13,345,177,168
050,51,053,"Virginia","Dinwiddie County",2,14,333,170,163
050,51,053,"Virginia","Dinwiddie County",2,15,341,169,172
050,51,053,"Virginia","Dinwiddie County",2,16,352,190,162
050,51,053,"Virginia","Dinwiddie County",2,17,338,184,154
050,51,053,"Virginia","Dinwiddie County",2,18,289,159,130
050,51,053,"Virginia","Dinwiddie County",2,19,245,130,115
050,51,053,"Virginia","Dinwiddie County",2,20,249,123,126
050,51,053,"Virginia","Dinwiddie County",2,21,254,131,123
050,51,053,"Virginia","Dinwiddie County",2,22,284,146,138
050,51,053,"Virginia","Dinwiddie County",2,23,307,157,150
050,51,053,"Virginia","Dinwiddie County",2,24,303,155,148
050,51,053,"Virginia","Dinwiddie County",2,25,310,151,159
050,51,053,"Virginia","Dinwiddie County",2,26,353,169,184
050,51,053,"Virginia","Dinwiddie County",2,27,382,187,195
050,51,053,"Virginia","Dinwiddie County",2,28,368,183,185
050,51,053,"Virginia","Dinwiddie County",2,29,365,186,179
050,51,053,"Virginia","Dinwiddie County",2,30,369,188,181
050,51,053,"Virginia","Dinwiddie County",2,31,373,186,187
050,51,053,"Virginia","Dinwiddie County",2,32,369,190,179
050,51,053,"Virginia","Dinwiddie County",2,33,365,177,188
050,51,053,"Virginia","Dinwiddie County",2,34,369,189,180
050,51,053,"Virginia","Dinwiddie County",2,35,352,179,173
050,51,053,"Virginia","Dinwiddie County",2,36,309,162,147
050,51,053,"Virginia","Dinwiddie County",2,37,315,162,153
050,51,053,"Virginia","Dinwiddie County",2,38,318,156,162
050,51,053,"Virginia","Dinwiddie County",2,39,316,157,159
050,51,053,"Virginia","Dinwiddie County",2,40,321,155,166
050,51,053,"Virginia","Dinwiddie County",2,41,298,139,159
050,51,053,"Virginia","Dinwiddie County",2,42,297,137,160
050,51,053,"Virginia","Dinwiddie County",2,43,309,143,166
050,51,053,"Virginia","Dinwiddie County",2,44,320,158,162
050,51,053,"Virginia","Dinwiddie County",2,45,314,155,159
050,51,053,"Virginia","Dinwiddie County",2,46,298,151,147
050,51,053,"Virginia","Dinwiddie County",2,47,338,166,172
050,51,053,"Virginia","Dinwiddie County",2,48,372,195,177
050,51,053,"Virginia","Dinwiddie County",2,49,413,208,205
050,51,053,"Virginia","Dinwiddie County",2,50,401,200,201
050,51,053,"Virginia","Dinwiddie County",2,51,382,196,186
050,51,053,"Virginia","Dinwiddie County",2,52,390,196,194
050,51,053,"Virginia","Dinwiddie County",2,53,428,220,208
050,51,053,"Virginia","Dinwiddie County",2,54,446,227,219
050,51,053,"Virginia","Dinwiddie County",2,55,478,241,237
050,51,053,"Virginia","Dinwiddie County",2,56,494,245,249
050,51,053,"Virginia","Dinwiddie County",2,57,461,229,232
050,51,053,"Virginia","Dinwiddie County",2,58,459,232,227
050,51,053,"Virginia","Dinwiddie County",2,59,444,225,219
050,51,053,"Virginia","Dinwiddie County",2,60,431,216,215
050,51,053,"Virginia","Dinwiddie County",2,61,441,224,217
050,51,053,"Virginia","Dinwiddie County",2,62,442,214,228
050,51,053,"Virginia","Dinwiddie County",2,63,421,200,221
050,51,053,"Virginia","Dinwiddie County",2,64,368,175,193
050,51,053,"Virginia","Dinwiddie County",2,65,358,176,182
050,51,053,"Virginia","Dinwiddie County",2,66,367,174,193
050,51,053,"Virginia","Dinwiddie County",2,67,350,166,184
050,51,053,"Virginia","Dinwiddie County",2,68,322,151,171
050,51,053,"Virginia","Dinwiddie County",2,69,308,140,168
050,51,053,"Virginia","Dinwiddie County",2,70,309,141,168
050,51,053,"Virginia","Dinwiddie County",2,71,299,137,162
050,51,053,"Virginia","Dinwiddie County",2,72,281,149,132
050,51,053,"Virginia","Dinwiddie County",2,73,284,150,134
050,51,053,"Virginia","Dinwiddie County",2,74,197,96,101
050,51,053,"Virginia","Dinwiddie County",2,75,205,94,111
050,51,053,"Virginia","Dinwiddie County",2,76,220,92,128
050,51,053,"Virginia","Dinwiddie County",2,77,204,92,112
050,51,053,"Virginia","Dinwiddie County",2,78,176,74,102
050,51,053,"Virginia","Dinwiddie County",2,79,165,73,92
050,51,053,"Virginia","Dinwiddie County",2,80,145,69,76
050,51,053,"Virginia","Dinwiddie County",2,81,128,57,71
050,51,053,"Virginia","Dinwiddie County",2,82,118,50,68
050,51,053,"Virginia","Dinwiddie County",2,83,107,37,70
050,51,053,"Virginia","Dinwiddie County",2,84,102,35,67
050,51,053,"Virginia","Dinwiddie County",2,85,464,160,304
050,51,053,"Virginia","Dinwiddie County",3,0,197,102,95
050,51,053,"Virginia","Dinwiddie County",3,1,227,114,113
050,51,053,"Virginia","Dinwiddie County",3,2,301,142,159
050,51,053,"Virginia","Dinwiddie County",3,3,289,143,146
050,51,053,"Virginia","Dinwiddie County",3,4,323,163,160
050,51,053,"Virginia","Dinwiddie County",3,5,349,181,168
050,51,053,"Virginia","Dinwiddie County",3,6,344,181,163
050,51,053,"Virginia","Dinwiddie County",3,7,354,186,168
050,51,053,"Virginia","Dinwiddie County",3,8,356,166,190
050,51,053,"Virginia","Dinwiddie County",3,9,333,167,166
050,51,053,"Virginia","Dinwiddie County",3,10,323,169,154
050,51,053,"Virginia","Dinwiddie County",3,11,323,171,152
050,51,053,"Virginia","Dinwiddie County",3,12,310,164,146
050,51,053,"Virginia","Dinwiddie County",3,13,354,185,169
050,51,053,"Virginia","Dinwiddie County",3,14,355,176,179
050,51,053,"Virginia","Dinwiddie County",3,15,332,169,163
050,51,053,"Virginia","Dinwiddie County",3,16,340,166,174
050,51,053,"Virginia","Dinwiddie County",3,17,361,188,173
050,51,053,"Virginia","Dinwiddie County",3,18,292,162,130
050,51,053,"Virginia","Dinwiddie County",3,19,243,136,107
050,51,053,"Virginia","Dinwiddie County",3,20,252,135,117
050,51,053,"Virginia","Dinwiddie County",3,21,260,131,129
050,51,053,"Virginia","Dinwiddie County",3,22,261,143,118
050,51,053,"Virginia","Dinwiddie County",3,23,294,161,133
050,51,053,"Virginia","Dinwiddie County",3,24,307,166,141
050,51,053,"Virginia","Dinwiddie County",3,25,304,155,149
050,51,053,"Virginia","Dinwiddie County",3,26,321,149,172
050,51,053,"Virginia","Dinwiddie County",3,27,363,172,191
050,51,053,"Virginia","Dinwiddie County",3,28,375,189,186
050,51,053,"Virginia","Dinwiddie County",3,29,391,200,191
050,51,053,"Virginia","Dinwiddie County",3,30,376,192,184
050,51,053,"Virginia","Dinwiddie County",3,31,384,186,198
050,51,053,"Virginia","Dinwiddie County",3,32,383,190,193
050,51,053,"Virginia","Dinwiddie County",3,33,377,200,177
050,51,053,"Virginia","Dinwiddie County",3,34,373,182,191
050,51,053,"Virginia","Dinwiddie County",3,35,359,182,177
050,51,053,"Virginia","Dinwiddie County",3,36,362,185,177
050,51,053,"Virginia","Dinwiddie County",3,37,338,174,164
050,51,053,"Virginia","Dinwiddie County",3,38,308,158,150
050,51,053,"Virginia","Dinwiddie County",3,39,318,151,167
050,51,053,"Virginia","Dinwiddie County",3,40,323,156,167
050,51,053,"Virginia","Dinwiddie County",3,41,325,157,168
050,51,053,"Virginia","Dinwiddie County",3,42,311,148,163
050,51,053,"Virginia","Dinwiddie County",3,43,297,134,163
050,51,053,"Virginia","Dinwiddie County",3,44,331,159,172
050,51,053,"Virginia","Dinwiddie County",3,45,318,150,168
050,51,053,"Virginia","Dinwiddie County",3,46,311,152,159
050,51,053,"Virginia","Dinwiddie County",3,47,300,157,143
050,51,053,"Virginia","Dinwiddie County",3,48,337,167,170
050,51,053,"Virginia","Dinwiddie County",3,49,377,201,176
050,51,053,"Virginia","Dinwiddie County",3,50,428,211,217
050,51,053,"Virginia","Dinwiddie County",3,51,411,202,209
050,51,053,"Virginia","Dinwiddie County",3,52,387,199,188
050,51,053,"Virginia","Dinwiddie County",3,53,391,200,191
050,51,053,"Virginia","Dinwiddie County",3,54,428,213,215
050,51,053,"Virginia","Dinwiddie County",3,55,459,237,222
050,51,053,"Virginia","Dinwiddie County",3,56,470,236,234
050,51,053,"Virginia","Dinwiddie County",3,57,505,253,252
050,51,053,"Virginia","Dinwiddie County",3,58,455,226,229
050,51,053,"Virginia","Dinwiddie County",3,59,455,230,225
050,51,053,"Virginia","Dinwiddie County",3,60,432,219,213
050,51,053,"Virginia","Dinwiddie County",3,61,424,207,217
050,51,053,"Virginia","Dinwiddie County",3,62,429,214,215
050,51,053,"Virginia","Dinwiddie County",3,63,435,211,224
050,51,053,"Virginia","Dinwiddie County",3,64,420,194,226
050,51,053,"Virginia","Dinwiddie County",3,65,365,175,190
050,51,053,"Virginia","Dinwiddie County",3,66,351,168,183
050,51,053,"Virginia","Dinwiddie County",3,67,356,171,185
050,51,053,"Virginia","Dinwiddie County",3,68,342,163,179
050,51,053,"Virginia","Dinwiddie County",3,69,314,152,162
050,51,053,"Virginia","Dinwiddie County",3,70,302,138,164
050,51,053,"Virginia","Dinwiddie County",3,71,312,140,172
050,51,053,"Virginia","Dinwiddie County",3,72,284,130,154
050,51,053,"Virginia","Dinwiddie County",3,73,266,137,129
050,51,053,"Virginia","Dinwiddie County",3,74,268,141,127
050,51,053,"Virginia","Dinwiddie County",3,75,197,93,104
050,51,053,"Virginia","Dinwiddie County",3,76,195,87,108
050,51,053,"Virginia","Dinwiddie County",3,77,202,87,115
050,51,053,"Virginia","Dinwiddie County",3,78,205,88,117
050,51,053,"Virginia","Dinwiddie County",3,79,159,70,89
050,51,053,"Virginia","Dinwiddie County",3,80,161,69,92
050,51,053,"Virginia","Dinwiddie County",3,81,132,63,69
050,51,053,"Virginia","Dinwiddie County",3,82,122,55,67
050,51,053,"Virginia","Dinwiddie County",3,83,115,47,68
050,51,053,"Virginia","Dinwiddie County",3,84,99,32,67
050,51,053,"Virginia","Dinwiddie County",3,85,479,169,310
050,51,053,"Virginia","Dinwiddie County",4,0,180,93,87
050,51,053,"Virginia","Dinwiddie County",4,1,187,93,94
050,51,053,"Virginia","Dinwiddie County",4,2,231,109,122
050,51,053,"Virginia","Dinwiddie County",4,3,326,162,164
050,51,053,"Virginia","Dinwiddie County",4,4,291,146,145
050,51,053,"Virginia","Dinwiddie County",4,5,322,165,157
050,51,053,"Virginia","Dinwiddie County",4,6,364,188,176
050,51,053,"Virginia","Dinwiddie County",4,7,345,178,167
050,51,053,"Virginia","Dinwiddie County",4,8,353,189,164
050,51,053,"Virginia","Dinwiddie County",4,9,359,163,196
050,51,053,"Virginia","Dinwiddie County",4,10,347,183,164
050,51,053,"Virginia","Dinwiddie County",4,11,314,170,144
050,51,053,"Virginia","Dinwiddie County",4,12,331,179,152
050,51,053,"Virginia","Dinwiddie County",4,13,322,166,156
050,51,053,"Virginia","Dinwiddie County",4,14,343,168,175
050,51,053,"Virginia","Dinwiddie County",4,15,350,181,169
050,51,053,"Virginia","Dinwiddie County",4,16,332,167,165
050,51,053,"Virginia","Dinwiddie County",4,17,329,166,163
050,51,053,"Virginia","Dinwiddie County",4,18,298,158,140
050,51,053,"Virginia","Dinwiddie County",4,19,250,140,110
050,51,053,"Virginia","Dinwiddie County",4,20,240,126,114
050,51,053,"Virginia","Dinwiddie County",4,21,281,152,129
050,51,053,"Virginia","Dinwiddie County",4,22,280,145,135
050,51,053,"Virginia","Dinwiddie County",4,23,279,156,123
050,51,053,"Virginia","Dinwiddie County",4,24,316,171,145
050,51,053,"Virginia","Dinwiddie County",4,25,314,165,149
050,51,053,"Virginia","Dinwiddie County",4,26,311,154,157
050,51,053,"Virginia","Dinwiddie County",4,27,326,148,178
050,51,053,"Virginia","Dinwiddie County",4,28,372,189,183
050,51,053,"Virginia","Dinwiddie County",4,29,362,180,182
050,51,053,"Virginia","Dinwiddie County",4,30,417,214,203
050,51,053,"Virginia","Dinwiddie County",4,31,357,180,177
050,51,053,"Virginia","Dinwiddie County",4,32,379,185,194
050,51,053,"Virginia","Dinwiddie County",4,33,392,194,198
050,51,053,"Virginia","Dinwiddie County",4,34,389,207,182
050,51,053,"Virginia","Dinwiddie County",4,35,368,177,191
050,51,053,"Virginia","Dinwiddie County",4,36,371,182,189
050,51,053,"Virginia","Dinwiddie County",4,37,375,193,182
050,51,053,"Virginia","Dinwiddie County",4,38,332,178,154
050,51,053,"Virginia","Dinwiddie County",4,39,303,152,151
050,51,053,"Virginia","Dinwiddie County",4,40,326,152,174
050,51,053,"Virginia","Dinwiddie County",4,41,319,158,161
050,51,053,"Virginia","Dinwiddie County",4,42,330,155,175
050,51,053,"Virginia","Dinwiddie County",4,43,314,144,170
050,51,053,"Virginia","Dinwiddie County",4,44,310,138,172
050,51,053,"Virginia","Dinwiddie County",4,45,355,170,185
050,51,053,"Virginia","Dinwiddie County",4,46,316,149,167
050,51,053,"Virginia","Dinwiddie County",4,47,327,162,165
050,51,053,"Virginia","Dinwiddie County",4,48,314,162,152
050,51,053,"Virginia","Dinwiddie County",4,49,336,172,164
050,51,053,"Virginia","Dinwiddie County",4,50,391,202,189
050,51,053,"Virginia","Dinwiddie County",4,51,430,214,216
050,51,053,"Virginia","Dinwiddie County",4,52,427,214,213
050,51,053,"Virginia","Dinwiddie County",4,53,396,206,190
050,51,053,"Virginia","Dinwiddie County",4,54,384,187,197
050,51,053,"Virginia","Dinwiddie County",4,55,432,222,210
050,51,053,"Virginia","Dinwiddie County",4,56,460,231,229
050,51,053,"Virginia","Dinwiddie County",4,57,474,237,237
050,51,053,"Virginia","Dinwiddie County",4,58,491,244,247
050,51,053,"Virginia","Dinwiddie County",4,59,466,234,232
050,51,053,"Virginia","Dinwiddie County",4,60,452,221,231
050,51,053,"Virginia","Dinwiddie County",4,61,438,217,221
050,51,053,"Virginia","Dinwiddie County",4,62,436,211,225
050,51,053,"Virginia","Dinwiddie County",4,63,419,213,206
050,51,053,"Virginia","Dinwiddie County",4,64,424,206,218
050,51,053,"Virginia","Dinwiddie County",4,65,413,190,223
050,51,053,"Virginia","Dinwiddie County",4,66,358,167,191
050,51,053,"Virginia","Dinwiddie County",4,67,348,166,182
050,51,053,"Virginia","Dinwiddie County",4,68,348,165,183
050,51,053,"Virginia","Dinwiddie County",4,69,335,162,173
050,51,053,"Virginia","Dinwiddie County",4,70,308,149,159
050,51,053,"Virginia","Dinwiddie County",4,71,305,136,169
050,51,053,"Virginia","Dinwiddie County",4,72,300,133,167
050,51,053,"Virginia","Dinwiddie County",4,73,272,122,150
050,51,053,"Virginia","Dinwiddie County",4,74,253,131,122
050,51,053,"Virginia","Dinwiddie County",4,75,265,137,128
050,51,053,"Virginia","Dinwiddie County",4,76,186,89,97
050,51,053,"Virginia","Dinwiddie County",4,77,175,76,99
050,51,053,"Virginia","Dinwiddie County",4,78,203,82,121
050,51,053,"Virginia","Dinwiddie County",4,79,189,86,103
050,51,053,"Virginia","Dinwiddie County",4,80,155,65,90
050,51,053,"Virginia","Dinwiddie County",4,81,148,60,88
050,51,053,"Virginia","Dinwiddie County",4,82,123,56,67
050,51,053,"Virginia","Dinwiddie County",4,83,114,51,63
050,51,053,"Virginia","Dinwiddie County",4,84,102,42,60
050,51,053,"Virginia","Dinwiddie County",4,85,494,177,317
050,51,053,"Virginia","Dinwiddie County",5,0,178,93,85
050,51,053,"Virginia","Dinwiddie County",5,1,213,116,97
050,51,053,"Virginia","Dinwiddie County",5,2,211,111,100
050,51,053,"Virginia","Dinwiddie County",5,3,240,116,124
050,51,053,"Virginia","Dinwiddie County",5,4,346,175,171
050,51,053,"Virginia","Dinwiddie County",5,5,314,157,157
050,51,053,"Virginia","Dinwiddie County",5,6,334,177,157
050,51,053,"Virginia","Dinwiddie County",5,7,356,191,165
050,51,053,"Virginia","Dinwiddie County",5,8,345,180,165
050,51,053,"Virginia","Dinwiddie County",5,9,345,193,152
050,51,053,"Virginia","Dinwiddie County",5,10,361,163,198
050,51,053,"Virginia","Dinwiddie County",5,11,333,176,157
050,51,053,"Virginia","Dinwiddie County",5,12,329,174,155
050,51,053,"Virginia","Dinwiddie County",5,13,344,188,156
050,51,053,"Virginia","Dinwiddie County",5,14,321,168,153
050,51,053,"Virginia","Dinwiddie County",5,15,354,178,176
050,51,053,"Virginia","Dinwiddie County",5,16,356,186,170
050,51,053,"Virginia","Dinwiddie County",5,17,328,162,166
050,51,053,"Virginia","Dinwiddie County",5,18,286,148,138
050,51,053,"Virginia","Dinwiddie County",5,19,248,131,117
050,51,053,"Virginia","Dinwiddie County",5,20,276,151,125
050,51,053,"Virginia","Dinwiddie County",5,21,264,140,124
050,51,053,"Virginia","Dinwiddie County",5,22,339,189,150
050,51,053,"Virginia","Dinwiddie County",5,23,294,156,138
050,51,053,"Virginia","Dinwiddie County",5,24,299,166,133
050,51,053,"Virginia","Dinwiddie County",5,25,324,176,148
050,51,053,"Virginia","Dinwiddie County",5,26,318,167,151
050,51,053,"Virginia","Dinwiddie County",5,27,336,171,165
050,51,053,"Virginia","Dinwiddie County",5,28,339,154,185
050,51,053,"Virginia","Dinwiddie County",5,29,368,185,183
050,51,053,"Virginia","Dinwiddie County",5,30,366,178,188
050,51,053,"Virginia","Dinwiddie County",5,31,414,204,210
050,51,053,"Virginia","Dinwiddie County",5,32,374,198,176
050,51,053,"Virginia","Dinwiddie County",5,33,396,200,196
050,51,053,"Virginia","Dinwiddie County",5,34,388,190,198
050,51,053,"Virginia","Dinwiddie County",5,35,388,201,187
050,51,053,"Virginia","Dinwiddie County",5,36,375,183,192
050,51,053,"Virginia","Dinwiddie County",5,37,383,184,199
050,51,053,"Virginia","Dinwiddie County",5,38,363,183,180
050,51,053,"Virginia","Dinwiddie County",5,39,350,184,166
050,51,053,"Virginia","Dinwiddie County",5,40,311,153,158
050,51,053,"Virginia","Dinwiddie County",5,41,324,153,171
050,51,053,"Virginia","Dinwiddie County",5,42,319,161,158
050,51,053,"Virginia","Dinwiddie County",5,43,325,155,170
050,51,053,"Virginia","Dinwiddie County",5,44,315,147,168
050,51,053,"Virginia","Dinwiddie County",5,45,315,140,175
050,51,053,"Virginia","Dinwiddie County",5,46,358,177,181
050,51,053,"Virginia","Dinwiddie County",5,47,329,156,173
050,51,053,"Virginia","Dinwiddie County",5,48,340,172,168
050,51,053,"Virginia","Dinwiddie County",5,49,315,165,150
050,51,053,"Virginia","Dinwiddie County",5,50,352,180,172
050,51,053,"Virginia","Dinwiddie County",5,51,399,207,192
050,51,053,"Virginia","Dinwiddie County",5,52,434,215,219
050,51,053,"Virginia","Dinwiddie County",5,53,425,213,212
050,51,053,"Virginia","Dinwiddie County",5,54,390,195,195
050,51,053,"Virginia","Dinwiddie County",5,55,381,188,193
050,51,053,"Virginia","Dinwiddie County",5,56,441,224,217
050,51,053,"Virginia","Dinwiddie County",5,57,457,228,229
050,51,053,"Virginia","Dinwiddie County",5,58,468,234,234
050,51,053,"Virginia","Dinwiddie County",5,59,498,248,250
050,51,053,"Virginia","Dinwiddie County",5,60,469,236,233
050,51,053,"Virginia","Dinwiddie County",5,61,451,215,236
050,51,053,"Virginia","Dinwiddie County",5,62,439,222,217
050,51,053,"Virginia","Dinwiddie County",5,63,425,207,218
050,51,053,"Virginia","Dinwiddie County",5,64,403,208,195
050,51,053,"Virginia","Dinwiddie County",5,65,421,202,219
050,51,053,"Virginia","Dinwiddie County",5,66,416,187,229
050,51,053,"Virginia","Dinwiddie County",5,67,352,166,186
050,51,053,"Virginia","Dinwiddie County",5,68,345,163,182
050,51,053,"Virginia","Dinwiddie County",5,69,343,164,179
050,51,053,"Virginia","Dinwiddie County",5,70,328,159,169
050,51,053,"Virginia","Dinwiddie County",5,71,311,147,164
050,51,053,"Virginia","Dinwiddie County",5,72,288,127,161
050,51,053,"Virginia","Dinwiddie County",5,73,292,126,166
050,51,053,"Virginia","Dinwiddie County",5,74,264,118,146
050,51,053,"Virginia","Dinwiddie County",5,75,243,126,117
050,51,053,"Virginia","Dinwiddie County",5,76,250,128,122
050,51,053,"Virginia","Dinwiddie County",5,77,171,82,89
050,51,053,"Virginia","Dinwiddie County",5,78,175,72,103
050,51,053,"Virginia","Dinwiddie County",5,79,183,75,108
050,51,053,"Virginia","Dinwiddie County",5,80,177,77,100
050,51,053,"Virginia","Dinwiddie County",5,81,138,55,83
050,51,053,"Virginia","Dinwiddie County",5,82,138,56,82
050,51,053,"Virginia","Dinwiddie County",5,83,115,53,62
050,51,053,"Virginia","Dinwiddie County",5,84,99,45,54
050,51,053,"Virginia","Dinwiddie County",5,85,515,194,321
050,51,057,"Virginia","Essex County",1,0,101,52,49
050,51,057,"Virginia","Essex County",1,1,114,60,54
050,51,057,"Virginia","Essex County",1,2,101,60,41
050,51,057,"Virginia","Essex County",1,3,81,44,37
050,51,057,"Virginia","Essex County",1,4,98,48,50
050,51,057,"Virginia","Essex County",1,5,112,53,59
050,51,057,"Virginia","Essex County",1,6,105,58,47
050,51,057,"Virginia","Essex County",1,7,110,58,52
050,51,057,"Virginia","Essex County",1,8,99,46,53
050,51,057,"Virginia","Essex County",1,9,88,42,46
050,51,057,"Virginia","Essex County",1,10,109,65,44
050,51,057,"Virginia","Essex County",1,11,115,55,60
050,51,057,"Virginia","Essex County",1,12,103,47,56
050,51,057,"Virginia","Essex County",1,13,105,53,52
050,51,057,"Virginia","Essex County",1,14,106,47,59
050,51,057,"Virginia","Essex County",1,15,125,60,65
050,51,057,"Virginia","Essex County",1,16,115,58,57
050,51,057,"Virginia","Essex County",1,17,105,54,51
050,51,057,"Virginia","Essex County",1,18,91,42,49
050,51,057,"Virginia","Essex County",1,19,89,45,44
050,51,057,"Virginia","Essex County",1,20,86,45,41
050,51,057,"Virginia","Essex County",1,21,100,49,51
050,51,057,"Virginia","Essex County",1,22,113,51,62
050,51,057,"Virginia","Essex County",1,23,115,49,66
050,51,057,"Virginia","Essex County",1,24,113,50,63
050,51,057,"Virginia","Essex County",1,25,115,59,56
050,51,057,"Virginia","Essex County",1,26,117,65,52
050,51,057,"Virginia","Essex County",1,27,134,62,72
050,51,057,"Virginia","Essex County",1,28,137,64,73
050,51,057,"Virginia","Essex County",1,29,134,65,69
050,51,057,"Virginia","Essex County",1,30,123,61,62
050,51,057,"Virginia","Essex County",1,31,112,55,57
050,51,057,"Virginia","Essex County",1,32,131,67,64
050,51,057,"Virginia","Essex County",1,33,129,68,61
050,51,057,"Virginia","Essex County",1,34,116,51,65
050,51,057,"Virginia","Essex County",1,35,124,55,69
050,51,057,"Virginia","Essex County",1,36,96,44,52
050,51,057,"Virginia","Essex County",1,37,101,52,49
050,51,057,"Virginia","Essex County",1,38,104,51,53
050,51,057,"Virginia","Essex County",1,39,107,53,54
050,51,057,"Virginia","Essex County",1,40,106,49,57
050,51,057,"Virginia","Essex County",1,41,117,57,60
050,51,057,"Virginia","Essex County",1,42,121,57,64
050,51,057,"Virginia","Essex County",1,43,114,58,56
050,51,057,"Virginia","Essex County",1,44,103,49,54
050,51,057,"Virginia","Essex County",1,45,96,43,53
050,51,057,"Virginia","Essex County",1,46,104,43,61
050,51,057,"Virginia","Essex County",1,47,134,58,76
050,51,057,"Virginia","Essex County",1,48,140,65,75
050,51,057,"Virginia","Essex County",1,49,149,66,83
050,51,057,"Virginia","Essex County",1,50,130,58,72
050,51,057,"Virginia","Essex County",1,51,148,65,83
050,51,057,"Virginia","Essex County",1,52,147,64,83
050,51,057,"Virginia","Essex County",1,53,158,79,79
050,51,057,"Virginia","Essex County",1,54,182,89,93
050,51,057,"Virginia","Essex County",1,55,174,75,99
050,51,057,"Virginia","Essex County",1,56,163,67,96
050,51,057,"Virginia","Essex County",1,57,177,82,95
050,51,057,"Virginia","Essex County",1,58,181,90,91
050,51,057,"Virginia","Essex County",1,59,197,86,111
050,51,057,"Virginia","Essex County",1,60,191,80,111
050,51,057,"Virginia","Essex County",1,61,182,97,85
050,51,057,"Virginia","Essex County",1,62,166,86,80
050,51,057,"Virginia","Essex County",1,63,166,84,82
050,51,057,"Virginia","Essex County",1,64,178,88,90
050,51,057,"Virginia","Essex County",1,65,158,78,80
050,51,057,"Virginia","Essex County",1,66,185,88,97
050,51,057,"Virginia","Essex County",1,67,171,81,90
050,51,057,"Virginia","Essex County",1,68,171,76,95
050,51,057,"Virginia","Essex County",1,69,168,71,97
050,51,057,"Virginia","Essex County",1,70,144,61,83
050,51,057,"Virginia","Essex County",1,71,141,58,83
050,51,057,"Virginia","Essex County",1,72,159,71,88
050,51,057,"Virginia","Essex County",1,73,159,73,86
050,51,057,"Virginia","Essex County",1,74,107,49,58
050,51,057,"Virginia","Essex County",1,75,96,43,53
050,51,057,"Virginia","Essex County",1,76,86,39,47
050,51,057,"Virginia","Essex County",1,77,96,47,49
050,51,057,"Virginia","Essex County",1,78,79,46,33
050,51,057,"Virginia","Essex County",1,79,80,42,38
050,51,057,"Virginia","Essex County",1,80,73,32,41
050,51,057,"Virginia","Essex County",1,81,61,28,33
050,51,057,"Virginia","Essex County",1,82,43,19,24
050,51,057,"Virginia","Essex County",1,83,41,16,25
050,51,057,"Virginia","Essex County",1,84,43,18,25
050,51,057,"Virginia","Essex County",1,85,236,95,141
050,51,057,"Virginia","Essex County",2,0,103,57,46
050,51,057,"Virginia","Essex County",2,1,110,58,52
050,51,057,"Virginia","Essex County",2,2,103,61,42
050,51,057,"Virginia","Essex County",2,3,85,48,37
050,51,057,"Virginia","Essex County",2,4,95,49,46
050,51,057,"Virginia","Essex County",2,5,108,53,55
050,51,057,"Virginia","Essex County",2,6,108,56,52
050,51,057,"Virginia","Essex County",2,7,107,57,50
050,51,057,"Virginia","Essex County",2,8,98,46,52
050,51,057,"Virginia","Essex County",2,9,92,45,47
050,51,057,"Virginia","Essex County",2,10,104,58,46
050,51,057,"Virginia","Essex County",2,11,114,58,56
050,51,057,"Virginia","Essex County",2,12,108,50,58
050,51,057,"Virginia","Essex County",2,13,103,52,51
050,51,057,"Virginia","Essex County",2,14,106,49,57
050,51,057,"Virginia","Essex County",2,15,121,58,63
050,51,057,"Virginia","Essex County",2,16,117,58,59
050,51,057,"Virginia","Essex County",2,17,107,54,53
050,51,057,"Virginia","Essex County",2,18,93,44,49
050,51,057,"Virginia","Essex County",2,19,87,43,44
050,51,057,"Virginia","Essex County",2,20,89,46,43
050,51,057,"Virginia","Essex County",2,21,97,48,49
050,51,057,"Virginia","Essex County",2,22,112,52,60
050,51,057,"Virginia","Essex County",2,23,114,49,65
050,51,057,"Virginia","Essex County",2,24,113,50,63
050,51,057,"Virginia","Essex County",2,25,111,55,56
050,51,057,"Virginia","Essex County",2,26,116,64,52
050,51,057,"Virginia","Essex County",2,27,133,65,68
050,51,057,"Virginia","Essex County",2,28,137,64,73
050,51,057,"Virginia","Essex County",2,29,133,64,69
050,51,057,"Virginia","Essex County",2,30,125,62,63
050,51,057,"Virginia","Essex County",2,31,115,58,57
050,51,057,"Virginia","Essex County",2,32,127,65,62
050,51,057,"Virginia","Essex County",2,33,129,68,61
050,51,057,"Virginia","Essex County",2,34,118,54,64
050,51,057,"Virginia","Essex County",2,35,123,54,69
050,51,057,"Virginia","Essex County",2,36,103,47,56
050,51,057,"Virginia","Essex County",2,37,101,50,51
050,51,057,"Virginia","Essex County",2,38,104,52,52
050,51,057,"Virginia","Essex County",2,39,106,53,53
050,51,057,"Virginia","Essex County",2,40,108,51,57
050,51,057,"Virginia","Essex County",2,41,117,56,61
050,51,057,"Virginia","Essex County",2,42,120,58,62
050,51,057,"Virginia","Essex County",2,43,118,58,60
050,51,057,"Virginia","Essex County",2,44,103,50,53
050,51,057,"Virginia","Essex County",2,45,96,44,52
050,51,057,"Virginia","Essex County",2,46,101,43,58
050,51,057,"Virginia","Essex County",2,47,126,54,72
050,51,057,"Virginia","Essex County",2,48,139,63,76
050,51,057,"Virginia","Essex County",2,49,147,66,81
050,51,057,"Virginia","Essex County",2,50,135,61,74
050,51,057,"Virginia","Essex County",2,51,143,62,81
050,51,057,"Virginia","Essex County",2,52,148,66,82
050,51,057,"Virginia","Essex County",2,53,157,78,79
050,51,057,"Virginia","Essex County",2,54,177,87,90
050,51,057,"Virginia","Essex County",2,55,176,78,98
050,51,057,"Virginia","Essex County",2,56,166,68,98
050,51,057,"Virginia","Essex County",2,57,176,80,96
050,51,057,"Virginia","Essex County",2,58,184,90,94
050,51,057,"Virginia","Essex County",2,59,194,87,107
050,51,057,"Virginia","Essex County",2,60,190,80,110
050,51,057,"Virginia","Essex County",2,61,183,92,91
050,51,057,"Virginia","Essex County",2,62,169,88,81
050,51,057,"Virginia","Essex County",2,63,168,86,82
050,51,057,"Virginia","Essex County",2,64,175,86,89
050,51,057,"Virginia","Essex County",2,65,162,80,82
050,51,057,"Virginia","Essex County",2,66,179,86,93
050,51,057,"Virginia","Essex County",2,67,172,81,91
050,51,057,"Virginia","Essex County",2,68,170,77,93
050,51,057,"Virginia","Essex County",2,69,169,71,98
050,51,057,"Virginia","Essex County",2,70,149,63,86
050,51,057,"Virginia","Essex County",2,71,141,59,82
050,51,057,"Virginia","Essex County",2,72,153,65,88
050,51,057,"Virginia","Essex County",2,73,165,75,90
050,51,057,"Virginia","Essex County",2,74,110,50,60
050,51,057,"Virginia","Essex County",2,75,98,44,54
050,51,057,"Virginia","Essex County",2,76,87,39,48
050,51,057,"Virginia","Essex County",2,77,94,45,49
050,51,057,"Virginia","Essex County",2,78,80,44,36
050,51,057,"Virginia","Essex County",2,79,77,40,37
050,51,057,"Virginia","Essex County",2,80,74,35,39
050,51,057,"Virginia","Essex County",2,81,61,27,34
050,51,057,"Virginia","Essex County",2,82,44,20,24
050,51,057,"Virginia","Essex County",2,83,42,17,25
050,51,057,"Virginia","Essex County",2,84,43,18,25
050,51,057,"Virginia","Essex County",2,85,237,96,141
050,51,057,"Virginia","Essex County",3,0,114,52,62
050,51,057,"Virginia","Essex County",3,1,102,61,41
050,51,057,"Virginia","Essex County",3,2,102,52,50
050,51,057,"Virginia","Essex County",3,3,101,61,40
050,51,057,"Virginia","Essex County",3,4,90,49,41
050,51,057,"Virginia","Essex County",3,5,94,46,48
050,51,057,"Virginia","Essex County",3,6,97,50,47
050,51,057,"Virginia","Essex County",3,7,112,57,55
050,51,057,"Virginia","Essex County",3,8,102,55,47
050,51,057,"Virginia","Essex County",3,9,94,45,49
050,51,057,"Virginia","Essex County",3,10,95,54,41
050,51,057,"Virginia","Essex County",3,11,109,62,47
050,51,057,"Virginia","Essex County",3,12,119,59,60
050,51,057,"Virginia","Essex County",3,13,105,46,59
050,51,057,"Virginia","Essex County",3,14,101,50,51
050,51,057,"Virginia","Essex County",3,15,105,50,55
050,51,057,"Virginia","Essex County",3,16,125,59,66
050,51,057,"Virginia","Essex County",3,17,118,59,59
050,51,057,"Virginia","Essex County",3,18,111,53,58
050,51,057,"Virginia","Essex County",3,19,81,40,41
050,51,057,"Virginia","Essex County",3,20,90,47,43
050,51,057,"Virginia","Essex County",3,21,98,49,49
050,51,057,"Virginia","Essex County",3,22,94,52,42
050,51,057,"Virginia","Essex County",3,23,104,49,55
050,51,057,"Virginia","Essex County",3,24,128,50,78
050,51,057,"Virginia","Essex County",3,25,110,46,64
050,51,057,"Virginia","Essex County",3,26,102,52,50
050,51,057,"Virginia","Essex County",3,27,114,63,51
050,51,057,"Virginia","Essex County",3,28,131,66,65
050,51,057,"Virginia","Essex County",3,29,136,63,73
050,51,057,"Virginia","Essex County",3,30,119,61,58
050,51,057,"Virginia","Essex County",3,31,129,62,67
050,51,057,"Virginia","Essex County",3,32,98,50,48
050,51,057,"Virginia","Essex County",3,33,119,60,59
050,51,057,"Virginia","Essex County",3,34,127,63,64
050,51,057,"Virginia","Essex County",3,35,121,56,65
050,51,057,"Virginia","Essex County",3,36,130,55,75
050,51,057,"Virginia","Essex County",3,37,104,49,55
050,51,057,"Virginia","Essex County",3,38,107,52,55
050,51,057,"Virginia","Essex County",3,39,115,56,59
050,51,057,"Virginia","Essex County",3,40,108,53,55
050,51,057,"Virginia","Essex County",3,41,111,55,56
050,51,057,"Virginia","Essex County",3,42,116,54,62
050,51,057,"Virginia","Essex County",3,43,120,58,62
050,51,057,"Virginia","Essex County",3,44,113,55,58
050,51,057,"Virginia","Essex County",3,45,109,55,54
050,51,057,"Virginia","Essex County",3,46,97,45,52
050,51,057,"Virginia","Essex County",3,47,99,42,57
050,51,057,"Virginia","Essex County",3,48,132,55,77
050,51,057,"Virginia","Essex County",3,49,145,69,76
050,51,057,"Virginia","Essex County",3,50,141,65,76
050,51,057,"Virginia","Essex County",3,51,132,63,69
050,51,057,"Virginia","Essex County",3,52,142,59,83
050,51,057,"Virginia","Essex County",3,53,150,63,87
050,51,057,"Virginia","Essex County",3,54,154,77,77
050,51,057,"Virginia","Essex County",3,55,176,88,88
050,51,057,"Virginia","Essex County",3,56,184,81,103
050,51,057,"Virginia","Essex County",3,57,163,67,96
050,51,057,"Virginia","Essex County",3,58,181,80,101
050,51,057,"Virginia","Essex County",3,59,183,97,86
050,51,057,"Virginia","Essex County",3,60,196,84,112
050,51,057,"Virginia","Essex County",3,61,189,81,108
050,51,057,"Virginia","Essex County",3,62,187,96,91
050,51,057,"Virginia","Essex County",3,63,176,94,82
050,51,057,"Virginia","Essex County",3,64,168,87,81
050,51,057,"Virginia","Essex County",3,65,171,86,85
050,51,057,"Virginia","Essex County",3,66,161,82,79
050,51,057,"Virginia","Essex County",3,67,172,81,91
050,51,057,"Virginia","Essex County",3,68,170,83,87
050,51,057,"Virginia","Essex County",3,69,171,76,95
050,51,057,"Virginia","Essex County",3,70,161,66,95
050,51,057,"Virginia","Essex County",3,71,143,60,83
050,51,057,"Virginia","Essex County",3,72,140,57,83
050,51,057,"Virginia","Essex County",3,73,148,65,83
050,51,057,"Virginia","Essex County",3,74,157,72,85
050,51,057,"Virginia","Essex County",3,75,106,49,57
050,51,057,"Virginia","Essex County",3,76,96,44,52
050,51,057,"Virginia","Essex County",3,77,87,37,50
050,51,057,"Virginia","Essex County",3,78,94,46,48
050,51,057,"Virginia","Essex County",3,79,72,41,31
050,51,057,"Virginia","Essex County",3,80,66,33,33
050,51,057,"Virginia","Essex County",3,81,72,31,41
050,51,057,"Virginia","Essex County",3,82,56,24,32
050,51,057,"Virginia","Essex County",3,83,37,16,21
050,51,057,"Virginia","Essex County",3,84,36,13,23
050,51,057,"Virginia","Essex County",3,85,230,94,136
050,51,057,"Virginia","Essex County",4,0,106,49,57
050,51,057,"Virginia","Essex County",4,1,119,60,59
050,51,057,"Virginia","Essex County",4,2,97,54,43
050,51,057,"Virginia","Essex County",4,3,117,59,58
050,51,057,"Virginia","Essex County",4,4,99,60,39
050,51,057,"Virginia","Essex County",4,5,96,57,39
050,51,057,"Virginia","Essex County",4,6,101,45,56
050,51,057,"Virginia","Essex County",4,7,99,48,51
050,51,057,"Virginia","Essex County",4,8,104,52,52
050,51,057,"Virginia","Essex County",4,9,106,56,50
050,51,057,"Virginia","Essex County",4,10,95,42,53
050,51,057,"Virginia","Essex County",4,11,97,54,43
050,51,057,"Virginia","Essex County",4,12,104,58,46
050,51,057,"Virginia","Essex County",4,13,115,54,61
050,51,057,"Virginia","Essex County",4,14,114,47,67
050,51,057,"Virginia","Essex County",4,15,96,47,49
050,51,057,"Virginia","Essex County",4,16,105,51,54
050,51,057,"Virginia","Essex County",4,17,119,58,61
050,51,057,"Virginia","Essex County",4,18,106,55,51
050,51,057,"Virginia","Essex County",4,19,97,44,53
050,51,057,"Virginia","Essex County",4,20,87,44,43
050,51,057,"Virginia","Essex County",4,21,102,49,53
050,51,057,"Virginia","Essex County",4,22,108,50,58
050,51,057,"Virginia","Essex County",4,23,113,62,51
050,51,057,"Virginia","Essex County",4,24,98,49,49
050,51,057,"Virginia","Essex County",4,25,121,48,73
050,51,057,"Virginia","Essex County",4,26,113,46,67
050,51,057,"Virginia","Essex County",4,27,98,52,46
050,51,057,"Virginia","Essex County",4,28,129,64,65
050,51,057,"Virginia","Essex County",4,29,134,63,71
050,51,057,"Virginia","Essex County",4,30,127,58,69
050,51,057,"Virginia","Essex County",4,31,130,72,58
050,51,057,"Virginia","Essex County",4,32,131,61,70
050,51,057,"Virginia","Essex County",4,33,99,50,49
050,51,057,"Virginia","Essex County",4,34,121,62,59
050,51,057,"Virginia","Essex County",4,35,128,63,65
050,51,057,"Virginia","Essex County",4,36,124,59,65
050,51,057,"Virginia","Essex County",4,37,133,59,74
050,51,057,"Virginia","Essex County",4,38,115,60,55
050,51,057,"Virginia","Essex County",4,39,104,51,53
050,51,057,"Virginia","Essex County",4,40,121,58,63
050,51,057,"Virginia","Essex County",4,41,105,53,52
050,51,057,"Virginia","Essex County",4,42,105,50,55
050,51,057,"Virginia","Essex County",4,43,120,58,62
050,51,057,"Virginia","Essex County",4,44,122,58,64
050,51,057,"Virginia","Essex County",4,45,115,55,60
050,51,057,"Virginia","Essex County",4,46,108,57,51
050,51,057,"Virginia","Essex County",4,47,98,50,48
050,51,057,"Virginia","Essex County",4,48,102,43,59
050,51,057,"Virginia","Essex County",4,49,121,49,72
050,51,057,"Virginia","Essex County",4,50,140,67,73
050,51,057,"Virginia","Essex County",4,51,144,64,80
050,51,057,"Virginia","Essex County",4,52,134,64,70
050,51,057,"Virginia","Essex County",4,53,140,59,81
050,51,057,"Virginia","Essex County",4,54,149,63,86
050,51,057,"Virginia","Essex County",4,55,153,78,75
050,51,057,"Virginia","Essex County",4,56,183,90,93
050,51,057,"Virginia","Essex County",4,57,185,81,104
050,51,057,"Virginia","Essex County",4,58,159,64,95
050,51,057,"Virginia","Essex County",4,59,182,78,104
050,51,057,"Virginia","Essex County",4,60,176,89,87
050,51,057,"Virginia","Essex County",4,61,202,86,116
050,51,057,"Virginia","Essex County",4,62,193,88,105
050,51,057,"Virginia","Essex County",4,63,193,98,95
050,51,057,"Virginia","Essex County",4,64,187,100,87
050,51,057,"Virginia","Essex County",4,65,168,87,81
050,51,057,"Virginia","Essex County",4,66,180,91,89
050,51,057,"Virginia","Essex County",4,67,161,78,83
050,51,057,"Virginia","Essex County",4,68,174,82,92
050,51,057,"Virginia","Essex County",4,69,157,75,82
050,51,057,"Virginia","Essex County",4,70,164,74,90
050,51,057,"Virginia","Essex County",4,71,157,63,94
050,51,057,"Virginia","Essex County",4,72,138,54,84
050,51,057,"Virginia","Essex County",4,73,134,55,79
050,51,057,"Virginia","Essex County",4,74,141,62,79
050,51,057,"Virginia","Essex County",4,75,151,70,81
050,51,057,"Virginia","Essex County",4,76,105,46,59
050,51,057,"Virginia","Essex County",4,77,92,42,50
050,51,057,"Virginia","Essex County",4,78,82,34,48
050,51,057,"Virginia","Essex County",4,79,88,43,45
050,51,057,"Virginia","Essex County",4,80,67,37,30
050,51,057,"Virginia","Essex County",4,81,65,33,32
050,51,057,"Virginia","Essex County",4,82,65,28,37
050,51,057,"Virginia","Essex County",4,83,48,22,26
050,51,057,"Virginia","Essex County",4,84,32,14,18
050,51,057,"Virginia","Essex County",4,85,217,92,125
050,51,057,"Virginia","Essex County",5,0,108,50,58
050,51,057,"Virginia","Essex County",5,1,99,45,54
050,51,057,"Virginia","Essex County",5,2,116,59,57
050,51,057,"Virginia","Essex County",5,3,100,57,43
050,51,057,"Virginia","Essex County",5,4,119,61,58
050,51,057,"Virginia","Essex County",5,5,98,62,36
050,51,057,"Virginia","Essex County",5,6,100,59,41
050,51,057,"Virginia","Essex County",5,7,102,46,56
050,51,057,"Virginia","Essex County",5,8,98,47,51
050,51,057,"Virginia","Essex County",5,9,105,57,48
050,51,057,"Virginia","Essex County",5,10,103,55,48
050,51,057,"Virginia","Essex County",5,11,98,44,54
050,51,057,"Virginia","Essex County",5,12,99,53,46
050,51,057,"Virginia","Essex County",5,13,107,61,46
050,51,057,"Virginia","Essex County",5,14,114,56,58
050,51,057,"Virginia","Essex County",5,15,122,52,70
050,51,057,"Virginia","Essex County",5,16,99,51,48
050,51,057,"Virginia","Essex County",5,17,105,49,56
050,51,057,"Virginia","Essex County",5,18,111,55,56
050,51,057,"Virginia","Essex County",5,19,91,47,44
050,51,057,"Virginia","Essex County",5,20,103,47,56
050,51,057,"Virginia","Essex County",5,21,84,40,44
050,51,057,"Virginia","Essex County",5,22,101,50,51
050,51,057,"Virginia","Essex County",5,23,110,53,57
050,51,057,"Virginia","Essex County",5,24,125,64,61
050,51,057,"Virginia","Essex County",5,25,97,51,46
050,51,057,"Virginia","Essex County",5,26,112,42,70
050,51,057,"Virginia","Essex County",5,27,103,42,61
050,51,057,"Virginia","Essex County",5,28,98,47,51
050,51,057,"Virginia","Essex County",5,29,134,70,64
050,51,057,"Virginia","Essex County",5,30,126,60,66
050,51,057,"Virginia","Essex County",5,31,128,60,68
050,51,057,"Virginia","Essex County",5,32,134,75,59
050,51,057,"Virginia","Essex County",5,33,126,58,68
050,51,057,"Virginia","Essex County",5,34,106,53,53
050,51,057,"Virginia","Essex County",5,35,117,60,57
050,51,057,"Virginia","Essex County",5,36,122,59,63
050,51,057,"Virginia","Essex County",5,37,127,64,63
050,51,057,"Virginia","Essex County",5,38,130,56,74
050,51,057,"Virginia","Essex County",5,39,126,62,64
050,51,057,"Virginia","Essex County",5,40,109,49,60
050,51,057,"Virginia","Essex County",5,41,125,62,63
050,51,057,"Virginia","Essex County",5,42,102,50,52
050,51,057,"Virginia","Essex County",5,43,107,53,54
050,51,057,"Virginia","Essex County",5,44,124,60,64
050,51,057,"Virginia","Essex County",5,45,122,62,60
050,51,057,"Virginia","Essex County",5,46,118,56,62
050,51,057,"Virginia","Essex County",5,47,104,56,48
050,51,057,"Virginia","Essex County",5,48,100,54,46
050,51,057,"Virginia","Essex County",5,49,105,46,59
050,51,057,"Virginia","Essex County",5,50,114,48,66
050,51,057,"Virginia","Essex County",5,51,138,63,75
050,51,057,"Virginia","Essex County",5,52,142,65,77
050,51,057,"Virginia","Essex County",5,53,134,61,73
050,51,057,"Virginia","Essex County",5,54,140,59,81
050,51,057,"Virginia","Essex County",5,55,151,66,85
050,51,057,"Virginia","Essex County",5,56,161,83,78
050,51,057,"Virginia","Essex County",5,57,177,87,90
050,51,057,"Virginia","Essex County",5,58,184,84,100
050,51,057,"Virginia","Essex County",5,59,158,66,92
050,51,057,"Virginia","Essex County",5,60,174,74,100
050,51,057,"Virginia","Essex County",5,61,176,86,90
050,51,057,"Virginia","Essex County",5,62,200,86,114
050,51,057,"Virginia","Essex County",5,63,191,86,105
050,51,057,"Virginia","Essex County",5,64,193,98,95
050,51,057,"Virginia","Essex County",5,65,184,98,86
050,51,057,"Virginia","Essex County",5,66,170,87,83
050,51,057,"Virginia","Essex County",5,67,182,92,90
050,51,057,"Virginia","Essex County",5,68,156,76,80
050,51,057,"Virginia","Essex County",5,69,166,78,88
050,51,057,"Virginia","Essex County",5,70,155,74,81
050,51,057,"Virginia","Essex County",5,71,162,75,87
050,51,057,"Virginia","Essex County",5,72,148,56,92
050,51,057,"Virginia","Essex County",5,73,137,55,82
050,51,057,"Virginia","Essex County",5,74,130,54,76
050,51,057,"Virginia","Essex County",5,75,135,60,75
050,51,057,"Virginia","Essex County",5,76,150,71,79
050,51,057,"Virginia","Essex County",5,77,102,45,57
050,51,057,"Virginia","Essex County",5,78,85,40,45
050,51,057,"Virginia","Essex County",5,79,75,32,43
050,51,057,"Virginia","Essex County",5,80,83,38,45
050,51,057,"Virginia","Essex County",5,81,61,32,29
050,51,057,"Virginia","Essex County",5,82,59,29,30
050,51,057,"Virginia","Essex County",5,83,56,24,32
050,51,057,"Virginia","Essex County",5,84,42,19,23
050,51,057,"Virginia","Essex County",5,85,208,90,118
050,51,059,"Virginia","Fairfax County",1,0,13664,6996,6668
050,51,059,"Virginia","Fairfax County",1,1,13899,7124,6775
050,51,059,"Virginia","Fairfax County",1,2,14344,7301,7043
050,51,059,"Virginia","Fairfax County",1,3,14442,7417,7025
050,51,059,"Virginia","Fairfax County",1,4,14937,7724,7213
050,51,059,"Virginia","Fairfax County",1,5,14942,7696,7246
050,51,059,"Virginia","Fairfax County",1,6,14593,7478,7115
050,51,059,"Virginia","Fairfax County",1,7,14705,7536,7169
050,51,059,"Virginia","Fairfax County",1,8,14716,7506,7210
050,51,059,"Virginia","Fairfax County",1,9,15053,7725,7328
050,51,059,"Virginia","Fairfax County",1,10,15294,7812,7482
050,51,059,"Virginia","Fairfax County",1,11,15575,8010,7565
050,51,059,"Virginia","Fairfax County",1,12,16133,8316,7817
050,51,059,"Virginia","Fairfax County",1,13,15988,8360,7628
050,51,059,"Virginia","Fairfax County",1,14,15801,8215,7586
050,51,059,"Virginia","Fairfax County",1,15,15794,8125,7669
050,51,059,"Virginia","Fairfax County",1,16,15799,8189,7610
050,51,059,"Virginia","Fairfax County",1,17,15694,8051,7643
050,51,059,"Virginia","Fairfax County",1,18,14319,7372,6947
050,51,059,"Virginia","Fairfax County",1,19,13151,6724,6427
050,51,059,"Virginia","Fairfax County",1,20,12866,6490,6376
050,51,059,"Virginia","Fairfax County",1,21,12949,6481,6468
050,51,059,"Virginia","Fairfax County",1,22,13336,6706,6630
050,51,059,"Virginia","Fairfax County",1,23,13741,6909,6832
050,51,059,"Virginia","Fairfax County",1,24,14133,7190,6943
050,51,059,"Virginia","Fairfax County",1,25,14633,7468,7165
050,51,059,"Virginia","Fairfax County",1,26,14767,7590,7177
050,51,059,"Virginia","Fairfax County",1,27,14767,7641,7126
050,51,059,"Virginia","Fairfax County",1,28,14637,7601,7036
050,51,059,"Virginia","Fairfax County",1,29,14518,7543,6975
050,51,059,"Virginia","Fairfax County",1,30,14571,7514,7057
050,51,059,"Virginia","Fairfax County",1,31,14985,7601,7384
050,51,059,"Virginia","Fairfax County",1,32,15365,7844,7521
050,51,059,"Virginia","Fairfax County",1,33,15908,8066,7842
050,51,059,"Virginia","Fairfax County",1,34,16323,8264,8059
050,51,059,"Virginia","Fairfax County",1,35,16418,8369,8049
050,51,059,"Virginia","Fairfax County",1,36,16938,8587,8351
050,51,059,"Virginia","Fairfax County",1,37,17388,8745,8643
050,51,059,"Virginia","Fairfax County",1,38,17276,8691,8585
050,51,059,"Virginia","Fairfax County",1,39,17318,8670,8648
050,51,059,"Virginia","Fairfax County",1,40,17128,8538,8590
050,51,059,"Virginia","Fairfax County",1,41,16615,8233,8382
050,51,059,"Virginia","Fairfax County",1,42,16284,8059,8225
050,51,059,"Virginia","Fairfax County",1,43,15941,7714,8227
050,51,059,"Virginia","Fairfax County",1,44,15795,7766,8029
050,51,059,"Virginia","Fairfax County",1,45,16137,8107,8030
050,51,059,"Virginia","Fairfax County",1,46,15876,7903,7973
050,51,059,"Virginia","Fairfax County",1,47,15974,7927,8047
050,51,059,"Virginia","Fairfax County",1,48,16580,8246,8334
050,51,059,"Virginia","Fairfax County",1,49,17127,8575,8552
050,51,059,"Virginia","Fairfax County",1,50,16448,8152,8296
050,51,059,"Virginia","Fairfax County",1,51,16071,7984,8087
050,51,059,"Virginia","Fairfax County",1,52,15554,7701,7853
050,51,059,"Virginia","Fairfax County",1,53,15425,7629,7796
050,51,059,"Virginia","Fairfax County",1,54,15468,7721,7747
050,51,059,"Virginia","Fairfax County",1,55,15848,7828,8020
050,51,059,"Virginia","Fairfax County",1,56,16066,8024,8042
050,51,059,"Virginia","Fairfax County",1,57,15844,7973,7871
050,51,059,"Virginia","Fairfax County",1,58,15506,7822,7684
050,51,059,"Virginia","Fairfax County",1,59,15198,7613,7585
050,51,059,"Virginia","Fairfax County",1,60,14696,7313,7383
050,51,059,"Virginia","Fairfax County",1,61,14133,7010,7123
050,51,059,"Virginia","Fairfax County",1,62,13857,6912,6945
050,51,059,"Virginia","Fairfax County",1,63,13006,6442,6564
050,51,059,"Virginia","Fairfax County",1,64,12649,6202,6447
050,51,059,"Virginia","Fairfax County",1,65,11957,5839,6118
050,51,059,"Virginia","Fairfax County",1,66,11150,5384,5766
050,51,059,"Virginia","Fairfax County",1,67,10627,5155,5472
050,51,059,"Virginia","Fairfax County",1,68,10230,4903,5327
050,51,059,"Virginia","Fairfax County",1,69,9668,4611,5057
050,51,059,"Virginia","Fairfax County",1,70,9464,4472,4992
050,51,059,"Virginia","Fairfax County",1,71,9035,4248,4787
050,51,059,"Virginia","Fairfax County",1,72,9001,4255,4746
050,51,059,"Virginia","Fairfax County",1,73,8953,4233,4720
050,51,059,"Virginia","Fairfax County",1,74,6677,3124,3553
050,51,059,"Virginia","Fairfax County",1,75,6509,3062,3447
050,51,059,"Virginia","Fairfax County",1,76,6278,2916,3362
050,51,059,"Virginia","Fairfax County",1,77,5966,2709,3257
050,51,059,"Virginia","Fairfax County",1,78,5035,2287,2748
050,51,059,"Virginia","Fairfax County",1,79,4506,2082,2424
050,51,059,"Virginia","Fairfax County",1,80,4039,1865,2174
050,51,059,"Virginia","Fairfax County",1,81,3792,1697,2095
050,51,059,"Virginia","Fairfax County",1,82,3455,1518,1937
050,51,059,"Virginia","Fairfax County",1,83,3053,1367,1686
050,51,059,"Virginia","Fairfax County",1,84,2725,1214,1511
050,51,059,"Virginia","Fairfax County",1,85,17268,6538,10730
050,51,059,"Virginia","Fairfax County",2,0,13368,6879,6489
050,51,059,"Virginia","Fairfax County",2,1,13788,7056,6732
050,51,059,"Virginia","Fairfax County",2,2,14203,7242,6961
050,51,059,"Virginia","Fairfax County",2,3,14360,7351,7009
050,51,059,"Virginia","Fairfax County",2,4,14817,7650,7167
050,51,059,"Virginia","Fairfax County",2,5,14926,7704,7222
050,51,059,"Virginia","Fairfax County",2,6,14679,7535,7144
050,51,059,"Virginia","Fairfax County",2,7,14661,7502,7159
050,51,059,"Virginia","Fairfax County",2,8,14645,7476,7169
050,51,059,"Virginia","Fairfax County",2,9,14918,7644,7274
050,51,059,"Virginia","Fairfax County",2,10,15205,7762,7443
050,51,059,"Virginia","Fairfax County",2,11,15419,7923,7496
050,51,059,"Virginia","Fairfax County",2,12,16043,8275,7768
050,51,059,"Virginia","Fairfax County",2,13,15965,8319,7646
050,51,059,"Virginia","Fairfax County",2,14,15828,8239,7589
050,51,059,"Virginia","Fairfax County",2,15,15778,8144,7634
050,51,059,"Virginia","Fairfax County",2,16,15793,8177,7616
050,51,059,"Virginia","Fairfax County",2,17,15697,8075,7622
050,51,059,"Virginia","Fairfax County",2,18,14268,7350,6918
050,51,059,"Virginia","Fairfax County",2,19,13191,6742,6449
050,51,059,"Virginia","Fairfax County",2,20,13038,6573,6465
050,51,059,"Virginia","Fairfax County",2,21,12948,6491,6457
050,51,059,"Virginia","Fairfax County",2,22,13311,6711,6600
050,51,059,"Virginia","Fairfax County",2,23,13712,6912,6800
050,51,059,"Virginia","Fairfax County",2,24,14088,7164,6924
050,51,059,"Virginia","Fairfax County",2,25,14535,7431,7104
050,51,059,"Virginia","Fairfax County",2,26,14744,7596,7148
050,51,059,"Virginia","Fairfax County",2,27,14731,7623,7108
050,51,059,"Virginia","Fairfax County",2,28,14687,7624,7063
050,51,059,"Virginia","Fairfax County",2,29,14566,7567,6999
050,51,059,"Virginia","Fairfax County",2,30,14642,7550,7092
050,51,059,"Virginia","Fairfax County",2,31,14888,7583,7305
050,51,059,"Virginia","Fairfax County",2,32,15271,7786,7485
050,51,059,"Virginia","Fairfax County",2,33,15781,8003,7778
050,51,059,"Virginia","Fairfax County",2,34,16218,8213,8005
050,51,059,"Virginia","Fairfax County",2,35,16473,8379,8094
050,51,059,"Virginia","Fairfax County",2,36,16748,8488,8260
050,51,059,"Virginia","Fairfax County",2,37,17287,8713,8574
050,51,059,"Virginia","Fairfax County",2,38,17344,8714,8630
050,51,059,"Virginia","Fairfax County",2,39,17226,8620,8606
050,51,059,"Virginia","Fairfax County",2,40,17239,8593,8646
050,51,059,"Virginia","Fairfax County",2,41,16688,8279,8409
050,51,059,"Virginia","Fairfax County",2,42,16269,8074,8195
050,51,059,"Virginia","Fairfax County",2,43,16069,7829,8240
050,51,059,"Virginia","Fairfax County",2,44,15688,7687,8001
050,51,059,"Virginia","Fairfax County",2,45,16081,8032,8049
050,51,059,"Virginia","Fairfax County",2,46,15858,7907,7951
050,51,059,"Virginia","Fairfax County",2,47,15882,7882,8000
050,51,059,"Virginia","Fairfax County",2,48,16388,8148,8240
050,51,059,"Virginia","Fairfax County",2,49,16994,8495,8499
050,51,059,"Virginia","Fairfax County",2,50,16583,8242,8341
050,51,059,"Virginia","Fairfax County",2,51,16037,7967,8070
050,51,059,"Virginia","Fairfax County",2,52,15620,7747,7873
050,51,059,"Virginia","Fairfax County",2,53,15367,7597,7770
050,51,059,"Virginia","Fairfax County",2,54,15379,7666,7713
050,51,059,"Virginia","Fairfax County",2,55,15664,7753,7911
050,51,059,"Virginia","Fairfax County",2,56,15963,7956,8007
050,51,059,"Virginia","Fairfax County",2,57,15839,7956,7883
050,51,059,"Virginia","Fairfax County",2,58,15486,7816,7670
050,51,059,"Virginia","Fairfax County",2,59,15158,7608,7550
050,51,059,"Virginia","Fairfax County",2,60,14745,7353,7392
050,51,059,"Virginia","Fairfax County",2,61,14130,7018,7112
050,51,059,"Virginia","Fairfax County",2,62,13809,6880,6929
050,51,059,"Virginia","Fairfax County",2,63,13170,6532,6638
050,51,059,"Virginia","Fairfax County",2,64,12566,6169,6397
050,51,059,"Virginia","Fairfax County",2,65,11996,5846,6150
050,51,059,"Virginia","Fairfax County",2,66,11265,5451,5814
050,51,059,"Virginia","Fairfax County",2,67,10609,5136,5473
050,51,059,"Virginia","Fairfax County",2,68,10204,4905,5299
050,51,059,"Virginia","Fairfax County",2,69,9762,4658,5104
050,51,059,"Virginia","Fairfax County",2,70,9426,4457,4969
050,51,059,"Virginia","Fairfax County",2,71,9056,4260,4796
050,51,059,"Virginia","Fairfax County",2,72,8819,4157,4662
050,51,059,"Virginia","Fairfax County",2,73,9246,4368,4878
050,51,059,"Virginia","Fairfax County",2,74,6828,3193,3635
050,51,059,"Virginia","Fairfax County",2,75,6508,3058,3450
050,51,059,"Virginia","Fairfax County",2,76,6222,2896,3326
050,51,059,"Virginia","Fairfax County",2,77,6082,2775,3307
050,51,059,"Virginia","Fairfax County",2,78,5150,2332,2818
050,51,059,"Virginia","Fairfax County",2,79,4557,2094,2463
050,51,059,"Virginia","Fairfax County",2,80,4112,1895,2217
050,51,059,"Virginia","Fairfax County",2,81,3800,1708,2092
050,51,059,"Virginia","Fairfax County",2,82,3491,1537,1954
050,51,059,"Virginia","Fairfax County",2,83,3081,1369,1712
050,51,059,"Virginia","Fairfax County",2,84,2726,1219,1507
050,51,059,"Virginia","Fairfax County",2,85,17225,6559,10666
050,51,059,"Virginia","Fairfax County",3,0,12445,6331,6114
050,51,059,"Virginia","Fairfax County",3,1,13174,6702,6472
050,51,059,"Virginia","Fairfax County",3,2,13514,6907,6607
050,51,059,"Virginia","Fairfax County",3,3,14050,7170,6880
050,51,059,"Virginia","Fairfax County",3,4,14179,7265,6914
050,51,059,"Virginia","Fairfax County",3,5,14564,7470,7094
050,51,059,"Virginia","Fairfax County",3,6,14794,7670,7124
050,51,059,"Virginia","Fairfax County",3,7,14436,7449,6987
050,51,059,"Virginia","Fairfax County",3,8,14559,7441,7118
050,51,059,"Virginia","Fairfax County",3,9,14452,7391,7061
050,51,059,"Virginia","Fairfax County",3,10,14881,7655,7226
050,51,059,"Virginia","Fairfax County",3,11,14989,7702,7287
050,51,059,"Virginia","Fairfax County",3,12,15309,7925,7384
050,51,059,"Virginia","Fairfax County",3,13,15851,8154,7697
050,51,059,"Virginia","Fairfax County",3,14,15918,8299,7619
050,51,059,"Virginia","Fairfax County",3,15,15624,8129,7495
050,51,059,"Virginia","Fairfax County",3,16,15579,8040,7539
050,51,059,"Virginia","Fairfax County",3,17,15701,8155,7546
050,51,059,"Virginia","Fairfax County",3,18,14420,7477,6943
050,51,059,"Virginia","Fairfax County",3,19,12900,6604,6296
050,51,059,"Virginia","Fairfax County",3,20,13281,6697,6584
050,51,059,"Virginia","Fairfax County",3,21,12967,6486,6481
050,51,059,"Virginia","Fairfax County",3,22,13070,6574,6496
050,51,059,"Virginia","Fairfax County",3,23,13692,6972,6720
050,51,059,"Virginia","Fairfax County",3,24,14120,7200,6920
050,51,059,"Virginia","Fairfax County",3,25,14373,7370,7003
050,51,059,"Virginia","Fairfax County",3,26,14489,7470,7019
050,51,059,"Virginia","Fairfax County",3,27,14810,7585,7225
050,51,059,"Virginia","Fairfax County",3,28,14744,7607,7137
050,51,059,"Virginia","Fairfax County",3,29,14851,7633,7218
050,51,059,"Virginia","Fairfax County",3,30,14751,7665,7086
050,51,059,"Virginia","Fairfax County",3,31,14812,7610,7202
050,51,059,"Virginia","Fairfax County",3,32,15048,7638,7410
050,51,059,"Virginia","Fairfax County",3,33,15316,7797,7519
050,51,059,"Virginia","Fairfax County",3,34,15762,7926,7836
050,51,059,"Virginia","Fairfax County",3,35,16204,8202,8002
050,51,059,"Virginia","Fairfax County",3,36,16409,8239,8170
050,51,059,"Virginia","Fairfax County",3,37,16794,8524,8270
050,51,059,"Virginia","Fairfax County",3,38,17185,8626,8559
050,51,059,"Virginia","Fairfax County",3,39,17193,8607,8586
050,51,059,"Virginia","Fairfax County",3,40,17106,8583,8523
050,51,059,"Virginia","Fairfax County",3,41,16972,8444,8528
050,51,059,"Virginia","Fairfax County",3,42,16668,8239,8429
050,51,059,"Virginia","Fairfax County",3,43,16166,8023,8143
050,51,059,"Virginia","Fairfax County",3,44,15894,7768,8126
050,51,059,"Virginia","Fairfax County",3,45,15504,7575,7929
050,51,059,"Virginia","Fairfax County",3,46,15905,7928,7977
050,51,059,"Virginia","Fairfax County",3,47,15560,7761,7799
050,51,059,"Virginia","Fairfax County",3,48,15641,7780,7861
050,51,059,"Virginia","Fairfax County",3,49,16313,8067,8246
050,51,059,"Virginia","Fairfax County",3,50,16746,8414,8332
050,51,059,"Virginia","Fairfax County",3,51,16313,8156,8157
050,51,059,"Virginia","Fairfax County",3,52,15744,7839,7905
050,51,059,"Virginia","Fairfax County",3,53,15224,7571,7653
050,51,059,"Virginia","Fairfax County",3,54,15040,7439,7601
050,51,059,"Virginia","Fairfax County",3,55,14973,7501,7472
050,51,059,"Virginia","Fairfax County",3,56,15220,7542,7678
050,51,059,"Virginia","Fairfax County",3,57,15427,7696,7731
050,51,059,"Virginia","Fairfax County",3,58,15346,7701,7645
050,51,059,"Virginia","Fairfax County",3,59,14940,7536,7404
050,51,059,"Virginia","Fairfax County",3,60,14603,7361,7242
050,51,059,"Virginia","Fairfax County",3,61,14282,7131,7151
050,51,059,"Virginia","Fairfax County",3,62,13571,6750,6821
050,51,059,"Virginia","Fairfax County",3,63,13248,6600,6648
050,51,059,"Virginia","Fairfax County",3,64,12695,6280,6415
050,51,059,"Virginia","Fairfax County",3,65,12105,5923,6182
050,51,059,"Virginia","Fairfax County",3,66,11580,5609,5971
050,51,059,"Virginia","Fairfax County",3,67,10874,5268,5606
050,51,059,"Virginia","Fairfax County",3,68,10307,4963,5344
050,51,059,"Virginia","Fairfax County",3,69,10006,4769,5237
050,51,059,"Virginia","Fairfax County",3,70,9495,4510,4985
050,51,059,"Virginia","Fairfax County",3,71,9141,4330,4811
050,51,059,"Virginia","Fairfax County",3,72,8869,4154,4715
050,51,059,"Virginia","Fairfax County",3,73,8646,4063,4583
050,51,059,"Virginia","Fairfax County",3,74,9001,4224,4777
050,51,059,"Virginia","Fairfax County",3,75,6639,3112,3527
050,51,059,"Virginia","Fairfax County",3,76,6361,2977,3384
050,51,059,"Virginia","Fairfax County",3,77,6058,2782,3276
050,51,059,"Virginia","Fairfax County",3,78,5859,2644,3215
050,51,059,"Virginia","Fairfax County",3,79,4976,2248,2728
050,51,059,"Virginia","Fairfax County",3,80,4394,2003,2391
050,51,059,"Virginia","Fairfax County",3,81,3985,1800,2185
050,51,059,"Virginia","Fairfax County",3,82,3595,1609,1986
050,51,059,"Virginia","Fairfax County",3,83,3302,1430,1872
050,51,059,"Virginia","Fairfax County",3,84,2915,1295,1620
050,51,059,"Virginia","Fairfax County",3,85,17784,6849,10935
050,51,059,"Virginia","Fairfax County",4,0,12805,6584,6221
050,51,059,"Virginia","Fairfax County",4,1,12345,6272,6073
050,51,059,"Virginia","Fairfax County",4,2,13126,6685,6441
050,51,059,"Virginia","Fairfax County",4,3,13473,6869,6604
050,51,059,"Virginia","Fairfax County",4,4,13997,7204,6793
050,51,059,"Virginia","Fairfax County",4,5,14113,7225,6888
050,51,059,"Virginia","Fairfax County",4,6,14565,7441,7124
050,51,059,"Virginia","Fairfax County",4,7,14660,7594,7066
050,51,059,"Virginia","Fairfax County",4,8,14368,7387,6981
050,51,059,"Virginia","Fairfax County",4,9,14588,7464,7124
050,51,059,"Virginia","Fairfax County",4,10,14340,7345,6995
050,51,059,"Virginia","Fairfax County",4,11,14797,7627,7170
050,51,059,"Virginia","Fairfax County",4,12,14902,7642,7260
050,51,059,"Virginia","Fairfax County",4,13,15214,7879,7335
050,51,059,"Virginia","Fairfax County",4,14,15775,8131,7644
050,51,059,"Virginia","Fairfax County",4,15,15851,8325,7526
050,51,059,"Virginia","Fairfax County",4,16,15664,8168,7496
050,51,059,"Virginia","Fairfax County",4,17,15635,8104,7531
050,51,059,"Virginia","Fairfax County",4,18,14375,7530,6845
050,51,059,"Virginia","Fairfax County",4,19,12850,6650,6200
050,51,059,"Virginia","Fairfax County",4,20,12869,6531,6338
050,51,059,"Virginia","Fairfax County",4,21,13371,6669,6702
050,51,059,"Virginia","Fairfax County",4,22,13125,6537,6588
050,51,059,"Virginia","Fairfax County",4,23,13223,6676,6547
050,51,059,"Virginia","Fairfax County",4,24,14115,7223,6892
050,51,059,"Virginia","Fairfax County",4,25,14257,7229,7028
050,51,059,"Virginia","Fairfax County",4,26,14474,7339,7135
050,51,059,"Virginia","Fairfax County",4,27,14555,7448,7107
050,51,059,"Virginia","Fairfax County",4,28,14893,7619,7274
050,51,059,"Virginia","Fairfax County",4,29,14810,7586,7224
050,51,059,"Virginia","Fairfax County",4,30,14834,7618,7216
050,51,059,"Virginia","Fairfax County",4,31,14765,7624,7141
050,51,059,"Virginia","Fairfax County",4,32,15079,7738,7341
050,51,059,"Virginia","Fairfax County",4,33,15283,7755,7528
050,51,059,"Virginia","Fairfax County",4,34,15350,7749,7601
050,51,059,"Virginia","Fairfax County",4,35,15751,7905,7846
050,51,059,"Virginia","Fairfax County",4,36,16296,8278,8018
050,51,059,"Virginia","Fairfax County",4,37,16441,8248,8193
050,51,059,"Virginia","Fairfax County",4,38,16769,8437,8332
050,51,059,"Virginia","Fairfax County",4,39,17123,8632,8491
050,51,059,"Virginia","Fairfax County",4,40,17005,8496,8509
050,51,059,"Virginia","Fairfax County",4,41,16976,8414,8562
050,51,059,"Virginia","Fairfax County",4,42,17004,8469,8535
050,51,059,"Virginia","Fairfax County",4,43,16541,8179,8362
050,51,059,"Virginia","Fairfax County",4,44,15993,7868,8125
050,51,059,"Virginia","Fairfax County",4,45,15779,7716,8063
050,51,059,"Virginia","Fairfax County",4,46,15423,7532,7891
050,51,059,"Virginia","Fairfax County",4,47,15698,7838,7860
050,51,059,"Virginia","Fairfax County",4,48,15388,7668,7720
050,51,059,"Virginia","Fairfax County",4,49,15459,7695,7764
050,51,059,"Virginia","Fairfax County",4,50,16088,7984,8104
050,51,059,"Virginia","Fairfax County",4,51,16445,8315,8130
050,51,059,"Virginia","Fairfax County",4,52,16120,8042,8078
050,51,059,"Virginia","Fairfax County",4,53,15444,7673,7771
050,51,059,"Virginia","Fairfax County",4,54,15025,7495,7530
050,51,059,"Virginia","Fairfax County",4,55,14738,7286,7452
050,51,059,"Virginia","Fairfax County",4,56,14696,7361,7335
050,51,059,"Virginia","Fairfax County",4,57,14850,7381,7469
050,51,059,"Virginia","Fairfax County",4,58,14997,7474,7523
050,51,059,"Virginia","Fairfax County",4,59,14895,7507,7388
050,51,059,"Virginia","Fairfax County",4,60,14587,7357,7230
050,51,059,"Virginia","Fairfax County",4,61,14187,7145,7042
050,51,059,"Virginia","Fairfax County",4,62,13828,6875,6953
050,51,059,"Virginia","Fairfax County",4,63,13051,6452,6599
050,51,059,"Virginia","Fairfax County",4,64,12788,6386,6402
050,51,059,"Virginia","Fairfax County",4,65,12249,6054,6195
050,51,059,"Virginia","Fairfax County",4,66,11632,5667,5965
050,51,059,"Virginia","Fairfax County",4,67,11192,5408,5784
050,51,059,"Virginia","Fairfax County",4,68,10589,5105,5484
050,51,059,"Virginia","Fairfax County",4,69,9978,4789,5189
050,51,059,"Virginia","Fairfax County",4,70,9646,4573,5073
050,51,059,"Virginia","Fairfax County",4,71,9230,4372,4858
050,51,059,"Virginia","Fairfax County",4,72,8960,4186,4774
050,51,059,"Virginia","Fairfax County",4,73,8627,4025,4602
050,51,059,"Virginia","Fairfax County",4,74,8442,3955,4487
050,51,059,"Virginia","Fairfax County",4,75,8758,4094,4664
050,51,059,"Virginia","Fairfax County",4,76,6473,3015,3458
050,51,059,"Virginia","Fairfax County",4,77,6208,2885,3323
050,51,059,"Virginia","Fairfax County",4,78,5779,2631,3148
050,51,059,"Virginia","Fairfax County",4,79,5698,2565,3133
050,51,059,"Virginia","Fairfax County",4,80,4793,2143,2650
050,51,059,"Virginia","Fairfax County",4,81,4260,1886,2374
050,51,059,"Virginia","Fairfax County",4,82,3762,1693,2069
050,51,059,"Virginia","Fairfax County",4,83,3439,1526,1913
050,51,059,"Virginia","Fairfax County",4,84,3133,1344,1789
050,51,059,"Virginia","Fairfax County",4,85,18630,7251,11379
050,51,059,"Virginia","Fairfax County",5,0,12648,6521,6127
050,51,059,"Virginia","Fairfax County",5,1,12844,6554,6290
050,51,059,"Virginia","Fairfax County",5,2,12541,6375,6166
050,51,059,"Virginia","Fairfax County",5,3,13210,6774,6436
050,51,059,"Virginia","Fairfax County",5,4,13511,6935,6576
050,51,059,"Virginia","Fairfax County",5,5,13996,7240,6756
050,51,059,"Virginia","Fairfax County",5,6,14103,7188,6915
050,51,059,"Virginia","Fairfax County",5,7,14466,7346,7120
050,51,059,"Virginia","Fairfax County",5,8,14633,7579,7054
050,51,059,"Virginia","Fairfax County",5,9,14409,7395,7014
050,51,059,"Virginia","Fairfax County",5,10,14514,7426,7088
050,51,059,"Virginia","Fairfax County",5,11,14465,7379,7086
050,51,059,"Virginia","Fairfax County",5,12,14931,7686,7245
050,51,059,"Virginia","Fairfax County",5,13,14878,7658,7220
050,51,059,"Virginia","Fairfax County",5,14,15229,7920,7309
050,51,059,"Virginia","Fairfax County",5,15,15788,8165,7623
050,51,059,"Virginia","Fairfax County",5,16,15849,8327,7522
050,51,059,"Virginia","Fairfax County",5,17,15777,8232,7545
050,51,059,"Virginia","Fairfax County",5,18,14270,7505,6765
050,51,059,"Virginia","Fairfax County",5,19,13015,6775,6240
050,51,059,"Virginia","Fairfax County",5,20,13083,6680,6403
050,51,059,"Virginia","Fairfax County",5,21,13057,6572,6485
050,51,059,"Virginia","Fairfax County",5,22,13531,6746,6785
050,51,059,"Virginia","Fairfax County",5,23,13696,6908,6788
050,51,059,"Virginia","Fairfax County",5,24,13653,6930,6723
050,51,059,"Virginia","Fairfax County",5,25,14206,7250,6956
050,51,059,"Virginia","Fairfax County",5,26,14349,7240,7109
050,51,059,"Virginia","Fairfax County",5,27,14495,7396,7099
050,51,059,"Virginia","Fairfax County",5,28,14626,7446,7180
050,51,059,"Virginia","Fairfax County",5,29,15039,7649,7390
050,51,059,"Virginia","Fairfax County",5,30,14869,7534,7335
050,51,059,"Virginia","Fairfax County",5,31,14992,7722,7270
050,51,059,"Virginia","Fairfax County",5,32,15104,7779,7325
050,51,059,"Virginia","Fairfax County",5,33,15277,7822,7455
050,51,059,"Virginia","Fairfax County",5,34,15530,7852,7678
050,51,059,"Virginia","Fairfax County",5,35,15528,7781,7747
050,51,059,"Virginia","Fairfax County",5,36,15909,8017,7892
050,51,059,"Virginia","Fairfax County",5,37,16419,8354,8065
050,51,059,"Virginia","Fairfax County",5,38,16466,8222,8244
050,51,059,"Virginia","Fairfax County",5,39,16824,8491,8333
050,51,059,"Virginia","Fairfax County",5,40,17195,8679,8516
050,51,059,"Virginia","Fairfax County",5,41,17103,8534,8569
050,51,059,"Virginia","Fairfax County",5,42,16941,8370,8571
050,51,059,"Virginia","Fairfax County",5,43,17071,8498,8573
050,51,059,"Virginia","Fairfax County",5,44,16523,8216,8307
050,51,059,"Virginia","Fairfax County",5,45,15983,7826,8157
050,51,059,"Virginia","Fairfax County",5,46,15682,7650,8032
050,51,059,"Virginia","Fairfax County",5,47,15276,7458,7818
050,51,059,"Virginia","Fairfax County",5,48,15564,7753,7811
050,51,059,"Virginia","Fairfax County",5,49,15319,7632,7687
050,51,059,"Virginia","Fairfax County",5,50,15246,7629,7617
050,51,059,"Virginia","Fairfax County",5,51,15834,7876,7958
050,51,059,"Virginia","Fairfax County",5,52,16163,8181,7982
050,51,059,"Virginia","Fairfax County",5,53,15867,7877,7990
050,51,059,"Virginia","Fairfax County",5,54,15299,7609,7690
050,51,059,"Virginia","Fairfax County",5,55,14727,7352,7375
050,51,059,"Virginia","Fairfax County",5,56,14495,7183,7312
050,51,059,"Virginia","Fairfax County",5,57,14280,7146,7134
050,51,059,"Virginia","Fairfax County",5,58,14502,7221,7281
050,51,059,"Virginia","Fairfax County",5,59,14661,7306,7355
050,51,059,"Virginia","Fairfax County",5,60,14532,7337,7195
050,51,059,"Virginia","Fairfax County",5,61,14178,7150,7028
050,51,059,"Virginia","Fairfax County",5,62,13721,6925,6796
050,51,059,"Virginia","Fairfax County",5,63,13393,6654,6739
050,51,059,"Virginia","Fairfax County",5,64,12738,6298,6440
050,51,059,"Virginia","Fairfax County",5,65,12377,6175,6202
050,51,059,"Virginia","Fairfax County",5,66,11889,5871,6018
050,51,059,"Virginia","Fairfax County",5,67,11253,5507,5746
050,51,059,"Virginia","Fairfax County",5,68,10992,5268,5724
050,51,059,"Virginia","Fairfax County",5,69,10275,4914,5361
050,51,059,"Virginia","Fairfax County",5,70,9739,4656,5083
050,51,059,"Virginia","Fairfax County",5,71,9407,4428,4979
050,51,059,"Virginia","Fairfax County",5,72,9013,4233,4780
050,51,059,"Virginia","Fairfax County",5,73,8749,4054,4695
050,51,059,"Virginia","Fairfax County",5,74,8470,3933,4537
050,51,059,"Virginia","Fairfax County",5,75,8217,3858,4359
050,51,059,"Virginia","Fairfax County",5,76,8558,4000,4558
050,51,059,"Virginia","Fairfax County",5,77,6327,2913,3414
050,51,059,"Virginia","Fairfax County",5,78,6009,2783,3226
050,51,059,"Virginia","Fairfax County",5,79,5642,2547,3095
050,51,059,"Virginia","Fairfax County",5,80,5546,2475,3071
050,51,059,"Virginia","Fairfax County",5,81,4708,2066,2642
050,51,059,"Virginia","Fairfax County",5,82,4057,1777,2280
050,51,059,"Virginia","Fairfax County",5,83,3584,1604,1980
050,51,059,"Virginia","Fairfax County",5,84,3286,1447,1839
050,51,059,"Virginia","Fairfax County",5,85,19757,7769,11988
050,51,061,"Virginia","Fauquier County",1,0,774,397,377
050,51,061,"Virginia","Fauquier County",1,1,810,405,405
050,51,061,"Virginia","Fauquier County",1,2,814,419,395
050,51,061,"Virginia","Fauquier County",1,3,864,424,440
050,51,061,"Virginia","Fauquier County",1,4,928,482,446
050,51,061,"Virginia","Fauquier County",1,5,924,459,465
050,51,061,"Virginia","Fauquier County",1,6,928,467,461
050,51,061,"Virginia","Fauquier County",1,7,914,464,450
050,51,061,"Virginia","Fauquier County",1,8,968,503,465
050,51,061,"Virginia","Fauquier County",1,9,959,501,458
050,51,061,"Virginia","Fauquier County",1,10,978,504,474
050,51,061,"Virginia","Fauquier County",1,11,993,516,477
050,51,061,"Virginia","Fauquier County",1,12,1013,550,463
050,51,061,"Virginia","Fauquier County",1,13,1011,529,482
050,51,061,"Virginia","Fauquier County",1,14,1062,551,511
050,51,061,"Virginia","Fauquier County",1,15,1055,532,523
050,51,061,"Virginia","Fauquier County",1,16,1104,548,556
050,51,061,"Virginia","Fauquier County",1,17,1068,537,531
050,51,061,"Virginia","Fauquier County",1,18,949,492,457
050,51,061,"Virginia","Fauquier County",1,19,786,420,366
050,51,061,"Virginia","Fauquier County",1,20,787,409,378
050,51,061,"Virginia","Fauquier County",1,21,786,429,357
050,51,061,"Virginia","Fauquier County",1,22,819,416,403
050,51,061,"Virginia","Fauquier County",1,23,724,357,367
050,51,061,"Virginia","Fauquier County",1,24,726,370,356
050,51,061,"Virginia","Fauquier County",1,25,722,349,373
050,51,061,"Virginia","Fauquier County",1,26,715,339,376
050,51,061,"Virginia","Fauquier County",1,27,759,358,401
050,51,061,"Virginia","Fauquier County",1,28,798,413,385
050,51,061,"Virginia","Fauquier County",1,29,787,434,353
050,51,061,"Virginia","Fauquier County",1,30,804,387,417
050,51,061,"Virginia","Fauquier County",1,31,801,384,417
050,51,061,"Virginia","Fauquier County",1,32,870,425,445
050,51,061,"Virginia","Fauquier County",1,33,876,426,450
050,51,061,"Virginia","Fauquier County",1,34,879,458,421
050,51,061,"Virginia","Fauquier County",1,35,879,450,429
050,51,061,"Virginia","Fauquier County",1,36,840,416,424
050,51,061,"Virginia","Fauquier County",1,37,962,466,496
050,51,061,"Virginia","Fauquier County",1,38,957,457,500
050,51,061,"Virginia","Fauquier County",1,39,902,435,467
050,51,061,"Virginia","Fauquier County",1,40,907,446,461
050,51,061,"Virginia","Fauquier County",1,41,867,447,420
050,51,061,"Virginia","Fauquier County",1,42,905,467,438
050,51,061,"Virginia","Fauquier County",1,43,854,423,431
050,51,061,"Virginia","Fauquier County",1,44,848,423,425
050,51,061,"Virginia","Fauquier County",1,45,891,454,437
050,51,061,"Virginia","Fauquier County",1,46,850,431,419
050,51,061,"Virginia","Fauquier County",1,47,939,478,461
050,51,061,"Virginia","Fauquier County",1,48,1031,509,522
050,51,061,"Virginia","Fauquier County",1,49,1081,518,563
050,51,061,"Virginia","Fauquier County",1,50,1093,538,555
050,51,061,"Virginia","Fauquier County",1,51,1057,517,540
050,51,061,"Virginia","Fauquier County",1,52,1057,519,538
050,51,061,"Virginia","Fauquier County",1,53,1076,523,553
050,51,061,"Virginia","Fauquier County",1,54,1062,531,531
050,51,061,"Virginia","Fauquier County",1,55,1210,594,616
050,51,061,"Virginia","Fauquier County",1,56,1244,619,625
050,51,061,"Virginia","Fauquier County",1,57,1227,620,607
050,51,061,"Virginia","Fauquier County",1,58,1221,611,610
050,51,061,"Virginia","Fauquier County",1,59,1093,550,543
050,51,061,"Virginia","Fauquier County",1,60,1103,549,554
050,51,061,"Virginia","Fauquier County",1,61,1062,536,526
050,51,061,"Virginia","Fauquier County",1,62,1035,526,509
050,51,061,"Virginia","Fauquier County",1,63,993,520,473
050,51,061,"Virginia","Fauquier County",1,64,911,444,467
050,51,061,"Virginia","Fauquier County",1,65,891,455,436
050,51,061,"Virginia","Fauquier County",1,66,822,394,428
050,51,061,"Virginia","Fauquier County",1,67,788,392,396
050,51,061,"Virginia","Fauquier County",1,68,783,397,386
050,51,061,"Virginia","Fauquier County",1,69,727,356,371
050,51,061,"Virginia","Fauquier County",1,70,666,329,337
050,51,061,"Virginia","Fauquier County",1,71,680,310,370
050,51,061,"Virginia","Fauquier County",1,72,692,329,363
050,51,061,"Virginia","Fauquier County",1,73,671,329,342
050,51,061,"Virginia","Fauquier County",1,74,485,231,254
050,51,061,"Virginia","Fauquier County",1,75,504,251,253
050,51,061,"Virginia","Fauquier County",1,76,496,221,275
050,51,061,"Virginia","Fauquier County",1,77,486,222,264
050,51,061,"Virginia","Fauquier County",1,78,422,185,237
050,51,061,"Virginia","Fauquier County",1,79,378,167,211
050,51,061,"Virginia","Fauquier County",1,80,349,167,182
050,51,061,"Virginia","Fauquier County",1,81,296,138,158
050,51,061,"Virginia","Fauquier County",1,82,270,124,146
050,51,061,"Virginia","Fauquier County",1,83,266,114,152
050,51,061,"Virginia","Fauquier County",1,84,223,104,119
050,51,061,"Virginia","Fauquier County",1,85,1157,434,723
050,51,061,"Virginia","Fauquier County",2,0,782,410,372
050,51,061,"Virginia","Fauquier County",2,1,801,402,399
050,51,061,"Virginia","Fauquier County",2,2,812,417,395
050,51,061,"Virginia","Fauquier County",2,3,854,425,429
050,51,061,"Virginia","Fauquier County",2,4,918,470,448
050,51,061,"Virginia","Fauquier County",2,5,931,466,465
050,51,061,"Virginia","Fauquier County",2,6,928,468,460
050,51,061,"Virginia","Fauquier County",2,7,914,465,449
050,51,061,"Virginia","Fauquier County",2,8,953,494,459
050,51,061,"Virginia","Fauquier County",2,9,963,504,459
050,51,061,"Virginia","Fauquier County",2,10,978,506,472
050,51,061,"Virginia","Fauquier County",2,11,990,513,477
050,51,061,"Virginia","Fauquier County",2,12,1009,544,465
050,51,061,"Virginia","Fauquier County",2,13,1016,536,480
050,51,061,"Virginia","Fauquier County",2,14,1055,547,508
050,51,061,"Virginia","Fauquier County",2,15,1061,538,523
050,51,061,"Virginia","Fauquier County",2,16,1097,550,547
050,51,061,"Virginia","Fauquier County",2,17,1078,542,536
050,51,061,"Virginia","Fauquier County",2,18,933,482,451
050,51,061,"Virginia","Fauquier County",2,19,789,418,371
050,51,061,"Virginia","Fauquier County",2,20,802,421,381
050,51,061,"Virginia","Fauquier County",2,21,787,424,363
050,51,061,"Virginia","Fauquier County",2,22,800,410,390
050,51,061,"Virginia","Fauquier County",2,23,743,368,375
050,51,061,"Virginia","Fauquier County",2,24,716,363,353
050,51,061,"Virginia","Fauquier County",2,25,713,348,365
050,51,061,"Virginia","Fauquier County",2,26,716,336,380
050,51,061,"Virginia","Fauquier County",2,27,753,357,396
050,51,061,"Virginia","Fauquier County",2,28,793,403,390
050,51,061,"Virginia","Fauquier County",2,29,797,429,368
050,51,061,"Virginia","Fauquier County",2,30,811,404,407
050,51,061,"Virginia","Fauquier County",2,31,803,387,416
050,51,061,"Virginia","Fauquier County",2,32,852,416,436
050,51,061,"Virginia","Fauquier County",2,33,873,424,449
050,51,061,"Virginia","Fauquier County",2,34,881,453,428
050,51,061,"Virginia","Fauquier County",2,35,887,456,431
050,51,061,"Virginia","Fauquier County",2,36,856,430,426
050,51,061,"Virginia","Fauquier County",2,37,944,459,485
050,51,061,"Virginia","Fauquier County",2,38,959,456,503
050,51,061,"Virginia","Fauquier County",2,39,917,438,479
050,51,061,"Virginia","Fauquier County",2,40,922,451,471
050,51,061,"Virginia","Fauquier County",2,41,883,452,431
050,51,061,"Virginia","Fauquier County",2,42,895,463,432
050,51,061,"Virginia","Fauquier County",2,43,877,441,436
050,51,061,"Virginia","Fauquier County",2,44,846,422,424
050,51,061,"Virginia","Fauquier County",2,45,886,453,433
050,51,061,"Virginia","Fauquier County",2,46,855,436,419
050,51,061,"Virginia","Fauquier County",2,47,919,467,452
050,51,061,"Virginia","Fauquier County",2,48,1010,503,507
050,51,061,"Virginia","Fauquier County",2,49,1077,520,557
050,51,061,"Virginia","Fauquier County",2,50,1087,530,557
050,51,061,"Virginia","Fauquier County",2,51,1059,517,542
050,51,061,"Virginia","Fauquier County",2,52,1056,518,538
050,51,061,"Virginia","Fauquier County",2,53,1071,523,548
050,51,061,"Virginia","Fauquier County",2,54,1064,527,537
050,51,061,"Virginia","Fauquier County",2,55,1177,581,596
050,51,061,"Virginia","Fauquier County",2,56,1241,615,626
050,51,061,"Virginia","Fauquier County",2,57,1231,622,609
050,51,061,"Virginia","Fauquier County",2,58,1217,610,607
050,51,061,"Virginia","Fauquier County",2,59,1130,569,561
050,51,061,"Virginia","Fauquier County",2,60,1094,548,546
050,51,061,"Virginia","Fauquier County",2,61,1064,535,529
050,51,061,"Virginia","Fauquier County",2,62,1036,526,510
050,51,061,"Virginia","Fauquier County",2,63,997,517,480
050,51,061,"Virginia","Fauquier County",2,64,921,456,465
050,51,061,"Virginia","Fauquier County",2,65,892,450,442
050,51,061,"Virginia","Fauquier County",2,66,836,406,430
050,51,061,"Virginia","Fauquier County",2,67,786,386,400
050,51,061,"Virginia","Fauquier County",2,68,773,389,384
050,51,061,"Virginia","Fauquier County",2,69,737,367,370
050,51,061,"Virginia","Fauquier County",2,70,675,333,342
050,51,061,"Virginia","Fauquier County",2,71,675,312,363
050,51,061,"Virginia","Fauquier County",2,72,674,316,358
050,51,061,"Virginia","Fauquier County",2,73,706,345,361
050,51,061,"Virginia","Fauquier County",2,74,494,235,259
050,51,061,"Virginia","Fauquier County",2,75,495,244,251
050,51,061,"Virginia","Fauquier County",2,76,490,224,266
050,51,061,"Virginia","Fauquier County",2,77,498,226,272
050,51,061,"Virginia","Fauquier County",2,78,430,190,240
050,51,061,"Virginia","Fauquier County",2,79,383,166,217
050,51,061,"Virginia","Fauquier County",2,80,349,163,186
050,51,061,"Virginia","Fauquier County",2,81,303,142,161
050,51,061,"Virginia","Fauquier County",2,82,275,128,147
050,51,061,"Virginia","Fauquier County",2,83,261,114,147
050,51,061,"Virginia","Fauquier County",2,84,232,106,126
050,51,061,"Virginia","Fauquier County",2,85,1162,438,724
050,51,061,"Virginia","Fauquier County",3,0,701,335,366
050,51,061,"Virginia","Fauquier County",3,1,879,451,428
050,51,061,"Virginia","Fauquier County",3,2,833,422,411
050,51,061,"Virginia","Fauquier County",3,3,845,445,400
050,51,061,"Virginia","Fauquier County",3,4,866,459,407
050,51,061,"Virginia","Fauquier County",3,5,958,485,473
050,51,061,"Virginia","Fauquier County",3,6,982,487,495
050,51,061,"Virginia","Fauquier County",3,7,957,472,485
050,51,061,"Virginia","Fauquier County",3,8,935,484,451
050,51,061,"Virginia","Fauquier County",3,9,1015,528,487
050,51,061,"Virginia","Fauquier County",3,10,975,503,472
050,51,061,"Virginia","Fauquier County",3,11,1004,531,473
050,51,061,"Virginia","Fauquier County",3,12,1016,519,497
050,51,061,"Virginia","Fauquier County",3,13,1023,551,472
050,51,061,"Virginia","Fauquier County",3,14,1014,541,473
050,51,061,"Virginia","Fauquier County",3,15,1045,540,505
050,51,061,"Virginia","Fauquier County",3,16,1073,534,539
050,51,061,"Virginia","Fauquier County",3,17,1108,553,555
050,51,061,"Virginia","Fauquier County",3,18,923,475,448
050,51,061,"Virginia","Fauquier County",3,19,783,411,372
050,51,061,"Virginia","Fauquier County",3,20,844,443,401
050,51,061,"Virginia","Fauquier County",3,21,854,462,392
050,51,061,"Virginia","Fauquier County",3,22,815,429,386
050,51,061,"Virginia","Fauquier County",3,23,806,417,389
050,51,061,"Virginia","Fauquier County",3,24,695,341,354
050,51,061,"Virginia","Fauquier County",3,25,735,380,355
050,51,061,"Virginia","Fauquier County",3,26,728,362,366
050,51,061,"Virginia","Fauquier County",3,27,721,328,393
050,51,061,"Virginia","Fauquier County",3,28,749,360,389
050,51,061,"Virginia","Fauquier County",3,29,831,427,404
050,51,061,"Virginia","Fauquier County",3,30,835,450,385
050,51,061,"Virginia","Fauquier County",3,31,868,425,443
050,51,061,"Virginia","Fauquier County",3,32,845,417,428
050,51,061,"Virginia","Fauquier County",3,33,937,452,485
050,51,061,"Virginia","Fauquier County",3,34,923,443,480
050,51,061,"Virginia","Fauquier County",3,35,890,450,440
050,51,061,"Virginia","Fauquier County",3,36,943,481,462
050,51,061,"Virginia","Fauquier County",3,37,898,445,453
050,51,061,"Virginia","Fauquier County",3,38,981,501,480
050,51,061,"Virginia","Fauquier County",3,39,989,482,507
050,51,061,"Virginia","Fauquier County",3,40,970,464,506
050,51,061,"Virginia","Fauquier County",3,41,942,470,472
050,51,061,"Virginia","Fauquier County",3,42,901,467,434
050,51,061,"Virginia","Fauquier County",3,43,925,487,438
050,51,061,"Virginia","Fauquier County",3,44,893,447,446
050,51,061,"Virginia","Fauquier County",3,45,880,449,431
050,51,061,"Virginia","Fauquier County",3,46,893,449,444
050,51,061,"Virginia","Fauquier County",3,47,869,453,416
050,51,061,"Virginia","Fauquier County",3,48,920,457,463
050,51,061,"Virginia","Fauquier County",3,49,1022,517,505
050,51,061,"Virginia","Fauquier County",3,50,1091,526,565
050,51,061,"Virginia","Fauquier County",3,51,1070,520,550
050,51,061,"Virginia","Fauquier County",3,52,1087,534,553
050,51,061,"Virginia","Fauquier County",3,53,1056,516,540
050,51,061,"Virginia","Fauquier County",3,54,1067,513,554
050,51,061,"Virginia","Fauquier County",3,55,1064,535,529
050,51,061,"Virginia","Fauquier County",3,56,1161,563,598
050,51,061,"Virginia","Fauquier County",3,57,1234,613,621
050,51,061,"Virginia","Fauquier County",3,58,1209,612,597
050,51,061,"Virginia","Fauquier County",3,59,1212,602,610
050,51,061,"Virginia","Fauquier County",3,60,1122,569,553
050,51,061,"Virginia","Fauquier County",3,61,1081,533,548
050,51,061,"Virginia","Fauquier County",3,62,1011,507,504
050,51,061,"Virginia","Fauquier County",3,63,998,512,486
050,51,061,"Virginia","Fauquier County",3,64,982,517,465
050,51,061,"Virginia","Fauquier County",3,65,896,443,453
050,51,061,"Virginia","Fauquier County",3,66,885,445,440
050,51,061,"Virginia","Fauquier County",3,67,813,386,427
050,51,061,"Virginia","Fauquier County",3,68,769,386,383
050,51,061,"Virginia","Fauquier County",3,69,748,372,376
050,51,061,"Virginia","Fauquier County",3,70,724,357,367
050,51,061,"Virginia","Fauquier County",3,71,668,320,348
050,51,061,"Virginia","Fauquier County",3,72,653,301,352
050,51,061,"Virginia","Fauquier County",3,73,664,308,356
050,51,061,"Virginia","Fauquier County",3,74,696,339,357
050,51,061,"Virginia","Fauquier County",3,75,488,233,255
050,51,061,"Virginia","Fauquier County",3,76,479,236,243
050,51,061,"Virginia","Fauquier County",3,77,474,207,267
050,51,061,"Virginia","Fauquier County",3,78,480,215,265
050,51,061,"Virginia","Fauquier County",3,79,421,180,241
050,51,061,"Virginia","Fauquier County",3,80,364,160,204
050,51,061,"Virginia","Fauquier County",3,81,325,147,178
050,51,061,"Virginia","Fauquier County",3,82,295,139,156
050,51,061,"Virginia","Fauquier County",3,83,269,119,150
050,51,061,"Virginia","Fauquier County",3,84,237,107,130
050,51,061,"Virginia","Fauquier County",3,85,1225,471,754
050,51,061,"Virginia","Fauquier County",4,0,750,386,364
050,51,061,"Virginia","Fauquier County",4,1,771,356,415
050,51,061,"Virginia","Fauquier County",4,2,911,481,430
050,51,061,"Virginia","Fauquier County",4,3,923,464,459
050,51,061,"Virginia","Fauquier County",4,4,916,469,447
050,51,061,"Virginia","Fauquier County",4,5,913,481,432
050,51,061,"Virginia","Fauquier County",4,6,960,486,474
050,51,061,"Virginia","Fauquier County",4,7,1004,503,501
050,51,061,"Virginia","Fauquier County",4,8,995,499,496
050,51,061,"Virginia","Fauquier County",4,9,948,484,464
050,51,061,"Virginia","Fauquier County",4,10,1023,530,493
050,51,061,"Virginia","Fauquier County",4,11,991,499,492
050,51,061,"Virginia","Fauquier County",4,12,1021,536,485
050,51,061,"Virginia","Fauquier County",4,13,1032,532,500
050,51,061,"Virginia","Fauquier County",4,14,1051,553,498
050,51,061,"Virginia","Fauquier County",4,15,1047,564,483
050,51,061,"Virginia","Fauquier County",4,16,1063,546,517
050,51,061,"Virginia","Fauquier County",4,17,1080,544,536
050,51,061,"Virginia","Fauquier County",4,18,940,501,439
050,51,061,"Virginia","Fauquier County",4,19,713,364,349
050,51,061,"Virginia","Fauquier County",4,20,815,430,385
050,51,061,"Virginia","Fauquier County",4,21,857,461,396
050,51,061,"Virginia","Fauquier County",4,22,875,457,418
050,51,061,"Virginia","Fauquier County",4,23,819,439,380
050,51,061,"Virginia","Fauquier County",4,24,772,399,373
050,51,061,"Virginia","Fauquier County",4,25,688,353,335
050,51,061,"Virginia","Fauquier County",4,26,740,380,360
050,51,061,"Virginia","Fauquier County",4,27,718,364,354
050,51,061,"Virginia","Fauquier County",4,28,708,324,384
050,51,061,"Virginia","Fauquier County",4,29,757,354,403
050,51,061,"Virginia","Fauquier County",4,30,815,420,395
050,51,061,"Virginia","Fauquier County",4,31,862,463,399
050,51,061,"Virginia","Fauquier County",4,32,904,455,449
050,51,061,"Virginia","Fauquier County",4,33,869,427,442
050,51,061,"Virginia","Fauquier County",4,34,993,478,515
050,51,061,"Virginia","Fauquier County",4,35,954,462,492
050,51,061,"Virginia","Fauquier County",4,36,953,495,458
050,51,061,"Virginia","Fauquier County",4,37,961,485,476
050,51,061,"Virginia","Fauquier County",4,38,932,478,454
050,51,061,"Virginia","Fauquier County",4,39,1040,523,517
050,51,061,"Virginia","Fauquier County",4,40,1041,514,527
050,51,061,"Virginia","Fauquier County",4,41,1013,491,522
050,51,061,"Virginia","Fauquier County",4,42,951,475,476
050,51,061,"Virginia","Fauquier County",4,43,923,476,447
050,51,061,"Virginia","Fauquier County",4,44,958,508,450
050,51,061,"Virginia","Fauquier County",4,45,911,474,437
050,51,061,"Virginia","Fauquier County",4,46,890,453,437
050,51,061,"Virginia","Fauquier County",4,47,896,456,440
050,51,061,"Virginia","Fauquier County",4,48,886,462,424
050,51,061,"Virginia","Fauquier County",4,49,932,450,482
050,51,061,"Virginia","Fauquier County",4,50,1005,508,497
050,51,061,"Virginia","Fauquier County",4,51,1068,514,554
050,51,061,"Virginia","Fauquier County",4,52,1059,529,530
050,51,061,"Virginia","Fauquier County",4,53,1088,535,553
050,51,061,"Virginia","Fauquier County",4,54,1035,499,536
050,51,061,"Virginia","Fauquier County",4,55,1073,520,553
050,51,061,"Virginia","Fauquier County",4,56,1033,529,504
050,51,061,"Virginia","Fauquier County",4,57,1108,531,577
050,51,061,"Virginia","Fauquier County",4,58,1206,596,610
050,51,061,"Virginia","Fauquier County",4,59,1192,612,580
050,51,061,"Virginia","Fauquier County",4,60,1187,588,599
050,51,061,"Virginia","Fauquier County",4,61,1103,558,545
050,51,061,"Virginia","Fauquier County",4,62,1055,515,540
050,51,061,"Virginia","Fauquier County",4,63,996,504,492
050,51,061,"Virginia","Fauquier County",4,64,983,510,473
050,51,061,"Virginia","Fauquier County",4,65,965,506,459
050,51,061,"Virginia","Fauquier County",4,66,887,447,440
050,51,061,"Virginia","Fauquier County",4,67,860,430,430
050,51,061,"Virginia","Fauquier County",4,68,781,360,421
050,51,061,"Virginia","Fauquier County",4,69,757,377,380
050,51,061,"Virginia","Fauquier County",4,70,738,367,371
050,51,061,"Virginia","Fauquier County",4,71,702,339,363
050,51,061,"Virginia","Fauquier County",4,72,640,305,335
050,51,061,"Virginia","Fauquier County",4,73,647,286,361
050,51,061,"Virginia","Fauquier County",4,74,651,304,347
050,51,061,"Virginia","Fauquier County",4,75,693,333,360
050,51,061,"Virginia","Fauquier County",4,76,469,222,247
050,51,061,"Virginia","Fauquier County",4,77,455,223,232
050,51,061,"Virginia","Fauquier County",4,78,460,202,258
050,51,061,"Virginia","Fauquier County",4,79,470,203,267
050,51,061,"Virginia","Fauquier County",4,80,396,176,220
050,51,061,"Virginia","Fauquier County",4,81,341,145,196
050,51,061,"Virginia","Fauquier County",4,82,314,143,171
050,51,061,"Virginia","Fauquier County",4,83,268,118,150
050,51,061,"Virginia","Fauquier County",4,84,243,113,130
050,51,061,"Virginia","Fauquier County",4,85,1264,507,757
050,51,061,"Virginia","Fauquier County",5,0,745,384,361
050,51,061,"Virginia","Fauquier County",5,1,799,425,374
050,51,061,"Virginia","Fauquier County",5,2,783,377,406
050,51,061,"Virginia","Fauquier County",5,3,949,500,449
050,51,061,"Virginia","Fauquier County",5,4,937,472,465
050,51,061,"Virginia","Fauquier County",5,5,956,487,469
050,51,061,"Virginia","Fauquier County",5,6,931,490,441
050,51,061,"Virginia","Fauquier County",5,7,990,485,505
050,51,061,"Virginia","Fauquier County",5,8,1015,515,500
050,51,061,"Virginia","Fauquier County",5,9,1024,504,520
050,51,061,"Virginia","Fauquier County",5,10,959,487,472
050,51,061,"Virginia","Fauquier County",5,11,1060,536,524
050,51,061,"Virginia","Fauquier County",5,12,1004,520,484
050,51,061,"Virginia","Fauquier County",5,13,1021,536,485
050,51,061,"Virginia","Fauquier County",5,14,1055,532,523
050,51,061,"Virginia","Fauquier County",5,15,1065,560,505
050,51,061,"Virginia","Fauquier County",5,16,1054,576,478
050,51,061,"Virginia","Fauquier County",5,17,1069,561,508
050,51,061,"Virginia","Fauquier County",5,18,924,481,443
050,51,061,"Virginia","Fauquier County",5,19,781,408,373
050,51,061,"Virginia","Fauquier County",5,20,775,389,386
050,51,061,"Virginia","Fauquier County",5,21,834,433,401
050,51,061,"Virginia","Fauquier County",5,22,899,463,436
050,51,061,"Virginia","Fauquier County",5,23,855,433,422
050,51,061,"Virginia","Fauquier County",5,24,785,427,358
050,51,061,"Virginia","Fauquier County",5,25,757,397,360
050,51,061,"Virginia","Fauquier County",5,26,684,350,334
050,51,061,"Virginia","Fauquier County",5,27,708,376,332
050,51,061,"Virginia","Fauquier County",5,28,730,366,364
050,51,061,"Virginia","Fauquier County",5,29,718,323,395
050,51,061,"Virginia","Fauquier County",5,30,779,368,411
050,51,061,"Virginia","Fauquier County",5,31,857,432,425
050,51,061,"Virginia","Fauquier County",5,32,877,464,413
050,51,061,"Virginia","Fauquier County",5,33,921,446,475
050,51,061,"Virginia","Fauquier County",5,34,895,438,457
050,51,061,"Virginia","Fauquier County",5,35,997,489,508
050,51,061,"Virginia","Fauquier County",5,36,963,470,493
050,51,061,"Virginia","Fauquier County",5,37,989,515,474
050,51,061,"Virginia","Fauquier County",5,38,978,493,485
050,51,061,"Virginia","Fauquier County",5,39,975,499,476
050,51,061,"Virginia","Fauquier County",5,40,1092,542,550
050,51,061,"Virginia","Fauquier County",5,41,1068,527,541
050,51,061,"Virginia","Fauquier County",5,42,1024,496,528
050,51,061,"Virginia","Fauquier County",5,43,968,484,484
050,51,061,"Virginia","Fauquier County",5,44,910,458,452
050,51,061,"Virginia","Fauquier County",5,45,968,517,451
050,51,061,"Virginia","Fauquier County",5,46,909,476,433
050,51,061,"Virginia","Fauquier County",5,47,907,456,451
050,51,061,"Virginia","Fauquier County",5,48,915,463,452
050,51,061,"Virginia","Fauquier County",5,49,894,471,423
050,51,061,"Virginia","Fauquier County",5,50,944,462,482
050,51,061,"Virginia","Fauquier County",5,51,1005,509,496
050,51,061,"Virginia","Fauquier County",5,52,1069,511,558
050,51,061,"Virginia","Fauquier County",5,53,1052,521,531
050,51,061,"Virginia","Fauquier County",5,54,1086,532,554
050,51,061,"Virginia","Fauquier County",5,55,1035,508,527
050,51,061,"Virginia","Fauquier County",5,56,1060,519,541
050,51,061,"Virginia","Fauquier County",5,57,1029,526,503
050,51,061,"Virginia","Fauquier County",5,58,1117,543,574
050,51,061,"Virginia","Fauquier County",5,59,1162,564,598
050,51,061,"Virginia","Fauquier County",5,60,1157,598,559
050,51,061,"Virginia","Fauquier County",5,61,1170,573,597
050,51,061,"Virginia","Fauquier County",5,62,1095,543,552
050,51,061,"Virginia","Fauquier County",5,63,1034,500,534
050,51,061,"Virginia","Fauquier County",5,64,958,485,473
050,51,061,"Virginia","Fauquier County",5,65,985,506,479
050,51,061,"Virginia","Fauquier County",5,66,943,494,449
050,51,061,"Virginia","Fauquier County",5,67,867,432,435
050,51,061,"Virginia","Fauquier County",5,68,851,421,430
050,51,061,"Virginia","Fauquier County",5,69,766,353,413
050,51,061,"Virginia","Fauquier County",5,70,742,362,380
050,51,061,"Virginia","Fauquier County",5,71,717,356,361
050,51,061,"Virginia","Fauquier County",5,72,686,329,357
050,51,061,"Virginia","Fauquier County",5,73,634,296,338
050,51,061,"Virginia","Fauquier County",5,74,633,280,353
050,51,061,"Virginia","Fauquier County",5,75,632,294,338
050,51,061,"Virginia","Fauquier County",5,76,670,323,347
050,51,061,"Virginia","Fauquier County",5,77,450,213,237
050,51,061,"Virginia","Fauquier County",5,78,445,217,228
050,51,061,"Virginia","Fauquier County",5,79,438,188,250
050,51,061,"Virginia","Fauquier County",5,80,456,196,260
050,51,061,"Virginia","Fauquier County",5,81,359,157,202
050,51,061,"Virginia","Fauquier County",5,82,313,133,180
050,51,061,"Virginia","Fauquier County",5,83,290,126,164
050,51,061,"Virginia","Fauquier County",5,84,244,114,130
050,51,061,"Virginia","Fauquier County",5,85,1319,554,765
050,51,063,"Virginia","Floyd County",1,0,137,69,68
050,51,063,"Virginia","Floyd County",1,1,155,76,79
050,51,063,"Virginia","Floyd County",1,2,145,75,70
050,51,063,"Virginia","Floyd County",1,3,149,68,81
050,51,063,"Virginia","Floyd County",1,4,147,73,74
050,51,063,"Virginia","Floyd County",1,5,154,85,69
050,51,063,"Virginia","Floyd County",1,6,167,87,80
050,51,063,"Virginia","Floyd County",1,7,147,86,61
050,51,063,"Virginia","Floyd County",1,8,157,84,73
050,51,063,"Virginia","Floyd County",1,9,167,84,83
050,51,063,"Virginia","Floyd County",1,10,178,90,88
050,51,063,"Virginia","Floyd County",1,11,170,84,86
050,51,063,"Virginia","Floyd County",1,12,192,97,95
050,51,063,"Virginia","Floyd County",1,13,178,90,88
050,51,063,"Virginia","Floyd County",1,14,191,101,90
050,51,063,"Virginia","Floyd County",1,15,196,102,94
050,51,063,"Virginia","Floyd County",1,16,209,108,101
050,51,063,"Virginia","Floyd County",1,17,181,87,94
050,51,063,"Virginia","Floyd County",1,18,150,82,68
050,51,063,"Virginia","Floyd County",1,19,127,68,59
050,51,063,"Virginia","Floyd County",1,20,138,70,68
050,51,063,"Virginia","Floyd County",1,21,141,73,68
050,51,063,"Virginia","Floyd County",1,22,135,71,64
050,51,063,"Virginia","Floyd County",1,23,138,68,70
050,51,063,"Virginia","Floyd County",1,24,152,83,69
050,51,063,"Virginia","Floyd County",1,25,154,85,69
050,51,063,"Virginia","Floyd County",1,26,150,69,81
050,51,063,"Virginia","Floyd County",1,27,155,77,78
050,51,063,"Virginia","Floyd County",1,28,139,69,70
050,51,063,"Virginia","Floyd County",1,29,141,74,67
050,51,063,"Virginia","Floyd County",1,30,165,76,89
050,51,063,"Virginia","Floyd County",1,31,161,79,82
050,51,063,"Virginia","Floyd County",1,32,147,77,70
050,51,063,"Virginia","Floyd County",1,33,153,83,70
050,51,063,"Virginia","Floyd County",1,34,163,91,72
050,51,063,"Virginia","Floyd County",1,35,168,83,85
050,51,063,"Virginia","Floyd County",1,36,154,79,75
050,51,063,"Virginia","Floyd County",1,37,164,74,90
050,51,063,"Virginia","Floyd County",1,38,166,87,79
050,51,063,"Virginia","Floyd County",1,39,178,96,82
050,51,063,"Virginia","Floyd County",1,40,151,79,72
050,51,063,"Virginia","Floyd County",1,41,161,80,81
050,51,063,"Virginia","Floyd County",1,42,182,88,94
050,51,063,"Virginia","Floyd County",1,43,192,94,98
050,51,063,"Virginia","Floyd County",1,44,203,108,95
050,51,063,"Virginia","Floyd County",1,45,197,109,88
050,51,063,"Virginia","Floyd County",1,46,172,91,81
050,51,063,"Virginia","Floyd County",1,47,192,103,89
050,51,063,"Virginia","Floyd County",1,48,205,109,96
050,51,063,"Virginia","Floyd County",1,49,239,120,119
050,51,063,"Virginia","Floyd County",1,50,237,119,118
050,51,063,"Virginia","Floyd County",1,51,212,106,106
050,51,063,"Virginia","Floyd County",1,52,221,124,97
050,51,063,"Virginia","Floyd County",1,53,200,110,90
050,51,063,"Virginia","Floyd County",1,54,219,121,98
050,51,063,"Virginia","Floyd County",1,55,221,121,100
050,51,063,"Virginia","Floyd County",1,56,254,140,114
050,51,063,"Virginia","Floyd County",1,57,253,130,123
050,51,063,"Virginia","Floyd County",1,58,262,130,132
050,51,063,"Virginia","Floyd County",1,59,273,137,136
050,51,063,"Virginia","Floyd County",1,60,236,111,125
050,51,063,"Virginia","Floyd County",1,61,235,108,127
050,51,063,"Virginia","Floyd County",1,62,254,114,140
050,51,063,"Virginia","Floyd County",1,63,253,119,134
050,51,063,"Virginia","Floyd County",1,64,253,134,119
050,51,063,"Virginia","Floyd County",1,65,249,130,119
050,51,063,"Virginia","Floyd County",1,66,243,128,115
050,51,063,"Virginia","Floyd County",1,67,213,109,104
050,51,063,"Virginia","Floyd County",1,68,240,121,119
050,51,063,"Virginia","Floyd County",1,69,225,116,109
050,51,063,"Virginia","Floyd County",1,70,221,108,113
050,51,063,"Virginia","Floyd County",1,71,229,111,118
050,51,063,"Virginia","Floyd County",1,72,211,100,111
050,51,063,"Virginia","Floyd County",1,73,203,100,103
050,51,063,"Virginia","Floyd County",1,74,145,67,78
050,51,063,"Virginia","Floyd County",1,75,147,66,81
050,51,063,"Virginia","Floyd County",1,76,139,63,76
050,51,063,"Virginia","Floyd County",1,77,153,78,75
050,51,063,"Virginia","Floyd County",1,78,140,75,65
050,51,063,"Virginia","Floyd County",1,79,105,56,49
050,51,063,"Virginia","Floyd County",1,80,100,50,50
050,51,063,"Virginia","Floyd County",1,81,94,48,46
050,51,063,"Virginia","Floyd County",1,82,86,44,42
050,51,063,"Virginia","Floyd County",1,83,75,30,45
050,51,063,"Virginia","Floyd County",1,84,68,28,40
050,51,063,"Virginia","Floyd County",1,85,353,114,239
050,51,063,"Virginia","Floyd County",2,0,142,77,65
050,51,063,"Virginia","Floyd County",2,1,150,73,77
050,51,063,"Virginia","Floyd County",2,2,148,74,74
050,51,063,"Virginia","Floyd County",2,3,148,69,79
050,51,063,"Virginia","Floyd County",2,4,149,73,76
050,51,063,"Virginia","Floyd County",2,5,152,82,70
050,51,063,"Virginia","Floyd County",2,6,163,86,77
050,51,063,"Virginia","Floyd County",2,7,150,86,64
050,51,063,"Virginia","Floyd County",2,8,152,84,68
050,51,063,"Virginia","Floyd County",2,9,164,84,80
050,51,063,"Virginia","Floyd County",2,10,173,88,85
050,51,063,"Virginia","Floyd County",2,11,170,84,86
050,51,063,"Virginia","Floyd County",2,12,187,92,95
050,51,063,"Virginia","Floyd County",2,13,182,92,90
050,51,063,"Virginia","Floyd County",2,14,189,99,90
050,51,063,"Virginia","Floyd County",2,15,195,102,93
050,51,063,"Virginia","Floyd County",2,16,208,108,100
050,51,063,"Virginia","Floyd County",2,17,188,92,96
050,51,063,"Virginia","Floyd County",2,18,148,78,70
050,51,063,"Virginia","Floyd County",2,19,125,67,58
050,51,063,"Virginia","Floyd County",2,20,138,70,68
050,51,063,"Virginia","Floyd County",2,21,142,73,69
050,51,063,"Virginia","Floyd County",2,22,137,73,64
050,51,063,"Virginia","Floyd County",2,23,138,70,68
050,51,063,"Virginia","Floyd County",2,24,150,82,68
050,51,063,"Virginia","Floyd County",2,25,154,84,70
050,51,063,"Virginia","Floyd County",2,26,153,74,79
050,51,063,"Virginia","Floyd County",2,27,152,74,78
050,51,063,"Virginia","Floyd County",2,28,145,73,72
050,51,063,"Virginia","Floyd County",2,29,141,72,69
050,51,063,"Virginia","Floyd County",2,30,162,76,86
050,51,063,"Virginia","Floyd County",2,31,161,78,83
050,51,063,"Virginia","Floyd County",2,32,151,79,72
050,51,063,"Virginia","Floyd County",2,33,151,81,70
050,51,063,"Virginia","Floyd County",2,34,162,90,72
050,51,063,"Virginia","Floyd County",2,35,169,86,83
050,51,063,"Virginia","Floyd County",2,36,154,79,75
050,51,063,"Virginia","Floyd County",2,37,161,75,86
050,51,063,"Virginia","Floyd County",2,38,165,83,82
050,51,063,"Virginia","Floyd County",2,39,172,92,80
050,51,063,"Virginia","Floyd County",2,40,160,85,75
050,51,063,"Virginia","Floyd County",2,41,158,79,79
050,51,063,"Virginia","Floyd County",2,42,176,86,90
050,51,063,"Virginia","Floyd County",2,43,191,94,97
050,51,063,"Virginia","Floyd County",2,44,200,105,95
050,51,063,"Virginia","Floyd County",2,45,200,110,90
050,51,063,"Virginia","Floyd County",2,46,178,95,83
050,51,063,"Virginia","Floyd County",2,47,189,100,89
050,51,063,"Virginia","Floyd County",2,48,204,109,95
050,51,063,"Virginia","Floyd County",2,49,230,116,114
050,51,063,"Virginia","Floyd County",2,50,239,119,120
050,51,063,"Virginia","Floyd County",2,51,216,108,108
050,51,063,"Virginia","Floyd County",2,52,220,120,100
050,51,063,"Virginia","Floyd County",2,53,204,112,92
050,51,063,"Virginia","Floyd County",2,54,215,119,96
050,51,063,"Virginia","Floyd County",2,55,219,118,101
050,51,063,"Virginia","Floyd County",2,56,246,135,111
050,51,063,"Virginia","Floyd County",2,57,251,130,121
050,51,063,"Virginia","Floyd County",2,58,262,131,131
050,51,063,"Virginia","Floyd County",2,59,271,135,136
050,51,063,"Virginia","Floyd County",2,60,244,117,127
050,51,063,"Virginia","Floyd County",2,61,237,108,129
050,51,063,"Virginia","Floyd County",2,62,247,112,135
050,51,063,"Virginia","Floyd County",2,63,257,120,137
050,51,063,"Virginia","Floyd County",2,64,251,131,120
050,51,063,"Virginia","Floyd County",2,65,250,132,118
050,51,063,"Virginia","Floyd County",2,66,246,129,117
050,51,063,"Virginia","Floyd County",2,67,219,112,107
050,51,063,"Virginia","Floyd County",2,68,234,118,116
050,51,063,"Virginia","Floyd County",2,69,227,117,110
050,51,063,"Virginia","Floyd County",2,70,223,111,112
050,51,063,"Virginia","Floyd County",2,71,225,109,116
050,51,063,"Virginia","Floyd County",2,72,210,99,111
050,51,063,"Virginia","Floyd County",2,73,215,105,110
050,51,063,"Virginia","Floyd County",2,74,147,68,79
050,51,063,"Virginia","Floyd County",2,75,148,67,81
050,51,063,"Virginia","Floyd County",2,76,139,64,75
050,51,063,"Virginia","Floyd County",2,77,151,76,75
050,51,063,"Virginia","Floyd County",2,78,139,73,66
050,51,063,"Virginia","Floyd County",2,79,113,60,53
050,51,063,"Virginia","Floyd County",2,80,101,52,49
050,51,063,"Virginia","Floyd County",2,81,94,48,46
050,51,063,"Virginia","Floyd County",2,82,85,43,42
050,51,063,"Virginia","Floyd County",2,83,77,33,44
050,51,063,"Virginia","Floyd County",2,84,68,28,40
050,51,063,"Virginia","Floyd County",2,85,353,113,240
050,51,063,"Virginia","Floyd County",3,0,126,66,60
050,51,063,"Virginia","Floyd County",3,1,144,72,72
050,51,063,"Virginia","Floyd County",3,2,152,76,76
050,51,063,"Virginia","Floyd County",3,3,142,74,68
050,51,063,"Virginia","Floyd County",3,4,148,71,77
050,51,063,"Virginia","Floyd County",3,5,147,71,76
050,51,063,"Virginia","Floyd County",3,6,154,88,66
050,51,063,"Virginia","Floyd County",3,7,163,87,76
050,51,063,"Virginia","Floyd County",3,8,162,93,69
050,51,063,"Virginia","Floyd County",3,9,160,89,71
050,51,063,"Virginia","Floyd County",3,10,164,86,78
050,51,063,"Virginia","Floyd County",3,11,170,87,83
050,51,063,"Virginia","Floyd County",3,12,175,82,93
050,51,063,"Virginia","Floyd County",3,13,187,96,91
050,51,063,"Virginia","Floyd County",3,14,180,92,88
050,51,063,"Virginia","Floyd County",3,15,190,98,92
050,51,063,"Virginia","Floyd County",3,16,186,101,85
050,51,063,"Virginia","Floyd County",3,17,210,111,99
050,51,063,"Virginia","Floyd County",3,18,153,79,74
050,51,063,"Virginia","Floyd County",3,19,118,63,55
050,51,063,"Virginia","Floyd County",3,20,142,78,64
050,51,063,"Virginia","Floyd County",3,21,156,78,78
050,51,063,"Virginia","Floyd County",3,22,152,81,71
050,51,063,"Virginia","Floyd County",3,23,147,75,72
050,51,063,"Virginia","Floyd County",3,24,146,70,76
050,51,063,"Virginia","Floyd County",3,25,144,75,69
050,51,063,"Virginia","Floyd County",3,26,164,91,73
050,51,063,"Virginia","Floyd County",3,27,154,78,76
050,51,063,"Virginia","Floyd County",3,28,156,74,82
050,51,063,"Virginia","Floyd County",3,29,154,73,81
050,51,063,"Virginia","Floyd County",3,30,142,72,70
050,51,063,"Virginia","Floyd County",3,31,166,80,86
050,51,063,"Virginia","Floyd County",3,32,160,75,85
050,51,063,"Virginia","Floyd County",3,33,156,82,74
050,51,063,"Virginia","Floyd County",3,34,158,85,73
050,51,063,"Virginia","Floyd County",3,35,157,90,67
050,51,063,"Virginia","Floyd County",3,36,158,82,76
050,51,063,"Virginia","Floyd County",3,37,151,78,73
050,51,063,"Virginia","Floyd County",3,38,160,73,87
050,51,063,"Virginia","Floyd County",3,39,161,81,80
050,51,063,"Virginia","Floyd County",3,40,182,94,88
050,51,063,"Virginia","Floyd County",3,41,164,90,74
050,51,063,"Virginia","Floyd County",3,42,160,78,82
050,51,063,"Virginia","Floyd County",3,43,183,91,92
050,51,063,"Virginia","Floyd County",3,44,191,97,94
050,51,063,"Virginia","Floyd County",3,45,207,109,98
050,51,063,"Virginia","Floyd County",3,46,206,107,99
050,51,063,"Virginia","Floyd County",3,47,183,97,86
050,51,063,"Virginia","Floyd County",3,48,195,96,99
050,51,063,"Virginia","Floyd County",3,49,206,110,96
050,51,063,"Virginia","Floyd County",3,50,232,116,116
050,51,063,"Virginia","Floyd County",3,51,235,117,118
050,51,063,"Virginia","Floyd County",3,52,221,109,112
050,51,063,"Virginia","Floyd County",3,53,223,119,104
050,51,063,"Virginia","Floyd County",3,54,216,119,97
050,51,063,"Virginia","Floyd County",3,55,211,119,92
050,51,063,"Virginia","Floyd County",3,56,222,120,102
050,51,063,"Virginia","Floyd County",3,57,250,136,114
050,51,063,"Virginia","Floyd County",3,58,255,134,121
050,51,063,"Virginia","Floyd County",3,59,264,132,132
050,51,063,"Virginia","Floyd County",3,60,262,128,134
050,51,063,"Virginia","Floyd County",3,61,250,113,137
050,51,063,"Virginia","Floyd County",3,62,240,108,132
050,51,063,"Virginia","Floyd County",3,63,238,104,134
050,51,063,"Virginia","Floyd County",3,64,252,120,132
050,51,063,"Virginia","Floyd County",3,65,244,126,118
050,51,063,"Virginia","Floyd County",3,66,254,133,121
050,51,063,"Virginia","Floyd County",3,67,242,125,117
050,51,063,"Virginia","Floyd County",3,68,215,112,103
050,51,063,"Virginia","Floyd County",3,69,233,119,114
050,51,063,"Virginia","Floyd County",3,70,218,112,106
050,51,063,"Virginia","Floyd County",3,71,207,103,104
050,51,063,"Virginia","Floyd County",3,72,224,107,117
050,51,063,"Virginia","Floyd County",3,73,203,96,107
050,51,063,"Virginia","Floyd County",3,74,207,97,110
050,51,063,"Virginia","Floyd County",3,75,150,70,80
050,51,063,"Virginia","Floyd County",3,76,143,66,77
050,51,063,"Virginia","Floyd County",3,77,126,53,73
050,51,063,"Virginia","Floyd County",3,78,149,74,75
050,51,063,"Virginia","Floyd County",3,79,133,66,67
050,51,063,"Virginia","Floyd County",3,80,106,57,49
050,51,063,"Virginia","Floyd County",3,81,94,50,44
050,51,063,"Virginia","Floyd County",3,82,80,41,39
050,51,063,"Virginia","Floyd County",3,83,83,39,44
050,51,063,"Virginia","Floyd County",3,84,72,31,41
050,51,063,"Virginia","Floyd County",3,85,364,118,246
050,51,063,"Virginia","Floyd County",4,0,111,52,59
050,51,063,"Virginia","Floyd County",4,1,127,59,68
050,51,063,"Virginia","Floyd County",4,2,151,80,71
050,51,063,"Virginia","Floyd County",4,3,153,78,75
050,51,063,"Virginia","Floyd County",4,4,143,77,66
050,51,063,"Virginia","Floyd County",4,5,153,77,76
050,51,063,"Virginia","Floyd County",4,6,160,76,84
050,51,063,"Virginia","Floyd County",4,7,153,85,68
050,51,063,"Virginia","Floyd County",4,8,161,88,73
050,51,063,"Virginia","Floyd County",4,9,173,100,73
050,51,063,"Virginia","Floyd County",4,10,163,90,73
050,51,063,"Virginia","Floyd County",4,11,175,92,83
050,51,063,"Virginia","Floyd County",4,12,168,84,84
050,51,063,"Virginia","Floyd County",4,13,173,79,94
050,51,063,"Virginia","Floyd County",4,14,192,99,93
050,51,063,"Virginia","Floyd County",4,15,186,98,88
050,51,063,"Virginia","Floyd County",4,16,186,99,87
050,51,063,"Virginia","Floyd County",4,17,181,97,84
050,51,063,"Virginia","Floyd County",4,18,180,98,82
050,51,063,"Virginia","Floyd County",4,19,120,63,57
050,51,063,"Virginia","Floyd County",4,20,122,63,59
050,51,063,"Virginia","Floyd County",4,21,143,81,62
050,51,063,"Virginia","Floyd County",4,22,164,83,81
050,51,063,"Virginia","Floyd County",4,23,161,90,71
050,51,063,"Virginia","Floyd County",4,24,154,76,78
050,51,063,"Virginia","Floyd County",4,25,139,70,69
050,51,063,"Virginia","Floyd County",4,26,148,77,71
050,51,063,"Virginia","Floyd County",4,27,163,89,74
050,51,063,"Virginia","Floyd County",4,28,167,86,81
050,51,063,"Virginia","Floyd County",4,29,165,83,82
050,51,063,"Virginia","Floyd County",4,30,155,78,77
050,51,063,"Virginia","Floyd County",4,31,143,71,72
050,51,063,"Virginia","Floyd County",4,32,167,77,90
050,51,063,"Virginia","Floyd County",4,33,171,81,90
050,51,063,"Virginia","Floyd County",4,34,161,83,78
050,51,063,"Virginia","Floyd County",4,35,157,85,72
050,51,063,"Virginia","Floyd County",4,36,163,93,70
050,51,063,"Virginia","Floyd County",4,37,167,85,82
050,51,063,"Virginia","Floyd County",4,38,159,83,76
050,51,063,"Virginia","Floyd County",4,39,168,76,92
050,51,063,"Virginia","Floyd County",4,40,165,82,83
050,51,063,"Virginia","Floyd County",4,41,181,101,80
050,51,063,"Virginia","Floyd County",4,42,165,88,77
050,51,063,"Virginia","Floyd County",4,43,161,77,84
050,51,063,"Virginia","Floyd County",4,44,183,91,92
050,51,063,"Virginia","Floyd County",4,45,187,97,90
050,51,063,"Virginia","Floyd County",4,46,211,112,99
050,51,063,"Virginia","Floyd County",4,47,202,105,97
050,51,063,"Virginia","Floyd County",4,48,183,96,87
050,51,063,"Virginia","Floyd County",4,49,199,92,107
050,51,063,"Virginia","Floyd County",4,50,214,110,104
050,51,063,"Virginia","Floyd County",4,51,240,121,119
050,51,063,"Virginia","Floyd County",4,52,238,116,122
050,51,063,"Virginia","Floyd County",4,53,228,114,114
050,51,063,"Virginia","Floyd County",4,54,229,119,110
050,51,063,"Virginia","Floyd County",4,55,211,116,95
050,51,063,"Virginia","Floyd County",4,56,218,121,97
050,51,063,"Virginia","Floyd County",4,57,221,118,103
050,51,063,"Virginia","Floyd County",4,58,253,141,112
050,51,063,"Virginia","Floyd County",4,59,270,138,132
050,51,063,"Virginia","Floyd County",4,60,267,134,133
050,51,063,"Virginia","Floyd County",4,61,265,130,135
050,51,063,"Virginia","Floyd County",4,62,247,111,136
050,51,063,"Virginia","Floyd County",4,63,248,111,137
050,51,063,"Virginia","Floyd County",4,64,238,105,133
050,51,063,"Virginia","Floyd County",4,65,251,121,130
050,51,063,"Virginia","Floyd County",4,66,236,124,112
050,51,063,"Virginia","Floyd County",4,67,253,132,121
050,51,063,"Virginia","Floyd County",4,68,242,127,115
050,51,063,"Virginia","Floyd County",4,69,211,111,100
050,51,063,"Virginia","Floyd County",4,70,237,118,119
050,51,063,"Virginia","Floyd County",4,71,219,113,106
050,51,063,"Virginia","Floyd County",4,72,211,102,109
050,51,063,"Virginia","Floyd County",4,73,218,106,112
050,51,063,"Virginia","Floyd County",4,74,197,91,106
050,51,063,"Virginia","Floyd County",4,75,203,98,105
050,51,063,"Virginia","Floyd County",4,76,143,71,72
050,51,063,"Virginia","Floyd County",4,77,138,62,76
050,51,063,"Virginia","Floyd County",4,78,128,51,77
050,51,063,"Virginia","Floyd County",4,79,136,69,67
050,51,063,"Virginia","Floyd County",4,80,123,59,64
050,51,063,"Virginia","Floyd County",4,81,95,54,41
050,51,063,"Virginia","Floyd County",4,82,86,45,41
050,51,063,"Virginia","Floyd County",4,83,81,39,42
050,51,063,"Virginia","Floyd County",4,84,78,37,41
050,51,063,"Virginia","Floyd County",4,85,367,129,238
050,51,063,"Virginia","Floyd County",5,0,110,52,58
050,51,063,"Virginia","Floyd County",5,1,110,54,56
050,51,063,"Virginia","Floyd County",5,2,134,66,68
050,51,063,"Virginia","Floyd County",5,3,155,83,72
050,51,063,"Virginia","Floyd County",5,4,165,85,80
050,51,063,"Virginia","Floyd County",5,5,148,76,72
050,51,063,"Virginia","Floyd County",5,6,147,75,72
050,51,063,"Virginia","Floyd County",5,7,171,76,95
050,51,063,"Virginia","Floyd County",5,8,151,82,69
050,51,063,"Virginia","Floyd County",5,9,164,88,76
050,51,063,"Virginia","Floyd County",5,10,177,100,77
050,51,063,"Virginia","Floyd County",5,11,163,91,72
050,51,063,"Virginia","Floyd County",5,12,177,90,87
050,51,063,"Virginia","Floyd County",5,13,176,89,87
050,51,063,"Virginia","Floyd County",5,14,182,83,99
050,51,063,"Virginia","Floyd County",5,15,191,97,94
050,51,063,"Virginia","Floyd County",5,16,186,100,86
050,51,063,"Virginia","Floyd County",5,17,193,104,89
050,51,063,"Virginia","Floyd County",5,18,162,88,74
050,51,063,"Virginia","Floyd County",5,19,144,78,66
050,51,063,"Virginia","Floyd County",5,20,132,69,63
050,51,063,"Virginia","Floyd County",5,21,129,63,66
050,51,063,"Virginia","Floyd County",5,22,154,81,73
050,51,063,"Virginia","Floyd County",5,23,164,77,87
050,51,063,"Virginia","Floyd County",5,24,149,82,67
050,51,063,"Virginia","Floyd County",5,25,149,70,79
050,51,063,"Virginia","Floyd County",5,26,150,76,74
050,51,063,"Virginia","Floyd County",5,27,163,82,81
050,51,063,"Virginia","Floyd County",5,28,160,86,74
050,51,063,"Virginia","Floyd County",5,29,162,79,83
050,51,063,"Virginia","Floyd County",5,30,168,81,87
050,51,063,"Virginia","Floyd County",5,31,161,81,80
050,51,063,"Virginia","Floyd County",5,32,147,74,73
050,51,063,"Virginia","Floyd County",5,33,174,83,91
050,51,063,"Virginia","Floyd County",5,34,177,86,91
050,51,063,"Virginia","Floyd County",5,35,162,81,81
050,51,063,"Virginia","Floyd County",5,36,158,90,68
050,51,063,"Virginia","Floyd County",5,37,158,90,68
050,51,063,"Virginia","Floyd County",5,38,164,86,78
050,51,063,"Virginia","Floyd County",5,39,164,87,77
050,51,063,"Virginia","Floyd County",5,40,180,79,101
050,51,063,"Virginia","Floyd County",5,41,166,89,77
050,51,063,"Virginia","Floyd County",5,42,178,96,82
050,51,063,"Virginia","Floyd County",5,43,164,89,75
050,51,063,"Virginia","Floyd County",5,44,170,80,90
050,51,063,"Virginia","Floyd County",5,45,190,90,100
050,51,063,"Virginia","Floyd County",5,46,192,103,89
050,51,063,"Virginia","Floyd County",5,47,206,104,102
050,51,063,"Virginia","Floyd County",5,48,201,103,98
050,51,063,"Virginia","Floyd County",5,49,180,95,85
050,51,063,"Virginia","Floyd County",5,50,206,98,108
050,51,063,"Virginia","Floyd County",5,51,223,113,110
050,51,063,"Virginia","Floyd County",5,52,233,118,115
050,51,063,"Virginia","Floyd County",5,53,246,123,123
050,51,063,"Virginia","Floyd County",5,54,234,118,116
050,51,063,"Virginia","Floyd County",5,55,225,117,108
050,51,063,"Virginia","Floyd County",5,56,209,118,91
050,51,063,"Virginia","Floyd County",5,57,219,120,99
050,51,063,"Virginia","Floyd County",5,58,223,120,103
050,51,063,"Virginia","Floyd County",5,59,252,140,112
050,51,063,"Virginia","Floyd County",5,60,268,137,131
050,51,063,"Virginia","Floyd County",5,61,272,138,134
050,51,063,"Virginia","Floyd County",5,62,264,128,136
050,51,063,"Virginia","Floyd County",5,63,256,115,141
050,51,063,"Virginia","Floyd County",5,64,250,118,132
050,51,063,"Virginia","Floyd County",5,65,239,106,133
050,51,063,"Virginia","Floyd County",5,66,255,122,133
050,51,063,"Virginia","Floyd County",5,67,233,120,113
050,51,063,"Virginia","Floyd County",5,68,254,131,123
050,51,063,"Virginia","Floyd County",5,69,241,124,117
050,51,063,"Virginia","Floyd County",5,70,210,107,103
050,51,063,"Virginia","Floyd County",5,71,229,114,115
050,51,063,"Virginia","Floyd County",5,72,209,106,103
050,51,063,"Virginia","Floyd County",5,73,202,96,106
050,51,063,"Virginia","Floyd County",5,74,209,100,109
050,51,063,"Virginia","Floyd County",5,75,189,89,100
050,51,063,"Virginia","Floyd County",5,76,195,100,95
050,51,063,"Virginia","Floyd County",5,77,132,62,70
050,51,063,"Virginia","Floyd County",5,78,136,59,77
050,51,063,"Virginia","Floyd County",5,79,118,47,71
050,51,063,"Virginia","Floyd County",5,80,127,63,64
050,51,063,"Virginia","Floyd County",5,81,110,56,54
050,51,063,"Virginia","Floyd County",5,82,84,47,37
050,51,063,"Virginia","Floyd County",5,83,91,45,46
050,51,063,"Virginia","Floyd County",5,84,78,38,40
050,51,063,"Virginia","Floyd County",5,85,380,145,235
050,51,065,"Virginia","Fluvanna County",1,0,250,128,122
050,51,065,"Virginia","Fluvanna County",1,1,258,134,124
050,51,065,"Virginia","Fluvanna County",1,2,297,164,133
050,51,065,"Virginia","Fluvanna County",1,3,281,147,134
050,51,065,"Virginia","Fluvanna County",1,4,278,138,140
050,51,065,"Virginia","Fluvanna County",1,5,276,144,132
050,51,065,"Virginia","Fluvanna County",1,6,271,139,132
050,51,065,"Virginia","Fluvanna County",1,7,266,136,130
050,51,065,"Virginia","Fluvanna County",1,8,283,145,138
050,51,065,"Virginia","Fluvanna County",1,9,287,143,144
050,51,065,"Virginia","Fluvanna County",1,10,294,153,141
050,51,065,"Virginia","Fluvanna County",1,11,338,176,162
050,51,065,"Virginia","Fluvanna County",1,12,348,163,185
050,51,065,"Virginia","Fluvanna County",1,13,334,166,168
050,51,065,"Virginia","Fluvanna County",1,14,353,181,172
050,51,065,"Virginia","Fluvanna County",1,15,359,185,174
050,51,065,"Virginia","Fluvanna County",1,16,335,171,164
050,51,065,"Virginia","Fluvanna County",1,17,343,164,179
050,51,065,"Virginia","Fluvanna County",1,18,301,152,149
050,51,065,"Virginia","Fluvanna County",1,19,265,126,139
050,51,065,"Virginia","Fluvanna County",1,20,276,128,148
050,51,065,"Virginia","Fluvanna County",1,21,276,134,142
050,51,065,"Virginia","Fluvanna County",1,22,285,127,158
050,51,065,"Virginia","Fluvanna County",1,23,273,124,149
050,51,065,"Virginia","Fluvanna County",1,24,285,126,159
050,51,065,"Virginia","Fluvanna County",1,25,272,116,156
050,51,065,"Virginia","Fluvanna County",1,26,306,119,187
050,51,065,"Virginia","Fluvanna County",1,27,329,128,201
050,51,065,"Virginia","Fluvanna County",1,28,349,150,199
050,51,065,"Virginia","Fluvanna County",1,29,382,160,222
050,51,065,"Virginia","Fluvanna County",1,30,340,136,204
050,51,065,"Virginia","Fluvanna County",1,31,337,140,197
050,51,065,"Virginia","Fluvanna County",1,32,340,146,194
050,51,065,"Virginia","Fluvanna County",1,33,351,163,188
050,51,065,"Virginia","Fluvanna County",1,34,305,138,167
050,51,065,"Virginia","Fluvanna County",1,35,330,148,182
050,51,065,"Virginia","Fluvanna County",1,36,347,157,190
050,51,065,"Virginia","Fluvanna County",1,37,350,154,196
050,51,065,"Virginia","Fluvanna County",1,38,382,165,217
050,51,065,"Virginia","Fluvanna County",1,39,362,173,189
050,51,065,"Virginia","Fluvanna County",1,40,386,181,205
050,51,065,"Virginia","Fluvanna County",1,41,331,153,178
050,51,065,"Virginia","Fluvanna County",1,42,314,134,180
050,51,065,"Virginia","Fluvanna County",1,43,327,151,176
050,51,065,"Virginia","Fluvanna County",1,44,354,157,197
050,51,065,"Virginia","Fluvanna County",1,45,318,143,175
050,51,065,"Virginia","Fluvanna County",1,46,317,147,170
050,51,065,"Virginia","Fluvanna County",1,47,338,146,192
050,51,065,"Virginia","Fluvanna County",1,48,370,170,200
050,51,065,"Virginia","Fluvanna County",1,49,364,182,182
050,51,065,"Virginia","Fluvanna County",1,50,354,164,190
050,51,065,"Virginia","Fluvanna County",1,51,368,177,191
050,51,065,"Virginia","Fluvanna County",1,52,361,165,196
050,51,065,"Virginia","Fluvanna County",1,53,381,170,211
050,51,065,"Virginia","Fluvanna County",1,54,369,159,210
050,51,065,"Virginia","Fluvanna County",1,55,404,185,219
050,51,065,"Virginia","Fluvanna County",1,56,387,184,203
050,51,065,"Virginia","Fluvanna County",1,57,365,177,188
050,51,065,"Virginia","Fluvanna County",1,58,414,183,231
050,51,065,"Virginia","Fluvanna County",1,59,406,190,216
050,51,065,"Virginia","Fluvanna County",1,60,398,193,205
050,51,065,"Virginia","Fluvanna County",1,61,411,191,220
050,51,065,"Virginia","Fluvanna County",1,62,428,195,233
050,51,065,"Virginia","Fluvanna County",1,63,411,189,222
050,51,065,"Virginia","Fluvanna County",1,64,363,156,207
050,51,065,"Virginia","Fluvanna County",1,65,371,169,202
050,51,065,"Virginia","Fluvanna County",1,66,381,176,205
050,51,065,"Virginia","Fluvanna County",1,67,360,160,200
050,51,065,"Virginia","Fluvanna County",1,68,333,150,183
050,51,065,"Virginia","Fluvanna County",1,69,326,163,163
050,51,065,"Virginia","Fluvanna County",1,70,313,150,163
050,51,065,"Virginia","Fluvanna County",1,71,329,155,174
050,51,065,"Virginia","Fluvanna County",1,72,369,170,199
050,51,065,"Virginia","Fluvanna County",1,73,317,153,164
050,51,065,"Virginia","Fluvanna County",1,74,215,92,123
050,51,065,"Virginia","Fluvanna County",1,75,230,113,117
050,51,065,"Virginia","Fluvanna County",1,76,240,111,129
050,51,065,"Virginia","Fluvanna County",1,77,238,99,139
050,51,065,"Virginia","Fluvanna County",1,78,199,95,104
050,51,065,"Virginia","Fluvanna County",1,79,166,84,82
050,51,065,"Virginia","Fluvanna County",1,80,141,64,77
050,51,065,"Virginia","Fluvanna County",1,81,157,68,89
050,51,065,"Virginia","Fluvanna County",1,82,128,58,70
050,51,065,"Virginia","Fluvanna County",1,83,112,51,61
050,51,065,"Virginia","Fluvanna County",1,84,100,49,51
050,51,065,"Virginia","Fluvanna County",1,85,494,203,291
050,51,065,"Virginia","Fluvanna County",2,0,252,135,117
050,51,065,"Virginia","Fluvanna County",2,1,254,132,122
050,51,065,"Virginia","Fluvanna County",2,2,288,156,132
050,51,065,"Virginia","Fluvanna County",2,3,289,152,137
050,51,065,"Virginia","Fluvanna County",2,4,282,141,141
050,51,065,"Virginia","Fluvanna County",2,5,275,141,134
050,51,065,"Virginia","Fluvanna County",2,6,275,142,133
050,51,065,"Virginia","Fluvanna County",2,7,266,135,131
050,51,065,"Virginia","Fluvanna County",2,8,281,144,137
050,51,065,"Virginia","Fluvanna County",2,9,286,144,142
050,51,065,"Virginia","Fluvanna County",2,10,297,153,144
050,51,065,"Virginia","Fluvanna County",2,11,328,171,157
050,51,065,"Virginia","Fluvanna County",2,12,346,168,178
050,51,065,"Virginia","Fluvanna County",2,13,338,166,172
050,51,065,"Virginia","Fluvanna County",2,14,351,179,172
050,51,065,"Virginia","Fluvanna County",2,15,357,185,172
050,51,065,"Virginia","Fluvanna County",2,16,341,175,166
050,51,065,"Virginia","Fluvanna County",2,17,339,166,173
050,51,065,"Virginia","Fluvanna County",2,18,303,151,152
050,51,065,"Virginia","Fluvanna County",2,19,263,125,138
050,51,065,"Virginia","Fluvanna County",2,20,281,130,151
050,51,065,"Virginia","Fluvanna County",2,21,281,132,149
050,51,065,"Virginia","Fluvanna County",2,22,283,128,155
050,51,065,"Virginia","Fluvanna County",2,23,281,126,155
050,51,065,"Virginia","Fluvanna County",2,24,285,127,158
050,51,065,"Virginia","Fluvanna County",2,25,274,119,155
050,51,065,"Virginia","Fluvanna County",2,26,298,118,180
050,51,065,"Virginia","Fluvanna County",2,27,329,127,202
050,51,065,"Virginia","Fluvanna County",2,28,352,150,202
050,51,065,"Virginia","Fluvanna County",2,29,379,160,219
050,51,065,"Virginia","Fluvanna County",2,30,352,142,210
050,51,065,"Virginia","Fluvanna County",2,31,334,138,196
050,51,065,"Virginia","Fluvanna County",2,32,338,144,194
050,51,065,"Virginia","Fluvanna County",2,33,349,157,192
050,51,065,"Virginia","Fluvanna County",2,34,315,144,171
050,51,065,"Virginia","Fluvanna County",2,35,329,146,183
050,51,065,"Virginia","Fluvanna County",2,36,340,155,185
050,51,065,"Virginia","Fluvanna County",2,37,349,155,194
050,51,065,"Virginia","Fluvanna County",2,38,376,162,214
050,51,065,"Virginia","Fluvanna County",2,39,364,171,193
050,51,065,"Virginia","Fluvanna County",2,40,388,182,206
050,51,065,"Virginia","Fluvanna County",2,41,341,158,183
050,51,065,"Virginia","Fluvanna County",2,42,316,137,179
050,51,065,"Virginia","Fluvanna County",2,43,324,147,177
050,51,065,"Virginia","Fluvanna County",2,44,348,155,193
050,51,065,"Virginia","Fluvanna County",2,45,327,149,178
050,51,065,"Virginia","Fluvanna County",2,46,319,146,173
050,51,065,"Virginia","Fluvanna County",2,47,331,145,186
050,51,065,"Virginia","Fluvanna County",2,48,361,164,197
050,51,065,"Virginia","Fluvanna County",2,49,363,181,182
050,51,065,"Virginia","Fluvanna County",2,50,361,172,189
050,51,065,"Virginia","Fluvanna County",2,51,362,172,190
050,51,065,"Virginia","Fluvanna County",2,52,360,166,194
050,51,065,"Virginia","Fluvanna County",2,53,373,168,205
050,51,065,"Virginia","Fluvanna County",2,54,373,163,210
050,51,065,"Virginia","Fluvanna County",2,55,394,180,214
050,51,065,"Virginia","Fluvanna County",2,56,391,182,209
050,51,065,"Virginia","Fluvanna County",2,57,372,178,194
050,51,065,"Virginia","Fluvanna County",2,58,403,179,224
050,51,065,"Virginia","Fluvanna County",2,59,409,189,220
050,51,065,"Virginia","Fluvanna County",2,60,401,193,208
050,51,065,"Virginia","Fluvanna County",2,61,407,190,217
050,51,065,"Virginia","Fluvanna County",2,62,423,193,230
050,51,065,"Virginia","Fluvanna County",2,63,418,192,226
050,51,065,"Virginia","Fluvanna County",2,64,375,164,211
050,51,065,"Virginia","Fluvanna County",2,65,370,165,205
050,51,065,"Virginia","Fluvanna County",2,66,384,176,208
050,51,065,"Virginia","Fluvanna County",2,67,366,164,202
050,51,065,"Virginia","Fluvanna County",2,68,340,153,187
050,51,065,"Virginia","Fluvanna County",2,69,326,159,167
050,51,065,"Virginia","Fluvanna County",2,70,316,153,163
050,51,065,"Virginia","Fluvanna County",2,71,324,154,170
050,51,065,"Virginia","Fluvanna County",2,72,353,163,190
050,51,065,"Virginia","Fluvanna County",2,73,344,164,180
050,51,065,"Virginia","Fluvanna County",2,74,221,99,122
050,51,065,"Virginia","Fluvanna County",2,75,226,107,119
050,51,065,"Virginia","Fluvanna County",2,76,233,109,124
050,51,065,"Virginia","Fluvanna County",2,77,242,104,138
050,51,065,"Virginia","Fluvanna County",2,78,200,93,107
050,51,065,"Virginia","Fluvanna County",2,79,172,86,86
050,51,065,"Virginia","Fluvanna County",2,80,146,69,77
050,51,065,"Virginia","Fluvanna County",2,81,149,66,83
050,51,065,"Virginia","Fluvanna County",2,82,135,61,74
050,51,065,"Virginia","Fluvanna County",2,83,112,51,61
050,51,065,"Virginia","Fluvanna County",2,84,101,50,51
050,51,065,"Virginia","Fluvanna County",2,85,494,208,286
050,51,065,"Virginia","Fluvanna County",3,0,264,153,111
050,51,065,"Virginia","Fluvanna County",3,1,272,143,129
050,51,065,"Virginia","Fluvanna County",3,2,254,130,124
050,51,065,"Virginia","Fluvanna County",3,3,307,167,140
050,51,065,"Virginia","Fluvanna County",3,4,298,156,142
050,51,065,"Virginia","Fluvanna County",3,5,280,137,143
050,51,065,"Virginia","Fluvanna County",3,6,288,144,144
050,51,065,"Virginia","Fluvanna County",3,7,288,148,140
050,51,065,"Virginia","Fluvanna County",3,8,267,138,129
050,51,065,"Virginia","Fluvanna County",3,9,282,147,135
050,51,065,"Virginia","Fluvanna County",3,10,294,150,144
050,51,065,"Virginia","Fluvanna County",3,11,292,151,141
050,51,065,"Virginia","Fluvanna County",3,12,329,172,157
050,51,065,"Virginia","Fluvanna County",3,13,349,167,182
050,51,065,"Virginia","Fluvanna County",3,14,341,165,176
050,51,065,"Virginia","Fluvanna County",3,15,361,182,179
050,51,065,"Virginia","Fluvanna County",3,16,347,180,167
050,51,065,"Virginia","Fluvanna County",3,17,346,179,167
050,51,065,"Virginia","Fluvanna County",3,18,304,150,154
050,51,065,"Virginia","Fluvanna County",3,19,268,133,135
050,51,065,"Virginia","Fluvanna County",3,20,268,127,141
050,51,065,"Virginia","Fluvanna County",3,21,296,138,158
050,51,065,"Virginia","Fluvanna County",3,22,290,135,155
050,51,065,"Virginia","Fluvanna County",3,23,303,137,166
050,51,065,"Virginia","Fluvanna County",3,24,286,118,168
050,51,065,"Virginia","Fluvanna County",3,25,266,128,138
050,51,065,"Virginia","Fluvanna County",3,26,283,117,166
050,51,065,"Virginia","Fluvanna County",3,27,312,125,187
050,51,065,"Virginia","Fluvanna County",3,28,336,128,208
050,51,065,"Virginia","Fluvanna County",3,29,359,144,215
050,51,065,"Virginia","Fluvanna County",3,30,376,156,220
050,51,065,"Virginia","Fluvanna County",3,31,388,150,238
050,51,065,"Virginia","Fluvanna County",3,32,357,149,208
050,51,065,"Virginia","Fluvanna County",3,33,359,159,200
050,51,065,"Virginia","Fluvanna County",3,34,379,168,211
050,51,065,"Virginia","Fluvanna County",3,35,352,163,189
050,51,065,"Virginia","Fluvanna County",3,36,351,163,188
050,51,065,"Virginia","Fluvanna County",3,37,332,158,174
050,51,065,"Virginia","Fluvanna County",3,38,359,157,202
050,51,065,"Virginia","Fluvanna County",3,39,383,171,212
050,51,065,"Virginia","Fluvanna County",3,40,369,159,210
050,51,065,"Virginia","Fluvanna County",3,41,394,180,214
050,51,065,"Virginia","Fluvanna County",3,42,363,165,198
050,51,065,"Virginia","Fluvanna County",3,43,324,146,178
050,51,065,"Virginia","Fluvanna County",3,44,356,161,195
050,51,065,"Virginia","Fluvanna County",3,45,329,150,179
050,51,065,"Virginia","Fluvanna County",3,46,340,151,189
050,51,065,"Virginia","Fluvanna County",3,47,335,154,181
050,51,065,"Virginia","Fluvanna County",3,48,326,143,183
050,51,065,"Virginia","Fluvanna County",3,49,361,168,193
050,51,065,"Virginia","Fluvanna County",3,50,378,186,192
050,51,065,"Virginia","Fluvanna County",3,51,370,174,196
050,51,065,"Virginia","Fluvanna County",3,52,355,173,182
050,51,065,"Virginia","Fluvanna County",3,53,370,168,202
050,51,065,"Virginia","Fluvanna County",3,54,382,172,210
050,51,065,"Virginia","Fluvanna County",3,55,371,167,204
050,51,065,"Virginia","Fluvanna County",3,56,402,187,215
050,51,065,"Virginia","Fluvanna County",3,57,399,188,211
050,51,065,"Virginia","Fluvanna County",3,58,377,178,199
050,51,065,"Virginia","Fluvanna County",3,59,393,179,214
050,51,065,"Virginia","Fluvanna County",3,60,408,191,217
050,51,065,"Virginia","Fluvanna County",3,61,401,201,200
050,51,065,"Virginia","Fluvanna County",3,62,417,196,221
050,51,065,"Virginia","Fluvanna County",3,63,432,196,236
050,51,065,"Virginia","Fluvanna County",3,64,440,200,240
050,51,065,"Virginia","Fluvanna County",3,65,386,162,224
050,51,065,"Virginia","Fluvanna County",3,66,375,165,210
050,51,065,"Virginia","Fluvanna County",3,67,385,176,209
050,51,065,"Virginia","Fluvanna County",3,68,375,167,208
050,51,065,"Virginia","Fluvanna County",3,69,333,153,180
050,51,065,"Virginia","Fluvanna County",3,70,324,159,165
050,51,065,"Virginia","Fluvanna County",3,71,313,157,156
050,51,065,"Virginia","Fluvanna County",3,72,321,156,165
050,51,065,"Virginia","Fluvanna County",3,73,356,166,190
050,51,065,"Virginia","Fluvanna County",3,74,326,152,174
050,51,065,"Virginia","Fluvanna County",3,75,217,99,118
050,51,065,"Virginia","Fluvanna County",3,76,218,97,121
050,51,065,"Virginia","Fluvanna County",3,77,228,102,126
050,51,065,"Virginia","Fluvanna County",3,78,220,97,123
050,51,065,"Virginia","Fluvanna County",3,79,190,86,104
050,51,065,"Virginia","Fluvanna County",3,80,162,79,83
050,51,065,"Virginia","Fluvanna County",3,81,140,64,76
050,51,065,"Virginia","Fluvanna County",3,82,135,65,70
050,51,065,"Virginia","Fluvanna County",3,83,126,56,70
050,51,065,"Virginia","Fluvanna County",3,84,107,47,60
050,51,065,"Virginia","Fluvanna County",3,85,502,213,289
050,51,065,"Virginia","Fluvanna County",4,0,257,121,136
050,51,065,"Virginia","Fluvanna County",4,1,287,153,134
050,51,065,"Virginia","Fluvanna County",4,2,261,138,123
050,51,065,"Virginia","Fluvanna County",4,3,266,140,126
050,51,065,"Virginia","Fluvanna County",4,4,309,166,143
050,51,065,"Virginia","Fluvanna County",4,5,293,154,139
050,51,065,"Virginia","Fluvanna County",4,6,291,141,150
050,51,065,"Virginia","Fluvanna County",4,7,289,142,147
050,51,065,"Virginia","Fluvanna County",4,8,295,149,146
050,51,065,"Virginia","Fluvanna County",4,9,266,132,134
050,51,065,"Virginia","Fluvanna County",4,10,296,153,143
050,51,065,"Virginia","Fluvanna County",4,11,301,158,143
050,51,065,"Virginia","Fluvanna County",4,12,299,157,142
050,51,065,"Virginia","Fluvanna County",4,13,324,168,156
050,51,065,"Virginia","Fluvanna County",4,14,363,174,189
050,51,065,"Virginia","Fluvanna County",4,15,346,171,175
050,51,065,"Virginia","Fluvanna County",4,16,360,184,176
050,51,065,"Virginia","Fluvanna County",4,17,343,171,172
050,51,065,"Virginia","Fluvanna County",4,18,321,160,161
050,51,065,"Virginia","Fluvanna County",4,19,264,129,135
050,51,065,"Virginia","Fluvanna County",4,20,266,124,142
050,51,065,"Virginia","Fluvanna County",4,21,283,128,155
050,51,065,"Virginia","Fluvanna County",4,22,286,136,150
050,51,065,"Virginia","Fluvanna County",4,23,279,129,150
050,51,065,"Virginia","Fluvanna County",4,24,296,131,165
050,51,065,"Virginia","Fluvanna County",4,25,288,121,167
050,51,065,"Virginia","Fluvanna County",4,26,293,144,149
050,51,065,"Virginia","Fluvanna County",4,27,323,133,190
050,51,065,"Virginia","Fluvanna County",4,28,313,126,187
050,51,065,"Virginia","Fluvanna County",4,29,338,131,207
050,51,065,"Virginia","Fluvanna County",4,30,385,161,224
050,51,065,"Virginia","Fluvanna County",4,31,393,170,223
050,51,065,"Virginia","Fluvanna County",4,32,392,151,241
050,51,065,"Virginia","Fluvanna County",4,33,368,154,214
050,51,065,"Virginia","Fluvanna County",4,34,382,174,208
050,51,065,"Virginia","Fluvanna County",4,35,416,182,234
050,51,065,"Virginia","Fluvanna County",4,36,361,162,199
050,51,065,"Virginia","Fluvanna County",4,37,336,159,177
050,51,065,"Virginia","Fluvanna County",4,38,328,153,175
050,51,065,"Virginia","Fluvanna County",4,39,353,166,187
050,51,065,"Virginia","Fluvanna County",4,40,395,169,226
050,51,065,"Virginia","Fluvanna County",4,41,372,161,211
050,51,065,"Virginia","Fluvanna County",4,42,394,179,215
050,51,065,"Virginia","Fluvanna County",4,43,357,164,193
050,51,065,"Virginia","Fluvanna County",4,44,343,150,193
050,51,065,"Virginia","Fluvanna County",4,45,333,161,172
050,51,065,"Virginia","Fluvanna County",4,46,331,149,182
050,51,065,"Virginia","Fluvanna County",4,47,334,140,194
050,51,065,"Virginia","Fluvanna County",4,48,322,156,166
050,51,065,"Virginia","Fluvanna County",4,49,309,142,167
050,51,065,"Virginia","Fluvanna County",4,50,356,166,190
050,51,065,"Virginia","Fluvanna County",4,51,391,190,201
050,51,065,"Virginia","Fluvanna County",4,52,367,172,195
050,51,065,"Virginia","Fluvanna County",4,53,364,177,187
050,51,065,"Virginia","Fluvanna County",4,54,385,166,219
050,51,065,"Virginia","Fluvanna County",4,55,366,169,197
050,51,065,"Virginia","Fluvanna County",4,56,372,169,203
050,51,065,"Virginia","Fluvanna County",4,57,401,186,215
050,51,065,"Virginia","Fluvanna County",4,58,404,185,219
050,51,065,"Virginia","Fluvanna County",4,59,380,179,201
050,51,065,"Virginia","Fluvanna County",4,60,400,184,216
050,51,065,"Virginia","Fluvanna County",4,61,426,204,222
050,51,065,"Virginia","Fluvanna County",4,62,416,199,217
050,51,065,"Virginia","Fluvanna County",4,63,420,201,219
050,51,065,"Virginia","Fluvanna County",4,64,438,192,246
050,51,065,"Virginia","Fluvanna County",4,65,459,210,249
050,51,065,"Virginia","Fluvanna County",4,66,390,167,223
050,51,065,"Virginia","Fluvanna County",4,67,398,182,216
050,51,065,"Virginia","Fluvanna County",4,68,391,171,220
050,51,065,"Virginia","Fluvanna County",4,69,376,170,206
050,51,065,"Virginia","Fluvanna County",4,70,334,155,179
050,51,065,"Virginia","Fluvanna County",4,71,325,158,167
050,51,065,"Virginia","Fluvanna County",4,72,313,159,154
050,51,065,"Virginia","Fluvanna County",4,73,313,158,155
050,51,065,"Virginia","Fluvanna County",4,74,349,163,186
050,51,065,"Virginia","Fluvanna County",4,75,329,151,178
050,51,065,"Virginia","Fluvanna County",4,76,207,93,114
050,51,065,"Virginia","Fluvanna County",4,77,216,95,121
050,51,065,"Virginia","Fluvanna County",4,78,212,94,118
050,51,065,"Virginia","Fluvanna County",4,79,207,89,118
050,51,065,"Virginia","Fluvanna County",4,80,180,81,99
050,51,065,"Virginia","Fluvanna County",4,81,158,74,84
050,51,065,"Virginia","Fluvanna County",4,82,131,63,68
050,51,065,"Virginia","Fluvanna County",4,83,129,56,73
050,51,065,"Virginia","Fluvanna County",4,84,114,50,64
050,51,065,"Virginia","Fluvanna County",4,85,500,205,295
050,51,065,"Virginia","Fluvanna County",5,0,256,121,135
050,51,065,"Virginia","Fluvanna County",5,1,294,143,151
050,51,065,"Virginia","Fluvanna County",5,2,289,151,138
050,51,065,"Virginia","Fluvanna County",5,3,264,143,121
050,51,065,"Virginia","Fluvanna County",5,4,268,137,131
050,51,065,"Virginia","Fluvanna County",5,5,315,160,155
050,51,065,"Virginia","Fluvanna County",5,6,294,158,136
050,51,065,"Virginia","Fluvanna County",5,7,292,144,148
050,51,065,"Virginia","Fluvanna County",5,8,303,154,149
050,51,065,"Virginia","Fluvanna County",5,9,293,152,141
050,51,065,"Virginia","Fluvanna County",5,10,270,135,135
050,51,065,"Virginia","Fluvanna County",5,11,314,158,156
050,51,065,"Virginia","Fluvanna County",5,12,304,154,150
050,51,065,"Virginia","Fluvanna County",5,13,307,157,150
050,51,065,"Virginia","Fluvanna County",5,14,332,171,161
050,51,065,"Virginia","Fluvanna County",5,15,370,174,196
050,51,065,"Virginia","Fluvanna County",5,16,365,176,189
050,51,065,"Virginia","Fluvanna County",5,17,364,189,175
050,51,065,"Virginia","Fluvanna County",5,18,318,157,161
050,51,065,"Virginia","Fluvanna County",5,19,276,139,137
050,51,065,"Virginia","Fluvanna County",5,20,280,127,153
050,51,065,"Virginia","Fluvanna County",5,21,278,126,152
050,51,065,"Virginia","Fluvanna County",5,22,278,127,151
050,51,065,"Virginia","Fluvanna County",5,23,287,133,154
050,51,065,"Virginia","Fluvanna County",5,24,277,124,153
050,51,065,"Virginia","Fluvanna County",5,25,283,125,158
050,51,065,"Virginia","Fluvanna County",5,26,306,126,180
050,51,065,"Virginia","Fluvanna County",5,27,309,150,159
050,51,065,"Virginia","Fluvanna County",5,28,320,133,187
050,51,065,"Virginia","Fluvanna County",5,29,325,129,196
050,51,065,"Virginia","Fluvanna County",5,30,338,133,205
050,51,065,"Virginia","Fluvanna County",5,31,410,181,229
050,51,065,"Virginia","Fluvanna County",5,32,401,168,233
050,51,065,"Virginia","Fluvanna County",5,33,405,169,236
050,51,065,"Virginia","Fluvanna County",5,34,380,172,208
050,51,065,"Virginia","Fluvanna County",5,35,395,170,225
050,51,065,"Virginia","Fluvanna County",5,36,420,193,227
050,51,065,"Virginia","Fluvanna County",5,37,374,177,197
050,51,065,"Virginia","Fluvanna County",5,38,357,161,196
050,51,065,"Virginia","Fluvanna County",5,39,320,152,168
050,51,065,"Virginia","Fluvanna County",5,40,364,176,188
050,51,065,"Virginia","Fluvanna County",5,41,384,163,221
050,51,065,"Virginia","Fluvanna County",5,42,382,160,222
050,51,065,"Virginia","Fluvanna County",5,43,382,182,200
050,51,065,"Virginia","Fluvanna County",5,44,381,166,215
050,51,065,"Virginia","Fluvanna County",5,45,322,140,182
050,51,065,"Virginia","Fluvanna County",5,46,338,159,179
050,51,065,"Virginia","Fluvanna County",5,47,323,148,175
050,51,065,"Virginia","Fluvanna County",5,48,316,140,176
050,51,065,"Virginia","Fluvanna County",5,49,316,158,158
050,51,065,"Virginia","Fluvanna County",5,50,330,154,176
050,51,065,"Virginia","Fluvanna County",5,51,367,177,190
050,51,065,"Virginia","Fluvanna County",5,52,392,186,206
050,51,065,"Virginia","Fluvanna County",5,53,375,177,198
050,51,065,"Virginia","Fluvanna County",5,54,369,177,192
050,51,065,"Virginia","Fluvanna County",5,55,372,167,205
050,51,065,"Virginia","Fluvanna County",5,56,374,174,200
050,51,065,"Virginia","Fluvanna County",5,57,369,168,201
050,51,065,"Virginia","Fluvanna County",5,58,420,188,232
050,51,065,"Virginia","Fluvanna County",5,59,406,190,216
050,51,065,"Virginia","Fluvanna County",5,60,392,187,205
050,51,065,"Virginia","Fluvanna County",5,61,408,188,220
050,51,065,"Virginia","Fluvanna County",5,62,434,198,236
050,51,065,"Virginia","Fluvanna County",5,63,419,202,217
050,51,065,"Virginia","Fluvanna County",5,64,428,203,225
050,51,065,"Virginia","Fluvanna County",5,65,448,196,252
050,51,065,"Virginia","Fluvanna County",5,66,463,208,255
050,51,065,"Virginia","Fluvanna County",5,67,403,178,225
050,51,065,"Virginia","Fluvanna County",5,68,392,178,214
050,51,065,"Virginia","Fluvanna County",5,69,385,168,217
050,51,065,"Virginia","Fluvanna County",5,70,384,171,213
050,51,065,"Virginia","Fluvanna County",5,71,334,155,179
050,51,065,"Virginia","Fluvanna County",5,72,332,160,172
050,51,065,"Virginia","Fluvanna County",5,73,308,156,152
050,51,065,"Virginia","Fluvanna County",5,74,311,155,156
050,51,065,"Virginia","Fluvanna County",5,75,342,157,185
050,51,065,"Virginia","Fluvanna County",5,76,314,148,166
050,51,065,"Virginia","Fluvanna County",5,77,199,87,112
050,51,065,"Virginia","Fluvanna County",5,78,197,87,110
050,51,065,"Virginia","Fluvanna County",5,79,202,88,114
050,51,065,"Virginia","Fluvanna County",5,80,202,83,119
050,51,065,"Virginia","Fluvanna County",5,81,168,71,97
050,51,065,"Virginia","Fluvanna County",5,82,142,70,72
050,51,065,"Virginia","Fluvanna County",5,83,116,52,64
050,51,065,"Virginia","Fluvanna County",5,84,117,52,65
050,51,065,"Virginia","Fluvanna County",5,85,509,204,305
050,51,067,"Virginia","Franklin County",1,0,478,244,234
050,51,067,"Virginia","Franklin County",1,1,500,247,253
050,51,067,"Virginia","Franklin County",1,2,480,234,246
050,51,067,"Virginia","Franklin County",1,3,506,266,240
050,51,067,"Virginia","Franklin County",1,4,532,256,276
050,51,067,"Virginia","Franklin County",1,5,526,261,265
050,51,067,"Virginia","Franklin County",1,6,514,272,242
050,51,067,"Virginia","Franklin County",1,7,541,276,265
050,51,067,"Virginia","Franklin County",1,8,551,292,259
050,51,067,"Virginia","Franklin County",1,9,551,288,263
050,51,067,"Virginia","Franklin County",1,10,661,318,343
050,51,067,"Virginia","Franklin County",1,11,645,309,336
050,51,067,"Virginia","Franklin County",1,12,671,361,310
050,51,067,"Virginia","Franklin County",1,13,674,356,318
050,51,067,"Virginia","Franklin County",1,14,650,333,317
050,51,067,"Virginia","Franklin County",1,15,628,328,300
050,51,067,"Virginia","Franklin County",1,16,636,328,308
050,51,067,"Virginia","Franklin County",1,17,621,318,303
050,51,067,"Virginia","Franklin County",1,18,730,370,360
050,51,067,"Virginia","Franklin County",1,19,757,371,386
050,51,067,"Virginia","Franklin County",1,20,667,334,333
050,51,067,"Virginia","Franklin County",1,21,606,307,299
050,51,067,"Virginia","Franklin County",1,22,560,280,280
050,51,067,"Virginia","Franklin County",1,23,503,261,242
050,51,067,"Virginia","Franklin County",1,24,475,246,229
050,51,067,"Virginia","Franklin County",1,25,527,255,272
050,51,067,"Virginia","Franklin County",1,26,524,254,270
050,51,067,"Virginia","Franklin County",1,27,543,273,270
050,51,067,"Virginia","Franklin County",1,28,586,300,286
050,51,067,"Virginia","Franklin County",1,29,560,288,272
050,51,067,"Virginia","Franklin County",1,30,558,271,287
050,51,067,"Virginia","Franklin County",1,31,529,253,276
050,51,067,"Virginia","Franklin County",1,32,535,257,278
050,51,067,"Virginia","Franklin County",1,33,539,252,287
050,51,067,"Virginia","Franklin County",1,34,519,248,271
050,51,067,"Virginia","Franklin County",1,35,505,247,258
050,51,067,"Virginia","Franklin County",1,36,509,247,262
050,51,067,"Virginia","Franklin County",1,37,544,259,285
050,51,067,"Virginia","Franklin County",1,38,568,299,269
050,51,067,"Virginia","Franklin County",1,39,553,290,263
050,51,067,"Virginia","Franklin County",1,40,524,271,253
050,51,067,"Virginia","Franklin County",1,41,547,281,266
050,51,067,"Virginia","Franklin County",1,42,526,262,264
050,51,067,"Virginia","Franklin County",1,43,531,258,273
050,51,067,"Virginia","Franklin County",1,44,530,250,280
050,51,067,"Virginia","Franklin County",1,45,571,280,291
050,51,067,"Virginia","Franklin County",1,46,560,295,265
050,51,067,"Virginia","Franklin County",1,47,639,321,318
050,51,067,"Virginia","Franklin County",1,48,742,374,368
050,51,067,"Virginia","Franklin County",1,49,758,377,381
050,51,067,"Virginia","Franklin County",1,50,715,351,364
050,51,067,"Virginia","Franklin County",1,51,730,367,363
050,51,067,"Virginia","Franklin County",1,52,774,389,385
050,51,067,"Virginia","Franklin County",1,53,813,411,402
050,51,067,"Virginia","Franklin County",1,54,832,417,415
050,51,067,"Virginia","Franklin County",1,55,862,448,414
050,51,067,"Virginia","Franklin County",1,56,890,459,431
050,51,067,"Virginia","Franklin County",1,57,900,437,463
050,51,067,"Virginia","Franklin County",1,58,956,469,487
050,51,067,"Virginia","Franklin County",1,59,897,469,428
050,51,067,"Virginia","Franklin County",1,60,876,441,435
050,51,067,"Virginia","Franklin County",1,61,898,444,454
050,51,067,"Virginia","Franklin County",1,62,911,448,463
050,51,067,"Virginia","Franklin County",1,63,932,477,455
050,51,067,"Virginia","Franklin County",1,64,895,467,428
050,51,067,"Virginia","Franklin County",1,65,872,435,437
050,51,067,"Virginia","Franklin County",1,66,838,392,446
050,51,067,"Virginia","Franklin County",1,67,864,422,442
050,51,067,"Virginia","Franklin County",1,68,843,426,417
050,51,067,"Virginia","Franklin County",1,69,773,388,385
050,51,067,"Virginia","Franklin County",1,70,747,354,393
050,51,067,"Virginia","Franklin County",1,71,771,364,407
050,51,067,"Virginia","Franklin County",1,72,786,387,399
050,51,067,"Virginia","Franklin County",1,73,810,406,404
050,51,067,"Virginia","Franklin County",1,74,562,280,282
050,51,067,"Virginia","Franklin County",1,75,581,283,298
050,51,067,"Virginia","Franklin County",1,76,539,269,270
050,51,067,"Virginia","Franklin County",1,77,533,273,260
050,51,067,"Virginia","Franklin County",1,78,470,225,245
050,51,067,"Virginia","Franklin County",1,79,395,193,202
050,51,067,"Virginia","Franklin County",1,80,331,153,178
050,51,067,"Virginia","Franklin County",1,81,299,147,152
050,51,067,"Virginia","Franklin County",1,82,280,132,148
050,51,067,"Virginia","Franklin County",1,83,234,99,135
050,51,067,"Virginia","Franklin County",1,84,215,85,130
050,51,067,"Virginia","Franklin County",1,85,1153,441,712
050,51,067,"Virginia","Franklin County",2,0,482,251,231
050,51,067,"Virginia","Franklin County",2,1,495,245,250
050,51,067,"Virginia","Franklin County",2,2,484,239,245
050,51,067,"Virginia","Franklin County",2,3,495,255,240
050,51,067,"Virginia","Franklin County",2,4,528,259,269
050,51,067,"Virginia","Franklin County",2,5,530,261,269
050,51,067,"Virginia","Franklin County",2,6,517,271,246
050,51,067,"Virginia","Franklin County",2,7,532,275,257
050,51,067,"Virginia","Franklin County",2,8,549,289,260
050,51,067,"Virginia","Franklin County",2,9,553,289,264
050,51,067,"Virginia","Franklin County",2,10,635,309,326
050,51,067,"Virginia","Franklin County",2,11,646,313,333
050,51,067,"Virginia","Franklin County",2,12,670,352,318
050,51,067,"Virginia","Franklin County",2,13,673,357,316
050,51,067,"Virginia","Franklin County",2,14,655,339,316
050,51,067,"Virginia","Franklin County",2,15,633,331,302
050,51,067,"Virginia","Franklin County",2,16,632,327,305
050,51,067,"Virginia","Franklin County",2,17,626,322,304
050,51,067,"Virginia","Franklin County",2,18,716,363,353
050,51,067,"Virginia","Franklin County",2,19,757,373,384
050,51,067,"Virginia","Franklin County",2,20,680,337,343
050,51,067,"Virginia","Franklin County",2,21,615,314,301
050,51,067,"Virginia","Franklin County",2,22,560,281,279
050,51,067,"Virginia","Franklin County",2,23,502,257,245
050,51,067,"Virginia","Franklin County",2,24,484,251,233
050,51,067,"Virginia","Franklin County",2,25,514,254,260
050,51,067,"Virginia","Franklin County",2,26,530,257,273
050,51,067,"Virginia","Franklin County",2,27,540,271,269
050,51,067,"Virginia","Franklin County",2,28,573,293,280
050,51,067,"Virginia","Franklin County",2,29,569,293,276
050,51,067,"Virginia","Franklin County",2,30,559,273,286
050,51,067,"Virginia","Franklin County",2,31,536,257,279
050,51,067,"Virginia","Franklin County",2,32,537,257,280
050,51,067,"Virginia","Franklin County",2,33,541,255,286
050,51,067,"Virginia","Franklin County",2,34,526,251,275
050,51,067,"Virginia","Franklin County",2,35,511,249,262
050,51,067,"Virginia","Franklin County",2,36,505,246,259
050,51,067,"Virginia","Franklin County",2,37,538,258,280
050,51,067,"Virginia","Franklin County",2,38,563,289,274
050,51,067,"Virginia","Franklin County",2,39,552,290,262
050,51,067,"Virginia","Franklin County",2,40,533,275,258
050,51,067,"Virginia","Franklin County",2,41,541,279,262
050,51,067,"Virginia","Franklin County",2,42,530,265,265
050,51,067,"Virginia","Franklin County",2,43,532,260,272
050,51,067,"Virginia","Franklin County",2,44,527,250,277
050,51,067,"Virginia","Franklin County",2,45,561,271,290
050,51,067,"Virginia","Franklin County",2,46,565,294,271
050,51,067,"Virginia","Franklin County",2,47,621,316,305
050,51,067,"Virginia","Franklin County",2,48,720,364,356
050,51,067,"Virginia","Franklin County",2,49,761,378,383
050,51,067,"Virginia","Franklin County",2,50,731,359,372
050,51,067,"Virginia","Franklin County",2,51,729,366,363
050,51,067,"Virginia","Franklin County",2,52,760,384,376
050,51,067,"Virginia","Franklin County",2,53,805,405,400
050,51,067,"Virginia","Franklin County",2,54,828,418,410
050,51,067,"Virginia","Franklin County",2,55,854,441,413
050,51,067,"Virginia","Franklin County",2,56,890,462,428
050,51,067,"Virginia","Franklin County",2,57,900,444,456
050,51,067,"Virginia","Franklin County",2,58,945,462,483
050,51,067,"Virginia","Franklin County",2,59,913,469,444
050,51,067,"Virginia","Franklin County",2,60,880,448,432
050,51,067,"Virginia","Franklin County",2,61,890,438,452
050,51,067,"Virginia","Franklin County",2,62,912,450,462
050,51,067,"Virginia","Franklin County",2,63,938,476,462
050,51,067,"Virginia","Franklin County",2,64,896,466,430
050,51,067,"Virginia","Franklin County",2,65,875,442,433
050,51,067,"Virginia","Franklin County",2,66,850,404,446
050,51,067,"Virginia","Franklin County",2,67,854,412,442
050,51,067,"Virginia","Franklin County",2,68,842,425,417
050,51,067,"Virginia","Franklin County",2,69,799,406,393
050,51,067,"Virginia","Franklin County",2,70,746,358,388
050,51,067,"Virginia","Franklin County",2,71,766,364,402
050,51,067,"Virginia","Franklin County",2,72,765,373,392
050,51,067,"Virginia","Franklin County",2,73,837,419,418
050,51,067,"Virginia","Franklin County",2,74,575,286,289
050,51,067,"Virginia","Franklin County",2,75,575,280,295
050,51,067,"Virginia","Franklin County",2,76,533,262,271
050,51,067,"Virginia","Franklin County",2,77,546,278,268
050,51,067,"Virginia","Franklin County",2,78,473,230,243
050,51,067,"Virginia","Franklin County",2,79,405,195,210
050,51,067,"Virginia","Franklin County",2,80,342,160,182
050,51,067,"Virginia","Franklin County",2,81,301,147,154
050,51,067,"Virginia","Franklin County",2,82,282,135,147
050,51,067,"Virginia","Franklin County",2,83,238,105,133
050,51,067,"Virginia","Franklin County",2,84,214,88,126
050,51,067,"Virginia","Franklin County",2,85,1159,445,714
050,51,067,"Virginia","Franklin County",3,0,477,244,233
050,51,067,"Virginia","Franklin County",3,1,520,275,245
050,51,067,"Virginia","Franklin County",3,2,518,254,264
050,51,067,"Virginia","Franklin County",3,3,497,251,246
050,51,067,"Virginia","Franklin County",3,4,510,264,246
050,51,067,"Virginia","Franklin County",3,5,532,265,267
050,51,067,"Virginia","Franklin County",3,6,541,265,276
050,51,067,"Virginia","Franklin County",3,7,521,272,249
050,51,067,"Virginia","Franklin County",3,8,536,280,256
050,51,067,"Virginia","Franklin County",3,9,535,285,250
050,51,067,"Virginia","Franklin County",3,10,548,287,261
050,51,067,"Virginia","Franklin County",3,11,641,316,325
050,51,067,"Virginia","Franklin County",3,12,655,316,339
050,51,067,"Virginia","Franklin County",3,13,682,356,326
050,51,067,"Virginia","Franklin County",3,14,678,362,316
050,51,067,"Virginia","Franklin County",3,15,658,333,325
050,51,067,"Virginia","Franklin County",3,16,637,334,303
050,51,067,"Virginia","Franklin County",3,17,651,333,318
050,51,067,"Virginia","Franklin County",3,18,678,346,332
050,51,067,"Virginia","Franklin County",3,19,738,377,361
050,51,067,"Virginia","Franklin County",3,20,701,342,359
050,51,067,"Virginia","Franklin County",3,21,650,331,319
050,51,067,"Virginia","Franklin County",3,22,587,293,294
050,51,067,"Virginia","Franklin County",3,23,531,265,266
050,51,067,"Virginia","Franklin County",3,24,506,255,251
050,51,067,"Virginia","Franklin County",3,25,523,267,256
050,51,067,"Virginia","Franklin County",3,26,528,261,267
050,51,067,"Virginia","Franklin County",3,27,555,266,289
050,51,067,"Virginia","Franklin County",3,28,555,271,284
050,51,067,"Virginia","Franklin County",3,29,566,288,278
050,51,067,"Virginia","Franklin County",3,30,566,299,267
050,51,067,"Virginia","Franklin County",3,31,565,275,290
050,51,067,"Virginia","Franklin County",3,32,561,266,295
050,51,067,"Virginia","Franklin County",3,33,566,268,298
050,51,067,"Virginia","Franklin County",3,34,557,264,293
050,51,067,"Virginia","Franklin County",3,35,554,272,282
050,51,067,"Virginia","Franklin County",3,36,526,257,269
050,51,067,"Virginia","Franklin County",3,37,535,257,278
050,51,067,"Virginia","Franklin County",3,38,542,261,281
050,51,067,"Virginia","Franklin County",3,39,557,289,268
050,51,067,"Virginia","Franklin County",3,40,540,280,260
050,51,067,"Virginia","Franklin County",3,41,538,280,258
050,51,067,"Virginia","Franklin County",3,42,528,278,250
050,51,067,"Virginia","Franklin County",3,43,527,257,270
050,51,067,"Virginia","Franklin County",3,44,537,263,274
050,51,067,"Virginia","Franklin County",3,45,535,246,289
050,51,067,"Virginia","Franklin County",3,46,580,287,293
050,51,067,"Virginia","Franklin County",3,47,590,302,288
050,51,067,"Virginia","Franklin County",3,48,628,316,312
050,51,067,"Virginia","Franklin County",3,49,720,367,353
050,51,067,"Virginia","Franklin County",3,50,769,380,389
050,51,067,"Virginia","Franklin County",3,51,758,378,380
050,51,067,"Virginia","Franklin County",3,52,746,365,381
050,51,067,"Virginia","Franklin County",3,53,769,392,377
050,51,067,"Virginia","Franklin County",3,54,803,399,404
050,51,067,"Virginia","Franklin County",3,55,836,416,420
050,51,067,"Virginia","Franklin County",3,56,873,456,417
050,51,067,"Virginia","Franklin County",3,57,924,470,454
050,51,067,"Virginia","Franklin County",3,58,922,447,475
050,51,067,"Virginia","Franklin County",3,59,970,476,494
050,51,067,"Virginia","Franklin County",3,60,941,481,460
050,51,067,"Virginia","Franklin County",3,61,892,445,447
050,51,067,"Virginia","Franklin County",3,62,919,451,468
050,51,067,"Virginia","Franklin County",3,63,936,462,474
050,51,067,"Virginia","Franklin County",3,64,925,465,460
050,51,067,"Virginia","Franklin County",3,65,905,467,438
050,51,067,"Virginia","Franklin County",3,66,894,452,442
050,51,067,"Virginia","Franklin County",3,67,851,402,449
050,51,067,"Virginia","Franklin County",3,68,855,405,450
050,51,067,"Virginia","Franklin County",3,69,841,430,411
050,51,067,"Virginia","Franklin County",3,70,784,396,388
050,51,067,"Virginia","Franklin County",3,71,734,362,372
050,51,067,"Virginia","Franklin County",3,72,737,350,387
050,51,067,"Virginia","Franklin County",3,73,743,360,383
050,51,067,"Virginia","Franklin County",3,74,813,415,398
050,51,067,"Virginia","Franklin County",3,75,540,266,274
050,51,067,"Virginia","Franklin County",3,76,552,264,288
050,51,067,"Virginia","Franklin County",3,77,508,256,252
050,51,067,"Virginia","Franklin County",3,78,526,262,264
050,51,067,"Virginia","Franklin County",3,79,442,220,222
050,51,067,"Virginia","Franklin County",3,80,375,174,201
050,51,067,"Virginia","Franklin County",3,81,311,145,166
050,51,067,"Virginia","Franklin County",3,82,274,133,141
050,51,067,"Virginia","Franklin County",3,83,263,125,138
050,51,067,"Virginia","Franklin County",3,84,222,97,125
050,51,067,"Virginia","Franklin County",3,85,1157,434,723
050,51,067,"Virginia","Franklin County",4,0,502,251,251
050,51,067,"Virginia","Franklin County",4,1,488,262,226
050,51,067,"Virginia","Franklin County",4,2,527,288,239
050,51,067,"Virginia","Franklin County",4,3,513,241,272
050,51,067,"Virginia","Franklin County",4,4,496,247,249
050,51,067,"Virginia","Franklin County",4,5,509,257,252
050,51,067,"Virginia","Franklin County",4,6,535,267,268
050,51,067,"Virginia","Franklin County",4,7,549,273,276
050,51,067,"Virginia","Franklin County",4,8,535,278,257
050,51,067,"Virginia","Franklin County",4,9,530,275,255
050,51,067,"Virginia","Franklin County",4,10,554,289,265
050,51,067,"Virginia","Franklin County",4,11,550,286,264
050,51,067,"Virginia","Franklin County",4,12,647,325,322
050,51,067,"Virginia","Franklin County",4,13,646,316,330
050,51,067,"Virginia","Franklin County",4,14,679,356,323
050,51,067,"Virginia","Franklin County",4,15,676,360,316
050,51,067,"Virginia","Franklin County",4,16,658,335,323
050,51,067,"Virginia","Franklin County",4,17,641,335,306
050,51,067,"Virginia","Franklin County",4,18,717,373,344
050,51,067,"Virginia","Franklin County",4,19,702,358,344
050,51,067,"Virginia","Franklin County",4,20,665,330,335
050,51,067,"Virginia","Franklin County",4,21,666,327,339
050,51,067,"Virginia","Franklin County",4,22,608,308,300
050,51,067,"Virginia","Franklin County",4,23,545,273,272
050,51,067,"Virginia","Franklin County",4,24,516,252,264
050,51,067,"Virginia","Franklin County",4,25,474,247,227
050,51,067,"Virginia","Franklin County",4,26,520,261,259
050,51,067,"Virginia","Franklin County",4,27,523,255,268
050,51,067,"Virginia","Franklin County",4,28,556,264,292
050,51,067,"Virginia","Franklin County",4,29,554,274,280
050,51,067,"Virginia","Franklin County",4,30,605,310,295
050,51,067,"Virginia","Franklin County",4,31,579,303,276
050,51,067,"Virginia","Franklin County",4,32,555,269,286
050,51,067,"Virginia","Franklin County",4,33,552,265,287
050,51,067,"Virginia","Franklin County",4,34,558,263,295
050,51,067,"Virginia","Franklin County",4,35,549,250,299
050,51,067,"Virginia","Franklin County",4,36,566,276,290
050,51,067,"Virginia","Franklin County",4,37,553,271,282
050,51,067,"Virginia","Franklin County",4,38,515,249,266
050,51,067,"Virginia","Franklin County",4,39,551,271,280
050,51,067,"Virginia","Franklin County",4,40,556,294,262
050,51,067,"Virginia","Franklin County",4,41,552,287,265
050,51,067,"Virginia","Franklin County",4,42,524,275,249
050,51,067,"Virginia","Franklin County",4,43,535,277,258
050,51,067,"Virginia","Franklin County",4,44,533,257,276
050,51,067,"Virginia","Franklin County",4,45,539,261,278
050,51,067,"Virginia","Franklin County",4,46,533,251,282
050,51,067,"Virginia","Franklin County",4,47,572,289,283
050,51,067,"Virginia","Franklin County",4,48,603,302,301
050,51,067,"Virginia","Franklin County",4,49,626,314,312
050,51,067,"Virginia","Franklin County",4,50,733,373,360
050,51,067,"Virginia","Franklin County",4,51,795,393,402
050,51,067,"Virginia","Franklin County",4,52,758,374,384
050,51,067,"Virginia","Franklin County",4,53,756,367,389
050,51,067,"Virginia","Franklin County",4,54,776,398,378
050,51,067,"Virginia","Franklin County",4,55,821,402,419
050,51,067,"Virginia","Franklin County",4,56,838,428,410
050,51,067,"Virginia","Franklin County",4,57,880,462,418
050,51,067,"Virginia","Franklin County",4,58,944,474,470
050,51,067,"Virginia","Franklin County",4,59,923,445,478
050,51,067,"Virginia","Franklin County",4,60,1000,485,515
050,51,067,"Virginia","Franklin County",4,61,964,485,479
050,51,067,"Virginia","Franklin County",4,62,903,458,445
050,51,067,"Virginia","Franklin County",4,63,939,461,478
050,51,067,"Virginia","Franklin County",4,64,941,460,481
050,51,067,"Virginia","Franklin County",4,65,946,477,469
050,51,067,"Virginia","Franklin County",4,66,906,462,444
050,51,067,"Virginia","Franklin County",4,67,890,450,440
050,51,067,"Virginia","Franklin County",4,68,854,397,457
050,51,067,"Virginia","Franklin County",4,69,848,410,438
050,51,067,"Virginia","Franklin County",4,70,820,413,407
050,51,067,"Virginia","Franklin County",4,71,770,398,372
050,51,067,"Virginia","Franklin County",4,72,696,342,354
050,51,067,"Virginia","Franklin County",4,73,717,334,383
050,51,067,"Virginia","Franklin County",4,74,716,356,360
050,51,067,"Virginia","Franklin County",4,75,783,388,395
050,51,067,"Virginia","Franklin County",4,76,509,238,271
050,51,067,"Virginia","Franklin County",4,77,529,255,274
050,51,067,"Virginia","Franklin County",4,78,484,242,242
050,51,067,"Virginia","Franklin County",4,79,491,247,244
050,51,067,"Virginia","Franklin County",4,80,418,203,215
050,51,067,"Virginia","Franklin County",4,81,351,161,190
050,51,067,"Virginia","Franklin County",4,82,289,135,154
050,51,067,"Virginia","Franklin County",4,83,253,124,129
050,51,067,"Virginia","Franklin County",4,84,241,109,132
050,51,067,"Virginia","Franklin County",4,85,1160,443,717
050,51,067,"Virginia","Franklin County",5,0,500,252,248
050,51,067,"Virginia","Franklin County",5,1,538,276,262
050,51,067,"Virginia","Franklin County",5,2,497,276,221
050,51,067,"Virginia","Franklin County",5,3,534,289,245
050,51,067,"Virginia","Franklin County",5,4,518,244,274
050,51,067,"Virginia","Franklin County",5,5,506,253,253
050,51,067,"Virginia","Franklin County",5,6,523,272,251
050,51,067,"Virginia","Franklin County",5,7,550,281,269
050,51,067,"Virginia","Franklin County",5,8,568,280,288
050,51,067,"Virginia","Franklin County",5,9,541,280,261
050,51,067,"Virginia","Franklin County",5,10,541,282,259
050,51,067,"Virginia","Franklin County",5,11,567,292,275
050,51,067,"Virginia","Franklin County",5,12,558,296,262
050,51,067,"Virginia","Franklin County",5,13,639,312,327
050,51,067,"Virginia","Franklin County",5,14,657,317,340
050,51,067,"Virginia","Franklin County",5,15,664,345,319
050,51,067,"Virginia","Franklin County",5,16,686,367,319
050,51,067,"Virginia","Franklin County",5,17,666,336,330
050,51,067,"Virginia","Franklin County",5,18,683,360,323
050,51,067,"Virginia","Franklin County",5,19,716,375,341
050,51,067,"Virginia","Franklin County",5,20,643,323,320
050,51,067,"Virginia","Franklin County",5,21,651,337,314
050,51,067,"Virginia","Franklin County",5,22,672,316,356
050,51,067,"Virginia","Franklin County",5,23,560,277,283
050,51,067,"Virginia","Franklin County",5,24,552,276,276
050,51,067,"Virginia","Franklin County",5,25,522,255,267
050,51,067,"Virginia","Franklin County",5,26,466,246,220
050,51,067,"Virginia","Franklin County",5,27,518,263,255
050,51,067,"Virginia","Franklin County",5,28,530,255,275
050,51,067,"Virginia","Franklin County",5,29,578,278,300
050,51,067,"Virginia","Franklin County",5,30,572,281,291
050,51,067,"Virginia","Franklin County",5,31,587,300,287
050,51,067,"Virginia","Franklin County",5,32,593,318,275
050,51,067,"Virginia","Franklin County",5,33,588,284,304
050,51,067,"Virginia","Franklin County",5,34,562,273,289
050,51,067,"Virginia","Franklin County",5,35,564,268,296
050,51,067,"Virginia","Franklin County",5,36,562,259,303
050,51,067,"Virginia","Franklin County",5,37,567,269,298
050,51,067,"Virginia","Franklin County",5,38,565,281,284
050,51,067,"Virginia","Franklin County",5,39,523,260,263
050,51,067,"Virginia","Franklin County",5,40,570,286,284
050,51,067,"Virginia","Franklin County",5,41,576,295,281
050,51,067,"Virginia","Franklin County",5,42,559,291,268
050,51,067,"Virginia","Franklin County",5,43,521,271,250
050,51,067,"Virginia","Franklin County",5,44,547,283,264
050,51,067,"Virginia","Franklin County",5,45,553,267,286
050,51,067,"Virginia","Franklin County",5,46,554,266,288
050,51,067,"Virginia","Franklin County",5,47,539,254,285
050,51,067,"Virginia","Franklin County",5,48,592,303,289
050,51,067,"Virginia","Franklin County",5,49,608,294,314
050,51,067,"Virginia","Franklin County",5,50,639,322,317
050,51,067,"Virginia","Franklin County",5,51,746,378,368
050,51,067,"Virginia","Franklin County",5,52,810,389,421
050,51,067,"Virginia","Franklin County",5,53,762,369,393
050,51,067,"Virginia","Franklin County",5,54,764,375,389
050,51,067,"Virginia","Franklin County",5,55,777,389,388
050,51,067,"Virginia","Franklin County",5,56,849,419,430
050,51,067,"Virginia","Franklin County",5,57,828,420,408
050,51,067,"Virginia","Franklin County",5,58,892,463,429
050,51,067,"Virginia","Franklin County",5,59,949,477,472
050,51,067,"Virginia","Franklin County",5,60,945,455,490
050,51,067,"Virginia","Franklin County",5,61,1020,489,531
050,51,067,"Virginia","Franklin County",5,62,996,505,491
050,51,067,"Virginia","Franklin County",5,63,918,477,441
050,51,067,"Virginia","Franklin County",5,64,942,461,481
050,51,067,"Virginia","Franklin County",5,65,945,466,479
050,51,067,"Virginia","Franklin County",5,66,957,479,478
050,51,067,"Virginia","Franklin County",5,67,907,458,449
050,51,067,"Virginia","Franklin County",5,68,883,444,439
050,51,067,"Virginia","Franklin County",5,69,839,390,449
050,51,067,"Virginia","Franklin County",5,70,822,393,429
050,51,067,"Virginia","Franklin County",5,71,808,412,396
050,51,067,"Virginia","Franklin County",5,72,727,368,359
050,51,067,"Virginia","Franklin County",5,73,683,330,353
050,51,067,"Virginia","Franklin County",5,74,703,333,370
050,51,067,"Virginia","Franklin County",5,75,703,347,356
050,51,067,"Virginia","Franklin County",5,76,745,361,384
050,51,067,"Virginia","Franklin County",5,77,495,233,262
050,51,067,"Virginia","Franklin County",5,78,519,245,274
050,51,067,"Virginia","Franklin County",5,79,453,234,219
050,51,067,"Virginia","Franklin County",5,80,462,225,237
050,51,067,"Virginia","Franklin County",5,81,389,185,204
050,51,067,"Virginia","Franklin County",5,82,335,154,181
050,51,067,"Virginia","Franklin County",5,83,267,125,142
050,51,067,"Virginia","Franklin County",5,84,237,112,125
050,51,067,"Virginia","Franklin County",5,85,1187,465,722
050,51,069,"Virginia","Frederick County",1,0,957,495,462
050,51,069,"Virginia","Frederick County",1,1,995,518,477
050,51,069,"Virginia","Frederick County",1,2,1068,543,525
050,51,069,"Virginia","Frederick County",1,3,1080,556,524
050,51,069,"Virginia","Frederick County",1,4,1150,605,545
050,51,069,"Virginia","Frederick County",1,5,1143,587,556
050,51,069,"Virginia","Frederick County",1,6,1162,610,552
050,51,069,"Virginia","Frederick County",1,7,1189,593,596
050,51,069,"Virginia","Frederick County",1,8,1147,580,567
050,51,069,"Virginia","Frederick County",1,9,1145,571,574
050,51,069,"Virginia","Frederick County",1,10,1179,621,558
050,51,069,"Virginia","Frederick County",1,11,1258,653,605
050,51,069,"Virginia","Frederick County",1,12,1319,687,632
050,51,069,"Virginia","Frederick County",1,13,1298,677,621
050,51,069,"Virginia","Frederick County",1,14,1291,674,617
050,51,069,"Virginia","Frederick County",1,15,1242,657,585
050,51,069,"Virginia","Frederick County",1,16,1312,671,641
050,51,069,"Virginia","Frederick County",1,17,1264,648,616
050,51,069,"Virginia","Frederick County",1,18,1062,573,489
050,51,069,"Virginia","Frederick County",1,19,890,467,423
050,51,069,"Virginia","Frederick County",1,20,950,501,449
050,51,069,"Virginia","Frederick County",1,21,983,524,459
050,51,069,"Virginia","Frederick County",1,22,970,495,475
050,51,069,"Virginia","Frederick County",1,23,948,460,488
050,51,069,"Virginia","Frederick County",1,24,984,488,496
050,51,069,"Virginia","Frederick County",1,25,1019,507,512
050,51,069,"Virginia","Frederick County",1,26,1014,517,497
050,51,069,"Virginia","Frederick County",1,27,1058,535,523
050,51,069,"Virginia","Frederick County",1,28,1094,549,545
050,51,069,"Virginia","Frederick County",1,29,1130,571,559
050,51,069,"Virginia","Frederick County",1,30,1100,552,548
050,51,069,"Virginia","Frederick County",1,31,1125,534,591
050,51,069,"Virginia","Frederick County",1,32,1153,577,576
050,51,069,"Virginia","Frederick County",1,33,1136,578,558
050,51,069,"Virginia","Frederick County",1,34,1164,590,574
050,51,069,"Virginia","Frederick County",1,35,1134,572,562
050,51,069,"Virginia","Frederick County",1,36,1154,570,584
050,51,069,"Virginia","Frederick County",1,37,1219,604,615
050,51,069,"Virginia","Frederick County",1,38,1211,603,608
050,51,069,"Virginia","Frederick County",1,39,1226,611,615
050,51,069,"Virginia","Frederick County",1,40,1206,615,591
050,51,069,"Virginia","Frederick County",1,41,1169,587,582
050,51,069,"Virginia","Frederick County",1,42,1166,583,583
050,51,069,"Virginia","Frederick County",1,43,1084,526,558
050,51,069,"Virginia","Frederick County",1,44,1023,528,495
050,51,069,"Virginia","Frederick County",1,45,1041,540,501
050,51,069,"Virginia","Frederick County",1,46,1053,543,510
050,51,069,"Virginia","Frederick County",1,47,1098,571,527
050,51,069,"Virginia","Frederick County",1,48,1211,595,616
050,51,069,"Virginia","Frederick County",1,49,1317,660,657
050,51,069,"Virginia","Frederick County",1,50,1266,648,618
050,51,069,"Virginia","Frederick County",1,51,1238,620,618
050,51,069,"Virginia","Frederick County",1,52,1234,623,611
050,51,069,"Virginia","Frederick County",1,53,1292,679,613
050,51,069,"Virginia","Frederick County",1,54,1315,671,644
050,51,069,"Virginia","Frederick County",1,55,1359,657,702
050,51,069,"Virginia","Frederick County",1,56,1369,680,689
050,51,069,"Virginia","Frederick County",1,57,1347,686,661
050,51,069,"Virginia","Frederick County",1,58,1315,678,637
050,51,069,"Virginia","Frederick County",1,59,1263,639,624
050,51,069,"Virginia","Frederick County",1,60,1281,640,641
050,51,069,"Virginia","Frederick County",1,61,1242,597,645
050,51,069,"Virginia","Frederick County",1,62,1207,577,630
050,51,069,"Virginia","Frederick County",1,63,1178,578,600
050,51,069,"Virginia","Frederick County",1,64,1123,556,567
050,51,069,"Virginia","Frederick County",1,65,1099,556,543
050,51,069,"Virginia","Frederick County",1,66,1035,507,528
050,51,069,"Virginia","Frederick County",1,67,1022,497,525
050,51,069,"Virginia","Frederick County",1,68,957,476,481
050,51,069,"Virginia","Frederick County",1,69,944,435,509
050,51,069,"Virginia","Frederick County",1,70,942,439,503
050,51,069,"Virginia","Frederick County",1,71,919,427,492
050,51,069,"Virginia","Frederick County",1,72,947,445,502
050,51,069,"Virginia","Frederick County",1,73,972,464,508
050,51,069,"Virginia","Frederick County",1,74,661,341,320
050,51,069,"Virginia","Frederick County",1,75,662,324,338
050,51,069,"Virginia","Frederick County",1,76,657,312,345
050,51,069,"Virginia","Frederick County",1,77,636,294,342
050,51,069,"Virginia","Frederick County",1,78,555,262,293
050,51,069,"Virginia","Frederick County",1,79,513,235,278
050,51,069,"Virginia","Frederick County",1,80,429,189,240
050,51,069,"Virginia","Frederick County",1,81,431,191,240
050,51,069,"Virginia","Frederick County",1,82,391,178,213
050,51,069,"Virginia","Frederick County",1,83,330,152,178
050,51,069,"Virginia","Frederick County",1,84,314,143,171
050,51,069,"Virginia","Frederick County",1,85,1682,673,1009
050,51,069,"Virginia","Frederick County",2,0,966,500,466
050,51,069,"Virginia","Frederick County",2,1,991,517,474
050,51,069,"Virginia","Frederick County",2,2,1058,540,518
050,51,069,"Virginia","Frederick County",2,3,1083,559,524
050,51,069,"Virginia","Frederick County",2,4,1145,599,546
050,51,069,"Virginia","Frederick County",2,5,1160,600,560
050,51,069,"Virginia","Frederick County",2,6,1173,609,564
050,51,069,"Virginia","Frederick County",2,7,1194,601,593
050,51,069,"Virginia","Frederick County",2,8,1157,582,575
050,51,069,"Virginia","Frederick County",2,9,1152,577,575
050,51,069,"Virginia","Frederick County",2,10,1177,611,566
050,51,069,"Virginia","Frederick County",2,11,1244,647,597
050,51,069,"Virginia","Frederick County",2,12,1314,683,631
050,51,069,"Virginia","Frederick County",2,13,1310,684,626
050,51,069,"Virginia","Frederick County",2,14,1302,680,622
050,51,069,"Virginia","Frederick County",2,15,1264,667,597
050,51,069,"Virginia","Frederick County",2,16,1306,673,633
050,51,069,"Virginia","Frederick County",2,17,1273,652,621
050,51,069,"Virginia","Frederick County",2,18,1065,571,494
050,51,069,"Virginia","Frederick County",2,19,891,472,419
050,51,069,"Virginia","Frederick County",2,20,963,507,456
050,51,069,"Virginia","Frederick County",2,21,992,528,464
050,51,069,"Virginia","Frederick County",2,22,972,496,476
050,51,069,"Virginia","Frederick County",2,23,960,469,491
050,51,069,"Virginia","Frederick County",2,24,977,479,498
050,51,069,"Virginia","Frederick County",2,25,1020,507,513
050,51,069,"Virginia","Frederick County",2,26,1019,514,505
050,51,069,"Virginia","Frederick County",2,27,1060,535,525
050,51,069,"Virginia","Frederick County",2,28,1095,553,542
050,51,069,"Virginia","Frederick County",2,29,1124,566,558
050,51,069,"Virginia","Frederick County",2,30,1120,559,561
050,51,069,"Virginia","Frederick County",2,31,1123,538,585
050,51,069,"Virginia","Frederick County",2,32,1156,576,580
050,51,069,"Virginia","Frederick County",2,33,1155,588,567
050,51,069,"Virginia","Frederick County",2,34,1171,599,572
050,51,069,"Virginia","Frederick County",2,35,1161,586,575
050,51,069,"Virginia","Frederick County",2,36,1152,570,582
050,51,069,"Virginia","Frederick County",2,37,1210,602,608
050,51,069,"Virginia","Frederick County",2,38,1218,604,614
050,51,069,"Virginia","Frederick County",2,39,1225,612,613
050,51,069,"Virginia","Frederick County",2,40,1225,622,603
050,51,069,"Virginia","Frederick County",2,41,1182,595,587
050,51,069,"Virginia","Frederick County",2,42,1166,585,581
050,51,069,"Virginia","Frederick County",2,43,1113,545,568
050,51,069,"Virginia","Frederick County",2,44,1031,523,508
050,51,069,"Virginia","Frederick County",2,45,1041,538,503
050,51,069,"Virginia","Frederick County",2,46,1050,542,508
050,51,069,"Virginia","Frederick County",2,47,1086,565,521
050,51,069,"Virginia","Frederick County",2,48,1185,591,594
050,51,069,"Virginia","Frederick County",2,49,1303,652,651
050,51,069,"Virginia","Frederick County",2,50,1281,650,631
050,51,069,"Virginia","Frederick County",2,51,1241,624,617
050,51,069,"Virginia","Frederick County",2,52,1234,625,609
050,51,069,"Virginia","Frederick County",2,53,1272,661,611
050,51,069,"Virginia","Frederick County",2,54,1308,670,638
050,51,069,"Virginia","Frederick County",2,55,1348,658,690
050,51,069,"Virginia","Frederick County",2,56,1375,677,698
050,51,069,"Virginia","Frederick County",2,57,1353,683,670
050,51,069,"Virginia","Frederick County",2,58,1317,673,644
050,51,069,"Virginia","Frederick County",2,59,1281,651,630
050,51,069,"Virginia","Frederick County",2,60,1273,637,636
050,51,069,"Virginia","Frederick County",2,61,1248,606,642
050,51,069,"Virginia","Frederick County",2,62,1216,579,637
050,51,069,"Virginia","Frederick County",2,63,1205,586,619
050,51,069,"Virginia","Frederick County",2,64,1136,559,577
050,51,069,"Virginia","Frederick County",2,65,1108,557,551
050,51,069,"Virginia","Frederick County",2,66,1060,523,537
050,51,069,"Virginia","Frederick County",2,67,1026,500,526
050,51,069,"Virginia","Frederick County",2,68,966,479,487
050,51,069,"Virginia","Frederick County",2,69,961,451,510
050,51,069,"Virginia","Frederick County",2,70,941,436,505
050,51,069,"Virginia","Frederick County",2,71,928,430,498
050,51,069,"Virginia","Frederick County",2,72,926,432,494
050,51,069,"Virginia","Frederick County",2,73,1017,485,532
050,51,069,"Virginia","Frederick County",2,74,689,345,344
050,51,069,"Virginia","Frederick County",2,75,664,328,336
050,51,069,"Virginia","Frederick County",2,76,656,314,342
050,51,069,"Virginia","Frederick County",2,77,654,307,347
050,51,069,"Virginia","Frederick County",2,78,563,264,299
050,51,069,"Virginia","Frederick County",2,79,516,235,281
050,51,069,"Virginia","Frederick County",2,80,446,200,246
050,51,069,"Virginia","Frederick County",2,81,422,188,234
050,51,069,"Virginia","Frederick County",2,82,398,177,221
050,51,069,"Virginia","Frederick County",2,83,338,155,183
050,51,069,"Virginia","Frederick County",2,84,319,145,174
050,51,069,"Virginia","Frederick County",2,85,1704,688,1016
050,51,069,"Virginia","Frederick County",3,0,921,473,448
050,51,069,"Virginia","Frederick County",3,1,1019,509,510
050,51,069,"Virginia","Frederick County",3,2,1046,538,508
050,51,069,"Virginia","Frederick County",3,3,1127,573,554
050,51,069,"Virginia","Frederick County",3,4,1142,573,569
050,51,069,"Virginia","Frederick County",3,5,1215,646,569
050,51,069,"Virginia","Frederick County",3,6,1185,601,584
050,51,069,"Virginia","Frederick County",3,7,1193,624,569
050,51,069,"Virginia","Frederick County",3,8,1228,609,619
050,51,069,"Virginia","Frederick County",3,9,1202,605,597
050,51,069,"Virginia","Frederick County",3,10,1198,610,588
050,51,069,"Virginia","Frederick County",3,11,1214,641,573
050,51,069,"Virginia","Frederick County",3,12,1252,643,609
050,51,069,"Virginia","Frederick County",3,13,1345,713,632
050,51,069,"Virginia","Frederick County",3,14,1350,696,654
050,51,069,"Virginia","Frederick County",3,15,1329,698,631
050,51,069,"Virginia","Frederick County",3,16,1323,711,612
050,51,069,"Virginia","Frederick County",3,17,1325,674,651
050,51,069,"Virginia","Frederick County",3,18,1120,595,525
050,51,069,"Virginia","Frederick County",3,19,900,476,424
050,51,069,"Virginia","Frederick County",3,20,1024,533,491
050,51,069,"Virginia","Frederick County",3,21,1029,540,489
050,51,069,"Virginia","Frederick County",3,22,1002,518,484
050,51,069,"Virginia","Frederick County",3,23,1029,512,517
050,51,069,"Virginia","Frederick County",3,24,1013,504,509
050,51,069,"Virginia","Frederick County",3,25,963,485,478
050,51,069,"Virginia","Frederick County",3,26,1040,506,534
050,51,069,"Virginia","Frederick County",3,27,1066,556,510
050,51,069,"Virginia","Frederick County",3,28,1113,576,537
050,51,069,"Virginia","Frederick County",3,29,1127,567,560
050,51,069,"Virginia","Frederick County",3,30,1142,563,579
050,51,069,"Virginia","Frederick County",3,31,1194,606,588
050,51,069,"Virginia","Frederick County",3,32,1160,559,601
050,51,069,"Virginia","Frederick County",3,33,1206,605,601
050,51,069,"Virginia","Frederick County",3,34,1191,599,592
050,51,069,"Virginia","Frederick County",3,35,1200,612,588
050,51,069,"Virginia","Frederick County",3,36,1209,598,611
050,51,069,"Virginia","Frederick County",3,37,1217,613,604
050,51,069,"Virginia","Frederick County",3,38,1225,610,615
050,51,069,"Virginia","Frederick County",3,39,1264,632,632
050,51,069,"Virginia","Frederick County",3,40,1227,632,595
050,51,069,"Virginia","Frederick County",3,41,1244,643,601
050,51,069,"Virginia","Frederick County",3,42,1223,620,603
050,51,069,"Virginia","Frederick County",3,43,1188,595,593
050,51,069,"Virginia","Frederick County",3,44,1124,552,572
050,51,069,"Virginia","Frederick County",3,45,1057,544,513
050,51,069,"Virginia","Frederick County",3,46,1069,548,521
050,51,069,"Virginia","Frederick County",3,47,1071,549,522
050,51,069,"Virginia","Frederick County",3,48,1113,580,533
050,51,069,"Virginia","Frederick County",3,49,1198,596,602
050,51,069,"Virginia","Frederick County",3,50,1300,647,653
050,51,069,"Virginia","Frederick County",3,51,1302,657,645
050,51,069,"Virginia","Frederick County",3,52,1272,640,632
050,51,069,"Virginia","Frederick County",3,53,1241,632,609
050,51,069,"Virginia","Frederick County",3,54,1279,663,616
050,51,069,"Virginia","Frederick County",3,55,1319,673,646
050,51,069,"Virginia","Frederick County",3,56,1355,663,692
050,51,069,"Virginia","Frederick County",3,57,1375,679,696
050,51,069,"Virginia","Frederick County",3,58,1357,676,681
050,51,069,"Virginia","Frederick County",3,59,1324,681,643
050,51,069,"Virginia","Frederick County",3,60,1280,641,639
050,51,069,"Virginia","Frederick County",3,61,1285,648,637
050,51,069,"Virginia","Frederick County",3,62,1238,596,642
050,51,069,"Virginia","Frederick County",3,63,1236,588,648
050,51,069,"Virginia","Frederick County",3,64,1206,569,637
050,51,069,"Virginia","Frederick County",3,65,1175,569,606
050,51,069,"Virginia","Frederick County",3,66,1137,573,564
050,51,069,"Virginia","Frederick County",3,67,1052,520,532
050,51,069,"Virginia","Frederick County",3,68,1037,506,531
050,51,069,"Virginia","Frederick County",3,69,982,492,490
050,51,069,"Virginia","Frederick County",3,70,960,449,511
050,51,069,"Virginia","Frederick County",3,71,945,434,511
050,51,069,"Virginia","Frederick County",3,72,936,437,499
050,51,069,"Virginia","Frederick County",3,73,933,442,491
050,51,069,"Virginia","Frederick County",3,74,990,470,520
050,51,069,"Virginia","Frederick County",3,75,666,332,334
050,51,069,"Virginia","Frederick County",3,76,667,320,347
050,51,069,"Virginia","Frederick County",3,77,630,305,325
050,51,069,"Virginia","Frederick County",3,78,641,300,341
050,51,069,"Virginia","Frederick County",3,79,545,249,296
050,51,069,"Virginia","Frederick County",3,80,487,223,264
050,51,069,"Virginia","Frederick County",3,81,430,183,247
050,51,069,"Virginia","Frederick County",3,82,391,172,219
050,51,069,"Virginia","Frederick County",3,83,362,157,205
050,51,069,"Virginia","Frederick County",3,84,330,155,175
050,51,069,"Virginia","Frederick County",3,85,1732,697,1035
050,51,069,"Virginia","Frederick County",4,0,898,470,428
050,51,069,"Virginia","Frederick County",4,1,993,493,500
050,51,069,"Virginia","Frederick County",4,2,1073,553,520
050,51,069,"Virginia","Frederick County",4,3,1120,566,554
050,51,069,"Virginia","Frederick County",4,4,1129,570,559
050,51,069,"Virginia","Frederick County",4,5,1112,561,551
050,51,069,"Virginia","Frederick County",4,6,1239,662,577
050,51,069,"Virginia","Frederick County",4,7,1191,608,583
050,51,069,"Virginia","Frederick County",4,8,1231,655,576
050,51,069,"Virginia","Frederick County",4,9,1227,603,624
050,51,069,"Virginia","Frederick County",4,10,1215,608,607
050,51,069,"Virginia","Frederick County",4,11,1209,624,585
050,51,069,"Virginia","Frederick County",4,12,1224,646,578
050,51,069,"Virginia","Frederick County",4,13,1268,646,622
050,51,069,"Virginia","Frederick County",4,14,1359,721,638
050,51,069,"Virginia","Frederick County",4,15,1363,712,651
050,51,069,"Virginia","Frederick County",4,16,1333,694,639
050,51,069,"Virginia","Frederick County",4,17,1315,695,620
050,51,069,"Virginia","Frederick County",4,18,1156,605,551
050,51,069,"Virginia","Frederick County",4,19,904,488,416
050,51,069,"Virginia","Frederick County",4,20,980,517,463
050,51,069,"Virginia","Frederick County",4,21,1033,546,487
050,51,069,"Virginia","Frederick County",4,22,1039,545,494
050,51,069,"Virginia","Frederick County",4,23,995,511,484
050,51,069,"Virginia","Frederick County",4,24,1015,502,513
050,51,069,"Virginia","Frederick County",4,25,1024,515,509
050,51,069,"Virginia","Frederick County",4,26,944,464,480
050,51,069,"Virginia","Frederick County",4,27,1062,519,543
050,51,069,"Virginia","Frederick County",4,28,1075,585,490
050,51,069,"Virginia","Frederick County",4,29,1149,602,547
050,51,069,"Virginia","Frederick County",4,30,1151,592,559
050,51,069,"Virginia","Frederick County",4,31,1176,576,600
050,51,069,"Virginia","Frederick County",4,32,1234,622,612
050,51,069,"Virginia","Frederick County",4,33,1181,572,609
050,51,069,"Virginia","Frederick County",4,34,1243,613,630
050,51,069,"Virginia","Frederick County",4,35,1243,651,592
050,51,069,"Virginia","Frederick County",4,36,1211,619,592
050,51,069,"Virginia","Frederick County",4,37,1222,621,601
050,51,069,"Virginia","Frederick County",4,38,1259,640,619
050,51,069,"Virginia","Frederick County",4,39,1235,618,617
050,51,069,"Virginia","Frederick County",4,40,1288,650,638
050,51,069,"Virginia","Frederick County",4,41,1250,647,603
050,51,069,"Virginia","Frederick County",4,42,1244,638,606
050,51,069,"Virginia","Frederick County",4,43,1254,634,620
050,51,069,"Virginia","Frederick County",4,44,1196,590,606
050,51,069,"Virginia","Frederick County",4,45,1131,553,578
050,51,069,"Virginia","Frederick County",4,46,1075,554,521
050,51,069,"Virginia","Frederick County",4,47,1076,553,523
050,51,069,"Virginia","Frederick County",4,48,1069,549,520
050,51,069,"Virginia","Frederick County",4,49,1094,566,528
050,51,069,"Virginia","Frederick County",4,50,1215,599,616
050,51,069,"Virginia","Frederick County",4,51,1294,632,662
050,51,069,"Virginia","Frederick County",4,52,1292,658,634
050,51,069,"Virginia","Frederick County",4,53,1244,622,622
050,51,069,"Virginia","Frederick County",4,54,1249,644,605
050,51,069,"Virginia","Frederick County",4,55,1273,654,619
050,51,069,"Virginia","Frederick County",4,56,1308,665,643
050,51,069,"Virginia","Frederick County",4,57,1364,665,699
050,51,069,"Virginia","Frederick County",4,58,1380,690,690
050,51,069,"Virginia","Frederick County",4,59,1354,668,686
050,51,069,"Virginia","Frederick County",4,60,1316,670,646
050,51,069,"Virginia","Frederick County",4,61,1295,645,650
050,51,069,"Virginia","Frederick County",4,62,1279,633,646
050,51,069,"Virginia","Frederick County",4,63,1237,593,644
050,51,069,"Virginia","Frederick County",4,64,1223,568,655
050,51,069,"Virginia","Frederick County",4,65,1223,564,659
050,51,069,"Virginia","Frederick County",4,66,1170,560,610
050,51,069,"Virginia","Frederick County",4,67,1164,582,582
050,51,069,"Virginia","Frederick County",4,68,1071,535,536
050,51,069,"Virginia","Frederick County",4,69,1039,495,544
050,51,069,"Virginia","Frederick County",4,70,994,489,505
050,51,069,"Virginia","Frederick County",4,71,943,445,498
050,51,069,"Virginia","Frederick County",4,72,939,432,507
050,51,069,"Virginia","Frederick County",4,73,938,444,494
050,51,069,"Virginia","Frederick County",4,74,924,442,482
050,51,069,"Virginia","Frederick County",4,75,978,461,517
050,51,069,"Virginia","Frederick County",4,76,659,327,332
050,51,069,"Virginia","Frederick County",4,77,633,308,325
050,51,069,"Virginia","Frederick County",4,78,614,294,320
050,51,069,"Virginia","Frederick County",4,79,616,280,336
050,51,069,"Virginia","Frederick County",4,80,517,240,277
050,51,069,"Virginia","Frederick County",4,81,483,212,271
050,51,069,"Virginia","Frederick County",4,82,420,178,242
050,51,069,"Virginia","Frederick County",4,83,367,163,204
050,51,069,"Virginia","Frederick County",4,84,343,145,198
050,51,069,"Virginia","Frederick County",4,85,1743,713,1030
050,51,069,"Virginia","Frederick County",5,0,893,466,427
050,51,069,"Virginia","Frederick County",5,1,949,496,453
050,51,069,"Virginia","Frederick County",5,2,1030,512,518
050,51,069,"Virginia","Frederick County",5,3,1097,556,541
050,51,069,"Virginia","Frederick County",5,4,1152,579,573
050,51,069,"Virginia","Frederick County",5,5,1153,585,568
050,51,069,"Virginia","Frederick County",5,6,1148,579,569
050,51,069,"Virginia","Frederick County",5,7,1251,657,594
050,51,069,"Virginia","Frederick County",5,8,1206,615,591
050,51,069,"Virginia","Frederick County",5,9,1281,683,598
050,51,069,"Virginia","Frederick County",5,10,1223,606,617
050,51,069,"Virginia","Frederick County",5,11,1234,636,598
050,51,069,"Virginia","Frederick County",5,12,1247,632,615
050,51,069,"Virginia","Frederick County",5,13,1239,641,598
050,51,069,"Virginia","Frederick County",5,14,1268,656,612
050,51,069,"Virginia","Frederick County",5,15,1360,724,636
050,51,069,"Virginia","Frederick County",5,16,1379,726,653
050,51,069,"Virginia","Frederick County",5,17,1329,698,631
050,51,069,"Virginia","Frederick County",5,18,1135,623,512
050,51,069,"Virginia","Frederick County",5,19,957,500,457
050,51,069,"Virginia","Frederick County",5,20,999,525,474
050,51,069,"Virginia","Frederick County",5,21,1050,549,501
050,51,069,"Virginia","Frederick County",5,22,1039,528,511
050,51,069,"Virginia","Frederick County",5,23,1051,538,513
050,51,069,"Virginia","Frederick County",5,24,1003,506,497
050,51,069,"Virginia","Frederick County",5,25,1037,519,518
050,51,069,"Virginia","Frederick County",5,26,986,493,493
050,51,069,"Virginia","Frederick County",5,27,969,482,487
050,51,069,"Virginia","Frederick County",5,28,1069,527,542
050,51,069,"Virginia","Frederick County",5,29,1089,587,502
050,51,069,"Virginia","Frederick County",5,30,1158,611,547
050,51,069,"Virginia","Frederick County",5,31,1204,603,601
050,51,069,"Virginia","Frederick County",5,32,1212,589,623
050,51,069,"Virginia","Frederick County",5,33,1245,646,599
050,51,069,"Virginia","Frederick County",5,34,1216,595,621
050,51,069,"Virginia","Frederick County",5,35,1290,634,656
050,51,069,"Virginia","Frederick County",5,36,1262,645,617
050,51,069,"Virginia","Frederick County",5,37,1235,632,603
050,51,069,"Virginia","Frederick County",5,38,1239,642,597
050,51,069,"Virginia","Frederick County",5,39,1266,644,622
050,51,069,"Virginia","Frederick County",5,40,1278,645,633
050,51,069,"Virginia","Frederick County",5,41,1368,704,664
050,51,069,"Virginia","Frederick County",5,42,1277,653,624
050,51,069,"Virginia","Frederick County",5,43,1270,656,614
050,51,069,"Virginia","Frederick County",5,44,1257,624,633
050,51,069,"Virginia","Frederick County",5,45,1198,580,618
050,51,069,"Virginia","Frederick County",5,46,1168,575,593
050,51,069,"Virginia","Frederick County",5,47,1103,570,533
050,51,069,"Virginia","Frederick County",5,48,1096,560,536
050,51,069,"Virginia","Frederick County",5,49,1082,565,517
050,51,069,"Virginia","Frederick County",5,50,1109,562,547
050,51,069,"Virginia","Frederick County",5,51,1204,587,617
050,51,069,"Virginia","Frederick County",5,52,1295,652,643
050,51,069,"Virginia","Frederick County",5,53,1280,656,624
050,51,069,"Virginia","Frederick County",5,54,1243,625,618
050,51,069,"Virginia","Frederick County",5,55,1213,621,592
050,51,069,"Virginia","Frederick County",5,56,1261,648,613
050,51,069,"Virginia","Frederick County",5,57,1320,670,650
050,51,069,"Virginia","Frederick County",5,58,1358,657,701
050,51,069,"Virginia","Frederick County",5,59,1418,715,703
050,51,069,"Virginia","Frederick County",5,60,1337,655,682
050,51,069,"Virginia","Frederick County",5,61,1333,679,654
050,51,069,"Virginia","Frederick County",5,62,1309,651,658
050,51,069,"Virginia","Frederick County",5,63,1272,618,654
050,51,069,"Virginia","Frederick County",5,64,1238,592,646
050,51,069,"Virginia","Frederick County",5,65,1244,573,671
050,51,069,"Virginia","Frederick County",5,66,1222,561,661
050,51,069,"Virginia","Frederick County",5,67,1183,564,619
050,51,069,"Virginia","Frederick County",5,68,1142,574,568
050,51,069,"Virginia","Frederick County",5,69,1079,530,549
050,51,069,"Virginia","Frederick County",5,70,1035,485,550
050,51,069,"Virginia","Frederick County",5,71,1001,490,511
050,51,069,"Virginia","Frederick County",5,72,936,445,491
050,51,069,"Virginia","Frederick County",5,73,931,435,496
050,51,069,"Virginia","Frederick County",5,74,918,429,489
050,51,069,"Virginia","Frederick County",5,75,922,439,483
050,51,069,"Virginia","Frederick County",5,76,974,454,520
050,51,069,"Virginia","Frederick County",5,77,636,311,325
050,51,069,"Virginia","Frederick County",5,78,636,308,328
050,51,069,"Virginia","Frederick County",5,79,605,290,315
050,51,069,"Virginia","Frederick County",5,80,585,264,321
050,51,069,"Virginia","Frederick County",5,81,512,230,282
050,51,069,"Virginia","Frederick County",5,82,457,202,255
050,51,069,"Virginia","Frederick County",5,83,387,163,224
050,51,069,"Virginia","Frederick County",5,84,345,152,193
050,51,069,"Virginia","Frederick County",5,85,1807,745,1062
050,51,071,"Virginia","Giles County",1,0,149,75,74
050,51,071,"Virginia","Giles County",1,1,157,75,82
050,51,071,"Virginia","Giles County",1,2,160,77,83
050,51,071,"Virginia","Giles County",1,3,179,104,75
050,51,071,"Virginia","Giles County",1,4,201,100,101
050,51,071,"Virginia","Giles County",1,5,175,78,97
050,51,071,"Virginia","Giles County",1,6,181,89,92
050,51,071,"Virginia","Giles County",1,7,190,101,89
050,51,071,"Virginia","Giles County",1,8,186,97,89
050,51,071,"Virginia","Giles County",1,9,203,102,101
050,51,071,"Virginia","Giles County",1,10,201,102,99
050,51,071,"Virginia","Giles County",1,11,189,90,99
050,51,071,"Virginia","Giles County",1,12,188,102,86
050,51,071,"Virginia","Giles County",1,13,202,107,95
050,51,071,"Virginia","Giles County",1,14,191,88,103
050,51,071,"Virginia","Giles County",1,15,208,104,104
050,51,071,"Virginia","Giles County",1,16,209,103,106
050,51,071,"Virginia","Giles County",1,17,240,119,121
050,51,071,"Virginia","Giles County",1,18,193,105,88
050,51,071,"Virginia","Giles County",1,19,149,75,74
050,51,071,"Virginia","Giles County",1,20,156,89,67
050,51,071,"Virginia","Giles County",1,21,168,84,84
050,51,071,"Virginia","Giles County",1,22,165,80,85
050,51,071,"Virginia","Giles County",1,23,180,96,84
050,51,071,"Virginia","Giles County",1,24,187,105,82
050,51,071,"Virginia","Giles County",1,25,182,93,89
050,51,071,"Virginia","Giles County",1,26,181,89,92
050,51,071,"Virginia","Giles County",1,27,175,87,88
050,51,071,"Virginia","Giles County",1,28,201,102,99
050,51,071,"Virginia","Giles County",1,29,199,99,100
050,51,071,"Virginia","Giles County",1,30,220,106,114
050,51,071,"Virginia","Giles County",1,31,200,98,102
050,51,071,"Virginia","Giles County",1,32,188,102,86
050,51,071,"Virginia","Giles County",1,33,162,90,72
050,51,071,"Virginia","Giles County",1,34,178,95,83
050,51,071,"Virginia","Giles County",1,35,160,80,80
050,51,071,"Virginia","Giles County",1,36,161,84,77
050,51,071,"Virginia","Giles County",1,37,194,100,94
050,51,071,"Virginia","Giles County",1,38,198,106,92
050,51,071,"Virginia","Giles County",1,39,168,87,81
050,51,071,"Virginia","Giles County",1,40,193,91,102
050,51,071,"Virginia","Giles County",1,41,181,86,95
050,51,071,"Virginia","Giles County",1,42,200,102,98
050,51,071,"Virginia","Giles County",1,43,191,100,91
050,51,071,"Virginia","Giles County",1,44,187,88,99
050,51,071,"Virginia","Giles County",1,45,206,102,104
050,51,071,"Virginia","Giles County",1,46,216,107,109
050,51,071,"Virginia","Giles County",1,47,231,119,112
050,51,071,"Virginia","Giles County",1,48,232,122,110
050,51,071,"Virginia","Giles County",1,49,248,138,110
050,51,071,"Virginia","Giles County",1,50,250,126,124
050,51,071,"Virginia","Giles County",1,51,244,106,138
050,51,071,"Virginia","Giles County",1,52,242,121,121
050,51,071,"Virginia","Giles County",1,53,243,122,121
050,51,071,"Virginia","Giles County",1,54,266,127,139
050,51,071,"Virginia","Giles County",1,55,278,152,126
050,51,071,"Virginia","Giles County",1,56,266,138,128
050,51,071,"Virginia","Giles County",1,57,253,136,117
050,51,071,"Virginia","Giles County",1,58,262,129,133
050,51,071,"Virginia","Giles County",1,59,238,123,115
050,51,071,"Virginia","Giles County",1,60,225,122,103
050,51,071,"Virginia","Giles County",1,61,240,123,117
050,51,071,"Virginia","Giles County",1,62,233,116,117
050,51,071,"Virginia","Giles County",1,63,225,104,121
050,51,071,"Virginia","Giles County",1,64,224,102,122
050,51,071,"Virginia","Giles County",1,65,208,91,117
050,51,071,"Virginia","Giles County",1,66,228,108,120
050,51,071,"Virginia","Giles County",1,67,229,119,110
050,51,071,"Virginia","Giles County",1,68,227,112,115
050,51,071,"Virginia","Giles County",1,69,215,103,112
050,51,071,"Virginia","Giles County",1,70,224,107,117
050,51,071,"Virginia","Giles County",1,71,201,99,102
050,51,071,"Virginia","Giles County",1,72,214,100,114
050,51,071,"Virginia","Giles County",1,73,229,112,117
050,51,071,"Virginia","Giles County",1,74,154,67,87
050,51,071,"Virginia","Giles County",1,75,167,82,85
050,51,071,"Virginia","Giles County",1,76,162,81,81
050,51,071,"Virginia","Giles County",1,77,156,80,76
050,51,071,"Virginia","Giles County",1,78,140,68,72
050,51,071,"Virginia","Giles County",1,79,108,45,63
050,51,071,"Virginia","Giles County",1,80,106,50,56
050,51,071,"Virginia","Giles County",1,81,94,48,46
050,51,071,"Virginia","Giles County",1,82,86,42,44
050,51,071,"Virginia","Giles County",1,83,69,25,44
050,51,071,"Virginia","Giles County",1,84,62,22,40
050,51,071,"Virginia","Giles County",1,85,365,109,256
050,51,071,"Virginia","Giles County",2,0,151,74,77
050,51,071,"Virginia","Giles County",2,1,153,74,79
050,51,071,"Virginia","Giles County",2,2,159,77,82
050,51,071,"Virginia","Giles County",2,3,173,97,76
050,51,071,"Virginia","Giles County",2,4,197,103,94
050,51,071,"Virginia","Giles County",2,5,181,83,98
050,51,071,"Virginia","Giles County",2,6,178,85,93
050,51,071,"Virginia","Giles County",2,7,188,97,91
050,51,071,"Virginia","Giles County",2,8,188,98,90
050,51,071,"Virginia","Giles County",2,9,198,101,97
050,51,071,"Virginia","Giles County",2,10,202,102,100
050,51,071,"Virginia","Giles County",2,11,192,93,99
050,51,071,"Virginia","Giles County",2,12,189,99,90
050,51,071,"Virginia","Giles County",2,13,198,105,93
050,51,071,"Virginia","Giles County",2,14,194,93,101
050,51,071,"Virginia","Giles County",2,15,203,100,103
050,51,071,"Virginia","Giles County",2,16,210,104,106
050,51,071,"Virginia","Giles County",2,17,232,115,117
050,51,071,"Virginia","Giles County",2,18,192,102,90
050,51,071,"Virginia","Giles County",2,19,151,78,73
050,51,071,"Virginia","Giles County",2,20,160,87,73
050,51,071,"Virginia","Giles County",2,21,169,87,82
050,51,071,"Virginia","Giles County",2,22,169,82,87
050,51,071,"Virginia","Giles County",2,23,181,95,86
050,51,071,"Virginia","Giles County",2,24,187,103,84
050,51,071,"Virginia","Giles County",2,25,185,96,89
050,51,071,"Virginia","Giles County",2,26,184,90,94
050,51,071,"Virginia","Giles County",2,27,177,87,90
050,51,071,"Virginia","Giles County",2,28,195,99,96
050,51,071,"Virginia","Giles County",2,29,198,100,98
050,51,071,"Virginia","Giles County",2,30,215,105,110
050,51,071,"Virginia","Giles County",2,31,203,100,103
050,51,071,"Virginia","Giles County",2,32,192,101,91
050,51,071,"Virginia","Giles County",2,33,170,94,76
050,51,071,"Virginia","Giles County",2,34,174,94,80
050,51,071,"Virginia","Giles County",2,35,165,84,81
050,51,071,"Virginia","Giles County",2,36,159,83,76
050,51,071,"Virginia","Giles County",2,37,188,97,91
050,51,071,"Virginia","Giles County",2,38,198,105,93
050,51,071,"Virginia","Giles County",2,39,174,90,84
050,51,071,"Virginia","Giles County",2,40,188,90,98
050,51,071,"Virginia","Giles County",2,41,182,86,96
050,51,071,"Virginia","Giles County",2,42,195,97,98
050,51,071,"Virginia","Giles County",2,43,196,102,94
050,51,071,"Virginia","Giles County",2,44,186,90,96
050,51,071,"Virginia","Giles County",2,45,202,100,102
050,51,071,"Virginia","Giles County",2,46,214,105,109
050,51,071,"Virginia","Giles County",2,47,225,115,110
050,51,071,"Virginia","Giles County",2,48,234,123,111
050,51,071,"Virginia","Giles County",2,49,246,136,110
050,51,071,"Virginia","Giles County",2,50,252,130,122
050,51,071,"Virginia","Giles County",2,51,244,110,134
050,51,071,"Virginia","Giles County",2,52,240,117,123
050,51,071,"Virginia","Giles County",2,53,243,121,122
050,51,071,"Virginia","Giles County",2,54,260,126,134
050,51,071,"Virginia","Giles County",2,55,274,144,130
050,51,071,"Virginia","Giles County",2,56,271,143,128
050,51,071,"Virginia","Giles County",2,57,258,135,123
050,51,071,"Virginia","Giles County",2,58,260,129,131
050,51,071,"Virginia","Giles County",2,59,245,126,119
050,51,071,"Virginia","Giles County",2,60,228,123,105
050,51,071,"Virginia","Giles County",2,61,239,125,114
050,51,071,"Virginia","Giles County",2,62,231,116,115
050,51,071,"Virginia","Giles County",2,63,227,108,119
050,51,071,"Virginia","Giles County",2,64,223,102,121
050,51,071,"Virginia","Giles County",2,65,208,92,116
050,51,071,"Virginia","Giles County",2,66,223,104,119
050,51,071,"Virginia","Giles County",2,67,227,115,112
050,51,071,"Virginia","Giles County",2,68,223,111,112
050,51,071,"Virginia","Giles County",2,69,220,106,114
050,51,071,"Virginia","Giles County",2,70,223,107,116
050,51,071,"Virginia","Giles County",2,71,204,99,105
050,51,071,"Virginia","Giles County",2,72,207,98,109
050,51,071,"Virginia","Giles County",2,73,235,113,122
050,51,071,"Virginia","Giles County",2,74,157,72,85
050,51,071,"Virginia","Giles County",2,75,165,78,87
050,51,071,"Virginia","Giles County",2,76,160,80,80
050,51,071,"Virginia","Giles County",2,77,161,82,79
050,51,071,"Virginia","Giles County",2,78,141,69,72
050,51,071,"Virginia","Giles County",2,79,112,49,63
050,51,071,"Virginia","Giles County",2,80,106,50,56
050,51,071,"Virginia","Giles County",2,81,91,44,47
050,51,071,"Virginia","Giles County",2,82,86,43,43
050,51,071,"Virginia","Giles County",2,83,71,28,43
050,51,071,"Virginia","Giles County",2,84,64,23,41
050,51,071,"Virginia","Giles County",2,85,367,109,258
050,51,071,"Virginia","Giles County",3,0,150,84,66
050,51,071,"Virginia","Giles County",3,1,140,72,68
050,51,071,"Virginia","Giles County",3,2,148,75,73
050,51,071,"Virginia","Giles County",3,3,156,81,75
050,51,071,"Virginia","Giles County",3,4,175,98,77
050,51,071,"Virginia","Giles County",3,5,192,96,96
050,51,071,"Virginia","Giles County",3,6,181,82,99
050,51,071,"Virginia","Giles County",3,7,176,87,89
050,51,071,"Virginia","Giles County",3,8,189,100,89
050,51,071,"Virginia","Giles County",3,9,185,96,89
050,51,071,"Virginia","Giles County",3,10,195,99,96
050,51,071,"Virginia","Giles County",3,11,198,100,98
050,51,071,"Virginia","Giles County",3,12,180,87,93
050,51,071,"Virginia","Giles County",3,13,189,100,89
050,51,071,"Virginia","Giles County",3,14,202,110,92
050,51,071,"Virginia","Giles County",3,15,190,93,97
050,51,071,"Virginia","Giles County",3,16,197,95,102
050,51,071,"Virginia","Giles County",3,17,215,105,110
050,51,071,"Virginia","Giles County",3,18,200,104,96
050,51,071,"Virginia","Giles County",3,19,152,83,69
050,51,071,"Virginia","Giles County",3,20,171,88,83
050,51,071,"Virginia","Giles County",3,21,164,86,78
050,51,071,"Virginia","Giles County",3,22,172,82,90
050,51,071,"Virginia","Giles County",3,23,174,84,90
050,51,071,"Virginia","Giles County",3,24,178,95,83
050,51,071,"Virginia","Giles County",3,25,189,104,85
050,51,071,"Virginia","Giles County",3,26,162,82,80
050,51,071,"Virginia","Giles County",3,27,180,85,95
050,51,071,"Virginia","Giles County",3,28,161,74,87
050,51,071,"Virginia","Giles County",3,29,200,105,95
050,51,071,"Virginia","Giles County",3,30,208,106,102
050,51,071,"Virginia","Giles County",3,31,224,108,116
050,51,071,"Virginia","Giles County",3,32,192,96,96
050,51,071,"Virginia","Giles County",3,33,194,98,96
050,51,071,"Virginia","Giles County",3,34,166,91,75
050,51,071,"Virginia","Giles County",3,35,182,100,82
050,51,071,"Virginia","Giles County",3,36,168,83,85
050,51,071,"Virginia","Giles County",3,37,159,87,72
050,51,071,"Virginia","Giles County",3,38,183,91,92
050,51,071,"Virginia","Giles County",3,39,195,109,86
050,51,071,"Virginia","Giles County",3,40,179,92,87
050,51,071,"Virginia","Giles County",3,41,187,89,98
050,51,071,"Virginia","Giles County",3,42,183,85,98
050,51,071,"Virginia","Giles County",3,43,192,98,94
050,51,071,"Virginia","Giles County",3,44,195,100,95
050,51,071,"Virginia","Giles County",3,45,179,87,92
050,51,071,"Virginia","Giles County",3,46,201,102,99
050,51,071,"Virginia","Giles County",3,47,204,98,106
050,51,071,"Virginia","Giles County",3,48,215,112,103
050,51,071,"Virginia","Giles County",3,49,241,130,111
050,51,071,"Virginia","Giles County",3,50,240,132,108
050,51,071,"Virginia","Giles County",3,51,247,129,118
050,51,071,"Virginia","Giles County",3,52,250,115,135
050,51,071,"Virginia","Giles County",3,53,237,116,121
050,51,071,"Virginia","Giles County",3,54,241,118,123
050,51,071,"Virginia","Giles County",3,55,258,121,137
050,51,071,"Virginia","Giles County",3,56,276,144,132
050,51,071,"Virginia","Giles County",3,57,275,140,135
050,51,071,"Virginia","Giles County",3,58,252,130,122
050,51,071,"Virginia","Giles County",3,59,268,131,137
050,51,071,"Virginia","Giles County",3,60,239,125,114
050,51,071,"Virginia","Giles County",3,61,231,124,107
050,51,071,"Virginia","Giles County",3,62,238,125,113
050,51,071,"Virginia","Giles County",3,63,230,112,118
050,51,071,"Virginia","Giles County",3,64,211,104,107
050,51,071,"Virginia","Giles County",3,65,216,106,110
050,51,071,"Virginia","Giles County",3,66,204,87,117
050,51,071,"Virginia","Giles County",3,67,225,109,116
050,51,071,"Virginia","Giles County",3,68,220,114,106
050,51,071,"Virginia","Giles County",3,69,220,111,109
050,51,071,"Virginia","Giles County",3,70,220,106,114
050,51,071,"Virginia","Giles County",3,71,213,103,110
050,51,071,"Virginia","Giles County",3,72,190,94,96
050,51,071,"Virginia","Giles County",3,73,205,96,109
050,51,071,"Virginia","Giles County",3,74,221,110,111
050,51,071,"Virginia","Giles County",3,75,145,64,81
050,51,071,"Virginia","Giles County",3,76,151,73,78
050,51,071,"Virginia","Giles County",3,77,152,74,78
050,51,071,"Virginia","Giles County",3,78,155,78,77
050,51,071,"Virginia","Giles County",3,79,131,65,66
050,51,071,"Virginia","Giles County",3,80,107,45,62
050,51,071,"Virginia","Giles County",3,81,101,47,54
050,51,071,"Virginia","Giles County",3,82,89,46,43
050,51,071,"Virginia","Giles County",3,83,70,34,36
050,51,071,"Virginia","Giles County",3,84,64,22,42
050,51,071,"Virginia","Giles County",3,85,372,111,261
050,51,071,"Virginia","Giles County",4,0,151,79,72
050,51,071,"Virginia","Giles County",4,1,163,97,66
050,51,071,"Virginia","Giles County",4,2,143,72,71
050,51,071,"Virginia","Giles County",4,3,150,72,78
050,51,071,"Virginia","Giles County",4,4,155,87,68
050,51,071,"Virginia","Giles County",4,5,171,94,77
050,51,071,"Virginia","Giles County",4,6,189,98,91
050,51,071,"Virginia","Giles County",4,7,183,88,95
050,51,071,"Virginia","Giles County",4,8,176,88,88
050,51,071,"Virginia","Giles County",4,9,193,100,93
050,51,071,"Virginia","Giles County",4,10,183,94,89
050,51,071,"Virginia","Giles County",4,11,194,98,96
050,51,071,"Virginia","Giles County",4,12,215,110,105
050,51,071,"Virginia","Giles County",4,13,186,90,96
050,51,071,"Virginia","Giles County",4,14,173,93,80
050,51,071,"Virginia","Giles County",4,15,195,112,83
050,51,071,"Virginia","Giles County",4,16,185,90,95
050,51,071,"Virginia","Giles County",4,17,197,101,96
050,51,071,"Virginia","Giles County",4,18,178,92,86
050,51,071,"Virginia","Giles County",4,19,154,81,73
050,51,071,"Virginia","Giles County",4,20,165,87,78
050,51,071,"Virginia","Giles County",4,21,173,92,81
050,51,071,"Virginia","Giles County",4,22,174,90,84
050,51,071,"Virginia","Giles County",4,23,173,87,86
050,51,071,"Virginia","Giles County",4,24,179,86,93
050,51,071,"Virginia","Giles County",4,25,176,98,78
050,51,071,"Virginia","Giles County",4,26,195,103,92
050,51,071,"Virginia","Giles County",4,27,171,87,84
050,51,071,"Virginia","Giles County",4,28,179,79,100
050,51,071,"Virginia","Giles County",4,29,169,84,85
050,51,071,"Virginia","Giles County",4,30,195,105,90
050,51,071,"Virginia","Giles County",4,31,205,99,106
050,51,071,"Virginia","Giles County",4,32,226,107,119
050,51,071,"Virginia","Giles County",4,33,188,92,96
050,51,071,"Virginia","Giles County",4,34,202,101,101
050,51,071,"Virginia","Giles County",4,35,172,93,79
050,51,071,"Virginia","Giles County",4,36,179,95,84
050,51,071,"Virginia","Giles County",4,37,167,84,83
050,51,071,"Virginia","Giles County",4,38,160,86,74
050,51,071,"Virginia","Giles County",4,39,177,88,89
050,51,071,"Virginia","Giles County",4,40,195,106,89
050,51,071,"Virginia","Giles County",4,41,175,91,84
050,51,071,"Virginia","Giles County",4,42,186,88,98
050,51,071,"Virginia","Giles County",4,43,187,89,98
050,51,071,"Virginia","Giles County",4,44,182,93,89
050,51,071,"Virginia","Giles County",4,45,183,96,87
050,51,071,"Virginia","Giles County",4,46,181,89,92
050,51,071,"Virginia","Giles County",4,47,196,98,98
050,51,071,"Virginia","Giles County",4,48,210,101,109
050,51,071,"Virginia","Giles County",4,49,220,114,106
050,51,071,"Virginia","Giles County",4,50,238,128,110
050,51,071,"Virginia","Giles County",4,51,242,126,116
050,51,071,"Virginia","Giles County",4,52,248,130,118
050,51,071,"Virginia","Giles County",4,53,249,117,132
050,51,071,"Virginia","Giles County",4,54,239,116,123
050,51,071,"Virginia","Giles County",4,55,231,115,116
050,51,071,"Virginia","Giles County",4,56,257,119,138
050,51,071,"Virginia","Giles County",4,57,275,144,131
050,51,071,"Virginia","Giles County",4,58,274,138,136
050,51,071,"Virginia","Giles County",4,59,256,127,129
050,51,071,"Virginia","Giles County",4,60,267,132,135
050,51,071,"Virginia","Giles County",4,61,243,126,117
050,51,071,"Virginia","Giles County",4,62,228,125,103
050,51,071,"Virginia","Giles County",4,63,236,124,112
050,51,071,"Virginia","Giles County",4,64,218,105,113
050,51,071,"Virginia","Giles County",4,65,199,101,98
050,51,071,"Virginia","Giles County",4,66,214,105,109
050,51,071,"Virginia","Giles County",4,67,201,86,115
050,51,071,"Virginia","Giles County",4,68,226,110,116
050,51,071,"Virginia","Giles County",4,69,217,115,102
050,51,071,"Virginia","Giles County",4,70,225,111,114
050,51,071,"Virginia","Giles County",4,71,207,98,109
050,51,071,"Virginia","Giles County",4,72,198,97,101
050,51,071,"Virginia","Giles County",4,73,181,89,92
050,51,071,"Virginia","Giles County",4,74,186,88,98
050,51,071,"Virginia","Giles County",4,75,207,101,106
050,51,071,"Virginia","Giles County",4,76,129,54,75
050,51,071,"Virginia","Giles County",4,77,148,71,77
050,51,071,"Virginia","Giles County",4,78,145,70,75
050,51,071,"Virginia","Giles County",4,79,135,65,70
050,51,071,"Virginia","Giles County",4,80,121,59,62
050,51,071,"Virginia","Giles County",4,81,100,42,58
050,51,071,"Virginia","Giles County",4,82,103,49,54
050,51,071,"Virginia","Giles County",4,83,79,39,40
050,51,071,"Virginia","Giles County",4,84,66,32,34
050,51,071,"Virginia","Giles County",4,85,370,105,265
050,51,071,"Virginia","Giles County",5,0,149,77,72
050,51,071,"Virginia","Giles County",5,1,148,80,68
050,51,071,"Virginia","Giles County",5,2,157,92,65
050,51,071,"Virginia","Giles County",5,3,150,75,75
050,51,071,"Virginia","Giles County",5,4,159,78,81
050,51,071,"Virginia","Giles County",5,5,171,93,78
050,51,071,"Virginia","Giles County",5,6,167,91,76
050,51,071,"Virginia","Giles County",5,7,199,101,98
050,51,071,"Virginia","Giles County",5,8,184,89,95
050,51,071,"Virginia","Giles County",5,9,178,90,88
050,51,071,"Virginia","Giles County",5,10,191,103,88
050,51,071,"Virginia","Giles County",5,11,183,93,90
050,51,071,"Virginia","Giles County",5,12,194,95,99
050,51,071,"Virginia","Giles County",5,13,230,111,119
050,51,071,"Virginia","Giles County",5,14,190,89,101
050,51,071,"Virginia","Giles County",5,15,185,103,82
050,51,071,"Virginia","Giles County",5,16,207,115,92
050,51,071,"Virginia","Giles County",5,17,184,88,96
050,51,071,"Virginia","Giles County",5,18,174,89,85
050,51,071,"Virginia","Giles County",5,19,133,66,67
050,51,071,"Virginia","Giles County",5,20,165,83,82
050,51,071,"Virginia","Giles County",5,21,164,84,80
050,51,071,"Virginia","Giles County",5,22,191,97,94
050,51,071,"Virginia","Giles County",5,23,191,100,91
050,51,071,"Virginia","Giles County",5,24,171,86,85
050,51,071,"Virginia","Giles County",5,25,177,85,92
050,51,071,"Virginia","Giles County",5,26,180,101,79
050,51,071,"Virginia","Giles County",5,27,196,105,91
050,51,071,"Virginia","Giles County",5,28,175,96,79
050,51,071,"Virginia","Giles County",5,29,186,82,104
050,51,071,"Virginia","Giles County",5,30,172,80,92
050,51,071,"Virginia","Giles County",5,31,199,111,88
050,51,071,"Virginia","Giles County",5,32,197,100,97
050,51,071,"Virginia","Giles County",5,33,229,109,120
050,51,071,"Virginia","Giles County",5,34,190,91,99
050,51,071,"Virginia","Giles County",5,35,202,97,105
050,51,071,"Virginia","Giles County",5,36,173,93,80
050,51,071,"Virginia","Giles County",5,37,190,101,89
050,51,071,"Virginia","Giles County",5,38,165,86,79
050,51,071,"Virginia","Giles County",5,39,161,85,76
050,51,071,"Virginia","Giles County",5,40,193,98,95
050,51,071,"Virginia","Giles County",5,41,200,111,89
050,51,071,"Virginia","Giles County",5,42,178,92,86
050,51,071,"Virginia","Giles County",5,43,184,87,97
050,51,071,"Virginia","Giles County",5,44,187,85,102
050,51,071,"Virginia","Giles County",5,45,180,87,93
050,51,071,"Virginia","Giles County",5,46,178,93,85
050,51,071,"Virginia","Giles County",5,47,185,93,92
050,51,071,"Virginia","Giles County",5,48,187,89,98
050,51,071,"Virginia","Giles County",5,49,212,106,106
050,51,071,"Virginia","Giles County",5,50,218,114,104
050,51,071,"Virginia","Giles County",5,51,242,125,117
050,51,071,"Virginia","Giles County",5,52,244,124,120
050,51,071,"Virginia","Giles County",5,53,254,131,123
050,51,071,"Virginia","Giles County",5,54,257,117,140
050,51,071,"Virginia","Giles County",5,55,229,112,117
050,51,071,"Virginia","Giles County",5,56,232,113,119
050,51,071,"Virginia","Giles County",5,57,257,120,137
050,51,071,"Virginia","Giles County",5,58,278,145,133
050,51,071,"Virginia","Giles County",5,59,276,140,136
050,51,071,"Virginia","Giles County",5,60,253,126,127
050,51,071,"Virginia","Giles County",5,61,278,138,140
050,51,071,"Virginia","Giles County",5,62,237,121,116
050,51,071,"Virginia","Giles County",5,63,229,124,105
050,51,071,"Virginia","Giles County",5,64,228,119,109
050,51,071,"Virginia","Giles County",5,65,204,103,101
050,51,071,"Virginia","Giles County",5,66,191,98,93
050,51,071,"Virginia","Giles County",5,67,212,102,110
050,51,071,"Virginia","Giles County",5,68,194,84,110
050,51,071,"Virginia","Giles County",5,69,226,111,115
050,51,071,"Virginia","Giles County",5,70,217,114,103
050,51,071,"Virginia","Giles County",5,71,211,105,106
050,51,071,"Virginia","Giles County",5,72,198,94,104
050,51,071,"Virginia","Giles County",5,73,189,93,96
050,51,071,"Virginia","Giles County",5,74,168,84,84
050,51,071,"Virginia","Giles County",5,75,175,78,97
050,51,071,"Virginia","Giles County",5,76,192,90,102
050,51,071,"Virginia","Giles County",5,77,125,50,75
050,51,071,"Virginia","Giles County",5,78,143,69,74
050,51,071,"Virginia","Giles County",5,79,131,58,73
050,51,071,"Virginia","Giles County",5,80,123,58,65
050,51,071,"Virginia","Giles County",5,81,113,55,58
050,51,071,"Virginia","Giles County",5,82,98,43,55
050,51,071,"Virginia","Giles County",5,83,89,42,47
050,51,071,"Virginia","Giles County",5,84,78,38,40
050,51,071,"Virginia","Giles County",5,85,377,112,265
050,51,073,"Virginia","Gloucester County",1,0,344,175,169
050,51,073,"Virginia","Gloucester County",1,1,373,189,184
050,51,073,"Virginia","Gloucester County",1,2,397,196,201
050,51,073,"Virginia","Gloucester County",1,3,413,210,203
050,51,073,"Virginia","Gloucester County",1,4,401,212,189
050,51,073,"Virginia","Gloucester County",1,5,425,236,189
050,51,073,"Virginia","Gloucester County",1,6,431,208,223
050,51,073,"Virginia","Gloucester County",1,7,447,210,237
050,51,073,"Virginia","Gloucester County",1,8,419,210,209
050,51,073,"Virginia","Gloucester County",1,9,455,245,210
050,51,073,"Virginia","Gloucester County",1,10,462,230,232
050,51,073,"Virginia","Gloucester County",1,11,462,233,229
050,51,073,"Virginia","Gloucester County",1,12,470,229,241
050,51,073,"Virginia","Gloucester County",1,13,441,225,216
050,51,073,"Virginia","Gloucester County",1,14,413,215,198
050,51,073,"Virginia","Gloucester County",1,15,454,239,215
050,51,073,"Virginia","Gloucester County",1,16,507,266,241
050,51,073,"Virginia","Gloucester County",1,17,484,259,225
050,51,073,"Virginia","Gloucester County",1,18,415,225,190
050,51,073,"Virginia","Gloucester County",1,19,323,166,157
050,51,073,"Virginia","Gloucester County",1,20,348,184,164
050,51,073,"Virginia","Gloucester County",1,21,357,199,158
050,51,073,"Virginia","Gloucester County",1,22,354,187,167
050,51,073,"Virginia","Gloucester County",1,23,376,188,188
050,51,073,"Virginia","Gloucester County",1,24,415,214,201
050,51,073,"Virginia","Gloucester County",1,25,416,219,197
050,51,073,"Virginia","Gloucester County",1,26,437,224,213
050,51,073,"Virginia","Gloucester County",1,27,458,230,228
050,51,073,"Virginia","Gloucester County",1,28,442,234,208
050,51,073,"Virginia","Gloucester County",1,29,444,218,226
050,51,073,"Virginia","Gloucester County",1,30,481,225,256
050,51,073,"Virginia","Gloucester County",1,31,457,227,230
050,51,073,"Virginia","Gloucester County",1,32,460,234,226
050,51,073,"Virginia","Gloucester County",1,33,482,241,241
050,51,073,"Virginia","Gloucester County",1,34,505,250,255
050,51,073,"Virginia","Gloucester County",1,35,473,245,228
050,51,073,"Virginia","Gloucester County",1,36,490,255,235
050,51,073,"Virginia","Gloucester County",1,37,521,269,252
050,51,073,"Virginia","Gloucester County",1,38,502,260,242
050,51,073,"Virginia","Gloucester County",1,39,498,255,243
050,51,073,"Virginia","Gloucester County",1,40,412,211,201
050,51,073,"Virginia","Gloucester County",1,41,422,211,211
050,51,073,"Virginia","Gloucester County",1,42,446,214,232
050,51,073,"Virginia","Gloucester County",1,43,409,212,197
050,51,073,"Virginia","Gloucester County",1,44,418,217,201
050,51,073,"Virginia","Gloucester County",1,45,442,219,223
050,51,073,"Virginia","Gloucester County",1,46,448,222,226
050,51,073,"Virginia","Gloucester County",1,47,441,208,233
050,51,073,"Virginia","Gloucester County",1,48,501,256,245
050,51,073,"Virginia","Gloucester County",1,49,517,277,240
050,51,073,"Virginia","Gloucester County",1,50,466,236,230
050,51,073,"Virginia","Gloucester County",1,51,512,252,260
050,51,073,"Virginia","Gloucester County",1,52,523,237,286
050,51,073,"Virginia","Gloucester County",1,53,556,271,285
050,51,073,"Virginia","Gloucester County",1,54,583,285,298
050,51,073,"Virginia","Gloucester County",1,55,626,301,325
050,51,073,"Virginia","Gloucester County",1,56,683,341,342
050,51,073,"Virginia","Gloucester County",1,57,644,339,305
050,51,073,"Virginia","Gloucester County",1,58,694,360,334
050,51,073,"Virginia","Gloucester County",1,59,705,327,378
050,51,073,"Virginia","Gloucester County",1,60,658,318,340
050,51,073,"Virginia","Gloucester County",1,61,652,326,326
050,51,073,"Virginia","Gloucester County",1,62,681,327,354
050,51,073,"Virginia","Gloucester County",1,63,631,302,329
050,51,073,"Virginia","Gloucester County",1,64,617,292,325
050,51,073,"Virginia","Gloucester County",1,65,596,297,299
050,51,073,"Virginia","Gloucester County",1,66,540,279,261
050,51,073,"Virginia","Gloucester County",1,67,525,257,268
050,51,073,"Virginia","Gloucester County",1,68,469,224,245
050,51,073,"Virginia","Gloucester County",1,69,397,185,212
050,51,073,"Virginia","Gloucester County",1,70,419,195,224
050,51,073,"Virginia","Gloucester County",1,71,462,225,237
050,51,073,"Virginia","Gloucester County",1,72,461,227,234
050,51,073,"Virginia","Gloucester County",1,73,449,226,223
050,51,073,"Virginia","Gloucester County",1,74,310,147,163
050,51,073,"Virginia","Gloucester County",1,75,310,141,169
050,51,073,"Virginia","Gloucester County",1,76,315,151,164
050,51,073,"Virginia","Gloucester County",1,77,288,131,157
050,51,073,"Virginia","Gloucester County",1,78,260,117,143
050,51,073,"Virginia","Gloucester County",1,79,230,98,132
050,51,073,"Virginia","Gloucester County",1,80,221,95,126
050,51,073,"Virginia","Gloucester County",1,81,187,86,101
050,51,073,"Virginia","Gloucester County",1,82,162,70,92
050,51,073,"Virginia","Gloucester County",1,83,151,57,94
050,51,073,"Virginia","Gloucester County",1,84,128,53,75
050,51,073,"Virginia","Gloucester County",1,85,696,274,422
050,51,073,"Virginia","Gloucester County",2,0,347,178,169
050,51,073,"Virginia","Gloucester County",2,1,369,186,183
050,51,073,"Virginia","Gloucester County",2,2,396,196,200
050,51,073,"Virginia","Gloucester County",2,3,410,207,203
050,51,073,"Virginia","Gloucester County",2,4,404,211,193
050,51,073,"Virginia","Gloucester County",2,5,418,229,189
050,51,073,"Virginia","Gloucester County",2,6,434,219,215
050,51,073,"Virginia","Gloucester County",2,7,441,208,233
050,51,073,"Virginia","Gloucester County",2,8,426,209,217
050,51,073,"Virginia","Gloucester County",2,9,446,236,210
050,51,073,"Virginia","Gloucester County",2,10,465,238,227
050,51,073,"Virginia","Gloucester County",2,11,461,232,229
050,51,073,"Virginia","Gloucester County",2,12,471,232,239
050,51,073,"Virginia","Gloucester County",2,13,447,226,221
050,51,073,"Virginia","Gloucester County",2,14,421,218,203
050,51,073,"Virginia","Gloucester County",2,15,445,234,211
050,51,073,"Virginia","Gloucester County",2,16,494,260,234
050,51,073,"Virginia","Gloucester County",2,17,491,260,231
050,51,073,"Virginia","Gloucester County",2,18,407,221,186
050,51,073,"Virginia","Gloucester County",2,19,325,171,154
050,51,073,"Virginia","Gloucester County",2,20,350,185,165
050,51,073,"Virginia","Gloucester County",2,21,354,195,159
050,51,073,"Virginia","Gloucester County",2,22,356,190,166
050,51,073,"Virginia","Gloucester County",2,23,374,189,185
050,51,073,"Virginia","Gloucester County",2,24,401,207,194
050,51,073,"Virginia","Gloucester County",2,25,417,220,197
050,51,073,"Virginia","Gloucester County",2,26,436,224,212
050,51,073,"Virginia","Gloucester County",2,27,456,230,226
050,51,073,"Virginia","Gloucester County",2,28,445,231,214
050,51,073,"Virginia","Gloucester County",2,29,446,223,223
050,51,073,"Virginia","Gloucester County",2,30,471,224,247
050,51,073,"Virginia","Gloucester County",2,31,463,225,238
050,51,073,"Virginia","Gloucester County",2,32,462,233,229
050,51,073,"Virginia","Gloucester County",2,33,478,242,236
050,51,073,"Virginia","Gloucester County",2,34,502,250,252
050,51,073,"Virginia","Gloucester County",2,35,490,250,240
050,51,073,"Virginia","Gloucester County",2,36,489,254,235
050,51,073,"Virginia","Gloucester County",2,37,516,269,247
050,51,073,"Virginia","Gloucester County",2,38,510,265,245
050,51,073,"Virginia","Gloucester County",2,39,496,257,239
050,51,073,"Virginia","Gloucester County",2,40,439,225,214
050,51,073,"Virginia","Gloucester County",2,41,424,213,211
050,51,073,"Virginia","Gloucester County",2,42,437,212,225
050,51,073,"Virginia","Gloucester County",2,43,420,213,207
050,51,073,"Virginia","Gloucester County",2,44,413,215,198
050,51,073,"Virginia","Gloucester County",2,45,438,218,220
050,51,073,"Virginia","Gloucester County",2,46,441,217,224
050,51,073,"Virginia","Gloucester County",2,47,441,210,231
050,51,073,"Virginia","Gloucester County",2,48,486,245,241
050,51,073,"Virginia","Gloucester County",2,49,511,273,238
050,51,073,"Virginia","Gloucester County",2,50,478,244,234
050,51,073,"Virginia","Gloucester County",2,51,500,245,255
050,51,073,"Virginia","Gloucester County",2,52,515,237,278
050,51,073,"Virginia","Gloucester County",2,53,548,261,287
050,51,073,"Virginia","Gloucester County",2,54,573,281,292
050,51,073,"Virginia","Gloucester County",2,55,615,298,317
050,51,073,"Virginia","Gloucester County",2,56,671,333,338
050,51,073,"Virginia","Gloucester County",2,57,653,340,313
050,51,073,"Virginia","Gloucester County",2,58,683,355,328
050,51,073,"Virginia","Gloucester County",2,59,707,336,371
050,51,073,"Virginia","Gloucester County",2,60,670,321,349
050,51,073,"Virginia","Gloucester County",2,61,648,321,327
050,51,073,"Virginia","Gloucester County",2,62,670,325,345
050,51,073,"Virginia","Gloucester County",2,63,648,310,338
050,51,073,"Virginia","Gloucester County",2,64,615,291,324
050,51,073,"Virginia","Gloucester County",2,65,600,296,304
050,51,073,"Virginia","Gloucester County",2,66,555,283,272
050,51,073,"Virginia","Gloucester County",2,67,523,259,264
050,51,073,"Virginia","Gloucester County",2,68,473,229,244
050,51,073,"Virginia","Gloucester County",2,69,417,195,222
050,51,073,"Virginia","Gloucester County",2,70,415,193,222
050,51,073,"Virginia","Gloucester County",2,71,446,214,232
050,51,073,"Virginia","Gloucester County",2,72,455,223,232
050,51,073,"Virginia","Gloucester County",2,73,470,237,233
050,51,073,"Virginia","Gloucester County",2,74,320,155,165
050,51,073,"Virginia","Gloucester County",2,75,310,142,168
050,51,073,"Virginia","Gloucester County",2,76,305,144,161
050,51,073,"Virginia","Gloucester County",2,77,300,140,160
050,51,073,"Virginia","Gloucester County",2,78,259,117,142
050,51,073,"Virginia","Gloucester County",2,79,235,102,133
050,51,073,"Virginia","Gloucester County",2,80,219,93,126
050,51,073,"Virginia","Gloucester County",2,81,194,86,108
050,51,073,"Virginia","Gloucester County",2,82,166,70,96
050,51,073,"Virginia","Gloucester County",2,83,149,59,90
050,51,073,"Virginia","Gloucester County",2,84,134,56,78
050,51,073,"Virginia","Gloucester County",2,85,703,276,427
050,51,073,"Virginia","Gloucester County",3,0,365,186,179
050,51,073,"Virginia","Gloucester County",3,1,384,204,180
050,51,073,"Virginia","Gloucester County",3,2,383,194,189
050,51,073,"Virginia","Gloucester County",3,3,415,217,198
050,51,073,"Virginia","Gloucester County",3,4,423,224,199
050,51,073,"Virginia","Gloucester County",3,5,410,212,198
050,51,073,"Virginia","Gloucester County",3,6,445,249,196
050,51,073,"Virginia","Gloucester County",3,7,468,237,231
050,51,073,"Virginia","Gloucester County",3,8,449,212,237
050,51,073,"Virginia","Gloucester County",3,9,421,204,217
050,51,073,"Virginia","Gloucester County",3,10,457,235,222
050,51,073,"Virginia","Gloucester County",3,11,484,245,239
050,51,073,"Virginia","Gloucester County",3,12,465,228,237
050,51,073,"Virginia","Gloucester County",3,13,481,234,247
050,51,073,"Virginia","Gloucester County",3,14,460,237,223
050,51,073,"Virginia","Gloucester County",3,15,425,219,206
050,51,073,"Virginia","Gloucester County",3,16,437,225,212
050,51,073,"Virginia","Gloucester County",3,17,494,260,234
050,51,073,"Virginia","Gloucester County",3,18,415,225,190
050,51,073,"Virginia","Gloucester County",3,19,340,182,158
050,51,073,"Virginia","Gloucester County",3,20,360,177,183
050,51,073,"Virginia","Gloucester County",3,21,362,182,180
050,51,073,"Virginia","Gloucester County",3,22,388,208,180
050,51,073,"Virginia","Gloucester County",3,23,387,202,185
050,51,073,"Virginia","Gloucester County",3,24,378,199,179
050,51,073,"Virginia","Gloucester County",3,25,400,208,192
050,51,073,"Virginia","Gloucester County",3,26,421,230,191
050,51,073,"Virginia","Gloucester County",3,27,426,212,214
050,51,073,"Virginia","Gloucester County",3,28,464,227,237
050,51,073,"Virginia","Gloucester County",3,29,475,240,235
050,51,073,"Virginia","Gloucester County",3,30,472,227,245
050,51,073,"Virginia","Gloucester County",3,31,489,232,257
050,51,073,"Virginia","Gloucester County",3,32,501,235,266
050,51,073,"Virginia","Gloucester County",3,33,491,243,248
050,51,073,"Virginia","Gloucester County",3,34,477,248,229
050,51,073,"Virginia","Gloucester County",3,35,519,254,265
050,51,073,"Virginia","Gloucester County",3,36,502,258,244
050,51,073,"Virginia","Gloucester County",3,37,507,260,247
050,51,073,"Virginia","Gloucester County",3,38,492,269,223
050,51,073,"Virginia","Gloucester County",3,39,528,269,259
050,51,073,"Virginia","Gloucester County",3,40,510,261,249
050,51,073,"Virginia","Gloucester County",3,41,463,231,232
050,51,073,"Virginia","Gloucester County",3,42,433,220,213
050,51,073,"Virginia","Gloucester County",3,43,435,210,225
050,51,073,"Virginia","Gloucester County",3,44,417,213,204
050,51,073,"Virginia","Gloucester County",3,45,417,214,203
050,51,073,"Virginia","Gloucester County",3,46,439,218,221
050,51,073,"Virginia","Gloucester County",3,47,439,210,229
050,51,073,"Virginia","Gloucester County",3,48,437,213,224
050,51,073,"Virginia","Gloucester County",3,49,485,244,241
050,51,073,"Virginia","Gloucester County",3,50,528,279,249
050,51,073,"Virginia","Gloucester County",3,51,486,248,238
050,51,073,"Virginia","Gloucester County",3,52,497,245,252
050,51,073,"Virginia","Gloucester County",3,53,510,236,274
050,51,073,"Virginia","Gloucester County",3,54,550,271,279
050,51,073,"Virginia","Gloucester County",3,55,562,276,286
050,51,073,"Virginia","Gloucester County",3,56,616,299,317
050,51,073,"Virginia","Gloucester County",3,57,686,342,344
050,51,073,"Virginia","Gloucester County",3,58,656,336,320
050,51,073,"Virginia","Gloucester County",3,59,686,351,335
050,51,073,"Virginia","Gloucester County",3,60,709,337,372
050,51,073,"Virginia","Gloucester County",3,61,665,311,354
050,51,073,"Virginia","Gloucester County",3,62,655,327,328
050,51,073,"Virginia","Gloucester County",3,63,659,317,342
050,51,073,"Virginia","Gloucester County",3,64,642,301,341
050,51,073,"Virginia","Gloucester County",3,65,617,294,323
050,51,073,"Virginia","Gloucester County",3,66,590,286,304
050,51,073,"Virginia","Gloucester County",3,67,549,279,270
050,51,073,"Virginia","Gloucester County",3,68,515,257,258
050,51,073,"Virginia","Gloucester County",3,69,466,224,242
050,51,073,"Virginia","Gloucester County",3,70,413,192,221
050,51,073,"Virginia","Gloucester County",3,71,407,190,217
050,51,073,"Virginia","Gloucester County",3,72,442,211,231
050,51,073,"Virginia","Gloucester County",3,73,438,213,225
050,51,073,"Virginia","Gloucester County",3,74,458,230,228
050,51,073,"Virginia","Gloucester County",3,75,308,144,164
050,51,073,"Virginia","Gloucester County",3,76,296,132,164
050,51,073,"Virginia","Gloucester County",3,77,293,142,151
050,51,073,"Virginia","Gloucester County",3,78,283,136,147
050,51,073,"Virginia","Gloucester County",3,79,257,113,144
050,51,073,"Virginia","Gloucester County",3,80,221,92,129
050,51,073,"Virginia","Gloucester County",3,81,207,88,119
050,51,073,"Virginia","Gloucester County",3,82,194,83,111
050,51,073,"Virginia","Gloucester County",3,83,145,56,89
050,51,073,"Virginia","Gloucester County",3,84,131,48,83
050,51,073,"Virginia","Gloucester County",3,85,702,276,426
050,51,073,"Virginia","Gloucester County",4,0,370,188,182
050,51,073,"Virginia","Gloucester County",4,1,382,192,190
050,51,073,"Virginia","Gloucester County",4,2,396,210,186
050,51,073,"Virginia","Gloucester County",4,3,382,186,196
050,51,073,"Virginia","Gloucester County",4,4,416,213,203
050,51,073,"Virginia","Gloucester County",4,5,420,219,201
050,51,073,"Virginia","Gloucester County",4,6,416,214,202
050,51,073,"Virginia","Gloucester County",4,7,446,246,200
050,51,073,"Virginia","Gloucester County",4,8,477,241,236
050,51,073,"Virginia","Gloucester County",4,9,440,207,233
050,51,073,"Virginia","Gloucester County",4,10,439,220,219
050,51,073,"Virginia","Gloucester County",4,11,481,244,237
050,51,073,"Virginia","Gloucester County",4,12,487,247,240
050,51,073,"Virginia","Gloucester County",4,13,491,242,249
050,51,073,"Virginia","Gloucester County",4,14,502,242,260
050,51,073,"Virginia","Gloucester County",4,15,477,245,232
050,51,073,"Virginia","Gloucester County",4,16,434,230,204
050,51,073,"Virginia","Gloucester County",4,17,462,247,215
050,51,073,"Virginia","Gloucester County",4,18,422,228,194
050,51,073,"Virginia","Gloucester County",4,19,326,175,151
050,51,073,"Virginia","Gloucester County",4,20,356,193,163
050,51,073,"Virginia","Gloucester County",4,21,383,188,195
050,51,073,"Virginia","Gloucester County",4,22,389,187,202
050,51,073,"Virginia","Gloucester County",4,23,391,218,173
050,51,073,"Virginia","Gloucester County",4,24,375,192,183
050,51,073,"Virginia","Gloucester County",4,25,371,188,183
050,51,073,"Virginia","Gloucester County",4,26,380,192,188
050,51,073,"Virginia","Gloucester County",4,27,415,218,197
050,51,073,"Virginia","Gloucester County",4,28,428,208,220
050,51,073,"Virginia","Gloucester County",4,29,455,223,232
050,51,073,"Virginia","Gloucester County",4,30,483,245,238
050,51,073,"Virginia","Gloucester County",4,31,461,226,235
050,51,073,"Virginia","Gloucester County",4,32,493,237,256
050,51,073,"Virginia","Gloucester County",4,33,531,254,277
050,51,073,"Virginia","Gloucester County",4,34,493,250,243
050,51,073,"Virginia","Gloucester County",4,35,496,262,234
050,51,073,"Virginia","Gloucester County",4,36,548,271,277
050,51,073,"Virginia","Gloucester County",4,37,509,260,249
050,51,073,"Virginia","Gloucester County",4,38,520,270,250
050,51,073,"Virginia","Gloucester County",4,39,517,281,236
050,51,073,"Virginia","Gloucester County",4,40,542,281,261
050,51,073,"Virginia","Gloucester County",4,41,521,265,256
050,51,073,"Virginia","Gloucester County",4,42,459,229,230
050,51,073,"Virginia","Gloucester County",4,43,448,227,221
050,51,073,"Virginia","Gloucester County",4,44,442,210,232
050,51,073,"Virginia","Gloucester County",4,45,417,215,202
050,51,073,"Virginia","Gloucester County",4,46,404,205,199
050,51,073,"Virginia","Gloucester County",4,47,439,218,221
050,51,073,"Virginia","Gloucester County",4,48,442,217,225
050,51,073,"Virginia","Gloucester County",4,49,452,223,229
050,51,073,"Virginia","Gloucester County",4,50,501,249,252
050,51,073,"Virginia","Gloucester County",4,51,540,285,255
050,51,073,"Virginia","Gloucester County",4,52,493,244,249
050,51,073,"Virginia","Gloucester County",4,53,512,251,261
050,51,073,"Virginia","Gloucester County",4,54,501,235,266
050,51,073,"Virginia","Gloucester County",4,55,558,272,286
050,51,073,"Virginia","Gloucester County",4,56,559,279,280
050,51,073,"Virginia","Gloucester County",4,57,628,296,332
050,51,073,"Virginia","Gloucester County",4,58,684,340,344
050,51,073,"Virginia","Gloucester County",4,59,645,330,315
050,51,073,"Virginia","Gloucester County",4,60,691,359,332
050,51,073,"Virginia","Gloucester County",4,61,715,334,381
050,51,073,"Virginia","Gloucester County",4,62,662,310,352
050,51,073,"Virginia","Gloucester County",4,63,651,324,327
050,51,073,"Virginia","Gloucester County",4,64,659,318,341
050,51,073,"Virginia","Gloucester County",4,65,638,305,333
050,51,073,"Virginia","Gloucester County",4,66,607,287,320
050,51,073,"Virginia","Gloucester County",4,67,595,286,309
050,51,073,"Virginia","Gloucester County",4,68,562,282,280
050,51,073,"Virginia","Gloucester County",4,69,499,241,258
050,51,073,"Virginia","Gloucester County",4,70,451,220,231
050,51,073,"Virginia","Gloucester County",4,71,412,193,219
050,51,073,"Virginia","Gloucester County",4,72,419,204,215
050,51,073,"Virginia","Gloucester County",4,73,430,204,226
050,51,073,"Virginia","Gloucester County",4,74,423,203,220
050,51,073,"Virginia","Gloucester County",4,75,456,233,223
050,51,073,"Virginia","Gloucester County",4,76,307,140,167
050,51,073,"Virginia","Gloucester County",4,77,286,130,156
050,51,073,"Virginia","Gloucester County",4,78,291,142,149
050,51,073,"Virginia","Gloucester County",4,79,283,138,145
050,51,073,"Virginia","Gloucester County",4,80,240,103,137
050,51,073,"Virginia","Gloucester County",4,81,206,84,122
050,51,073,"Virginia","Gloucester County",4,82,196,81,115
050,51,073,"Virginia","Gloucester County",4,83,173,65,108
050,51,073,"Virginia","Gloucester County",4,84,127,46,81
050,51,073,"Virginia","Gloucester County",4,85,724,274,450
050,51,073,"Virginia","Gloucester County",5,0,364,185,179
050,51,073,"Virginia","Gloucester County",5,1,401,187,214
050,51,073,"Virginia","Gloucester County",5,2,387,200,187
050,51,073,"Virginia","Gloucester County",5,3,402,210,192
050,51,073,"Virginia","Gloucester County",5,4,396,190,206
050,51,073,"Virginia","Gloucester County",5,5,426,220,206
050,51,073,"Virginia","Gloucester County",5,6,426,230,196
050,51,073,"Virginia","Gloucester County",5,7,415,213,202
050,51,073,"Virginia","Gloucester County",5,8,457,249,208
050,51,073,"Virginia","Gloucester County",5,9,477,244,233
050,51,073,"Virginia","Gloucester County",5,10,445,205,240
050,51,073,"Virginia","Gloucester County",5,11,461,225,236
050,51,073,"Virginia","Gloucester County",5,12,492,259,233
050,51,073,"Virginia","Gloucester County",5,13,501,254,247
050,51,073,"Virginia","Gloucester County",5,14,501,249,252
050,51,073,"Virginia","Gloucester County",5,15,516,249,267
050,51,073,"Virginia","Gloucester County",5,16,477,244,233
050,51,073,"Virginia","Gloucester County",5,17,448,243,205
050,51,073,"Virginia","Gloucester County",5,18,382,207,175
050,51,073,"Virginia","Gloucester County",5,19,335,179,156
050,51,073,"Virginia","Gloucester County",5,20,351,191,160
050,51,073,"Virginia","Gloucester County",5,21,382,210,172
050,51,073,"Virginia","Gloucester County",5,22,412,202,210
050,51,073,"Virginia","Gloucester County",5,23,401,199,202
050,51,073,"Virginia","Gloucester County",5,24,395,212,183
050,51,073,"Virginia","Gloucester County",5,25,396,204,192
050,51,073,"Virginia","Gloucester County",5,26,377,195,182
050,51,073,"Virginia","Gloucester County",5,27,400,209,191
050,51,073,"Virginia","Gloucester County",5,28,424,229,195
050,51,073,"Virginia","Gloucester County",5,29,446,214,232
050,51,073,"Virginia","Gloucester County",5,30,492,240,252
050,51,073,"Virginia","Gloucester County",5,31,472,240,232
050,51,073,"Virginia","Gloucester County",5,32,482,236,246
050,51,073,"Virginia","Gloucester County",5,33,525,259,266
050,51,073,"Virginia","Gloucester County",5,34,549,262,287
050,51,073,"Virginia","Gloucester County",5,35,494,257,237
050,51,073,"Virginia","Gloucester County",5,36,505,269,236
050,51,073,"Virginia","Gloucester County",5,37,565,287,278
050,51,073,"Virginia","Gloucester County",5,38,508,254,254
050,51,073,"Virginia","Gloucester County",5,39,524,267,257
050,51,073,"Virginia","Gloucester County",5,40,525,285,240
050,51,073,"Virginia","Gloucester County",5,41,537,278,259
050,51,073,"Virginia","Gloucester County",5,42,523,264,259
050,51,073,"Virginia","Gloucester County",5,43,467,238,229
050,51,073,"Virginia","Gloucester County",5,44,443,219,224
050,51,073,"Virginia","Gloucester County",5,45,441,206,235
050,51,073,"Virginia","Gloucester County",5,46,411,213,198
050,51,073,"Virginia","Gloucester County",5,47,404,199,205
050,51,073,"Virginia","Gloucester County",5,48,428,212,216
050,51,073,"Virginia","Gloucester County",5,49,444,216,228
050,51,073,"Virginia","Gloucester County",5,50,451,219,232
050,51,073,"Virginia","Gloucester County",5,51,507,255,252
050,51,073,"Virginia","Gloucester County",5,52,553,302,251
050,51,073,"Virginia","Gloucester County",5,53,506,253,253
050,51,073,"Virginia","Gloucester County",5,54,520,254,266
050,51,073,"Virginia","Gloucester County",5,55,506,234,272
050,51,073,"Virginia","Gloucester County",5,56,564,276,288
050,51,073,"Virginia","Gloucester County",5,57,555,274,281
050,51,073,"Virginia","Gloucester County",5,58,623,302,321
050,51,073,"Virginia","Gloucester County",5,59,696,343,353
050,51,073,"Virginia","Gloucester County",5,60,647,324,323
050,51,073,"Virginia","Gloucester County",5,61,699,360,339
050,51,073,"Virginia","Gloucester County",5,62,715,331,384
050,51,073,"Virginia","Gloucester County",5,63,662,309,353
050,51,073,"Virginia","Gloucester County",5,64,666,330,336
050,51,073,"Virginia","Gloucester County",5,65,661,323,338
050,51,073,"Virginia","Gloucester County",5,66,631,297,334
050,51,073,"Virginia","Gloucester County",5,67,609,282,327
050,51,073,"Virginia","Gloucester County",5,68,599,287,312
050,51,073,"Virginia","Gloucester County",5,69,559,281,278
050,51,073,"Virginia","Gloucester County",5,70,502,237,265
050,51,073,"Virginia","Gloucester County",5,71,450,221,229
050,51,073,"Virginia","Gloucester County",5,72,408,191,217
050,51,073,"Virginia","Gloucester County",5,73,396,194,202
050,51,073,"Virginia","Gloucester County",5,74,427,203,224
050,51,073,"Virginia","Gloucester County",5,75,421,203,218
050,51,073,"Virginia","Gloucester County",5,76,459,233,226
050,51,073,"Virginia","Gloucester County",5,77,289,136,153
050,51,073,"Virginia","Gloucester County",5,78,282,127,155
050,51,073,"Virginia","Gloucester County",5,79,290,141,149
050,51,073,"Virginia","Gloucester County",5,80,264,127,137
050,51,073,"Virginia","Gloucester County",5,81,236,100,136
050,51,073,"Virginia","Gloucester County",5,82,196,78,118
050,51,073,"Virginia","Gloucester County",5,83,178,65,113
050,51,073,"Virginia","Gloucester County",5,84,154,57,97
050,51,073,"Virginia","Gloucester County",5,85,744,279,465
050,51,075,"Virginia","Goochland County",1,0,182,95,87
050,51,075,"Virginia","Goochland County",1,1,182,98,84
050,51,075,"Virginia","Goochland County",1,2,185,101,84
050,51,075,"Virginia","Goochland County",1,3,195,110,85
050,51,075,"Virginia","Goochland County",1,4,195,98,97
050,51,075,"Virginia","Goochland County",1,5,214,97,117
050,51,075,"Virginia","Goochland County",1,6,217,111,106
050,51,075,"Virginia","Goochland County",1,7,220,110,110
050,51,075,"Virginia","Goochland County",1,8,224,114,110
050,51,075,"Virginia","Goochland County",1,9,241,125,116
050,51,075,"Virginia","Goochland County",1,10,264,135,129
050,51,075,"Virginia","Goochland County",1,11,261,146,115
050,51,075,"Virginia","Goochland County",1,12,282,145,137
050,51,075,"Virginia","Goochland County",1,13,282,143,139
050,51,075,"Virginia","Goochland County",1,14,282,141,141
050,51,075,"Virginia","Goochland County",1,15,284,148,136
050,51,075,"Virginia","Goochland County",1,16,303,155,148
050,51,075,"Virginia","Goochland County",1,17,308,157,151
050,51,075,"Virginia","Goochland County",1,18,257,127,130
050,51,075,"Virginia","Goochland County",1,19,215,118,97
050,51,075,"Virginia","Goochland County",1,20,211,108,103
050,51,075,"Virginia","Goochland County",1,21,254,135,119
050,51,075,"Virginia","Goochland County",1,22,268,134,134
050,51,075,"Virginia","Goochland County",1,23,271,146,125
050,51,075,"Virginia","Goochland County",1,24,251,129,122
050,51,075,"Virginia","Goochland County",1,25,234,128,106
050,51,075,"Virginia","Goochland County",1,26,247,130,117
050,51,075,"Virginia","Goochland County",1,27,238,132,106
050,51,075,"Virginia","Goochland County",1,28,263,147,116
050,51,075,"Virginia","Goochland County",1,29,267,139,128
050,51,075,"Virginia","Goochland County",1,30,268,138,130
050,51,075,"Virginia","Goochland County",1,31,254,131,123
050,51,075,"Virginia","Goochland County",1,32,230,111,119
050,51,075,"Virginia","Goochland County",1,33,240,128,112
050,51,075,"Virginia","Goochland County",1,34,238,117,121
050,51,075,"Virginia","Goochland County",1,35,257,135,122
050,51,075,"Virginia","Goochland County",1,36,244,120,124
050,51,075,"Virginia","Goochland County",1,37,243,130,113
050,51,075,"Virginia","Goochland County",1,38,276,140,136
050,51,075,"Virginia","Goochland County",1,39,277,136,141
050,51,075,"Virginia","Goochland County",1,40,247,115,132
050,51,075,"Virginia","Goochland County",1,41,282,132,150
050,51,075,"Virginia","Goochland County",1,42,282,139,143
050,51,075,"Virginia","Goochland County",1,43,273,135,138
050,51,075,"Virginia","Goochland County",1,44,262,131,131
050,51,075,"Virginia","Goochland County",1,45,295,153,142
050,51,075,"Virginia","Goochland County",1,46,293,141,152
050,51,075,"Virginia","Goochland County",1,47,320,146,174
050,51,075,"Virginia","Goochland County",1,48,360,161,199
050,51,075,"Virginia","Goochland County",1,49,394,199,195
050,51,075,"Virginia","Goochland County",1,50,370,184,186
050,51,075,"Virginia","Goochland County",1,51,326,168,158
050,51,075,"Virginia","Goochland County",1,52,360,174,186
050,51,075,"Virginia","Goochland County",1,53,372,190,182
050,51,075,"Virginia","Goochland County",1,54,422,204,218
050,51,075,"Virginia","Goochland County",1,55,437,196,241
050,51,075,"Virginia","Goochland County",1,56,449,210,239
050,51,075,"Virginia","Goochland County",1,57,457,217,240
050,51,075,"Virginia","Goochland County",1,58,442,223,219
050,51,075,"Virginia","Goochland County",1,59,447,221,226
050,51,075,"Virginia","Goochland County",1,60,452,207,245
050,51,075,"Virginia","Goochland County",1,61,473,222,251
050,51,075,"Virginia","Goochland County",1,62,465,224,241
050,51,075,"Virginia","Goochland County",1,63,430,211,219
050,51,075,"Virginia","Goochland County",1,64,389,193,196
050,51,075,"Virginia","Goochland County",1,65,405,190,215
050,51,075,"Virginia","Goochland County",1,66,408,201,207
050,51,075,"Virginia","Goochland County",1,67,388,197,191
050,51,075,"Virginia","Goochland County",1,68,353,184,169
050,51,075,"Virginia","Goochland County",1,69,351,173,178
050,51,075,"Virginia","Goochland County",1,70,333,161,172
050,51,075,"Virginia","Goochland County",1,71,336,161,175
050,51,075,"Virginia","Goochland County",1,72,346,165,181
050,51,075,"Virginia","Goochland County",1,73,365,185,180
050,51,075,"Virginia","Goochland County",1,74,232,110,122
050,51,075,"Virginia","Goochland County",1,75,241,117,124
050,51,075,"Virginia","Goochland County",1,76,233,109,124
050,51,075,"Virginia","Goochland County",1,77,235,112,123
050,51,075,"Virginia","Goochland County",1,78,191,87,104
050,51,075,"Virginia","Goochland County",1,79,160,70,90
050,51,075,"Virginia","Goochland County",1,80,150,71,79
050,51,075,"Virginia","Goochland County",1,81,112,50,62
050,51,075,"Virginia","Goochland County",1,82,98,51,47
050,51,075,"Virginia","Goochland County",1,83,93,47,46
050,51,075,"Virginia","Goochland County",1,84,76,34,42
050,51,075,"Virginia","Goochland County",1,85,501,211,290
050,51,075,"Virginia","Goochland County",2,0,173,90,83
050,51,075,"Virginia","Goochland County",2,1,181,94,87
050,51,075,"Virginia","Goochland County",2,2,188,102,86
050,51,075,"Virginia","Goochland County",2,3,191,107,84
050,51,075,"Virginia","Goochland County",2,4,197,102,95
050,51,075,"Virginia","Goochland County",2,5,209,99,110
050,51,075,"Virginia","Goochland County",2,6,216,108,108
050,51,075,"Virginia","Goochland County",2,7,216,108,108
050,51,075,"Virginia","Goochland County",2,8,224,114,110
050,51,075,"Virginia","Goochland County",2,9,240,123,117
050,51,075,"Virginia","Goochland County",2,10,264,135,129
050,51,075,"Virginia","Goochland County",2,11,266,144,122
050,51,075,"Virginia","Goochland County",2,12,280,146,134
050,51,075,"Virginia","Goochland County",2,13,284,144,140
050,51,075,"Virginia","Goochland County",2,14,284,143,141
050,51,075,"Virginia","Goochland County",2,15,284,147,137
050,51,075,"Virginia","Goochland County",2,16,300,155,145
050,51,075,"Virginia","Goochland County",2,17,307,157,150
050,51,075,"Virginia","Goochland County",2,18,253,127,126
050,51,075,"Virginia","Goochland County",2,19,213,113,100
050,51,075,"Virginia","Goochland County",2,20,221,115,106
050,51,075,"Virginia","Goochland County",2,21,250,131,119
050,51,075,"Virginia","Goochland County",2,22,271,138,133
050,51,075,"Virginia","Goochland County",2,23,275,146,129
050,51,075,"Virginia","Goochland County",2,24,254,132,122
050,51,075,"Virginia","Goochland County",2,25,241,129,112
050,51,075,"Virginia","Goochland County",2,26,245,130,115
050,51,075,"Virginia","Goochland County",2,27,243,132,111
050,51,075,"Virginia","Goochland County",2,28,264,148,116
050,51,075,"Virginia","Goochland County",2,29,267,142,125
050,51,075,"Virginia","Goochland County",2,30,276,144,132
050,51,075,"Virginia","Goochland County",2,31,257,133,124
050,51,075,"Virginia","Goochland County",2,32,242,120,122
050,51,075,"Virginia","Goochland County",2,33,237,124,113
050,51,075,"Virginia","Goochland County",2,34,240,119,121
050,51,075,"Virginia","Goochland County",2,35,257,133,124
050,51,075,"Virginia","Goochland County",2,36,246,121,125
050,51,075,"Virginia","Goochland County",2,37,246,131,115
050,51,075,"Virginia","Goochland County",2,38,273,140,133
050,51,075,"Virginia","Goochland County",2,39,280,139,141
050,51,075,"Virginia","Goochland County",2,40,258,121,137
050,51,075,"Virginia","Goochland County",2,41,274,128,146
050,51,075,"Virginia","Goochland County",2,42,283,140,143
050,51,075,"Virginia","Goochland County",2,43,280,138,142
050,51,075,"Virginia","Goochland County",2,44,266,134,132
050,51,075,"Virginia","Goochland County",2,45,294,150,144
050,51,075,"Virginia","Goochland County",2,46,295,145,150
050,51,075,"Virginia","Goochland County",2,47,315,146,169
050,51,075,"Virginia","Goochland County",2,48,351,158,193
050,51,075,"Virginia","Goochland County",2,49,393,193,200
050,51,075,"Virginia","Goochland County",2,50,380,189,191
050,51,075,"Virginia","Goochland County",2,51,336,172,164
050,51,075,"Virginia","Goochland County",2,52,356,174,182
050,51,075,"Virginia","Goochland County",2,53,373,188,185
050,51,075,"Virginia","Goochland County",2,54,409,202,207
050,51,075,"Virginia","Goochland County",2,55,435,200,235
050,51,075,"Virginia","Goochland County",2,56,449,209,240
050,51,075,"Virginia","Goochland County",2,57,459,217,242
050,51,075,"Virginia","Goochland County",2,58,445,218,227
050,51,075,"Virginia","Goochland County",2,59,451,224,227
050,51,075,"Virginia","Goochland County",2,60,451,211,240
050,51,075,"Virginia","Goochland County",2,61,472,221,251
050,51,075,"Virginia","Goochland County",2,62,469,224,245
050,51,075,"Virginia","Goochland County",2,63,446,218,228
050,51,075,"Virginia","Goochland County",2,64,401,199,202
050,51,075,"Virginia","Goochland County",2,65,403,191,212
050,51,075,"Virginia","Goochland County",2,66,411,200,211
050,51,075,"Virginia","Goochland County",2,67,396,200,196
050,51,075,"Virginia","Goochland County",2,68,357,186,171
050,51,075,"Virginia","Goochland County",2,69,352,176,176
050,51,075,"Virginia","Goochland County",2,70,332,160,172
050,51,075,"Virginia","Goochland County",2,71,335,161,174
050,51,075,"Virginia","Goochland County",2,72,338,162,176
050,51,075,"Virginia","Goochland County",2,73,378,189,189
050,51,075,"Virginia","Goochland County",2,74,247,119,128
050,51,075,"Virginia","Goochland County",2,75,241,116,125
050,51,075,"Virginia","Goochland County",2,76,231,110,121
050,51,075,"Virginia","Goochland County",2,77,236,114,122
050,51,075,"Virginia","Goochland County",2,78,196,91,105
050,51,075,"Virginia","Goochland County",2,79,165,72,93
050,51,075,"Virginia","Goochland County",2,80,151,69,82
050,51,075,"Virginia","Goochland County",2,81,120,55,65
050,51,075,"Virginia","Goochland County",2,82,98,49,49
050,51,075,"Virginia","Goochland County",2,83,92,46,46
050,51,075,"Virginia","Goochland County",2,84,76,34,42
050,51,075,"Virginia","Goochland County",2,85,504,213,291
050,51,075,"Virginia","Goochland County",3,0,192,104,88
050,51,075,"Virginia","Goochland County",3,1,210,110,100
050,51,075,"Virginia","Goochland County",3,2,207,104,103
050,51,075,"Virginia","Goochland County",3,3,199,103,96
050,51,075,"Virginia","Goochland County",3,4,204,105,99
050,51,075,"Virginia","Goochland County",3,5,204,106,98
050,51,075,"Virginia","Goochland County",3,6,217,98,119
050,51,075,"Virginia","Goochland County",3,7,222,116,106
050,51,075,"Virginia","Goochland County",3,8,220,112,108
050,51,075,"Virginia","Goochland County",3,9,220,104,116
050,51,075,"Virginia","Goochland County",3,10,239,125,114
050,51,075,"Virginia","Goochland County",3,11,272,139,133
050,51,075,"Virginia","Goochland County",3,12,263,145,118
050,51,075,"Virginia","Goochland County",3,13,285,148,137
050,51,075,"Virginia","Goochland County",3,14,295,153,142
050,51,075,"Virginia","Goochland County",3,15,279,144,135
050,51,075,"Virginia","Goochland County",3,16,287,144,143
050,51,075,"Virginia","Goochland County",3,17,300,156,144
050,51,075,"Virginia","Goochland County",3,18,250,130,120
050,51,075,"Virginia","Goochland County",3,19,205,107,98
050,51,075,"Virginia","Goochland County",3,20,238,126,112
050,51,075,"Virginia","Goochland County",3,21,239,121,118
050,51,075,"Virginia","Goochland County",3,22,300,150,150
050,51,075,"Virginia","Goochland County",3,23,260,140,120
050,51,075,"Virginia","Goochland County",3,24,272,143,129
050,51,075,"Virginia","Goochland County",3,25,270,142,128
050,51,075,"Virginia","Goochland County",3,26,260,135,125
050,51,075,"Virginia","Goochland County",3,27,253,126,127
050,51,075,"Virginia","Goochland County",3,28,249,136,113
050,51,075,"Virginia","Goochland County",3,29,298,156,142
050,51,075,"Virginia","Goochland County",3,30,285,144,141
050,51,075,"Virginia","Goochland County",3,31,284,147,137
050,51,075,"Virginia","Goochland County",3,32,283,145,138
050,51,075,"Virginia","Goochland County",3,33,263,130,133
050,51,075,"Virginia","Goochland County",3,34,257,136,121
050,51,075,"Virginia","Goochland County",3,35,255,127,128
050,51,075,"Virginia","Goochland County",3,36,269,129,140
050,51,075,"Virginia","Goochland County",3,37,271,141,130
050,51,075,"Virginia","Goochland County",3,38,244,127,117
050,51,075,"Virginia","Goochland County",3,39,284,141,143
050,51,075,"Virginia","Goochland County",3,40,287,144,143
050,51,075,"Virginia","Goochland County",3,41,271,129,142
050,51,075,"Virginia","Goochland County",3,42,289,135,154
050,51,075,"Virginia","Goochland County",3,43,295,147,148
050,51,075,"Virginia","Goochland County",3,44,291,152,139
050,51,075,"Virginia","Goochland County",3,45,277,142,135
050,51,075,"Virginia","Goochland County",3,46,298,151,147
050,51,075,"Virginia","Goochland County",3,47,320,157,163
050,51,075,"Virginia","Goochland County",3,48,317,146,171
050,51,075,"Virginia","Goochland County",3,49,348,163,185
050,51,075,"Virginia","Goochland County",3,50,401,199,202
050,51,075,"Virginia","Goochland County",3,51,364,188,176
050,51,075,"Virginia","Goochland County",3,52,358,183,175
050,51,075,"Virginia","Goochland County",3,53,349,167,182
050,51,075,"Virginia","Goochland County",3,54,380,191,189
050,51,075,"Virginia","Goochland County",3,55,423,210,213
050,51,075,"Virginia","Goochland County",3,56,456,205,251
050,51,075,"Virginia","Goochland County",3,57,463,215,248
050,51,075,"Virginia","Goochland County",3,58,476,216,260
050,51,075,"Virginia","Goochland County",3,59,459,224,235
050,51,075,"Virginia","Goochland County",3,60,437,212,225
050,51,075,"Virginia","Goochland County",3,61,487,229,258
050,51,075,"Virginia","Goochland County",3,62,503,234,269
050,51,075,"Virginia","Goochland County",3,63,456,213,243
050,51,075,"Virginia","Goochland County",3,64,454,226,228
050,51,075,"Virginia","Goochland County",3,65,414,200,214
050,51,075,"Virginia","Goochland County",3,66,401,198,203
050,51,075,"Virginia","Goochland County",3,67,418,199,219
050,51,075,"Virginia","Goochland County",3,68,408,211,197
050,51,075,"Virginia","Goochland County",3,69,360,183,177
050,51,075,"Virginia","Goochland County",3,70,358,177,181
050,51,075,"Virginia","Goochland County",3,71,334,163,171
050,51,075,"Virginia","Goochland County",3,72,329,156,173
050,51,075,"Virginia","Goochland County",3,73,343,165,178
050,51,075,"Virginia","Goochland County",3,74,369,187,182
050,51,075,"Virginia","Goochland County",3,75,260,119,141
050,51,075,"Virginia","Goochland County",3,76,233,113,120
050,51,075,"Virginia","Goochland County",3,77,224,109,115
050,51,075,"Virginia","Goochland County",3,78,224,107,117
050,51,075,"Virginia","Goochland County",3,79,191,86,105
050,51,075,"Virginia","Goochland County",3,80,163,69,94
050,51,075,"Virginia","Goochland County",3,81,143,65,78
050,51,075,"Virginia","Goochland County",3,82,108,49,59
050,51,075,"Virginia","Goochland County",3,83,85,41,44
050,51,075,"Virginia","Goochland County",3,84,83,44,39
050,51,075,"Virginia","Goochland County",3,85,518,215,303
050,51,075,"Virginia","Goochland County",4,0,211,117,94
050,51,075,"Virginia","Goochland County",4,1,200,103,97
050,51,075,"Virginia","Goochland County",4,2,214,112,102
050,51,075,"Virginia","Goochland County",4,3,220,111,109
050,51,075,"Virginia","Goochland County",4,4,214,117,97
050,51,075,"Virginia","Goochland County",4,5,216,120,96
050,51,075,"Virginia","Goochland County",4,6,218,115,103
050,51,075,"Virginia","Goochland County",4,7,225,104,121
050,51,075,"Virginia","Goochland County",4,8,231,125,106
050,51,075,"Virginia","Goochland County",4,9,238,119,119
050,51,075,"Virginia","Goochland County",4,10,232,113,119
050,51,075,"Virginia","Goochland County",4,11,255,131,124
050,51,075,"Virginia","Goochland County",4,12,280,138,142
050,51,075,"Virginia","Goochland County",4,13,265,153,112
050,51,075,"Virginia","Goochland County",4,14,275,139,136
050,51,075,"Virginia","Goochland County",4,15,298,155,143
050,51,075,"Virginia","Goochland County",4,16,286,146,140
050,51,075,"Virginia","Goochland County",4,17,288,146,142
050,51,075,"Virginia","Goochland County",4,18,239,126,113
050,51,075,"Virginia","Goochland County",4,19,201,106,95
050,51,075,"Virginia","Goochland County",4,20,209,103,106
050,51,075,"Virginia","Goochland County",4,21,260,135,125
050,51,075,"Virginia","Goochland County",4,22,252,124,128
050,51,075,"Virginia","Goochland County",4,23,297,146,151
050,51,075,"Virginia","Goochland County",4,24,250,142,108
050,51,075,"Virginia","Goochland County",4,25,283,142,141
050,51,075,"Virginia","Goochland County",4,26,280,150,130
050,51,075,"Virginia","Goochland County",4,27,259,120,139
050,51,075,"Virginia","Goochland County",4,28,258,133,125
050,51,075,"Virginia","Goochland County",4,29,258,142,116
050,51,075,"Virginia","Goochland County",4,30,310,162,148
050,51,075,"Virginia","Goochland County",4,31,280,142,138
050,51,075,"Virginia","Goochland County",4,32,309,155,154
050,51,075,"Virginia","Goochland County",4,33,295,145,150
050,51,075,"Virginia","Goochland County",4,34,286,128,158
050,51,075,"Virginia","Goochland County",4,35,274,150,124
050,51,075,"Virginia","Goochland County",4,36,269,140,129
050,51,075,"Virginia","Goochland County",4,37,296,147,149
050,51,075,"Virginia","Goochland County",4,38,284,147,137
050,51,075,"Virginia","Goochland County",4,39,265,129,136
050,51,075,"Virginia","Goochland County",4,40,291,150,141
050,51,075,"Virginia","Goochland County",4,41,289,143,146
050,51,075,"Virginia","Goochland County",4,42,289,142,147
050,51,075,"Virginia","Goochland County",4,43,279,123,156
050,51,075,"Virginia","Goochland County",4,44,303,164,139
050,51,075,"Virginia","Goochland County",4,45,288,147,141
050,51,075,"Virginia","Goochland County",4,46,277,140,137
050,51,075,"Virginia","Goochland County",4,47,309,153,156
050,51,075,"Virginia","Goochland County",4,48,313,154,159
050,51,075,"Virginia","Goochland County",4,49,331,159,172
050,51,075,"Virginia","Goochland County",4,50,366,171,195
050,51,075,"Virginia","Goochland County",4,51,415,209,206
050,51,075,"Virginia","Goochland County",4,52,380,195,185
050,51,075,"Virginia","Goochland County",4,53,354,181,173
050,51,075,"Virginia","Goochland County",4,54,344,167,177
050,51,075,"Virginia","Goochland County",4,55,383,194,189
050,51,075,"Virginia","Goochland County",4,56,430,215,215
050,51,075,"Virginia","Goochland County",4,57,458,207,251
050,51,075,"Virginia","Goochland County",4,58,470,221,249
050,51,075,"Virginia","Goochland County",4,59,492,228,264
050,51,075,"Virginia","Goochland County",4,60,473,228,245
050,51,075,"Virginia","Goochland County",4,61,466,228,238
050,51,075,"Virginia","Goochland County",4,62,498,233,265
050,51,075,"Virginia","Goochland County",4,63,508,235,273
050,51,075,"Virginia","Goochland County",4,64,456,213,243
050,51,075,"Virginia","Goochland County",4,65,458,229,229
050,51,075,"Virginia","Goochland County",4,66,416,197,219
050,51,075,"Virginia","Goochland County",4,67,403,195,208
050,51,075,"Virginia","Goochland County",4,68,417,206,211
050,51,075,"Virginia","Goochland County",4,69,412,212,200
050,51,075,"Virginia","Goochland County",4,70,378,194,184
050,51,075,"Virginia","Goochland County",4,71,355,176,179
050,51,075,"Virginia","Goochland County",4,72,329,158,171
050,51,075,"Virginia","Goochland County",4,73,333,155,178
050,51,075,"Virginia","Goochland County",4,74,346,163,183
050,51,075,"Virginia","Goochland County",4,75,385,188,197
050,51,075,"Virginia","Goochland County",4,76,256,119,137
050,51,075,"Virginia","Goochland County",4,77,238,119,119
050,51,075,"Virginia","Goochland County",4,78,221,109,112
050,51,075,"Virginia","Goochland County",4,79,223,105,118
050,51,075,"Virginia","Goochland County",4,80,191,89,102
050,51,075,"Virginia","Goochland County",4,81,166,70,96
050,51,075,"Virginia","Goochland County",4,82,141,67,74
050,51,075,"Virginia","Goochland County",4,83,105,43,62
050,51,075,"Virginia","Goochland County",4,84,88,44,44
050,51,075,"Virginia","Goochland County",4,85,559,231,328
050,51,075,"Virginia","Goochland County",5,0,211,117,94
050,51,075,"Virginia","Goochland County",5,1,206,107,99
050,51,075,"Virginia","Goochland County",5,2,206,102,104
050,51,075,"Virginia","Goochland County",5,3,226,116,110
050,51,075,"Virginia","Goochland County",5,4,236,116,120
050,51,075,"Virginia","Goochland County",5,5,210,112,98
050,51,075,"Virginia","Goochland County",5,6,224,125,99
050,51,075,"Virginia","Goochland County",5,7,228,112,116
050,51,075,"Virginia","Goochland County",5,8,231,111,120
050,51,075,"Virginia","Goochland County",5,9,240,125,115
050,51,075,"Virginia","Goochland County",5,10,251,122,129
050,51,075,"Virginia","Goochland County",5,11,243,119,124
050,51,075,"Virginia","Goochland County",5,12,267,145,122
050,51,075,"Virginia","Goochland County",5,13,287,141,146
050,51,075,"Virginia","Goochland County",5,14,292,166,126
050,51,075,"Virginia","Goochland County",5,15,287,151,136
050,51,075,"Virginia","Goochland County",5,16,312,161,151
050,51,075,"Virginia","Goochland County",5,17,302,152,150
050,51,075,"Virginia","Goochland County",5,18,241,125,116
050,51,075,"Virginia","Goochland County",5,19,204,107,97
050,51,075,"Virginia","Goochland County",5,20,237,120,117
050,51,075,"Virginia","Goochland County",5,21,241,113,128
050,51,075,"Virginia","Goochland County",5,22,299,160,139
050,51,075,"Virginia","Goochland County",5,23,274,138,136
050,51,075,"Virginia","Goochland County",5,24,296,148,148
050,51,075,"Virginia","Goochland County",5,25,243,141,102
050,51,075,"Virginia","Goochland County",5,26,285,142,143
050,51,075,"Virginia","Goochland County",5,27,276,138,138
050,51,075,"Virginia","Goochland County",5,28,257,125,132
050,51,075,"Virginia","Goochland County",5,29,261,132,129
050,51,075,"Virginia","Goochland County",5,30,284,160,124
050,51,075,"Virginia","Goochland County",5,31,292,151,141
050,51,075,"Virginia","Goochland County",5,32,291,153,138
050,51,075,"Virginia","Goochland County",5,33,314,158,156
050,51,075,"Virginia","Goochland County",5,34,310,156,154
050,51,075,"Virginia","Goochland County",5,35,290,138,152
050,51,075,"Virginia","Goochland County",5,36,255,134,121
050,51,075,"Virginia","Goochland County",5,37,280,148,132
050,51,075,"Virginia","Goochland County",5,38,301,150,151
050,51,075,"Virginia","Goochland County",5,39,287,142,145
050,51,075,"Virginia","Goochland County",5,40,280,134,146
050,51,075,"Virginia","Goochland County",5,41,299,148,151
050,51,075,"Virginia","Goochland County",5,42,299,153,146
050,51,075,"Virginia","Goochland County",5,43,305,145,160
050,51,075,"Virginia","Goochland County",5,44,285,133,152
050,51,075,"Virginia","Goochland County",5,45,314,167,147
050,51,075,"Virginia","Goochland County",5,46,297,151,146
050,51,075,"Virginia","Goochland County",5,47,296,144,152
050,51,075,"Virginia","Goochland County",5,48,305,150,155
050,51,075,"Virginia","Goochland County",5,49,321,163,158
050,51,075,"Virginia","Goochland County",5,50,342,164,178
050,51,075,"Virginia","Goochland County",5,51,368,180,188
050,51,075,"Virginia","Goochland County",5,52,421,215,206
050,51,075,"Virginia","Goochland County",5,53,380,193,187
050,51,075,"Virginia","Goochland County",5,54,376,186,190
050,51,075,"Virginia","Goochland County",5,55,348,170,178
050,51,075,"Virginia","Goochland County",5,56,408,201,207
050,51,075,"Virginia","Goochland County",5,57,444,226,218
050,51,075,"Virginia","Goochland County",5,58,490,217,273
050,51,075,"Virginia","Goochland County",5,59,472,223,249
050,51,075,"Virginia","Goochland County",5,60,502,230,272
050,51,075,"Virginia","Goochland County",5,61,484,234,250
050,51,075,"Virginia","Goochland County",5,62,476,243,233
050,51,075,"Virginia","Goochland County",5,63,520,240,280
050,51,075,"Virginia","Goochland County",5,64,533,251,282
050,51,075,"Virginia","Goochland County",5,65,481,223,258
050,51,075,"Virginia","Goochland County",5,66,473,229,244
050,51,075,"Virginia","Goochland County",5,67,435,209,226
050,51,075,"Virginia","Goochland County",5,68,429,216,213
050,51,075,"Virginia","Goochland County",5,69,429,213,216
050,51,075,"Virginia","Goochland County",5,70,433,221,212
050,51,075,"Virginia","Goochland County",5,71,393,200,193
050,51,075,"Virginia","Goochland County",5,72,367,181,186
050,51,075,"Virginia","Goochland County",5,73,356,167,189
050,51,075,"Virginia","Goochland County",5,74,346,152,194
050,51,075,"Virginia","Goochland County",5,75,369,171,198
050,51,075,"Virginia","Goochland County",5,76,402,195,207
050,51,075,"Virginia","Goochland County",5,77,255,119,136
050,51,075,"Virginia","Goochland County",5,78,242,120,122
050,51,075,"Virginia","Goochland County",5,79,233,112,121
050,51,075,"Virginia","Goochland County",5,80,233,105,128
050,51,075,"Virginia","Goochland County",5,81,195,89,106
050,51,075,"Virginia","Goochland County",5,82,180,75,105
050,51,075,"Virginia","Goochland County",5,83,148,68,80
050,51,075,"Virginia","Goochland County",5,84,103,45,58
050,51,075,"Virginia","Goochland County",5,85,653,266,387
050,51,077,"Virginia","Grayson County",1,0,122,63,59
050,51,077,"Virginia","Grayson County",1,1,121,65,56
050,51,077,"Virginia","Grayson County",1,2,124,60,64
050,51,077,"Virginia","Grayson County",1,3,119,58,61
050,51,077,"Virginia","Grayson County",1,4,121,66,55
050,51,077,"Virginia","Grayson County",1,5,133,70,63
050,51,077,"Virginia","Grayson County",1,6,172,87,85
050,51,077,"Virginia","Grayson County",1,7,157,75,82
050,51,077,"Virginia","Grayson County",1,8,141,69,72
050,51,077,"Virginia","Grayson County",1,9,139,69,70
050,51,077,"Virginia","Grayson County",1,10,134,60,74
050,51,077,"Virginia","Grayson County",1,11,132,66,66
050,51,077,"Virginia","Grayson County",1,12,160,90,70
050,51,077,"Virginia","Grayson County",1,13,156,81,75
050,51,077,"Virginia","Grayson County",1,14,148,77,71
050,51,077,"Virginia","Grayson County",1,15,138,63,75
050,51,077,"Virginia","Grayson County",1,16,144,68,76
050,51,077,"Virginia","Grayson County",1,17,170,83,87
050,51,077,"Virginia","Grayson County",1,18,140,77,63
050,51,077,"Virginia","Grayson County",1,19,129,76,53
050,51,077,"Virginia","Grayson County",1,20,138,79,59
050,51,077,"Virginia","Grayson County",1,21,148,85,63
050,51,077,"Virginia","Grayson County",1,22,158,90,68
050,51,077,"Virginia","Grayson County",1,23,163,101,62
050,51,077,"Virginia","Grayson County",1,24,179,106,73
050,51,077,"Virginia","Grayson County",1,25,170,98,72
050,51,077,"Virginia","Grayson County",1,26,160,95,65
050,51,077,"Virginia","Grayson County",1,27,168,93,75
050,51,077,"Virginia","Grayson County",1,28,170,99,71
050,51,077,"Virginia","Grayson County",1,29,171,98,73
050,51,077,"Virginia","Grayson County",1,30,174,102,72
050,51,077,"Virginia","Grayson County",1,31,166,98,68
050,51,077,"Virginia","Grayson County",1,32,157,91,66
050,51,077,"Virginia","Grayson County",1,33,156,92,64
050,51,077,"Virginia","Grayson County",1,34,174,99,75
050,51,077,"Virginia","Grayson County",1,35,150,88,62
050,51,077,"Virginia","Grayson County",1,36,145,75,70
050,51,077,"Virginia","Grayson County",1,37,165,93,72
050,51,077,"Virginia","Grayson County",1,38,172,99,73
050,51,077,"Virginia","Grayson County",1,39,156,88,68
050,51,077,"Virginia","Grayson County",1,40,154,84,70
050,51,077,"Virginia","Grayson County",1,41,161,97,64
050,51,077,"Virginia","Grayson County",1,42,163,96,67
050,51,077,"Virginia","Grayson County",1,43,186,111,75
050,51,077,"Virginia","Grayson County",1,44,189,101,88
050,51,077,"Virginia","Grayson County",1,45,189,99,90
050,51,077,"Virginia","Grayson County",1,46,201,110,91
050,51,077,"Virginia","Grayson County",1,47,212,115,97
050,51,077,"Virginia","Grayson County",1,48,231,131,100
050,51,077,"Virginia","Grayson County",1,49,226,119,107
050,51,077,"Virginia","Grayson County",1,50,197,107,90
050,51,077,"Virginia","Grayson County",1,51,211,127,84
050,51,077,"Virginia","Grayson County",1,52,216,122,94
050,51,077,"Virginia","Grayson County",1,53,225,114,111
050,51,077,"Virginia","Grayson County",1,54,226,109,117
050,51,077,"Virginia","Grayson County",1,55,246,121,125
050,51,077,"Virginia","Grayson County",1,56,245,119,126
050,51,077,"Virginia","Grayson County",1,57,244,127,117
050,51,077,"Virginia","Grayson County",1,58,227,111,116
050,51,077,"Virginia","Grayson County",1,59,259,128,131
050,51,077,"Virginia","Grayson County",1,60,264,129,135
050,51,077,"Virginia","Grayson County",1,61,236,118,118
050,51,077,"Virginia","Grayson County",1,62,252,133,119
050,51,077,"Virginia","Grayson County",1,63,257,129,128
050,51,077,"Virginia","Grayson County",1,64,242,125,117
050,51,077,"Virginia","Grayson County",1,65,238,116,122
050,51,077,"Virginia","Grayson County",1,66,264,140,124
050,51,077,"Virginia","Grayson County",1,67,251,133,118
050,51,077,"Virginia","Grayson County",1,68,251,128,123
050,51,077,"Virginia","Grayson County",1,69,228,107,121
050,51,077,"Virginia","Grayson County",1,70,213,94,119
050,51,077,"Virginia","Grayson County",1,71,201,106,95
050,51,077,"Virginia","Grayson County",1,72,205,111,94
050,51,077,"Virginia","Grayson County",1,73,225,124,101
050,51,077,"Virginia","Grayson County",1,74,161,77,84
050,51,077,"Virginia","Grayson County",1,75,145,65,80
050,51,077,"Virginia","Grayson County",1,76,158,77,81
050,51,077,"Virginia","Grayson County",1,77,148,69,79
050,51,077,"Virginia","Grayson County",1,78,122,53,69
050,51,077,"Virginia","Grayson County",1,79,120,54,66
050,51,077,"Virginia","Grayson County",1,80,109,46,63
050,51,077,"Virginia","Grayson County",1,81,107,40,67
050,51,077,"Virginia","Grayson County",1,82,100,43,57
050,51,077,"Virginia","Grayson County",1,83,91,34,57
050,51,077,"Virginia","Grayson County",1,84,82,39,43
050,51,077,"Virginia","Grayson County",1,85,418,148,270
050,51,077,"Virginia","Grayson County",2,0,108,56,52
050,51,077,"Virginia","Grayson County",2,1,122,65,57
050,51,077,"Virginia","Grayson County",2,2,122,61,61
050,51,077,"Virginia","Grayson County",2,3,119,58,61
050,51,077,"Virginia","Grayson County",2,4,119,63,56
050,51,077,"Virginia","Grayson County",2,5,130,68,62
050,51,077,"Virginia","Grayson County",2,6,163,83,80
050,51,077,"Virginia","Grayson County",2,7,159,78,81
050,51,077,"Virginia","Grayson County",2,8,142,69,73
050,51,077,"Virginia","Grayson County",2,9,140,70,70
050,51,077,"Virginia","Grayson County",2,10,134,61,73
050,51,077,"Virginia","Grayson County",2,11,133,66,67
050,51,077,"Virginia","Grayson County",2,12,155,85,70
050,51,077,"Virginia","Grayson County",2,13,156,83,73
050,51,077,"Virginia","Grayson County",2,14,149,78,71
050,51,077,"Virginia","Grayson County",2,15,141,66,75
050,51,077,"Virginia","Grayson County",2,16,143,68,75
050,51,077,"Virginia","Grayson County",2,17,162,78,84
050,51,077,"Virginia","Grayson County",2,18,142,78,64
050,51,077,"Virginia","Grayson County",2,19,127,74,53
050,51,077,"Virginia","Grayson County",2,20,140,81,59
050,51,077,"Virginia","Grayson County",2,21,150,87,63
050,51,077,"Virginia","Grayson County",2,22,157,90,67
050,51,077,"Virginia","Grayson County",2,23,166,101,65
050,51,077,"Virginia","Grayson County",2,24,175,105,70
050,51,077,"Virginia","Grayson County",2,25,172,101,71
050,51,077,"Virginia","Grayson County",2,26,162,95,67
050,51,077,"Virginia","Grayson County",2,27,166,94,72
050,51,077,"Virginia","Grayson County",2,28,169,97,72
050,51,077,"Virginia","Grayson County",2,29,172,99,73
050,51,077,"Virginia","Grayson County",2,30,177,104,73
050,51,077,"Virginia","Grayson County",2,31,166,98,68
050,51,077,"Virginia","Grayson County",2,32,159,93,66
050,51,077,"Virginia","Grayson County",2,33,154,89,65
050,51,077,"Virginia","Grayson County",2,34,170,97,73
050,51,077,"Virginia","Grayson County",2,35,154,89,65
050,51,077,"Virginia","Grayson County",2,36,144,77,67
050,51,077,"Virginia","Grayson County",2,37,161,90,71
050,51,077,"Virginia","Grayson County",2,38,170,97,73
050,51,077,"Virginia","Grayson County",2,39,160,91,69
050,51,077,"Virginia","Grayson County",2,40,156,86,70
050,51,077,"Virginia","Grayson County",2,41,159,94,65
050,51,077,"Virginia","Grayson County",2,42,160,95,65
050,51,077,"Virginia","Grayson County",2,43,183,108,75
050,51,077,"Virginia","Grayson County",2,44,187,101,86
050,51,077,"Virginia","Grayson County",2,45,189,99,90
050,51,077,"Virginia","Grayson County",2,46,196,107,89
050,51,077,"Virginia","Grayson County",2,47,208,113,95
050,51,077,"Virginia","Grayson County",2,48,226,126,100
050,51,077,"Virginia","Grayson County",2,49,228,123,105
050,51,077,"Virginia","Grayson County",2,50,202,107,95
050,51,077,"Virginia","Grayson County",2,51,208,123,85
050,51,077,"Virginia","Grayson County",2,52,213,123,90
050,51,077,"Virginia","Grayson County",2,53,222,115,107
050,51,077,"Virginia","Grayson County",2,54,225,110,115
050,51,077,"Virginia","Grayson County",2,55,242,118,124
050,51,077,"Virginia","Grayson County",2,56,246,121,125
050,51,077,"Virginia","Grayson County",2,57,246,125,121
050,51,077,"Virginia","Grayson County",2,58,230,113,117
050,51,077,"Virginia","Grayson County",2,59,250,123,127
050,51,077,"Virginia","Grayson County",2,60,261,129,132
050,51,077,"Virginia","Grayson County",2,61,245,123,122
050,51,077,"Virginia","Grayson County",2,62,249,129,120
050,51,077,"Virginia","Grayson County",2,63,258,131,127
050,51,077,"Virginia","Grayson County",2,64,245,125,120
050,51,077,"Virginia","Grayson County",2,65,242,119,123
050,51,077,"Virginia","Grayson County",2,66,256,132,124
050,51,077,"Virginia","Grayson County",2,67,251,133,118
050,51,077,"Virginia","Grayson County",2,68,247,127,120
050,51,077,"Virginia","Grayson County",2,69,235,113,122
050,51,077,"Virginia","Grayson County",2,70,212,95,117
050,51,077,"Virginia","Grayson County",2,71,202,102,100
050,51,077,"Virginia","Grayson County",2,72,200,108,92
050,51,077,"Virginia","Grayson County",2,73,230,126,104
050,51,077,"Virginia","Grayson County",2,74,161,80,81
050,51,077,"Virginia","Grayson County",2,75,150,69,81
050,51,077,"Virginia","Grayson County",2,76,151,71,80
050,51,077,"Virginia","Grayson County",2,77,154,72,82
050,51,077,"Virginia","Grayson County",2,78,124,56,68
050,51,077,"Virginia","Grayson County",2,79,119,53,66
050,51,077,"Virginia","Grayson County",2,80,110,47,63
050,51,077,"Virginia","Grayson County",2,81,107,41,66
050,51,077,"Virginia","Grayson County",2,82,97,39,58
050,51,077,"Virginia","Grayson County",2,83,93,37,56
050,51,077,"Virginia","Grayson County",2,84,83,38,45
050,51,077,"Virginia","Grayson County",2,85,413,149,264
050,51,077,"Virginia","Grayson County",3,0,118,60,58
050,51,077,"Virginia","Grayson County",3,1,104,54,50
050,51,077,"Virginia","Grayson County",3,2,126,67,59
050,51,077,"Virginia","Grayson County",3,3,125,63,62
050,51,077,"Virginia","Grayson County",3,4,128,68,60
050,51,077,"Virginia","Grayson County",3,5,129,66,63
050,51,077,"Virginia","Grayson County",3,6,128,66,62
050,51,077,"Virginia","Grayson County",3,7,162,84,78
050,51,077,"Virginia","Grayson County",3,8,168,84,84
050,51,077,"Virginia","Grayson County",3,9,145,71,74
050,51,077,"Virginia","Grayson County",3,10,146,72,74
050,51,077,"Virginia","Grayson County",3,11,134,65,69
050,51,077,"Virginia","Grayson County",3,12,126,63,63
050,51,077,"Virginia","Grayson County",3,13,147,80,67
050,51,077,"Virginia","Grayson County",3,14,162,86,76
050,51,077,"Virginia","Grayson County",3,15,146,75,71
050,51,077,"Virginia","Grayson County",3,16,145,72,73
050,51,077,"Virginia","Grayson County",3,17,149,69,80
050,51,077,"Virginia","Grayson County",3,18,143,70,73
050,51,077,"Virginia","Grayson County",3,19,123,72,51
050,51,077,"Virginia","Grayson County",3,20,146,84,62
050,51,077,"Virginia","Grayson County",3,21,155,89,66
050,51,077,"Virginia","Grayson County",3,22,164,96,68
050,51,077,"Virginia","Grayson County",3,23,168,95,73
050,51,077,"Virginia","Grayson County",3,24,173,102,71
050,51,077,"Virginia","Grayson County",3,25,170,106,64
050,51,077,"Virginia","Grayson County",3,26,166,96,70
050,51,077,"Virginia","Grayson County",3,27,162,98,64
050,51,077,"Virginia","Grayson County",3,28,157,91,66
050,51,077,"Virginia","Grayson County",3,29,173,102,71
050,51,077,"Virginia","Grayson County",3,30,187,110,77
050,51,077,"Virginia","Grayson County",3,31,175,107,68
050,51,077,"Virginia","Grayson County",3,32,168,100,68
050,51,077,"Virginia","Grayson County",3,33,157,93,64
050,51,077,"Virginia","Grayson County",3,34,167,100,67
050,51,077,"Virginia","Grayson County",3,35,174,98,76
050,51,077,"Virginia","Grayson County",3,36,159,95,64
050,51,077,"Virginia","Grayson County",3,37,157,82,75
050,51,077,"Virginia","Grayson County",3,38,160,91,69
050,51,077,"Virginia","Grayson County",3,39,175,101,74
050,51,077,"Virginia","Grayson County",3,40,168,98,70
050,51,077,"Virginia","Grayson County",3,41,163,92,71
050,51,077,"Virginia","Grayson County",3,42,163,98,65
050,51,077,"Virginia","Grayson County",3,43,157,94,63
050,51,077,"Virginia","Grayson County",3,44,184,107,77
050,51,077,"Virginia","Grayson County",3,45,179,103,76
050,51,077,"Virginia","Grayson County",3,46,197,103,94
050,51,077,"Virginia","Grayson County",3,47,191,103,88
050,51,077,"Virginia","Grayson County",3,48,214,113,101
050,51,077,"Virginia","Grayson County",3,49,226,129,97
050,51,077,"Virginia","Grayson County",3,50,220,122,98
050,51,077,"Virginia","Grayson County",3,51,203,111,92
050,51,077,"Virginia","Grayson County",3,52,220,127,93
050,51,077,"Virginia","Grayson County",3,53,213,122,91
050,51,077,"Virginia","Grayson County",3,54,211,106,105
050,51,077,"Virginia","Grayson County",3,55,237,115,122
050,51,077,"Virginia","Grayson County",3,56,242,118,124
050,51,077,"Virginia","Grayson County",3,57,240,116,124
050,51,077,"Virginia","Grayson County",3,58,247,123,124
050,51,077,"Virginia","Grayson County",3,59,225,111,114
050,51,077,"Virginia","Grayson County",3,60,244,120,124
050,51,077,"Virginia","Grayson County",3,61,264,134,130
050,51,077,"Virginia","Grayson County",3,62,247,123,124
050,51,077,"Virginia","Grayson County",3,63,258,133,125
050,51,077,"Virginia","Grayson County",3,64,257,130,127
050,51,077,"Virginia","Grayson County",3,65,248,122,126
050,51,077,"Virginia","Grayson County",3,66,247,120,127
050,51,077,"Virginia","Grayson County",3,67,252,130,122
050,51,077,"Virginia","Grayson County",3,68,255,131,124
050,51,077,"Virginia","Grayson County",3,69,243,128,115
050,51,077,"Virginia","Grayson County",3,70,231,110,121
050,51,077,"Virginia","Grayson County",3,71,203,90,113
050,51,077,"Virginia","Grayson County",3,72,199,98,101
050,51,077,"Virginia","Grayson County",3,73,192,107,85
050,51,077,"Virginia","Grayson County",3,74,213,116,97
050,51,077,"Virginia","Grayson County",3,75,157,77,80
050,51,077,"Virginia","Grayson County",3,76,146,68,78
050,51,077,"Virginia","Grayson County",3,77,140,62,78
050,51,077,"Virginia","Grayson County",3,78,147,70,77
050,51,077,"Virginia","Grayson County",3,79,123,57,66
050,51,077,"Virginia","Grayson County",3,80,108,47,61
050,51,077,"Virginia","Grayson County",3,81,111,44,67
050,51,077,"Virginia","Grayson County",3,82,96,40,56
050,51,077,"Virginia","Grayson County",3,83,95,39,56
050,51,077,"Virginia","Grayson County",3,84,88,36,52
050,51,077,"Virginia","Grayson County",3,85,413,153,260
050,51,077,"Virginia","Grayson County",4,0,117,67,50
050,51,077,"Virginia","Grayson County",4,1,117,58,59
050,51,077,"Virginia","Grayson County",4,2,102,54,48
050,51,077,"Virginia","Grayson County",4,3,127,69,58
050,51,077,"Virginia","Grayson County",4,4,130,67,63
050,51,077,"Virginia","Grayson County",4,5,126,69,57
050,51,077,"Virginia","Grayson County",4,6,130,67,63
050,51,077,"Virginia","Grayson County",4,7,135,67,68
050,51,077,"Virginia","Grayson County",4,8,154,75,79
050,51,077,"Virginia","Grayson County",4,9,171,87,84
050,51,077,"Virginia","Grayson County",4,10,147,73,74
050,51,077,"Virginia","Grayson County",4,11,154,81,73
050,51,077,"Virginia","Grayson County",4,12,133,66,67
050,51,077,"Virginia","Grayson County",4,13,136,69,67
050,51,077,"Virginia","Grayson County",4,14,157,91,66
050,51,077,"Virginia","Grayson County",4,15,173,92,81
050,51,077,"Virginia","Grayson County",4,16,152,83,69
050,51,077,"Virginia","Grayson County",4,17,145,70,75
050,51,077,"Virginia","Grayson County",4,18,128,66,62
050,51,077,"Virginia","Grayson County",4,19,125,65,60
050,51,077,"Virginia","Grayson County",4,20,129,80,49
050,51,077,"Virginia","Grayson County",4,21,160,90,70
050,51,077,"Virginia","Grayson County",4,22,163,97,66
050,51,077,"Virginia","Grayson County",4,23,160,96,64
050,51,077,"Virginia","Grayson County",4,24,167,95,72
050,51,077,"Virginia","Grayson County",4,25,179,107,72
050,51,077,"Virginia","Grayson County",4,26,164,105,59
050,51,077,"Virginia","Grayson County",4,27,172,98,74
050,51,077,"Virginia","Grayson County",4,28,157,96,61
050,51,077,"Virginia","Grayson County",4,29,162,96,66
050,51,077,"Virginia","Grayson County",4,30,178,106,72
050,51,077,"Virginia","Grayson County",4,31,173,99,74
050,51,077,"Virginia","Grayson County",4,32,175,106,69
050,51,077,"Virginia","Grayson County",4,33,165,95,70
050,51,077,"Virginia","Grayson County",4,34,161,90,71
050,51,077,"Virginia","Grayson County",4,35,165,97,68
050,51,077,"Virginia","Grayson County",4,36,175,99,76
050,51,077,"Virginia","Grayson County",4,37,165,100,65
050,51,077,"Virginia","Grayson County",4,38,166,87,79
050,51,077,"Virginia","Grayson County",4,39,154,91,63
050,51,077,"Virginia","Grayson County",4,40,187,107,80
050,51,077,"Virginia","Grayson County",4,41,187,109,78
050,51,077,"Virginia","Grayson County",4,42,158,84,74
050,51,077,"Virginia","Grayson County",4,43,166,96,70
050,51,077,"Virginia","Grayson County",4,44,160,98,62
050,51,077,"Virginia","Grayson County",4,45,182,106,76
050,51,077,"Virginia","Grayson County",4,46,196,110,86
050,51,077,"Virginia","Grayson County",4,47,188,98,90
050,51,077,"Virginia","Grayson County",4,48,185,100,85
050,51,077,"Virginia","Grayson County",4,49,216,115,101
050,51,077,"Virginia","Grayson County",4,50,225,132,93
050,51,077,"Virginia","Grayson County",4,51,223,124,99
050,51,077,"Virginia","Grayson County",4,52,206,108,98
050,51,077,"Virginia","Grayson County",4,53,222,130,92
050,51,077,"Virginia","Grayson County",4,54,211,116,95
050,51,077,"Virginia","Grayson County",4,55,211,107,104
050,51,077,"Virginia","Grayson County",4,56,238,117,121
050,51,077,"Virginia","Grayson County",4,57,228,110,118
050,51,077,"Virginia","Grayson County",4,58,240,112,128
050,51,077,"Virginia","Grayson County",4,59,248,119,129
050,51,077,"Virginia","Grayson County",4,60,232,116,116
050,51,077,"Virginia","Grayson County",4,61,239,117,122
050,51,077,"Virginia","Grayson County",4,62,264,133,131
050,51,077,"Virginia","Grayson County",4,63,240,120,120
050,51,077,"Virginia","Grayson County",4,64,260,132,128
050,51,077,"Virginia","Grayson County",4,65,258,129,129
050,51,077,"Virginia","Grayson County",4,66,248,121,127
050,51,077,"Virginia","Grayson County",4,67,252,126,126
050,51,077,"Virginia","Grayson County",4,68,247,122,125
050,51,077,"Virginia","Grayson County",4,69,253,128,125
050,51,077,"Virginia","Grayson County",4,70,240,126,114
050,51,077,"Virginia","Grayson County",4,71,225,106,119
050,51,077,"Virginia","Grayson County",4,72,201,88,113
050,51,077,"Virginia","Grayson County",4,73,195,94,101
050,51,077,"Virginia","Grayson County",4,74,177,97,80
050,51,077,"Virginia","Grayson County",4,75,209,114,95
050,51,077,"Virginia","Grayson County",4,76,156,77,79
050,51,077,"Virginia","Grayson County",4,77,134,62,72
050,51,077,"Virginia","Grayson County",4,78,132,59,73
050,51,077,"Virginia","Grayson County",4,79,150,73,77
050,51,077,"Virginia","Grayson County",4,80,107,45,62
050,51,077,"Virginia","Grayson County",4,81,107,40,67
050,51,077,"Virginia","Grayson County",4,82,97,41,56
050,51,077,"Virginia","Grayson County",4,83,91,39,52
050,51,077,"Virginia","Grayson County",4,84,86,38,48
050,51,077,"Virginia","Grayson County",4,85,399,143,256
050,51,077,"Virginia","Grayson County",5,0,118,69,49
050,51,077,"Virginia","Grayson County",5,1,119,65,54
050,51,077,"Virginia","Grayson County",5,2,119,64,55
050,51,077,"Virginia","Grayson County",5,3,105,56,49
050,51,077,"Virginia","Grayson County",5,4,133,77,56
050,51,077,"Virginia","Grayson County",5,5,139,70,69
050,51,077,"Virginia","Grayson County",5,6,128,69,59
050,51,077,"Virginia","Grayson County",5,7,135,71,64
050,51,077,"Virginia","Grayson County",5,8,131,62,69
050,51,077,"Virginia","Grayson County",5,9,165,78,87
050,51,077,"Virginia","Grayson County",5,10,168,81,87
050,51,077,"Virginia","Grayson County",5,11,147,74,73
050,51,077,"Virginia","Grayson County",5,12,160,84,76
050,51,077,"Virginia","Grayson County",5,13,137,66,71
050,51,077,"Virginia","Grayson County",5,14,145,77,68
050,51,077,"Virginia","Grayson County",5,15,156,90,66
050,51,077,"Virginia","Grayson County",5,16,170,95,75
050,51,077,"Virginia","Grayson County",5,17,165,82,83
050,51,077,"Virginia","Grayson County",5,18,139,70,69
050,51,077,"Virginia","Grayson County",5,19,105,58,47
050,51,077,"Virginia","Grayson County",5,20,143,72,71
050,51,077,"Virginia","Grayson County",5,21,137,84,53
050,51,077,"Virginia","Grayson County",5,22,163,95,68
050,51,077,"Virginia","Grayson County",5,23,163,99,64
050,51,077,"Virginia","Grayson County",5,24,180,108,72
050,51,077,"Virginia","Grayson County",5,25,166,93,73
050,51,077,"Virginia","Grayson County",5,26,164,95,69
050,51,077,"Virginia","Grayson County",5,27,163,109,54
050,51,077,"Virginia","Grayson County",5,28,166,96,70
050,51,077,"Virginia","Grayson County",5,29,161,99,62
050,51,077,"Virginia","Grayson County",5,30,165,95,70
050,51,077,"Virginia","Grayson County",5,31,162,100,62
050,51,077,"Virginia","Grayson County",5,32,178,104,74
050,51,077,"Virginia","Grayson County",5,33,173,100,73
050,51,077,"Virginia","Grayson County",5,34,171,99,72
050,51,077,"Virginia","Grayson County",5,35,156,86,70
050,51,077,"Virginia","Grayson County",5,36,166,97,69
050,51,077,"Virginia","Grayson County",5,37,184,108,76
050,51,077,"Virginia","Grayson County",5,38,169,100,69
050,51,077,"Virginia","Grayson County",5,39,165,87,78
050,51,077,"Virginia","Grayson County",5,40,158,92,66
050,51,077,"Virginia","Grayson County",5,41,193,110,83
050,51,077,"Virginia","Grayson County",5,42,177,106,71
050,51,077,"Virginia","Grayson County",5,43,162,87,75
050,51,077,"Virginia","Grayson County",5,44,177,103,74
050,51,077,"Virginia","Grayson County",5,45,161,96,65
050,51,077,"Virginia","Grayson County",5,46,194,114,80
050,51,077,"Virginia","Grayson County",5,47,188,104,84
050,51,077,"Virginia","Grayson County",5,48,192,100,92
050,51,077,"Virginia","Grayson County",5,49,183,98,85
050,51,077,"Virginia","Grayson County",5,50,209,108,101
050,51,077,"Virginia","Grayson County",5,51,222,128,94
050,51,077,"Virginia","Grayson County",5,52,221,121,100
050,51,077,"Virginia","Grayson County",5,53,204,106,98
050,51,077,"Virginia","Grayson County",5,54,213,121,92
050,51,077,"Virginia","Grayson County",5,55,221,118,103
050,51,077,"Virginia","Grayson County",5,56,199,106,93
050,51,077,"Virginia","Grayson County",5,57,235,115,120
050,51,077,"Virginia","Grayson County",5,58,222,108,114
050,51,077,"Virginia","Grayson County",5,59,239,113,126
050,51,077,"Virginia","Grayson County",5,60,251,118,133
050,51,077,"Virginia","Grayson County",5,61,226,114,112
050,51,077,"Virginia","Grayson County",5,62,238,115,123
050,51,077,"Virginia","Grayson County",5,63,266,135,131
050,51,077,"Virginia","Grayson County",5,64,239,119,120
050,51,077,"Virginia","Grayson County",5,65,259,130,129
050,51,077,"Virginia","Grayson County",5,66,263,132,131
050,51,077,"Virginia","Grayson County",5,67,246,119,127
050,51,077,"Virginia","Grayson County",5,68,241,120,121
050,51,077,"Virginia","Grayson County",5,69,243,122,121
050,51,077,"Virginia","Grayson County",5,70,252,126,126
050,51,077,"Virginia","Grayson County",5,71,235,124,111
050,51,077,"Virginia","Grayson County",5,72,224,106,118
050,51,077,"Virginia","Grayson County",5,73,191,83,108
050,51,077,"Virginia","Grayson County",5,74,179,83,96
050,51,077,"Virginia","Grayson County",5,75,168,93,75
050,51,077,"Virginia","Grayson County",5,76,206,113,93
050,51,077,"Virginia","Grayson County",5,77,140,68,72
050,51,077,"Virginia","Grayson County",5,78,132,61,71
050,51,077,"Virginia","Grayson County",5,79,133,62,71
050,51,077,"Virginia","Grayson County",5,80,136,66,70
050,51,077,"Virginia","Grayson County",5,81,101,38,63
050,51,077,"Virginia","Grayson County",5,82,92,38,54
050,51,077,"Virginia","Grayson County",5,83,94,39,55
050,51,077,"Virginia","Grayson County",5,84,80,36,44
050,51,077,"Virginia","Grayson County",5,85,401,143,258
050,51,079,"Virginia","Greene County",1,0,217,109,108
050,51,079,"Virginia","Greene County",1,1,240,120,120
050,51,079,"Virginia","Greene County",1,2,252,123,129
050,51,079,"Virginia","Greene County",1,3,249,112,137
050,51,079,"Virginia","Greene County",1,4,244,114,130
050,51,079,"Virginia","Greene County",1,5,261,134,127
050,51,079,"Virginia","Greene County",1,6,242,121,121
050,51,079,"Virginia","Greene County",1,7,246,125,121
050,51,079,"Virginia","Greene County",1,8,242,127,115
050,51,079,"Virginia","Greene County",1,9,254,135,119
050,51,079,"Virginia","Greene County",1,10,302,156,146
050,51,079,"Virginia","Greene County",1,11,294,144,150
050,51,079,"Virginia","Greene County",1,12,303,147,156
050,51,079,"Virginia","Greene County",1,13,311,173,138
050,51,079,"Virginia","Greene County",1,14,322,173,149
050,51,079,"Virginia","Greene County",1,15,294,154,140
050,51,079,"Virginia","Greene County",1,16,307,161,146
050,51,079,"Virginia","Greene County",1,17,286,153,133
050,51,079,"Virginia","Greene County",1,18,236,132,104
050,51,079,"Virginia","Greene County",1,19,185,99,86
050,51,079,"Virginia","Greene County",1,20,197,108,89
050,51,079,"Virginia","Greene County",1,21,197,112,85
050,51,079,"Virginia","Greene County",1,22,189,100,89
050,51,079,"Virginia","Greene County",1,23,182,89,93
050,51,079,"Virginia","Greene County",1,24,198,97,101
050,51,079,"Virginia","Greene County",1,25,207,113,94
050,51,079,"Virginia","Greene County",1,26,204,108,96
050,51,079,"Virginia","Greene County",1,27,226,113,113
050,51,079,"Virginia","Greene County",1,28,253,122,131
050,51,079,"Virginia","Greene County",1,29,279,130,149
050,51,079,"Virginia","Greene County",1,30,259,110,149
050,51,079,"Virginia","Greene County",1,31,250,128,122
050,51,079,"Virginia","Greene County",1,32,264,129,135
050,51,079,"Virginia","Greene County",1,33,272,139,133
050,51,079,"Virginia","Greene County",1,34,281,149,132
050,51,079,"Virginia","Greene County",1,35,257,120,137
050,51,079,"Virginia","Greene County",1,36,250,136,114
050,51,079,"Virginia","Greene County",1,37,244,116,128
050,51,079,"Virginia","Greene County",1,38,225,100,125
050,51,079,"Virginia","Greene County",1,39,271,124,147
050,51,079,"Virginia","Greene County",1,40,271,137,134
050,51,079,"Virginia","Greene County",1,41,248,132,116
050,51,079,"Virginia","Greene County",1,42,265,135,130
050,51,079,"Virginia","Greene County",1,43,245,119,126
050,51,079,"Virginia","Greene County",1,44,227,106,121
050,51,079,"Virginia","Greene County",1,45,239,115,124
050,51,079,"Virginia","Greene County",1,46,233,123,110
050,51,079,"Virginia","Greene County",1,47,245,130,115
050,51,079,"Virginia","Greene County",1,48,249,128,121
050,51,079,"Virginia","Greene County",1,49,272,134,138
050,51,079,"Virginia","Greene County",1,50,263,130,133
050,51,079,"Virginia","Greene County",1,51,272,128,144
050,51,079,"Virginia","Greene County",1,52,287,152,135
050,51,079,"Virginia","Greene County",1,53,269,144,125
050,51,079,"Virginia","Greene County",1,54,281,142,139
050,51,079,"Virginia","Greene County",1,55,309,150,159
050,51,079,"Virginia","Greene County",1,56,334,166,168
050,51,079,"Virginia","Greene County",1,57,314,144,170
050,51,079,"Virginia","Greene County",1,58,318,160,158
050,51,079,"Virginia","Greene County",1,59,290,145,145
050,51,079,"Virginia","Greene County",1,60,296,154,142
050,51,079,"Virginia","Greene County",1,61,277,135,142
050,51,079,"Virginia","Greene County",1,62,286,145,141
050,51,079,"Virginia","Greene County",1,63,274,129,145
050,51,079,"Virginia","Greene County",1,64,264,127,137
050,51,079,"Virginia","Greene County",1,65,243,103,140
050,51,079,"Virginia","Greene County",1,66,264,124,140
050,51,079,"Virginia","Greene County",1,67,263,126,137
050,51,079,"Virginia","Greene County",1,68,216,103,113
050,51,079,"Virginia","Greene County",1,69,221,98,123
050,51,079,"Virginia","Greene County",1,70,225,98,127
050,51,079,"Virginia","Greene County",1,71,217,107,110
050,51,079,"Virginia","Greene County",1,72,249,116,133
050,51,079,"Virginia","Greene County",1,73,249,118,131
050,51,079,"Virginia","Greene County",1,74,173,79,94
050,51,079,"Virginia","Greene County",1,75,161,78,83
050,51,079,"Virginia","Greene County",1,76,152,66,86
050,51,079,"Virginia","Greene County",1,77,145,73,72
050,51,079,"Virginia","Greene County",1,78,125,62,63
050,51,079,"Virginia","Greene County",1,79,115,53,62
050,51,079,"Virginia","Greene County",1,80,91,35,56
050,51,079,"Virginia","Greene County",1,81,98,48,50
050,51,079,"Virginia","Greene County",1,82,81,38,43
050,51,079,"Virginia","Greene County",1,83,66,27,39
050,51,079,"Virginia","Greene County",1,84,64,28,36
050,51,079,"Virginia","Greene County",1,85,316,111,205
050,51,079,"Virginia","Greene County",2,0,213,111,102
050,51,079,"Virginia","Greene County",2,1,236,120,116
050,51,079,"Virginia","Greene County",2,2,253,124,129
050,51,079,"Virginia","Greene County",2,3,248,113,135
050,51,079,"Virginia","Greene County",2,4,247,116,131
050,51,079,"Virginia","Greene County",2,5,259,131,128
050,51,079,"Virginia","Greene County",2,6,248,126,122
050,51,079,"Virginia","Greene County",2,7,244,124,120
050,51,079,"Virginia","Greene County",2,8,242,126,116
050,51,079,"Virginia","Greene County",2,9,253,133,120
050,51,079,"Virginia","Greene County",2,10,290,150,140
050,51,079,"Virginia","Greene County",2,11,297,147,150
050,51,079,"Virginia","Greene County",2,12,302,148,154
050,51,079,"Virginia","Greene County",2,13,311,167,144
050,51,079,"Virginia","Greene County",2,14,318,172,146
050,51,079,"Virginia","Greene County",2,15,302,159,143
050,51,079,"Virginia","Greene County",2,16,303,159,144
050,51,079,"Virginia","Greene County",2,17,291,155,136
050,51,079,"Virginia","Greene County",2,18,237,132,105
050,51,079,"Virginia","Greene County",2,19,186,101,85
050,51,079,"Virginia","Greene County",2,20,201,110,91
050,51,079,"Virginia","Greene County",2,21,197,111,86
050,51,079,"Virginia","Greene County",2,22,192,102,90
050,51,079,"Virginia","Greene County",2,23,187,91,96
050,51,079,"Virginia","Greene County",2,24,199,98,101
050,51,079,"Virginia","Greene County",2,25,207,110,97
050,51,079,"Virginia","Greene County",2,26,210,112,98
050,51,079,"Virginia","Greene County",2,27,225,113,112
050,51,079,"Virginia","Greene County",2,28,251,122,129
050,51,079,"Virginia","Greene County",2,29,276,128,148
050,51,079,"Virginia","Greene County",2,30,267,117,150
050,51,079,"Virginia","Greene County",2,31,257,127,130
050,51,079,"Virginia","Greene County",2,32,264,131,133
050,51,079,"Virginia","Greene County",2,33,274,139,135
050,51,079,"Virginia","Greene County",2,34,281,149,132
050,51,079,"Virginia","Greene County",2,35,265,130,135
050,51,079,"Virginia","Greene County",2,36,249,131,118
050,51,079,"Virginia","Greene County",2,37,246,119,127
050,51,079,"Virginia","Greene County",2,38,230,105,125
050,51,079,"Virginia","Greene County",2,39,259,119,140
050,51,079,"Virginia","Greene County",2,40,271,134,137
050,51,079,"Virginia","Greene County",2,41,252,131,121
050,51,079,"Virginia","Greene County",2,42,263,135,128
050,51,079,"Virginia","Greene County",2,43,253,124,129
050,51,079,"Virginia","Greene County",2,44,229,107,122
050,51,079,"Virginia","Greene County",2,45,233,112,121
050,51,079,"Virginia","Greene County",2,46,234,121,113
050,51,079,"Virginia","Greene County",2,47,243,129,114
050,51,079,"Virginia","Greene County",2,48,248,129,119
050,51,079,"Virginia","Greene County",2,49,271,135,136
050,51,079,"Virginia","Greene County",2,50,266,131,135
050,51,079,"Virginia","Greene County",2,51,268,127,141
050,51,079,"Virginia","Greene County",2,52,280,145,135
050,51,079,"Virginia","Greene County",2,53,275,148,127
050,51,079,"Virginia","Greene County",2,54,275,141,134
050,51,079,"Virginia","Greene County",2,55,303,149,154
050,51,079,"Virginia","Greene County",2,56,329,161,168
050,51,079,"Virginia","Greene County",2,57,315,148,167
050,51,079,"Virginia","Greene County",2,58,315,155,160
050,51,079,"Virginia","Greene County",2,59,298,149,149
050,51,079,"Virginia","Greene County",2,60,294,151,143
050,51,079,"Virginia","Greene County",2,61,282,141,141
050,51,079,"Virginia","Greene County",2,62,282,141,141
050,51,079,"Virginia","Greene County",2,63,279,135,144
050,51,079,"Virginia","Greene County",2,64,262,126,136
050,51,079,"Virginia","Greene County",2,65,246,108,138
050,51,079,"Virginia","Greene County",2,66,260,120,140
050,51,079,"Virginia","Greene County",2,67,262,126,136
050,51,079,"Virginia","Greene County",2,68,224,105,119
050,51,079,"Virginia","Greene County",2,69,222,100,122
050,51,079,"Virginia","Greene County",2,70,224,98,126
050,51,079,"Virginia","Greene County",2,71,217,104,113
050,51,079,"Virginia","Greene County",2,72,236,112,124
050,51,079,"Virginia","Greene County",2,73,263,125,138
050,51,079,"Virginia","Greene County",2,74,177,81,96
050,51,079,"Virginia","Greene County",2,75,164,79,85
050,51,079,"Virginia","Greene County",2,76,154,68,86
050,51,079,"Virginia","Greene County",2,77,153,73,80
050,51,079,"Virginia","Greene County",2,78,124,63,61
050,51,079,"Virginia","Greene County",2,79,115,55,60
050,51,079,"Virginia","Greene County",2,80,98,40,58
050,51,079,"Virginia","Greene County",2,81,97,45,52
050,51,079,"Virginia","Greene County",2,82,83,39,44
050,51,079,"Virginia","Greene County",2,83,68,29,39
050,51,079,"Virginia","Greene County",2,84,64,28,36
050,51,079,"Virginia","Greene County",2,85,319,114,205
050,51,079,"Virginia","Greene County",3,0,239,115,124
050,51,079,"Virginia","Greene County",3,1,254,139,115
050,51,079,"Virginia","Greene County",3,2,272,135,137
050,51,079,"Virginia","Greene County",3,3,273,132,141
050,51,079,"Virginia","Greene County",3,4,254,117,137
050,51,079,"Virginia","Greene County",3,5,265,120,145
050,51,079,"Virginia","Greene County",3,6,268,133,135
050,51,079,"Virginia","Greene County",3,7,256,127,129
050,51,079,"Virginia","Greene County",3,8,251,124,127
050,51,079,"Virginia","Greene County",3,9,249,130,119
050,51,079,"Virginia","Greene County",3,10,259,138,121
050,51,079,"Virginia","Greene County",3,11,296,157,139
050,51,079,"Virginia","Greene County",3,12,300,150,150
050,51,079,"Virginia","Greene County",3,13,301,147,154
050,51,079,"Virginia","Greene County",3,14,311,164,147
050,51,079,"Virginia","Greene County",3,15,330,182,148
050,51,079,"Virginia","Greene County",3,16,308,161,147
050,51,079,"Virginia","Greene County",3,17,293,157,136
050,51,079,"Virginia","Greene County",3,18,246,141,105
050,51,079,"Virginia","Greene County",3,19,185,100,85
050,51,079,"Virginia","Greene County",3,20,192,103,89
050,51,079,"Virginia","Greene County",3,21,205,113,92
050,51,079,"Virginia","Greene County",3,22,214,116,98
050,51,079,"Virginia","Greene County",3,23,205,112,93
050,51,079,"Virginia","Greene County",3,24,186,96,90
050,51,079,"Virginia","Greene County",3,25,206,103,103
050,51,079,"Virginia","Greene County",3,26,222,116,106
050,51,079,"Virginia","Greene County",3,27,234,111,123
050,51,079,"Virginia","Greene County",3,28,252,130,122
050,51,079,"Virginia","Greene County",3,29,273,134,139
050,51,079,"Virginia","Greene County",3,30,284,140,144
050,51,079,"Virginia","Greene County",3,31,268,111,157
050,51,079,"Virginia","Greene County",3,32,281,137,144
050,51,079,"Virginia","Greene County",3,33,272,137,135
050,51,079,"Virginia","Greene County",3,34,284,139,145
050,51,079,"Virginia","Greene County",3,35,301,156,145
050,51,079,"Virginia","Greene County",3,36,281,139,142
050,51,079,"Virginia","Greene County",3,37,267,139,128
050,51,079,"Virginia","Greene County",3,38,261,130,131
050,51,079,"Virginia","Greene County",3,39,240,116,124
050,51,079,"Virginia","Greene County",3,40,280,131,149
050,51,079,"Virginia","Greene County",3,41,289,150,139
050,51,079,"Virginia","Greene County",3,42,248,130,118
050,51,079,"Virginia","Greene County",3,43,261,133,128
050,51,079,"Virginia","Greene County",3,44,239,118,121
050,51,079,"Virginia","Greene County",3,45,219,99,120
050,51,079,"Virginia","Greene County",3,46,231,113,118
050,51,079,"Virginia","Greene County",3,47,235,120,115
050,51,079,"Virginia","Greene County",3,48,241,129,112
050,51,079,"Virginia","Greene County",3,49,258,137,121
050,51,079,"Virginia","Greene County",3,50,271,133,138
050,51,079,"Virginia","Greene County",3,51,262,125,137
050,51,079,"Virginia","Greene County",3,52,278,132,146
050,51,079,"Virginia","Greene County",3,53,277,147,130
050,51,079,"Virginia","Greene County",3,54,273,150,123
050,51,079,"Virginia","Greene County",3,55,285,146,139
050,51,079,"Virginia","Greene County",3,56,305,149,156
050,51,079,"Virginia","Greene County",3,57,314,154,160
050,51,079,"Virginia","Greene County",3,58,318,148,170
050,51,079,"Virginia","Greene County",3,59,317,152,165
050,51,079,"Virginia","Greene County",3,60,300,153,147
050,51,079,"Virginia","Greene County",3,61,284,143,141
050,51,079,"Virginia","Greene County",3,62,278,137,141
050,51,079,"Virginia","Greene County",3,63,283,138,145
050,51,079,"Virginia","Greene County",3,64,273,140,133
050,51,079,"Virginia","Greene County",3,65,261,125,136
050,51,079,"Virginia","Greene County",3,66,241,108,133
050,51,079,"Virginia","Greene County",3,67,255,117,138
050,51,079,"Virginia","Greene County",3,68,255,120,135
050,51,079,"Virginia","Greene County",3,69,225,106,119
050,51,079,"Virginia","Greene County",3,70,219,98,121
050,51,079,"Virginia","Greene County",3,71,218,94,124
050,51,079,"Virginia","Greene County",3,72,207,101,106
050,51,079,"Virginia","Greene County",3,73,232,107,125
050,51,079,"Virginia","Greene County",3,74,249,119,130
050,51,079,"Virginia","Greene County",3,75,169,73,96
050,51,079,"Virginia","Greene County",3,76,154,73,81
050,51,079,"Virginia","Greene County",3,77,149,64,85
050,51,079,"Virginia","Greene County",3,78,138,65,73
050,51,079,"Virginia","Greene County",3,79,116,61,55
050,51,079,"Virginia","Greene County",3,80,101,46,55
050,51,079,"Virginia","Greene County",3,81,92,38,54
050,51,079,"Virginia","Greene County",3,82,87,40,47
050,51,079,"Virginia","Greene County",3,83,79,37,42
050,51,079,"Virginia","Greene County",3,84,61,32,29
050,51,079,"Virginia","Greene County",3,85,339,124,215
050,51,079,"Virginia","Greene County",4,0,237,110,127
050,51,079,"Virginia","Greene County",4,1,255,129,126
050,51,079,"Virginia","Greene County",4,2,254,137,117
050,51,079,"Virginia","Greene County",4,3,257,131,126
050,51,079,"Virginia","Greene County",4,4,265,127,138
050,51,079,"Virginia","Greene County",4,5,242,110,132
050,51,079,"Virginia","Greene County",4,6,267,119,148
050,51,079,"Virginia","Greene County",4,7,271,136,135
050,51,079,"Virginia","Greene County",4,8,264,135,129
050,51,079,"Virginia","Greene County",4,9,259,127,132
050,51,079,"Virginia","Greene County",4,10,247,126,121
050,51,079,"Virginia","Greene County",4,11,248,133,115
050,51,079,"Virginia","Greene County",4,12,309,165,144
050,51,079,"Virginia","Greene County",4,13,305,162,143
050,51,079,"Virginia","Greene County",4,14,307,153,154
050,51,079,"Virginia","Greene County",4,15,308,162,146
050,51,079,"Virginia","Greene County",4,16,325,175,150
050,51,079,"Virginia","Greene County",4,17,305,162,143
050,51,079,"Virginia","Greene County",4,18,249,142,107
050,51,079,"Virginia","Greene County",4,19,189,108,81
050,51,079,"Virginia","Greene County",4,20,183,99,84
050,51,079,"Virginia","Greene County",4,21,201,109,92
050,51,079,"Virginia","Greene County",4,22,217,113,104
050,51,079,"Virginia","Greene County",4,23,217,116,101
050,51,079,"Virginia","Greene County",4,24,211,114,97
050,51,079,"Virginia","Greene County",4,25,181,87,94
050,51,079,"Virginia","Greene County",4,26,190,89,101
050,51,079,"Virginia","Greene County",4,27,220,109,111
050,51,079,"Virginia","Greene County",4,28,235,112,123
050,51,079,"Virginia","Greene County",4,29,254,135,119
050,51,079,"Virginia","Greene County",4,30,272,127,145
050,51,079,"Virginia","Greene County",4,31,268,132,136
050,51,079,"Virginia","Greene County",4,32,275,113,162
050,51,079,"Virginia","Greene County",4,33,277,134,143
050,51,079,"Virginia","Greene County",4,34,282,133,149
050,51,079,"Virginia","Greene County",4,35,301,150,151
050,51,079,"Virginia","Greene County",4,36,291,145,146
050,51,079,"Virginia","Greene County",4,37,277,143,134
050,51,079,"Virginia","Greene County",4,38,271,138,133
050,51,079,"Virginia","Greene County",4,39,275,140,135
050,51,079,"Virginia","Greene County",4,40,241,116,125
050,51,079,"Virginia","Greene County",4,41,260,117,143
050,51,079,"Virginia","Greene County",4,42,292,148,144
050,51,079,"Virginia","Greene County",4,43,252,130,122
050,51,079,"Virginia","Greene County",4,44,257,131,126
050,51,079,"Virginia","Greene County",4,45,240,123,117
050,51,079,"Virginia","Greene County",4,46,217,98,119
050,51,079,"Virginia","Greene County",4,47,235,115,120
050,51,079,"Virginia","Greene County",4,48,240,121,119
050,51,079,"Virginia","Greene County",4,49,245,130,115
050,51,079,"Virginia","Greene County",4,50,256,140,116
050,51,079,"Virginia","Greene County",4,51,279,137,142
050,51,079,"Virginia","Greene County",4,52,263,125,138
050,51,079,"Virginia","Greene County",4,53,285,137,148
050,51,079,"Virginia","Greene County",4,54,277,141,136
050,51,079,"Virginia","Greene County",4,55,274,146,128
050,51,079,"Virginia","Greene County",4,56,295,151,144
050,51,079,"Virginia","Greene County",4,57,303,149,154
050,51,079,"Virginia","Greene County",4,58,308,152,156
050,51,079,"Virginia","Greene County",4,59,313,142,171
050,51,079,"Virginia","Greene County",4,60,306,148,158
050,51,079,"Virginia","Greene County",4,61,293,148,145
050,51,079,"Virginia","Greene County",4,62,283,142,141
050,51,079,"Virginia","Greene County",4,63,277,137,140
050,51,079,"Virginia","Greene County",4,64,266,131,135
050,51,079,"Virginia","Greene County",4,65,273,139,134
050,51,079,"Virginia","Greene County",4,66,264,121,143
050,51,079,"Virginia","Greene County",4,67,250,115,135
050,51,079,"Virginia","Greene County",4,68,262,118,144
050,51,079,"Virginia","Greene County",4,69,257,121,136
050,51,079,"Virginia","Greene County",4,70,226,108,118
050,51,079,"Virginia","Greene County",4,71,222,97,125
050,51,079,"Virginia","Greene County",4,72,216,96,120
050,51,079,"Virginia","Greene County",4,73,212,104,108
050,51,079,"Virginia","Greene County",4,74,217,100,117
050,51,079,"Virginia","Greene County",4,75,241,113,128
050,51,079,"Virginia","Greene County",4,76,160,71,89
050,51,079,"Virginia","Greene County",4,77,151,71,80
050,51,079,"Virginia","Greene County",4,78,140,58,82
050,51,079,"Virginia","Greene County",4,79,131,63,68
050,51,079,"Virginia","Greene County",4,80,110,57,53
050,51,079,"Virginia","Greene County",4,81,93,42,51
050,51,079,"Virginia","Greene County",4,82,86,36,50
050,51,079,"Virginia","Greene County",4,83,77,33,44
050,51,079,"Virginia","Greene County",4,84,73,39,34
050,51,079,"Virginia","Greene County",4,85,336,129,207
050,51,079,"Virginia","Greene County",5,0,237,110,127
050,51,079,"Virginia","Greene County",5,1,243,105,138
050,51,079,"Virginia","Greene County",5,2,263,129,134
050,51,079,"Virginia","Greene County",5,3,247,134,113
050,51,079,"Virginia","Greene County",5,4,251,121,130
050,51,079,"Virginia","Greene County",5,5,265,133,132
050,51,079,"Virginia","Greene County",5,6,240,112,128
050,51,079,"Virginia","Greene County",5,7,273,121,152
050,51,079,"Virginia","Greene County",5,8,285,146,139
050,51,079,"Virginia","Greene County",5,9,268,135,133
050,51,079,"Virginia","Greene County",5,10,262,134,128
050,51,079,"Virginia","Greene County",5,11,262,136,126
050,51,079,"Virginia","Greene County",5,12,251,135,116
050,51,079,"Virginia","Greene County",5,13,309,169,140
050,51,079,"Virginia","Greene County",5,14,303,158,145
050,51,079,"Virginia","Greene County",5,15,311,154,157
050,51,079,"Virginia","Greene County",5,16,302,159,143
050,51,079,"Virginia","Greene County",5,17,310,168,142
050,51,079,"Virginia","Greene County",5,18,273,153,120
050,51,079,"Virginia","Greene County",5,19,205,118,87
050,51,079,"Virginia","Greene County",5,20,203,114,89
050,51,079,"Virginia","Greene County",5,21,203,109,94
050,51,079,"Virginia","Greene County",5,22,219,117,102
050,51,079,"Virginia","Greene County",5,23,231,117,114
050,51,079,"Virginia","Greene County",5,24,225,125,100
050,51,079,"Virginia","Greene County",5,25,224,118,106
050,51,079,"Virginia","Greene County",5,26,189,90,99
050,51,079,"Virginia","Greene County",5,27,198,90,108
050,51,079,"Virginia","Greene County",5,28,230,104,126
050,51,079,"Virginia","Greene County",5,29,254,119,135
050,51,079,"Virginia","Greene County",5,30,262,134,128
050,51,079,"Virginia","Greene County",5,31,283,137,146
050,51,079,"Virginia","Greene County",5,32,285,146,139
050,51,079,"Virginia","Greene County",5,33,271,103,168
050,51,079,"Virginia","Greene County",5,34,288,141,147
050,51,079,"Virginia","Greene County",5,35,279,127,152
050,51,079,"Virginia","Greene County",5,36,303,150,153
050,51,079,"Virginia","Greene County",5,37,297,144,153
050,51,079,"Virginia","Greene County",5,38,290,151,139
050,51,079,"Virginia","Greene County",5,39,269,137,132
050,51,079,"Virginia","Greene County",5,40,260,135,125
050,51,079,"Virginia","Greene County",5,41,248,116,132
050,51,079,"Virginia","Greene County",5,42,270,119,151
050,51,079,"Virginia","Greene County",5,43,296,150,146
050,51,079,"Virginia","Greene County",5,44,264,138,126
050,51,079,"Virginia","Greene County",5,45,261,138,123
050,51,079,"Virginia","Greene County",5,46,249,129,120
050,51,079,"Virginia","Greene County",5,47,241,107,134
050,51,079,"Virginia","Greene County",5,48,239,116,123
050,51,079,"Virginia","Greene County",5,49,235,120,115
050,51,079,"Virginia","Greene County",5,50,253,134,119
050,51,079,"Virginia","Greene County",5,51,244,131,113
050,51,079,"Virginia","Greene County",5,52,277,139,138
050,51,079,"Virginia","Greene County",5,53,261,127,134
050,51,079,"Virginia","Greene County",5,54,275,125,150
050,51,079,"Virginia","Greene County",5,55,265,134,131
050,51,079,"Virginia","Greene County",5,56,274,143,131
050,51,079,"Virginia","Greene County",5,57,289,142,147
050,51,079,"Virginia","Greene County",5,58,305,151,154
050,51,079,"Virginia","Greene County",5,59,309,152,157
050,51,079,"Virginia","Greene County",5,60,317,143,174
050,51,079,"Virginia","Greene County",5,61,305,144,161
050,51,079,"Virginia","Greene County",5,62,291,148,143
050,51,079,"Virginia","Greene County",5,63,291,144,147
050,51,079,"Virginia","Greene County",5,64,274,131,143
050,51,079,"Virginia","Greene County",5,65,266,128,138
050,51,079,"Virginia","Greene County",5,66,284,146,138
050,51,079,"Virginia","Greene County",5,67,274,128,146
050,51,079,"Virginia","Greene County",5,68,247,110,137
050,51,079,"Virginia","Greene County",5,69,262,118,144
050,51,079,"Virginia","Greene County",5,70,258,119,139
050,51,079,"Virginia","Greene County",5,71,226,108,118
050,51,079,"Virginia","Greene County",5,72,220,103,117
050,51,079,"Virginia","Greene County",5,73,213,94,119
050,51,079,"Virginia","Greene County",5,74,201,100,101
050,51,079,"Virginia","Greene County",5,75,203,92,111
050,51,079,"Virginia","Greene County",5,76,235,111,124
050,51,079,"Virginia","Greene County",5,77,154,68,86
050,51,079,"Virginia","Greene County",5,78,145,66,79
050,51,079,"Virginia","Greene County",5,79,133,55,78
050,51,079,"Virginia","Greene County",5,80,123,59,64
050,51,079,"Virginia","Greene County",5,81,107,51,56
050,51,079,"Virginia","Greene County",5,82,89,40,49
050,51,079,"Virginia","Greene County",5,83,77,31,46
050,51,079,"Virginia","Greene County",5,84,71,35,36
050,51,079,"Virginia","Greene County",5,85,357,140,217
050,51,081,"Virginia","Greensville County",1,0,93,47,46
050,51,081,"Virginia","Greensville County",1,1,71,38,33
050,51,081,"Virginia","Greensville County",1,2,80,33,47
050,51,081,"Virginia","Greensville County",1,3,82,41,41
050,51,081,"Virginia","Greensville County",1,4,98,55,43
050,51,081,"Virginia","Greensville County",1,5,84,39,45
050,51,081,"Virginia","Greensville County",1,6,112,57,55
050,51,081,"Virginia","Greensville County",1,7,105,62,43
050,51,081,"Virginia","Greensville County",1,8,113,69,44
050,51,081,"Virginia","Greensville County",1,9,112,59,53
050,51,081,"Virginia","Greensville County",1,10,103,55,48
050,51,081,"Virginia","Greensville County",1,11,105,54,51
050,51,081,"Virginia","Greensville County",1,12,117,64,53
050,51,081,"Virginia","Greensville County",1,13,126,60,66
050,51,081,"Virginia","Greensville County",1,14,118,58,60
050,51,081,"Virginia","Greensville County",1,15,122,59,63
050,51,081,"Virginia","Greensville County",1,16,125,59,66
050,51,081,"Virginia","Greensville County",1,17,116,62,54
050,51,081,"Virginia","Greensville County",1,18,101,60,41
050,51,081,"Virginia","Greensville County",1,19,109,68,41
050,51,081,"Virginia","Greensville County",1,20,135,84,51
050,51,081,"Virginia","Greensville County",1,21,129,80,49
050,51,081,"Virginia","Greensville County",1,22,156,114,42
050,51,081,"Virginia","Greensville County",1,23,153,125,28
050,51,081,"Virginia","Greensville County",1,24,166,124,42
050,51,081,"Virginia","Greensville County",1,25,147,115,32
050,51,081,"Virginia","Greensville County",1,26,165,127,38
050,51,081,"Virginia","Greensville County",1,27,168,120,48
050,51,081,"Virginia","Greensville County",1,28,180,127,53
050,51,081,"Virginia","Greensville County",1,29,171,117,54
050,51,081,"Virginia","Greensville County",1,30,199,145,54
050,51,081,"Virginia","Greensville County",1,31,210,157,53
050,51,081,"Virginia","Greensville County",1,32,218,167,51
050,51,081,"Virginia","Greensville County",1,33,175,127,48
050,51,081,"Virginia","Greensville County",1,34,168,117,51
050,51,081,"Virginia","Greensville County",1,35,165,118,47
050,51,081,"Virginia","Greensville County",1,36,151,115,36
050,51,081,"Virginia","Greensville County",1,37,178,138,40
050,51,081,"Virginia","Greensville County",1,38,169,131,38
050,51,081,"Virginia","Greensville County",1,39,153,115,38
050,51,081,"Virginia","Greensville County",1,40,173,135,38
050,51,081,"Virginia","Greensville County",1,41,178,130,48
050,51,081,"Virginia","Greensville County",1,42,187,128,59
050,51,081,"Virginia","Greensville County",1,43,152,117,35
050,51,081,"Virginia","Greensville County",1,44,187,149,38
050,51,081,"Virginia","Greensville County",1,45,181,130,51
050,51,081,"Virginia","Greensville County",1,46,191,138,53
050,51,081,"Virginia","Greensville County",1,47,159,109,50
050,51,081,"Virginia","Greensville County",1,48,176,118,58
050,51,081,"Virginia","Greensville County",1,49,193,134,59
050,51,081,"Virginia","Greensville County",1,50,204,133,71
050,51,081,"Virginia","Greensville County",1,51,181,120,61
050,51,081,"Virginia","Greensville County",1,52,166,108,58
050,51,081,"Virginia","Greensville County",1,53,144,91,53
050,51,081,"Virginia","Greensville County",1,54,164,112,52
050,51,081,"Virginia","Greensville County",1,55,162,100,62
050,51,081,"Virginia","Greensville County",1,56,174,111,63
050,51,081,"Virginia","Greensville County",1,57,161,99,62
050,51,081,"Virginia","Greensville County",1,58,150,92,58
050,51,081,"Virginia","Greensville County",1,59,134,70,64
050,51,081,"Virginia","Greensville County",1,60,146,77,69
050,51,081,"Virginia","Greensville County",1,61,138,85,53
050,51,081,"Virginia","Greensville County",1,62,146,80,66
050,51,081,"Virginia","Greensville County",1,63,163,82,81
050,51,081,"Virginia","Greensville County",1,64,123,54,69
050,51,081,"Virginia","Greensville County",1,65,144,73,71
050,51,081,"Virginia","Greensville County",1,66,130,73,57
050,51,081,"Virginia","Greensville County",1,67,123,71,52
050,51,081,"Virginia","Greensville County",1,68,123,67,56
050,51,081,"Virginia","Greensville County",1,69,121,59,62
050,51,081,"Virginia","Greensville County",1,70,116,55,61
050,51,081,"Virginia","Greensville County",1,71,114,59,55
050,51,081,"Virginia","Greensville County",1,72,103,51,52
050,51,081,"Virginia","Greensville County",1,73,105,47,58
050,51,081,"Virginia","Greensville County",1,74,79,33,46
050,51,081,"Virginia","Greensville County",1,75,75,29,46
050,51,081,"Virginia","Greensville County",1,76,72,24,48
050,51,081,"Virginia","Greensville County",1,77,75,29,46
050,51,081,"Virginia","Greensville County",1,78,60,25,35
050,51,081,"Virginia","Greensville County",1,79,45,18,27
050,51,081,"Virginia","Greensville County",1,80,50,17,33
050,51,081,"Virginia","Greensville County",1,81,36,15,21
050,51,081,"Virginia","Greensville County",1,82,36,15,21
050,51,081,"Virginia","Greensville County",1,83,41,16,25
050,51,081,"Virginia","Greensville County",1,84,32,17,15
050,51,081,"Virginia","Greensville County",1,85,130,45,85
050,51,081,"Virginia","Greensville County",2,0,99,50,49
050,51,081,"Virginia","Greensville County",2,1,78,40,38
050,51,081,"Virginia","Greensville County",2,2,79,34,45
050,51,081,"Virginia","Greensville County",2,3,84,41,43
050,51,081,"Virginia","Greensville County",2,4,94,51,43
050,51,081,"Virginia","Greensville County",2,5,90,45,45
050,51,081,"Virginia","Greensville County",2,6,105,52,53
050,51,081,"Virginia","Greensville County",2,7,106,61,45
050,51,081,"Virginia","Greensville County",2,8,111,67,44
050,51,081,"Virginia","Greensville County",2,9,110,61,49
050,51,081,"Virginia","Greensville County",2,10,103,55,48
050,51,081,"Virginia","Greensville County",2,11,106,55,51
050,51,081,"Virginia","Greensville County",2,12,118,63,55
050,51,081,"Virginia","Greensville County",2,13,126,63,63
050,51,081,"Virginia","Greensville County",2,14,122,59,63
050,51,081,"Virginia","Greensville County",2,15,121,59,62
050,51,081,"Virginia","Greensville County",2,16,127,60,67
050,51,081,"Virginia","Greensville County",2,17,116,60,56
050,51,081,"Virginia","Greensville County",2,18,102,61,41
050,51,081,"Virginia","Greensville County",2,19,105,66,39
050,51,081,"Virginia","Greensville County",2,20,136,86,50
050,51,081,"Virginia","Greensville County",2,21,131,80,51
050,51,081,"Virginia","Greensville County",2,22,157,114,43
050,51,081,"Virginia","Greensville County",2,23,155,123,32
050,51,081,"Virginia","Greensville County",2,24,163,124,39
050,51,081,"Virginia","Greensville County",2,25,150,116,34
050,51,081,"Virginia","Greensville County",2,26,161,125,36
050,51,081,"Virginia","Greensville County",2,27,169,122,47
050,51,081,"Virginia","Greensville County",2,28,183,130,53
050,51,081,"Virginia","Greensville County",2,29,170,116,54
050,51,081,"Virginia","Greensville County",2,30,199,145,54
050,51,081,"Virginia","Greensville County",2,31,204,153,51
050,51,081,"Virginia","Greensville County",2,32,219,169,50
050,51,081,"Virginia","Greensville County",2,33,178,129,49
050,51,081,"Virginia","Greensville County",2,34,168,117,51
050,51,081,"Virginia","Greensville County",2,35,164,117,47
050,51,081,"Virginia","Greensville County",2,36,153,115,38
050,51,081,"Virginia","Greensville County",2,37,178,138,40
050,51,081,"Virginia","Greensville County",2,38,171,133,38
050,51,081,"Virginia","Greensville County",2,39,154,116,38
050,51,081,"Virginia","Greensville County",2,40,175,137,38
050,51,081,"Virginia","Greensville County",2,41,173,128,45
050,51,081,"Virginia","Greensville County",2,42,184,128,56
050,51,081,"Virginia","Greensville County",2,43,160,118,42
050,51,081,"Virginia","Greensville County",2,44,183,146,37
050,51,081,"Virginia","Greensville County",2,45,180,131,49
050,51,081,"Virginia","Greensville County",2,46,190,139,51
050,51,081,"Virginia","Greensville County",2,47,158,107,51
050,51,081,"Virginia","Greensville County",2,48,174,118,56
050,51,081,"Virginia","Greensville County",2,49,192,132,60
050,51,081,"Virginia","Greensville County",2,50,199,132,67
050,51,081,"Virginia","Greensville County",2,51,184,122,62
050,51,081,"Virginia","Greensville County",2,52,164,106,58
050,51,081,"Virginia","Greensville County",2,53,144,91,53
050,51,081,"Virginia","Greensville County",2,54,160,108,52
050,51,081,"Virginia","Greensville County",2,55,158,100,58
050,51,081,"Virginia","Greensville County",2,56,174,111,63
050,51,081,"Virginia","Greensville County",2,57,162,99,63
050,51,081,"Virginia","Greensville County",2,58,153,93,60
050,51,081,"Virginia","Greensville County",2,59,134,72,62
050,51,081,"Virginia","Greensville County",2,60,143,76,67
050,51,081,"Virginia","Greensville County",2,61,140,85,55
050,51,081,"Virginia","Greensville County",2,62,141,80,61
050,51,081,"Virginia","Greensville County",2,63,162,83,79
050,51,081,"Virginia","Greensville County",2,64,128,57,71
050,51,081,"Virginia","Greensville County",2,65,141,71,70
050,51,081,"Virginia","Greensville County",2,66,132,72,60
050,51,081,"Virginia","Greensville County",2,67,124,71,53
050,51,081,"Virginia","Greensville County",2,68,123,68,55
050,51,081,"Virginia","Greensville County",2,69,120,60,60
050,51,081,"Virginia","Greensville County",2,70,115,54,61
050,51,081,"Virginia","Greensville County",2,71,115,59,56
050,51,081,"Virginia","Greensville County",2,72,101,50,51
050,51,081,"Virginia","Greensville County",2,73,107,49,58
050,51,081,"Virginia","Greensville County",2,74,81,35,46
050,51,081,"Virginia","Greensville County",2,75,75,30,45
050,51,081,"Virginia","Greensville County",2,76,71,24,47
050,51,081,"Virginia","Greensville County",2,77,71,26,45
050,51,081,"Virginia","Greensville County",2,78,62,25,37
050,51,081,"Virginia","Greensville County",2,79,48,19,29
050,51,081,"Virginia","Greensville County",2,80,49,18,31
050,51,081,"Virginia","Greensville County",2,81,37,13,24
050,51,081,"Virginia","Greensville County",2,82,34,15,19
050,51,081,"Virginia","Greensville County",2,83,36,15,21
050,51,081,"Virginia","Greensville County",2,84,34,17,17
050,51,081,"Virginia","Greensville County",2,85,130,45,85
050,51,081,"Virginia","Greensville County",3,0,99,52,47
050,51,081,"Virginia","Greensville County",3,1,103,53,50
050,51,081,"Virginia","Greensville County",3,2,83,41,42
050,51,081,"Virginia","Greensville County",3,3,82,40,42
050,51,081,"Virginia","Greensville County",3,4,82,39,43
050,51,081,"Virginia","Greensville County",3,5,91,45,46
050,51,081,"Virginia","Greensville County",3,6,86,42,44
050,51,081,"Virginia","Greensville County",3,7,100,48,52
050,51,081,"Virginia","Greensville County",3,8,93,55,38
050,51,081,"Virginia","Greensville County",3,9,112,70,42
050,51,081,"Virginia","Greensville County",3,10,113,64,49
050,51,081,"Virginia","Greensville County",3,11,100,53,47
050,51,081,"Virginia","Greensville County",3,12,103,56,47
050,51,081,"Virginia","Greensville County",3,13,116,58,58
050,51,081,"Virginia","Greensville County",3,14,117,60,57
050,51,081,"Virginia","Greensville County",3,15,122,56,66
050,51,081,"Virginia","Greensville County",3,16,122,58,64
050,51,081,"Virginia","Greensville County",3,17,120,59,61
050,51,081,"Virginia","Greensville County",3,18,109,61,48
050,51,081,"Virginia","Greensville County",3,19,97,60,37
050,51,081,"Virginia","Greensville County",3,20,128,88,40
050,51,081,"Virginia","Greensville County",3,21,140,87,53
050,51,081,"Virginia","Greensville County",3,22,166,118,48
050,51,081,"Virginia","Greensville County",3,23,170,123,47
050,51,081,"Virginia","Greensville County",3,24,166,134,32
050,51,081,"Virginia","Greensville County",3,25,148,112,36
050,51,081,"Virginia","Greensville County",3,26,159,121,38
050,51,081,"Virginia","Greensville County",3,27,157,121,36
050,51,081,"Virginia","Greensville County",3,28,193,147,46
050,51,081,"Virginia","Greensville County",3,29,179,128,51
050,51,081,"Virginia","Greensville County",3,30,192,142,50
050,51,081,"Virginia","Greensville County",3,31,206,148,58
050,51,081,"Virginia","Greensville County",3,32,230,176,54
050,51,081,"Virginia","Greensville County",3,33,194,143,51
050,51,081,"Virginia","Greensville County",3,34,164,117,47
050,51,081,"Virginia","Greensville County",3,35,170,123,47
050,51,081,"Virginia","Greensville County",3,36,160,118,42
050,51,081,"Virginia","Greensville County",3,37,174,133,41
050,51,081,"Virginia","Greensville County",3,38,176,138,38
050,51,081,"Virginia","Greensville County",3,39,162,122,40
050,51,081,"Virginia","Greensville County",3,40,186,146,40
050,51,081,"Virginia","Greensville County",3,41,168,130,38
050,51,081,"Virginia","Greensville County",3,42,184,137,47
050,51,081,"Virginia","Greensville County",3,43,175,119,56
050,51,081,"Virginia","Greensville County",3,44,181,141,40
050,51,081,"Virginia","Greensville County",3,45,176,139,37
050,51,081,"Virginia","Greensville County",3,46,200,149,51
050,51,081,"Virginia","Greensville County",3,47,162,111,51
050,51,081,"Virginia","Greensville County",3,48,168,117,51
050,51,081,"Virginia","Greensville County",3,49,168,116,52
050,51,081,"Virginia","Greensville County",3,50,190,131,59
050,51,081,"Virginia","Greensville County",3,51,203,133,70
050,51,081,"Virginia","Greensville County",3,52,178,114,64
050,51,081,"Virginia","Greensville County",3,53,141,87,54
050,51,081,"Virginia","Greensville County",3,54,140,89,51
050,51,081,"Virginia","Greensville County",3,55,150,98,52
050,51,081,"Virginia","Greensville County",3,56,175,118,57
050,51,081,"Virginia","Greensville County",3,57,163,101,62
050,51,081,"Virginia","Greensville County",3,58,164,99,65
050,51,081,"Virginia","Greensville County",3,59,136,77,59
050,51,081,"Virginia","Greensville County",3,60,134,71,63
050,51,081,"Virginia","Greensville County",3,61,145,80,65
050,51,081,"Virginia","Greensville County",3,62,130,77,53
050,51,081,"Virginia","Greensville County",3,63,149,88,61
050,51,081,"Virginia","Greensville County",3,64,138,64,74
050,51,081,"Virginia","Greensville County",3,65,132,64,68
050,51,081,"Virginia","Greensville County",3,66,139,71,68
050,51,081,"Virginia","Greensville County",3,67,128,67,61
050,51,081,"Virginia","Greensville County",3,68,123,70,53
050,51,081,"Virginia","Greensville County",3,69,118,63,55
050,51,081,"Virginia","Greensville County",3,70,110,52,58
050,51,081,"Virginia","Greensville County",3,71,117,57,60
050,51,081,"Virginia","Greensville County",3,72,106,51,55
050,51,081,"Virginia","Greensville County",3,73,95,46,49
050,51,081,"Virginia","Greensville County",3,74,107,48,59
050,51,081,"Virginia","Greensville County",3,75,74,30,44
050,51,081,"Virginia","Greensville County",3,76,73,31,42
050,51,081,"Virginia","Greensville County",3,77,67,20,47
050,51,081,"Virginia","Greensville County",3,78,71,25,46
050,51,081,"Virginia","Greensville County",3,79,59,23,36
050,51,081,"Virginia","Greensville County",3,80,46,17,29
050,51,081,"Virginia","Greensville County",3,81,43,16,27
050,51,081,"Virginia","Greensville County",3,82,33,10,23
050,51,081,"Virginia","Greensville County",3,83,31,12,19
050,51,081,"Virginia","Greensville County",3,84,29,12,17
050,51,081,"Virginia","Greensville County",3,85,124,50,74
050,51,081,"Virginia","Greensville County",4,0,90,49,41
050,51,081,"Virginia","Greensville County",4,1,91,47,44
050,51,081,"Virginia","Greensville County",4,2,94,50,44
050,51,081,"Virginia","Greensville County",4,3,86,43,43
050,51,081,"Virginia","Greensville County",4,4,79,39,40
050,51,081,"Virginia","Greensville County",4,5,85,42,43
050,51,081,"Virginia","Greensville County",4,6,90,47,43
050,51,081,"Virginia","Greensville County",4,7,88,41,47
050,51,081,"Virginia","Greensville County",4,8,104,47,57
050,51,081,"Virginia","Greensville County",4,9,93,54,39
050,51,081,"Virginia","Greensville County",4,10,109,67,42
050,51,081,"Virginia","Greensville County",4,11,118,64,54
050,51,081,"Virginia","Greensville County",4,12,102,52,50
050,51,081,"Virginia","Greensville County",4,13,108,57,51
050,51,081,"Virginia","Greensville County",4,14,107,57,50
050,51,081,"Virginia","Greensville County",4,15,123,61,62
050,51,081,"Virginia","Greensville County",4,16,130,60,70
050,51,081,"Virginia","Greensville County",4,17,119,54,65
050,51,081,"Virginia","Greensville County",4,18,116,66,50
050,51,081,"Virginia","Greensville County",4,19,98,63,35
050,51,081,"Virginia","Greensville County",4,20,125,84,41
050,51,081,"Virginia","Greensville County",4,21,138,95,43
050,51,081,"Virginia","Greensville County",4,22,170,120,50
050,51,081,"Virginia","Greensville County",4,23,169,117,52
050,51,081,"Virginia","Greensville County",4,24,168,122,46
050,51,081,"Virginia","Greensville County",4,25,156,127,29
050,51,081,"Virginia","Greensville County",4,26,150,114,36
050,51,081,"Virginia","Greensville County",4,27,148,113,35
050,51,081,"Virginia","Greensville County",4,28,170,136,34
050,51,081,"Virginia","Greensville County",4,29,166,127,39
050,51,081,"Virginia","Greensville County",4,30,198,145,53
050,51,081,"Virginia","Greensville County",4,31,186,134,52
050,51,081,"Virginia","Greensville County",4,32,220,165,55
050,51,081,"Virginia","Greensville County",4,33,194,142,52
050,51,081,"Virginia","Greensville County",4,34,171,127,44
050,51,081,"Virginia","Greensville County",4,35,163,112,51
050,51,081,"Virginia","Greensville County",4,36,161,113,48
050,51,081,"Virginia","Greensville County",4,37,182,140,42
050,51,081,"Virginia","Greensville County",4,38,174,133,41
050,51,081,"Virginia","Greensville County",4,39,162,125,37
050,51,081,"Virginia","Greensville County",4,40,178,138,40
050,51,081,"Virginia","Greensville County",4,41,175,135,40
050,51,081,"Virginia","Greensville County",4,42,159,124,35
050,51,081,"Virginia","Greensville County",4,43,163,117,46
050,51,081,"Virginia","Greensville County",4,44,194,139,55
050,51,081,"Virginia","Greensville County",4,45,164,127,37
050,51,081,"Virginia","Greensville County",4,46,190,153,37
050,51,081,"Virginia","Greensville County",4,47,163,115,48
050,51,081,"Virginia","Greensville County",4,48,163,112,51
050,51,081,"Virginia","Greensville County",4,49,170,115,55
050,51,081,"Virginia","Greensville County",4,50,166,114,52
050,51,081,"Virginia","Greensville County",4,51,186,129,57
050,51,081,"Virginia","Greensville County",4,52,187,118,69
050,51,081,"Virginia","Greensville County",4,53,159,95,64
050,51,081,"Virginia","Greensville County",4,54,142,90,52
050,51,081,"Virginia","Greensville County",4,55,131,82,49
050,51,081,"Virginia","Greensville County",4,56,165,113,52
050,51,081,"Virginia","Greensville County",4,57,156,100,56
050,51,081,"Virginia","Greensville County",4,58,154,95,59
050,51,081,"Virginia","Greensville County",4,59,132,68,64
050,51,081,"Virginia","Greensville County",4,60,132,73,59
050,51,081,"Virginia","Greensville County",4,61,131,74,57
050,51,081,"Virginia","Greensville County",4,62,132,68,64
050,51,081,"Virginia","Greensville County",4,63,134,80,54
050,51,081,"Virginia","Greensville County",4,64,126,71,55
050,51,081,"Virginia","Greensville County",4,65,144,72,72
050,51,081,"Virginia","Greensville County",4,66,130,62,68
050,51,081,"Virginia","Greensville County",4,67,135,67,68
050,51,081,"Virginia","Greensville County",4,68,128,69,59
050,51,081,"Virginia","Greensville County",4,69,113,59,54
050,51,081,"Virginia","Greensville County",4,70,103,56,47
050,51,081,"Virginia","Greensville County",4,71,114,55,59
050,51,081,"Virginia","Greensville County",4,72,108,49,59
050,51,081,"Virginia","Greensville County",4,73,98,46,52
050,51,081,"Virginia","Greensville County",4,74,90,44,46
050,51,081,"Virginia","Greensville County",4,75,103,46,57
050,51,081,"Virginia","Greensville County",4,76,72,29,43
050,51,081,"Virginia","Greensville County",4,77,72,29,43
050,51,081,"Virginia","Greensville County",4,78,60,16,44
050,51,081,"Virginia","Greensville County",4,79,68,24,44
050,51,081,"Virginia","Greensville County",4,80,55,23,32
050,51,081,"Virginia","Greensville County",4,81,40,14,26
050,51,081,"Virginia","Greensville County",4,82,37,12,25
050,51,081,"Virginia","Greensville County",4,83,33,8,25
050,51,081,"Virginia","Greensville County",4,84,23,9,14
050,51,081,"Virginia","Greensville County",4,85,125,49,76
050,51,081,"Virginia","Greensville County",5,0,92,50,42
050,51,081,"Virginia","Greensville County",5,1,84,48,36
050,51,081,"Virginia","Greensville County",5,2,98,59,39
050,51,081,"Virginia","Greensville County",5,3,87,49,38
050,51,081,"Virginia","Greensville County",5,4,85,37,48
050,51,081,"Virginia","Greensville County",5,5,75,35,40
050,51,081,"Virginia","Greensville County",5,6,88,43,45
050,51,081,"Virginia","Greensville County",5,7,98,51,47
050,51,081,"Virginia","Greensville County",5,8,92,45,47
050,51,081,"Virginia","Greensville County",5,9,104,48,56
050,51,081,"Virginia","Greensville County",5,10,99,61,38
050,51,081,"Virginia","Greensville County",5,11,111,68,43
050,51,081,"Virginia","Greensville County",5,12,112,60,52
050,51,081,"Virginia","Greensville County",5,13,111,59,52
050,51,081,"Virginia","Greensville County",5,14,109,51,58
050,51,081,"Virginia","Greensville County",5,15,101,53,48
050,51,081,"Virginia","Greensville County",5,16,132,66,66
050,51,081,"Virginia","Greensville County",5,17,122,54,68
050,51,081,"Virginia","Greensville County",5,18,114,63,51
050,51,081,"Virginia","Greensville County",5,19,97,61,36
050,51,081,"Virginia","Greensville County",5,20,119,83,36
050,51,081,"Virginia","Greensville County",5,21,132,90,42
050,51,081,"Virginia","Greensville County",5,22,176,131,45
050,51,081,"Virginia","Greensville County",5,23,162,120,42
050,51,081,"Virginia","Greensville County",5,24,165,113,52
050,51,081,"Virginia","Greensville County",5,25,166,118,48
050,51,081,"Virginia","Greensville County",5,26,157,129,28
050,51,081,"Virginia","Greensville County",5,27,148,111,37
050,51,081,"Virginia","Greensville County",5,28,170,134,36
050,51,081,"Virginia","Greensville County",5,29,161,123,38
050,51,081,"Virginia","Greensville County",5,30,193,150,43
050,51,081,"Virginia","Greensville County",5,31,187,138,49
050,51,081,"Virginia","Greensville County",5,32,205,156,49
050,51,081,"Virginia","Greensville County",5,33,187,134,53
050,51,081,"Virginia","Greensville County",5,34,189,133,56
050,51,081,"Virginia","Greensville County",5,35,164,126,38
050,51,081,"Virginia","Greensville County",5,36,168,113,55
050,51,081,"Virginia","Greensville County",5,37,180,134,46
050,51,081,"Virginia","Greensville County",5,38,185,138,47
050,51,081,"Virginia","Greensville County",5,39,159,117,42
050,51,081,"Virginia","Greensville County",5,40,184,148,36
050,51,081,"Virginia","Greensville County",5,41,164,124,40
050,51,081,"Virginia","Greensville County",5,42,170,133,37
050,51,081,"Virginia","Greensville County",5,43,147,111,36
050,51,081,"Virginia","Greensville County",5,44,178,135,43
050,51,081,"Virginia","Greensville County",5,45,173,121,52
050,51,081,"Virginia","Greensville County",5,46,182,144,38
050,51,081,"Virginia","Greensville County",5,47,150,118,32
050,51,081,"Virginia","Greensville County",5,48,170,121,49
050,51,081,"Virginia","Greensville County",5,49,163,111,52
050,51,081,"Virginia","Greensville County",5,50,166,113,53
050,51,081,"Virginia","Greensville County",5,51,166,112,54
050,51,081,"Virginia","Greensville County",5,52,174,118,56
050,51,081,"Virginia","Greensville County",5,53,157,92,65
050,51,081,"Virginia","Greensville County",5,54,159,99,60
050,51,081,"Virginia","Greensville County",5,55,126,78,48
050,51,081,"Virginia","Greensville County",5,56,143,94,49
050,51,081,"Virginia","Greensville County",5,57,159,104,55
050,51,081,"Virginia","Greensville County",5,58,150,96,54
050,51,081,"Virginia","Greensville County",5,59,131,75,56
050,51,081,"Virginia","Greensville County",5,60,133,72,61
050,51,081,"Virginia","Greensville County",5,61,131,77,54
050,51,081,"Virginia","Greensville County",5,62,125,66,59
050,51,081,"Virginia","Greensville County",5,63,139,75,64
050,51,081,"Virginia","Greensville County",5,64,113,63,50
050,51,081,"Virginia","Greensville County",5,65,131,82,49
050,51,081,"Virginia","Greensville County",5,66,140,70,70
050,51,081,"Virginia","Greensville County",5,67,126,59,67
050,51,081,"Virginia","Greensville County",5,68,136,67,69
050,51,081,"Virginia","Greensville County",5,69,125,62,63
050,51,081,"Virginia","Greensville County",5,70,104,53,51
050,51,081,"Virginia","Greensville County",5,71,108,62,46
050,51,081,"Virginia","Greensville County",5,72,104,46,58
050,51,081,"Virginia","Greensville County",5,73,102,46,56
050,51,081,"Virginia","Greensville County",5,74,96,46,50
050,51,081,"Virginia","Greensville County",5,75,87,40,47
050,51,081,"Virginia","Greensville County",5,76,104,46,58
050,51,081,"Virginia","Greensville County",5,77,69,27,42
050,51,081,"Virginia","Greensville County",5,78,68,27,41
050,51,081,"Virginia","Greensville County",5,79,60,15,45
050,51,081,"Virginia","Greensville County",5,80,67,24,43
050,51,081,"Virginia","Greensville County",5,81,49,22,27
050,51,081,"Virginia","Greensville County",5,82,34,10,24
050,51,081,"Virginia","Greensville County",5,83,35,10,25
050,51,081,"Virginia","Greensville County",5,84,25,5,20
050,51,081,"Virginia","Greensville County",5,85,126,48,78
050,51,083,"Virginia","Halifax County",1,0,355,183,172
050,51,083,"Virginia","Halifax County",1,1,362,196,166
050,51,083,"Virginia","Halifax County",1,2,351,187,164
050,51,083,"Virginia","Halifax County",1,3,361,180,181
050,51,083,"Virginia","Halifax County",1,4,374,178,196
050,51,083,"Virginia","Halifax County",1,5,377,194,183
050,51,083,"Virginia","Halifax County",1,6,359,177,182
050,51,083,"Virginia","Halifax County",1,7,364,180,184
050,51,083,"Virginia","Halifax County",1,8,358,189,169
050,51,083,"Virginia","Halifax County",1,9,352,192,160
050,51,083,"Virginia","Halifax County",1,10,376,204,172
050,51,083,"Virginia","Halifax County",1,11,399,198,201
050,51,083,"Virginia","Halifax County",1,12,441,221,220
050,51,083,"Virginia","Halifax County",1,13,445,240,205
050,51,083,"Virginia","Halifax County",1,14,427,217,210
050,51,083,"Virginia","Halifax County",1,15,419,197,222
050,51,083,"Virginia","Halifax County",1,16,454,215,239
050,51,083,"Virginia","Halifax County",1,17,411,206,205
050,51,083,"Virginia","Halifax County",1,18,365,178,187
050,51,083,"Virginia","Halifax County",1,19,305,158,147
050,51,083,"Virginia","Halifax County",1,20,331,182,149
050,51,083,"Virginia","Halifax County",1,21,352,181,171
050,51,083,"Virginia","Halifax County",1,22,338,158,180
050,51,083,"Virginia","Halifax County",1,23,353,187,166
050,51,083,"Virginia","Halifax County",1,24,387,197,190
050,51,083,"Virginia","Halifax County",1,25,373,188,185
050,51,083,"Virginia","Halifax County",1,26,366,187,179
050,51,083,"Virginia","Halifax County",1,27,373,180,193
050,51,083,"Virginia","Halifax County",1,28,384,183,201
050,51,083,"Virginia","Halifax County",1,29,376,192,184
050,51,083,"Virginia","Halifax County",1,30,340,176,164
050,51,083,"Virginia","Halifax County",1,31,322,162,160
050,51,083,"Virginia","Halifax County",1,32,319,155,164
050,51,083,"Virginia","Halifax County",1,33,314,161,153
050,51,083,"Virginia","Halifax County",1,34,349,177,172
050,51,083,"Virginia","Halifax County",1,35,351,166,185
050,51,083,"Virginia","Halifax County",1,36,348,163,185
050,51,083,"Virginia","Halifax County",1,37,344,161,183
050,51,083,"Virginia","Halifax County",1,38,347,170,177
050,51,083,"Virginia","Halifax County",1,39,336,162,174
050,51,083,"Virginia","Halifax County",1,40,343,172,171
050,51,083,"Virginia","Halifax County",1,41,310,147,163
050,51,083,"Virginia","Halifax County",1,42,341,156,185
050,51,083,"Virginia","Halifax County",1,43,349,161,188
050,51,083,"Virginia","Halifax County",1,44,336,157,179
050,51,083,"Virginia","Halifax County",1,45,328,167,161
050,51,083,"Virginia","Halifax County",1,46,342,179,163
050,51,083,"Virginia","Halifax County",1,47,393,196,197
050,51,083,"Virginia","Halifax County",1,48,408,204,204
050,51,083,"Virginia","Halifax County",1,49,426,190,236
050,51,083,"Virginia","Halifax County",1,50,451,216,235
050,51,083,"Virginia","Halifax County",1,51,406,193,213
050,51,083,"Virginia","Halifax County",1,52,443,210,233
050,51,083,"Virginia","Halifax County",1,53,470,237,233
050,51,083,"Virginia","Halifax County",1,54,458,235,223
050,51,083,"Virginia","Halifax County",1,55,476,229,247
050,51,083,"Virginia","Halifax County",1,56,471,217,254
050,51,083,"Virginia","Halifax County",1,57,493,234,259
050,51,083,"Virginia","Halifax County",1,58,498,236,262
050,51,083,"Virginia","Halifax County",1,59,486,251,235
050,51,083,"Virginia","Halifax County",1,60,519,270,249
050,51,083,"Virginia","Halifax County",1,61,521,261,260
050,51,083,"Virginia","Halifax County",1,62,560,270,290
050,51,083,"Virginia","Halifax County",1,63,530,236,294
050,51,083,"Virginia","Halifax County",1,64,545,261,284
050,51,083,"Virginia","Halifax County",1,65,532,253,279
050,51,083,"Virginia","Halifax County",1,66,500,235,265
050,51,083,"Virginia","Halifax County",1,67,539,259,280
050,51,083,"Virginia","Halifax County",1,68,512,243,269
050,51,083,"Virginia","Halifax County",1,69,473,221,252
050,51,083,"Virginia","Halifax County",1,70,479,215,264
050,51,083,"Virginia","Halifax County",1,71,475,214,261
050,51,083,"Virginia","Halifax County",1,72,498,239,259
050,51,083,"Virginia","Halifax County",1,73,515,244,271
050,51,083,"Virginia","Halifax County",1,74,372,172,200
050,51,083,"Virginia","Halifax County",1,75,352,155,197
050,51,083,"Virginia","Halifax County",1,76,348,159,189
050,51,083,"Virginia","Halifax County",1,77,330,155,175
050,51,083,"Virginia","Halifax County",1,78,294,139,155
050,51,083,"Virginia","Halifax County",1,79,262,112,150
050,51,083,"Virginia","Halifax County",1,80,236,90,146
050,51,083,"Virginia","Halifax County",1,81,235,92,143
050,51,083,"Virginia","Halifax County",1,82,204,86,118
050,51,083,"Virginia","Halifax County",1,83,180,74,106
050,51,083,"Virginia","Halifax County",1,84,168,65,103
050,51,083,"Virginia","Halifax County",1,85,959,270,689
050,51,083,"Virginia","Halifax County",2,0,356,184,172
050,51,083,"Virginia","Halifax County",2,1,360,194,166
050,51,083,"Virginia","Halifax County",2,2,355,190,165
050,51,083,"Virginia","Halifax County",2,3,358,181,177
050,51,083,"Virginia","Halifax County",2,4,369,177,192
050,51,083,"Virginia","Halifax County",2,5,376,190,186
050,51,083,"Virginia","Halifax County",2,6,362,181,181
050,51,083,"Virginia","Halifax County",2,7,362,180,182
050,51,083,"Virginia","Halifax County",2,8,358,186,172
050,51,083,"Virginia","Halifax County",2,9,351,189,162
050,51,083,"Virginia","Halifax County",2,10,370,201,169
050,51,083,"Virginia","Halifax County",2,11,394,200,194
050,51,083,"Virginia","Halifax County",2,12,433,218,215
050,51,083,"Virginia","Halifax County",2,13,440,233,207
050,51,083,"Virginia","Halifax County",2,14,431,222,209
050,51,083,"Virginia","Halifax County",2,15,420,201,219
050,51,083,"Virginia","Halifax County",2,16,448,213,235
050,51,083,"Virginia","Halifax County",2,17,421,208,213
050,51,083,"Virginia","Halifax County",2,18,355,175,180
050,51,083,"Virginia","Halifax County",2,19,306,156,150
050,51,083,"Virginia","Halifax County",2,20,334,181,153
050,51,083,"Virginia","Halifax County",2,21,348,183,165
050,51,083,"Virginia","Halifax County",2,22,340,162,178
050,51,083,"Virginia","Halifax County",2,23,353,181,172
050,51,083,"Virginia","Halifax County",2,24,375,192,183
050,51,083,"Virginia","Halifax County",2,25,374,188,186
050,51,083,"Virginia","Halifax County",2,26,367,186,181
050,51,083,"Virginia","Halifax County",2,27,370,181,189
050,51,083,"Virginia","Halifax County",2,28,383,185,198
050,51,083,"Virginia","Halifax County",2,29,376,188,188
050,51,083,"Virginia","Halifax County",2,30,349,178,171
050,51,083,"Virginia","Halifax County",2,31,328,167,161
050,51,083,"Virginia","Halifax County",2,32,317,154,163
050,51,083,"Virginia","Halifax County",2,33,318,161,157
050,51,083,"Virginia","Halifax County",2,34,343,175,168
050,51,083,"Virginia","Halifax County",2,35,352,169,183
050,51,083,"Virginia","Halifax County",2,36,343,161,182
050,51,083,"Virginia","Halifax County",2,37,344,161,183
050,51,083,"Virginia","Halifax County",2,38,345,168,177
050,51,083,"Virginia","Halifax County",2,39,338,164,174
050,51,083,"Virginia","Halifax County",2,40,345,172,173
050,51,083,"Virginia","Halifax County",2,41,318,152,166
050,51,083,"Virginia","Halifax County",2,42,331,152,179
050,51,083,"Virginia","Halifax County",2,43,349,160,189
050,51,083,"Virginia","Halifax County",2,44,335,157,178
050,51,083,"Virginia","Halifax County",2,45,329,165,164
050,51,083,"Virginia","Halifax County",2,46,335,173,162
050,51,083,"Virginia","Halifax County",2,47,379,192,187
050,51,083,"Virginia","Halifax County",2,48,400,199,201
050,51,083,"Virginia","Halifax County",2,49,427,195,232
050,51,083,"Virginia","Halifax County",2,50,446,211,235
050,51,083,"Virginia","Halifax County",2,51,413,196,217
050,51,083,"Virginia","Halifax County",2,52,435,205,230
050,51,083,"Virginia","Halifax County",2,53,460,229,231
050,51,083,"Virginia","Halifax County",2,54,461,237,224
050,51,083,"Virginia","Halifax County",2,55,470,229,241
050,51,083,"Virginia","Halifax County",2,56,471,218,253
050,51,083,"Virginia","Halifax County",2,57,489,230,259
050,51,083,"Virginia","Halifax County",2,58,492,233,259
050,51,083,"Virginia","Halifax County",2,59,486,246,240
050,51,083,"Virginia","Halifax County",2,60,508,264,244
050,51,083,"Virginia","Halifax County",2,61,519,263,256
050,51,083,"Virginia","Halifax County",2,62,547,266,281
050,51,083,"Virginia","Halifax County",2,63,544,247,297
050,51,083,"Virginia","Halifax County",2,64,538,255,283
050,51,083,"Virginia","Halifax County",2,65,533,253,280
050,51,083,"Virginia","Halifax County",2,66,510,242,268
050,51,083,"Virginia","Halifax County",2,67,520,244,276
050,51,083,"Virginia","Halifax County",2,68,512,244,268
050,51,083,"Virginia","Halifax County",2,69,484,226,258
050,51,083,"Virginia","Halifax County",2,70,473,214,259
050,51,083,"Virginia","Halifax County",2,71,470,212,258
050,51,083,"Virginia","Halifax County",2,72,478,227,251
050,51,083,"Virginia","Halifax County",2,73,530,252,278
050,51,083,"Virginia","Halifax County",2,74,382,177,205
050,51,083,"Virginia","Halifax County",2,75,358,161,197
050,51,083,"Virginia","Halifax County",2,76,344,154,190
050,51,083,"Virginia","Halifax County",2,77,337,158,179
050,51,083,"Virginia","Halifax County",2,78,297,140,157
050,51,083,"Virginia","Halifax County",2,79,262,114,148
050,51,083,"Virginia","Halifax County",2,80,239,94,145
050,51,083,"Virginia","Halifax County",2,81,232,91,141
050,51,083,"Virginia","Halifax County",2,82,210,87,123
050,51,083,"Virginia","Halifax County",2,83,182,74,108
050,51,083,"Virginia","Halifax County",2,84,162,60,102
050,51,083,"Virginia","Halifax County",2,85,962,277,685
050,51,083,"Virginia","Halifax County",3,0,342,185,157
050,51,083,"Virginia","Halifax County",3,1,358,174,184
050,51,083,"Virginia","Halifax County",3,2,375,199,176
050,51,083,"Virginia","Halifax County",3,3,359,196,163
050,51,083,"Virginia","Halifax County",3,4,364,188,176
050,51,083,"Virginia","Halifax County",3,5,367,175,192
050,51,083,"Virginia","Halifax County",3,6,390,197,193
050,51,083,"Virginia","Halifax County",3,7,375,178,197
050,51,083,"Virginia","Halifax County",3,8,361,174,187
050,51,083,"Virginia","Halifax County",3,9,362,187,175
050,51,083,"Virginia","Halifax County",3,10,352,187,165
050,51,083,"Virginia","Halifax County",3,11,376,206,170
050,51,083,"Virginia","Halifax County",3,12,395,198,197
050,51,083,"Virginia","Halifax County",3,13,431,212,219
050,51,083,"Virginia","Halifax County",3,14,441,227,214
050,51,083,"Virginia","Halifax County",3,15,429,219,210
050,51,083,"Virginia","Halifax County",3,16,417,205,212
050,51,083,"Virginia","Halifax County",3,17,442,209,233
050,51,083,"Virginia","Halifax County",3,18,362,178,184
050,51,083,"Virginia","Halifax County",3,19,297,147,150
050,51,083,"Virginia","Halifax County",3,20,324,164,160
050,51,083,"Virginia","Halifax County",3,21,346,195,151
050,51,083,"Virginia","Halifax County",3,22,350,182,168
050,51,083,"Virginia","Halifax County",3,23,363,174,189
050,51,083,"Virginia","Halifax County",3,24,357,179,178
050,51,083,"Virginia","Halifax County",3,25,369,192,177
050,51,083,"Virginia","Halifax County",3,26,382,185,197
050,51,083,"Virginia","Halifax County",3,27,360,186,174
050,51,083,"Virginia","Halifax County",3,28,375,188,187
050,51,083,"Virginia","Halifax County",3,29,389,188,201
050,51,083,"Virginia","Halifax County",3,30,377,181,196
050,51,083,"Virginia","Halifax County",3,31,350,178,172
050,51,083,"Virginia","Halifax County",3,32,326,158,168
050,51,083,"Virginia","Halifax County",3,33,325,157,168
050,51,083,"Virginia","Halifax County",3,34,329,168,161
050,51,083,"Virginia","Halifax County",3,35,356,183,173
050,51,083,"Virginia","Halifax County",3,36,352,169,183
050,51,083,"Virginia","Halifax County",3,37,350,166,184
050,51,083,"Virginia","Halifax County",3,38,340,167,173
050,51,083,"Virginia","Halifax County",3,39,347,162,185
050,51,083,"Virginia","Halifax County",3,40,343,172,171
050,51,083,"Virginia","Halifax County",3,41,331,158,173
050,51,083,"Virginia","Halifax County",3,42,310,151,159
050,51,083,"Virginia","Halifax County",3,43,326,156,170
050,51,083,"Virginia","Halifax County",3,44,346,156,190
050,51,083,"Virginia","Halifax County",3,45,330,155,175
050,51,083,"Virginia","Halifax County",3,46,318,151,167
050,51,083,"Virginia","Halifax County",3,47,333,175,158
050,51,083,"Virginia","Halifax County",3,48,363,179,184
050,51,083,"Virginia","Halifax County",3,49,402,203,199
050,51,083,"Virginia","Halifax County",3,50,430,205,225
050,51,083,"Virginia","Halifax County",3,51,427,196,231
050,51,083,"Virginia","Halifax County",3,52,414,199,215
050,51,083,"Virginia","Halifax County",3,53,431,205,226
050,51,083,"Virginia","Halifax County",3,54,462,225,237
050,51,083,"Virginia","Halifax County",3,55,448,224,224
050,51,083,"Virginia","Halifax County",3,56,455,220,235
050,51,083,"Virginia","Halifax County",3,57,472,217,255
050,51,083,"Virginia","Halifax County",3,58,482,226,256
050,51,083,"Virginia","Halifax County",3,59,494,238,256
050,51,083,"Virginia","Halifax County",3,60,491,249,242
050,51,083,"Virginia","Halifax County",3,61,509,263,246
050,51,083,"Virginia","Halifax County",3,62,517,256,261
050,51,083,"Virginia","Halifax County",3,63,558,273,285
050,51,083,"Virginia","Halifax County",3,64,547,252,295
050,51,083,"Virginia","Halifax County",3,65,528,247,281
050,51,083,"Virginia","Halifax County",3,66,519,244,275
050,51,083,"Virginia","Halifax County",3,67,498,239,259
050,51,083,"Virginia","Halifax County",3,68,502,236,266
050,51,083,"Virginia","Halifax County",3,69,502,237,265
050,51,083,"Virginia","Halifax County",3,70,471,214,257
050,51,083,"Virginia","Halifax County",3,71,466,211,255
050,51,083,"Virginia","Halifax County",3,72,453,200,253
050,51,083,"Virginia","Halifax County",3,73,469,222,247
050,51,083,"Virginia","Halifax County",3,74,513,240,273
050,51,083,"Virginia","Halifax County",3,75,375,174,201
050,51,083,"Virginia","Halifax County",3,76,342,150,192
050,51,083,"Virginia","Halifax County",3,77,341,152,189
050,51,083,"Virginia","Halifax County",3,78,319,146,173
050,51,083,"Virginia","Halifax County",3,79,278,132,146
050,51,083,"Virginia","Halifax County",3,80,248,102,146
050,51,083,"Virginia","Halifax County",3,81,224,84,140
050,51,083,"Virginia","Halifax County",3,82,223,90,133
050,51,083,"Virginia","Halifax County",3,83,198,77,121
050,51,083,"Virginia","Halifax County",3,84,161,66,95
050,51,083,"Virginia","Halifax County",3,85,946,283,663
050,51,083,"Virginia","Halifax County",4,0,326,159,167
050,51,083,"Virginia","Halifax County",4,1,357,185,172
050,51,083,"Virginia","Halifax County",4,2,358,178,180
050,51,083,"Virginia","Halifax County",4,3,374,198,176
050,51,083,"Virginia","Halifax County",4,4,368,201,167
050,51,083,"Virginia","Halifax County",4,5,382,195,187
050,51,083,"Virginia","Halifax County",4,6,377,181,196
050,51,083,"Virginia","Halifax County",4,7,388,194,194
050,51,083,"Virginia","Halifax County",4,8,372,175,197
050,51,083,"Virginia","Halifax County",4,9,364,175,189
050,51,083,"Virginia","Halifax County",4,10,363,184,179
050,51,083,"Virginia","Halifax County",4,11,355,194,161
050,51,083,"Virginia","Halifax County",4,12,377,209,168
050,51,083,"Virginia","Halifax County",4,13,406,201,205
050,51,083,"Virginia","Halifax County",4,14,428,210,218
050,51,083,"Virginia","Halifax County",4,15,440,224,216
050,51,083,"Virginia","Halifax County",4,16,433,224,209
050,51,083,"Virginia","Halifax County",4,17,424,211,213
050,51,083,"Virginia","Halifax County",4,18,377,185,192
050,51,083,"Virginia","Halifax County",4,19,296,147,149
050,51,083,"Virginia","Halifax County",4,20,304,150,154
050,51,083,"Virginia","Halifax County",4,21,325,169,156
050,51,083,"Virginia","Halifax County",4,22,339,191,148
050,51,083,"Virginia","Halifax County",4,23,364,195,169
050,51,083,"Virginia","Halifax County",4,24,352,172,180
050,51,083,"Virginia","Halifax County",4,25,370,185,185
050,51,083,"Virginia","Halifax County",4,26,357,192,165
050,51,083,"Virginia","Halifax County",4,27,385,183,202
050,51,083,"Virginia","Halifax County",4,28,362,194,168
050,51,083,"Virginia","Halifax County",4,29,369,185,184
050,51,083,"Virginia","Halifax County",4,30,376,182,194
050,51,083,"Virginia","Halifax County",4,31,384,180,204
050,51,083,"Virginia","Halifax County",4,32,339,170,169
050,51,083,"Virginia","Halifax County",4,33,322,161,161
050,51,083,"Virginia","Halifax County",4,34,337,162,175
050,51,083,"Virginia","Halifax County",4,35,327,163,164
050,51,083,"Virginia","Halifax County",4,36,341,170,171
050,51,083,"Virginia","Halifax County",4,37,356,173,183
050,51,083,"Virginia","Halifax County",4,38,343,164,179
050,51,083,"Virginia","Halifax County",4,39,343,163,180
050,51,083,"Virginia","Halifax County",4,40,344,160,184
050,51,083,"Virginia","Halifax County",4,41,360,181,179
050,51,083,"Virginia","Halifax County",4,42,329,159,170
050,51,083,"Virginia","Halifax County",4,43,316,155,161
050,51,083,"Virginia","Halifax County",4,44,337,162,175
050,51,083,"Virginia","Halifax County",4,45,343,156,187
050,51,083,"Virginia","Halifax County",4,46,338,155,183
050,51,083,"Virginia","Halifax County",4,47,325,158,167
050,51,083,"Virginia","Halifax County",4,48,336,179,157
050,51,083,"Virginia","Halifax County",4,49,363,178,185
050,51,083,"Virginia","Halifax County",4,50,404,204,200
050,51,083,"Virginia","Halifax County",4,51,441,210,231
050,51,083,"Virginia","Halifax County",4,52,437,195,242
050,51,083,"Virginia","Halifax County",4,53,402,190,212
050,51,083,"Virginia","Halifax County",4,54,445,210,235
050,51,083,"Virginia","Halifax County",4,55,456,221,235
050,51,083,"Virginia","Halifax County",4,56,444,222,222
050,51,083,"Virginia","Halifax County",4,57,470,231,239
050,51,083,"Virginia","Halifax County",4,58,467,211,256
050,51,083,"Virginia","Halifax County",4,59,473,220,253
050,51,083,"Virginia","Halifax County",4,60,499,245,254
050,51,083,"Virginia","Halifax County",4,61,493,252,241
050,51,083,"Virginia","Halifax County",4,62,503,249,254
050,51,083,"Virginia","Halifax County",4,63,512,248,264
050,51,083,"Virginia","Halifax County",4,64,549,269,280
050,51,083,"Virginia","Halifax County",4,65,536,243,293
050,51,083,"Virginia","Halifax County",4,66,513,234,279
050,51,083,"Virginia","Halifax County",4,67,511,238,273
050,51,083,"Virginia","Halifax County",4,68,495,240,255
050,51,083,"Virginia","Halifax County",4,69,488,228,260
050,51,083,"Virginia","Halifax County",4,70,496,230,266
050,51,083,"Virginia","Halifax County",4,71,452,201,251
050,51,083,"Virginia","Halifax County",4,72,446,201,245
050,51,083,"Virginia","Halifax County",4,73,445,198,247
050,51,083,"Virginia","Halifax County",4,74,455,216,239
050,51,083,"Virginia","Halifax County",4,75,498,234,264
050,51,083,"Virginia","Halifax County",4,76,355,164,191
050,51,083,"Virginia","Halifax County",4,77,336,147,189
050,51,083,"Virginia","Halifax County",4,78,322,141,181
050,51,083,"Virginia","Halifax County",4,79,293,134,159
050,51,083,"Virginia","Halifax County",4,80,267,122,145
050,51,083,"Virginia","Halifax County",4,81,228,92,136
050,51,083,"Virginia","Halifax County",4,82,217,87,130
050,51,083,"Virginia","Halifax County",4,83,210,82,128
050,51,083,"Virginia","Halifax County",4,84,177,66,111
050,51,083,"Virginia","Halifax County",4,85,934,296,638
050,51,083,"Virginia","Halifax County",5,0,326,156,170
050,51,083,"Virginia","Halifax County",5,1,320,150,170
050,51,083,"Virginia","Halifax County",5,2,357,187,170
050,51,083,"Virginia","Halifax County",5,3,347,180,167
050,51,083,"Virginia","Halifax County",5,4,366,191,175
050,51,083,"Virginia","Halifax County",5,5,370,200,170
050,51,083,"Virginia","Halifax County",5,6,362,179,183
050,51,083,"Virginia","Halifax County",5,7,378,181,197
050,51,083,"Virginia","Halifax County",5,8,393,193,200
050,51,083,"Virginia","Halifax County",5,9,384,183,201
050,51,083,"Virginia","Halifax County",5,10,363,179,184
050,51,083,"Virginia","Halifax County",5,11,364,188,176
050,51,083,"Virginia","Halifax County",5,12,351,195,156
050,51,083,"Virginia","Halifax County",5,13,386,209,177
050,51,083,"Virginia","Halifax County",5,14,406,205,201
050,51,083,"Virginia","Halifax County",5,15,434,213,221
050,51,083,"Virginia","Halifax County",5,16,437,221,216
050,51,083,"Virginia","Halifax County",5,17,445,230,215
050,51,083,"Virginia","Halifax County",5,18,359,181,178
050,51,083,"Virginia","Halifax County",5,19,310,154,156
050,51,083,"Virginia","Halifax County",5,20,322,162,160
050,51,083,"Virginia","Halifax County",5,21,319,158,161
050,51,083,"Virginia","Halifax County",5,22,343,174,169
050,51,083,"Virginia","Halifax County",5,23,368,215,153
050,51,083,"Virginia","Halifax County",5,24,363,196,167
050,51,083,"Virginia","Halifax County",5,25,357,174,183
050,51,083,"Virginia","Halifax County",5,26,362,176,186
050,51,083,"Virginia","Halifax County",5,27,328,168,160
050,51,083,"Virginia","Halifax County",5,28,386,187,199
050,51,083,"Virginia","Halifax County",5,29,353,191,162
050,51,083,"Virginia","Halifax County",5,30,366,184,182
050,51,083,"Virginia","Halifax County",5,31,372,180,192
050,51,083,"Virginia","Halifax County",5,32,369,172,197
050,51,083,"Virginia","Halifax County",5,33,332,163,169
050,51,083,"Virginia","Halifax County",5,34,322,162,160
050,51,083,"Virginia","Halifax County",5,35,349,163,186
050,51,083,"Virginia","Halifax County",5,36,322,161,161
050,51,083,"Virginia","Halifax County",5,37,339,162,177
050,51,083,"Virginia","Halifax County",5,38,350,175,175
050,51,083,"Virginia","Halifax County",5,39,343,162,181
050,51,083,"Virginia","Halifax County",5,40,345,168,177
050,51,083,"Virginia","Halifax County",5,41,345,166,179
050,51,083,"Virginia","Halifax County",5,42,356,178,178
050,51,083,"Virginia","Halifax County",5,43,336,161,175
050,51,083,"Virginia","Halifax County",5,44,324,161,163
050,51,083,"Virginia","Halifax County",5,45,343,165,178
050,51,083,"Virginia","Halifax County",5,46,349,154,195
050,51,083,"Virginia","Halifax County",5,47,340,164,176
050,51,083,"Virginia","Halifax County",5,48,323,153,170
050,51,083,"Virginia","Halifax County",5,49,341,184,157
050,51,083,"Virginia","Halifax County",5,50,376,186,190
050,51,083,"Virginia","Halifax County",5,51,395,197,198
050,51,083,"Virginia","Halifax County",5,52,450,214,236
050,51,083,"Virginia","Halifax County",5,53,427,184,243
050,51,083,"Virginia","Halifax County",5,54,412,194,218
050,51,083,"Virginia","Halifax County",5,55,432,201,231
050,51,083,"Virginia","Halifax County",5,56,452,219,233
050,51,083,"Virginia","Halifax County",5,57,460,232,228
050,51,083,"Virginia","Halifax County",5,58,462,225,237
050,51,083,"Virginia","Halifax County",5,59,457,207,250
050,51,083,"Virginia","Halifax County",5,60,479,227,252
050,51,083,"Virginia","Halifax County",5,61,495,239,256
050,51,083,"Virginia","Halifax County",5,62,492,246,246
050,51,083,"Virginia","Halifax County",5,63,485,237,248
050,51,083,"Virginia","Halifax County",5,64,504,246,258
050,51,083,"Virginia","Halifax County",5,65,545,264,281
050,51,083,"Virginia","Halifax County",5,66,530,240,290
050,51,083,"Virginia","Halifax County",5,67,506,229,277
050,51,083,"Virginia","Halifax County",5,68,499,232,267
050,51,083,"Virginia","Halifax County",5,69,484,234,250
050,51,083,"Virginia","Halifax County",5,70,485,227,258
050,51,083,"Virginia","Halifax County",5,71,488,219,269
050,51,083,"Virginia","Halifax County",5,72,435,194,241
050,51,083,"Virginia","Halifax County",5,73,442,201,241
050,51,083,"Virginia","Halifax County",5,74,425,191,234
050,51,083,"Virginia","Halifax County",5,75,438,208,230
050,51,083,"Virginia","Halifax County",5,76,471,215,256
050,51,083,"Virginia","Halifax County",5,77,350,165,185
050,51,083,"Virginia","Halifax County",5,78,320,141,179
050,51,083,"Virginia","Halifax County",5,79,302,131,171
050,51,083,"Virginia","Halifax County",5,80,278,122,156
050,51,083,"Virginia","Halifax County",5,81,252,116,136
050,51,083,"Virginia","Halifax County",5,82,220,94,126
050,51,083,"Virginia","Halifax County",5,83,211,80,131
050,51,083,"Virginia","Halifax County",5,84,196,75,121
050,51,083,"Virginia","Halifax County",5,85,952,310,642
050,51,085,"Virginia","Hanover County",1,0,961,495,466
050,51,085,"Virginia","Hanover County",1,1,1041,550,491
050,51,085,"Virginia","Hanover County",1,2,1072,561,511
050,51,085,"Virginia","Hanover County",1,3,1110,570,540
050,51,085,"Virginia","Hanover County",1,4,1181,596,585
050,51,085,"Virginia","Hanover County",1,5,1267,639,628
050,51,085,"Virginia","Hanover County",1,6,1286,685,601
050,51,085,"Virginia","Hanover County",1,7,1337,730,607
050,51,085,"Virginia","Hanover County",1,8,1322,667,655
050,51,085,"Virginia","Hanover County",1,9,1338,709,629
050,51,085,"Virginia","Hanover County",1,10,1426,744,682
050,51,085,"Virginia","Hanover County",1,11,1445,740,705
050,51,085,"Virginia","Hanover County",1,12,1510,785,725
050,51,085,"Virginia","Hanover County",1,13,1542,815,727
050,51,085,"Virginia","Hanover County",1,14,1599,846,753
050,51,085,"Virginia","Hanover County",1,15,1601,849,752
050,51,085,"Virginia","Hanover County",1,16,1567,779,788
050,51,085,"Virginia","Hanover County",1,17,1545,773,772
050,51,085,"Virginia","Hanover County",1,18,1434,726,708
050,51,085,"Virginia","Hanover County",1,19,1376,702,674
050,51,085,"Virginia","Hanover County",1,20,1406,727,679
050,51,085,"Virginia","Hanover County",1,21,1362,717,645
050,51,085,"Virginia","Hanover County",1,22,1281,671,610
050,51,085,"Virginia","Hanover County",1,23,1161,605,556
050,51,085,"Virginia","Hanover County",1,24,1112,593,519
050,51,085,"Virginia","Hanover County",1,25,1057,530,527
050,51,085,"Virginia","Hanover County",1,26,1030,536,494
050,51,085,"Virginia","Hanover County",1,27,1096,555,541
050,51,085,"Virginia","Hanover County",1,28,1100,556,544
050,51,085,"Virginia","Hanover County",1,29,1127,581,546
050,51,085,"Virginia","Hanover County",1,30,1151,562,589
050,51,085,"Virginia","Hanover County",1,31,1112,536,576
050,51,085,"Virginia","Hanover County",1,32,1195,580,615
050,51,085,"Virginia","Hanover County",1,33,1161,567,594
050,51,085,"Virginia","Hanover County",1,34,1267,613,654
050,51,085,"Virginia","Hanover County",1,35,1362,682,680
050,51,085,"Virginia","Hanover County",1,36,1386,677,709
050,51,085,"Virginia","Hanover County",1,37,1403,687,716
050,51,085,"Virginia","Hanover County",1,38,1416,700,716
050,51,085,"Virginia","Hanover County",1,39,1377,682,695
050,51,085,"Virginia","Hanover County",1,40,1383,700,683
050,51,085,"Virginia","Hanover County",1,41,1316,670,646
050,51,085,"Virginia","Hanover County",1,42,1357,660,697
050,51,085,"Virginia","Hanover County",1,43,1325,636,689
050,51,085,"Virginia","Hanover County",1,44,1331,662,669
050,51,085,"Virginia","Hanover County",1,45,1309,622,687
050,51,085,"Virginia","Hanover County",1,46,1301,648,653
050,51,085,"Virginia","Hanover County",1,47,1397,700,697
050,51,085,"Virginia","Hanover County",1,48,1550,770,780
050,51,085,"Virginia","Hanover County",1,49,1649,811,838
050,51,085,"Virginia","Hanover County",1,50,1617,800,817
050,51,085,"Virginia","Hanover County",1,51,1574,770,804
050,51,085,"Virginia","Hanover County",1,52,1552,765,787
050,51,085,"Virginia","Hanover County",1,53,1547,738,809
050,51,085,"Virginia","Hanover County",1,54,1536,733,803
050,51,085,"Virginia","Hanover County",1,55,1708,820,888
050,51,085,"Virginia","Hanover County",1,56,1732,817,915
050,51,085,"Virginia","Hanover County",1,57,1795,861,934
050,51,085,"Virginia","Hanover County",1,58,1806,885,921
050,51,085,"Virginia","Hanover County",1,59,1712,839,873
050,51,085,"Virginia","Hanover County",1,60,1661,818,843
050,51,085,"Virginia","Hanover County",1,61,1641,821,820
050,51,085,"Virginia","Hanover County",1,62,1619,795,824
050,51,085,"Virginia","Hanover County",1,63,1544,759,785
050,51,085,"Virginia","Hanover County",1,64,1476,709,767
050,51,085,"Virginia","Hanover County",1,65,1402,657,745
050,51,085,"Virginia","Hanover County",1,66,1386,677,709
050,51,085,"Virginia","Hanover County",1,67,1280,601,679
050,51,085,"Virginia","Hanover County",1,68,1279,604,675
050,51,085,"Virginia","Hanover County",1,69,1225,584,641
050,51,085,"Virginia","Hanover County",1,70,1175,565,610
050,51,085,"Virginia","Hanover County",1,71,1124,540,584
050,51,085,"Virginia","Hanover County",1,72,1140,536,604
050,51,085,"Virginia","Hanover County",1,73,1207,581,626
050,51,085,"Virginia","Hanover County",1,74,813,376,437
050,51,085,"Virginia","Hanover County",1,75,827,386,441
050,51,085,"Virginia","Hanover County",1,76,788,352,436
050,51,085,"Virginia","Hanover County",1,77,777,353,424
050,51,085,"Virginia","Hanover County",1,78,706,305,401
050,51,085,"Virginia","Hanover County",1,79,618,272,346
050,51,085,"Virginia","Hanover County",1,80,523,230,293
050,51,085,"Virginia","Hanover County",1,81,487,218,269
050,51,085,"Virginia","Hanover County",1,82,449,203,246
050,51,085,"Virginia","Hanover County",1,83,369,160,209
050,51,085,"Virginia","Hanover County",1,84,372,143,229
050,51,085,"Virginia","Hanover County",1,85,2070,734,1336
050,51,085,"Virginia","Hanover County",2,0,994,516,478
050,51,085,"Virginia","Hanover County",2,1,1026,539,487
050,51,085,"Virginia","Hanover County",2,2,1079,567,512
050,51,085,"Virginia","Hanover County",2,3,1100,567,533
050,51,085,"Virginia","Hanover County",2,4,1178,593,585
050,51,085,"Virginia","Hanover County",2,5,1256,632,624
050,51,085,"Virginia","Hanover County",2,6,1298,684,614
050,51,085,"Virginia","Hanover County",2,7,1330,722,608
050,51,085,"Virginia","Hanover County",2,8,1332,688,644
050,51,085,"Virginia","Hanover County",2,9,1342,703,639
050,51,085,"Virginia","Hanover County",2,10,1406,733,673
050,51,085,"Virginia","Hanover County",2,11,1443,743,700
050,51,085,"Virginia","Hanover County",2,12,1507,783,724
050,51,085,"Virginia","Hanover County",2,13,1543,812,731
050,51,085,"Virginia","Hanover County",2,14,1592,844,748
050,51,085,"Virginia","Hanover County",2,15,1605,851,754
050,51,085,"Virginia","Hanover County",2,16,1582,801,781
050,51,085,"Virginia","Hanover County",2,17,1550,777,773
050,51,085,"Virginia","Hanover County",2,18,1427,721,706
050,51,085,"Virginia","Hanover County",2,19,1370,694,676
050,51,085,"Virginia","Hanover County",2,20,1420,733,687
050,51,085,"Virginia","Hanover County",2,21,1357,714,643
050,51,085,"Virginia","Hanover County",2,22,1284,671,613
050,51,085,"Virginia","Hanover County",2,23,1161,614,547
050,51,085,"Virginia","Hanover County",2,24,1109,584,525
050,51,085,"Virginia","Hanover County",2,25,1059,539,520
050,51,085,"Virginia","Hanover County",2,26,1041,538,503
050,51,085,"Virginia","Hanover County",2,27,1082,549,533
050,51,085,"Virginia","Hanover County",2,28,1109,562,547
050,51,085,"Virginia","Hanover County",2,29,1138,583,555
050,51,085,"Virginia","Hanover County",2,30,1160,573,587
050,51,085,"Virginia","Hanover County",2,31,1125,543,582
050,51,085,"Virginia","Hanover County",2,32,1183,572,611
050,51,085,"Virginia","Hanover County",2,33,1182,575,607
050,51,085,"Virginia","Hanover County",2,34,1249,608,641
050,51,085,"Virginia","Hanover County",2,35,1362,674,688
050,51,085,"Virginia","Hanover County",2,36,1380,679,701
050,51,085,"Virginia","Hanover County",2,37,1412,689,723
050,51,085,"Virginia","Hanover County",2,38,1429,708,721
050,51,085,"Virginia","Hanover County",2,39,1390,687,703
050,51,085,"Virginia","Hanover County",2,40,1395,705,690
050,51,085,"Virginia","Hanover County",2,41,1346,685,661
050,51,085,"Virginia","Hanover County",2,42,1353,667,686
050,51,085,"Virginia","Hanover County",2,43,1347,650,697
050,51,085,"Virginia","Hanover County",2,44,1317,648,669
050,51,085,"Virginia","Hanover County",2,45,1323,636,687
050,51,085,"Virginia","Hanover County",2,46,1298,639,659
050,51,085,"Virginia","Hanover County",2,47,1368,683,685
050,51,085,"Virginia","Hanover County",2,48,1511,755,756
050,51,085,"Virginia","Hanover County",2,49,1630,803,827
050,51,085,"Virginia","Hanover County",2,50,1623,798,825
050,51,085,"Virginia","Hanover County",2,51,1574,774,800
050,51,085,"Virginia","Hanover County",2,52,1547,760,787
050,51,085,"Virginia","Hanover County",2,53,1544,743,801
050,51,085,"Virginia","Hanover County",2,54,1538,737,801
050,51,085,"Virginia","Hanover County",2,55,1667,799,868
050,51,085,"Virginia","Hanover County",2,56,1735,822,913
050,51,085,"Virginia","Hanover County",2,57,1784,851,933
050,51,085,"Virginia","Hanover County",2,58,1799,876,923
050,51,085,"Virginia","Hanover County",2,59,1741,852,889
050,51,085,"Virginia","Hanover County",2,60,1669,819,850
050,51,085,"Virginia","Hanover County",2,61,1636,815,821
050,51,085,"Virginia","Hanover County",2,62,1613,796,817
050,51,085,"Virginia","Hanover County",2,63,1572,772,800
050,51,085,"Virginia","Hanover County",2,64,1479,713,766
050,51,085,"Virginia","Hanover County",2,65,1411,668,743
050,51,085,"Virginia","Hanover County",2,66,1391,671,720
050,51,085,"Virginia","Hanover County",2,67,1303,618,685
050,51,085,"Virginia","Hanover County",2,68,1273,602,671
050,51,085,"Virginia","Hanover County",2,69,1244,591,653
050,51,085,"Virginia","Hanover County",2,70,1181,566,615
050,51,085,"Virginia","Hanover County",2,71,1139,548,591
050,51,085,"Virginia","Hanover County",2,72,1117,530,587
050,51,085,"Virginia","Hanover County",2,73,1244,594,650
050,51,085,"Virginia","Hanover County",2,74,850,396,454
050,51,085,"Virginia","Hanover County",2,75,824,386,438
050,51,085,"Virginia","Hanover County",2,76,785,354,431
050,51,085,"Virginia","Hanover County",2,77,795,359,436
050,51,085,"Virginia","Hanover County",2,78,710,310,400
050,51,085,"Virginia","Hanover County",2,79,629,274,355
050,51,085,"Virginia","Hanover County",2,80,544,241,303
050,51,085,"Virginia","Hanover County",2,81,487,218,269
050,51,085,"Virginia","Hanover County",2,82,451,205,246
050,51,085,"Virginia","Hanover County",2,83,381,164,217
050,51,085,"Virginia","Hanover County",2,84,366,142,224
050,51,085,"Virginia","Hanover County",2,85,2076,738,1338
050,51,085,"Virginia","Hanover County",3,0,970,518,452
050,51,085,"Virginia","Hanover County",3,1,1066,566,500
050,51,085,"Virginia","Hanover County",3,2,1101,587,514
050,51,085,"Virginia","Hanover County",3,3,1153,619,534
050,51,085,"Virginia","Hanover County",3,4,1152,587,565
050,51,085,"Virginia","Hanover County",3,5,1232,616,616
050,51,085,"Virginia","Hanover County",3,6,1301,663,638
050,51,085,"Virginia","Hanover County",3,7,1323,690,633
050,51,085,"Virginia","Hanover County",3,8,1368,726,642
050,51,085,"Virginia","Hanover County",3,9,1384,721,663
050,51,085,"Virginia","Hanover County",3,10,1378,720,658
050,51,085,"Virginia","Hanover County",3,11,1456,767,689
050,51,085,"Virginia","Hanover County",3,12,1490,770,720
050,51,085,"Virginia","Hanover County",3,13,1548,806,742
050,51,085,"Virginia","Hanover County",3,14,1550,824,726
050,51,085,"Virginia","Hanover County",3,15,1610,849,761
050,51,085,"Virginia","Hanover County",3,16,1600,852,748
050,51,085,"Virginia","Hanover County",3,17,1590,807,783
050,51,085,"Virginia","Hanover County",3,18,1433,718,715
050,51,085,"Virginia","Hanover County",3,19,1336,670,666
050,51,085,"Virginia","Hanover County",3,20,1403,712,691
050,51,085,"Virginia","Hanover County",3,21,1401,734,667
050,51,085,"Virginia","Hanover County",3,22,1342,698,644
050,51,085,"Virginia","Hanover County",3,23,1173,636,537
050,51,085,"Virginia","Hanover County",3,24,1105,592,513
050,51,085,"Virginia","Hanover County",3,25,1088,574,514
050,51,085,"Virginia","Hanover County",3,26,1064,528,536
050,51,085,"Virginia","Hanover County",3,27,1051,555,496
050,51,085,"Virginia","Hanover County",3,28,1140,595,545
050,51,085,"Virginia","Hanover County",3,29,1150,574,576
050,51,085,"Virginia","Hanover County",3,30,1269,644,625
050,51,085,"Virginia","Hanover County",3,31,1234,606,628
050,51,085,"Virginia","Hanover County",3,32,1206,579,627
050,51,085,"Virginia","Hanover County",3,33,1262,601,661
050,51,085,"Virginia","Hanover County",3,34,1280,644,636
050,51,085,"Virginia","Hanover County",3,35,1345,656,689
050,51,085,"Virginia","Hanover County",3,36,1439,729,710
050,51,085,"Virginia","Hanover County",3,37,1443,706,737
050,51,085,"Virginia","Hanover County",3,38,1490,730,760
050,51,085,"Virginia","Hanover County",3,39,1486,734,752
050,51,085,"Virginia","Hanover County",3,40,1387,685,702
050,51,085,"Virginia","Hanover County",3,41,1410,712,698
050,51,085,"Virginia","Hanover County",3,42,1398,720,678
050,51,085,"Virginia","Hanover County",3,43,1388,690,698
050,51,085,"Virginia","Hanover County",3,44,1354,651,703
050,51,085,"Virginia","Hanover County",3,45,1349,668,681
050,51,085,"Virginia","Hanover County",3,46,1378,658,720
050,51,085,"Virginia","Hanover County",3,47,1343,666,677
050,51,085,"Virginia","Hanover County",3,48,1384,701,683
050,51,085,"Virginia","Hanover County",3,49,1516,758,758
050,51,085,"Virginia","Hanover County",3,50,1635,805,830
050,51,085,"Virginia","Hanover County",3,51,1608,783,825
050,51,085,"Virginia","Hanover County",3,52,1578,773,805
050,51,085,"Virginia","Hanover County",3,53,1546,763,783
050,51,085,"Virginia","Hanover County",3,54,1544,759,785
050,51,085,"Virginia","Hanover County",3,55,1530,727,803
050,51,085,"Virginia","Hanover County",3,56,1625,788,837
050,51,085,"Virginia","Hanover County",3,57,1735,818,917
050,51,085,"Virginia","Hanover County",3,58,1796,869,927
050,51,085,"Virginia","Hanover County",3,59,1804,874,930
050,51,085,"Virginia","Hanover County",3,60,1725,845,880
050,51,085,"Virginia","Hanover County",3,61,1662,831,831
050,51,085,"Virginia","Hanover County",3,62,1631,810,821
050,51,085,"Virginia","Hanover County",3,63,1573,771,802
050,51,085,"Virginia","Hanover County",3,64,1553,753,800
050,51,085,"Virginia","Hanover County",3,65,1462,704,758
050,51,085,"Virginia","Hanover County",3,66,1413,668,745
050,51,085,"Virginia","Hanover County",3,67,1392,664,728
050,51,085,"Virginia","Hanover County",3,68,1288,597,691
050,51,085,"Virginia","Hanover County",3,69,1259,603,656
050,51,085,"Virginia","Hanover County",3,70,1232,568,664
050,51,085,"Virginia","Hanover County",3,71,1157,556,601
050,51,085,"Virginia","Hanover County",3,72,1115,534,581
050,51,085,"Virginia","Hanover County",3,73,1102,525,577
050,51,085,"Virginia","Hanover County",3,74,1214,567,647
050,51,085,"Virginia","Hanover County",3,75,825,376,449
050,51,085,"Virginia","Hanover County",3,76,797,379,418
050,51,085,"Virginia","Hanover County",3,77,753,336,417
050,51,085,"Virginia","Hanover County",3,78,785,342,443
050,51,085,"Virginia","Hanover County",3,79,661,291,370
050,51,085,"Virginia","Hanover County",3,80,618,276,342
050,51,085,"Virginia","Hanover County",3,81,515,217,298
050,51,085,"Virginia","Hanover County",3,82,452,204,248
050,51,085,"Virginia","Hanover County",3,83,421,184,237
050,51,085,"Virginia","Hanover County",3,84,346,136,210
050,51,085,"Virginia","Hanover County",3,85,2112,776,1336
050,51,085,"Virginia","Hanover County",4,0,1068,553,515
050,51,085,"Virginia","Hanover County",4,1,1049,547,502
050,51,085,"Virginia","Hanover County",4,2,1123,595,528
050,51,085,"Virginia","Hanover County",4,3,1192,621,571
050,51,085,"Virginia","Hanover County",4,4,1237,663,574
050,51,085,"Virginia","Hanover County",4,5,1196,608,588
050,51,085,"Virginia","Hanover County",4,6,1289,659,630
050,51,085,"Virginia","Hanover County",4,7,1337,682,655
050,51,085,"Virginia","Hanover County",4,8,1355,704,651
050,51,085,"Virginia","Hanover County",4,9,1416,753,663
050,51,085,"Virginia","Hanover County",4,10,1424,746,678
050,51,085,"Virginia","Hanover County",4,11,1406,714,692
050,51,085,"Virginia","Hanover County",4,12,1465,791,674
050,51,085,"Virginia","Hanover County",4,13,1503,769,734
050,51,085,"Virginia","Hanover County",4,14,1538,799,739
050,51,085,"Virginia","Hanover County",4,15,1563,831,732
050,51,085,"Virginia","Hanover County",4,16,1613,835,778
050,51,085,"Virginia","Hanover County",4,17,1609,851,758
050,51,085,"Virginia","Hanover County",4,18,1470,750,720
050,51,085,"Virginia","Hanover County",4,19,1303,655,648
050,51,085,"Virginia","Hanover County",4,20,1351,676,675
050,51,085,"Virginia","Hanover County",4,21,1343,691,652
050,51,085,"Virginia","Hanover County",4,22,1341,680,661
050,51,085,"Virginia","Hanover County",4,23,1234,666,568
050,51,085,"Virginia","Hanover County",4,24,1102,582,520
050,51,085,"Virginia","Hanover County",4,25,1060,564,496
050,51,085,"Virginia","Hanover County",4,26,1084,585,499
050,51,085,"Virginia","Hanover County",4,27,1071,546,525
050,51,085,"Virginia","Hanover County",4,28,1097,552,545
050,51,085,"Virginia","Hanover County",4,29,1143,584,559
050,51,085,"Virginia","Hanover County",4,30,1213,588,625
050,51,085,"Virginia","Hanover County",4,31,1322,664,658
050,51,085,"Virginia","Hanover County",4,32,1309,656,653
050,51,085,"Virginia","Hanover County",4,33,1311,627,684
050,51,085,"Virginia","Hanover County",4,34,1327,654,673
050,51,085,"Virginia","Hanover County",4,35,1318,654,664
050,51,085,"Virginia","Hanover County",4,36,1411,694,717
050,51,085,"Virginia","Hanover County",4,37,1495,754,741
050,51,085,"Virginia","Hanover County",4,38,1498,741,757
050,51,085,"Virginia","Hanover County",4,39,1533,758,775
050,51,085,"Virginia","Hanover County",4,40,1497,737,760
050,51,085,"Virginia","Hanover County",4,41,1443,716,727
050,51,085,"Virginia","Hanover County",4,42,1440,730,710
050,51,085,"Virginia","Hanover County",4,43,1422,738,684
050,51,085,"Virginia","Hanover County",4,44,1397,691,706
050,51,085,"Virginia","Hanover County",4,45,1382,671,711
050,51,085,"Virginia","Hanover County",4,46,1347,676,671
050,51,085,"Virginia","Hanover County",4,47,1409,675,734
050,51,085,"Virginia","Hanover County",4,48,1350,680,670
050,51,085,"Virginia","Hanover County",4,49,1400,702,698
050,51,085,"Virginia","Hanover County",4,50,1515,751,764
050,51,085,"Virginia","Hanover County",4,51,1647,807,840
050,51,085,"Virginia","Hanover County",4,52,1615,793,822
050,51,085,"Virginia","Hanover County",4,53,1572,770,802
050,51,085,"Virginia","Hanover County",4,54,1523,755,768
050,51,085,"Virginia","Hanover County",4,55,1559,766,793
050,51,085,"Virginia","Hanover County",4,56,1514,712,802
050,51,085,"Virginia","Hanover County",4,57,1614,793,821
050,51,085,"Virginia","Hanover County",4,58,1727,822,905
050,51,085,"Virginia","Hanover County",4,59,1775,855,920
050,51,085,"Virginia","Hanover County",4,60,1760,850,910
050,51,085,"Virginia","Hanover County",4,61,1714,835,879
050,51,085,"Virginia","Hanover County",4,62,1630,797,833
050,51,085,"Virginia","Hanover County",4,63,1606,800,806
050,51,085,"Virginia","Hanover County",4,64,1569,774,795
050,51,085,"Virginia","Hanover County",4,65,1530,752,778
050,51,085,"Virginia","Hanover County",4,66,1458,702,756
050,51,085,"Virginia","Hanover County",4,67,1416,667,749
050,51,085,"Virginia","Hanover County",4,68,1370,653,717
050,51,085,"Virginia","Hanover County",4,69,1254,584,670
050,51,085,"Virginia","Hanover County",4,70,1238,584,654
050,51,085,"Virginia","Hanover County",4,71,1197,553,644
050,51,085,"Virginia","Hanover County",4,72,1141,545,596
050,51,085,"Virginia","Hanover County",4,73,1115,541,574
050,51,085,"Virginia","Hanover County",4,74,1068,499,569
050,51,085,"Virginia","Hanover County",4,75,1188,557,631
050,51,085,"Virginia","Hanover County",4,76,800,365,435
050,51,085,"Virginia","Hanover County",4,77,766,349,417
050,51,085,"Virginia","Hanover County",4,78,741,319,422
050,51,085,"Virginia","Hanover County",4,79,745,326,419
050,51,085,"Virginia","Hanover County",4,80,650,289,361
050,51,085,"Virginia","Hanover County",4,81,603,262,341
050,51,085,"Virginia","Hanover County",4,82,481,212,269
050,51,085,"Virginia","Hanover County",4,83,426,183,243
050,51,085,"Virginia","Hanover County",4,84,397,160,237
050,51,085,"Virginia","Hanover County",4,85,2130,784,1346
050,51,085,"Virginia","Hanover County",5,0,1066,552,514
050,51,085,"Virginia","Hanover County",5,1,1145,596,549
050,51,085,"Virginia","Hanover County",5,2,1116,570,546
050,51,085,"Virginia","Hanover County",5,3,1153,616,537
050,51,085,"Virginia","Hanover County",5,4,1253,654,599
050,51,085,"Virginia","Hanover County",5,5,1268,672,596
050,51,085,"Virginia","Hanover County",5,6,1239,646,593
050,51,085,"Virginia","Hanover County",5,7,1358,696,662
050,51,085,"Virginia","Hanover County",5,8,1387,702,685
050,51,085,"Virginia","Hanover County",5,9,1405,732,673
050,51,085,"Virginia","Hanover County",5,10,1452,783,669
050,51,085,"Virginia","Hanover County",5,11,1448,756,692
050,51,085,"Virginia","Hanover County",5,12,1411,733,678
050,51,085,"Virginia","Hanover County",5,13,1482,788,694
050,51,085,"Virginia","Hanover County",5,14,1507,774,733
050,51,085,"Virginia","Hanover County",5,15,1558,807,751
050,51,085,"Virginia","Hanover County",5,16,1588,842,746
050,51,085,"Virginia","Hanover County",5,17,1603,829,774
050,51,085,"Virginia","Hanover County",5,18,1496,794,702
050,51,085,"Virginia","Hanover County",5,19,1352,679,673
050,51,085,"Virginia","Hanover County",5,20,1350,675,675
050,51,085,"Virginia","Hanover County",5,21,1321,672,649
050,51,085,"Virginia","Hanover County",5,22,1325,668,657
050,51,085,"Virginia","Hanover County",5,23,1267,649,618
050,51,085,"Virginia","Hanover County",5,24,1220,657,563
050,51,085,"Virginia","Hanover County",5,25,1094,586,508
050,51,085,"Virginia","Hanover County",5,26,1031,549,482
050,51,085,"Virginia","Hanover County",5,27,1066,565,501
050,51,085,"Virginia","Hanover County",5,28,1074,552,522
050,51,085,"Virginia","Hanover County",5,29,1116,561,555
050,51,085,"Virginia","Hanover County",5,30,1184,611,573
050,51,085,"Virginia","Hanover County",5,31,1282,628,654
050,51,085,"Virginia","Hanover County",5,32,1374,714,660
050,51,085,"Virginia","Hanover County",5,33,1415,686,729
050,51,085,"Virginia","Hanover County",5,34,1367,663,704
050,51,085,"Virginia","Hanover County",5,35,1412,698,714
050,51,085,"Virginia","Hanover County",5,36,1426,709,717
050,51,085,"Virginia","Hanover County",5,37,1439,706,733
050,51,085,"Virginia","Hanover County",5,38,1562,799,763
050,51,085,"Virginia","Hanover County",5,39,1535,772,763
050,51,085,"Virginia","Hanover County",5,40,1576,794,782
050,51,085,"Virginia","Hanover County",5,41,1539,761,778
050,51,085,"Virginia","Hanover County",5,42,1484,731,753
050,51,085,"Virginia","Hanover County",5,43,1467,742,725
050,51,085,"Virginia","Hanover County",5,44,1440,733,707
050,51,085,"Virginia","Hanover County",5,45,1396,692,704
050,51,085,"Virginia","Hanover County",5,46,1380,681,699
050,51,085,"Virginia","Hanover County",5,47,1362,679,683
050,51,085,"Virginia","Hanover County",5,48,1414,676,738
050,51,085,"Virginia","Hanover County",5,49,1372,692,680
050,51,085,"Virginia","Hanover County",5,50,1389,689,700
050,51,085,"Virginia","Hanover County",5,51,1508,759,749
050,51,085,"Virginia","Hanover County",5,52,1665,819,846
050,51,085,"Virginia","Hanover County",5,53,1619,796,823
050,51,085,"Virginia","Hanover County",5,54,1561,772,789
050,51,085,"Virginia","Hanover County",5,55,1525,757,768
050,51,085,"Virginia","Hanover County",5,56,1548,762,786
050,51,085,"Virginia","Hanover County",5,57,1507,714,793
050,51,085,"Virginia","Hanover County",5,58,1615,793,822
050,51,085,"Virginia","Hanover County",5,59,1711,820,891
050,51,085,"Virginia","Hanover County",5,60,1747,834,913
050,51,085,"Virginia","Hanover County",5,61,1732,838,894
050,51,085,"Virginia","Hanover County",5,62,1699,826,873
050,51,085,"Virginia","Hanover County",5,63,1626,796,830
050,51,085,"Virginia","Hanover County",5,64,1605,790,815
050,51,085,"Virginia","Hanover County",5,65,1560,766,794
050,51,085,"Virginia","Hanover County",5,66,1493,732,761
050,51,085,"Virginia","Hanover County",5,67,1470,704,766
050,51,085,"Virginia","Hanover County",5,68,1391,651,740
050,51,085,"Virginia","Hanover County",5,69,1362,645,717
050,51,085,"Virginia","Hanover County",5,70,1236,570,666
050,51,085,"Virginia","Hanover County",5,71,1230,580,650
050,51,085,"Virginia","Hanover County",5,72,1166,533,633
050,51,085,"Virginia","Hanover County",5,73,1134,546,588
050,51,085,"Virginia","Hanover County",5,74,1089,521,568
050,51,085,"Virginia","Hanover County",5,75,1047,489,558
050,51,085,"Virginia","Hanover County",5,76,1163,539,624
050,51,085,"Virginia","Hanover County",5,77,775,348,427
050,51,085,"Virginia","Hanover County",5,78,753,336,417
050,51,085,"Virginia","Hanover County",5,79,690,297,393
050,51,085,"Virginia","Hanover County",5,80,724,323,401
050,51,085,"Virginia","Hanover County",5,81,629,276,353
050,51,085,"Virginia","Hanover County",5,82,559,249,310
050,51,085,"Virginia","Hanover County",5,83,443,189,254
050,51,085,"Virginia","Hanover County",5,84,394,158,236
050,51,085,"Virginia","Hanover County",5,85,2206,814,1392
050,51,087,"Virginia","Henrico County",1,0,3896,1980,1916
050,51,087,"Virginia","Henrico County",1,1,4004,2017,1987
050,51,087,"Virginia","Henrico County",1,2,4112,2095,2017
050,51,087,"Virginia","Henrico County",1,3,4002,2072,1930
050,51,087,"Virginia","Henrico County",1,4,4116,2118,1998
050,51,087,"Virginia","Henrico County",1,5,4029,2071,1958
050,51,087,"Virginia","Henrico County",1,6,4037,2101,1936
050,51,087,"Virginia","Henrico County",1,7,4064,2107,1957
050,51,087,"Virginia","Henrico County",1,8,4093,2110,1983
050,51,087,"Virginia","Henrico County",1,9,4077,2077,2000
050,51,087,"Virginia","Henrico County",1,10,4259,2194,2065
050,51,087,"Virginia","Henrico County",1,11,4304,2200,2104
050,51,087,"Virginia","Henrico County",1,12,4452,2242,2210
050,51,087,"Virginia","Henrico County",1,13,4533,2305,2228
050,51,087,"Virginia","Henrico County",1,14,4507,2289,2218
050,51,087,"Virginia","Henrico County",1,15,4456,2288,2168
050,51,087,"Virginia","Henrico County",1,16,4535,2341,2194
050,51,087,"Virginia","Henrico County",1,17,4387,2260,2127
050,51,087,"Virginia","Henrico County",1,18,3837,2016,1821
050,51,087,"Virginia","Henrico County",1,19,3449,1832,1617
050,51,087,"Virginia","Henrico County",1,20,3481,1769,1712
050,51,087,"Virginia","Henrico County",1,21,3506,1752,1754
050,51,087,"Virginia","Henrico County",1,22,3654,1839,1815
050,51,087,"Virginia","Henrico County",1,23,3749,1837,1912
050,51,087,"Virginia","Henrico County",1,24,3886,1881,2005
050,51,087,"Virginia","Henrico County",1,25,4248,2059,2189
050,51,087,"Virginia","Henrico County",1,26,4460,2139,2321
050,51,087,"Virginia","Henrico County",1,27,4679,2261,2418
050,51,087,"Virginia","Henrico County",1,28,4821,2328,2493
050,51,087,"Virginia","Henrico County",1,29,4962,2412,2550
050,51,087,"Virginia","Henrico County",1,30,4970,2372,2598
050,51,087,"Virginia","Henrico County",1,31,4858,2323,2535
050,51,087,"Virginia","Henrico County",1,32,4817,2279,2538
050,51,087,"Virginia","Henrico County",1,33,4845,2359,2486
050,51,087,"Virginia","Henrico County",1,34,4895,2400,2495
050,51,087,"Virginia","Henrico County",1,35,4889,2329,2560
050,51,087,"Virginia","Henrico County",1,36,4866,2342,2524
050,51,087,"Virginia","Henrico County",1,37,4792,2367,2425
050,51,087,"Virginia","Henrico County",1,38,4701,2280,2421
050,51,087,"Virginia","Henrico County",1,39,4851,2353,2498
050,51,087,"Virginia","Henrico County",1,40,4786,2344,2442
050,51,087,"Virginia","Henrico County",1,41,4478,2192,2286
050,51,087,"Virginia","Henrico County",1,42,4339,2091,2248
050,51,087,"Virginia","Henrico County",1,43,4176,1976,2200
050,51,087,"Virginia","Henrico County",1,44,4055,1954,2101
050,51,087,"Virginia","Henrico County",1,45,4136,1982,2154
050,51,087,"Virginia","Henrico County",1,46,4045,1923,2122
050,51,087,"Virginia","Henrico County",1,47,4167,1929,2238
050,51,087,"Virginia","Henrico County",1,48,4530,2160,2370
050,51,087,"Virginia","Henrico County",1,49,4833,2318,2515
050,51,087,"Virginia","Henrico County",1,50,4516,2190,2326
050,51,087,"Virginia","Henrico County",1,51,4380,2103,2277
050,51,087,"Virginia","Henrico County",1,52,4230,1998,2232
050,51,087,"Virginia","Henrico County",1,53,4352,2082,2270
050,51,087,"Virginia","Henrico County",1,54,4245,2017,2228
050,51,087,"Virginia","Henrico County",1,55,4472,2064,2408
050,51,087,"Virginia","Henrico County",1,56,4546,2135,2411
050,51,087,"Virginia","Henrico County",1,57,4533,2119,2414
050,51,087,"Virginia","Henrico County",1,58,4473,2089,2384
050,51,087,"Virginia","Henrico County",1,59,4405,2062,2343
050,51,087,"Virginia","Henrico County",1,60,4330,2011,2319
050,51,087,"Virginia","Henrico County",1,61,4328,1939,2389
050,51,087,"Virginia","Henrico County",1,62,4149,1903,2246
050,51,087,"Virginia","Henrico County",1,63,4036,1834,2202
050,51,087,"Virginia","Henrico County",1,64,3957,1767,2190
050,51,087,"Virginia","Henrico County",1,65,3890,1764,2126
050,51,087,"Virginia","Henrico County",1,66,3752,1658,2094
050,51,087,"Virginia","Henrico County",1,67,3575,1634,1941
050,51,087,"Virginia","Henrico County",1,68,3337,1492,1845
050,51,087,"Virginia","Henrico County",1,69,3087,1343,1744
050,51,087,"Virginia","Henrico County",1,70,3153,1388,1765
050,51,087,"Virginia","Henrico County",1,71,3027,1315,1712
050,51,087,"Virginia","Henrico County",1,72,2969,1298,1671
050,51,087,"Virginia","Henrico County",1,73,2908,1280,1628
050,51,087,"Virginia","Henrico County",1,74,2091,915,1176
050,51,087,"Virginia","Henrico County",1,75,2021,860,1161
050,51,087,"Virginia","Henrico County",1,76,1996,818,1178
050,51,087,"Virginia","Henrico County",1,77,1971,809,1162
050,51,087,"Virginia","Henrico County",1,78,1685,700,985
050,51,087,"Virginia","Henrico County",1,79,1480,578,902
050,51,087,"Virginia","Henrico County",1,80,1366,538,828
050,51,087,"Virginia","Henrico County",1,81,1270,501,769
050,51,087,"Virginia","Henrico County",1,82,1144,426,718
050,51,087,"Virginia","Henrico County",1,83,1065,379,686
050,51,087,"Virginia","Henrico County",1,84,1024,361,663
050,51,087,"Virginia","Henrico County",1,85,6544,2103,4441
050,51,087,"Virginia","Henrico County",2,0,3811,1932,1879
050,51,087,"Virginia","Henrico County",2,1,3968,1997,1971
050,51,087,"Virginia","Henrico County",2,2,4092,2078,2014
050,51,087,"Virginia","Henrico County",2,3,4014,2071,1943
050,51,087,"Virginia","Henrico County",2,4,4089,2107,1982
050,51,087,"Virginia","Henrico County",2,5,4059,2090,1969
050,51,087,"Virginia","Henrico County",2,6,4039,2093,1946
050,51,087,"Virginia","Henrico County",2,7,4046,2102,1944
050,51,087,"Virginia","Henrico County",2,8,4071,2103,1968
050,51,087,"Virginia","Henrico County",2,9,4075,2086,1989
050,51,087,"Virginia","Henrico County",2,10,4217,2165,2052
050,51,087,"Virginia","Henrico County",2,11,4274,2186,2088
050,51,087,"Virginia","Henrico County",2,12,4429,2241,2188
050,51,087,"Virginia","Henrico County",2,13,4499,2287,2212
050,51,087,"Virginia","Henrico County",2,14,4498,2288,2210
050,51,087,"Virginia","Henrico County",2,15,4470,2287,2183
050,51,087,"Virginia","Henrico County",2,16,4519,2328,2191
050,51,087,"Virginia","Henrico County",2,17,4409,2270,2139
050,51,087,"Virginia","Henrico County",2,18,3843,2018,1825
050,51,087,"Virginia","Henrico County",2,19,3450,1820,1630
050,51,087,"Virginia","Henrico County",2,20,3532,1801,1731
050,51,087,"Virginia","Henrico County",2,21,3524,1765,1759
050,51,087,"Virginia","Henrico County",2,22,3656,1828,1828
050,51,087,"Virginia","Henrico County",2,23,3769,1852,1917
050,51,087,"Virginia","Henrico County",2,24,3883,1885,1998
050,51,087,"Virginia","Henrico County",2,25,4190,2034,2156
050,51,087,"Virginia","Henrico County",2,26,4428,2133,2295
050,51,087,"Virginia","Henrico County",2,27,4654,2242,2412
050,51,087,"Virginia","Henrico County",2,28,4810,2325,2485
050,51,087,"Virginia","Henrico County",2,29,4940,2395,2545
050,51,087,"Virginia","Henrico County",2,30,5022,2413,2609
050,51,087,"Virginia","Henrico County",2,31,4876,2334,2542
050,51,087,"Virginia","Henrico County",2,32,4838,2291,2547
050,51,087,"Virginia","Henrico County",2,33,4836,2338,2498
050,51,087,"Virginia","Henrico County",2,34,4877,2381,2496
050,51,087,"Virginia","Henrico County",2,35,4924,2361,2563
050,51,087,"Virginia","Henrico County",2,36,4850,2329,2521
050,51,087,"Virginia","Henrico County",2,37,4805,2355,2450
050,51,087,"Virginia","Henrico County",2,38,4729,2301,2428
050,51,087,"Virginia","Henrico County",2,39,4787,2324,2463
050,51,087,"Virginia","Henrico County",2,40,4828,2361,2467
050,51,087,"Virginia","Henrico County",2,41,4538,2219,2319
050,51,087,"Virginia","Henrico County",2,42,4352,2108,2244
050,51,087,"Virginia","Henrico County",2,43,4223,2003,2220
050,51,087,"Virginia","Henrico County",2,44,4047,1940,2107
050,51,087,"Virginia","Henrico County",2,45,4122,1973,2149
050,51,087,"Virginia","Henrico County",2,46,4045,1924,2121
050,51,087,"Virginia","Henrico County",2,47,4117,1919,2198
050,51,087,"Virginia","Henrico County",2,48,4433,2099,2334
050,51,087,"Virginia","Henrico County",2,49,4766,2282,2484
050,51,087,"Virginia","Henrico County",2,50,4595,2228,2367
050,51,087,"Virginia","Henrico County",2,51,4383,2110,2273
050,51,087,"Virginia","Henrico County",2,52,4258,2014,2244
050,51,087,"Virginia","Henrico County",2,53,4305,2053,2252
050,51,087,"Virginia","Henrico County",2,54,4250,2025,2225
050,51,087,"Virginia","Henrico County",2,55,4411,2050,2361
050,51,087,"Virginia","Henrico County",2,56,4520,2112,2408
050,51,087,"Virginia","Henrico County",2,57,4533,2121,2412
050,51,087,"Virginia","Henrico County",2,58,4482,2097,2385
050,51,087,"Virginia","Henrico County",2,59,4420,2065,2355
050,51,087,"Virginia","Henrico County",2,60,4320,2003,2317
050,51,087,"Virginia","Henrico County",2,61,4309,1943,2366
050,51,087,"Virginia","Henrico County",2,62,4160,1892,2268
050,51,087,"Virginia","Henrico County",2,63,4083,1854,2229
050,51,087,"Virginia","Henrico County",2,64,3934,1766,2168
050,51,087,"Virginia","Henrico County",2,65,3891,1753,2138
050,51,087,"Virginia","Henrico County",2,66,3776,1676,2100
050,51,087,"Virginia","Henrico County",2,67,3586,1622,1964
050,51,087,"Virginia","Henrico County",2,68,3359,1509,1850
050,51,087,"Virginia","Henrico County",2,69,3151,1380,1771
050,51,087,"Virginia","Henrico County",2,70,3108,1361,1747
050,51,087,"Virginia","Henrico County",2,71,3030,1320,1710
050,51,087,"Virginia","Henrico County",2,72,2930,1271,1659
050,51,087,"Virginia","Henrico County",2,73,3034,1338,1696
050,51,087,"Virginia","Henrico County",2,74,2157,942,1215
050,51,087,"Virginia","Henrico County",2,75,2033,873,1160
050,51,087,"Virginia","Henrico County",2,76,1977,816,1161
050,51,087,"Virginia","Henrico County",2,77,2002,817,1185
050,51,087,"Virginia","Henrico County",2,78,1716,709,1007
050,51,087,"Virginia","Henrico County",2,79,1501,593,908
050,51,087,"Virginia","Henrico County",2,80,1382,540,842
050,51,087,"Virginia","Henrico County",2,81,1276,503,773
050,51,087,"Virginia","Henrico County",2,82,1152,432,720
050,51,087,"Virginia","Henrico County",2,83,1073,382,691
050,51,087,"Virginia","Henrico County",2,84,1029,364,665
050,51,087,"Virginia","Henrico County",2,85,6506,2104,4402
050,51,087,"Virginia","Henrico County",3,0,3561,1819,1742
050,51,087,"Virginia","Henrico County",3,1,3732,1884,1848
050,51,087,"Virginia","Henrico County",3,2,4000,2012,1988
050,51,087,"Virginia","Henrico County",3,3,4098,2089,2009
050,51,087,"Virginia","Henrico County",3,4,3984,2048,1936
050,51,087,"Virginia","Henrico County",3,5,4065,2084,1981
050,51,087,"Virginia","Henrico County",3,6,4021,2058,1963
050,51,087,"Virginia","Henrico County",3,7,4025,2127,1898
050,51,087,"Virginia","Henrico County",3,8,4002,2071,1931
050,51,087,"Virginia","Henrico County",3,9,4099,2103,1996
050,51,087,"Virginia","Henrico County",3,10,4053,2069,1984
050,51,087,"Virginia","Henrico County",3,11,4151,2114,2037
050,51,087,"Virginia","Henrico County",3,12,4225,2152,2073
050,51,087,"Virginia","Henrico County",3,13,4421,2241,2180
050,51,087,"Virginia","Henrico County",3,14,4486,2258,2228
050,51,087,"Virginia","Henrico County",3,15,4481,2309,2172
050,51,087,"Virginia","Henrico County",3,16,4490,2283,2207
050,51,087,"Virginia","Henrico County",3,17,4477,2313,2164
050,51,087,"Virginia","Henrico County",3,18,3925,2065,1860
050,51,087,"Virginia","Henrico County",3,19,3424,1790,1634
050,51,087,"Virginia","Henrico County",3,20,3564,1833,1731
050,51,087,"Virginia","Henrico County",3,21,3615,1820,1795
050,51,087,"Virginia","Henrico County",3,22,3656,1810,1846
050,51,087,"Virginia","Henrico County",3,23,3791,1868,1923
050,51,087,"Virginia","Henrico County",3,24,3928,1923,2005
050,51,087,"Virginia","Henrico County",3,25,3958,1918,2040
050,51,087,"Virginia","Henrico County",3,26,4277,2091,2186
050,51,087,"Virginia","Henrico County",3,27,4548,2184,2364
050,51,087,"Virginia","Henrico County",3,28,4754,2295,2459
050,51,087,"Virginia","Henrico County",3,29,4822,2402,2420
050,51,087,"Virginia","Henrico County",3,30,4987,2400,2587
050,51,087,"Virginia","Henrico County",3,31,5043,2427,2616
050,51,087,"Virginia","Henrico County",3,32,4995,2380,2615
050,51,087,"Virginia","Henrico County",3,33,4807,2274,2533
050,51,087,"Virginia","Henrico County",3,34,4818,2286,2532
050,51,087,"Virginia","Henrico County",3,35,4876,2388,2488
050,51,087,"Virginia","Henrico County",3,36,4887,2369,2518
050,51,087,"Virginia","Henrico County",3,37,4808,2302,2506
050,51,087,"Virginia","Henrico County",3,38,4774,2375,2399
050,51,087,"Virginia","Henrico County",3,39,4674,2284,2390
050,51,087,"Virginia","Henrico County",3,40,4785,2322,2463
050,51,087,"Virginia","Henrico County",3,41,4774,2337,2437
050,51,087,"Virginia","Henrico County",3,42,4551,2225,2326
050,51,087,"Virginia","Henrico County",3,43,4296,2076,2220
050,51,087,"Virginia","Henrico County",3,44,4188,1973,2215
050,51,087,"Virginia","Henrico County",3,45,3961,1902,2059
050,51,087,"Virginia","Henrico County",3,46,4087,1952,2135
050,51,087,"Virginia","Henrico County",3,47,4001,1896,2105
050,51,087,"Virginia","Henrico County",3,48,4091,1917,2174
050,51,087,"Virginia","Henrico County",3,49,4363,2066,2297
050,51,087,"Virginia","Henrico County",3,50,4712,2269,2443
050,51,087,"Virginia","Henrico County",3,51,4579,2234,2345
050,51,087,"Virginia","Henrico County",3,52,4306,2048,2258
050,51,087,"Virginia","Henrico County",3,53,4248,2007,2241
050,51,087,"Virginia","Henrico County",3,54,4235,2038,2197
050,51,087,"Virginia","Henrico County",3,55,4209,2003,2206
050,51,087,"Virginia","Henrico County",3,56,4317,2013,2304
050,51,087,"Virginia","Henrico County",3,57,4445,2069,2376
050,51,087,"Virginia","Henrico County",3,58,4492,2095,2397
050,51,087,"Virginia","Henrico County",3,59,4417,2071,2346
050,51,087,"Virginia","Henrico County",3,60,4379,2041,2338
050,51,087,"Virginia","Henrico County",3,61,4236,1928,2308
050,51,087,"Virginia","Henrico County",3,62,4196,1907,2289
050,51,087,"Virginia","Henrico County",3,63,4117,1873,2244
050,51,087,"Virginia","Henrico County",3,64,3959,1806,2153
050,51,087,"Virginia","Henrico County",3,65,3857,1692,2165
050,51,087,"Virginia","Henrico County",3,66,3826,1713,2113
050,51,087,"Virginia","Henrico County",3,67,3705,1633,2072
050,51,087,"Virginia","Henrico County",3,68,3525,1569,1956
050,51,087,"Virginia","Henrico County",3,69,3291,1470,1821
050,51,087,"Virginia","Henrico County",3,70,3105,1353,1752
050,51,087,"Virginia","Henrico County",3,71,3015,1317,1698
050,51,087,"Virginia","Henrico County",3,72,2962,1278,1684
050,51,087,"Virginia","Henrico County",3,73,2867,1230,1637
050,51,087,"Virginia","Henrico County",3,74,2966,1307,1659
050,51,087,"Virginia","Henrico County",3,75,2100,903,1197
050,51,087,"Virginia","Henrico County",3,76,1974,832,1142
050,51,087,"Virginia","Henrico County",3,77,1932,798,1134
050,51,087,"Virginia","Henrico County",3,78,1962,805,1157
050,51,087,"Virginia","Henrico County",3,79,1643,662,981
050,51,087,"Virginia","Henrico County",3,80,1445,557,888
050,51,087,"Virginia","Henrico County",3,81,1317,503,814
050,51,087,"Virginia","Henrico County",3,82,1160,447,713
050,51,087,"Virginia","Henrico County",3,83,1101,411,690
050,51,087,"Virginia","Henrico County",3,84,1029,352,677
050,51,087,"Virginia","Henrico County",3,85,6394,2081,4313
050,51,087,"Virginia","Henrico County",4,0,3672,1873,1799
050,51,087,"Virginia","Henrico County",4,1,3538,1849,1689
050,51,087,"Virginia","Henrico County",4,2,3787,1917,1870
050,51,087,"Virginia","Henrico County",4,3,3944,1995,1949
050,51,087,"Virginia","Henrico County",4,4,4090,2090,2000
050,51,087,"Virginia","Henrico County",4,5,3988,2017,1971
050,51,087,"Virginia","Henrico County",4,6,4071,2070,2001
050,51,087,"Virginia","Henrico County",4,7,4011,2047,1964
050,51,087,"Virginia","Henrico County",4,8,3995,2103,1892
050,51,087,"Virginia","Henrico County",4,9,3978,2055,1923
050,51,087,"Virginia","Henrico County",4,10,4080,2118,1962
050,51,087,"Virginia","Henrico County",4,11,4029,2070,1959
050,51,087,"Virginia","Henrico County",4,12,4128,2108,2020
050,51,087,"Virginia","Henrico County",4,13,4236,2159,2077
050,51,087,"Virginia","Henrico County",4,14,4354,2191,2163
050,51,087,"Virginia","Henrico County",4,15,4478,2256,2222
050,51,087,"Virginia","Henrico County",4,16,4497,2316,2181
050,51,087,"Virginia","Henrico County",4,17,4513,2285,2228
050,51,087,"Virginia","Henrico County",4,18,3948,2073,1875
050,51,087,"Virginia","Henrico County",4,19,3416,1780,1636
050,51,087,"Virginia","Henrico County",4,20,3501,1801,1700
050,51,087,"Virginia","Henrico County",4,21,3600,1845,1755
050,51,087,"Virginia","Henrico County",4,22,3756,1854,1902
050,51,087,"Virginia","Henrico County",4,23,3879,1903,1976
050,51,087,"Virginia","Henrico County",4,24,3892,1909,1983
050,51,087,"Virginia","Henrico County",4,25,4002,1980,2022
050,51,087,"Virginia","Henrico County",4,26,4016,1943,2073
050,51,087,"Virginia","Henrico County",4,27,4330,2113,2217
050,51,087,"Virginia","Henrico County",4,28,4674,2218,2456
050,51,087,"Virginia","Henrico County",4,29,4769,2276,2493
050,51,087,"Virginia","Henrico County",4,30,4948,2459,2489
050,51,087,"Virginia","Henrico County",4,31,4990,2400,2590
050,51,087,"Virginia","Henrico County",4,32,5080,2463,2617
050,51,087,"Virginia","Henrico County",4,33,4948,2393,2555
050,51,087,"Virginia","Henrico County",4,34,4856,2292,2564
050,51,087,"Virginia","Henrico County",4,35,4868,2316,2552
050,51,087,"Virginia","Henrico County",4,36,4907,2350,2557
050,51,087,"Virginia","Henrico County",4,37,4913,2364,2549
050,51,087,"Virginia","Henrico County",4,38,4799,2307,2492
050,51,087,"Virginia","Henrico County",4,39,4752,2346,2406
050,51,087,"Virginia","Henrico County",4,40,4744,2302,2442
050,51,087,"Virginia","Henrico County",4,41,4739,2265,2474
050,51,087,"Virginia","Henrico County",4,42,4801,2341,2460
050,51,087,"Virginia","Henrico County",4,43,4554,2212,2342
050,51,087,"Virginia","Henrico County",4,44,4257,2044,2213
050,51,087,"Virginia","Henrico County",4,45,4120,1941,2179
050,51,087,"Virginia","Henrico County",4,46,3909,1861,2048
050,51,087,"Virginia","Henrico County",4,47,4008,1902,2106
050,51,087,"Virginia","Henrico County",4,48,3994,1897,2097
050,51,087,"Virginia","Henrico County",4,49,4073,1900,2173
050,51,087,"Virginia","Henrico County",4,50,4331,2063,2268
050,51,087,"Virginia","Henrico County",4,51,4645,2238,2407
050,51,087,"Virginia","Henrico County",4,52,4520,2191,2329
050,51,087,"Virginia","Henrico County",4,53,4262,2020,2242
050,51,087,"Virginia","Henrico County",4,54,4196,1979,2217
050,51,087,"Virginia","Henrico County",4,55,4166,1996,2170
050,51,087,"Virginia","Henrico County",4,56,4135,1965,2170
050,51,087,"Virginia","Henrico County",4,57,4251,1961,2290
050,51,087,"Virginia","Henrico County",4,58,4354,2028,2326
050,51,087,"Virginia","Henrico County",4,59,4380,2036,2344
050,51,087,"Virginia","Henrico County",4,60,4333,2024,2309
050,51,087,"Virginia","Henrico County",4,61,4331,2014,2317
050,51,087,"Virginia","Henrico County",4,62,4129,1893,2236
050,51,087,"Virginia","Henrico County",4,63,4142,1866,2276
050,51,087,"Virginia","Henrico County",4,64,4024,1830,2194
050,51,087,"Virginia","Henrico County",4,65,3885,1737,2148
050,51,087,"Virginia","Henrico County",4,66,3756,1633,2123
050,51,087,"Virginia","Henrico County",4,67,3733,1657,2076
050,51,087,"Virginia","Henrico County",4,68,3656,1575,2081
050,51,087,"Virginia","Henrico County",4,69,3503,1561,1942
050,51,087,"Virginia","Henrico County",4,70,3288,1452,1836
050,51,087,"Virginia","Henrico County",4,71,3038,1332,1706
050,51,087,"Virginia","Henrico County",4,72,2960,1283,1677
050,51,087,"Virginia","Henrico County",4,73,2876,1236,1640
050,51,087,"Virginia","Henrico County",4,74,2830,1207,1623
050,51,087,"Virginia","Henrico County",4,75,2903,1251,1652
050,51,087,"Virginia","Henrico County",4,76,2039,871,1168
050,51,087,"Virginia","Henrico County",4,77,1933,818,1115
050,51,087,"Virginia","Henrico County",4,78,1898,785,1113
050,51,087,"Virginia","Henrico County",4,79,1888,765,1123
050,51,087,"Virginia","Henrico County",4,80,1599,631,968
050,51,087,"Virginia","Henrico County",4,81,1414,542,872
050,51,087,"Virginia","Henrico County",4,82,1195,440,755
050,51,087,"Virginia","Henrico County",4,83,1090,419,671
050,51,087,"Virginia","Henrico County",4,84,1060,391,669
050,51,087,"Virginia","Henrico County",4,85,6378,2056,4322
050,51,087,"Virginia","Henrico County",5,0,3669,1875,1794
050,51,087,"Virginia","Henrico County",5,1,3724,1904,1820
050,51,087,"Virginia","Henrico County",5,2,3572,1883,1689
050,51,087,"Virginia","Henrico County",5,3,3756,1906,1850
050,51,087,"Virginia","Henrico County",5,4,3952,2004,1948
050,51,087,"Virginia","Henrico County",5,5,4031,2060,1971
050,51,087,"Virginia","Henrico County",5,6,3969,2015,1954
050,51,087,"Virginia","Henrico County",5,7,4012,2056,1956
050,51,087,"Virginia","Henrico County",5,8,3972,2036,1936
050,51,087,"Virginia","Henrico County",5,9,3959,2090,1869
050,51,087,"Virginia","Henrico County",5,10,3969,2063,1906
050,51,087,"Virginia","Henrico County",5,11,4071,2110,1961
050,51,087,"Virginia","Henrico County",5,12,4037,2085,1952
050,51,087,"Virginia","Henrico County",5,13,4127,2101,2026
050,51,087,"Virginia","Henrico County",5,14,4185,2137,2048
050,51,087,"Virginia","Henrico County",5,15,4353,2198,2155
050,51,087,"Virginia","Henrico County",5,16,4447,2253,2194
050,51,087,"Virginia","Henrico County",5,17,4436,2284,2152
050,51,087,"Virginia","Henrico County",5,18,3922,2035,1887
050,51,087,"Virginia","Henrico County",5,19,3404,1760,1644
050,51,087,"Virginia","Henrico County",5,20,3577,1838,1739
050,51,087,"Virginia","Henrico County",5,21,3655,1838,1817
050,51,087,"Virginia","Henrico County",5,22,3806,1903,1903
050,51,087,"Virginia","Henrico County",5,23,3882,1887,1995
050,51,087,"Virginia","Henrico County",5,24,3882,1874,2008
050,51,087,"Virginia","Henrico County",5,25,3993,1935,2058
050,51,087,"Virginia","Henrico County",5,26,4089,2006,2083
050,51,087,"Virginia","Henrico County",5,27,4210,2042,2168
050,51,087,"Virginia","Henrico County",5,28,4469,2151,2318
050,51,087,"Virginia","Henrico County",5,29,4712,2215,2497
050,51,087,"Virginia","Henrico County",5,30,4868,2339,2529
050,51,087,"Virginia","Henrico County",5,31,4924,2462,2462
050,51,087,"Virginia","Henrico County",5,32,5016,2371,2645
050,51,087,"Virginia","Henrico County",5,33,5105,2493,2612
050,51,087,"Virginia","Henrico County",5,34,4989,2408,2581
050,51,087,"Virginia","Henrico County",5,35,4907,2315,2592
050,51,087,"Virginia","Henrico County",5,36,4897,2317,2580
050,51,087,"Virginia","Henrico County",5,37,4871,2343,2528
050,51,087,"Virginia","Henrico County",5,38,4783,2289,2494
050,51,087,"Virginia","Henrico County",5,39,4811,2308,2503
050,51,087,"Virginia","Henrico County",5,40,4789,2347,2442
050,51,087,"Virginia","Henrico County",5,41,4706,2291,2415
050,51,087,"Virginia","Henrico County",5,42,4766,2301,2465
050,51,087,"Virginia","Henrico County",5,43,4750,2318,2432
050,51,087,"Virginia","Henrico County",5,44,4524,2210,2314
050,51,087,"Virginia","Henrico County",5,45,4244,2005,2239
050,51,087,"Virginia","Henrico County",5,46,4116,1930,2186
050,51,087,"Virginia","Henrico County",5,47,3871,1860,2011
050,51,087,"Virginia","Henrico County",5,48,3988,1890,2098
050,51,087,"Virginia","Henrico County",5,49,3939,1872,2067
050,51,087,"Virginia","Henrico County",5,50,4053,1894,2159
050,51,087,"Virginia","Henrico County",5,51,4278,2026,2252
050,51,087,"Virginia","Henrico County",5,52,4589,2212,2377
050,51,087,"Virginia","Henrico County",5,53,4443,2151,2292
050,51,087,"Virginia","Henrico County",5,54,4216,1996,2220
050,51,087,"Virginia","Henrico County",5,55,4169,1951,2218
050,51,087,"Virginia","Henrico County",5,56,4045,1949,2096
050,51,087,"Virginia","Henrico County",5,57,4124,1940,2184
050,51,087,"Virginia","Henrico County",5,58,4188,1947,2241
050,51,087,"Virginia","Henrico County",5,59,4288,1994,2294
050,51,087,"Virginia","Henrico County",5,60,4282,1995,2287
050,51,087,"Virginia","Henrico County",5,61,4324,2016,2308
050,51,087,"Virginia","Henrico County",5,62,4236,1980,2256
050,51,087,"Virginia","Henrico County",5,63,4092,1867,2225
050,51,087,"Virginia","Henrico County",5,64,4038,1832,2206
050,51,087,"Virginia","Henrico County",5,65,3964,1794,2170
050,51,087,"Virginia","Henrico County",5,66,3816,1678,2138
050,51,087,"Virginia","Henrico County",5,67,3696,1591,2105
050,51,087,"Virginia","Henrico County",5,68,3693,1613,2080
050,51,087,"Virginia","Henrico County",5,69,3573,1533,2040
050,51,087,"Virginia","Henrico County",5,70,3456,1523,1933
050,51,087,"Virginia","Henrico County",5,71,3230,1430,1800
050,51,087,"Virginia","Henrico County",5,72,2969,1292,1677
050,51,087,"Virginia","Henrico County",5,73,2890,1251,1639
050,51,087,"Virginia","Henrico County",5,74,2835,1210,1625
050,51,087,"Virginia","Henrico County",5,75,2782,1181,1601
050,51,087,"Virginia","Henrico County",5,76,2820,1210,1610
050,51,087,"Virginia","Henrico County",5,77,1997,852,1145
050,51,087,"Virginia","Henrico County",5,78,1881,797,1084
050,51,087,"Virginia","Henrico County",5,79,1822,744,1078
050,51,087,"Virginia","Henrico County",5,80,1798,712,1086
050,51,087,"Virginia","Henrico County",5,81,1548,608,940
050,51,087,"Virginia","Henrico County",5,82,1303,481,822
050,51,087,"Virginia","Henrico County",5,83,1129,409,720
050,51,087,"Virginia","Henrico County",5,84,1043,395,648
050,51,087,"Virginia","Henrico County",5,85,6444,2099,4345
050,51,089,"Virginia","Henry County",1,0,436,221,215
050,51,089,"Virginia","Henry County",1,1,459,233,226
050,51,089,"Virginia","Henry County",1,2,493,234,259
050,51,089,"Virginia","Henry County",1,3,497,235,262
050,51,089,"Virginia","Henry County",1,4,511,240,271
050,51,089,"Virginia","Henry County",1,5,504,234,270
050,51,089,"Virginia","Henry County",1,6,515,264,251
050,51,089,"Virginia","Henry County",1,7,564,290,274
050,51,089,"Virginia","Henry County",1,8,562,284,278
050,51,089,"Virginia","Henry County",1,9,555,301,254
050,51,089,"Virginia","Henry County",1,10,600,321,279
050,51,089,"Virginia","Henry County",1,11,627,336,291
050,51,089,"Virginia","Henry County",1,12,648,351,297
050,51,089,"Virginia","Henry County",1,13,648,339,309
050,51,089,"Virginia","Henry County",1,14,594,293,301
050,51,089,"Virginia","Henry County",1,15,602,294,308
050,51,089,"Virginia","Henry County",1,16,610,326,284
050,51,089,"Virginia","Henry County",1,17,620,319,301
050,51,089,"Virginia","Henry County",1,18,553,296,257
050,51,089,"Virginia","Henry County",1,19,470,244,226
050,51,089,"Virginia","Henry County",1,20,493,249,244
050,51,089,"Virginia","Henry County",1,21,476,239,237
050,51,089,"Virginia","Henry County",1,22,512,261,251
050,51,089,"Virginia","Henry County",1,23,498,263,235
050,51,089,"Virginia","Henry County",1,24,505,269,236
050,51,089,"Virginia","Henry County",1,25,528,264,264
050,51,089,"Virginia","Henry County",1,26,516,255,261
050,51,089,"Virginia","Henry County",1,27,500,260,240
050,51,089,"Virginia","Henry County",1,28,495,259,236
050,51,089,"Virginia","Henry County",1,29,535,278,257
050,51,089,"Virginia","Henry County",1,30,545,261,284
050,51,089,"Virginia","Henry County",1,31,549,262,287
050,51,089,"Virginia","Henry County",1,32,544,247,297
050,51,089,"Virginia","Henry County",1,33,559,263,296
050,51,089,"Virginia","Henry County",1,34,538,267,271
050,51,089,"Virginia","Henry County",1,35,491,227,264
050,51,089,"Virginia","Henry County",1,36,500,231,269
050,51,089,"Virginia","Henry County",1,37,533,249,284
050,51,089,"Virginia","Henry County",1,38,532,254,278
050,51,089,"Virginia","Henry County",1,39,526,250,276
050,51,089,"Virginia","Henry County",1,40,507,251,256
050,51,089,"Virginia","Henry County",1,41,496,240,256
050,51,089,"Virginia","Henry County",1,42,515,255,260
050,51,089,"Virginia","Henry County",1,43,517,275,242
050,51,089,"Virginia","Henry County",1,44,539,267,272
050,51,089,"Virginia","Henry County",1,45,571,294,277
050,51,089,"Virginia","Henry County",1,46,586,297,289
050,51,089,"Virginia","Henry County",1,47,591,287,304
050,51,089,"Virginia","Henry County",1,48,647,326,321
050,51,089,"Virginia","Henry County",1,49,674,330,344
050,51,089,"Virginia","Henry County",1,50,671,318,353
050,51,089,"Virginia","Henry County",1,51,709,352,357
050,51,089,"Virginia","Henry County",1,52,717,353,364
050,51,089,"Virginia","Henry County",1,53,760,375,385
050,51,089,"Virginia","Henry County",1,54,748,365,383
050,51,089,"Virginia","Henry County",1,55,804,379,425
050,51,089,"Virginia","Henry County",1,56,834,418,416
050,51,089,"Virginia","Henry County",1,57,798,387,411
050,51,089,"Virginia","Henry County",1,58,800,382,418
050,51,089,"Virginia","Henry County",1,59,824,410,414
050,51,089,"Virginia","Henry County",1,60,785,408,377
050,51,089,"Virginia","Henry County",1,61,816,397,419
050,51,089,"Virginia","Henry County",1,62,836,383,453
050,51,089,"Virginia","Henry County",1,63,791,403,388
050,51,089,"Virginia","Henry County",1,64,743,381,362
050,51,089,"Virginia","Henry County",1,65,738,367,371
050,51,089,"Virginia","Henry County",1,66,714,360,354
050,51,089,"Virginia","Henry County",1,67,680,330,350
050,51,089,"Virginia","Henry County",1,68,666,315,351
050,51,089,"Virginia","Henry County",1,69,650,303,347
050,51,089,"Virginia","Henry County",1,70,687,322,365
050,51,089,"Virginia","Henry County",1,71,651,297,354
050,51,089,"Virginia","Henry County",1,72,679,319,360
050,51,089,"Virginia","Henry County",1,73,669,304,365
050,51,089,"Virginia","Henry County",1,74,502,216,286
050,51,089,"Virginia","Henry County",1,75,515,215,300
050,51,089,"Virginia","Henry County",1,76,549,235,314
050,51,089,"Virginia","Henry County",1,77,542,236,306
050,51,089,"Virginia","Henry County",1,78,447,204,243
050,51,089,"Virginia","Henry County",1,79,426,189,237
050,51,089,"Virginia","Henry County",1,80,408,178,230
050,51,089,"Virginia","Henry County",1,81,365,162,203
050,51,089,"Virginia","Henry County",1,82,329,140,189
050,51,089,"Virginia","Henry County",1,83,295,131,164
050,51,089,"Virginia","Henry County",1,84,263,108,155
050,51,089,"Virginia","Henry County",1,85,1452,521,931
050,51,089,"Virginia","Henry County",2,0,424,222,202
050,51,089,"Virginia","Henry County",2,1,456,232,224
050,51,089,"Virginia","Henry County",2,2,486,234,252
050,51,089,"Virginia","Henry County",2,3,497,235,262
050,51,089,"Virginia","Henry County",2,4,510,237,273
050,51,089,"Virginia","Henry County",2,5,505,236,269
050,51,089,"Virginia","Henry County",2,6,512,256,256
050,51,089,"Virginia","Henry County",2,7,556,285,271
050,51,089,"Virginia","Henry County",2,8,559,284,275
050,51,089,"Virginia","Henry County",2,9,555,295,260
050,51,089,"Virginia","Henry County",2,10,588,314,274
050,51,089,"Virginia","Henry County",2,11,613,328,285
050,51,089,"Virginia","Henry County",2,12,644,348,296
050,51,089,"Virginia","Henry County",2,13,644,339,305
050,51,089,"Virginia","Henry County",2,14,607,303,304
050,51,089,"Virginia","Henry County",2,15,602,296,306
050,51,089,"Virginia","Henry County",2,16,611,321,290
050,51,089,"Virginia","Henry County",2,17,620,322,298
050,51,089,"Virginia","Henry County",2,18,550,294,256
050,51,089,"Virginia","Henry County",2,19,470,245,225
050,51,089,"Virginia","Henry County",2,20,498,253,245
050,51,089,"Virginia","Henry County",2,21,481,242,239
050,51,089,"Virginia","Henry County",2,22,511,260,251
050,51,089,"Virginia","Henry County",2,23,505,264,241
050,51,089,"Virginia","Henry County",2,24,505,270,235
050,51,089,"Virginia","Henry County",2,25,522,266,256
050,51,089,"Virginia","Henry County",2,26,520,258,262
050,51,089,"Virginia","Henry County",2,27,498,257,241
050,51,089,"Virginia","Henry County",2,28,496,261,235
050,51,089,"Virginia","Henry County",2,29,525,273,252
050,51,089,"Virginia","Henry County",2,30,544,266,278
050,51,089,"Virginia","Henry County",2,31,545,260,285
050,51,089,"Virginia","Henry County",2,32,543,249,294
050,51,089,"Virginia","Henry County",2,33,555,259,296
050,51,089,"Virginia","Henry County",2,34,541,265,276
050,51,089,"Virginia","Henry County",2,35,505,238,267
050,51,089,"Virginia","Henry County",2,36,499,231,268
050,51,089,"Virginia","Henry County",2,37,528,246,282
050,51,089,"Virginia","Henry County",2,38,535,253,282
050,51,089,"Virginia","Henry County",2,39,525,250,275
050,51,089,"Virginia","Henry County",2,40,519,255,264
050,51,089,"Virginia","Henry County",2,41,495,241,254
050,51,089,"Virginia","Henry County",2,42,503,249,254
050,51,089,"Virginia","Henry County",2,43,522,275,247
050,51,089,"Virginia","Henry County",2,44,530,267,263
050,51,089,"Virginia","Henry County",2,45,569,291,278
050,51,089,"Virginia","Henry County",2,46,580,294,286
050,51,089,"Virginia","Henry County",2,47,586,286,300
050,51,089,"Virginia","Henry County",2,48,634,316,318
050,51,089,"Virginia","Henry County",2,49,669,330,339
050,51,089,"Virginia","Henry County",2,50,674,322,352
050,51,089,"Virginia","Henry County",2,51,697,344,353
050,51,089,"Virginia","Henry County",2,52,711,353,358
050,51,089,"Virginia","Henry County",2,53,746,369,377
050,51,089,"Virginia","Henry County",2,54,745,364,381
050,51,089,"Virginia","Henry County",2,55,789,375,414
050,51,089,"Virginia","Henry County",2,56,830,410,420
050,51,089,"Virginia","Henry County",2,57,805,394,411
050,51,089,"Virginia","Henry County",2,58,800,384,416
050,51,089,"Virginia","Henry County",2,59,821,407,414
050,51,089,"Virginia","Henry County",2,60,791,405,386
050,51,089,"Virginia","Henry County",2,61,805,397,408
050,51,089,"Virginia","Henry County",2,62,828,385,443
050,51,089,"Virginia","Henry County",2,63,806,401,405
050,51,089,"Virginia","Henry County",2,64,747,381,366
050,51,089,"Virginia","Henry County",2,65,734,369,365
050,51,089,"Virginia","Henry County",2,66,717,356,361
050,51,089,"Virginia","Henry County",2,67,683,337,346
050,51,089,"Virginia","Henry County",2,68,661,315,346
050,51,089,"Virginia","Henry County",2,69,658,307,351
050,51,089,"Virginia","Henry County",2,70,675,317,358
050,51,089,"Virginia","Henry County",2,71,655,302,353
050,51,089,"Virginia","Henry County",2,72,661,306,355
050,51,089,"Virginia","Henry County",2,73,701,322,379
050,51,089,"Virginia","Henry County",2,74,506,221,285
050,51,089,"Virginia","Henry County",2,75,510,214,296
050,51,089,"Virginia","Henry County",2,76,533,227,306
050,51,089,"Virginia","Henry County",2,77,546,235,311
050,51,089,"Virginia","Henry County",2,78,459,208,251
050,51,089,"Virginia","Henry County",2,79,428,189,239
050,51,089,"Virginia","Henry County",2,80,406,181,225
050,51,089,"Virginia","Henry County",2,81,371,163,208
050,51,089,"Virginia","Henry County",2,82,333,142,191
050,51,089,"Virginia","Henry County",2,83,300,133,167
050,51,089,"Virginia","Henry County",2,84,264,109,155
050,51,089,"Virginia","Henry County",2,85,1458,529,929
050,51,089,"Virginia","Henry County",3,0,355,190,165
050,51,089,"Virginia","Henry County",3,1,429,212,217
050,51,089,"Virginia","Henry County",3,2,458,234,224
050,51,089,"Virginia","Henry County",3,3,481,231,250
050,51,089,"Virginia","Henry County",3,4,488,235,253
050,51,089,"Virginia","Henry County",3,5,483,229,254
050,51,089,"Virginia","Henry County",3,6,484,220,264
050,51,089,"Virginia","Henry County",3,7,524,269,255
050,51,089,"Virginia","Henry County",3,8,552,281,271
050,51,089,"Virginia","Henry County",3,9,554,277,277
050,51,089,"Virginia","Henry County",3,10,552,295,257
050,51,089,"Virginia","Henry County",3,11,582,314,268
050,51,089,"Virginia","Henry County",3,12,623,330,293
050,51,089,"Virginia","Henry County",3,13,647,353,294
050,51,089,"Virginia","Henry County",3,14,643,344,299
050,51,089,"Virginia","Henry County",3,15,607,300,307
050,51,089,"Virginia","Henry County",3,16,614,302,312
050,51,089,"Virginia","Henry County",3,17,617,320,297
050,51,089,"Virginia","Henry County",3,18,543,287,256
050,51,089,"Virginia","Henry County",3,19,453,246,207
050,51,089,"Virginia","Henry County",3,20,504,259,245
050,51,089,"Virginia","Henry County",3,21,519,260,259
050,51,089,"Virginia","Henry County",3,22,479,251,228
050,51,089,"Virginia","Henry County",3,23,523,261,262
050,51,089,"Virginia","Henry County",3,24,504,266,238
050,51,089,"Virginia","Henry County",3,25,498,262,236
050,51,089,"Virginia","Henry County",3,26,526,267,259
050,51,089,"Virginia","Henry County",3,27,527,252,275
050,51,089,"Virginia","Henry County",3,28,473,251,222
050,51,089,"Virginia","Henry County",3,29,487,254,233
050,51,089,"Virginia","Henry County",3,30,530,269,261
050,51,089,"Virginia","Henry County",3,31,557,273,284
050,51,089,"Virginia","Henry County",3,32,529,246,283
050,51,089,"Virginia","Henry County",3,33,545,245,300
050,51,089,"Virginia","Henry County",3,34,565,269,296
050,51,089,"Virginia","Henry County",3,35,520,253,267
050,51,089,"Virginia","Henry County",3,36,520,245,275
050,51,089,"Virginia","Henry County",3,37,497,242,255
050,51,089,"Virginia","Henry County",3,38,525,243,282
050,51,089,"Virginia","Henry County",3,39,522,239,283
050,51,089,"Virginia","Henry County",3,40,527,248,279
050,51,089,"Virginia","Henry County",3,41,518,258,260
050,51,089,"Virginia","Henry County",3,42,502,243,259
050,51,089,"Virginia","Henry County",3,43,523,254,269
050,51,089,"Virginia","Henry County",3,44,530,280,250
050,51,089,"Virginia","Henry County",3,45,517,259,258
050,51,089,"Virginia","Henry County",3,46,562,291,271
050,51,089,"Virginia","Henry County",3,47,579,295,284
050,51,089,"Virginia","Henry County",3,48,576,286,290
050,51,089,"Virginia","Henry County",3,49,630,311,319
050,51,089,"Virginia","Henry County",3,50,678,328,350
050,51,089,"Virginia","Henry County",3,51,664,312,352
050,51,089,"Virginia","Henry County",3,52,707,347,360
050,51,089,"Virginia","Henry County",3,53,703,350,353
050,51,089,"Virginia","Henry County",3,54,731,355,376
050,51,089,"Virginia","Henry County",3,55,737,359,378
050,51,089,"Virginia","Henry County",3,56,800,374,426
050,51,089,"Virginia","Henry County",3,57,826,406,420
050,51,089,"Virginia","Henry County",3,58,805,392,413
050,51,089,"Virginia","Henry County",3,59,819,404,415
050,51,089,"Virginia","Henry County",3,60,805,391,414
050,51,089,"Virginia","Henry County",3,61,775,384,391
050,51,089,"Virginia","Henry County",3,62,804,402,402
050,51,089,"Virginia","Henry County",3,63,829,390,439
050,51,089,"Virginia","Henry County",3,64,784,385,399
050,51,089,"Virginia","Henry County",3,65,738,380,358
050,51,089,"Virginia","Henry County",3,66,723,358,365
050,51,089,"Virginia","Henry County",3,67,709,352,357
050,51,089,"Virginia","Henry County",3,68,665,323,342
050,51,089,"Virginia","Henry County",3,69,637,301,336
050,51,089,"Virginia","Henry County",3,70,646,300,346
050,51,089,"Virginia","Henry County",3,71,653,311,342
050,51,089,"Virginia","Henry County",3,72,631,283,348
050,51,089,"Virginia","Henry County",3,73,634,294,340
050,51,089,"Virginia","Henry County",3,74,678,313,365
050,51,089,"Virginia","Henry County",3,75,494,209,285
050,51,089,"Virginia","Henry County",3,76,501,207,294
050,51,089,"Virginia","Henry County",3,77,504,213,291
050,51,089,"Virginia","Henry County",3,78,525,225,300
050,51,089,"Virginia","Henry County",3,79,431,184,247
050,51,089,"Virginia","Henry County",3,80,388,169,219
050,51,089,"Virginia","Henry County",3,81,373,161,212
050,51,089,"Virginia","Henry County",3,82,348,153,195
050,51,089,"Virginia","Henry County",3,83,308,125,183
050,51,089,"Virginia","Henry County",3,84,257,111,146
050,51,089,"Virginia","Henry County",3,85,1449,527,922
050,51,089,"Virginia","Henry County",4,0,373,190,183
050,51,089,"Virginia","Henry County",4,1,359,193,166
050,51,089,"Virginia","Henry County",4,2,433,222,211
050,51,089,"Virginia","Henry County",4,3,455,228,227
050,51,089,"Virginia","Henry County",4,4,497,234,263
050,51,089,"Virginia","Henry County",4,5,498,240,258
050,51,089,"Virginia","Henry County",4,6,492,232,260
050,51,089,"Virginia","Henry County",4,7,484,225,259
050,51,089,"Virginia","Henry County",4,8,521,268,253
050,51,089,"Virginia","Henry County",4,9,550,287,263
050,51,089,"Virginia","Henry County",4,10,567,279,288
050,51,089,"Virginia","Henry County",4,11,563,300,263
050,51,089,"Virginia","Henry County",4,12,582,316,266
050,51,089,"Virginia","Henry County",4,13,630,328,302
050,51,089,"Virginia","Henry County",4,14,645,337,308
050,51,089,"Virginia","Henry County",4,15,652,341,311
050,51,089,"Virginia","Henry County",4,16,612,305,307
050,51,089,"Virginia","Henry County",4,17,609,297,312
050,51,089,"Virginia","Henry County",4,18,526,285,241
050,51,089,"Virginia","Henry County",4,19,435,236,199
050,51,089,"Virginia","Henry County",4,20,475,259,216
050,51,089,"Virginia","Henry County",4,21,515,261,254
050,51,089,"Virginia","Henry County",4,22,546,270,276
050,51,089,"Virginia","Henry County",4,23,513,277,236
050,51,089,"Virginia","Henry County",4,24,515,265,250
050,51,089,"Virginia","Henry County",4,25,490,249,241
050,51,089,"Virginia","Henry County",4,26,488,257,231
050,51,089,"Virginia","Henry County",4,27,516,256,260
050,51,089,"Virginia","Henry County",4,28,529,259,270
050,51,089,"Virginia","Henry County",4,29,463,240,223
050,51,089,"Virginia","Henry County",4,30,494,257,237
050,51,089,"Virginia","Henry County",4,31,531,270,261
050,51,089,"Virginia","Henry County",4,32,567,274,293
050,51,089,"Virginia","Henry County",4,33,529,254,275
050,51,089,"Virginia","Henry County",4,34,543,247,296
050,51,089,"Virginia","Henry County",4,35,559,261,298
050,51,089,"Virginia","Henry County",4,36,523,254,269
050,51,089,"Virginia","Henry County",4,37,527,256,271
050,51,089,"Virginia","Henry County",4,38,505,247,258
050,51,089,"Virginia","Henry County",4,39,530,241,289
050,51,089,"Virginia","Henry County",4,40,520,240,280
050,51,089,"Virginia","Henry County",4,41,516,243,273
050,51,089,"Virginia","Henry County",4,42,517,252,265
050,51,089,"Virginia","Henry County",4,43,513,253,260
050,51,089,"Virginia","Henry County",4,44,512,248,264
050,51,089,"Virginia","Henry County",4,45,532,278,254
050,51,089,"Virginia","Henry County",4,46,509,249,260
050,51,089,"Virginia","Henry County",4,47,556,287,269
050,51,089,"Virginia","Henry County",4,48,567,290,277
050,51,089,"Virginia","Henry County",4,49,573,281,292
050,51,089,"Virginia","Henry County",4,50,631,302,329
050,51,089,"Virginia","Henry County",4,51,658,316,342
050,51,089,"Virginia","Henry County",4,52,665,320,345
050,51,089,"Virginia","Henry County",4,53,702,348,354
050,51,089,"Virginia","Henry County",4,54,705,346,359
050,51,089,"Virginia","Henry County",4,55,733,343,390
050,51,089,"Virginia","Henry County",4,56,736,366,370
050,51,089,"Virginia","Henry County",4,57,795,359,436
050,51,089,"Virginia","Henry County",4,58,825,406,419
050,51,089,"Virginia","Henry County",4,59,827,412,415
050,51,089,"Virginia","Henry County",4,60,805,395,410
050,51,089,"Virginia","Henry County",4,61,804,388,416
050,51,089,"Virginia","Henry County",4,62,792,390,402
050,51,089,"Virginia","Henry County",4,63,804,405,399
050,51,089,"Virginia","Henry County",4,64,818,383,435
050,51,089,"Virginia","Henry County",4,65,768,377,391
050,51,089,"Virginia","Henry County",4,66,730,372,358
050,51,089,"Virginia","Henry County",4,67,714,358,356
050,51,089,"Virginia","Henry County",4,68,698,340,358
050,51,089,"Virginia","Henry County",4,69,657,313,344
050,51,089,"Virginia","Henry County",4,70,623,295,328
050,51,089,"Virginia","Henry County",4,71,622,289,333
050,51,089,"Virginia","Henry County",4,72,629,296,333
050,51,089,"Virginia","Henry County",4,73,591,266,325
050,51,089,"Virginia","Henry County",4,74,601,280,321
050,51,089,"Virginia","Henry County",4,75,654,299,355
050,51,089,"Virginia","Henry County",4,76,482,204,278
050,51,089,"Virginia","Henry County",4,77,467,191,276
050,51,089,"Virginia","Henry County",4,78,476,202,274
050,51,089,"Virginia","Henry County",4,79,499,204,295
050,51,089,"Virginia","Henry County",4,80,398,165,233
050,51,089,"Virginia","Henry County",4,81,369,160,209
050,51,089,"Virginia","Henry County",4,82,343,143,200
050,51,089,"Virginia","Henry County",4,83,320,137,183
050,51,089,"Virginia","Henry County",4,84,264,104,160
050,51,089,"Virginia","Henry County",4,85,1434,532,902
050,51,089,"Virginia","Henry County",5,0,387,202,185
050,51,089,"Virginia","Henry County",5,1,383,184,199
050,51,089,"Virginia","Henry County",5,2,375,192,183
050,51,089,"Virginia","Henry County",5,3,451,233,218
050,51,089,"Virginia","Henry County",5,4,475,239,236
050,51,089,"Virginia","Henry County",5,5,500,240,260
050,51,089,"Virginia","Henry County",5,6,516,252,264
050,51,089,"Virginia","Henry County",5,7,512,249,263
050,51,089,"Virginia","Henry County",5,8,499,233,266
050,51,089,"Virginia","Henry County",5,9,545,272,273
050,51,089,"Virginia","Henry County",5,10,557,289,268
050,51,089,"Virginia","Henry County",5,11,586,297,289
050,51,089,"Virginia","Henry County",5,12,575,303,272
050,51,089,"Virginia","Henry County",5,13,602,326,276
050,51,089,"Virginia","Henry County",5,14,610,326,284
050,51,089,"Virginia","Henry County",5,15,663,344,319
050,51,089,"Virginia","Henry County",5,16,651,340,311
050,51,089,"Virginia","Henry County",5,17,623,316,307
050,51,089,"Virginia","Henry County",5,18,531,267,264
050,51,089,"Virginia","Henry County",5,19,446,239,207
050,51,089,"Virginia","Henry County",5,20,468,247,221
050,51,089,"Virginia","Henry County",5,21,509,275,234
050,51,089,"Virginia","Henry County",5,22,554,281,273
050,51,089,"Virginia","Henry County",5,23,541,266,275
050,51,089,"Virginia","Henry County",5,24,504,277,227
050,51,089,"Virginia","Henry County",5,25,489,251,238
050,51,089,"Virginia","Henry County",5,26,501,258,243
050,51,089,"Virginia","Henry County",5,27,479,256,223
050,51,089,"Virginia","Henry County",5,28,534,267,267
050,51,089,"Virginia","Henry County",5,29,531,257,274
050,51,089,"Virginia","Henry County",5,30,491,249,242
050,51,089,"Virginia","Henry County",5,31,501,255,246
050,51,089,"Virginia","Henry County",5,32,535,273,262
050,51,089,"Virginia","Henry County",5,33,572,276,296
050,51,089,"Virginia","Henry County",5,34,539,250,289
050,51,089,"Virginia","Henry County",5,35,534,247,287
050,51,089,"Virginia","Henry County",5,36,570,268,302
050,51,089,"Virginia","Henry County",5,37,542,262,280
050,51,089,"Virginia","Henry County",5,38,524,258,266
050,51,089,"Virginia","Henry County",5,39,510,253,257
050,51,089,"Virginia","Henry County",5,40,540,244,296
050,51,089,"Virginia","Henry County",5,41,522,235,287
050,51,089,"Virginia","Henry County",5,42,517,242,275
050,51,089,"Virginia","Henry County",5,43,519,254,265
050,51,089,"Virginia","Henry County",5,44,509,256,253
050,51,089,"Virginia","Henry County",5,45,511,249,262
050,51,089,"Virginia","Henry County",5,46,531,277,254
050,51,089,"Virginia","Henry County",5,47,517,248,269
050,51,089,"Virginia","Henry County",5,48,552,285,267
050,51,089,"Virginia","Henry County",5,49,568,290,278
050,51,089,"Virginia","Henry County",5,50,580,282,298
050,51,089,"Virginia","Henry County",5,51,625,292,333
050,51,089,"Virginia","Henry County",5,52,657,315,342
050,51,089,"Virginia","Henry County",5,53,653,313,340
050,51,089,"Virginia","Henry County",5,54,703,350,353
050,51,089,"Virginia","Henry County",5,55,716,347,369
050,51,089,"Virginia","Henry County",5,56,746,346,400
050,51,089,"Virginia","Henry County",5,57,728,358,370
050,51,089,"Virginia","Henry County",5,58,797,360,437
050,51,089,"Virginia","Henry County",5,59,824,413,411
050,51,089,"Virginia","Henry County",5,60,808,399,409
050,51,089,"Virginia","Henry County",5,61,790,386,404
050,51,089,"Virginia","Henry County",5,62,792,380,412
050,51,089,"Virginia","Henry County",5,63,777,387,390
050,51,089,"Virginia","Henry County",5,64,796,400,396
050,51,089,"Virginia","Henry County",5,65,800,370,430
050,51,089,"Virginia","Henry County",5,66,759,368,391
050,51,089,"Virginia","Henry County",5,67,725,370,355
050,51,089,"Virginia","Henry County",5,68,708,349,359
050,51,089,"Virginia","Henry County",5,69,688,334,354
050,51,089,"Virginia","Henry County",5,70,640,305,335
050,51,089,"Virginia","Henry County",5,71,604,287,317
050,51,089,"Virginia","Henry County",5,72,604,276,328
050,51,089,"Virginia","Henry County",5,73,603,283,320
050,51,089,"Virginia","Henry County",5,74,571,255,316
050,51,089,"Virginia","Henry County",5,75,585,264,321
050,51,089,"Virginia","Henry County",5,76,633,289,344
050,51,089,"Virginia","Henry County",5,77,458,188,270
050,51,089,"Virginia","Henry County",5,78,437,182,255
050,51,089,"Virginia","Henry County",5,79,465,192,273
050,51,089,"Virginia","Henry County",5,80,462,183,279
050,51,089,"Virginia","Henry County",5,81,380,161,219
050,51,089,"Virginia","Henry County",5,82,337,144,193
050,51,089,"Virginia","Henry County",5,83,313,129,184
050,51,089,"Virginia","Henry County",5,84,282,117,165
050,51,089,"Virginia","Henry County",5,85,1455,535,920
050,51,091,"Virginia","Highland County",1,0,15,7,8
050,51,091,"Virginia","Highland County",1,1,19,9,10
050,51,091,"Virginia","Highland County",1,2,14,6,8
050,51,091,"Virginia","Highland County",1,3,19,8,11
050,51,091,"Virginia","Highland County",1,4,23,10,13
050,51,091,"Virginia","Highland County",1,5,20,9,11
050,51,091,"Virginia","Highland County",1,6,21,10,11
050,51,091,"Virginia","Highland County",1,7,11,6,5
050,51,091,"Virginia","Highland County",1,8,20,10,10
050,51,091,"Virginia","Highland County",1,9,18,7,11
050,51,091,"Virginia","Highland County",1,10,9,5,4
050,51,091,"Virginia","Highland County",1,11,16,9,7
050,51,091,"Virginia","Highland County",1,12,15,10,5
050,51,091,"Virginia","Highland County",1,13,10,5,5
050,51,091,"Virginia","Highland County",1,14,13,3,10
050,51,091,"Virginia","Highland County",1,15,11,5,6
050,51,091,"Virginia","Highland County",1,16,14,4,10
050,51,091,"Virginia","Highland County",1,17,24,12,12
050,51,091,"Virginia","Highland County",1,18,19,11,8
050,51,091,"Virginia","Highland County",1,19,10,6,4
050,51,091,"Virginia","Highland County",1,20,13,8,5
050,51,091,"Virginia","Highland County",1,21,14,6,8
050,51,091,"Virginia","Highland County",1,22,10,6,4
050,51,091,"Virginia","Highland County",1,23,20,9,11
050,51,091,"Virginia","Highland County",1,24,14,6,8
050,51,091,"Virginia","Highland County",1,25,14,6,8
050,51,091,"Virginia","Highland County",1,26,17,4,13
050,51,091,"Virginia","Highland County",1,27,15,7,8
050,51,091,"Virginia","Highland County",1,28,25,13,12
050,51,091,"Virginia","Highland County",1,29,21,11,10
050,51,091,"Virginia","Highland County",1,30,28,15,13
050,51,091,"Virginia","Highland County",1,31,25,12,13
050,51,091,"Virginia","Highland County",1,32,15,6,9
050,51,091,"Virginia","Highland County",1,33,22,10,12
050,51,091,"Virginia","Highland County",1,34,17,8,9
050,51,091,"Virginia","Highland County",1,35,15,8,7
050,51,091,"Virginia","Highland County",1,36,12,6,6
050,51,091,"Virginia","Highland County",1,37,11,4,7
050,51,091,"Virginia","Highland County",1,38,9,5,4
050,51,091,"Virginia","Highland County",1,39,13,7,6
050,51,091,"Virginia","Highland County",1,40,21,13,8
050,51,091,"Virginia","Highland County",1,41,20,12,8
050,51,091,"Virginia","Highland County",1,42,29,17,12
050,51,091,"Virginia","Highland County",1,43,19,8,11
050,51,091,"Virginia","Highland County",1,44,10,5,5
050,51,091,"Virginia","Highland County",1,45,23,11,12
050,51,091,"Virginia","Highland County",1,46,22,12,10
050,51,091,"Virginia","Highland County",1,47,15,9,6
050,51,091,"Virginia","Highland County",1,48,19,11,8
050,51,091,"Virginia","Highland County",1,49,23,11,12
050,51,091,"Virginia","Highland County",1,50,22,14,8
050,51,091,"Virginia","Highland County",1,51,31,18,13
050,51,091,"Virginia","Highland County",1,52,24,13,11
050,51,091,"Virginia","Highland County",1,53,20,12,8
050,51,091,"Virginia","Highland County",1,54,21,15,6
050,51,091,"Virginia","Highland County",1,55,21,13,8
050,51,091,"Virginia","Highland County",1,56,35,18,17
050,51,091,"Virginia","Highland County",1,57,41,18,23
050,51,091,"Virginia","Highland County",1,58,55,26,29
050,51,091,"Virginia","Highland County",1,59,49,24,25
050,51,091,"Virginia","Highland County",1,60,47,23,24
050,51,091,"Virginia","Highland County",1,61,58,31,27
050,51,091,"Virginia","Highland County",1,62,62,28,34
050,51,091,"Virginia","Highland County",1,63,49,21,28
050,51,091,"Virginia","Highland County",1,64,51,26,25
050,51,091,"Virginia","Highland County",1,65,57,33,24
050,51,091,"Virginia","Highland County",1,66,51,28,23
050,51,091,"Virginia","Highland County",1,67,56,32,24
050,51,091,"Virginia","Highland County",1,68,53,30,23
050,51,091,"Virginia","Highland County",1,69,36,19,17
050,51,091,"Virginia","Highland County",1,70,51,27,24
050,51,091,"Virginia","Highland County",1,71,49,24,25
050,51,091,"Virginia","Highland County",1,72,51,26,25
050,51,091,"Virginia","Highland County",1,73,50,28,22
050,51,091,"Virginia","Highland County",1,74,35,16,19
050,51,091,"Virginia","Highland County",1,75,38,16,22
050,51,091,"Virginia","Highland County",1,76,32,14,18
050,51,091,"Virginia","Highland County",1,77,29,12,17
050,51,091,"Virginia","Highland County",1,78,28,12,16
050,51,091,"Virginia","Highland County",1,79,22,11,11
050,51,091,"Virginia","Highland County",1,80,19,10,9
050,51,091,"Virginia","Highland County",1,81,23,11,12
050,51,091,"Virginia","Highland County",1,82,22,9,13
050,51,091,"Virginia","Highland County",1,83,16,6,10
050,51,091,"Virginia","Highland County",1,84,13,5,8
050,51,091,"Virginia","Highland County",1,85,63,28,35
050,51,091,"Virginia","Highland County",2,0,18,10,8
050,51,091,"Virginia","Highland County",2,1,18,9,9
050,51,091,"Virginia","Highland County",2,2,15,7,8
050,51,091,"Virginia","Highland County",2,3,18,8,10
050,51,091,"Virginia","Highland County",2,4,22,9,13
050,51,091,"Virginia","Highland County",2,5,21,9,12
050,51,091,"Virginia","Highland County",2,6,21,10,11
050,51,091,"Virginia","Highland County",2,7,14,7,7
050,51,091,"Virginia","Highland County",2,8,18,9,9
050,51,091,"Virginia","Highland County",2,9,19,8,11
050,51,091,"Virginia","Highland County",2,10,12,6,6
050,51,091,"Virginia","Highland County",2,11,14,8,6
050,51,091,"Virginia","Highland County",2,12,14,9,5
050,51,091,"Virginia","Highland County",2,13,11,6,5
050,51,091,"Virginia","Highland County",2,14,12,4,8
050,51,091,"Virginia","Highland County",2,15,11,4,7
050,51,091,"Virginia","Highland County",2,16,13,4,9
050,51,091,"Virginia","Highland County",2,17,22,11,11
050,51,091,"Virginia","Highland County",2,18,18,10,8
050,51,091,"Virginia","Highland County",2,19,12,7,5
050,51,091,"Virginia","Highland County",2,20,13,8,5
050,51,091,"Virginia","Highland County",2,21,13,6,7
050,51,091,"Virginia","Highland County",2,22,12,7,5
050,51,091,"Virginia","Highland County",2,23,17,8,9
050,51,091,"Virginia","Highland County",2,24,15,7,8
050,51,091,"Virginia","Highland County",2,25,16,7,9
050,51,091,"Virginia","Highland County",2,26,16,4,12
050,51,091,"Virginia","Highland County",2,27,17,7,10
050,51,091,"Virginia","Highland County",2,28,22,11,11
050,51,091,"Virginia","Highland County",2,29,22,12,10
050,51,091,"Virginia","Highland County",2,30,28,15,13
050,51,091,"Virginia","Highland County",2,31,25,12,13
050,51,091,"Virginia","Highland County",2,32,18,8,10
050,51,091,"Virginia","Highland County",2,33,20,9,11
050,51,091,"Virginia","Highland County",2,34,20,10,10
050,51,091,"Virginia","Highland County",2,35,15,8,7
050,51,091,"Virginia","Highland County",2,36,12,6,6
050,51,091,"Virginia","Highland County",2,37,11,4,7
050,51,091,"Virginia","Highland County",2,38,10,5,5
050,51,091,"Virginia","Highland County",2,39,13,7,6
050,51,091,"Virginia","Highland County",2,40,20,12,8
050,51,091,"Virginia","Highland County",2,41,20,12,8
050,51,091,"Virginia","Highland County",2,42,27,16,11
050,51,091,"Virginia","Highland County",2,43,21,10,11
050,51,091,"Virginia","Highland County",2,44,12,6,6
050,51,091,"Virginia","Highland County",2,45,21,10,11
050,51,091,"Virginia","Highland County",2,46,22,12,10
050,51,091,"Virginia","Highland County",2,47,16,10,6
050,51,091,"Virginia","Highland County",2,48,18,10,8
050,51,091,"Virginia","Highland County",2,49,22,11,11
050,51,091,"Virginia","Highland County",2,50,21,13,8
050,51,091,"Virginia","Highland County",2,51,30,17,13
050,51,091,"Virginia","Highland County",2,52,27,15,12
050,51,091,"Virginia","Highland County",2,53,21,12,9
050,51,091,"Virginia","Highland County",2,54,20,14,6
050,51,091,"Virginia","Highland County",2,55,21,13,8
050,51,091,"Virginia","Highland County",2,56,33,18,15
050,51,091,"Virginia","Highland County",2,57,40,18,22
050,51,091,"Virginia","Highland County",2,58,52,24,28
050,51,091,"Virginia","Highland County",2,59,51,25,26
050,51,091,"Virginia","Highland County",2,60,47,23,24
050,51,091,"Virginia","Highland County",2,61,56,29,27
050,51,091,"Virginia","Highland County",2,62,61,29,32
050,51,091,"Virginia","Highland County",2,63,53,23,30
050,51,091,"Virginia","Highland County",2,64,51,25,26
050,51,091,"Virginia","Highland County",2,65,54,31,23
050,51,091,"Virginia","Highland County",2,66,54,30,24
050,51,091,"Virginia","Highland County",2,67,55,31,24
050,51,091,"Virginia","Highland County",2,68,53,30,23
050,51,091,"Virginia","Highland County",2,69,41,22,19
050,51,091,"Virginia","Highland County",2,70,46,24,22
050,51,091,"Virginia","Highland County",2,71,50,25,25
050,51,091,"Virginia","Highland County",2,72,51,26,25
050,51,091,"Virginia","Highland County",2,73,52,28,24
050,51,091,"Virginia","Highland County",2,74,37,18,19
050,51,091,"Virginia","Highland County",2,75,37,16,21
050,51,091,"Virginia","Highland County",2,76,33,14,19
050,51,091,"Virginia","Highland County",2,77,31,13,18
050,51,091,"Virginia","Highland County",2,78,28,12,16
050,51,091,"Virginia","Highland County",2,79,23,11,12
050,51,091,"Virginia","Highland County",2,80,18,10,8
050,51,091,"Virginia","Highland County",2,81,22,10,12
050,51,091,"Virginia","Highland County",2,82,22,9,13
050,51,091,"Virginia","Highland County",2,83,16,6,10
050,51,091,"Virginia","Highland County",2,84,13,4,9
050,51,091,"Virginia","Highland County",2,85,63,28,35
050,51,091,"Virginia","Highland County",3,0,9,3,6
050,51,091,"Virginia","Highland County",3,1,16,8,8
050,51,091,"Virginia","Highland County",3,2,17,8,9
050,51,091,"Virginia","Highland County",3,3,17,8,9
050,51,091,"Virginia","Highland County",3,4,16,6,10
050,51,091,"Virginia","Highland County",3,5,22,9,13
050,51,091,"Virginia","Highland County",3,6,20,10,10
050,51,091,"Virginia","Highland County",3,7,21,10,11
050,51,091,"Virginia","Highland County",3,8,14,7,7
050,51,091,"Virginia","Highland County",3,9,19,9,10
050,51,091,"Virginia","Highland County",3,10,18,8,10
050,51,091,"Virginia","Highland County",3,11,12,6,6
050,51,091,"Virginia","Highland County",3,12,15,9,6
050,51,091,"Virginia","Highland County",3,13,14,9,5
050,51,091,"Virginia","Highland County",3,14,14,9,5
050,51,091,"Virginia","Highland County",3,15,11,4,7
050,51,091,"Virginia","Highland County",3,16,11,4,7
050,51,091,"Virginia","Highland County",3,17,13,4,9
050,51,091,"Virginia","Highland County",3,18,15,6,9
050,51,091,"Virginia","Highland County",3,19,16,9,7
050,51,091,"Virginia","Highland County",3,20,13,8,5
050,51,091,"Virginia","Highland County",3,21,15,9,6
050,51,091,"Virginia","Highland County",3,22,15,6,9
050,51,091,"Virginia","Highland County",3,23,13,8,5
050,51,091,"Virginia","Highland County",3,24,20,9,11
050,51,091,"Virginia","Highland County",3,25,18,7,11
050,51,091,"Virginia","Highland County",3,26,16,8,8
050,51,091,"Virginia","Highland County",3,27,17,3,14
050,51,091,"Virginia","Highland County",3,28,16,7,9
050,51,091,"Virginia","Highland County",3,29,21,11,10
050,51,091,"Virginia","Highland County",3,30,21,12,9
050,51,091,"Virginia","Highland County",3,31,29,14,15
050,51,091,"Virginia","Highland County",3,32,29,12,17
050,51,091,"Virginia","Highland County",3,33,20,9,11
050,51,091,"Virginia","Highland County",3,34,21,8,13
050,51,091,"Virginia","Highland County",3,35,22,11,11
050,51,091,"Virginia","Highland County",3,36,17,7,10
050,51,091,"Virginia","Highland County",3,37,14,7,7
050,51,091,"Virginia","Highland County",3,38,11,4,7
050,51,091,"Virginia","Highland County",3,39,10,6,4
050,51,091,"Virginia","Highland County",3,40,15,8,7
050,51,091,"Virginia","Highland County",3,41,20,12,8
050,51,091,"Virginia","Highland County",3,42,19,11,8
050,51,091,"Virginia","Highland County",3,43,27,15,12
050,51,091,"Virginia","Highland County",3,44,21,10,11
050,51,091,"Virginia","Highland County",3,45,12,6,6
050,51,091,"Virginia","Highland County",3,46,22,10,12
050,51,091,"Virginia","Highland County",3,47,23,12,11
050,51,091,"Virginia","Highland County",3,48,16,10,6
050,51,091,"Virginia","Highland County",3,49,18,10,8
050,51,091,"Virginia","Highland County",3,50,20,11,9
050,51,091,"Virginia","Highland County",3,51,21,11,10
050,51,091,"Virginia","Highland County",3,52,30,17,13
050,51,091,"Virginia","Highland County",3,53,22,12,10
050,51,091,"Virginia","Highland County",3,54,20,11,9
050,51,091,"Virginia","Highland County",3,55,22,16,6
050,51,091,"Virginia","Highland County",3,56,23,13,10
050,51,091,"Virginia","Highland County",3,57,33,18,15
050,51,091,"Virginia","Highland County",3,58,42,18,24
050,51,091,"Virginia","Highland County",3,59,50,23,27
050,51,091,"Virginia","Highland County",3,60,52,24,28
050,51,091,"Virginia","Highland County",3,61,48,22,26
050,51,091,"Virginia","Highland County",3,62,58,29,29
050,51,091,"Virginia","Highland County",3,63,63,29,34
050,51,091,"Virginia","Highland County",3,64,51,22,29
050,51,091,"Virginia","Highland County",3,65,55,28,27
050,51,091,"Virginia","Highland County",3,66,54,31,23
050,51,091,"Virginia","Highland County",3,67,54,30,24
050,51,091,"Virginia","Highland County",3,68,55,31,24
050,51,091,"Virginia","Highland County",3,69,53,30,23
050,51,091,"Virginia","Highland County",3,70,36,19,17
050,51,091,"Virginia","Highland County",3,71,44,24,20
050,51,091,"Virginia","Highland County",3,72,52,25,27
050,51,091,"Virginia","Highland County",3,73,46,23,23
050,51,091,"Virginia","Highland County",3,74,51,27,24
050,51,091,"Virginia","Highland County",3,75,35,15,20
050,51,091,"Virginia","Highland County",3,76,34,15,19
050,51,091,"Virginia","Highland County",3,77,33,14,19
050,51,091,"Virginia","Highland County",3,78,31,13,18
050,51,091,"Virginia","Highland County",3,79,28,12,16
050,51,091,"Virginia","Highland County",3,80,22,10,12
050,51,091,"Virginia","Highland County",3,81,16,8,8
050,51,091,"Virginia","Highland County",3,82,19,10,9
050,51,091,"Virginia","Highland County",3,83,22,9,13
050,51,091,"Virginia","Highland County",3,84,15,5,10
050,51,091,"Virginia","Highland County",3,85,68,27,41
050,51,091,"Virginia","Highland County",4,0,17,9,8
050,51,091,"Virginia","Highland County",4,1,12,2,10
050,51,091,"Virginia","Highland County",4,2,18,11,7
050,51,091,"Virginia","Highland County",4,3,22,12,10
050,51,091,"Virginia","Highland County",4,4,17,9,8
050,51,091,"Virginia","Highland County",4,5,20,8,12
050,51,091,"Virginia","Highland County",4,6,19,9,10
050,51,091,"Virginia","Highland County",4,7,20,10,10
050,51,091,"Virginia","Highland County",4,8,23,13,10
050,51,091,"Virginia","Highland County",4,9,14,7,7
050,51,091,"Virginia","Highland County",4,10,18,9,9
050,51,091,"Virginia","Highland County",4,11,17,7,10
050,51,091,"Virginia","Highland County",4,12,13,6,7
050,51,091,"Virginia","Highland County",4,13,14,9,5
050,51,091,"Virginia","Highland County",4,14,16,11,5
050,51,091,"Virginia","Highland County",4,15,15,10,5
050,51,091,"Virginia","Highland County",4,16,13,6,7
050,51,091,"Virginia","Highland County",4,17,11,3,8
050,51,091,"Virginia","Highland County",4,18,11,3,8
050,51,091,"Virginia","Highland County",4,19,15,7,8
050,51,091,"Virginia","Highland County",4,20,13,7,6
050,51,091,"Virginia","Highland County",4,21,15,9,6
050,51,091,"Virginia","Highland County",4,22,15,9,6
050,51,091,"Virginia","Highland County",4,23,13,3,10
050,51,091,"Virginia","Highland County",4,24,13,8,5
050,51,091,"Virginia","Highland County",4,25,15,8,7
050,51,091,"Virginia","Highland County",4,26,17,8,9
050,51,091,"Virginia","Highland County",4,27,18,9,9
050,51,091,"Virginia","Highland County",4,28,15,4,11
050,51,091,"Virginia","Highland County",4,29,18,8,10
050,51,091,"Virginia","Highland County",4,30,22,11,11
050,51,091,"Virginia","Highland County",4,31,21,11,10
050,51,091,"Virginia","Highland County",4,32,33,16,17
050,51,091,"Virginia","Highland County",4,33,28,13,15
050,51,091,"Virginia","Highland County",4,34,20,9,11
050,51,091,"Virginia","Highland County",4,35,22,9,13
050,51,091,"Virginia","Highland County",4,36,23,12,11
050,51,091,"Virginia","Highland County",4,37,19,7,12
050,51,091,"Virginia","Highland County",4,38,13,7,6
050,51,091,"Virginia","Highland County",4,39,12,5,7
050,51,091,"Virginia","Highland County",4,40,10,6,4
050,51,091,"Virginia","Highland County",4,41,16,8,8
050,51,091,"Virginia","Highland County",4,42,21,12,9
050,51,091,"Virginia","Highland County",4,43,19,10,9
050,51,091,"Virginia","Highland County",4,44,27,15,12
050,51,091,"Virginia","Highland County",4,45,23,11,12
050,51,091,"Virginia","Highland County",4,46,16,9,7
050,51,091,"Virginia","Highland County",4,47,20,9,11
050,51,091,"Virginia","Highland County",4,48,23,12,11
050,51,091,"Virginia","Highland County",4,49,16,10,6
050,51,091,"Virginia","Highland County",4,50,17,9,8
050,51,091,"Virginia","Highland County",4,51,18,10,8
050,51,091,"Virginia","Highland County",4,52,19,9,10
050,51,091,"Virginia","Highland County",4,53,32,18,14
050,51,091,"Virginia","Highland County",4,54,23,12,11
050,51,091,"Virginia","Highland County",4,55,20,11,9
050,51,091,"Virginia","Highland County",4,56,26,16,10
050,51,091,"Virginia","Highland County",4,57,26,16,10
050,51,091,"Virginia","Highland County",4,58,35,21,14
050,51,091,"Virginia","Highland County",4,59,40,17,23
050,51,091,"Virginia","Highland County",4,60,54,23,31
050,51,091,"Virginia","Highland County",4,61,54,25,29
050,51,091,"Virginia","Highland County",4,62,46,21,25
050,51,091,"Virginia","Highland County",4,63,64,32,32
050,51,091,"Virginia","Highland County",4,64,63,28,35
050,51,091,"Virginia","Highland County",4,65,50,21,29
050,51,091,"Virginia","Highland County",4,66,58,31,27
050,51,091,"Virginia","Highland County",4,67,55,34,21
050,51,091,"Virginia","Highland County",4,68,54,31,23
050,51,091,"Virginia","Highland County",4,69,56,30,26
050,51,091,"Virginia","Highland County",4,70,55,31,24
050,51,091,"Virginia","Highland County",4,71,39,20,19
050,51,091,"Virginia","Highland County",4,72,47,26,21
050,51,091,"Virginia","Highland County",4,73,52,25,27
050,51,091,"Virginia","Highland County",4,74,47,23,24
050,51,091,"Virginia","Highland County",4,75,48,26,22
050,51,091,"Virginia","Highland County",4,76,34,15,19
050,51,091,"Virginia","Highland County",4,77,35,15,20
050,51,091,"Virginia","Highland County",4,78,33,14,19
050,51,091,"Virginia","Highland County",4,79,32,14,18
050,51,091,"Virginia","Highland County",4,80,27,12,15
050,51,091,"Virginia","Highland County",4,81,23,9,14
050,51,091,"Virginia","Highland County",4,82,13,6,7
050,51,091,"Virginia","Highland County",4,83,19,10,9
050,51,091,"Virginia","Highland County",4,84,22,9,13
050,51,091,"Virginia","Highland County",4,85,79,29,50
050,51,091,"Virginia","Highland County",5,0,18,10,8
050,51,091,"Virginia","Highland County",5,1,19,11,8
050,51,091,"Virginia","Highland County",5,2,14,5,9
050,51,091,"Virginia","Highland County",5,3,20,12,8
050,51,091,"Virginia","Highland County",5,4,22,14,8
050,51,091,"Virginia","Highland County",5,5,21,11,10
050,51,091,"Virginia","Highland County",5,6,25,11,14
050,51,091,"Virginia","Highland County",5,7,23,13,10
050,51,091,"Virginia","Highland County",5,8,20,11,9
050,51,091,"Virginia","Highland County",5,9,23,12,11
050,51,091,"Virginia","Highland County",5,10,16,9,7
050,51,091,"Virginia","Highland County",5,11,20,9,11
050,51,091,"Virginia","Highland County",5,12,18,7,11
050,51,091,"Virginia","Highland County",5,13,13,5,8
050,51,091,"Virginia","Highland County",5,14,15,9,6
050,51,091,"Virginia","Highland County",5,15,21,13,8
050,51,091,"Virginia","Highland County",5,16,15,10,5
050,51,091,"Virginia","Highland County",5,17,14,7,7
050,51,091,"Virginia","Highland County",5,18,11,4,7
050,51,091,"Virginia","Highland County",5,19,8,1,7
050,51,091,"Virginia","Highland County",5,20,14,6,8
050,51,091,"Virginia","Highland County",5,21,14,8,6
050,51,091,"Virginia","Highland County",5,22,15,8,7
050,51,091,"Virginia","Highland County",5,23,17,11,6
050,51,091,"Virginia","Highland County",5,24,15,4,11
050,51,091,"Virginia","Highland County",5,25,12,8,4
050,51,091,"Virginia","Highland County",5,26,16,8,8
050,51,091,"Virginia","Highland County",5,27,20,11,9
050,51,091,"Virginia","Highland County",5,28,18,9,9
050,51,091,"Virginia","Highland County",5,29,17,4,13
050,51,091,"Virginia","Highland County",5,30,18,6,12
050,51,091,"Virginia","Highland County",5,31,26,16,10
050,51,091,"Virginia","Highland County",5,32,21,11,10
050,51,091,"Virginia","Highland County",5,33,30,16,14
050,51,091,"Virginia","Highland County",5,34,24,11,13
050,51,091,"Virginia","Highland County",5,35,20,7,13
050,51,091,"Virginia","Highland County",5,36,24,10,14
050,51,091,"Virginia","Highland County",5,37,24,13,11
050,51,091,"Virginia","Highland County",5,38,19,7,12
050,51,091,"Virginia","Highland County",5,39,17,7,10
050,51,091,"Virginia","Highland County",5,40,14,6,8
050,51,091,"Virginia","Highland County",5,41,11,6,5
050,51,091,"Virginia","Highland County",5,42,19,9,10
050,51,091,"Virginia","Highland County",5,43,21,13,8
050,51,091,"Virginia","Highland County",5,44,21,12,9
050,51,091,"Virginia","Highland County",5,45,31,16,15
050,51,091,"Virginia","Highland County",5,46,22,10,12
050,51,091,"Virginia","Highland County",5,47,16,9,7
050,51,091,"Virginia","Highland County",5,48,19,9,10
050,51,091,"Virginia","Highland County",5,49,22,10,12
050,51,091,"Virginia","Highland County",5,50,15,10,5
050,51,091,"Virginia","Highland County",5,51,15,8,7
050,51,091,"Virginia","Highland County",5,52,19,11,8
050,51,091,"Virginia","Highland County",5,53,20,9,11
050,51,091,"Virginia","Highland County",5,54,35,21,14
050,51,091,"Virginia","Highland County",5,55,25,12,13
050,51,091,"Virginia","Highland County",5,56,21,12,9
050,51,091,"Virginia","Highland County",5,57,27,16,11
050,51,091,"Virginia","Highland County",5,58,28,17,11
050,51,091,"Virginia","Highland County",5,59,33,20,13
050,51,091,"Virginia","Highland County",5,60,40,17,23
050,51,091,"Virginia","Highland County",5,61,51,22,29
050,51,091,"Virginia","Highland County",5,62,53,27,26
050,51,091,"Virginia","Highland County",5,63,49,21,28
050,51,091,"Virginia","Highland County",5,64,63,31,32
050,51,091,"Virginia","Highland County",5,65,62,27,35
050,51,091,"Virginia","Highland County",5,66,52,23,29
050,51,091,"Virginia","Highland County",5,67,56,29,27
050,51,091,"Virginia","Highland County",5,68,53,34,19
050,51,091,"Virginia","Highland County",5,69,55,32,23
050,51,091,"Virginia","Highland County",5,70,55,30,25
050,51,091,"Virginia","Highland County",5,71,54,30,24
050,51,091,"Virginia","Highland County",5,72,36,17,19
050,51,091,"Virginia","Highland County",5,73,47,24,23
050,51,091,"Virginia","Highland County",5,74,53,27,26
050,51,091,"Virginia","Highland County",5,75,47,23,24
050,51,091,"Virginia","Highland County",5,76,45,24,21
050,51,091,"Virginia","Highland County",5,77,35,16,19
050,51,091,"Virginia","Highland County",5,78,34,15,19
050,51,091,"Virginia","Highland County",5,79,33,14,19
050,51,091,"Virginia","Highland County",5,80,30,14,16
050,51,091,"Virginia","Highland County",5,81,27,11,16
050,51,091,"Virginia","Highland County",5,82,19,7,12
050,51,091,"Virginia","Highland County",5,83,14,6,8
050,51,091,"Virginia","Highland County",5,84,18,9,9
050,51,091,"Virginia","Highland County",5,85,87,33,54
050,51,093,"Virginia","Isle of Wight County",1,0,352,181,171
050,51,093,"Virginia","Isle of Wight County",1,1,356,180,176
050,51,093,"Virginia","Isle of Wight County",1,2,417,206,211
050,51,093,"Virginia","Isle of Wight County",1,3,422,220,202
050,51,093,"Virginia","Isle of Wight County",1,4,445,224,221
050,51,093,"Virginia","Isle of Wight County",1,5,441,232,209
050,51,093,"Virginia","Isle of Wight County",1,6,440,220,220
050,51,093,"Virginia","Isle of Wight County",1,7,424,220,204
050,51,093,"Virginia","Isle of Wight County",1,8,455,238,217
050,51,093,"Virginia","Isle of Wight County",1,9,487,259,228
050,51,093,"Virginia","Isle of Wight County",1,10,472,251,221
050,51,093,"Virginia","Isle of Wight County",1,11,491,250,241
050,51,093,"Virginia","Isle of Wight County",1,12,500,270,230
050,51,093,"Virginia","Isle of Wight County",1,13,508,255,253
050,51,093,"Virginia","Isle of Wight County",1,14,479,222,257
050,51,093,"Virginia","Isle of Wight County",1,15,496,234,262
050,51,093,"Virginia","Isle of Wight County",1,16,492,245,247
050,51,093,"Virginia","Isle of Wight County",1,17,473,243,230
050,51,093,"Virginia","Isle of Wight County",1,18,404,212,192
050,51,093,"Virginia","Isle of Wight County",1,19,333,163,170
050,51,093,"Virginia","Isle of Wight County",1,20,361,184,177
050,51,093,"Virginia","Isle of Wight County",1,21,396,199,197
050,51,093,"Virginia","Isle of Wight County",1,22,399,211,188
050,51,093,"Virginia","Isle of Wight County",1,23,385,203,182
050,51,093,"Virginia","Isle of Wight County",1,24,400,202,198
050,51,093,"Virginia","Isle of Wight County",1,25,401,206,195
050,51,093,"Virginia","Isle of Wight County",1,26,376,202,174
050,51,093,"Virginia","Isle of Wight County",1,27,352,171,181
050,51,093,"Virginia","Isle of Wight County",1,28,400,208,192
050,51,093,"Virginia","Isle of Wight County",1,29,427,208,219
050,51,093,"Virginia","Isle of Wight County",1,30,438,210,228
050,51,093,"Virginia","Isle of Wight County",1,31,404,197,207
050,51,093,"Virginia","Isle of Wight County",1,32,455,204,251
050,51,093,"Virginia","Isle of Wight County",1,33,500,238,262
050,51,093,"Virginia","Isle of Wight County",1,34,488,257,231
050,51,093,"Virginia","Isle of Wight County",1,35,476,229,247
050,51,093,"Virginia","Isle of Wight County",1,36,497,235,262
050,51,093,"Virginia","Isle of Wight County",1,37,463,227,236
050,51,093,"Virginia","Isle of Wight County",1,38,483,252,231
050,51,093,"Virginia","Isle of Wight County",1,39,499,256,243
050,51,093,"Virginia","Isle of Wight County",1,40,482,259,223
050,51,093,"Virginia","Isle of Wight County",1,41,463,239,224
050,51,093,"Virginia","Isle of Wight County",1,42,451,230,221
050,51,093,"Virginia","Isle of Wight County",1,43,442,216,226
050,51,093,"Virginia","Isle of Wight County",1,44,414,195,219
050,51,093,"Virginia","Isle of Wight County",1,45,389,187,202
050,51,093,"Virginia","Isle of Wight County",1,46,407,200,207
050,51,093,"Virginia","Isle of Wight County",1,47,462,237,225
050,51,093,"Virginia","Isle of Wight County",1,48,493,245,248
050,51,093,"Virginia","Isle of Wight County",1,49,580,278,302
050,51,093,"Virginia","Isle of Wight County",1,50,549,260,289
050,51,093,"Virginia","Isle of Wight County",1,51,470,237,233
050,51,093,"Virginia","Isle of Wight County",1,52,497,238,259
050,51,093,"Virginia","Isle of Wight County",1,53,513,251,262
050,51,093,"Virginia","Isle of Wight County",1,54,589,287,302
050,51,093,"Virginia","Isle of Wight County",1,55,618,293,325
050,51,093,"Virginia","Isle of Wight County",1,56,659,321,338
050,51,093,"Virginia","Isle of Wight County",1,57,710,366,344
050,51,093,"Virginia","Isle of Wight County",1,58,706,352,354
050,51,093,"Virginia","Isle of Wight County",1,59,717,368,349
050,51,093,"Virginia","Isle of Wight County",1,60,684,357,327
050,51,093,"Virginia","Isle of Wight County",1,61,627,309,318
050,51,093,"Virginia","Isle of Wight County",1,62,576,293,283
050,51,093,"Virginia","Isle of Wight County",1,63,547,262,285
050,51,093,"Virginia","Isle of Wight County",1,64,553,268,285
050,51,093,"Virginia","Isle of Wight County",1,65,544,279,265
050,51,093,"Virginia","Isle of Wight County",1,66,557,275,282
050,51,093,"Virginia","Isle of Wight County",1,67,530,259,271
050,51,093,"Virginia","Isle of Wight County",1,68,508,255,253
050,51,093,"Virginia","Isle of Wight County",1,69,439,211,228
050,51,093,"Virginia","Isle of Wight County",1,70,448,211,237
050,51,093,"Virginia","Isle of Wight County",1,71,444,199,245
050,51,093,"Virginia","Isle of Wight County",1,72,414,194,220
050,51,093,"Virginia","Isle of Wight County",1,73,419,200,219
050,51,093,"Virginia","Isle of Wight County",1,74,316,142,174
050,51,093,"Virginia","Isle of Wight County",1,75,301,133,168
050,51,093,"Virginia","Isle of Wight County",1,76,305,146,159
050,51,093,"Virginia","Isle of Wight County",1,77,325,160,165
050,51,093,"Virginia","Isle of Wight County",1,78,265,130,135
050,51,093,"Virginia","Isle of Wight County",1,79,196,87,109
050,51,093,"Virginia","Isle of Wight County",1,80,197,91,106
050,51,093,"Virginia","Isle of Wight County",1,81,179,86,93
050,51,093,"Virginia","Isle of Wight County",1,82,149,73,76
050,51,093,"Virginia","Isle of Wight County",1,83,150,52,98
050,51,093,"Virginia","Isle of Wight County",1,84,122,44,78
050,51,093,"Virginia","Isle of Wight County",1,85,718,254,464
050,51,093,"Virginia","Isle of Wight County",2,0,349,180,169
050,51,093,"Virginia","Isle of Wight County",2,1,359,182,177
050,51,093,"Virginia","Isle of Wight County",2,2,407,201,206
050,51,093,"Virginia","Isle of Wight County",2,3,425,217,208
050,51,093,"Virginia","Isle of Wight County",2,4,445,227,218
050,51,093,"Virginia","Isle of Wight County",2,5,447,232,215
050,51,093,"Virginia","Isle of Wight County",2,6,443,224,219
050,51,093,"Virginia","Isle of Wight County",2,7,432,222,210
050,51,093,"Virginia","Isle of Wight County",2,8,449,236,213
050,51,093,"Virginia","Isle of Wight County",2,9,481,256,225
050,51,093,"Virginia","Isle of Wight County",2,10,476,252,224
050,51,093,"Virginia","Isle of Wight County",2,11,486,250,236
050,51,093,"Virginia","Isle of Wight County",2,12,503,268,235
050,51,093,"Virginia","Isle of Wight County",2,13,506,257,249
050,51,093,"Virginia","Isle of Wight County",2,14,489,231,258
050,51,093,"Virginia","Isle of Wight County",2,15,495,233,262
050,51,093,"Virginia","Isle of Wight County",2,16,492,242,250
050,51,093,"Virginia","Isle of Wight County",2,17,478,243,235
050,51,093,"Virginia","Isle of Wight County",2,18,404,213,191
050,51,093,"Virginia","Isle of Wight County",2,19,335,169,166
050,51,093,"Virginia","Isle of Wight County",2,20,364,183,181
050,51,093,"Virginia","Isle of Wight County",2,21,393,198,195
050,51,093,"Virginia","Isle of Wight County",2,22,400,210,190
050,51,093,"Virginia","Isle of Wight County",2,23,389,205,184
050,51,093,"Virginia","Isle of Wight County",2,24,393,200,193
050,51,093,"Virginia","Isle of Wight County",2,25,398,204,194
050,51,093,"Virginia","Isle of Wight County",2,26,380,200,180
050,51,093,"Virginia","Isle of Wight County",2,27,357,177,180
050,51,093,"Virginia","Isle of Wight County",2,28,393,202,191
050,51,093,"Virginia","Isle of Wight County",2,29,427,212,215
050,51,093,"Virginia","Isle of Wight County",2,30,441,213,228
050,51,093,"Virginia","Isle of Wight County",2,31,416,202,214
050,51,093,"Virginia","Isle of Wight County",2,32,449,206,243
050,51,093,"Virginia","Isle of Wight County",2,33,496,234,262
050,51,093,"Virginia","Isle of Wight County",2,34,490,251,239
050,51,093,"Virginia","Isle of Wight County",2,35,481,235,246
050,51,093,"Virginia","Isle of Wight County",2,36,490,233,257
050,51,093,"Virginia","Isle of Wight County",2,37,477,233,244
050,51,093,"Virginia","Isle of Wight County",2,38,478,244,234
050,51,093,"Virginia","Isle of Wight County",2,39,495,255,240
050,51,093,"Virginia","Isle of Wight County",2,40,498,264,234
050,51,093,"Virginia","Isle of Wight County",2,41,470,246,224
050,51,093,"Virginia","Isle of Wight County",2,42,455,234,221
050,51,093,"Virginia","Isle of Wight County",2,43,449,220,229
050,51,093,"Virginia","Isle of Wight County",2,44,418,197,221
050,51,093,"Virginia","Isle of Wight County",2,45,396,189,207
050,51,093,"Virginia","Isle of Wight County",2,46,399,196,203
050,51,093,"Virginia","Isle of Wight County",2,47,446,226,220
050,51,093,"Virginia","Isle of Wight County",2,48,488,246,242
050,51,093,"Virginia","Isle of Wight County",2,49,566,273,293
050,51,093,"Virginia","Isle of Wight County",2,50,560,268,292
050,51,093,"Virginia","Isle of Wight County",2,51,491,244,247
050,51,093,"Virginia","Isle of Wight County",2,52,488,238,250
050,51,093,"Virginia","Isle of Wight County",2,53,510,248,262
050,51,093,"Virginia","Isle of Wight County",2,54,570,277,293
050,51,093,"Virginia","Isle of Wight County",2,55,609,290,319
050,51,093,"Virginia","Isle of Wight County",2,56,652,318,334
050,51,093,"Virginia","Isle of Wight County",2,57,699,358,341
050,51,093,"Virginia","Isle of Wight County",2,58,707,355,352
050,51,093,"Virginia","Isle of Wight County",2,59,714,363,351
050,51,093,"Virginia","Isle of Wight County",2,60,690,359,331
050,51,093,"Virginia","Isle of Wight County",2,61,639,319,320
050,51,093,"Virginia","Isle of Wight County",2,62,584,293,291
050,51,093,"Virginia","Isle of Wight County",2,63,559,270,289
050,51,093,"Virginia","Isle of Wight County",2,64,551,265,286
050,51,093,"Virginia","Isle of Wight County",2,65,545,276,269
050,51,093,"Virginia","Isle of Wight County",2,66,556,276,280
050,51,093,"Virginia","Isle of Wight County",2,67,532,262,270
050,51,093,"Virginia","Isle of Wight County",2,68,509,254,255
050,51,093,"Virginia","Isle of Wight County",2,69,458,223,235
050,51,093,"Virginia","Isle of Wight County",2,70,446,209,237
050,51,093,"Virginia","Isle of Wight County",2,71,445,204,241
050,51,093,"Virginia","Isle of Wight County",2,72,417,193,224
050,51,093,"Virginia","Isle of Wight County",2,73,434,207,227
050,51,093,"Virginia","Isle of Wight County",2,74,319,147,172
050,51,093,"Virginia","Isle of Wight County",2,75,301,134,167
050,51,093,"Virginia","Isle of Wight County",2,76,297,140,157
050,51,093,"Virginia","Isle of Wight County",2,77,327,160,167
050,51,093,"Virginia","Isle of Wight County",2,78,272,133,139
050,51,093,"Virginia","Isle of Wight County",2,79,212,94,118
050,51,093,"Virginia","Isle of Wight County",2,80,196,89,107
050,51,093,"Virginia","Isle of Wight County",2,81,178,84,94
050,51,093,"Virginia","Isle of Wight County",2,82,154,76,78
050,51,093,"Virginia","Isle of Wight County",2,83,148,58,90
050,51,093,"Virginia","Isle of Wight County",2,84,126,44,82
050,51,093,"Virginia","Isle of Wight County",2,85,719,253,466
050,51,093,"Virginia","Isle of Wight County",3,0,383,196,187
050,51,093,"Virginia","Isle of Wight County",3,1,358,177,181
050,51,093,"Virginia","Isle of Wight County",3,2,380,207,173
050,51,093,"Virginia","Isle of Wight County",3,3,426,197,229
050,51,093,"Virginia","Isle of Wight County",3,4,440,220,220
050,51,093,"Virginia","Isle of Wight County",3,5,474,243,231
050,51,093,"Virginia","Isle of Wight County",3,6,472,244,228
050,51,093,"Virginia","Isle of Wight County",3,7,488,245,243
050,51,093,"Virginia","Isle of Wight County",3,8,440,225,215
050,51,093,"Virginia","Isle of Wight County",3,9,472,251,221
050,51,093,"Virginia","Isle of Wight County",3,10,503,272,231
050,51,093,"Virginia","Isle of Wight County",3,11,489,258,231
050,51,093,"Virginia","Isle of Wight County",3,12,500,256,244
050,51,093,"Virginia","Isle of Wight County",3,13,522,274,248
050,51,093,"Virginia","Isle of Wight County",3,14,526,262,264
050,51,093,"Virginia","Isle of Wight County",3,15,505,241,264
050,51,093,"Virginia","Isle of Wight County",3,16,531,255,276
050,51,093,"Virginia","Isle of Wight County",3,17,502,248,254
050,51,093,"Virginia","Isle of Wight County",3,18,416,220,196
050,51,093,"Virginia","Isle of Wight County",3,19,332,163,169
050,51,093,"Virginia","Isle of Wight County",3,20,372,183,189
050,51,093,"Virginia","Isle of Wight County",3,21,376,181,195
050,51,093,"Virginia","Isle of Wight County",3,22,392,195,197
050,51,093,"Virginia","Isle of Wight County",3,23,401,225,176
050,51,093,"Virginia","Isle of Wight County",3,24,378,189,189
050,51,093,"Virginia","Isle of Wight County",3,25,385,188,197
050,51,093,"Virginia","Isle of Wight County",3,26,394,207,187
050,51,093,"Virginia","Isle of Wight County",3,27,385,203,182
050,51,093,"Virginia","Isle of Wight County",3,28,381,189,192
050,51,093,"Virginia","Isle of Wight County",3,29,418,213,205
050,51,093,"Virginia","Isle of Wight County",3,30,433,208,225
050,51,093,"Virginia","Isle of Wight County",3,31,473,227,246
050,51,093,"Virginia","Isle of Wight County",3,32,450,219,231
050,51,093,"Virginia","Isle of Wight County",3,33,477,231,246
050,51,093,"Virginia","Isle of Wight County",3,34,529,251,278
050,51,093,"Virginia","Isle of Wight County",3,35,510,264,246
050,51,093,"Virginia","Isle of Wight County",3,36,514,270,244
050,51,093,"Virginia","Isle of Wight County",3,37,503,237,266
050,51,093,"Virginia","Isle of Wight County",3,38,473,220,253
050,51,093,"Virginia","Isle of Wight County",3,39,484,245,239
050,51,093,"Virginia","Isle of Wight County",3,40,502,264,238
050,51,093,"Virginia","Isle of Wight County",3,41,528,276,252
050,51,093,"Virginia","Isle of Wight County",3,42,487,245,242
050,51,093,"Virginia","Isle of Wight County",3,43,444,236,208
050,51,093,"Virginia","Isle of Wight County",3,44,481,249,232
050,51,093,"Virginia","Isle of Wight County",3,45,434,205,229
050,51,093,"Virginia","Isle of Wight County",3,46,407,183,224
050,51,093,"Virginia","Isle of Wight County",3,47,408,200,208
050,51,093,"Virginia","Isle of Wight County",3,48,448,220,228
050,51,093,"Virginia","Isle of Wight County",3,49,492,249,243
050,51,093,"Virginia","Isle of Wight County",3,50,564,268,296
050,51,093,"Virginia","Isle of Wight County",3,51,558,274,284
050,51,093,"Virginia","Isle of Wight County",3,52,497,243,254
050,51,093,"Virginia","Isle of Wight County",3,53,498,249,249
050,51,093,"Virginia","Isle of Wight County",3,54,527,254,273
050,51,093,"Virginia","Isle of Wight County",3,55,580,277,303
050,51,093,"Virginia","Isle of Wight County",3,56,625,308,317
050,51,093,"Virginia","Isle of Wight County",3,57,662,317,345
050,51,093,"Virginia","Isle of Wight County",3,58,705,357,348
050,51,093,"Virginia","Isle of Wight County",3,59,698,359,339
050,51,093,"Virginia","Isle of Wight County",3,60,698,354,344
050,51,093,"Virginia","Isle of Wight County",3,61,697,365,332
050,51,093,"Virginia","Isle of Wight County",3,62,625,310,315
050,51,093,"Virginia","Isle of Wight County",3,63,577,286,291
050,51,093,"Virginia","Isle of Wight County",3,64,549,267,282
050,51,093,"Virginia","Isle of Wight County",3,65,548,265,283
050,51,093,"Virginia","Isle of Wight County",3,66,549,276,273
050,51,093,"Virginia","Isle of Wight County",3,67,555,271,284
050,51,093,"Virginia","Isle of Wight County",3,68,537,266,271
050,51,093,"Virginia","Isle of Wight County",3,69,495,247,248
050,51,093,"Virginia","Isle of Wight County",3,70,451,213,238
050,51,093,"Virginia","Isle of Wight County",3,71,430,207,223
050,51,093,"Virginia","Isle of Wight County",3,72,436,200,236
050,51,093,"Virginia","Isle of Wight County",3,73,402,185,217
050,51,093,"Virginia","Isle of Wight County",3,74,414,197,217
050,51,093,"Virginia","Isle of Wight County",3,75,295,134,161
050,51,093,"Virginia","Isle of Wight County",3,76,296,132,164
050,51,093,"Virginia","Isle of Wight County",3,77,283,136,147
050,51,093,"Virginia","Isle of Wight County",3,78,307,150,157
050,51,093,"Virginia","Isle of Wight County",3,79,261,122,139
050,51,093,"Virginia","Isle of Wight County",3,80,208,92,116
050,51,093,"Virginia","Isle of Wight County",3,81,187,85,102
050,51,093,"Virginia","Isle of Wight County",3,82,160,78,82
050,51,093,"Virginia","Isle of Wight County",3,83,142,68,74
050,51,093,"Virginia","Isle of Wight County",3,84,131,48,83
050,51,093,"Virginia","Isle of Wight County",3,85,726,247,479
050,51,093,"Virginia","Isle of Wight County",4,0,403,209,194
050,51,093,"Virginia","Isle of Wight County",4,1,425,211,214
050,51,093,"Virginia","Isle of Wight County",4,2,410,199,211
050,51,093,"Virginia","Isle of Wight County",4,3,410,216,194
050,51,093,"Virginia","Isle of Wight County",4,4,420,195,225
050,51,093,"Virginia","Isle of Wight County",4,5,470,232,238
050,51,093,"Virginia","Isle of Wight County",4,6,482,256,226
050,51,093,"Virginia","Isle of Wight County",4,7,490,252,238
050,51,093,"Virginia","Isle of Wight County",4,8,517,265,252
050,51,093,"Virginia","Isle of Wight County",4,9,473,241,232
050,51,093,"Virginia","Isle of Wight County",4,10,485,258,227
050,51,093,"Virginia","Isle of Wight County",4,11,538,292,246
050,51,093,"Virginia","Isle of Wight County",4,12,494,263,231
050,51,093,"Virginia","Isle of Wight County",4,13,530,283,247
050,51,093,"Virginia","Isle of Wight County",4,14,518,272,246
050,51,093,"Virginia","Isle of Wight County",4,15,536,260,276
050,51,093,"Virginia","Isle of Wight County",4,16,524,254,270
050,51,093,"Virginia","Isle of Wight County",4,17,534,255,279
050,51,093,"Virginia","Isle of Wight County",4,18,417,213,204
050,51,093,"Virginia","Isle of Wight County",4,19,336,172,164
050,51,093,"Virginia","Isle of Wight County",4,20,353,168,185
050,51,093,"Virginia","Isle of Wight County",4,21,390,195,195
050,51,093,"Virginia","Isle of Wight County",4,22,400,196,204
050,51,093,"Virginia","Isle of Wight County",4,23,412,200,212
050,51,093,"Virginia","Isle of Wight County",4,24,403,220,183
050,51,093,"Virginia","Isle of Wight County",4,25,381,193,188
050,51,093,"Virginia","Isle of Wight County",4,26,393,192,201
050,51,093,"Virginia","Isle of Wight County",4,27,393,205,188
050,51,093,"Virginia","Isle of Wight County",4,28,379,198,181
050,51,093,"Virginia","Isle of Wight County",4,29,403,189,214
050,51,093,"Virginia","Isle of Wight County",4,30,444,221,223
050,51,093,"Virginia","Isle of Wight County",4,31,453,223,230
050,51,093,"Virginia","Isle of Wight County",4,32,513,250,263
050,51,093,"Virginia","Isle of Wight County",4,33,505,266,239
050,51,093,"Virginia","Isle of Wight County",4,34,523,242,281
050,51,093,"Virginia","Isle of Wight County",4,35,546,273,273
050,51,093,"Virginia","Isle of Wight County",4,36,525,271,254
050,51,093,"Virginia","Isle of Wight County",4,37,549,289,260
050,51,093,"Virginia","Isle of Wight County",4,38,538,258,280
050,51,093,"Virginia","Isle of Wight County",4,39,523,248,275
050,51,093,"Virginia","Isle of Wight County",4,40,518,255,263
050,51,093,"Virginia","Isle of Wight County",4,41,523,274,249
050,51,093,"Virginia","Isle of Wight County",4,42,545,287,258
050,51,093,"Virginia","Isle of Wight County",4,43,513,265,248
050,51,093,"Virginia","Isle of Wight County",4,44,442,232,210
050,51,093,"Virginia","Isle of Wight County",4,45,479,247,232
050,51,093,"Virginia","Isle of Wight County",4,46,435,214,221
050,51,093,"Virginia","Isle of Wight County",4,47,396,179,217
050,51,093,"Virginia","Isle of Wight County",4,48,414,196,218
050,51,093,"Virginia","Isle of Wight County",4,49,442,214,228
050,51,093,"Virginia","Isle of Wight County",4,50,501,258,243
050,51,093,"Virginia","Isle of Wight County",4,51,560,265,295
050,51,093,"Virginia","Isle of Wight County",4,52,563,280,283
050,51,093,"Virginia","Isle of Wight County",4,53,498,245,253
050,51,093,"Virginia","Isle of Wight County",4,54,492,255,237
050,51,093,"Virginia","Isle of Wight County",4,55,536,258,278
050,51,093,"Virginia","Isle of Wight County",4,56,578,279,299
050,51,093,"Virginia","Isle of Wight County",4,57,609,302,307
050,51,093,"Virginia","Isle of Wight County",4,58,656,315,341
050,51,093,"Virginia","Isle of Wight County",4,59,689,350,339
050,51,093,"Virginia","Isle of Wight County",4,60,699,364,335
050,51,093,"Virginia","Isle of Wight County",4,61,688,350,338
050,51,093,"Virginia","Isle of Wight County",4,62,685,354,331
050,51,093,"Virginia","Isle of Wight County",4,63,628,311,317
050,51,093,"Virginia","Isle of Wight County",4,64,574,284,290
050,51,093,"Virginia","Isle of Wight County",4,65,541,261,280
050,51,093,"Virginia","Isle of Wight County",4,66,551,265,286
050,51,093,"Virginia","Isle of Wight County",4,67,536,267,269
050,51,093,"Virginia","Isle of Wight County",4,68,554,272,282
050,51,093,"Virginia","Isle of Wight County",4,69,527,262,265
050,51,093,"Virginia","Isle of Wight County",4,70,488,243,245
050,51,093,"Virginia","Isle of Wight County",4,71,443,211,232
050,51,093,"Virginia","Isle of Wight County",4,72,426,204,222
050,51,093,"Virginia","Isle of Wight County",4,73,419,187,232
050,51,093,"Virginia","Isle of Wight County",4,74,391,180,211
050,51,093,"Virginia","Isle of Wight County",4,75,392,184,208
050,51,093,"Virginia","Isle of Wight County",4,76,288,130,158
050,51,093,"Virginia","Isle of Wight County",4,77,286,128,158
050,51,093,"Virginia","Isle of Wight County",4,78,269,130,139
050,51,093,"Virginia","Isle of Wight County",4,79,293,138,155
050,51,093,"Virginia","Isle of Wight County",4,80,252,113,139
050,51,093,"Virginia","Isle of Wight County",4,81,201,87,114
050,51,093,"Virginia","Isle of Wight County",4,82,170,81,89
050,51,093,"Virginia","Isle of Wight County",4,83,153,74,79
050,51,093,"Virginia","Isle of Wight County",4,84,121,57,64
050,51,093,"Virginia","Isle of Wight County",4,85,733,241,492
050,51,093,"Virginia","Isle of Wight County",5,0,402,210,192
050,51,093,"Virginia","Isle of Wight County",5,1,429,225,204
050,51,093,"Virginia","Isle of Wight County",5,2,447,221,226
050,51,093,"Virginia","Isle of Wight County",5,3,433,210,223
050,51,093,"Virginia","Isle of Wight County",5,4,441,240,201
050,51,093,"Virginia","Isle of Wight County",5,5,448,218,230
050,51,093,"Virginia","Isle of Wight County",5,6,476,251,225
050,51,093,"Virginia","Isle of Wight County",5,7,510,279,231
050,51,093,"Virginia","Isle of Wight County",5,8,487,248,239
050,51,093,"Virginia","Isle of Wight County",5,9,532,264,268
050,51,093,"Virginia","Isle of Wight County",5,10,487,248,239
050,51,093,"Virginia","Isle of Wight County",5,11,479,257,222
050,51,093,"Virginia","Isle of Wight County",5,12,520,292,228
050,51,093,"Virginia","Isle of Wight County",5,13,509,261,248
050,51,093,"Virginia","Isle of Wight County",5,14,535,286,249
050,51,093,"Virginia","Isle of Wight County",5,15,525,281,244
050,51,093,"Virginia","Isle of Wight County",5,16,536,267,269
050,51,093,"Virginia","Isle of Wight County",5,17,534,249,285
050,51,093,"Virginia","Isle of Wight County",5,18,450,223,227
050,51,093,"Virginia","Isle of Wight County",5,19,340,177,163
050,51,093,"Virginia","Isle of Wight County",5,20,377,178,199
050,51,093,"Virginia","Isle of Wight County",5,21,380,181,199
050,51,093,"Virginia","Isle of Wight County",5,22,394,202,192
050,51,093,"Virginia","Isle of Wight County",5,23,397,196,201
050,51,093,"Virginia","Isle of Wight County",5,24,377,186,191
050,51,093,"Virginia","Isle of Wight County",5,25,381,211,170
050,51,093,"Virginia","Isle of Wight County",5,26,383,192,191
050,51,093,"Virginia","Isle of Wight County",5,27,396,192,204
050,51,093,"Virginia","Isle of Wight County",5,28,407,209,198
050,51,093,"Virginia","Isle of Wight County",5,29,387,200,187
050,51,093,"Virginia","Isle of Wight County",5,30,411,189,222
050,51,093,"Virginia","Isle of Wight County",5,31,467,227,240
050,51,093,"Virginia","Isle of Wight County",5,32,480,225,255
050,51,093,"Virginia","Isle of Wight County",5,33,531,266,265
050,51,093,"Virginia","Isle of Wight County",5,34,510,268,242
050,51,093,"Virginia","Isle of Wight County",5,35,536,259,277
050,51,093,"Virginia","Isle of Wight County",5,36,578,293,285
050,51,093,"Virginia","Isle of Wight County",5,37,545,276,269
050,51,093,"Virginia","Isle of Wight County",5,38,571,308,263
050,51,093,"Virginia","Isle of Wight County",5,39,554,270,284
050,51,093,"Virginia","Isle of Wight County",5,40,538,255,283
050,51,093,"Virginia","Isle of Wight County",5,41,513,254,259
050,51,093,"Virginia","Isle of Wight County",5,42,547,286,261
050,51,093,"Virginia","Isle of Wight County",5,43,564,299,265
050,51,093,"Virginia","Isle of Wight County",5,44,523,267,256
050,51,093,"Virginia","Isle of Wight County",5,45,467,250,217
050,51,093,"Virginia","Isle of Wight County",5,46,498,252,246
050,51,093,"Virginia","Isle of Wight County",5,47,440,225,215
050,51,093,"Virginia","Isle of Wight County",5,48,411,193,218
050,51,093,"Virginia","Isle of Wight County",5,49,428,206,222
050,51,093,"Virginia","Isle of Wight County",5,50,466,224,242
050,51,093,"Virginia","Isle of Wight County",5,51,526,270,256
050,51,093,"Virginia","Isle of Wight County",5,52,564,273,291
050,51,093,"Virginia","Isle of Wight County",5,53,592,292,300
050,51,093,"Virginia","Isle of Wight County",5,54,499,241,258
050,51,093,"Virginia","Isle of Wight County",5,55,506,266,240
050,51,093,"Virginia","Isle of Wight County",5,56,532,257,275
050,51,093,"Virginia","Isle of Wight County",5,57,582,280,302
050,51,093,"Virginia","Isle of Wight County",5,58,609,304,305
050,51,093,"Virginia","Isle of Wight County",5,59,656,311,345
050,51,093,"Virginia","Isle of Wight County",5,60,674,348,326
050,51,093,"Virginia","Isle of Wight County",5,61,693,355,338
050,51,093,"Virginia","Isle of Wight County",5,62,680,348,332
050,51,093,"Virginia","Isle of Wight County",5,63,688,356,332
050,51,093,"Virginia","Isle of Wight County",5,64,611,305,306
050,51,093,"Virginia","Isle of Wight County",5,65,570,282,288
050,51,093,"Virginia","Isle of Wight County",5,66,547,253,294
050,51,093,"Virginia","Isle of Wight County",5,67,539,257,282
050,51,093,"Virginia","Isle of Wight County",5,68,536,261,275
050,51,093,"Virginia","Isle of Wight County",5,69,545,273,272
050,51,093,"Virginia","Isle of Wight County",5,70,518,253,265
050,51,093,"Virginia","Isle of Wight County",5,71,481,247,234
050,51,093,"Virginia","Isle of Wight County",5,72,431,204,227
050,51,093,"Virginia","Isle of Wight County",5,73,430,203,227
050,51,093,"Virginia","Isle of Wight County",5,74,413,190,223
050,51,093,"Virginia","Isle of Wight County",5,75,372,171,201
050,51,093,"Virginia","Isle of Wight County",5,76,389,182,207
050,51,093,"Virginia","Isle of Wight County",5,77,274,122,152
050,51,093,"Virginia","Isle of Wight County",5,78,273,123,150
050,51,093,"Virginia","Isle of Wight County",5,79,256,115,141
050,51,093,"Virginia","Isle of Wight County",5,80,278,132,146
050,51,093,"Virginia","Isle of Wight County",5,81,248,107,141
050,51,093,"Virginia","Isle of Wight County",5,82,188,86,102
050,51,093,"Virginia","Isle of Wight County",5,83,161,76,85
050,51,093,"Virginia","Isle of Wight County",5,84,125,58,67
050,51,093,"Virginia","Isle of Wight County",5,85,748,257,491
050,51,095,"Virginia","James City County",1,0,671,341,330
050,51,095,"Virginia","James City County",1,1,671,345,326
050,51,095,"Virginia","James City County",1,2,723,370,353
050,51,095,"Virginia","James City County",1,3,769,365,404
050,51,095,"Virginia","James City County",1,4,762,389,373
050,51,095,"Virginia","James City County",1,5,831,422,409
050,51,095,"Virginia","James City County",1,6,778,399,379
050,51,095,"Virginia","James City County",1,7,837,428,409
050,51,095,"Virginia","James City County",1,8,882,473,409
050,51,095,"Virginia","James City County",1,9,874,437,437
050,51,095,"Virginia","James City County",1,10,883,446,437
050,51,095,"Virginia","James City County",1,11,906,463,443
050,51,095,"Virginia","James City County",1,12,943,483,460
050,51,095,"Virginia","James City County",1,13,999,514,485
050,51,095,"Virginia","James City County",1,14,992,513,479
050,51,095,"Virginia","James City County",1,15,963,479,484
050,51,095,"Virginia","James City County",1,16,992,508,484
050,51,095,"Virginia","James City County",1,17,989,497,492
050,51,095,"Virginia","James City County",1,18,838,436,402
050,51,095,"Virginia","James City County",1,19,689,355,334
050,51,095,"Virginia","James City County",1,20,751,409,342
050,51,095,"Virginia","James City County",1,21,797,408,389
050,51,095,"Virginia","James City County",1,22,741,385,356
050,51,095,"Virginia","James City County",1,23,724,357,367
050,51,095,"Virginia","James City County",1,24,760,376,384
050,51,095,"Virginia","James City County",1,25,753,402,351
050,51,095,"Virginia","James City County",1,26,707,371,336
050,51,095,"Virginia","James City County",1,27,721,380,341
050,51,095,"Virginia","James City County",1,28,769,393,376
050,51,095,"Virginia","James City County",1,29,783,377,406
050,51,095,"Virginia","James City County",1,30,766,365,401
050,51,095,"Virginia","James City County",1,31,762,367,395
050,51,095,"Virginia","James City County",1,32,746,373,373
050,51,095,"Virginia","James City County",1,33,806,385,421
050,51,095,"Virginia","James City County",1,34,915,461,454
050,51,095,"Virginia","James City County",1,35,881,419,462
050,51,095,"Virginia","James City County",1,36,866,432,434
050,51,095,"Virginia","James City County",1,37,934,462,472
050,51,095,"Virginia","James City County",1,38,943,467,476
050,51,095,"Virginia","James City County",1,39,889,426,463
050,51,095,"Virginia","James City County",1,40,898,457,441
050,51,095,"Virginia","James City County",1,41,883,443,440
050,51,095,"Virginia","James City County",1,42,852,427,425
050,51,095,"Virginia","James City County",1,43,822,389,433
050,51,095,"Virginia","James City County",1,44,843,401,442
050,51,095,"Virginia","James City County",1,45,866,417,449
050,51,095,"Virginia","James City County",1,46,831,390,441
050,51,095,"Virginia","James City County",1,47,886,420,466
050,51,095,"Virginia","James City County",1,48,919,455,464
050,51,095,"Virginia","James City County",1,49,973,480,493
050,51,095,"Virginia","James City County",1,50,970,470,500
050,51,095,"Virginia","James City County",1,51,988,496,492
050,51,095,"Virginia","James City County",1,52,959,472,487
050,51,095,"Virginia","James City County",1,53,1029,511,518
050,51,095,"Virginia","James City County",1,54,1006,492,514
050,51,095,"Virginia","James City County",1,55,1070,503,567
050,51,095,"Virginia","James City County",1,56,1110,529,581
050,51,095,"Virginia","James City County",1,57,1160,534,626
050,51,095,"Virginia","James City County",1,58,1140,534,606
050,51,095,"Virginia","James City County",1,59,1131,539,592
050,51,095,"Virginia","James City County",1,60,1152,533,619
050,51,095,"Virginia","James City County",1,61,1145,532,613
050,51,095,"Virginia","James City County",1,62,1104,534,570
050,51,095,"Virginia","James City County",1,63,1082,510,572
050,51,095,"Virginia","James City County",1,64,1125,504,621
050,51,095,"Virginia","James City County",1,65,1126,515,611
050,51,095,"Virginia","James City County",1,66,1181,560,621
050,51,095,"Virginia","James City County",1,67,1154,526,628
050,51,095,"Virginia","James City County",1,68,1155,534,621
050,51,095,"Virginia","James City County",1,69,1098,484,614
050,51,095,"Virginia","James City County",1,70,1106,492,614
050,51,095,"Virginia","James City County",1,71,1179,547,632
050,51,095,"Virginia","James City County",1,72,1287,599,688
050,51,095,"Virginia","James City County",1,73,1243,588,655
050,51,095,"Virginia","James City County",1,74,875,415,460
050,51,095,"Virginia","James City County",1,75,853,395,458
050,51,095,"Virginia","James City County",1,76,852,382,470
050,51,095,"Virginia","James City County",1,77,902,419,483
050,51,095,"Virginia","James City County",1,78,762,347,415
050,51,095,"Virginia","James City County",1,79,675,312,363
050,51,095,"Virginia","James City County",1,80,620,278,342
050,51,095,"Virginia","James City County",1,81,583,289,294
050,51,095,"Virginia","James City County",1,82,510,248,262
050,51,095,"Virginia","James City County",1,83,446,213,233
050,51,095,"Virginia","James City County",1,84,421,206,215
050,51,095,"Virginia","James City County",1,85,2275,936,1339
050,51,095,"Virginia","James City County",2,0,726,359,367
050,51,095,"Virginia","James City County",2,1,673,345,328
050,51,095,"Virginia","James City County",2,2,719,366,353
050,51,095,"Virginia","James City County",2,3,761,368,393
050,51,095,"Virginia","James City County",2,4,773,388,385
050,51,095,"Virginia","James City County",2,5,815,413,402
050,51,095,"Virginia","James City County",2,6,798,406,392
050,51,095,"Virginia","James City County",2,7,829,424,405
050,51,095,"Virginia","James City County",2,8,876,463,413
050,51,095,"Virginia","James City County",2,9,882,447,435
050,51,095,"Virginia","James City County",2,10,884,444,440
050,51,095,"Virginia","James City County",2,11,904,461,443
050,51,095,"Virginia","James City County",2,12,946,483,463
050,51,095,"Virginia","James City County",2,13,988,508,480
050,51,095,"Virginia","James City County",2,14,993,514,479
050,51,095,"Virginia","James City County",2,15,973,491,482
050,51,095,"Virginia","James City County",2,16,986,501,485
050,51,095,"Virginia","James City County",2,17,989,499,490
050,51,095,"Virginia","James City County",2,18,835,433,402
050,51,095,"Virginia","James City County",2,19,699,362,337
050,51,095,"Virginia","James City County",2,20,756,408,348
050,51,095,"Virginia","James City County",2,21,789,410,379
050,51,095,"Virginia","James City County",2,22,757,391,366
050,51,095,"Virginia","James City County",2,23,730,363,367
050,51,095,"Virginia","James City County",2,24,747,373,374
050,51,095,"Virginia","James City County",2,25,745,393,352
050,51,095,"Virginia","James City County",2,26,719,380,339
050,51,095,"Virginia","James City County",2,27,717,380,337
050,51,095,"Virginia","James City County",2,28,759,387,372
050,51,095,"Virginia","James City County",2,29,778,381,397
050,51,095,"Virginia","James City County",2,30,780,372,408
050,51,095,"Virginia","James City County",2,31,760,367,393
050,51,095,"Virginia","James City County",2,32,752,370,382
050,51,095,"Virginia","James City County",2,33,804,388,416
050,51,095,"Virginia","James City County",2,34,897,444,453
050,51,095,"Virginia","James City County",2,35,892,429,463
050,51,095,"Virginia","James City County",2,36,867,429,438
050,51,095,"Virginia","James City County",2,37,930,464,466
050,51,095,"Virginia","James City County",2,38,938,459,479
050,51,095,"Virginia","James City County",2,39,900,435,465
050,51,095,"Virginia","James City County",2,40,907,456,451
050,51,095,"Virginia","James City County",2,41,890,449,441
050,51,095,"Virginia","James City County",2,42,858,430,428
050,51,095,"Virginia","James City County",2,43,845,406,439
050,51,095,"Virginia","James City County",2,44,836,396,440
050,51,095,"Virginia","James City County",2,45,869,416,453
050,51,095,"Virginia","James City County",2,46,841,397,444
050,51,095,"Virginia","James City County",2,47,869,409,460
050,51,095,"Virginia","James City County",2,48,921,451,470
050,51,095,"Virginia","James City County",2,49,968,478,490
050,51,095,"Virginia","James City County",2,50,973,474,499
050,51,095,"Virginia","James City County",2,51,980,486,494
050,51,095,"Virginia","James City County",2,52,960,478,482
050,51,095,"Virginia","James City County",2,53,1008,498,510
050,51,095,"Virginia","James City County",2,54,1011,497,514
050,51,095,"Virginia","James City County",2,55,1051,498,553
050,51,095,"Virginia","James City County",2,56,1107,525,582
050,51,095,"Virginia","James City County",2,57,1156,536,620
050,51,095,"Virginia","James City County",2,58,1151,541,610
050,51,095,"Virginia","James City County",2,59,1136,537,599
050,51,095,"Virginia","James City County",2,60,1150,534,616
050,51,095,"Virginia","James City County",2,61,1149,536,613
050,51,095,"Virginia","James City County",2,62,1114,532,582
050,51,095,"Virginia","James City County",2,63,1102,521,581
050,51,095,"Virginia","James City County",2,64,1112,504,608
050,51,095,"Virginia","James City County",2,65,1131,516,615
050,51,095,"Virginia","James City County",2,66,1177,554,623
050,51,095,"Virginia","James City County",2,67,1161,532,629
050,51,095,"Virginia","James City County",2,68,1155,533,622
050,51,095,"Virginia","James City County",2,69,1122,500,622
050,51,095,"Virginia","James City County",2,70,1099,489,610
050,51,095,"Virginia","James City County",2,71,1165,535,630
050,51,095,"Virginia","James City County",2,72,1241,576,665
050,51,095,"Virginia","James City County",2,73,1322,624,698
050,51,095,"Virginia","James City County",2,74,907,429,478
050,51,095,"Virginia","James City County",2,75,860,401,459
050,51,095,"Virginia","James City County",2,76,840,381,459
050,51,095,"Virginia","James City County",2,77,910,421,489
050,51,095,"Virginia","James City County",2,78,780,355,425
050,51,095,"Virginia","James City County",2,79,693,317,376
050,51,095,"Virginia","James City County",2,80,632,287,345
050,51,095,"Virginia","James City County",2,81,586,284,302
050,51,095,"Virginia","James City County",2,82,519,251,268
050,51,095,"Virginia","James City County",2,83,453,216,237
050,51,095,"Virginia","James City County",2,84,418,203,215
050,51,095,"Virginia","James City County",2,85,2286,951,1335
050,51,095,"Virginia","James City County",3,0,758,388,370
050,51,095,"Virginia","James City County",3,1,752,380,372
050,51,095,"Virginia","James City County",3,2,715,359,356
050,51,095,"Virginia","James City County",3,3,764,385,379
050,51,095,"Virginia","James City County",3,4,807,389,418
050,51,095,"Virginia","James City County",3,5,798,402,396
050,51,095,"Virginia","James City County",3,6,841,419,422
050,51,095,"Virginia","James City County",3,7,864,442,422
050,51,095,"Virginia","James City County",3,8,853,436,417
050,51,095,"Virginia","James City County",3,9,876,462,414
050,51,095,"Virginia","James City County",3,10,895,449,446
050,51,095,"Virginia","James City County",3,11,908,464,444
050,51,095,"Virginia","James City County",3,12,915,474,441
050,51,095,"Virginia","James City County",3,13,971,489,482
050,51,095,"Virginia","James City County",3,14,992,505,487
050,51,095,"Virginia","James City County",3,15,1001,512,489
050,51,095,"Virginia","James City County",3,16,981,496,485
050,51,095,"Virginia","James City County",3,17,996,502,494
050,51,095,"Virginia","James City County",3,18,855,450,405
050,51,095,"Virginia","James City County",3,19,713,375,338
050,51,095,"Virginia","James City County",3,20,758,395,363
050,51,095,"Virginia","James City County",3,21,783,420,363
050,51,095,"Virginia","James City County",3,22,813,404,409
050,51,095,"Virginia","James City County",3,23,737,372,365
050,51,095,"Virginia","James City County",3,24,756,368,388
050,51,095,"Virginia","James City County",3,25,758,390,368
050,51,095,"Virginia","James City County",3,26,788,411,377
050,51,095,"Virginia","James City County",3,27,705,377,328
050,51,095,"Virginia","James City County",3,28,778,403,375
050,51,095,"Virginia","James City County",3,29,766,387,379
050,51,095,"Virginia","James City County",3,30,792,388,404
050,51,095,"Virginia","James City County",3,31,803,369,434
050,51,095,"Virginia","James City County",3,32,819,397,422
050,51,095,"Virginia","James City County",3,33,792,394,398
050,51,095,"Virginia","James City County",3,34,851,408,443
050,51,095,"Virginia","James City County",3,35,907,453,454
050,51,095,"Virginia","James City County",3,36,927,452,475
050,51,095,"Virginia","James City County",3,37,902,436,466
050,51,095,"Virginia","James City County",3,38,967,486,481
050,51,095,"Virginia","James City County",3,39,993,493,500
050,51,095,"Virginia","James City County",3,40,931,437,494
050,51,095,"Virginia","James City County",3,41,944,473,471
050,51,095,"Virginia","James City County",3,42,903,456,447
050,51,095,"Virginia","James City County",3,43,918,459,459
050,51,095,"Virginia","James City County",3,44,846,401,445
050,51,095,"Virginia","James City County",3,45,834,396,438
050,51,095,"Virginia","James City County",3,46,893,431,462
050,51,095,"Virginia","James City County",3,47,848,398,450
050,51,095,"Virginia","James City County",3,48,915,445,470
050,51,095,"Virginia","James City County",3,49,931,445,486
050,51,095,"Virginia","James City County",3,50,973,479,494
050,51,095,"Virginia","James City County",3,51,974,460,514
050,51,095,"Virginia","James City County",3,52,996,500,496
050,51,095,"Virginia","James City County",3,53,988,491,497
050,51,095,"Virginia","James City County",3,54,1019,510,509
050,51,095,"Virginia","James City County",3,55,1024,503,521
050,51,095,"Virginia","James City County",3,56,1052,489,563
050,51,095,"Virginia","James City County",3,57,1126,531,595
050,51,095,"Virginia","James City County",3,58,1178,554,624
050,51,095,"Virginia","James City County",3,59,1157,541,616
050,51,095,"Virginia","James City County",3,60,1170,554,616
050,51,095,"Virginia","James City County",3,61,1176,554,622
050,51,095,"Virginia","James City County",3,62,1180,546,634
050,51,095,"Virginia","James City County",3,63,1138,539,599
050,51,095,"Virginia","James City County",3,64,1144,539,605
050,51,095,"Virginia","James City County",3,65,1141,529,612
050,51,095,"Virginia","James City County",3,66,1164,524,640
050,51,095,"Virginia","James City County",3,67,1198,555,643
050,51,095,"Virginia","James City County",3,68,1175,534,641
050,51,095,"Virginia","James City County",3,69,1185,543,642
050,51,095,"Virginia","James City County",3,70,1132,504,628
050,51,095,"Virginia","James City County",3,71,1092,491,601
050,51,095,"Virginia","James City County",3,72,1151,529,622
050,51,095,"Virginia","James City County",3,73,1233,567,666
050,51,095,"Virginia","James City County",3,74,1321,626,695
050,51,095,"Virginia","James City County",3,75,903,428,475
050,51,095,"Virginia","James City County",3,76,838,389,449
050,51,095,"Virginia","James City County",3,77,828,376,452
050,51,095,"Virginia","James City County",3,78,888,403,485
050,51,095,"Virginia","James City County",3,79,757,347,410
050,51,095,"Virginia","James City County",3,80,664,307,357
050,51,095,"Virginia","James City County",3,81,614,277,337
050,51,095,"Virginia","James City County",3,82,539,250,289
050,51,095,"Virginia","James City County",3,83,506,241,265
050,51,095,"Virginia","James City County",3,84,425,205,220
050,51,095,"Virginia","James City County",3,85,2329,978,1351
050,51,095,"Virginia","James City County",4,0,825,424,401
050,51,095,"Virginia","James City County",4,1,786,405,381
050,51,095,"Virginia","James City County",4,2,771,391,380
050,51,095,"Virginia","James City County",4,3,723,361,362
050,51,095,"Virginia","James City County",4,4,790,396,394
050,51,095,"Virginia","James City County",4,5,856,410,446
050,51,095,"Virginia","James City County",4,6,841,414,427
050,51,095,"Virginia","James City County",4,7,842,434,408
050,51,095,"Virginia","James City County",4,8,886,460,426
050,51,095,"Virginia","James City County",4,9,886,445,441
050,51,095,"Virginia","James City County",4,10,896,454,442
050,51,095,"Virginia","James City County",4,11,936,465,471
050,51,095,"Virginia","James City County",4,12,917,481,436
050,51,095,"Virginia","James City County",4,13,927,484,443
050,51,095,"Virginia","James City County",4,14,978,498,480
050,51,095,"Virginia","James City County",4,15,1022,518,504
050,51,095,"Virginia","James City County",4,16,1025,516,509
050,51,095,"Virginia","James City County",4,17,1013,515,498
050,51,095,"Virginia","James City County",4,18,864,450,414
050,51,095,"Virginia","James City County",4,19,702,359,343
050,51,095,"Virginia","James City County",4,20,765,410,355
050,51,095,"Virginia","James City County",4,21,778,395,383
050,51,095,"Virginia","James City County",4,22,840,434,406
050,51,095,"Virginia","James City County",4,23,813,413,400
050,51,095,"Virginia","James City County",4,24,765,382,383
050,51,095,"Virginia","James City County",4,25,758,364,394
050,51,095,"Virginia","James City County",4,26,781,405,376
050,51,095,"Virginia","James City County",4,27,771,396,375
050,51,095,"Virginia","James City County",4,28,721,382,339
050,51,095,"Virginia","James City County",4,29,783,409,374
050,51,095,"Virginia","James City County",4,30,768,385,383
050,51,095,"Virginia","James City County",4,31,765,369,396
050,51,095,"Virginia","James City County",4,32,875,394,481
050,51,095,"Virginia","James City County",4,33,884,426,458
050,51,095,"Virginia","James City County",4,34,849,413,436
050,51,095,"Virginia","James City County",4,35,902,433,469
050,51,095,"Virginia","James City County",4,36,939,471,468
050,51,095,"Virginia","James City County",4,37,956,479,477
050,51,095,"Virginia","James City County",4,38,931,438,493
050,51,095,"Virginia","James City County",4,39,997,506,491
050,51,095,"Virginia","James City County",4,40,994,497,497
050,51,095,"Virginia","James City County",4,41,947,444,503
050,51,095,"Virginia","James City County",4,42,971,490,481
050,51,095,"Virginia","James City County",4,43,901,463,438
050,51,095,"Virginia","James City County",4,44,965,480,485
050,51,095,"Virginia","James City County",4,45,868,409,459
050,51,095,"Virginia","James City County",4,46,864,419,445
050,51,095,"Virginia","James City County",4,47,901,422,479
050,51,095,"Virginia","James City County",4,48,857,413,444
050,51,095,"Virginia","James City County",4,49,931,456,475
050,51,095,"Virginia","James City County",4,50,930,437,493
050,51,095,"Virginia","James City County",4,51,989,486,503
050,51,095,"Virginia","James City County",4,52,994,482,512
050,51,095,"Virginia","James City County",4,53,1018,497,521
050,51,095,"Virginia","James City County",4,54,1009,495,514
050,51,095,"Virginia","James City County",4,55,1014,511,503
050,51,095,"Virginia","James City County",4,56,1051,512,539
050,51,095,"Virginia","James City County",4,57,1081,490,591
050,51,095,"Virginia","James City County",4,58,1147,549,598
050,51,095,"Virginia","James City County",4,59,1178,562,616
050,51,095,"Virginia","James City County",4,60,1186,556,630
050,51,095,"Virginia","James City County",4,61,1231,586,645
050,51,095,"Virginia","James City County",4,62,1206,563,643
050,51,095,"Virginia","James City County",4,63,1203,552,651
050,51,095,"Virginia","James City County",4,64,1176,543,633
050,51,095,"Virginia","James City County",4,65,1185,566,619
050,51,095,"Virginia","James City County",4,66,1183,545,638
050,51,095,"Virginia","James City County",4,67,1178,531,647
050,51,095,"Virginia","James City County",4,68,1223,567,656
050,51,095,"Virginia","James City County",4,69,1184,535,649
050,51,095,"Virginia","James City County",4,70,1206,543,663
050,51,095,"Virginia","James City County",4,71,1133,504,629
050,51,095,"Virginia","James City County",4,72,1090,491,599
050,51,095,"Virginia","James City County",4,73,1153,525,628
050,51,095,"Virginia","James City County",4,74,1236,566,670
050,51,095,"Virginia","James City County",4,75,1352,642,710
050,51,095,"Virginia","James City County",4,76,867,402,465
050,51,095,"Virginia","James City County",4,77,826,376,450
050,51,095,"Virginia","James City County",4,78,809,377,432
050,51,095,"Virginia","James City County",4,79,856,395,461
050,51,095,"Virginia","James City County",4,80,712,317,395
050,51,095,"Virginia","James City County",4,81,634,292,342
050,51,095,"Virginia","James City County",4,82,562,249,313
050,51,095,"Virginia","James City County",4,83,515,237,278
050,51,095,"Virginia","James City County",4,84,462,217,245
050,51,095,"Virginia","James City County",4,85,2378,1000,1378
050,51,095,"Virginia","James City County",5,0,818,419,399
050,51,095,"Virginia","James City County",5,1,821,437,384
050,51,095,"Virginia","James City County",5,2,797,424,373
050,51,095,"Virginia","James City County",5,3,782,381,401
050,51,095,"Virginia","James City County",5,4,750,380,370
050,51,095,"Virginia","James City County",5,5,828,416,412
050,51,095,"Virginia","James City County",5,6,874,415,459
050,51,095,"Virginia","James City County",5,7,857,434,423
050,51,095,"Virginia","James City County",5,8,889,444,445
050,51,095,"Virginia","James City County",5,9,902,464,438
050,51,095,"Virginia","James City County",5,10,916,450,466
050,51,095,"Virginia","James City County",5,11,930,468,462
050,51,095,"Virginia","James City County",5,12,974,483,491
050,51,095,"Virginia","James City County",5,13,962,513,449
050,51,095,"Virginia","James City County",5,14,962,481,481
050,51,095,"Virginia","James City County",5,15,994,511,483
050,51,095,"Virginia","James City County",5,16,1037,520,517
050,51,095,"Virginia","James City County",5,17,1028,507,521
050,51,095,"Virginia","James City County",5,18,855,454,401
050,51,095,"Virginia","James City County",5,19,726,376,350
050,51,095,"Virginia","James City County",5,20,773,404,369
050,51,095,"Virginia","James City County",5,21,799,416,383
050,51,095,"Virginia","James City County",5,22,801,413,388
050,51,095,"Virginia","James City County",5,23,815,412,403
050,51,095,"Virginia","James City County",5,24,805,399,406
050,51,095,"Virginia","James City County",5,25,725,364,361
050,51,095,"Virginia","James City County",5,26,699,339,360
050,51,095,"Virginia","James City County",5,27,776,413,363
050,51,095,"Virginia","James City County",5,28,759,388,371
050,51,095,"Virginia","James City County",5,29,749,390,359
050,51,095,"Virginia","James City County",5,30,807,418,389
050,51,095,"Virginia","James City County",5,31,791,392,399
050,51,095,"Virginia","James City County",5,32,795,373,422
050,51,095,"Virginia","James City County",5,33,878,405,473
050,51,095,"Virginia","James City County",5,34,890,437,453
050,51,095,"Virginia","James City County",5,35,838,401,437
050,51,095,"Virginia","James City County",5,36,918,440,478
050,51,095,"Virginia","James City County",5,37,975,505,470
050,51,095,"Virginia","James City County",5,38,949,462,487
050,51,095,"Virginia","James City County",5,39,962,469,493
050,51,095,"Virginia","James City County",5,40,1010,508,502
050,51,095,"Virginia","James City County",5,41,1028,503,525
050,51,095,"Virginia","James City County",5,42,961,448,513
050,51,095,"Virginia","James City County",5,43,1001,516,485
050,51,095,"Virginia","James City County",5,44,925,456,469
050,51,095,"Virginia","James City County",5,45,986,496,490
050,51,095,"Virginia","James City County",5,46,886,435,451
050,51,095,"Virginia","James City County",5,47,866,402,464
050,51,095,"Virginia","James City County",5,48,927,431,496
050,51,095,"Virginia","James City County",5,49,839,395,444
050,51,095,"Virginia","James City County",5,50,943,462,481
050,51,095,"Virginia","James City County",5,51,950,445,505
050,51,095,"Virginia","James City County",5,52,1015,494,521
050,51,095,"Virginia","James City County",5,53,1019,488,531
050,51,095,"Virginia","James City County",5,54,1058,517,541
050,51,095,"Virginia","James City County",5,55,1029,498,531
050,51,095,"Virginia","James City County",5,56,1045,531,514
050,51,095,"Virginia","James City County",5,57,1069,519,550
050,51,095,"Virginia","James City County",5,58,1116,513,603
050,51,095,"Virginia","James City County",5,59,1142,544,598
050,51,095,"Virginia","James City County",5,60,1220,596,624
050,51,095,"Virginia","James City County",5,61,1218,571,647
050,51,095,"Virginia","James City County",5,62,1233,581,652
050,51,095,"Virginia","James City County",5,63,1220,555,665
050,51,095,"Virginia","James City County",5,64,1225,566,659
050,51,095,"Virginia","James City County",5,65,1181,540,641
050,51,095,"Virginia","James City County",5,66,1217,576,641
050,51,095,"Virginia","James City County",5,67,1222,568,654
050,51,095,"Virginia","James City County",5,68,1192,539,653
050,51,095,"Virginia","James City County",5,69,1236,574,662
050,51,095,"Virginia","James City County",5,70,1205,546,659
050,51,095,"Virginia","James City County",5,71,1227,549,678
050,51,095,"Virginia","James City County",5,72,1131,506,625
050,51,095,"Virginia","James City County",5,73,1088,484,604
050,51,095,"Virginia","James City County",5,74,1163,528,635
050,51,095,"Virginia","James City County",5,75,1253,573,680
050,51,095,"Virginia","James City County",5,76,1325,632,693
050,51,095,"Virginia","James City County",5,77,856,396,460
050,51,095,"Virginia","James City County",5,78,808,367,441
050,51,095,"Virginia","James City County",5,79,790,377,413
050,51,095,"Virginia","James City County",5,80,826,377,449
050,51,095,"Virginia","James City County",5,81,693,309,384
050,51,095,"Virginia","James City County",5,82,590,269,321
050,51,095,"Virginia","James City County",5,83,552,242,310
050,51,095,"Virginia","James City County",5,84,472,211,261
050,51,095,"Virginia","James City County",5,85,2490,1061,1429
050,51,097,"Virginia","King and Queen County",1,0,56,29,27
050,51,097,"Virginia","King and Queen County",1,1,59,31,28
050,51,097,"Virginia","King and Queen County",1,2,69,36,33
050,51,097,"Virginia","King and Queen County",1,3,63,33,30
050,51,097,"Virginia","King and Queen County",1,4,58,30,28
050,51,097,"Virginia","King and Queen County",1,5,67,39,28
050,51,097,"Virginia","King and Queen County",1,6,60,29,31
050,51,097,"Virginia","King and Queen County",1,7,59,26,33
050,51,097,"Virginia","King and Queen County",1,8,63,28,35
050,51,097,"Virginia","King and Queen County",1,9,64,33,31
050,51,097,"Virginia","King and Queen County",1,10,66,42,24
050,51,097,"Virginia","King and Queen County",1,11,58,32,26
050,51,097,"Virginia","King and Queen County",1,12,75,38,37
050,51,097,"Virginia","King and Queen County",1,13,67,31,36
050,51,097,"Virginia","King and Queen County",1,14,64,32,32
050,51,097,"Virginia","King and Queen County",1,15,76,42,34
050,51,097,"Virginia","King and Queen County",1,16,81,39,42
050,51,097,"Virginia","King and Queen County",1,17,66,30,36
050,51,097,"Virginia","King and Queen County",1,18,63,31,32
050,51,097,"Virginia","King and Queen County",1,19,56,33,23
050,51,097,"Virginia","King and Queen County",1,20,59,38,21
050,51,097,"Virginia","King and Queen County",1,21,57,33,24
050,51,097,"Virginia","King and Queen County",1,22,64,37,27
050,51,097,"Virginia","King and Queen County",1,23,64,34,30
050,51,097,"Virginia","King and Queen County",1,24,60,28,32
050,51,097,"Virginia","King and Queen County",1,25,82,47,35
050,51,097,"Virginia","King and Queen County",1,26,64,37,27
050,51,097,"Virginia","King and Queen County",1,27,71,36,35
050,51,097,"Virginia","King and Queen County",1,28,49,27,22
050,51,097,"Virginia","King and Queen County",1,29,67,35,32
050,51,097,"Virginia","King and Queen County",1,30,88,44,44
050,51,097,"Virginia","King and Queen County",1,31,80,43,37
050,51,097,"Virginia","King and Queen County",1,32,61,34,27
050,51,097,"Virginia","King and Queen County",1,33,77,41,36
050,51,097,"Virginia","King and Queen County",1,34,60,38,22
050,51,097,"Virginia","King and Queen County",1,35,72,40,32
050,51,097,"Virginia","King and Queen County",1,36,71,37,34
050,51,097,"Virginia","King and Queen County",1,37,66,37,29
050,51,097,"Virginia","King and Queen County",1,38,59,25,34
050,51,097,"Virginia","King and Queen County",1,39,71,32,39
050,51,097,"Virginia","King and Queen County",1,40,73,42,31
050,51,097,"Virginia","King and Queen County",1,41,77,45,32
050,51,097,"Virginia","King and Queen County",1,42,78,44,34
050,51,097,"Virginia","King and Queen County",1,43,70,42,28
050,51,097,"Virginia","King and Queen County",1,44,65,32,33
050,51,097,"Virginia","King and Queen County",1,45,64,32,32
050,51,097,"Virginia","King and Queen County",1,46,63,33,30
050,51,097,"Virginia","King and Queen County",1,47,72,41,31
050,51,097,"Virginia","King and Queen County",1,48,90,47,43
050,51,097,"Virginia","King and Queen County",1,49,107,51,56
050,51,097,"Virginia","King and Queen County",1,50,96,49,47
050,51,097,"Virginia","King and Queen County",1,51,92,46,46
050,51,097,"Virginia","King and Queen County",1,52,89,42,47
050,51,097,"Virginia","King and Queen County",1,53,102,48,54
050,51,097,"Virginia","King and Queen County",1,54,98,48,50
050,51,097,"Virginia","King and Queen County",1,55,127,66,61
050,51,097,"Virginia","King and Queen County",1,56,118,63,55
050,51,097,"Virginia","King and Queen County",1,57,121,70,51
050,51,097,"Virginia","King and Queen County",1,58,115,61,54
050,51,097,"Virginia","King and Queen County",1,59,119,65,54
050,51,097,"Virginia","King and Queen County",1,60,120,56,64
050,51,097,"Virginia","King and Queen County",1,61,115,61,54
050,51,097,"Virginia","King and Queen County",1,62,128,71,57
050,51,097,"Virginia","King and Queen County",1,63,121,66,55
050,51,097,"Virginia","King and Queen County",1,64,123,68,55
050,51,097,"Virginia","King and Queen County",1,65,112,56,56
050,51,097,"Virginia","King and Queen County",1,66,112,49,63
050,51,097,"Virginia","King and Queen County",1,67,106,41,65
050,51,097,"Virginia","King and Queen County",1,68,101,47,54
050,51,097,"Virginia","King and Queen County",1,69,94,50,44
050,51,097,"Virginia","King and Queen County",1,70,89,49,40
050,51,097,"Virginia","King and Queen County",1,71,82,43,39
050,51,097,"Virginia","King and Queen County",1,72,86,44,42
050,51,097,"Virginia","King and Queen County",1,73,80,39,41
050,51,097,"Virginia","King and Queen County",1,74,61,33,28
050,51,097,"Virginia","King and Queen County",1,75,65,35,30
050,51,097,"Virginia","King and Queen County",1,76,64,31,33
050,51,097,"Virginia","King and Queen County",1,77,64,28,36
050,51,097,"Virginia","King and Queen County",1,78,56,27,29
050,51,097,"Virginia","King and Queen County",1,79,47,23,24
050,51,097,"Virginia","King and Queen County",1,80,40,17,23
050,51,097,"Virginia","King and Queen County",1,81,26,10,16
050,51,097,"Virginia","King and Queen County",1,82,28,12,16
050,51,097,"Virginia","King and Queen County",1,83,27,9,18
050,51,097,"Virginia","King and Queen County",1,84,22,10,12
050,51,097,"Virginia","King and Queen County",1,85,169,65,104
050,51,097,"Virginia","King and Queen County",2,0,52,28,24
050,51,097,"Virginia","King and Queen County",2,1,58,31,27
050,51,097,"Virginia","King and Queen County",2,2,67,34,33
050,51,097,"Virginia","King and Queen County",2,3,63,33,30
050,51,097,"Virginia","King and Queen County",2,4,59,31,28
050,51,097,"Virginia","King and Queen County",2,5,64,36,28
050,51,097,"Virginia","King and Queen County",2,6,60,30,30
050,51,097,"Virginia","King and Queen County",2,7,58,25,33
050,51,097,"Virginia","King and Queen County",2,8,61,27,34
050,51,097,"Virginia","King and Queen County",2,9,65,32,33
050,51,097,"Virginia","King and Queen County",2,10,66,39,27
050,51,097,"Virginia","King and Queen County",2,11,60,34,26
050,51,097,"Virginia","King and Queen County",2,12,71,37,34
050,51,097,"Virginia","King and Queen County",2,13,69,32,37
050,51,097,"Virginia","King and Queen County",2,14,66,32,34
050,51,097,"Virginia","King and Queen County",2,15,74,40,34
050,51,097,"Virginia","King and Queen County",2,16,80,40,40
050,51,097,"Virginia","King and Queen County",2,17,68,31,37
050,51,097,"Virginia","King and Queen County",2,18,61,30,31
050,51,097,"Virginia","King and Queen County",2,19,55,32,23
050,51,097,"Virginia","King and Queen County",2,20,60,37,23
050,51,097,"Virginia","King and Queen County",2,21,56,33,23
050,51,097,"Virginia","King and Queen County",2,22,61,36,25
050,51,097,"Virginia","King and Queen County",2,23,65,36,29
050,51,097,"Virginia","King and Queen County",2,24,61,30,31
050,51,097,"Virginia","King and Queen County",2,25,76,43,33
050,51,097,"Virginia","King and Queen County",2,26,67,39,28
050,51,097,"Virginia","King and Queen County",2,27,67,36,31
050,51,097,"Virginia","King and Queen County",2,28,54,29,25
050,51,097,"Virginia","King and Queen County",2,29,61,32,29
050,51,097,"Virginia","King and Queen County",2,30,81,40,41
050,51,097,"Virginia","King and Queen County",2,31,81,42,39
050,51,097,"Virginia","King and Queen County",2,32,67,36,31
050,51,097,"Virginia","King and Queen County",2,33,74,39,35
050,51,097,"Virginia","King and Queen County",2,34,62,38,24
050,51,097,"Virginia","King and Queen County",2,35,69,39,30
050,51,097,"Virginia","King and Queen County",2,36,70,38,32
050,51,097,"Virginia","King and Queen County",2,37,67,37,30
050,51,097,"Virginia","King and Queen County",2,38,62,29,33
050,51,097,"Virginia","King and Queen County",2,39,70,31,39
050,51,097,"Virginia","King and Queen County",2,40,73,39,34
050,51,097,"Virginia","King and Queen County",2,41,79,47,32
050,51,097,"Virginia","King and Queen County",2,42,78,45,33
050,51,097,"Virginia","King and Queen County",2,43,71,42,29
050,51,097,"Virginia","King and Queen County",2,44,66,34,32
050,51,097,"Virginia","King and Queen County",2,45,65,32,33
050,51,097,"Virginia","King and Queen County",2,46,63,33,30
050,51,097,"Virginia","King and Queen County",2,47,71,39,32
050,51,097,"Virginia","King and Queen County",2,48,86,45,41
050,51,097,"Virginia","King and Queen County",2,49,105,51,54
050,51,097,"Virginia","King and Queen County",2,50,97,47,50
050,51,097,"Virginia","King and Queen County",2,51,92,46,46
050,51,097,"Virginia","King and Queen County",2,52,88,42,46
050,51,097,"Virginia","King and Queen County",2,53,98,47,51
050,51,097,"Virginia","King and Queen County",2,54,100,48,52
050,51,097,"Virginia","King and Queen County",2,55,121,61,60
050,51,097,"Virginia","King and Queen County",2,56,121,64,57
050,51,097,"Virginia","King and Queen County",2,57,121,69,52
050,51,097,"Virginia","King and Queen County",2,58,117,64,53
050,51,097,"Virginia","King and Queen County",2,59,118,63,55
050,51,097,"Virginia","King and Queen County",2,60,119,58,61
050,51,097,"Virginia","King and Queen County",2,61,117,60,57
050,51,097,"Virginia","King and Queen County",2,62,124,68,56
050,51,097,"Virginia","King and Queen County",2,63,124,68,56
050,51,097,"Virginia","King and Queen County",2,64,122,67,55
050,51,097,"Virginia","King and Queen County",2,65,116,59,57
050,51,097,"Virginia","King and Queen County",2,66,113,51,62
050,51,097,"Virginia","King and Queen County",2,67,106,42,64
050,51,097,"Virginia","King and Queen County",2,68,101,45,56
050,51,097,"Virginia","King and Queen County",2,69,95,49,46
050,51,097,"Virginia","King and Queen County",2,70,89,47,42
050,51,097,"Virginia","King and Queen County",2,71,84,44,40
050,51,097,"Virginia","King and Queen County",2,72,83,43,40
050,51,097,"Virginia","King and Queen County",2,73,86,43,43
050,51,097,"Virginia","King and Queen County",2,74,63,33,30
050,51,097,"Virginia","King and Queen County",2,75,62,33,29
050,51,097,"Virginia","King and Queen County",2,76,61,29,32
050,51,097,"Virginia","King and Queen County",2,77,63,28,35
050,51,097,"Virginia","King and Queen County",2,78,55,25,30
050,51,097,"Virginia","King and Queen County",2,79,47,23,24
050,51,097,"Virginia","King and Queen County",2,80,41,17,24
050,51,097,"Virginia","King and Queen County",2,81,30,12,18
050,51,097,"Virginia","King and Queen County",2,82,29,12,17
050,51,097,"Virginia","King and Queen County",2,83,27,10,17
050,51,097,"Virginia","King and Queen County",2,84,22,9,13
050,51,097,"Virginia","King and Queen County",2,85,171,66,105
050,51,097,"Virginia","King and Queen County",3,0,56,30,26
050,51,097,"Virginia","King and Queen County",3,1,60,32,28
050,51,097,"Virginia","King and Queen County",3,2,59,32,27
050,51,097,"Virginia","King and Queen County",3,3,70,35,35
050,51,097,"Virginia","King and Queen County",3,4,60,34,26
050,51,097,"Virginia","King and Queen County",3,5,58,36,22
050,51,097,"Virginia","King and Queen County",3,6,61,34,27
050,51,097,"Virginia","King and Queen County",3,7,60,30,30
050,51,097,"Virginia","King and Queen County",3,8,55,24,31
050,51,097,"Virginia","King and Queen County",3,9,69,33,36
050,51,097,"Virginia","King and Queen County",3,10,67,32,35
050,51,097,"Virginia","King and Queen County",3,11,69,39,30
050,51,097,"Virginia","King and Queen County",3,12,61,37,24
050,51,097,"Virginia","King and Queen County",3,13,61,31,30
050,51,097,"Virginia","King and Queen County",3,14,69,33,36
050,51,097,"Virginia","King and Queen County",3,15,67,30,37
050,51,097,"Virginia","King and Queen County",3,16,71,38,33
050,51,097,"Virginia","King and Queen County",3,17,72,33,39
050,51,097,"Virginia","King and Queen County",3,18,60,26,34
050,51,097,"Virginia","King and Queen County",3,19,58,27,31
050,51,097,"Virginia","King and Queen County",3,20,63,34,29
050,51,097,"Virginia","King and Queen County",3,21,66,38,28
050,51,097,"Virginia","King and Queen County",3,22,67,40,27
050,51,097,"Virginia","King and Queen County",3,23,82,50,32
050,51,097,"Virginia","King and Queen County",3,24,67,40,27
050,51,097,"Virginia","King and Queen County",3,25,62,28,34
050,51,097,"Virginia","King and Queen County",3,26,77,45,32
050,51,097,"Virginia","King and Queen County",3,27,70,40,30
050,51,097,"Virginia","King and Queen County",3,28,63,35,28
050,51,097,"Virginia","King and Queen County",3,29,54,29,25
050,51,097,"Virginia","King and Queen County",3,30,67,31,36
050,51,097,"Virginia","King and Queen County",3,31,73,36,37
050,51,097,"Virginia","King and Queen County",3,32,80,43,37
050,51,097,"Virginia","King and Queen County",3,33,65,38,27
050,51,097,"Virginia","King and Queen County",3,34,77,40,37
050,51,097,"Virginia","King and Queen County",3,35,64,37,27
050,51,097,"Virginia","King and Queen County",3,36,72,43,29
050,51,097,"Virginia","King and Queen County",3,37,74,37,37
050,51,097,"Virginia","King and Queen County",3,38,67,41,26
050,51,097,"Virginia","King and Queen County",3,39,64,30,34
050,51,097,"Virginia","King and Queen County",3,40,74,34,40
050,51,097,"Virginia","King and Queen County",3,41,72,38,34
050,51,097,"Virginia","King and Queen County",3,42,84,50,34
050,51,097,"Virginia","King and Queen County",3,43,86,48,38
050,51,097,"Virginia","King and Queen County",3,44,70,42,28
050,51,097,"Virginia","King and Queen County",3,45,66,29,37
050,51,097,"Virginia","King and Queen County",3,46,65,32,33
050,51,097,"Virginia","King and Queen County",3,47,71,38,33
050,51,097,"Virginia","King and Queen County",3,48,75,38,37
050,51,097,"Virginia","King and Queen County",3,49,82,41,41
050,51,097,"Virginia","King and Queen County",3,50,106,51,55
050,51,097,"Virginia","King and Queen County",3,51,103,52,51
050,51,097,"Virginia","King and Queen County",3,52,96,48,48
050,51,097,"Virginia","King and Queen County",3,53,92,46,46
050,51,097,"Virginia","King and Queen County",3,54,101,47,54
050,51,097,"Virginia","King and Queen County",3,55,102,47,55
050,51,097,"Virginia","King and Queen County",3,56,123,62,61
050,51,097,"Virginia","King and Queen County",3,57,128,68,60
050,51,097,"Virginia","King and Queen County",3,58,131,72,59
050,51,097,"Virginia","King and Queen County",3,59,118,66,52
050,51,097,"Virginia","King and Queen County",3,60,110,60,50
050,51,097,"Virginia","King and Queen County",3,61,125,61,64
050,51,097,"Virginia","King and Queen County",3,62,117,57,60
050,51,097,"Virginia","King and Queen County",3,63,124,66,58
050,51,097,"Virginia","King and Queen County",3,64,127,71,56
050,51,097,"Virginia","King and Queen County",3,65,120,64,56
050,51,097,"Virginia","King and Queen County",3,66,114,58,56
050,51,097,"Virginia","King and Queen County",3,67,111,51,60
050,51,097,"Virginia","King and Queen County",3,68,103,40,63
050,51,097,"Virginia","King and Queen County",3,69,102,45,57
050,51,097,"Virginia","King and Queen County",3,70,92,49,43
050,51,097,"Virginia","King and Queen County",3,71,88,47,41
050,51,097,"Virginia","King and Queen County",3,72,82,44,38
050,51,097,"Virginia","King and Queen County",3,73,80,39,41
050,51,097,"Virginia","King and Queen County",3,74,81,40,41
050,51,097,"Virginia","King and Queen County",3,75,59,31,28
050,51,097,"Virginia","King and Queen County",3,76,60,32,28
050,51,097,"Virginia","King and Queen County",3,77,61,28,33
050,51,097,"Virginia","King and Queen County",3,78,58,26,32
050,51,097,"Virginia","King and Queen County",3,79,50,23,27
050,51,097,"Virginia","King and Queen County",3,80,43,18,25
050,51,097,"Virginia","King and Queen County",3,81,35,13,22
050,51,097,"Virginia","King and Queen County",3,82,29,13,16
050,51,097,"Virginia","King and Queen County",3,83,26,10,16
050,51,097,"Virginia","King and Queen County",3,84,25,9,16
050,51,097,"Virginia","King and Queen County",3,85,165,66,99
050,51,097,"Virginia","King and Queen County",4,0,47,20,27
050,51,097,"Virginia","King and Queen County",4,1,63,35,28
050,51,097,"Virginia","King and Queen County",4,2,72,40,32
050,51,097,"Virginia","King and Queen County",4,3,67,39,28
050,51,097,"Virginia","King and Queen County",4,4,67,31,36
050,51,097,"Virginia","King and Queen County",4,5,66,35,31
050,51,097,"Virginia","King and Queen County",4,6,60,37,23
050,51,097,"Virginia","King and Queen County",4,7,58,34,24
050,51,097,"Virginia","King and Queen County",4,8,63,32,31
050,51,097,"Virginia","King and Queen County",4,9,62,27,35
050,51,097,"Virginia","King and Queen County",4,10,78,34,44
050,51,097,"Virginia","King and Queen County",4,11,69,33,36
050,51,097,"Virginia","King and Queen County",4,12,72,39,33
050,51,097,"Virginia","King and Queen County",4,13,65,39,26
050,51,097,"Virginia","King and Queen County",4,14,65,34,31
050,51,097,"Virginia","King and Queen County",4,15,69,35,34
050,51,097,"Virginia","King and Queen County",4,16,66,31,35
050,51,097,"Virginia","King and Queen County",4,17,74,39,35
050,51,097,"Virginia","King and Queen County",4,18,63,31,32
050,51,097,"Virginia","King and Queen County",4,19,48,23,25
050,51,097,"Virginia","King and Queen County",4,20,60,27,33
050,51,097,"Virginia","King and Queen County",4,21,65,35,30
050,51,097,"Virginia","King and Queen County",4,22,66,39,27
050,51,097,"Virginia","King and Queen County",4,23,73,43,30
050,51,097,"Virginia","King and Queen County",4,24,79,44,35
050,51,097,"Virginia","King and Queen County",4,25,72,44,28
050,51,097,"Virginia","King and Queen County",4,26,73,35,38
050,51,097,"Virginia","King and Queen County",4,27,77,46,31
050,51,097,"Virginia","King and Queen County",4,28,69,37,32
050,51,097,"Virginia","King and Queen County",4,29,68,35,33
050,51,097,"Virginia","King and Queen County",4,30,70,37,33
050,51,097,"Virginia","King and Queen County",4,31,72,33,39
050,51,097,"Virginia","King and Queen County",4,32,79,40,39
050,51,097,"Virginia","King and Queen County",4,33,77,39,38
050,51,097,"Virginia","King and Queen County",4,34,74,40,34
050,51,097,"Virginia","King and Queen County",4,35,76,40,36
050,51,097,"Virginia","King and Queen County",4,36,62,36,26
050,51,097,"Virginia","King and Queen County",4,37,71,44,27
050,51,097,"Virginia","King and Queen County",4,38,74,37,37
050,51,097,"Virginia","King and Queen County",4,39,67,39,28
050,51,097,"Virginia","King and Queen County",4,40,69,31,38
050,51,097,"Virginia","King and Queen County",4,41,69,28,41
050,51,097,"Virginia","King and Queen County",4,42,83,43,40
050,51,097,"Virginia","King and Queen County",4,43,88,51,37
050,51,097,"Virginia","King and Queen County",4,44,78,42,36
050,51,097,"Virginia","King and Queen County",4,45,65,38,27
050,51,097,"Virginia","King and Queen County",4,46,73,32,41
050,51,097,"Virginia","King and Queen County",4,47,67,34,33
050,51,097,"Virginia","King and Queen County",4,48,73,39,34
050,51,097,"Virginia","King and Queen County",4,49,80,39,41
050,51,097,"Virginia","King and Queen County",4,50,76,38,38
050,51,097,"Virginia","King and Queen County",4,51,106,52,54
050,51,097,"Virginia","King and Queen County",4,52,100,52,48
050,51,097,"Virginia","King and Queen County",4,53,104,50,54
050,51,097,"Virginia","King and Queen County",4,54,92,46,46
050,51,097,"Virginia","King and Queen County",4,55,102,49,53
050,51,097,"Virginia","King and Queen County",4,56,97,42,55
050,51,097,"Virginia","King and Queen County",4,57,118,57,61
050,51,097,"Virginia","King and Queen County",4,58,133,74,59
050,51,097,"Virginia","King and Queen County",4,59,126,67,59
050,51,097,"Virginia","King and Queen County",4,60,112,63,49
050,51,097,"Virginia","King and Queen County",4,61,108,59,49
050,51,097,"Virginia","King and Queen County",4,62,122,63,59
050,51,097,"Virginia","King and Queen County",4,63,113,54,59
050,51,097,"Virginia","King and Queen County",4,64,117,62,55
050,51,097,"Virginia","King and Queen County",4,65,124,71,53
050,51,097,"Virginia","King and Queen County",4,66,117,63,54
050,51,097,"Virginia","King and Queen County",4,67,112,56,56
050,51,097,"Virginia","King and Queen County",4,68,114,51,63
050,51,097,"Virginia","King and Queen County",4,69,105,41,64
050,51,097,"Virginia","King and Queen County",4,70,96,42,54
050,51,097,"Virginia","King and Queen County",4,71,89,47,42
050,51,097,"Virginia","King and Queen County",4,72,89,50,39
050,51,097,"Virginia","King and Queen County",4,73,81,42,39
050,51,097,"Virginia","King and Queen County",4,74,78,38,40
050,51,097,"Virginia","King and Queen County",4,75,81,40,41
050,51,097,"Virginia","King and Queen County",4,76,57,30,27
050,51,097,"Virginia","King and Queen County",4,77,55,27,28
050,51,097,"Virginia","King and Queen County",4,78,54,27,27
050,51,097,"Virginia","King and Queen County",4,79,54,23,31
050,51,097,"Virginia","King and Queen County",4,80,43,18,25
050,51,097,"Virginia","King and Queen County",4,81,40,16,24
050,51,097,"Virginia","King and Queen County",4,82,33,13,20
050,51,097,"Virginia","King and Queen County",4,83,24,10,14
050,51,097,"Virginia","King and Queen County",4,84,22,8,14
050,51,097,"Virginia","King and Queen County",4,85,157,62,95
050,51,097,"Virginia","King and Queen County",5,0,47,20,27
050,51,097,"Virginia","King and Queen County",5,1,60,26,34
050,51,097,"Virginia","King and Queen County",5,2,58,31,27
050,51,097,"Virginia","King and Queen County",5,3,73,42,31
050,51,097,"Virginia","King and Queen County",5,4,67,36,31
050,51,097,"Virginia","King and Queen County",5,5,61,28,33
050,51,097,"Virginia","King and Queen County",5,6,61,31,30
050,51,097,"Virginia","King and Queen County",5,7,63,37,26
050,51,097,"Virginia","King and Queen County",5,8,60,32,28
050,51,097,"Virginia","King and Queen County",5,9,62,32,30
050,51,097,"Virginia","King and Queen County",5,10,64,25,39
050,51,097,"Virginia","King and Queen County",5,11,74,32,42
050,51,097,"Virginia","King and Queen County",5,12,62,32,30
050,51,097,"Virginia","King and Queen County",5,13,67,38,29
050,51,097,"Virginia","King and Queen County",5,14,59,33,26
050,51,097,"Virginia","King and Queen County",5,15,71,36,35
050,51,097,"Virginia","King and Queen County",5,16,65,32,33
050,51,097,"Virginia","King and Queen County",5,17,63,31,32
050,51,097,"Virginia","King and Queen County",5,18,60,34,26
050,51,097,"Virginia","King and Queen County",5,19,58,30,28
050,51,097,"Virginia","King and Queen County",5,20,53,23,30
050,51,097,"Virginia","King and Queen County",5,21,62,27,35
050,51,097,"Virginia","King and Queen County",5,22,75,39,36
050,51,097,"Virginia","King and Queen County",5,23,65,36,29
050,51,097,"Virginia","King and Queen County",5,24,81,49,32
050,51,097,"Virginia","King and Queen County",5,25,86,47,39
050,51,097,"Virginia","King and Queen County",5,26,80,49,31
050,51,097,"Virginia","King and Queen County",5,27,73,36,37
050,51,097,"Virginia","King and Queen County",5,28,79,45,34
050,51,097,"Virginia","King and Queen County",5,29,74,41,33
050,51,097,"Virginia","King and Queen County",5,30,65,35,30
050,51,097,"Virginia","King and Queen County",5,31,71,36,35
050,51,097,"Virginia","King and Queen County",5,32,75,38,37
050,51,097,"Virginia","King and Queen County",5,33,80,43,37
050,51,097,"Virginia","King and Queen County",5,34,82,41,41
050,51,097,"Virginia","King and Queen County",5,35,80,46,34
050,51,097,"Virginia","King and Queen County",5,36,72,37,35
050,51,097,"Virginia","King and Queen County",5,37,63,37,26
050,51,097,"Virginia","King and Queen County",5,38,70,42,28
050,51,097,"Virginia","King and Queen County",5,39,77,38,39
050,51,097,"Virginia","King and Queen County",5,40,64,38,26
050,51,097,"Virginia","King and Queen County",5,41,69,30,39
050,51,097,"Virginia","King and Queen County",5,42,73,29,44
050,51,097,"Virginia","King and Queen County",5,43,83,39,44
050,51,097,"Virginia","King and Queen County",5,44,84,50,34
050,51,097,"Virginia","King and Queen County",5,45,72,37,35
050,51,097,"Virginia","King and Queen County",5,46,68,37,31
050,51,097,"Virginia","King and Queen County",5,47,73,30,43
050,51,097,"Virginia","King and Queen County",5,48,68,34,34
050,51,097,"Virginia","King and Queen County",5,49,77,39,38
050,51,097,"Virginia","King and Queen County",5,50,72,33,39
050,51,097,"Virginia","King and Queen County",5,51,76,39,37
050,51,097,"Virginia","King and Queen County",5,52,105,51,54
050,51,097,"Virginia","King and Queen County",5,53,104,55,49
050,51,097,"Virginia","King and Queen County",5,54,102,49,53
050,51,097,"Virginia","King and Queen County",5,55,95,46,49
050,51,097,"Virginia","King and Queen County",5,56,101,46,55
050,51,097,"Virginia","King and Queen County",5,57,98,44,54
050,51,097,"Virginia","King and Queen County",5,58,122,60,62
050,51,097,"Virginia","King and Queen County",5,59,131,71,60
050,51,097,"Virginia","King and Queen County",5,60,123,63,60
050,51,097,"Virginia","King and Queen County",5,61,122,69,53
050,51,097,"Virginia","King and Queen County",5,62,112,60,52
050,51,097,"Virginia","King and Queen County",5,63,124,63,61
050,51,097,"Virginia","King and Queen County",5,64,113,53,60
050,51,097,"Virginia","King and Queen County",5,65,118,60,58
050,51,097,"Virginia","King and Queen County",5,66,117,67,50
050,51,097,"Virginia","King and Queen County",5,67,120,64,56
050,51,097,"Virginia","King and Queen County",5,68,114,56,58
050,51,097,"Virginia","King and Queen County",5,69,112,51,61
050,51,097,"Virginia","King and Queen County",5,70,99,37,62
050,51,097,"Virginia","King and Queen County",5,71,91,40,51
050,51,097,"Virginia","King and Queen County",5,72,87,47,40
050,51,097,"Virginia","King and Queen County",5,73,90,49,41
050,51,097,"Virginia","King and Queen County",5,74,77,39,38
050,51,097,"Virginia","King and Queen County",5,75,76,36,40
050,51,097,"Virginia","King and Queen County",5,76,79,37,42
050,51,097,"Virginia","King and Queen County",5,77,54,27,27
050,51,097,"Virginia","King and Queen County",5,78,51,28,23
050,51,097,"Virginia","King and Queen County",5,79,53,27,26
050,51,097,"Virginia","King and Queen County",5,80,46,17,29
050,51,097,"Virginia","King and Queen County",5,81,42,17,25
050,51,097,"Virginia","King and Queen County",5,82,42,16,26
050,51,097,"Virginia","King and Queen County",5,83,30,11,19
050,51,097,"Virginia","King and Queen County",5,84,24,11,13
050,51,097,"Virginia","King and Queen County",5,85,149,61,88
050,51,099,"Virginia","King George County",1,0,298,154,144
050,51,099,"Virginia","King George County",1,1,319,160,159
050,51,099,"Virginia","King George County",1,2,303,132,171
050,51,099,"Virginia","King George County",1,3,305,170,135
050,51,099,"Virginia","King George County",1,4,325,174,151
050,51,099,"Virginia","King George County",1,5,354,181,173
050,51,099,"Virginia","King George County",1,6,366,186,180
050,51,099,"Virginia","King George County",1,7,362,192,170
050,51,099,"Virginia","King George County",1,8,391,206,185
050,51,099,"Virginia","King George County",1,9,377,203,174
050,51,099,"Virginia","King George County",1,10,378,190,188
050,51,099,"Virginia","King George County",1,11,433,224,209
050,51,099,"Virginia","King George County",1,12,449,222,227
050,51,099,"Virginia","King George County",1,13,422,221,201
050,51,099,"Virginia","King George County",1,14,387,204,183
050,51,099,"Virginia","King George County",1,15,403,214,189
050,51,099,"Virginia","King George County",1,16,385,195,190
050,51,099,"Virginia","King George County",1,17,382,186,196
050,51,099,"Virginia","King George County",1,18,311,154,157
050,51,099,"Virginia","King George County",1,19,264,140,124
050,51,099,"Virginia","King George County",1,20,334,191,143
050,51,099,"Virginia","King George County",1,21,319,168,151
050,51,099,"Virginia","King George County",1,22,317,177,140
050,51,099,"Virginia","King George County",1,23,293,160,133
050,51,099,"Virginia","King George County",1,24,300,155,145
050,51,099,"Virginia","King George County",1,25,300,156,144
050,51,099,"Virginia","King George County",1,26,340,183,157
050,51,099,"Virginia","King George County",1,27,307,168,139
050,51,099,"Virginia","King George County",1,28,303,157,146
050,51,099,"Virginia","King George County",1,29,344,174,170
050,51,099,"Virginia","King George County",1,30,316,146,170
050,51,099,"Virginia","King George County",1,31,360,186,174
050,51,099,"Virginia","King George County",1,32,356,193,163
050,51,099,"Virginia","King George County",1,33,373,207,166
050,51,099,"Virginia","King George County",1,34,360,172,188
050,51,099,"Virginia","King George County",1,35,342,170,172
050,51,099,"Virginia","King George County",1,36,358,172,186
050,51,099,"Virginia","King George County",1,37,402,192,210
050,51,099,"Virginia","King George County",1,38,405,202,203
050,51,099,"Virginia","King George County",1,39,363,185,178
050,51,099,"Virginia","King George County",1,40,378,192,186
050,51,099,"Virginia","King George County",1,41,388,201,187
050,51,099,"Virginia","King George County",1,42,353,176,177
050,51,099,"Virginia","King George County",1,43,330,176,154
050,51,099,"Virginia","King George County",1,44,351,177,174
050,51,099,"Virginia","King George County",1,45,377,191,186
050,51,099,"Virginia","King George County",1,46,345,178,167
050,51,099,"Virginia","King George County",1,47,322,171,151
050,51,099,"Virginia","King George County",1,48,350,184,166
050,51,099,"Virginia","King George County",1,49,370,184,186
050,51,099,"Virginia","King George County",1,50,364,179,185
050,51,099,"Virginia","King George County",1,51,375,195,180
050,51,099,"Virginia","King George County",1,52,384,207,177
050,51,099,"Virginia","King George County",1,53,367,186,181
050,51,099,"Virginia","King George County",1,54,375,181,194
050,51,099,"Virginia","King George County",1,55,409,194,215
050,51,099,"Virginia","King George County",1,56,423,207,216
050,51,099,"Virginia","King George County",1,57,412,205,207
050,51,099,"Virginia","King George County",1,58,391,201,190
050,51,099,"Virginia","King George County",1,59,379,196,183
050,51,099,"Virginia","King George County",1,60,377,187,190
050,51,099,"Virginia","King George County",1,61,338,160,178
050,51,099,"Virginia","King George County",1,62,326,162,164
050,51,099,"Virginia","King George County",1,63,322,151,171
050,51,099,"Virginia","King George County",1,64,294,161,133
050,51,099,"Virginia","King George County",1,65,284,152,132
050,51,099,"Virginia","King George County",1,66,269,137,132
050,51,099,"Virginia","King George County",1,67,247,133,114
050,51,099,"Virginia","King George County",1,68,241,131,110
050,51,099,"Virginia","King George County",1,69,217,95,122
050,51,099,"Virginia","King George County",1,70,203,95,108
050,51,099,"Virginia","King George County",1,71,196,102,94
050,51,099,"Virginia","King George County",1,72,202,110,92
050,51,099,"Virginia","King George County",1,73,211,112,99
050,51,099,"Virginia","King George County",1,74,165,76,89
050,51,099,"Virginia","King George County",1,75,154,72,82
050,51,099,"Virginia","King George County",1,76,153,68,85
050,51,099,"Virginia","King George County",1,77,137,54,83
050,51,099,"Virginia","King George County",1,78,119,61,58
050,51,099,"Virginia","King George County",1,79,112,60,52
050,51,099,"Virginia","King George County",1,80,93,44,49
050,51,099,"Virginia","King George County",1,81,83,37,46
050,51,099,"Virginia","King George County",1,82,85,37,48
050,51,099,"Virginia","King George County",1,83,72,34,38
050,51,099,"Virginia","King George County",1,84,54,30,24
050,51,099,"Virginia","King George County",1,85,321,123,198
050,51,099,"Virginia","King George County",2,0,308,156,152
050,51,099,"Virginia","King George County",2,1,316,158,158
050,51,099,"Virginia","King George County",2,2,307,140,167
050,51,099,"Virginia","King George County",2,3,303,160,143
050,51,099,"Virginia","King George County",2,4,324,175,149
050,51,099,"Virginia","King George County",2,5,353,182,171
050,51,099,"Virginia","King George County",2,6,368,189,179
050,51,099,"Virginia","King George County",2,7,363,189,174
050,51,099,"Virginia","King George County",2,8,383,202,181
050,51,099,"Virginia","King George County",2,9,381,204,177
050,51,099,"Virginia","King George County",2,10,379,196,183
050,51,099,"Virginia","King George County",2,11,422,218,204
050,51,099,"Virginia","King George County",2,12,452,226,226
050,51,099,"Virginia","King George County",2,13,426,220,206
050,51,099,"Virginia","King George County",2,14,395,207,188
050,51,099,"Virginia","King George County",2,15,395,209,186
050,51,099,"Virginia","King George County",2,16,389,199,190
050,51,099,"Virginia","King George County",2,17,383,188,195
050,51,099,"Virginia","King George County",2,18,317,157,160
050,51,099,"Virginia","King George County",2,19,270,142,128
050,51,099,"Virginia","King George County",2,20,325,182,143
050,51,099,"Virginia","King George County",2,21,321,173,148
050,51,099,"Virginia","King George County",2,22,316,173,143
050,51,099,"Virginia","King George County",2,23,303,165,138
050,51,099,"Virginia","King George County",2,24,304,159,145
050,51,099,"Virginia","King George County",2,25,304,158,146
050,51,099,"Virginia","King George County",2,26,329,176,153
050,51,099,"Virginia","King George County",2,27,313,170,143
050,51,099,"Virginia","King George County",2,28,303,159,144
050,51,099,"Virginia","King George County",2,29,331,166,165
050,51,099,"Virginia","King George County",2,30,331,156,175
050,51,099,"Virginia","King George County",2,31,352,177,175
050,51,099,"Virginia","King George County",2,32,360,193,167
050,51,099,"Virginia","King George County",2,33,369,203,166
050,51,099,"Virginia","King George County",2,34,366,182,184
050,51,099,"Virginia","King George County",2,35,353,175,178
050,51,099,"Virginia","King George County",2,36,355,172,183
050,51,099,"Virginia","King George County",2,37,393,187,206
050,51,099,"Virginia","King George County",2,38,408,201,207
050,51,099,"Virginia","King George County",2,39,372,188,184
050,51,099,"Virginia","King George County",2,40,383,196,187
050,51,099,"Virginia","King George County",2,41,387,200,187
050,51,099,"Virginia","King George County",2,42,357,179,178
050,51,099,"Virginia","King George County",2,43,341,179,162
050,51,099,"Virginia","King George County",2,44,346,177,169
050,51,099,"Virginia","King George County",2,45,369,188,181
050,51,099,"Virginia","King George County",2,46,353,182,171
050,51,099,"Virginia","King George County",2,47,326,172,154
050,51,099,"Virginia","King George County",2,48,345,181,164
050,51,099,"Virginia","King George County",2,49,367,185,182
050,51,099,"Virginia","King George County",2,50,368,181,187
050,51,099,"Virginia","King George County",2,51,372,189,183
050,51,099,"Virginia","King George County",2,52,381,203,178
050,51,099,"Virginia","King George County",2,53,374,192,182
050,51,099,"Virginia","King George County",2,54,373,182,191
050,51,099,"Virginia","King George County",2,55,400,190,210
050,51,099,"Virginia","King George County",2,56,422,206,216
050,51,099,"Virginia","King George County",2,57,415,205,210
050,51,099,"Virginia","King George County",2,58,391,199,192
050,51,099,"Virginia","King George County",2,59,384,198,186
050,51,099,"Virginia","King George County",2,60,377,187,190
050,51,099,"Virginia","King George County",2,61,347,168,179
050,51,099,"Virginia","King George County",2,62,329,161,168
050,51,099,"Virginia","King George County",2,63,324,155,169
050,51,099,"Virginia","King George County",2,64,298,158,140
050,51,099,"Virginia","King George County",2,65,285,153,132
050,51,099,"Virginia","King George County",2,66,272,140,132
050,51,099,"Virginia","King George County",2,67,251,133,118
050,51,099,"Virginia","King George County",2,68,240,128,112
050,51,099,"Virginia","King George County",2,69,220,100,120
050,51,099,"Virginia","King George County",2,70,205,94,111
050,51,099,"Virginia","King George County",2,71,199,100,99
050,51,099,"Virginia","King George County",2,72,197,106,91
050,51,099,"Virginia","King George County",2,73,219,116,103
050,51,099,"Virginia","King George County",2,74,165,79,86
050,51,099,"Virginia","King George County",2,75,157,73,84
050,51,099,"Virginia","King George County",2,76,152,68,84
050,51,099,"Virginia","King George County",2,77,142,55,87
050,51,099,"Virginia","King George County",2,78,120,58,62
050,51,099,"Virginia","King George County",2,79,113,59,54
050,51,099,"Virginia","King George County",2,80,97,47,50
050,51,099,"Virginia","King George County",2,81,84,37,47
050,51,099,"Virginia","King George County",2,82,82,36,46
050,51,099,"Virginia","King George County",2,83,73,33,40
050,51,099,"Virginia","King George County",2,84,56,31,25
050,51,099,"Virginia","King George County",2,85,326,127,199
050,51,099,"Virginia","King George County",3,0,297,142,155
050,51,099,"Virginia","King George County",3,1,290,137,153
050,51,099,"Virginia","King George County",3,2,337,173,164
050,51,099,"Virginia","King George County",3,3,337,167,170
050,51,099,"Virginia","King George County",3,4,329,167,162
050,51,099,"Virginia","King George County",3,5,353,185,168
050,51,099,"Virginia","King George County",3,6,384,194,190
050,51,099,"Virginia","King George County",3,7,385,204,181
050,51,099,"Virginia","King George County",3,8,378,189,189
050,51,099,"Virginia","King George County",3,9,408,211,197
050,51,099,"Virginia","King George County",3,10,385,192,193
050,51,099,"Virginia","King George County",3,11,406,212,194
050,51,099,"Virginia","King George County",3,12,442,224,218
050,51,099,"Virginia","King George County",3,13,453,218,235
050,51,099,"Virginia","King George County",3,14,426,229,197
050,51,099,"Virginia","King George County",3,15,406,215,191
050,51,099,"Virginia","King George County",3,16,408,221,187
050,51,099,"Virginia","King George County",3,17,387,191,196
050,51,099,"Virginia","King George County",3,18,330,173,157
050,51,099,"Virginia","King George County",3,19,282,144,138
050,51,099,"Virginia","King George County",3,20,341,189,152
050,51,099,"Virginia","King George County",3,21,325,178,147
050,51,099,"Virginia","King George County",3,22,316,163,153
050,51,099,"Virginia","King George County",3,23,329,171,158
050,51,099,"Virginia","King George County",3,24,313,168,145
050,51,099,"Virginia","King George County",3,25,305,152,153
050,51,099,"Virginia","King George County",3,26,308,171,137
050,51,099,"Virginia","King George County",3,27,369,197,172
050,51,099,"Virginia","King George County",3,28,325,173,152
050,51,099,"Virginia","King George County",3,29,327,169,158
050,51,099,"Virginia","King George County",3,30,367,180,187
050,51,099,"Virginia","King George County",3,31,367,184,183
050,51,099,"Virginia","King George County",3,32,381,189,192
050,51,099,"Virginia","King George County",3,33,380,197,183
050,51,099,"Virginia","King George County",3,34,380,205,175
050,51,099,"Virginia","King George County",3,35,371,184,187
050,51,099,"Virginia","King George County",3,36,361,179,182
050,51,099,"Virginia","King George County",3,37,374,187,187
050,51,099,"Virginia","King George County",3,38,402,194,208
050,51,099,"Virginia","King George County",3,39,406,205,201
050,51,099,"Virginia","King George County",3,40,389,197,192
050,51,099,"Virginia","King George County",3,41,389,196,193
050,51,099,"Virginia","King George County",3,42,383,199,184
050,51,099,"Virginia","King George County",3,43,360,176,184
050,51,099,"Virginia","King George County",3,44,351,183,168
050,51,099,"Virginia","King George County",3,45,341,177,164
050,51,099,"Virginia","King George County",3,46,366,185,181
050,51,099,"Virginia","King George County",3,47,365,185,180
050,51,099,"Virginia","King George County",3,48,343,182,161
050,51,099,"Virginia","King George County",3,49,338,178,160
050,51,099,"Virginia","King George County",3,50,375,192,183
050,51,099,"Virginia","King George County",3,51,359,179,180
050,51,099,"Virginia","King George County",3,52,373,187,186
050,51,099,"Virginia","King George County",3,53,378,197,181
050,51,099,"Virginia","King George County",3,54,370,202,168
050,51,099,"Virginia","King George County",3,55,378,186,192
050,51,099,"Virginia","King George County",3,56,395,192,203
050,51,099,"Virginia","King George County",3,57,419,200,219
050,51,099,"Virginia","King George County",3,58,419,212,207
050,51,099,"Virginia","King George County",3,59,386,186,200
050,51,099,"Virginia","King George County",3,60,377,193,184
050,51,099,"Virginia","King George County",3,61,368,178,190
050,51,099,"Virginia","King George County",3,62,350,171,179
050,51,099,"Virginia","King George County",3,63,343,169,174
050,51,099,"Virginia","King George County",3,64,338,158,180
050,51,099,"Virginia","King George County",3,65,294,157,137
050,51,099,"Virginia","King George County",3,66,280,148,132
050,51,099,"Virginia","King George County",3,67,275,141,134
050,51,099,"Virginia","King George County",3,68,246,132,114
050,51,099,"Virginia","King George County",3,69,229,124,105
050,51,099,"Virginia","King George County",3,70,215,96,119
050,51,099,"Virginia","King George County",3,71,203,90,113
050,51,099,"Virginia","King George County",3,72,197,97,100
050,51,099,"Virginia","King George County",3,73,203,111,92
050,51,099,"Virginia","King George County",3,74,205,107,98
050,51,099,"Virginia","King George County",3,75,160,75,85
050,51,099,"Virginia","King George County",3,76,151,73,78
050,51,099,"Virginia","King George County",3,77,149,67,82
050,51,099,"Virginia","King George County",3,78,138,55,83
050,51,099,"Virginia","King George County",3,79,116,57,59
050,51,099,"Virginia","King George County",3,80,107,58,49
050,51,099,"Virginia","King George County",3,81,99,51,48
050,51,099,"Virginia","King George County",3,82,75,35,40
050,51,099,"Virginia","King George County",3,83,74,33,41
050,51,099,"Virginia","King George County",3,84,71,31,40
050,51,099,"Virginia","King George County",3,85,331,140,191
050,51,099,"Virginia","King George County",4,0,314,164,150
050,51,099,"Virginia","King George County",4,1,289,147,142
050,51,099,"Virginia","King George County",4,2,304,156,148
050,51,099,"Virginia","King George County",4,3,330,176,154
050,51,099,"Virginia","King George County",4,4,333,161,172
050,51,099,"Virginia","King George County",4,5,348,179,169
050,51,099,"Virginia","King George County",4,6,372,195,177
050,51,099,"Virginia","King George County",4,7,392,202,190
050,51,099,"Virginia","King George County",4,8,383,198,185
050,51,099,"Virginia","King George County",4,9,393,189,204
050,51,099,"Virginia","King George County",4,10,417,211,206
050,51,099,"Virginia","King George County",4,11,407,209,198
050,51,099,"Virginia","King George County",4,12,405,208,197
050,51,099,"Virginia","King George County",4,13,446,231,215
050,51,099,"Virginia","King George County",4,14,459,221,238
050,51,099,"Virginia","King George County",4,15,441,238,203
050,51,099,"Virginia","King George County",4,16,411,219,192
050,51,099,"Virginia","King George County",4,17,411,229,182
050,51,099,"Virginia","King George County",4,18,320,164,156
050,51,099,"Virginia","King George County",4,19,277,148,129
050,51,099,"Virginia","King George County",4,20,343,179,164
050,51,099,"Virginia","King George County",4,21,317,171,146
050,51,099,"Virginia","King George County",4,22,318,171,147
050,51,099,"Virginia","King George County",4,23,285,153,132
050,51,099,"Virginia","King George County",4,24,323,173,150
050,51,099,"Virginia","King George County",4,25,313,173,140
050,51,099,"Virginia","King George County",4,26,331,170,161
050,51,099,"Virginia","King George County",4,27,336,183,153
050,51,099,"Virginia","King George County",4,28,351,174,177
050,51,099,"Virginia","King George County",4,29,339,179,160
050,51,099,"Virginia","King George County",4,30,342,172,170
050,51,099,"Virginia","King George County",4,31,361,183,178
050,51,099,"Virginia","King George County",4,32,373,191,182
050,51,099,"Virginia","King George County",4,33,398,205,193
050,51,099,"Virginia","King George County",4,34,403,202,201
050,51,099,"Virginia","King George County",4,35,376,199,177
050,51,099,"Virginia","King George County",4,36,385,193,192
050,51,099,"Virginia","King George County",4,37,365,183,182
050,51,099,"Virginia","King George County",4,38,385,187,198
050,51,099,"Virginia","King George County",4,39,405,210,195
050,51,099,"Virginia","King George County",4,40,425,209,216
050,51,099,"Virginia","King George County",4,41,390,200,190
050,51,099,"Virginia","King George County",4,42,388,204,184
050,51,099,"Virginia","King George County",4,43,384,200,184
050,51,099,"Virginia","King George County",4,44,383,181,202
050,51,099,"Virginia","King George County",4,45,352,183,169
050,51,099,"Virginia","King George County",4,46,348,179,169
050,51,099,"Virginia","King George County",4,47,375,188,187
050,51,099,"Virginia","King George County",4,48,373,196,177
050,51,099,"Virginia","King George County",4,49,352,183,169
050,51,099,"Virginia","King George County",4,50,350,179,171
050,51,099,"Virginia","King George County",4,51,382,192,190
050,51,099,"Virginia","King George County",4,52,361,181,180
050,51,099,"Virginia","King George County",4,53,379,188,191
050,51,099,"Virginia","King George County",4,54,375,197,178
050,51,099,"Virginia","King George County",4,55,364,197,167
050,51,099,"Virginia","King George County",4,56,386,191,195
050,51,099,"Virginia","King George County",4,57,399,191,208
050,51,099,"Virginia","King George County",4,58,417,203,214
050,51,099,"Virginia","King George County",4,59,404,197,207
050,51,099,"Virginia","King George County",4,60,381,187,194
050,51,099,"Virginia","King George County",4,61,378,190,188
050,51,099,"Virginia","King George County",4,62,376,180,196
050,51,099,"Virginia","King George County",4,63,341,164,177
050,51,099,"Virginia","King George County",4,64,338,166,172
050,51,099,"Virginia","King George County",4,65,325,152,173
050,51,099,"Virginia","King George County",4,66,292,157,135
050,51,099,"Virginia","King George County",4,67,280,145,135
050,51,099,"Virginia","King George County",4,68,279,144,135
050,51,099,"Virginia","King George County",4,69,238,124,114
050,51,099,"Virginia","King George County",4,70,229,121,108
050,51,099,"Virginia","King George County",4,71,209,93,116
050,51,099,"Virginia","King George County",4,72,193,85,108
050,51,099,"Virginia","King George County",4,73,197,98,99
050,51,099,"Virginia","King George County",4,74,195,101,94
050,51,099,"Virginia","King George County",4,75,209,109,100
050,51,099,"Virginia","King George County",4,76,153,73,80
050,51,099,"Virginia","King George County",4,77,150,71,79
050,51,099,"Virginia","King George County",4,78,146,66,80
050,51,099,"Virginia","King George County",4,79,133,53,80
050,51,099,"Virginia","King George County",4,80,109,54,55
050,51,099,"Virginia","King George County",4,81,108,57,51
050,51,099,"Virginia","King George County",4,82,89,45,44
050,51,099,"Virginia","King George County",4,83,59,28,31
050,51,099,"Virginia","King George County",4,84,69,31,38
050,51,099,"Virginia","King George County",4,85,354,152,202
050,51,099,"Virginia","King George County",5,0,314,163,151
050,51,099,"Virginia","King George County",5,1,330,168,162
050,51,099,"Virginia","King George County",5,2,321,170,151
050,51,099,"Virginia","King George County",5,3,303,160,143
050,51,099,"Virginia","King George County",5,4,332,169,163
050,51,099,"Virginia","King George County",5,5,352,177,175
050,51,099,"Virginia","King George County",5,6,364,184,180
050,51,099,"Virginia","King George County",5,7,372,197,175
050,51,099,"Virginia","King George County",5,8,419,216,203
050,51,099,"Virginia","King George County",5,9,377,204,173
050,51,099,"Virginia","King George County",5,10,412,201,211
050,51,099,"Virginia","King George County",5,11,443,223,220
050,51,099,"Virginia","King George County",5,12,418,214,204
050,51,099,"Virginia","King George County",5,13,414,215,199
050,51,099,"Virginia","King George County",5,14,439,226,213
050,51,099,"Virginia","King George County",5,15,462,226,236
050,51,099,"Virginia","King George County",5,16,441,234,207
050,51,099,"Virginia","King George County",5,17,417,220,197
050,51,099,"Virginia","King George County",5,18,351,201,150
050,51,099,"Virginia","King George County",5,19,286,159,127
050,51,099,"Virginia","King George County",5,20,350,199,151
050,51,099,"Virginia","King George County",5,21,337,176,161
050,51,099,"Virginia","King George County",5,22,334,173,161
050,51,099,"Virginia","King George County",5,23,319,177,142
050,51,099,"Virginia","King George County",5,24,301,161,140
050,51,099,"Virginia","King George County",5,25,319,169,150
050,51,099,"Virginia","King George County",5,26,330,173,157
050,51,099,"Virginia","King George County",5,27,329,177,152
050,51,099,"Virginia","King George County",5,28,350,172,178
050,51,099,"Virginia","King George County",5,29,373,196,177
050,51,099,"Virginia","King George County",5,30,351,185,166
050,51,099,"Virginia","King George County",5,31,363,183,180
050,51,099,"Virginia","King George County",5,32,395,205,190
050,51,099,"Virginia","King George County",5,33,386,189,197
050,51,099,"Virginia","King George County",5,34,391,201,190
050,51,099,"Virginia","King George County",5,35,422,209,213
050,51,099,"Virginia","King George County",5,36,391,206,185
050,51,099,"Virginia","King George County",5,37,404,202,202
050,51,099,"Virginia","King George County",5,38,396,196,200
050,51,099,"Virginia","King George County",5,39,386,187,199
050,51,099,"Virginia","King George County",5,40,411,206,205
050,51,099,"Virginia","King George County",5,41,425,201,224
050,51,099,"Virginia","King George County",5,42,398,205,193
050,51,099,"Virginia","King George County",5,43,399,210,189
050,51,099,"Virginia","King George County",5,44,384,198,186
050,51,099,"Virginia","King George County",5,45,377,175,202
050,51,099,"Virginia","King George County",5,46,371,199,172
050,51,099,"Virginia","King George County",5,47,353,183,170
050,51,099,"Virginia","King George County",5,48,387,191,196
050,51,099,"Virginia","King George County",5,49,375,195,180
050,51,099,"Virginia","King George County",5,50,349,180,169
050,51,099,"Virginia","King George County",5,51,348,183,165
050,51,099,"Virginia","King George County",5,52,380,186,194
050,51,099,"Virginia","King George County",5,53,359,177,182
050,51,099,"Virginia","King George County",5,54,382,194,188
050,51,099,"Virginia","King George County",5,55,381,197,184
050,51,099,"Virginia","King George County",5,56,383,208,175
050,51,099,"Virginia","King George County",5,57,396,197,199
050,51,099,"Virginia","King George County",5,58,405,191,214
050,51,099,"Virginia","King George County",5,59,415,194,221
050,51,099,"Virginia","King George County",5,60,406,197,209
050,51,099,"Virginia","King George County",5,61,385,189,196
050,51,099,"Virginia","King George County",5,62,402,201,201
050,51,099,"Virginia","King George County",5,63,367,179,188
050,51,099,"Virginia","King George County",5,64,338,158,180
050,51,099,"Virginia","King George County",5,65,342,172,170
050,51,099,"Virginia","King George County",5,66,311,144,167
050,51,099,"Virginia","King George County",5,67,294,153,141
050,51,099,"Virginia","King George County",5,68,279,150,129
050,51,099,"Virginia","King George County",5,69,266,140,126
050,51,099,"Virginia","King George County",5,70,235,122,113
050,51,099,"Virginia","King George County",5,71,231,118,113
050,51,099,"Virginia","King George County",5,72,207,92,115
050,51,099,"Virginia","King George County",5,73,187,83,104
050,51,099,"Virginia","King George County",5,74,185,88,97
050,51,099,"Virginia","King George County",5,75,192,99,93
050,51,099,"Virginia","King George County",5,76,202,108,94
050,51,099,"Virginia","King George County",5,77,145,70,75
050,51,099,"Virginia","King George County",5,78,151,73,78
050,51,099,"Virginia","King George County",5,79,141,64,77
050,51,099,"Virginia","King George County",5,80,121,48,73
050,51,099,"Virginia","King George County",5,81,107,52,55
050,51,099,"Virginia","King George County",5,82,103,55,48
050,51,099,"Virginia","King George County",5,83,73,38,35
050,51,099,"Virginia","King George County",5,84,53,26,27
050,51,099,"Virginia","King George County",5,85,373,163,210
050,51,101,"Virginia","King William County",1,0,208,109,99
050,51,101,"Virginia","King William County",1,1,216,117,99
050,51,101,"Virginia","King William County",1,2,224,115,109
050,51,101,"Virginia","King William County",1,3,211,117,94
050,51,101,"Virginia","King William County",1,4,211,106,105
050,51,101,"Virginia","King William County",1,5,210,113,97
050,51,101,"Virginia","King William County",1,6,224,121,103
050,51,101,"Virginia","King William County",1,7,222,123,99
050,51,101,"Virginia","King William County",1,8,225,112,113
050,51,101,"Virginia","King William County",1,9,235,118,117
050,51,101,"Virginia","King William County",1,10,209,102,107
050,51,101,"Virginia","King William County",1,11,229,105,124
050,51,101,"Virginia","King William County",1,12,269,135,134
050,51,101,"Virginia","King William County",1,13,247,128,119
050,51,101,"Virginia","King William County",1,14,254,134,120
050,51,101,"Virginia","King William County",1,15,250,131,119
050,51,101,"Virginia","King William County",1,16,217,119,98
050,51,101,"Virginia","King William County",1,17,247,131,116
050,51,101,"Virginia","King William County",1,18,209,113,96
050,51,101,"Virginia","King William County",1,19,170,91,79
050,51,101,"Virginia","King William County",1,20,166,89,77
050,51,101,"Virginia","King William County",1,21,160,75,85
050,51,101,"Virginia","King William County",1,22,160,79,81
050,51,101,"Virginia","King William County",1,23,200,102,98
050,51,101,"Virginia","King William County",1,24,195,97,98
050,51,101,"Virginia","King William County",1,25,216,112,104
050,51,101,"Virginia","King William County",1,26,222,108,114
050,51,101,"Virginia","King William County",1,27,227,105,122
050,51,101,"Virginia","King William County",1,28,238,105,133
050,51,101,"Virginia","King William County",1,29,252,126,126
050,51,101,"Virginia","King William County",1,30,261,128,133
050,51,101,"Virginia","King William County",1,31,209,105,104
050,51,101,"Virginia","King William County",1,32,231,103,128
050,51,101,"Virginia","King William County",1,33,248,119,129
050,51,101,"Virginia","King William County",1,34,246,116,130
050,51,101,"Virginia","King William County",1,35,258,131,127
050,51,101,"Virginia","King William County",1,36,223,128,95
050,51,101,"Virginia","King William County",1,37,246,127,119
050,51,101,"Virginia","King William County",1,38,235,121,114
050,51,101,"Virginia","King William County",1,39,243,125,118
050,51,101,"Virginia","King William County",1,40,223,100,123
050,51,101,"Virginia","King William County",1,41,200,89,111
050,51,101,"Virginia","King William County",1,42,202,110,92
050,51,101,"Virginia","King William County",1,43,209,108,101
050,51,101,"Virginia","King William County",1,44,214,105,109
050,51,101,"Virginia","King William County",1,45,208,97,111
050,51,101,"Virginia","King William County",1,46,205,100,105
050,51,101,"Virginia","King William County",1,47,208,106,102
050,51,101,"Virginia","King William County",1,48,244,113,131
050,51,101,"Virginia","King William County",1,49,254,125,129
050,51,101,"Virginia","King William County",1,50,236,128,108
050,51,101,"Virginia","King William County",1,51,238,125,113
050,51,101,"Virginia","King William County",1,52,238,121,117
050,51,101,"Virginia","King William County",1,53,255,128,127
050,51,101,"Virginia","King William County",1,54,258,127,131
050,51,101,"Virginia","King William County",1,55,300,151,149
050,51,101,"Virginia","King William County",1,56,295,130,165
050,51,101,"Virginia","King William County",1,57,281,134,147
050,51,101,"Virginia","King William County",1,58,273,138,135
050,51,101,"Virginia","King William County",1,59,274,141,133
050,51,101,"Virginia","King William County",1,60,262,134,128
050,51,101,"Virginia","King William County",1,61,240,118,122
050,51,101,"Virginia","King William County",1,62,228,113,115
050,51,101,"Virginia","King William County",1,63,230,112,118
050,51,101,"Virginia","King William County",1,64,226,104,122
050,51,101,"Virginia","King William County",1,65,212,94,118
050,51,101,"Virginia","King William County",1,66,184,88,96
050,51,101,"Virginia","King William County",1,67,201,89,112
050,51,101,"Virginia","King William County",1,68,182,78,104
050,51,101,"Virginia","King William County",1,69,200,92,108
050,51,101,"Virginia","King William County",1,70,189,84,105
050,51,101,"Virginia","King William County",1,71,170,74,96
050,51,101,"Virginia","King William County",1,72,159,81,78
050,51,101,"Virginia","King William County",1,73,176,82,94
050,51,101,"Virginia","King William County",1,74,130,56,74
050,51,101,"Virginia","King William County",1,75,130,67,63
050,51,101,"Virginia","King William County",1,76,118,60,58
050,51,101,"Virginia","King William County",1,77,119,55,64
050,51,101,"Virginia","King William County",1,78,93,40,53
050,51,101,"Virginia","King William County",1,79,77,29,48
050,51,101,"Virginia","King William County",1,80,68,34,34
050,51,101,"Virginia","King William County",1,81,63,35,28
050,51,101,"Virginia","King William County",1,82,61,28,33
050,51,101,"Virginia","King William County",1,83,60,23,37
050,51,101,"Virginia","King William County",1,84,51,24,27
050,51,101,"Virginia","King William County",1,85,244,91,153
050,51,101,"Virginia","King William County",2,0,211,112,99
050,51,101,"Virginia","King William County",2,1,217,114,103
050,51,101,"Virginia","King William County",2,2,224,116,108
050,51,101,"Virginia","King William County",2,3,213,116,97
050,51,101,"Virginia","King William County",2,4,215,111,104
050,51,101,"Virginia","King William County",2,5,214,111,103
050,51,101,"Virginia","King William County",2,6,226,121,105
050,51,101,"Virginia","King William County",2,7,225,125,100
050,51,101,"Virginia","King William County",2,8,224,114,110
050,51,101,"Virginia","King William County",2,9,229,115,114
050,51,101,"Virginia","King William County",2,10,219,108,111
050,51,101,"Virginia","King William County",2,11,225,105,120
050,51,101,"Virginia","King William County",2,12,261,129,132
050,51,101,"Virginia","King William County",2,13,251,128,123
050,51,101,"Virginia","King William County",2,14,253,132,121
050,51,101,"Virginia","King William County",2,15,251,131,120
050,51,101,"Virginia","King William County",2,16,227,123,104
050,51,101,"Virginia","King William County",2,17,241,129,112
050,51,101,"Virginia","King William County",2,18,211,114,97
050,51,101,"Virginia","King William County",2,19,172,92,80
050,51,101,"Virginia","King William County",2,20,172,91,81
050,51,101,"Virginia","King William County",2,21,162,79,83
050,51,101,"Virginia","King William County",2,22,166,80,86
050,51,101,"Virginia","King William County",2,23,195,99,96
050,51,101,"Virginia","King William County",2,24,203,101,102
050,51,101,"Virginia","King William County",2,25,214,111,103
050,51,101,"Virginia","King William County",2,26,225,112,113
050,51,101,"Virginia","King William County",2,27,229,106,123
050,51,101,"Virginia","King William County",2,28,237,107,130
050,51,101,"Virginia","King William County",2,29,252,122,130
050,51,101,"Virginia","King William County",2,30,261,130,131
050,51,101,"Virginia","King William County",2,31,225,111,114
050,51,101,"Virginia","King William County",2,32,227,105,122
050,51,101,"Virginia","King William County",2,33,244,116,128
050,51,101,"Virginia","King William County",2,34,253,119,134
050,51,101,"Virginia","King William County",2,35,259,131,128
050,51,101,"Virginia","King William County",2,36,229,127,102
050,51,101,"Virginia","King William County",2,37,239,125,114
050,51,101,"Virginia","King William County",2,38,240,122,118
050,51,101,"Virginia","King William County",2,39,243,125,118
050,51,101,"Virginia","King William County",2,40,231,108,123
050,51,101,"Virginia","King William County",2,41,204,91,113
050,51,101,"Virginia","King William County",2,42,200,104,96
050,51,101,"Virginia","King William County",2,43,209,109,100
050,51,101,"Virginia","King William County",2,44,210,103,107
050,51,101,"Virginia","King William County",2,45,214,102,112
050,51,101,"Virginia","King William County",2,46,206,100,106
050,51,101,"Virginia","King William County",2,47,207,104,103
050,51,101,"Virginia","King William County",2,48,239,113,126
050,51,101,"Virginia","King William County",2,49,255,124,131
050,51,101,"Virginia","King William County",2,50,243,130,113
050,51,101,"Virginia","King William County",2,51,237,126,111
050,51,101,"Virginia","King William County",2,52,238,123,115
050,51,101,"Virginia","King William County",2,53,251,127,124
050,51,101,"Virginia","King William County",2,54,259,128,131
050,51,101,"Virginia","King William County",2,55,291,147,144
050,51,101,"Virginia","King William County",2,56,300,136,164
050,51,101,"Virginia","King William County",2,57,288,136,152
050,51,101,"Virginia","King William County",2,58,275,137,138
050,51,101,"Virginia","King William County",2,59,276,141,135
050,51,101,"Virginia","King William County",2,60,266,135,131
050,51,101,"Virginia","King William County",2,61,241,120,121
050,51,101,"Virginia","King William County",2,62,229,114,115
050,51,101,"Virginia","King William County",2,63,232,113,119
050,51,101,"Virginia","King William County",2,64,224,105,119
050,51,101,"Virginia","King William County",2,65,214,96,118
050,51,101,"Virginia","King William County",2,66,192,89,103
050,51,101,"Virginia","King William County",2,67,196,89,107
050,51,101,"Virginia","King William County",2,68,185,80,105
050,51,101,"Virginia","King William County",2,69,195,88,107
050,51,101,"Virginia","King William County",2,70,190,85,105
050,51,101,"Virginia","King William County",2,71,176,77,99
050,51,101,"Virginia","King William County",2,72,158,78,80
050,51,101,"Virginia","King William County",2,73,177,83,94
050,51,101,"Virginia","King William County",2,74,133,59,74
050,51,101,"Virginia","King William County",2,75,128,64,64
050,51,101,"Virginia","King William County",2,76,116,60,56
050,51,101,"Virginia","King William County",2,77,122,58,64
050,51,101,"Virginia","King William County",2,78,95,41,54
050,51,101,"Virginia","King William County",2,79,80,30,50
050,51,101,"Virginia","King William County",2,80,71,34,37
050,51,101,"Virginia","King William County",2,81,64,35,29
050,51,101,"Virginia","King William County",2,82,63,30,33
050,51,101,"Virginia","King William County",2,83,60,26,34
050,51,101,"Virginia","King William County",2,84,52,24,28
050,51,101,"Virginia","King William County",2,85,242,89,153
050,51,101,"Virginia","King William County",3,0,223,108,115
050,51,101,"Virginia","King William County",3,1,226,121,105
050,51,101,"Virginia","King William County",3,2,224,120,104
050,51,101,"Virginia","King William County",3,3,219,107,112
050,51,101,"Virginia","King William County",3,4,222,114,108
050,51,101,"Virginia","King William County",3,5,225,126,99
050,51,101,"Virginia","King William County",3,6,222,115,107
050,51,101,"Virginia","King William County",3,7,228,119,109
050,51,101,"Virginia","King William County",3,8,233,128,105
050,51,101,"Virginia","King William County",3,9,222,107,115
050,51,101,"Virginia","King William County",3,10,239,121,118
050,51,101,"Virginia","King William County",3,11,211,97,114
050,51,101,"Virginia","King William County",3,12,226,107,119
050,51,101,"Virginia","King William County",3,13,277,134,143
050,51,101,"Virginia","King William County",3,14,247,123,124
050,51,101,"Virginia","King William County",3,15,256,133,123
050,51,101,"Virginia","King William County",3,16,254,132,122
050,51,101,"Virginia","King William County",3,17,245,136,109
050,51,101,"Virginia","King William County",3,18,209,114,95
050,51,101,"Virginia","King William County",3,19,163,86,77
050,51,101,"Virginia","King William County",3,20,182,94,88
050,51,101,"Virginia","King William County",3,21,177,93,84
050,51,101,"Virginia","King William County",3,22,167,80,87
050,51,101,"Virginia","King William County",3,23,184,87,97
050,51,101,"Virginia","King William County",3,24,206,107,99
050,51,101,"Virginia","King William County",3,25,203,96,107
050,51,101,"Virginia","King William County",3,26,231,118,113
050,51,101,"Virginia","King William County",3,27,240,116,124
050,51,101,"Virginia","King William County",3,28,230,104,126
050,51,101,"Virginia","King William County",3,29,258,119,139
050,51,101,"Virginia","King William County",3,30,265,134,131
050,51,101,"Virginia","King William County",3,31,275,130,145
050,51,101,"Virginia","King William County",3,32,224,111,113
050,51,101,"Virginia","King William County",3,33,231,107,124
050,51,101,"Virginia","King William County",3,34,247,117,130
050,51,101,"Virginia","King William County",3,35,259,124,135
050,51,101,"Virginia","King William County",3,36,265,132,133
050,51,101,"Virginia","King William County",3,37,243,130,113
050,51,101,"Virginia","King William County",3,38,248,132,116
050,51,101,"Virginia","King William County",3,39,255,133,122
050,51,101,"Virginia","King William County",3,40,255,134,121
050,51,101,"Virginia","King William County",3,41,234,112,122
050,51,101,"Virginia","King William County",3,42,207,94,113
050,51,101,"Virginia","King William County",3,43,205,104,101
050,51,101,"Virginia","King William County",3,44,214,107,107
050,51,101,"Virginia","King William County",3,45,208,105,103
050,51,101,"Virginia","King William County",3,46,214,108,106
050,51,101,"Virginia","King William County",3,47,201,99,102
050,51,101,"Virginia","King William County",3,48,191,100,91
050,51,101,"Virginia","King William County",3,49,239,114,125
050,51,101,"Virginia","King William County",3,50,247,123,124
050,51,101,"Virginia","King William County",3,51,245,130,115
050,51,101,"Virginia","King William County",3,52,233,122,111
050,51,101,"Virginia","King William County",3,53,242,120,122
050,51,101,"Virginia","King William County",3,54,247,123,124
050,51,101,"Virginia","King William County",3,55,258,127,131
050,51,101,"Virginia","King William County",3,56,287,142,145
050,51,101,"Virginia","King William County",3,57,298,135,163
050,51,101,"Virginia","King William County",3,58,295,138,157
050,51,101,"Virginia","King William County",3,59,281,143,138
050,51,101,"Virginia","King William County",3,60,274,141,133
050,51,101,"Virginia","King William County",3,61,270,136,134
050,51,101,"Virginia","King William County",3,62,244,121,123
050,51,101,"Virginia","King William County",3,63,221,108,113
050,51,101,"Virginia","King William County",3,64,235,110,125
050,51,101,"Virginia","King William County",3,65,223,106,117
050,51,101,"Virginia","King William County",3,66,219,99,120
050,51,101,"Virginia","King William County",3,67,188,86,102
050,51,101,"Virginia","King William County",3,68,193,92,101
050,51,101,"Virginia","King William County",3,69,191,83,108
050,51,101,"Virginia","King William County",3,70,192,88,104
050,51,101,"Virginia","King William County",3,71,187,83,104
050,51,101,"Virginia","King William County",3,72,172,77,95
050,51,101,"Virginia","King William County",3,73,157,77,80
050,51,101,"Virginia","King William County",3,74,172,82,90
050,51,101,"Virginia","King William County",3,75,139,63,76
050,51,101,"Virginia","King William County",3,76,117,56,61
050,51,101,"Virginia","King William County",3,77,113,59,54
050,51,101,"Virginia","King William County",3,78,116,54,62
050,51,101,"Virginia","King William County",3,79,95,40,55
050,51,101,"Virginia","King William County",3,80,78,29,49
050,51,101,"Virginia","King William County",3,81,67,31,36
050,51,101,"Virginia","King William County",3,82,62,32,30
050,51,101,"Virginia","King William County",3,83,55,26,29
050,51,101,"Virginia","King William County",3,84,51,20,31
050,51,101,"Virginia","King William County",3,85,250,92,158
050,51,101,"Virginia","King William County",4,0,244,123,121
050,51,101,"Virginia","King William County",4,1,234,117,117
050,51,101,"Virginia","King William County",4,2,237,130,107
050,51,101,"Virginia","King William County",4,3,222,121,101
050,51,101,"Virginia","King William County",4,4,224,107,117
050,51,101,"Virginia","King William County",4,5,228,122,106
050,51,101,"Virginia","King William County",4,6,238,137,101
050,51,101,"Virginia","King William County",4,7,231,117,114
050,51,101,"Virginia","King William County",4,8,222,118,104
050,51,101,"Virginia","King William County",4,9,229,129,100
050,51,101,"Virginia","King William County",4,10,213,102,111
050,51,101,"Virginia","King William County",4,11,227,115,112
050,51,101,"Virginia","King William County",4,12,208,94,114
050,51,101,"Virginia","King William County",4,13,229,112,117
050,51,101,"Virginia","King William County",4,14,280,136,144
050,51,101,"Virginia","King William County",4,15,251,128,123
050,51,101,"Virginia","King William County",4,16,250,127,123
050,51,101,"Virginia","King William County",4,17,251,130,121
050,51,101,"Virginia","King William County",4,18,206,110,96
050,51,101,"Virginia","King William County",4,19,168,96,72
050,51,101,"Virginia","King William County",4,20,176,89,87
050,51,101,"Virginia","King William County",4,21,182,92,90
050,51,101,"Virginia","King William County",4,22,187,98,89
050,51,101,"Virginia","King William County",4,23,184,81,103
050,51,101,"Virginia","King William County",4,24,199,89,110
050,51,101,"Virginia","King William County",4,25,214,113,101
050,51,101,"Virginia","King William County",4,26,224,116,108
050,51,101,"Virginia","King William County",4,27,233,113,120
050,51,101,"Virginia","King William County",4,28,243,121,122
050,51,101,"Virginia","King William County",4,29,243,107,136
050,51,101,"Virginia","King William County",4,30,255,126,129
050,51,101,"Virginia","King William County",4,31,280,137,143
050,51,101,"Virginia","King William County",4,32,276,133,143
050,51,101,"Virginia","King William County",4,33,238,122,116
050,51,101,"Virginia","King William County",4,34,238,109,129
050,51,101,"Virginia","King William County",4,35,247,113,134
050,51,101,"Virginia","King William County",4,36,250,121,129
050,51,101,"Virginia","King William County",4,37,266,132,134
050,51,101,"Virginia","King William County",4,38,247,138,109
050,51,101,"Virginia","King William County",4,39,248,139,109
050,51,101,"Virginia","King William County",4,40,257,136,121
050,51,101,"Virginia","King William County",4,41,255,130,125
050,51,101,"Virginia","King William County",4,42,241,113,128
050,51,101,"Virginia","King William County",4,43,210,92,118
050,51,101,"Virginia","King William County",4,44,217,112,105
050,51,101,"Virginia","King William County",4,45,225,121,104
050,51,101,"Virginia","King William County",4,46,219,113,106
050,51,101,"Virginia","King William County",4,47,214,109,105
050,51,101,"Virginia","King William County",4,48,203,103,100
050,51,101,"Virginia","King William County",4,49,207,110,97
050,51,101,"Virginia","King William County",4,50,240,112,128
050,51,101,"Virginia","King William County",4,51,256,124,132
050,51,101,"Virginia","King William County",4,52,254,135,119
050,51,101,"Virginia","King William County",4,53,229,122,107
050,51,101,"Virginia","King William County",4,54,248,121,127
050,51,101,"Virginia","King William County",4,55,245,120,125
050,51,101,"Virginia","King William County",4,56,259,130,129
050,51,101,"Virginia","King William County",4,57,281,136,145
050,51,101,"Virginia","King William County",4,58,302,137,165
050,51,101,"Virginia","King William County",4,59,295,136,159
050,51,101,"Virginia","King William County",4,60,275,144,131
050,51,101,"Virginia","King William County",4,61,279,146,133
050,51,101,"Virginia","King William County",4,62,270,135,135
050,51,101,"Virginia","King William County",4,63,254,123,131
050,51,101,"Virginia","King William County",4,64,222,107,115
050,51,101,"Virginia","King William County",4,65,243,116,127
050,51,101,"Virginia","King William County",4,66,225,107,118
050,51,101,"Virginia","King William County",4,67,222,97,125
050,51,101,"Virginia","King William County",4,68,184,87,97
050,51,101,"Virginia","King William County",4,69,198,94,104
050,51,101,"Virginia","King William County",4,70,184,79,105
050,51,101,"Virginia","King William County",4,71,186,86,100
050,51,101,"Virginia","King William County",4,72,181,82,99
050,51,101,"Virginia","King William County",4,73,170,78,92
050,51,101,"Virginia","King William County",4,74,158,78,80
050,51,101,"Virginia","King William County",4,75,160,78,82
050,51,101,"Virginia","King William County",4,76,122,53,69
050,51,101,"Virginia","King William County",4,77,119,56,63
050,51,101,"Virginia","King William County",4,78,102,58,44
050,51,101,"Virginia","King William County",4,79,109,49,60
050,51,101,"Virginia","King William County",4,80,85,37,48
050,51,101,"Virginia","King William County",4,81,76,27,49
050,51,101,"Virginia","King William County",4,82,63,28,35
050,51,101,"Virginia","King William County",4,83,58,31,27
050,51,101,"Virginia","King William County",4,84,49,24,25
050,51,101,"Virginia","King William County",4,85,256,91,165
050,51,101,"Virginia","King William County",5,0,242,123,119
050,51,101,"Virginia","King William County",5,1,263,137,126
050,51,101,"Virginia","King William County",5,2,234,118,116
050,51,101,"Virginia","King William County",5,3,244,131,113
050,51,101,"Virginia","King William County",5,4,226,123,103
050,51,101,"Virginia","King William County",5,5,236,112,124
050,51,101,"Virginia","King William County",5,6,234,123,111
050,51,101,"Virginia","King William County",5,7,247,140,107
050,51,101,"Virginia","King William County",5,8,244,126,118
050,51,101,"Virginia","King William County",5,9,236,127,109
050,51,101,"Virginia","King William County",5,10,222,121,101
050,51,101,"Virginia","King William County",5,11,215,103,112
050,51,101,"Virginia","King William County",5,12,245,120,125
050,51,101,"Virginia","King William County",5,13,216,96,120
050,51,101,"Virginia","King William County",5,14,233,113,120
050,51,101,"Virginia","King William County",5,15,285,139,146
050,51,101,"Virginia","King William County",5,16,247,125,122
050,51,101,"Virginia","King William County",5,17,262,140,122
050,51,101,"Virginia","King William County",5,18,213,119,94
050,51,101,"Virginia","King William County",5,19,165,89,76
050,51,101,"Virginia","King William County",5,20,175,99,76
050,51,101,"Virginia","King William County",5,21,197,96,101
050,51,101,"Virginia","King William County",5,22,199,98,101
050,51,101,"Virginia","King William County",5,23,220,116,104
050,51,101,"Virginia","King William County",5,24,190,95,95
050,51,101,"Virginia","King William County",5,25,228,100,128
050,51,101,"Virginia","King William County",5,26,216,111,105
050,51,101,"Virginia","King William County",5,27,227,120,107
050,51,101,"Virginia","King William County",5,28,251,125,126
050,51,101,"Virginia","King William County",5,29,250,129,121
050,51,101,"Virginia","King William County",5,30,247,114,133
050,51,101,"Virginia","King William County",5,31,282,141,141
050,51,101,"Virginia","King William County",5,32,280,139,141
050,51,101,"Virginia","King William County",5,33,298,142,156
050,51,101,"Virginia","King William County",5,34,257,133,124
050,51,101,"Virginia","King William County",5,35,242,106,136
050,51,101,"Virginia","King William County",5,36,248,114,134
050,51,101,"Virginia","King William County",5,37,265,131,134
050,51,101,"Virginia","King William County",5,38,278,142,136
050,51,101,"Virginia","King William County",5,39,255,147,108
050,51,101,"Virginia","King William County",5,40,254,138,116
050,51,101,"Virginia","King William County",5,41,259,135,124
050,51,101,"Virginia","King William County",5,42,259,130,129
050,51,101,"Virginia","King William County",5,43,252,116,136
050,51,101,"Virginia","King William County",5,44,222,95,127
050,51,101,"Virginia","King William County",5,45,222,112,110
050,51,101,"Virginia","King William County",5,46,225,122,103
050,51,101,"Virginia","King William County",5,47,216,108,108
050,51,101,"Virginia","King William County",5,48,227,116,111
050,51,101,"Virginia","King William County",5,49,193,95,98
050,51,101,"Virginia","King William County",5,50,220,114,106
050,51,101,"Virginia","King William County",5,51,241,110,131
050,51,101,"Virginia","King William County",5,52,258,128,130
050,51,101,"Virginia","King William County",5,53,257,131,126
050,51,101,"Virginia","King William County",5,54,240,124,116
050,51,101,"Virginia","King William County",5,55,246,121,125
050,51,101,"Virginia","King William County",5,56,244,120,124
050,51,101,"Virginia","King William County",5,57,257,124,133
050,51,101,"Virginia","King William County",5,58,277,133,144
050,51,101,"Virginia","King William County",5,59,301,142,159
050,51,101,"Virginia","King William County",5,60,292,134,158
050,51,101,"Virginia","King William County",5,61,279,141,138
050,51,101,"Virginia","King William County",5,62,280,150,130
050,51,101,"Virginia","King William County",5,63,278,139,139
050,51,101,"Virginia","King William County",5,64,250,118,132
050,51,101,"Virginia","King William County",5,65,225,112,113
050,51,101,"Virginia","King William County",5,66,242,115,127
050,51,101,"Virginia","King William County",5,67,227,109,118
050,51,101,"Virginia","King William County",5,68,228,96,132
050,51,101,"Virginia","King William County",5,69,185,85,100
050,51,101,"Virginia","King William County",5,70,195,93,102
050,51,101,"Virginia","King William County",5,71,176,73,103
050,51,101,"Virginia","King William County",5,72,185,87,98
050,51,101,"Virginia","King William County",5,73,179,83,96
050,51,101,"Virginia","King William County",5,74,165,75,90
050,51,101,"Virginia","King William County",5,75,152,76,76
050,51,101,"Virginia","King William County",5,76,153,73,80
050,51,101,"Virginia","King William County",5,77,118,52,66
050,51,101,"Virginia","King William County",5,78,116,56,60
050,51,101,"Virginia","King William County",5,79,97,55,42
050,51,101,"Virginia","King William County",5,80,101,48,53
050,51,101,"Virginia","King William County",5,81,83,38,45
050,51,101,"Virginia","King William County",5,82,75,26,49
050,51,101,"Virginia","King William County",5,83,55,26,29
050,51,101,"Virginia","King William County",5,84,48,26,22
050,51,101,"Virginia","King William County",5,85,262,99,163
050,51,103,"Virginia","Lancaster County",1,0,84,43,41
050,51,103,"Virginia","Lancaster County",1,1,80,40,40
050,51,103,"Virginia","Lancaster County",1,2,90,46,44
050,51,103,"Virginia","Lancaster County",1,3,84,43,41
050,51,103,"Virginia","Lancaster County",1,4,103,52,51
050,51,103,"Virginia","Lancaster County",1,5,99,45,54
050,51,103,"Virginia","Lancaster County",1,6,77,31,46
050,51,103,"Virginia","Lancaster County",1,7,78,38,40
050,51,103,"Virginia","Lancaster County",1,8,86,44,42
050,51,103,"Virginia","Lancaster County",1,9,89,46,43
050,51,103,"Virginia","Lancaster County",1,10,100,49,51
050,51,103,"Virginia","Lancaster County",1,11,87,48,39
050,51,103,"Virginia","Lancaster County",1,12,105,73,32
050,51,103,"Virginia","Lancaster County",1,13,107,67,40
050,51,103,"Virginia","Lancaster County",1,14,111,66,45
050,51,103,"Virginia","Lancaster County",1,15,126,67,59
050,51,103,"Virginia","Lancaster County",1,16,117,59,58
050,51,103,"Virginia","Lancaster County",1,17,105,53,52
050,51,103,"Virginia","Lancaster County",1,18,82,48,34
050,51,103,"Virginia","Lancaster County",1,19,74,41,33
050,51,103,"Virginia","Lancaster County",1,20,78,43,35
050,51,103,"Virginia","Lancaster County",1,21,74,38,36
050,51,103,"Virginia","Lancaster County",1,22,79,39,40
050,51,103,"Virginia","Lancaster County",1,23,73,35,38
050,51,103,"Virginia","Lancaster County",1,24,89,42,47
050,51,103,"Virginia","Lancaster County",1,25,82,39,43
050,51,103,"Virginia","Lancaster County",1,26,83,38,45
050,51,103,"Virginia","Lancaster County",1,27,83,46,37
050,51,103,"Virginia","Lancaster County",1,28,94,48,46
050,51,103,"Virginia","Lancaster County",1,29,99,49,50
050,51,103,"Virginia","Lancaster County",1,30,85,43,42
050,51,103,"Virginia","Lancaster County",1,31,95,48,47
050,51,103,"Virginia","Lancaster County",1,32,91,42,49
050,51,103,"Virginia","Lancaster County",1,33,92,44,48
050,51,103,"Virginia","Lancaster County",1,34,91,41,50
050,51,103,"Virginia","Lancaster County",1,35,89,42,47
050,51,103,"Virginia","Lancaster County",1,36,87,43,44
050,51,103,"Virginia","Lancaster County",1,37,93,46,47
050,51,103,"Virginia","Lancaster County",1,38,78,43,35
050,51,103,"Virginia","Lancaster County",1,39,80,41,39
050,51,103,"Virginia","Lancaster County",1,40,71,39,32
050,51,103,"Virginia","Lancaster County",1,41,80,35,45
050,51,103,"Virginia","Lancaster County",1,42,81,34,47
050,51,103,"Virginia","Lancaster County",1,43,86,38,48
050,51,103,"Virginia","Lancaster County",1,44,77,37,40
050,51,103,"Virginia","Lancaster County",1,45,84,39,45
050,51,103,"Virginia","Lancaster County",1,46,73,30,43
050,51,103,"Virginia","Lancaster County",1,47,89,43,46
050,51,103,"Virginia","Lancaster County",1,48,100,49,51
050,51,103,"Virginia","Lancaster County",1,49,95,44,51
050,51,103,"Virginia","Lancaster County",1,50,118,59,59
050,51,103,"Virginia","Lancaster County",1,51,109,48,61
050,51,103,"Virginia","Lancaster County",1,52,105,46,59
050,51,103,"Virginia","Lancaster County",1,53,122,66,56
050,51,103,"Virginia","Lancaster County",1,54,127,61,66
050,51,103,"Virginia","Lancaster County",1,55,143,74,69
050,51,103,"Virginia","Lancaster County",1,56,162,69,93
050,51,103,"Virginia","Lancaster County",1,57,155,72,83
050,51,103,"Virginia","Lancaster County",1,58,174,80,94
050,51,103,"Virginia","Lancaster County",1,59,174,78,96
050,51,103,"Virginia","Lancaster County",1,60,194,85,109
050,51,103,"Virginia","Lancaster County",1,61,207,97,110
050,51,103,"Virginia","Lancaster County",1,62,235,111,124
050,51,103,"Virginia","Lancaster County",1,63,221,102,119
050,51,103,"Virginia","Lancaster County",1,64,230,109,121
050,51,103,"Virginia","Lancaster County",1,65,233,110,123
050,51,103,"Virginia","Lancaster County",1,66,219,90,129
050,51,103,"Virginia","Lancaster County",1,67,217,100,117
050,51,103,"Virginia","Lancaster County",1,68,230,112,118
050,51,103,"Virginia","Lancaster County",1,69,186,95,91
050,51,103,"Virginia","Lancaster County",1,70,200,95,105
050,51,103,"Virginia","Lancaster County",1,71,225,108,117
050,51,103,"Virginia","Lancaster County",1,72,239,100,139
050,51,103,"Virginia","Lancaster County",1,73,236,117,119
050,51,103,"Virginia","Lancaster County",1,74,155,73,82
050,51,103,"Virginia","Lancaster County",1,75,155,72,83
050,51,103,"Virginia","Lancaster County",1,76,186,82,104
050,51,103,"Virginia","Lancaster County",1,77,170,80,90
050,51,103,"Virginia","Lancaster County",1,78,148,73,75
050,51,103,"Virginia","Lancaster County",1,79,143,69,74
050,51,103,"Virginia","Lancaster County",1,80,128,64,64
050,51,103,"Virginia","Lancaster County",1,81,118,57,61
050,51,103,"Virginia","Lancaster County",1,82,95,45,50
050,51,103,"Virginia","Lancaster County",1,83,89,39,50
050,51,103,"Virginia","Lancaster County",1,84,102,40,62
050,51,103,"Virginia","Lancaster County",1,85,538,188,350
050,51,103,"Virginia","Lancaster County",2,0,69,35,34
050,51,103,"Virginia","Lancaster County",2,1,81,40,41
050,51,103,"Virginia","Lancaster County",2,2,89,45,44
050,51,103,"Virginia","Lancaster County",2,3,85,44,41
050,51,103,"Virginia","Lancaster County",2,4,98,49,49
050,51,103,"Virginia","Lancaster County",2,5,100,46,54
050,51,103,"Virginia","Lancaster County",2,6,80,33,47
050,51,103,"Virginia","Lancaster County",2,7,77,36,41
050,51,103,"Virginia","Lancaster County",2,8,84,42,42
050,51,103,"Virginia","Lancaster County",2,9,90,47,43
050,51,103,"Virginia","Lancaster County",2,10,99,48,51
050,51,103,"Virginia","Lancaster County",2,11,90,49,41
050,51,103,"Virginia","Lancaster County",2,12,102,67,35
050,51,103,"Virginia","Lancaster County",2,13,108,68,40
050,51,103,"Virginia","Lancaster County",2,14,110,65,45
050,51,103,"Virginia","Lancaster County",2,15,123,67,56
050,51,103,"Virginia","Lancaster County",2,16,120,61,59
050,51,103,"Virginia","Lancaster County",2,17,106,54,52
050,51,103,"Virginia","Lancaster County",2,18,84,48,36
050,51,103,"Virginia","Lancaster County",2,19,72,41,31
050,51,103,"Virginia","Lancaster County",2,20,77,42,35
050,51,103,"Virginia","Lancaster County",2,21,76,40,36
050,51,103,"Virginia","Lancaster County",2,22,77,39,38
050,51,103,"Virginia","Lancaster County",2,23,76,37,39
050,51,103,"Virginia","Lancaster County",2,24,84,40,44
050,51,103,"Virginia","Lancaster County",2,25,85,40,45
050,51,103,"Virginia","Lancaster County",2,26,84,39,45
050,51,103,"Virginia","Lancaster County",2,27,83,44,39
050,51,103,"Virginia","Lancaster County",2,28,92,47,45
050,51,103,"Virginia","Lancaster County",2,29,99,50,49
050,51,103,"Virginia","Lancaster County",2,30,90,46,44
050,51,103,"Virginia","Lancaster County",2,31,93,47,46
050,51,103,"Virginia","Lancaster County",2,32,91,43,48
050,51,103,"Virginia","Lancaster County",2,33,91,42,49
050,51,103,"Virginia","Lancaster County",2,34,92,42,50
050,51,103,"Virginia","Lancaster County",2,35,88,41,47
050,51,103,"Virginia","Lancaster County",2,36,86,41,45
050,51,103,"Virginia","Lancaster County",2,37,90,45,45
050,51,103,"Virginia","Lancaster County",2,38,82,44,38
050,51,103,"Virginia","Lancaster County",2,39,79,41,38
050,51,103,"Virginia","Lancaster County",2,40,75,41,34
050,51,103,"Virginia","Lancaster County",2,41,78,37,41
050,51,103,"Virginia","Lancaster County",2,42,78,33,45
050,51,103,"Virginia","Lancaster County",2,43,86,37,49
050,51,103,"Virginia","Lancaster County",2,44,78,37,41
050,51,103,"Virginia","Lancaster County",2,45,82,37,45
050,51,103,"Virginia","Lancaster County",2,46,76,32,44
050,51,103,"Virginia","Lancaster County",2,47,84,39,45
050,51,103,"Virginia","Lancaster County",2,48,96,47,49
050,51,103,"Virginia","Lancaster County",2,49,98,47,51
050,51,103,"Virginia","Lancaster County",2,50,112,56,56
050,51,103,"Virginia","Lancaster County",2,51,110,50,60
050,51,103,"Virginia","Lancaster County",2,52,106,46,60
050,51,103,"Virginia","Lancaster County",2,53,119,61,58
050,51,103,"Virginia","Lancaster County",2,54,126,62,64
050,51,103,"Virginia","Lancaster County",2,55,141,71,70
050,51,103,"Virginia","Lancaster County",2,56,160,73,87
050,51,103,"Virginia","Lancaster County",2,57,158,72,86
050,51,103,"Virginia","Lancaster County",2,58,170,79,91
050,51,103,"Virginia","Lancaster County",2,59,175,80,95
050,51,103,"Virginia","Lancaster County",2,60,187,81,106
050,51,103,"Virginia","Lancaster County",2,61,206,95,111
050,51,103,"Virginia","Lancaster County",2,62,232,110,122
050,51,103,"Virginia","Lancaster County",2,63,227,105,122
050,51,103,"Virginia","Lancaster County",2,64,230,109,121
050,51,103,"Virginia","Lancaster County",2,65,234,111,123
050,51,103,"Virginia","Lancaster County",2,66,221,96,125
050,51,103,"Virginia","Lancaster County",2,67,217,97,120
050,51,103,"Virginia","Lancaster County",2,68,223,107,116
050,51,103,"Virginia","Lancaster County",2,69,198,101,97
050,51,103,"Virginia","Lancaster County",2,70,198,96,102
050,51,103,"Virginia","Lancaster County",2,71,219,105,114
050,51,103,"Virginia","Lancaster County",2,72,232,101,131
050,51,103,"Virginia","Lancaster County",2,73,245,117,128
050,51,103,"Virginia","Lancaster County",2,74,166,79,87
050,51,103,"Virginia","Lancaster County",2,75,153,72,81
050,51,103,"Virginia","Lancaster County",2,76,178,78,100
050,51,103,"Virginia","Lancaster County",2,77,176,81,95
050,51,103,"Virginia","Lancaster County",2,78,148,71,77
050,51,103,"Virginia","Lancaster County",2,79,143,70,73
050,51,103,"Virginia","Lancaster County",2,80,129,63,66
050,51,103,"Virginia","Lancaster County",2,81,121,60,61
050,51,103,"Virginia","Lancaster County",2,82,99,47,52
050,51,103,"Virginia","Lancaster County",2,83,87,39,48
050,51,103,"Virginia","Lancaster County",2,84,100,40,60
050,51,103,"Virginia","Lancaster County",2,85,544,195,349
050,51,103,"Virginia","Lancaster County",3,0,76,35,41
050,51,103,"Virginia","Lancaster County",3,1,58,42,16
050,51,103,"Virginia","Lancaster County",3,2,84,43,41
050,51,103,"Virginia","Lancaster County",3,3,93,45,48
050,51,103,"Virginia","Lancaster County",3,4,83,44,39
050,51,103,"Virginia","Lancaster County",3,5,93,44,49
050,51,103,"Virginia","Lancaster County",3,6,101,50,51
050,51,103,"Virginia","Lancaster County",3,7,78,29,49
050,51,103,"Virginia","Lancaster County",3,8,84,37,47
050,51,103,"Virginia","Lancaster County",3,9,93,46,47
050,51,103,"Virginia","Lancaster County",3,10,96,51,45
050,51,103,"Virginia","Lancaster County",3,11,102,49,53
050,51,103,"Virginia","Lancaster County",3,12,97,49,48
050,51,103,"Virginia","Lancaster County",3,13,103,65,38
050,51,103,"Virginia","Lancaster County",3,14,110,71,39
050,51,103,"Virginia","Lancaster County",3,15,109,66,43
050,51,103,"Virginia","Lancaster County",3,16,119,63,56
050,51,103,"Virginia","Lancaster County",3,17,111,54,57
050,51,103,"Virginia","Lancaster County",3,18,92,48,44
050,51,103,"Virginia","Lancaster County",3,19,65,39,26
050,51,103,"Virginia","Lancaster County",3,20,75,43,32
050,51,103,"Virginia","Lancaster County",3,21,86,47,39
050,51,103,"Virginia","Lancaster County",3,22,86,47,39
050,51,103,"Virginia","Lancaster County",3,23,71,35,36
050,51,103,"Virginia","Lancaster County",3,24,78,34,44
050,51,103,"Virginia","Lancaster County",3,25,83,41,42
050,51,103,"Virginia","Lancaster County",3,26,83,38,45
050,51,103,"Virginia","Lancaster County",3,27,81,38,43
050,51,103,"Virginia","Lancaster County",3,28,84,45,39
050,51,103,"Virginia","Lancaster County",3,29,81,40,41
050,51,103,"Virginia","Lancaster County",3,30,99,50,49
050,51,103,"Virginia","Lancaster County",3,31,95,51,44
050,51,103,"Virginia","Lancaster County",3,32,87,50,37
050,51,103,"Virginia","Lancaster County",3,33,95,46,49
050,51,103,"Virginia","Lancaster County",3,34,101,45,56
050,51,103,"Virginia","Lancaster County",3,35,95,44,51
050,51,103,"Virginia","Lancaster County",3,36,91,45,46
050,51,103,"Virginia","Lancaster County",3,37,84,42,42
050,51,103,"Virginia","Lancaster County",3,38,88,44,44
050,51,103,"Virginia","Lancaster County",3,39,81,45,36
050,51,103,"Virginia","Lancaster County",3,40,78,36,42
050,51,103,"Virginia","Lancaster County",3,41,76,40,36
050,51,103,"Virginia","Lancaster County",3,42,81,33,48
050,51,103,"Virginia","Lancaster County",3,43,92,37,55
050,51,103,"Virginia","Lancaster County",3,44,81,34,47
050,51,103,"Virginia","Lancaster County",3,45,80,37,43
050,51,103,"Virginia","Lancaster County",3,46,87,40,47
050,51,103,"Virginia","Lancaster County",3,47,80,37,43
050,51,103,"Virginia","Lancaster County",3,48,82,36,46
050,51,103,"Virginia","Lancaster County",3,49,96,47,49
050,51,103,"Virginia","Lancaster County",3,50,104,48,56
050,51,103,"Virginia","Lancaster County",3,51,114,55,59
050,51,103,"Virginia","Lancaster County",3,52,116,56,60
050,51,103,"Virginia","Lancaster County",3,53,105,49,56
050,51,103,"Virginia","Lancaster County",3,54,120,60,60
050,51,103,"Virginia","Lancaster County",3,55,139,70,69
050,51,103,"Virginia","Lancaster County",3,56,143,76,67
050,51,103,"Virginia","Lancaster County",3,57,165,75,90
050,51,103,"Virginia","Lancaster County",3,58,174,82,92
050,51,103,"Virginia","Lancaster County",3,59,178,79,99
050,51,103,"Virginia","Lancaster County",3,60,187,80,107
050,51,103,"Virginia","Lancaster County",3,61,194,87,107
050,51,103,"Virginia","Lancaster County",3,62,215,101,114
050,51,103,"Virginia","Lancaster County",3,63,237,114,123
050,51,103,"Virginia","Lancaster County",3,64,242,120,122
050,51,103,"Virginia","Lancaster County",3,65,228,106,122
050,51,103,"Virginia","Lancaster County",3,66,235,111,124
050,51,103,"Virginia","Lancaster County",3,67,222,94,128
050,51,103,"Virginia","Lancaster County",3,68,226,105,121
050,51,103,"Virginia","Lancaster County",3,69,232,116,116
050,51,103,"Virginia","Lancaster County",3,70,195,97,98
050,51,103,"Virginia","Lancaster County",3,71,192,88,104
050,51,103,"Virginia","Lancaster County",3,72,216,105,111
050,51,103,"Virginia","Lancaster County",3,73,222,95,127
050,51,103,"Virginia","Lancaster County",3,74,239,116,123
050,51,103,"Virginia","Lancaster County",3,75,161,75,86
050,51,103,"Virginia","Lancaster County",3,76,153,68,85
050,51,103,"Virginia","Lancaster County",3,77,165,71,94
050,51,103,"Virginia","Lancaster County",3,78,172,81,91
050,51,103,"Virginia","Lancaster County",3,79,142,65,77
050,51,103,"Virginia","Lancaster County",3,80,129,61,68
050,51,103,"Virginia","Lancaster County",3,81,126,65,61
050,51,103,"Virginia","Lancaster County",3,82,122,56,66
050,51,103,"Virginia","Lancaster County",3,83,84,42,42
050,51,103,"Virginia","Lancaster County",3,84,88,37,51
050,51,103,"Virginia","Lancaster County",3,85,549,190,359
050,51,103,"Virginia","Lancaster County",4,0,73,36,37
050,51,103,"Virginia","Lancaster County",4,1,75,32,43
050,51,103,"Virginia","Lancaster County",4,2,56,39,17
050,51,103,"Virginia","Lancaster County",4,3,79,39,40
050,51,103,"Virginia","Lancaster County",4,4,83,40,43
050,51,103,"Virginia","Lancaster County",4,5,77,43,34
050,51,103,"Virginia","Lancaster County",4,6,88,42,46
050,51,103,"Virginia","Lancaster County",4,7,98,47,51
050,51,103,"Virginia","Lancaster County",4,8,78,30,48
050,51,103,"Virginia","Lancaster County",4,9,87,39,48
050,51,103,"Virginia","Lancaster County",4,10,94,45,49
050,51,103,"Virginia","Lancaster County",4,11,90,48,42
050,51,103,"Virginia","Lancaster County",4,12,101,46,55
050,51,103,"Virginia","Lancaster County",4,13,90,45,45
050,51,103,"Virginia","Lancaster County",4,14,102,65,37
050,51,103,"Virginia","Lancaster County",4,15,114,69,45
050,51,103,"Virginia","Lancaster County",4,16,114,67,47
050,51,103,"Virginia","Lancaster County",4,17,118,62,56
050,51,103,"Virginia","Lancaster County",4,18,99,49,50
050,51,103,"Virginia","Lancaster County",4,19,69,38,31
050,51,103,"Virginia","Lancaster County",4,20,66,42,24
050,51,103,"Virginia","Lancaster County",4,21,77,43,34
050,51,103,"Virginia","Lancaster County",4,22,89,50,39
050,51,103,"Virginia","Lancaster County",4,23,86,49,37
050,51,103,"Virginia","Lancaster County",4,24,69,33,36
050,51,103,"Virginia","Lancaster County",4,25,76,38,38
050,51,103,"Virginia","Lancaster County",4,26,74,35,39
050,51,103,"Virginia","Lancaster County",4,27,83,42,41
050,51,103,"Virginia","Lancaster County",4,28,78,38,40
050,51,103,"Virginia","Lancaster County",4,29,83,45,38
050,51,103,"Virginia","Lancaster County",4,30,73,35,38
050,51,103,"Virginia","Lancaster County",4,31,91,51,40
050,51,103,"Virginia","Lancaster County",4,32,90,47,43
050,51,103,"Virginia","Lancaster County",4,33,80,44,36
050,51,103,"Virginia","Lancaster County",4,34,101,54,47
050,51,103,"Virginia","Lancaster County",4,35,96,43,53
050,51,103,"Virginia","Lancaster County",4,36,95,47,48
050,51,103,"Virginia","Lancaster County",4,37,99,50,49
050,51,103,"Virginia","Lancaster County",4,38,88,45,43
050,51,103,"Virginia","Lancaster County",4,39,95,46,49
050,51,103,"Virginia","Lancaster County",4,40,77,38,39
050,51,103,"Virginia","Lancaster County",4,41,81,36,45
050,51,103,"Virginia","Lancaster County",4,42,80,38,42
050,51,103,"Virginia","Lancaster County",4,43,84,37,47
050,51,103,"Virginia","Lancaster County",4,44,86,35,51
050,51,103,"Virginia","Lancaster County",4,45,75,33,42
050,51,103,"Virginia","Lancaster County",4,46,77,35,42
050,51,103,"Virginia","Lancaster County",4,47,94,48,46
050,51,103,"Virginia","Lancaster County",4,48,82,36,46
050,51,103,"Virginia","Lancaster County",4,49,76,38,38
050,51,103,"Virginia","Lancaster County",4,50,96,43,53
050,51,103,"Virginia","Lancaster County",4,51,106,51,55
050,51,103,"Virginia","Lancaster County",4,52,120,55,65
050,51,103,"Virginia","Lancaster County",4,53,119,56,63
050,51,103,"Virginia","Lancaster County",4,54,103,45,58
050,51,103,"Virginia","Lancaster County",4,55,123,61,62
050,51,103,"Virginia","Lancaster County",4,56,141,70,71
050,51,103,"Virginia","Lancaster County",4,57,149,79,70
050,51,103,"Virginia","Lancaster County",4,58,178,83,95
050,51,103,"Virginia","Lancaster County",4,59,181,84,97
050,51,103,"Virginia","Lancaster County",4,60,184,82,102
050,51,103,"Virginia","Lancaster County",4,61,186,81,105
050,51,103,"Virginia","Lancaster County",4,62,206,93,113
050,51,103,"Virginia","Lancaster County",4,63,221,102,119
050,51,103,"Virginia","Lancaster County",4,64,239,121,118
050,51,103,"Virginia","Lancaster County",4,65,255,120,135
050,51,103,"Virginia","Lancaster County",4,66,230,106,124
050,51,103,"Virginia","Lancaster County",4,67,245,112,133
050,51,103,"Virginia","Lancaster County",4,68,222,95,127
050,51,103,"Virginia","Lancaster County",4,69,240,117,123
050,51,103,"Virginia","Lancaster County",4,70,234,110,124
050,51,103,"Virginia","Lancaster County",4,71,192,93,99
050,51,103,"Virginia","Lancaster County",4,72,188,87,101
050,51,103,"Virginia","Lancaster County",4,73,210,102,108
050,51,103,"Virginia","Lancaster County",4,74,211,89,122
050,51,103,"Virginia","Lancaster County",4,75,231,113,118
050,51,103,"Virginia","Lancaster County",4,76,154,68,86
050,51,103,"Virginia","Lancaster County",4,77,133,55,78
050,51,103,"Virginia","Lancaster County",4,78,148,62,86
050,51,103,"Virginia","Lancaster County",4,79,177,79,98
050,51,103,"Virginia","Lancaster County",4,80,125,56,69
050,51,103,"Virginia","Lancaster County",4,81,121,56,65
050,51,103,"Virginia","Lancaster County",4,82,125,64,61
050,51,103,"Virginia","Lancaster County",4,83,108,53,55
050,51,103,"Virginia","Lancaster County",4,84,84,37,47
050,51,103,"Virginia","Lancaster County",4,85,535,190,345
050,51,103,"Virginia","Lancaster County",5,0,73,36,37
050,51,103,"Virginia","Lancaster County",5,1,69,36,33
050,51,103,"Virginia","Lancaster County",5,2,72,31,41
050,51,103,"Virginia","Lancaster County",5,3,55,36,19
050,51,103,"Virginia","Lancaster County",5,4,86,43,43
050,51,103,"Virginia","Lancaster County",5,5,95,49,46
050,51,103,"Virginia","Lancaster County",5,6,78,41,37
050,51,103,"Virginia","Lancaster County",5,7,93,45,48
050,51,103,"Virginia","Lancaster County",5,8,108,54,54
050,51,103,"Virginia","Lancaster County",5,9,82,33,49
050,51,103,"Virginia","Lancaster County",5,10,91,38,53
050,51,103,"Virginia","Lancaster County",5,11,85,37,48
050,51,103,"Virginia","Lancaster County",5,12,97,49,48
050,51,103,"Virginia","Lancaster County",5,13,104,47,57
050,51,103,"Virginia","Lancaster County",5,14,89,44,45
050,51,103,"Virginia","Lancaster County",5,15,106,67,39
050,51,103,"Virginia","Lancaster County",5,16,114,67,47
050,51,103,"Virginia","Lancaster County",5,17,113,69,44
050,51,103,"Virginia","Lancaster County",5,18,96,55,41
050,51,103,"Virginia","Lancaster County",5,19,86,44,42
050,51,103,"Virginia","Lancaster County",5,20,73,41,32
050,51,103,"Virginia","Lancaster County",5,21,74,41,33
050,51,103,"Virginia","Lancaster County",5,22,79,44,35
050,51,103,"Virginia","Lancaster County",5,23,93,55,38
050,51,103,"Virginia","Lancaster County",5,24,89,45,44
050,51,103,"Virginia","Lancaster County",5,25,64,31,33
050,51,103,"Virginia","Lancaster County",5,26,76,35,41
050,51,103,"Virginia","Lancaster County",5,27,77,34,43
050,51,103,"Virginia","Lancaster County",5,28,72,35,37
050,51,103,"Virginia","Lancaster County",5,29,84,43,41
050,51,103,"Virginia","Lancaster County",5,30,88,47,41
050,51,103,"Virginia","Lancaster County",5,31,83,37,46
050,51,103,"Virginia","Lancaster County",5,32,103,57,46
050,51,103,"Virginia","Lancaster County",5,33,88,49,39
050,51,103,"Virginia","Lancaster County",5,34,89,49,40
050,51,103,"Virginia","Lancaster County",5,35,99,54,45
050,51,103,"Virginia","Lancaster County",5,36,98,42,56
050,51,103,"Virginia","Lancaster County",5,37,102,50,52
050,51,103,"Virginia","Lancaster County",5,38,99,51,48
050,51,103,"Virginia","Lancaster County",5,39,97,51,46
050,51,103,"Virginia","Lancaster County",5,40,93,43,50
050,51,103,"Virginia","Lancaster County",5,41,79,37,42
050,51,103,"Virginia","Lancaster County",5,42,87,37,50
050,51,103,"Virginia","Lancaster County",5,43,83,42,41
050,51,103,"Virginia","Lancaster County",5,44,84,36,48
050,51,103,"Virginia","Lancaster County",5,45,88,32,56
050,51,103,"Virginia","Lancaster County",5,46,69,29,40
050,51,103,"Virginia","Lancaster County",5,47,78,35,43
050,51,103,"Virginia","Lancaster County",5,48,97,52,45
050,51,103,"Virginia","Lancaster County",5,49,84,39,45
050,51,103,"Virginia","Lancaster County",5,50,79,36,43
050,51,103,"Virginia","Lancaster County",5,51,100,44,56
050,51,103,"Virginia","Lancaster County",5,52,110,54,56
050,51,103,"Virginia","Lancaster County",5,53,123,54,69
050,51,103,"Virginia","Lancaster County",5,54,123,60,63
050,51,103,"Virginia","Lancaster County",5,55,105,43,62
050,51,103,"Virginia","Lancaster County",5,56,135,67,68
050,51,103,"Virginia","Lancaster County",5,57,145,74,71
050,51,103,"Virginia","Lancaster County",5,58,141,78,63
050,51,103,"Virginia","Lancaster County",5,59,187,86,101
050,51,103,"Virginia","Lancaster County",5,60,192,92,100
050,51,103,"Virginia","Lancaster County",5,61,199,89,110
050,51,103,"Virginia","Lancaster County",5,62,194,81,113
050,51,103,"Virginia","Lancaster County",5,63,222,95,127
050,51,103,"Virginia","Lancaster County",5,64,230,111,119
050,51,103,"Virginia","Lancaster County",5,65,241,123,118
050,51,103,"Virginia","Lancaster County",5,66,264,127,137
050,51,103,"Virginia","Lancaster County",5,67,232,105,127
050,51,103,"Virginia","Lancaster County",5,68,245,116,129
050,51,103,"Virginia","Lancaster County",5,69,221,94,127
050,51,103,"Virginia","Lancaster County",5,70,234,113,121
050,51,103,"Virginia","Lancaster County",5,71,230,108,122
050,51,103,"Virginia","Lancaster County",5,72,191,94,97
050,51,103,"Virginia","Lancaster County",5,73,171,81,90
050,51,103,"Virginia","Lancaster County",5,74,205,96,109
050,51,103,"Virginia","Lancaster County",5,75,206,89,117
050,51,103,"Virginia","Lancaster County",5,76,230,105,125
050,51,103,"Virginia","Lancaster County",5,77,136,56,80
050,51,103,"Virginia","Lancaster County",5,78,121,47,74
050,51,103,"Virginia","Lancaster County",5,79,142,57,85
050,51,103,"Virginia","Lancaster County",5,80,162,72,90
050,51,103,"Virginia","Lancaster County",5,81,119,55,64
050,51,103,"Virginia","Lancaster County",5,82,123,52,71
050,51,103,"Virginia","Lancaster County",5,83,111,60,51
050,51,103,"Virginia","Lancaster County",5,84,112,53,59
050,51,103,"Virginia","Lancaster County",5,85,517,185,332
050,51,105,"Virginia","Lee County",1,0,193,98,95
050,51,105,"Virginia","Lee County",1,1,203,102,101
050,51,105,"Virginia","Lee County",1,2,188,108,80
050,51,105,"Virginia","Lee County",1,3,207,111,96
050,51,105,"Virginia","Lee County",1,4,214,119,95
050,51,105,"Virginia","Lee County",1,5,203,104,99
050,51,105,"Virginia","Lee County",1,6,208,107,101
050,51,105,"Virginia","Lee County",1,7,230,123,107
050,51,105,"Virginia","Lee County",1,8,243,127,116
050,51,105,"Virginia","Lee County",1,9,234,127,107
050,51,105,"Virginia","Lee County",1,10,244,129,115
050,51,105,"Virginia","Lee County",1,11,250,131,119
050,51,105,"Virginia","Lee County",1,12,232,120,112
050,51,105,"Virginia","Lee County",1,13,249,124,125
050,51,105,"Virginia","Lee County",1,14,242,120,122
050,51,105,"Virginia","Lee County",1,15,251,131,120
050,51,105,"Virginia","Lee County",1,16,251,130,121
050,51,105,"Virginia","Lee County",1,17,254,136,118
050,51,105,"Virginia","Lee County",1,18,218,122,96
050,51,105,"Virginia","Lee County",1,19,171,92,79
050,51,105,"Virginia","Lee County",1,20,158,77,81
050,51,105,"Virginia","Lee County",1,21,195,99,96
050,51,105,"Virginia","Lee County",1,22,219,119,100
050,51,105,"Virginia","Lee County",1,23,240,137,103
050,51,105,"Virginia","Lee County",1,24,242,136,106
050,51,105,"Virginia","Lee County",1,25,276,171,105
050,51,105,"Virginia","Lee County",1,26,265,167,98
050,51,105,"Virginia","Lee County",1,27,257,149,108
050,51,105,"Virginia","Lee County",1,28,263,159,104
050,51,105,"Virginia","Lee County",1,29,328,193,135
050,51,105,"Virginia","Lee County",1,30,320,211,109
050,51,105,"Virginia","Lee County",1,31,270,167,103
050,51,105,"Virginia","Lee County",1,32,304,196,108
050,51,105,"Virginia","Lee County",1,33,305,198,107
050,51,105,"Virginia","Lee County",1,34,286,174,112
050,51,105,"Virginia","Lee County",1,35,244,155,89
050,51,105,"Virginia","Lee County",1,36,245,149,96
050,51,105,"Virginia","Lee County",1,37,261,152,109
050,51,105,"Virginia","Lee County",1,38,254,144,110
050,51,105,"Virginia","Lee County",1,39,282,170,112
050,51,105,"Virginia","Lee County",1,40,273,149,124
050,51,105,"Virginia","Lee County",1,41,284,162,122
050,51,105,"Virginia","Lee County",1,42,251,136,115
050,51,105,"Virginia","Lee County",1,43,274,160,114
050,51,105,"Virginia","Lee County",1,44,274,151,123
050,51,105,"Virginia","Lee County",1,45,297,159,138
050,51,105,"Virginia","Lee County",1,46,280,159,121
050,51,105,"Virginia","Lee County",1,47,295,166,129
050,51,105,"Virginia","Lee County",1,48,323,176,147
050,51,105,"Virginia","Lee County",1,49,307,144,163
050,51,105,"Virginia","Lee County",1,50,293,149,144
050,51,105,"Virginia","Lee County",1,51,308,162,146
050,51,105,"Virginia","Lee County",1,52,296,153,143
050,51,105,"Virginia","Lee County",1,53,303,150,153
050,51,105,"Virginia","Lee County",1,54,302,147,155
050,51,105,"Virginia","Lee County",1,55,290,138,152
050,51,105,"Virginia","Lee County",1,56,296,138,158
050,51,105,"Virginia","Lee County",1,57,312,147,165
050,51,105,"Virginia","Lee County",1,58,304,159,145
050,51,105,"Virginia","Lee County",1,59,313,154,159
050,51,105,"Virginia","Lee County",1,60,327,160,167
050,51,105,"Virginia","Lee County",1,61,343,174,169
050,51,105,"Virginia","Lee County",1,62,345,171,174
050,51,105,"Virginia","Lee County",1,63,339,160,179
050,51,105,"Virginia","Lee County",1,64,323,166,157
050,51,105,"Virginia","Lee County",1,65,337,176,161
050,51,105,"Virginia","Lee County",1,66,321,169,152
050,51,105,"Virginia","Lee County",1,67,327,156,171
050,51,105,"Virginia","Lee County",1,68,322,164,158
050,51,105,"Virginia","Lee County",1,69,294,145,149
050,51,105,"Virginia","Lee County",1,70,282,138,144
050,51,105,"Virginia","Lee County",1,71,275,138,137
050,51,105,"Virginia","Lee County",1,72,286,142,144
050,51,105,"Virginia","Lee County",1,73,276,136,140
050,51,105,"Virginia","Lee County",1,74,201,96,105
050,51,105,"Virginia","Lee County",1,75,201,101,100
050,51,105,"Virginia","Lee County",1,76,213,110,103
050,51,105,"Virginia","Lee County",1,77,218,106,112
050,51,105,"Virginia","Lee County",1,78,163,69,94
050,51,105,"Virginia","Lee County",1,79,154,62,92
050,51,105,"Virginia","Lee County",1,80,148,66,82
050,51,105,"Virginia","Lee County",1,81,135,55,80
050,51,105,"Virginia","Lee County",1,82,124,53,71
050,51,105,"Virginia","Lee County",1,83,110,46,64
050,51,105,"Virginia","Lee County",1,84,86,39,47
050,51,105,"Virginia","Lee County",1,85,448,178,270
050,51,105,"Virginia","Lee County",2,0,201,98,103
050,51,105,"Virginia","Lee County",2,1,199,100,99
050,51,105,"Virginia","Lee County",2,2,191,106,85
050,51,105,"Virginia","Lee County",2,3,201,109,92
050,51,105,"Virginia","Lee County",2,4,214,118,96
050,51,105,"Virginia","Lee County",2,5,207,109,98
050,51,105,"Virginia","Lee County",2,6,206,106,100
050,51,105,"Virginia","Lee County",2,7,225,119,106
050,51,105,"Virginia","Lee County",2,8,235,125,110
050,51,105,"Virginia","Lee County",2,9,235,127,108
050,51,105,"Virginia","Lee County",2,10,241,128,113
050,51,105,"Virginia","Lee County",2,11,246,129,117
050,51,105,"Virginia","Lee County",2,12,239,124,115
050,51,105,"Virginia","Lee County",2,13,241,121,120
050,51,105,"Virginia","Lee County",2,14,242,120,122
050,51,105,"Virginia","Lee County",2,15,249,129,120
050,51,105,"Virginia","Lee County",2,16,252,130,122
050,51,105,"Virginia","Lee County",2,17,251,135,116
050,51,105,"Virginia","Lee County",2,18,214,121,93
050,51,105,"Virginia","Lee County",2,19,170,93,77
050,51,105,"Virginia","Lee County",2,20,163,81,82
050,51,105,"Virginia","Lee County",2,21,189,96,93
050,51,105,"Virginia","Lee County",2,22,216,115,101
050,51,105,"Virginia","Lee County",2,23,240,135,105
050,51,105,"Virginia","Lee County",2,24,249,141,108
050,51,105,"Virginia","Lee County",2,25,272,168,104
050,51,105,"Virginia","Lee County",2,26,268,168,100
050,51,105,"Virginia","Lee County",2,27,254,150,104
050,51,105,"Virginia","Lee County",2,28,264,158,106
050,51,105,"Virginia","Lee County",2,29,314,188,126
050,51,105,"Virginia","Lee County",2,30,326,209,117
050,51,105,"Virginia","Lee County",2,31,273,170,103
050,51,105,"Virginia","Lee County",2,32,302,196,106
050,51,105,"Virginia","Lee County",2,33,306,200,106
050,51,105,"Virginia","Lee County",2,34,286,176,110
050,51,105,"Virginia","Lee County",2,35,252,157,95
050,51,105,"Virginia","Lee County",2,36,242,148,94
050,51,105,"Virginia","Lee County",2,37,257,149,108
050,51,105,"Virginia","Lee County",2,38,254,143,111
050,51,105,"Virginia","Lee County",2,39,277,166,111
050,51,105,"Virginia","Lee County",2,40,270,149,121
050,51,105,"Virginia","Lee County",2,41,282,160,122
050,51,105,"Virginia","Lee County",2,42,252,137,115
050,51,105,"Virginia","Lee County",2,43,275,159,116
050,51,105,"Virginia","Lee County",2,44,267,147,120
050,51,105,"Virginia","Lee County",2,45,292,157,135
050,51,105,"Virginia","Lee County",2,46,283,158,125
050,51,105,"Virginia","Lee County",2,47,288,162,126
050,51,105,"Virginia","Lee County",2,48,314,173,141
050,51,105,"Virginia","Lee County",2,49,308,149,159
050,51,105,"Virginia","Lee County",2,50,298,149,149
050,51,105,"Virginia","Lee County",2,51,302,158,144
050,51,105,"Virginia","Lee County",2,52,296,153,143
050,51,105,"Virginia","Lee County",2,53,302,152,150
050,51,105,"Virginia","Lee County",2,54,300,146,154
050,51,105,"Virginia","Lee County",2,55,293,140,153
050,51,105,"Virginia","Lee County",2,56,290,135,155
050,51,105,"Virginia","Lee County",2,57,306,143,163
050,51,105,"Virginia","Lee County",2,58,302,154,148
050,51,105,"Virginia","Lee County",2,59,314,158,156
050,51,105,"Virginia","Lee County",2,60,323,158,165
050,51,105,"Virginia","Lee County",2,61,336,168,168
050,51,105,"Virginia","Lee County",2,62,342,170,172
050,51,105,"Virginia","Lee County",2,63,345,164,181
050,51,105,"Virginia","Lee County",2,64,323,162,161
050,51,105,"Virginia","Lee County",2,65,331,173,158
050,51,105,"Virginia","Lee County",2,66,325,170,155
050,51,105,"Virginia","Lee County",2,67,324,159,165
050,51,105,"Virginia","Lee County",2,68,317,161,156
050,51,105,"Virginia","Lee County",2,69,303,151,152
050,51,105,"Virginia","Lee County",2,70,280,135,145
050,51,105,"Virginia","Lee County",2,71,275,137,138
050,51,105,"Virginia","Lee County",2,72,279,139,140
050,51,105,"Virginia","Lee County",2,73,293,144,149
050,51,105,"Virginia","Lee County",2,74,203,97,106
050,51,105,"Virginia","Lee County",2,75,199,99,100
050,51,105,"Virginia","Lee County",2,76,207,105,102
050,51,105,"Virginia","Lee County",2,77,221,110,111
050,51,105,"Virginia","Lee County",2,78,172,76,96
050,51,105,"Virginia","Lee County",2,79,153,61,92
050,51,105,"Virginia","Lee County",2,80,146,63,83
050,51,105,"Virginia","Lee County",2,81,136,56,80
050,51,105,"Virginia","Lee County",2,82,122,51,71
050,51,105,"Virginia","Lee County",2,83,109,46,63
050,51,105,"Virginia","Lee County",2,84,89,39,50
050,51,105,"Virginia","Lee County",2,85,458,185,273
050,51,105,"Virginia","Lee County",3,0,193,100,93
050,51,105,"Virginia","Lee County",3,1,201,98,103
050,51,105,"Virginia","Lee County",3,2,197,100,97
050,51,105,"Virginia","Lee County",3,3,195,109,86
050,51,105,"Virginia","Lee County",3,4,202,111,91
050,51,105,"Virginia","Lee County",3,5,217,124,93
050,51,105,"Virginia","Lee County",3,6,221,118,103
050,51,105,"Virginia","Lee County",3,7,210,112,98
050,51,105,"Virginia","Lee County",3,8,226,119,107
050,51,105,"Virginia","Lee County",3,9,241,133,108
050,51,105,"Virginia","Lee County",3,10,251,134,117
050,51,105,"Virginia","Lee County",3,11,237,123,114
050,51,105,"Virginia","Lee County",3,12,250,132,118
050,51,105,"Virginia","Lee County",3,13,242,127,115
050,51,105,"Virginia","Lee County",3,14,247,125,122
050,51,105,"Virginia","Lee County",3,15,244,122,122
050,51,105,"Virginia","Lee County",3,16,253,134,119
050,51,105,"Virginia","Lee County",3,17,254,132,122
050,51,105,"Virginia","Lee County",3,18,221,127,94
050,51,105,"Virginia","Lee County",3,19,170,99,71
050,51,105,"Virginia","Lee County",3,20,176,96,80
050,51,105,"Virginia","Lee County",3,21,189,95,94
050,51,105,"Virginia","Lee County",3,22,210,108,102
050,51,105,"Virginia","Lee County",3,23,240,133,107
050,51,105,"Virginia","Lee County",3,24,258,147,111
050,51,105,"Virginia","Lee County",3,25,252,151,101
050,51,105,"Virginia","Lee County",3,26,270,168,102
050,51,105,"Virginia","Lee County",3,27,256,163,93
050,51,105,"Virginia","Lee County",3,28,260,157,103
050,51,105,"Virginia","Lee County",3,29,283,173,110
050,51,105,"Virginia","Lee County",3,30,331,207,124
050,51,105,"Virginia","Lee County",3,31,297,183,114
050,51,105,"Virginia","Lee County",3,32,305,197,108
050,51,105,"Virginia","Lee County",3,33,310,204,106
050,51,105,"Virginia","Lee County",3,34,306,199,107
050,51,105,"Virginia","Lee County",3,35,268,162,106
050,51,105,"Virginia","Lee County",3,36,247,153,94
050,51,105,"Virginia","Lee County",3,37,229,141,88
050,51,105,"Virginia","Lee County",3,38,249,140,109
050,51,105,"Virginia","Lee County",3,39,270,159,111
050,51,105,"Virginia","Lee County",3,40,259,143,116
050,51,105,"Virginia","Lee County",3,41,280,162,118
050,51,105,"Virginia","Lee County",3,42,270,145,125
050,51,105,"Virginia","Lee County",3,43,264,149,115
050,51,105,"Virginia","Lee County",3,44,256,141,115
050,51,105,"Virginia","Lee County",3,45,273,148,125
050,51,105,"Virginia","Lee County",3,46,296,162,134
050,51,105,"Virginia","Lee County",3,47,279,151,128
050,51,105,"Virginia","Lee County",3,48,287,163,124
050,51,105,"Virginia","Lee County",3,49,300,156,144
050,51,105,"Virginia","Lee County",3,50,309,150,159
050,51,105,"Virginia","Lee County",3,51,294,147,147
050,51,105,"Virginia","Lee County",3,52,294,146,148
050,51,105,"Virginia","Lee County",3,53,295,158,137
050,51,105,"Virginia","Lee County",3,54,294,144,150
050,51,105,"Virginia","Lee County",3,55,297,146,151
050,51,105,"Virginia","Lee County",3,56,281,129,152
050,51,105,"Virginia","Lee County",3,57,300,138,162
050,51,105,"Virginia","Lee County",3,58,298,141,157
050,51,105,"Virginia","Lee County",3,59,292,148,144
050,51,105,"Virginia","Lee County",3,60,314,161,153
050,51,105,"Virginia","Lee County",3,61,329,162,167
050,51,105,"Virginia","Lee County",3,62,318,158,160
050,51,105,"Virginia","Lee County",3,63,338,167,171
050,51,105,"Virginia","Lee County",3,64,327,155,172
050,51,105,"Virginia","Lee County",3,65,310,154,156
050,51,105,"Virginia","Lee County",3,66,334,171,163
050,51,105,"Virginia","Lee County",3,67,318,163,155
050,51,105,"Virginia","Lee County",3,68,313,153,160
050,51,105,"Virginia","Lee County",3,69,311,159,152
050,51,105,"Virginia","Lee County",3,70,299,149,150
050,51,105,"Virginia","Lee County",3,71,275,130,145
050,51,105,"Virginia","Lee County",3,72,271,137,134
050,51,105,"Virginia","Lee County",3,73,268,133,135
050,51,105,"Virginia","Lee County",3,74,279,136,143
050,51,105,"Virginia","Lee County",3,75,200,95,105
050,51,105,"Virginia","Lee County",3,76,191,93,98
050,51,105,"Virginia","Lee County",3,77,193,97,96
050,51,105,"Virginia","Lee County",3,78,207,102,105
050,51,105,"Virginia","Lee County",3,79,161,67,94
050,51,105,"Virginia","Lee County",3,80,143,56,87
050,51,105,"Virginia","Lee County",3,81,128,55,73
050,51,105,"Virginia","Lee County",3,82,127,48,79
050,51,105,"Virginia","Lee County",3,83,116,48,68
050,51,105,"Virginia","Lee County",3,84,97,41,56
050,51,105,"Virginia","Lee County",3,85,442,183,259
050,51,105,"Virginia","Lee County",4,0,166,85,81
050,51,105,"Virginia","Lee County",4,1,200,107,93
050,51,105,"Virginia","Lee County",4,2,206,101,105
050,51,105,"Virginia","Lee County",4,3,202,99,103
050,51,105,"Virginia","Lee County",4,4,199,107,92
050,51,105,"Virginia","Lee County",4,5,198,113,85
050,51,105,"Virginia","Lee County",4,6,216,124,92
050,51,105,"Virginia","Lee County",4,7,230,126,104
050,51,105,"Virginia","Lee County",4,8,214,111,103
050,51,105,"Virginia","Lee County",4,9,235,125,110
050,51,105,"Virginia","Lee County",4,10,237,129,108
050,51,105,"Virginia","Lee County",4,11,252,133,119
050,51,105,"Virginia","Lee County",4,12,247,125,122
050,51,105,"Virginia","Lee County",4,13,247,127,120
050,51,105,"Virginia","Lee County",4,14,244,129,115
050,51,105,"Virginia","Lee County",4,15,246,126,120
050,51,105,"Virginia","Lee County",4,16,253,124,129
050,51,105,"Virginia","Lee County",4,17,244,128,116
050,51,105,"Virginia","Lee County",4,18,221,120,101
050,51,105,"Virginia","Lee County",4,19,165,98,67
050,51,105,"Virginia","Lee County",4,20,174,100,74
050,51,105,"Virginia","Lee County",4,21,199,109,90
050,51,105,"Virginia","Lee County",4,22,197,97,100
050,51,105,"Virginia","Lee County",4,23,229,116,113
050,51,105,"Virginia","Lee County",4,24,237,135,102
050,51,105,"Virginia","Lee County",4,25,290,172,118
050,51,105,"Virginia","Lee County",4,26,266,161,105
050,51,105,"Virginia","Lee County",4,27,267,166,101
050,51,105,"Virginia","Lee County",4,28,261,157,104
050,51,105,"Virginia","Lee County",4,29,272,166,106
050,51,105,"Virginia","Lee County",4,30,305,192,113
050,51,105,"Virginia","Lee County",4,31,298,187,111
050,51,105,"Virginia","Lee County",4,32,323,207,116
050,51,105,"Virginia","Lee County",4,33,302,195,107
050,51,105,"Virginia","Lee County",4,34,291,181,110
050,51,105,"Virginia","Lee County",4,35,289,189,100
050,51,105,"Virginia","Lee County",4,36,269,158,111
050,51,105,"Virginia","Lee County",4,37,246,147,99
050,51,105,"Virginia","Lee County",4,38,212,125,87
050,51,105,"Virginia","Lee County",4,39,259,151,108
050,51,105,"Virginia","Lee County",4,40,248,135,113
050,51,105,"Virginia","Lee County",4,41,264,150,114
050,51,105,"Virginia","Lee County",4,42,256,146,110
050,51,105,"Virginia","Lee County",4,43,291,163,128
050,51,105,"Virginia","Lee County",4,44,256,137,119
050,51,105,"Virginia","Lee County",4,45,264,141,123
050,51,105,"Virginia","Lee County",4,46,285,158,127
050,51,105,"Virginia","Lee County",4,47,287,150,137
050,51,105,"Virginia","Lee County",4,48,288,156,132
050,51,105,"Virginia","Lee County",4,49,281,151,130
050,51,105,"Virginia","Lee County",4,50,314,167,147
050,51,105,"Virginia","Lee County",4,51,303,150,153
050,51,105,"Virginia","Lee County",4,52,283,139,144
050,51,105,"Virginia","Lee County",4,53,288,146,142
050,51,105,"Virginia","Lee County",4,54,287,149,138
050,51,105,"Virginia","Lee County",4,55,300,146,154
050,51,105,"Virginia","Lee County",4,56,286,137,149
050,51,105,"Virginia","Lee County",4,57,276,127,149
050,51,105,"Virginia","Lee County",4,58,284,130,154
050,51,105,"Virginia","Lee County",4,59,282,129,153
050,51,105,"Virginia","Lee County",4,60,291,148,143
050,51,105,"Virginia","Lee County",4,61,308,156,152
050,51,105,"Virginia","Lee County",4,62,314,150,164
050,51,105,"Virginia","Lee County",4,63,320,158,162
050,51,105,"Virginia","Lee County",4,64,319,159,160
050,51,105,"Virginia","Lee County",4,65,332,159,173
050,51,105,"Virginia","Lee County",4,66,318,154,164
050,51,105,"Virginia","Lee County",4,67,334,166,168
050,51,105,"Virginia","Lee County",4,68,313,161,152
050,51,105,"Virginia","Lee County",4,69,308,149,159
050,51,105,"Virginia","Lee County",4,70,305,150,155
050,51,105,"Virginia","Lee County",4,71,294,147,147
050,51,105,"Virginia","Lee County",4,72,267,127,140
050,51,105,"Virginia","Lee County",4,73,256,127,129
050,51,105,"Virginia","Lee County",4,74,266,131,135
050,51,105,"Virginia","Lee County",4,75,271,131,140
050,51,105,"Virginia","Lee County",4,76,194,91,103
050,51,105,"Virginia","Lee County",4,77,176,83,93
050,51,105,"Virginia","Lee County",4,78,179,89,90
050,51,105,"Virginia","Lee County",4,79,202,97,105
050,51,105,"Virginia","Lee County",4,80,151,61,90
050,51,105,"Virginia","Lee County",4,81,127,48,79
050,51,105,"Virginia","Lee County",4,82,119,46,73
050,51,105,"Virginia","Lee County",4,83,113,42,71
050,51,105,"Virginia","Lee County",4,84,108,45,63
050,51,105,"Virginia","Lee County",4,85,431,185,246
050,51,105,"Virginia","Lee County",5,0,172,87,85
050,51,105,"Virginia","Lee County",5,1,172,91,81
050,51,105,"Virginia","Lee County",5,2,188,100,88
050,51,105,"Virginia","Lee County",5,3,196,96,100
050,51,105,"Virginia","Lee County",5,4,203,100,103
050,51,105,"Virginia","Lee County",5,5,202,110,92
050,51,105,"Virginia","Lee County",5,6,200,116,84
050,51,105,"Virginia","Lee County",5,7,210,118,92
050,51,105,"Virginia","Lee County",5,8,235,129,106
050,51,105,"Virginia","Lee County",5,9,219,113,106
050,51,105,"Virginia","Lee County",5,10,230,114,116
050,51,105,"Virginia","Lee County",5,11,241,133,108
050,51,105,"Virginia","Lee County",5,12,250,130,120
050,51,105,"Virginia","Lee County",5,13,253,132,121
050,51,105,"Virginia","Lee County",5,14,258,129,129
050,51,105,"Virginia","Lee County",5,15,248,130,118
050,51,105,"Virginia","Lee County",5,16,250,129,121
050,51,105,"Virginia","Lee County",5,17,248,122,126
050,51,105,"Virginia","Lee County",5,18,200,107,93
050,51,105,"Virginia","Lee County",5,19,176,98,78
050,51,105,"Virginia","Lee County",5,20,179,104,75
050,51,105,"Virginia","Lee County",5,21,203,118,85
050,51,105,"Virginia","Lee County",5,22,221,122,99
050,51,105,"Virginia","Lee County",5,23,215,114,101
050,51,105,"Virginia","Lee County",5,24,246,130,116
050,51,105,"Virginia","Lee County",5,25,253,157,96
050,51,105,"Virginia","Lee County",5,26,302,181,121
050,51,105,"Virginia","Lee County",5,27,264,161,103
050,51,105,"Virginia","Lee County",5,28,269,168,101
050,51,105,"Virginia","Lee County",5,29,267,164,103
050,51,105,"Virginia","Lee County",5,30,283,179,104
050,51,105,"Virginia","Lee County",5,31,278,171,107
050,51,105,"Virginia","Lee County",5,32,315,211,104
050,51,105,"Virginia","Lee County",5,33,325,209,116
050,51,105,"Virginia","Lee County",5,34,301,187,114
050,51,105,"Virginia","Lee County",5,35,282,173,109
050,51,105,"Virginia","Lee County",5,36,294,189,105
050,51,105,"Virginia","Lee County",5,37,272,156,116
050,51,105,"Virginia","Lee County",5,38,223,130,93
050,51,105,"Virginia","Lee County",5,39,220,130,90
050,51,105,"Virginia","Lee County",5,40,245,126,119
050,51,105,"Virginia","Lee County",5,41,249,141,108
050,51,105,"Virginia","Lee County",5,42,253,139,114
050,51,105,"Virginia","Lee County",5,43,286,169,117
050,51,105,"Virginia","Lee County",5,44,275,148,127
050,51,105,"Virginia","Lee County",5,45,254,132,122
050,51,105,"Virginia","Lee County",5,46,269,151,118
050,51,105,"Virginia","Lee County",5,47,276,147,129
050,51,105,"Virginia","Lee County",5,48,292,153,139
050,51,105,"Virginia","Lee County",5,49,265,132,133
050,51,105,"Virginia","Lee County",5,50,286,158,128
050,51,105,"Virginia","Lee County",5,51,323,173,150
050,51,105,"Virginia","Lee County",5,52,295,139,156
050,51,105,"Virginia","Lee County",5,53,284,143,141
050,51,105,"Virginia","Lee County",5,54,273,133,140
050,51,105,"Virginia","Lee County",5,55,290,150,140
050,51,105,"Virginia","Lee County",5,56,294,142,152
050,51,105,"Virginia","Lee County",5,57,291,142,149
050,51,105,"Virginia","Lee County",5,58,266,126,140
050,51,105,"Virginia","Lee County",5,59,272,122,150
050,51,105,"Virginia","Lee County",5,60,282,130,152
050,51,105,"Virginia","Lee County",5,61,297,154,143
050,51,105,"Virginia","Lee County",5,62,296,147,149
050,51,105,"Virginia","Lee County",5,63,310,146,164
050,51,105,"Virginia","Lee County",5,64,310,154,156
050,51,105,"Virginia","Lee County",5,65,318,160,158
050,51,105,"Virginia","Lee County",5,66,329,153,176
050,51,105,"Virginia","Lee County",5,67,314,146,168
050,51,105,"Virginia","Lee County",5,68,330,165,165
050,51,105,"Virginia","Lee County",5,69,312,159,153
050,51,105,"Virginia","Lee County",5,70,301,141,160
050,51,105,"Virginia","Lee County",5,71,298,146,152
050,51,105,"Virginia","Lee County",5,72,281,139,142
050,51,105,"Virginia","Lee County",5,73,257,120,137
050,51,105,"Virginia","Lee County",5,74,254,125,129
050,51,105,"Virginia","Lee County",5,75,259,125,134
050,51,105,"Virginia","Lee County",5,76,270,128,142
050,51,105,"Virginia","Lee County",5,77,182,81,101
050,51,105,"Virginia","Lee County",5,78,161,73,88
050,51,105,"Virginia","Lee County",5,79,175,88,87
050,51,105,"Virginia","Lee County",5,80,193,90,103
050,51,105,"Virginia","Lee County",5,81,134,55,79
050,51,105,"Virginia","Lee County",5,82,117,39,78
050,51,105,"Virginia","Lee County",5,83,111,43,68
050,51,105,"Virginia","Lee County",5,84,103,39,64
050,51,105,"Virginia","Lee County",5,85,450,201,249
050,51,107,"Virginia","Loudoun County",1,0,5027,2563,2464
050,51,107,"Virginia","Loudoun County",1,1,5290,2679,2611
050,51,107,"Virginia","Loudoun County",1,2,5625,2891,2734
050,51,107,"Virginia","Loudoun County",1,3,5961,3018,2943
050,51,107,"Virginia","Loudoun County",1,4,6166,3118,3048
050,51,107,"Virginia","Loudoun County",1,5,6212,3129,3083
050,51,107,"Virginia","Loudoun County",1,6,6359,3231,3128
050,51,107,"Virginia","Loudoun County",1,7,6483,3347,3136
050,51,107,"Virginia","Loudoun County",1,8,6721,3491,3230
050,51,107,"Virginia","Loudoun County",1,9,6869,3564,3305
050,51,107,"Virginia","Loudoun County",1,10,6998,3649,3349
050,51,107,"Virginia","Loudoun County",1,11,7108,3658,3450
050,51,107,"Virginia","Loudoun County",1,12,7355,3756,3599
050,51,107,"Virginia","Loudoun County",1,13,7242,3704,3538
050,51,107,"Virginia","Loudoun County",1,14,7028,3608,3420
050,51,107,"Virginia","Loudoun County",1,15,7001,3597,3404
050,51,107,"Virginia","Loudoun County",1,16,6980,3470,3510
050,51,107,"Virginia","Loudoun County",1,17,6700,3325,3375
050,51,107,"Virginia","Loudoun County",1,18,5603,2932,2671
050,51,107,"Virginia","Loudoun County",1,19,4442,2290,2152
050,51,107,"Virginia","Loudoun County",1,20,4457,2251,2206
050,51,107,"Virginia","Loudoun County",1,21,4403,2211,2192
050,51,107,"Virginia","Loudoun County",1,22,4259,2140,2119
050,51,107,"Virginia","Loudoun County",1,23,4183,2104,2079
050,51,107,"Virginia","Loudoun County",1,24,4065,2047,2018
050,51,107,"Virginia","Loudoun County",1,25,3942,1975,1967
050,51,107,"Virginia","Loudoun County",1,26,4007,1998,2009
050,51,107,"Virginia","Loudoun County",1,27,4104,2055,2049
050,51,107,"Virginia","Loudoun County",1,28,4077,2018,2059
050,51,107,"Virginia","Loudoun County",1,29,4252,2089,2163
050,51,107,"Virginia","Loudoun County",1,30,4512,2214,2298
050,51,107,"Virginia","Loudoun County",1,31,4934,2338,2596
050,51,107,"Virginia","Loudoun County",1,32,5308,2532,2776
050,51,107,"Virginia","Loudoun County",1,33,5758,2720,3038
050,51,107,"Virginia","Loudoun County",1,34,6285,2982,3303
050,51,107,"Virginia","Loudoun County",1,35,6645,3145,3500
050,51,107,"Virginia","Loudoun County",1,36,6868,3353,3515
050,51,107,"Virginia","Loudoun County",1,37,7238,3570,3668
050,51,107,"Virginia","Loudoun County",1,38,7311,3606,3705
050,51,107,"Virginia","Loudoun County",1,39,7520,3781,3739
050,51,107,"Virginia","Loudoun County",1,40,7537,3759,3778
050,51,107,"Virginia","Loudoun County",1,41,7421,3631,3790
050,51,107,"Virginia","Loudoun County",1,42,7233,3618,3615
050,51,107,"Virginia","Loudoun County",1,43,7112,3551,3561
050,51,107,"Virginia","Loudoun County",1,44,7117,3522,3595
050,51,107,"Virginia","Loudoun County",1,45,6919,3544,3375
050,51,107,"Virginia","Loudoun County",1,46,6927,3602,3325
050,51,107,"Virginia","Loudoun County",1,47,6899,3605,3294
050,51,107,"Virginia","Loudoun County",1,48,7134,3715,3419
050,51,107,"Virginia","Loudoun County",1,49,7183,3771,3412
050,51,107,"Virginia","Loudoun County",1,50,6844,3570,3274
050,51,107,"Virginia","Loudoun County",1,51,6510,3358,3152
050,51,107,"Virginia","Loudoun County",1,52,6111,3084,3027
050,51,107,"Virginia","Loudoun County",1,53,5853,2900,2953
050,51,107,"Virginia","Loudoun County",1,54,5840,2974,2866
050,51,107,"Virginia","Loudoun County",1,55,5815,3007,2808
050,51,107,"Virginia","Loudoun County",1,56,5615,2875,2740
050,51,107,"Virginia","Loudoun County",1,57,5312,2747,2565
050,51,107,"Virginia","Loudoun County",1,58,5067,2687,2380
050,51,107,"Virginia","Loudoun County",1,59,4829,2532,2297
050,51,107,"Virginia","Loudoun County",1,60,4368,2256,2112
050,51,107,"Virginia","Loudoun County",1,61,4124,2036,2088
050,51,107,"Virginia","Loudoun County",1,62,3892,1944,1948
050,51,107,"Virginia","Loudoun County",1,63,3523,1746,1777
050,51,107,"Virginia","Loudoun County",1,64,3247,1618,1629
050,51,107,"Virginia","Loudoun County",1,65,3069,1493,1576
050,51,107,"Virginia","Loudoun County",1,66,2835,1398,1437
050,51,107,"Virginia","Loudoun County",1,67,2713,1320,1393
050,51,107,"Virginia","Loudoun County",1,68,2563,1218,1345
050,51,107,"Virginia","Loudoun County",1,69,2436,1133,1303
050,51,107,"Virginia","Loudoun County",1,70,2375,1127,1248
050,51,107,"Virginia","Loudoun County",1,71,2285,1069,1216
050,51,107,"Virginia","Loudoun County",1,72,2321,1089,1232
050,51,107,"Virginia","Loudoun County",1,73,2341,1081,1260
050,51,107,"Virginia","Loudoun County",1,74,1694,761,933
050,51,107,"Virginia","Loudoun County",1,75,1695,736,959
050,51,107,"Virginia","Loudoun County",1,76,1659,744,915
050,51,107,"Virginia","Loudoun County",1,77,1598,701,897
050,51,107,"Virginia","Loudoun County",1,78,1388,625,763
050,51,107,"Virginia","Loudoun County",1,79,1203,520,683
050,51,107,"Virginia","Loudoun County",1,80,1096,464,632
050,51,107,"Virginia","Loudoun County",1,81,986,438,548
050,51,107,"Virginia","Loudoun County",1,82,881,395,486
050,51,107,"Virginia","Loudoun County",1,83,831,342,489
050,51,107,"Virginia","Loudoun County",1,84,754,310,444
050,51,107,"Virginia","Loudoun County",1,85,4504,1700,2804
050,51,107,"Virginia","Loudoun County",2,0,4995,2539,2456
050,51,107,"Virginia","Loudoun County",2,1,5270,2673,2597
050,51,107,"Virginia","Loudoun County",2,2,5601,2872,2729
050,51,107,"Virginia","Loudoun County",2,3,5894,2994,2900
050,51,107,"Virginia","Loudoun County",2,4,6146,3110,3036
050,51,107,"Virginia","Loudoun County",2,5,6237,3149,3088
050,51,107,"Virginia","Loudoun County",2,6,6362,3225,3137
050,51,107,"Virginia","Loudoun County",2,7,6471,3330,3141
050,51,107,"Virginia","Loudoun County",2,8,6663,3456,3207
050,51,107,"Virginia","Loudoun County",2,9,6848,3554,3294
050,51,107,"Virginia","Loudoun County",2,10,6980,3636,3344
050,51,107,"Virginia","Loudoun County",2,11,7064,3637,3427
050,51,107,"Virginia","Loudoun County",2,12,7348,3751,3597
050,51,107,"Virginia","Loudoun County",2,13,7275,3724,3551
050,51,107,"Virginia","Loudoun County",2,14,7092,3646,3446
050,51,107,"Virginia","Loudoun County",2,15,7022,3609,3413
050,51,107,"Virginia","Loudoun County",2,16,6991,3502,3489
050,51,107,"Virginia","Loudoun County",2,17,6777,3369,3408
050,51,107,"Virginia","Loudoun County",2,18,5614,2915,2699
050,51,107,"Virginia","Loudoun County",2,19,4547,2354,2193
050,51,107,"Virginia","Loudoun County",2,20,4554,2306,2248
050,51,107,"Virginia","Loudoun County",2,21,4445,2231,2214
050,51,107,"Virginia","Loudoun County",2,22,4304,2162,2142
050,51,107,"Virginia","Loudoun County",2,23,4201,2122,2079
050,51,107,"Virginia","Loudoun County",2,24,4075,2058,2017
050,51,107,"Virginia","Loudoun County",2,25,3977,1993,1984
050,51,107,"Virginia","Loudoun County",2,26,4040,2016,2024
050,51,107,"Virginia","Loudoun County",2,27,4112,2057,2055
050,51,107,"Virginia","Loudoun County",2,28,4134,2050,2084
050,51,107,"Virginia","Loudoun County",2,29,4265,2099,2166
050,51,107,"Virginia","Loudoun County",2,30,4553,2227,2326
050,51,107,"Virginia","Loudoun County",2,31,4881,2328,2553
050,51,107,"Virginia","Loudoun County",2,32,5266,2511,2755
050,51,107,"Virginia","Loudoun County",2,33,5723,2721,3002
050,51,107,"Virginia","Loudoun County",2,34,6233,2961,3272
050,51,107,"Virginia","Loudoun County",2,35,6652,3160,3492
050,51,107,"Virginia","Loudoun County",2,36,6838,3320,3518
050,51,107,"Virginia","Loudoun County",2,37,7194,3542,3652
050,51,107,"Virginia","Loudoun County",2,38,7374,3639,3735
050,51,107,"Virginia","Loudoun County",2,39,7486,3751,3735
050,51,107,"Virginia","Loudoun County",2,40,7620,3811,3809
050,51,107,"Virginia","Loudoun County",2,41,7461,3670,3791
050,51,107,"Virginia","Loudoun County",2,42,7282,3628,3654
050,51,107,"Virginia","Loudoun County",2,43,7208,3604,3604
050,51,107,"Virginia","Loudoun County",2,44,7084,3523,3561
050,51,107,"Virginia","Loudoun County",2,45,7008,3563,3445
050,51,107,"Virginia","Loudoun County",2,46,6915,3588,3327
050,51,107,"Virginia","Loudoun County",2,47,6908,3608,3300
050,51,107,"Virginia","Loudoun County",2,48,7084,3693,3391
050,51,107,"Virginia","Loudoun County",2,49,7184,3771,3413
050,51,107,"Virginia","Loudoun County",2,50,6951,3638,3313
050,51,107,"Virginia","Loudoun County",2,51,6571,3397,3174
050,51,107,"Virginia","Loudoun County",2,52,6206,3148,3058
050,51,107,"Virginia","Loudoun County",2,53,5899,2937,2962
050,51,107,"Virginia","Loudoun County",2,54,5812,2940,2872
050,51,107,"Virginia","Loudoun County",2,55,5802,2992,2810
050,51,107,"Virginia","Loudoun County",2,56,5646,2898,2748
050,51,107,"Virginia","Loudoun County",2,57,5377,2777,2600
050,51,107,"Virginia","Loudoun County",2,58,5105,2688,2417
050,51,107,"Virginia","Loudoun County",2,59,4878,2569,2309
050,51,107,"Virginia","Loudoun County",2,60,4462,2309,2153
050,51,107,"Virginia","Loudoun County",2,61,4142,2063,2079
050,51,107,"Virginia","Loudoun County",2,62,3913,1944,1969
050,51,107,"Virginia","Loudoun County",2,63,3616,1792,1824
050,51,107,"Virginia","Loudoun County",2,64,3291,1630,1661
050,51,107,"Virginia","Loudoun County",2,65,3094,1510,1584
050,51,107,"Virginia","Loudoun County",2,66,2878,1412,1466
050,51,107,"Virginia","Loudoun County",2,67,2715,1324,1391
050,51,107,"Virginia","Loudoun County",2,68,2589,1236,1353
050,51,107,"Virginia","Loudoun County",2,69,2474,1157,1317
050,51,107,"Virginia","Loudoun County",2,70,2389,1127,1262
050,51,107,"Virginia","Loudoun County",2,71,2303,1075,1228
050,51,107,"Virginia","Loudoun County",2,72,2285,1065,1220
050,51,107,"Virginia","Loudoun County",2,73,2426,1119,1307
050,51,107,"Virginia","Loudoun County",2,74,1761,794,967
050,51,107,"Virginia","Loudoun County",2,75,1701,742,959
050,51,107,"Virginia","Loudoun County",2,76,1665,737,928
050,51,107,"Virginia","Loudoun County",2,77,1645,727,918
050,51,107,"Virginia","Loudoun County",2,78,1427,638,789
050,51,107,"Virginia","Loudoun County",2,79,1252,544,708
050,51,107,"Virginia","Loudoun County",2,80,1128,480,648
050,51,107,"Virginia","Loudoun County",2,81,1000,439,561
050,51,107,"Virginia","Loudoun County",2,82,909,405,504
050,51,107,"Virginia","Loudoun County",2,83,833,351,482
050,51,107,"Virginia","Loudoun County",2,84,765,317,448
050,51,107,"Virginia","Loudoun County",2,85,4537,1725,2812
050,51,107,"Virginia","Loudoun County",3,0,4804,2438,2366
050,51,107,"Virginia","Loudoun County",3,1,5200,2672,2528
050,51,107,"Virginia","Loudoun County",3,2,5524,2829,2695
050,51,107,"Virginia","Loudoun County",3,3,5751,2953,2798
050,51,107,"Virginia","Loudoun County",3,4,6065,3057,3008
050,51,107,"Virginia","Loudoun County",3,5,6252,3182,3070
050,51,107,"Virginia","Loudoun County",3,6,6315,3179,3136
050,51,107,"Virginia","Loudoun County",3,7,6407,3254,3153
050,51,107,"Virginia","Loudoun County",3,8,6478,3336,3142
050,51,107,"Virginia","Loudoun County",3,9,6702,3464,3238
050,51,107,"Virginia","Loudoun County",3,10,6843,3572,3271
050,51,107,"Virginia","Loudoun County",3,11,6954,3616,3338
050,51,107,"Virginia","Loudoun County",3,12,7096,3607,3489
050,51,107,"Virginia","Loudoun County",3,13,7398,3785,3613
050,51,107,"Virginia","Loudoun County",3,14,7301,3750,3551
050,51,107,"Virginia","Loudoun County",3,15,7111,3658,3453
050,51,107,"Virginia","Loudoun County",3,16,7039,3619,3420
050,51,107,"Virginia","Loudoun County",3,17,6928,3476,3452
050,51,107,"Virginia","Loudoun County",3,18,5785,2964,2821
050,51,107,"Virginia","Loudoun County",3,19,4655,2402,2253
050,51,107,"Virginia","Loudoun County",3,20,4799,2477,2322
050,51,107,"Virginia","Loudoun County",3,21,4749,2377,2372
050,51,107,"Virginia","Loudoun County",3,22,4566,2288,2278
050,51,107,"Virginia","Loudoun County",3,23,4379,2222,2157
050,51,107,"Virginia","Loudoun County",3,24,4210,2130,2080
050,51,107,"Virginia","Loudoun County",3,25,4171,2091,2080
050,51,107,"Virginia","Loudoun County",3,26,4079,2046,2033
050,51,107,"Virginia","Loudoun County",3,27,4128,2047,2081
050,51,107,"Virginia","Loudoun County",3,28,4431,2221,2210
050,51,107,"Virginia","Loudoun County",3,29,4394,2160,2234
050,51,107,"Virginia","Loudoun County",3,30,4605,2254,2351
050,51,107,"Virginia","Loudoun County",3,31,4807,2351,2456
050,51,107,"Virginia","Loudoun County",3,32,5247,2506,2741
050,51,107,"Virginia","Loudoun County",3,33,5595,2644,2951
050,51,107,"Virginia","Loudoun County",3,34,5996,2860,3136
050,51,107,"Virginia","Loudoun County",3,35,6564,3150,3414
050,51,107,"Virginia","Loudoun County",3,36,6892,3293,3599
050,51,107,"Virginia","Loudoun County",3,37,7054,3465,3589
050,51,107,"Virginia","Loudoun County",3,38,7322,3642,3680
050,51,107,"Virginia","Loudoun County",3,39,7594,3725,3869
050,51,107,"Virginia","Loudoun County",3,40,7620,3847,3773
050,51,107,"Virginia","Loudoun County",3,41,7725,3856,3869
050,51,107,"Virginia","Loudoun County",3,42,7503,3700,3803
050,51,107,"Virginia","Loudoun County",3,43,7371,3669,3702
050,51,107,"Virginia","Loudoun County",3,44,7266,3647,3619
050,51,107,"Virginia","Loudoun County",3,45,7127,3556,3571
050,51,107,"Virginia","Loudoun County",3,46,7018,3587,3431
050,51,107,"Virginia","Loudoun County",3,47,6902,3579,3323
050,51,107,"Virginia","Loudoun County",3,48,6900,3595,3305
050,51,107,"Virginia","Loudoun County",3,49,7074,3696,3378
050,51,107,"Virginia","Loudoun County",3,50,7124,3748,3376
050,51,107,"Virginia","Loudoun County",3,51,6867,3602,3265
050,51,107,"Virginia","Loudoun County",3,52,6451,3325,3126
050,51,107,"Virginia","Loudoun County",3,53,6115,3117,2998
050,51,107,"Virginia","Loudoun County",3,54,5829,2922,2907
050,51,107,"Virginia","Loudoun County",3,55,5732,2913,2819
050,51,107,"Virginia","Loudoun County",3,56,5719,2972,2747
050,51,107,"Virginia","Loudoun County",3,57,5561,2853,2708
050,51,107,"Virginia","Loudoun County",3,58,5259,2711,2548
050,51,107,"Virginia","Loudoun County",3,59,5018,2661,2357
050,51,107,"Virginia","Loudoun County",3,60,4778,2516,2262
050,51,107,"Virginia","Loudoun County",3,61,4315,2241,2074
050,51,107,"Virginia","Loudoun County",3,62,4008,1986,2022
050,51,107,"Virginia","Loudoun County",3,63,3814,1872,1942
050,51,107,"Virginia","Loudoun County",3,64,3534,1743,1791
050,51,107,"Virginia","Loudoun County",3,65,3222,1586,1636
050,51,107,"Virginia","Loudoun County",3,66,3029,1475,1554
050,51,107,"Virginia","Loudoun County",3,67,2819,1378,1441
050,51,107,"Virginia","Loudoun County",3,68,2672,1288,1384
050,51,107,"Virginia","Loudoun County",3,69,2542,1204,1338
050,51,107,"Virginia","Loudoun County",3,70,2443,1134,1309
050,51,107,"Virginia","Loudoun County",3,71,2351,1092,1259
050,51,107,"Virginia","Loudoun County",3,72,2278,1066,1212
050,51,107,"Virginia","Loudoun County",3,73,2271,1045,1226
050,51,107,"Virginia","Loudoun County",3,74,2420,1108,1312
050,51,107,"Virginia","Loudoun County",3,75,1738,769,969
050,51,107,"Virginia","Loudoun County",3,76,1706,751,955
050,51,107,"Virginia","Loudoun County",3,77,1617,708,909
050,51,107,"Virginia","Loudoun County",3,78,1631,719,912
050,51,107,"Virginia","Loudoun County",3,79,1422,623,799
050,51,107,"Virginia","Loudoun County",3,80,1246,552,694
050,51,107,"Virginia","Loudoun County",3,81,1098,458,640
050,51,107,"Virginia","Loudoun County",3,82,984,418,566
050,51,107,"Virginia","Loudoun County",3,83,864,386,478
050,51,107,"Virginia","Loudoun County",3,84,802,334,468
050,51,107,"Virginia","Loudoun County",3,85,4789,1821,2968
050,51,107,"Virginia","Loudoun County",4,0,4987,2602,2385
050,51,107,"Virginia","Loudoun County",4,1,5029,2551,2478
050,51,107,"Virginia","Loudoun County",4,2,5384,2793,2591
050,51,107,"Virginia","Loudoun County",4,3,5665,2948,2717
050,51,107,"Virginia","Loudoun County",4,4,5888,3025,2863
050,51,107,"Virginia","Loudoun County",4,5,6102,3063,3039
050,51,107,"Virginia","Loudoun County",4,6,6347,3205,3142
050,51,107,"Virginia","Loudoun County",4,7,6418,3241,3177
050,51,107,"Virginia","Loudoun County",4,8,6434,3274,3160
050,51,107,"Virginia","Loudoun County",4,9,6496,3308,3188
050,51,107,"Virginia","Loudoun County",4,10,6759,3493,3266
050,51,107,"Virginia","Loudoun County",4,11,6811,3563,3248
050,51,107,"Virginia","Loudoun County",4,12,7007,3640,3367
050,51,107,"Virginia","Loudoun County",4,13,7081,3610,3471
050,51,107,"Virginia","Loudoun County",4,14,7432,3828,3604
050,51,107,"Virginia","Loudoun County",4,15,7299,3743,3556
050,51,107,"Virginia","Loudoun County",4,16,7100,3645,3455
050,51,107,"Virginia","Loudoun County",4,17,7004,3594,3410
050,51,107,"Virginia","Loudoun County",4,18,5881,3029,2852
050,51,107,"Virginia","Loudoun County",4,19,4664,2377,2287
050,51,107,"Virginia","Loudoun County",4,20,4790,2453,2337
050,51,107,"Virginia","Loudoun County",4,21,4893,2523,2370
050,51,107,"Virginia","Loudoun County",4,22,4849,2384,2465
050,51,107,"Virginia","Loudoun County",4,23,4553,2311,2242
050,51,107,"Virginia","Loudoun County",4,24,4185,2110,2075
050,51,107,"Virginia","Loudoun County",4,25,4130,2077,2053
050,51,107,"Virginia","Loudoun County",4,26,4102,2079,2023
050,51,107,"Virginia","Loudoun County",4,27,4093,2044,2049
050,51,107,"Virginia","Loudoun County",4,28,4210,2064,2146
050,51,107,"Virginia","Loudoun County",4,29,4559,2251,2308
050,51,107,"Virginia","Loudoun County",4,30,4592,2239,2353
050,51,107,"Virginia","Loudoun County",4,31,4842,2365,2477
050,51,107,"Virginia","Loudoun County",4,32,5055,2477,2578
050,51,107,"Virginia","Loudoun County",4,33,5548,2639,2909
050,51,107,"Virginia","Loudoun County",4,34,5854,2780,3074
050,51,107,"Virginia","Loudoun County",4,35,6157,2926,3231
050,51,107,"Virginia","Loudoun County",4,36,6757,3244,3513
050,51,107,"Virginia","Loudoun County",4,37,7044,3391,3653
050,51,107,"Virginia","Loudoun County",4,38,7338,3599,3739
050,51,107,"Virginia","Loudoun County",4,39,7494,3733,3761
050,51,107,"Virginia","Loudoun County",4,40,7776,3850,3926
050,51,107,"Virginia","Loudoun County",4,41,7704,3916,3788
050,51,107,"Virginia","Loudoun County",4,42,7823,3912,3911
050,51,107,"Virginia","Loudoun County",4,43,7514,3708,3806
050,51,107,"Virginia","Loudoun County",4,44,7388,3680,3708
050,51,107,"Virginia","Loudoun County",4,45,7288,3651,3637
050,51,107,"Virginia","Loudoun County",4,46,7114,3577,3537
050,51,107,"Virginia","Loudoun County",4,47,7020,3599,3421
050,51,107,"Virginia","Loudoun County",4,48,6852,3577,3275
050,51,107,"Virginia","Loudoun County",4,49,6844,3606,3238
050,51,107,"Virginia","Loudoun County",4,50,7016,3681,3335
050,51,107,"Virginia","Loudoun County",4,51,7058,3708,3350
050,51,107,"Virginia","Loudoun County",4,52,6780,3568,3212
050,51,107,"Virginia","Loudoun County",4,53,6327,3268,3059
050,51,107,"Virginia","Loudoun County",4,54,5992,3054,2938
050,51,107,"Virginia","Loudoun County",4,55,5729,2896,2833
050,51,107,"Virginia","Loudoun County",4,56,5619,2862,2757
050,51,107,"Virginia","Loudoun County",4,57,5546,2899,2647
050,51,107,"Virginia","Loudoun County",4,58,5466,2776,2690
050,51,107,"Virginia","Loudoun County",4,59,5124,2643,2481
050,51,107,"Virginia","Loudoun County",4,60,4893,2613,2280
050,51,107,"Virginia","Loudoun County",4,61,4636,2459,2177
050,51,107,"Virginia","Loudoun County",4,62,4152,2145,2007
050,51,107,"Virginia","Loudoun County",4,63,3837,1882,1955
050,51,107,"Virginia","Loudoun County",4,64,3723,1803,1920
050,51,107,"Virginia","Loudoun County",4,65,3471,1687,1784
050,51,107,"Virginia","Loudoun County",4,66,3121,1519,1602
050,51,107,"Virginia","Loudoun County",4,67,2953,1420,1533
050,51,107,"Virginia","Loudoun County",4,68,2746,1319,1427
050,51,107,"Virginia","Loudoun County",4,69,2699,1299,1400
050,51,107,"Virginia","Loudoun County",4,70,2564,1196,1368
050,51,107,"Virginia","Loudoun County",4,71,2434,1107,1327
050,51,107,"Virginia","Loudoun County",4,72,2343,1096,1247
050,51,107,"Virginia","Loudoun County",4,73,2269,1067,1202
050,51,107,"Virginia","Loudoun County",4,74,2266,1043,1223
050,51,107,"Virginia","Loudoun County",4,75,2390,1076,1314
050,51,107,"Virginia","Loudoun County",4,76,1770,780,990
050,51,107,"Virginia","Loudoun County",4,77,1673,744,929
050,51,107,"Virginia","Loudoun County",4,78,1625,712,913
050,51,107,"Virginia","Loudoun County",4,79,1648,710,938
050,51,107,"Virginia","Loudoun County",4,80,1435,635,800
050,51,107,"Virginia","Loudoun County",4,81,1206,522,684
050,51,107,"Virginia","Loudoun County",4,82,1101,455,646
050,51,107,"Virginia","Loudoun County",4,83,983,424,559
050,51,107,"Virginia","Loudoun County",4,84,861,379,482
050,51,107,"Virginia","Loudoun County",4,85,5180,1993,3187
050,51,107,"Virginia","Loudoun County",5,0,4903,2564,2339
050,51,107,"Virginia","Loudoun County",5,1,5071,2607,2464
050,51,107,"Virginia","Loudoun County",5,2,5121,2635,2486
050,51,107,"Virginia","Loudoun County",5,3,5464,2837,2627
050,51,107,"Virginia","Loudoun County",5,4,5732,2978,2754
050,51,107,"Virginia","Loudoun County",5,5,5888,3031,2857
050,51,107,"Virginia","Loudoun County",5,6,6193,3115,3078
050,51,107,"Virginia","Loudoun County",5,7,6401,3236,3165
050,51,107,"Virginia","Loudoun County",5,8,6478,3282,3196
050,51,107,"Virginia","Loudoun County",5,9,6451,3299,3152
050,51,107,"Virginia","Loudoun County",5,10,6542,3343,3199
050,51,107,"Virginia","Loudoun County",5,11,6754,3492,3262
050,51,107,"Virginia","Loudoun County",5,12,6853,3576,3277
050,51,107,"Virginia","Loudoun County",5,13,7063,3700,3363
050,51,107,"Virginia","Loudoun County",5,14,7167,3679,3488
050,51,107,"Virginia","Loudoun County",5,15,7463,3833,3630
050,51,107,"Virginia","Loudoun County",5,16,7296,3747,3549
050,51,107,"Virginia","Loudoun County",5,17,7114,3670,3444
050,51,107,"Virginia","Loudoun County",5,18,5894,3106,2788
050,51,107,"Virginia","Loudoun County",5,19,4762,2456,2306
050,51,107,"Virginia","Loudoun County",5,20,4908,2488,2420
050,51,107,"Virginia","Loudoun County",5,21,4990,2545,2445
050,51,107,"Virginia","Loudoun County",5,22,4964,2522,2442
050,51,107,"Virginia","Loudoun County",5,23,4756,2367,2389
050,51,107,"Virginia","Loudoun County",5,24,4406,2201,2205
050,51,107,"Virginia","Loudoun County",5,25,4108,2087,2021
050,51,107,"Virginia","Loudoun County",5,26,4120,2099,2021
050,51,107,"Virginia","Loudoun County",5,27,4086,2053,2033
050,51,107,"Virginia","Loudoun County",5,28,4143,2062,2081
050,51,107,"Virginia","Loudoun County",5,29,4345,2107,2238
050,51,107,"Virginia","Loudoun County",5,30,4675,2261,2414
050,51,107,"Virginia","Loudoun County",5,31,4828,2377,2451
050,51,107,"Virginia","Loudoun County",5,32,5030,2427,2603
050,51,107,"Virginia","Loudoun County",5,33,5287,2618,2669
050,51,107,"Virginia","Loudoun County",5,34,5696,2754,2942
050,51,107,"Virginia","Loudoun County",5,35,6011,2876,3135
050,51,107,"Virginia","Loudoun County",5,36,6361,2990,3371
050,51,107,"Virginia","Loudoun County",5,37,6888,3313,3575
050,51,107,"Virginia","Loudoun County",5,38,7197,3486,3711
050,51,107,"Virginia","Loudoun County",5,39,7431,3648,3783
050,51,107,"Virginia","Loudoun County",5,40,7597,3786,3811
050,51,107,"Virginia","Loudoun County",5,41,7821,3895,3926
050,51,107,"Virginia","Loudoun County",5,42,7768,3958,3810
050,51,107,"Virginia","Loudoun County",5,43,7863,3934,3929
050,51,107,"Virginia","Loudoun County",5,44,7577,3748,3829
050,51,107,"Virginia","Loudoun County",5,45,7436,3716,3720
050,51,107,"Virginia","Loudoun County",5,46,7338,3687,3651
050,51,107,"Virginia","Loudoun County",5,47,7041,3552,3489
050,51,107,"Virginia","Loudoun County",5,48,6997,3584,3413
050,51,107,"Virginia","Loudoun County",5,49,6806,3533,3273
050,51,107,"Virginia","Loudoun County",5,50,6804,3572,3232
050,51,107,"Virginia","Loudoun County",5,51,6939,3654,3285
050,51,107,"Virginia","Loudoun County",5,52,6931,3641,3290
050,51,107,"Virginia","Loudoun County",5,53,6709,3539,3170
050,51,107,"Virginia","Loudoun County",5,54,6260,3223,3037
050,51,107,"Virginia","Loudoun County",5,55,5961,3027,2934
050,51,107,"Virginia","Loudoun County",5,56,5660,2878,2782
050,51,107,"Virginia","Loudoun County",5,57,5465,2819,2646
050,51,107,"Virginia","Loudoun County",5,58,5421,2833,2588
050,51,107,"Virginia","Loudoun County",5,59,5311,2696,2615
050,51,107,"Virginia","Loudoun County",5,60,5031,2596,2435
050,51,107,"Virginia","Loudoun County",5,61,4793,2540,2253
050,51,107,"Virginia","Loudoun County",5,62,4471,2374,2097
050,51,107,"Virginia","Loudoun County",5,63,4032,2078,1954
050,51,107,"Virginia","Loudoun County",5,64,3764,1848,1916
050,51,107,"Virginia","Loudoun County",5,65,3661,1751,1910
050,51,107,"Virginia","Loudoun County",5,66,3385,1618,1767
050,51,107,"Virginia","Loudoun County",5,67,3050,1476,1574
050,51,107,"Virginia","Loudoun County",5,68,2891,1395,1496
050,51,107,"Virginia","Loudoun County",5,69,2790,1331,1459
050,51,107,"Virginia","Loudoun County",5,70,2717,1270,1447
050,51,107,"Virginia","Loudoun County",5,71,2578,1203,1375
050,51,107,"Virginia","Loudoun County",5,72,2450,1105,1345
050,51,107,"Virginia","Loudoun County",5,73,2339,1089,1250
050,51,107,"Virginia","Loudoun County",5,74,2263,1058,1205
050,51,107,"Virginia","Loudoun County",5,75,2246,1013,1233
050,51,107,"Virginia","Loudoun County",5,76,2417,1091,1326
050,51,107,"Virginia","Loudoun County",5,77,1714,745,969
050,51,107,"Virginia","Loudoun County",5,78,1670,745,925
050,51,107,"Virginia","Loudoun County",5,79,1631,708,923
050,51,107,"Virginia","Loudoun County",5,80,1634,706,928
050,51,107,"Virginia","Loudoun County",5,81,1376,616,760
050,51,107,"Virginia","Loudoun County",5,82,1207,523,684
050,51,107,"Virginia","Loudoun County",5,83,1098,460,638
050,51,107,"Virginia","Loudoun County",5,84,981,419,562
050,51,107,"Virginia","Loudoun County",5,85,5613,2189,3424
050,51,109,"Virginia","Louisa County",1,0,371,187,184
050,51,109,"Virginia","Louisa County",1,1,386,198,188
050,51,109,"Virginia","Louisa County",1,2,404,205,199
050,51,109,"Virginia","Louisa County",1,3,404,205,199
050,51,109,"Virginia","Louisa County",1,4,440,239,201
050,51,109,"Virginia","Louisa County",1,5,401,204,197
050,51,109,"Virginia","Louisa County",1,6,417,210,207
050,51,109,"Virginia","Louisa County",1,7,418,216,202
050,51,109,"Virginia","Louisa County",1,8,418,212,206
050,51,109,"Virginia","Louisa County",1,9,405,186,219
050,51,109,"Virginia","Louisa County",1,10,423,210,213
050,51,109,"Virginia","Louisa County",1,11,442,212,230
050,51,109,"Virginia","Louisa County",1,12,476,233,243
050,51,109,"Virginia","Louisa County",1,13,466,238,228
050,51,109,"Virginia","Louisa County",1,14,430,225,205
050,51,109,"Virginia","Louisa County",1,15,436,227,209
050,51,109,"Virginia","Louisa County",1,16,434,215,219
050,51,109,"Virginia","Louisa County",1,17,427,206,221
050,51,109,"Virginia","Louisa County",1,18,377,200,177
050,51,109,"Virginia","Louisa County",1,19,302,159,143
050,51,109,"Virginia","Louisa County",1,20,307,156,151
050,51,109,"Virginia","Louisa County",1,21,315,155,160
050,51,109,"Virginia","Louisa County",1,22,332,178,154
050,51,109,"Virginia","Louisa County",1,23,342,180,162
050,51,109,"Virginia","Louisa County",1,24,375,184,191
050,51,109,"Virginia","Louisa County",1,25,422,217,205
050,51,109,"Virginia","Louisa County",1,26,438,213,225
050,51,109,"Virginia","Louisa County",1,27,450,230,220
050,51,109,"Virginia","Louisa County",1,28,473,222,251
050,51,109,"Virginia","Louisa County",1,29,458,226,232
050,51,109,"Virginia","Louisa County",1,30,434,210,224
050,51,109,"Virginia","Louisa County",1,31,449,219,230
050,51,109,"Virginia","Louisa County",1,32,450,220,230
050,51,109,"Virginia","Louisa County",1,33,456,222,234
050,51,109,"Virginia","Louisa County",1,34,455,228,227
050,51,109,"Virginia","Louisa County",1,35,480,239,241
050,51,109,"Virginia","Louisa County",1,36,431,219,212
050,51,109,"Virginia","Louisa County",1,37,460,235,225
050,51,109,"Virginia","Louisa County",1,38,479,268,211
050,51,109,"Virginia","Louisa County",1,39,465,242,223
050,51,109,"Virginia","Louisa County",1,40,452,225,227
050,51,109,"Virginia","Louisa County",1,41,416,203,213
050,51,109,"Virginia","Louisa County",1,42,402,199,203
050,51,109,"Virginia","Louisa County",1,43,432,229,203
050,51,109,"Virginia","Louisa County",1,44,419,214,205
050,51,109,"Virginia","Louisa County",1,45,383,193,190
050,51,109,"Virginia","Louisa County",1,46,388,192,196
050,51,109,"Virginia","Louisa County",1,47,430,221,209
050,51,109,"Virginia","Louisa County",1,48,448,232,216
050,51,109,"Virginia","Louisa County",1,49,514,268,246
050,51,109,"Virginia","Louisa County",1,50,488,250,238
050,51,109,"Virginia","Louisa County",1,51,513,252,261
050,51,109,"Virginia","Louisa County",1,52,522,262,260
050,51,109,"Virginia","Louisa County",1,53,548,266,282
050,51,109,"Virginia","Louisa County",1,54,574,284,290
050,51,109,"Virginia","Louisa County",1,55,601,289,312
050,51,109,"Virginia","Louisa County",1,56,612,276,336
050,51,109,"Virginia","Louisa County",1,57,666,321,345
050,51,109,"Virginia","Louisa County",1,58,664,347,317
050,51,109,"Virginia","Louisa County",1,59,678,334,344
050,51,109,"Virginia","Louisa County",1,60,654,311,343
050,51,109,"Virginia","Louisa County",1,61,627,314,313
050,51,109,"Virginia","Louisa County",1,62,645,312,333
050,51,109,"Virginia","Louisa County",1,63,589,298,291
050,51,109,"Virginia","Louisa County",1,64,595,295,300
050,51,109,"Virginia","Louisa County",1,65,606,313,293
050,51,109,"Virginia","Louisa County",1,66,544,269,275
050,51,109,"Virginia","Louisa County",1,67,528,245,283
050,51,109,"Virginia","Louisa County",1,68,534,264,270
050,51,109,"Virginia","Louisa County",1,69,498,244,254
050,51,109,"Virginia","Louisa County",1,70,491,254,237
050,51,109,"Virginia","Louisa County",1,71,459,230,229
050,51,109,"Virginia","Louisa County",1,72,436,219,217
050,51,109,"Virginia","Louisa County",1,73,453,224,229
050,51,109,"Virginia","Louisa County",1,74,325,156,169
050,51,109,"Virginia","Louisa County",1,75,312,155,157
050,51,109,"Virginia","Louisa County",1,76,295,153,142
050,51,109,"Virginia","Louisa County",1,77,266,126,140
050,51,109,"Virginia","Louisa County",1,78,235,98,137
050,51,109,"Virginia","Louisa County",1,79,225,108,117
050,51,109,"Virginia","Louisa County",1,80,200,98,102
050,51,109,"Virginia","Louisa County",1,81,182,96,86
050,51,109,"Virginia","Louisa County",1,82,170,87,83
050,51,109,"Virginia","Louisa County",1,83,141,69,72
050,51,109,"Virginia","Louisa County",1,84,103,52,51
050,51,109,"Virginia","Louisa County",1,85,586,237,349
050,51,109,"Virginia","Louisa County",2,0,390,198,192
050,51,109,"Virginia","Louisa County",2,1,383,196,187
050,51,109,"Virginia","Louisa County",2,2,399,202,197
050,51,109,"Virginia","Louisa County",2,3,407,208,199
050,51,109,"Virginia","Louisa County",2,4,434,232,202
050,51,109,"Virginia","Louisa County",2,5,411,211,200
050,51,109,"Virginia","Louisa County",2,6,414,211,203
050,51,109,"Virginia","Louisa County",2,7,418,216,202
050,51,109,"Virginia","Louisa County",2,8,418,212,206
050,51,109,"Virginia","Louisa County",2,9,407,192,215
050,51,109,"Virginia","Louisa County",2,10,419,203,216
050,51,109,"Virginia","Louisa County",2,11,436,210,226
050,51,109,"Virginia","Louisa County",2,12,472,230,242
050,51,109,"Virginia","Louisa County",2,13,468,237,231
050,51,109,"Virginia","Louisa County",2,14,441,230,211
050,51,109,"Virginia","Louisa County",2,15,438,229,209
050,51,109,"Virginia","Louisa County",2,16,437,218,219
050,51,109,"Virginia","Louisa County",2,17,433,211,222
050,51,109,"Virginia","Louisa County",2,18,373,195,178
050,51,109,"Virginia","Louisa County",2,19,303,159,144
050,51,109,"Virginia","Louisa County",2,20,316,162,154
050,51,109,"Virginia","Louisa County",2,21,317,157,160
050,51,109,"Virginia","Louisa County",2,22,333,174,159
050,51,109,"Virginia","Louisa County",2,23,347,181,166
050,51,109,"Virginia","Louisa County",2,24,376,188,188
050,51,109,"Virginia","Louisa County",2,25,418,213,205
050,51,109,"Virginia","Louisa County",2,26,438,217,221
050,51,109,"Virginia","Louisa County",2,27,457,232,225
050,51,109,"Virginia","Louisa County",2,28,472,227,245
050,51,109,"Virginia","Louisa County",2,29,464,226,238
050,51,109,"Virginia","Louisa County",2,30,452,219,233
050,51,109,"Virginia","Louisa County",2,31,449,216,233
050,51,109,"Virginia","Louisa County",2,32,454,223,231
050,51,109,"Virginia","Louisa County",2,33,458,225,233
050,51,109,"Virginia","Louisa County",2,34,456,228,228
050,51,109,"Virginia","Louisa County",2,35,478,239,239
050,51,109,"Virginia","Louisa County",2,36,446,225,221
050,51,109,"Virginia","Louisa County",2,37,459,234,225
050,51,109,"Virginia","Louisa County",2,38,478,262,216
050,51,109,"Virginia","Louisa County",2,39,467,248,219
050,51,109,"Virginia","Louisa County",2,40,465,235,230
050,51,109,"Virginia","Louisa County",2,41,425,206,219
050,51,109,"Virginia","Louisa County",2,42,401,197,204
050,51,109,"Virginia","Louisa County",2,43,430,225,205
050,51,109,"Virginia","Louisa County",2,44,420,217,203
050,51,109,"Virginia","Louisa County",2,45,398,201,197
050,51,109,"Virginia","Louisa County",2,46,387,192,195
050,51,109,"Virginia","Louisa County",2,47,421,216,205
050,51,109,"Virginia","Louisa County",2,48,446,231,215
050,51,109,"Virginia","Louisa County",2,49,503,262,241
050,51,109,"Virginia","Louisa County",2,50,498,255,243
050,51,109,"Virginia","Louisa County",2,51,503,250,253
050,51,109,"Virginia","Louisa County",2,52,522,261,261
050,51,109,"Virginia","Louisa County",2,53,540,265,275
050,51,109,"Virginia","Louisa County",2,54,570,281,289
050,51,109,"Virginia","Louisa County",2,55,595,286,309
050,51,109,"Virginia","Louisa County",2,56,611,279,332
050,51,109,"Virginia","Louisa County",2,57,654,311,343
050,51,109,"Virginia","Louisa County",2,58,665,340,325
050,51,109,"Virginia","Louisa County",2,59,683,341,342
050,51,109,"Virginia","Louisa County",2,60,664,320,344
050,51,109,"Virginia","Louisa County",2,61,637,315,322
050,51,109,"Virginia","Louisa County",2,62,642,313,329
050,51,109,"Virginia","Louisa County",2,63,613,304,309
050,51,109,"Virginia","Louisa County",2,64,595,295,300
050,51,109,"Virginia","Louisa County",2,65,608,312,296
050,51,109,"Virginia","Louisa County",2,66,562,280,282
050,51,109,"Virginia","Louisa County",2,67,529,249,280
050,51,109,"Virginia","Louisa County",2,68,531,259,272
050,51,109,"Virginia","Louisa County",2,69,512,250,262
050,51,109,"Virginia","Louisa County",2,70,490,250,240
050,51,109,"Virginia","Louisa County",2,71,461,231,230
050,51,109,"Virginia","Louisa County",2,72,438,220,218
050,51,109,"Virginia","Louisa County",2,73,466,230,236
050,51,109,"Virginia","Louisa County",2,74,333,161,172
050,51,109,"Virginia","Louisa County",2,75,315,157,158
050,51,109,"Virginia","Louisa County",2,76,294,151,143
050,51,109,"Virginia","Louisa County",2,77,273,134,139
050,51,109,"Virginia","Louisa County",2,78,232,102,130
050,51,109,"Virginia","Louisa County",2,79,222,104,118
050,51,109,"Virginia","Louisa County",2,80,205,99,106
050,51,109,"Virginia","Louisa County",2,81,186,98,88
050,51,109,"Virginia","Louisa County",2,82,170,88,82
050,51,109,"Virginia","Louisa County",2,83,145,71,74
050,51,109,"Virginia","Louisa County",2,84,111,55,56
050,51,109,"Virginia","Louisa County",2,85,589,238,351
050,51,109,"Virginia","Louisa County",3,0,411,224,187
050,51,109,"Virginia","Louisa County",3,1,413,213,200
050,51,109,"Virginia","Louisa County",3,2,412,212,200
050,51,109,"Virginia","Louisa County",3,3,421,209,212
050,51,109,"Virginia","Louisa County",3,4,400,205,195
050,51,109,"Virginia","Louisa County",3,5,449,236,213
050,51,109,"Virginia","Louisa County",3,6,411,207,204
050,51,109,"Virginia","Louisa County",3,7,424,219,205
050,51,109,"Virginia","Louisa County",3,8,455,232,223
050,51,109,"Virginia","Louisa County",3,9,442,222,220
050,51,109,"Virginia","Louisa County",3,10,417,199,218
050,51,109,"Virginia","Louisa County",3,11,429,209,220
050,51,109,"Virginia","Louisa County",3,12,441,212,229
050,51,109,"Virginia","Louisa County",3,13,460,221,239
050,51,109,"Virginia","Louisa County",3,14,487,246,241
050,51,109,"Virginia","Louisa County",3,15,457,236,221
050,51,109,"Virginia","Louisa County",3,16,444,240,204
050,51,109,"Virginia","Louisa County",3,17,441,220,221
050,51,109,"Virginia","Louisa County",3,18,364,184,180
050,51,109,"Virginia","Louisa County",3,19,322,162,160
050,51,109,"Virginia","Louisa County",3,20,334,185,149
050,51,109,"Virginia","Louisa County",3,21,348,180,168
050,51,109,"Virginia","Louisa County",3,22,375,186,189
050,51,109,"Virginia","Louisa County",3,23,361,181,180
050,51,109,"Virginia","Louisa County",3,24,381,202,179
050,51,109,"Virginia","Louisa County",3,25,412,214,198
050,51,109,"Virginia","Louisa County",3,26,444,226,218
050,51,109,"Virginia","Louisa County",3,27,471,237,234
050,51,109,"Virginia","Louisa County",3,28,496,252,244
050,51,109,"Virginia","Louisa County",3,29,462,217,245
050,51,109,"Virginia","Louisa County",3,30,487,230,257
050,51,109,"Virginia","Louisa County",3,31,476,228,248
050,51,109,"Virginia","Louisa County",3,32,481,231,250
050,51,109,"Virginia","Louisa County",3,33,476,245,231
050,51,109,"Virginia","Louisa County",3,34,487,236,251
050,51,109,"Virginia","Louisa County",3,35,473,243,230
050,51,109,"Virginia","Louisa County",3,36,497,252,245
050,51,109,"Virginia","Louisa County",3,37,468,226,242
050,51,109,"Virginia","Louisa County",3,38,492,253,239
050,51,109,"Virginia","Louisa County",3,39,514,274,240
050,51,109,"Virginia","Louisa County",3,40,485,266,219
050,51,109,"Virginia","Louisa County",3,41,494,255,239
050,51,109,"Virginia","Louisa County",3,42,423,206,217
050,51,109,"Virginia","Louisa County",3,43,414,210,204
050,51,109,"Virginia","Louisa County",3,44,449,237,212
050,51,109,"Virginia","Louisa County",3,45,427,222,205
050,51,109,"Virginia","Louisa County",3,46,413,214,199
050,51,109,"Virginia","Louisa County",3,47,397,197,200
050,51,109,"Virginia","Louisa County",3,48,437,227,210
050,51,109,"Virginia","Louisa County",3,49,460,235,225
050,51,109,"Virginia","Louisa County",3,50,502,264,238
050,51,109,"Virginia","Louisa County",3,51,509,265,244
050,51,109,"Virginia","Louisa County",3,52,507,244,263
050,51,109,"Virginia","Louisa County",3,53,539,278,261
050,51,109,"Virginia","Louisa County",3,54,555,273,282
050,51,109,"Virginia","Louisa County",3,55,561,270,291
050,51,109,"Virginia","Louisa County",3,56,610,290,320
050,51,109,"Virginia","Louisa County",3,57,650,290,360
050,51,109,"Virginia","Louisa County",3,58,667,321,346
050,51,109,"Virginia","Louisa County",3,59,693,353,340
050,51,109,"Virginia","Louisa County",3,60,703,357,346
050,51,109,"Virginia","Louisa County",3,61,680,331,349
050,51,109,"Virginia","Louisa County",3,62,681,334,347
050,51,109,"Virginia","Louisa County",3,63,658,313,345
050,51,109,"Virginia","Louisa County",3,64,623,301,322
050,51,109,"Virginia","Louisa County",3,65,603,295,308
050,51,109,"Virginia","Louisa County",3,66,612,312,300
050,51,109,"Virginia","Louisa County",3,67,561,281,280
050,51,109,"Virginia","Louisa County",3,68,533,250,283
050,51,109,"Virginia","Louisa County",3,69,532,260,272
050,51,109,"Virginia","Louisa County",3,70,506,242,264
050,51,109,"Virginia","Louisa County",3,71,478,240,238
050,51,109,"Virginia","Louisa County",3,72,455,227,228
050,51,109,"Virginia","Louisa County",3,73,436,221,215
050,51,109,"Virginia","Louisa County",3,74,464,230,234
050,51,109,"Virginia","Louisa County",3,75,310,154,156
050,51,109,"Virginia","Louisa County",3,76,313,151,162
050,51,109,"Virginia","Louisa County",3,77,283,143,140
050,51,109,"Virginia","Louisa County",3,78,267,129,138
050,51,109,"Virginia","Louisa County",3,79,222,97,125
050,51,109,"Virginia","Louisa County",3,80,207,97,110
050,51,109,"Virginia","Louisa County",3,81,194,96,98
050,51,109,"Virginia","Louisa County",3,82,176,89,87
050,51,109,"Virginia","Louisa County",3,83,159,83,76
050,51,109,"Virginia","Louisa County",3,84,134,67,67
050,51,109,"Virginia","Louisa County",3,85,599,248,351
050,51,109,"Virginia","Louisa County",4,0,411,212,199
050,51,109,"Virginia","Louisa County",4,1,429,245,184
050,51,109,"Virginia","Louisa County",4,2,429,210,219
050,51,109,"Virginia","Louisa County",4,3,438,225,213
050,51,109,"Virginia","Louisa County",4,4,452,225,227
050,51,109,"Virginia","Louisa County",4,5,410,215,195
050,51,109,"Virginia","Louisa County",4,6,461,246,215
050,51,109,"Virginia","Louisa County",4,7,426,212,214
050,51,109,"Virginia","Louisa County",4,8,434,229,205
050,51,109,"Virginia","Louisa County",4,9,487,258,229
050,51,109,"Virginia","Louisa County",4,10,463,236,227
050,51,109,"Virginia","Louisa County",4,11,411,196,215
050,51,109,"Virginia","Louisa County",4,12,446,224,222
050,51,109,"Virginia","Louisa County",4,13,449,217,232
050,51,109,"Virginia","Louisa County",4,14,461,221,240
050,51,109,"Virginia","Louisa County",4,15,496,252,244
050,51,109,"Virginia","Louisa County",4,16,468,240,228
050,51,109,"Virginia","Louisa County",4,17,453,241,212
050,51,109,"Virginia","Louisa County",4,18,382,200,182
050,51,109,"Virginia","Louisa County",4,19,300,156,144
050,51,109,"Virginia","Louisa County",4,20,322,165,157
050,51,109,"Virginia","Louisa County",4,21,357,194,163
050,51,109,"Virginia","Louisa County",4,22,367,184,183
050,51,109,"Virginia","Louisa County",4,23,388,190,198
050,51,109,"Virginia","Louisa County",4,24,355,189,166
050,51,109,"Virginia","Louisa County",4,25,407,225,182
050,51,109,"Virginia","Louisa County",4,26,423,208,215
050,51,109,"Virginia","Louisa County",4,27,480,250,230
050,51,109,"Virginia","Louisa County",4,28,485,235,250
050,51,109,"Virginia","Louisa County",4,29,510,271,239
050,51,109,"Virginia","Louisa County",4,30,489,230,259
050,51,109,"Virginia","Louisa County",4,31,502,231,271
050,51,109,"Virginia","Louisa County",4,32,510,230,280
050,51,109,"Virginia","Louisa County",4,33,502,238,264
050,51,109,"Virginia","Louisa County",4,34,516,261,255
050,51,109,"Virginia","Louisa County",4,35,490,249,241
050,51,109,"Virginia","Louisa County",4,36,497,262,235
050,51,109,"Virginia","Louisa County",4,37,518,265,253
050,51,109,"Virginia","Louisa County",4,38,499,246,253
050,51,109,"Virginia","Louisa County",4,39,511,260,251
050,51,109,"Virginia","Louisa County",4,40,523,276,247
050,51,109,"Virginia","Louisa County",4,41,496,279,217
050,51,109,"Virginia","Louisa County",4,42,489,253,236
050,51,109,"Virginia","Louisa County",4,43,427,209,218
050,51,109,"Virginia","Louisa County",4,44,424,218,206
050,51,109,"Virginia","Louisa County",4,45,465,243,222
050,51,109,"Virginia","Louisa County",4,46,447,228,219
050,51,109,"Virginia","Louisa County",4,47,432,223,209
050,51,109,"Virginia","Louisa County",4,48,435,224,211
050,51,109,"Virginia","Louisa County",4,49,461,243,218
050,51,109,"Virginia","Louisa County",4,50,474,239,235
050,51,109,"Virginia","Louisa County",4,51,501,258,243
050,51,109,"Virginia","Louisa County",4,52,527,281,246
050,51,109,"Virginia","Louisa County",4,53,528,253,275
050,51,109,"Virginia","Louisa County",4,54,572,289,283
050,51,109,"Virginia","Louisa County",4,55,568,274,294
050,51,109,"Virginia","Louisa County",4,56,560,274,286
050,51,109,"Virginia","Louisa County",4,57,620,298,322
050,51,109,"Virginia","Louisa County",4,58,669,302,367
050,51,109,"Virginia","Louisa County",4,59,695,343,352
050,51,109,"Virginia","Louisa County",4,60,708,356,352
050,51,109,"Virginia","Louisa County",4,61,719,358,361
050,51,109,"Virginia","Louisa County",4,62,698,340,358
050,51,109,"Virginia","Louisa County",4,63,678,332,346
050,51,109,"Virginia","Louisa County",4,64,672,325,347
050,51,109,"Virginia","Louisa County",4,65,632,308,324
050,51,109,"Virginia","Louisa County",4,66,603,295,308
050,51,109,"Virginia","Louisa County",4,67,630,315,315
050,51,109,"Virginia","Louisa County",4,68,555,274,281
050,51,109,"Virginia","Louisa County",4,69,542,259,283
050,51,109,"Virginia","Louisa County",4,70,524,252,272
050,51,109,"Virginia","Louisa County",4,71,505,243,262
050,51,109,"Virginia","Louisa County",4,72,468,233,235
050,51,109,"Virginia","Louisa County",4,73,448,224,224
050,51,109,"Virginia","Louisa County",4,74,429,217,212
050,51,109,"Virginia","Louisa County",4,75,443,221,222
050,51,109,"Virginia","Louisa County",4,76,296,148,148
050,51,109,"Virginia","Louisa County",4,77,305,140,165
050,51,109,"Virginia","Louisa County",4,78,277,141,136
050,51,109,"Virginia","Louisa County",4,79,257,123,134
050,51,109,"Virginia","Louisa County",4,80,203,84,119
050,51,109,"Virginia","Louisa County",4,81,198,92,106
050,51,109,"Virginia","Louisa County",4,82,173,80,93
050,51,109,"Virginia","Louisa County",4,83,151,76,75
050,51,109,"Virginia","Louisa County",4,84,146,81,65
050,51,109,"Virginia","Louisa County",4,85,623,254,369
050,51,109,"Virginia","Louisa County",5,0,408,212,196
050,51,109,"Virginia","Louisa County",5,1,403,199,204
050,51,109,"Virginia","Louisa County",5,2,441,257,184
050,51,109,"Virginia","Louisa County",5,3,470,230,240
050,51,109,"Virginia","Louisa County",5,4,447,234,213
050,51,109,"Virginia","Louisa County",5,5,468,232,236
050,51,109,"Virginia","Louisa County",5,6,423,218,205
050,51,109,"Virginia","Louisa County",5,7,475,246,229
050,51,109,"Virginia","Louisa County",5,8,423,216,207
050,51,109,"Virginia","Louisa County",5,9,448,235,213
050,51,109,"Virginia","Louisa County",5,10,493,253,240
050,51,109,"Virginia","Louisa County",5,11,463,233,230
050,51,109,"Virginia","Louisa County",5,12,427,207,220
050,51,109,"Virginia","Louisa County",5,13,473,238,235
050,51,109,"Virginia","Louisa County",5,14,453,217,236
050,51,109,"Virginia","Louisa County",5,15,484,236,248
050,51,109,"Virginia","Louisa County",5,16,506,247,259
050,51,109,"Virginia","Louisa County",5,17,473,235,238
050,51,109,"Virginia","Louisa County",5,18,387,207,180
050,51,109,"Virginia","Louisa County",5,19,322,169,153
050,51,109,"Virginia","Louisa County",5,20,333,168,165
050,51,109,"Virginia","Louisa County",5,21,333,167,166
050,51,109,"Virginia","Louisa County",5,22,395,204,191
050,51,109,"Virginia","Louisa County",5,23,383,183,200
050,51,109,"Virginia","Louisa County",5,24,422,208,214
050,51,109,"Virginia","Louisa County",5,25,370,200,170
050,51,109,"Virginia","Louisa County",5,26,403,223,180
050,51,109,"Virginia","Louisa County",5,27,434,222,212
050,51,109,"Virginia","Louisa County",5,28,494,260,234
050,51,109,"Virginia","Louisa County",5,29,508,250,258
050,51,109,"Virginia","Louisa County",5,30,515,271,244
050,51,109,"Virginia","Louisa County",5,31,528,241,287
050,51,109,"Virginia","Louisa County",5,32,566,268,298
050,51,109,"Virginia","Louisa County",5,33,524,240,284
050,51,109,"Virginia","Louisa County",5,34,503,235,268
050,51,109,"Virginia","Louisa County",5,35,512,264,248
050,51,109,"Virginia","Louisa County",5,36,507,255,252
050,51,109,"Virginia","Louisa County",5,37,520,275,245
050,51,109,"Virginia","Louisa County",5,38,554,294,260
050,51,109,"Virginia","Louisa County",5,39,516,264,252
050,51,109,"Virginia","Louisa County",5,40,516,265,251
050,51,109,"Virginia","Louisa County",5,41,541,284,257
050,51,109,"Virginia","Louisa County",5,42,509,284,225
050,51,109,"Virginia","Louisa County",5,43,484,247,237
050,51,109,"Virginia","Louisa County",5,44,416,199,217
050,51,109,"Virginia","Louisa County",5,45,435,216,219
050,51,109,"Virginia","Louisa County",5,46,474,247,227
050,51,109,"Virginia","Louisa County",5,47,464,239,225
050,51,109,"Virginia","Louisa County",5,48,442,228,214
050,51,109,"Virginia","Louisa County",5,49,441,223,218
050,51,109,"Virginia","Louisa County",5,50,462,244,218
050,51,109,"Virginia","Louisa County",5,51,482,243,239
050,51,109,"Virginia","Louisa County",5,52,508,267,241
050,51,109,"Virginia","Louisa County",5,53,546,293,253
050,51,109,"Virginia","Louisa County",5,54,530,254,276
050,51,109,"Virginia","Louisa County",5,55,573,285,288
050,51,109,"Virginia","Louisa County",5,56,591,280,311
050,51,109,"Virginia","Louisa County",5,57,576,288,288
050,51,109,"Virginia","Louisa County",5,58,634,306,328
050,51,109,"Virginia","Louisa County",5,59,695,316,379
050,51,109,"Virginia","Louisa County",5,60,722,347,375
050,51,109,"Virginia","Louisa County",5,61,732,364,368
050,51,109,"Virginia","Louisa County",5,62,762,375,387
050,51,109,"Virginia","Louisa County",5,63,739,362,377
050,51,109,"Virginia","Louisa County",5,64,712,343,369
050,51,109,"Virginia","Louisa County",5,65,686,336,350
050,51,109,"Virginia","Louisa County",5,66,642,312,330
050,51,109,"Virginia","Louisa County",5,67,616,296,320
050,51,109,"Virginia","Louisa County",5,68,629,316,313
050,51,109,"Virginia","Louisa County",5,69,557,270,287
050,51,109,"Virginia","Louisa County",5,70,543,259,284
050,51,109,"Virginia","Louisa County",5,71,520,244,276
050,51,109,"Virginia","Louisa County",5,72,484,236,248
050,51,109,"Virginia","Louisa County",5,73,457,228,229
050,51,109,"Virginia","Louisa County",5,74,438,214,224
050,51,109,"Virginia","Louisa County",5,75,414,210,204
050,51,109,"Virginia","Louisa County",5,76,421,204,217
050,51,109,"Virginia","Louisa County",5,77,290,141,149
050,51,109,"Virginia","Louisa County",5,78,293,135,158
050,51,109,"Virginia","Louisa County",5,79,268,139,129
050,51,109,"Virginia","Louisa County",5,80,241,114,127
050,51,109,"Virginia","Louisa County",5,81,195,82,113
050,51,109,"Virginia","Louisa County",5,82,177,80,97
050,51,109,"Virginia","Louisa County",5,83,146,63,83
050,51,109,"Virginia","Louisa County",5,84,143,73,70
050,51,109,"Virginia","Louisa County",5,85,684,292,392
050,51,111,"Virginia","Lunenburg County",1,0,100,50,50
050,51,111,"Virginia","Lunenburg County",1,1,103,56,47
050,51,111,"Virginia","Lunenburg County",1,2,135,74,61
050,51,111,"Virginia","Lunenburg County",1,3,126,65,61
050,51,111,"Virginia","Lunenburg County",1,4,151,88,63
050,51,111,"Virginia","Lunenburg County",1,5,141,74,67
050,51,111,"Virginia","Lunenburg County",1,6,114,62,52
050,51,111,"Virginia","Lunenburg County",1,7,126,70,56
050,51,111,"Virginia","Lunenburg County",1,8,127,65,62
050,51,111,"Virginia","Lunenburg County",1,9,123,62,61
050,51,111,"Virginia","Lunenburg County",1,10,122,64,58
050,51,111,"Virginia","Lunenburg County",1,11,133,67,66
050,51,111,"Virginia","Lunenburg County",1,12,139,64,75
050,51,111,"Virginia","Lunenburg County",1,13,145,76,69
050,51,111,"Virginia","Lunenburg County",1,14,147,75,72
050,51,111,"Virginia","Lunenburg County",1,15,146,76,70
050,51,111,"Virginia","Lunenburg County",1,16,133,66,67
050,51,111,"Virginia","Lunenburg County",1,17,121,64,57
050,51,111,"Virginia","Lunenburg County",1,18,114,64,50
050,51,111,"Virginia","Lunenburg County",1,19,89,51,38
050,51,111,"Virginia","Lunenburg County",1,20,88,50,38
050,51,111,"Virginia","Lunenburg County",1,21,103,58,45
050,51,111,"Virginia","Lunenburg County",1,22,123,70,53
050,51,111,"Virginia","Lunenburg County",1,23,118,70,48
050,51,111,"Virginia","Lunenburg County",1,24,112,67,45
050,51,111,"Virginia","Lunenburg County",1,25,115,67,48
050,51,111,"Virginia","Lunenburg County",1,26,108,61,47
050,51,111,"Virginia","Lunenburg County",1,27,124,74,50
050,51,111,"Virginia","Lunenburg County",1,28,140,70,70
050,51,111,"Virginia","Lunenburg County",1,29,154,93,61
050,51,111,"Virginia","Lunenburg County",1,30,145,85,60
050,51,111,"Virginia","Lunenburg County",1,31,173,96,77
050,51,111,"Virginia","Lunenburg County",1,32,147,86,61
050,51,111,"Virginia","Lunenburg County",1,33,128,72,56
050,51,111,"Virginia","Lunenburg County",1,34,135,74,61
050,51,111,"Virginia","Lunenburg County",1,35,151,95,56
050,51,111,"Virginia","Lunenburg County",1,36,146,87,59
050,51,111,"Virginia","Lunenburg County",1,37,145,92,53
050,51,111,"Virginia","Lunenburg County",1,38,133,83,50
050,51,111,"Virginia","Lunenburg County",1,39,136,87,49
050,51,111,"Virginia","Lunenburg County",1,40,165,105,60
050,51,111,"Virginia","Lunenburg County",1,41,163,95,68
050,51,111,"Virginia","Lunenburg County",1,42,157,91,66
050,51,111,"Virginia","Lunenburg County",1,43,160,94,66
050,51,111,"Virginia","Lunenburg County",1,44,178,111,67
050,51,111,"Virginia","Lunenburg County",1,45,158,96,62
050,51,111,"Virginia","Lunenburg County",1,46,153,88,65
050,51,111,"Virginia","Lunenburg County",1,47,147,85,62
050,51,111,"Virginia","Lunenburg County",1,48,150,88,62
050,51,111,"Virginia","Lunenburg County",1,49,133,68,65
050,51,111,"Virginia","Lunenburg County",1,50,127,74,53
050,51,111,"Virginia","Lunenburg County",1,51,148,85,63
050,51,111,"Virginia","Lunenburg County",1,52,151,86,65
050,51,111,"Virginia","Lunenburg County",1,53,153,85,68
050,51,111,"Virginia","Lunenburg County",1,54,164,90,74
050,51,111,"Virginia","Lunenburg County",1,55,162,92,70
050,51,111,"Virginia","Lunenburg County",1,56,184,101,83
050,51,111,"Virginia","Lunenburg County",1,57,171,88,83
050,51,111,"Virginia","Lunenburg County",1,58,165,84,81
050,51,111,"Virginia","Lunenburg County",1,59,166,79,87
050,51,111,"Virginia","Lunenburg County",1,60,179,94,85
050,51,111,"Virginia","Lunenburg County",1,61,180,91,89
050,51,111,"Virginia","Lunenburg County",1,62,186,95,91
050,51,111,"Virginia","Lunenburg County",1,63,176,89,87
050,51,111,"Virginia","Lunenburg County",1,64,197,100,97
050,51,111,"Virginia","Lunenburg County",1,65,220,92,128
050,51,111,"Virginia","Lunenburg County",1,66,186,89,97
050,51,111,"Virginia","Lunenburg County",1,67,188,90,98
050,51,111,"Virginia","Lunenburg County",1,68,182,97,85
050,51,111,"Virginia","Lunenburg County",1,69,168,88,80
050,51,111,"Virginia","Lunenburg County",1,70,162,83,79
050,51,111,"Virginia","Lunenburg County",1,71,147,75,72
050,51,111,"Virginia","Lunenburg County",1,72,145,66,79
050,51,111,"Virginia","Lunenburg County",1,73,137,65,72
050,51,111,"Virginia","Lunenburg County",1,74,125,58,67
050,51,111,"Virginia","Lunenburg County",1,75,105,46,59
050,51,111,"Virginia","Lunenburg County",1,76,113,44,69
050,51,111,"Virginia","Lunenburg County",1,77,105,52,53
050,51,111,"Virginia","Lunenburg County",1,78,86,43,43
050,51,111,"Virginia","Lunenburg County",1,79,74,31,43
050,51,111,"Virginia","Lunenburg County",1,80,75,32,43
050,51,111,"Virginia","Lunenburg County",1,81,70,35,35
050,51,111,"Virginia","Lunenburg County",1,82,57,28,29
050,51,111,"Virginia","Lunenburg County",1,83,58,22,36
050,51,111,"Virginia","Lunenburg County",1,84,54,18,36
050,51,111,"Virginia","Lunenburg County",1,85,247,81,166
050,51,111,"Virginia","Lunenburg County",2,0,108,57,51
050,51,111,"Virginia","Lunenburg County",2,1,104,55,49
050,51,111,"Virginia","Lunenburg County",2,2,127,69,58
050,51,111,"Virginia","Lunenburg County",2,3,130,70,60
050,51,111,"Virginia","Lunenburg County",2,4,151,86,65
050,51,111,"Virginia","Lunenburg County",2,5,143,77,66
050,51,111,"Virginia","Lunenburg County",2,6,121,66,55
050,51,111,"Virginia","Lunenburg County",2,7,122,68,54
050,51,111,"Virginia","Lunenburg County",2,8,128,67,61
050,51,111,"Virginia","Lunenburg County",2,9,124,64,60
050,51,111,"Virginia","Lunenburg County",2,10,122,63,59
050,51,111,"Virginia","Lunenburg County",2,11,131,66,65
050,51,111,"Virginia","Lunenburg County",2,12,141,66,75
050,51,111,"Virginia","Lunenburg County",2,13,145,74,71
050,51,111,"Virginia","Lunenburg County",2,14,148,77,71
050,51,111,"Virginia","Lunenburg County",2,15,147,76,71
050,51,111,"Virginia","Lunenburg County",2,16,136,68,68
050,51,111,"Virginia","Lunenburg County",2,17,123,64,59
050,51,111,"Virginia","Lunenburg County",2,18,110,62,48
050,51,111,"Virginia","Lunenburg County",2,19,88,51,37
050,51,111,"Virginia","Lunenburg County",2,20,91,51,40
050,51,111,"Virginia","Lunenburg County",2,21,101,57,44
050,51,111,"Virginia","Lunenburg County",2,22,123,70,53
050,51,111,"Virginia","Lunenburg County",2,23,119,70,49
050,51,111,"Virginia","Lunenburg County",2,24,115,69,46
050,51,111,"Virginia","Lunenburg County",2,25,113,66,47
050,51,111,"Virginia","Lunenburg County",2,26,111,64,47
050,51,111,"Virginia","Lunenburg County",2,27,121,71,50
050,51,111,"Virginia","Lunenburg County",2,28,136,71,65
050,51,111,"Virginia","Lunenburg County",2,29,152,89,63
050,51,111,"Virginia","Lunenburg County",2,30,148,87,61
050,51,111,"Virginia","Lunenburg County",2,31,169,96,73
050,51,111,"Virginia","Lunenburg County",2,32,153,88,65
050,51,111,"Virginia","Lunenburg County",2,33,127,69,58
050,51,111,"Virginia","Lunenburg County",2,34,135,75,60
050,51,111,"Virginia","Lunenburg County",2,35,149,90,59
050,51,111,"Virginia","Lunenburg County",2,36,143,86,57
050,51,111,"Virginia","Lunenburg County",2,37,145,91,54
050,51,111,"Virginia","Lunenburg County",2,38,139,88,51
050,51,111,"Virginia","Lunenburg County",2,39,132,84,48
050,51,111,"Virginia","Lunenburg County",2,40,164,105,59
050,51,111,"Virginia","Lunenburg County",2,41,162,95,67
050,51,111,"Virginia","Lunenburg County",2,42,157,91,66
050,51,111,"Virginia","Lunenburg County",2,43,160,93,67
050,51,111,"Virginia","Lunenburg County",2,44,174,108,66
050,51,111,"Virginia","Lunenburg County",2,45,161,97,64
050,51,111,"Virginia","Lunenburg County",2,46,158,92,66
050,51,111,"Virginia","Lunenburg County",2,47,146,84,62
050,51,111,"Virginia","Lunenburg County",2,48,148,88,60
050,51,111,"Virginia","Lunenburg County",2,49,136,73,63
050,51,111,"Virginia","Lunenburg County",2,50,127,72,55
050,51,111,"Virginia","Lunenburg County",2,51,143,82,61
050,51,111,"Virginia","Lunenburg County",2,52,151,85,66
050,51,111,"Virginia","Lunenburg County",2,53,153,85,68
050,51,111,"Virginia","Lunenburg County",2,54,162,90,72
050,51,111,"Virginia","Lunenburg County",2,55,161,90,71
050,51,111,"Virginia","Lunenburg County",2,56,178,97,81
050,51,111,"Virginia","Lunenburg County",2,57,172,88,84
050,51,111,"Virginia","Lunenburg County",2,58,166,85,81
050,51,111,"Virginia","Lunenburg County",2,59,168,81,87
050,51,111,"Virginia","Lunenburg County",2,60,174,89,85
050,51,111,"Virginia","Lunenburg County",2,61,177,90,87
050,51,111,"Virginia","Lunenburg County",2,62,186,95,91
050,51,111,"Virginia","Lunenburg County",2,63,181,92,89
050,51,111,"Virginia","Lunenburg County",2,64,191,96,95
050,51,111,"Virginia","Lunenburg County",2,65,215,94,121
050,51,111,"Virginia","Lunenburg County",2,66,193,90,103
050,51,111,"Virginia","Lunenburg County",2,67,186,88,98
050,51,111,"Virginia","Lunenburg County",2,68,178,93,85
050,51,111,"Virginia","Lunenburg County",2,69,173,90,83
050,51,111,"Virginia","Lunenburg County",2,70,164,84,80
050,51,111,"Virginia","Lunenburg County",2,71,150,77,73
050,51,111,"Virginia","Lunenburg County",2,72,143,68,75
050,51,111,"Virginia","Lunenburg County",2,73,143,66,77
050,51,111,"Virginia","Lunenburg County",2,74,119,56,63
050,51,111,"Virginia","Lunenburg County",2,75,110,49,61
050,51,111,"Virginia","Lunenburg County",2,76,109,45,64
050,51,111,"Virginia","Lunenburg County",2,77,108,51,57
050,51,111,"Virginia","Lunenburg County",2,78,90,45,45
050,51,111,"Virginia","Lunenburg County",2,79,75,33,42
050,51,111,"Virginia","Lunenburg County",2,80,73,32,41
050,51,111,"Virginia","Lunenburg County",2,81,70,34,36
050,51,111,"Virginia","Lunenburg County",2,82,59,30,29
050,51,111,"Virginia","Lunenburg County",2,83,57,23,34
050,51,111,"Virginia","Lunenburg County",2,84,56,20,36
050,51,111,"Virginia","Lunenburg County",2,85,249,79,170
050,51,111,"Virginia","Lunenburg County",3,0,120,57,63
050,51,111,"Virginia","Lunenburg County",3,1,114,59,55
050,51,111,"Virginia","Lunenburg County",3,2,101,52,49
050,51,111,"Virginia","Lunenburg County",3,3,128,66,62
050,51,111,"Virginia","Lunenburg County",3,4,133,75,58
050,51,111,"Virginia","Lunenburg County",3,5,138,79,59
050,51,111,"Virginia","Lunenburg County",3,6,134,74,60
050,51,111,"Virginia","Lunenburg County",3,7,133,76,57
050,51,111,"Virginia","Lunenburg County",3,8,116,64,52
050,51,111,"Virginia","Lunenburg County",3,9,134,73,61
050,51,111,"Virginia","Lunenburg County",3,10,124,63,61
050,51,111,"Virginia","Lunenburg County",3,11,126,67,59
050,51,111,"Virginia","Lunenburg County",3,12,140,71,69
050,51,111,"Virginia","Lunenburg County",3,13,139,65,74
050,51,111,"Virginia","Lunenburg County",3,14,141,72,69
050,51,111,"Virginia","Lunenburg County",3,15,147,76,71
050,51,111,"Virginia","Lunenburg County",3,16,145,78,67
050,51,111,"Virginia","Lunenburg County",3,17,139,66,73
050,51,111,"Virginia","Lunenburg County",3,18,114,59,55
050,51,111,"Virginia","Lunenburg County",3,19,95,50,45
050,51,111,"Virginia","Lunenburg County",3,20,102,59,43
050,51,111,"Virginia","Lunenburg County",3,21,97,47,50
050,51,111,"Virginia","Lunenburg County",3,22,118,71,47
050,51,111,"Virginia","Lunenburg County",3,23,120,69,51
050,51,111,"Virginia","Lunenburg County",3,24,111,66,45
050,51,111,"Virginia","Lunenburg County",3,25,110,60,50
050,51,111,"Virginia","Lunenburg County",3,26,131,80,51
050,51,111,"Virginia","Lunenburg County",3,27,115,67,48
050,51,111,"Virginia","Lunenburg County",3,28,122,73,49
050,51,111,"Virginia","Lunenburg County",3,29,141,81,60
050,51,111,"Virginia","Lunenburg County",3,30,136,78,58
050,51,111,"Virginia","Lunenburg County",3,31,169,104,65
050,51,111,"Virginia","Lunenburg County",3,32,172,103,69
050,51,111,"Virginia","Lunenburg County",3,33,140,77,63
050,51,111,"Virginia","Lunenburg County",3,34,138,75,63
050,51,111,"Virginia","Lunenburg County",3,35,129,72,57
050,51,111,"Virginia","Lunenburg County",3,36,151,86,65
050,51,111,"Virginia","Lunenburg County",3,37,159,97,62
050,51,111,"Virginia","Lunenburg County",3,38,157,102,55
050,51,111,"Virginia","Lunenburg County",3,39,134,85,49
050,51,111,"Virginia","Lunenburg County",3,40,149,101,48
050,51,111,"Virginia","Lunenburg County",3,41,154,98,56
050,51,111,"Virginia","Lunenburg County",3,42,159,91,68
050,51,111,"Virginia","Lunenburg County",3,43,160,93,67
050,51,111,"Virginia","Lunenburg County",3,44,166,106,60
050,51,111,"Virginia","Lunenburg County",3,45,167,100,67
050,51,111,"Virginia","Lunenburg County",3,46,167,105,62
050,51,111,"Virginia","Lunenburg County",3,47,143,78,65
050,51,111,"Virginia","Lunenburg County",3,48,151,90,61
050,51,111,"Virginia","Lunenburg County",3,49,140,84,56
050,51,111,"Virginia","Lunenburg County",3,50,137,75,62
050,51,111,"Virginia","Lunenburg County",3,51,125,75,50
050,51,111,"Virginia","Lunenburg County",3,52,140,79,61
050,51,111,"Virginia","Lunenburg County",3,53,157,88,69
050,51,111,"Virginia","Lunenburg County",3,54,154,87,67
050,51,111,"Virginia","Lunenburg County",3,55,160,89,71
050,51,111,"Virginia","Lunenburg County",3,56,167,92,75
050,51,111,"Virginia","Lunenburg County",3,57,169,92,77
050,51,111,"Virginia","Lunenburg County",3,58,172,85,87
050,51,111,"Virginia","Lunenburg County",3,59,172,91,81
050,51,111,"Virginia","Lunenburg County",3,60,166,78,88
050,51,111,"Virginia","Lunenburg County",3,61,172,88,84
050,51,111,"Virginia","Lunenburg County",3,62,185,96,89
050,51,111,"Virginia","Lunenburg County",3,63,192,103,89
050,51,111,"Virginia","Lunenburg County",3,64,175,91,84
050,51,111,"Virginia","Lunenburg County",3,65,194,97,97
050,51,111,"Virginia","Lunenburg County",3,66,210,90,120
050,51,111,"Virginia","Lunenburg County",3,67,196,91,105
050,51,111,"Virginia","Lunenburg County",3,68,179,86,93
050,51,111,"Virginia","Lunenburg County",3,69,177,94,83
050,51,111,"Virginia","Lunenburg County",3,70,163,81,82
050,51,111,"Virginia","Lunenburg County",3,71,161,84,77
050,51,111,"Virginia","Lunenburg County",3,72,146,74,72
050,51,111,"Virginia","Lunenburg County",3,73,137,65,72
050,51,111,"Virginia","Lunenburg County",3,74,140,64,76
050,51,111,"Virginia","Lunenburg County",3,75,113,52,61
050,51,111,"Virginia","Lunenburg County",3,76,107,49,58
050,51,111,"Virginia","Lunenburg County",3,77,107,45,62
050,51,111,"Virginia","Lunenburg County",3,78,104,49,55
050,51,111,"Virginia","Lunenburg County",3,79,84,40,44
050,51,111,"Virginia","Lunenburg County",3,80,71,30,41
050,51,111,"Virginia","Lunenburg County",3,81,66,29,37
050,51,111,"Virginia","Lunenburg County",3,82,65,32,33
050,51,111,"Virginia","Lunenburg County",3,83,54,27,27
050,51,111,"Virginia","Lunenburg County",3,84,53,21,32
050,51,111,"Virginia","Lunenburg County",3,85,262,79,183
050,51,111,"Virginia","Lunenburg County",4,0,112,51,61
050,51,111,"Virginia","Lunenburg County",4,1,116,53,63
050,51,111,"Virginia","Lunenburg County",4,2,117,61,56
050,51,111,"Virginia","Lunenburg County",4,3,99,49,50
050,51,111,"Virginia","Lunenburg County",4,4,117,58,59
050,51,111,"Virginia","Lunenburg County",4,5,123,74,49
050,51,111,"Virginia","Lunenburg County",4,6,142,81,61
050,51,111,"Virginia","Lunenburg County",4,7,143,74,69
050,51,111,"Virginia","Lunenburg County",4,8,138,80,58
050,51,111,"Virginia","Lunenburg County",4,9,127,73,54
050,51,111,"Virginia","Lunenburg County",4,10,143,79,64
050,51,111,"Virginia","Lunenburg County",4,11,138,75,63
050,51,111,"Virginia","Lunenburg County",4,12,128,65,63
050,51,111,"Virginia","Lunenburg County",4,13,145,72,73
050,51,111,"Virginia","Lunenburg County",4,14,153,66,87
050,51,111,"Virginia","Lunenburg County",4,15,140,75,65
050,51,111,"Virginia","Lunenburg County",4,16,145,76,69
050,51,111,"Virginia","Lunenburg County",4,17,147,81,66
050,51,111,"Virginia","Lunenburg County",4,18,125,54,71
050,51,111,"Virginia","Lunenburg County",4,19,90,45,45
050,51,111,"Virginia","Lunenburg County",4,20,99,54,45
050,51,111,"Virginia","Lunenburg County",4,21,107,66,41
050,51,111,"Virginia","Lunenburg County",4,22,108,58,50
050,51,111,"Virginia","Lunenburg County",4,23,119,70,49
050,51,111,"Virginia","Lunenburg County",4,24,122,73,49
050,51,111,"Virginia","Lunenburg County",4,25,107,62,45
050,51,111,"Virginia","Lunenburg County",4,26,109,64,45
050,51,111,"Virginia","Lunenburg County",4,27,124,76,48
050,51,111,"Virginia","Lunenburg County",4,28,124,73,51
050,51,111,"Virginia","Lunenburg County",4,29,123,80,43
050,51,111,"Virginia","Lunenburg County",4,30,138,85,53
050,51,111,"Virginia","Lunenburg County",4,31,159,95,64
050,51,111,"Virginia","Lunenburg County",4,32,166,102,64
050,51,111,"Virginia","Lunenburg County",4,33,159,91,68
050,51,111,"Virginia","Lunenburg County",4,34,155,84,71
050,51,111,"Virginia","Lunenburg County",4,35,141,78,63
050,51,111,"Virginia","Lunenburg County",4,36,119,62,57
050,51,111,"Virginia","Lunenburg County",4,37,163,94,69
050,51,111,"Virginia","Lunenburg County",4,38,159,93,66
050,51,111,"Virginia","Lunenburg County",4,39,151,96,55
050,51,111,"Virginia","Lunenburg County",4,40,156,104,52
050,51,111,"Virginia","Lunenburg County",4,41,139,87,52
050,51,111,"Virginia","Lunenburg County",4,42,154,97,57
050,51,111,"Virginia","Lunenburg County",4,43,164,90,74
050,51,111,"Virginia","Lunenburg County",4,44,172,104,68
050,51,111,"Virginia","Lunenburg County",4,45,154,92,62
050,51,111,"Virginia","Lunenburg County",4,46,185,117,68
050,51,111,"Virginia","Lunenburg County",4,47,153,93,60
050,51,111,"Virginia","Lunenburg County",4,48,149,85,64
050,51,111,"Virginia","Lunenburg County",4,49,143,81,62
050,51,111,"Virginia","Lunenburg County",4,50,138,81,57
050,51,111,"Virginia","Lunenburg County",4,51,136,77,59
050,51,111,"Virginia","Lunenburg County",4,52,122,72,50
050,51,111,"Virginia","Lunenburg County",4,53,138,79,59
050,51,111,"Virginia","Lunenburg County",4,54,150,85,65
050,51,111,"Virginia","Lunenburg County",4,55,152,80,72
050,51,111,"Virginia","Lunenburg County",4,56,158,86,72
050,51,111,"Virginia","Lunenburg County",4,57,159,87,72
050,51,111,"Virginia","Lunenburg County",4,58,171,91,80
050,51,111,"Virginia","Lunenburg County",4,59,164,77,87
050,51,111,"Virginia","Lunenburg County",4,60,175,97,78
050,51,111,"Virginia","Lunenburg County",4,61,159,75,84
050,51,111,"Virginia","Lunenburg County",4,62,177,91,86
050,51,111,"Virginia","Lunenburg County",4,63,178,88,90
050,51,111,"Virginia","Lunenburg County",4,64,187,99,88
050,51,111,"Virginia","Lunenburg County",4,65,178,91,87
050,51,111,"Virginia","Lunenburg County",4,66,194,98,96
050,51,111,"Virginia","Lunenburg County",4,67,204,89,115
050,51,111,"Virginia","Lunenburg County",4,68,189,87,102
050,51,111,"Virginia","Lunenburg County",4,69,175,83,92
050,51,111,"Virginia","Lunenburg County",4,70,166,85,81
050,51,111,"Virginia","Lunenburg County",4,71,156,79,77
050,51,111,"Virginia","Lunenburg County",4,72,161,82,79
050,51,111,"Virginia","Lunenburg County",4,73,142,71,71
050,51,111,"Virginia","Lunenburg County",4,74,137,67,70
050,51,111,"Virginia","Lunenburg County",4,75,136,60,76
050,51,111,"Virginia","Lunenburg County",4,76,109,51,58
050,51,111,"Virginia","Lunenburg County",4,77,104,47,57
050,51,111,"Virginia","Lunenburg County",4,78,99,41,58
050,51,111,"Virginia","Lunenburg County",4,79,97,46,51
050,51,111,"Virginia","Lunenburg County",4,80,81,37,44
050,51,111,"Virginia","Lunenburg County",4,81,66,27,39
050,51,111,"Virginia","Lunenburg County",4,82,60,26,34
050,51,111,"Virginia","Lunenburg County",4,83,61,32,29
050,51,111,"Virginia","Lunenburg County",4,84,47,24,23
050,51,111,"Virginia","Lunenburg County",4,85,267,84,183
050,51,111,"Virginia","Lunenburg County",5,0,113,51,62
050,51,111,"Virginia","Lunenburg County",5,1,117,52,65
050,51,111,"Virginia","Lunenburg County",5,2,113,51,62
050,51,111,"Virginia","Lunenburg County",5,3,122,64,58
050,51,111,"Virginia","Lunenburg County",5,4,104,54,50
050,51,111,"Virginia","Lunenburg County",5,5,121,62,59
050,51,111,"Virginia","Lunenburg County",5,6,138,81,57
050,51,111,"Virginia","Lunenburg County",5,7,140,80,60
050,51,111,"Virginia","Lunenburg County",5,8,154,83,71
050,51,111,"Virginia","Lunenburg County",5,9,134,76,58
050,51,111,"Virginia","Lunenburg County",5,10,128,75,53
050,51,111,"Virginia","Lunenburg County",5,11,147,82,65
050,51,111,"Virginia","Lunenburg County",5,12,142,79,63
050,51,111,"Virginia","Lunenburg County",5,13,130,62,68
050,51,111,"Virginia","Lunenburg County",5,14,145,72,73
050,51,111,"Virginia","Lunenburg County",5,15,157,69,88
050,51,111,"Virginia","Lunenburg County",5,16,132,70,62
050,51,111,"Virginia","Lunenburg County",5,17,148,74,74
050,51,111,"Virginia","Lunenburg County",5,18,131,71,60
050,51,111,"Virginia","Lunenburg County",5,19,105,45,60
050,51,111,"Virginia","Lunenburg County",5,20,105,58,47
050,51,111,"Virginia","Lunenburg County",5,21,108,58,50
050,51,111,"Virginia","Lunenburg County",5,22,117,75,42
050,51,111,"Virginia","Lunenburg County",5,23,110,64,46
050,51,111,"Virginia","Lunenburg County",5,24,115,71,44
050,51,111,"Virginia","Lunenburg County",5,25,119,68,51
050,51,111,"Virginia","Lunenburg County",5,26,117,74,43
050,51,111,"Virginia","Lunenburg County",5,27,110,63,47
050,51,111,"Virginia","Lunenburg County",5,28,122,72,50
050,51,111,"Virginia","Lunenburg County",5,29,129,76,53
050,51,111,"Virginia","Lunenburg County",5,30,117,75,42
050,51,111,"Virginia","Lunenburg County",5,31,153,95,58
050,51,111,"Virginia","Lunenburg County",5,32,170,102,68
050,51,111,"Virginia","Lunenburg County",5,33,149,83,66
050,51,111,"Virginia","Lunenburg County",5,34,177,99,78
050,51,111,"Virginia","Lunenburg County",5,35,164,84,80
050,51,111,"Virginia","Lunenburg County",5,36,136,70,66
050,51,111,"Virginia","Lunenburg County",5,37,129,70,59
050,51,111,"Virginia","Lunenburg County",5,38,164,93,71
050,51,111,"Virginia","Lunenburg County",5,39,152,88,64
050,51,111,"Virginia","Lunenburg County",5,40,171,114,57
050,51,111,"Virginia","Lunenburg County",5,41,144,90,54
050,51,111,"Virginia","Lunenburg County",5,42,137,84,53
050,51,111,"Virginia","Lunenburg County",5,43,157,102,55
050,51,111,"Virginia","Lunenburg County",5,44,164,96,68
050,51,111,"Virginia","Lunenburg County",5,45,172,99,73
050,51,111,"Virginia","Lunenburg County",5,46,164,98,66
050,51,111,"Virginia","Lunenburg County",5,47,168,100,68
050,51,111,"Virginia","Lunenburg County",5,48,155,95,60
050,51,111,"Virginia","Lunenburg County",5,49,142,82,60
050,51,111,"Virginia","Lunenburg County",5,50,140,80,60
050,51,111,"Virginia","Lunenburg County",5,51,139,81,58
050,51,111,"Virginia","Lunenburg County",5,52,136,75,61
050,51,111,"Virginia","Lunenburg County",5,53,121,68,53
050,51,111,"Virginia","Lunenburg County",5,54,140,82,58
050,51,111,"Virginia","Lunenburg County",5,55,154,84,70
050,51,111,"Virginia","Lunenburg County",5,56,146,82,64
050,51,111,"Virginia","Lunenburg County",5,57,158,84,74
050,51,111,"Virginia","Lunenburg County",5,58,155,85,70
050,51,111,"Virginia","Lunenburg County",5,59,170,91,79
050,51,111,"Virginia","Lunenburg County",5,60,162,75,87
050,51,111,"Virginia","Lunenburg County",5,61,157,87,70
050,51,111,"Virginia","Lunenburg County",5,62,162,78,84
050,51,111,"Virginia","Lunenburg County",5,63,175,87,88
050,51,111,"Virginia","Lunenburg County",5,64,176,85,91
050,51,111,"Virginia","Lunenburg County",5,65,182,94,88
050,51,111,"Virginia","Lunenburg County",5,66,183,94,89
050,51,111,"Virginia","Lunenburg County",5,67,191,92,99
050,51,111,"Virginia","Lunenburg County",5,68,199,86,113
050,51,111,"Virginia","Lunenburg County",5,69,185,84,101
050,51,111,"Virginia","Lunenburg County",5,70,168,77,91
050,51,111,"Virginia","Lunenburg County",5,71,161,82,79
050,51,111,"Virginia","Lunenburg County",5,72,153,76,77
050,51,111,"Virginia","Lunenburg County",5,73,156,78,78
050,51,111,"Virginia","Lunenburg County",5,74,137,70,67
050,51,111,"Virginia","Lunenburg County",5,75,136,65,71
050,51,111,"Virginia","Lunenburg County",5,76,131,56,75
050,51,111,"Virginia","Lunenburg County",5,77,109,52,57
050,51,111,"Virginia","Lunenburg County",5,78,99,44,55
050,51,111,"Virginia","Lunenburg County",5,79,89,34,55
050,51,111,"Virginia","Lunenburg County",5,80,90,42,48
050,51,111,"Virginia","Lunenburg County",5,81,78,33,45
050,51,111,"Virginia","Lunenburg County",5,82,62,25,37
050,51,111,"Virginia","Lunenburg County",5,83,55,23,32
050,51,111,"Virginia","Lunenburg County",5,84,53,28,25
050,51,111,"Virginia","Lunenburg County",5,85,272,96,176
050,51,113,"Virginia","Madison County",1,0,141,73,68
050,51,113,"Virginia","Madison County",1,1,149,77,72
050,51,113,"Virginia","Madison County",1,2,134,72,62
050,51,113,"Virginia","Madison County",1,3,126,62,64
050,51,113,"Virginia","Madison County",1,4,157,80,77
050,51,113,"Virginia","Madison County",1,5,143,65,78
050,51,113,"Virginia","Madison County",1,6,134,59,75
050,51,113,"Virginia","Madison County",1,7,149,69,80
050,51,113,"Virginia","Madison County",1,8,160,76,84
050,51,113,"Virginia","Madison County",1,9,151,76,75
050,51,113,"Virginia","Madison County",1,10,152,80,72
050,51,113,"Virginia","Madison County",1,11,167,87,80
050,51,113,"Virginia","Madison County",1,12,172,94,78
050,51,113,"Virginia","Madison County",1,13,180,94,86
050,51,113,"Virginia","Madison County",1,14,181,88,93
050,51,113,"Virginia","Madison County",1,15,165,81,84
050,51,113,"Virginia","Madison County",1,16,159,73,86
050,51,113,"Virginia","Madison County",1,17,158,79,79
050,51,113,"Virginia","Madison County",1,18,174,89,85
050,51,113,"Virginia","Madison County",1,19,143,69,74
050,51,113,"Virginia","Madison County",1,20,149,71,78
050,51,113,"Virginia","Madison County",1,21,144,67,77
050,51,113,"Virginia","Madison County",1,22,141,60,81
050,51,113,"Virginia","Madison County",1,23,135,60,75
050,51,113,"Virginia","Madison County",1,24,130,69,61
050,51,113,"Virginia","Madison County",1,25,132,70,62
050,51,113,"Virginia","Madison County",1,26,138,70,68
050,51,113,"Virginia","Madison County",1,27,140,77,63
050,51,113,"Virginia","Madison County",1,28,152,80,72
050,51,113,"Virginia","Madison County",1,29,154,71,83
050,51,113,"Virginia","Madison County",1,30,157,70,87
050,51,113,"Virginia","Madison County",1,31,140,68,72
050,51,113,"Virginia","Madison County",1,32,169,79,90
050,51,113,"Virginia","Madison County",1,33,150,80,70
050,51,113,"Virginia","Madison County",1,34,141,74,67
050,51,113,"Virginia","Madison County",1,35,142,66,76
050,51,113,"Virginia","Madison County",1,36,148,71,77
050,51,113,"Virginia","Madison County",1,37,161,84,77
050,51,113,"Virginia","Madison County",1,38,155,75,80
050,51,113,"Virginia","Madison County",1,39,145,75,70
050,51,113,"Virginia","Madison County",1,40,151,72,79
050,51,113,"Virginia","Madison County",1,41,148,69,79
050,51,113,"Virginia","Madison County",1,42,150,78,72
050,51,113,"Virginia","Madison County",1,43,155,70,85
050,51,113,"Virginia","Madison County",1,44,147,71,76
050,51,113,"Virginia","Madison County",1,45,127,61,66
050,51,113,"Virginia","Madison County",1,46,139,71,68
050,51,113,"Virginia","Madison County",1,47,165,90,75
050,51,113,"Virginia","Madison County",1,48,167,81,86
050,51,113,"Virginia","Madison County",1,49,169,82,87
050,51,113,"Virginia","Madison County",1,50,161,80,81
050,51,113,"Virginia","Madison County",1,51,179,94,85
050,51,113,"Virginia","Madison County",1,52,170,88,82
050,51,113,"Virginia","Madison County",1,53,188,102,86
050,51,113,"Virginia","Madison County",1,54,186,100,86
050,51,113,"Virginia","Madison County",1,55,218,104,114
050,51,113,"Virginia","Madison County",1,56,237,111,126
050,51,113,"Virginia","Madison County",1,57,232,109,123
050,51,113,"Virginia","Madison County",1,58,225,110,115
050,51,113,"Virginia","Madison County",1,59,251,121,130
050,51,113,"Virginia","Madison County",1,60,242,110,132
050,51,113,"Virginia","Madison County",1,61,254,123,131
050,51,113,"Virginia","Madison County",1,62,243,116,127
050,51,113,"Virginia","Madison County",1,63,221,112,109
050,51,113,"Virginia","Madison County",1,64,219,112,107
050,51,113,"Virginia","Madison County",1,65,209,103,106
050,51,113,"Virginia","Madison County",1,66,208,97,111
050,51,113,"Virginia","Madison County",1,67,191,86,105
050,51,113,"Virginia","Madison County",1,68,191,91,100
050,51,113,"Virginia","Madison County",1,69,178,86,92
050,51,113,"Virginia","Madison County",1,70,184,92,92
050,51,113,"Virginia","Madison County",1,71,190,92,98
050,51,113,"Virginia","Madison County",1,72,196,92,104
050,51,113,"Virginia","Madison County",1,73,173,70,103
050,51,113,"Virginia","Madison County",1,74,125,54,71
050,51,113,"Virginia","Madison County",1,75,113,53,60
050,51,113,"Virginia","Madison County",1,76,117,50,67
050,51,113,"Virginia","Madison County",1,77,122,60,62
050,51,113,"Virginia","Madison County",1,78,115,57,58
050,51,113,"Virginia","Madison County",1,79,88,43,45
050,51,113,"Virginia","Madison County",1,80,83,37,46
050,51,113,"Virginia","Madison County",1,81,76,35,41
050,51,113,"Virginia","Madison County",1,82,89,41,48
050,51,113,"Virginia","Madison County",1,83,62,27,35
050,51,113,"Virginia","Madison County",1,84,53,27,26
050,51,113,"Virginia","Madison County",1,85,316,125,191
050,51,113,"Virginia","Madison County",2,0,128,67,61
050,51,113,"Virginia","Madison County",2,1,146,76,70
050,51,113,"Virginia","Madison County",2,2,138,73,65
050,51,113,"Virginia","Madison County",2,3,126,64,62
050,51,113,"Virginia","Madison County",2,4,151,75,76
050,51,113,"Virginia","Madison County",2,5,147,67,80
050,51,113,"Virginia","Madison County",2,6,138,61,77
050,51,113,"Virginia","Madison County",2,7,148,68,80
050,51,113,"Virginia","Madison County",2,8,156,75,81
050,51,113,"Virginia","Madison County",2,9,154,77,77
050,51,113,"Virginia","Madison County",2,10,154,80,74
050,51,113,"Virginia","Madison County",2,11,163,86,77
050,51,113,"Virginia","Madison County",2,12,171,92,79
050,51,113,"Virginia","Madison County",2,13,179,95,84
050,51,113,"Virginia","Madison County",2,14,180,89,91
050,51,113,"Virginia","Madison County",2,15,167,81,86
050,51,113,"Virginia","Madison County",2,16,158,74,84
050,51,113,"Virginia","Madison County",2,17,159,78,81
050,51,113,"Virginia","Madison County",2,18,162,83,79
050,51,113,"Virginia","Madison County",2,19,145,71,74
050,51,113,"Virginia","Madison County",2,20,150,70,80
050,51,113,"Virginia","Madison County",2,21,146,68,78
050,51,113,"Virginia","Madison County",2,22,145,62,83
050,51,113,"Virginia","Madison County",2,23,135,60,75
050,51,113,"Virginia","Madison County",2,24,131,67,64
050,51,113,"Virginia","Madison County",2,25,131,70,61
050,51,113,"Virginia","Madison County",2,26,135,69,66
050,51,113,"Virginia","Madison County",2,27,139,74,65
050,51,113,"Virginia","Madison County",2,28,151,79,72
050,51,113,"Virginia","Madison County",2,29,157,74,83
050,51,113,"Virginia","Madison County",2,30,158,71,87
050,51,113,"Virginia","Madison County",2,31,145,70,75
050,51,113,"Virginia","Madison County",2,32,163,77,86
050,51,113,"Virginia","Madison County",2,33,155,80,75
050,51,113,"Virginia","Madison County",2,34,144,75,69
050,51,113,"Virginia","Madison County",2,35,145,69,76
050,51,113,"Virginia","Madison County",2,36,146,70,76
050,51,113,"Virginia","Madison County",2,37,159,82,77
050,51,113,"Virginia","Madison County",2,38,159,78,81
050,51,113,"Virginia","Madison County",2,39,147,75,72
050,51,113,"Virginia","Madison County",2,40,153,74,79
050,51,113,"Virginia","Madison County",2,41,148,69,79
050,51,113,"Virginia","Madison County",2,42,148,75,73
050,51,113,"Virginia","Madison County",2,43,157,73,84
050,51,113,"Virginia","Madison County",2,44,148,71,77
050,51,113,"Virginia","Madison County",2,45,133,64,69
050,51,113,"Virginia","Madison County",2,46,134,68,66
050,51,113,"Virginia","Madison County",2,47,158,86,72
050,51,113,"Virginia","Madison County",2,48,167,84,83
050,51,113,"Virginia","Madison County",2,49,169,82,87
050,51,113,"Virginia","Madison County",2,50,165,81,84
050,51,113,"Virginia","Madison County",2,51,173,90,83
050,51,113,"Virginia","Madison County",2,52,173,90,83
050,51,113,"Virginia","Madison County",2,53,188,100,88
050,51,113,"Virginia","Madison County",2,54,184,100,84
050,51,113,"Virginia","Madison County",2,55,215,104,111
050,51,113,"Virginia","Madison County",2,56,236,111,125
050,51,113,"Virginia","Madison County",2,57,232,109,123
050,51,113,"Virginia","Madison County",2,58,227,110,117
050,51,113,"Virginia","Madison County",2,59,246,119,127
050,51,113,"Virginia","Madison County",2,60,244,112,132
050,51,113,"Virginia","Madison County",2,61,251,120,131
050,51,113,"Virginia","Madison County",2,62,247,119,128
050,51,113,"Virginia","Madison County",2,63,226,113,113
050,51,113,"Virginia","Madison County",2,64,218,112,106
050,51,113,"Virginia","Madison County",2,65,209,103,106
050,51,113,"Virginia","Madison County",2,66,210,99,111
050,51,113,"Virginia","Madison County",2,67,194,87,107
050,51,113,"Virginia","Madison County",2,68,191,91,100
050,51,113,"Virginia","Madison County",2,69,182,87,95
050,51,113,"Virginia","Madison County",2,70,183,91,92
050,51,113,"Virginia","Madison County",2,71,189,92,97
050,51,113,"Virginia","Madison County",2,72,192,90,102
050,51,113,"Virginia","Madison County",2,73,187,79,108
050,51,113,"Virginia","Madison County",2,74,127,54,73
050,51,113,"Virginia","Madison County",2,75,116,53,63
050,51,113,"Virginia","Madison County",2,76,116,51,65
050,51,113,"Virginia","Madison County",2,77,124,58,66
050,51,113,"Virginia","Madison County",2,78,114,56,58
050,51,113,"Virginia","Madison County",2,79,93,46,47
050,51,113,"Virginia","Madison County",2,80,85,39,46
050,51,113,"Virginia","Madison County",2,81,74,35,39
050,51,113,"Virginia","Madison County",2,82,84,39,45
050,51,113,"Virginia","Madison County",2,83,64,27,37
050,51,113,"Virginia","Madison County",2,84,53,25,28
050,51,113,"Virginia","Madison County",2,85,323,130,193
050,51,113,"Virginia","Madison County",3,0,134,71,63
050,51,113,"Virginia","Madison County",3,1,119,57,62
050,51,113,"Virginia","Madison County",3,2,149,72,77
050,51,113,"Virginia","Madison County",3,3,140,74,66
050,51,113,"Virginia","Madison County",3,4,133,72,61
050,51,113,"Virginia","Madison County",3,5,149,74,75
050,51,113,"Virginia","Madison County",3,6,150,67,83
050,51,113,"Virginia","Madison County",3,7,144,64,80
050,51,113,"Virginia","Madison County",3,8,150,72,78
050,51,113,"Virginia","Madison County",3,9,165,79,86
050,51,113,"Virginia","Madison County",3,10,153,73,80
050,51,113,"Virginia","Madison County",3,11,152,77,75
050,51,113,"Virginia","Madison County",3,12,155,82,73
050,51,113,"Virginia","Madison County",3,13,180,98,82
050,51,113,"Virginia","Madison County",3,14,176,93,83
050,51,113,"Virginia","Madison County",3,15,178,88,90
050,51,113,"Virginia","Madison County",3,16,166,83,83
050,51,113,"Virginia","Madison County",3,17,163,78,85
050,51,113,"Virginia","Madison County",3,18,153,75,78
050,51,113,"Virginia","Madison County",3,19,152,74,78
050,51,113,"Virginia","Madison County",3,20,150,74,76
050,51,113,"Virginia","Madison County",3,21,148,67,81
050,51,113,"Virginia","Madison County",3,22,156,73,83
050,51,113,"Virginia","Madison County",3,23,143,65,78
050,51,113,"Virginia","Madison County",3,24,134,60,74
050,51,113,"Virginia","Madison County",3,25,122,62,60
050,51,113,"Virginia","Madison County",3,26,135,68,67
050,51,113,"Virginia","Madison County",3,27,135,71,64
050,51,113,"Virginia","Madison County",3,28,137,75,62
050,51,113,"Virginia","Madison County",3,29,155,80,75
050,51,113,"Virginia","Madison County",3,30,165,81,84
050,51,113,"Virginia","Madison County",3,31,167,71,96
050,51,113,"Virginia","Madison County",3,32,144,67,77
050,51,113,"Virginia","Madison County",3,33,170,76,94
050,51,113,"Virginia","Madison County",3,34,162,83,79
050,51,113,"Virginia","Madison County",3,35,148,71,77
050,51,113,"Virginia","Madison County",3,36,139,70,69
050,51,113,"Virginia","Madison County",3,37,153,71,82
050,51,113,"Virginia","Madison County",3,38,169,88,81
050,51,113,"Virginia","Madison County",3,39,162,82,80
050,51,113,"Virginia","Madison County",3,40,149,76,73
050,51,113,"Virginia","Madison County",3,41,154,78,76
050,51,113,"Virginia","Madison County",3,42,153,73,80
050,51,113,"Virginia","Madison County",3,43,142,68,74
050,51,113,"Virginia","Madison County",3,44,153,73,80
050,51,113,"Virginia","Madison County",3,45,157,69,88
050,51,113,"Virginia","Madison County",3,46,132,66,66
050,51,113,"Virginia","Madison County",3,47,134,71,63
050,51,113,"Virginia","Madison County",3,48,157,82,75
050,51,113,"Virginia","Madison County",3,49,165,83,82
050,51,113,"Virginia","Madison County",3,50,169,82,87
050,51,113,"Virginia","Madison County",3,51,173,82,91
050,51,113,"Virginia","Madison County",3,52,179,92,87
050,51,113,"Virginia","Madison County",3,53,177,89,88
050,51,113,"Virginia","Madison County",3,54,189,98,91
050,51,113,"Virginia","Madison County",3,55,191,108,83
050,51,113,"Virginia","Madison County",3,56,214,103,111
050,51,113,"Virginia","Madison County",3,57,234,111,123
050,51,113,"Virginia","Madison County",3,58,227,105,122
050,51,113,"Virginia","Madison County",3,59,237,116,121
050,51,113,"Virginia","Madison County",3,60,255,120,135
050,51,113,"Virginia","Madison County",3,61,246,112,134
050,51,113,"Virginia","Madison County",3,62,248,121,127
050,51,113,"Virginia","Madison County",3,63,245,120,125
050,51,113,"Virginia","Madison County",3,64,228,113,115
050,51,113,"Virginia","Madison County",3,65,217,110,107
050,51,113,"Virginia","Madison County",3,66,211,103,108
050,51,113,"Virginia","Madison County",3,67,204,97,107
050,51,113,"Virginia","Madison County",3,68,191,85,106
050,51,113,"Virginia","Madison County",3,69,187,90,97
050,51,113,"Virginia","Madison County",3,70,180,85,95
050,51,113,"Virginia","Madison County",3,71,188,95,93
050,51,113,"Virginia","Madison County",3,72,182,90,92
050,51,113,"Virginia","Madison County",3,73,187,88,99
050,51,113,"Virginia","Madison County",3,74,184,82,102
050,51,113,"Virginia","Madison County",3,75,118,49,69
050,51,113,"Virginia","Madison County",3,76,113,49,64
050,51,113,"Virginia","Madison County",3,77,106,39,67
050,51,113,"Virginia","Madison County",3,78,119,55,64
050,51,113,"Virginia","Madison County",3,79,105,53,52
050,51,113,"Virginia","Madison County",3,80,91,44,47
050,51,113,"Virginia","Madison County",3,81,80,40,40
050,51,113,"Virginia","Madison County",3,82,67,31,36
050,51,113,"Virginia","Madison County",3,83,74,36,38
050,51,113,"Virginia","Madison County",3,84,65,28,37
050,51,113,"Virginia","Madison County",3,85,325,133,192
050,51,113,"Virginia","Madison County",4,0,126,61,65
050,51,113,"Virginia","Madison County",4,1,146,76,70
050,51,113,"Virginia","Madison County",4,2,137,62,75
050,51,113,"Virginia","Madison County",4,3,157,73,84
050,51,113,"Virginia","Madison County",4,4,136,73,63
050,51,113,"Virginia","Madison County",4,5,145,80,65
050,51,113,"Virginia","Madison County",4,6,157,81,76
050,51,113,"Virginia","Madison County",4,7,156,72,84
050,51,113,"Virginia","Madison County",4,8,137,67,70
050,51,113,"Virginia","Madison County",4,9,148,71,77
050,51,113,"Virginia","Madison County",4,10,170,77,93
050,51,113,"Virginia","Madison County",4,11,155,77,78
050,51,113,"Virginia","Madison County",4,12,153,78,75
050,51,113,"Virginia","Madison County",4,13,162,80,82
050,51,113,"Virginia","Madison County",4,14,181,95,86
050,51,113,"Virginia","Madison County",4,15,171,91,80
050,51,113,"Virginia","Madison County",4,16,176,89,87
050,51,113,"Virginia","Madison County",4,17,170,87,83
050,51,113,"Virginia","Madison County",4,18,153,76,77
050,51,113,"Virginia","Madison County",4,19,138,68,70
050,51,113,"Virginia","Madison County",4,20,153,72,81
050,51,113,"Virginia","Madison County",4,21,155,71,84
050,51,113,"Virginia","Madison County",4,22,152,71,81
050,51,113,"Virginia","Madison County",4,23,141,68,73
050,51,113,"Virginia","Madison County",4,24,140,65,75
050,51,113,"Virginia","Madison County",4,25,125,62,63
050,51,113,"Virginia","Madison County",4,26,120,63,57
050,51,113,"Virginia","Madison County",4,27,130,69,61
050,51,113,"Virginia","Madison County",4,28,143,77,66
050,51,113,"Virginia","Madison County",4,29,148,77,71
050,51,113,"Virginia","Madison County",4,30,153,79,74
050,51,113,"Virginia","Madison County",4,31,170,87,83
050,51,113,"Virginia","Madison County",4,32,169,74,95
050,51,113,"Virginia","Madison County",4,33,144,69,75
050,51,113,"Virginia","Madison County",4,34,168,80,88
050,51,113,"Virginia","Madison County",4,35,154,78,76
050,51,113,"Virginia","Madison County",4,36,150,69,81
050,51,113,"Virginia","Madison County",4,37,144,74,70
050,51,113,"Virginia","Madison County",4,38,155,67,88
050,51,113,"Virginia","Madison County",4,39,177,87,90
050,51,113,"Virginia","Madison County",4,40,167,82,85
050,51,113,"Virginia","Madison County",4,41,159,79,80
050,51,113,"Virginia","Madison County",4,42,151,78,73
050,51,113,"Virginia","Madison County",4,43,156,75,81
050,51,113,"Virginia","Madison County",4,44,143,66,77
050,51,113,"Virginia","Madison County",4,45,151,70,81
050,51,113,"Virginia","Madison County",4,46,168,81,87
050,51,113,"Virginia","Madison County",4,47,139,69,70
050,51,113,"Virginia","Madison County",4,48,144,78,66
050,51,113,"Virginia","Madison County",4,49,151,81,70
050,51,113,"Virginia","Madison County",4,50,170,87,83
050,51,113,"Virginia","Madison County",4,51,167,84,83
050,51,113,"Virginia","Madison County",4,52,181,84,97
050,51,113,"Virginia","Madison County",4,53,180,94,86
050,51,113,"Virginia","Madison County",4,54,174,91,83
050,51,113,"Virginia","Madison County",4,55,191,98,93
050,51,113,"Virginia","Madison County",4,56,191,109,82
050,51,113,"Virginia","Madison County",4,57,217,102,115
050,51,113,"Virginia","Madison County",4,58,242,116,126
050,51,113,"Virginia","Madison County",4,59,228,105,123
050,51,113,"Virginia","Madison County",4,60,232,111,121
050,51,113,"Virginia","Madison County",4,61,251,113,138
050,51,113,"Virginia","Madison County",4,62,244,112,132
050,51,113,"Virginia","Madison County",4,63,245,113,132
050,51,113,"Virginia","Madison County",4,64,253,129,124
050,51,113,"Virginia","Madison County",4,65,218,109,109
050,51,113,"Virginia","Madison County",4,66,214,110,104
050,51,113,"Virginia","Madison County",4,67,212,101,111
050,51,113,"Virginia","Madison County",4,68,198,93,105
050,51,113,"Virginia","Madison County",4,69,183,79,104
050,51,113,"Virginia","Madison County",4,70,178,85,93
050,51,113,"Virginia","Madison County",4,71,188,89,99
050,51,113,"Virginia","Madison County",4,72,176,89,87
050,51,113,"Virginia","Madison County",4,73,173,87,86
050,51,113,"Virginia","Madison County",4,74,183,85,98
050,51,113,"Virginia","Madison County",4,75,176,76,100
050,51,113,"Virginia","Madison County",4,76,110,45,65
050,51,113,"Virginia","Madison County",4,77,108,48,60
050,51,113,"Virginia","Madison County",4,78,96,30,66
050,51,113,"Virginia","Madison County",4,79,113,54,59
050,51,113,"Virginia","Madison County",4,80,103,51,52
050,51,113,"Virginia","Madison County",4,81,84,42,42
050,51,113,"Virginia","Madison County",4,82,72,36,36
050,51,113,"Virginia","Madison County",4,83,54,24,30
050,51,113,"Virginia","Madison County",4,84,72,37,35
050,51,113,"Virginia","Madison County",4,85,337,129,208
050,51,113,"Virginia","Madison County",5,0,127,61,66
050,51,113,"Virginia","Madison County",5,1,118,54,64
050,51,113,"Virginia","Madison County",5,2,142,69,73
050,51,113,"Virginia","Madison County",5,3,133,58,75
050,51,113,"Virginia","Madison County",5,4,158,73,85
050,51,113,"Virginia","Madison County",5,5,129,62,67
050,51,113,"Virginia","Madison County",5,6,155,85,70
050,51,113,"Virginia","Madison County",5,7,162,83,79
050,51,113,"Virginia","Madison County",5,8,158,77,81
050,51,113,"Virginia","Madison County",5,9,152,73,79
050,51,113,"Virginia","Madison County",5,10,158,75,83
050,51,113,"Virginia","Madison County",5,11,166,81,85
050,51,113,"Virginia","Madison County",5,12,162,78,84
050,51,113,"Virginia","Madison County",5,13,159,81,78
050,51,113,"Virginia","Madison County",5,14,166,87,79
050,51,113,"Virginia","Madison County",5,15,188,97,91
050,51,113,"Virginia","Madison County",5,16,172,91,81
050,51,113,"Virginia","Madison County",5,17,172,85,87
050,51,113,"Virginia","Madison County",5,18,161,80,81
050,51,113,"Virginia","Madison County",5,19,136,62,74
050,51,113,"Virginia","Madison County",5,20,144,71,73
050,51,113,"Virginia","Madison County",5,21,152,72,80
050,51,113,"Virginia","Madison County",5,22,155,70,85
050,51,113,"Virginia","Madison County",5,23,160,74,86
050,51,113,"Virginia","Madison County",5,24,151,72,79
050,51,113,"Virginia","Madison County",5,25,136,60,76
050,51,113,"Virginia","Madison County",5,26,118,56,62
050,51,113,"Virginia","Madison County",5,27,123,64,59
050,51,113,"Virginia","Madison County",5,28,131,66,65
050,51,113,"Virginia","Madison County",5,29,148,76,72
050,51,113,"Virginia","Madison County",5,30,156,80,76
050,51,113,"Virginia","Madison County",5,31,149,80,69
050,51,113,"Virginia","Madison County",5,32,180,94,86
050,51,113,"Virginia","Madison County",5,33,174,81,93
050,51,113,"Virginia","Madison County",5,34,145,73,72
050,51,113,"Virginia","Madison County",5,35,161,75,86
050,51,113,"Virginia","Madison County",5,36,161,80,81
050,51,113,"Virginia","Madison County",5,37,145,67,78
050,51,113,"Virginia","Madison County",5,38,149,75,74
050,51,113,"Virginia","Madison County",5,39,155,68,87
050,51,113,"Virginia","Madison County",5,40,183,85,98
050,51,113,"Virginia","Madison County",5,41,169,83,86
050,51,113,"Virginia","Madison County",5,42,159,82,77
050,51,113,"Virginia","Madison County",5,43,165,82,83
050,51,113,"Virginia","Madison County",5,44,160,79,81
050,51,113,"Virginia","Madison County",5,45,149,79,70
050,51,113,"Virginia","Madison County",5,46,160,72,88
050,51,113,"Virginia","Madison County",5,47,167,81,86
050,51,113,"Virginia","Madison County",5,48,137,65,72
050,51,113,"Virginia","Madison County",5,49,143,78,65
050,51,113,"Virginia","Madison County",5,50,155,80,75
050,51,113,"Virginia","Madison County",5,51,170,86,84
050,51,113,"Virginia","Madison County",5,52,166,86,80
050,51,113,"Virginia","Madison County",5,53,187,86,101
050,51,113,"Virginia","Madison County",5,54,182,91,91
050,51,113,"Virginia","Madison County",5,55,173,88,85
050,51,113,"Virginia","Madison County",5,56,197,101,96
050,51,113,"Virginia","Madison County",5,57,191,112,79
050,51,113,"Virginia","Madison County",5,58,221,102,119
050,51,113,"Virginia","Madison County",5,59,242,114,128
050,51,113,"Virginia","Madison County",5,60,233,107,126
050,51,113,"Virginia","Madison County",5,61,232,115,117
050,51,113,"Virginia","Madison County",5,62,265,123,142
050,51,113,"Virginia","Madison County",5,63,244,110,134
050,51,113,"Virginia","Madison County",5,64,255,116,139
050,51,113,"Virginia","Madison County",5,65,247,121,126
050,51,113,"Virginia","Madison County",5,66,221,109,112
050,51,113,"Virginia","Madison County",5,67,213,109,104
050,51,113,"Virginia","Madison County",5,68,204,102,102
050,51,113,"Virginia","Madison County",5,69,194,93,101
050,51,113,"Virginia","Madison County",5,70,179,78,101
050,51,113,"Virginia","Madison County",5,71,179,88,91
050,51,113,"Virginia","Madison County",5,72,181,83,98
050,51,113,"Virginia","Madison County",5,73,167,85,82
050,51,113,"Virginia","Madison County",5,74,172,88,84
050,51,113,"Virginia","Madison County",5,75,181,83,98
050,51,113,"Virginia","Madison County",5,76,166,67,99
050,51,113,"Virginia","Madison County",5,77,109,42,67
050,51,113,"Virginia","Madison County",5,78,98,41,57
050,51,113,"Virginia","Madison County",5,79,91,30,61
050,51,113,"Virginia","Madison County",5,80,111,50,61
050,51,113,"Virginia","Madison County",5,81,97,50,47
050,51,113,"Virginia","Madison County",5,82,78,37,41
050,51,113,"Virginia","Madison County",5,83,62,29,33
050,51,113,"Virginia","Madison County",5,84,50,25,25
050,51,113,"Virginia","Madison County",5,85,356,136,220
050,51,115,"Virginia","Mathews County",1,0,57,29,28
050,51,115,"Virginia","Mathews County",1,1,55,28,27
050,51,115,"Virginia","Mathews County",1,2,59,27,32
050,51,115,"Virginia","Mathews County",1,3,55,30,25
050,51,115,"Virginia","Mathews County",1,4,76,47,29
050,51,115,"Virginia","Mathews County",1,5,73,41,32
050,51,115,"Virginia","Mathews County",1,6,75,47,28
050,51,115,"Virginia","Mathews County",1,7,72,34,38
050,51,115,"Virginia","Mathews County",1,8,65,32,33
050,51,115,"Virginia","Mathews County",1,9,66,32,34
050,51,115,"Virginia","Mathews County",1,10,81,37,44
050,51,115,"Virginia","Mathews County",1,11,87,48,39
050,51,115,"Virginia","Mathews County",1,12,85,44,41
050,51,115,"Virginia","Mathews County",1,13,87,38,49
050,51,115,"Virginia","Mathews County",1,14,70,30,40
050,51,115,"Virginia","Mathews County",1,15,76,30,46
050,51,115,"Virginia","Mathews County",1,16,86,43,43
050,51,115,"Virginia","Mathews County",1,17,91,46,45
050,51,115,"Virginia","Mathews County",1,18,80,41,39
050,51,115,"Virginia","Mathews County",1,19,70,37,33
050,51,115,"Virginia","Mathews County",1,20,73,36,37
050,51,115,"Virginia","Mathews County",1,21,80,48,32
050,51,115,"Virginia","Mathews County",1,22,78,40,38
050,51,115,"Virginia","Mathews County",1,23,81,37,44
050,51,115,"Virginia","Mathews County",1,24,89,49,40
050,51,115,"Virginia","Mathews County",1,25,79,41,38
050,51,115,"Virginia","Mathews County",1,26,70,38,32
050,51,115,"Virginia","Mathews County",1,27,68,34,34
050,51,115,"Virginia","Mathews County",1,28,60,33,27
050,51,115,"Virginia","Mathews County",1,29,73,34,39
050,51,115,"Virginia","Mathews County",1,30,68,31,37
050,51,115,"Virginia","Mathews County",1,31,73,38,35
050,51,115,"Virginia","Mathews County",1,32,72,25,47
050,51,115,"Virginia","Mathews County",1,33,70,37,33
050,51,115,"Virginia","Mathews County",1,34,79,43,36
050,51,115,"Virginia","Mathews County",1,35,72,36,36
050,51,115,"Virginia","Mathews County",1,36,82,44,38
050,51,115,"Virginia","Mathews County",1,37,76,39,37
050,51,115,"Virginia","Mathews County",1,38,73,36,37
050,51,115,"Virginia","Mathews County",1,39,62,31,31
050,51,115,"Virginia","Mathews County",1,40,63,27,36
050,51,115,"Virginia","Mathews County",1,41,70,32,38
050,51,115,"Virginia","Mathews County",1,42,80,43,37
050,51,115,"Virginia","Mathews County",1,43,68,38,30
050,51,115,"Virginia","Mathews County",1,44,71,38,33
050,51,115,"Virginia","Mathews County",1,45,102,55,47
050,51,115,"Virginia","Mathews County",1,46,107,52,55
050,51,115,"Virginia","Mathews County",1,47,91,49,42
050,51,115,"Virginia","Mathews County",1,48,96,41,55
050,51,115,"Virginia","Mathews County",1,49,111,51,60
050,51,115,"Virginia","Mathews County",1,50,109,60,49
050,51,115,"Virginia","Mathews County",1,51,119,61,58
050,51,115,"Virginia","Mathews County",1,52,103,52,51
050,51,115,"Virginia","Mathews County",1,53,103,48,55
050,51,115,"Virginia","Mathews County",1,54,142,65,77
050,51,115,"Virginia","Mathews County",1,55,143,63,80
050,51,115,"Virginia","Mathews County",1,56,149,72,77
050,51,115,"Virginia","Mathews County",1,57,135,66,69
050,51,115,"Virginia","Mathews County",1,58,146,73,73
050,51,115,"Virginia","Mathews County",1,59,143,69,74
050,51,115,"Virginia","Mathews County",1,60,135,64,71
050,51,115,"Virginia","Mathews County",1,61,154,83,71
050,51,115,"Virginia","Mathews County",1,62,162,84,78
050,51,115,"Virginia","Mathews County",1,63,167,78,89
050,51,115,"Virginia","Mathews County",1,64,174,81,93
050,51,115,"Virginia","Mathews County",1,65,157,67,90
050,51,115,"Virginia","Mathews County",1,66,140,62,78
050,51,115,"Virginia","Mathews County",1,67,159,76,83
050,51,115,"Virginia","Mathews County",1,68,145,73,72
050,51,115,"Virginia","Mathews County",1,69,144,72,72
050,51,115,"Virginia","Mathews County",1,70,150,69,81
050,51,115,"Virginia","Mathews County",1,71,138,67,71
050,51,115,"Virginia","Mathews County",1,72,139,63,76
050,51,115,"Virginia","Mathews County",1,73,165,75,90
050,51,115,"Virginia","Mathews County",1,74,120,60,60
050,51,115,"Virginia","Mathews County",1,75,125,57,68
050,51,115,"Virginia","Mathews County",1,76,142,70,72
050,51,115,"Virginia","Mathews County",1,77,125,61,64
050,51,115,"Virginia","Mathews County",1,78,98,46,52
050,51,115,"Virginia","Mathews County",1,79,79,39,40
050,51,115,"Virginia","Mathews County",1,80,79,38,41
050,51,115,"Virginia","Mathews County",1,81,65,32,33
050,51,115,"Virginia","Mathews County",1,82,69,34,35
050,51,115,"Virginia","Mathews County",1,83,71,30,41
050,51,115,"Virginia","Mathews County",1,84,59,27,32
050,51,115,"Virginia","Mathews County",1,85,277,118,159
050,51,115,"Virginia","Mathews County",2,0,55,26,29
050,51,115,"Virginia","Mathews County",2,1,56,29,27
050,51,115,"Virginia","Mathews County",2,2,57,27,30
050,51,115,"Virginia","Mathews County",2,3,56,29,27
050,51,115,"Virginia","Mathews County",2,4,73,45,28
050,51,115,"Virginia","Mathews County",2,5,75,43,32
050,51,115,"Virginia","Mathews County",2,6,74,45,29
050,51,115,"Virginia","Mathews County",2,7,73,37,36
050,51,115,"Virginia","Mathews County",2,8,64,31,33
050,51,115,"Virginia","Mathews County",2,9,67,34,33
050,51,115,"Virginia","Mathews County",2,10,78,36,42
050,51,115,"Virginia","Mathews County",2,11,83,45,38
050,51,115,"Virginia","Mathews County",2,12,89,46,43
050,51,115,"Virginia","Mathews County",2,13,86,39,47
050,51,115,"Virginia","Mathews County",2,14,73,31,42
050,51,115,"Virginia","Mathews County",2,15,76,30,46
050,51,115,"Virginia","Mathews County",2,16,82,40,42
050,51,115,"Virginia","Mathews County",2,17,90,46,44
050,51,115,"Virginia","Mathews County",2,18,80,41,39
050,51,115,"Virginia","Mathews County",2,19,69,36,33
050,51,115,"Virginia","Mathews County",2,20,74,37,37
050,51,115,"Virginia","Mathews County",2,21,80,46,34
050,51,115,"Virginia","Mathews County",2,22,78,41,37
050,51,115,"Virginia","Mathews County",2,23,85,40,45
050,51,115,"Virginia","Mathews County",2,24,87,47,40
050,51,115,"Virginia","Mathews County",2,25,80,42,38
050,51,115,"Virginia","Mathews County",2,26,72,39,33
050,51,115,"Virginia","Mathews County",2,27,67,35,32
050,51,115,"Virginia","Mathews County",2,28,60,32,28
050,51,115,"Virginia","Mathews County",2,29,67,31,36
050,51,115,"Virginia","Mathews County",2,30,71,33,38
050,51,115,"Virginia","Mathews County",2,31,72,37,35
050,51,115,"Virginia","Mathews County",2,32,70,27,43
050,51,115,"Virginia","Mathews County",2,33,71,35,36
050,51,115,"Virginia","Mathews County",2,34,74,39,35
050,51,115,"Virginia","Mathews County",2,35,74,38,36
050,51,115,"Virginia","Mathews County",2,36,79,42,37
050,51,115,"Virginia","Mathews County",2,37,79,41,38
050,51,115,"Virginia","Mathews County",2,38,74,37,37
050,51,115,"Virginia","Mathews County",2,39,63,31,32
050,51,115,"Virginia","Mathews County",2,40,63,28,35
050,51,115,"Virginia","Mathews County",2,41,70,31,39
050,51,115,"Virginia","Mathews County",2,42,79,42,37
050,51,115,"Virginia","Mathews County",2,43,73,41,32
050,51,115,"Virginia","Mathews County",2,44,68,36,32
050,51,115,"Virginia","Mathews County",2,45,95,51,44
050,51,115,"Virginia","Mathews County",2,46,106,53,53
050,51,115,"Virginia","Mathews County",2,47,94,49,45
050,51,115,"Virginia","Mathews County",2,48,95,42,53
050,51,115,"Virginia","Mathews County",2,49,110,50,60
050,51,115,"Virginia","Mathews County",2,50,110,57,53
050,51,115,"Virginia","Mathews County",2,51,117,61,56
050,51,115,"Virginia","Mathews County",2,52,105,52,53
050,51,115,"Virginia","Mathews County",2,53,104,49,55
050,51,115,"Virginia","Mathews County",2,54,134,63,71
050,51,115,"Virginia","Mathews County",2,55,146,64,82
050,51,115,"Virginia","Mathews County",2,56,149,70,79
050,51,115,"Virginia","Mathews County",2,57,139,68,71
050,51,115,"Virginia","Mathews County",2,58,146,73,73
050,51,115,"Virginia","Mathews County",2,59,145,71,74
050,51,115,"Virginia","Mathews County",2,60,135,64,71
050,51,115,"Virginia","Mathews County",2,61,147,77,70
050,51,115,"Virginia","Mathews County",2,62,160,84,76
050,51,115,"Virginia","Mathews County",2,63,171,82,89
050,51,115,"Virginia","Mathews County",2,64,169,78,91
050,51,115,"Virginia","Mathews County",2,65,160,69,91
050,51,115,"Virginia","Mathews County",2,66,146,64,82
050,51,115,"Virginia","Mathews County",2,67,152,72,80
050,51,115,"Virginia","Mathews County",2,68,146,72,74
050,51,115,"Virginia","Mathews County",2,69,148,74,74
050,51,115,"Virginia","Mathews County",2,70,145,68,77
050,51,115,"Virginia","Mathews County",2,71,142,68,74
050,51,115,"Virginia","Mathews County",2,72,137,63,74
050,51,115,"Virginia","Mathews County",2,73,167,76,91
050,51,115,"Virginia","Mathews County",2,74,122,59,63
050,51,115,"Virginia","Mathews County",2,75,123,56,67
050,51,115,"Virginia","Mathews County",2,76,138,67,71
050,51,115,"Virginia","Mathews County",2,77,132,65,67
050,51,115,"Virginia","Mathews County",2,78,100,48,52
050,51,115,"Virginia","Mathews County",2,79,83,40,43
050,51,115,"Virginia","Mathews County",2,80,78,38,40
050,51,115,"Virginia","Mathews County",2,81,67,32,35
050,51,115,"Virginia","Mathews County",2,82,66,33,33
050,51,115,"Virginia","Mathews County",2,83,68,29,39
050,51,115,"Virginia","Mathews County",2,84,59,28,31
050,51,115,"Virginia","Mathews County",2,85,276,119,157
050,51,115,"Virginia","Mathews County",3,0,59,30,29
050,51,115,"Virginia","Mathews County",3,1,59,23,36
050,51,115,"Virginia","Mathews County",3,2,60,30,30
050,51,115,"Virginia","Mathews County",3,3,56,25,31
050,51,115,"Virginia","Mathews County",3,4,58,28,30
050,51,115,"Virginia","Mathews County",3,5,73,48,25
050,51,115,"Virginia","Mathews County",3,6,75,43,32
050,51,115,"Virginia","Mathews County",3,7,66,44,22
050,51,115,"Virginia","Mathews County",3,8,75,39,36
050,51,115,"Virginia","Mathews County",3,9,70,34,36
050,51,115,"Virginia","Mathews County",3,10,73,38,35
050,51,115,"Virginia","Mathews County",3,11,82,37,45
050,51,115,"Virginia","Mathews County",3,12,86,50,36
050,51,115,"Virginia","Mathews County",3,13,102,54,48
050,51,115,"Virginia","Mathews County",3,14,88,45,43
050,51,115,"Virginia","Mathews County",3,15,75,29,46
050,51,115,"Virginia","Mathews County",3,16,74,31,43
050,51,115,"Virginia","Mathews County",3,17,77,40,37
050,51,115,"Virginia","Mathews County",3,18,81,43,38
050,51,115,"Virginia","Mathews County",3,19,65,35,30
050,51,115,"Virginia","Mathews County",3,20,87,46,41
050,51,115,"Virginia","Mathews County",3,21,83,40,43
050,51,115,"Virginia","Mathews County",3,22,81,48,33
050,51,115,"Virginia","Mathews County",3,23,79,43,36
050,51,115,"Virginia","Mathews County",3,24,75,35,40
050,51,115,"Virginia","Mathews County",3,25,84,47,37
050,51,115,"Virginia","Mathews County",3,26,83,42,41
050,51,115,"Virginia","Mathews County",3,27,74,40,34
050,51,115,"Virginia","Mathews County",3,28,64,33,31
050,51,115,"Virginia","Mathews County",3,29,61,33,28
050,51,115,"Virginia","Mathews County",3,30,75,37,38
050,51,115,"Virginia","Mathews County",3,31,72,33,39
050,51,115,"Virginia","Mathews County",3,32,67,35,32
050,51,115,"Virginia","Mathews County",3,33,71,29,42
050,51,115,"Virginia","Mathews County",3,34,78,40,38
050,51,115,"Virginia","Mathews County",3,35,69,36,33
050,51,115,"Virginia","Mathews County",3,36,72,37,35
050,51,115,"Virginia","Mathews County",3,37,80,42,38
050,51,115,"Virginia","Mathews County",3,38,88,46,42
050,51,115,"Virginia","Mathews County",3,39,67,33,34
050,51,115,"Virginia","Mathews County",3,40,68,34,34
050,51,115,"Virginia","Mathews County",3,41,66,29,37
050,51,115,"Virginia","Mathews County",3,42,71,30,41
050,51,115,"Virginia","Mathews County",3,43,78,45,33
050,51,115,"Virginia","Mathews County",3,44,73,37,36
050,51,115,"Virginia","Mathews County",3,45,73,41,32
050,51,115,"Virginia","Mathews County",3,46,91,49,42
050,51,115,"Virginia","Mathews County",3,47,99,52,47
050,51,115,"Virginia","Mathews County",3,48,99,51,48
050,51,115,"Virginia","Mathews County",3,49,95,44,51
050,51,115,"Virginia","Mathews County",3,50,114,54,60
050,51,115,"Virginia","Mathews County",3,51,98,51,47
050,51,115,"Virginia","Mathews County",3,52,114,59,55
050,51,115,"Virginia","Mathews County",3,53,107,47,60
050,51,115,"Virginia","Mathews County",3,54,115,55,60
050,51,115,"Virginia","Mathews County",3,55,139,66,73
050,51,115,"Virginia","Mathews County",3,56,151,70,81
050,51,115,"Virginia","Mathews County",3,57,151,68,83
050,51,115,"Virginia","Mathews County",3,58,144,71,73
050,51,115,"Virginia","Mathews County",3,59,147,80,67
050,51,115,"Virginia","Mathews County",3,60,144,70,74
050,51,115,"Virginia","Mathews County",3,61,138,61,77
050,51,115,"Virginia","Mathews County",3,62,142,72,70
050,51,115,"Virginia","Mathews County",3,63,167,86,81
050,51,115,"Virginia","Mathews County",3,64,172,83,89
050,51,115,"Virginia","Mathews County",3,65,166,75,91
050,51,115,"Virginia","Mathews County",3,66,168,73,95
050,51,115,"Virginia","Mathews County",3,67,147,66,81
050,51,115,"Virginia","Mathews County",3,68,154,72,82
050,51,115,"Virginia","Mathews County",3,69,147,73,74
050,51,115,"Virginia","Mathews County",3,70,141,70,71
050,51,115,"Virginia","Mathews County",3,71,144,67,77
050,51,115,"Virginia","Mathews County",3,72,146,68,78
050,51,115,"Virginia","Mathews County",3,73,134,60,74
050,51,115,"Virginia","Mathews County",3,74,159,76,83
050,51,115,"Virginia","Mathews County",3,75,124,60,64
050,51,115,"Virginia","Mathews County",3,76,117,52,65
050,51,115,"Virginia","Mathews County",3,77,131,66,65
050,51,115,"Virginia","Mathews County",3,78,124,59,65
050,51,115,"Virginia","Mathews County",3,79,93,41,52
050,51,115,"Virginia","Mathews County",3,80,77,37,40
050,51,115,"Virginia","Mathews County",3,81,78,37,41
050,51,115,"Virginia","Mathews County",3,82,61,30,31
050,51,115,"Virginia","Mathews County",3,83,64,32,32
050,51,115,"Virginia","Mathews County",3,84,62,24,38
050,51,115,"Virginia","Mathews County",3,85,286,125,161
050,51,115,"Virginia","Mathews County",4,0,62,31,31
050,51,115,"Virginia","Mathews County",4,1,68,32,36
050,51,115,"Virginia","Mathews County",4,2,63,23,40
050,51,115,"Virginia","Mathews County",4,3,64,33,31
050,51,115,"Virginia","Mathews County",4,4,57,25,32
050,51,115,"Virginia","Mathews County",4,5,64,34,30
050,51,115,"Virginia","Mathews County",4,6,67,39,28
050,51,115,"Virginia","Mathews County",4,7,75,42,33
050,51,115,"Virginia","Mathews County",4,8,70,46,24
050,51,115,"Virginia","Mathews County",4,9,73,34,39
050,51,115,"Virginia","Mathews County",4,10,71,35,36
050,51,115,"Virginia","Mathews County",4,11,72,35,37
050,51,115,"Virginia","Mathews County",4,12,77,37,40
050,51,115,"Virginia","Mathews County",4,13,84,45,39
050,51,115,"Virginia","Mathews County",4,14,100,51,49
050,51,115,"Virginia","Mathews County",4,15,85,42,43
050,51,115,"Virginia","Mathews County",4,16,70,28,42
050,51,115,"Virginia","Mathews County",4,17,68,26,42
050,51,115,"Virginia","Mathews County",4,18,67,35,32
050,51,115,"Virginia","Mathews County",4,19,70,35,35
050,51,115,"Virginia","Mathews County",4,20,68,34,34
050,51,115,"Virginia","Mathews County",4,21,87,42,45
050,51,115,"Virginia","Mathews County",4,22,74,38,36
050,51,115,"Virginia","Mathews County",4,23,83,49,34
050,51,115,"Virginia","Mathews County",4,24,68,30,38
050,51,115,"Virginia","Mathews County",4,25,74,39,35
050,51,115,"Virginia","Mathews County",4,26,80,45,35
050,51,115,"Virginia","Mathews County",4,27,78,38,40
050,51,115,"Virginia","Mathews County",4,28,69,36,33
050,51,115,"Virginia","Mathews County",4,29,62,32,30
050,51,115,"Virginia","Mathews County",4,30,57,32,25
050,51,115,"Virginia","Mathews County",4,31,79,40,39
050,51,115,"Virginia","Mathews County",4,32,71,35,36
050,51,115,"Virginia","Mathews County",4,33,71,36,35
050,51,115,"Virginia","Mathews County",4,34,69,30,39
050,51,115,"Virginia","Mathews County",4,35,86,41,45
050,51,115,"Virginia","Mathews County",4,36,69,37,32
050,51,115,"Virginia","Mathews County",4,37,70,34,36
050,51,115,"Virginia","Mathews County",4,38,78,42,36
050,51,115,"Virginia","Mathews County",4,39,77,43,34
050,51,115,"Virginia","Mathews County",4,40,71,37,34
050,51,115,"Virginia","Mathews County",4,41,64,31,33
050,51,115,"Virginia","Mathews County",4,42,71,33,38
050,51,115,"Virginia","Mathews County",4,43,71,31,40
050,51,115,"Virginia","Mathews County",4,44,82,46,36
050,51,115,"Virginia","Mathews County",4,45,78,38,40
050,51,115,"Virginia","Mathews County",4,46,75,40,35
050,51,115,"Virginia","Mathews County",4,47,93,53,40
050,51,115,"Virginia","Mathews County",4,48,97,49,48
050,51,115,"Virginia","Mathews County",4,49,91,49,42
050,51,115,"Virginia","Mathews County",4,50,94,44,50
050,51,115,"Virginia","Mathews County",4,51,115,56,59
050,51,115,"Virginia","Mathews County",4,52,101,48,53
050,51,115,"Virginia","Mathews County",4,53,114,59,55
050,51,115,"Virginia","Mathews County",4,54,108,50,58
050,51,115,"Virginia","Mathews County",4,55,114,50,64
050,51,115,"Virginia","Mathews County",4,56,140,66,74
050,51,115,"Virginia","Mathews County",4,57,154,73,81
050,51,115,"Virginia","Mathews County",4,58,147,66,81
050,51,115,"Virginia","Mathews County",4,59,158,76,82
050,51,115,"Virginia","Mathews County",4,60,147,76,71
050,51,115,"Virginia","Mathews County",4,61,152,72,80
050,51,115,"Virginia","Mathews County",4,62,133,59,74
050,51,115,"Virginia","Mathews County",4,63,151,74,77
050,51,115,"Virginia","Mathews County",4,64,180,91,89
050,51,115,"Virginia","Mathews County",4,65,174,87,87
050,51,115,"Virginia","Mathews County",4,66,168,71,97
050,51,115,"Virginia","Mathews County",4,67,168,77,91
050,51,115,"Virginia","Mathews County",4,68,146,66,80
050,51,115,"Virginia","Mathews County",4,69,156,69,87
050,51,115,"Virginia","Mathews County",4,70,137,67,70
050,51,115,"Virginia","Mathews County",4,71,145,67,78
050,51,115,"Virginia","Mathews County",4,72,143,65,78
050,51,115,"Virginia","Mathews County",4,73,148,69,79
050,51,115,"Virginia","Mathews County",4,74,119,56,63
050,51,115,"Virginia","Mathews County",4,75,150,72,78
050,51,115,"Virginia","Mathews County",4,76,121,56,65
050,51,115,"Virginia","Mathews County",4,77,115,56,59
050,51,115,"Virginia","Mathews County",4,78,121,58,63
050,51,115,"Virginia","Mathews County",4,79,115,55,60
050,51,115,"Virginia","Mathews County",4,80,82,33,49
050,51,115,"Virginia","Mathews County",4,81,78,38,40
050,51,115,"Virginia","Mathews County",4,82,68,32,36
050,51,115,"Virginia","Mathews County",4,83,58,26,32
050,51,115,"Virginia","Mathews County",4,84,58,28,30
050,51,115,"Virginia","Mathews County",4,85,282,118,164
050,51,115,"Virginia","Mathews County",5,0,63,32,31
050,51,115,"Virginia","Mathews County",5,1,59,32,27
050,51,115,"Virginia","Mathews County",5,2,71,33,38
050,51,115,"Virginia","Mathews County",5,3,74,32,42
050,51,115,"Virginia","Mathews County",5,4,65,34,31
050,51,115,"Virginia","Mathews County",5,5,69,35,34
050,51,115,"Virginia","Mathews County",5,6,77,38,39
050,51,115,"Virginia","Mathews County",5,7,64,38,26
050,51,115,"Virginia","Mathews County",5,8,86,47,39
050,51,115,"Virginia","Mathews County",5,9,66,44,22
050,51,115,"Virginia","Mathews County",5,10,73,35,38
050,51,115,"Virginia","Mathews County",5,11,70,33,37
050,51,115,"Virginia","Mathews County",5,12,73,37,36
050,51,115,"Virginia","Mathews County",5,13,74,34,40
050,51,115,"Virginia","Mathews County",5,14,90,51,39
050,51,115,"Virginia","Mathews County",5,15,104,52,52
050,51,115,"Virginia","Mathews County",5,16,91,48,43
050,51,115,"Virginia","Mathews County",5,17,75,31,44
050,51,115,"Virginia","Mathews County",5,18,59,24,35
050,51,115,"Virginia","Mathews County",5,19,54,28,26
050,51,115,"Virginia","Mathews County",5,20,77,38,39
050,51,115,"Virginia","Mathews County",5,21,73,34,39
050,51,115,"Virginia","Mathews County",5,22,83,43,40
050,51,115,"Virginia","Mathews County",5,23,81,43,38
050,51,115,"Virginia","Mathews County",5,24,89,54,35
050,51,115,"Virginia","Mathews County",5,25,72,32,40
050,51,115,"Virginia","Mathews County",5,26,82,45,37
050,51,115,"Virginia","Mathews County",5,27,85,48,37
050,51,115,"Virginia","Mathews County",5,28,66,31,35
050,51,115,"Virginia","Mathews County",5,29,70,38,32
050,51,115,"Virginia","Mathews County",5,30,63,33,30
050,51,115,"Virginia","Mathews County",5,31,64,36,28
050,51,115,"Virginia","Mathews County",5,32,83,40,43
050,51,115,"Virginia","Mathews County",5,33,80,40,40
050,51,115,"Virginia","Mathews County",5,34,82,40,42
050,51,115,"Virginia","Mathews County",5,35,70,29,41
050,51,115,"Virginia","Mathews County",5,36,80,36,44
050,51,115,"Virginia","Mathews County",5,37,72,36,36
050,51,115,"Virginia","Mathews County",5,38,70,35,35
050,51,115,"Virginia","Mathews County",5,39,71,42,29
050,51,115,"Virginia","Mathews County",5,40,81,43,38
050,51,115,"Virginia","Mathews County",5,41,78,39,39
050,51,115,"Virginia","Mathews County",5,42,67,32,35
050,51,115,"Virginia","Mathews County",5,43,67,28,39
050,51,115,"Virginia","Mathews County",5,44,79,38,41
050,51,115,"Virginia","Mathews County",5,45,80,49,31
050,51,115,"Virginia","Mathews County",5,46,78,37,41
050,51,115,"Virginia","Mathews County",5,47,65,34,31
050,51,115,"Virginia","Mathews County",5,48,96,54,42
050,51,115,"Virginia","Mathews County",5,49,94,48,46
050,51,115,"Virginia","Mathews County",5,50,99,53,46
050,51,115,"Virginia","Mathews County",5,51,101,50,51
050,51,115,"Virginia","Mathews County",5,52,123,60,63
050,51,115,"Virginia","Mathews County",5,53,102,47,55
050,51,115,"Virginia","Mathews County",5,54,125,64,61
050,51,115,"Virginia","Mathews County",5,55,105,50,55
050,51,115,"Virginia","Mathews County",5,56,117,53,64
050,51,115,"Virginia","Mathews County",5,57,142,67,75
050,51,115,"Virginia","Mathews County",5,58,157,72,85
050,51,115,"Virginia","Mathews County",5,59,158,75,83
050,51,115,"Virginia","Mathews County",5,60,162,77,85
050,51,115,"Virginia","Mathews County",5,61,155,78,77
050,51,115,"Virginia","Mathews County",5,62,148,71,77
050,51,115,"Virginia","Mathews County",5,63,135,61,74
050,51,115,"Virginia","Mathews County",5,64,156,79,77
050,51,115,"Virginia","Mathews County",5,65,182,88,94
050,51,115,"Virginia","Mathews County",5,66,169,84,85
050,51,115,"Virginia","Mathews County",5,67,172,76,96
050,51,115,"Virginia","Mathews County",5,68,165,75,90
050,51,115,"Virginia","Mathews County",5,69,146,64,82
050,51,115,"Virginia","Mathews County",5,70,151,68,83
050,51,115,"Virginia","Mathews County",5,71,121,57,64
050,51,115,"Virginia","Mathews County",5,72,145,68,77
050,51,115,"Virginia","Mathews County",5,73,143,63,80
050,51,115,"Virginia","Mathews County",5,74,133,66,67
050,51,115,"Virginia","Mathews County",5,75,114,56,58
050,51,115,"Virginia","Mathews County",5,76,141,64,77
050,51,115,"Virginia","Mathews County",5,77,116,56,60
050,51,115,"Virginia","Mathews County",5,78,105,51,54
050,51,115,"Virginia","Mathews County",5,79,120,58,62
050,51,115,"Virginia","Mathews County",5,80,106,49,57
050,51,115,"Virginia","Mathews County",5,81,76,31,45
050,51,115,"Virginia","Mathews County",5,82,70,35,35
050,51,115,"Virginia","Mathews County",5,83,68,31,37
050,51,115,"Virginia","Mathews County",5,84,51,21,30
050,51,115,"Virginia","Mathews County",5,85,280,121,159
050,51,117,"Virginia","Mecklenburg County",1,0,300,157,143
050,51,117,"Virginia","Mecklenburg County",1,1,299,162,137
050,51,117,"Virginia","Mecklenburg County",1,2,311,177,134
050,51,117,"Virginia","Mecklenburg County",1,3,308,157,151
050,51,117,"Virginia","Mecklenburg County",1,4,300,155,145
050,51,117,"Virginia","Mecklenburg County",1,5,301,154,147
050,51,117,"Virginia","Mecklenburg County",1,6,291,142,149
050,51,117,"Virginia","Mecklenburg County",1,7,289,143,146
050,51,117,"Virginia","Mecklenburg County",1,8,316,165,151
050,51,117,"Virginia","Mecklenburg County",1,9,303,156,147
050,51,117,"Virginia","Mecklenburg County",1,10,319,167,152
050,51,117,"Virginia","Mecklenburg County",1,11,323,154,169
050,51,117,"Virginia","Mecklenburg County",1,12,323,158,165
050,51,117,"Virginia","Mecklenburg County",1,13,346,187,159
050,51,117,"Virginia","Mecklenburg County",1,14,343,184,159
050,51,117,"Virginia","Mecklenburg County",1,15,331,155,176
050,51,117,"Virginia","Mecklenburg County",1,16,349,177,172
050,51,117,"Virginia","Mecklenburg County",1,17,361,180,181
050,51,117,"Virginia","Mecklenburg County",1,18,285,148,137
050,51,117,"Virginia","Mecklenburg County",1,19,244,129,115
050,51,117,"Virginia","Mecklenburg County",1,20,276,146,130
050,51,117,"Virginia","Mecklenburg County",1,21,295,156,139
050,51,117,"Virginia","Mecklenburg County",1,22,316,169,147
050,51,117,"Virginia","Mecklenburg County",1,23,324,165,159
050,51,117,"Virginia","Mecklenburg County",1,24,307,149,158
050,51,117,"Virginia","Mecklenburg County",1,25,306,150,156
050,51,117,"Virginia","Mecklenburg County",1,26,291,157,134
050,51,117,"Virginia","Mecklenburg County",1,27,331,180,151
050,51,117,"Virginia","Mecklenburg County",1,28,315,158,157
050,51,117,"Virginia","Mecklenburg County",1,29,328,175,153
050,51,117,"Virginia","Mecklenburg County",1,30,313,153,160
050,51,117,"Virginia","Mecklenburg County",1,31,295,140,155
050,51,117,"Virginia","Mecklenburg County",1,32,300,146,154
050,51,117,"Virginia","Mecklenburg County",1,33,309,166,143
050,51,117,"Virginia","Mecklenburg County",1,34,293,153,140
050,51,117,"Virginia","Mecklenburg County",1,35,269,132,137
050,51,117,"Virginia","Mecklenburg County",1,36,289,150,139
050,51,117,"Virginia","Mecklenburg County",1,37,314,159,155
050,51,117,"Virginia","Mecklenburg County",1,38,289,153,136
050,51,117,"Virginia","Mecklenburg County",1,39,297,163,134
050,51,117,"Virginia","Mecklenburg County",1,40,297,160,137
050,51,117,"Virginia","Mecklenburg County",1,41,293,146,147
050,51,117,"Virginia","Mecklenburg County",1,42,324,154,170
050,51,117,"Virginia","Mecklenburg County",1,43,304,150,154
050,51,117,"Virginia","Mecklenburg County",1,44,294,143,151
050,51,117,"Virginia","Mecklenburg County",1,45,301,131,170
050,51,117,"Virginia","Mecklenburg County",1,46,329,157,172
050,51,117,"Virginia","Mecklenburg County",1,47,354,168,186
050,51,117,"Virginia","Mecklenburg County",1,48,369,171,198
050,51,117,"Virginia","Mecklenburg County",1,49,382,169,213
050,51,117,"Virginia","Mecklenburg County",1,50,344,171,173
050,51,117,"Virginia","Mecklenburg County",1,51,352,178,174
050,51,117,"Virginia","Mecklenburg County",1,52,358,176,182
050,51,117,"Virginia","Mecklenburg County",1,53,381,185,196
050,51,117,"Virginia","Mecklenburg County",1,54,403,189,214
050,51,117,"Virginia","Mecklenburg County",1,55,457,228,229
050,51,117,"Virginia","Mecklenburg County",1,56,506,259,247
050,51,117,"Virginia","Mecklenburg County",1,57,512,253,259
050,51,117,"Virginia","Mecklenburg County",1,58,493,233,260
050,51,117,"Virginia","Mecklenburg County",1,59,491,236,255
050,51,117,"Virginia","Mecklenburg County",1,60,481,226,255
050,51,117,"Virginia","Mecklenburg County",1,61,514,249,265
050,51,117,"Virginia","Mecklenburg County",1,62,526,262,264
050,51,117,"Virginia","Mecklenburg County",1,63,501,251,250
050,51,117,"Virginia","Mecklenburg County",1,64,528,257,271
050,51,117,"Virginia","Mecklenburg County",1,65,504,232,272
050,51,117,"Virginia","Mecklenburg County",1,66,482,211,271
050,51,117,"Virginia","Mecklenburg County",1,67,514,235,279
050,51,117,"Virginia","Mecklenburg County",1,68,481,232,249
050,51,117,"Virginia","Mecklenburg County",1,69,448,231,217
050,51,117,"Virginia","Mecklenburg County",1,70,458,217,241
050,51,117,"Virginia","Mecklenburg County",1,71,479,226,253
050,51,117,"Virginia","Mecklenburg County",1,72,487,236,251
050,51,117,"Virginia","Mecklenburg County",1,73,457,228,229
050,51,117,"Virginia","Mecklenburg County",1,74,320,142,178
050,51,117,"Virginia","Mecklenburg County",1,75,304,135,169
050,51,117,"Virginia","Mecklenburg County",1,76,337,151,186
050,51,117,"Virginia","Mecklenburg County",1,77,326,146,180
050,51,117,"Virginia","Mecklenburg County",1,78,274,119,155
050,51,117,"Virginia","Mecklenburg County",1,79,253,113,140
050,51,117,"Virginia","Mecklenburg County",1,80,212,87,125
050,51,117,"Virginia","Mecklenburg County",1,81,219,97,122
050,51,117,"Virginia","Mecklenburg County",1,82,180,73,107
050,51,117,"Virginia","Mecklenburg County",1,83,185,84,101
050,51,117,"Virginia","Mecklenburg County",1,84,166,71,95
050,51,117,"Virginia","Mecklenburg County",1,85,836,279,557
050,51,117,"Virginia","Mecklenburg County",2,0,295,151,144
050,51,117,"Virginia","Mecklenburg County",2,1,298,161,137
050,51,117,"Virginia","Mecklenburg County",2,2,310,174,136
050,51,117,"Virginia","Mecklenburg County",2,3,307,160,147
050,51,117,"Virginia","Mecklenburg County",2,4,301,154,147
050,51,117,"Virginia","Mecklenburg County",2,5,301,154,147
050,51,117,"Virginia","Mecklenburg County",2,6,297,146,151
050,51,117,"Virginia","Mecklenburg County",2,7,291,144,147
050,51,117,"Virginia","Mecklenburg County",2,8,307,158,149
050,51,117,"Virginia","Mecklenburg County",2,9,306,159,147
050,51,117,"Virginia","Mecklenburg County",2,10,315,162,153
050,51,117,"Virginia","Mecklenburg County",2,11,318,155,163
050,51,117,"Virginia","Mecklenburg County",2,12,323,156,167
050,51,117,"Virginia","Mecklenburg County",2,13,339,181,158
050,51,117,"Virginia","Mecklenburg County",2,14,345,185,160
050,51,117,"Virginia","Mecklenburg County",2,15,332,161,171
050,51,117,"Virginia","Mecklenburg County",2,16,344,172,172
050,51,117,"Virginia","Mecklenburg County",2,17,358,178,180
050,51,117,"Virginia","Mecklenburg County",2,18,292,151,141
050,51,117,"Virginia","Mecklenburg County",2,19,247,131,116
050,51,117,"Virginia","Mecklenburg County",2,20,276,146,130
050,51,117,"Virginia","Mecklenburg County",2,21,293,155,138
050,51,117,"Virginia","Mecklenburg County",2,22,315,168,147
050,51,117,"Virginia","Mecklenburg County",2,23,327,168,159
050,51,117,"Virginia","Mecklenburg County",2,24,311,152,159
050,51,117,"Virginia","Mecklenburg County",2,25,302,148,154
050,51,117,"Virginia","Mecklenburg County",2,26,291,152,139
050,51,117,"Virginia","Mecklenburg County",2,27,322,173,149
050,51,117,"Virginia","Mecklenburg County",2,28,316,162,154
050,51,117,"Virginia","Mecklenburg County",2,29,327,172,155
050,51,117,"Virginia","Mecklenburg County",2,30,315,157,158
050,51,117,"Virginia","Mecklenburg County",2,31,297,142,155
050,51,117,"Virginia","Mecklenburg County",2,32,300,146,154
050,51,117,"Virginia","Mecklenburg County",2,33,309,164,145
050,51,117,"Virginia","Mecklenburg County",2,34,296,156,140
050,51,117,"Virginia","Mecklenburg County",2,35,278,140,138
050,51,117,"Virginia","Mecklenburg County",2,36,285,146,139
050,51,117,"Virginia","Mecklenburg County",2,37,304,153,151
050,51,117,"Virginia","Mecklenburg County",2,38,297,156,141
050,51,117,"Virginia","Mecklenburg County",2,39,291,158,133
050,51,117,"Virginia","Mecklenburg County",2,40,298,160,138
050,51,117,"Virginia","Mecklenburg County",2,41,295,149,146
050,51,117,"Virginia","Mecklenburg County",2,42,314,152,162
050,51,117,"Virginia","Mecklenburg County",2,43,313,153,160
050,51,117,"Virginia","Mecklenburg County",2,44,295,142,153
050,51,117,"Virginia","Mecklenburg County",2,45,302,135,167
050,51,117,"Virginia","Mecklenburg County",2,46,321,151,170
050,51,117,"Virginia","Mecklenburg County",2,47,347,166,181
050,51,117,"Virginia","Mecklenburg County",2,48,365,168,197
050,51,117,"Virginia","Mecklenburg County",2,49,383,171,212
050,51,117,"Virginia","Mecklenburg County",2,50,352,170,182
050,51,117,"Virginia","Mecklenburg County",2,51,347,174,173
050,51,117,"Virginia","Mecklenburg County",2,52,357,175,182
050,51,117,"Virginia","Mecklenburg County",2,53,376,184,192
050,51,117,"Virginia","Mecklenburg County",2,54,396,187,209
050,51,117,"Virginia","Mecklenburg County",2,55,443,220,223
050,51,117,"Virginia","Mecklenburg County",2,56,500,256,244
050,51,117,"Virginia","Mecklenburg County",2,57,513,255,258
050,51,117,"Virginia","Mecklenburg County",2,58,500,238,262
050,51,117,"Virginia","Mecklenburg County",2,59,490,234,256
050,51,117,"Virginia","Mecklenburg County",2,60,486,228,258
050,51,117,"Virginia","Mecklenburg County",2,61,509,244,265
050,51,117,"Virginia","Mecklenburg County",2,62,522,259,263
050,51,117,"Virginia","Mecklenburg County",2,63,513,256,257
050,51,117,"Virginia","Mecklenburg County",2,64,516,254,262
050,51,117,"Virginia","Mecklenburg County",2,65,512,239,273
050,51,117,"Virginia","Mecklenburg County",2,66,487,216,271
050,51,117,"Virginia","Mecklenburg County",2,67,506,229,277
050,51,117,"Virginia","Mecklenburg County",2,68,484,229,255
050,51,117,"Virginia","Mecklenburg County",2,69,459,233,226
050,51,117,"Virginia","Mecklenburg County",2,70,453,220,233
050,51,117,"Virginia","Mecklenburg County",2,71,475,224,251
050,51,117,"Virginia","Mecklenburg County",2,72,474,229,245
050,51,117,"Virginia","Mecklenburg County",2,73,482,237,245
050,51,117,"Virginia","Mecklenburg County",2,74,330,150,180
050,51,117,"Virginia","Mecklenburg County",2,75,305,135,170
050,51,117,"Virginia","Mecklenburg County",2,76,324,145,179
050,51,117,"Virginia","Mecklenburg County",2,77,330,148,182
050,51,117,"Virginia","Mecklenburg County",2,78,276,120,156
050,51,117,"Virginia","Mecklenburg County",2,79,253,113,140
050,51,117,"Virginia","Mecklenburg County",2,80,218,91,127
050,51,117,"Virginia","Mecklenburg County",2,81,211,91,120
050,51,117,"Virginia","Mecklenburg County",2,82,189,78,111
050,51,117,"Virginia","Mecklenburg County",2,83,180,81,99
050,51,117,"Virginia","Mecklenburg County",2,84,166,72,94
050,51,117,"Virginia","Mecklenburg County",2,85,838,283,555
050,51,117,"Virginia","Mecklenburg County",3,0,286,149,137
050,51,117,"Virginia","Mecklenburg County",3,1,298,144,154
050,51,117,"Virginia","Mecklenburg County",3,2,301,163,138
050,51,117,"Virginia","Mecklenburg County",3,3,307,172,135
050,51,117,"Virginia","Mecklenburg County",3,4,312,168,144
050,51,117,"Virginia","Mecklenburg County",3,5,310,164,146
050,51,117,"Virginia","Mecklenburg County",3,6,304,156,148
050,51,117,"Virginia","Mecklenburg County",3,7,292,143,149
050,51,117,"Virginia","Mecklenburg County",3,8,294,148,146
050,51,117,"Virginia","Mecklenburg County",3,9,318,165,153
050,51,117,"Virginia","Mecklenburg County",3,10,296,156,140
050,51,117,"Virginia","Mecklenburg County",3,11,315,169,146
050,51,117,"Virginia","Mecklenburg County",3,12,305,153,152
050,51,117,"Virginia","Mecklenburg County",3,13,324,163,161
050,51,117,"Virginia","Mecklenburg County",3,14,338,183,155
050,51,117,"Virginia","Mecklenburg County",3,15,334,177,157
050,51,117,"Virginia","Mecklenburg County",3,16,321,155,166
050,51,117,"Virginia","Mecklenburg County",3,17,347,172,175
050,51,117,"Virginia","Mecklenburg County",3,18,300,156,144
050,51,117,"Virginia","Mecklenburg County",3,19,251,134,117
050,51,117,"Virginia","Mecklenburg County",3,20,265,136,129
050,51,117,"Virginia","Mecklenburg County",3,21,295,152,143
050,51,117,"Virginia","Mecklenburg County",3,22,300,152,148
050,51,117,"Virginia","Mecklenburg County",3,23,336,184,152
050,51,117,"Virginia","Mecklenburg County",3,24,337,188,149
050,51,117,"Virginia","Mecklenburg County",3,25,311,156,155
050,51,117,"Virginia","Mecklenburg County",3,26,278,134,144
050,51,117,"Virginia","Mecklenburg County",3,27,304,157,147
050,51,117,"Virginia","Mecklenburg County",3,28,314,166,148
050,51,117,"Virginia","Mecklenburg County",3,29,315,160,155
050,51,117,"Virginia","Mecklenburg County",3,30,335,185,150
050,51,117,"Virginia","Mecklenburg County",3,31,311,151,160
050,51,117,"Virginia","Mecklenburg County",3,32,301,149,152
050,51,117,"Virginia","Mecklenburg County",3,33,300,147,153
050,51,117,"Virginia","Mecklenburg County",3,34,308,164,144
050,51,117,"Virginia","Mecklenburg County",3,35,303,157,146
050,51,117,"Virginia","Mecklenburg County",3,36,297,151,146
050,51,117,"Virginia","Mecklenburg County",3,37,290,148,142
050,51,117,"Virginia","Mecklenburg County",3,38,313,156,157
050,51,117,"Virginia","Mecklenburg County",3,39,300,159,141
050,51,117,"Virginia","Mecklenburg County",3,40,293,164,129
050,51,117,"Virginia","Mecklenburg County",3,41,300,155,145
050,51,117,"Virginia","Mecklenburg County",3,42,300,154,146
050,51,117,"Virginia","Mecklenburg County",3,43,331,167,164
050,51,117,"Virginia","Mecklenburg County",3,44,314,147,167
050,51,117,"Virginia","Mecklenburg County",3,45,284,135,149
050,51,117,"Virginia","Mecklenburg County",3,46,314,146,168
050,51,117,"Virginia","Mecklenburg County",3,47,322,147,175
050,51,117,"Virginia","Mecklenburg County",3,48,346,171,175
050,51,117,"Virginia","Mecklenburg County",3,49,361,165,196
050,51,117,"Virginia","Mecklenburg County",3,50,390,181,209
050,51,117,"Virginia","Mecklenburg County",3,51,356,171,185
050,51,117,"Virginia","Mecklenburg County",3,52,356,173,183
050,51,117,"Virginia","Mecklenburg County",3,53,362,186,176
050,51,117,"Virginia","Mecklenburg County",3,54,371,182,189
050,51,117,"Virginia","Mecklenburg County",3,55,402,190,212
050,51,117,"Virginia","Mecklenburg County",3,56,453,219,234
050,51,117,"Virginia","Mecklenburg County",3,57,502,256,246
050,51,117,"Virginia","Mecklenburg County",3,58,528,263,265
050,51,117,"Virginia","Mecklenburg County",3,59,521,251,270
050,51,117,"Virginia","Mecklenburg County",3,60,495,234,261
050,51,117,"Virginia","Mecklenburg County",3,61,488,226,262
050,51,117,"Virginia","Mecklenburg County",3,62,509,241,268
050,51,117,"Virginia","Mecklenburg County",3,63,537,260,277
050,51,117,"Virginia","Mecklenburg County",3,64,522,262,260
050,51,117,"Virginia","Mecklenburg County",3,65,515,250,265
050,51,117,"Virginia","Mecklenburg County",3,66,513,243,270
050,51,117,"Virginia","Mecklenburg County",3,67,483,211,272
050,51,117,"Virginia","Mecklenburg County",3,68,500,229,271
050,51,117,"Virginia","Mecklenburg County",3,69,478,218,260
050,51,117,"Virginia","Mecklenburg County",3,70,450,224,226
050,51,117,"Virginia","Mecklenburg County",3,71,451,221,230
050,51,117,"Virginia","Mecklenburg County",3,72,463,221,242
050,51,117,"Virginia","Mecklenburg County",3,73,467,221,246
050,51,117,"Virginia","Mecklenburg County",3,74,473,225,248
050,51,117,"Virginia","Mecklenburg County",3,75,313,145,168
050,51,117,"Virginia","Mecklenburg County",3,76,304,136,168
050,51,117,"Virginia","Mecklenburg County",3,77,302,132,170
050,51,117,"Virginia","Mecklenburg County",3,78,310,134,176
050,51,117,"Virginia","Mecklenburg County",3,79,264,118,146
050,51,117,"Virginia","Mecklenburg County",3,80,219,101,118
050,51,117,"Virginia","Mecklenburg County",3,81,211,80,131
050,51,117,"Virginia","Mecklenburg County",3,82,203,82,121
050,51,117,"Virginia","Mecklenburg County",3,83,180,77,103
050,51,117,"Virginia","Mecklenburg County",3,84,152,66,86
050,51,117,"Virginia","Mecklenburg County",3,85,859,306,553
050,51,117,"Virginia","Mecklenburg County",4,0,302,152,150
050,51,117,"Virginia","Mecklenburg County",4,1,291,152,139
050,51,117,"Virginia","Mecklenburg County",4,2,318,154,164
050,51,117,"Virginia","Mecklenburg County",4,3,305,169,136
050,51,117,"Virginia","Mecklenburg County",4,4,321,179,142
050,51,117,"Virginia","Mecklenburg County",4,5,306,158,148
050,51,117,"Virginia","Mecklenburg County",4,6,320,167,153
050,51,117,"Virginia","Mecklenburg County",4,7,318,168,150
050,51,117,"Virginia","Mecklenburg County",4,8,294,149,145
050,51,117,"Virginia","Mecklenburg County",4,9,291,144,147
050,51,117,"Virginia","Mecklenburg County",4,10,319,156,163
050,51,117,"Virginia","Mecklenburg County",4,11,290,146,144
050,51,117,"Virginia","Mecklenburg County",4,12,319,162,157
050,51,117,"Virginia","Mecklenburg County",4,13,313,150,163
050,51,117,"Virginia","Mecklenburg County",4,14,327,165,162
050,51,117,"Virginia","Mecklenburg County",4,15,338,180,158
050,51,117,"Virginia","Mecklenburg County",4,16,335,175,160
050,51,117,"Virginia","Mecklenburg County",4,17,330,163,167
050,51,117,"Virginia","Mecklenburg County",4,18,301,154,147
050,51,117,"Virginia","Mecklenburg County",4,19,257,136,121
050,51,117,"Virginia","Mecklenburg County",4,20,273,144,129
050,51,117,"Virginia","Mecklenburg County",4,21,269,138,131
050,51,117,"Virginia","Mecklenburg County",4,22,305,153,152
050,51,117,"Virginia","Mecklenburg County",4,23,327,185,142
050,51,117,"Virginia","Mecklenburg County",4,24,366,214,152
050,51,117,"Virginia","Mecklenburg County",4,25,339,193,146
050,51,117,"Virginia","Mecklenburg County",4,26,309,146,163
050,51,117,"Virginia","Mecklenburg County",4,27,288,145,143
050,51,117,"Virginia","Mecklenburg County",4,28,303,151,152
050,51,117,"Virginia","Mecklenburg County",4,29,333,176,157
050,51,117,"Virginia","Mecklenburg County",4,30,318,166,152
050,51,117,"Virginia","Mecklenburg County",4,31,334,182,152
050,51,117,"Virginia","Mecklenburg County",4,32,324,152,172
050,51,117,"Virginia","Mecklenburg County",4,33,310,151,159
050,51,117,"Virginia","Mecklenburg County",4,34,299,147,152
050,51,117,"Virginia","Mecklenburg County",4,35,301,164,137
050,51,117,"Virginia","Mecklenburg County",4,36,293,161,132
050,51,117,"Virginia","Mecklenburg County",4,37,301,149,152
050,51,117,"Virginia","Mecklenburg County",4,38,299,149,150
050,51,117,"Virginia","Mecklenburg County",4,39,314,159,155
050,51,117,"Virginia","Mecklenburg County",4,40,312,164,148
050,51,117,"Virginia","Mecklenburg County",4,41,292,162,130
050,51,117,"Virginia","Mecklenburg County",4,42,302,159,143
050,51,117,"Virginia","Mecklenburg County",4,43,321,173,148
050,51,117,"Virginia","Mecklenburg County",4,44,325,157,168
050,51,117,"Virginia","Mecklenburg County",4,45,308,145,163
050,51,117,"Virginia","Mecklenburg County",4,46,287,138,149
050,51,117,"Virginia","Mecklenburg County",4,47,326,153,173
050,51,117,"Virginia","Mecklenburg County",4,48,328,153,175
050,51,117,"Virginia","Mecklenburg County",4,49,344,170,174
050,51,117,"Virginia","Mecklenburg County",4,50,367,170,197
050,51,117,"Virginia","Mecklenburg County",4,51,390,180,210
050,51,117,"Virginia","Mecklenburg County",4,52,368,177,191
050,51,117,"Virginia","Mecklenburg County",4,53,358,176,182
050,51,117,"Virginia","Mecklenburg County",4,54,362,177,185
050,51,117,"Virginia","Mecklenburg County",4,55,383,188,195
050,51,117,"Virginia","Mecklenburg County",4,56,403,183,220
050,51,117,"Virginia","Mecklenburg County",4,57,467,224,243
050,51,117,"Virginia","Mecklenburg County",4,58,520,264,256
050,51,117,"Virginia","Mecklenburg County",4,59,527,261,266
050,51,117,"Virginia","Mecklenburg County",4,60,509,237,272
050,51,117,"Virginia","Mecklenburg County",4,61,509,247,262
050,51,117,"Virginia","Mecklenburg County",4,62,497,236,261
050,51,117,"Virginia","Mecklenburg County",4,63,505,235,270
050,51,117,"Virginia","Mecklenburg County",4,64,547,263,284
050,51,117,"Virginia","Mecklenburg County",4,65,516,266,250
050,51,117,"Virginia","Mecklenburg County",4,66,519,251,268
050,51,117,"Virginia","Mecklenburg County",4,67,517,240,277
050,51,117,"Virginia","Mecklenburg County",4,68,482,215,267
050,51,117,"Virginia","Mecklenburg County",4,69,486,216,270
050,51,117,"Virginia","Mecklenburg County",4,70,474,215,259
050,51,117,"Virginia","Mecklenburg County",4,71,461,230,231
050,51,117,"Virginia","Mecklenburg County",4,72,440,223,217
050,51,117,"Virginia","Mecklenburg County",4,73,458,221,237
050,51,117,"Virginia","Mecklenburg County",4,74,456,207,249
050,51,117,"Virginia","Mecklenburg County",4,75,448,222,226
050,51,117,"Virginia","Mecklenburg County",4,76,307,142,165
050,51,117,"Virginia","Mecklenburg County",4,77,285,125,160
050,51,117,"Virginia","Mecklenburg County",4,78,281,121,160
050,51,117,"Virginia","Mecklenburg County",4,79,296,124,172
050,51,117,"Virginia","Mecklenburg County",4,80,252,114,138
050,51,117,"Virginia","Mecklenburg County",4,81,199,87,112
050,51,117,"Virginia","Mecklenburg County",4,82,196,66,130
050,51,117,"Virginia","Mecklenburg County",4,83,190,79,111
050,51,117,"Virginia","Mecklenburg County",4,84,152,66,86
050,51,117,"Virginia","Mecklenburg County",4,85,855,311,544
050,51,117,"Virginia","Mecklenburg County",5,0,302,154,148
050,51,117,"Virginia","Mecklenburg County",5,1,305,143,162
050,51,117,"Virginia","Mecklenburg County",5,2,302,159,143
050,51,117,"Virginia","Mecklenburg County",5,3,312,145,167
050,51,117,"Virginia","Mecklenburg County",5,4,319,167,152
050,51,117,"Virginia","Mecklenburg County",5,5,311,176,135
050,51,117,"Virginia","Mecklenburg County",5,6,312,157,155
050,51,117,"Virginia","Mecklenburg County",5,7,317,169,148
050,51,117,"Virginia","Mecklenburg County",5,8,333,177,156
050,51,117,"Virginia","Mecklenburg County",5,9,303,156,147
050,51,117,"Virginia","Mecklenburg County",5,10,298,144,154
050,51,117,"Virginia","Mecklenburg County",5,11,310,159,151
050,51,117,"Virginia","Mecklenburg County",5,12,287,144,143
050,51,117,"Virginia","Mecklenburg County",5,13,326,165,161
050,51,117,"Virginia","Mecklenburg County",5,14,328,151,177
050,51,117,"Virginia","Mecklenburg County",5,15,332,166,166
050,51,117,"Virginia","Mecklenburg County",5,16,336,181,155
050,51,117,"Virginia","Mecklenburg County",5,17,328,174,154
050,51,117,"Virginia","Mecklenburg County",5,18,279,141,138
050,51,117,"Virginia","Mecklenburg County",5,19,273,143,130
050,51,117,"Virginia","Mecklenburg County",5,20,273,145,128
050,51,117,"Virginia","Mecklenburg County",5,21,286,149,137
050,51,117,"Virginia","Mecklenburg County",5,22,277,146,131
050,51,117,"Virginia","Mecklenburg County",5,23,316,177,139
050,51,117,"Virginia","Mecklenburg County",5,24,356,213,143
050,51,117,"Virginia","Mecklenburg County",5,25,393,236,157
050,51,117,"Virginia","Mecklenburg County",5,26,341,199,142
050,51,117,"Virginia","Mecklenburg County",5,27,312,153,159
050,51,117,"Virginia","Mecklenburg County",5,28,289,135,154
050,51,117,"Virginia","Mecklenburg County",5,29,296,153,143
050,51,117,"Virginia","Mecklenburg County",5,30,331,169,162
050,51,117,"Virginia","Mecklenburg County",5,31,303,152,151
050,51,117,"Virginia","Mecklenburg County",5,32,337,180,157
050,51,117,"Virginia","Mecklenburg County",5,33,332,156,176
050,51,117,"Virginia","Mecklenburg County",5,34,326,167,159
050,51,117,"Virginia","Mecklenburg County",5,35,308,157,151
050,51,117,"Virginia","Mecklenburg County",5,36,318,175,143
050,51,117,"Virginia","Mecklenburg County",5,37,297,156,141
050,51,117,"Virginia","Mecklenburg County",5,38,309,154,155
050,51,117,"Virginia","Mecklenburg County",5,39,302,147,155
050,51,117,"Virginia","Mecklenburg County",5,40,316,160,156
050,51,117,"Virginia","Mecklenburg County",5,41,330,176,154
050,51,117,"Virginia","Mecklenburg County",5,42,294,160,134
050,51,117,"Virginia","Mecklenburg County",5,43,321,176,145
050,51,117,"Virginia","Mecklenburg County",5,44,318,163,155
050,51,117,"Virginia","Mecklenburg County",5,45,313,155,158
050,51,117,"Virginia","Mecklenburg County",5,46,308,143,165
050,51,117,"Virginia","Mecklenburg County",5,47,288,135,153
050,51,117,"Virginia","Mecklenburg County",5,48,327,151,176
050,51,117,"Virginia","Mecklenburg County",5,49,316,147,169
050,51,117,"Virginia","Mecklenburg County",5,50,352,173,179
050,51,117,"Virginia","Mecklenburg County",5,51,357,169,188
050,51,117,"Virginia","Mecklenburg County",5,52,402,183,219
050,51,117,"Virginia","Mecklenburg County",5,53,376,183,193
050,51,117,"Virginia","Mecklenburg County",5,54,347,174,173
050,51,117,"Virginia","Mecklenburg County",5,55,361,174,187
050,51,117,"Virginia","Mecklenburg County",5,56,377,184,193
050,51,117,"Virginia","Mecklenburg County",5,57,412,192,220
050,51,117,"Virginia","Mecklenburg County",5,58,476,229,247
050,51,117,"Virginia","Mecklenburg County",5,59,510,260,250
050,51,117,"Virginia","Mecklenburg County",5,60,527,261,266
050,51,117,"Virginia","Mecklenburg County",5,61,530,249,281
050,51,117,"Virginia","Mecklenburg County",5,62,524,254,270
050,51,117,"Virginia","Mecklenburg County",5,63,513,238,275
050,51,117,"Virginia","Mecklenburg County",5,64,493,230,263
050,51,117,"Virginia","Mecklenburg County",5,65,544,265,279
050,51,117,"Virginia","Mecklenburg County",5,66,530,269,261
050,51,117,"Virginia","Mecklenburg County",5,67,517,251,266
050,51,117,"Virginia","Mecklenburg County",5,68,526,251,275
050,51,117,"Virginia","Mecklenburg County",5,69,473,203,270
050,51,117,"Virginia","Mecklenburg County",5,70,467,209,258
050,51,117,"Virginia","Mecklenburg County",5,71,471,209,262
050,51,117,"Virginia","Mecklenburg County",5,72,441,225,216
050,51,117,"Virginia","Mecklenburg County",5,73,432,219,213
050,51,117,"Virginia","Mecklenburg County",5,74,446,211,235
050,51,117,"Virginia","Mecklenburg County",5,75,440,205,235
050,51,117,"Virginia","Mecklenburg County",5,76,438,218,220
050,51,117,"Virginia","Mecklenburg County",5,77,282,128,154
050,51,117,"Virginia","Mecklenburg County",5,78,264,115,149
050,51,117,"Virginia","Mecklenburg County",5,79,269,113,156
050,51,117,"Virginia","Mecklenburg County",5,80,275,117,158
050,51,117,"Virginia","Mecklenburg County",5,81,232,102,130
050,51,117,"Virginia","Mecklenburg County",5,82,192,77,115
050,51,117,"Virginia","Mecklenburg County",5,83,180,63,117
050,51,117,"Virginia","Mecklenburg County",5,84,162,68,94
050,51,117,"Virginia","Mecklenburg County",5,85,864,325,539
050,51,119,"Virginia","Middlesex County",1,0,74,38,36
050,51,119,"Virginia","Middlesex County",1,1,76,48,28
050,51,119,"Virginia","Middlesex County",1,2,91,60,31
050,51,119,"Virginia","Middlesex County",1,3,106,61,45
050,51,119,"Virginia","Middlesex County",1,4,91,44,47
050,51,119,"Virginia","Middlesex County",1,5,96,46,50
050,51,119,"Virginia","Middlesex County",1,6,84,48,36
050,51,119,"Virginia","Middlesex County",1,7,79,47,32
050,51,119,"Virginia","Middlesex County",1,8,87,46,41
050,51,119,"Virginia","Middlesex County",1,9,84,43,41
050,51,119,"Virginia","Middlesex County",1,10,81,45,36
050,51,119,"Virginia","Middlesex County",1,11,111,57,54
050,51,119,"Virginia","Middlesex County",1,12,117,61,56
050,51,119,"Virginia","Middlesex County",1,13,98,51,47
050,51,119,"Virginia","Middlesex County",1,14,95,52,43
050,51,119,"Virginia","Middlesex County",1,15,99,45,54
050,51,119,"Virginia","Middlesex County",1,16,101,52,49
050,51,119,"Virginia","Middlesex County",1,17,105,50,55
050,51,119,"Virginia","Middlesex County",1,18,97,57,40
050,51,119,"Virginia","Middlesex County",1,19,73,41,32
050,51,119,"Virginia","Middlesex County",1,20,76,35,41
050,51,119,"Virginia","Middlesex County",1,21,74,43,31
050,51,119,"Virginia","Middlesex County",1,22,79,47,32
050,51,119,"Virginia","Middlesex County",1,23,92,47,45
050,51,119,"Virginia","Middlesex County",1,24,83,43,40
050,51,119,"Virginia","Middlesex County",1,25,96,54,42
050,51,119,"Virginia","Middlesex County",1,26,99,54,45
050,51,119,"Virginia","Middlesex County",1,27,105,52,53
050,51,119,"Virginia","Middlesex County",1,28,97,55,42
050,51,119,"Virginia","Middlesex County",1,29,91,43,48
050,51,119,"Virginia","Middlesex County",1,30,76,37,39
050,51,119,"Virginia","Middlesex County",1,31,96,48,48
050,51,119,"Virginia","Middlesex County",1,32,97,54,43
050,51,119,"Virginia","Middlesex County",1,33,96,47,49
050,51,119,"Virginia","Middlesex County",1,34,96,49,47
050,51,119,"Virginia","Middlesex County",1,35,87,49,38
050,51,119,"Virginia","Middlesex County",1,36,88,49,39
050,51,119,"Virginia","Middlesex County",1,37,105,52,53
050,51,119,"Virginia","Middlesex County",1,38,99,41,58
050,51,119,"Virginia","Middlesex County",1,39,101,56,45
050,51,119,"Virginia","Middlesex County",1,40,85,46,39
050,51,119,"Virginia","Middlesex County",1,41,74,37,37
050,51,119,"Virginia","Middlesex County",1,42,79,38,41
050,51,119,"Virginia","Middlesex County",1,43,80,36,44
050,51,119,"Virginia","Middlesex County",1,44,91,45,46
050,51,119,"Virginia","Middlesex County",1,45,71,33,38
050,51,119,"Virginia","Middlesex County",1,46,92,51,41
050,51,119,"Virginia","Middlesex County",1,47,101,51,50
050,51,119,"Virginia","Middlesex County",1,48,111,54,57
050,51,119,"Virginia","Middlesex County",1,49,117,62,55
050,51,119,"Virginia","Middlesex County",1,50,116,58,58
050,51,119,"Virginia","Middlesex County",1,51,132,59,73
050,51,119,"Virginia","Middlesex County",1,52,124,59,65
050,51,119,"Virginia","Middlesex County",1,53,129,61,68
050,51,119,"Virginia","Middlesex County",1,54,148,74,74
050,51,119,"Virginia","Middlesex County",1,55,165,76,89
050,51,119,"Virginia","Middlesex County",1,56,176,86,90
050,51,119,"Virginia","Middlesex County",1,57,179,92,87
050,51,119,"Virginia","Middlesex County",1,58,200,98,102
050,51,119,"Virginia","Middlesex County",1,59,213,98,115
050,51,119,"Virginia","Middlesex County",1,60,197,100,97
050,51,119,"Virginia","Middlesex County",1,61,208,103,105
050,51,119,"Virginia","Middlesex County",1,62,211,99,112
050,51,119,"Virginia","Middlesex County",1,63,202,95,107
050,51,119,"Virginia","Middlesex County",1,64,193,84,109
050,51,119,"Virginia","Middlesex County",1,65,196,95,101
050,51,119,"Virginia","Middlesex County",1,66,193,90,103
050,51,119,"Virginia","Middlesex County",1,67,198,88,110
050,51,119,"Virginia","Middlesex County",1,68,178,87,91
050,51,119,"Virginia","Middlesex County",1,69,193,92,101
050,51,119,"Virginia","Middlesex County",1,70,171,81,90
050,51,119,"Virginia","Middlesex County",1,71,174,78,96
050,51,119,"Virginia","Middlesex County",1,72,214,102,112
050,51,119,"Virginia","Middlesex County",1,73,221,108,113
050,51,119,"Virginia","Middlesex County",1,74,168,78,90
050,51,119,"Virginia","Middlesex County",1,75,165,83,82
050,51,119,"Virginia","Middlesex County",1,76,166,80,86
050,51,119,"Virginia","Middlesex County",1,77,167,77,90
050,51,119,"Virginia","Middlesex County",1,78,122,65,57
050,51,119,"Virginia","Middlesex County",1,79,119,63,56
050,51,119,"Virginia","Middlesex County",1,80,129,67,62
050,51,119,"Virginia","Middlesex County",1,81,91,41,50
050,51,119,"Virginia","Middlesex County",1,82,77,33,44
050,51,119,"Virginia","Middlesex County",1,83,73,35,38
050,51,119,"Virginia","Middlesex County",1,84,57,23,34
050,51,119,"Virginia","Middlesex County",1,85,381,152,229
050,51,119,"Virginia","Middlesex County",2,0,67,36,31
050,51,119,"Virginia","Middlesex County",2,1,77,47,30
050,51,119,"Virginia","Middlesex County",2,2,88,59,29
050,51,119,"Virginia","Middlesex County",2,3,102,61,41
050,51,119,"Virginia","Middlesex County",2,4,96,49,47
050,51,119,"Virginia","Middlesex County",2,5,96,46,50
050,51,119,"Virginia","Middlesex County",2,6,86,47,39
050,51,119,"Virginia","Middlesex County",2,7,82,48,34
050,51,119,"Virginia","Middlesex County",2,8,83,46,37
050,51,119,"Virginia","Middlesex County",2,9,84,43,41
050,51,119,"Virginia","Middlesex County",2,10,82,44,38
050,51,119,"Virginia","Middlesex County",2,11,104,54,50
050,51,119,"Virginia","Middlesex County",2,12,118,61,57
050,51,119,"Virginia","Middlesex County",2,13,103,54,49
050,51,119,"Virginia","Middlesex County",2,14,95,51,44
050,51,119,"Virginia","Middlesex County",2,15,97,46,51
050,51,119,"Virginia","Middlesex County",2,16,99,49,50
050,51,119,"Virginia","Middlesex County",2,17,104,50,54
050,51,119,"Virginia","Middlesex County",2,18,96,54,42
050,51,119,"Virginia","Middlesex County",2,19,74,41,33
050,51,119,"Virginia","Middlesex County",2,20,77,37,40
050,51,119,"Virginia","Middlesex County",2,21,76,44,32
050,51,119,"Virginia","Middlesex County",2,22,78,44,34
050,51,119,"Virginia","Middlesex County",2,23,89,46,43
050,51,119,"Virginia","Middlesex County",2,24,85,43,42
050,51,119,"Virginia","Middlesex County",2,25,96,55,41
050,51,119,"Virginia","Middlesex County",2,26,98,53,45
050,51,119,"Virginia","Middlesex County",2,27,105,53,52
050,51,119,"Virginia","Middlesex County",2,28,98,53,45
050,51,119,"Virginia","Middlesex County",2,29,91,45,46
050,51,119,"Virginia","Middlesex County",2,30,82,39,43
050,51,119,"Virginia","Middlesex County",2,31,92,47,45
050,51,119,"Virginia","Middlesex County",2,32,99,54,45
050,51,119,"Virginia","Middlesex County",2,33,95,48,47
050,51,119,"Virginia","Middlesex County",2,34,100,50,50
050,51,119,"Virginia","Middlesex County",2,35,90,50,40
050,51,119,"Virginia","Middlesex County",2,36,89,50,39
050,51,119,"Virginia","Middlesex County",2,37,100,49,51
050,51,119,"Virginia","Middlesex County",2,38,100,44,56
050,51,119,"Virginia","Middlesex County",2,39,101,54,47
050,51,119,"Virginia","Middlesex County",2,40,88,48,40
050,51,119,"Virginia","Middlesex County",2,41,76,39,37
050,51,119,"Virginia","Middlesex County",2,42,78,38,40
050,51,119,"Virginia","Middlesex County",2,43,82,37,45
050,51,119,"Virginia","Middlesex County",2,44,89,43,46
050,51,119,"Virginia","Middlesex County",2,45,74,35,39
050,51,119,"Virginia","Middlesex County",2,46,88,48,40
050,51,119,"Virginia","Middlesex County",2,47,97,50,47
050,51,119,"Virginia","Middlesex County",2,48,110,54,56
050,51,119,"Virginia","Middlesex County",2,49,116,61,55
050,51,119,"Virginia","Middlesex County",2,50,117,57,60
050,51,119,"Virginia","Middlesex County",2,51,129,59,70
050,51,119,"Virginia","Middlesex County",2,52,124,58,66
050,51,119,"Virginia","Middlesex County",2,53,127,60,67
050,51,119,"Virginia","Middlesex County",2,54,145,72,73
050,51,119,"Virginia","Middlesex County",2,55,161,76,85
050,51,119,"Virginia","Middlesex County",2,56,176,85,91
050,51,119,"Virginia","Middlesex County",2,57,177,91,86
050,51,119,"Virginia","Middlesex County",2,58,194,95,99
050,51,119,"Virginia","Middlesex County",2,59,213,100,113
050,51,119,"Virginia","Middlesex County",2,60,201,99,102
050,51,119,"Virginia","Middlesex County",2,61,206,103,103
050,51,119,"Virginia","Middlesex County",2,62,212,102,110
050,51,119,"Virginia","Middlesex County",2,63,208,98,110
050,51,119,"Virginia","Middlesex County",2,64,192,84,108
050,51,119,"Virginia","Middlesex County",2,65,194,92,102
050,51,119,"Virginia","Middlesex County",2,66,192,91,101
050,51,119,"Virginia","Middlesex County",2,67,198,89,109
050,51,119,"Virginia","Middlesex County",2,68,182,88,94
050,51,119,"Virginia","Middlesex County",2,69,191,92,99
050,51,119,"Virginia","Middlesex County",2,70,176,83,93
050,51,119,"Virginia","Middlesex County",2,71,174,78,96
050,51,119,"Virginia","Middlesex County",2,72,200,95,105
050,51,119,"Virginia","Middlesex County",2,73,226,109,117
050,51,119,"Virginia","Middlesex County",2,74,167,79,88
050,51,119,"Virginia","Middlesex County",2,75,166,82,84
050,51,119,"Virginia","Middlesex County",2,76,162,78,84
050,51,119,"Virginia","Middlesex County",2,77,169,79,90
050,51,119,"Virginia","Middlesex County",2,78,130,67,63
050,51,119,"Virginia","Middlesex County",2,79,120,64,56
050,51,119,"Virginia","Middlesex County",2,80,127,66,61
050,51,119,"Virginia","Middlesex County",2,81,98,46,52
050,51,119,"Virginia","Middlesex County",2,82,73,34,39
050,51,119,"Virginia","Middlesex County",2,83,74,34,40
050,51,119,"Virginia","Middlesex County",2,84,59,26,33
050,51,119,"Virginia","Middlesex County",2,85,382,153,229
050,51,119,"Virginia","Middlesex County",3,0,89,37,52
050,51,119,"Virginia","Middlesex County",3,1,88,56,32
050,51,119,"Virginia","Middlesex County",3,2,87,52,35
050,51,119,"Virginia","Middlesex County",3,3,96,62,34
050,51,119,"Virginia","Middlesex County",3,4,102,58,44
050,51,119,"Virginia","Middlesex County",3,5,98,51,47
050,51,119,"Virginia","Middlesex County",3,6,98,49,49
050,51,119,"Virginia","Middlesex County",3,7,86,45,41
050,51,119,"Virginia","Middlesex County",3,8,77,43,34
050,51,119,"Virginia","Middlesex County",3,9,86,51,35
050,51,119,"Virginia","Middlesex County",3,10,89,48,41
050,51,119,"Virginia","Middlesex County",3,11,87,47,40
050,51,119,"Virginia","Middlesex County",3,12,96,49,47
050,51,119,"Virginia","Middlesex County",3,13,112,57,55
050,51,119,"Virginia","Middlesex County",3,14,109,57,52
050,51,119,"Virginia","Middlesex County",3,15,96,51,45
050,51,119,"Virginia","Middlesex County",3,16,93,43,50
050,51,119,"Virginia","Middlesex County",3,17,96,44,52
050,51,119,"Virginia","Middlesex County",3,18,94,50,44
050,51,119,"Virginia","Middlesex County",3,19,71,40,31
050,51,119,"Virginia","Middlesex County",3,20,74,39,35
050,51,119,"Virginia","Middlesex County",3,21,90,45,45
050,51,119,"Virginia","Middlesex County",3,22,86,50,36
050,51,119,"Virginia","Middlesex County",3,23,79,46,33
050,51,119,"Virginia","Middlesex County",3,24,94,48,46
050,51,119,"Virginia","Middlesex County",3,25,86,44,42
050,51,119,"Virginia","Middlesex County",3,26,95,50,45
050,51,119,"Virginia","Middlesex County",3,27,103,57,46
050,51,119,"Virginia","Middlesex County",3,28,117,60,57
050,51,119,"Virginia","Middlesex County",3,29,97,48,49
050,51,119,"Virginia","Middlesex County",3,30,92,46,46
050,51,119,"Virginia","Middlesex County",3,31,95,46,49
050,51,119,"Virginia","Middlesex County",3,32,113,57,56
050,51,119,"Virginia","Middlesex County",3,33,86,46,40
050,51,119,"Virginia","Middlesex County",3,34,97,51,46
050,51,119,"Virginia","Middlesex County",3,35,105,54,51
050,51,119,"Virginia","Middlesex County",3,36,100,55,45
050,51,119,"Virginia","Middlesex County",3,37,87,40,47
050,51,119,"Virginia","Middlesex County",3,38,107,55,52
050,51,119,"Virginia","Middlesex County",3,39,94,47,47
050,51,119,"Virginia","Middlesex County",3,40,98,51,47
050,51,119,"Virginia","Middlesex County",3,41,85,48,37
050,51,119,"Virginia","Middlesex County",3,42,81,44,37
050,51,119,"Virginia","Middlesex County",3,43,83,38,45
050,51,119,"Virginia","Middlesex County",3,44,83,34,49
050,51,119,"Virginia","Middlesex County",3,45,86,41,45
050,51,119,"Virginia","Middlesex County",3,46,92,47,45
050,51,119,"Virginia","Middlesex County",3,47,83,44,39
050,51,119,"Virginia","Middlesex County",3,48,100,51,49
050,51,119,"Virginia","Middlesex County",3,49,110,55,55
050,51,119,"Virginia","Middlesex County",3,50,114,56,58
050,51,119,"Virginia","Middlesex County",3,51,125,61,64
050,51,119,"Virginia","Middlesex County",3,52,127,60,67
050,51,119,"Virginia","Middlesex County",3,53,122,59,63
050,51,119,"Virginia","Middlesex County",3,54,135,60,75
050,51,119,"Virginia","Middlesex County",3,55,152,71,81
050,51,119,"Virginia","Middlesex County",3,56,173,78,95
050,51,119,"Virginia","Middlesex County",3,57,168,86,82
050,51,119,"Virginia","Middlesex County",3,58,187,99,88
050,51,119,"Virginia","Middlesex County",3,59,197,96,101
050,51,119,"Virginia","Middlesex County",3,60,212,101,111
050,51,119,"Virginia","Middlesex County",3,61,212,101,111
050,51,119,"Virginia","Middlesex County",3,62,219,113,106
050,51,119,"Virginia","Middlesex County",3,63,225,103,122
050,51,119,"Virginia","Middlesex County",3,64,206,98,108
050,51,119,"Virginia","Middlesex County",3,65,196,90,106
050,51,119,"Virginia","Middlesex County",3,66,197,93,104
050,51,119,"Virginia","Middlesex County",3,67,195,88,107
050,51,119,"Virginia","Middlesex County",3,68,198,88,110
050,51,119,"Virginia","Middlesex County",3,69,191,89,102
050,51,119,"Virginia","Middlesex County",3,70,193,94,99
050,51,119,"Virginia","Middlesex County",3,71,179,82,97
050,51,119,"Virginia","Middlesex County",3,72,169,76,93
050,51,119,"Virginia","Middlesex County",3,73,195,92,103
050,51,119,"Virginia","Middlesex County",3,74,228,110,118
050,51,119,"Virginia","Middlesex County",3,75,164,77,87
050,51,119,"Virginia","Middlesex County",3,76,162,79,83
050,51,119,"Virginia","Middlesex County",3,77,160,79,81
050,51,119,"Virginia","Middlesex County",3,78,162,81,81
050,51,119,"Virginia","Middlesex County",3,79,129,63,66
050,51,119,"Virginia","Middlesex County",3,80,116,63,53
050,51,119,"Virginia","Middlesex County",3,81,113,55,58
050,51,119,"Virginia","Middlesex County",3,82,92,45,47
050,51,119,"Virginia","Middlesex County",3,83,76,33,43
050,51,119,"Virginia","Middlesex County",3,84,63,29,34
050,51,119,"Virginia","Middlesex County",3,85,379,161,218
050,51,119,"Virginia","Middlesex County",4,0,89,44,45
050,51,119,"Virginia","Middlesex County",4,1,88,41,47
050,51,119,"Virginia","Middlesex County",4,2,95,55,40
050,51,119,"Virginia","Middlesex County",4,3,91,56,35
050,51,119,"Virginia","Middlesex County",4,4,102,64,38
050,51,119,"Virginia","Middlesex County",4,5,106,62,44
050,51,119,"Virginia","Middlesex County",4,6,98,49,49
050,51,119,"Virginia","Middlesex County",4,7,113,51,62
050,51,119,"Virginia","Middlesex County",4,8,86,44,42
050,51,119,"Virginia","Middlesex County",4,9,90,50,40
050,51,119,"Virginia","Middlesex County",4,10,96,54,42
050,51,119,"Virginia","Middlesex County",4,11,95,51,44
050,51,119,"Virginia","Middlesex County",4,12,91,45,46
050,51,119,"Virginia","Middlesex County",4,13,101,49,52
050,51,119,"Virginia","Middlesex County",4,14,109,54,55
050,51,119,"Virginia","Middlesex County",4,15,114,61,53
050,51,119,"Virginia","Middlesex County",4,16,103,59,44
050,51,119,"Virginia","Middlesex County",4,17,92,41,51
050,51,119,"Virginia","Middlesex County",4,18,88,45,43
050,51,119,"Virginia","Middlesex County",4,19,71,37,34
050,51,119,"Virginia","Middlesex County",4,20,71,41,30
050,51,119,"Virginia","Middlesex County",4,21,85,47,38
050,51,119,"Virginia","Middlesex County",4,22,85,40,45
050,51,119,"Virginia","Middlesex County",4,23,81,44,37
050,51,119,"Virginia","Middlesex County",4,24,79,47,32
050,51,119,"Virginia","Middlesex County",4,25,108,58,50
050,51,119,"Virginia","Middlesex County",4,26,90,44,46
050,51,119,"Virginia","Middlesex County",4,27,94,49,45
050,51,119,"Virginia","Middlesex County",4,28,104,62,42
050,51,119,"Virginia","Middlesex County",4,29,102,50,52
050,51,119,"Virginia","Middlesex County",4,30,102,51,51
050,51,119,"Virginia","Middlesex County",4,31,97,47,50
050,51,119,"Virginia","Middlesex County",4,32,115,52,63
050,51,119,"Virginia","Middlesex County",4,33,110,54,56
050,51,119,"Virginia","Middlesex County",4,34,103,57,46
050,51,119,"Virginia","Middlesex County",4,35,108,56,52
050,51,119,"Virginia","Middlesex County",4,36,118,58,60
050,51,119,"Virginia","Middlesex County",4,37,105,56,49
050,51,119,"Virginia","Middlesex County",4,38,94,45,49
050,51,119,"Virginia","Middlesex County",4,39,114,62,52
050,51,119,"Virginia","Middlesex County",4,40,91,42,49
050,51,119,"Virginia","Middlesex County",4,41,104,58,46
050,51,119,"Virginia","Middlesex County",4,42,86,48,38
050,51,119,"Virginia","Middlesex County",4,43,89,47,42
050,51,119,"Virginia","Middlesex County",4,44,92,47,45
050,51,119,"Virginia","Middlesex County",4,45,84,32,52
050,51,119,"Virginia","Middlesex County",4,46,95,45,50
050,51,119,"Virginia","Middlesex County",4,47,90,37,53
050,51,119,"Virginia","Middlesex County",4,48,85,46,39
050,51,119,"Virginia","Middlesex County",4,49,101,53,48
050,51,119,"Virginia","Middlesex County",4,50,104,54,50
050,51,119,"Virginia","Middlesex County",4,51,124,62,62
050,51,119,"Virginia","Middlesex County",4,52,117,55,62
050,51,119,"Virginia","Middlesex County",4,53,127,60,67
050,51,119,"Virginia","Middlesex County",4,54,128,63,65
050,51,119,"Virginia","Middlesex County",4,55,139,64,75
050,51,119,"Virginia","Middlesex County",4,56,161,71,90
050,51,119,"Virginia","Middlesex County",4,57,173,77,96
050,51,119,"Virginia","Middlesex County",4,58,166,82,84
050,51,119,"Virginia","Middlesex County",4,59,199,101,98
050,51,119,"Virginia","Middlesex County",4,60,203,97,106
050,51,119,"Virginia","Middlesex County",4,61,222,104,118
050,51,119,"Virginia","Middlesex County",4,62,220,105,115
050,51,119,"Virginia","Middlesex County",4,63,217,113,104
050,51,119,"Virginia","Middlesex County",4,64,232,110,122
050,51,119,"Virginia","Middlesex County",4,65,208,102,106
050,51,119,"Virginia","Middlesex County",4,66,196,93,103
050,51,119,"Virginia","Middlesex County",4,67,203,94,109
050,51,119,"Virginia","Middlesex County",4,68,193,85,108
050,51,119,"Virginia","Middlesex County",4,69,203,86,117
050,51,119,"Virginia","Middlesex County",4,70,185,84,101
050,51,119,"Virginia","Middlesex County",4,71,194,96,98
050,51,119,"Virginia","Middlesex County",4,72,170,78,92
050,51,119,"Virginia","Middlesex County",4,73,158,70,88
050,51,119,"Virginia","Middlesex County",4,74,195,97,98
050,51,119,"Virginia","Middlesex County",4,75,219,106,113
050,51,119,"Virginia","Middlesex County",4,76,156,74,82
050,51,119,"Virginia","Middlesex County",4,77,165,83,82
050,51,119,"Virginia","Middlesex County",4,78,154,74,80
050,51,119,"Virginia","Middlesex County",4,79,155,77,78
050,51,119,"Virginia","Middlesex County",4,80,116,58,58
050,51,119,"Virginia","Middlesex County",4,81,108,54,54
050,51,119,"Virginia","Middlesex County",4,82,102,51,51
050,51,119,"Virginia","Middlesex County",4,83,93,43,50
050,51,119,"Virginia","Middlesex County",4,84,71,33,38
050,51,119,"Virginia","Middlesex County",4,85,376,163,213
050,51,119,"Virginia","Middlesex County",5,0,89,44,45
050,51,119,"Virginia","Middlesex County",5,1,82,42,40
050,51,119,"Virginia","Middlesex County",5,2,83,35,48
050,51,119,"Virginia","Middlesex County",5,3,89,50,39
050,51,119,"Virginia","Middlesex County",5,4,90,54,36
050,51,119,"Virginia","Middlesex County",5,5,96,60,36
050,51,119,"Virginia","Middlesex County",5,6,109,64,45
050,51,119,"Virginia","Middlesex County",5,7,105,49,56
050,51,119,"Virginia","Middlesex County",5,8,120,59,61
050,51,119,"Virginia","Middlesex County",5,9,83,43,40
050,51,119,"Virginia","Middlesex County",5,10,89,51,38
050,51,119,"Virginia","Middlesex County",5,11,105,62,43
050,51,119,"Virginia","Middlesex County",5,12,100,56,44
050,51,119,"Virginia","Middlesex County",5,13,97,52,45
050,51,119,"Virginia","Middlesex County",5,14,101,53,48
050,51,119,"Virginia","Middlesex County",5,15,113,60,53
050,51,119,"Virginia","Middlesex County",5,16,119,66,53
050,51,119,"Virginia","Middlesex County",5,17,104,59,45
050,51,119,"Virginia","Middlesex County",5,18,82,40,42
050,51,119,"Virginia","Middlesex County",5,19,64,32,32
050,51,119,"Virginia","Middlesex County",5,20,73,38,35
050,51,119,"Virginia","Middlesex County",5,21,83,51,32
050,51,119,"Virginia","Middlesex County",5,22,90,47,43
050,51,119,"Virginia","Middlesex County",5,23,89,38,51
050,51,119,"Virginia","Middlesex County",5,24,75,42,33
050,51,119,"Virginia","Middlesex County",5,25,98,58,40
050,51,119,"Virginia","Middlesex County",5,26,92,46,46
050,51,119,"Virginia","Middlesex County",5,27,82,38,44
050,51,119,"Virginia","Middlesex County",5,28,94,50,44
050,51,119,"Virginia","Middlesex County",5,29,104,57,47
050,51,119,"Virginia","Middlesex County",5,30,89,43,46
050,51,119,"Virginia","Middlesex County",5,31,98,51,47
050,51,119,"Virginia","Middlesex County",5,32,104,52,52
050,51,119,"Virginia","Middlesex County",5,33,100,39,61
050,51,119,"Virginia","Middlesex County",5,34,105,51,54
050,51,119,"Virginia","Middlesex County",5,35,108,57,51
050,51,119,"Virginia","Middlesex County",5,36,114,58,56
050,51,119,"Virginia","Middlesex County",5,37,109,54,55
050,51,119,"Virginia","Middlesex County",5,38,95,50,45
050,51,119,"Virginia","Middlesex County",5,39,98,50,48
050,51,119,"Virginia","Middlesex County",5,40,112,59,53
050,51,119,"Virginia","Middlesex County",5,41,92,41,51
050,51,119,"Virginia","Middlesex County",5,42,115,61,54
050,51,119,"Virginia","Middlesex County",5,43,85,48,37
050,51,119,"Virginia","Middlesex County",5,44,94,50,44
050,51,119,"Virginia","Middlesex County",5,45,90,42,48
050,51,119,"Virginia","Middlesex County",5,46,91,40,51
050,51,119,"Virginia","Middlesex County",5,47,91,39,52
050,51,119,"Virginia","Middlesex County",5,48,98,42,56
050,51,119,"Virginia","Middlesex County",5,49,87,48,39
050,51,119,"Virginia","Middlesex County",5,50,104,52,52
050,51,119,"Virginia","Middlesex County",5,51,115,57,58
050,51,119,"Virginia","Middlesex County",5,52,123,57,66
050,51,119,"Virginia","Middlesex County",5,53,121,56,65
050,51,119,"Virginia","Middlesex County",5,54,130,62,68
050,51,119,"Virginia","Middlesex County",5,55,128,65,63
050,51,119,"Virginia","Middlesex County",5,56,143,65,78
050,51,119,"Virginia","Middlesex County",5,57,164,76,88
050,51,119,"Virginia","Middlesex County",5,58,171,74,97
050,51,119,"Virginia","Middlesex County",5,59,165,82,83
050,51,119,"Virginia","Middlesex County",5,60,198,100,98
050,51,119,"Virginia","Middlesex County",5,61,201,96,105
050,51,119,"Virginia","Middlesex County",5,62,228,104,124
050,51,119,"Virginia","Middlesex County",5,63,223,113,110
050,51,119,"Virginia","Middlesex County",5,64,226,117,109
050,51,119,"Virginia","Middlesex County",5,65,229,107,122
050,51,119,"Virginia","Middlesex County",5,66,210,102,108
050,51,119,"Virginia","Middlesex County",5,67,201,94,107
050,51,119,"Virginia","Middlesex County",5,68,196,91,105
050,51,119,"Virginia","Middlesex County",5,69,199,88,111
050,51,119,"Virginia","Middlesex County",5,70,190,82,108
050,51,119,"Virginia","Middlesex County",5,71,178,82,96
050,51,119,"Virginia","Middlesex County",5,72,195,99,96
050,51,119,"Virginia","Middlesex County",5,73,170,79,91
050,51,119,"Virginia","Middlesex County",5,74,153,69,84
050,51,119,"Virginia","Middlesex County",5,75,188,94,94
050,51,119,"Virginia","Middlesex County",5,76,210,102,108
050,51,119,"Virginia","Middlesex County",5,77,157,74,83
050,51,119,"Virginia","Middlesex County",5,78,151,76,75
050,51,119,"Virginia","Middlesex County",5,79,155,72,83
050,51,119,"Virginia","Middlesex County",5,80,140,66,74
050,51,119,"Virginia","Middlesex County",5,81,113,52,61
050,51,119,"Virginia","Middlesex County",5,82,92,50,42
050,51,119,"Virginia","Middlesex County",5,83,99,48,51
050,51,119,"Virginia","Middlesex County",5,84,85,40,45
050,51,119,"Virginia","Middlesex County",5,85,398,171,227
050,51,121,"Virginia","Montgomery County",1,0,778,396,382
050,51,121,"Virginia","Montgomery County",1,1,770,381,389
050,51,121,"Virginia","Montgomery County",1,2,833,438,395
050,51,121,"Virginia","Montgomery County",1,3,817,422,395
050,51,121,"Virginia","Montgomery County",1,4,780,389,391
050,51,121,"Virginia","Montgomery County",1,5,838,404,434
050,51,121,"Virginia","Montgomery County",1,6,868,429,439
050,51,121,"Virginia","Montgomery County",1,7,935,461,474
050,51,121,"Virginia","Montgomery County",1,8,896,450,446
050,51,121,"Virginia","Montgomery County",1,9,842,446,396
050,51,121,"Virginia","Montgomery County",1,10,849,448,401
050,51,121,"Virginia","Montgomery County",1,11,867,444,423
050,51,121,"Virginia","Montgomery County",1,12,962,488,474
050,51,121,"Virginia","Montgomery County",1,13,935,479,456
050,51,121,"Virginia","Montgomery County",1,14,836,434,402
050,51,121,"Virginia","Montgomery County",1,15,860,453,407
050,51,121,"Virginia","Montgomery County",1,16,896,479,417
050,51,121,"Virginia","Montgomery County",1,17,887,470,417
050,51,121,"Virginia","Montgomery County",1,18,3472,1839,1633
050,51,121,"Virginia","Montgomery County",1,19,5638,3156,2482
050,51,121,"Virginia","Montgomery County",1,20,4858,2713,2145
050,51,121,"Virginia","Montgomery County",1,21,4803,2754,2049
050,51,121,"Virginia","Montgomery County",1,22,4165,2454,1711
050,51,121,"Virginia","Montgomery County",1,23,2800,1607,1193
050,51,121,"Virginia","Montgomery County",1,24,1695,938,757
050,51,121,"Virginia","Montgomery County",1,25,1601,908,693
050,51,121,"Virginia","Montgomery County",1,26,1427,745,682
050,51,121,"Virginia","Montgomery County",1,27,1327,710,617
050,51,121,"Virginia","Montgomery County",1,28,1313,694,619
050,51,121,"Virginia","Montgomery County",1,29,1345,708,637
050,51,121,"Virginia","Montgomery County",1,30,1358,700,658
050,51,121,"Virginia","Montgomery County",1,31,1335,696,639
050,51,121,"Virginia","Montgomery County",1,32,1223,607,616
050,51,121,"Virginia","Montgomery County",1,33,1171,623,548
050,51,121,"Virginia","Montgomery County",1,34,1199,653,546
050,51,121,"Virginia","Montgomery County",1,35,1180,593,587
050,51,121,"Virginia","Montgomery County",1,36,1098,574,524
050,51,121,"Virginia","Montgomery County",1,37,1037,524,513
050,51,121,"Virginia","Montgomery County",1,38,1003,535,468
050,51,121,"Virginia","Montgomery County",1,39,1019,539,480
050,51,121,"Virginia","Montgomery County",1,40,1023,554,469
050,51,121,"Virginia","Montgomery County",1,41,936,518,418
050,51,121,"Virginia","Montgomery County",1,42,993,515,478
050,51,121,"Virginia","Montgomery County",1,43,1045,529,516
050,51,121,"Virginia","Montgomery County",1,44,986,499,487
050,51,121,"Virginia","Montgomery County",1,45,1051,552,499
050,51,121,"Virginia","Montgomery County",1,46,1006,521,485
050,51,121,"Virginia","Montgomery County",1,47,1025,510,515
050,51,121,"Virginia","Montgomery County",1,48,1072,528,544
050,51,121,"Virginia","Montgomery County",1,49,1104,553,551
050,51,121,"Virginia","Montgomery County",1,50,1026,523,503
050,51,121,"Virginia","Montgomery County",1,51,986,517,469
050,51,121,"Virginia","Montgomery County",1,52,977,516,461
050,51,121,"Virginia","Montgomery County",1,53,999,509,490
050,51,121,"Virginia","Montgomery County",1,54,1014,496,518
050,51,121,"Virginia","Montgomery County",1,55,1028,518,510
050,51,121,"Virginia","Montgomery County",1,56,1017,511,506
050,51,121,"Virginia","Montgomery County",1,57,1016,503,513
050,51,121,"Virginia","Montgomery County",1,58,1020,494,526
050,51,121,"Virginia","Montgomery County",1,59,980,475,505
050,51,121,"Virginia","Montgomery County",1,60,930,439,491
050,51,121,"Virginia","Montgomery County",1,61,951,457,494
050,51,121,"Virginia","Montgomery County",1,62,991,473,518
050,51,121,"Virginia","Montgomery County",1,63,986,476,510
050,51,121,"Virginia","Montgomery County",1,64,970,477,493
050,51,121,"Virginia","Montgomery County",1,65,1005,509,496
050,51,121,"Virginia","Montgomery County",1,66,983,482,501
050,51,121,"Virginia","Montgomery County",1,67,894,409,485
050,51,121,"Virginia","Montgomery County",1,68,810,388,422
050,51,121,"Virginia","Montgomery County",1,69,766,362,404
050,51,121,"Virginia","Montgomery County",1,70,735,338,397
050,51,121,"Virginia","Montgomery County",1,71,713,325,388
050,51,121,"Virginia","Montgomery County",1,72,750,333,417
050,51,121,"Virginia","Montgomery County",1,73,749,341,408
050,51,121,"Virginia","Montgomery County",1,74,501,222,279
050,51,121,"Virginia","Montgomery County",1,75,483,239,244
050,51,121,"Virginia","Montgomery County",1,76,492,235,257
050,51,121,"Virginia","Montgomery County",1,77,497,224,273
050,51,121,"Virginia","Montgomery County",1,78,443,198,245
050,51,121,"Virginia","Montgomery County",1,79,365,163,202
050,51,121,"Virginia","Montgomery County",1,80,345,159,186
050,51,121,"Virginia","Montgomery County",1,81,326,152,174
050,51,121,"Virginia","Montgomery County",1,82,307,141,166
050,51,121,"Virginia","Montgomery County",1,83,279,121,158
050,51,121,"Virginia","Montgomery County",1,84,243,97,146
050,51,121,"Virginia","Montgomery County",1,85,1385,466,919
050,51,121,"Virginia","Montgomery County",2,0,760,395,365
050,51,121,"Virginia","Montgomery County",2,1,762,377,385
050,51,121,"Virginia","Montgomery County",2,2,817,425,392
050,51,121,"Virginia","Montgomery County",2,3,816,426,390
050,51,121,"Virginia","Montgomery County",2,4,793,396,397
050,51,121,"Virginia","Montgomery County",2,5,827,399,428
050,51,121,"Virginia","Montgomery County",2,6,867,427,440
050,51,121,"Virginia","Montgomery County",2,7,919,455,464
050,51,121,"Virginia","Montgomery County",2,8,904,450,454
050,51,121,"Virginia","Montgomery County",2,9,853,445,408
050,51,121,"Virginia","Montgomery County",2,10,845,445,400
050,51,121,"Virginia","Montgomery County",2,11,862,444,418
050,51,121,"Virginia","Montgomery County",2,12,945,481,464
050,51,121,"Virginia","Montgomery County",2,13,941,478,463
050,51,121,"Virginia","Montgomery County",2,14,859,443,416
050,51,121,"Virginia","Montgomery County",2,15,855,447,408
050,51,121,"Virginia","Montgomery County",2,16,889,473,416
050,51,121,"Virginia","Montgomery County",2,17,897,475,422
050,51,121,"Virginia","Montgomery County",2,18,3458,1830,1628
050,51,121,"Virginia","Montgomery County",2,19,5616,3141,2475
050,51,121,"Virginia","Montgomery County",2,20,4895,2735,2160
050,51,121,"Virginia","Montgomery County",2,21,4777,2735,2042
050,51,121,"Virginia","Montgomery County",2,22,4129,2424,1705
050,51,121,"Virginia","Montgomery County",2,23,2795,1606,1189
050,51,121,"Virginia","Montgomery County",2,24,1678,931,747
050,51,121,"Virginia","Montgomery County",2,25,1600,908,692
050,51,121,"Virginia","Montgomery County",2,26,1416,744,672
050,51,121,"Virginia","Montgomery County",2,27,1316,700,616
050,51,121,"Virginia","Montgomery County",2,28,1299,690,609
050,51,121,"Virginia","Montgomery County",2,29,1314,693,621
050,51,121,"Virginia","Montgomery County",2,30,1342,697,645
050,51,121,"Virginia","Montgomery County",2,31,1307,675,632
050,51,121,"Virginia","Montgomery County",2,32,1228,614,614
050,51,121,"Virginia","Montgomery County",2,33,1172,612,560
050,51,121,"Virginia","Montgomery County",2,34,1186,642,544
050,51,121,"Virginia","Montgomery County",2,35,1177,603,574
050,51,121,"Virginia","Montgomery County",2,36,1099,566,533
050,51,121,"Virginia","Montgomery County",2,37,1046,534,512
050,51,121,"Virginia","Montgomery County",2,38,1012,529,483
050,51,121,"Virginia","Montgomery County",2,39,1009,535,474
050,51,121,"Virginia","Montgomery County",2,40,1028,554,474
050,51,121,"Virginia","Montgomery County",2,41,956,526,430
050,51,121,"Virginia","Montgomery County",2,42,981,514,467
050,51,121,"Virginia","Montgomery County",2,43,1042,530,512
050,51,121,"Virginia","Montgomery County",2,44,991,500,491
050,51,121,"Virginia","Montgomery County",2,45,1043,544,499
050,51,121,"Virginia","Montgomery County",2,46,1011,526,485
050,51,121,"Virginia","Montgomery County",2,47,1015,509,506
050,51,121,"Virginia","Montgomery County",2,48,1054,520,534
050,51,121,"Virginia","Montgomery County",2,49,1097,548,549
050,51,121,"Virginia","Montgomery County",2,50,1044,529,515
050,51,121,"Virginia","Montgomery County",2,51,993,519,474
050,51,121,"Virginia","Montgomery County",2,52,980,516,464
050,51,121,"Virginia","Montgomery County",2,53,991,509,482
050,51,121,"Virginia","Montgomery County",2,54,1010,502,508
050,51,121,"Virginia","Montgomery County",2,55,1022,512,510
050,51,121,"Virginia","Montgomery County",2,56,1018,513,505
050,51,121,"Virginia","Montgomery County",2,57,1014,503,511
050,51,121,"Virginia","Montgomery County",2,58,1015,495,520
050,51,121,"Virginia","Montgomery County",2,59,992,481,511
050,51,121,"Virginia","Montgomery County",2,60,933,445,488
050,51,121,"Virginia","Montgomery County",2,61,943,452,491
050,51,121,"Virginia","Montgomery County",2,62,975,464,511
050,51,121,"Virginia","Montgomery County",2,63,994,479,515
050,51,121,"Virginia","Montgomery County",2,64,970,475,495
050,51,121,"Virginia","Montgomery County",2,65,993,501,492
050,51,121,"Virginia","Montgomery County",2,66,988,486,502
050,51,121,"Virginia","Montgomery County",2,67,907,423,484
050,51,121,"Virginia","Montgomery County",2,68,825,390,435
050,51,121,"Virginia","Montgomery County",2,69,778,370,408
050,51,121,"Virginia","Montgomery County",2,70,739,342,397
050,51,121,"Virginia","Montgomery County",2,71,717,326,391
050,51,121,"Virginia","Montgomery County",2,72,728,326,402
050,51,121,"Virginia","Montgomery County",2,73,784,354,430
050,51,121,"Virginia","Montgomery County",2,74,526,235,291
050,51,121,"Virginia","Montgomery County",2,75,483,231,252
050,51,121,"Virginia","Montgomery County",2,76,483,233,250
050,51,121,"Virginia","Montgomery County",2,77,508,232,276
050,51,121,"Virginia","Montgomery County",2,78,445,200,245
050,51,121,"Virginia","Montgomery County",2,79,378,167,211
050,51,121,"Virginia","Montgomery County",2,80,348,157,191
050,51,121,"Virginia","Montgomery County",2,81,329,154,175
050,51,121,"Virginia","Montgomery County",2,82,308,142,166
050,51,121,"Virginia","Montgomery County",2,83,281,122,159
050,51,121,"Virginia","Montgomery County",2,84,242,99,143
050,51,121,"Virginia","Montgomery County",2,85,1390,465,925
050,51,121,"Virginia","Montgomery County",3,0,646,342,304
050,51,121,"Virginia","Montgomery County",3,1,797,401,396
050,51,121,"Virginia","Montgomery County",3,2,732,369,363
050,51,121,"Virginia","Montgomery County",3,3,819,415,404
050,51,121,"Virginia","Montgomery County",3,4,803,405,398
050,51,121,"Virginia","Montgomery County",3,5,797,402,395
050,51,121,"Virginia","Montgomery County",3,6,837,417,420
050,51,121,"Virginia","Montgomery County",3,7,876,426,450
050,51,121,"Virginia","Montgomery County",3,8,906,444,462
050,51,121,"Virginia","Montgomery County",3,9,877,447,430
050,51,121,"Virginia","Montgomery County",3,10,864,447,417
050,51,121,"Virginia","Montgomery County",3,11,851,454,397
050,51,121,"Virginia","Montgomery County",3,12,855,448,407
050,51,121,"Virginia","Montgomery County",3,13,923,466,457
050,51,121,"Virginia","Montgomery County",3,14,938,481,457
050,51,121,"Virginia","Montgomery County",3,15,837,431,406
050,51,121,"Virginia","Montgomery County",3,16,866,447,419
050,51,121,"Virginia","Montgomery County",3,17,908,491,417
050,51,121,"Virginia","Montgomery County",3,18,3509,1864,1645
050,51,121,"Virginia","Montgomery County",3,19,5582,3138,2444
050,51,121,"Virginia","Montgomery County",3,20,4908,2749,2159
050,51,121,"Virginia","Montgomery County",3,21,4814,2738,2076
050,51,121,"Virginia","Montgomery County",3,22,4061,2405,1656
050,51,121,"Virginia","Montgomery County",3,23,2676,1543,1133
050,51,121,"Virginia","Montgomery County",3,24,1662,914,748
050,51,121,"Virginia","Montgomery County",3,25,1597,882,715
050,51,121,"Virginia","Montgomery County",3,26,1344,699,645
050,51,121,"Virginia","Montgomery County",3,27,1247,667,580
050,51,121,"Virginia","Montgomery County",3,28,1221,646,575
050,51,121,"Virginia","Montgomery County",3,29,1216,645,571
050,51,121,"Virginia","Montgomery County",3,30,1175,612,563
050,51,121,"Virginia","Montgomery County",3,31,1278,684,594
050,51,121,"Virginia","Montgomery County",3,32,1273,670,603
050,51,121,"Virginia","Montgomery County",3,33,1146,567,579
050,51,121,"Virginia","Montgomery County",3,34,1136,577,559
050,51,121,"Virginia","Montgomery County",3,35,1166,613,553
050,51,121,"Virginia","Montgomery County",3,36,1153,583,570
050,51,121,"Virginia","Montgomery County",3,37,1072,548,524
050,51,121,"Virginia","Montgomery County",3,38,1062,541,521
050,51,121,"Virginia","Montgomery County",3,39,1010,524,486
050,51,121,"Virginia","Montgomery County",3,40,997,527,470
050,51,121,"Virginia","Montgomery County",3,41,1007,535,472
050,51,121,"Virginia","Montgomery County",3,42,953,533,420
050,51,121,"Virginia","Montgomery County",3,43,969,497,472
050,51,121,"Virginia","Montgomery County",3,44,1018,517,501
050,51,121,"Virginia","Montgomery County",3,45,988,511,477
050,51,121,"Virginia","Montgomery County",3,46,1033,538,495
050,51,121,"Virginia","Montgomery County",3,47,996,518,478
050,51,121,"Virginia","Montgomery County",3,48,988,493,495
050,51,121,"Virginia","Montgomery County",3,49,1057,525,532
050,51,121,"Virginia","Montgomery County",3,50,1074,540,534
050,51,121,"Virginia","Montgomery County",3,51,1034,520,514
050,51,121,"Virginia","Montgomery County",3,52,998,520,478
050,51,121,"Virginia","Montgomery County",3,53,972,520,452
050,51,121,"Virginia","Montgomery County",3,54,976,500,476
050,51,121,"Virginia","Montgomery County",3,55,983,494,489
050,51,121,"Virginia","Montgomery County",3,56,999,491,508
050,51,121,"Virginia","Montgomery County",3,57,1010,511,499
050,51,121,"Virginia","Montgomery County",3,58,1000,492,508
050,51,121,"Virginia","Montgomery County",3,59,1024,500,524
050,51,121,"Virginia","Montgomery County",3,60,983,461,522
050,51,121,"Virginia","Montgomery County",3,61,912,430,482
050,51,121,"Virginia","Montgomery County",3,62,919,428,491
050,51,121,"Virginia","Montgomery County",3,63,954,452,502
050,51,121,"Virginia","Montgomery County",3,64,987,471,516
050,51,121,"Virginia","Montgomery County",3,65,949,456,493
050,51,121,"Virginia","Montgomery County",3,66,971,484,487
050,51,121,"Virginia","Montgomery County",3,67,964,479,485
050,51,121,"Virginia","Montgomery County",3,68,891,414,477
050,51,121,"Virginia","Montgomery County",3,69,811,380,431
050,51,121,"Virginia","Montgomery County",3,70,758,357,401
050,51,121,"Virginia","Montgomery County",3,71,725,338,387
050,51,121,"Virginia","Montgomery County",3,72,706,329,377
050,51,121,"Virginia","Montgomery County",3,73,710,322,388
050,51,121,"Virginia","Montgomery County",3,74,756,345,411
050,51,121,"Virginia","Montgomery County",3,75,516,225,291
050,51,121,"Virginia","Montgomery County",3,76,461,213,248
050,51,121,"Virginia","Montgomery County",3,77,460,225,235
050,51,121,"Virginia","Montgomery County",3,78,485,222,263
050,51,121,"Virginia","Montgomery County",3,79,420,195,225
050,51,121,"Virginia","Montgomery County",3,80,359,156,203
050,51,121,"Virginia","Montgomery County",3,81,324,146,178
050,51,121,"Virginia","Montgomery County",3,82,304,142,162
050,51,121,"Virginia","Montgomery County",3,83,287,125,162
050,51,121,"Virginia","Montgomery County",3,84,256,114,142
050,51,121,"Virginia","Montgomery County",3,85,1404,477,927
050,51,121,"Virginia","Montgomery County",4,0,656,341,315
050,51,121,"Virginia","Montgomery County",4,1,678,372,306
050,51,121,"Virginia","Montgomery County",4,2,786,394,392
050,51,121,"Virginia","Montgomery County",4,3,757,390,367
050,51,121,"Virginia","Montgomery County",4,4,814,410,404
050,51,121,"Virginia","Montgomery County",4,5,814,403,411
050,51,121,"Virginia","Montgomery County",4,6,812,406,406
050,51,121,"Virginia","Montgomery County",4,7,856,421,435
050,51,121,"Virginia","Montgomery County",4,8,868,418,450
050,51,121,"Virginia","Montgomery County",4,9,905,452,453
050,51,121,"Virginia","Montgomery County",4,10,876,444,432
050,51,121,"Virginia","Montgomery County",4,11,853,432,421
050,51,121,"Virginia","Montgomery County",4,12,849,467,382
050,51,121,"Virginia","Montgomery County",4,13,869,453,416
050,51,121,"Virginia","Montgomery County",4,14,931,470,461
050,51,121,"Virginia","Montgomery County",4,15,949,487,462
050,51,121,"Virginia","Montgomery County",4,16,875,461,414
050,51,121,"Virginia","Montgomery County",4,17,927,476,451
050,51,121,"Virginia","Montgomery County",4,18,3473,1861,1612
050,51,121,"Virginia","Montgomery County",4,19,5555,3132,2423
050,51,121,"Virginia","Montgomery County",4,20,4850,2753,2097
050,51,121,"Virginia","Montgomery County",4,21,4895,2817,2078
050,51,121,"Virginia","Montgomery County",4,22,4160,2431,1729
050,51,121,"Virginia","Montgomery County",4,23,2679,1557,1122
050,51,121,"Virginia","Montgomery County",4,24,1622,897,725
050,51,121,"Virginia","Montgomery County",4,25,1606,907,699
050,51,121,"Virginia","Montgomery County",4,26,1414,727,687
050,51,121,"Virginia","Montgomery County",4,27,1202,636,566
050,51,121,"Virginia","Montgomery County",4,28,1140,607,533
050,51,121,"Virginia","Montgomery County",4,29,1160,598,562
050,51,121,"Virginia","Montgomery County",4,30,1176,616,560
050,51,121,"Virginia","Montgomery County",4,31,1152,614,538
050,51,121,"Virginia","Montgomery County",4,32,1246,674,572
050,51,121,"Virginia","Montgomery County",4,33,1247,659,588
050,51,121,"Virginia","Montgomery County",4,34,1098,560,538
050,51,121,"Virginia","Montgomery County",4,35,1120,563,557
050,51,121,"Virginia","Montgomery County",4,36,1128,577,551
050,51,121,"Virginia","Montgomery County",4,37,1137,579,558
050,51,121,"Virginia","Montgomery County",4,38,1115,567,548
050,51,121,"Virginia","Montgomery County",4,39,1046,522,524
050,51,121,"Virginia","Montgomery County",4,40,1015,538,477
050,51,121,"Virginia","Montgomery County",4,41,988,510,478
050,51,121,"Virginia","Montgomery County",4,42,1010,524,486
050,51,121,"Virginia","Montgomery County",4,43,963,540,423
050,51,121,"Virginia","Montgomery County",4,44,943,489,454
050,51,121,"Virginia","Montgomery County",4,45,1025,523,502
050,51,121,"Virginia","Montgomery County",4,46,981,508,473
050,51,121,"Virginia","Montgomery County",4,47,1030,538,492
050,51,121,"Virginia","Montgomery County",4,48,986,505,481
050,51,121,"Virginia","Montgomery County",4,49,980,491,489
050,51,121,"Virginia","Montgomery County",4,50,1035,511,524
050,51,121,"Virginia","Montgomery County",4,51,1065,531,534
050,51,121,"Virginia","Montgomery County",4,52,1022,507,515
050,51,121,"Virginia","Montgomery County",4,53,995,526,469
050,51,121,"Virginia","Montgomery County",4,54,964,514,450
050,51,121,"Virginia","Montgomery County",4,55,961,498,463
050,51,121,"Virginia","Montgomery County",4,56,968,488,480
050,51,121,"Virginia","Montgomery County",4,57,998,487,511
050,51,121,"Virginia","Montgomery County",4,58,988,494,494
050,51,121,"Virginia","Montgomery County",4,59,999,488,511
050,51,121,"Virginia","Montgomery County",4,60,987,478,509
050,51,121,"Virginia","Montgomery County",4,61,993,472,521
050,51,121,"Virginia","Montgomery County",4,62,892,416,476
050,51,121,"Virginia","Montgomery County",4,63,900,424,476
050,51,121,"Virginia","Montgomery County",4,64,942,443,499
050,51,121,"Virginia","Montgomery County",4,65,967,454,513
050,51,121,"Virginia","Montgomery County",4,66,943,446,497
050,51,121,"Virginia","Montgomery County",4,67,948,478,470
050,51,121,"Virginia","Montgomery County",4,68,944,462,482
050,51,121,"Virginia","Montgomery County",4,69,882,409,473
050,51,121,"Virginia","Montgomery County",4,70,798,373,425
050,51,121,"Virginia","Montgomery County",4,71,725,341,384
050,51,121,"Virginia","Montgomery County",4,72,704,331,373
050,51,121,"Virginia","Montgomery County",4,73,688,314,374
050,51,121,"Virginia","Montgomery County",4,74,702,317,385
050,51,121,"Virginia","Montgomery County",4,75,748,339,409
050,51,121,"Virginia","Montgomery County",4,76,500,219,281
050,51,121,"Virginia","Montgomery County",4,77,440,205,235
050,51,121,"Virginia","Montgomery County",4,78,434,210,224
050,51,121,"Virginia","Montgomery County",4,79,450,211,239
050,51,121,"Virginia","Montgomery County",4,80,406,186,220
050,51,121,"Virginia","Montgomery County",4,81,344,150,194
050,51,121,"Virginia","Montgomery County",4,82,308,139,169
050,51,121,"Virginia","Montgomery County",4,83,282,122,160
050,51,121,"Virginia","Montgomery County",4,84,258,116,142
050,51,121,"Virginia","Montgomery County",4,85,1429,499,930
050,51,121,"Virginia","Montgomery County",5,0,647,337,310
050,51,121,"Virginia","Montgomery County",5,1,660,351,309
050,51,121,"Virginia","Montgomery County",5,2,682,359,323
050,51,121,"Virginia","Montgomery County",5,3,746,379,367
050,51,121,"Virginia","Montgomery County",5,4,746,385,361
050,51,121,"Virginia","Montgomery County",5,5,810,408,402
050,51,121,"Virginia","Montgomery County",5,6,797,401,396
050,51,121,"Virginia","Montgomery County",5,7,820,395,425
050,51,121,"Virginia","Montgomery County",5,8,846,421,425
050,51,121,"Virginia","Montgomery County",5,9,879,417,462
050,51,121,"Virginia","Montgomery County",5,10,899,452,447
050,51,121,"Virginia","Montgomery County",5,11,882,441,441
050,51,121,"Virginia","Montgomery County",5,12,858,441,417
050,51,121,"Virginia","Montgomery County",5,13,861,471,390
050,51,121,"Virginia","Montgomery County",5,14,888,466,422
050,51,121,"Virginia","Montgomery County",5,15,950,488,462
050,51,121,"Virginia","Montgomery County",5,16,957,494,463
050,51,121,"Virginia","Montgomery County",5,17,925,494,431
050,51,121,"Virginia","Montgomery County",5,18,3483,1841,1642
050,51,121,"Virginia","Montgomery County",5,19,5570,3159,2411
050,51,121,"Virginia","Montgomery County",5,20,4848,2751,2097
050,51,121,"Virginia","Montgomery County",5,21,4769,2781,1988
050,51,121,"Virginia","Montgomery County",5,22,4211,2483,1728
050,51,121,"Virginia","Montgomery County",5,23,2804,1637,1167
050,51,121,"Virginia","Montgomery County",5,24,1690,945,745
050,51,121,"Virginia","Montgomery County",5,25,1592,887,705
050,51,121,"Virginia","Montgomery County",5,26,1368,739,629
050,51,121,"Virginia","Montgomery County",5,27,1253,638,615
050,51,121,"Virginia","Montgomery County",5,28,1112,570,542
050,51,121,"Virginia","Montgomery County",5,29,1127,605,522
050,51,121,"Virginia","Montgomery County",5,30,1084,555,529
050,51,121,"Virginia","Montgomery County",5,31,1090,561,529
050,51,121,"Virginia","Montgomery County",5,32,1110,587,523
050,51,121,"Virginia","Montgomery County",5,33,1191,617,574
050,51,121,"Virginia","Montgomery County",5,34,1157,612,545
050,51,121,"Virginia","Montgomery County",5,35,1071,539,532
050,51,121,"Virginia","Montgomery County",5,36,1097,553,544
050,51,121,"Virginia","Montgomery County",5,37,1108,554,554
050,51,121,"Virginia","Montgomery County",5,38,1127,573,554
050,51,121,"Virginia","Montgomery County",5,39,1100,563,537
050,51,121,"Virginia","Montgomery County",5,40,1049,531,518
050,51,121,"Virginia","Montgomery County",5,41,1018,527,491
050,51,121,"Virginia","Montgomery County",5,42,976,500,476
050,51,121,"Virginia","Montgomery County",5,43,999,512,487
050,51,121,"Virginia","Montgomery County",5,44,965,530,435
050,51,121,"Virginia","Montgomery County",5,45,945,493,452
050,51,121,"Virginia","Montgomery County",5,46,1026,533,493
050,51,121,"Virginia","Montgomery County",5,47,981,498,483
050,51,121,"Virginia","Montgomery County",5,48,1034,538,496
050,51,121,"Virginia","Montgomery County",5,49,981,494,487
050,51,121,"Virginia","Montgomery County",5,50,982,487,495
050,51,121,"Virginia","Montgomery County",5,51,1027,505,522
050,51,121,"Virginia","Montgomery County",5,52,1064,540,524
050,51,121,"Virginia","Montgomery County",5,53,1010,504,506
050,51,121,"Virginia","Montgomery County",5,54,981,527,454
050,51,121,"Virginia","Montgomery County",5,55,951,511,440
050,51,121,"Virginia","Montgomery County",5,56,938,476,462
050,51,121,"Virginia","Montgomery County",5,57,932,470,462
050,51,121,"Virginia","Montgomery County",5,58,992,478,514
050,51,121,"Virginia","Montgomery County",5,59,995,495,500
050,51,121,"Virginia","Montgomery County",5,60,975,474,501
050,51,121,"Virginia","Montgomery County",5,61,986,469,517
050,51,121,"Virginia","Montgomery County",5,62,993,475,518
050,51,121,"Virginia","Montgomery County",5,63,868,408,460
050,51,121,"Virginia","Montgomery County",5,64,893,423,470
050,51,121,"Virginia","Montgomery County",5,65,921,430,491
050,51,121,"Virginia","Montgomery County",5,66,965,452,513
050,51,121,"Virginia","Montgomery County",5,67,924,440,484
050,51,121,"Virginia","Montgomery County",5,68,924,463,461
050,51,121,"Virginia","Montgomery County",5,69,932,458,474
050,51,121,"Virginia","Montgomery County",5,70,879,405,474
050,51,121,"Virginia","Montgomery County",5,71,781,364,417
050,51,121,"Virginia","Montgomery County",5,72,712,339,373
050,51,121,"Virginia","Montgomery County",5,73,687,321,366
050,51,121,"Virginia","Montgomery County",5,74,669,296,373
050,51,121,"Virginia","Montgomery County",5,75,684,307,377
050,51,121,"Virginia","Montgomery County",5,76,719,320,399
050,51,121,"Virginia","Montgomery County",5,77,483,212,271
050,51,121,"Virginia","Montgomery County",5,78,416,197,219
050,51,121,"Virginia","Montgomery County",5,79,405,198,207
050,51,121,"Virginia","Montgomery County",5,80,434,205,229
050,51,121,"Virginia","Montgomery County",5,81,387,175,212
050,51,121,"Virginia","Montgomery County",5,82,334,143,191
050,51,121,"Virginia","Montgomery County",5,83,290,122,168
050,51,121,"Virginia","Montgomery County",5,84,246,109,137
050,51,121,"Virginia","Montgomery County",5,85,1498,534,964
050,51,125,"Virginia","Nelson County",1,0,139,70,69
050,51,125,"Virginia","Nelson County",1,1,143,68,75
050,51,125,"Virginia","Nelson County",1,2,149,75,74
050,51,125,"Virginia","Nelson County",1,3,128,73,55
050,51,125,"Virginia","Nelson County",1,4,125,66,59
050,51,125,"Virginia","Nelson County",1,5,134,75,59
050,51,125,"Virginia","Nelson County",1,6,128,53,75
050,51,125,"Virginia","Nelson County",1,7,124,63,61
050,51,125,"Virginia","Nelson County",1,8,135,73,62
050,51,125,"Virginia","Nelson County",1,9,129,64,65
050,51,125,"Virginia","Nelson County",1,10,145,67,78
050,51,125,"Virginia","Nelson County",1,11,154,75,79
050,51,125,"Virginia","Nelson County",1,12,158,77,81
050,51,125,"Virginia","Nelson County",1,13,169,92,77
050,51,125,"Virginia","Nelson County",1,14,149,70,79
050,51,125,"Virginia","Nelson County",1,15,165,94,71
050,51,125,"Virginia","Nelson County",1,16,173,94,79
050,51,125,"Virginia","Nelson County",1,17,179,92,87
050,51,125,"Virginia","Nelson County",1,18,146,85,61
050,51,125,"Virginia","Nelson County",1,19,121,59,62
050,51,125,"Virginia","Nelson County",1,20,129,67,62
050,51,125,"Virginia","Nelson County",1,21,135,67,68
050,51,125,"Virginia","Nelson County",1,22,138,75,63
050,51,125,"Virginia","Nelson County",1,23,124,61,63
050,51,125,"Virginia","Nelson County",1,24,124,61,63
050,51,125,"Virginia","Nelson County",1,25,130,67,63
050,51,125,"Virginia","Nelson County",1,26,129,66,63
050,51,125,"Virginia","Nelson County",1,27,134,66,68
050,51,125,"Virginia","Nelson County",1,28,137,66,71
050,51,125,"Virginia","Nelson County",1,29,136,64,72
050,51,125,"Virginia","Nelson County",1,30,137,65,72
050,51,125,"Virginia","Nelson County",1,31,137,67,70
050,51,125,"Virginia","Nelson County",1,32,149,73,76
050,51,125,"Virginia","Nelson County",1,33,149,73,76
050,51,125,"Virginia","Nelson County",1,34,136,67,69
050,51,125,"Virginia","Nelson County",1,35,141,72,69
050,51,125,"Virginia","Nelson County",1,36,137,69,68
050,51,125,"Virginia","Nelson County",1,37,154,72,82
050,51,125,"Virginia","Nelson County",1,38,150,77,73
050,51,125,"Virginia","Nelson County",1,39,169,83,86
050,51,125,"Virginia","Nelson County",1,40,169,75,94
050,51,125,"Virginia","Nelson County",1,41,144,70,74
050,51,125,"Virginia","Nelson County",1,42,156,76,80
050,51,125,"Virginia","Nelson County",1,43,152,76,76
050,51,125,"Virginia","Nelson County",1,44,142,72,70
050,51,125,"Virginia","Nelson County",1,45,145,70,75
050,51,125,"Virginia","Nelson County",1,46,143,67,76
050,51,125,"Virginia","Nelson County",1,47,163,82,81
050,51,125,"Virginia","Nelson County",1,48,176,92,84
050,51,125,"Virginia","Nelson County",1,49,193,99,94
050,51,125,"Virginia","Nelson County",1,50,162,77,85
050,51,125,"Virginia","Nelson County",1,51,189,102,87
050,51,125,"Virginia","Nelson County",1,52,180,94,86
050,51,125,"Virginia","Nelson County",1,53,186,92,94
050,51,125,"Virginia","Nelson County",1,54,197,98,99
050,51,125,"Virginia","Nelson County",1,55,225,100,125
050,51,125,"Virginia","Nelson County",1,56,236,106,130
050,51,125,"Virginia","Nelson County",1,57,218,100,118
050,51,125,"Virginia","Nelson County",1,58,244,114,130
050,51,125,"Virginia","Nelson County",1,59,249,124,125
050,51,125,"Virginia","Nelson County",1,60,238,121,117
050,51,125,"Virginia","Nelson County",1,61,263,127,136
050,51,125,"Virginia","Nelson County",1,62,283,139,144
050,51,125,"Virginia","Nelson County",1,63,262,119,143
050,51,125,"Virginia","Nelson County",1,64,268,133,135
050,51,125,"Virginia","Nelson County",1,65,269,140,129
050,51,125,"Virginia","Nelson County",1,66,282,131,151
050,51,125,"Virginia","Nelson County",1,67,284,127,157
050,51,125,"Virginia","Nelson County",1,68,266,120,146
050,51,125,"Virginia","Nelson County",1,69,266,131,135
050,51,125,"Virginia","Nelson County",1,70,264,123,141
050,51,125,"Virginia","Nelson County",1,71,277,135,142
050,51,125,"Virginia","Nelson County",1,72,278,140,138
050,51,125,"Virginia","Nelson County",1,73,261,137,124
050,51,125,"Virginia","Nelson County",1,74,158,76,82
050,51,125,"Virginia","Nelson County",1,75,173,83,90
050,51,125,"Virginia","Nelson County",1,76,171,92,79
050,51,125,"Virginia","Nelson County",1,77,156,78,78
050,51,125,"Virginia","Nelson County",1,78,134,65,69
050,51,125,"Virginia","Nelson County",1,79,125,59,66
050,51,125,"Virginia","Nelson County",1,80,112,57,55
050,51,125,"Virginia","Nelson County",1,81,102,45,57
050,51,125,"Virginia","Nelson County",1,82,82,35,47
050,51,125,"Virginia","Nelson County",1,83,77,40,37
050,51,125,"Virginia","Nelson County",1,84,59,24,35
050,51,125,"Virginia","Nelson County",1,85,325,108,217
050,51,125,"Virginia","Nelson County",2,0,141,78,63
050,51,125,"Virginia","Nelson County",2,1,143,68,75
050,51,125,"Virginia","Nelson County",2,2,146,73,73
050,51,125,"Virginia","Nelson County",2,3,134,75,59
050,51,125,"Virginia","Nelson County",2,4,123,68,55
050,51,125,"Virginia","Nelson County",2,5,131,73,58
050,51,125,"Virginia","Nelson County",2,6,129,58,71
050,51,125,"Virginia","Nelson County",2,7,126,61,65
050,51,125,"Virginia","Nelson County",2,8,131,71,60
050,51,125,"Virginia","Nelson County",2,9,129,66,63
050,51,125,"Virginia","Nelson County",2,10,141,66,75
050,51,125,"Virginia","Nelson County",2,11,149,71,78
050,51,125,"Virginia","Nelson County",2,12,156,76,80
050,51,125,"Virginia","Nelson County",2,13,163,86,77
050,51,125,"Virginia","Nelson County",2,14,154,77,77
050,51,125,"Virginia","Nelson County",2,15,162,89,73
050,51,125,"Virginia","Nelson County",2,16,170,93,77
050,51,125,"Virginia","Nelson County",2,17,175,92,83
050,51,125,"Virginia","Nelson County",2,18,146,83,63
050,51,125,"Virginia","Nelson County",2,19,121,63,58
050,51,125,"Virginia","Nelson County",2,20,132,67,65
050,51,125,"Virginia","Nelson County",2,21,134,67,67
050,51,125,"Virginia","Nelson County",2,22,136,72,64
050,51,125,"Virginia","Nelson County",2,23,126,64,62
050,51,125,"Virginia","Nelson County",2,24,126,61,65
050,51,125,"Virginia","Nelson County",2,25,127,65,62
050,51,125,"Virginia","Nelson County",2,26,125,64,61
050,51,125,"Virginia","Nelson County",2,27,130,65,65
050,51,125,"Virginia","Nelson County",2,28,134,65,69
050,51,125,"Virginia","Nelson County",2,29,134,64,70
050,51,125,"Virginia","Nelson County",2,30,138,66,72
050,51,125,"Virginia","Nelson County",2,31,140,68,72
050,51,125,"Virginia","Nelson County",2,32,150,76,74
050,51,125,"Virginia","Nelson County",2,33,148,74,74
050,51,125,"Virginia","Nelson County",2,34,137,68,69
050,51,125,"Virginia","Nelson County",2,35,141,72,69
050,51,125,"Virginia","Nelson County",2,36,137,70,67
050,51,125,"Virginia","Nelson County",2,37,151,72,79
050,51,125,"Virginia","Nelson County",2,38,153,76,77
050,51,125,"Virginia","Nelson County",2,39,163,80,83
050,51,125,"Virginia","Nelson County",2,40,169,77,92
050,51,125,"Virginia","Nelson County",2,41,151,72,79
050,51,125,"Virginia","Nelson County",2,42,151,74,77
050,51,125,"Virginia","Nelson County",2,43,154,76,78
050,51,125,"Virginia","Nelson County",2,44,142,72,70
050,51,125,"Virginia","Nelson County",2,45,148,72,76
050,51,125,"Virginia","Nelson County",2,46,144,68,76
050,51,125,"Virginia","Nelson County",2,47,160,80,80
050,51,125,"Virginia","Nelson County",2,48,175,89,86
050,51,125,"Virginia","Nelson County",2,49,188,98,90
050,51,125,"Virginia","Nelson County",2,50,170,83,87
050,51,125,"Virginia","Nelson County",2,51,183,97,86
050,51,125,"Virginia","Nelson County",2,52,182,96,86
050,51,125,"Virginia","Nelson County",2,53,185,92,93
050,51,125,"Virginia","Nelson County",2,54,195,97,98
050,51,125,"Virginia","Nelson County",2,55,220,100,120
050,51,125,"Virginia","Nelson County",2,56,231,104,127
050,51,125,"Virginia","Nelson County",2,57,224,102,122
050,51,125,"Virginia","Nelson County",2,58,240,112,128
050,51,125,"Virginia","Nelson County",2,59,248,122,126
050,51,125,"Virginia","Nelson County",2,60,240,122,118
050,51,125,"Virginia","Nelson County",2,61,256,127,129
050,51,125,"Virginia","Nelson County",2,62,279,136,143
050,51,125,"Virginia","Nelson County",2,63,268,126,142
050,51,125,"Virginia","Nelson County",2,64,265,130,135
050,51,125,"Virginia","Nelson County",2,65,268,138,130
050,51,125,"Virginia","Nelson County",2,66,277,132,145
050,51,125,"Virginia","Nelson County",2,67,283,128,155
050,51,125,"Virginia","Nelson County",2,68,267,119,148
050,51,125,"Virginia","Nelson County",2,69,268,130,138
050,51,125,"Virginia","Nelson County",2,70,261,123,138
050,51,125,"Virginia","Nelson County",2,71,271,131,140
050,51,125,"Virginia","Nelson County",2,72,270,136,134
050,51,125,"Virginia","Nelson County",2,73,276,143,133
050,51,125,"Virginia","Nelson County",2,74,171,84,87
050,51,125,"Virginia","Nelson County",2,75,170,81,89
050,51,125,"Virginia","Nelson County",2,76,169,88,81
050,51,125,"Virginia","Nelson County",2,77,160,81,79
050,51,125,"Virginia","Nelson County",2,78,133,64,69
050,51,125,"Virginia","Nelson County",2,79,124,58,66
050,51,125,"Virginia","Nelson County",2,80,116,58,58
050,51,125,"Virginia","Nelson County",2,81,105,49,56
050,51,125,"Virginia","Nelson County",2,82,84,35,49
050,51,125,"Virginia","Nelson County",2,83,75,37,38
050,51,125,"Virginia","Nelson County",2,84,62,27,35
050,51,125,"Virginia","Nelson County",2,85,330,111,219
050,51,125,"Virginia","Nelson County",3,0,151,81,70
050,51,125,"Virginia","Nelson County",3,1,140,75,65
050,51,125,"Virginia","Nelson County",3,2,144,68,76
050,51,125,"Virginia","Nelson County",3,3,144,72,72
050,51,125,"Virginia","Nelson County",3,4,126,71,55
050,51,125,"Virginia","Nelson County",3,5,118,66,52
050,51,125,"Virginia","Nelson County",3,6,133,73,60
050,51,125,"Virginia","Nelson County",3,7,136,61,75
050,51,125,"Virginia","Nelson County",3,8,129,58,71
050,51,125,"Virginia","Nelson County",3,9,131,72,59
050,51,125,"Virginia","Nelson County",3,10,134,69,65
050,51,125,"Virginia","Nelson County",3,11,151,76,75
050,51,125,"Virginia","Nelson County",3,12,152,78,74
050,51,125,"Virginia","Nelson County",3,13,157,78,79
050,51,125,"Virginia","Nelson County",3,14,165,90,75
050,51,125,"Virginia","Nelson County",3,15,156,81,75
050,51,125,"Virginia","Nelson County",3,16,158,84,74
050,51,125,"Virginia","Nelson County",3,17,175,95,80
050,51,125,"Virginia","Nelson County",3,18,149,79,70
050,51,125,"Virginia","Nelson County",3,19,116,66,50
050,51,125,"Virginia","Nelson County",3,20,113,60,53
050,51,125,"Virginia","Nelson County",3,21,136,68,68
050,51,125,"Virginia","Nelson County",3,22,151,73,78
050,51,125,"Virginia","Nelson County",3,23,143,69,74
050,51,125,"Virginia","Nelson County",3,24,122,62,60
050,51,125,"Virginia","Nelson County",3,25,124,63,61
050,51,125,"Virginia","Nelson County",3,26,125,62,63
050,51,125,"Virginia","Nelson County",3,27,129,68,61
050,51,125,"Virginia","Nelson County",3,28,128,69,59
050,51,125,"Virginia","Nelson County",3,29,137,67,70
050,51,125,"Virginia","Nelson County",3,30,136,64,72
050,51,125,"Virginia","Nelson County",3,31,146,72,74
050,51,125,"Virginia","Nelson County",3,32,143,66,77
050,51,125,"Virginia","Nelson County",3,33,150,73,77
050,51,125,"Virginia","Nelson County",3,34,142,67,75
050,51,125,"Virginia","Nelson County",3,35,143,70,73
050,51,125,"Virginia","Nelson County",3,36,147,73,74
050,51,125,"Virginia","Nelson County",3,37,134,69,65
050,51,125,"Virginia","Nelson County",3,38,160,80,80
050,51,125,"Virginia","Nelson County",3,39,155,75,80
050,51,125,"Virginia","Nelson County",3,40,163,80,83
050,51,125,"Virginia","Nelson County",3,41,175,75,100
050,51,125,"Virginia","Nelson County",3,42,143,70,73
050,51,125,"Virginia","Nelson County",3,43,157,75,82
050,51,125,"Virginia","Nelson County",3,44,159,80,79
050,51,125,"Virginia","Nelson County",3,45,142,68,74
050,51,125,"Virginia","Nelson County",3,46,148,70,78
050,51,125,"Virginia","Nelson County",3,47,147,71,76
050,51,125,"Virginia","Nelson County",3,48,167,85,82
050,51,125,"Virginia","Nelson County",3,49,178,94,84
050,51,125,"Virginia","Nelson County",3,50,190,103,87
050,51,125,"Virginia","Nelson County",3,51,177,83,94
050,51,125,"Virginia","Nelson County",3,52,188,99,89
050,51,125,"Virginia","Nelson County",3,53,185,96,89
050,51,125,"Virginia","Nelson County",3,54,195,99,96
050,51,125,"Virginia","Nelson County",3,55,204,101,103
050,51,125,"Virginia","Nelson County",3,56,212,97,115
050,51,125,"Virginia","Nelson County",3,57,238,113,125
050,51,125,"Virginia","Nelson County",3,58,239,110,129
050,51,125,"Virginia","Nelson County",3,59,244,119,125
050,51,125,"Virginia","Nelson County",3,60,259,130,129
050,51,125,"Virginia","Nelson County",3,61,244,118,126
050,51,125,"Virginia","Nelson County",3,62,247,124,123
050,51,125,"Virginia","Nelson County",3,63,281,139,142
050,51,125,"Virginia","Nelson County",3,64,267,124,143
050,51,125,"Virginia","Nelson County",3,65,270,134,136
050,51,125,"Virginia","Nelson County",3,66,268,133,135
050,51,125,"Virginia","Nelson County",3,67,277,130,147
050,51,125,"Virginia","Nelson County",3,68,285,132,153
050,51,125,"Virginia","Nelson County",3,69,265,115,150
050,51,125,"Virginia","Nelson County",3,70,270,132,138
050,51,125,"Virginia","Nelson County",3,71,255,114,141
050,51,125,"Virginia","Nelson County",3,72,272,131,141
050,51,125,"Virginia","Nelson County",3,73,272,134,138
050,51,125,"Virginia","Nelson County",3,74,269,138,131
050,51,125,"Virginia","Nelson County",3,75,162,82,80
050,51,125,"Virginia","Nelson County",3,76,158,75,83
050,51,125,"Virginia","Nelson County",3,77,167,86,81
050,51,125,"Virginia","Nelson County",3,78,154,82,72
050,51,125,"Virginia","Nelson County",3,79,126,59,67
050,51,125,"Virginia","Nelson County",3,80,120,54,66
050,51,125,"Virginia","Nelson County",3,81,99,46,53
050,51,125,"Virginia","Nelson County",3,82,98,48,50
050,51,125,"Virginia","Nelson County",3,83,74,32,42
050,51,125,"Virginia","Nelson County",3,84,69,36,33
050,51,125,"Virginia","Nelson County",3,85,330,119,211
050,51,125,"Virginia","Nelson County",4,0,167,88,79
050,51,125,"Virginia","Nelson County",4,1,132,72,60
050,51,125,"Virginia","Nelson County",4,2,144,75,69
050,51,125,"Virginia","Nelson County",4,3,146,68,78
050,51,125,"Virginia","Nelson County",4,4,139,67,72
050,51,125,"Virginia","Nelson County",4,5,131,70,61
050,51,125,"Virginia","Nelson County",4,6,116,65,51
050,51,125,"Virginia","Nelson County",4,7,145,79,66
050,51,125,"Virginia","Nelson County",4,8,143,58,85
050,51,125,"Virginia","Nelson County",4,9,128,62,66
050,51,125,"Virginia","Nelson County",4,10,125,67,58
050,51,125,"Virginia","Nelson County",4,11,130,67,63
050,51,125,"Virginia","Nelson County",4,12,149,74,75
050,51,125,"Virginia","Nelson County",4,13,149,77,72
050,51,125,"Virginia","Nelson County",4,14,152,73,79
050,51,125,"Virginia","Nelson County",4,15,164,89,75
050,51,125,"Virginia","Nelson County",4,16,147,74,73
050,51,125,"Virginia","Nelson County",4,17,162,86,76
050,51,125,"Virginia","Nelson County",4,18,144,82,62
050,51,125,"Virginia","Nelson County",4,19,119,65,54
050,51,125,"Virginia","Nelson County",4,20,118,67,51
050,51,125,"Virginia","Nelson County",4,21,119,65,54
050,51,125,"Virginia","Nelson County",4,22,146,71,75
050,51,125,"Virginia","Nelson County",4,23,138,69,69
050,51,125,"Virginia","Nelson County",4,24,130,59,71
050,51,125,"Virginia","Nelson County",4,25,114,64,50
050,51,125,"Virginia","Nelson County",4,26,126,58,68
050,51,125,"Virginia","Nelson County",4,27,120,65,55
050,51,125,"Virginia","Nelson County",4,28,124,64,60
050,51,125,"Virginia","Nelson County",4,29,135,66,69
050,51,125,"Virginia","Nelson County",4,30,148,75,73
050,51,125,"Virginia","Nelson County",4,31,136,66,70
050,51,125,"Virginia","Nelson County",4,32,143,72,71
050,51,125,"Virginia","Nelson County",4,33,146,72,74
050,51,125,"Virginia","Nelson County",4,34,151,75,76
050,51,125,"Virginia","Nelson County",4,35,149,71,78
050,51,125,"Virginia","Nelson County",4,36,141,70,71
050,51,125,"Virginia","Nelson County",4,37,146,72,74
050,51,125,"Virginia","Nelson County",4,38,142,68,74
050,51,125,"Virginia","Nelson County",4,39,155,74,81
050,51,125,"Virginia","Nelson County",4,40,148,72,76
050,51,125,"Virginia","Nelson County",4,41,154,75,79
050,51,125,"Virginia","Nelson County",4,42,177,77,100
050,51,125,"Virginia","Nelson County",4,43,139,65,74
050,51,125,"Virginia","Nelson County",4,44,146,66,80
050,51,125,"Virginia","Nelson County",4,45,162,82,80
050,51,125,"Virginia","Nelson County",4,46,134,64,70
050,51,125,"Virginia","Nelson County",4,47,151,73,78
050,51,125,"Virginia","Nelson County",4,48,149,68,81
050,51,125,"Virginia","Nelson County",4,49,154,79,75
050,51,125,"Virginia","Nelson County",4,50,170,88,82
050,51,125,"Virginia","Nelson County",4,51,199,107,92
050,51,125,"Virginia","Nelson County",4,52,184,85,99
050,51,125,"Virginia","Nelson County",4,53,191,96,95
050,51,125,"Virginia","Nelson County",4,54,181,95,86
050,51,125,"Virginia","Nelson County",4,55,199,104,95
050,51,125,"Virginia","Nelson County",4,56,209,105,104
050,51,125,"Virginia","Nelson County",4,57,224,102,122
050,51,125,"Virginia","Nelson County",4,58,236,114,122
050,51,125,"Virginia","Nelson County",4,59,240,112,128
050,51,125,"Virginia","Nelson County",4,60,248,120,128
050,51,125,"Virginia","Nelson County",4,61,259,124,135
050,51,125,"Virginia","Nelson County",4,62,239,114,125
050,51,125,"Virginia","Nelson County",4,63,260,128,132
050,51,125,"Virginia","Nelson County",4,64,284,143,141
050,51,125,"Virginia","Nelson County",4,65,269,122,147
050,51,125,"Virginia","Nelson County",4,66,270,131,139
050,51,125,"Virginia","Nelson County",4,67,267,133,134
050,51,125,"Virginia","Nelson County",4,68,275,130,145
050,51,125,"Virginia","Nelson County",4,69,279,126,153
050,51,125,"Virginia","Nelson County",4,70,264,115,149
050,51,125,"Virginia","Nelson County",4,71,256,123,133
050,51,125,"Virginia","Nelson County",4,72,245,110,135
050,51,125,"Virginia","Nelson County",4,73,261,124,137
050,51,125,"Virginia","Nelson County",4,74,267,132,135
050,51,125,"Virginia","Nelson County",4,75,257,138,119
050,51,125,"Virginia","Nelson County",4,76,157,79,78
050,51,125,"Virginia","Nelson County",4,77,153,74,79
050,51,125,"Virginia","Nelson County",4,78,154,80,74
050,51,125,"Virginia","Nelson County",4,79,153,77,76
050,51,125,"Virginia","Nelson County",4,80,113,53,60
050,51,125,"Virginia","Nelson County",4,81,111,49,62
050,51,125,"Virginia","Nelson County",4,82,87,40,47
050,51,125,"Virginia","Nelson County",4,83,91,44,47
050,51,125,"Virginia","Nelson County",4,84,68,27,41
050,51,125,"Virginia","Nelson County",4,85,354,129,225
050,51,125,"Virginia","Nelson County",5,0,166,87,79
050,51,125,"Virginia","Nelson County",5,1,164,82,82
050,51,125,"Virginia","Nelson County",5,2,127,74,53
050,51,125,"Virginia","Nelson County",5,3,131,71,60
050,51,125,"Virginia","Nelson County",5,4,147,65,82
050,51,125,"Virginia","Nelson County",5,5,141,70,71
050,51,125,"Virginia","Nelson County",5,6,131,72,59
050,51,125,"Virginia","Nelson County",5,7,110,60,50
050,51,125,"Virginia","Nelson County",5,8,148,81,67
050,51,125,"Virginia","Nelson County",5,9,140,58,82
050,51,125,"Virginia","Nelson County",5,10,128,64,64
050,51,125,"Virginia","Nelson County",5,11,133,73,60
050,51,125,"Virginia","Nelson County",5,12,133,69,64
050,51,125,"Virginia","Nelson County",5,13,157,81,76
050,51,125,"Virginia","Nelson County",5,14,154,83,71
050,51,125,"Virginia","Nelson County",5,15,158,73,85
050,51,125,"Virginia","Nelson County",5,16,166,89,77
050,51,125,"Virginia","Nelson County",5,17,154,79,75
050,51,125,"Virginia","Nelson County",5,18,138,74,64
050,51,125,"Virginia","Nelson County",5,19,113,64,49
050,51,125,"Virginia","Nelson County",5,20,126,67,59
050,51,125,"Virginia","Nelson County",5,21,122,67,55
050,51,125,"Virginia","Nelson County",5,22,120,62,58
050,51,125,"Virginia","Nelson County",5,23,135,73,62
050,51,125,"Virginia","Nelson County",5,24,129,64,65
050,51,125,"Virginia","Nelson County",5,25,120,56,64
050,51,125,"Virginia","Nelson County",5,26,103,54,49
050,51,125,"Virginia","Nelson County",5,27,122,55,67
050,51,125,"Virginia","Nelson County",5,28,109,60,49
050,51,125,"Virginia","Nelson County",5,29,126,66,60
050,51,125,"Virginia","Nelson County",5,30,146,71,75
050,51,125,"Virginia","Nelson County",5,31,140,71,69
050,51,125,"Virginia","Nelson County",5,32,137,67,70
050,51,125,"Virginia","Nelson County",5,33,152,77,75
050,51,125,"Virginia","Nelson County",5,34,149,79,70
050,51,125,"Virginia","Nelson County",5,35,152,70,82
050,51,125,"Virginia","Nelson County",5,36,151,73,78
050,51,125,"Virginia","Nelson County",5,37,147,69,78
050,51,125,"Virginia","Nelson County",5,38,148,69,79
050,51,125,"Virginia","Nelson County",5,39,135,63,72
050,51,125,"Virginia","Nelson County",5,40,154,74,80
050,51,125,"Virginia","Nelson County",5,41,152,72,80
050,51,125,"Virginia","Nelson County",5,42,152,71,81
050,51,125,"Virginia","Nelson County",5,43,172,72,100
050,51,125,"Virginia","Nelson County",5,44,139,64,75
050,51,125,"Virginia","Nelson County",5,45,152,71,81
050,51,125,"Virginia","Nelson County",5,46,155,80,75
050,51,125,"Virginia","Nelson County",5,47,141,66,75
050,51,125,"Virginia","Nelson County",5,48,146,69,77
050,51,125,"Virginia","Nelson County",5,49,142,64,78
050,51,125,"Virginia","Nelson County",5,50,155,77,78
050,51,125,"Virginia","Nelson County",5,51,178,91,87
050,51,125,"Virginia","Nelson County",5,52,200,109,91
050,51,125,"Virginia","Nelson County",5,53,181,87,94
050,51,125,"Virginia","Nelson County",5,54,199,104,95
050,51,125,"Virginia","Nelson County",5,55,183,97,86
050,51,125,"Virginia","Nelson County",5,56,202,107,95
050,51,125,"Virginia","Nelson County",5,57,203,99,104
050,51,125,"Virginia","Nelson County",5,58,221,100,121
050,51,125,"Virginia","Nelson County",5,59,230,109,121
050,51,125,"Virginia","Nelson County",5,60,243,111,132
050,51,125,"Virginia","Nelson County",5,61,251,123,128
050,51,125,"Virginia","Nelson County",5,62,260,120,140
050,51,125,"Virginia","Nelson County",5,63,246,115,131
050,51,125,"Virginia","Nelson County",5,64,264,131,133
050,51,125,"Virginia","Nelson County",5,65,287,140,147
050,51,125,"Virginia","Nelson County",5,66,262,117,145
050,51,125,"Virginia","Nelson County",5,67,268,128,140
050,51,125,"Virginia","Nelson County",5,68,259,129,130
050,51,125,"Virginia","Nelson County",5,69,269,127,142
050,51,125,"Virginia","Nelson County",5,70,279,125,154
050,51,125,"Virginia","Nelson County",5,71,256,106,150
050,51,125,"Virginia","Nelson County",5,72,249,120,129
050,51,125,"Virginia","Nelson County",5,73,238,104,134
050,51,125,"Virginia","Nelson County",5,74,255,124,131
050,51,125,"Virginia","Nelson County",5,75,255,130,125
050,51,125,"Virginia","Nelson County",5,76,248,134,114
050,51,125,"Virginia","Nelson County",5,77,149,75,74
050,51,125,"Virginia","Nelson County",5,78,150,73,77
050,51,125,"Virginia","Nelson County",5,79,156,78,78
050,51,125,"Virginia","Nelson County",5,80,144,71,73
050,51,125,"Virginia","Nelson County",5,81,105,48,57
050,51,125,"Virginia","Nelson County",5,82,103,45,58
050,51,125,"Virginia","Nelson County",5,83,83,39,44
050,51,125,"Virginia","Nelson County",5,84,84,40,44
050,51,125,"Virginia","Nelson County",5,85,377,135,242
050,51,127,"Virginia","New Kent County",1,0,209,107,102
050,51,127,"Virginia","New Kent County",1,1,216,103,113
050,51,127,"Virginia","New Kent County",1,2,231,114,117
050,51,127,"Virginia","New Kent County",1,3,222,110,112
050,51,127,"Virginia","New Kent County",1,4,244,120,124
050,51,127,"Virginia","New Kent County",1,5,230,125,105
050,51,127,"Virginia","New Kent County",1,6,232,125,107
050,51,127,"Virginia","New Kent County",1,7,258,124,134
050,51,127,"Virginia","New Kent County",1,8,267,126,141
050,51,127,"Virginia","New Kent County",1,9,248,127,121
050,51,127,"Virginia","New Kent County",1,10,249,122,127
050,51,127,"Virginia","New Kent County",1,11,256,143,113
050,51,127,"Virginia","New Kent County",1,12,281,156,125
050,51,127,"Virginia","New Kent County",1,13,287,150,137
050,51,127,"Virginia","New Kent County",1,14,283,145,138
050,51,127,"Virginia","New Kent County",1,15,260,136,124
050,51,127,"Virginia","New Kent County",1,16,257,131,126
050,51,127,"Virginia","New Kent County",1,17,242,119,123
050,51,127,"Virginia","New Kent County",1,18,206,117,89
050,51,127,"Virginia","New Kent County",1,19,204,117,87
050,51,127,"Virginia","New Kent County",1,20,211,118,93
050,51,127,"Virginia","New Kent County",1,21,213,121,92
050,51,127,"Virginia","New Kent County",1,22,209,125,84
050,51,127,"Virginia","New Kent County",1,23,245,144,101
050,51,127,"Virginia","New Kent County",1,24,282,161,121
050,51,127,"Virginia","New Kent County",1,25,302,165,137
050,51,127,"Virginia","New Kent County",1,26,295,153,142
050,51,127,"Virginia","New Kent County",1,27,294,163,131
050,51,127,"Virginia","New Kent County",1,28,290,166,124
050,51,127,"Virginia","New Kent County",1,29,298,168,130
050,51,127,"Virginia","New Kent County",1,30,299,173,126
050,51,127,"Virginia","New Kent County",1,31,296,148,148
050,51,127,"Virginia","New Kent County",1,32,315,163,152
050,51,127,"Virginia","New Kent County",1,33,311,170,141
050,51,127,"Virginia","New Kent County",1,34,312,162,150
050,51,127,"Virginia","New Kent County",1,35,310,165,145
050,51,127,"Virginia","New Kent County",1,36,298,166,132
050,51,127,"Virginia","New Kent County",1,37,300,153,147
050,51,127,"Virginia","New Kent County",1,38,299,142,157
050,51,127,"Virginia","New Kent County",1,39,317,167,150
050,51,127,"Virginia","New Kent County",1,40,281,153,128
050,51,127,"Virginia","New Kent County",1,41,289,148,141
050,51,127,"Virginia","New Kent County",1,42,274,143,131
050,51,127,"Virginia","New Kent County",1,43,291,152,139
050,51,127,"Virginia","New Kent County",1,44,294,154,140
050,51,127,"Virginia","New Kent County",1,45,298,151,147
050,51,127,"Virginia","New Kent County",1,46,295,157,138
050,51,127,"Virginia","New Kent County",1,47,297,155,142
050,51,127,"Virginia","New Kent County",1,48,307,152,155
050,51,127,"Virginia","New Kent County",1,49,366,199,167
050,51,127,"Virginia","New Kent County",1,50,357,180,177
050,51,127,"Virginia","New Kent County",1,51,318,174,144
050,51,127,"Virginia","New Kent County",1,52,314,160,154
050,51,127,"Virginia","New Kent County",1,53,322,166,156
050,51,127,"Virginia","New Kent County",1,54,345,164,181
050,51,127,"Virginia","New Kent County",1,55,362,195,167
050,51,127,"Virginia","New Kent County",1,56,366,192,174
050,51,127,"Virginia","New Kent County",1,57,358,176,182
050,51,127,"Virginia","New Kent County",1,58,390,197,193
050,51,127,"Virginia","New Kent County",1,59,394,209,185
050,51,127,"Virginia","New Kent County",1,60,370,185,185
050,51,127,"Virginia","New Kent County",1,61,345,170,175
050,51,127,"Virginia","New Kent County",1,62,381,178,203
050,51,127,"Virginia","New Kent County",1,63,337,159,178
050,51,127,"Virginia","New Kent County",1,64,331,162,169
050,51,127,"Virginia","New Kent County",1,65,367,181,186
050,51,127,"Virginia","New Kent County",1,66,314,162,152
050,51,127,"Virginia","New Kent County",1,67,290,137,153
050,51,127,"Virginia","New Kent County",1,68,281,138,143
050,51,127,"Virginia","New Kent County",1,69,271,136,135
050,51,127,"Virginia","New Kent County",1,70,278,133,145
050,51,127,"Virginia","New Kent County",1,71,280,131,149
050,51,127,"Virginia","New Kent County",1,72,280,141,139
050,51,127,"Virginia","New Kent County",1,73,256,134,122
050,51,127,"Virginia","New Kent County",1,74,180,88,92
050,51,127,"Virginia","New Kent County",1,75,173,81,92
050,51,127,"Virginia","New Kent County",1,76,158,85,73
050,51,127,"Virginia","New Kent County",1,77,145,74,71
050,51,127,"Virginia","New Kent County",1,78,115,62,53
050,51,127,"Virginia","New Kent County",1,79,113,58,55
050,51,127,"Virginia","New Kent County",1,80,91,44,47
050,51,127,"Virginia","New Kent County",1,81,67,32,35
050,51,127,"Virginia","New Kent County",1,82,73,35,38
050,51,127,"Virginia","New Kent County",1,83,73,33,40
050,51,127,"Virginia","New Kent County",1,84,50,19,31
050,51,127,"Virginia","New Kent County",1,85,229,86,143
050,51,127,"Virginia","New Kent County",2,0,216,104,112
050,51,127,"Virginia","New Kent County",2,1,220,107,113
050,51,127,"Virginia","New Kent County",2,2,229,112,117
050,51,127,"Virginia","New Kent County",2,3,225,111,114
050,51,127,"Virginia","New Kent County",2,4,242,120,122
050,51,127,"Virginia","New Kent County",2,5,235,126,109
050,51,127,"Virginia","New Kent County",2,6,233,126,107
050,51,127,"Virginia","New Kent County",2,7,257,127,130
050,51,127,"Virginia","New Kent County",2,8,265,128,137
050,51,127,"Virginia","New Kent County",2,9,253,128,125
050,51,127,"Virginia","New Kent County",2,10,249,124,125
050,51,127,"Virginia","New Kent County",2,11,255,136,119
050,51,127,"Virginia","New Kent County",2,12,275,150,125
050,51,127,"Virginia","New Kent County",2,13,287,151,136
050,51,127,"Virginia","New Kent County",2,14,282,145,137
050,51,127,"Virginia","New Kent County",2,15,266,139,127
050,51,127,"Virginia","New Kent County",2,16,256,131,125
050,51,127,"Virginia","New Kent County",2,17,243,120,123
050,51,127,"Virginia","New Kent County",2,18,208,115,93
050,51,127,"Virginia","New Kent County",2,19,202,116,86
050,51,127,"Virginia","New Kent County",2,20,215,121,94
050,51,127,"Virginia","New Kent County",2,21,216,122,94
050,51,127,"Virginia","New Kent County",2,22,221,131,90
050,51,127,"Virginia","New Kent County",2,23,246,146,100
050,51,127,"Virginia","New Kent County",2,24,282,163,119
050,51,127,"Virginia","New Kent County",2,25,303,168,135
050,51,127,"Virginia","New Kent County",2,26,303,159,144
050,51,127,"Virginia","New Kent County",2,27,299,164,135
050,51,127,"Virginia","New Kent County",2,28,300,171,129
050,51,127,"Virginia","New Kent County",2,29,299,170,129
050,51,127,"Virginia","New Kent County",2,30,304,176,128
050,51,127,"Virginia","New Kent County",2,31,293,150,143
050,51,127,"Virginia","New Kent County",2,32,316,163,153
050,51,127,"Virginia","New Kent County",2,33,309,166,143
050,51,127,"Virginia","New Kent County",2,34,314,164,150
050,51,127,"Virginia","New Kent County",2,35,313,167,146
050,51,127,"Virginia","New Kent County",2,36,299,166,133
050,51,127,"Virginia","New Kent County",2,37,302,158,144
050,51,127,"Virginia","New Kent County",2,38,305,148,157
050,51,127,"Virginia","New Kent County",2,39,314,163,151
050,51,127,"Virginia","New Kent County",2,40,292,158,134
050,51,127,"Virginia","New Kent County",2,41,291,150,141
050,51,127,"Virginia","New Kent County",2,42,277,145,132
050,51,127,"Virginia","New Kent County",2,43,287,151,136
050,51,127,"Virginia","New Kent County",2,44,290,152,138
050,51,127,"Virginia","New Kent County",2,45,305,156,149
050,51,127,"Virginia","New Kent County",2,46,296,156,140
050,51,127,"Virginia","New Kent County",2,47,299,157,142
050,51,127,"Virginia","New Kent County",2,48,306,153,153
050,51,127,"Virginia","New Kent County",2,49,362,194,168
050,51,127,"Virginia","New Kent County",2,50,359,184,175
050,51,127,"Virginia","New Kent County",2,51,328,176,152
050,51,127,"Virginia","New Kent County",2,52,314,163,151
050,51,127,"Virginia","New Kent County",2,53,322,165,157
050,51,127,"Virginia","New Kent County",2,54,340,164,176
050,51,127,"Virginia","New Kent County",2,55,358,187,171
050,51,127,"Virginia","New Kent County",2,56,366,193,173
050,51,127,"Virginia","New Kent County",2,57,364,182,182
050,51,127,"Virginia","New Kent County",2,58,384,193,191
050,51,127,"Virginia","New Kent County",2,59,399,209,190
050,51,127,"Virginia","New Kent County",2,60,380,194,186
050,51,127,"Virginia","New Kent County",2,61,350,172,178
050,51,127,"Virginia","New Kent County",2,62,371,175,196
050,51,127,"Virginia","New Kent County",2,63,349,165,184
050,51,127,"Virginia","New Kent County",2,64,330,161,169
050,51,127,"Virginia","New Kent County",2,65,360,178,182
050,51,127,"Virginia","New Kent County",2,66,325,166,159
050,51,127,"Virginia","New Kent County",2,67,296,144,152
050,51,127,"Virginia","New Kent County",2,68,280,136,144
050,51,127,"Virginia","New Kent County",2,69,279,140,139
050,51,127,"Virginia","New Kent County",2,70,278,135,143
050,51,127,"Virginia","New Kent County",2,71,280,132,148
050,51,127,"Virginia","New Kent County",2,72,277,137,140
050,51,127,"Virginia","New Kent County",2,73,276,142,134
050,51,127,"Virginia","New Kent County",2,74,186,92,94
050,51,127,"Virginia","New Kent County",2,75,173,81,92
050,51,127,"Virginia","New Kent County",2,76,161,83,78
050,51,127,"Virginia","New Kent County",2,77,148,76,72
050,51,127,"Virginia","New Kent County",2,78,123,65,58
050,51,127,"Virginia","New Kent County",2,79,114,59,55
050,51,127,"Virginia","New Kent County",2,80,94,46,48
050,51,127,"Virginia","New Kent County",2,81,73,35,38
050,51,127,"Virginia","New Kent County",2,82,73,34,39
050,51,127,"Virginia","New Kent County",2,83,70,33,37
050,51,127,"Virginia","New Kent County",2,84,55,22,33
050,51,127,"Virginia","New Kent County",2,85,232,85,147
050,51,127,"Virginia","New Kent County",3,0,235,118,117
050,51,127,"Virginia","New Kent County",3,1,241,122,119
050,51,127,"Virginia","New Kent County",3,2,234,113,121
050,51,127,"Virginia","New Kent County",3,3,244,120,124
050,51,127,"Virginia","New Kent County",3,4,246,133,113
050,51,127,"Virginia","New Kent County",3,5,253,122,131
050,51,127,"Virginia","New Kent County",3,6,256,139,117
050,51,127,"Virginia","New Kent County",3,7,244,133,111
050,51,127,"Virginia","New Kent County",3,8,257,126,131
050,51,127,"Virginia","New Kent County",3,9,253,117,136
050,51,127,"Virginia","New Kent County",3,10,258,132,126
050,51,127,"Virginia","New Kent County",3,11,262,131,131
050,51,127,"Virginia","New Kent County",3,12,258,138,120
050,51,127,"Virginia","New Kent County",3,13,282,156,126
050,51,127,"Virginia","New Kent County",3,14,284,150,134
050,51,127,"Virginia","New Kent County",3,15,290,153,137
050,51,127,"Virginia","New Kent County",3,16,280,151,129
050,51,127,"Virginia","New Kent County",3,17,261,136,125
050,51,127,"Virginia","New Kent County",3,18,221,118,103
050,51,127,"Virginia","New Kent County",3,19,176,96,80
050,51,127,"Virginia","New Kent County",3,20,216,129,87
050,51,127,"Virginia","New Kent County",3,21,214,118,96
050,51,127,"Virginia","New Kent County",3,22,237,133,104
050,51,127,"Virginia","New Kent County",3,23,242,147,95
050,51,127,"Virginia","New Kent County",3,24,270,168,102
050,51,127,"Virginia","New Kent County",3,25,292,170,122
050,51,127,"Virginia","New Kent County",3,26,316,177,139
050,51,127,"Virginia","New Kent County",3,27,330,178,152
050,51,127,"Virginia","New Kent County",3,28,330,178,152
050,51,127,"Virginia","New Kent County",3,29,332,182,150
050,51,127,"Virginia","New Kent County",3,30,337,182,155
050,51,127,"Virginia","New Kent County",3,31,326,185,141
050,51,127,"Virginia","New Kent County",3,32,329,180,149
050,51,127,"Virginia","New Kent County",3,33,335,169,166
050,51,127,"Virginia","New Kent County",3,34,334,181,153
050,51,127,"Virginia","New Kent County",3,35,355,200,155
050,51,127,"Virginia","New Kent County",3,36,328,176,152
050,51,127,"Virginia","New Kent County",3,37,314,169,145
050,51,127,"Virginia","New Kent County",3,38,324,174,150
050,51,127,"Virginia","New Kent County",3,39,326,155,171
050,51,127,"Virginia","New Kent County",3,40,314,161,153
050,51,127,"Virginia","New Kent County",3,41,311,168,143
050,51,127,"Virginia","New Kent County",3,42,284,137,147
050,51,127,"Virginia","New Kent County",3,43,282,143,139
050,51,127,"Virginia","New Kent County",3,44,300,162,138
050,51,127,"Virginia","New Kent County",3,45,324,180,144
050,51,127,"Virginia","New Kent County",3,46,319,159,160
050,51,127,"Virginia","New Kent County",3,47,291,154,137
050,51,127,"Virginia","New Kent County",3,48,303,157,146
050,51,127,"Virginia","New Kent County",3,49,338,171,167
050,51,127,"Virginia","New Kent County",3,50,361,193,168
050,51,127,"Virginia","New Kent County",3,51,373,195,178
050,51,127,"Virginia","New Kent County",3,52,336,183,153
050,51,127,"Virginia","New Kent County",3,53,323,167,156
050,51,127,"Virginia","New Kent County",3,54,328,163,165
050,51,127,"Virginia","New Kent County",3,55,342,162,180
050,51,127,"Virginia","New Kent County",3,56,379,194,185
050,51,127,"Virginia","New Kent County",3,57,373,188,185
050,51,127,"Virginia","New Kent County",3,58,375,188,187
050,51,127,"Virginia","New Kent County",3,59,388,193,195
050,51,127,"Virginia","New Kent County",3,60,391,205,186
050,51,127,"Virginia","New Kent County",3,61,382,194,188
050,51,127,"Virginia","New Kent County",3,62,349,181,168
050,51,127,"Virginia","New Kent County",3,63,369,170,199
050,51,127,"Virginia","New Kent County",3,64,342,159,183
050,51,127,"Virginia","New Kent County",3,65,342,162,180
050,51,127,"Virginia","New Kent County",3,66,366,186,180
050,51,127,"Virginia","New Kent County",3,67,314,160,154
050,51,127,"Virginia","New Kent County",3,68,300,141,159
050,51,127,"Virginia","New Kent County",3,69,280,135,145
050,51,127,"Virginia","New Kent County",3,70,270,135,135
050,51,127,"Virginia","New Kent County",3,71,273,135,138
050,51,127,"Virginia","New Kent County",3,72,278,131,147
050,51,127,"Virginia","New Kent County",3,73,269,131,138
050,51,127,"Virginia","New Kent County",3,74,266,136,130
050,51,127,"Virginia","New Kent County",3,75,168,80,88
050,51,127,"Virginia","New Kent County",3,76,171,81,90
050,51,127,"Virginia","New Kent County",3,77,154,80,74
050,51,127,"Virginia","New Kent County",3,78,140,74,66
050,51,127,"Virginia","New Kent County",3,79,120,61,59
050,51,127,"Virginia","New Kent County",3,80,113,55,58
050,51,127,"Virginia","New Kent County",3,81,91,44,47
050,51,127,"Virginia","New Kent County",3,82,66,33,33
050,51,127,"Virginia","New Kent County",3,83,65,28,37
050,51,127,"Virginia","New Kent County",3,84,65,29,36
050,51,127,"Virginia","New Kent County",3,85,253,101,152
050,51,127,"Virginia","New Kent County",4,0,250,123,127
050,51,127,"Virginia","New Kent County",4,1,258,129,129
050,51,127,"Virginia","New Kent County",4,2,279,144,135
050,51,127,"Virginia","New Kent County",4,3,273,136,137
050,51,127,"Virginia","New Kent County",4,4,255,128,127
050,51,127,"Virginia","New Kent County",4,5,255,134,121
050,51,127,"Virginia","New Kent County",4,6,277,133,144
050,51,127,"Virginia","New Kent County",4,7,275,150,125
050,51,127,"Virginia","New Kent County",4,8,254,141,113
050,51,127,"Virginia","New Kent County",4,9,274,136,138
050,51,127,"Virginia","New Kent County",4,10,275,129,146
050,51,127,"Virginia","New Kent County",4,11,266,137,129
050,51,127,"Virginia","New Kent County",4,12,262,130,132
050,51,127,"Virginia","New Kent County",4,13,268,144,124
050,51,127,"Virginia","New Kent County",4,14,288,157,131
050,51,127,"Virginia","New Kent County",4,15,306,164,142
050,51,127,"Virginia","New Kent County",4,16,291,151,140
050,51,127,"Virginia","New Kent County",4,17,275,151,124
050,51,127,"Virginia","New Kent County",4,18,214,119,95
050,51,127,"Virginia","New Kent County",4,19,188,107,81
050,51,127,"Virginia","New Kent County",4,20,181,97,84
050,51,127,"Virginia","New Kent County",4,21,225,139,86
050,51,127,"Virginia","New Kent County",4,22,248,150,98
050,51,127,"Virginia","New Kent County",4,23,256,150,106
050,51,127,"Virginia","New Kent County",4,24,258,155,103
050,51,127,"Virginia","New Kent County",4,25,281,174,107
050,51,127,"Virginia","New Kent County",4,26,312,171,141
050,51,127,"Virginia","New Kent County",4,27,353,189,164
050,51,127,"Virginia","New Kent County",4,28,361,191,170
050,51,127,"Virginia","New Kent County",4,29,351,187,164
050,51,127,"Virginia","New Kent County",4,30,359,210,149
050,51,127,"Virginia","New Kent County",4,31,352,179,173
050,51,127,"Virginia","New Kent County",4,32,388,231,157
050,51,127,"Virginia","New Kent County",4,33,356,192,164
050,51,127,"Virginia","New Kent County",4,34,355,175,180
050,51,127,"Virginia","New Kent County",4,35,378,201,177
050,51,127,"Virginia","New Kent County",4,36,367,202,165
050,51,127,"Virginia","New Kent County",4,37,341,180,161
050,51,127,"Virginia","New Kent County",4,38,351,192,159
050,51,127,"Virginia","New Kent County",4,39,343,181,162
050,51,127,"Virginia","New Kent County",4,40,330,151,179
050,51,127,"Virginia","New Kent County",4,41,339,179,160
050,51,127,"Virginia","New Kent County",4,42,337,177,160
050,51,127,"Virginia","New Kent County",4,43,286,142,144
050,51,127,"Virginia","New Kent County",4,44,283,137,146
050,51,127,"Virginia","New Kent County",4,45,334,184,150
050,51,127,"Virginia","New Kent County",4,46,327,176,151
050,51,127,"Virginia","New Kent County",4,47,333,175,158
050,51,127,"Virginia","New Kent County",4,48,294,154,140
050,51,127,"Virginia","New Kent County",4,49,315,163,152
050,51,127,"Virginia","New Kent County",4,50,334,167,167
050,51,127,"Virginia","New Kent County",4,51,377,209,168
050,51,127,"Virginia","New Kent County",4,52,360,192,168
050,51,127,"Virginia","New Kent County",4,53,349,190,159
050,51,127,"Virginia","New Kent County",4,54,320,172,148
050,51,127,"Virginia","New Kent County",4,55,337,168,169
050,51,127,"Virginia","New Kent County",4,56,353,168,185
050,51,127,"Virginia","New Kent County",4,57,397,198,199
050,51,127,"Virginia","New Kent County",4,58,376,190,186
050,51,127,"Virginia","New Kent County",4,59,381,191,190
050,51,127,"Virginia","New Kent County",4,60,407,205,202
050,51,127,"Virginia","New Kent County",4,61,380,203,177
050,51,127,"Virginia","New Kent County",4,62,382,198,184
050,51,127,"Virginia","New Kent County",4,63,344,173,171
050,51,127,"Virginia","New Kent County",4,64,377,172,205
050,51,127,"Virginia","New Kent County",4,65,347,168,179
050,51,127,"Virginia","New Kent County",4,66,361,165,196
050,51,127,"Virginia","New Kent County",4,67,361,187,174
050,51,127,"Virginia","New Kent County",4,68,305,158,147
050,51,127,"Virginia","New Kent County",4,69,301,139,162
050,51,127,"Virginia","New Kent County",4,70,275,131,144
050,51,127,"Virginia","New Kent County",4,71,266,136,130
050,51,127,"Virginia","New Kent County",4,72,263,128,135
050,51,127,"Virginia","New Kent County",4,73,270,125,145
050,51,127,"Virginia","New Kent County",4,74,263,121,142
050,51,127,"Virginia","New Kent County",4,75,250,121,129
050,51,127,"Virginia","New Kent County",4,76,166,80,86
050,51,127,"Virginia","New Kent County",4,77,168,81,87
050,51,127,"Virginia","New Kent County",4,78,147,76,71
050,51,127,"Virginia","New Kent County",4,79,132,65,67
050,51,127,"Virginia","New Kent County",4,80,118,61,57
050,51,127,"Virginia","New Kent County",4,81,107,55,52
050,51,127,"Virginia","New Kent County",4,82,83,38,45
050,51,127,"Virginia","New Kent County",4,83,64,32,32
050,51,127,"Virginia","New Kent County",4,84,68,27,41
050,51,127,"Virginia","New Kent County",4,85,286,120,166
050,51,127,"Virginia","New Kent County",5,0,247,121,126
050,51,127,"Virginia","New Kent County",5,1,266,131,135
050,51,127,"Virginia","New Kent County",5,2,290,150,140
050,51,127,"Virginia","New Kent County",5,3,300,161,139
050,51,127,"Virginia","New Kent County",5,4,277,134,143
050,51,127,"Virginia","New Kent County",5,5,265,142,123
050,51,127,"Virginia","New Kent County",5,6,270,145,125
050,51,127,"Virginia","New Kent County",5,7,312,151,161
050,51,127,"Virginia","New Kent County",5,8,292,159,133
050,51,127,"Virginia","New Kent County",5,9,269,152,117
050,51,127,"Virginia","New Kent County",5,10,279,141,138
050,51,127,"Virginia","New Kent County",5,11,289,141,148
050,51,127,"Virginia","New Kent County",5,12,284,138,146
050,51,127,"Virginia","New Kent County",5,13,263,122,141
050,51,127,"Virginia","New Kent County",5,14,281,148,133
050,51,127,"Virginia","New Kent County",5,15,304,165,139
050,51,127,"Virginia","New Kent County",5,16,305,164,141
050,51,127,"Virginia","New Kent County",5,17,294,151,143
050,51,127,"Virginia","New Kent County",5,18,241,142,99
050,51,127,"Virginia","New Kent County",5,19,191,111,80
050,51,127,"Virginia","New Kent County",5,20,211,122,89
050,51,127,"Virginia","New Kent County",5,21,193,103,90
050,51,127,"Virginia","New Kent County",5,22,259,159,100
050,51,127,"Virginia","New Kent County",5,23,277,175,102
050,51,127,"Virginia","New Kent County",5,24,302,187,115
050,51,127,"Virginia","New Kent County",5,25,288,164,124
050,51,127,"Virginia","New Kent County",5,26,309,179,130
050,51,127,"Virginia","New Kent County",5,27,339,182,157
050,51,127,"Virginia","New Kent County",5,28,388,208,180
050,51,127,"Virginia","New Kent County",5,29,377,185,192
050,51,127,"Virginia","New Kent County",5,30,377,206,171
050,51,127,"Virginia","New Kent County",5,31,398,235,163
050,51,127,"Virginia","New Kent County",5,32,398,212,186
050,51,127,"Virginia","New Kent County",5,33,405,235,170
050,51,127,"Virginia","New Kent County",5,34,375,204,171
050,51,127,"Virginia","New Kent County",5,35,385,205,180
050,51,127,"Virginia","New Kent County",5,36,379,198,181
050,51,127,"Virginia","New Kent County",5,37,385,203,182
050,51,127,"Virginia","New Kent County",5,38,356,186,170
050,51,127,"Virginia","New Kent County",5,39,350,191,159
050,51,127,"Virginia","New Kent County",5,40,352,181,171
050,51,127,"Virginia","New Kent County",5,41,366,174,192
050,51,127,"Virginia","New Kent County",5,42,355,187,168
050,51,127,"Virginia","New Kent County",5,43,347,180,167
050,51,127,"Virginia","New Kent County",5,44,295,145,150
050,51,127,"Virginia","New Kent County",5,45,317,157,160
050,51,127,"Virginia","New Kent County",5,46,334,183,151
050,51,127,"Virginia","New Kent County",5,47,321,167,154
050,51,127,"Virginia","New Kent County",5,48,333,163,170
050,51,127,"Virginia","New Kent County",5,49,325,185,140
050,51,127,"Virginia","New Kent County",5,50,310,158,152
050,51,127,"Virginia","New Kent County",5,51,357,175,182
050,51,127,"Virginia","New Kent County",5,52,387,211,176
050,51,127,"Virginia","New Kent County",5,53,382,203,179
050,51,127,"Virginia","New Kent County",5,54,346,186,160
050,51,127,"Virginia","New Kent County",5,55,327,174,153
050,51,127,"Virginia","New Kent County",5,56,360,183,177
050,51,127,"Virginia","New Kent County",5,57,368,170,198
050,51,127,"Virginia","New Kent County",5,58,400,206,194
050,51,127,"Virginia","New Kent County",5,59,392,195,197
050,51,127,"Virginia","New Kent County",5,60,403,202,201
050,51,127,"Virginia","New Kent County",5,61,400,196,204
050,51,127,"Virginia","New Kent County",5,62,393,203,190
050,51,127,"Virginia","New Kent County",5,63,396,203,193
050,51,127,"Virginia","New Kent County",5,64,353,175,178
050,51,127,"Virginia","New Kent County",5,65,402,180,222
050,51,127,"Virginia","New Kent County",5,66,349,174,175
050,51,127,"Virginia","New Kent County",5,67,364,167,197
050,51,127,"Virginia","New Kent County",5,68,359,181,178
050,51,127,"Virginia","New Kent County",5,69,319,163,156
050,51,127,"Virginia","New Kent County",5,70,311,143,168
050,51,127,"Virginia","New Kent County",5,71,282,135,147
050,51,127,"Virginia","New Kent County",5,72,268,138,130
050,51,127,"Virginia","New Kent County",5,73,255,124,131
050,51,127,"Virginia","New Kent County",5,74,262,120,142
050,51,127,"Virginia","New Kent County",5,75,251,106,145
050,51,127,"Virginia","New Kent County",5,76,245,119,126
050,51,127,"Virginia","New Kent County",5,77,165,78,87
050,51,127,"Virginia","New Kent County",5,78,159,77,82
050,51,127,"Virginia","New Kent County",5,79,151,77,74
050,51,127,"Virginia","New Kent County",5,80,137,66,71
050,51,127,"Virginia","New Kent County",5,81,113,59,54
050,51,127,"Virginia","New Kent County",5,82,97,50,47
050,51,127,"Virginia","New Kent County",5,83,84,40,44
050,51,127,"Virginia","New Kent County",5,84,64,30,34
050,51,127,"Virginia","New Kent County",5,85,308,124,184
050,51,131,"Virginia","Northampton County",1,0,117,62,55
050,51,131,"Virginia","Northampton County",1,1,123,70,53
050,51,131,"Virginia","Northampton County",1,2,136,77,59
050,51,131,"Virginia","Northampton County",1,3,114,55,59
050,51,131,"Virginia","Northampton County",1,4,121,58,63
050,51,131,"Virginia","Northampton County",1,5,116,56,60
050,51,131,"Virginia","Northampton County",1,6,134,79,55
050,51,131,"Virginia","Northampton County",1,7,122,68,54
050,51,131,"Virginia","Northampton County",1,8,142,74,68
050,51,131,"Virginia","Northampton County",1,9,154,80,74
050,51,131,"Virginia","Northampton County",1,10,134,77,57
050,51,131,"Virginia","Northampton County",1,11,145,86,59
050,51,131,"Virginia","Northampton County",1,12,139,78,61
050,51,131,"Virginia","Northampton County",1,13,133,67,66
050,51,131,"Virginia","Northampton County",1,14,142,70,72
050,51,131,"Virginia","Northampton County",1,15,143,63,80
050,51,131,"Virginia","Northampton County",1,16,143,74,69
050,51,131,"Virginia","Northampton County",1,17,126,57,69
050,51,131,"Virginia","Northampton County",1,18,104,54,50
050,51,131,"Virginia","Northampton County",1,19,107,59,48
050,51,131,"Virginia","Northampton County",1,20,106,59,47
050,51,131,"Virginia","Northampton County",1,21,104,62,42
050,51,131,"Virginia","Northampton County",1,22,95,47,48
050,51,131,"Virginia","Northampton County",1,23,105,47,58
050,51,131,"Virginia","Northampton County",1,24,113,57,56
050,51,131,"Virginia","Northampton County",1,25,108,51,57
050,51,131,"Virginia","Northampton County",1,26,106,57,49
050,51,131,"Virginia","Northampton County",1,27,116,53,63
050,51,131,"Virginia","Northampton County",1,28,123,67,56
050,51,131,"Virginia","Northampton County",1,29,137,69,68
050,51,131,"Virginia","Northampton County",1,30,127,63,64
050,51,131,"Virginia","Northampton County",1,31,129,69,60
050,51,131,"Virginia","Northampton County",1,32,115,63,52
050,51,131,"Virginia","Northampton County",1,33,127,55,72
050,51,131,"Virginia","Northampton County",1,34,121,56,65
050,51,131,"Virginia","Northampton County",1,35,133,66,67
050,51,131,"Virginia","Northampton County",1,36,125,70,55
050,51,131,"Virginia","Northampton County",1,37,122,60,62
050,51,131,"Virginia","Northampton County",1,38,109,44,65
050,51,131,"Virginia","Northampton County",1,39,108,55,53
050,51,131,"Virginia","Northampton County",1,40,96,46,50
050,51,131,"Virginia","Northampton County",1,41,124,57,67
050,51,131,"Virginia","Northampton County",1,42,108,52,56
050,51,131,"Virginia","Northampton County",1,43,106,50,56
050,51,131,"Virginia","Northampton County",1,44,95,57,38
050,51,131,"Virginia","Northampton County",1,45,101,51,50
050,51,131,"Virginia","Northampton County",1,46,102,41,61
050,51,131,"Virginia","Northampton County",1,47,114,49,65
050,51,131,"Virginia","Northampton County",1,48,143,65,78
050,51,131,"Virginia","Northampton County",1,49,133,70,63
050,51,131,"Virginia","Northampton County",1,50,133,63,70
050,51,131,"Virginia","Northampton County",1,51,136,65,71
050,51,131,"Virginia","Northampton County",1,52,129,64,65
050,51,131,"Virginia","Northampton County",1,53,141,69,72
050,51,131,"Virginia","Northampton County",1,54,142,68,74
050,51,131,"Virginia","Northampton County",1,55,161,68,93
050,51,131,"Virginia","Northampton County",1,56,186,78,108
050,51,131,"Virginia","Northampton County",1,57,199,76,123
050,51,131,"Virginia","Northampton County",1,58,193,81,112
050,51,131,"Virginia","Northampton County",1,59,221,115,106
050,51,131,"Virginia","Northampton County",1,60,242,117,125
050,51,131,"Virginia","Northampton County",1,61,245,93,152
050,51,131,"Virginia","Northampton County",1,62,225,103,122
050,51,131,"Virginia","Northampton County",1,63,246,120,126
050,51,131,"Virginia","Northampton County",1,64,229,109,120
050,51,131,"Virginia","Northampton County",1,65,221,95,126
050,51,131,"Virginia","Northampton County",1,66,235,108,127
050,51,131,"Virginia","Northampton County",1,67,209,100,109
050,51,131,"Virginia","Northampton County",1,68,202,99,103
050,51,131,"Virginia","Northampton County",1,69,194,88,106
050,51,131,"Virginia","Northampton County",1,70,201,91,110
050,51,131,"Virginia","Northampton County",1,71,193,86,107
050,51,131,"Virginia","Northampton County",1,72,178,81,97
050,51,131,"Virginia","Northampton County",1,73,203,97,106
050,51,131,"Virginia","Northampton County",1,74,130,61,69
050,51,131,"Virginia","Northampton County",1,75,136,67,69
050,51,131,"Virginia","Northampton County",1,76,149,72,77
050,51,131,"Virginia","Northampton County",1,77,136,64,72
050,51,131,"Virginia","Northampton County",1,78,106,51,55
050,51,131,"Virginia","Northampton County",1,79,117,55,62
050,51,131,"Virginia","Northampton County",1,80,96,37,59
050,51,131,"Virginia","Northampton County",1,81,89,37,52
050,51,131,"Virginia","Northampton County",1,82,79,33,46
050,51,131,"Virginia","Northampton County",1,83,65,33,32
050,51,131,"Virginia","Northampton County",1,84,59,31,28
050,51,131,"Virginia","Northampton County",1,85,409,127,282
050,51,131,"Virginia","Northampton County",2,0,110,56,54
050,51,131,"Virginia","Northampton County",2,1,120,67,53
050,51,131,"Virginia","Northampton County",2,2,130,73,57
050,51,131,"Virginia","Northampton County",2,3,119,60,59
050,51,131,"Virginia","Northampton County",2,4,118,56,62
050,51,131,"Virginia","Northampton County",2,5,118,57,61
050,51,131,"Virginia","Northampton County",2,6,129,72,57
050,51,131,"Virginia","Northampton County",2,7,124,70,54
050,51,131,"Virginia","Northampton County",2,8,139,73,66
050,51,131,"Virginia","Northampton County",2,9,147,77,70
050,51,131,"Virginia","Northampton County",2,10,139,77,62
050,51,131,"Virginia","Northampton County",2,11,141,84,57
050,51,131,"Virginia","Northampton County",2,12,143,81,62
050,51,131,"Virginia","Northampton County",2,13,132,68,64
050,51,131,"Virginia","Northampton County",2,14,136,67,69
050,51,131,"Virginia","Northampton County",2,15,141,64,77
050,51,131,"Virginia","Northampton County",2,16,143,72,71
050,51,131,"Virginia","Northampton County",2,17,128,60,68
050,51,131,"Virginia","Northampton County",2,18,105,53,52
050,51,131,"Virginia","Northampton County",2,19,103,57,46
050,51,131,"Virginia","Northampton County",2,20,107,59,48
050,51,131,"Virginia","Northampton County",2,21,106,61,45
050,51,131,"Virginia","Northampton County",2,22,97,47,50
050,51,131,"Virginia","Northampton County",2,23,104,47,57
050,51,131,"Virginia","Northampton County",2,24,113,55,58
050,51,131,"Virginia","Northampton County",2,25,106,51,55
050,51,131,"Virginia","Northampton County",2,26,106,55,51
050,51,131,"Virginia","Northampton County",2,27,113,54,59
050,51,131,"Virginia","Northampton County",2,28,124,65,59
050,51,131,"Virginia","Northampton County",2,29,133,68,65
050,51,131,"Virginia","Northampton County",2,30,131,64,67
050,51,131,"Virginia","Northampton County",2,31,126,66,60
050,51,131,"Virginia","Northampton County",2,32,119,63,56
050,51,131,"Virginia","Northampton County",2,33,121,55,66
050,51,131,"Virginia","Northampton County",2,34,122,56,66
050,51,131,"Virginia","Northampton County",2,35,129,64,65
050,51,131,"Virginia","Northampton County",2,36,125,68,57
050,51,131,"Virginia","Northampton County",2,37,121,60,61
050,51,131,"Virginia","Northampton County",2,38,109,45,64
050,51,131,"Virginia","Northampton County",2,39,104,50,54
050,51,131,"Virginia","Northampton County",2,40,99,48,51
050,51,131,"Virginia","Northampton County",2,41,115,53,62
050,51,131,"Virginia","Northampton County",2,42,110,51,59
050,51,131,"Virginia","Northampton County",2,43,105,49,56
050,51,131,"Virginia","Northampton County",2,44,95,53,42
050,51,131,"Virginia","Northampton County",2,45,101,52,49
050,51,131,"Virginia","Northampton County",2,46,102,43,59
050,51,131,"Virginia","Northampton County",2,47,110,46,64
050,51,131,"Virginia","Northampton County",2,48,135,61,74
050,51,131,"Virginia","Northampton County",2,49,134,68,66
050,51,131,"Virginia","Northampton County",2,50,134,65,69
050,51,131,"Virginia","Northampton County",2,51,136,65,71
050,51,131,"Virginia","Northampton County",2,52,133,65,68
050,51,131,"Virginia","Northampton County",2,53,139,69,70
050,51,131,"Virginia","Northampton County",2,54,144,69,75
050,51,131,"Virginia","Northampton County",2,55,159,69,90
050,51,131,"Virginia","Northampton County",2,56,180,75,105
050,51,131,"Virginia","Northampton County",2,57,198,76,122
050,51,131,"Virginia","Northampton County",2,58,195,81,114
050,51,131,"Virginia","Northampton County",2,59,218,110,108
050,51,131,"Virginia","Northampton County",2,60,239,117,122
050,51,131,"Virginia","Northampton County",2,61,243,97,146
050,51,131,"Virginia","Northampton County",2,62,232,102,130
050,51,131,"Virginia","Northampton County",2,63,244,118,126
050,51,131,"Virginia","Northampton County",2,64,229,109,120
050,51,131,"Virginia","Northampton County",2,65,222,97,125
050,51,131,"Virginia","Northampton County",2,66,235,107,128
050,51,131,"Virginia","Northampton County",2,67,213,101,112
050,51,131,"Virginia","Northampton County",2,68,202,98,104
050,51,131,"Virginia","Northampton County",2,69,198,91,107
050,51,131,"Virginia","Northampton County",2,70,197,90,107
050,51,131,"Virginia","Northampton County",2,71,193,85,108
050,51,131,"Virginia","Northampton County",2,72,180,81,99
050,51,131,"Virginia","Northampton County",2,73,203,97,106
050,51,131,"Virginia","Northampton County",2,74,138,65,73
050,51,131,"Virginia","Northampton County",2,75,133,65,68
050,51,131,"Virginia","Northampton County",2,76,145,70,75
050,51,131,"Virginia","Northampton County",2,77,139,66,73
050,51,131,"Virginia","Northampton County",2,78,107,53,54
050,51,131,"Virginia","Northampton County",2,79,113,52,61
050,51,131,"Virginia","Northampton County",2,80,101,41,60
050,51,131,"Virginia","Northampton County",2,81,84,33,51
050,51,131,"Virginia","Northampton County",2,82,78,32,46
050,51,131,"Virginia","Northampton County",2,83,66,33,33
050,51,131,"Virginia","Northampton County",2,84,58,29,29
050,51,131,"Virginia","Northampton County",2,85,398,124,274
050,51,131,"Virginia","Northampton County",3,0,100,50,50
050,51,131,"Virginia","Northampton County",3,1,94,50,44
050,51,131,"Virginia","Northampton County",3,2,113,59,54
050,51,131,"Virginia","Northampton County",3,3,127,66,61
050,51,131,"Virginia","Northampton County",3,4,113,60,53
050,51,131,"Virginia","Northampton County",3,5,112,51,61
050,51,131,"Virginia","Northampton County",3,6,117,61,56
050,51,131,"Virginia","Northampton County",3,7,125,69,56
050,51,131,"Virginia","Northampton County",3,8,123,74,49
050,51,131,"Virginia","Northampton County",3,9,125,63,62
050,51,131,"Virginia","Northampton County",3,10,145,75,70
050,51,131,"Virginia","Northampton County",3,11,129,72,57
050,51,131,"Virginia","Northampton County",3,12,138,87,51
050,51,131,"Virginia","Northampton County",3,13,138,79,59
050,51,131,"Virginia","Northampton County",3,14,131,67,64
050,51,131,"Virginia","Northampton County",3,15,135,66,69
050,51,131,"Virginia","Northampton County",3,16,147,69,78
050,51,131,"Virginia","Northampton County",3,17,145,70,75
050,51,131,"Virginia","Northampton County",3,18,115,60,55
050,51,131,"Virginia","Northampton County",3,19,105,53,52
050,51,131,"Virginia","Northampton County",3,20,103,55,48
050,51,131,"Virginia","Northampton County",3,21,107,62,45
050,51,131,"Virginia","Northampton County",3,22,102,59,43
050,51,131,"Virginia","Northampton County",3,23,84,38,46
050,51,131,"Virginia","Northampton County",3,24,105,48,57
050,51,131,"Virginia","Northampton County",3,25,107,49,58
050,51,131,"Virginia","Northampton County",3,26,108,52,56
050,51,131,"Virginia","Northampton County",3,27,100,52,48
050,51,131,"Virginia","Northampton County",3,28,102,54,48
050,51,131,"Virginia","Northampton County",3,29,122,59,63
050,51,131,"Virginia","Northampton County",3,30,121,57,64
050,51,131,"Virginia","Northampton County",3,31,119,58,61
050,51,131,"Virginia","Northampton County",3,32,120,61,59
050,51,131,"Virginia","Northampton County",3,33,129,65,64
050,51,131,"Virginia","Northampton County",3,34,124,59,65
050,51,131,"Virginia","Northampton County",3,35,116,52,64
050,51,131,"Virginia","Northampton County",3,36,122,58,64
050,51,131,"Virginia","Northampton County",3,37,121,70,51
050,51,131,"Virginia","Northampton County",3,38,125,61,64
050,51,131,"Virginia","Northampton County",3,39,107,44,63
050,51,131,"Virginia","Northampton County",3,40,109,51,58
050,51,131,"Virginia","Northampton County",3,41,98,49,49
050,51,131,"Virginia","Northampton County",3,42,117,54,63
050,51,131,"Virginia","Northampton County",3,43,109,49,60
050,51,131,"Virginia","Northampton County",3,44,111,50,61
050,51,131,"Virginia","Northampton County",3,45,98,57,41
050,51,131,"Virginia","Northampton County",3,46,104,55,49
050,51,131,"Virginia","Northampton County",3,47,100,42,58
050,51,131,"Virginia","Northampton County",3,48,104,45,59
050,51,131,"Virginia","Northampton County",3,49,133,59,74
050,51,131,"Virginia","Northampton County",3,50,139,70,69
050,51,131,"Virginia","Northampton County",3,51,130,61,69
050,51,131,"Virginia","Northampton County",3,52,140,66,74
050,51,131,"Virginia","Northampton County",3,53,135,66,69
050,51,131,"Virginia","Northampton County",3,54,142,72,70
050,51,131,"Virginia","Northampton County",3,55,145,66,79
050,51,131,"Virginia","Northampton County",3,56,166,71,95
050,51,131,"Virginia","Northampton County",3,57,187,78,109
050,51,131,"Virginia","Northampton County",3,58,210,83,127
050,51,131,"Virginia","Northampton County",3,59,197,84,113
050,51,131,"Virginia","Northampton County",3,60,221,113,108
050,51,131,"Virginia","Northampton County",3,61,244,117,127
050,51,131,"Virginia","Northampton County",3,62,249,103,146
050,51,131,"Virginia","Northampton County",3,63,231,104,127
050,51,131,"Virginia","Northampton County",3,64,251,124,127
050,51,131,"Virginia","Northampton County",3,65,239,115,124
050,51,131,"Virginia","Northampton County",3,66,231,98,133
050,51,131,"Virginia","Northampton County",3,67,241,110,131
050,51,131,"Virginia","Northampton County",3,68,207,102,105
050,51,131,"Virginia","Northampton County",3,69,204,100,104
050,51,131,"Virginia","Northampton County",3,70,189,86,103
050,51,131,"Virginia","Northampton County",3,71,189,82,107
050,51,131,"Virginia","Northampton County",3,72,189,86,103
050,51,131,"Virginia","Northampton County",3,73,172,77,95
050,51,131,"Virginia","Northampton County",3,74,185,91,94
050,51,131,"Virginia","Northampton County",3,75,130,64,66
050,51,131,"Virginia","Northampton County",3,76,129,58,71
050,51,131,"Virginia","Northampton County",3,77,142,68,74
050,51,131,"Virginia","Northampton County",3,78,128,58,70
050,51,131,"Virginia","Northampton County",3,79,107,56,51
050,51,131,"Virginia","Northampton County",3,80,107,48,59
050,51,131,"Virginia","Northampton County",3,81,92,37,55
050,51,131,"Virginia","Northampton County",3,82,80,28,52
050,51,131,"Virginia","Northampton County",3,83,59,22,37
050,51,131,"Virginia","Northampton County",3,84,62,30,32
050,51,131,"Virginia","Northampton County",3,85,395,132,263
050,51,131,"Virginia","Northampton County",4,0,112,51,61
050,51,131,"Virginia","Northampton County",4,1,99,46,53
050,51,131,"Virginia","Northampton County",4,2,92,48,44
050,51,131,"Virginia","Northampton County",4,3,101,51,50
050,51,131,"Virginia","Northampton County",4,4,120,65,55
050,51,131,"Virginia","Northampton County",4,5,114,60,54
050,51,131,"Virginia","Northampton County",4,6,107,50,57
050,51,131,"Virginia","Northampton County",4,7,113,53,60
050,51,131,"Virginia","Northampton County",4,8,119,64,55
050,51,131,"Virginia","Northampton County",4,9,121,69,52
050,51,131,"Virginia","Northampton County",4,10,127,69,58
050,51,131,"Virginia","Northampton County",4,11,148,80,68
050,51,131,"Virginia","Northampton County",4,12,122,66,56
050,51,131,"Virginia","Northampton County",4,13,134,84,50
050,51,131,"Virginia","Northampton County",4,14,133,76,57
050,51,131,"Virginia","Northampton County",4,15,134,68,66
050,51,131,"Virginia","Northampton County",4,16,142,68,74
050,51,131,"Virginia","Northampton County",4,17,147,69,78
050,51,131,"Virginia","Northampton County",4,18,132,69,63
050,51,131,"Virginia","Northampton County",4,19,97,53,44
050,51,131,"Virginia","Northampton County",4,20,103,50,53
050,51,131,"Virginia","Northampton County",4,21,110,58,52
050,51,131,"Virginia","Northampton County",4,22,108,60,48
050,51,131,"Virginia","Northampton County",4,23,110,60,50
050,51,131,"Virginia","Northampton County",4,24,88,42,46
050,51,131,"Virginia","Northampton County",4,25,118,59,59
050,51,131,"Virginia","Northampton County",4,26,103,52,51
050,51,131,"Virginia","Northampton County",4,27,105,47,58
050,51,131,"Virginia","Northampton County",4,28,102,56,46
050,51,131,"Virginia","Northampton County",4,29,100,49,51
050,51,131,"Virginia","Northampton County",4,30,115,60,55
050,51,131,"Virginia","Northampton County",4,31,120,52,68
050,51,131,"Virginia","Northampton County",4,32,110,58,52
050,51,131,"Virginia","Northampton County",4,33,114,57,57
050,51,131,"Virginia","Northampton County",4,34,120,58,62
050,51,131,"Virginia","Northampton County",4,35,123,61,62
050,51,131,"Virginia","Northampton County",4,36,123,55,68
050,51,131,"Virginia","Northampton County",4,37,124,59,65
050,51,131,"Virginia","Northampton County",4,38,120,66,54
050,51,131,"Virginia","Northampton County",4,39,115,58,57
050,51,131,"Virginia","Northampton County",4,40,102,39,63
050,51,131,"Virginia","Northampton County",4,41,122,60,62
050,51,131,"Virginia","Northampton County",4,42,99,52,47
050,51,131,"Virginia","Northampton County",4,43,113,54,59
050,51,131,"Virginia","Northampton County",4,44,108,50,58
050,51,131,"Virginia","Northampton County",4,45,104,49,55
050,51,131,"Virginia","Northampton County",4,46,96,54,42
050,51,131,"Virginia","Northampton County",4,47,109,59,50
050,51,131,"Virginia","Northampton County",4,48,98,42,56
050,51,131,"Virginia","Northampton County",4,49,110,47,63
050,51,131,"Virginia","Northampton County",4,50,135,63,72
050,51,131,"Virginia","Northampton County",4,51,132,62,70
050,51,131,"Virginia","Northampton County",4,52,127,57,70
050,51,131,"Virginia","Northampton County",4,53,144,72,72
050,51,131,"Virginia","Northampton County",4,54,145,70,75
050,51,131,"Virginia","Northampton County",4,55,139,69,70
050,51,131,"Virginia","Northampton County",4,56,147,65,82
050,51,131,"Virginia","Northampton County",4,57,171,73,98
050,51,131,"Virginia","Northampton County",4,58,183,75,108
050,51,131,"Virginia","Northampton County",4,59,214,83,131
050,51,131,"Virginia","Northampton County",4,60,199,86,113
050,51,131,"Virginia","Northampton County",4,61,233,116,117
050,51,131,"Virginia","Northampton County",4,62,240,110,130
050,51,131,"Virginia","Northampton County",4,63,252,110,142
050,51,131,"Virginia","Northampton County",4,64,229,101,128
050,51,131,"Virginia","Northampton County",4,65,252,127,125
050,51,131,"Virginia","Northampton County",4,66,240,116,124
050,51,131,"Virginia","Northampton County",4,67,237,100,137
050,51,131,"Virginia","Northampton County",4,68,240,112,128
050,51,131,"Virginia","Northampton County",4,69,212,103,109
050,51,131,"Virginia","Northampton County",4,70,198,96,102
050,51,131,"Virginia","Northampton County",4,71,186,85,101
050,51,131,"Virginia","Northampton County",4,72,187,80,107
050,51,131,"Virginia","Northampton County",4,73,181,84,97
050,51,131,"Virginia","Northampton County",4,74,157,69,88
050,51,131,"Virginia","Northampton County",4,75,179,89,90
050,51,131,"Virginia","Northampton County",4,76,130,56,74
050,51,131,"Virginia","Northampton County",4,77,120,50,70
050,51,131,"Virginia","Northampton County",4,78,125,60,65
050,51,131,"Virginia","Northampton County",4,79,130,59,71
050,51,131,"Virginia","Northampton County",4,80,96,50,46
050,51,131,"Virginia","Northampton County",4,81,104,46,58
050,51,131,"Virginia","Northampton County",4,82,87,32,55
050,51,131,"Virginia","Northampton County",4,83,66,23,43
050,51,131,"Virginia","Northampton County",4,84,53,16,37
050,51,131,"Virginia","Northampton County",4,85,402,144,258
050,51,131,"Virginia","Northampton County",5,0,113,51,62
050,51,131,"Virginia","Northampton County",5,1,109,39,70
050,51,131,"Virginia","Northampton County",5,2,91,39,52
050,51,131,"Virginia","Northampton County",5,3,103,53,50
050,51,131,"Virginia","Northampton County",5,4,105,52,53
050,51,131,"Virginia","Northampton County",5,5,117,63,54
050,51,131,"Virginia","Northampton County",5,6,116,62,54
050,51,131,"Virginia","Northampton County",5,7,107,49,58
050,51,131,"Virginia","Northampton County",5,8,114,54,60
050,51,131,"Virginia","Northampton County",5,9,121,66,55
050,51,131,"Virginia","Northampton County",5,10,120,68,52
050,51,131,"Virginia","Northampton County",5,11,125,68,57
050,51,131,"Virginia","Northampton County",5,12,143,75,68
050,51,131,"Virginia","Northampton County",5,13,127,67,60
050,51,131,"Virginia","Northampton County",5,14,135,83,52
050,51,131,"Virginia","Northampton County",5,15,132,73,59
050,51,131,"Virginia","Northampton County",5,16,142,68,74
050,51,131,"Virginia","Northampton County",5,17,147,71,76
050,51,131,"Virginia","Northampton County",5,18,131,66,65
050,51,131,"Virginia","Northampton County",5,19,115,61,54
050,51,131,"Virginia","Northampton County",5,20,101,52,49
050,51,131,"Virginia","Northampton County",5,21,109,57,52
050,51,131,"Virginia","Northampton County",5,22,105,53,52
050,51,131,"Virginia","Northampton County",5,23,101,53,48
050,51,131,"Virginia","Northampton County",5,24,117,69,48
050,51,131,"Virginia","Northampton County",5,25,80,36,44
050,51,131,"Virginia","Northampton County",5,26,109,53,56
050,51,131,"Virginia","Northampton County",5,27,116,57,59
050,51,131,"Virginia","Northampton County",5,28,96,45,51
050,51,131,"Virginia","Northampton County",5,29,100,55,45
050,51,131,"Virginia","Northampton County",5,30,88,43,45
050,51,131,"Virginia","Northampton County",5,31,113,56,57
050,51,131,"Virginia","Northampton County",5,32,121,52,69
050,51,131,"Virginia","Northampton County",5,33,113,62,51
050,51,131,"Virginia","Northampton County",5,34,119,60,59
050,51,131,"Virginia","Northampton County",5,35,121,58,63
050,51,131,"Virginia","Northampton County",5,36,118,59,59
050,51,131,"Virginia","Northampton County",5,37,126,59,67
050,51,131,"Virginia","Northampton County",5,38,133,61,72
050,51,131,"Virginia","Northampton County",5,39,124,71,53
050,51,131,"Virginia","Northampton County",5,40,122,57,65
050,51,131,"Virginia","Northampton County",5,41,105,43,62
050,51,131,"Virginia","Northampton County",5,42,118,56,62
050,51,131,"Virginia","Northampton County",5,43,95,47,48
050,51,131,"Virginia","Northampton County",5,44,109,49,60
050,51,131,"Virginia","Northampton County",5,45,108,53,55
050,51,131,"Virginia","Northampton County",5,46,109,47,62
050,51,131,"Virginia","Northampton County",5,47,102,54,48
050,51,131,"Virginia","Northampton County",5,48,105,53,52
050,51,131,"Virginia","Northampton County",5,49,99,40,59
050,51,131,"Virginia","Northampton County",5,50,112,53,59
050,51,131,"Virginia","Northampton County",5,51,134,60,74
050,51,131,"Virginia","Northampton County",5,52,138,59,79
050,51,131,"Virginia","Northampton County",5,53,134,64,70
050,51,131,"Virginia","Northampton County",5,54,161,80,81
050,51,131,"Virginia","Northampton County",5,55,144,68,76
050,51,131,"Virginia","Northampton County",5,56,141,66,75
050,51,131,"Virginia","Northampton County",5,57,156,70,86
050,51,131,"Virginia","Northampton County",5,58,174,76,98
050,51,131,"Virginia","Northampton County",5,59,184,76,108
050,51,131,"Virginia","Northampton County",5,60,207,78,129
050,51,131,"Virginia","Northampton County",5,61,200,86,114
050,51,131,"Virginia","Northampton County",5,62,251,128,123
050,51,131,"Virginia","Northampton County",5,63,258,117,141
050,51,131,"Virginia","Northampton County",5,64,241,103,138
050,51,131,"Virginia","Northampton County",5,65,223,100,123
050,51,131,"Virginia","Northampton County",5,66,262,133,129
050,51,131,"Virginia","Northampton County",5,67,242,117,125
050,51,131,"Virginia","Northampton County",5,68,234,97,137
050,51,131,"Virginia","Northampton County",5,69,248,117,131
050,51,131,"Virginia","Northampton County",5,70,206,98,108
050,51,131,"Virginia","Northampton County",5,71,194,93,101
050,51,131,"Virginia","Northampton County",5,72,179,83,96
050,51,131,"Virginia","Northampton County",5,73,183,76,107
050,51,131,"Virginia","Northampton County",5,74,169,77,92
050,51,131,"Virginia","Northampton County",5,75,154,69,85
050,51,131,"Virginia","Northampton County",5,76,182,86,96
050,51,131,"Virginia","Northampton County",5,77,132,56,76
050,51,131,"Virginia","Northampton County",5,78,108,43,65
050,51,131,"Virginia","Northampton County",5,79,119,58,61
050,51,131,"Virginia","Northampton County",5,80,126,54,72
050,51,131,"Virginia","Northampton County",5,81,92,48,44
050,51,131,"Virginia","Northampton County",5,82,105,45,60
050,51,131,"Virginia","Northampton County",5,83,70,24,46
050,51,131,"Virginia","Northampton County",5,84,61,18,43
050,51,131,"Virginia","Northampton County",5,85,402,141,261
050,51,133,"Virginia","Northumberland County",1,0,79,40,39
050,51,133,"Virginia","Northumberland County",1,1,79,39,40
050,51,133,"Virginia","Northumberland County",1,2,87,38,49
050,51,133,"Virginia","Northumberland County",1,3,89,43,46
050,51,133,"Virginia","Northumberland County",1,4,83,43,40
050,51,133,"Virginia","Northumberland County",1,5,86,47,39
050,51,133,"Virginia","Northumberland County",1,6,86,51,35
050,51,133,"Virginia","Northumberland County",1,7,105,59,46
050,51,133,"Virginia","Northumberland County",1,8,85,46,39
050,51,133,"Virginia","Northumberland County",1,9,103,55,48
050,51,133,"Virginia","Northumberland County",1,10,110,57,53
050,51,133,"Virginia","Northumberland County",1,11,108,52,56
050,51,133,"Virginia","Northumberland County",1,12,100,56,44
050,51,133,"Virginia","Northumberland County",1,13,99,54,45
050,51,133,"Virginia","Northumberland County",1,14,109,57,52
050,51,133,"Virginia","Northumberland County",1,15,95,57,38
050,51,133,"Virginia","Northumberland County",1,16,105,61,44
050,51,133,"Virginia","Northumberland County",1,17,114,59,55
050,51,133,"Virginia","Northumberland County",1,18,104,58,46
050,51,133,"Virginia","Northumberland County",1,19,85,40,45
050,51,133,"Virginia","Northumberland County",1,20,93,47,46
050,51,133,"Virginia","Northumberland County",1,21,86,45,41
050,51,133,"Virginia","Northumberland County",1,22,94,52,42
050,51,133,"Virginia","Northumberland County",1,23,88,40,48
050,51,133,"Virginia","Northumberland County",1,24,86,40,46
050,51,133,"Virginia","Northumberland County",1,25,88,48,40
050,51,133,"Virginia","Northumberland County",1,26,81,39,42
050,51,133,"Virginia","Northumberland County",1,27,78,37,41
050,51,133,"Virginia","Northumberland County",1,28,98,44,54
050,51,133,"Virginia","Northumberland County",1,29,103,49,54
050,51,133,"Virginia","Northumberland County",1,30,100,50,50
050,51,133,"Virginia","Northumberland County",1,31,93,41,52
050,51,133,"Virginia","Northumberland County",1,32,85,37,48
050,51,133,"Virginia","Northumberland County",1,33,86,40,46
050,51,133,"Virginia","Northumberland County",1,34,80,43,37
050,51,133,"Virginia","Northumberland County",1,35,73,38,35
050,51,133,"Virginia","Northumberland County",1,36,70,30,40
050,51,133,"Virginia","Northumberland County",1,37,109,55,54
050,51,133,"Virginia","Northumberland County",1,38,102,54,48
050,51,133,"Virginia","Northumberland County",1,39,88,45,43
050,51,133,"Virginia","Northumberland County",1,40,93,44,49
050,51,133,"Virginia","Northumberland County",1,41,112,54,58
050,51,133,"Virginia","Northumberland County",1,42,97,54,43
050,51,133,"Virginia","Northumberland County",1,43,87,47,40
050,51,133,"Virginia","Northumberland County",1,44,83,42,41
050,51,133,"Virginia","Northumberland County",1,45,92,47,45
050,51,133,"Virginia","Northumberland County",1,46,84,36,48
050,51,133,"Virginia","Northumberland County",1,47,79,36,43
050,51,133,"Virginia","Northumberland County",1,48,92,40,52
050,51,133,"Virginia","Northumberland County",1,49,106,50,56
050,51,133,"Virginia","Northumberland County",1,50,97,50,47
050,51,133,"Virginia","Northumberland County",1,51,119,50,69
050,51,133,"Virginia","Northumberland County",1,52,138,59,79
050,51,133,"Virginia","Northumberland County",1,53,153,74,79
050,51,133,"Virginia","Northumberland County",1,54,139,58,81
050,51,133,"Virginia","Northumberland County",1,55,179,79,100
050,51,133,"Virginia","Northumberland County",1,56,203,98,105
050,51,133,"Virginia","Northumberland County",1,57,187,86,101
050,51,133,"Virginia","Northumberland County",1,58,195,93,102
050,51,133,"Virginia","Northumberland County",1,59,213,101,112
050,51,133,"Virginia","Northumberland County",1,60,246,127,119
050,51,133,"Virginia","Northumberland County",1,61,238,117,121
050,51,133,"Virginia","Northumberland County",1,62,221,115,106
050,51,133,"Virginia","Northumberland County",1,63,241,116,125
050,51,133,"Virginia","Northumberland County",1,64,234,108,126
050,51,133,"Virginia","Northumberland County",1,65,242,102,140
050,51,133,"Virginia","Northumberland County",1,66,247,117,130
050,51,133,"Virginia","Northumberland County",1,67,249,111,138
050,51,133,"Virginia","Northumberland County",1,68,253,126,127
050,51,133,"Virginia","Northumberland County",1,69,240,133,107
050,51,133,"Virginia","Northumberland County",1,70,252,120,132
050,51,133,"Virginia","Northumberland County",1,71,253,110,143
050,51,133,"Virginia","Northumberland County",1,72,269,118,151
050,51,133,"Virginia","Northumberland County",1,73,272,133,139
050,51,133,"Virginia","Northumberland County",1,74,184,90,94
050,51,133,"Virginia","Northumberland County",1,75,213,106,107
050,51,133,"Virginia","Northumberland County",1,76,209,102,107
050,51,133,"Virginia","Northumberland County",1,77,224,116,108
050,51,133,"Virginia","Northumberland County",1,78,175,92,83
050,51,133,"Virginia","Northumberland County",1,79,149,80,69
050,51,133,"Virginia","Northumberland County",1,80,139,73,66
050,51,133,"Virginia","Northumberland County",1,81,115,60,55
050,51,133,"Virginia","Northumberland County",1,82,110,57,53
050,51,133,"Virginia","Northumberland County",1,83,100,53,47
050,51,133,"Virginia","Northumberland County",1,84,86,47,39
050,51,133,"Virginia","Northumberland County",1,85,438,217,221
050,51,133,"Virginia","Northumberland County",2,0,76,38,38
050,51,133,"Virginia","Northumberland County",2,1,80,39,41
050,51,133,"Virginia","Northumberland County",2,2,85,38,47
050,51,133,"Virginia","Northumberland County",2,3,88,41,47
050,51,133,"Virginia","Northumberland County",2,4,86,43,43
050,51,133,"Virginia","Northumberland County",2,5,85,47,38
050,51,133,"Virginia","Northumberland County",2,6,87,51,36
050,51,133,"Virginia","Northumberland County",2,7,100,58,42
050,51,133,"Virginia","Northumberland County",2,8,90,49,41
050,51,133,"Virginia","Northumberland County",2,9,101,54,47
050,51,133,"Virginia","Northumberland County",2,10,109,57,52
050,51,133,"Virginia","Northumberland County",2,11,106,53,53
050,51,133,"Virginia","Northumberland County",2,12,100,55,45
050,51,133,"Virginia","Northumberland County",2,13,99,55,44
050,51,133,"Virginia","Northumberland County",2,14,103,56,47
050,51,133,"Virginia","Northumberland County",2,15,100,58,42
050,51,133,"Virginia","Northumberland County",2,16,102,60,42
050,51,133,"Virginia","Northumberland County",2,17,113,61,52
050,51,133,"Virginia","Northumberland County",2,18,103,57,46
050,51,133,"Virginia","Northumberland County",2,19,90,43,47
050,51,133,"Virginia","Northumberland County",2,20,95,47,48
050,51,133,"Virginia","Northumberland County",2,21,85,44,41
050,51,133,"Virginia","Northumberland County",2,22,93,50,43
050,51,133,"Virginia","Northumberland County",2,23,89,42,47
050,51,133,"Virginia","Northumberland County",2,24,86,40,46
050,51,133,"Virginia","Northumberland County",2,25,90,47,43
050,51,133,"Virginia","Northumberland County",2,26,82,40,42
050,51,133,"Virginia","Northumberland County",2,27,78,38,40
050,51,133,"Virginia","Northumberland County",2,28,93,42,51
050,51,133,"Virginia","Northumberland County",2,29,102,48,54
050,51,133,"Virginia","Northumberland County",2,30,102,51,51
050,51,133,"Virginia","Northumberland County",2,31,94,42,52
050,51,133,"Virginia","Northumberland County",2,32,87,38,49
050,51,133,"Virginia","Northumberland County",2,33,87,40,47
050,51,133,"Virginia","Northumberland County",2,34,81,43,38
050,51,133,"Virginia","Northumberland County",2,35,73,38,35
050,51,133,"Virginia","Northumberland County",2,36,71,32,39
050,51,133,"Virginia","Northumberland County",2,37,103,51,52
050,51,133,"Virginia","Northumberland County",2,38,103,54,49
050,51,133,"Virginia","Northumberland County",2,39,94,49,45
050,51,133,"Virginia","Northumberland County",2,40,93,44,49
050,51,133,"Virginia","Northumberland County",2,41,107,51,56
050,51,133,"Virginia","Northumberland County",2,42,99,54,45
050,51,133,"Virginia","Northumberland County",2,43,90,48,42
050,51,133,"Virginia","Northumberland County",2,44,84,43,41
050,51,133,"Virginia","Northumberland County",2,45,90,46,44
050,51,133,"Virginia","Northumberland County",2,46,85,38,47
050,51,133,"Virginia","Northumberland County",2,47,82,37,45
050,51,133,"Virginia","Northumberland County",2,48,91,39,52
050,51,133,"Virginia","Northumberland County",2,49,103,49,54
050,51,133,"Virginia","Northumberland County",2,50,101,50,51
050,51,133,"Virginia","Northumberland County",2,51,114,50,64
050,51,133,"Virginia","Northumberland County",2,52,134,58,76
050,51,133,"Virginia","Northumberland County",2,53,149,69,80
050,51,133,"Virginia","Northumberland County",2,54,144,62,82
050,51,133,"Virginia","Northumberland County",2,55,171,74,97
050,51,133,"Virginia","Northumberland County",2,56,200,94,106
050,51,133,"Virginia","Northumberland County",2,57,193,90,103
050,51,133,"Virginia","Northumberland County",2,58,195,93,102
050,51,133,"Virginia","Northumberland County",2,59,210,100,110
050,51,133,"Virginia","Northumberland County",2,60,242,123,119
050,51,133,"Virginia","Northumberland County",2,61,241,120,121
050,51,133,"Virginia","Northumberland County",2,62,227,116,111
050,51,133,"Virginia","Northumberland County",2,63,241,119,122
050,51,133,"Virginia","Northumberland County",2,64,236,110,126
050,51,133,"Virginia","Northumberland County",2,65,243,105,138
050,51,133,"Virginia","Northumberland County",2,66,245,113,132
050,51,133,"Virginia","Northumberland County",2,67,250,113,137
050,51,133,"Virginia","Northumberland County",2,68,251,124,127
050,51,133,"Virginia","Northumberland County",2,69,249,135,114
050,51,133,"Virginia","Northumberland County",2,70,250,123,127
050,51,133,"Virginia","Northumberland County",2,71,253,113,140
050,51,133,"Virginia","Northumberland County",2,72,259,115,144
050,51,133,"Virginia","Northumberland County",2,73,283,135,148
050,51,133,"Virginia","Northumberland County",2,74,190,94,96
050,51,133,"Virginia","Northumberland County",2,75,205,101,104
050,51,133,"Virginia","Northumberland County",2,76,206,101,105
050,51,133,"Virginia","Northumberland County",2,77,222,112,110
050,51,133,"Virginia","Northumberland County",2,78,178,93,85
050,51,133,"Virginia","Northumberland County",2,79,153,81,72
050,51,133,"Virginia","Northumberland County",2,80,141,75,66
050,51,133,"Virginia","Northumberland County",2,81,117,61,56
050,51,133,"Virginia","Northumberland County",2,82,104,54,50
050,51,133,"Virginia","Northumberland County",2,83,100,53,47
050,51,133,"Virginia","Northumberland County",2,84,88,47,41
050,51,133,"Virginia","Northumberland County",2,85,441,220,221
050,51,133,"Virginia","Northumberland County",3,0,85,43,42
050,51,133,"Virginia","Northumberland County",3,1,79,35,44
050,51,133,"Virginia","Northumberland County",3,2,80,41,39
050,51,133,"Virginia","Northumberland County",3,3,92,42,50
050,51,133,"Virginia","Northumberland County",3,4,89,42,47
050,51,133,"Virginia","Northumberland County",3,5,82,46,36
050,51,133,"Virginia","Northumberland County",3,6,88,46,42
050,51,133,"Virginia","Northumberland County",3,7,89,53,36
050,51,133,"Virginia","Northumberland County",3,8,102,59,43
050,51,133,"Virginia","Northumberland County",3,9,96,47,49
050,51,133,"Virginia","Northumberland County",3,10,97,50,47
050,51,133,"Virginia","Northumberland County",3,11,104,56,48
050,51,133,"Virginia","Northumberland County",3,12,102,51,51
050,51,133,"Virginia","Northumberland County",3,13,112,62,50
050,51,133,"Virginia","Northumberland County",3,14,102,56,46
050,51,133,"Virginia","Northumberland County",3,15,104,57,47
050,51,133,"Virginia","Northumberland County",3,16,100,59,41
050,51,133,"Virginia","Northumberland County",3,17,105,61,44
050,51,133,"Virginia","Northumberland County",3,18,100,58,42
050,51,133,"Virginia","Northumberland County",3,19,88,47,41
050,51,133,"Virginia","Northumberland County",3,20,100,51,49
050,51,133,"Virginia","Northumberland County",3,21,98,49,49
050,51,133,"Virginia","Northumberland County",3,22,90,44,46
050,51,133,"Virginia","Northumberland County",3,23,101,52,49
050,51,133,"Virginia","Northumberland County",3,24,99,53,46
050,51,133,"Virginia","Northumberland County",3,25,94,45,49
050,51,133,"Virginia","Northumberland County",3,26,89,53,36
050,51,133,"Virginia","Northumberland County",3,27,86,41,45
050,51,133,"Virginia","Northumberland County",3,28,89,46,43
050,51,133,"Virginia","Northumberland County",3,29,105,48,57
050,51,133,"Virginia","Northumberland County",3,30,102,50,52
050,51,133,"Virginia","Northumberland County",3,31,102,47,55
050,51,133,"Virginia","Northumberland County",3,32,108,48,60
050,51,133,"Virginia","Northumberland County",3,33,94,46,48
050,51,133,"Virginia","Northumberland County",3,34,86,37,49
050,51,133,"Virginia","Northumberland County",3,35,93,49,44
050,51,133,"Virginia","Northumberland County",3,36,73,38,35
050,51,133,"Virginia","Northumberland County",3,37,85,39,46
050,51,133,"Virginia","Northumberland County",3,38,104,48,56
050,51,133,"Virginia","Northumberland County",3,39,107,56,51
050,51,133,"Virginia","Northumberland County",3,40,95,48,47
050,51,133,"Virginia","Northumberland County",3,41,96,45,51
050,51,133,"Virginia","Northumberland County",3,42,100,49,51
050,51,133,"Virginia","Northumberland County",3,43,97,56,41
050,51,133,"Virginia","Northumberland County",3,44,87,49,38
050,51,133,"Virginia","Northumberland County",3,45,84,43,41
050,51,133,"Virginia","Northumberland County",3,46,94,44,50
050,51,133,"Virginia","Northumberland County",3,47,85,39,46
050,51,133,"Virginia","Northumberland County",3,48,81,37,44
050,51,133,"Virginia","Northumberland County",3,49,90,39,51
050,51,133,"Virginia","Northumberland County",3,50,107,55,52
050,51,133,"Virginia","Northumberland County",3,51,99,49,50
050,51,133,"Virginia","Northumberland County",3,52,123,53,70
050,51,133,"Virginia","Northumberland County",3,53,132,60,72
050,51,133,"Virginia","Northumberland County",3,54,166,75,91
050,51,133,"Virginia","Northumberland County",3,55,164,69,95
050,51,133,"Virginia","Northumberland County",3,56,168,69,99
050,51,133,"Virginia","Northumberland County",3,57,225,102,123
050,51,133,"Virginia","Northumberland County",3,58,223,108,115
050,51,133,"Virginia","Northumberland County",3,59,200,100,100
050,51,133,"Virginia","Northumberland County",3,60,232,112,120
050,51,133,"Virginia","Northumberland County",3,61,258,123,135
050,51,133,"Virginia","Northumberland County",3,62,265,132,133
050,51,133,"Virginia","Northumberland County",3,63,239,127,112
050,51,133,"Virginia","Northumberland County",3,64,263,132,131
050,51,133,"Virginia","Northumberland County",3,65,240,114,126
050,51,133,"Virginia","Northumberland County",3,66,242,108,134
050,51,133,"Virginia","Northumberland County",3,67,259,118,141
050,51,133,"Virginia","Northumberland County",3,68,255,116,139
050,51,133,"Virginia","Northumberland County",3,69,255,127,128
050,51,133,"Virginia","Northumberland County",3,70,251,132,119
050,51,133,"Virginia","Northumberland County",3,71,246,121,125
050,51,133,"Virginia","Northumberland County",3,72,246,115,131
050,51,133,"Virginia","Northumberland County",3,73,243,111,132
050,51,133,"Virginia","Northumberland County",3,74,276,132,144
050,51,133,"Virginia","Northumberland County",3,75,183,92,91
050,51,133,"Virginia","Northumberland County",3,76,196,97,99
050,51,133,"Virginia","Northumberland County",3,77,191,90,101
050,51,133,"Virginia","Northumberland County",3,78,215,111,104
050,51,133,"Virginia","Northumberland County",3,79,161,81,80
050,51,133,"Virginia","Northumberland County",3,80,141,74,67
050,51,133,"Virginia","Northumberland County",3,81,138,71,67
050,51,133,"Virginia","Northumberland County",3,82,107,55,52
050,51,133,"Virginia","Northumberland County",3,83,103,50,53
050,51,133,"Virginia","Northumberland County",3,84,85,45,40
050,51,133,"Virginia","Northumberland County",3,85,445,221,224
050,51,133,"Virginia","Northumberland County",4,0,83,36,47
050,51,133,"Virginia","Northumberland County",4,1,85,42,43
050,51,133,"Virginia","Northumberland County",4,2,76,31,45
050,51,133,"Virginia","Northumberland County",4,3,86,42,44
050,51,133,"Virginia","Northumberland County",4,4,90,47,43
050,51,133,"Virginia","Northumberland County",4,5,90,46,44
050,51,133,"Virginia","Northumberland County",4,6,86,48,38
050,51,133,"Virginia","Northumberland County",4,7,90,52,38
050,51,133,"Virginia","Northumberland County",4,8,78,45,33
050,51,133,"Virginia","Northumberland County",4,9,102,56,46
050,51,133,"Virginia","Northumberland County",4,10,101,48,53
050,51,133,"Virginia","Northumberland County",4,11,103,49,54
050,51,133,"Virginia","Northumberland County",4,12,112,59,53
050,51,133,"Virginia","Northumberland County",4,13,100,52,48
050,51,133,"Virginia","Northumberland County",4,14,118,63,55
050,51,133,"Virginia","Northumberland County",4,15,104,57,47
050,51,133,"Virginia","Northumberland County",4,16,104,59,45
050,51,133,"Virginia","Northumberland County",4,17,105,65,40
050,51,133,"Virginia","Northumberland County",4,18,94,55,39
050,51,133,"Virginia","Northumberland County",4,19,77,48,29
050,51,133,"Virginia","Northumberland County",4,20,93,50,43
050,51,133,"Virginia","Northumberland County",4,21,105,54,51
050,51,133,"Virginia","Northumberland County",4,22,110,56,54
050,51,133,"Virginia","Northumberland County",4,23,97,50,47
050,51,133,"Virginia","Northumberland County",4,24,84,48,36
050,51,133,"Virginia","Northumberland County",4,25,89,51,38
050,51,133,"Virginia","Northumberland County",4,26,96,49,47
050,51,133,"Virginia","Northumberland County",4,27,98,56,42
050,51,133,"Virginia","Northumberland County",4,28,92,47,45
050,51,133,"Virginia","Northumberland County",4,29,85,45,40
050,51,133,"Virginia","Northumberland County",4,30,125,57,68
050,51,133,"Virginia","Northumberland County",4,31,98,53,45
050,51,133,"Virginia","Northumberland County",4,32,102,46,56
050,51,133,"Virginia","Northumberland County",4,33,109,47,62
050,51,133,"Virginia","Northumberland County",4,34,85,40,45
050,51,133,"Virginia","Northumberland County",4,35,92,40,52
050,51,133,"Virginia","Northumberland County",4,36,91,46,45
050,51,133,"Virginia","Northumberland County",4,37,79,41,38
050,51,133,"Virginia","Northumberland County",4,38,79,35,44
050,51,133,"Virginia","Northumberland County",4,39,110,51,59
050,51,133,"Virginia","Northumberland County",4,40,113,60,53
050,51,133,"Virginia","Northumberland County",4,41,99,50,49
050,51,133,"Virginia","Northumberland County",4,42,99,49,50
050,51,133,"Virginia","Northumberland County",4,43,101,52,49
050,51,133,"Virginia","Northumberland County",4,44,99,56,43
050,51,133,"Virginia","Northumberland County",4,45,92,51,41
050,51,133,"Virginia","Northumberland County",4,46,85,45,40
050,51,133,"Virginia","Northumberland County",4,47,101,45,56
050,51,133,"Virginia","Northumberland County",4,48,88,35,53
050,51,133,"Virginia","Northumberland County",4,49,96,43,53
050,51,133,"Virginia","Northumberland County",4,50,99,44,55
050,51,133,"Virginia","Northumberland County",4,51,119,56,63
050,51,133,"Virginia","Northumberland County",4,52,107,53,54
050,51,133,"Virginia","Northumberland County",4,53,126,56,70
050,51,133,"Virginia","Northumberland County",4,54,141,66,75
050,51,133,"Virginia","Northumberland County",4,55,167,75,92
050,51,133,"Virginia","Northumberland County",4,56,186,73,113
050,51,133,"Virginia","Northumberland County",4,57,183,77,106
050,51,133,"Virginia","Northumberland County",4,58,230,104,126
050,51,133,"Virginia","Northumberland County",4,59,250,121,129
050,51,133,"Virginia","Northumberland County",4,60,224,111,113
050,51,133,"Virginia","Northumberland County",4,61,257,124,133
050,51,133,"Virginia","Northumberland County",4,62,290,140,150
050,51,133,"Virginia","Northumberland County",4,63,291,144,147
050,51,133,"Virginia","Northumberland County",4,64,262,138,124
050,51,133,"Virginia","Northumberland County",4,65,277,142,135
050,51,133,"Virginia","Northumberland County",4,66,256,125,131
050,51,133,"Virginia","Northumberland County",4,67,255,115,140
050,51,133,"Virginia","Northumberland County",4,68,261,121,140
050,51,133,"Virginia","Northumberland County",4,69,259,120,139
050,51,133,"Virginia","Northumberland County",4,70,263,133,130
050,51,133,"Virginia","Northumberland County",4,71,244,135,109
050,51,133,"Virginia","Northumberland County",4,72,240,119,121
050,51,133,"Virginia","Northumberland County",4,73,240,118,122
050,51,133,"Virginia","Northumberland County",4,74,237,113,124
050,51,133,"Virginia","Northumberland County",4,75,265,128,137
050,51,133,"Virginia","Northumberland County",4,76,186,94,92
050,51,133,"Virginia","Northumberland County",4,77,185,92,93
050,51,133,"Virginia","Northumberland County",4,78,185,88,97
050,51,133,"Virginia","Northumberland County",4,79,197,100,97
050,51,133,"Virginia","Northumberland County",4,80,150,75,75
050,51,133,"Virginia","Northumberland County",4,81,127,67,60
050,51,133,"Virginia","Northumberland County",4,82,127,64,63
050,51,133,"Virginia","Northumberland County",4,83,101,51,50
050,51,133,"Virginia","Northumberland County",4,84,83,42,41
050,51,133,"Virginia","Northumberland County",4,85,432,215,217
050,51,133,"Virginia","Northumberland County",5,0,85,38,47
050,51,133,"Virginia","Northumberland County",5,1,84,35,49
050,51,133,"Virginia","Northumberland County",5,2,88,45,43
050,51,133,"Virginia","Northumberland County",5,3,80,38,42
050,51,133,"Virginia","Northumberland County",5,4,86,41,45
050,51,133,"Virginia","Northumberland County",5,5,79,38,41
050,51,133,"Virginia","Northumberland County",5,6,95,49,46
050,51,133,"Virginia","Northumberland County",5,7,95,49,46
050,51,133,"Virginia","Northumberland County",5,8,88,52,36
050,51,133,"Virginia","Northumberland County",5,9,77,47,30
050,51,133,"Virginia","Northumberland County",5,10,102,56,46
050,51,133,"Virginia","Northumberland County",5,11,100,47,53
050,51,133,"Virginia","Northumberland County",5,12,102,53,49
050,51,133,"Virginia","Northumberland County",5,13,110,56,54
050,51,133,"Virginia","Northumberland County",5,14,107,54,53
050,51,133,"Virginia","Northumberland County",5,15,119,63,56
050,51,133,"Virginia","Northumberland County",5,16,106,59,47
050,51,133,"Virginia","Northumberland County",5,17,101,57,44
050,51,133,"Virginia","Northumberland County",5,18,99,61,38
050,51,133,"Virginia","Northumberland County",5,19,85,46,39
050,51,133,"Virginia","Northumberland County",5,20,87,53,34
050,51,133,"Virginia","Northumberland County",5,21,105,54,51
050,51,133,"Virginia","Northumberland County",5,22,108,54,54
050,51,133,"Virginia","Northumberland County",5,23,115,58,57
050,51,133,"Virginia","Northumberland County",5,24,107,56,51
050,51,133,"Virginia","Northumberland County",5,25,93,53,40
050,51,133,"Virginia","Northumberland County",5,26,81,43,38
050,51,133,"Virginia","Northumberland County",5,27,83,46,37
050,51,133,"Virginia","Northumberland County",5,28,104,59,45
050,51,133,"Virginia","Northumberland County",5,29,97,48,49
050,51,133,"Virginia","Northumberland County",5,30,87,43,44
050,51,133,"Virginia","Northumberland County",5,31,119,58,61
050,51,133,"Virginia","Northumberland County",5,32,98,55,43
050,51,133,"Virginia","Northumberland County",5,33,104,46,58
050,51,133,"Virginia","Northumberland County",5,34,112,50,62
050,51,133,"Virginia","Northumberland County",5,35,87,39,48
050,51,133,"Virginia","Northumberland County",5,36,94,40,54
050,51,133,"Virginia","Northumberland County",5,37,95,53,42
050,51,133,"Virginia","Northumberland County",5,38,83,45,38
050,51,133,"Virginia","Northumberland County",5,39,79,35,44
050,51,133,"Virginia","Northumberland County",5,40,110,50,60
050,51,133,"Virginia","Northumberland County",5,41,117,60,57
050,51,133,"Virginia","Northumberland County",5,42,108,58,50
050,51,133,"Virginia","Northumberland County",5,43,101,49,52
050,51,133,"Virginia","Northumberland County",5,44,107,56,51
050,51,133,"Virginia","Northumberland County",5,45,101,61,40
050,51,133,"Virginia","Northumberland County",5,46,99,54,45
050,51,133,"Virginia","Northumberland County",5,47,85,43,42
050,51,133,"Virginia","Northumberland County",5,48,103,48,55
050,51,133,"Virginia","Northumberland County",5,49,92,37,55
050,51,133,"Virginia","Northumberland County",5,50,98,42,56
050,51,133,"Virginia","Northumberland County",5,51,110,50,60
050,51,133,"Virginia","Northumberland County",5,52,121,55,66
050,51,133,"Virginia","Northumberland County",5,53,112,59,53
050,51,133,"Virginia","Northumberland County",5,54,133,56,77
050,51,133,"Virginia","Northumberland County",5,55,143,67,76
050,51,133,"Virginia","Northumberland County",5,56,173,78,95
050,51,133,"Virginia","Northumberland County",5,57,198,78,120
050,51,133,"Virginia","Northumberland County",5,58,203,92,111
050,51,133,"Virginia","Northumberland County",5,59,247,111,136
050,51,133,"Virginia","Northumberland County",5,60,270,129,141
050,51,133,"Virginia","Northumberland County",5,61,236,114,122
050,51,133,"Virginia","Northumberland County",5,62,270,128,142
050,51,133,"Virginia","Northumberland County",5,63,292,146,146
050,51,133,"Virginia","Northumberland County",5,64,290,144,146
050,51,133,"Virginia","Northumberland County",5,65,269,146,123
050,51,133,"Virginia","Northumberland County",5,66,275,143,132
050,51,133,"Virginia","Northumberland County",5,67,267,130,137
050,51,133,"Virginia","Northumberland County",5,68,257,113,144
050,51,133,"Virginia","Northumberland County",5,69,259,118,141
050,51,133,"Virginia","Northumberland County",5,70,256,121,135
050,51,133,"Virginia","Northumberland County",5,71,262,132,130
050,51,133,"Virginia","Northumberland County",5,72,244,135,109
050,51,133,"Virginia","Northumberland County",5,73,231,116,115
050,51,133,"Virginia","Northumberland County",5,74,235,118,117
050,51,133,"Virginia","Northumberland County",5,75,225,108,117
050,51,133,"Virginia","Northumberland County",5,76,258,121,137
050,51,133,"Virginia","Northumberland County",5,77,178,91,87
050,51,133,"Virginia","Northumberland County",5,78,176,87,89
050,51,133,"Virginia","Northumberland County",5,79,173,82,91
050,51,133,"Virginia","Northumberland County",5,80,183,92,91
050,51,133,"Virginia","Northumberland County",5,81,141,70,71
050,51,133,"Virginia","Northumberland County",5,82,114,62,52
050,51,133,"Virginia","Northumberland County",5,83,123,58,65
050,51,133,"Virginia","Northumberland County",5,84,82,43,39
050,51,133,"Virginia","Northumberland County",5,85,438,212,226
050,51,135,"Virginia","Nottoway County",1,0,162,83,79
050,51,135,"Virginia","Nottoway County",1,1,176,96,80
050,51,135,"Virginia","Nottoway County",1,2,157,83,74
050,51,135,"Virginia","Nottoway County",1,3,142,66,76
050,51,135,"Virginia","Nottoway County",1,4,152,77,75
050,51,135,"Virginia","Nottoway County",1,5,178,94,84
050,51,135,"Virginia","Nottoway County",1,6,159,82,77
050,51,135,"Virginia","Nottoway County",1,7,179,80,99
050,51,135,"Virginia","Nottoway County",1,8,163,72,91
050,51,135,"Virginia","Nottoway County",1,9,168,83,85
050,51,135,"Virginia","Nottoway County",1,10,166,89,77
050,51,135,"Virginia","Nottoway County",1,11,174,80,94
050,51,135,"Virginia","Nottoway County",1,12,167,83,84
050,51,135,"Virginia","Nottoway County",1,13,189,101,88
050,51,135,"Virginia","Nottoway County",1,14,186,98,88
050,51,135,"Virginia","Nottoway County",1,15,170,90,80
050,51,135,"Virginia","Nottoway County",1,16,187,101,86
050,51,135,"Virginia","Nottoway County",1,17,195,100,95
050,51,135,"Virginia","Nottoway County",1,18,152,76,76
050,51,135,"Virginia","Nottoway County",1,19,142,75,67
050,51,135,"Virginia","Nottoway County",1,20,164,89,75
050,51,135,"Virginia","Nottoway County",1,21,190,115,75
050,51,135,"Virginia","Nottoway County",1,22,216,132,84
050,51,135,"Virginia","Nottoway County",1,23,214,133,81
050,51,135,"Virginia","Nottoway County",1,24,224,146,78
050,51,135,"Virginia","Nottoway County",1,25,228,152,76
050,51,135,"Virginia","Nottoway County",1,26,223,141,82
050,51,135,"Virginia","Nottoway County",1,27,212,132,80
050,51,135,"Virginia","Nottoway County",1,28,225,147,78
050,51,135,"Virginia","Nottoway County",1,29,252,159,93
050,51,135,"Virginia","Nottoway County",1,30,243,150,93
050,51,135,"Virginia","Nottoway County",1,31,218,145,73
050,51,135,"Virginia","Nottoway County",1,32,191,123,68
050,51,135,"Virginia","Nottoway County",1,33,193,124,69
050,51,135,"Virginia","Nottoway County",1,34,202,125,77
050,51,135,"Virginia","Nottoway County",1,35,214,130,84
050,51,135,"Virginia","Nottoway County",1,36,202,104,98
050,51,135,"Virginia","Nottoway County",1,37,217,116,101
050,51,135,"Virginia","Nottoway County",1,38,183,106,77
050,51,135,"Virginia","Nottoway County",1,39,189,108,81
050,51,135,"Virginia","Nottoway County",1,40,229,132,97
050,51,135,"Virginia","Nottoway County",1,41,213,119,94
050,51,135,"Virginia","Nottoway County",1,42,162,95,67
050,51,135,"Virginia","Nottoway County",1,43,202,123,79
050,51,135,"Virginia","Nottoway County",1,44,192,116,76
050,51,135,"Virginia","Nottoway County",1,45,185,112,73
050,51,135,"Virginia","Nottoway County",1,46,178,115,63
050,51,135,"Virginia","Nottoway County",1,47,196,130,66
050,51,135,"Virginia","Nottoway County",1,48,202,126,76
050,51,135,"Virginia","Nottoway County",1,49,218,136,82
050,51,135,"Virginia","Nottoway County",1,50,192,118,74
050,51,135,"Virginia","Nottoway County",1,51,208,123,85
050,51,135,"Virginia","Nottoway County",1,52,228,131,97
050,51,135,"Virginia","Nottoway County",1,53,193,107,86
050,51,135,"Virginia","Nottoway County",1,54,197,102,95
050,51,135,"Virginia","Nottoway County",1,55,240,129,111
050,51,135,"Virginia","Nottoway County",1,56,236,124,112
050,51,135,"Virginia","Nottoway County",1,57,222,125,97
050,51,135,"Virginia","Nottoway County",1,58,240,124,116
050,51,135,"Virginia","Nottoway County",1,59,224,108,116
050,51,135,"Virginia","Nottoway County",1,60,206,101,105
050,51,135,"Virginia","Nottoway County",1,61,214,110,104
050,51,135,"Virginia","Nottoway County",1,62,222,110,112
050,51,135,"Virginia","Nottoway County",1,63,213,108,105
050,51,135,"Virginia","Nottoway County",1,64,205,99,106
050,51,135,"Virginia","Nottoway County",1,65,202,97,105
050,51,135,"Virginia","Nottoway County",1,66,179,89,90
050,51,135,"Virginia","Nottoway County",1,67,189,91,98
050,51,135,"Virginia","Nottoway County",1,68,184,90,94
050,51,135,"Virginia","Nottoway County",1,69,173,90,83
050,51,135,"Virginia","Nottoway County",1,70,163,75,88
050,51,135,"Virginia","Nottoway County",1,71,149,63,86
050,51,135,"Virginia","Nottoway County",1,72,150,69,81
050,51,135,"Virginia","Nottoway County",1,73,163,74,89
050,51,135,"Virginia","Nottoway County",1,74,108,48,60
050,51,135,"Virginia","Nottoway County",1,75,108,51,57
050,51,135,"Virginia","Nottoway County",1,76,114,44,70
050,51,135,"Virginia","Nottoway County",1,77,110,42,68
050,51,135,"Virginia","Nottoway County",1,78,99,40,59
050,51,135,"Virginia","Nottoway County",1,79,94,36,58
050,51,135,"Virginia","Nottoway County",1,80,81,37,44
050,51,135,"Virginia","Nottoway County",1,81,84,38,46
050,51,135,"Virginia","Nottoway County",1,82,53,24,29
050,51,135,"Virginia","Nottoway County",1,83,58,22,36
050,51,135,"Virginia","Nottoway County",1,84,72,26,46
050,51,135,"Virginia","Nottoway County",1,85,335,120,215
050,51,135,"Virginia","Nottoway County",2,0,164,82,82
050,51,135,"Virginia","Nottoway County",2,1,173,94,79
050,51,135,"Virginia","Nottoway County",2,2,161,85,76
050,51,135,"Virginia","Nottoway County",2,3,142,68,74
050,51,135,"Virginia","Nottoway County",2,4,151,75,76
050,51,135,"Virginia","Nottoway County",2,5,171,91,80
050,51,135,"Virginia","Nottoway County",2,6,163,84,79
050,51,135,"Virginia","Nottoway County",2,7,173,80,93
050,51,135,"Virginia","Nottoway County",2,8,164,74,90
050,51,135,"Virginia","Nottoway County",2,9,164,79,85
050,51,135,"Virginia","Nottoway County",2,10,168,88,80
050,51,135,"Virginia","Nottoway County",2,11,171,83,88
050,51,135,"Virginia","Nottoway County",2,12,168,83,85
050,51,135,"Virginia","Nottoway County",2,13,181,96,85
050,51,135,"Virginia","Nottoway County",2,14,185,96,89
050,51,135,"Virginia","Nottoway County",2,15,174,92,82
050,51,135,"Virginia","Nottoway County",2,16,181,98,83
050,51,135,"Virginia","Nottoway County",2,17,196,101,95
050,51,135,"Virginia","Nottoway County",2,18,157,81,76
050,51,135,"Virginia","Nottoway County",2,19,143,77,66
050,51,135,"Virginia","Nottoway County",2,20,164,89,75
050,51,135,"Virginia","Nottoway County",2,21,191,115,76
050,51,135,"Virginia","Nottoway County",2,22,215,131,84
050,51,135,"Virginia","Nottoway County",2,23,220,137,83
050,51,135,"Virginia","Nottoway County",2,24,223,144,79
050,51,135,"Virginia","Nottoway County",2,25,230,153,77
050,51,135,"Virginia","Nottoway County",2,26,220,139,81
050,51,135,"Virginia","Nottoway County",2,27,218,137,81
050,51,135,"Virginia","Nottoway County",2,28,222,143,79
050,51,135,"Virginia","Nottoway County",2,29,248,157,91
050,51,135,"Virginia","Nottoway County",2,30,246,153,93
050,51,135,"Virginia","Nottoway County",2,31,224,148,76
050,51,135,"Virginia","Nottoway County",2,32,192,123,69
050,51,135,"Virginia","Nottoway County",2,33,189,122,67
050,51,135,"Virginia","Nottoway County",2,34,199,124,75
050,51,135,"Virginia","Nottoway County",2,35,211,128,83
050,51,135,"Virginia","Nottoway County",2,36,199,105,94
050,51,135,"Virginia","Nottoway County",2,37,212,113,99
050,51,135,"Virginia","Nottoway County",2,38,191,109,82
050,51,135,"Virginia","Nottoway County",2,39,190,111,79
050,51,135,"Virginia","Nottoway County",2,40,226,130,96
050,51,135,"Virginia","Nottoway County",2,41,212,118,94
050,51,135,"Virginia","Nottoway County",2,42,175,101,74
050,51,135,"Virginia","Nottoway County",2,43,199,122,77
050,51,135,"Virginia","Nottoway County",2,44,192,117,75
050,51,135,"Virginia","Nottoway County",2,45,185,112,73
050,51,135,"Virginia","Nottoway County",2,46,180,114,66
050,51,135,"Virginia","Nottoway County",2,47,193,128,65
050,51,135,"Virginia","Nottoway County",2,48,201,128,73
050,51,135,"Virginia","Nottoway County",2,49,215,133,82
050,51,135,"Virginia","Nottoway County",2,50,196,120,76
050,51,135,"Virginia","Nottoway County",2,51,203,121,82
050,51,135,"Virginia","Nottoway County",2,52,223,130,93
050,51,135,"Virginia","Nottoway County",2,53,196,108,88
050,51,135,"Virginia","Nottoway County",2,54,195,102,93
050,51,135,"Virginia","Nottoway County",2,55,233,125,108
050,51,135,"Virginia","Nottoway County",2,56,236,124,112
050,51,135,"Virginia","Nottoway County",2,57,223,123,100
050,51,135,"Virginia","Nottoway County",2,58,236,124,112
050,51,135,"Virginia","Nottoway County",2,59,229,112,117
050,51,135,"Virginia","Nottoway County",2,60,211,103,108
050,51,135,"Virginia","Nottoway County",2,61,212,108,104
050,51,135,"Virginia","Nottoway County",2,62,220,110,110
050,51,135,"Virginia","Nottoway County",2,63,216,107,109
050,51,135,"Virginia","Nottoway County",2,64,206,101,105
050,51,135,"Virginia","Nottoway County",2,65,203,97,106
050,51,135,"Virginia","Nottoway County",2,66,183,89,94
050,51,135,"Virginia","Nottoway County",2,67,187,90,97
050,51,135,"Virginia","Nottoway County",2,68,184,90,94
050,51,135,"Virginia","Nottoway County",2,69,174,89,85
050,51,135,"Virginia","Nottoway County",2,70,164,78,86
050,51,135,"Virginia","Nottoway County",2,71,153,65,88
050,51,135,"Virginia","Nottoway County",2,72,146,66,80
050,51,135,"Virginia","Nottoway County",2,73,168,76,92
050,51,135,"Virginia","Nottoway County",2,74,112,51,61
050,51,135,"Virginia","Nottoway County",2,75,108,51,57
050,51,135,"Virginia","Nottoway County",2,76,111,45,66
050,51,135,"Virginia","Nottoway County",2,77,111,42,69
050,51,135,"Virginia","Nottoway County",2,78,99,41,58
050,51,135,"Virginia","Nottoway County",2,79,93,35,58
050,51,135,"Virginia","Nottoway County",2,80,82,37,45
050,51,135,"Virginia","Nottoway County",2,81,84,38,46
050,51,135,"Virginia","Nottoway County",2,82,57,27,30
050,51,135,"Virginia","Nottoway County",2,83,57,22,35
050,51,135,"Virginia","Nottoway County",2,84,67,24,43
050,51,135,"Virginia","Nottoway County",2,85,337,120,217
050,51,135,"Virginia","Nottoway County",3,0,149,83,66
050,51,135,"Virginia","Nottoway County",3,1,152,76,76
050,51,135,"Virginia","Nottoway County",3,2,155,81,74
050,51,135,"Virginia","Nottoway County",3,3,163,85,78
050,51,135,"Virginia","Nottoway County",3,4,141,73,68
050,51,135,"Virginia","Nottoway County",3,5,158,83,75
050,51,135,"Virginia","Nottoway County",3,6,170,90,80
050,51,135,"Virginia","Nottoway County",3,7,160,82,78
050,51,135,"Virginia","Nottoway County",3,8,167,79,88
050,51,135,"Virginia","Nottoway County",3,9,166,78,88
050,51,135,"Virginia","Nottoway County",3,10,161,80,81
050,51,135,"Virginia","Nottoway County",3,11,169,90,79
050,51,135,"Virginia","Nottoway County",3,12,182,91,91
050,51,135,"Virginia","Nottoway County",3,13,165,85,80
050,51,135,"Virginia","Nottoway County",3,14,185,93,92
050,51,135,"Virginia","Nottoway County",3,15,189,98,91
050,51,135,"Virginia","Nottoway County",3,16,162,83,79
050,51,135,"Virginia","Nottoway County",3,17,178,97,81
050,51,135,"Virginia","Nottoway County",3,18,165,85,80
050,51,135,"Virginia","Nottoway County",3,19,138,76,62
050,51,135,"Virginia","Nottoway County",3,20,160,88,72
050,51,135,"Virginia","Nottoway County",3,21,188,109,79
050,51,135,"Virginia","Nottoway County",3,22,202,125,77
050,51,135,"Virginia","Nottoway County",3,23,222,139,83
050,51,135,"Virginia","Nottoway County",3,24,224,144,80
050,51,135,"Virginia","Nottoway County",3,25,216,145,71
050,51,135,"Virginia","Nottoway County",3,26,211,130,81
050,51,135,"Virginia","Nottoway County",3,27,222,151,71
050,51,135,"Virginia","Nottoway County",3,28,208,131,77
050,51,135,"Virginia","Nottoway County",3,29,240,158,82
050,51,135,"Virginia","Nottoway County",3,30,239,153,86
050,51,135,"Virginia","Nottoway County",3,31,264,173,91
050,51,135,"Virginia","Nottoway County",3,32,209,131,78
050,51,135,"Virginia","Nottoway County",3,33,195,121,74
050,51,135,"Virginia","Nottoway County",3,34,201,129,72
050,51,135,"Virginia","Nottoway County",3,35,214,137,77
050,51,135,"Virginia","Nottoway County",3,36,203,119,84
050,51,135,"Virginia","Nottoway County",3,37,205,112,93
050,51,135,"Virginia","Nottoway County",3,38,208,112,96
050,51,135,"Virginia","Nottoway County",3,39,196,122,74
050,51,135,"Virginia","Nottoway County",3,40,200,121,79
050,51,135,"Virginia","Nottoway County",3,41,206,106,100
050,51,135,"Virginia","Nottoway County",3,42,206,117,89
050,51,135,"Virginia","Nottoway County",3,43,198,123,75
050,51,135,"Virginia","Nottoway County",3,44,195,119,76
050,51,135,"Virginia","Nottoway County",3,45,198,118,80
050,51,135,"Virginia","Nottoway County",3,46,187,113,74
050,51,135,"Virginia","Nottoway County",3,47,190,123,67
050,51,135,"Virginia","Nottoway County",3,48,187,123,64
050,51,135,"Virginia","Nottoway County",3,49,205,123,82
050,51,135,"Virginia","Nottoway County",3,50,200,119,81
050,51,135,"Virginia","Nottoway County",3,51,199,125,74
050,51,135,"Virginia","Nottoway County",3,52,212,123,89
050,51,135,"Virginia","Nottoway County",3,53,212,119,93
050,51,135,"Virginia","Nottoway County",3,54,195,108,87
050,51,135,"Virginia","Nottoway County",3,55,211,115,96
050,51,135,"Virginia","Nottoway County",3,56,224,115,109
050,51,135,"Virginia","Nottoway County",3,57,225,116,109
050,51,135,"Virginia","Nottoway County",3,58,231,131,100
050,51,135,"Virginia","Nottoway County",3,59,237,127,110
050,51,135,"Virginia","Nottoway County",3,60,225,111,114
050,51,135,"Virginia","Nottoway County",3,61,218,108,110
050,51,135,"Virginia","Nottoway County",3,62,211,107,104
050,51,135,"Virginia","Nottoway County",3,63,215,106,109
050,51,135,"Virginia","Nottoway County",3,64,205,104,101
050,51,135,"Virginia","Nottoway County",3,65,209,105,104
050,51,135,"Virginia","Nottoway County",3,66,183,88,95
050,51,135,"Virginia","Nottoway County",3,67,177,84,93
050,51,135,"Virginia","Nottoway County",3,68,192,92,100
050,51,135,"Virginia","Nottoway County",3,69,181,88,93
050,51,135,"Virginia","Nottoway County",3,70,162,81,81
050,51,135,"Virginia","Nottoway County",3,71,156,72,84
050,51,135,"Virginia","Nottoway County",3,72,139,58,81
050,51,135,"Virginia","Nottoway County",3,73,142,63,79
050,51,135,"Virginia","Nottoway County",3,74,159,74,85
050,51,135,"Virginia","Nottoway County",3,75,108,50,58
050,51,135,"Virginia","Nottoway County",3,76,108,49,59
050,51,135,"Virginia","Nottoway County",3,77,104,42,62
050,51,135,"Virginia","Nottoway County",3,78,103,42,61
050,51,135,"Virginia","Nottoway County",3,79,96,36,60
050,51,135,"Virginia","Nottoway County",3,80,80,32,48
050,51,135,"Virginia","Nottoway County",3,81,84,38,46
050,51,135,"Virginia","Nottoway County",3,82,70,33,37
050,51,135,"Virginia","Nottoway County",3,83,52,21,31
050,51,135,"Virginia","Nottoway County",3,84,49,17,32
050,51,135,"Virginia","Nottoway County",3,85,326,116,210
050,51,135,"Virginia","Nottoway County",4,0,170,91,79
050,51,135,"Virginia","Nottoway County",4,1,148,79,69
050,51,135,"Virginia","Nottoway County",4,2,166,86,80
050,51,135,"Virginia","Nottoway County",4,3,168,90,78
050,51,135,"Virginia","Nottoway County",4,4,173,89,84
050,51,135,"Virginia","Nottoway County",4,5,158,76,82
050,51,135,"Virginia","Nottoway County",4,6,158,81,77
050,51,135,"Virginia","Nottoway County",4,7,167,85,82
050,51,135,"Virginia","Nottoway County",4,8,165,81,84
050,51,135,"Virginia","Nottoway County",4,9,178,87,91
050,51,135,"Virginia","Nottoway County",4,10,179,83,96
050,51,135,"Virginia","Nottoway County",4,11,167,80,87
050,51,135,"Virginia","Nottoway County",4,12,178,94,84
050,51,135,"Virginia","Nottoway County",4,13,179,93,86
050,51,135,"Virginia","Nottoway County",4,14,163,83,80
050,51,135,"Virginia","Nottoway County",4,15,178,86,92
050,51,135,"Virginia","Nottoway County",4,16,187,95,92
050,51,135,"Virginia","Nottoway County",4,17,165,85,80
050,51,135,"Virginia","Nottoway County",4,18,162,93,69
050,51,135,"Virginia","Nottoway County",4,19,140,77,63
050,51,135,"Virginia","Nottoway County",4,20,163,91,72
050,51,135,"Virginia","Nottoway County",4,21,177,98,79
050,51,135,"Virginia","Nottoway County",4,22,204,125,79
050,51,135,"Virginia","Nottoway County",4,23,217,140,77
050,51,135,"Virginia","Nottoway County",4,24,220,153,67
050,51,135,"Virginia","Nottoway County",4,25,231,155,76
050,51,135,"Virginia","Nottoway County",4,26,189,127,62
050,51,135,"Virginia","Nottoway County",4,27,227,142,85
050,51,135,"Virginia","Nottoway County",4,28,220,147,73
050,51,135,"Virginia","Nottoway County",4,29,218,138,80
050,51,135,"Virginia","Nottoway County",4,30,236,157,79
050,51,135,"Virginia","Nottoway County",4,31,246,164,82
050,51,135,"Virginia","Nottoway County",4,32,253,151,102
050,51,135,"Virginia","Nottoway County",4,33,207,123,84
050,51,135,"Virginia","Nottoway County",4,34,193,114,79
050,51,135,"Virginia","Nottoway County",4,35,208,136,72
050,51,135,"Virginia","Nottoway County",4,36,195,120,75
050,51,135,"Virginia","Nottoway County",4,37,188,104,84
050,51,135,"Virginia","Nottoway County",4,38,206,114,92
050,51,135,"Virginia","Nottoway County",4,39,229,131,98
050,51,135,"Virginia","Nottoway County",4,40,199,125,74
050,51,135,"Virginia","Nottoway County",4,41,189,103,86
050,51,135,"Virginia","Nottoway County",4,42,201,104,97
050,51,135,"Virginia","Nottoway County",4,43,222,132,90
050,51,135,"Virginia","Nottoway County",4,44,188,108,80
050,51,135,"Virginia","Nottoway County",4,45,181,107,74
050,51,135,"Virginia","Nottoway County",4,46,199,114,85
050,51,135,"Virginia","Nottoway County",4,47,186,107,79
050,51,135,"Virginia","Nottoway County",4,48,185,115,70
050,51,135,"Virginia","Nottoway County",4,49,203,129,74
050,51,135,"Virginia","Nottoway County",4,50,198,120,78
050,51,135,"Virginia","Nottoway County",4,51,193,113,80
050,51,135,"Virginia","Nottoway County",4,52,201,128,73
050,51,135,"Virginia","Nottoway County",4,53,200,112,88
050,51,135,"Virginia","Nottoway County",4,54,204,111,93
050,51,135,"Virginia","Nottoway County",4,55,203,116,87
050,51,135,"Virginia","Nottoway County",4,56,200,100,100
050,51,135,"Virginia","Nottoway County",4,57,213,105,108
050,51,135,"Virginia","Nottoway County",4,58,228,121,107
050,51,135,"Virginia","Nottoway County",4,59,228,123,105
050,51,135,"Virginia","Nottoway County",4,60,227,119,108
050,51,135,"Virginia","Nottoway County",4,61,226,112,114
050,51,135,"Virginia","Nottoway County",4,62,214,105,109
050,51,135,"Virginia","Nottoway County",4,63,212,108,104
050,51,135,"Virginia","Nottoway County",4,64,199,100,99
050,51,135,"Virginia","Nottoway County",4,65,210,104,106
050,51,135,"Virginia","Nottoway County",4,66,199,100,99
050,51,135,"Virginia","Nottoway County",4,67,179,84,95
050,51,135,"Virginia","Nottoway County",4,68,178,84,94
050,51,135,"Virginia","Nottoway County",4,69,179,88,91
050,51,135,"Virginia","Nottoway County",4,70,169,79,90
050,51,135,"Virginia","Nottoway County",4,71,155,77,78
050,51,135,"Virginia","Nottoway County",4,72,139,64,75
050,51,135,"Virginia","Nottoway County",4,73,143,57,86
050,51,135,"Virginia","Nottoway County",4,74,128,57,71
050,51,135,"Virginia","Nottoway County",4,75,151,66,85
050,51,135,"Virginia","Nottoway County",4,76,104,47,57
050,51,135,"Virginia","Nottoway County",4,77,105,46,59
050,51,135,"Virginia","Nottoway County",4,78,98,41,57
050,51,135,"Virginia","Nottoway County",4,79,94,32,62
050,51,135,"Virginia","Nottoway County",4,80,81,32,49
050,51,135,"Virginia","Nottoway County",4,81,82,31,51
050,51,135,"Virginia","Nottoway County",4,82,66,33,33
050,51,135,"Virginia","Nottoway County",4,83,73,30,43
050,51,135,"Virginia","Nottoway County",4,84,46,17,29
050,51,135,"Virginia","Nottoway County",4,85,301,108,193
050,51,135,"Virginia","Nottoway County",5,0,169,90,79
050,51,135,"Virginia","Nottoway County",5,1,158,88,70
050,51,135,"Virginia","Nottoway County",5,2,156,84,72
050,51,135,"Virginia","Nottoway County",5,3,173,90,83
050,51,135,"Virginia","Nottoway County",5,4,176,97,79
050,51,135,"Virginia","Nottoway County",5,5,188,93,95
050,51,135,"Virginia","Nottoway County",5,6,144,66,78
050,51,135,"Virginia","Nottoway County",5,7,155,77,78
050,51,135,"Virginia","Nottoway County",5,8,170,84,86
050,51,135,"Virginia","Nottoway County",5,9,164,79,85
050,51,135,"Virginia","Nottoway County",5,10,169,83,86
050,51,135,"Virginia","Nottoway County",5,11,185,83,102
050,51,135,"Virginia","Nottoway County",5,12,168,83,85
050,51,135,"Virginia","Nottoway County",5,13,177,98,79
050,51,135,"Virginia","Nottoway County",5,14,181,91,90
050,51,135,"Virginia","Nottoway County",5,15,155,80,75
050,51,135,"Virginia","Nottoway County",5,16,185,84,101
050,51,135,"Virginia","Nottoway County",5,17,197,100,97
050,51,135,"Virginia","Nottoway County",5,18,147,76,71
050,51,135,"Virginia","Nottoway County",5,19,148,87,61
050,51,135,"Virginia","Nottoway County",5,20,162,93,69
050,51,135,"Virginia","Nottoway County",5,21,184,112,72
050,51,135,"Virginia","Nottoway County",5,22,187,110,77
050,51,135,"Virginia","Nottoway County",5,23,204,125,79
050,51,135,"Virginia","Nottoway County",5,24,222,150,72
050,51,135,"Virginia","Nottoway County",5,25,227,154,73
050,51,135,"Virginia","Nottoway County",5,26,229,147,82
050,51,135,"Virginia","Nottoway County",5,27,202,142,60
050,51,135,"Virginia","Nottoway County",5,28,228,141,87
050,51,135,"Virginia","Nottoway County",5,29,225,147,78
050,51,135,"Virginia","Nottoway County",5,30,232,145,87
050,51,135,"Virginia","Nottoway County",5,31,254,181,73
050,51,135,"Virginia","Nottoway County",5,32,238,152,86
050,51,135,"Virginia","Nottoway County",5,33,236,144,92
050,51,135,"Virginia","Nottoway County",5,34,207,123,84
050,51,135,"Virginia","Nottoway County",5,35,212,123,89
050,51,135,"Virginia","Nottoway County",5,36,195,120,75
050,51,135,"Virginia","Nottoway County",5,37,194,123,71
050,51,135,"Virginia","Nottoway County",5,38,180,102,78
050,51,135,"Virginia","Nottoway County",5,39,211,123,88
050,51,135,"Virginia","Nottoway County",5,40,229,132,97
050,51,135,"Virginia","Nottoway County",5,41,192,114,78
050,51,135,"Virginia","Nottoway County",5,42,189,104,85
050,51,135,"Virginia","Nottoway County",5,43,225,123,102
050,51,135,"Virginia","Nottoway County",5,44,219,124,95
050,51,135,"Virginia","Nottoway County",5,45,188,105,83
050,51,135,"Virginia","Nottoway County",5,46,179,111,68
050,51,135,"Virginia","Nottoway County",5,47,209,122,87
050,51,135,"Virginia","Nottoway County",5,48,172,95,77
050,51,135,"Virginia","Nottoway County",5,49,186,113,73
050,51,135,"Virginia","Nottoway County",5,50,200,123,77
050,51,135,"Virginia","Nottoway County",5,51,201,122,79
050,51,135,"Virginia","Nottoway County",5,52,186,112,74
050,51,135,"Virginia","Nottoway County",5,53,192,115,77
050,51,135,"Virginia","Nottoway County",5,54,193,107,86
050,51,135,"Virginia","Nottoway County",5,55,214,123,91
050,51,135,"Virginia","Nottoway County",5,56,183,98,85
050,51,135,"Virginia","Nottoway County",5,57,185,96,89
050,51,135,"Virginia","Nottoway County",5,58,214,108,106
050,51,135,"Virginia","Nottoway County",5,59,229,121,108
050,51,135,"Virginia","Nottoway County",5,60,218,113,105
050,51,135,"Virginia","Nottoway County",5,61,226,118,108
050,51,135,"Virginia","Nottoway County",5,62,215,104,111
050,51,135,"Virginia","Nottoway County",5,63,209,103,106
050,51,135,"Virginia","Nottoway County",5,64,211,108,103
050,51,135,"Virginia","Nottoway County",5,65,211,105,106
050,51,135,"Virginia","Nottoway County",5,66,199,97,102
050,51,135,"Virginia","Nottoway County",5,67,197,99,98
050,51,135,"Virginia","Nottoway County",5,68,176,82,94
050,51,135,"Virginia","Nottoway County",5,69,172,84,88
050,51,135,"Virginia","Nottoway County",5,70,176,80,96
050,51,135,"Virginia","Nottoway County",5,71,167,78,89
050,51,135,"Virginia","Nottoway County",5,72,145,71,74
050,51,135,"Virginia","Nottoway County",5,73,143,61,82
050,51,135,"Virginia","Nottoway County",5,74,131,55,76
050,51,135,"Virginia","Nottoway County",5,75,120,51,69
050,51,135,"Virginia","Nottoway County",5,76,143,62,81
050,51,135,"Virginia","Nottoway County",5,77,98,43,55
050,51,135,"Virginia","Nottoway County",5,78,99,45,54
050,51,135,"Virginia","Nottoway County",5,79,90,33,57
050,51,135,"Virginia","Nottoway County",5,80,83,29,54
050,51,135,"Virginia","Nottoway County",5,81,79,32,47
050,51,135,"Virginia","Nottoway County",5,82,67,26,41
050,51,135,"Virginia","Nottoway County",5,83,65,30,35
050,51,135,"Virginia","Nottoway County",5,84,64,27,37
050,51,135,"Virginia","Nottoway County",5,85,283,104,179
050,51,137,"Virginia","Orange County",1,0,379,196,183
050,51,137,"Virginia","Orange County",1,1,410,209,201
050,51,137,"Virginia","Orange County",1,2,430,221,209
050,51,137,"Virginia","Orange County",1,3,403,198,205
050,51,137,"Virginia","Orange County",1,4,406,205,201
050,51,137,"Virginia","Orange County",1,5,414,205,209
050,51,137,"Virginia","Orange County",1,6,413,207,206
050,51,137,"Virginia","Orange County",1,7,430,214,216
050,51,137,"Virginia","Orange County",1,8,435,209,226
050,51,137,"Virginia","Orange County",1,9,464,240,224
050,51,137,"Virginia","Orange County",1,10,431,211,220
050,51,137,"Virginia","Orange County",1,11,460,221,239
050,51,137,"Virginia","Orange County",1,12,449,215,234
050,51,137,"Virginia","Orange County",1,13,451,227,224
050,51,137,"Virginia","Orange County",1,14,413,214,199
050,51,137,"Virginia","Orange County",1,15,414,196,218
050,51,137,"Virginia","Orange County",1,16,431,218,213
050,51,137,"Virginia","Orange County",1,17,447,227,220
050,51,137,"Virginia","Orange County",1,18,383,210,173
050,51,137,"Virginia","Orange County",1,19,322,175,147
050,51,137,"Virginia","Orange County",1,20,355,192,163
050,51,137,"Virginia","Orange County",1,21,382,194,188
050,51,137,"Virginia","Orange County",1,22,393,192,201
050,51,137,"Virginia","Orange County",1,23,386,193,193
050,51,137,"Virginia","Orange County",1,24,431,223,208
050,51,137,"Virginia","Orange County",1,25,404,202,202
050,51,137,"Virginia","Orange County",1,26,422,215,207
050,51,137,"Virginia","Orange County",1,27,437,225,212
050,51,137,"Virginia","Orange County",1,28,430,218,212
050,51,137,"Virginia","Orange County",1,29,421,206,215
050,51,137,"Virginia","Orange County",1,30,444,223,221
050,51,137,"Virginia","Orange County",1,31,405,206,199
050,51,137,"Virginia","Orange County",1,32,424,216,208
050,51,137,"Virginia","Orange County",1,33,402,187,215
050,51,137,"Virginia","Orange County",1,34,444,208,236
050,51,137,"Virginia","Orange County",1,35,434,215,219
050,51,137,"Virginia","Orange County",1,36,453,235,218
050,51,137,"Virginia","Orange County",1,37,440,234,206
050,51,137,"Virginia","Orange County",1,38,437,223,214
050,51,137,"Virginia","Orange County",1,39,433,211,222
050,51,137,"Virginia","Orange County",1,40,397,193,204
050,51,137,"Virginia","Orange County",1,41,398,205,193
050,51,137,"Virginia","Orange County",1,42,381,191,190
050,51,137,"Virginia","Orange County",1,43,390,186,204
050,51,137,"Virginia","Orange County",1,44,412,201,211
050,51,137,"Virginia","Orange County",1,45,422,197,225
050,51,137,"Virginia","Orange County",1,46,422,206,216
050,51,137,"Virginia","Orange County",1,47,370,173,197
050,51,137,"Virginia","Orange County",1,48,439,224,215
050,51,137,"Virginia","Orange County",1,49,532,257,275
050,51,137,"Virginia","Orange County",1,50,521,258,263
050,51,137,"Virginia","Orange County",1,51,482,250,232
050,51,137,"Virginia","Orange County",1,52,450,235,215
050,51,137,"Virginia","Orange County",1,53,485,226,259
050,51,137,"Virginia","Orange County",1,54,516,253,263
050,51,137,"Virginia","Orange County",1,55,578,278,300
050,51,137,"Virginia","Orange County",1,56,566,274,292
050,51,137,"Virginia","Orange County",1,57,564,273,291
050,51,137,"Virginia","Orange County",1,58,554,273,281
050,51,137,"Virginia","Orange County",1,59,571,288,283
050,51,137,"Virginia","Orange County",1,60,535,259,276
050,51,137,"Virginia","Orange County",1,61,541,258,283
050,51,137,"Virginia","Orange County",1,62,535,261,274
050,51,137,"Virginia","Orange County",1,63,508,252,256
050,51,137,"Virginia","Orange County",1,64,512,257,255
050,51,137,"Virginia","Orange County",1,65,497,233,264
050,51,137,"Virginia","Orange County",1,66,476,211,265
050,51,137,"Virginia","Orange County",1,67,449,202,247
050,51,137,"Virginia","Orange County",1,68,434,189,245
050,51,137,"Virginia","Orange County",1,69,437,204,233
050,51,137,"Virginia","Orange County",1,70,405,178,227
050,51,137,"Virginia","Orange County",1,71,424,196,228
050,51,137,"Virginia","Orange County",1,72,437,199,238
050,51,137,"Virginia","Orange County",1,73,430,189,241
050,51,137,"Virginia","Orange County",1,74,292,133,159
050,51,137,"Virginia","Orange County",1,75,306,139,167
050,51,137,"Virginia","Orange County",1,76,300,129,171
050,51,137,"Virginia","Orange County",1,77,315,156,159
050,51,137,"Virginia","Orange County",1,78,270,131,139
050,51,137,"Virginia","Orange County",1,79,236,111,125
050,51,137,"Virginia","Orange County",1,80,215,88,127
050,51,137,"Virginia","Orange County",1,81,208,93,115
050,51,137,"Virginia","Orange County",1,82,179,81,98
050,51,137,"Virginia","Orange County",1,83,177,77,100
050,51,137,"Virginia","Orange County",1,84,128,59,69
050,51,137,"Virginia","Orange County",1,85,728,280,448
050,51,137,"Virginia","Orange County",2,0,398,206,192
050,51,137,"Virginia","Orange County",2,1,406,208,198
050,51,137,"Virginia","Orange County",2,2,431,220,211
050,51,137,"Virginia","Orange County",2,3,413,207,206
050,51,137,"Virginia","Orange County",2,4,412,207,205
050,51,137,"Virginia","Orange County",2,5,417,209,208
050,51,137,"Virginia","Orange County",2,6,418,210,208
050,51,137,"Virginia","Orange County",2,7,427,212,215
050,51,137,"Virginia","Orange County",2,8,436,211,225
050,51,137,"Virginia","Orange County",2,9,465,236,229
050,51,137,"Virginia","Orange County",2,10,441,219,222
050,51,137,"Virginia","Orange County",2,11,452,217,235
050,51,137,"Virginia","Orange County",2,12,455,217,238
050,51,137,"Virginia","Orange County",2,13,450,225,225
050,51,137,"Virginia","Orange County",2,14,422,218,204
050,51,137,"Virginia","Orange County",2,15,412,199,213
050,51,137,"Virginia","Orange County",2,16,430,215,215
050,51,137,"Virginia","Orange County",2,17,447,228,219
050,51,137,"Virginia","Orange County",2,18,380,207,173
050,51,137,"Virginia","Orange County",2,19,325,177,148
050,51,137,"Virginia","Orange County",2,20,357,192,165
050,51,137,"Virginia","Orange County",2,21,382,194,188
050,51,137,"Virginia","Orange County",2,22,396,193,203
050,51,137,"Virginia","Orange County",2,23,395,196,199
050,51,137,"Virginia","Orange County",2,24,422,218,204
050,51,137,"Virginia","Orange County",2,25,415,212,203
050,51,137,"Virginia","Orange County",2,26,423,215,208
050,51,137,"Virginia","Orange County",2,27,439,224,215
050,51,137,"Virginia","Orange County",2,28,435,220,215
050,51,137,"Virginia","Orange County",2,29,428,214,214
050,51,137,"Virginia","Orange County",2,30,446,223,223
050,51,137,"Virginia","Orange County",2,31,417,212,205
050,51,137,"Virginia","Orange County",2,32,421,214,207
050,51,137,"Virginia","Orange County",2,33,408,193,215
050,51,137,"Virginia","Orange County",2,34,434,204,230
050,51,137,"Virginia","Orange County",2,35,446,218,228
050,51,137,"Virginia","Orange County",2,36,447,229,218
050,51,137,"Virginia","Orange County",2,37,453,236,217
050,51,137,"Virginia","Orange County",2,38,441,225,216
050,51,137,"Virginia","Orange County",2,39,430,211,219
050,51,137,"Virginia","Orange County",2,40,409,199,210
050,51,137,"Virginia","Orange County",2,41,399,203,196
050,51,137,"Virginia","Orange County",2,42,384,193,191
050,51,137,"Virginia","Orange County",2,43,393,191,202
050,51,137,"Virginia","Orange County",2,44,405,197,208
050,51,137,"Virginia","Orange County",2,45,424,199,225
050,51,137,"Virginia","Orange County",2,46,421,202,219
050,51,137,"Virginia","Orange County",2,47,385,182,203
050,51,137,"Virginia","Orange County",2,48,429,214,215
050,51,137,"Virginia","Orange County",2,49,518,254,264
050,51,137,"Virginia","Orange County",2,50,529,260,269
050,51,137,"Virginia","Orange County",2,51,492,251,241
050,51,137,"Virginia","Orange County",2,52,452,235,217
050,51,137,"Virginia","Orange County",2,53,479,229,250
050,51,137,"Virginia","Orange County",2,54,511,246,265
050,51,137,"Virginia","Orange County",2,55,567,274,293
050,51,137,"Virginia","Orange County",2,56,572,278,294
050,51,137,"Virginia","Orange County",2,57,568,275,293
050,51,137,"Virginia","Orange County",2,58,560,276,284
050,51,137,"Virginia","Orange County",2,59,571,285,286
050,51,137,"Virginia","Orange County",2,60,545,265,280
050,51,137,"Virginia","Orange County",2,61,537,258,279
050,51,137,"Virginia","Orange County",2,62,537,259,278
050,51,137,"Virginia","Orange County",2,63,518,256,262
050,51,137,"Virginia","Orange County",2,64,513,255,258
050,51,137,"Virginia","Orange County",2,65,503,239,264
050,51,137,"Virginia","Orange County",2,66,483,217,266
050,51,137,"Virginia","Orange County",2,67,457,204,253
050,51,137,"Virginia","Orange County",2,68,435,192,243
050,51,137,"Virginia","Orange County",2,69,438,201,237
050,51,137,"Virginia","Orange County",2,70,410,182,228
050,51,137,"Virginia","Orange County",2,71,421,191,230
050,51,137,"Virginia","Orange County",2,72,429,197,232
050,51,137,"Virginia","Orange County",2,73,451,202,249
050,51,137,"Virginia","Orange County",2,74,305,137,168
050,51,137,"Virginia","Orange County",2,75,303,139,164
050,51,137,"Virginia","Orange County",2,76,299,129,170
050,51,137,"Virginia","Orange County",2,77,314,150,164
050,51,137,"Virginia","Orange County",2,78,271,133,138
050,51,137,"Virginia","Orange County",2,79,239,113,126
050,51,137,"Virginia","Orange County",2,80,220,93,127
050,51,137,"Virginia","Orange County",2,81,205,89,116
050,51,137,"Virginia","Orange County",2,82,186,83,103
050,51,137,"Virginia","Orange County",2,83,173,76,97
050,51,137,"Virginia","Orange County",2,84,138,64,74
050,51,137,"Virginia","Orange County",2,85,727,278,449
050,51,137,"Virginia","Orange County",3,0,426,236,190
050,51,137,"Virginia","Orange County",3,1,407,210,197
050,51,137,"Virginia","Orange County",3,2,423,218,205
050,51,137,"Virginia","Orange County",3,3,468,239,229
050,51,137,"Virginia","Orange County",3,4,432,222,210
050,51,137,"Virginia","Orange County",3,5,430,229,201
050,51,137,"Virginia","Orange County",3,6,440,227,213
050,51,137,"Virginia","Orange County",3,7,434,221,213
050,51,137,"Virginia","Orange County",3,8,419,204,215
050,51,137,"Virginia","Orange County",3,9,433,216,217
050,51,137,"Virginia","Orange County",3,10,477,240,237
050,51,137,"Virginia","Orange County",3,11,461,225,236
050,51,137,"Virginia","Orange County",3,12,466,222,244
050,51,137,"Virginia","Orange County",3,13,461,226,235
050,51,137,"Virginia","Orange County",3,14,460,221,239
050,51,137,"Virginia","Orange County",3,15,416,211,205
050,51,137,"Virginia","Orange County",3,16,424,201,223
050,51,137,"Virginia","Orange County",3,17,445,227,218
050,51,137,"Virginia","Orange County",3,18,398,205,193
050,51,137,"Virginia","Orange County",3,19,334,175,159
050,51,137,"Virginia","Orange County",3,20,357,191,166
050,51,137,"Virginia","Orange County",3,21,379,197,182
050,51,137,"Virginia","Orange County",3,22,413,207,206
050,51,137,"Virginia","Orange County",3,23,413,191,222
050,51,137,"Virginia","Orange County",3,24,400,201,199
050,51,137,"Virginia","Orange County",3,25,437,235,202
050,51,137,"Virginia","Orange County",3,26,442,224,218
050,51,137,"Virginia","Orange County",3,27,447,233,214
050,51,137,"Virginia","Orange County",3,28,464,232,232
050,51,137,"Virginia","Orange County",3,29,466,236,230
050,51,137,"Virginia","Orange County",3,30,456,230,226
050,51,137,"Virginia","Orange County",3,31,483,237,246
050,51,137,"Virginia","Orange County",3,32,421,205,216
050,51,137,"Virginia","Orange County",3,33,446,230,216
050,51,137,"Virginia","Orange County",3,34,416,201,215
050,51,137,"Virginia","Orange County",3,35,456,214,242
050,51,137,"Virginia","Orange County",3,36,456,219,237
050,51,137,"Virginia","Orange County",3,37,460,236,224
050,51,137,"Virginia","Orange County",3,38,455,240,215
050,51,137,"Virginia","Orange County",3,39,454,223,231
050,51,137,"Virginia","Orange County",3,40,452,215,237
050,51,137,"Virginia","Orange County",3,41,443,216,227
050,51,137,"Virginia","Orange County",3,42,423,224,199
050,51,137,"Virginia","Orange County",3,43,400,192,208
050,51,137,"Virginia","Orange County",3,44,416,205,211
050,51,137,"Virginia","Orange County",3,45,414,204,210
050,51,137,"Virginia","Orange County",3,46,427,202,225
050,51,137,"Virginia","Orange County",3,47,424,204,220
050,51,137,"Virginia","Orange County",3,48,396,186,210
050,51,137,"Virginia","Orange County",3,49,445,217,228
050,51,137,"Virginia","Orange County",3,50,524,257,267
050,51,137,"Virginia","Orange County",3,51,513,245,268
050,51,137,"Virginia","Orange County",3,52,492,248,244
050,51,137,"Virginia","Orange County",3,53,476,250,226
050,51,137,"Virginia","Orange County",3,54,466,223,243
050,51,137,"Virginia","Orange County",3,55,523,248,275
050,51,137,"Virginia","Orange County",3,56,585,285,300
050,51,137,"Virginia","Orange County",3,57,563,276,287
050,51,137,"Virginia","Orange County",3,58,570,283,287
050,51,137,"Virginia","Orange County",3,59,572,276,296
050,51,137,"Virginia","Orange County",3,60,569,285,284
050,51,137,"Virginia","Orange County",3,61,558,270,288
050,51,137,"Virginia","Orange County",3,62,558,270,288
050,51,137,"Virginia","Orange County",3,63,540,258,282
050,51,137,"Virginia","Orange County",3,64,530,263,267
050,51,137,"Virginia","Orange County",3,65,510,253,257
050,51,137,"Virginia","Orange County",3,66,501,237,264
050,51,137,"Virginia","Orange County",3,67,480,211,269
050,51,137,"Virginia","Orange County",3,68,448,199,249
050,51,137,"Virginia","Orange County",3,69,433,192,241
050,51,137,"Virginia","Orange County",3,70,424,189,235
050,51,137,"Virginia","Orange County",3,71,409,186,223
050,51,137,"Virginia","Orange County",3,72,405,183,222
050,51,137,"Virginia","Orange County",3,73,419,195,224
050,51,137,"Virginia","Orange County",3,74,447,200,247
050,51,137,"Virginia","Orange County",3,75,284,126,158
050,51,137,"Virginia","Orange County",3,76,278,125,153
050,51,137,"Virginia","Orange County",3,77,290,128,162
050,51,137,"Virginia","Orange County",3,78,301,138,163
050,51,137,"Virginia","Orange County",3,79,261,130,131
050,51,137,"Virginia","Orange County",3,80,228,107,121
050,51,137,"Virginia","Orange County",3,81,208,83,125
050,51,137,"Virginia","Orange County",3,82,187,79,108
050,51,137,"Virginia","Orange County",3,83,178,76,102
050,51,137,"Virginia","Orange County",3,84,149,67,82
050,51,137,"Virginia","Orange County",3,85,726,276,450
050,51,137,"Virginia","Orange County",4,0,435,230,205
050,51,137,"Virginia","Orange County",4,1,434,253,181
050,51,137,"Virginia","Orange County",4,2,437,215,222
050,51,137,"Virginia","Orange County",4,3,440,227,213
050,51,137,"Virginia","Orange County",4,4,534,280,254
050,51,137,"Virginia","Orange County",4,5,453,231,222
050,51,137,"Virginia","Orange County",4,6,443,238,205
050,51,137,"Virginia","Orange County",4,7,448,230,218
050,51,137,"Virginia","Orange County",4,8,466,217,249
050,51,137,"Virginia","Orange County",4,9,441,212,229
050,51,137,"Virginia","Orange County",4,10,454,233,221
050,51,137,"Virginia","Orange County",4,11,488,247,241
050,51,137,"Virginia","Orange County",4,12,473,236,237
050,51,137,"Virginia","Orange County",4,13,467,226,241
050,51,137,"Virginia","Orange County",4,14,489,243,246
050,51,137,"Virginia","Orange County",4,15,477,227,250
050,51,137,"Virginia","Orange County",4,16,428,211,217
050,51,137,"Virginia","Orange County",4,17,441,209,232
050,51,137,"Virginia","Orange County",4,18,383,198,185
050,51,137,"Virginia","Orange County",4,19,312,164,148
050,51,137,"Virginia","Orange County",4,20,350,181,169
050,51,137,"Virginia","Orange County",4,21,350,188,162
050,51,137,"Virginia","Orange County",4,22,413,213,200
050,51,137,"Virginia","Orange County",4,23,445,231,214
050,51,137,"Virginia","Orange County",4,24,405,188,217
050,51,137,"Virginia","Orange County",4,25,417,203,214
050,51,137,"Virginia","Orange County",4,26,450,234,216
050,51,137,"Virginia","Orange County",4,27,447,220,227
050,51,137,"Virginia","Orange County",4,28,458,236,222
050,51,137,"Virginia","Orange County",4,29,490,245,245
050,51,137,"Virginia","Orange County",4,30,495,249,246
050,51,137,"Virginia","Orange County",4,31,486,241,245
050,51,137,"Virginia","Orange County",4,32,508,255,253
050,51,137,"Virginia","Orange County",4,33,439,210,229
050,51,137,"Virginia","Orange County",4,34,493,254,239
050,51,137,"Virginia","Orange County",4,35,424,195,229
050,51,137,"Virginia","Orange County",4,36,469,217,252
050,51,137,"Virginia","Orange County",4,37,458,230,228
050,51,137,"Virginia","Orange County",4,38,480,247,233
050,51,137,"Virginia","Orange County",4,39,484,255,229
050,51,137,"Virginia","Orange County",4,40,460,222,238
050,51,137,"Virginia","Orange County",4,41,448,223,225
050,51,137,"Virginia","Orange County",4,42,462,238,224
050,51,137,"Virginia","Orange County",4,43,439,233,206
050,51,137,"Virginia","Orange County",4,44,407,203,204
050,51,137,"Virginia","Orange County",4,45,411,199,212
050,51,137,"Virginia","Orange County",4,46,417,203,214
050,51,137,"Virginia","Orange County",4,47,424,201,223
050,51,137,"Virginia","Orange County",4,48,424,196,228
050,51,137,"Virginia","Orange County",4,49,392,193,199
050,51,137,"Virginia","Orange County",4,50,457,229,228
050,51,137,"Virginia","Orange County",4,51,524,262,262
050,51,137,"Virginia","Orange County",4,52,528,248,280
050,51,137,"Virginia","Orange County",4,53,507,254,253
050,51,137,"Virginia","Orange County",4,54,474,242,232
050,51,137,"Virginia","Orange County",4,55,483,216,267
050,51,137,"Virginia","Orange County",4,56,537,253,284
050,51,137,"Virginia","Orange County",4,57,599,292,307
050,51,137,"Virginia","Orange County",4,58,577,290,287
050,51,137,"Virginia","Orange County",4,59,578,290,288
050,51,137,"Virginia","Orange County",4,60,562,274,288
050,51,137,"Virginia","Orange County",4,61,579,295,284
050,51,137,"Virginia","Orange County",4,62,554,269,285
050,51,137,"Virginia","Orange County",4,63,575,276,299
050,51,137,"Virginia","Orange County",4,64,539,244,295
050,51,137,"Virginia","Orange County",4,65,546,266,280
050,51,137,"Virginia","Orange County",4,66,518,260,258
050,51,137,"Virginia","Orange County",4,67,503,239,264
050,51,137,"Virginia","Orange County",4,68,491,220,271
050,51,137,"Virginia","Orange County",4,69,442,196,246
050,51,137,"Virginia","Orange County",4,70,417,183,234
050,51,137,"Virginia","Orange County",4,71,424,192,232
050,51,137,"Virginia","Orange County",4,72,394,179,215
050,51,137,"Virginia","Orange County",4,73,392,177,215
050,51,137,"Virginia","Orange County",4,74,405,194,211
050,51,137,"Virginia","Orange County",4,75,428,192,236
050,51,137,"Virginia","Orange County",4,76,277,123,154
050,51,137,"Virginia","Orange County",4,77,269,120,149
050,51,137,"Virginia","Orange County",4,78,281,122,159
050,51,137,"Virginia","Orange County",4,79,291,139,152
050,51,137,"Virginia","Orange County",4,80,245,122,123
050,51,137,"Virginia","Orange County",4,81,213,94,119
050,51,137,"Virginia","Orange County",4,82,181,69,112
050,51,137,"Virginia","Orange County",4,83,175,69,106
050,51,137,"Virginia","Orange County",4,84,149,66,83
050,51,137,"Virginia","Orange County",4,85,753,289,464
050,51,137,"Virginia","Orange County",5,0,432,229,203
050,51,137,"Virginia","Orange County",5,1,453,239,214
050,51,137,"Virginia","Orange County",5,2,455,262,193
050,51,137,"Virginia","Orange County",5,3,430,206,224
050,51,137,"Virginia","Orange County",5,4,454,236,218
050,51,137,"Virginia","Orange County",5,5,548,290,258
050,51,137,"Virginia","Orange County",5,6,449,221,228
050,51,137,"Virginia","Orange County",5,7,446,238,208
050,51,137,"Virginia","Orange County",5,8,456,232,224
050,51,137,"Virginia","Orange County",5,9,482,220,262
050,51,137,"Virginia","Orange County",5,10,444,208,236
050,51,137,"Virginia","Orange County",5,11,451,227,224
050,51,137,"Virginia","Orange County",5,12,485,243,242
050,51,137,"Virginia","Orange County",5,13,472,240,232
050,51,137,"Virginia","Orange County",5,14,489,231,258
050,51,137,"Virginia","Orange County",5,15,479,238,241
050,51,137,"Virginia","Orange County",5,16,475,220,255
050,51,137,"Virginia","Orange County",5,17,434,217,217
050,51,137,"Virginia","Orange County",5,18,369,180,189
050,51,137,"Virginia","Orange County",5,19,314,164,150
050,51,137,"Virginia","Orange County",5,20,333,165,168
050,51,137,"Virginia","Orange County",5,21,372,199,173
050,51,137,"Virginia","Orange County",5,22,367,190,177
050,51,137,"Virginia","Orange County",5,23,424,215,209
050,51,137,"Virginia","Orange County",5,24,462,231,231
050,51,137,"Virginia","Orange County",5,25,411,188,223
050,51,137,"Virginia","Orange County",5,26,412,210,202
050,51,137,"Virginia","Orange County",5,27,478,248,230
050,51,137,"Virginia","Orange County",5,28,465,219,246
050,51,137,"Virginia","Orange County",5,29,474,259,215
050,51,137,"Virginia","Orange County",5,30,520,258,262
050,51,137,"Virginia","Orange County",5,31,506,256,250
050,51,137,"Virginia","Orange County",5,32,506,254,252
050,51,137,"Virginia","Orange County",5,33,517,262,255
050,51,137,"Virginia","Orange County",5,34,431,211,220
050,51,137,"Virginia","Orange County",5,35,489,253,236
050,51,137,"Virginia","Orange County",5,36,441,207,234
050,51,137,"Virginia","Orange County",5,37,496,239,257
050,51,137,"Virginia","Orange County",5,38,465,235,230
050,51,137,"Virginia","Orange County",5,39,495,256,239
050,51,137,"Virginia","Orange County",5,40,501,258,243
050,51,137,"Virginia","Orange County",5,41,452,223,229
050,51,137,"Virginia","Orange County",5,42,465,223,242
050,51,137,"Virginia","Orange County",5,43,450,225,225
050,51,137,"Virginia","Orange County",5,44,448,240,208
050,51,137,"Virginia","Orange County",5,45,409,200,209
050,51,137,"Virginia","Orange County",5,46,413,202,211
050,51,137,"Virginia","Orange County",5,47,419,208,211
050,51,137,"Virginia","Orange County",5,48,422,198,224
050,51,137,"Virginia","Orange County",5,49,422,198,224
050,51,137,"Virginia","Orange County",5,50,400,195,205
050,51,137,"Virginia","Orange County",5,51,454,239,215
050,51,137,"Virginia","Orange County",5,52,541,266,275
050,51,137,"Virginia","Orange County",5,53,516,254,262
050,51,137,"Virginia","Orange County",5,54,520,255,265
050,51,137,"Virginia","Orange County",5,55,500,255,245
050,51,137,"Virginia","Orange County",5,56,494,217,277
050,51,137,"Virginia","Orange County",5,57,534,248,286
050,51,137,"Virginia","Orange County",5,58,592,291,301
050,51,137,"Virginia","Orange County",5,59,574,286,288
050,51,137,"Virginia","Orange County",5,60,589,295,294
050,51,137,"Virginia","Orange County",5,61,555,272,283
050,51,137,"Virginia","Orange County",5,62,607,295,312
050,51,137,"Virginia","Orange County",5,63,554,268,286
050,51,137,"Virginia","Orange County",5,64,593,285,308
050,51,137,"Virginia","Orange County",5,65,549,252,297
050,51,137,"Virginia","Orange County",5,66,552,266,286
050,51,137,"Virginia","Orange County",5,67,515,254,261
050,51,137,"Virginia","Orange County",5,68,509,246,263
050,51,137,"Virginia","Orange County",5,69,483,215,268
050,51,137,"Virginia","Orange County",5,70,445,191,254
050,51,137,"Virginia","Orange County",5,71,420,189,231
050,51,137,"Virginia","Orange County",5,72,414,196,218
050,51,137,"Virginia","Orange County",5,73,383,172,211
050,51,137,"Virginia","Orange County",5,74,384,171,213
050,51,137,"Virginia","Orange County",5,75,397,192,205
050,51,137,"Virginia","Orange County",5,76,420,187,233
050,51,137,"Virginia","Orange County",5,77,265,115,150
050,51,137,"Virginia","Orange County",5,78,257,107,150
050,51,137,"Virginia","Orange County",5,79,267,119,148
050,51,137,"Virginia","Orange County",5,80,277,130,147
050,51,137,"Virginia","Orange County",5,81,225,111,114
050,51,137,"Virginia","Orange County",5,82,197,84,113
050,51,137,"Virginia","Orange County",5,83,164,57,107
050,51,137,"Virginia","Orange County",5,84,153,61,92
050,51,137,"Virginia","Orange County",5,85,793,307,486
050,51,139,"Virginia","Page County",1,0,244,125,119
050,51,139,"Virginia","Page County",1,1,245,126,119
050,51,139,"Virginia","Page County",1,2,275,137,138
050,51,139,"Virginia","Page County",1,3,256,129,127
050,51,139,"Virginia","Page County",1,4,267,127,140
050,51,139,"Virginia","Page County",1,5,255,127,128
050,51,139,"Virginia","Page County",1,6,265,133,132
050,51,139,"Virginia","Page County",1,7,238,106,132
050,51,139,"Virginia","Page County",1,8,234,122,112
050,51,139,"Virginia","Page County",1,9,235,116,119
050,51,139,"Virginia","Page County",1,10,255,130,125
050,51,139,"Virginia","Page County",1,11,282,145,137
050,51,139,"Virginia","Page County",1,12,277,144,133
050,51,139,"Virginia","Page County",1,13,278,140,138
050,51,139,"Virginia","Page County",1,14,296,149,147
050,51,139,"Virginia","Page County",1,15,289,142,147
050,51,139,"Virginia","Page County",1,16,314,154,160
050,51,139,"Virginia","Page County",1,17,287,149,138
050,51,139,"Virginia","Page County",1,18,256,142,114
050,51,139,"Virginia","Page County",1,19,196,102,94
050,51,139,"Virginia","Page County",1,20,197,101,96
050,51,139,"Virginia","Page County",1,21,212,115,97
050,51,139,"Virginia","Page County",1,22,222,113,109
050,51,139,"Virginia","Page County",1,23,246,121,125
050,51,139,"Virginia","Page County",1,24,255,129,126
050,51,139,"Virginia","Page County",1,25,262,120,142
050,51,139,"Virginia","Page County",1,26,256,135,121
050,51,139,"Virginia","Page County",1,27,264,129,135
050,51,139,"Virginia","Page County",1,28,265,126,139
050,51,139,"Virginia","Page County",1,29,253,124,129
050,51,139,"Virginia","Page County",1,30,287,145,142
050,51,139,"Virginia","Page County",1,31,290,143,147
050,51,139,"Virginia","Page County",1,32,256,125,131
050,51,139,"Virginia","Page County",1,33,253,128,125
050,51,139,"Virginia","Page County",1,34,257,131,126
050,51,139,"Virginia","Page County",1,35,274,146,128
050,51,139,"Virginia","Page County",1,36,257,131,126
050,51,139,"Virginia","Page County",1,37,269,137,132
050,51,139,"Virginia","Page County",1,38,260,139,121
050,51,139,"Virginia","Page County",1,39,264,130,134
050,51,139,"Virginia","Page County",1,40,268,134,134
050,51,139,"Virginia","Page County",1,41,280,125,155
050,51,139,"Virginia","Page County",1,42,272,129,143
050,51,139,"Virginia","Page County",1,43,271,137,134
050,51,139,"Virginia","Page County",1,44,264,142,122
050,51,139,"Virginia","Page County",1,45,267,135,132
050,51,139,"Virginia","Page County",1,46,277,140,137
050,51,139,"Virginia","Page County",1,47,278,138,140
050,51,139,"Virginia","Page County",1,48,301,153,148
050,51,139,"Virginia","Page County",1,49,343,177,166
050,51,139,"Virginia","Page County",1,50,341,168,173
050,51,139,"Virginia","Page County",1,51,323,162,161
050,51,139,"Virginia","Page County",1,52,337,192,145
050,51,139,"Virginia","Page County",1,53,340,174,166
050,51,139,"Virginia","Page County",1,54,378,185,193
050,51,139,"Virginia","Page County",1,55,395,198,197
050,51,139,"Virginia","Page County",1,56,388,202,186
050,51,139,"Virginia","Page County",1,57,401,200,201
050,51,139,"Virginia","Page County",1,58,387,194,193
050,51,139,"Virginia","Page County",1,59,379,184,195
050,51,139,"Virginia","Page County",1,60,370,186,184
050,51,139,"Virginia","Page County",1,61,344,175,169
050,51,139,"Virginia","Page County",1,62,356,173,183
050,51,139,"Virginia","Page County",1,63,332,158,174
050,51,139,"Virginia","Page County",1,64,333,160,173
050,51,139,"Virginia","Page County",1,65,345,168,177
050,51,139,"Virginia","Page County",1,66,326,170,156
050,51,139,"Virginia","Page County",1,67,317,156,161
050,51,139,"Virginia","Page County",1,68,309,154,155
050,51,139,"Virginia","Page County",1,69,296,147,149
050,51,139,"Virginia","Page County",1,70,308,150,158
050,51,139,"Virginia","Page County",1,71,295,145,150
050,51,139,"Virginia","Page County",1,72,302,145,157
050,51,139,"Virginia","Page County",1,73,286,145,141
050,51,139,"Virginia","Page County",1,74,202,94,108
050,51,139,"Virginia","Page County",1,75,201,91,110
050,51,139,"Virginia","Page County",1,76,224,107,117
050,51,139,"Virginia","Page County",1,77,232,115,117
050,51,139,"Virginia","Page County",1,78,196,98,98
050,51,139,"Virginia","Page County",1,79,173,73,100
050,51,139,"Virginia","Page County",1,80,134,60,74
050,51,139,"Virginia","Page County",1,81,132,59,73
050,51,139,"Virginia","Page County",1,82,123,48,75
050,51,139,"Virginia","Page County",1,83,117,49,68
050,51,139,"Virginia","Page County",1,84,105,44,61
050,51,139,"Virginia","Page County",1,85,518,189,329
050,51,139,"Virginia","Page County",2,0,238,128,110
050,51,139,"Virginia","Page County",2,1,244,125,119
050,51,139,"Virginia","Page County",2,2,270,135,135
050,51,139,"Virginia","Page County",2,3,262,132,130
050,51,139,"Virginia","Page County",2,4,266,128,138
050,51,139,"Virginia","Page County",2,5,260,127,133
050,51,139,"Virginia","Page County",2,6,266,134,132
050,51,139,"Virginia","Page County",2,7,246,114,132
050,51,139,"Virginia","Page County",2,8,234,117,117
050,51,139,"Virginia","Page County",2,9,235,116,119
050,51,139,"Virginia","Page County",2,10,253,129,124
050,51,139,"Virginia","Page County",2,11,275,142,133
050,51,139,"Virginia","Page County",2,12,282,146,136
050,51,139,"Virginia","Page County",2,13,279,142,137
050,51,139,"Virginia","Page County",2,14,290,146,144
050,51,139,"Virginia","Page County",2,15,289,142,147
050,51,139,"Virginia","Page County",2,16,310,152,158
050,51,139,"Virginia","Page County",2,17,295,150,145
050,51,139,"Virginia","Page County",2,18,252,138,114
050,51,139,"Virginia","Page County",2,19,198,104,94
050,51,139,"Virginia","Page County",2,20,203,105,98
050,51,139,"Virginia","Page County",2,21,208,111,97
050,51,139,"Virginia","Page County",2,22,222,113,109
050,51,139,"Virginia","Page County",2,23,246,123,123
050,51,139,"Virginia","Page County",2,24,250,125,125
050,51,139,"Virginia","Page County",2,25,258,122,136
050,51,139,"Virginia","Page County",2,26,257,132,125
050,51,139,"Virginia","Page County",2,27,261,130,131
050,51,139,"Virginia","Page County",2,28,266,126,140
050,51,139,"Virginia","Page County",2,29,258,124,134
050,51,139,"Virginia","Page County",2,30,280,140,140
050,51,139,"Virginia","Page County",2,31,290,144,146
050,51,139,"Virginia","Page County",2,32,263,127,136
050,51,139,"Virginia","Page County",2,33,254,127,127
050,51,139,"Virginia","Page County",2,34,257,131,126
050,51,139,"Virginia","Page County",2,35,274,146,128
050,51,139,"Virginia","Page County",2,36,261,134,127
050,51,139,"Virginia","Page County",2,37,265,135,130
050,51,139,"Virginia","Page County",2,38,265,140,125
050,51,139,"Virginia","Page County",2,39,263,131,132
050,51,139,"Virginia","Page County",2,40,269,135,134
050,51,139,"Virginia","Page County",2,41,277,128,149
050,51,139,"Virginia","Page County",2,42,270,127,143
050,51,139,"Virginia","Page County",2,43,271,134,137
050,51,139,"Virginia","Page County",2,44,264,140,124
050,51,139,"Virginia","Page County",2,45,267,137,130
050,51,139,"Virginia","Page County",2,46,276,140,136
050,51,139,"Virginia","Page County",2,47,276,137,139
050,51,139,"Virginia","Page County",2,48,296,150,146
050,51,139,"Virginia","Page County",2,49,335,172,163
050,51,139,"Virginia","Page County",2,50,343,170,173
050,51,139,"Virginia","Page County",2,51,326,164,162
050,51,139,"Virginia","Page County",2,52,334,185,149
050,51,139,"Virginia","Page County",2,53,341,180,161
050,51,139,"Virginia","Page County",2,54,367,182,185
050,51,139,"Virginia","Page County",2,55,390,194,196
050,51,139,"Virginia","Page County",2,56,392,201,191
050,51,139,"Virginia","Page County",2,57,397,200,197
050,51,139,"Virginia","Page County",2,58,388,194,194
050,51,139,"Virginia","Page County",2,59,384,188,196
050,51,139,"Virginia","Page County",2,60,369,184,185
050,51,139,"Virginia","Page County",2,61,350,177,173
050,51,139,"Virginia","Page County",2,62,352,173,179
050,51,139,"Virginia","Page County",2,63,340,164,176
050,51,139,"Virginia","Page County",2,64,326,155,171
050,51,139,"Virginia","Page County",2,65,342,165,177
050,51,139,"Virginia","Page County",2,66,331,169,162
050,51,139,"Virginia","Page County",2,67,316,158,158
050,51,139,"Virginia","Page County",2,68,309,153,156
050,51,139,"Virginia","Page County",2,69,299,149,150
050,51,139,"Virginia","Page County",2,70,303,148,155
050,51,139,"Virginia","Page County",2,71,301,148,153
050,51,139,"Virginia","Page County",2,72,292,142,150
050,51,139,"Virginia","Page County",2,73,301,151,150
050,51,139,"Virginia","Page County",2,74,210,100,110
050,51,139,"Virginia","Page County",2,75,201,91,110
050,51,139,"Virginia","Page County",2,76,214,100,114
050,51,139,"Virginia","Page County",2,77,228,112,116
050,51,139,"Virginia","Page County",2,78,196,95,101
050,51,139,"Virginia","Page County",2,79,175,77,98
050,51,139,"Virginia","Page County",2,80,143,65,78
050,51,139,"Virginia","Page County",2,81,129,58,71
050,51,139,"Virginia","Page County",2,82,122,49,73
050,51,139,"Virginia","Page County",2,83,115,47,68
050,51,139,"Virginia","Page County",2,84,104,44,60
050,51,139,"Virginia","Page County",2,85,515,189,326
050,51,139,"Virginia","Page County",3,0,214,122,92
050,51,139,"Virginia","Page County",3,1,242,132,110
050,51,139,"Virginia","Page County",3,2,244,131,113
050,51,139,"Virginia","Page County",3,3,266,129,137
050,51,139,"Virginia","Page County",3,4,263,134,129
050,51,139,"Virginia","Page County",3,5,262,126,136
050,51,139,"Virginia","Page County",3,6,260,130,130
050,51,139,"Virginia","Page County",3,7,261,131,130
050,51,139,"Virginia","Page County",3,8,257,119,138
050,51,139,"Virginia","Page County",3,9,233,119,114
050,51,139,"Virginia","Page County",3,10,235,118,117
050,51,139,"Virginia","Page County",3,11,265,136,129
050,51,139,"Virginia","Page County",3,12,281,147,134
050,51,139,"Virginia","Page County",3,13,289,151,138
050,51,139,"Virginia","Page County",3,14,275,143,132
050,51,139,"Virginia","Page County",3,15,290,152,138
050,51,139,"Virginia","Page County",3,16,297,144,153
050,51,139,"Virginia","Page County",3,17,313,155,158
050,51,139,"Virginia","Page County",3,18,250,130,120
050,51,139,"Virginia","Page County",3,19,200,108,92
050,51,139,"Virginia","Page County",3,20,218,115,103
050,51,139,"Virginia","Page County",3,21,215,108,107
050,51,139,"Virginia","Page County",3,22,228,118,110
050,51,139,"Virginia","Page County",3,23,231,121,110
050,51,139,"Virginia","Page County",3,24,257,130,127
050,51,139,"Virginia","Page County",3,25,263,128,135
050,51,139,"Virginia","Page County",3,26,264,130,134
050,51,139,"Virginia","Page County",3,27,268,137,131
050,51,139,"Virginia","Page County",3,28,273,139,134
050,51,139,"Virginia","Page County",3,29,257,117,140
050,51,139,"Virginia","Page County",3,30,276,139,137
050,51,139,"Virginia","Page County",3,31,286,145,141
050,51,139,"Virginia","Page County",3,32,294,147,147
050,51,139,"Virginia","Page County",3,33,256,112,144
050,51,139,"Virginia","Page County",3,34,256,131,125
050,51,139,"Virginia","Page County",3,35,260,131,129
050,51,139,"Virginia","Page County",3,36,282,150,132
050,51,139,"Virginia","Page County",3,37,256,129,127
050,51,139,"Virginia","Page County",3,38,277,146,131
050,51,139,"Virginia","Page County",3,39,263,140,123
050,51,139,"Virginia","Page County",3,40,276,137,139
050,51,139,"Virginia","Page County",3,41,267,134,133
050,51,139,"Virginia","Page County",3,42,281,133,148
050,51,139,"Virginia","Page County",3,43,271,130,141
050,51,139,"Virginia","Page County",3,44,271,129,142
050,51,139,"Virginia","Page County",3,45,274,143,131
050,51,139,"Virginia","Page County",3,46,272,141,131
050,51,139,"Virginia","Page County",3,47,273,137,136
050,51,139,"Virginia","Page County",3,48,282,145,137
050,51,139,"Virginia","Page County",3,49,300,153,147
050,51,139,"Virginia","Page County",3,50,331,174,157
050,51,139,"Virginia","Page County",3,51,345,170,175
050,51,139,"Virginia","Page County",3,52,329,169,160
050,51,139,"Virginia","Page County",3,53,333,187,146
050,51,139,"Virginia","Page County",3,54,345,189,156
050,51,139,"Virginia","Page County",3,55,362,175,187
050,51,139,"Virginia","Page County",3,56,386,191,195
050,51,139,"Virginia","Page County",3,57,396,204,192
050,51,139,"Virginia","Page County",3,58,400,203,197
050,51,139,"Virginia","Page County",3,59,392,194,198
050,51,139,"Virginia","Page County",3,60,387,190,197
050,51,139,"Virginia","Page County",3,61,372,186,186
050,51,139,"Virginia","Page County",3,62,353,172,181
050,51,139,"Virginia","Page County",3,63,350,173,177
050,51,139,"Virginia","Page County",3,64,336,159,177
050,51,139,"Virginia","Page County",3,65,322,146,176
050,51,139,"Virginia","Page County",3,66,334,157,177
050,51,139,"Virginia","Page County",3,67,336,173,163
050,51,139,"Virginia","Page County",3,68,314,155,159
050,51,139,"Virginia","Page County",3,69,309,154,155
050,51,139,"Virginia","Page County",3,70,293,144,149
050,51,139,"Virginia","Page County",3,71,303,149,154
050,51,139,"Virginia","Page County",3,72,281,139,142
050,51,139,"Virginia","Page County",3,73,287,143,144
050,51,139,"Virginia","Page County",3,74,299,146,153
050,51,139,"Virginia","Page County",3,75,200,97,103
050,51,139,"Virginia","Page County",3,76,203,90,113
050,51,139,"Virginia","Page County",3,77,201,97,104
050,51,139,"Virginia","Page County",3,78,228,106,122
050,51,139,"Virginia","Page County",3,79,190,90,100
050,51,139,"Virginia","Page County",3,80,165,70,95
050,51,139,"Virginia","Page County",3,81,137,61,76
050,51,139,"Virginia","Page County",3,82,119,53,66
050,51,139,"Virginia","Page County",3,83,119,51,68
050,51,139,"Virginia","Page County",3,84,102,40,62
050,51,139,"Virginia","Page County",3,85,522,184,338
050,51,139,"Virginia","Page County",4,0,211,124,87
050,51,139,"Virginia","Page County",4,1,206,115,91
050,51,139,"Virginia","Page County",4,2,254,131,123
050,51,139,"Virginia","Page County",4,3,242,132,110
050,51,139,"Virginia","Page County",4,4,272,131,141
050,51,139,"Virginia","Page County",4,5,258,134,124
050,51,139,"Virginia","Page County",4,6,271,132,139
050,51,139,"Virginia","Page County",4,7,256,130,126
050,51,139,"Virginia","Page County",4,8,271,130,141
050,51,139,"Virginia","Page County",4,9,261,123,138
050,51,139,"Virginia","Page County",4,10,234,118,116
050,51,139,"Virginia","Page County",4,11,246,130,116
050,51,139,"Virginia","Page County",4,12,266,133,133
050,51,139,"Virginia","Page County",4,13,286,150,136
050,51,139,"Virginia","Page County",4,14,281,148,133
050,51,139,"Virginia","Page County",4,15,275,147,128
050,51,139,"Virginia","Page County",4,16,289,151,138
050,51,139,"Virginia","Page County",4,17,289,145,144
050,51,139,"Virginia","Page County",4,18,258,137,121
050,51,139,"Virginia","Page County",4,19,188,97,91
050,51,139,"Virginia","Page County",4,20,212,117,95
050,51,139,"Virginia","Page County",4,21,221,116,105
050,51,139,"Virginia","Page County",4,22,227,114,113
050,51,139,"Virginia","Page County",4,23,242,128,114
050,51,139,"Virginia","Page County",4,24,239,123,116
050,51,139,"Virginia","Page County",4,25,265,124,141
050,51,139,"Virginia","Page County",4,26,251,125,126
050,51,139,"Virginia","Page County",4,27,261,128,133
050,51,139,"Virginia","Page County",4,28,262,129,133
050,51,139,"Virginia","Page County",4,29,283,142,141
050,51,139,"Virginia","Page County",4,30,267,129,138
050,51,139,"Virginia","Page County",4,31,277,139,138
050,51,139,"Virginia","Page County",4,32,297,156,141
050,51,139,"Virginia","Page County",4,33,293,143,150
050,51,139,"Virginia","Page County",4,34,260,113,147
050,51,139,"Virginia","Page County",4,35,263,137,126
050,51,139,"Virginia","Page County",4,36,270,140,130
050,51,139,"Virginia","Page County",4,37,282,144,138
050,51,139,"Virginia","Page County",4,38,260,128,132
050,51,139,"Virginia","Page County",4,39,277,145,132
050,51,139,"Virginia","Page County",4,40,265,144,121
050,51,139,"Virginia","Page County",4,41,282,140,142
050,51,139,"Virginia","Page County",4,42,269,135,134
050,51,139,"Virginia","Page County",4,43,275,130,145
050,51,139,"Virginia","Page County",4,44,270,126,144
050,51,139,"Virginia","Page County",4,45,272,129,143
050,51,139,"Virginia","Page County",4,46,269,141,128
050,51,139,"Virginia","Page County",4,47,279,144,135
050,51,139,"Virginia","Page County",4,48,272,132,140
050,51,139,"Virginia","Page County",4,49,281,143,138
050,51,139,"Virginia","Page County",4,50,296,155,141
050,51,139,"Virginia","Page County",4,51,328,176,152
050,51,139,"Virginia","Page County",4,52,339,166,173
050,51,139,"Virginia","Page County",4,53,328,168,160
050,51,139,"Virginia","Page County",4,54,333,181,152
050,51,139,"Virginia","Page County",4,55,351,192,159
050,51,139,"Virginia","Page County",4,56,365,174,191
050,51,139,"Virginia","Page County",4,57,391,198,193
050,51,139,"Virginia","Page County",4,58,394,204,190
050,51,139,"Virginia","Page County",4,59,399,200,199
050,51,139,"Virginia","Page County",4,60,396,200,196
050,51,139,"Virginia","Page County",4,61,389,186,203
050,51,139,"Virginia","Page County",4,62,372,186,186
050,51,139,"Virginia","Page County",4,63,354,175,179
050,51,139,"Virginia","Page County",4,64,352,174,178
050,51,139,"Virginia","Page County",4,65,341,163,178
050,51,139,"Virginia","Page County",4,66,316,144,172
050,51,139,"Virginia","Page County",4,67,328,152,176
050,51,139,"Virginia","Page County",4,68,330,166,164
050,51,139,"Virginia","Page County",4,69,310,152,158
050,51,139,"Virginia","Page County",4,70,285,145,140
050,51,139,"Virginia","Page County",4,71,284,141,143
050,51,139,"Virginia","Page County",4,72,294,142,152
050,51,139,"Virginia","Page County",4,73,279,139,140
050,51,139,"Virginia","Page County",4,74,290,148,142
050,51,139,"Virginia","Page County",4,75,284,137,147
050,51,139,"Virginia","Page County",4,76,198,97,101
050,51,139,"Virginia","Page County",4,77,193,89,104
050,51,139,"Virginia","Page County",4,78,197,92,105
050,51,139,"Virginia","Page County",4,79,212,93,119
050,51,139,"Virginia","Page County",4,80,179,85,94
050,51,139,"Virginia","Page County",4,81,154,63,91
050,51,139,"Virginia","Page County",4,82,124,55,69
050,51,139,"Virginia","Page County",4,83,108,51,57
050,51,139,"Virginia","Page County",4,84,107,43,64
050,51,139,"Virginia","Page County",4,85,520,177,343
050,51,139,"Virginia","Page County",5,0,210,123,87
050,51,139,"Virginia","Page County",5,1,219,129,90
050,51,139,"Virginia","Page County",5,2,212,120,92
050,51,139,"Virginia","Page County",5,3,249,129,120
050,51,139,"Virginia","Page County",5,4,253,134,119
050,51,139,"Virginia","Page County",5,5,265,131,134
050,51,139,"Virginia","Page County",5,6,263,140,123
050,51,139,"Virginia","Page County",5,7,265,130,135
050,51,139,"Virginia","Page County",5,8,247,125,122
050,51,139,"Virginia","Page County",5,9,264,132,132
050,51,139,"Virginia","Page County",5,10,263,123,140
050,51,139,"Virginia","Page County",5,11,233,118,115
050,51,139,"Virginia","Page County",5,12,255,135,120
050,51,139,"Virginia","Page County",5,13,262,132,130
050,51,139,"Virginia","Page County",5,14,284,152,132
050,51,139,"Virginia","Page County",5,15,277,144,133
050,51,139,"Virginia","Page County",5,16,276,150,126
050,51,139,"Virginia","Page County",5,17,285,146,139
050,51,139,"Virginia","Page County",5,18,238,122,116
050,51,139,"Virginia","Page County",5,19,206,106,100
050,51,139,"Virginia","Page County",5,20,209,105,104
050,51,139,"Virginia","Page County",5,21,231,126,105
050,51,139,"Virginia","Page County",5,22,238,127,111
050,51,139,"Virginia","Page County",5,23,249,132,117
050,51,139,"Virginia","Page County",5,24,248,127,121
050,51,139,"Virginia","Page County",5,25,245,123,122
050,51,139,"Virginia","Page County",5,26,270,125,145
050,51,139,"Virginia","Page County",5,27,260,135,125
050,51,139,"Virginia","Page County",5,28,255,125,130
050,51,139,"Virginia","Page County",5,29,252,124,128
050,51,139,"Virginia","Page County",5,30,283,138,145
050,51,139,"Virginia","Page County",5,31,275,137,138
050,51,139,"Virginia","Page County",5,32,271,131,140
050,51,139,"Virginia","Page County",5,33,297,159,138
050,51,139,"Virginia","Page County",5,34,285,143,142
050,51,139,"Virginia","Page County",5,35,258,116,142
050,51,139,"Virginia","Page County",5,36,266,139,127
050,51,139,"Virginia","Page County",5,37,269,137,132
050,51,139,"Virginia","Page County",5,38,291,148,143
050,51,139,"Virginia","Page County",5,39,272,129,143
050,51,139,"Virginia","Page County",5,40,275,144,131
050,51,139,"Virginia","Page County",5,41,272,147,125
050,51,139,"Virginia","Page County",5,42,280,135,145
050,51,139,"Virginia","Page County",5,43,278,138,140
050,51,139,"Virginia","Page County",5,44,272,130,142
050,51,139,"Virginia","Page County",5,45,265,127,138
050,51,139,"Virginia","Page County",5,46,274,133,141
050,51,139,"Virginia","Page County",5,47,264,144,120
050,51,139,"Virginia","Page County",5,48,284,144,140
050,51,139,"Virginia","Page County",5,49,275,135,140
050,51,139,"Virginia","Page County",5,50,280,142,138
050,51,139,"Virginia","Page County",5,51,293,150,143
050,51,139,"Virginia","Page County",5,52,333,181,152
050,51,139,"Virginia","Page County",5,53,339,162,177
050,51,139,"Virginia","Page County",5,54,328,167,161
050,51,139,"Virginia","Page County",5,55,347,181,166
050,51,139,"Virginia","Page County",5,56,351,194,157
050,51,139,"Virginia","Page County",5,57,370,182,188
050,51,139,"Virginia","Page County",5,58,385,194,191
050,51,139,"Virginia","Page County",5,59,401,212,189
050,51,139,"Virginia","Page County",5,60,396,196,200
050,51,139,"Virginia","Page County",5,61,395,198,197
050,51,139,"Virginia","Page County",5,62,388,184,204
050,51,139,"Virginia","Page County",5,63,368,183,185
050,51,139,"Virginia","Page County",5,64,352,178,174
050,51,139,"Virginia","Page County",5,65,348,171,177
050,51,139,"Virginia","Page County",5,66,328,156,172
050,51,139,"Virginia","Page County",5,67,318,137,181
050,51,139,"Virginia","Page County",5,68,317,146,171
050,51,139,"Virginia","Page County",5,69,325,164,161
050,51,139,"Virginia","Page County",5,70,289,141,148
050,51,139,"Virginia","Page County",5,71,279,144,135
050,51,139,"Virginia","Page County",5,72,275,138,137
050,51,139,"Virginia","Page County",5,73,288,141,147
050,51,139,"Virginia","Page County",5,74,278,140,138
050,51,139,"Virginia","Page County",5,75,274,136,138
050,51,139,"Virginia","Page County",5,76,280,135,145
050,51,139,"Virginia","Page County",5,77,187,98,89
050,51,139,"Virginia","Page County",5,78,188,85,103
050,51,139,"Virginia","Page County",5,79,179,82,97
050,51,139,"Virginia","Page County",5,80,203,87,116
050,51,139,"Virginia","Page County",5,81,173,76,97
050,51,139,"Virginia","Page County",5,82,149,61,88
050,51,139,"Virginia","Page County",5,83,121,59,62
050,51,139,"Virginia","Page County",5,84,96,42,54
050,51,139,"Virginia","Page County",5,85,531,177,354
050,51,141,"Virginia","Patrick County",1,0,130,68,62
050,51,141,"Virginia","Patrick County",1,1,134,76,58
050,51,141,"Virginia","Patrick County",1,2,147,76,71
050,51,141,"Virginia","Patrick County",1,3,160,84,76
050,51,141,"Virginia","Patrick County",1,4,144,79,65
050,51,141,"Virginia","Patrick County",1,5,142,72,70
050,51,141,"Virginia","Patrick County",1,6,150,73,77
050,51,141,"Virginia","Patrick County",1,7,145,77,68
050,51,141,"Virginia","Patrick County",1,8,175,83,92
050,51,141,"Virginia","Patrick County",1,9,189,96,93
050,51,141,"Virginia","Patrick County",1,10,190,99,91
050,51,141,"Virginia","Patrick County",1,11,184,87,97
050,51,141,"Virginia","Patrick County",1,12,192,102,90
050,51,141,"Virginia","Patrick County",1,13,196,96,100
050,51,141,"Virginia","Patrick County",1,14,210,107,103
050,51,141,"Virginia","Patrick County",1,15,200,112,88
050,51,141,"Virginia","Patrick County",1,16,206,114,92
050,51,141,"Virginia","Patrick County",1,17,175,94,81
050,51,141,"Virginia","Patrick County",1,18,146,71,75
050,51,141,"Virginia","Patrick County",1,19,130,67,63
050,51,141,"Virginia","Patrick County",1,20,157,83,74
050,51,141,"Virginia","Patrick County",1,21,156,81,75
050,51,141,"Virginia","Patrick County",1,22,171,84,87
050,51,141,"Virginia","Patrick County",1,23,162,79,83
050,51,141,"Virginia","Patrick County",1,24,149,85,64
050,51,141,"Virginia","Patrick County",1,25,168,102,66
050,51,141,"Virginia","Patrick County",1,26,171,98,73
050,51,141,"Virginia","Patrick County",1,27,146,80,66
050,51,141,"Virginia","Patrick County",1,28,140,73,67
050,51,141,"Virginia","Patrick County",1,29,164,80,84
050,51,141,"Virginia","Patrick County",1,30,151,87,64
050,51,141,"Virginia","Patrick County",1,31,129,72,57
050,51,141,"Virginia","Patrick County",1,32,149,77,72
050,51,141,"Virginia","Patrick County",1,33,159,82,77
050,51,141,"Virginia","Patrick County",1,34,162,81,81
050,51,141,"Virginia","Patrick County",1,35,145,73,72
050,51,141,"Virginia","Patrick County",1,36,152,77,75
050,51,141,"Virginia","Patrick County",1,37,189,106,83
050,51,141,"Virginia","Patrick County",1,38,168,87,81
050,51,141,"Virginia","Patrick County",1,39,171,84,87
050,51,141,"Virginia","Patrick County",1,40,157,82,75
050,51,141,"Virginia","Patrick County",1,41,161,79,82
050,51,141,"Virginia","Patrick County",1,42,193,86,107
050,51,141,"Virginia","Patrick County",1,43,203,102,101
050,51,141,"Virginia","Patrick County",1,44,196,102,94
050,51,141,"Virginia","Patrick County",1,45,208,102,106
050,51,141,"Virginia","Patrick County",1,46,228,116,112
050,51,141,"Virginia","Patrick County",1,47,235,129,106
050,51,141,"Virginia","Patrick County",1,48,268,136,132
050,51,141,"Virginia","Patrick County",1,49,275,142,133
050,51,141,"Virginia","Patrick County",1,50,250,138,112
050,51,141,"Virginia","Patrick County",1,51,246,134,112
050,51,141,"Virginia","Patrick County",1,52,251,133,118
050,51,141,"Virginia","Patrick County",1,53,259,139,120
050,51,141,"Virginia","Patrick County",1,54,263,130,133
050,51,141,"Virginia","Patrick County",1,55,265,122,143
050,51,141,"Virginia","Patrick County",1,56,281,146,135
050,51,141,"Virginia","Patrick County",1,57,292,141,151
050,51,141,"Virginia","Patrick County",1,58,326,158,168
050,51,141,"Virginia","Patrick County",1,59,319,152,167
050,51,141,"Virginia","Patrick County",1,60,305,148,157
050,51,141,"Virginia","Patrick County",1,61,295,146,149
050,51,141,"Virginia","Patrick County",1,62,315,160,155
050,51,141,"Virginia","Patrick County",1,63,303,156,147
050,51,141,"Virginia","Patrick County",1,64,280,148,132
050,51,141,"Virginia","Patrick County",1,65,269,147,122
050,51,141,"Virginia","Patrick County",1,66,275,135,140
050,51,141,"Virginia","Patrick County",1,67,294,147,147
050,51,141,"Virginia","Patrick County",1,68,273,134,139
050,51,141,"Virginia","Patrick County",1,69,248,128,120
050,51,141,"Virginia","Patrick County",1,70,268,142,126
050,51,141,"Virginia","Patrick County",1,71,258,129,129
050,51,141,"Virginia","Patrick County",1,72,276,131,145
050,51,141,"Virginia","Patrick County",1,73,276,126,150
050,51,141,"Virginia","Patrick County",1,74,187,78,109
050,51,141,"Virginia","Patrick County",1,75,206,97,109
050,51,141,"Virginia","Patrick County",1,76,214,103,111
050,51,141,"Virginia","Patrick County",1,77,203,92,111
050,51,141,"Virginia","Patrick County",1,78,184,79,105
050,51,141,"Virginia","Patrick County",1,79,185,80,105
050,51,141,"Virginia","Patrick County",1,80,163,78,85
050,51,141,"Virginia","Patrick County",1,81,147,69,78
050,51,141,"Virginia","Patrick County",1,82,116,50,66
050,51,141,"Virginia","Patrick County",1,83,113,55,58
050,51,141,"Virginia","Patrick County",1,84,101,45,56
050,51,141,"Virginia","Patrick County",1,85,476,164,312
050,51,141,"Virginia","Patrick County",2,0,131,70,61
050,51,141,"Virginia","Patrick County",2,1,132,74,58
050,51,141,"Virginia","Patrick County",2,2,145,76,69
050,51,141,"Virginia","Patrick County",2,3,155,81,74
050,51,141,"Virginia","Patrick County",2,4,150,82,68
050,51,141,"Virginia","Patrick County",2,5,144,75,69
050,51,141,"Virginia","Patrick County",2,6,151,75,76
050,51,141,"Virginia","Patrick County",2,7,146,76,70
050,51,141,"Virginia","Patrick County",2,8,166,81,85
050,51,141,"Virginia","Patrick County",2,9,184,94,90
050,51,141,"Virginia","Patrick County",2,10,189,97,92
050,51,141,"Virginia","Patrick County",2,11,182,89,93
050,51,141,"Virginia","Patrick County",2,12,192,99,93
050,51,141,"Virginia","Patrick County",2,13,196,99,97
050,51,141,"Virginia","Patrick County",2,14,208,106,102
050,51,141,"Virginia","Patrick County",2,15,204,112,92
050,51,141,"Virginia","Patrick County",2,16,206,114,92
050,51,141,"Virginia","Patrick County",2,17,179,96,83
050,51,141,"Virginia","Patrick County",2,18,145,73,72
050,51,141,"Virginia","Patrick County",2,19,129,65,64
050,51,141,"Virginia","Patrick County",2,20,155,81,74
050,51,141,"Virginia","Patrick County",2,21,156,81,75
050,51,141,"Virginia","Patrick County",2,22,166,82,84
050,51,141,"Virginia","Patrick County",2,23,161,79,82
050,51,141,"Virginia","Patrick County",2,24,154,87,67
050,51,141,"Virginia","Patrick County",2,25,163,99,64
050,51,141,"Virginia","Patrick County",2,26,169,99,70
050,51,141,"Virginia","Patrick County",2,27,151,85,66
050,51,141,"Virginia","Patrick County",2,28,141,74,67
050,51,141,"Virginia","Patrick County",2,29,158,80,78
050,51,141,"Virginia","Patrick County",2,30,155,88,67
050,51,141,"Virginia","Patrick County",2,31,133,75,58
050,51,141,"Virginia","Patrick County",2,32,147,77,70
050,51,141,"Virginia","Patrick County",2,33,157,82,75
050,51,141,"Virginia","Patrick County",2,34,159,80,79
050,51,141,"Virginia","Patrick County",2,35,147,75,72
050,51,141,"Virginia","Patrick County",2,36,149,75,74
050,51,141,"Virginia","Patrick County",2,37,185,103,82
050,51,141,"Virginia","Patrick County",2,38,174,91,83
050,51,141,"Virginia","Patrick County",2,39,168,83,85
050,51,141,"Virginia","Patrick County",2,40,161,82,79
050,51,141,"Virginia","Patrick County",2,41,159,79,80
050,51,141,"Virginia","Patrick County",2,42,183,83,100
050,51,141,"Virginia","Patrick County",2,43,203,99,104
050,51,141,"Virginia","Patrick County",2,44,195,101,94
050,51,141,"Virginia","Patrick County",2,45,205,101,104
050,51,141,"Virginia","Patrick County",2,46,223,114,109
050,51,141,"Virginia","Patrick County",2,47,234,128,106
050,51,141,"Virginia","Patrick County",2,48,257,131,126
050,51,141,"Virginia","Patrick County",2,49,277,142,135
050,51,141,"Virginia","Patrick County",2,50,257,139,118
050,51,141,"Virginia","Patrick County",2,51,248,136,112
050,51,141,"Virginia","Patrick County",2,52,247,131,116
050,51,141,"Virginia","Patrick County",2,53,256,137,119
050,51,141,"Virginia","Patrick County",2,54,260,130,130
050,51,141,"Virginia","Patrick County",2,55,265,125,140
050,51,141,"Virginia","Patrick County",2,56,279,142,137
050,51,141,"Virginia","Patrick County",2,57,292,143,149
050,51,141,"Virginia","Patrick County",2,58,317,154,163
050,51,141,"Virginia","Patrick County",2,59,325,155,170
050,51,141,"Virginia","Patrick County",2,60,310,150,160
050,51,141,"Virginia","Patrick County",2,61,297,145,152
050,51,141,"Virginia","Patrick County",2,62,308,155,153
050,51,141,"Virginia","Patrick County",2,63,309,158,151
050,51,141,"Virginia","Patrick County",2,64,281,149,132
050,51,141,"Virginia","Patrick County",2,65,273,148,125
050,51,141,"Virginia","Patrick County",2,66,277,141,136
050,51,141,"Virginia","Patrick County",2,67,287,142,145
050,51,141,"Virginia","Patrick County",2,68,276,137,139
050,51,141,"Virginia","Patrick County",2,69,257,131,126
050,51,141,"Virginia","Patrick County",2,70,263,138,125
050,51,141,"Virginia","Patrick County",2,71,261,132,129
050,51,141,"Virginia","Patrick County",2,72,267,129,138
050,51,141,"Virginia","Patrick County",2,73,289,133,156
050,51,141,"Virginia","Patrick County",2,74,195,83,112
050,51,141,"Virginia","Patrick County",2,75,205,94,111
050,51,141,"Virginia","Patrick County",2,76,209,101,108
050,51,141,"Virginia","Patrick County",2,77,209,96,113
050,51,141,"Virginia","Patrick County",2,78,184,79,105
050,51,141,"Virginia","Patrick County",2,79,184,79,105
050,51,141,"Virginia","Patrick County",2,80,160,75,85
050,51,141,"Virginia","Patrick County",2,81,149,70,79
050,51,141,"Virginia","Patrick County",2,82,120,52,68
050,51,141,"Virginia","Patrick County",2,83,113,54,59
050,51,141,"Virginia","Patrick County",2,84,102,46,56
050,51,141,"Virginia","Patrick County",2,85,481,168,313
050,51,141,"Virginia","Patrick County",3,0,145,93,52
050,51,141,"Virginia","Patrick County",3,1,122,64,58
050,51,141,"Virginia","Patrick County",3,2,132,74,58
050,51,141,"Virginia","Patrick County",3,3,152,77,75
050,51,141,"Virginia","Patrick County",3,4,162,81,81
050,51,141,"Virginia","Patrick County",3,5,169,91,78
050,51,141,"Virginia","Patrick County",3,6,151,78,73
050,51,141,"Virginia","Patrick County",3,7,153,76,77
050,51,141,"Virginia","Patrick County",3,8,149,76,73
050,51,141,"Virginia","Patrick County",3,9,181,91,90
050,51,141,"Virginia","Patrick County",3,10,198,99,99
050,51,141,"Virginia","Patrick County",3,11,195,99,96
050,51,141,"Virginia","Patrick County",3,12,190,95,95
050,51,141,"Virginia","Patrick County",3,13,202,102,100
050,51,141,"Virginia","Patrick County",3,14,199,100,99
050,51,141,"Virginia","Patrick County",3,15,217,112,105
050,51,141,"Virginia","Patrick County",3,16,211,118,93
050,51,141,"Virginia","Patrick County",3,17,199,112,87
050,51,141,"Virginia","Patrick County",3,18,161,89,72
050,51,141,"Virginia","Patrick County",3,19,120,59,61
050,51,141,"Virginia","Patrick County",3,20,129,67,62
050,51,141,"Virginia","Patrick County",3,21,164,86,78
050,51,141,"Virginia","Patrick County",3,22,159,80,79
050,51,141,"Virginia","Patrick County",3,23,168,80,88
050,51,141,"Virginia","Patrick County",3,24,160,80,80
050,51,141,"Virginia","Patrick County",3,25,161,88,73
050,51,141,"Virginia","Patrick County",3,26,156,93,63
050,51,141,"Virginia","Patrick County",3,27,174,102,72
050,51,141,"Virginia","Patrick County",3,28,142,75,67
050,51,141,"Virginia","Patrick County",3,29,153,77,76
050,51,141,"Virginia","Patrick County",3,30,161,82,79
050,51,141,"Virginia","Patrick County",3,31,157,87,70
050,51,141,"Virginia","Patrick County",3,32,150,87,63
050,51,141,"Virginia","Patrick County",3,33,137,69,68
050,51,141,"Virginia","Patrick County",3,34,166,81,85
050,51,141,"Virginia","Patrick County",3,35,165,79,86
050,51,141,"Virginia","Patrick County",3,36,150,78,72
050,51,141,"Virginia","Patrick County",3,37,170,88,82
050,51,141,"Virginia","Patrick County",3,38,180,97,83
050,51,141,"Virginia","Patrick County",3,39,177,94,83
050,51,141,"Virginia","Patrick County",3,40,176,90,86
050,51,141,"Virginia","Patrick County",3,41,172,90,82
050,51,141,"Virginia","Patrick County",3,42,155,77,78
050,51,141,"Virginia","Patrick County",3,43,191,89,102
050,51,141,"Virginia","Patrick County",3,44,197,95,102
050,51,141,"Virginia","Patrick County",3,45,187,98,89
050,51,141,"Virginia","Patrick County",3,46,200,100,100
050,51,141,"Virginia","Patrick County",3,47,237,124,113
050,51,141,"Virginia","Patrick County",3,48,230,118,112
050,51,141,"Virginia","Patrick County",3,49,259,133,126
050,51,141,"Virginia","Patrick County",3,50,274,141,133
050,51,141,"Virginia","Patrick County",3,51,263,141,122
050,51,141,"Virginia","Patrick County",3,52,255,140,115
050,51,141,"Virginia","Patrick County",3,53,251,129,122
050,51,141,"Virginia","Patrick County",3,54,253,137,116
050,51,141,"Virginia","Patrick County",3,55,269,127,142
050,51,141,"Virginia","Patrick County",3,56,271,133,138
050,51,141,"Virginia","Patrick County",3,57,289,147,142
050,51,141,"Virginia","Patrick County",3,58,292,146,146
050,51,141,"Virginia","Patrick County",3,59,322,149,173
050,51,141,"Virginia","Patrick County",3,60,321,158,163
050,51,141,"Virginia","Patrick County",3,61,303,147,156
050,51,141,"Virginia","Patrick County",3,62,301,146,155
050,51,141,"Virginia","Patrick County",3,63,321,165,156
050,51,141,"Virginia","Patrick County",3,64,304,157,147
050,51,141,"Virginia","Patrick County",3,65,285,146,139
050,51,141,"Virginia","Patrick County",3,66,273,149,124
050,51,141,"Virginia","Patrick County",3,67,269,133,136
050,51,141,"Virginia","Patrick County",3,68,290,141,149
050,51,141,"Virginia","Patrick County",3,69,265,131,134
050,51,141,"Virginia","Patrick County",3,70,253,130,123
050,51,141,"Virginia","Patrick County",3,71,260,139,121
050,51,141,"Virginia","Patrick County",3,72,256,132,124
050,51,141,"Virginia","Patrick County",3,73,259,126,133
050,51,141,"Virginia","Patrick County",3,74,281,129,152
050,51,141,"Virginia","Patrick County",3,75,189,80,109
050,51,141,"Virginia","Patrick County",3,76,203,96,107
050,51,141,"Virginia","Patrick County",3,77,190,92,98
050,51,141,"Virginia","Patrick County",3,78,190,87,103
050,51,141,"Virginia","Patrick County",3,79,180,77,103
050,51,141,"Virginia","Patrick County",3,80,171,77,94
050,51,141,"Virginia","Patrick County",3,81,149,72,77
050,51,141,"Virginia","Patrick County",3,82,125,56,69
050,51,141,"Virginia","Patrick County",3,83,117,57,60
050,51,141,"Virginia","Patrick County",3,84,93,44,49
050,51,141,"Virginia","Patrick County",3,85,472,182,290
050,51,141,"Virginia","Patrick County",4,0,153,85,68
050,51,141,"Virginia","Patrick County",4,1,152,98,54
050,51,141,"Virginia","Patrick County",4,2,132,72,60
050,51,141,"Virginia","Patrick County",4,3,129,69,60
050,51,141,"Virginia","Patrick County",4,4,149,74,75
050,51,141,"Virginia","Patrick County",4,5,171,88,83
050,51,141,"Virginia","Patrick County",4,6,179,99,80
050,51,141,"Virginia","Patrick County",4,7,155,77,78
050,51,141,"Virginia","Patrick County",4,8,163,78,85
050,51,141,"Virginia","Patrick County",4,9,158,77,81
050,51,141,"Virginia","Patrick County",4,10,180,91,89
050,51,141,"Virginia","Patrick County",4,11,193,94,99
050,51,141,"Virginia","Patrick County",4,12,198,99,99
050,51,141,"Virginia","Patrick County",4,13,190,93,97
050,51,141,"Virginia","Patrick County",4,14,206,106,100
050,51,141,"Virginia","Patrick County",4,15,204,103,101
050,51,141,"Virginia","Patrick County",4,16,219,117,102
050,51,141,"Virginia","Patrick County",4,17,213,116,97
050,51,141,"Virginia","Patrick County",4,18,163,92,71
050,51,141,"Virginia","Patrick County",4,19,119,67,52
050,51,141,"Virginia","Patrick County",4,20,127,60,67
050,51,141,"Virginia","Patrick County",4,21,143,75,68
050,51,141,"Virginia","Patrick County",4,22,173,90,83
050,51,141,"Virginia","Patrick County",4,23,154,78,76
050,51,141,"Virginia","Patrick County",4,24,177,86,91
050,51,141,"Virginia","Patrick County",4,25,153,77,76
050,51,141,"Virginia","Patrick County",4,26,148,78,70
050,51,141,"Virginia","Patrick County",4,27,167,106,61
050,51,141,"Virginia","Patrick County",4,28,173,94,79
050,51,141,"Virginia","Patrick County",4,29,141,77,64
050,51,141,"Virginia","Patrick County",4,30,153,75,78
050,51,141,"Virginia","Patrick County",4,31,168,84,84
050,51,141,"Virginia","Patrick County",4,32,156,91,65
050,51,141,"Virginia","Patrick County",4,33,147,84,63
050,51,141,"Virginia","Patrick County",4,34,137,68,69
050,51,141,"Virginia","Patrick County",4,35,171,83,88
050,51,141,"Virginia","Patrick County",4,36,169,82,87
050,51,141,"Virginia","Patrick County",4,37,169,92,77
050,51,141,"Virginia","Patrick County",4,38,157,76,81
050,51,141,"Virginia","Patrick County",4,39,179,94,85
050,51,141,"Virginia","Patrick County",4,40,181,94,87
050,51,141,"Virginia","Patrick County",4,41,179,94,85
050,51,141,"Virginia","Patrick County",4,42,176,91,85
050,51,141,"Virginia","Patrick County",4,43,156,78,78
050,51,141,"Virginia","Patrick County",4,44,197,92,105
050,51,141,"Virginia","Patrick County",4,45,190,91,99
050,51,141,"Virginia","Patrick County",4,46,186,100,86
050,51,141,"Virginia","Patrick County",4,47,221,112,109
050,51,141,"Virginia","Patrick County",4,48,230,115,115
050,51,141,"Virginia","Patrick County",4,49,232,117,115
050,51,141,"Virginia","Patrick County",4,50,261,135,126
050,51,141,"Virginia","Patrick County",4,51,273,142,131
050,51,141,"Virginia","Patrick County",4,52,259,138,121
050,51,141,"Virginia","Patrick County",4,53,264,144,120
050,51,141,"Virginia","Patrick County",4,54,249,126,123
050,51,141,"Virginia","Patrick County",4,55,257,133,124
050,51,141,"Virginia","Patrick County",4,56,271,133,138
050,51,141,"Virginia","Patrick County",4,57,277,137,140
050,51,141,"Virginia","Patrick County",4,58,287,144,143
050,51,141,"Virginia","Patrick County",4,59,306,152,154
050,51,141,"Virginia","Patrick County",4,60,328,157,171
050,51,141,"Virginia","Patrick County",4,61,317,156,161
050,51,141,"Virginia","Patrick County",4,62,301,140,161
050,51,141,"Virginia","Patrick County",4,63,294,143,151
050,51,141,"Virginia","Patrick County",4,64,309,162,147
050,51,141,"Virginia","Patrick County",4,65,295,154,141
050,51,141,"Virginia","Patrick County",4,66,287,151,136
050,51,141,"Virginia","Patrick County",4,67,272,145,127
050,51,141,"Virginia","Patrick County",4,68,273,135,138
050,51,141,"Virginia","Patrick County",4,69,282,136,146
050,51,141,"Virginia","Patrick County",4,70,269,132,137
050,51,141,"Virginia","Patrick County",4,71,244,121,123
050,51,141,"Virginia","Patrick County",4,72,255,140,115
050,51,141,"Virginia","Patrick County",4,73,256,130,126
050,51,141,"Virginia","Patrick County",4,74,248,118,130
050,51,141,"Virginia","Patrick County",4,75,282,127,155
050,51,141,"Virginia","Patrick County",4,76,188,82,106
050,51,141,"Virginia","Patrick County",4,77,181,85,96
050,51,141,"Virginia","Patrick County",4,78,180,90,90
050,51,141,"Virginia","Patrick County",4,79,182,78,104
050,51,141,"Virginia","Patrick County",4,80,165,75,90
050,51,141,"Virginia","Patrick County",4,81,163,73,90
050,51,141,"Virginia","Patrick County",4,82,129,56,73
050,51,141,"Virginia","Patrick County",4,83,113,54,59
050,51,141,"Virginia","Patrick County",4,84,94,46,48
050,51,141,"Virginia","Patrick County",4,85,454,174,280
050,51,141,"Virginia","Patrick County",5,0,159,87,72
050,51,141,"Virginia","Patrick County",5,1,146,79,67
050,51,141,"Virginia","Patrick County",5,2,155,102,53
050,51,141,"Virginia","Patrick County",5,3,135,71,64
050,51,141,"Virginia","Patrick County",5,4,139,73,66
050,51,141,"Virginia","Patrick County",5,5,148,73,75
050,51,141,"Virginia","Patrick County",5,6,170,86,84
050,51,141,"Virginia","Patrick County",5,7,184,100,84
050,51,141,"Virginia","Patrick County",5,8,167,82,85
050,51,141,"Virginia","Patrick County",5,9,159,81,78
050,51,141,"Virginia","Patrick County",5,10,152,73,79
050,51,141,"Virginia","Patrick County",5,11,183,90,93
050,51,141,"Virginia","Patrick County",5,12,195,93,102
050,51,141,"Virginia","Patrick County",5,13,201,100,101
050,51,141,"Virginia","Patrick County",5,14,193,92,101
050,51,141,"Virginia","Patrick County",5,15,202,104,98
050,51,141,"Virginia","Patrick County",5,16,197,99,98
050,51,141,"Virginia","Patrick County",5,17,222,115,107
050,51,141,"Virginia","Patrick County",5,18,174,96,78
050,51,141,"Virginia","Patrick County",5,19,132,78,54
050,51,141,"Virginia","Patrick County",5,20,134,74,60
050,51,141,"Virginia","Patrick County",5,21,134,65,69
050,51,141,"Virginia","Patrick County",5,22,143,75,68
050,51,141,"Virginia","Patrick County",5,23,174,90,84
050,51,141,"Virginia","Patrick County",5,24,158,85,73
050,51,141,"Virginia","Patrick County",5,25,162,88,74
050,51,141,"Virginia","Patrick County",5,26,149,71,78
050,51,141,"Virginia","Patrick County",5,27,158,86,72
050,51,141,"Virginia","Patrick County",5,28,162,94,68
050,51,141,"Virginia","Patrick County",5,29,169,98,71
050,51,141,"Virginia","Patrick County",5,30,134,69,65
050,51,141,"Virginia","Patrick County",5,31,164,82,82
050,51,141,"Virginia","Patrick County",5,32,172,89,83
050,51,141,"Virginia","Patrick County",5,33,156,88,68
050,51,141,"Virginia","Patrick County",5,34,148,88,60
050,51,141,"Virginia","Patrick County",5,35,142,67,75
050,51,141,"Virginia","Patrick County",5,36,159,74,85
050,51,141,"Virginia","Patrick County",5,37,179,93,86
050,51,141,"Virginia","Patrick County",5,38,165,84,81
050,51,141,"Virginia","Patrick County",5,39,157,74,83
050,51,141,"Virginia","Patrick County",5,40,182,94,88
050,51,141,"Virginia","Patrick County",5,41,178,96,82
050,51,141,"Virginia","Patrick County",5,42,173,94,79
050,51,141,"Virginia","Patrick County",5,43,187,93,94
050,51,141,"Virginia","Patrick County",5,44,159,81,78
050,51,141,"Virginia","Patrick County",5,45,196,91,105
050,51,141,"Virginia","Patrick County",5,46,193,92,101
050,51,141,"Virginia","Patrick County",5,47,202,115,87
050,51,141,"Virginia","Patrick County",5,48,213,102,111
050,51,141,"Virginia","Patrick County",5,49,236,116,120
050,51,141,"Virginia","Patrick County",5,50,238,121,117
050,51,141,"Virginia","Patrick County",5,51,268,140,128
050,51,141,"Virginia","Patrick County",5,52,282,146,136
050,51,141,"Virginia","Patrick County",5,53,264,142,122
050,51,141,"Virginia","Patrick County",5,54,260,141,119
050,51,141,"Virginia","Patrick County",5,55,249,126,123
050,51,141,"Virginia","Patrick County",5,56,255,137,118
050,51,141,"Virginia","Patrick County",5,57,277,134,143
050,51,141,"Virginia","Patrick County",5,58,279,133,146
050,51,141,"Virginia","Patrick County",5,59,289,141,148
050,51,141,"Virginia","Patrick County",5,60,301,151,150
050,51,141,"Virginia","Patrick County",5,61,330,161,169
050,51,141,"Virginia","Patrick County",5,62,309,153,156
050,51,141,"Virginia","Patrick County",5,63,300,137,163
050,51,141,"Virginia","Patrick County",5,64,288,139,149
050,51,141,"Virginia","Patrick County",5,65,308,165,143
050,51,141,"Virginia","Patrick County",5,66,292,153,139
050,51,141,"Virginia","Patrick County",5,67,289,149,140
050,51,141,"Virginia","Patrick County",5,68,266,146,120
050,51,141,"Virginia","Patrick County",5,69,268,130,138
050,51,141,"Virginia","Patrick County",5,70,286,134,152
050,51,141,"Virginia","Patrick County",5,71,255,122,133
050,51,141,"Virginia","Patrick County",5,72,242,122,120
050,51,141,"Virginia","Patrick County",5,73,258,141,117
050,51,141,"Virginia","Patrick County",5,74,243,120,123
050,51,141,"Virginia","Patrick County",5,75,248,117,131
050,51,141,"Virginia","Patrick County",5,76,280,129,151
050,51,141,"Virginia","Patrick County",5,77,167,71,96
050,51,141,"Virginia","Patrick County",5,78,167,81,86
050,51,141,"Virginia","Patrick County",5,79,176,83,93
050,51,141,"Virginia","Patrick County",5,80,169,77,92
050,51,141,"Virginia","Patrick County",5,81,157,69,88
050,51,141,"Virginia","Patrick County",5,82,143,58,85
050,51,141,"Virginia","Patrick County",5,83,118,53,65
050,51,141,"Virginia","Patrick County",5,84,93,45,48
050,51,141,"Virginia","Patrick County",5,85,444,167,277
050,51,143,"Virginia","Pittsylvania County",1,0,480,247,233
050,51,143,"Virginia","Pittsylvania County",1,1,501,270,231
050,51,143,"Virginia","Pittsylvania County",1,2,495,262,233
050,51,143,"Virginia","Pittsylvania County",1,3,501,249,252
050,51,143,"Virginia","Pittsylvania County",1,4,545,282,263
050,51,143,"Virginia","Pittsylvania County",1,5,535,269,266
050,51,143,"Virginia","Pittsylvania County",1,6,542,273,269
050,51,143,"Virginia","Pittsylvania County",1,7,573,299,274
050,51,143,"Virginia","Pittsylvania County",1,8,582,286,296
050,51,143,"Virginia","Pittsylvania County",1,9,607,313,294
050,51,143,"Virginia","Pittsylvania County",1,10,658,305,353
050,51,143,"Virginia","Pittsylvania County",1,11,698,334,364
050,51,143,"Virginia","Pittsylvania County",1,12,730,338,392
050,51,143,"Virginia","Pittsylvania County",1,13,752,370,382
050,51,143,"Virginia","Pittsylvania County",1,14,763,394,369
050,51,143,"Virginia","Pittsylvania County",1,15,725,378,347
050,51,143,"Virginia","Pittsylvania County",1,16,749,383,366
050,51,143,"Virginia","Pittsylvania County",1,17,753,377,376
050,51,143,"Virginia","Pittsylvania County",1,18,656,358,298
050,51,143,"Virginia","Pittsylvania County",1,19,546,281,265
050,51,143,"Virginia","Pittsylvania County",1,20,604,330,274
050,51,143,"Virginia","Pittsylvania County",1,21,643,355,288
050,51,143,"Virginia","Pittsylvania County",1,22,672,374,298
050,51,143,"Virginia","Pittsylvania County",1,23,617,329,288
050,51,143,"Virginia","Pittsylvania County",1,24,657,344,313
050,51,143,"Virginia","Pittsylvania County",1,25,595,296,299
050,51,143,"Virginia","Pittsylvania County",1,26,639,340,299
050,51,143,"Virginia","Pittsylvania County",1,27,619,324,295
050,51,143,"Virginia","Pittsylvania County",1,28,619,330,289
050,51,143,"Virginia","Pittsylvania County",1,29,643,351,292
050,51,143,"Virginia","Pittsylvania County",1,30,671,355,316
050,51,143,"Virginia","Pittsylvania County",1,31,617,334,283
050,51,143,"Virginia","Pittsylvania County",1,32,568,294,274
050,51,143,"Virginia","Pittsylvania County",1,33,591,325,266
050,51,143,"Virginia","Pittsylvania County",1,34,628,328,300
050,51,143,"Virginia","Pittsylvania County",1,35,646,323,323
050,51,143,"Virginia","Pittsylvania County",1,36,633,304,329
050,51,143,"Virginia","Pittsylvania County",1,37,656,338,318
050,51,143,"Virginia","Pittsylvania County",1,38,664,334,330
050,51,143,"Virginia","Pittsylvania County",1,39,611,309,302
050,51,143,"Virginia","Pittsylvania County",1,40,636,333,303
050,51,143,"Virginia","Pittsylvania County",1,41,664,342,322
050,51,143,"Virginia","Pittsylvania County",1,42,674,332,342
050,51,143,"Virginia","Pittsylvania County",1,43,614,312,302
050,51,143,"Virginia","Pittsylvania County",1,44,635,342,293
050,51,143,"Virginia","Pittsylvania County",1,45,746,410,336
050,51,143,"Virginia","Pittsylvania County",1,46,753,391,362
050,51,143,"Virginia","Pittsylvania County",1,47,764,383,381
050,51,143,"Virginia","Pittsylvania County",1,48,844,426,418
050,51,143,"Virginia","Pittsylvania County",1,49,904,451,453
050,51,143,"Virginia","Pittsylvania County",1,50,851,458,393
050,51,143,"Virginia","Pittsylvania County",1,51,829,443,386
050,51,143,"Virginia","Pittsylvania County",1,52,781,407,374
050,51,143,"Virginia","Pittsylvania County",1,53,844,423,421
050,51,143,"Virginia","Pittsylvania County",1,54,938,456,482
050,51,143,"Virginia","Pittsylvania County",1,55,978,496,482
050,51,143,"Virginia","Pittsylvania County",1,56,1026,529,497
050,51,143,"Virginia","Pittsylvania County",1,57,1017,476,541
050,51,143,"Virginia","Pittsylvania County",1,58,1017,482,535
050,51,143,"Virginia","Pittsylvania County",1,59,1014,515,499
050,51,143,"Virginia","Pittsylvania County",1,60,995,497,498
050,51,143,"Virginia","Pittsylvania County",1,61,966,476,490
050,51,143,"Virginia","Pittsylvania County",1,62,996,482,514
050,51,143,"Virginia","Pittsylvania County",1,63,997,465,532
050,51,143,"Virginia","Pittsylvania County",1,64,953,449,504
050,51,143,"Virginia","Pittsylvania County",1,65,917,458,459
050,51,143,"Virginia","Pittsylvania County",1,66,902,442,460
050,51,143,"Virginia","Pittsylvania County",1,67,892,429,463
050,51,143,"Virginia","Pittsylvania County",1,68,909,446,463
050,51,143,"Virginia","Pittsylvania County",1,69,849,424,425
050,51,143,"Virginia","Pittsylvania County",1,70,818,395,423
050,51,143,"Virginia","Pittsylvania County",1,71,786,380,406
050,51,143,"Virginia","Pittsylvania County",1,72,807,382,425
050,51,143,"Virginia","Pittsylvania County",1,73,797,386,411
050,51,143,"Virginia","Pittsylvania County",1,74,592,259,333
050,51,143,"Virginia","Pittsylvania County",1,75,591,254,337
050,51,143,"Virginia","Pittsylvania County",1,76,608,285,323
050,51,143,"Virginia","Pittsylvania County",1,77,601,292,309
050,51,143,"Virginia","Pittsylvania County",1,78,532,256,276
050,51,143,"Virginia","Pittsylvania County",1,79,460,195,265
050,51,143,"Virginia","Pittsylvania County",1,80,386,161,225
050,51,143,"Virginia","Pittsylvania County",1,81,384,167,217
050,51,143,"Virginia","Pittsylvania County",1,82,332,140,192
050,51,143,"Virginia","Pittsylvania County",1,83,290,128,162
050,51,143,"Virginia","Pittsylvania County",1,84,253,117,136
050,51,143,"Virginia","Pittsylvania County",1,85,1372,473,899
050,51,143,"Virginia","Pittsylvania County",2,0,482,246,236
050,51,143,"Virginia","Pittsylvania County",2,1,495,265,230
050,51,143,"Virginia","Pittsylvania County",2,2,493,262,231
050,51,143,"Virginia","Pittsylvania County",2,3,495,253,242
050,51,143,"Virginia","Pittsylvania County",2,4,537,273,264
050,51,143,"Virginia","Pittsylvania County",2,5,538,270,268
050,51,143,"Virginia","Pittsylvania County",2,6,541,272,269
050,51,143,"Virginia","Pittsylvania County",2,7,563,290,273
050,51,143,"Virginia","Pittsylvania County",2,8,580,290,290
050,51,143,"Virginia","Pittsylvania County",2,9,602,306,296
050,51,143,"Virginia","Pittsylvania County",2,10,644,307,337
050,51,143,"Virginia","Pittsylvania County",2,11,684,324,360
050,51,143,"Virginia","Pittsylvania County",2,12,728,340,388
050,51,143,"Virginia","Pittsylvania County",2,13,749,364,385
050,51,143,"Virginia","Pittsylvania County",2,14,757,389,368
050,51,143,"Virginia","Pittsylvania County",2,15,731,379,352
050,51,143,"Virginia","Pittsylvania County",2,16,743,383,360
050,51,143,"Virginia","Pittsylvania County",2,17,753,379,374
050,51,143,"Virginia","Pittsylvania County",2,18,648,348,300
050,51,143,"Virginia","Pittsylvania County",2,19,543,282,261
050,51,143,"Virginia","Pittsylvania County",2,20,609,329,280
050,51,143,"Virginia","Pittsylvania County",2,21,642,353,289
050,51,143,"Virginia","Pittsylvania County",2,22,667,372,295
050,51,143,"Virginia","Pittsylvania County",2,23,627,336,291
050,51,143,"Virginia","Pittsylvania County",2,24,645,343,302
050,51,143,"Virginia","Pittsylvania County",2,25,604,300,304
050,51,143,"Virginia","Pittsylvania County",2,26,635,335,300
050,51,143,"Virginia","Pittsylvania County",2,27,622,329,293
050,51,143,"Virginia","Pittsylvania County",2,28,614,325,289
050,51,143,"Virginia","Pittsylvania County",2,29,636,343,293
050,51,143,"Virginia","Pittsylvania County",2,30,667,354,313
050,51,143,"Virginia","Pittsylvania County",2,31,626,337,289
050,51,143,"Virginia","Pittsylvania County",2,32,574,301,273
050,51,143,"Virginia","Pittsylvania County",2,33,585,318,267
050,51,143,"Virginia","Pittsylvania County",2,34,616,326,290
050,51,143,"Virginia","Pittsylvania County",2,35,650,330,320
050,51,143,"Virginia","Pittsylvania County",2,36,630,303,327
050,51,143,"Virginia","Pittsylvania County",2,37,657,335,322
050,51,143,"Virginia","Pittsylvania County",2,38,666,338,328
050,51,143,"Virginia","Pittsylvania County",2,39,620,311,309
050,51,143,"Virginia","Pittsylvania County",2,40,635,331,304
050,51,143,"Virginia","Pittsylvania County",2,41,657,340,317
050,51,143,"Virginia","Pittsylvania County",2,42,666,332,334
050,51,143,"Virginia","Pittsylvania County",2,43,635,321,314
050,51,143,"Virginia","Pittsylvania County",2,44,628,335,293
050,51,143,"Virginia","Pittsylvania County",2,45,720,393,327
050,51,143,"Virginia","Pittsylvania County",2,46,748,394,354
050,51,143,"Virginia","Pittsylvania County",2,47,759,385,374
050,51,143,"Virginia","Pittsylvania County",2,48,821,412,409
050,51,143,"Virginia","Pittsylvania County",2,49,896,449,447
050,51,143,"Virginia","Pittsylvania County",2,50,864,456,408
050,51,143,"Virginia","Pittsylvania County",2,51,830,444,386
050,51,143,"Virginia","Pittsylvania County",2,52,780,406,374
050,51,143,"Virginia","Pittsylvania County",2,53,826,418,408
050,51,143,"Virginia","Pittsylvania County",2,54,913,447,466
050,51,143,"Virginia","Pittsylvania County",2,55,969,488,481
050,51,143,"Virginia","Pittsylvania County",2,56,1019,523,496
050,51,143,"Virginia","Pittsylvania County",2,57,1017,486,531
050,51,143,"Virginia","Pittsylvania County",2,58,1014,482,532
050,51,143,"Virginia","Pittsylvania County",2,59,1016,508,508
050,51,143,"Virginia","Pittsylvania County",2,60,999,502,497
050,51,143,"Virginia","Pittsylvania County",2,61,970,480,490
050,51,143,"Virginia","Pittsylvania County",2,62,981,478,503
050,51,143,"Virginia","Pittsylvania County",2,63,1003,472,531
050,51,143,"Virginia","Pittsylvania County",2,64,954,447,507
050,51,143,"Virginia","Pittsylvania County",2,65,926,454,472
050,51,143,"Virginia","Pittsylvania County",2,66,899,443,456
050,51,143,"Virginia","Pittsylvania County",2,67,889,429,460
050,51,143,"Virginia","Pittsylvania County",2,68,890,436,454
050,51,143,"Virginia","Pittsylvania County",2,69,869,432,437
050,51,143,"Virginia","Pittsylvania County",2,70,824,402,422
050,51,143,"Virginia","Pittsylvania County",2,71,790,379,411
050,51,143,"Virginia","Pittsylvania County",2,72,789,374,415
050,51,143,"Virginia","Pittsylvania County",2,73,826,398,428
050,51,143,"Virginia","Pittsylvania County",2,74,602,271,331
050,51,143,"Virginia","Pittsylvania County",2,75,592,255,337
050,51,143,"Virginia","Pittsylvania County",2,76,593,271,322
050,51,143,"Virginia","Pittsylvania County",2,77,607,292,315
050,51,143,"Virginia","Pittsylvania County",2,78,535,259,276
050,51,143,"Virginia","Pittsylvania County",2,79,467,206,261
050,51,143,"Virginia","Pittsylvania County",2,80,400,168,232
050,51,143,"Virginia","Pittsylvania County",2,81,380,163,217
050,51,143,"Virginia","Pittsylvania County",2,82,338,144,194
050,51,143,"Virginia","Pittsylvania County",2,83,295,127,168
050,51,143,"Virginia","Pittsylvania County",2,84,256,118,138
050,51,143,"Virginia","Pittsylvania County",2,85,1382,483,899
050,51,143,"Virginia","Pittsylvania County",3,0,435,229,206
050,51,143,"Virginia","Pittsylvania County",3,1,528,275,253
050,51,143,"Virginia","Pittsylvania County",3,2,503,267,236
050,51,143,"Virginia","Pittsylvania County",3,3,502,274,228
050,51,143,"Virginia","Pittsylvania County",3,4,508,260,248
050,51,143,"Virginia","Pittsylvania County",3,5,538,270,268
050,51,143,"Virginia","Pittsylvania County",3,6,556,289,267
050,51,143,"Virginia","Pittsylvania County",3,7,544,260,284
050,51,143,"Virginia","Pittsylvania County",3,8,578,295,283
050,51,143,"Virginia","Pittsylvania County",3,9,591,290,301
050,51,143,"Virginia","Pittsylvania County",3,10,601,310,291
050,51,143,"Virginia","Pittsylvania County",3,11,652,317,335
050,51,143,"Virginia","Pittsylvania County",3,12,684,330,354
050,51,143,"Virginia","Pittsylvania County",3,13,719,329,390
050,51,143,"Virginia","Pittsylvania County",3,14,744,364,380
050,51,143,"Virginia","Pittsylvania County",3,15,732,370,362
050,51,143,"Virginia","Pittsylvania County",3,16,729,374,355
050,51,143,"Virginia","Pittsylvania County",3,17,746,378,368
050,51,143,"Virginia","Pittsylvania County",3,18,645,343,302
050,51,143,"Virginia","Pittsylvania County",3,19,525,282,243
050,51,143,"Virginia","Pittsylvania County",3,20,589,306,283
050,51,143,"Virginia","Pittsylvania County",3,21,660,363,297
050,51,143,"Virginia","Pittsylvania County",3,22,675,374,301
050,51,143,"Virginia","Pittsylvania County",3,23,659,352,307
050,51,143,"Virginia","Pittsylvania County",3,24,638,354,284
050,51,143,"Virginia","Pittsylvania County",3,25,594,304,290
050,51,143,"Virginia","Pittsylvania County",3,26,597,304,293
050,51,143,"Virginia","Pittsylvania County",3,27,618,326,292
050,51,143,"Virginia","Pittsylvania County",3,28,615,329,286
050,51,143,"Virginia","Pittsylvania County",3,29,642,344,298
050,51,143,"Virginia","Pittsylvania County",3,30,653,358,295
050,51,143,"Virginia","Pittsylvania County",3,31,667,357,310
050,51,143,"Virginia","Pittsylvania County",3,32,625,340,285
050,51,143,"Virginia","Pittsylvania County",3,33,567,284,283
050,51,143,"Virginia","Pittsylvania County",3,34,598,317,281
050,51,143,"Virginia","Pittsylvania County",3,35,652,354,298
050,51,143,"Virginia","Pittsylvania County",3,36,658,331,327
050,51,143,"Virginia","Pittsylvania County",3,37,642,312,330
050,51,143,"Virginia","Pittsylvania County",3,38,649,332,317
050,51,143,"Virginia","Pittsylvania County",3,39,651,333,318
050,51,143,"Virginia","Pittsylvania County",3,40,623,308,315
050,51,143,"Virginia","Pittsylvania County",3,41,641,342,299
050,51,143,"Virginia","Pittsylvania County",3,42,655,335,320
050,51,143,"Virginia","Pittsylvania County",3,43,673,330,343
050,51,143,"Virginia","Pittsylvania County",3,44,649,330,319
050,51,143,"Virginia","Pittsylvania County",3,45,608,318,290
050,51,143,"Virginia","Pittsylvania County",3,46,711,403,308
050,51,143,"Virginia","Pittsylvania County",3,47,744,385,359
050,51,143,"Virginia","Pittsylvania County",3,48,753,381,372
050,51,143,"Virginia","Pittsylvania County",3,49,839,429,410
050,51,143,"Virginia","Pittsylvania County",3,50,876,429,447
050,51,143,"Virginia","Pittsylvania County",3,51,877,469,408
050,51,143,"Virginia","Pittsylvania County",3,52,812,420,392
050,51,143,"Virginia","Pittsylvania County",3,53,787,408,379
050,51,143,"Virginia","Pittsylvania County",3,54,821,417,404
050,51,143,"Virginia","Pittsylvania County",3,55,909,447,462
050,51,143,"Virginia","Pittsylvania County",3,56,965,486,479
050,51,143,"Virginia","Pittsylvania County",3,57,998,499,499
050,51,143,"Virginia","Pittsylvania County",3,58,1024,494,530
050,51,143,"Virginia","Pittsylvania County",3,59,996,469,527
050,51,143,"Virginia","Pittsylvania County",3,60,1011,499,512
050,51,143,"Virginia","Pittsylvania County",3,61,969,485,484
050,51,143,"Virginia","Pittsylvania County",3,62,964,481,483
050,51,143,"Virginia","Pittsylvania County",3,63,971,474,497
050,51,143,"Virginia","Pittsylvania County",3,64,997,474,523
050,51,143,"Virginia","Pittsylvania County",3,65,944,434,510
050,51,143,"Virginia","Pittsylvania County",3,66,915,445,470
050,51,143,"Virginia","Pittsylvania County",3,67,891,440,451
050,51,143,"Virginia","Pittsylvania County",3,68,873,415,458
050,51,143,"Virginia","Pittsylvania County",3,69,871,419,452
050,51,143,"Virginia","Pittsylvania County",3,70,853,425,428
050,51,143,"Virginia","Pittsylvania County",3,71,801,389,412
050,51,143,"Virginia","Pittsylvania County",3,72,778,367,411
050,51,143,"Virginia","Pittsylvania County",3,73,770,362,408
050,51,143,"Virginia","Pittsylvania County",3,74,791,374,417
050,51,143,"Virginia","Pittsylvania County",3,75,589,263,326
050,51,143,"Virginia","Pittsylvania County",3,76,569,243,326
050,51,143,"Virginia","Pittsylvania County",3,77,571,256,315
050,51,143,"Virginia","Pittsylvania County",3,78,575,278,297
050,51,143,"Virginia","Pittsylvania County",3,79,520,247,273
050,51,143,"Virginia","Pittsylvania County",3,80,442,195,247
050,51,143,"Virginia","Pittsylvania County",3,81,384,161,223
050,51,143,"Virginia","Pittsylvania County",3,82,342,144,198
050,51,143,"Virginia","Pittsylvania County",3,83,317,133,184
050,51,143,"Virginia","Pittsylvania County",3,84,262,118,144
050,51,143,"Virginia","Pittsylvania County",3,85,1398,510,888
050,51,143,"Virginia","Pittsylvania County",4,0,411,219,192
050,51,143,"Virginia","Pittsylvania County",4,1,439,240,199
050,51,143,"Virginia","Pittsylvania County",4,2,546,285,261
050,51,143,"Virginia","Pittsylvania County",4,3,517,272,245
050,51,143,"Virginia","Pittsylvania County",4,4,518,281,237
050,51,143,"Virginia","Pittsylvania County",4,5,514,259,255
050,51,143,"Virginia","Pittsylvania County",4,6,553,276,277
050,51,143,"Virginia","Pittsylvania County",4,7,555,288,267
050,51,143,"Virginia","Pittsylvania County",4,8,547,265,282
050,51,143,"Virginia","Pittsylvania County",4,9,581,302,279
050,51,143,"Virginia","Pittsylvania County",4,10,587,291,296
050,51,143,"Virginia","Pittsylvania County",4,11,601,318,283
050,51,143,"Virginia","Pittsylvania County",4,12,665,328,337
050,51,143,"Virginia","Pittsylvania County",4,13,691,334,357
050,51,143,"Virginia","Pittsylvania County",4,14,730,334,396
050,51,143,"Virginia","Pittsylvania County",4,15,757,356,401
050,51,143,"Virginia","Pittsylvania County",4,16,750,376,374
050,51,143,"Virginia","Pittsylvania County",4,17,723,376,347
050,51,143,"Virginia","Pittsylvania County",4,18,626,346,280
050,51,143,"Virginia","Pittsylvania County",4,19,500,263,237
050,51,143,"Virginia","Pittsylvania County",4,20,567,314,253
050,51,143,"Virginia","Pittsylvania County",4,21,631,329,302
050,51,143,"Virginia","Pittsylvania County",4,22,716,394,322
050,51,143,"Virginia","Pittsylvania County",4,23,688,374,314
050,51,143,"Virginia","Pittsylvania County",4,24,648,361,287
050,51,143,"Virginia","Pittsylvania County",4,25,601,321,280
050,51,143,"Virginia","Pittsylvania County",4,26,599,321,278
050,51,143,"Virginia","Pittsylvania County",4,27,622,315,307
050,51,143,"Virginia","Pittsylvania County",4,28,648,342,306
050,51,143,"Virginia","Pittsylvania County",4,29,627,341,286
050,51,143,"Virginia","Pittsylvania County",4,30,645,340,305
050,51,143,"Virginia","Pittsylvania County",4,31,656,349,307
050,51,143,"Virginia","Pittsylvania County",4,32,662,346,316
050,51,143,"Virginia","Pittsylvania County",4,33,640,354,286
050,51,143,"Virginia","Pittsylvania County",4,34,581,282,299
050,51,143,"Virginia","Pittsylvania County",4,35,608,328,280
050,51,143,"Virginia","Pittsylvania County",4,36,642,342,300
050,51,143,"Virginia","Pittsylvania County",4,37,680,351,329
050,51,143,"Virginia","Pittsylvania County",4,38,654,314,340
050,51,143,"Virginia","Pittsylvania County",4,39,636,317,319
050,51,143,"Virginia","Pittsylvania County",4,40,666,348,318
050,51,143,"Virginia","Pittsylvania County",4,41,627,307,320
050,51,143,"Virginia","Pittsylvania County",4,42,631,329,302
050,51,143,"Virginia","Pittsylvania County",4,43,663,336,327
050,51,143,"Virginia","Pittsylvania County",4,44,698,353,345
050,51,143,"Virginia","Pittsylvania County",4,45,641,322,319
050,51,143,"Virginia","Pittsylvania County",4,46,612,326,286
050,51,143,"Virginia","Pittsylvania County",4,47,729,412,317
050,51,143,"Virginia","Pittsylvania County",4,48,736,375,361
050,51,143,"Virginia","Pittsylvania County",4,49,774,406,368
050,51,143,"Virginia","Pittsylvania County",4,50,832,419,413
050,51,143,"Virginia","Pittsylvania County",4,51,884,442,442
050,51,143,"Virginia","Pittsylvania County",4,52,843,440,403
050,51,143,"Virginia","Pittsylvania County",4,53,804,415,389
050,51,143,"Virginia","Pittsylvania County",4,54,789,407,382
050,51,143,"Virginia","Pittsylvania County",4,55,796,414,382
050,51,143,"Virginia","Pittsylvania County",4,56,908,449,459
050,51,143,"Virginia","Pittsylvania County",4,57,949,480,469
050,51,143,"Virginia","Pittsylvania County",4,58,1002,506,496
050,51,143,"Virginia","Pittsylvania County",4,59,1025,485,540
050,51,143,"Virginia","Pittsylvania County",4,60,987,463,524
050,51,143,"Virginia","Pittsylvania County",4,61,1003,495,508
050,51,143,"Virginia","Pittsylvania County",4,62,945,462,483
050,51,143,"Virginia","Pittsylvania County",4,63,942,468,474
050,51,143,"Virginia","Pittsylvania County",4,64,975,479,496
050,51,143,"Virginia","Pittsylvania County",4,65,982,458,524
050,51,143,"Virginia","Pittsylvania County",4,66,925,431,494
050,51,143,"Virginia","Pittsylvania County",4,67,920,442,478
050,51,143,"Virginia","Pittsylvania County",4,68,878,433,445
050,51,143,"Virginia","Pittsylvania County",4,69,862,411,451
050,51,143,"Virginia","Pittsylvania County",4,70,866,417,449
050,51,143,"Virginia","Pittsylvania County",4,71,837,413,424
050,51,143,"Virginia","Pittsylvania County",4,72,785,383,402
050,51,143,"Virginia","Pittsylvania County",4,73,751,356,395
050,51,143,"Virginia","Pittsylvania County",4,74,757,351,406
050,51,143,"Virginia","Pittsylvania County",4,75,763,359,404
050,51,143,"Virginia","Pittsylvania County",4,76,569,253,316
050,51,143,"Virginia","Pittsylvania County",4,77,540,217,323
050,51,143,"Virginia","Pittsylvania County",4,78,549,243,306
050,51,143,"Virginia","Pittsylvania County",4,79,552,264,288
050,51,143,"Virginia","Pittsylvania County",4,80,491,237,254
050,51,143,"Virginia","Pittsylvania County",4,81,424,190,234
050,51,143,"Virginia","Pittsylvania County",4,82,341,131,210
050,51,143,"Virginia","Pittsylvania County",4,83,322,128,194
050,51,143,"Virginia","Pittsylvania County",4,84,284,121,163
050,51,143,"Virginia","Pittsylvania County",4,85,1403,534,869
050,51,143,"Virginia","Pittsylvania County",5,0,398,210,188
050,51,143,"Virginia","Pittsylvania County",5,1,438,250,188
050,51,143,"Virginia","Pittsylvania County",5,2,453,240,213
050,51,143,"Virginia","Pittsylvania County",5,3,553,288,265
050,51,143,"Virginia","Pittsylvania County",5,4,531,286,245
050,51,143,"Virginia","Pittsylvania County",5,5,523,284,239
050,51,143,"Virginia","Pittsylvania County",5,6,540,272,268
050,51,143,"Virginia","Pittsylvania County",5,7,560,276,284
050,51,143,"Virginia","Pittsylvania County",5,8,560,290,270
050,51,143,"Virginia","Pittsylvania County",5,9,544,264,280
050,51,143,"Virginia","Pittsylvania County",5,10,595,316,279
050,51,143,"Virginia","Pittsylvania County",5,11,579,289,290
050,51,143,"Virginia","Pittsylvania County",5,12,607,326,281
050,51,143,"Virginia","Pittsylvania County",5,13,660,324,336
050,51,143,"Virginia","Pittsylvania County",5,14,693,351,342
050,51,143,"Virginia","Pittsylvania County",5,15,728,332,396
050,51,143,"Virginia","Pittsylvania County",5,16,752,364,388
050,51,143,"Virginia","Pittsylvania County",5,17,727,358,369
050,51,143,"Virginia","Pittsylvania County",5,18,617,333,284
050,51,143,"Virginia","Pittsylvania County",5,19,480,261,219
050,51,143,"Virginia","Pittsylvania County",5,20,558,303,255
050,51,143,"Virginia","Pittsylvania County",5,21,598,339,259
050,51,143,"Virginia","Pittsylvania County",5,22,677,354,323
050,51,143,"Virginia","Pittsylvania County",5,23,693,379,314
050,51,143,"Virginia","Pittsylvania County",5,24,676,377,299
050,51,143,"Virginia","Pittsylvania County",5,25,612,326,286
050,51,143,"Virginia","Pittsylvania County",5,26,626,337,289
050,51,143,"Virginia","Pittsylvania County",5,27,598,320,278
050,51,143,"Virginia","Pittsylvania County",5,28,628,321,307
050,51,143,"Virginia","Pittsylvania County",5,29,662,360,302
050,51,143,"Virginia","Pittsylvania County",5,30,637,355,282
050,51,143,"Virginia","Pittsylvania County",5,31,631,323,308
050,51,143,"Virginia","Pittsylvania County",5,32,641,337,304
050,51,143,"Virginia","Pittsylvania County",5,33,659,351,308
050,51,143,"Virginia","Pittsylvania County",5,34,641,349,292
050,51,143,"Virginia","Pittsylvania County",5,35,608,297,311
050,51,143,"Virginia","Pittsylvania County",5,36,619,337,282
050,51,143,"Virginia","Pittsylvania County",5,37,668,355,313
050,51,143,"Virginia","Pittsylvania County",5,38,679,348,331
050,51,143,"Virginia","Pittsylvania County",5,39,626,294,332
050,51,143,"Virginia","Pittsylvania County",5,40,639,320,319
050,51,143,"Virginia","Pittsylvania County",5,41,669,355,314
050,51,143,"Virginia","Pittsylvania County",5,42,628,306,322
050,51,143,"Virginia","Pittsylvania County",5,43,651,337,314
050,51,143,"Virginia","Pittsylvania County",5,44,695,361,334
050,51,143,"Virginia","Pittsylvania County",5,45,685,343,342
050,51,143,"Virginia","Pittsylvania County",5,46,644,333,311
050,51,143,"Virginia","Pittsylvania County",5,47,617,327,290
050,51,143,"Virginia","Pittsylvania County",5,48,716,403,313
050,51,143,"Virginia","Pittsylvania County",5,49,745,384,361
050,51,143,"Virginia","Pittsylvania County",5,50,770,405,365
050,51,143,"Virginia","Pittsylvania County",5,51,835,423,412
050,51,143,"Virginia","Pittsylvania County",5,52,878,435,443
050,51,143,"Virginia","Pittsylvania County",5,53,841,443,398
050,51,143,"Virginia","Pittsylvania County",5,54,806,422,384
050,51,143,"Virginia","Pittsylvania County",5,55,789,405,384
050,51,143,"Virginia","Pittsylvania County",5,56,786,411,375
050,51,143,"Virginia","Pittsylvania County",5,57,905,445,460
050,51,143,"Virginia","Pittsylvania County",5,58,955,484,471
050,51,143,"Virginia","Pittsylvania County",5,59,999,500,499
050,51,143,"Virginia","Pittsylvania County",5,60,1028,482,546
050,51,143,"Virginia","Pittsylvania County",5,61,990,468,522
050,51,143,"Virginia","Pittsylvania County",5,62,992,487,505
050,51,143,"Virginia","Pittsylvania County",5,63,926,453,473
050,51,143,"Virginia","Pittsylvania County",5,64,938,473,465
050,51,143,"Virginia","Pittsylvania County",5,65,963,462,501
050,51,143,"Virginia","Pittsylvania County",5,66,961,445,516
050,51,143,"Virginia","Pittsylvania County",5,67,927,431,496
050,51,143,"Virginia","Pittsylvania County",5,68,911,435,476
050,51,143,"Virginia","Pittsylvania County",5,69,875,432,443
050,51,143,"Virginia","Pittsylvania County",5,70,861,410,451
050,51,143,"Virginia","Pittsylvania County",5,71,850,402,448
050,51,143,"Virginia","Pittsylvania County",5,72,821,409,412
050,51,143,"Virginia","Pittsylvania County",5,73,758,368,390
050,51,143,"Virginia","Pittsylvania County",5,74,728,341,387
050,51,143,"Virginia","Pittsylvania County",5,75,734,341,393
050,51,143,"Virginia","Pittsylvania County",5,76,732,347,385
050,51,143,"Virginia","Pittsylvania County",5,77,554,237,317
050,51,143,"Virginia","Pittsylvania County",5,78,514,207,307
050,51,143,"Virginia","Pittsylvania County",5,79,532,229,303
050,51,143,"Virginia","Pittsylvania County",5,80,516,249,267
050,51,143,"Virginia","Pittsylvania County",5,81,471,229,242
050,51,143,"Virginia","Pittsylvania County",5,82,376,161,215
050,51,143,"Virginia","Pittsylvania County",5,83,322,114,208
050,51,143,"Virginia","Pittsylvania County",5,84,300,118,182
050,51,143,"Virginia","Pittsylvania County",5,85,1463,573,890
050,51,145,"Virginia","Powhatan County",1,0,255,129,126
050,51,145,"Virginia","Powhatan County",1,1,251,123,128
050,51,145,"Virginia","Powhatan County",1,2,267,127,140
050,51,145,"Virginia","Powhatan County",1,3,286,138,148
050,51,145,"Virginia","Powhatan County",1,4,278,152,126
050,51,145,"Virginia","Powhatan County",1,5,313,157,156
050,51,145,"Virginia","Powhatan County",1,6,304,157,147
050,51,145,"Virginia","Powhatan County",1,7,287,143,144
050,51,145,"Virginia","Powhatan County",1,8,311,162,149
050,51,145,"Virginia","Powhatan County",1,9,335,179,156
050,51,145,"Virginia","Powhatan County",1,10,310,170,140
050,51,145,"Virginia","Powhatan County",1,11,319,173,146
050,51,145,"Virginia","Powhatan County",1,12,353,186,167
050,51,145,"Virginia","Powhatan County",1,13,342,178,164
050,51,145,"Virginia","Powhatan County",1,14,343,195,148
050,51,145,"Virginia","Powhatan County",1,15,341,180,161
050,51,145,"Virginia","Powhatan County",1,16,346,184,162
050,51,145,"Virginia","Powhatan County",1,17,336,178,158
050,51,145,"Virginia","Powhatan County",1,18,292,164,128
050,51,145,"Virginia","Powhatan County",1,19,264,144,120
050,51,145,"Virginia","Powhatan County",1,20,271,153,118
050,51,145,"Virginia","Powhatan County",1,21,295,179,116
050,51,145,"Virginia","Powhatan County",1,22,289,166,123
050,51,145,"Virginia","Powhatan County",1,23,299,172,127
050,51,145,"Virginia","Powhatan County",1,24,307,169,138
050,51,145,"Virginia","Powhatan County",1,25,314,180,134
050,51,145,"Virginia","Powhatan County",1,26,359,210,149
050,51,145,"Virginia","Powhatan County",1,27,298,172,126
050,51,145,"Virginia","Powhatan County",1,28,333,191,142
050,51,145,"Virginia","Powhatan County",1,29,317,168,149
050,51,145,"Virginia","Powhatan County",1,30,316,174,142
050,51,145,"Virginia","Powhatan County",1,31,324,179,145
050,51,145,"Virginia","Powhatan County",1,32,365,204,161
050,51,145,"Virginia","Powhatan County",1,33,310,160,150
050,51,145,"Virginia","Powhatan County",1,34,322,167,155
050,51,145,"Virginia","Powhatan County",1,35,349,179,170
050,51,145,"Virginia","Powhatan County",1,36,407,215,192
050,51,145,"Virginia","Powhatan County",1,37,385,206,179
050,51,145,"Virginia","Powhatan County",1,38,394,214,180
050,51,145,"Virginia","Powhatan County",1,39,401,211,190
050,51,145,"Virginia","Powhatan County",1,40,415,217,198
050,51,145,"Virginia","Powhatan County",1,41,391,213,178
050,51,145,"Virginia","Powhatan County",1,42,408,221,187
050,51,145,"Virginia","Powhatan County",1,43,409,226,183
050,51,145,"Virginia","Powhatan County",1,44,411,204,207
050,51,145,"Virginia","Powhatan County",1,45,432,238,194
050,51,145,"Virginia","Powhatan County",1,46,412,225,187
050,51,145,"Virginia","Powhatan County",1,47,446,236,210
050,51,145,"Virginia","Powhatan County",1,48,456,236,220
050,51,145,"Virginia","Powhatan County",1,49,526,276,250
050,51,145,"Virginia","Powhatan County",1,50,511,264,247
050,51,145,"Virginia","Powhatan County",1,51,478,257,221
050,51,145,"Virginia","Powhatan County",1,52,468,232,236
050,51,145,"Virginia","Powhatan County",1,53,519,272,247
050,51,145,"Virginia","Powhatan County",1,54,516,270,246
050,51,145,"Virginia","Powhatan County",1,55,549,293,256
050,51,145,"Virginia","Powhatan County",1,56,529,278,251
050,51,145,"Virginia","Powhatan County",1,57,538,279,259
050,51,145,"Virginia","Powhatan County",1,58,549,269,280
050,51,145,"Virginia","Powhatan County",1,59,517,252,265
050,51,145,"Virginia","Powhatan County",1,60,489,250,239
050,51,145,"Virginia","Powhatan County",1,61,475,223,252
050,51,145,"Virginia","Powhatan County",1,62,500,251,249
050,51,145,"Virginia","Powhatan County",1,63,458,222,236
050,51,145,"Virginia","Powhatan County",1,64,421,208,213
050,51,145,"Virginia","Powhatan County",1,65,433,212,221
050,51,145,"Virginia","Powhatan County",1,66,439,230,209
050,51,145,"Virginia","Powhatan County",1,67,387,195,192
050,51,145,"Virginia","Powhatan County",1,68,373,185,188
050,51,145,"Virginia","Powhatan County",1,69,360,170,190
050,51,145,"Virginia","Powhatan County",1,70,353,175,178
050,51,145,"Virginia","Powhatan County",1,71,367,184,183
050,51,145,"Virginia","Powhatan County",1,72,362,186,176
050,51,145,"Virginia","Powhatan County",1,73,353,179,174
050,51,145,"Virginia","Powhatan County",1,74,260,129,131
050,51,145,"Virginia","Powhatan County",1,75,256,130,126
050,51,145,"Virginia","Powhatan County",1,76,239,120,119
050,51,145,"Virginia","Powhatan County",1,77,230,120,110
050,51,145,"Virginia","Powhatan County",1,78,183,81,102
050,51,145,"Virginia","Powhatan County",1,79,164,69,95
050,51,145,"Virginia","Powhatan County",1,80,136,63,73
050,51,145,"Virginia","Powhatan County",1,81,127,55,72
050,51,145,"Virginia","Powhatan County",1,82,109,57,52
050,51,145,"Virginia","Powhatan County",1,83,94,51,43
050,51,145,"Virginia","Powhatan County",1,84,85,41,44
050,51,145,"Virginia","Powhatan County",1,85,422,164,258
050,51,145,"Virginia","Powhatan County",2,0,246,123,123
050,51,145,"Virginia","Powhatan County",2,1,252,125,127
050,51,145,"Virginia","Powhatan County",2,2,267,127,140
050,51,145,"Virginia","Powhatan County",2,3,281,136,145
050,51,145,"Virginia","Powhatan County",2,4,284,152,132
050,51,145,"Virginia","Powhatan County",2,5,307,156,151
050,51,145,"Virginia","Powhatan County",2,6,310,159,151
050,51,145,"Virginia","Powhatan County",2,7,295,149,146
050,51,145,"Virginia","Powhatan County",2,8,309,161,148
050,51,145,"Virginia","Powhatan County",2,9,332,178,154
050,51,145,"Virginia","Powhatan County",2,10,317,172,145
050,51,145,"Virginia","Powhatan County",2,11,319,173,146
050,51,145,"Virginia","Powhatan County",2,12,349,185,164
050,51,145,"Virginia","Powhatan County",2,13,348,183,165
050,51,145,"Virginia","Powhatan County",2,14,343,190,153
050,51,145,"Virginia","Powhatan County",2,15,347,188,159
050,51,145,"Virginia","Powhatan County",2,16,347,186,161
050,51,145,"Virginia","Powhatan County",2,17,341,181,160
050,51,145,"Virginia","Powhatan County",2,18,294,163,131
050,51,145,"Virginia","Powhatan County",2,19,255,142,113
050,51,145,"Virginia","Powhatan County",2,20,279,156,123
050,51,145,"Virginia","Powhatan County",2,21,294,176,118
050,51,145,"Virginia","Powhatan County",2,22,290,170,120
050,51,145,"Virginia","Powhatan County",2,23,298,172,126
050,51,145,"Virginia","Powhatan County",2,24,301,168,133
050,51,145,"Virginia","Powhatan County",2,25,314,179,135
050,51,145,"Virginia","Powhatan County",2,26,344,199,145
050,51,145,"Virginia","Powhatan County",2,27,314,182,132
050,51,145,"Virginia","Powhatan County",2,28,332,191,141
050,51,145,"Virginia","Powhatan County",2,29,327,174,153
050,51,145,"Virginia","Powhatan County",2,30,323,178,145
050,51,145,"Virginia","Powhatan County",2,31,327,180,147
050,51,145,"Virginia","Powhatan County",2,32,359,200,159
050,51,145,"Virginia","Powhatan County",2,33,328,172,156
050,51,145,"Virginia","Powhatan County",2,34,326,168,158
050,51,145,"Virginia","Powhatan County",2,35,350,179,171
050,51,145,"Virginia","Powhatan County",2,36,391,206,185
050,51,145,"Virginia","Powhatan County",2,37,396,213,183
050,51,145,"Virginia","Powhatan County",2,38,395,214,181
050,51,145,"Virginia","Powhatan County",2,39,402,213,189
050,51,145,"Virginia","Powhatan County",2,40,422,221,201
050,51,145,"Virginia","Powhatan County",2,41,403,214,189
050,51,145,"Virginia","Powhatan County",2,42,406,219,187
050,51,145,"Virginia","Powhatan County",2,43,415,228,187
050,51,145,"Virginia","Powhatan County",2,44,409,211,198
050,51,145,"Virginia","Powhatan County",2,45,432,233,199
050,51,145,"Virginia","Powhatan County",2,46,418,230,188
050,51,145,"Virginia","Powhatan County",2,47,436,234,202
050,51,145,"Virginia","Powhatan County",2,48,450,234,216
050,51,145,"Virginia","Powhatan County",2,49,512,268,244
050,51,145,"Virginia","Powhatan County",2,50,517,270,247
050,51,145,"Virginia","Powhatan County",2,51,481,256,225
050,51,145,"Virginia","Powhatan County",2,52,465,233,232
050,51,145,"Virginia","Powhatan County",2,53,509,263,246
050,51,145,"Virginia","Powhatan County",2,54,516,271,245
050,51,145,"Virginia","Powhatan County",2,55,541,286,255
050,51,145,"Virginia","Powhatan County",2,56,537,280,257
050,51,145,"Virginia","Powhatan County",2,57,538,280,258
050,51,145,"Virginia","Powhatan County",2,58,546,269,277
050,51,145,"Virginia","Powhatan County",2,59,526,259,267
050,51,145,"Virginia","Powhatan County",2,60,497,250,247
050,51,145,"Virginia","Powhatan County",2,61,475,228,247
050,51,145,"Virginia","Powhatan County",2,62,493,245,248
050,51,145,"Virginia","Powhatan County",2,63,473,231,242
050,51,145,"Virginia","Powhatan County",2,64,424,210,214
050,51,145,"Virginia","Powhatan County",2,65,431,212,219
050,51,145,"Virginia","Powhatan County",2,66,440,226,214
050,51,145,"Virginia","Powhatan County",2,67,399,202,197
050,51,145,"Virginia","Powhatan County",2,68,374,186,188
050,51,145,"Virginia","Powhatan County",2,69,363,174,189
050,51,145,"Virginia","Powhatan County",2,70,353,173,180
050,51,145,"Virginia","Powhatan County",2,71,361,181,180
050,51,145,"Virginia","Powhatan County",2,72,355,183,172
050,51,145,"Virginia","Powhatan County",2,73,373,189,184
050,51,145,"Virginia","Powhatan County",2,74,263,132,131
050,51,145,"Virginia","Powhatan County",2,75,257,130,127
050,51,145,"Virginia","Powhatan County",2,76,238,120,118
050,51,145,"Virginia","Powhatan County",2,77,236,122,114
050,51,145,"Virginia","Powhatan County",2,78,190,89,101
050,51,145,"Virginia","Powhatan County",2,79,163,67,96
050,51,145,"Virginia","Powhatan County",2,80,142,64,78
050,51,145,"Virginia","Powhatan County",2,81,124,55,69
050,51,145,"Virginia","Powhatan County",2,82,112,55,57
050,51,145,"Virginia","Powhatan County",2,83,97,51,46
050,51,145,"Virginia","Powhatan County",2,84,85,42,43
050,51,145,"Virginia","Powhatan County",2,85,420,162,258
050,51,145,"Virginia","Powhatan County",3,0,285,162,123
050,51,145,"Virginia","Powhatan County",3,1,270,133,137
050,51,145,"Virginia","Powhatan County",3,2,276,128,148
050,51,145,"Virginia","Powhatan County",3,3,290,140,150
050,51,145,"Virginia","Powhatan County",3,4,291,143,148
050,51,145,"Virginia","Powhatan County",3,5,317,167,150
050,51,145,"Virginia","Powhatan County",3,6,325,175,150
050,51,145,"Virginia","Powhatan County",3,7,313,165,148
050,51,145,"Virginia","Powhatan County",3,8,296,146,150
050,51,145,"Virginia","Powhatan County",3,9,316,172,144
050,51,145,"Virginia","Powhatan County",3,10,351,187,164
050,51,145,"Virginia","Powhatan County",3,11,325,178,147
050,51,145,"Virginia","Powhatan County",3,12,328,177,151
050,51,145,"Virginia","Powhatan County",3,13,350,191,159
050,51,145,"Virginia","Powhatan County",3,14,359,186,173
050,51,145,"Virginia","Powhatan County",3,15,345,187,158
050,51,145,"Virginia","Powhatan County",3,16,352,194,158
050,51,145,"Virginia","Powhatan County",3,17,357,194,163
050,51,145,"Virginia","Powhatan County",3,18,302,162,140
050,51,145,"Virginia","Powhatan County",3,19,240,132,108
050,51,145,"Virginia","Powhatan County",3,20,297,167,130
050,51,145,"Virginia","Powhatan County",3,21,287,158,129
050,51,145,"Virginia","Powhatan County",3,22,306,182,124
050,51,145,"Virginia","Powhatan County",3,23,315,186,129
050,51,145,"Virginia","Powhatan County",3,24,293,176,117
050,51,145,"Virginia","Powhatan County",3,25,311,168,143
050,51,145,"Virginia","Powhatan County",3,26,322,183,139
050,51,145,"Virginia","Powhatan County",3,27,362,208,154
050,51,145,"Virginia","Powhatan County",3,28,338,193,145
050,51,145,"Virginia","Powhatan County",3,29,331,186,145
050,51,145,"Virginia","Powhatan County",3,30,356,191,165
050,51,145,"Virginia","Powhatan County",3,31,332,171,161
050,51,145,"Virginia","Powhatan County",3,32,342,189,153
050,51,145,"Virginia","Powhatan County",3,33,360,200,160
050,51,145,"Virginia","Powhatan County",3,34,365,191,174
050,51,145,"Virginia","Powhatan County",3,35,349,180,169
050,51,145,"Virginia","Powhatan County",3,36,372,191,181
050,51,145,"Virginia","Powhatan County",3,37,424,225,199
050,51,145,"Virginia","Powhatan County",3,38,413,224,189
050,51,145,"Virginia","Powhatan County",3,39,429,243,186
050,51,145,"Virginia","Powhatan County",3,40,426,228,198
050,51,145,"Virginia","Powhatan County",3,41,422,209,213
050,51,145,"Virginia","Powhatan County",3,42,412,215,197
050,51,145,"Virginia","Powhatan County",3,43,425,240,185
050,51,145,"Virginia","Powhatan County",3,44,427,235,192
050,51,145,"Virginia","Powhatan County",3,45,412,212,200
050,51,145,"Virginia","Powhatan County",3,46,445,233,212
050,51,145,"Virginia","Powhatan County",3,47,422,234,188
050,51,145,"Virginia","Powhatan County",3,48,450,231,219
050,51,145,"Virginia","Powhatan County",3,49,457,241,216
050,51,145,"Virginia","Powhatan County",3,50,522,278,244
050,51,145,"Virginia","Powhatan County",3,51,525,282,243
050,51,145,"Virginia","Powhatan County",3,52,497,262,235
050,51,145,"Virginia","Powhatan County",3,53,478,236,242
050,51,145,"Virginia","Powhatan County",3,54,526,275,251
050,51,145,"Virginia","Powhatan County",3,55,525,285,240
050,51,145,"Virginia","Powhatan County",3,56,527,274,253
050,51,145,"Virginia","Powhatan County",3,57,532,280,252
050,51,145,"Virginia","Powhatan County",3,58,549,281,268
050,51,145,"Virginia","Powhatan County",3,59,557,276,281
050,51,145,"Virginia","Powhatan County",3,60,528,263,265
050,51,145,"Virginia","Powhatan County",3,61,481,242,239
050,51,145,"Virginia","Powhatan County",3,62,484,229,255
050,51,145,"Virginia","Powhatan County",3,63,490,237,253
050,51,145,"Virginia","Powhatan County",3,64,459,222,237
050,51,145,"Virginia","Powhatan County",3,65,427,209,218
050,51,145,"Virginia","Powhatan County",3,66,424,209,215
050,51,145,"Virginia","Powhatan County",3,67,438,222,216
050,51,145,"Virginia","Powhatan County",3,68,398,204,194
050,51,145,"Virginia","Powhatan County",3,69,368,182,186
050,51,145,"Virginia","Powhatan County",3,70,363,171,192
050,51,145,"Virginia","Powhatan County",3,71,342,167,175
050,51,145,"Virginia","Powhatan County",3,72,363,177,186
050,51,145,"Virginia","Powhatan County",3,73,348,180,168
050,51,145,"Virginia","Powhatan County",3,74,377,194,183
050,51,145,"Virginia","Powhatan County",3,75,260,134,126
050,51,145,"Virginia","Powhatan County",3,76,262,130,132
050,51,145,"Virginia","Powhatan County",3,77,237,121,116
050,51,145,"Virginia","Powhatan County",3,78,234,117,117
050,51,145,"Virginia","Powhatan County",3,79,180,86,94
050,51,145,"Virginia","Powhatan County",3,80,149,62,87
050,51,145,"Virginia","Powhatan County",3,81,138,62,76
050,51,145,"Virginia","Powhatan County",3,82,117,52,65
050,51,145,"Virginia","Powhatan County",3,83,99,49,50
050,51,145,"Virginia","Powhatan County",3,84,88,46,42
050,51,145,"Virginia","Powhatan County",3,85,448,180,268
050,51,145,"Virginia","Powhatan County",4,0,281,154,127
050,51,145,"Virginia","Powhatan County",4,1,285,171,114
050,51,145,"Virginia","Powhatan County",4,2,287,142,145
050,51,145,"Virginia","Powhatan County",4,3,289,138,151
050,51,145,"Virginia","Powhatan County",4,4,303,151,152
050,51,145,"Virginia","Powhatan County",4,5,309,151,158
050,51,145,"Virginia","Powhatan County",4,6,322,164,158
050,51,145,"Virginia","Powhatan County",4,7,327,175,152
050,51,145,"Virginia","Powhatan County",4,8,339,171,168
050,51,145,"Virginia","Powhatan County",4,9,310,150,160
050,51,145,"Virginia","Powhatan County",4,10,325,175,150
050,51,145,"Virginia","Powhatan County",4,11,363,189,174
050,51,145,"Virginia","Powhatan County",4,12,327,181,146
050,51,145,"Virginia","Powhatan County",4,13,329,180,149
050,51,145,"Virginia","Powhatan County",4,14,370,203,167
050,51,145,"Virginia","Powhatan County",4,15,359,187,172
050,51,145,"Virginia","Powhatan County",4,16,348,190,158
050,51,145,"Virginia","Powhatan County",4,17,355,194,161
050,51,145,"Virginia","Powhatan County",4,18,301,169,132
050,51,145,"Virginia","Powhatan County",4,19,235,125,110
050,51,145,"Virginia","Powhatan County",4,20,257,144,113
050,51,145,"Virginia","Powhatan County",4,21,308,168,140
050,51,145,"Virginia","Powhatan County",4,22,302,172,130
050,51,145,"Virginia","Powhatan County",4,23,336,207,129
050,51,145,"Virginia","Powhatan County",4,24,297,173,124
050,51,145,"Virginia","Powhatan County",4,25,289,181,108
050,51,145,"Virginia","Powhatan County",4,26,313,168,145
050,51,145,"Virginia","Powhatan County",4,27,334,188,146
050,51,145,"Virginia","Powhatan County",4,28,384,218,166
050,51,145,"Virginia","Powhatan County",4,29,328,183,145
050,51,145,"Virginia","Powhatan County",4,30,336,179,157
050,51,145,"Virginia","Powhatan County",4,31,371,192,179
050,51,145,"Virginia","Powhatan County",4,32,327,165,162
050,51,145,"Virginia","Powhatan County",4,33,355,194,161
050,51,145,"Virginia","Powhatan County",4,34,388,213,175
050,51,145,"Virginia","Powhatan County",4,35,385,205,180
050,51,145,"Virginia","Powhatan County",4,36,378,197,181
050,51,145,"Virginia","Powhatan County",4,37,388,197,191
050,51,145,"Virginia","Powhatan County",4,38,429,224,205
050,51,145,"Virginia","Powhatan County",4,39,430,236,194
050,51,145,"Virginia","Powhatan County",4,40,432,245,187
050,51,145,"Virginia","Powhatan County",4,41,431,233,198
050,51,145,"Virginia","Powhatan County",4,42,420,211,209
050,51,145,"Virginia","Powhatan County",4,43,439,232,207
050,51,145,"Virginia","Powhatan County",4,44,432,241,191
050,51,145,"Virginia","Powhatan County",4,45,425,233,192
050,51,145,"Virginia","Powhatan County",4,46,417,217,200
050,51,145,"Virginia","Powhatan County",4,47,442,234,208
050,51,145,"Virginia","Powhatan County",4,48,426,231,195
050,51,145,"Virginia","Powhatan County",4,49,444,230,214
050,51,145,"Virginia","Powhatan County",4,50,474,249,225
050,51,145,"Virginia","Powhatan County",4,51,521,278,243
050,51,145,"Virginia","Powhatan County",4,52,518,275,243
050,51,145,"Virginia","Powhatan County",4,53,516,263,253
050,51,145,"Virginia","Powhatan County",4,54,468,235,233
050,51,145,"Virginia","Powhatan County",4,55,520,276,244
050,51,145,"Virginia","Powhatan County",4,56,526,280,246
050,51,145,"Virginia","Powhatan County",4,57,541,285,256
050,51,145,"Virginia","Powhatan County",4,58,531,278,253
050,51,145,"Virginia","Powhatan County",4,59,539,276,263
050,51,145,"Virginia","Powhatan County",4,60,548,272,276
050,51,145,"Virginia","Powhatan County",4,61,527,264,263
050,51,145,"Virginia","Powhatan County",4,62,479,235,244
050,51,145,"Virginia","Powhatan County",4,63,476,222,254
050,51,145,"Virginia","Powhatan County",4,64,485,234,251
050,51,145,"Virginia","Powhatan County",4,65,457,220,237
050,51,145,"Virginia","Powhatan County",4,66,419,203,216
050,51,145,"Virginia","Powhatan County",4,67,432,212,220
050,51,145,"Virginia","Powhatan County",4,68,438,224,214
050,51,145,"Virginia","Powhatan County",4,69,406,201,205
050,51,145,"Virginia","Powhatan County",4,70,348,166,182
050,51,145,"Virginia","Powhatan County",4,71,350,159,191
050,51,145,"Virginia","Powhatan County",4,72,332,161,171
050,51,145,"Virginia","Powhatan County",4,73,356,174,182
050,51,145,"Virginia","Powhatan County",4,74,351,182,169
050,51,145,"Virginia","Powhatan County",4,75,363,188,175
050,51,145,"Virginia","Powhatan County",4,76,251,131,120
050,51,145,"Virginia","Powhatan County",4,77,257,130,127
050,51,145,"Virginia","Powhatan County",4,78,227,116,111
050,51,145,"Virginia","Powhatan County",4,79,227,109,118
050,51,145,"Virginia","Powhatan County",4,80,160,78,82
050,51,145,"Virginia","Powhatan County",4,81,147,60,87
050,51,145,"Virginia","Powhatan County",4,82,136,60,76
050,51,145,"Virginia","Powhatan County",4,83,105,48,57
050,51,145,"Virginia","Powhatan County",4,84,93,45,48
050,51,145,"Virginia","Powhatan County",4,85,454,196,258
050,51,145,"Virginia","Powhatan County",5,0,280,155,125
050,51,145,"Virginia","Powhatan County",5,1,301,163,138
050,51,145,"Virginia","Powhatan County",5,2,296,176,120
050,51,145,"Virginia","Powhatan County",5,3,295,145,150
050,51,145,"Virginia","Powhatan County",5,4,311,153,158
050,51,145,"Virginia","Powhatan County",5,5,318,162,156
050,51,145,"Virginia","Powhatan County",5,6,325,161,164
050,51,145,"Virginia","Powhatan County",5,7,337,166,171
050,51,145,"Virginia","Powhatan County",5,8,329,178,151
050,51,145,"Virginia","Powhatan County",5,9,347,173,174
050,51,145,"Virginia","Powhatan County",5,10,321,156,165
050,51,145,"Virginia","Powhatan County",5,11,343,179,164
050,51,145,"Virginia","Powhatan County",5,12,355,182,173
050,51,145,"Virginia","Powhatan County",5,13,347,195,152
050,51,145,"Virginia","Powhatan County",5,14,335,175,160
050,51,145,"Virginia","Powhatan County",5,15,368,200,168
050,51,145,"Virginia","Powhatan County",5,16,369,188,181
050,51,145,"Virginia","Powhatan County",5,17,353,199,154
050,51,145,"Virginia","Powhatan County",5,18,309,169,140
050,51,145,"Virginia","Powhatan County",5,19,239,133,106
050,51,145,"Virginia","Powhatan County",5,20,266,140,126
050,51,145,"Virginia","Powhatan County",5,21,280,155,125
050,51,145,"Virginia","Powhatan County",5,22,332,185,147
050,51,145,"Virginia","Powhatan County",5,23,328,188,140
050,51,145,"Virginia","Powhatan County",5,24,314,184,130
050,51,145,"Virginia","Powhatan County",5,25,284,164,120
050,51,145,"Virginia","Powhatan County",5,26,295,176,119
050,51,145,"Virginia","Powhatan County",5,27,312,172,140
050,51,145,"Virginia","Powhatan County",5,28,338,194,144
050,51,145,"Virginia","Powhatan County",5,29,383,213,170
050,51,145,"Virginia","Powhatan County",5,30,353,197,156
050,51,145,"Virginia","Powhatan County",5,31,346,182,164
050,51,145,"Virginia","Powhatan County",5,32,390,197,193
050,51,145,"Virginia","Powhatan County",5,33,330,168,162
050,51,145,"Virginia","Powhatan County",5,34,367,198,169
050,51,145,"Virginia","Powhatan County",5,35,411,216,195
050,51,145,"Virginia","Powhatan County",5,36,413,217,196
050,51,145,"Virginia","Powhatan County",5,37,393,201,192
050,51,145,"Virginia","Powhatan County",5,38,402,200,202
050,51,145,"Virginia","Powhatan County",5,39,452,242,210
050,51,145,"Virginia","Powhatan County",5,40,447,248,199
050,51,145,"Virginia","Powhatan County",5,41,433,240,193
050,51,145,"Virginia","Powhatan County",5,42,428,227,201
050,51,145,"Virginia","Powhatan County",5,43,431,224,207
050,51,145,"Virginia","Powhatan County",5,44,434,232,202
050,51,145,"Virginia","Powhatan County",5,45,447,247,200
050,51,145,"Virginia","Powhatan County",5,46,436,236,200
050,51,145,"Virginia","Powhatan County",5,47,421,214,207
050,51,145,"Virginia","Powhatan County",5,48,445,237,208
050,51,145,"Virginia","Powhatan County",5,49,434,232,202
050,51,145,"Virginia","Powhatan County",5,50,453,228,225
050,51,145,"Virginia","Powhatan County",5,51,470,241,229
050,51,145,"Virginia","Powhatan County",5,52,511,267,244
050,51,145,"Virginia","Powhatan County",5,53,547,292,255
050,51,145,"Virginia","Powhatan County",5,54,517,266,251
050,51,145,"Virginia","Powhatan County",5,55,470,234,236
050,51,145,"Virginia","Powhatan County",5,56,518,271,247
050,51,145,"Virginia","Powhatan County",5,57,529,287,242
050,51,145,"Virginia","Powhatan County",5,58,537,283,254
050,51,145,"Virginia","Powhatan County",5,59,535,283,252
050,51,145,"Virginia","Powhatan County",5,60,537,279,258
050,51,145,"Virginia","Powhatan County",5,61,541,263,278
050,51,145,"Virginia","Powhatan County",5,62,533,266,267
050,51,145,"Virginia","Powhatan County",5,63,482,231,251
050,51,145,"Virginia","Powhatan County",5,64,476,220,256
050,51,145,"Virginia","Powhatan County",5,65,493,243,250
050,51,145,"Virginia","Powhatan County",5,66,471,228,243
050,51,145,"Virginia","Powhatan County",5,67,411,194,217
050,51,145,"Virginia","Powhatan County",5,68,440,208,232
050,51,145,"Virginia","Powhatan County",5,69,437,222,215
050,51,145,"Virginia","Powhatan County",5,70,401,196,205
050,51,145,"Virginia","Powhatan County",5,71,335,160,175
050,51,145,"Virginia","Powhatan County",5,72,342,158,184
050,51,145,"Virginia","Powhatan County",5,73,327,160,167
050,51,145,"Virginia","Powhatan County",5,74,350,173,177
050,51,145,"Virginia","Powhatan County",5,75,341,181,160
050,51,145,"Virginia","Powhatan County",5,76,356,184,172
050,51,145,"Virginia","Powhatan County",5,77,245,124,121
050,51,145,"Virginia","Powhatan County",5,78,247,123,124
050,51,145,"Virginia","Powhatan County",5,79,222,113,109
050,51,145,"Virginia","Powhatan County",5,80,216,106,110
050,51,145,"Virginia","Powhatan County",5,81,157,76,81
050,51,145,"Virginia","Powhatan County",5,82,135,55,80
050,51,145,"Virginia","Powhatan County",5,83,130,58,72
050,51,145,"Virginia","Powhatan County",5,84,94,43,51
050,51,145,"Virginia","Powhatan County",5,85,476,221,255
050,51,147,"Virginia","Prince Edward County",1,0,200,102,98
050,51,147,"Virginia","Prince Edward County",1,1,196,99,97
050,51,147,"Virginia","Prince Edward County",1,2,182,88,94
050,51,147,"Virginia","Prince Edward County",1,3,196,108,88
050,51,147,"Virginia","Prince Edward County",1,4,221,125,96
050,51,147,"Virginia","Prince Edward County",1,5,192,103,89
050,51,147,"Virginia","Prince Edward County",1,6,189,90,99
050,51,147,"Virginia","Prince Edward County",1,7,168,72,96
050,51,147,"Virginia","Prince Edward County",1,8,179,89,90
050,51,147,"Virginia","Prince Edward County",1,9,169,89,80
050,51,147,"Virginia","Prince Edward County",1,10,183,93,90
050,51,147,"Virginia","Prince Edward County",1,11,198,92,106
050,51,147,"Virginia","Prince Edward County",1,12,189,93,96
050,51,147,"Virginia","Prince Edward County",1,13,171,91,80
050,51,147,"Virginia","Prince Edward County",1,14,193,102,91
050,51,147,"Virginia","Prince Edward County",1,15,208,110,98
050,51,147,"Virginia","Prince Edward County",1,16,207,106,101
050,51,147,"Virginia","Prince Edward County",1,17,220,120,100
050,51,147,"Virginia","Prince Edward County",1,18,687,333,354
050,51,147,"Virginia","Prince Edward County",1,19,1287,583,704
050,51,147,"Virginia","Prince Edward County",1,20,1209,568,641
050,51,147,"Virginia","Prince Edward County",1,21,1039,704,335
050,51,147,"Virginia","Prince Edward County",1,22,785,483,302
050,51,147,"Virginia","Prince Edward County",1,23,384,245,139
050,51,147,"Virginia","Prince Edward County",1,24,306,191,115
050,51,147,"Virginia","Prince Edward County",1,25,306,176,130
050,51,147,"Virginia","Prince Edward County",1,26,274,175,99
050,51,147,"Virginia","Prince Edward County",1,27,268,167,101
050,51,147,"Virginia","Prince Edward County",1,28,245,139,106
050,51,147,"Virginia","Prince Edward County",1,29,269,152,117
050,51,147,"Virginia","Prince Edward County",1,30,241,128,113
050,51,147,"Virginia","Prince Edward County",1,31,232,135,97
050,51,147,"Virginia","Prince Edward County",1,32,240,138,102
050,51,147,"Virginia","Prince Edward County",1,33,222,106,116
050,51,147,"Virginia","Prince Edward County",1,34,226,115,111
050,51,147,"Virginia","Prince Edward County",1,35,213,117,96
050,51,147,"Virginia","Prince Edward County",1,36,193,119,74
050,51,147,"Virginia","Prince Edward County",1,37,205,121,84
050,51,147,"Virginia","Prince Edward County",1,38,206,99,107
050,51,147,"Virginia","Prince Edward County",1,39,228,124,104
050,51,147,"Virginia","Prince Edward County",1,40,210,114,96
050,51,147,"Virginia","Prince Edward County",1,41,199,119,80
050,51,147,"Virginia","Prince Edward County",1,42,200,112,88
050,51,147,"Virginia","Prince Edward County",1,43,179,97,82
050,51,147,"Virginia","Prince Edward County",1,44,196,106,90
050,51,147,"Virginia","Prince Edward County",1,45,211,110,101
050,51,147,"Virginia","Prince Edward County",1,46,194,109,85
050,51,147,"Virginia","Prince Edward County",1,47,189,101,88
050,51,147,"Virginia","Prince Edward County",1,48,199,88,111
050,51,147,"Virginia","Prince Edward County",1,49,197,103,94
050,51,147,"Virginia","Prince Edward County",1,50,190,90,100
050,51,147,"Virginia","Prince Edward County",1,51,239,113,126
050,51,147,"Virginia","Prince Edward County",1,52,213,109,104
050,51,147,"Virginia","Prince Edward County",1,53,213,106,107
050,51,147,"Virginia","Prince Edward County",1,54,233,121,112
050,51,147,"Virginia","Prince Edward County",1,55,241,128,113
050,51,147,"Virginia","Prince Edward County",1,56,247,117,130
050,51,147,"Virginia","Prince Edward County",1,57,254,114,140
050,51,147,"Virginia","Prince Edward County",1,58,252,125,127
050,51,147,"Virginia","Prince Edward County",1,59,239,122,117
050,51,147,"Virginia","Prince Edward County",1,60,252,108,144
050,51,147,"Virginia","Prince Edward County",1,61,265,124,141
050,51,147,"Virginia","Prince Edward County",1,62,266,138,128
050,51,147,"Virginia","Prince Edward County",1,63,247,120,127
050,51,147,"Virginia","Prince Edward County",1,64,246,118,128
050,51,147,"Virginia","Prince Edward County",1,65,256,125,131
050,51,147,"Virginia","Prince Edward County",1,66,235,102,133
050,51,147,"Virginia","Prince Edward County",1,67,221,98,123
050,51,147,"Virginia","Prince Edward County",1,68,211,104,107
050,51,147,"Virginia","Prince Edward County",1,69,227,110,117
050,51,147,"Virginia","Prince Edward County",1,70,197,101,96
050,51,147,"Virginia","Prince Edward County",1,71,182,86,96
050,51,147,"Virginia","Prince Edward County",1,72,169,79,90
050,51,147,"Virginia","Prince Edward County",1,73,162,70,92
050,51,147,"Virginia","Prince Edward County",1,74,125,53,72
050,51,147,"Virginia","Prince Edward County",1,75,126,54,72
050,51,147,"Virginia","Prince Edward County",1,76,140,63,77
050,51,147,"Virginia","Prince Edward County",1,77,151,63,88
050,51,147,"Virginia","Prince Edward County",1,78,112,48,64
050,51,147,"Virginia","Prince Edward County",1,79,99,40,59
050,51,147,"Virginia","Prince Edward County",1,80,104,52,52
050,51,147,"Virginia","Prince Edward County",1,81,92,38,54
050,51,147,"Virginia","Prince Edward County",1,82,85,33,52
050,51,147,"Virginia","Prince Edward County",1,83,83,31,52
050,51,147,"Virginia","Prince Edward County",1,84,63,24,39
050,51,147,"Virginia","Prince Edward County",1,85,512,150,362
050,51,147,"Virginia","Prince Edward County",2,0,227,116,111
050,51,147,"Virginia","Prince Edward County",2,1,198,99,99
050,51,147,"Virginia","Prince Edward County",2,2,184,90,94
050,51,147,"Virginia","Prince Edward County",2,3,192,103,89
050,51,147,"Virginia","Prince Edward County",2,4,213,119,94
050,51,147,"Virginia","Prince Edward County",2,5,199,107,92
050,51,147,"Virginia","Prince Edward County",2,6,187,91,96
050,51,147,"Virginia","Prince Edward County",2,7,174,78,96
050,51,147,"Virginia","Prince Edward County",2,8,177,86,91
050,51,147,"Virginia","Prince Edward County",2,9,175,90,85
050,51,147,"Virginia","Prince Edward County",2,10,182,93,89
050,51,147,"Virginia","Prince Edward County",2,11,193,93,100
050,51,147,"Virginia","Prince Edward County",2,12,194,95,99
050,51,147,"Virginia","Prince Edward County",2,13,179,95,84
050,51,147,"Virginia","Prince Edward County",2,14,188,100,88
050,51,147,"Virginia","Prince Edward County",2,15,204,108,96
050,51,147,"Virginia","Prince Edward County",2,16,209,107,102
050,51,147,"Virginia","Prince Edward County",2,17,216,116,100
050,51,147,"Virginia","Prince Edward County",2,18,685,330,355
050,51,147,"Virginia","Prince Edward County",2,19,1273,577,696
050,51,147,"Virginia","Prince Edward County",2,20,1225,573,652
050,51,147,"Virginia","Prince Edward County",2,21,1040,710,330
050,51,147,"Virginia","Prince Edward County",2,22,787,480,307
050,51,147,"Virginia","Prince Edward County",2,23,385,248,137
050,51,147,"Virginia","Prince Edward County",2,24,307,191,116
050,51,147,"Virginia","Prince Edward County",2,25,306,176,130
050,51,147,"Virginia","Prince Edward County",2,26,279,174,105
050,51,147,"Virginia","Prince Edward County",2,27,270,169,101
050,51,147,"Virginia","Prince Edward County",2,28,255,147,108
050,51,147,"Virginia","Prince Edward County",2,29,266,151,115
050,51,147,"Virginia","Prince Edward County",2,30,244,129,115
050,51,147,"Virginia","Prince Edward County",2,31,237,137,100
050,51,147,"Virginia","Prince Edward County",2,32,242,140,102
050,51,147,"Virginia","Prince Edward County",2,33,224,109,115
050,51,147,"Virginia","Prince Edward County",2,34,230,117,113
050,51,147,"Virginia","Prince Edward County",2,35,221,120,101
050,51,147,"Virginia","Prince Edward County",2,36,193,115,78
050,51,147,"Virginia","Prince Edward County",2,37,203,121,82
050,51,147,"Virginia","Prince Edward County",2,38,206,102,104
050,51,147,"Virginia","Prince Edward County",2,39,224,122,102
050,51,147,"Virginia","Prince Edward County",2,40,208,110,98
050,51,147,"Virginia","Prince Edward County",2,41,204,120,84
050,51,147,"Virginia","Prince Edward County",2,42,201,114,87
050,51,147,"Virginia","Prince Edward County",2,43,183,99,84
050,51,147,"Virginia","Prince Edward County",2,44,189,103,86
050,51,147,"Virginia","Prince Edward County",2,45,211,112,99
050,51,147,"Virginia","Prince Edward County",2,46,196,107,89
050,51,147,"Virginia","Prince Edward County",2,47,188,102,86
050,51,147,"Virginia","Prince Edward County",2,48,195,90,105
050,51,147,"Virginia","Prince Edward County",2,49,198,100,98
050,51,147,"Virginia","Prince Edward County",2,50,189,91,98
050,51,147,"Virginia","Prince Edward County",2,51,226,108,118
050,51,147,"Virginia","Prince Edward County",2,52,217,109,108
050,51,147,"Virginia","Prince Edward County",2,53,212,104,108
050,51,147,"Virginia","Prince Edward County",2,54,228,118,110
050,51,147,"Virginia","Prince Edward County",2,55,240,127,113
050,51,147,"Virginia","Prince Edward County",2,56,246,119,127
050,51,147,"Virginia","Prince Edward County",2,57,252,114,138
050,51,147,"Virginia","Prince Edward County",2,58,256,124,132
050,51,147,"Virginia","Prince Edward County",2,59,241,120,121
050,51,147,"Virginia","Prince Edward County",2,60,251,113,138
050,51,147,"Virginia","Prince Edward County",2,61,261,119,142
050,51,147,"Virginia","Prince Edward County",2,62,265,136,129
050,51,147,"Virginia","Prince Edward County",2,63,252,124,128
050,51,147,"Virginia","Prince Edward County",2,64,247,119,128
050,51,147,"Virginia","Prince Edward County",2,65,254,122,132
050,51,147,"Virginia","Prince Edward County",2,66,240,107,133
050,51,147,"Virginia","Prince Edward County",2,67,225,98,127
050,51,147,"Virginia","Prince Edward County",2,68,208,99,109
050,51,147,"Virginia","Prince Edward County",2,69,224,110,114
050,51,147,"Virginia","Prince Edward County",2,70,203,104,99
050,51,147,"Virginia","Prince Edward County",2,71,183,87,96
050,51,147,"Virginia","Prince Edward County",2,72,167,78,89
050,51,147,"Virginia","Prince Edward County",2,73,171,75,96
050,51,147,"Virginia","Prince Edward County",2,74,127,56,71
050,51,147,"Virginia","Prince Edward County",2,75,123,50,73
050,51,147,"Virginia","Prince Edward County",2,76,136,60,76
050,51,147,"Virginia","Prince Edward County",2,77,151,64,87
050,51,147,"Virginia","Prince Edward County",2,78,118,51,67
050,51,147,"Virginia","Prince Edward County",2,79,98,40,58
050,51,147,"Virginia","Prince Edward County",2,80,101,48,53
050,51,147,"Virginia","Prince Edward County",2,81,91,39,52
050,51,147,"Virginia","Prince Edward County",2,82,87,34,53
050,51,147,"Virginia","Prince Edward County",2,83,82,29,53
050,51,147,"Virginia","Prince Edward County",2,84,60,22,38
050,51,147,"Virginia","Prince Edward County",2,85,508,149,359
050,51,147,"Virginia","Prince Edward County",3,0,201,100,101
050,51,147,"Virginia","Prince Edward County",3,1,212,113,99
050,51,147,"Virginia","Prince Edward County",3,2,201,102,99
050,51,147,"Virginia","Prince Edward County",3,3,194,98,96
050,51,147,"Virginia","Prince Edward County",3,4,183,102,81
050,51,147,"Virginia","Prince Edward County",3,5,210,121,89
050,51,147,"Virginia","Prince Edward County",3,6,194,105,89
050,51,147,"Virginia","Prince Edward County",3,7,196,103,93
050,51,147,"Virginia","Prince Edward County",3,8,180,85,95
050,51,147,"Virginia","Prince Edward County",3,9,181,86,95
050,51,147,"Virginia","Prince Edward County",3,10,168,87,81
050,51,147,"Virginia","Prince Edward County",3,11,180,91,89
050,51,147,"Virginia","Prince Edward County",3,12,194,94,100
050,51,147,"Virginia","Prince Edward County",3,13,199,94,105
050,51,147,"Virginia","Prince Edward County",3,14,169,95,74
050,51,147,"Virginia","Prince Edward County",3,15,189,98,91
050,51,147,"Virginia","Prince Edward County",3,16,202,108,94
050,51,147,"Virginia","Prince Edward County",3,17,205,104,101
050,51,147,"Virginia","Prince Edward County",3,18,681,322,359
050,51,147,"Virginia","Prince Edward County",3,19,1265,572,693
050,51,147,"Virginia","Prince Edward County",3,20,1231,574,657
050,51,147,"Virginia","Prince Edward County",3,21,1046,721,325
050,51,147,"Virginia","Prince Edward County",3,22,781,464,317
050,51,147,"Virginia","Prince Edward County",3,23,378,248,130
050,51,147,"Virginia","Prince Edward County",3,24,290,191,99
050,51,147,"Virginia","Prince Edward County",3,25,298,177,121
050,51,147,"Virginia","Prince Edward County",3,26,280,170,110
050,51,147,"Virginia","Prince Edward County",3,27,288,177,111
050,51,147,"Virginia","Prince Edward County",3,28,249,146,103
050,51,147,"Virginia","Prince Edward County",3,29,262,152,110
050,51,147,"Virginia","Prince Edward County",3,30,247,126,121
050,51,147,"Virginia","Prince Edward County",3,31,247,142,105
050,51,147,"Virginia","Prince Edward County",3,32,244,147,97
050,51,147,"Virginia","Prince Edward County",3,33,244,131,113
050,51,147,"Virginia","Prince Edward County",3,34,242,134,108
050,51,147,"Virginia","Prince Edward County",3,35,241,130,111
050,51,147,"Virginia","Prince Edward County",3,36,205,107,98
050,51,147,"Virginia","Prince Edward County",3,37,204,117,87
050,51,147,"Virginia","Prince Edward County",3,38,191,105,86
050,51,147,"Virginia","Prince Edward County",3,39,227,128,99
050,51,147,"Virginia","Prince Edward County",3,40,206,103,103
050,51,147,"Virginia","Prince Edward County",3,41,210,110,100
050,51,147,"Virginia","Prince Edward County",3,42,224,131,93
050,51,147,"Virginia","Prince Edward County",3,43,199,111,88
050,51,147,"Virginia","Prince Edward County",3,44,182,98,84
050,51,147,"Virginia","Prince Edward County",3,45,203,110,93
050,51,147,"Virginia","Prince Edward County",3,46,213,111,102
050,51,147,"Virginia","Prince Edward County",3,47,202,109,93
050,51,147,"Virginia","Prince Edward County",3,48,171,84,87
050,51,147,"Virginia","Prince Edward County",3,49,194,95,99
050,51,147,"Virginia","Prince Edward County",3,50,196,95,101
050,51,147,"Virginia","Prince Edward County",3,51,198,99,99
050,51,147,"Virginia","Prince Edward County",3,52,216,101,115
050,51,147,"Virginia","Prince Edward County",3,53,209,98,111
050,51,147,"Virginia","Prince Edward County",3,54,222,110,112
050,51,147,"Virginia","Prince Edward County",3,55,234,124,110
050,51,147,"Virginia","Prince Edward County",3,56,232,124,108
050,51,147,"Virginia","Prince Edward County",3,57,249,122,127
050,51,147,"Virginia","Prince Edward County",3,58,260,121,139
050,51,147,"Virginia","Prince Edward County",3,59,245,116,129
050,51,147,"Virginia","Prince Edward County",3,60,244,122,122
050,51,147,"Virginia","Prince Edward County",3,61,239,105,134
050,51,147,"Virginia","Prince Edward County",3,62,270,128,142
050,51,147,"Virginia","Prince Edward County",3,63,262,128,134
050,51,147,"Virginia","Prince Edward County",3,64,251,126,125
050,51,147,"Virginia","Prince Edward County",3,65,240,112,128
050,51,147,"Virginia","Prince Edward County",3,66,246,117,129
050,51,147,"Virginia","Prince Edward County",3,67,252,116,136
050,51,147,"Virginia","Prince Edward County",3,68,217,94,123
050,51,147,"Virginia","Prince Edward County",3,69,215,100,115
050,51,147,"Virginia","Prince Edward County",3,70,216,109,107
050,51,147,"Virginia","Prince Edward County",3,71,198,100,98
050,51,147,"Virginia","Prince Edward County",3,72,174,82,92
050,51,147,"Virginia","Prince Edward County",3,73,172,77,95
050,51,147,"Virginia","Prince Edward County",3,74,163,78,85
050,51,147,"Virginia","Prince Edward County",3,75,105,39,66
050,51,147,"Virginia","Prince Edward County",3,76,130,52,78
050,51,147,"Virginia","Prince Edward County",3,77,136,57,79
050,51,147,"Virginia","Prince Edward County",3,78,131,58,73
050,51,147,"Virginia","Prince Edward County",3,79,111,47,64
050,51,147,"Virginia","Prince Edward County",3,80,94,40,54
050,51,147,"Virginia","Prince Edward County",3,81,97,43,54
050,51,147,"Virginia","Prince Edward County",3,82,95,43,52
050,51,147,"Virginia","Prince Edward County",3,83,86,29,57
050,51,147,"Virginia","Prince Edward County",3,84,61,22,39
050,51,147,"Virginia","Prince Edward County",3,85,493,137,356
050,51,147,"Virginia","Prince Edward County",4,0,210,113,97
050,51,147,"Virginia","Prince Edward County",4,1,178,79,99
050,51,147,"Virginia","Prince Edward County",4,2,207,112,95
050,51,147,"Virginia","Prince Edward County",4,3,197,97,100
050,51,147,"Virginia","Prince Edward County",4,4,189,91,98
050,51,147,"Virginia","Prince Edward County",4,5,179,100,79
050,51,147,"Virginia","Prince Edward County",4,6,207,120,87
050,51,147,"Virginia","Prince Edward County",4,7,204,117,87
050,51,147,"Virginia","Prince Edward County",4,8,202,105,97
050,51,147,"Virginia","Prince Edward County",4,9,179,84,95
050,51,147,"Virginia","Prince Edward County",4,10,191,92,99
050,51,147,"Virginia","Prince Edward County",4,11,175,95,80
050,51,147,"Virginia","Prince Edward County",4,12,179,93,86
050,51,147,"Virginia","Prince Edward County",4,13,193,91,102
050,51,147,"Virginia","Prince Edward County",4,14,198,94,104
050,51,147,"Virginia","Prince Edward County",4,15,167,92,75
050,51,147,"Virginia","Prince Edward County",4,16,202,105,97
050,51,147,"Virginia","Prince Edward County",4,17,215,115,100
050,51,147,"Virginia","Prince Edward County",4,18,683,313,370
050,51,147,"Virginia","Prince Edward County",4,19,1256,560,696
050,51,147,"Virginia","Prince Edward County",4,20,1230,571,659
050,51,147,"Virginia","Prince Edward County",4,21,1078,739,339
050,51,147,"Virginia","Prince Edward County",4,22,811,481,330
050,51,147,"Virginia","Prince Edward County",4,23,358,229,129
050,51,147,"Virginia","Prince Edward County",4,24,293,197,96
050,51,147,"Virginia","Prince Edward County",4,25,268,163,105
050,51,147,"Virginia","Prince Edward County",4,26,263,160,103
050,51,147,"Virginia","Prince Edward County",4,27,263,154,109
050,51,147,"Virginia","Prince Edward County",4,28,272,164,108
050,51,147,"Virginia","Prince Edward County",4,29,254,152,102
050,51,147,"Virginia","Prince Edward County",4,30,233,118,115
050,51,147,"Virginia","Prince Edward County",4,31,244,133,111
050,51,147,"Virginia","Prince Edward County",4,32,236,132,104
050,51,147,"Virginia","Prince Edward County",4,33,227,127,100
050,51,147,"Virginia","Prince Edward County",4,34,254,144,110
050,51,147,"Virginia","Prince Edward County",4,35,224,130,94
050,51,147,"Virginia","Prince Edward County",4,36,226,108,118
050,51,147,"Virginia","Prince Edward County",4,37,211,111,100
050,51,147,"Virginia","Prince Edward County",4,38,192,104,88
050,51,147,"Virginia","Prince Edward County",4,39,198,123,75
050,51,147,"Virginia","Prince Edward County",4,40,215,116,99
050,51,147,"Virginia","Prince Edward County",4,41,209,101,108
050,51,147,"Virginia","Prince Edward County",4,42,214,115,99
050,51,147,"Virginia","Prince Edward County",4,43,221,126,95
050,51,147,"Virginia","Prince Edward County",4,44,195,112,83
050,51,147,"Virginia","Prince Edward County",4,45,196,106,90
050,51,147,"Virginia","Prince Edward County",4,46,201,104,97
050,51,147,"Virginia","Prince Edward County",4,47,216,115,101
050,51,147,"Virginia","Prince Edward County",4,48,185,92,93
050,51,147,"Virginia","Prince Edward County",4,49,172,84,88
050,51,147,"Virginia","Prince Edward County",4,50,187,92,95
050,51,147,"Virginia","Prince Edward County",4,51,195,100,95
050,51,147,"Virginia","Prince Edward County",4,52,192,89,103
050,51,147,"Virginia","Prince Edward County",4,53,219,94,125
050,51,147,"Virginia","Prince Edward County",4,54,210,100,110
050,51,147,"Virginia","Prince Edward County",4,55,226,109,117
050,51,147,"Virginia","Prince Edward County",4,56,231,120,111
050,51,147,"Virginia","Prince Edward County",4,57,225,121,104
050,51,147,"Virginia","Prince Edward County",4,58,260,136,124
050,51,147,"Virginia","Prince Edward County",4,59,241,109,132
050,51,147,"Virginia","Prince Edward County",4,60,237,111,126
050,51,147,"Virginia","Prince Edward County",4,61,252,125,127
050,51,147,"Virginia","Prince Edward County",4,62,239,109,130
050,51,147,"Virginia","Prince Edward County",4,63,260,125,135
050,51,147,"Virginia","Prince Edward County",4,64,264,129,135
050,51,147,"Virginia","Prince Edward County",4,65,241,116,125
050,51,147,"Virginia","Prince Edward County",4,66,236,112,124
050,51,147,"Virginia","Prince Edward County",4,67,255,123,132
050,51,147,"Virginia","Prince Edward County",4,68,236,104,132
050,51,147,"Virginia","Prince Edward County",4,69,228,99,129
050,51,147,"Virginia","Prince Edward County",4,70,205,98,107
050,51,147,"Virginia","Prince Edward County",4,71,214,104,110
050,51,147,"Virginia","Prince Edward County",4,72,193,97,96
050,51,147,"Virginia","Prince Edward County",4,73,175,81,94
050,51,147,"Virginia","Prince Edward County",4,74,164,79,85
050,51,147,"Virginia","Prince Edward County",4,75,146,67,79
050,51,147,"Virginia","Prince Edward County",4,76,109,41,68
050,51,147,"Virginia","Prince Edward County",4,77,130,52,78
050,51,147,"Virginia","Prince Edward County",4,78,119,52,67
050,51,147,"Virginia","Prince Edward County",4,79,117,49,68
050,51,147,"Virginia","Prince Edward County",4,80,106,44,62
050,51,147,"Virginia","Prince Edward County",4,81,89,37,52
050,51,147,"Virginia","Prince Edward County",4,82,102,45,57
050,51,147,"Virginia","Prince Edward County",4,83,91,33,58
050,51,147,"Virginia","Prince Edward County",4,84,66,23,43
050,51,147,"Virginia","Prince Edward County",4,85,469,122,347
050,51,147,"Virginia","Prince Edward County",5,0,206,110,96
050,51,147,"Virginia","Prince Edward County",5,1,232,125,107
050,51,147,"Virginia","Prince Edward County",5,2,184,78,106
050,51,147,"Virginia","Prince Edward County",5,3,213,121,92
050,51,147,"Virginia","Prince Edward County",5,4,192,96,96
050,51,147,"Virginia","Prince Edward County",5,5,194,97,97
050,51,147,"Virginia","Prince Edward County",5,6,172,90,82
050,51,147,"Virginia","Prince Edward County",5,7,215,126,89
050,51,147,"Virginia","Prince Edward County",5,8,203,116,87
050,51,147,"Virginia","Prince Edward County",5,9,203,106,97
050,51,147,"Virginia","Prince Edward County",5,10,188,88,100
050,51,147,"Virginia","Prince Edward County",5,11,192,94,98
050,51,147,"Virginia","Prince Edward County",5,12,175,98,77
050,51,147,"Virginia","Prince Edward County",5,13,178,94,84
050,51,147,"Virginia","Prince Edward County",5,14,200,94,106
050,51,147,"Virginia","Prince Edward County",5,15,194,91,103
050,51,147,"Virginia","Prince Edward County",5,16,165,94,71
050,51,147,"Virginia","Prince Edward County",5,17,211,109,102
050,51,147,"Virginia","Prince Edward County",5,18,680,320,360
050,51,147,"Virginia","Prince Edward County",5,19,1274,563,711
050,51,147,"Virginia","Prince Edward County",5,20,1210,559,651
050,51,147,"Virginia","Prince Edward County",5,21,1063,727,336
050,51,147,"Virginia","Prince Edward County",5,22,827,499,328
050,51,147,"Virginia","Prince Edward County",5,23,388,237,151
050,51,147,"Virginia","Prince Edward County",5,24,275,178,97
050,51,147,"Virginia","Prince Edward County",5,25,275,175,100
050,51,147,"Virginia","Prince Edward County",5,26,238,149,89
050,51,147,"Virginia","Prince Edward County",5,27,253,137,116
050,51,147,"Virginia","Prince Edward County",5,28,237,130,107
050,51,147,"Virginia","Prince Edward County",5,29,262,160,102
050,51,147,"Virginia","Prince Edward County",5,30,239,129,110
050,51,147,"Virginia","Prince Edward County",5,31,244,131,113
050,51,147,"Virginia","Prince Edward County",5,32,251,133,118
050,51,147,"Virginia","Prince Edward County",5,33,242,123,119
050,51,147,"Virginia","Prince Edward County",5,34,238,144,94
050,51,147,"Virginia","Prince Edward County",5,35,266,153,113
050,51,147,"Virginia","Prince Edward County",5,36,222,119,103
050,51,147,"Virginia","Prince Edward County",5,37,237,119,118
050,51,147,"Virginia","Prince Edward County",5,38,208,104,104
050,51,147,"Virginia","Prince Edward County",5,39,197,124,73
050,51,147,"Virginia","Prince Edward County",5,40,179,104,75
050,51,147,"Virginia","Prince Edward County",5,41,215,110,105
050,51,147,"Virginia","Prince Edward County",5,42,213,101,112
050,51,147,"Virginia","Prince Edward County",5,43,222,115,107
050,51,147,"Virginia","Prince Edward County",5,44,220,129,91
050,51,147,"Virginia","Prince Edward County",5,45,201,119,82
050,51,147,"Virginia","Prince Edward County",5,46,203,108,95
050,51,147,"Virginia","Prince Edward County",5,47,194,105,89
050,51,147,"Virginia","Prince Edward County",5,48,207,102,105
050,51,147,"Virginia","Prince Edward County",5,49,188,96,92
050,51,147,"Virginia","Prince Edward County",5,50,164,79,85
050,51,147,"Virginia","Prince Edward County",5,51,199,99,100
050,51,147,"Virginia","Prince Edward County",5,52,191,89,102
050,51,147,"Virginia","Prince Edward County",5,53,184,80,104
050,51,147,"Virginia","Prince Edward County",5,54,225,97,128
050,51,147,"Virginia","Prince Edward County",5,55,218,102,116
050,51,147,"Virginia","Prince Edward County",5,56,219,99,120
050,51,147,"Virginia","Prince Edward County",5,57,234,123,111
050,51,147,"Virginia","Prince Edward County",5,58,234,127,107
050,51,147,"Virginia","Prince Edward County",5,59,254,131,123
050,51,147,"Virginia","Prince Edward County",5,60,238,106,132
050,51,147,"Virginia","Prince Edward County",5,61,239,115,124
050,51,147,"Virginia","Prince Edward County",5,62,261,128,133
050,51,147,"Virginia","Prince Edward County",5,63,243,107,136
050,51,147,"Virginia","Prince Edward County",5,64,273,135,138
050,51,147,"Virginia","Prince Edward County",5,65,257,124,133
050,51,147,"Virginia","Prince Edward County",5,66,234,113,121
050,51,147,"Virginia","Prince Edward County",5,67,243,120,123
050,51,147,"Virginia","Prince Edward County",5,68,246,117,129
050,51,147,"Virginia","Prince Edward County",5,69,250,110,140
050,51,147,"Virginia","Prince Edward County",5,70,213,93,120
050,51,147,"Virginia","Prince Edward County",5,71,198,91,107
050,51,147,"Virginia","Prince Edward County",5,72,204,97,107
050,51,147,"Virginia","Prince Edward County",5,73,192,95,97
050,51,147,"Virginia","Prince Edward County",5,74,177,87,90
050,51,147,"Virginia","Prince Edward County",5,75,143,65,78
050,51,147,"Virginia","Prince Edward County",5,76,150,66,84
050,51,147,"Virginia","Prince Edward County",5,77,113,39,74
050,51,147,"Virginia","Prince Edward County",5,78,109,46,63
050,51,147,"Virginia","Prince Edward County",5,79,107,43,64
050,51,147,"Virginia","Prince Edward County",5,80,115,50,65
050,51,147,"Virginia","Prince Edward County",5,81,102,39,63
050,51,147,"Virginia","Prince Edward County",5,82,93,40,53
050,51,147,"Virginia","Prince Edward County",5,83,97,34,63
050,51,147,"Virginia","Prince Edward County",5,84,73,27,46
050,51,147,"Virginia","Prince Edward County",5,85,472,116,356
050,51,149,"Virginia","Prince George County",1,0,374,193,181
050,51,149,"Virginia","Prince George County",1,1,430,224,206
050,51,149,"Virginia","Prince George County",1,2,460,238,222
050,51,149,"Virginia","Prince George County",1,3,478,240,238
050,51,149,"Virginia","Prince George County",1,4,494,248,246
050,51,149,"Virginia","Prince George County",1,5,539,275,264
050,51,149,"Virginia","Prince George County",1,6,468,237,231
050,51,149,"Virginia","Prince George County",1,7,476,255,221
050,51,149,"Virginia","Prince George County",1,8,501,261,240
050,51,149,"Virginia","Prince George County",1,9,481,248,233
050,51,149,"Virginia","Prince George County",1,10,495,253,242
050,51,149,"Virginia","Prince George County",1,11,487,251,236
050,51,149,"Virginia","Prince George County",1,12,527,284,243
050,51,149,"Virginia","Prince George County",1,13,500,246,254
050,51,149,"Virginia","Prince George County",1,14,472,231,241
050,51,149,"Virginia","Prince George County",1,15,459,228,231
050,51,149,"Virginia","Prince George County",1,16,474,230,244
050,51,149,"Virginia","Prince George County",1,17,448,213,235
050,51,149,"Virginia","Prince George County",1,18,591,300,291
050,51,149,"Virginia","Prince George County",1,19,1105,607,498
050,51,149,"Virginia","Prince George County",1,20,866,460,406
050,51,149,"Virginia","Prince George County",1,21,918,606,312
050,51,149,"Virginia","Prince George County",1,22,1093,688,405
050,51,149,"Virginia","Prince George County",1,23,1101,744,357
050,51,149,"Virginia","Prince George County",1,24,697,470,227
050,51,149,"Virginia","Prince George County",1,25,846,546,300
050,51,149,"Virginia","Prince George County",1,26,682,470,212
050,51,149,"Virginia","Prince George County",1,27,813,509,304
050,51,149,"Virginia","Prince George County",1,28,772,510,262
050,51,149,"Virginia","Prince George County",1,29,750,454,296
050,51,149,"Virginia","Prince George County",1,30,770,519,251
050,51,149,"Virginia","Prince George County",1,31,655,423,232
050,51,149,"Virginia","Prince George County",1,32,658,382,276
050,51,149,"Virginia","Prince George County",1,33,740,423,317
050,51,149,"Virginia","Prince George County",1,34,752,446,306
050,51,149,"Virginia","Prince George County",1,35,700,429,271
050,51,149,"Virginia","Prince George County",1,36,675,388,287
050,51,149,"Virginia","Prince George County",1,37,674,413,261
050,51,149,"Virginia","Prince George County",1,38,635,391,244
050,51,149,"Virginia","Prince George County",1,39,666,419,247
050,51,149,"Virginia","Prince George County",1,40,634,411,223
050,51,149,"Virginia","Prince George County",1,41,612,394,218
050,51,149,"Virginia","Prince George County",1,42,537,330,207
050,51,149,"Virginia","Prince George County",1,43,483,292,191
050,51,149,"Virginia","Prince George County",1,44,487,289,198
050,51,149,"Virginia","Prince George County",1,45,432,237,195
050,51,149,"Virginia","Prince George County",1,46,478,304,174
050,51,149,"Virginia","Prince George County",1,47,429,245,184
050,51,149,"Virginia","Prince George County",1,48,494,298,196
050,51,149,"Virginia","Prince George County",1,49,501,285,216
050,51,149,"Virginia","Prince George County",1,50,441,244,197
050,51,149,"Virginia","Prince George County",1,51,421,223,198
050,51,149,"Virginia","Prince George County",1,52,452,244,208
050,51,149,"Virginia","Prince George County",1,53,475,288,187
050,51,149,"Virginia","Prince George County",1,54,496,272,224
050,51,149,"Virginia","Prince George County",1,55,484,247,237
050,51,149,"Virginia","Prince George County",1,56,509,254,255
050,51,149,"Virginia","Prince George County",1,57,476,259,217
050,51,149,"Virginia","Prince George County",1,58,459,241,218
050,51,149,"Virginia","Prince George County",1,59,456,220,236
050,51,149,"Virginia","Prince George County",1,60,440,238,202
050,51,149,"Virginia","Prince George County",1,61,464,241,223
050,51,149,"Virginia","Prince George County",1,62,430,201,229
050,51,149,"Virginia","Prince George County",1,63,415,220,195
050,51,149,"Virginia","Prince George County",1,64,406,208,198
050,51,149,"Virginia","Prince George County",1,65,415,210,205
050,51,149,"Virginia","Prince George County",1,66,370,186,184
050,51,149,"Virginia","Prince George County",1,67,349,164,185
050,51,149,"Virginia","Prince George County",1,68,358,171,187
050,51,149,"Virginia","Prince George County",1,69,350,172,178
050,51,149,"Virginia","Prince George County",1,70,301,141,160
050,51,149,"Virginia","Prince George County",1,71,315,151,164
050,51,149,"Virginia","Prince George County",1,72,322,162,160
050,51,149,"Virginia","Prince George County",1,73,324,155,169
050,51,149,"Virginia","Prince George County",1,74,214,104,110
050,51,149,"Virginia","Prince George County",1,75,217,98,119
050,51,149,"Virginia","Prince George County",1,76,216,101,115
050,51,149,"Virginia","Prince George County",1,77,192,99,93
050,51,149,"Virginia","Prince George County",1,78,166,87,79
050,51,149,"Virginia","Prince George County",1,79,161,72,89
050,51,149,"Virginia","Prince George County",1,80,171,77,94
050,51,149,"Virginia","Prince George County",1,81,134,60,74
050,51,149,"Virginia","Prince George County",1,82,110,49,61
050,51,149,"Virginia","Prince George County",1,83,100,42,58
050,51,149,"Virginia","Prince George County",1,84,75,34,41
050,51,149,"Virginia","Prince George County",1,85,517,196,321
050,51,149,"Virginia","Prince George County",2,0,372,191,181
050,51,149,"Virginia","Prince George County",2,1,423,216,207
050,51,149,"Virginia","Prince George County",2,2,454,236,218
050,51,149,"Virginia","Prince George County",2,3,468,235,233
050,51,149,"Virginia","Prince George County",2,4,496,249,247
050,51,149,"Virginia","Prince George County",2,5,532,267,265
050,51,149,"Virginia","Prince George County",2,6,489,246,243
050,51,149,"Virginia","Prince George County",2,7,478,252,226
050,51,149,"Virginia","Prince George County",2,8,494,259,235
050,51,149,"Virginia","Prince George County",2,9,484,251,233
050,51,149,"Virginia","Prince George County",2,10,491,250,241
050,51,149,"Virginia","Prince George County",2,11,489,254,235
050,51,149,"Virginia","Prince George County",2,12,521,278,243
050,51,149,"Virginia","Prince George County",2,13,502,252,250
050,51,149,"Virginia","Prince George County",2,14,475,234,241
050,51,149,"Virginia","Prince George County",2,15,462,230,232
050,51,149,"Virginia","Prince George County",2,16,470,228,242
050,51,149,"Virginia","Prince George County",2,17,461,223,238
050,51,149,"Virginia","Prince George County",2,18,584,295,289
050,51,149,"Virginia","Prince George County",2,19,1117,616,501
050,51,149,"Virginia","Prince George County",2,20,864,454,410
050,51,149,"Virginia","Prince George County",2,21,923,613,310
050,51,149,"Virginia","Prince George County",2,22,1106,692,414
050,51,149,"Virginia","Prince George County",2,23,1097,743,354
050,51,149,"Virginia","Prince George County",2,24,711,476,235
050,51,149,"Virginia","Prince George County",2,25,840,550,290
050,51,149,"Virginia","Prince George County",2,26,684,470,214
050,51,149,"Virginia","Prince George County",2,27,810,510,300
050,51,149,"Virginia","Prince George County",2,28,772,509,263
050,51,149,"Virginia","Prince George County",2,29,759,460,299
050,51,149,"Virginia","Prince George County",2,30,782,527,255
050,51,149,"Virginia","Prince George County",2,31,660,419,241
050,51,149,"Virginia","Prince George County",2,32,662,389,273
050,51,149,"Virginia","Prince George County",2,33,729,425,304
050,51,149,"Virginia","Prince George County",2,34,738,433,305
050,51,149,"Virginia","Prince George County",2,35,718,439,279
050,51,149,"Virginia","Prince George County",2,36,659,380,279
050,51,149,"Virginia","Prince George County",2,37,684,417,267
050,51,149,"Virginia","Prince George County",2,38,643,393,250
050,51,149,"Virginia","Prince George County",2,39,662,416,246
050,51,149,"Virginia","Prince George County",2,40,645,415,230
050,51,149,"Virginia","Prince George County",2,41,611,390,221
050,51,149,"Virginia","Prince George County",2,42,539,331,208
050,51,149,"Virginia","Prince George County",2,43,496,300,196
050,51,149,"Virginia","Prince George County",2,44,486,291,195
050,51,149,"Virginia","Prince George County",2,45,429,237,192
050,51,149,"Virginia","Prince George County",2,46,481,303,178
050,51,149,"Virginia","Prince George County",2,47,426,243,183
050,51,149,"Virginia","Prince George County",2,48,481,286,195
050,51,149,"Virginia","Prince George County",2,49,501,291,210
050,51,149,"Virginia","Prince George County",2,50,445,245,200
050,51,149,"Virginia","Prince George County",2,51,418,221,197
050,51,149,"Virginia","Prince George County",2,52,442,240,202
050,51,149,"Virginia","Prince George County",2,53,473,281,192
050,51,149,"Virginia","Prince George County",2,54,487,270,217
050,51,149,"Virginia","Prince George County",2,55,488,254,234
050,51,149,"Virginia","Prince George County",2,56,499,252,247
050,51,149,"Virginia","Prince George County",2,57,484,258,226
050,51,149,"Virginia","Prince George County",2,58,463,245,218
050,51,149,"Virginia","Prince George County",2,59,453,222,231
050,51,149,"Virginia","Prince George County",2,60,441,233,208
050,51,149,"Virginia","Prince George County",2,61,454,236,218
050,51,149,"Virginia","Prince George County",2,62,433,209,224
050,51,149,"Virginia","Prince George County",2,63,415,213,202
050,51,149,"Virginia","Prince George County",2,64,399,204,195
050,51,149,"Virginia","Prince George County",2,65,414,210,204
050,51,149,"Virginia","Prince George County",2,66,380,191,189
050,51,149,"Virginia","Prince George County",2,67,349,167,182
050,51,149,"Virginia","Prince George County",2,68,354,168,186
050,51,149,"Virginia","Prince George County",2,69,355,175,180
050,51,149,"Virginia","Prince George County",2,70,314,149,165
050,51,149,"Virginia","Prince George County",2,71,308,146,162
050,51,149,"Virginia","Prince George County",2,72,315,157,158
050,51,149,"Virginia","Prince George County",2,73,333,162,171
050,51,149,"Virginia","Prince George County",2,74,226,110,116
050,51,149,"Virginia","Prince George County",2,75,218,101,117
050,51,149,"Virginia","Prince George County",2,76,211,96,115
050,51,149,"Virginia","Prince George County",2,77,201,102,99
050,51,149,"Virginia","Prince George County",2,78,166,87,79
050,51,149,"Virginia","Prince George County",2,79,162,75,87
050,51,149,"Virginia","Prince George County",2,80,164,73,91
050,51,149,"Virginia","Prince George County",2,81,138,61,77
050,51,149,"Virginia","Prince George County",2,82,114,51,63
050,51,149,"Virginia","Prince George County",2,83,101,44,57
050,51,149,"Virginia","Prince George County",2,84,78,35,43
050,51,149,"Virginia","Prince George County",2,85,518,194,324
050,51,149,"Virginia","Prince George County",3,0,352,181,171
050,51,149,"Virginia","Prince George County",3,1,372,184,188
050,51,149,"Virginia","Prince George County",3,2,448,231,217
050,51,149,"Virginia","Prince George County",3,3,463,243,220
050,51,149,"Virginia","Prince George County",3,4,441,239,202
050,51,149,"Virginia","Prince George County",3,5,524,264,260
050,51,149,"Virginia","Prince George County",3,6,527,259,268
050,51,149,"Virginia","Prince George County",3,7,493,245,248
050,51,149,"Virginia","Prince George County",3,8,488,246,242
050,51,149,"Virginia","Prince George County",3,9,505,253,252
050,51,149,"Virginia","Prince George County",3,10,463,227,236
050,51,149,"Virginia","Prince George County",3,11,507,259,248
050,51,149,"Virginia","Prince George County",3,12,470,251,219
050,51,149,"Virginia","Prince George County",3,13,522,273,249
050,51,149,"Virginia","Prince George County",3,14,518,263,255
050,51,149,"Virginia","Prince George County",3,15,469,229,240
050,51,149,"Virginia","Prince George County",3,16,451,233,218
050,51,149,"Virginia","Prince George County",3,17,474,240,234
050,51,149,"Virginia","Prince George County",3,18,579,291,288
050,51,149,"Virginia","Prince George County",3,19,1157,656,501
050,51,149,"Virginia","Prince George County",3,20,857,444,413
050,51,149,"Virginia","Prince George County",3,21,934,632,302
050,51,149,"Virginia","Prince George County",3,22,1140,700,440
050,51,149,"Virginia","Prince George County",3,23,1087,736,351
050,51,149,"Virginia","Prince George County",3,24,718,472,246
050,51,149,"Virginia","Prince George County",3,25,815,525,290
050,51,149,"Virginia","Prince George County",3,26,663,453,210
050,51,149,"Virginia","Prince George County",3,27,804,513,291
050,51,149,"Virginia","Prince George County",3,28,728,486,242
050,51,149,"Virginia","Prince George County",3,29,774,486,288
050,51,149,"Virginia","Prince George County",3,30,845,553,292
050,51,149,"Virginia","Prince George County",3,31,674,424,250
050,51,149,"Virginia","Prince George County",3,32,642,382,260
050,51,149,"Virginia","Prince George County",3,33,711,421,290
050,51,149,"Virginia","Prince George County",3,34,712,400,312
050,51,149,"Virginia","Prince George County",3,35,717,459,258
050,51,149,"Virginia","Prince George County",3,36,603,349,254
050,51,149,"Virginia","Prince George County",3,37,654,394,260
050,51,149,"Virginia","Prince George County",3,38,657,405,252
050,51,149,"Virginia","Prince George County",3,39,676,425,251
050,51,149,"Virginia","Prince George County",3,40,661,407,254
050,51,149,"Virginia","Prince George County",3,41,596,375,221
050,51,149,"Virginia","Prince George County",3,42,555,353,202
050,51,149,"Virginia","Prince George County",3,43,525,323,202
050,51,149,"Virginia","Prince George County",3,44,499,304,195
050,51,149,"Virginia","Prince George County",3,45,416,229,187
050,51,149,"Virginia","Prince George County",3,46,493,306,187
050,51,149,"Virginia","Prince George County",3,47,412,232,180
050,51,149,"Virginia","Prince George County",3,48,431,244,187
050,51,149,"Virginia","Prince George County",3,49,472,287,185
050,51,149,"Virginia","Prince George County",3,50,456,256,200
050,51,149,"Virginia","Prince George County",3,51,424,237,187
050,51,149,"Virginia","Prince George County",3,52,406,213,193
050,51,149,"Virginia","Prince George County",3,53,464,267,197
050,51,149,"Virginia","Prince George County",3,54,457,252,205
050,51,149,"Virginia","Prince George County",3,55,476,256,220
050,51,149,"Virginia","Prince George County",3,56,476,249,227
050,51,149,"Virginia","Prince George County",3,57,479,242,237
050,51,149,"Virginia","Prince George County",3,58,487,266,221
050,51,149,"Virginia","Prince George County",3,59,447,229,218
050,51,149,"Virginia","Prince George County",3,60,448,219,229
050,51,149,"Virginia","Prince George County",3,61,433,222,211
050,51,149,"Virginia","Prince George County",3,62,437,225,212
050,51,149,"Virginia","Prince George County",3,63,429,203,226
050,51,149,"Virginia","Prince George County",3,64,389,202,187
050,51,149,"Virginia","Prince George County",3,65,396,203,193
050,51,149,"Virginia","Prince George County",3,66,413,211,202
050,51,149,"Virginia","Prince George County",3,67,361,176,185
050,51,149,"Virginia","Prince George County",3,68,341,170,171
050,51,149,"Virginia","Prince George County",3,69,345,161,184
050,51,149,"Virginia","Prince George County",3,70,340,163,177
050,51,149,"Virginia","Prince George County",3,71,299,141,158
050,51,149,"Virginia","Prince George County",3,72,298,141,157
050,51,149,"Virginia","Prince George County",3,73,314,158,156
050,51,149,"Virginia","Prince George County",3,74,325,159,166
050,51,149,"Virginia","Prince George County",3,75,215,105,110
050,51,149,"Virginia","Prince George County",3,76,217,100,117
050,51,149,"Virginia","Prince George County",3,77,204,91,113
050,51,149,"Virginia","Prince George County",3,78,188,96,92
050,51,149,"Virginia","Prince George County",3,79,159,84,75
050,51,149,"Virginia","Prince George County",3,80,156,72,84
050,51,149,"Virginia","Prince George County",3,81,153,69,84
050,51,149,"Virginia","Prince George County",3,82,121,53,68
050,51,149,"Virginia","Prince George County",3,83,107,49,58
050,51,149,"Virginia","Prince George County",3,84,87,39,48
050,51,149,"Virginia","Prince George County",3,85,521,189,332
050,51,149,"Virginia","Prince George County",4,0,363,180,183
050,51,149,"Virginia","Prince George County",4,1,407,208,199
050,51,149,"Virginia","Prince George County",4,2,400,200,200
050,51,149,"Virginia","Prince George County",4,3,458,244,214
050,51,149,"Virginia","Prince George County",4,4,491,265,226
050,51,149,"Virginia","Prince George County",4,5,472,240,232
050,51,149,"Virginia","Prince George County",4,6,516,262,254
050,51,149,"Virginia","Prince George County",4,7,547,273,274
050,51,149,"Virginia","Prince George County",4,8,504,257,247
050,51,149,"Virginia","Prince George County",4,9,513,251,262
050,51,149,"Virginia","Prince George County",4,10,506,255,251
050,51,149,"Virginia","Prince George County",4,11,480,230,250
050,51,149,"Virginia","Prince George County",4,12,507,265,242
050,51,149,"Virginia","Prince George County",4,13,463,252,211
050,51,149,"Virginia","Prince George County",4,14,519,273,246
050,51,149,"Virginia","Prince George County",4,15,505,254,251
050,51,149,"Virginia","Prince George County",4,16,471,241,230
050,51,149,"Virginia","Prince George County",4,17,423,218,205
050,51,149,"Virginia","Prince George County",4,18,598,306,292
050,51,149,"Virginia","Prince George County",4,19,1130,625,505
050,51,149,"Virginia","Prince George County",4,20,871,461,410
050,51,149,"Virginia","Prince George County",4,21,919,607,312
050,51,149,"Virginia","Prince George County",4,22,1117,719,398
050,51,149,"Virginia","Prince George County",4,23,1104,742,362
050,51,149,"Virginia","Prince George County",4,24,703,472,231
050,51,149,"Virginia","Prince George County",4,25,830,541,289
050,51,149,"Virginia","Prince George County",4,26,701,463,238
050,51,149,"Virginia","Prince George County",4,27,763,492,271
050,51,149,"Virginia","Prince George County",4,28,742,497,245
050,51,149,"Virginia","Prince George County",4,29,726,457,269
050,51,149,"Virginia","Prince George County",4,30,827,560,267
050,51,149,"Virginia","Prince George County",4,31,753,455,298
050,51,149,"Virginia","Prince George County",4,32,664,398,266
050,51,149,"Virginia","Prince George County",4,33,707,413,294
050,51,149,"Virginia","Prince George County",4,34,698,417,281
050,51,149,"Virginia","Prince George County",4,35,737,432,305
050,51,149,"Virginia","Prince George County",4,36,657,397,260
050,51,149,"Virginia","Prince George County",4,37,634,397,237
050,51,149,"Virginia","Prince George County",4,38,651,393,258
050,51,149,"Virginia","Prince George County",4,39,669,433,236
050,51,149,"Virginia","Prince George County",4,40,655,407,248
050,51,149,"Virginia","Prince George County",4,41,605,356,249
050,51,149,"Virginia","Prince George County",4,42,537,323,214
050,51,149,"Virginia","Prince George County",4,43,542,344,198
050,51,149,"Virginia","Prince George County",4,44,526,315,211
050,51,149,"Virginia","Prince George County",4,45,437,253,184
050,51,149,"Virginia","Prince George County",4,46,474,290,184
050,51,149,"Virginia","Prince George County",4,47,424,245,179
050,51,149,"Virginia","Prince George County",4,48,422,243,179
050,51,149,"Virginia","Prince George County",4,49,427,242,185
050,51,149,"Virginia","Prince George County",4,50,437,256,181
050,51,149,"Virginia","Prince George County",4,51,448,242,206
050,51,149,"Virginia","Prince George County",4,52,417,233,184
050,51,149,"Virginia","Prince George County",4,53,408,228,180
050,51,149,"Virginia","Prince George County",4,54,435,236,199
050,51,149,"Virginia","Prince George County",4,55,429,232,197
050,51,149,"Virginia","Prince George County",4,56,439,234,205
050,51,149,"Virginia","Prince George County",4,57,451,236,215
050,51,149,"Virginia","Prince George County",4,58,476,246,230
050,51,149,"Virginia","Prince George County",4,59,469,250,219
050,51,149,"Virginia","Prince George County",4,60,431,212,219
050,51,149,"Virginia","Prince George County",4,61,443,205,238
050,51,149,"Virginia","Prince George County",4,62,427,218,209
050,51,149,"Virginia","Prince George County",4,63,424,215,209
050,51,149,"Virginia","Prince George County",4,64,397,185,212
050,51,149,"Virginia","Prince George County",4,65,386,201,185
050,51,149,"Virginia","Prince George County",4,66,414,213,201
050,51,149,"Virginia","Prince George County",4,67,406,209,197
050,51,149,"Virginia","Prince George County",4,68,360,174,186
050,51,149,"Virginia","Prince George County",4,69,342,172,170
050,51,149,"Virginia","Prince George County",4,70,330,154,176
050,51,149,"Virginia","Prince George County",4,71,329,156,173
050,51,149,"Virginia","Prince George County",4,72,281,133,148
050,51,149,"Virginia","Prince George County",4,73,290,139,151
050,51,149,"Virginia","Prince George County",4,74,297,149,148
050,51,149,"Virginia","Prince George County",4,75,318,155,163
050,51,149,"Virginia","Prince George County",4,76,208,102,106
050,51,149,"Virginia","Prince George County",4,77,209,98,111
050,51,149,"Virginia","Prince George County",4,78,196,87,109
050,51,149,"Virginia","Prince George County",4,79,181,93,88
050,51,149,"Virginia","Prince George County",4,80,151,78,73
050,51,149,"Virginia","Prince George County",4,81,147,64,83
050,51,149,"Virginia","Prince George County",4,82,137,61,76
050,51,149,"Virginia","Prince George County",4,83,114,51,63
050,51,149,"Virginia","Prince George County",4,84,90,41,49
050,51,149,"Virginia","Prince George County",4,85,509,194,315
050,51,149,"Virginia","Prince George County",5,0,361,178,183
050,51,149,"Virginia","Prince George County",5,1,353,166,187
050,51,149,"Virginia","Prince George County",5,2,400,204,196
050,51,149,"Virginia","Prince George County",5,3,426,229,197
050,51,149,"Virginia","Prince George County",5,4,464,234,230
050,51,149,"Virginia","Prince George County",5,5,498,265,233
050,51,149,"Virginia","Prince George County",5,6,450,211,239
050,51,149,"Virginia","Prince George County",5,7,516,273,243
050,51,149,"Virginia","Prince George County",5,8,512,255,257
050,51,149,"Virginia","Prince George County",5,9,503,258,245
050,51,149,"Virginia","Prince George County",5,10,511,247,264
050,51,149,"Virginia","Prince George County",5,11,501,259,242
050,51,149,"Virginia","Prince George County",5,12,496,248,248
050,51,149,"Virginia","Prince George County",5,13,494,254,240
050,51,149,"Virginia","Prince George County",5,14,456,239,217
050,51,149,"Virginia","Prince George County",5,15,518,259,259
050,51,149,"Virginia","Prince George County",5,16,484,243,241
050,51,149,"Virginia","Prince George County",5,17,478,235,243
050,51,149,"Virginia","Prince George County",5,18,523,268,255
050,51,149,"Virginia","Prince George County",5,19,1129,633,496
050,51,149,"Virginia","Prince George County",5,20,872,453,419
050,51,149,"Virginia","Prince George County",5,21,939,628,311
050,51,149,"Virginia","Prince George County",5,22,1093,679,414
050,51,149,"Virginia","Prince George County",5,23,1103,748,355
050,51,149,"Virginia","Prince George County",5,24,731,463,268
050,51,149,"Virginia","Prince George County",5,25,826,546,280
050,51,149,"Virginia","Prince George County",5,26,681,469,212
050,51,149,"Virginia","Prince George County",5,27,782,487,295
050,51,149,"Virginia","Prince George County",5,28,692,482,210
050,51,149,"Virginia","Prince George County",5,29,704,439,265
050,51,149,"Virginia","Prince George County",5,30,775,524,251
050,51,149,"Virginia","Prince George County",5,31,721,450,271
050,51,149,"Virginia","Prince George County",5,32,766,430,336
050,51,149,"Virginia","Prince George County",5,33,725,429,296
050,51,149,"Virginia","Prince George County",5,34,713,404,309
050,51,149,"Virginia","Prince George County",5,35,712,465,247
050,51,149,"Virginia","Prince George County",5,36,639,354,285
050,51,149,"Virginia","Prince George County",5,37,685,436,249
050,51,149,"Virginia","Prince George County",5,38,621,381,240
050,51,149,"Virginia","Prince George County",5,39,671,412,259
050,51,149,"Virginia","Prince George County",5,40,663,433,230
050,51,149,"Virginia","Prince George County",5,41,658,397,261
050,51,149,"Virginia","Prince George County",5,42,536,305,231
050,51,149,"Virginia","Prince George County",5,43,522,322,200
050,51,149,"Virginia","Prince George County",5,44,527,337,190
050,51,149,"Virginia","Prince George County",5,45,448,246,202
050,51,149,"Virginia","Prince George County",5,46,492,315,177
050,51,149,"Virginia","Prince George County",5,47,420,234,186
050,51,149,"Virginia","Prince George County",5,48,417,237,180
050,51,149,"Virginia","Prince George County",5,49,422,242,180
050,51,149,"Virginia","Prince George County",5,50,395,219,176
050,51,149,"Virginia","Prince George County",5,51,419,230,189
050,51,149,"Virginia","Prince George County",5,52,453,246,207
050,51,149,"Virginia","Prince George County",5,53,435,250,185
050,51,149,"Virginia","Prince George County",5,54,394,212,182
050,51,149,"Virginia","Prince George County",5,55,417,226,191
050,51,149,"Virginia","Prince George County",5,56,409,221,188
050,51,149,"Virginia","Prince George County",5,57,429,235,194
050,51,149,"Virginia","Prince George County",5,58,457,235,222
050,51,149,"Virginia","Prince George County",5,59,469,237,232
050,51,149,"Virginia","Prince George County",5,60,465,257,208
050,51,149,"Virginia","Prince George County",5,61,424,212,212
050,51,149,"Virginia","Prince George County",5,62,428,206,222
050,51,149,"Virginia","Prince George County",5,63,421,217,204
050,51,149,"Virginia","Prince George County",5,64,399,188,211
050,51,149,"Virginia","Prince George County",5,65,404,190,214
050,51,149,"Virginia","Prince George County",5,66,388,204,184
050,51,149,"Virginia","Prince George County",5,67,394,197,197
050,51,149,"Virginia","Prince George County",5,68,403,211,192
050,51,149,"Virginia","Prince George County",5,69,357,172,185
050,51,149,"Virginia","Prince George County",5,70,328,165,163
050,51,149,"Virginia","Prince George County",5,71,314,145,169
050,51,149,"Virginia","Prince George County",5,72,317,151,166
050,51,149,"Virginia","Prince George County",5,73,278,130,148
050,51,149,"Virginia","Prince George County",5,74,291,138,153
050,51,149,"Virginia","Prince George County",5,75,289,143,146
050,51,149,"Virginia","Prince George County",5,76,312,152,160
050,51,149,"Virginia","Prince George County",5,77,201,98,103
050,51,149,"Virginia","Prince George County",5,78,194,93,101
050,51,149,"Virginia","Prince George County",5,79,186,83,103
050,51,149,"Virginia","Prince George County",5,80,173,85,88
050,51,149,"Virginia","Prince George County",5,81,137,71,66
050,51,149,"Virginia","Prince George County",5,82,137,59,78
050,51,149,"Virginia","Prince George County",5,83,126,59,67
050,51,149,"Virginia","Prince George County",5,84,92,42,50
050,51,149,"Virginia","Prince George County",5,85,507,200,307
050,51,153,"Virginia","Prince William County",1,0,6279,3220,3059
050,51,153,"Virginia","Prince William County",1,1,6421,3243,3178
050,51,153,"Virginia","Prince William County",1,2,6797,3434,3363
050,51,153,"Virginia","Prince William County",1,3,6944,3558,3386
050,51,153,"Virginia","Prince William County",1,4,7125,3770,3355
050,51,153,"Virginia","Prince William County",1,5,7096,3639,3457
050,51,153,"Virginia","Prince William County",1,6,7037,3617,3420
050,51,153,"Virginia","Prince William County",1,7,7041,3684,3357
050,51,153,"Virginia","Prince William County",1,8,7203,3710,3493
050,51,153,"Virginia","Prince William County",1,9,7225,3700,3525
050,51,153,"Virginia","Prince William County",1,10,7391,3795,3596
050,51,153,"Virginia","Prince William County",1,11,7587,3922,3665
050,51,153,"Virginia","Prince William County",1,12,7846,4071,3775
050,51,153,"Virginia","Prince William County",1,13,7999,4188,3811
050,51,153,"Virginia","Prince William County",1,14,7850,4095,3755
050,51,153,"Virginia","Prince William County",1,15,7480,3883,3597
050,51,153,"Virginia","Prince William County",1,16,7475,3837,3638
050,51,153,"Virginia","Prince William County",1,17,7205,3619,3586
050,51,153,"Virginia","Prince William County",1,18,6465,3381,3084
050,51,153,"Virginia","Prince William County",1,19,5640,2987,2653
050,51,153,"Virginia","Prince William County",1,20,5959,3161,2798
050,51,153,"Virginia","Prince William County",1,21,5958,3119,2839
050,51,153,"Virginia","Prince William County",1,22,6150,3287,2863
050,51,153,"Virginia","Prince William County",1,23,6277,3273,3004
050,51,153,"Virginia","Prince William County",1,24,6174,3218,2956
050,51,153,"Virginia","Prince William County",1,25,6077,3068,3009
050,51,153,"Virginia","Prince William County",1,26,6126,3052,3074
050,51,153,"Virginia","Prince William County",1,27,6043,2962,3081
050,51,153,"Virginia","Prince William County",1,28,6047,2959,3088
050,51,153,"Virginia","Prince William County",1,29,6163,3057,3106
050,51,153,"Virginia","Prince William County",1,30,6245,3122,3123
050,51,153,"Virginia","Prince William County",1,31,6267,3125,3142
050,51,153,"Virginia","Prince William County",1,32,6445,3156,3289
050,51,153,"Virginia","Prince William County",1,33,6477,3217,3260
050,51,153,"Virginia","Prince William County",1,34,6833,3444,3389
050,51,153,"Virginia","Prince William County",1,35,6914,3505,3409
050,51,153,"Virginia","Prince William County",1,36,7223,3638,3585
050,51,153,"Virginia","Prince William County",1,37,7471,3715,3756
050,51,153,"Virginia","Prince William County",1,38,7488,3737,3751
050,51,153,"Virginia","Prince William County",1,39,7647,3884,3763
050,51,153,"Virginia","Prince William County",1,40,7598,3848,3750
050,51,153,"Virginia","Prince William County",1,41,7471,3762,3709
050,51,153,"Virginia","Prince William County",1,42,7274,3621,3653
050,51,153,"Virginia","Prince William County",1,43,6953,3458,3495
050,51,153,"Virginia","Prince William County",1,44,6979,3476,3503
050,51,153,"Virginia","Prince William County",1,45,6806,3348,3458
050,51,153,"Virginia","Prince William County",1,46,6738,3424,3314
050,51,153,"Virginia","Prince William County",1,47,6913,3478,3435
050,51,153,"Virginia","Prince William County",1,48,7108,3591,3517
050,51,153,"Virginia","Prince William County",1,49,7230,3666,3564
050,51,153,"Virginia","Prince William County",1,50,7032,3601,3431
050,51,153,"Virginia","Prince William County",1,51,6762,3407,3355
050,51,153,"Virginia","Prince William County",1,52,6542,3282,3260
050,51,153,"Virginia","Prince William County",1,53,6479,3258,3221
050,51,153,"Virginia","Prince William County",1,54,6510,3323,3187
050,51,153,"Virginia","Prince William County",1,55,6597,3381,3216
050,51,153,"Virginia","Prince William County",1,56,6568,3374,3194
050,51,153,"Virginia","Prince William County",1,57,6319,3172,3147
050,51,153,"Virginia","Prince William County",1,58,6142,3084,3058
050,51,153,"Virginia","Prince William County",1,59,5754,2904,2850
050,51,153,"Virginia","Prince William County",1,60,5434,2759,2675
050,51,153,"Virginia","Prince William County",1,61,5259,2648,2611
050,51,153,"Virginia","Prince William County",1,62,4968,2548,2420
050,51,153,"Virginia","Prince William County",1,63,4612,2289,2323
050,51,153,"Virginia","Prince William County",1,64,4271,2083,2188
050,51,153,"Virginia","Prince William County",1,65,4056,1964,2092
050,51,153,"Virginia","Prince William County",1,66,3762,1797,1965
050,51,153,"Virginia","Prince William County",1,67,3541,1633,1908
050,51,153,"Virginia","Prince William County",1,68,3212,1509,1703
050,51,153,"Virginia","Prince William County",1,69,3111,1463,1648
050,51,153,"Virginia","Prince William County",1,70,3087,1454,1633
050,51,153,"Virginia","Prince William County",1,71,3046,1413,1633
050,51,153,"Virginia","Prince William County",1,72,3049,1431,1618
050,51,153,"Virginia","Prince William County",1,73,2981,1427,1554
050,51,153,"Virginia","Prince William County",1,74,2145,991,1154
050,51,153,"Virginia","Prince William County",1,75,2024,927,1097
050,51,153,"Virginia","Prince William County",1,76,1976,864,1112
050,51,153,"Virginia","Prince William County",1,77,1875,823,1052
050,51,153,"Virginia","Prince William County",1,78,1547,685,862
050,51,153,"Virginia","Prince William County",1,79,1385,610,775
050,51,153,"Virginia","Prince William County",1,80,1220,520,700
050,51,153,"Virginia","Prince William County",1,81,1168,522,646
050,51,153,"Virginia","Prince William County",1,82,990,434,556
050,51,153,"Virginia","Prince William County",1,83,830,345,485
050,51,153,"Virginia","Prince William County",1,84,745,291,454
050,51,153,"Virginia","Prince William County",1,85,4041,1471,2570
050,51,153,"Virginia","Prince William County",2,0,6251,3211,3040
050,51,153,"Virginia","Prince William County",2,1,6416,3241,3175
050,51,153,"Virginia","Prince William County",2,2,6742,3401,3341
050,51,153,"Virginia","Prince William County",2,3,6911,3535,3376
050,51,153,"Virginia","Prince William County",2,4,7102,3730,3372
050,51,153,"Virginia","Prince William County",2,5,7111,3675,3436
050,51,153,"Virginia","Prince William County",2,6,7067,3634,3433
050,51,153,"Virginia","Prince William County",2,7,7054,3670,3384
050,51,153,"Virginia","Prince William County",2,8,7160,3699,3461
050,51,153,"Virginia","Prince William County",2,9,7233,3712,3521
050,51,153,"Virginia","Prince William County",2,10,7343,3775,3568
050,51,153,"Virginia","Prince William County",2,11,7514,3872,3642
050,51,153,"Virginia","Prince William County",2,12,7824,4059,3765
050,51,153,"Virginia","Prince William County",2,13,7957,4161,3796
050,51,153,"Virginia","Prince William County",2,14,7867,4105,3762
050,51,153,"Virginia","Prince William County",2,15,7556,3927,3629
050,51,153,"Virginia","Prince William County",2,16,7463,3840,3623
050,51,153,"Virginia","Prince William County",2,17,7261,3673,3588
050,51,153,"Virginia","Prince William County",2,18,6422,3348,3074
050,51,153,"Virginia","Prince William County",2,19,5713,3023,2690
050,51,153,"Virginia","Prince William County",2,20,6025,3201,2824
050,51,153,"Virginia","Prince William County",2,21,5980,3144,2836
050,51,153,"Virginia","Prince William County",2,22,6158,3276,2882
050,51,153,"Virginia","Prince William County",2,23,6282,3292,2990
050,51,153,"Virginia","Prince William County",2,24,6171,3209,2962
050,51,153,"Virginia","Prince William County",2,25,6118,3111,3007
050,51,153,"Virginia","Prince William County",2,26,6122,3061,3061
050,51,153,"Virginia","Prince William County",2,27,6056,2974,3082
050,51,153,"Virginia","Prince William County",2,28,6069,2967,3102
050,51,153,"Virginia","Prince William County",2,29,6172,3048,3124
050,51,153,"Virginia","Prince William County",2,30,6279,3133,3146
050,51,153,"Virginia","Prince William County",2,31,6275,3123,3152
050,51,153,"Virginia","Prince William County",2,32,6418,3154,3264
050,51,153,"Virginia","Prince William County",2,33,6497,3223,3274
050,51,153,"Virginia","Prince William County",2,34,6765,3408,3357
050,51,153,"Virginia","Prince William County",2,35,6937,3508,3429
050,51,153,"Virginia","Prince William County",2,36,7126,3581,3545
050,51,153,"Virginia","Prince William County",2,37,7420,3699,3721
050,51,153,"Virginia","Prince William County",2,38,7525,3758,3767
050,51,153,"Virginia","Prince William County",2,39,7581,3828,3753
050,51,153,"Virginia","Prince William County",2,40,7660,3889,3771
050,51,153,"Virginia","Prince William County",2,41,7478,3774,3704
050,51,153,"Virginia","Prince William County",2,42,7277,3636,3641
050,51,153,"Virginia","Prince William County",2,43,7074,3521,3553
050,51,153,"Virginia","Prince William County",2,44,6918,3443,3475
050,51,153,"Virginia","Prince William County",2,45,6868,3388,3480
050,51,153,"Virginia","Prince William County",2,46,6737,3397,3340
050,51,153,"Virginia","Prince William County",2,47,6840,3449,3391
050,51,153,"Virginia","Prince William County",2,48,7057,3565,3492
050,51,153,"Virginia","Prince William County",2,49,7218,3663,3555
050,51,153,"Virginia","Prince William County",2,50,7078,3620,3458
050,51,153,"Virginia","Prince William County",2,51,6766,3426,3340
050,51,153,"Virginia","Prince William County",2,52,6582,3309,3273
050,51,153,"Virginia","Prince William County",2,53,6473,3250,3223
050,51,153,"Virginia","Prince William County",2,54,6469,3294,3175
050,51,153,"Virginia","Prince William County",2,55,6546,3358,3188
050,51,153,"Virginia","Prince William County",2,56,6568,3379,3189
050,51,153,"Virginia","Prince William County",2,57,6357,3214,3143
050,51,153,"Virginia","Prince William County",2,58,6165,3094,3071
050,51,153,"Virginia","Prince William County",2,59,5814,2936,2878
050,51,153,"Virginia","Prince William County",2,60,5468,2770,2698
050,51,153,"Virginia","Prince William County",2,61,5247,2649,2598
050,51,153,"Virginia","Prince William County",2,62,4997,2549,2448
050,51,153,"Virginia","Prince William County",2,63,4696,2348,2348
050,51,153,"Virginia","Prince William County",2,64,4313,2111,2202
050,51,153,"Virginia","Prince William County",2,65,4072,1977,2095
050,51,153,"Virginia","Prince William County",2,66,3814,1830,1984
050,51,153,"Virginia","Prince William County",2,67,3551,1651,1900
050,51,153,"Virginia","Prince William County",2,68,3258,1524,1734
050,51,153,"Virginia","Prince William County",2,69,3136,1473,1663
050,51,153,"Virginia","Prince William County",2,70,3071,1442,1629
050,51,153,"Virginia","Prince William County",2,71,3034,1408,1626
050,51,153,"Virginia","Prince William County",2,72,3001,1404,1597
050,51,153,"Virginia","Prince William County",2,73,3093,1470,1623
050,51,153,"Virginia","Prince William County",2,74,2215,1031,1184
050,51,153,"Virginia","Prince William County",2,75,2057,945,1112
050,51,153,"Virginia","Prince William County",2,76,1963,869,1094
050,51,153,"Virginia","Prince William County",2,77,1911,839,1072
050,51,153,"Virginia","Prince William County",2,78,1599,708,891
050,51,153,"Virginia","Prince William County",2,79,1398,615,783
050,51,153,"Virginia","Prince William County",2,80,1245,531,714
050,51,153,"Virginia","Prince William County",2,81,1168,519,649
050,51,153,"Virginia","Prince William County",2,82,1015,448,567
050,51,153,"Virginia","Prince William County",2,83,849,354,495
050,51,153,"Virginia","Prince William County",2,84,743,289,454
050,51,153,"Virginia","Prince William County",2,85,4032,1465,2567
050,51,153,"Virginia","Prince William County",3,0,6108,3150,2958
050,51,153,"Virginia","Prince William County",3,1,6318,3250,3068
050,51,153,"Virginia","Prince William County",3,2,6613,3360,3253
050,51,153,"Virginia","Prince William County",3,3,6851,3445,3406
050,51,153,"Virginia","Prince William County",3,4,6941,3508,3433
050,51,153,"Virginia","Prince William County",3,5,7178,3751,3427
050,51,153,"Virginia","Prince William County",3,6,7123,3656,3467
050,51,153,"Virginia","Prince William County",3,7,7104,3658,3446
050,51,153,"Virginia","Prince William County",3,8,7047,3660,3387
050,51,153,"Virginia","Prince William County",3,9,7298,3746,3552
050,51,153,"Virginia","Prince William County",3,10,7201,3702,3499
050,51,153,"Virginia","Prince William County",3,11,7387,3789,3598
050,51,153,"Virginia","Prince William County",3,12,7535,3882,3653
050,51,153,"Virginia","Prince William County",3,13,7789,4032,3757
050,51,153,"Virginia","Prince William County",3,14,7895,4130,3765
050,51,153,"Virginia","Prince William County",3,15,7855,4105,3750
050,51,153,"Virginia","Prince William County",3,16,7569,3921,3648
050,51,153,"Virginia","Prince William County",3,17,7398,3798,3600
050,51,153,"Virginia","Prince William County",3,18,6500,3358,3142
050,51,153,"Virginia","Prince William County",3,19,5715,3009,2706
050,51,153,"Virginia","Prince William County",3,20,6118,3243,2875
050,51,153,"Virginia","Prince William County",3,21,6183,3255,2928
050,51,153,"Virginia","Prince William County",3,22,6249,3284,2965
050,51,153,"Virginia","Prince William County",3,23,6219,3283,2936
050,51,153,"Virginia","Prince William County",3,24,6185,3187,2998
050,51,153,"Virginia","Prince William County",3,25,6099,3132,2967
050,51,153,"Virginia","Prince William County",3,26,6110,3101,3009
050,51,153,"Virginia","Prince William County",3,27,6059,3015,3044
050,51,153,"Virginia","Prince William County",3,28,6067,3000,3067
050,51,153,"Virginia","Prince William County",3,29,6119,3015,3104
050,51,153,"Virginia","Prince William County",3,30,6233,3056,3177
050,51,153,"Virginia","Prince William County",3,31,6381,3192,3189
050,51,153,"Virginia","Prince William County",3,32,6407,3156,3251
050,51,153,"Virginia","Prince William County",3,33,6593,3271,3322
050,51,153,"Virginia","Prince William County",3,34,6623,3279,3344
050,51,153,"Virginia","Prince William County",3,35,6881,3476,3405
050,51,153,"Virginia","Prince William County",3,36,7029,3534,3495
050,51,153,"Virginia","Prince William County",3,37,7212,3615,3597
050,51,153,"Virginia","Prince William County",3,38,7435,3719,3716
050,51,153,"Virginia","Prince William County",3,39,7580,3772,3808
050,51,153,"Virginia","Prince William County",3,40,7610,3874,3736
050,51,153,"Virginia","Prince William County",3,41,7700,3915,3785
050,51,153,"Virginia","Prince William County",3,42,7423,3774,3649
050,51,153,"Virginia","Prince William County",3,43,7288,3627,3661
050,51,153,"Virginia","Prince William County",3,44,7061,3514,3547
050,51,153,"Virginia","Prince William County",3,45,6890,3453,3437
050,51,153,"Virginia","Prince William County",3,46,6786,3340,3446
050,51,153,"Virginia","Prince William County",3,47,6702,3400,3302
050,51,153,"Virginia","Prince William County",3,48,6804,3442,3362
050,51,153,"Virginia","Prince William County",3,49,6913,3475,3438
050,51,153,"Virginia","Prince William County",3,50,7197,3633,3564
050,51,153,"Virginia","Prince William County",3,51,7005,3619,3386
050,51,153,"Virginia","Prince William County",3,52,6632,3343,3289
050,51,153,"Virginia","Prince William County",3,53,6531,3264,3267
050,51,153,"Virginia","Prince William County",3,54,6316,3185,3131
050,51,153,"Virginia","Prince William County",3,55,6342,3244,3098
050,51,153,"Virginia","Prince William County",3,56,6375,3255,3120
050,51,153,"Virginia","Prince William County",3,57,6439,3316,3123
050,51,153,"Virginia","Prince William County",3,58,6228,3130,3098
050,51,153,"Virginia","Prince William County",3,59,6034,3058,2976
050,51,153,"Virginia","Prince William County",3,60,5638,2828,2810
050,51,153,"Virginia","Prince William County",3,61,5322,2697,2625
050,51,153,"Virginia","Prince William County",3,62,5094,2564,2530
050,51,153,"Virginia","Prince William County",3,63,4801,2406,2395
050,51,153,"Virginia","Prince William County",3,64,4522,2268,2254
050,51,153,"Virginia","Prince William County",3,65,4188,2057,2131
050,51,153,"Virginia","Prince William County",3,66,3939,1905,2034
050,51,153,"Virginia","Prince William County",3,67,3690,1747,1943
050,51,153,"Virginia","Prince William County",3,68,3480,1607,1873
050,51,153,"Virginia","Prince William County",3,69,3199,1490,1709
050,51,153,"Virginia","Prince William County",3,70,3031,1416,1615
050,51,153,"Virginia","Prince William County",3,71,2996,1382,1614
050,51,153,"Virginia","Prince William County",3,72,2966,1372,1594
050,51,153,"Virginia","Prince William County",3,73,2956,1377,1579
050,51,153,"Virginia","Prince William County",3,74,3015,1425,1590
050,51,153,"Virginia","Prince William County",3,75,2159,1000,1159
050,51,153,"Virginia","Prince William County",3,76,2002,918,1084
050,51,153,"Virginia","Prince William County",3,77,1888,836,1052
050,51,153,"Virginia","Prince William County",3,78,1872,814,1058
050,51,153,"Virginia","Prince William County",3,79,1539,686,853
050,51,153,"Virginia","Prince William County",3,80,1338,581,757
050,51,153,"Virginia","Prince William County",3,81,1204,514,690
050,51,153,"Virginia","Prince William County",3,82,1096,485,611
050,51,153,"Virginia","Prince William County",3,83,943,404,539
050,51,153,"Virginia","Prince William County",3,84,803,336,467
050,51,153,"Virginia","Prince William County",3,85,4188,1513,2675
050,51,153,"Virginia","Prince William County",4,0,6299,3265,3034
050,51,153,"Virginia","Prince William County",4,1,6085,3151,2934
050,51,153,"Virginia","Prince William County",4,2,6575,3351,3224
050,51,153,"Virginia","Prince William County",4,3,6715,3415,3300
050,51,153,"Virginia","Prince William County",4,4,6987,3521,3466
050,51,153,"Virginia","Prince William County",4,5,7009,3544,3465
050,51,153,"Virginia","Prince William County",4,6,7250,3800,3450
050,51,153,"Virginia","Prince William County",4,7,7165,3648,3517
050,51,153,"Virginia","Prince William County",4,8,7179,3719,3460
050,51,153,"Virginia","Prince William County",4,9,7149,3728,3421
050,51,153,"Virginia","Prince William County",4,10,7283,3751,3532
050,51,153,"Virginia","Prince William County",4,11,7197,3696,3501
050,51,153,"Virginia","Prince William County",4,12,7377,3793,3584
050,51,153,"Virginia","Prince William County",4,13,7517,3858,3659
050,51,153,"Virginia","Prince William County",4,14,7826,4045,3781
050,51,153,"Virginia","Prince William County",4,15,7915,4116,3799
050,51,153,"Virginia","Prince William County",4,16,7895,4153,3742
050,51,153,"Virginia","Prince William County",4,17,7487,3894,3593
050,51,153,"Virginia","Prince William County",4,18,6583,3443,3140
050,51,153,"Virginia","Prince William County",4,19,5654,2967,2687
050,51,153,"Virginia","Prince William County",4,20,6027,3164,2863
050,51,153,"Virginia","Prince William County",4,21,6261,3278,2983
050,51,153,"Virginia","Prince William County",4,22,6257,3253,3004
050,51,153,"Virginia","Prince William County",4,23,6201,3197,3004
050,51,153,"Virginia","Prince William County",4,24,6052,3161,2891
050,51,153,"Virginia","Prince William County",4,25,6009,3079,2930
050,51,153,"Virginia","Prince William County",4,26,5957,3041,2916
050,51,153,"Virginia","Prince William County",4,27,6092,3040,3052
050,51,153,"Virginia","Prince William County",4,28,6113,3030,3083
050,51,153,"Virginia","Prince William County",4,29,6024,2955,3069
050,51,153,"Virginia","Prince William County",4,30,6182,3047,3135
050,51,153,"Virginia","Prince William County",4,31,6338,3149,3189
050,51,153,"Virginia","Prince William County",4,32,6409,3196,3213
050,51,153,"Virginia","Prince William County",4,33,6529,3237,3292
050,51,153,"Virginia","Prince William County",4,34,6628,3327,3301
050,51,153,"Virginia","Prince William County",4,35,6794,3370,3424
050,51,153,"Virginia","Prince William County",4,36,6971,3492,3479
050,51,153,"Virginia","Prince William County",4,37,7058,3549,3509
050,51,153,"Virginia","Prince William County",4,38,7233,3599,3634
050,51,153,"Virginia","Prince William County",4,39,7529,3744,3785
050,51,153,"Virginia","Prince William County",4,40,7668,3820,3848
050,51,153,"Virginia","Prince William County",4,41,7658,3935,3723
050,51,153,"Virginia","Prince William County",4,42,7750,3925,3825
050,51,153,"Virginia","Prince William County",4,43,7426,3762,3664
050,51,153,"Virginia","Prince William County",4,44,7265,3650,3615
050,51,153,"Virginia","Prince William County",4,45,7006,3470,3536
050,51,153,"Virginia","Prince William County",4,46,6797,3374,3423
050,51,153,"Virginia","Prince William County",4,47,6723,3324,3399
050,51,153,"Virginia","Prince William County",4,48,6637,3349,3288
050,51,153,"Virginia","Prince William County",4,49,6760,3454,3306
050,51,153,"Virginia","Prince William County",4,50,6819,3421,3398
050,51,153,"Virginia","Prince William County",4,51,7088,3591,3497
050,51,153,"Virginia","Prince William County",4,52,6914,3560,3354
050,51,153,"Virginia","Prince William County",4,53,6511,3287,3224
050,51,153,"Virginia","Prince William County",4,54,6392,3239,3153
050,51,153,"Virginia","Prince William County",4,55,6195,3106,3089
050,51,153,"Virginia","Prince William County",4,56,6151,3131,3020
050,51,153,"Virginia","Prince William County",4,57,6217,3160,3057
050,51,153,"Virginia","Prince William County",4,58,6267,3244,3023
050,51,153,"Virginia","Prince William County",4,59,6043,3073,2970
050,51,153,"Virginia","Prince William County",4,60,5876,2964,2912
050,51,153,"Virginia","Prince William County",4,61,5472,2721,2751
050,51,153,"Virginia","Prince William County",4,62,5152,2593,2559
050,51,153,"Virginia","Prince William County",4,63,4864,2407,2457
050,51,153,"Virginia","Prince William County",4,64,4636,2312,2324
050,51,153,"Virginia","Prince William County",4,65,4462,2233,2229
050,51,153,"Virginia","Prince William County",4,66,4023,1960,2063
050,51,153,"Virginia","Prince William County",4,67,3798,1822,1976
050,51,153,"Virginia","Prince William County",4,68,3548,1670,1878
050,51,153,"Virginia","Prince William County",4,69,3426,1581,1845
050,51,153,"Virginia","Prince William County",4,70,3125,1447,1678
050,51,153,"Virginia","Prince William County",4,71,2985,1386,1599
050,51,153,"Virginia","Prince William County",4,72,2935,1345,1590
050,51,153,"Virginia","Prince William County",4,73,2861,1303,1558
050,51,153,"Virginia","Prince William County",4,74,2909,1352,1557
050,51,153,"Virginia","Prince William County",4,75,2923,1372,1551
050,51,153,"Virginia","Prince William County",4,76,2130,975,1155
050,51,153,"Virginia","Prince William County",4,77,1951,905,1046
050,51,153,"Virginia","Prince William County",4,78,1848,813,1035
050,51,153,"Virginia","Prince William County",4,79,1772,773,999
050,51,153,"Virginia","Prince William County",4,80,1472,640,832
050,51,153,"Virginia","Prince William County",4,81,1289,557,732
050,51,153,"Virginia","Prince William County",4,82,1136,480,656
050,51,153,"Virginia","Prince William County",4,83,1030,443,587
050,51,153,"Virginia","Prince William County",4,84,861,364,497
050,51,153,"Virginia","Prince William County",4,85,4430,1619,2811
050,51,153,"Virginia","Prince William County",5,0,6226,3224,3002
050,51,153,"Virginia","Prince William County",5,1,6442,3321,3121
050,51,153,"Virginia","Prince William County",5,2,6260,3245,3015
050,51,153,"Virginia","Prince William County",5,3,6651,3364,3287
050,51,153,"Virginia","Prince William County",5,4,6756,3405,3351
050,51,153,"Virginia","Prince William County",5,5,6952,3529,3423
050,51,153,"Virginia","Prince William County",5,6,7119,3625,3494
050,51,153,"Virginia","Prince William County",5,7,7220,3761,3459
050,51,153,"Virginia","Prince William County",5,8,7223,3688,3535
050,51,153,"Virginia","Prince William County",5,9,7314,3776,3538
050,51,153,"Virginia","Prince William County",5,10,7176,3701,3475
050,51,153,"Virginia","Prince William County",5,11,7280,3755,3525
050,51,153,"Virginia","Prince William County",5,12,7164,3693,3471
050,51,153,"Virginia","Prince William County",5,13,7335,3754,3581
050,51,153,"Virginia","Prince William County",5,14,7507,3846,3661
050,51,153,"Virginia","Prince William County",5,15,7807,4021,3786
050,51,153,"Virginia","Prince William County",5,16,7923,4136,3787
050,51,153,"Virginia","Prince William County",5,17,7861,4146,3715
050,51,153,"Virginia","Prince William County",5,18,6583,3486,3097
050,51,153,"Virginia","Prince William County",5,19,5839,3078,2761
050,51,153,"Virginia","Prince William County",5,20,6132,3209,2923
050,51,153,"Virginia","Prince William County",5,21,6152,3192,2960
050,51,153,"Virginia","Prince William County",5,22,6560,3405,3155
050,51,153,"Virginia","Prince William County",5,23,6259,3270,2989
050,51,153,"Virginia","Prince William County",5,24,6135,3117,3018
050,51,153,"Virginia","Prince William County",5,25,6046,3150,2896
050,51,153,"Virginia","Prince William County",5,26,5920,3008,2912
050,51,153,"Virginia","Prince William County",5,27,5970,3036,2934
050,51,153,"Virginia","Prince William County",5,28,6086,3046,3040
050,51,153,"Virginia","Prince William County",5,29,6023,2954,3069
050,51,153,"Virginia","Prince William County",5,30,6114,2996,3118
050,51,153,"Virginia","Prince William County",5,31,6204,3056,3148
050,51,153,"Virginia","Prince William County",5,32,6360,3167,3193
050,51,153,"Virginia","Prince William County",5,33,6430,3219,3211
050,51,153,"Virginia","Prince William County",5,34,6670,3335,3335
050,51,153,"Virginia","Prince William County",5,35,6718,3377,3341
050,51,153,"Virginia","Prince William County",5,36,6892,3369,3523
050,51,153,"Virginia","Prince William County",5,37,7025,3531,3494
050,51,153,"Virginia","Prince William County",5,38,7119,3568,3551
050,51,153,"Virginia","Prince William County",5,39,7302,3637,3665
050,51,153,"Virginia","Prince William County",5,40,7567,3783,3784
050,51,153,"Virginia","Prince William County",5,41,7685,3859,3826
050,51,153,"Virginia","Prince William County",5,42,7618,3904,3714
050,51,153,"Virginia","Prince William County",5,43,7672,3887,3785
050,51,153,"Virginia","Prince William County",5,44,7363,3725,3638
050,51,153,"Virginia","Prince William County",5,45,7260,3646,3614
050,51,153,"Virginia","Prince William County",5,46,6941,3447,3494
050,51,153,"Virginia","Prince William County",5,47,6758,3345,3413
050,51,153,"Virginia","Prince William County",5,48,6675,3283,3392
050,51,153,"Virginia","Prince William County",5,49,6597,3336,3261
050,51,153,"Virginia","Prince William County",5,50,6698,3414,3284
050,51,153,"Virginia","Prince William County",5,51,6737,3383,3354
050,51,153,"Virginia","Prince William County",5,52,6964,3534,3430
050,51,153,"Virginia","Prince William County",5,53,6840,3530,3310
050,51,153,"Virginia","Prince William County",5,54,6355,3218,3137
050,51,153,"Virginia","Prince William County",5,55,6262,3166,3096
050,51,153,"Virginia","Prince William County",5,56,6146,3044,3102
050,51,153,"Virginia","Prince William County",5,57,6036,3087,2949
050,51,153,"Virginia","Prince William County",5,58,6035,3051,2984
050,51,153,"Virginia","Prince William County",5,59,6092,3149,2943
050,51,153,"Virginia","Prince William County",5,60,5909,2972,2937
050,51,153,"Virginia","Prince William County",5,61,5731,2891,2840
050,51,153,"Virginia","Prince William County",5,62,5330,2627,2703
050,51,153,"Virginia","Prince William County",5,63,5037,2521,2516
050,51,153,"Virginia","Prince William County",5,64,4772,2379,2393
050,51,153,"Virginia","Prince William County",5,65,4576,2305,2271
050,51,153,"Virginia","Prince William County",5,66,4304,2151,2153
050,51,153,"Virginia","Prince William County",5,67,3953,1915,2038
050,51,153,"Virginia","Prince William County",5,68,3698,1746,1952
050,51,153,"Virginia","Prince William County",5,69,3505,1636,1869
050,51,153,"Virginia","Prince William County",5,70,3360,1528,1832
050,51,153,"Virginia","Prince William County",5,71,3130,1429,1701
050,51,153,"Virginia","Prince William County",5,72,2939,1349,1590
050,51,153,"Virginia","Prince William County",5,73,2896,1317,1579
050,51,153,"Virginia","Prince William County",5,74,2801,1264,1537
050,51,153,"Virginia","Prince William County",5,75,2872,1339,1533
050,51,153,"Virginia","Prince William County",5,76,2842,1328,1514
050,51,153,"Virginia","Prince William County",5,77,2074,958,1116
050,51,153,"Virginia","Prince William County",5,78,1910,880,1030
050,51,153,"Virginia","Prince William County",5,79,1802,805,997
050,51,153,"Virginia","Prince William County",5,80,1729,737,992
050,51,153,"Virginia","Prince William County",5,81,1428,629,799
050,51,153,"Virginia","Prince William County",5,82,1224,525,699
050,51,153,"Virginia","Prince William County",5,83,1087,449,638
050,51,153,"Virginia","Prince William County",5,84,954,402,552
050,51,153,"Virginia","Prince William County",5,85,4721,1753,2968
050,51,155,"Virginia","Pulaski County",1,0,293,149,144
050,51,155,"Virginia","Pulaski County",1,1,291,143,148
050,51,155,"Virginia","Pulaski County",1,2,331,176,155
050,51,155,"Virginia","Pulaski County",1,3,335,168,167
050,51,155,"Virginia","Pulaski County",1,4,327,156,171
050,51,155,"Virginia","Pulaski County",1,5,318,166,152
050,51,155,"Virginia","Pulaski County",1,6,345,178,167
050,51,155,"Virginia","Pulaski County",1,7,337,174,163
050,51,155,"Virginia","Pulaski County",1,8,312,156,156
050,51,155,"Virginia","Pulaski County",1,9,305,159,146
050,51,155,"Virginia","Pulaski County",1,10,319,161,158
050,51,155,"Virginia","Pulaski County",1,11,354,175,179
050,51,155,"Virginia","Pulaski County",1,12,394,194,200
050,51,155,"Virginia","Pulaski County",1,13,354,169,185
050,51,155,"Virginia","Pulaski County",1,14,332,162,170
050,51,155,"Virginia","Pulaski County",1,15,361,192,169
050,51,155,"Virginia","Pulaski County",1,16,374,203,171
050,51,155,"Virginia","Pulaski County",1,17,345,182,163
050,51,155,"Virginia","Pulaski County",1,18,306,158,148
050,51,155,"Virginia","Pulaski County",1,19,298,169,129
050,51,155,"Virginia","Pulaski County",1,20,317,176,141
050,51,155,"Virginia","Pulaski County",1,21,353,196,157
050,51,155,"Virginia","Pulaski County",1,22,358,183,175
050,51,155,"Virginia","Pulaski County",1,23,387,203,184
050,51,155,"Virginia","Pulaski County",1,24,402,236,166
050,51,155,"Virginia","Pulaski County",1,25,406,224,182
050,51,155,"Virginia","Pulaski County",1,26,408,220,188
050,51,155,"Virginia","Pulaski County",1,27,415,224,191
050,51,155,"Virginia","Pulaski County",1,28,436,249,187
050,51,155,"Virginia","Pulaski County",1,29,443,238,205
050,51,155,"Virginia","Pulaski County",1,30,403,215,188
050,51,155,"Virginia","Pulaski County",1,31,383,211,172
050,51,155,"Virginia","Pulaski County",1,32,374,208,166
050,51,155,"Virginia","Pulaski County",1,33,358,190,168
050,51,155,"Virginia","Pulaski County",1,34,380,197,183
050,51,155,"Virginia","Pulaski County",1,35,379,204,175
050,51,155,"Virginia","Pulaski County",1,36,347,189,158
050,51,155,"Virginia","Pulaski County",1,37,329,181,148
050,51,155,"Virginia","Pulaski County",1,38,366,194,172
050,51,155,"Virginia","Pulaski County",1,39,386,224,162
050,51,155,"Virginia","Pulaski County",1,40,345,185,160
050,51,155,"Virginia","Pulaski County",1,41,337,175,162
050,51,155,"Virginia","Pulaski County",1,42,374,191,183
050,51,155,"Virginia","Pulaski County",1,43,375,200,175
050,51,155,"Virginia","Pulaski County",1,44,356,178,178
050,51,155,"Virginia","Pulaski County",1,45,421,218,203
050,51,155,"Virginia","Pulaski County",1,46,448,234,214
050,51,155,"Virginia","Pulaski County",1,47,448,235,213
050,51,155,"Virginia","Pulaski County",1,48,500,273,227
050,51,155,"Virginia","Pulaski County",1,49,546,273,273
050,51,155,"Virginia","Pulaski County",1,50,520,269,251
050,51,155,"Virginia","Pulaski County",1,51,507,247,260
050,51,155,"Virginia","Pulaski County",1,52,507,249,258
050,51,155,"Virginia","Pulaski County",1,53,499,277,222
050,51,155,"Virginia","Pulaski County",1,54,479,259,220
050,51,155,"Virginia","Pulaski County",1,55,518,278,240
050,51,155,"Virginia","Pulaski County",1,56,519,264,255
050,51,155,"Virginia","Pulaski County",1,57,517,255,262
050,51,155,"Virginia","Pulaski County",1,58,540,279,261
050,51,155,"Virginia","Pulaski County",1,59,523,264,259
050,51,155,"Virginia","Pulaski County",1,60,497,249,248
050,51,155,"Virginia","Pulaski County",1,61,531,265,266
050,51,155,"Virginia","Pulaski County",1,62,516,250,266
050,51,155,"Virginia","Pulaski County",1,63,526,257,269
050,51,155,"Virginia","Pulaski County",1,64,510,246,264
050,51,155,"Virginia","Pulaski County",1,65,486,231,255
050,51,155,"Virginia","Pulaski County",1,66,503,235,268
050,51,155,"Virginia","Pulaski County",1,67,489,231,258
050,51,155,"Virginia","Pulaski County",1,68,472,226,246
050,51,155,"Virginia","Pulaski County",1,69,448,207,241
050,51,155,"Virginia","Pulaski County",1,70,459,198,261
050,51,155,"Virginia","Pulaski County",1,71,445,213,232
050,51,155,"Virginia","Pulaski County",1,72,492,248,244
050,51,155,"Virginia","Pulaski County",1,73,479,217,262
050,51,155,"Virginia","Pulaski County",1,74,339,169,170
050,51,155,"Virginia","Pulaski County",1,75,332,150,182
050,51,155,"Virginia","Pulaski County",1,76,331,149,182
050,51,155,"Virginia","Pulaski County",1,77,313,146,167
050,51,155,"Virginia","Pulaski County",1,78,269,127,142
050,51,155,"Virginia","Pulaski County",1,79,235,95,140
050,51,155,"Virginia","Pulaski County",1,80,212,90,122
050,51,155,"Virginia","Pulaski County",1,81,197,95,102
050,51,155,"Virginia","Pulaski County",1,82,177,81,96
050,51,155,"Virginia","Pulaski County",1,83,162,66,96
050,51,155,"Virginia","Pulaski County",1,84,124,55,69
050,51,155,"Virginia","Pulaski County",1,85,715,251,464
050,51,155,"Virginia","Pulaski County",2,0,294,143,151
050,51,155,"Virginia","Pulaski County",2,1,292,145,147
050,51,155,"Virginia","Pulaski County",2,2,319,166,153
050,51,155,"Virginia","Pulaski County",2,3,333,169,164
050,51,155,"Virginia","Pulaski County",2,4,328,158,170
050,51,155,"Virginia","Pulaski County",2,5,322,165,157
050,51,155,"Virginia","Pulaski County",2,6,342,177,165
050,51,155,"Virginia","Pulaski County",2,7,339,173,166
050,51,155,"Virginia","Pulaski County",2,8,317,160,157
050,51,155,"Virginia","Pulaski County",2,9,307,159,148
050,51,155,"Virginia","Pulaski County",2,10,317,160,157
050,51,155,"Virginia","Pulaski County",2,11,345,170,175
050,51,155,"Virginia","Pulaski County",2,12,386,190,196
050,51,155,"Virginia","Pulaski County",2,13,361,173,188
050,51,155,"Virginia","Pulaski County",2,14,337,164,173
050,51,155,"Virginia","Pulaski County",2,15,355,184,171
050,51,155,"Virginia","Pulaski County",2,16,375,203,172
050,51,155,"Virginia","Pulaski County",2,17,354,187,167
050,51,155,"Virginia","Pulaski County",2,18,301,159,142
050,51,155,"Virginia","Pulaski County",2,19,289,162,127
050,51,155,"Virginia","Pulaski County",2,20,323,180,143
050,51,155,"Virginia","Pulaski County",2,21,351,195,156
050,51,155,"Virginia","Pulaski County",2,22,367,188,179
050,51,155,"Virginia","Pulaski County",2,23,394,205,189
050,51,155,"Virginia","Pulaski County",2,24,399,229,170
050,51,155,"Virginia","Pulaski County",2,25,406,226,180
050,51,155,"Virginia","Pulaski County",2,26,407,221,186
050,51,155,"Virginia","Pulaski County",2,27,413,222,191
050,51,155,"Virginia","Pulaski County",2,28,431,243,188
050,51,155,"Virginia","Pulaski County",2,29,442,242,200
050,51,155,"Virginia","Pulaski County",2,30,409,217,192
050,51,155,"Virginia","Pulaski County",2,31,388,212,176
050,51,155,"Virginia","Pulaski County",2,32,379,210,169
050,51,155,"Virginia","Pulaski County",2,33,354,188,166
050,51,155,"Virginia","Pulaski County",2,34,375,195,180
050,51,155,"Virginia","Pulaski County",2,35,384,206,178
050,51,155,"Virginia","Pulaski County",2,36,350,189,161
050,51,155,"Virginia","Pulaski County",2,37,337,185,152
050,51,155,"Virginia","Pulaski County",2,38,360,191,169
050,51,155,"Virginia","Pulaski County",2,39,377,217,160
050,51,155,"Virginia","Pulaski County",2,40,353,194,159
050,51,155,"Virginia","Pulaski County",2,41,337,175,162
050,51,155,"Virginia","Pulaski County",2,42,368,191,177
050,51,155,"Virginia","Pulaski County",2,43,374,194,180
050,51,155,"Virginia","Pulaski County",2,44,353,178,175
050,51,155,"Virginia","Pulaski County",2,45,412,212,200
050,51,155,"Virginia","Pulaski County",2,46,434,226,208
050,51,155,"Virginia","Pulaski County",2,47,449,236,213
050,51,155,"Virginia","Pulaski County",2,48,492,268,224
050,51,155,"Virginia","Pulaski County",2,49,533,269,264
050,51,155,"Virginia","Pulaski County",2,50,531,273,258
050,51,155,"Virginia","Pulaski County",2,51,514,253,261
050,51,155,"Virginia","Pulaski County",2,52,509,250,259
050,51,155,"Virginia","Pulaski County",2,53,500,270,230
050,51,155,"Virginia","Pulaski County",2,54,485,263,222
050,51,155,"Virginia","Pulaski County",2,55,511,275,236
050,51,155,"Virginia","Pulaski County",2,56,523,269,254
050,51,155,"Virginia","Pulaski County",2,57,516,256,260
050,51,155,"Virginia","Pulaski County",2,58,537,275,262
050,51,155,"Virginia","Pulaski County",2,59,531,270,261
050,51,155,"Virginia","Pulaski County",2,60,499,250,249
050,51,155,"Virginia","Pulaski County",2,61,519,260,259
050,51,155,"Virginia","Pulaski County",2,62,516,252,264
050,51,155,"Virginia","Pulaski County",2,63,525,255,270
050,51,155,"Virginia","Pulaski County",2,64,505,244,261
050,51,155,"Virginia","Pulaski County",2,65,494,236,258
050,51,155,"Virginia","Pulaski County",2,66,500,234,266
050,51,155,"Virginia","Pulaski County",2,67,491,233,258
050,51,155,"Virginia","Pulaski County",2,68,469,225,244
050,51,155,"Virginia","Pulaski County",2,69,454,211,243
050,51,155,"Virginia","Pulaski County",2,70,453,198,255
050,51,155,"Virginia","Pulaski County",2,71,447,210,237
050,51,155,"Virginia","Pulaski County",2,72,472,235,237
050,51,155,"Virginia","Pulaski County",2,73,500,230,270
050,51,155,"Virginia","Pulaski County",2,74,348,169,179
050,51,155,"Virginia","Pulaski County",2,75,335,154,181
050,51,155,"Virginia","Pulaski County",2,76,324,144,180
050,51,155,"Virginia","Pulaski County",2,77,323,150,173
050,51,155,"Virginia","Pulaski County",2,78,270,127,143
050,51,155,"Virginia","Pulaski County",2,79,236,98,138
050,51,155,"Virginia","Pulaski County",2,80,215,90,125
050,51,155,"Virginia","Pulaski County",2,81,197,90,107
050,51,155,"Virginia","Pulaski County",2,82,183,86,97
050,51,155,"Virginia","Pulaski County",2,83,161,67,94
050,51,155,"Virginia","Pulaski County",2,84,130,56,74
050,51,155,"Virginia","Pulaski County",2,85,720,254,466
050,51,155,"Virginia","Pulaski County",3,0,296,150,146
050,51,155,"Virginia","Pulaski County",3,1,291,149,142
050,51,155,"Virginia","Pulaski County",3,2,300,151,149
050,51,155,"Virginia","Pulaski County",3,3,326,175,151
050,51,155,"Virginia","Pulaski County",3,4,341,170,171
050,51,155,"Virginia","Pulaski County",3,5,347,174,173
050,51,155,"Virginia","Pulaski County",3,6,315,160,155
050,51,155,"Virginia","Pulaski County",3,7,339,175,164
050,51,155,"Virginia","Pulaski County",3,8,335,175,160
050,51,155,"Virginia","Pulaski County",3,9,314,161,153
050,51,155,"Virginia","Pulaski County",3,10,317,161,156
050,51,155,"Virginia","Pulaski County",3,11,322,159,163
050,51,155,"Virginia","Pulaski County",3,12,363,175,188
050,51,155,"Virginia","Pulaski County",3,13,391,200,191
050,51,155,"Virginia","Pulaski County",3,14,355,172,183
050,51,155,"Virginia","Pulaski County",3,15,348,171,177
050,51,155,"Virginia","Pulaski County",3,16,363,192,171
050,51,155,"Virginia","Pulaski County",3,17,384,210,174
050,51,155,"Virginia","Pulaski County",3,18,314,170,144
050,51,155,"Virginia","Pulaski County",3,19,255,142,113
050,51,155,"Virginia","Pulaski County",3,20,315,173,142
050,51,155,"Virginia","Pulaski County",3,21,341,194,147
050,51,155,"Virginia","Pulaski County",3,22,385,205,180
050,51,155,"Virginia","Pulaski County",3,23,377,196,181
050,51,155,"Virginia","Pulaski County",3,24,392,207,185
050,51,155,"Virginia","Pulaski County",3,25,405,227,178
050,51,155,"Virginia","Pulaski County",3,26,413,240,173
050,51,155,"Virginia","Pulaski County",3,27,389,213,176
050,51,155,"Virginia","Pulaski County",3,28,436,237,199
050,51,155,"Virginia","Pulaski County",3,29,452,259,193
050,51,155,"Virginia","Pulaski County",3,30,444,242,202
050,51,155,"Virginia","Pulaski County",3,31,418,221,197
050,51,155,"Virginia","Pulaski County",3,32,397,214,183
050,51,155,"Virginia","Pulaski County",3,33,353,192,161
050,51,155,"Virginia","Pulaski County",3,34,380,207,173
050,51,155,"Virginia","Pulaski County",3,35,395,206,189
050,51,155,"Virginia","Pulaski County",3,36,374,198,176
050,51,155,"Virginia","Pulaski County",3,37,357,206,151
050,51,155,"Virginia","Pulaski County",3,38,329,175,154
050,51,155,"Virginia","Pulaski County",3,39,376,200,176
050,51,155,"Virginia","Pulaski County",3,40,362,202,160
050,51,155,"Virginia","Pulaski County",3,41,360,193,167
050,51,155,"Virginia","Pulaski County",3,42,350,191,159
050,51,155,"Virginia","Pulaski County",3,43,363,180,183
050,51,155,"Virginia","Pulaski County",3,44,364,189,175
050,51,155,"Virginia","Pulaski County",3,45,375,194,181
050,51,155,"Virginia","Pulaski County",3,46,403,205,198
050,51,155,"Virginia","Pulaski County",3,47,438,231,207
050,51,155,"Virginia","Pulaski County",3,48,458,244,214
050,51,155,"Virginia","Pulaski County",3,49,477,254,223
050,51,155,"Virginia","Pulaski County",3,50,542,274,268
050,51,155,"Virginia","Pulaski County",3,51,531,267,264
050,51,155,"Virginia","Pulaski County",3,52,518,259,259
050,51,155,"Virginia","Pulaski County",3,53,522,256,266
050,51,155,"Virginia","Pulaski County",3,54,493,261,232
050,51,155,"Virginia","Pulaski County",3,55,485,265,220
050,51,155,"Virginia","Pulaski County",3,56,511,274,237
050,51,155,"Virginia","Pulaski County",3,57,506,258,248
050,51,155,"Virginia","Pulaski County",3,58,527,260,267
050,51,155,"Virginia","Pulaski County",3,59,541,282,259
050,51,155,"Virginia","Pulaski County",3,60,526,263,263
050,51,155,"Virginia","Pulaski County",3,61,489,247,242
050,51,155,"Virginia","Pulaski County",3,62,519,260,259
050,51,155,"Virginia","Pulaski County",3,63,511,251,260
050,51,155,"Virginia","Pulaski County",3,64,518,250,268
050,51,155,"Virginia","Pulaski County",3,65,506,245,261
050,51,155,"Virginia","Pulaski County",3,66,484,230,254
050,51,155,"Virginia","Pulaski County",3,67,496,228,268
050,51,155,"Virginia","Pulaski County",3,68,476,225,251
050,51,155,"Virginia","Pulaski County",3,69,458,216,242
050,51,155,"Virginia","Pulaski County",3,70,436,200,236
050,51,155,"Virginia","Pulaski County",3,71,432,186,246
050,51,155,"Virginia","Pulaski County",3,72,421,196,225
050,51,155,"Virginia","Pulaski County",3,73,453,227,226
050,51,155,"Virginia","Pulaski County",3,74,486,226,260
050,51,155,"Virginia","Pulaski County",3,75,344,164,180
050,51,155,"Virginia","Pulaski County",3,76,311,143,168
050,51,155,"Virginia","Pulaski County",3,77,299,130,169
050,51,155,"Virginia","Pulaski County",3,78,318,149,169
050,51,155,"Virginia","Pulaski County",3,79,246,112,134
050,51,155,"Virginia","Pulaski County",3,80,221,90,131
050,51,155,"Virginia","Pulaski County",3,81,204,82,122
050,51,155,"Virginia","Pulaski County",3,82,184,86,98
050,51,155,"Virginia","Pulaski County",3,83,165,82,83
050,51,155,"Virginia","Pulaski County",3,84,139,57,82
050,51,155,"Virginia","Pulaski County",3,85,704,254,450
050,51,155,"Virginia","Pulaski County",4,0,297,159,138
050,51,155,"Virginia","Pulaski County",4,1,293,142,151
050,51,155,"Virginia","Pulaski County",4,2,282,145,137
050,51,155,"Virginia","Pulaski County",4,3,302,152,150
050,51,155,"Virginia","Pulaski County",4,4,333,183,150
050,51,155,"Virginia","Pulaski County",4,5,355,184,171
050,51,155,"Virginia","Pulaski County",4,6,337,162,175
050,51,155,"Virginia","Pulaski County",4,7,318,158,160
050,51,155,"Virginia","Pulaski County",4,8,350,181,169
050,51,155,"Virginia","Pulaski County",4,9,337,177,160
050,51,155,"Virginia","Pulaski County",4,10,305,166,139
050,51,155,"Virginia","Pulaski County",4,11,314,158,156
050,51,155,"Virginia","Pulaski County",4,12,331,162,169
050,51,155,"Virginia","Pulaski County",4,13,372,172,200
050,51,155,"Virginia","Pulaski County",4,14,395,203,192
050,51,155,"Virginia","Pulaski County",4,15,361,176,185
050,51,155,"Virginia","Pulaski County",4,16,344,168,176
050,51,155,"Virginia","Pulaski County",4,17,358,194,164
050,51,155,"Virginia","Pulaski County",4,18,324,184,140
050,51,155,"Virginia","Pulaski County",4,19,262,148,114
050,51,155,"Virginia","Pulaski County",4,20,268,143,125
050,51,155,"Virginia","Pulaski County",4,21,336,190,146
050,51,155,"Virginia","Pulaski County",4,22,368,201,167
050,51,155,"Virginia","Pulaski County",4,23,414,215,199
050,51,155,"Virginia","Pulaski County",4,24,392,221,171
050,51,155,"Virginia","Pulaski County",4,25,415,218,197
050,51,155,"Virginia","Pulaski County",4,26,408,221,187
050,51,155,"Virginia","Pulaski County",4,27,423,245,178
050,51,155,"Virginia","Pulaski County",4,28,404,231,173
050,51,155,"Virginia","Pulaski County",4,29,459,248,211
050,51,155,"Virginia","Pulaski County",4,30,435,244,191
050,51,155,"Virginia","Pulaski County",4,31,436,231,205
050,51,155,"Virginia","Pulaski County",4,32,431,223,208
050,51,155,"Virginia","Pulaski County",4,33,380,200,180
050,51,155,"Virginia","Pulaski County",4,34,362,203,159
050,51,155,"Virginia","Pulaski County",4,35,403,226,177
050,51,155,"Virginia","Pulaski County",4,36,399,213,186
050,51,155,"Virginia","Pulaski County",4,37,373,196,177
050,51,155,"Virginia","Pulaski County",4,38,344,197,147
050,51,155,"Virginia","Pulaski County",4,39,325,172,153
050,51,155,"Virginia","Pulaski County",4,40,361,182,179
050,51,155,"Virginia","Pulaski County",4,41,367,203,164
050,51,155,"Virginia","Pulaski County",4,42,376,210,166
050,51,155,"Virginia","Pulaski County",4,43,336,177,159
050,51,155,"Virginia","Pulaski County",4,44,357,176,181
050,51,155,"Virginia","Pulaski County",4,45,382,202,180
050,51,155,"Virginia","Pulaski County",4,46,363,181,182
050,51,155,"Virginia","Pulaski County",4,47,407,207,200
050,51,155,"Virginia","Pulaski County",4,48,456,248,208
050,51,155,"Virginia","Pulaski County",4,49,440,234,206
050,51,155,"Virginia","Pulaski County",4,50,485,255,230
050,51,155,"Virginia","Pulaski County",4,51,535,263,272
050,51,155,"Virginia","Pulaski County",4,52,521,259,262
050,51,155,"Virginia","Pulaski County",4,53,498,244,254
050,51,155,"Virginia","Pulaski County",4,54,526,257,269
050,51,155,"Virginia","Pulaski County",4,55,474,252,222
050,51,155,"Virginia","Pulaski County",4,56,485,260,225
050,51,155,"Virginia","Pulaski County",4,57,493,265,228
050,51,155,"Virginia","Pulaski County",4,58,511,258,253
050,51,155,"Virginia","Pulaski County",4,59,518,259,259
050,51,155,"Virginia","Pulaski County",4,60,541,283,258
050,51,155,"Virginia","Pulaski County",4,61,526,264,262
050,51,155,"Virginia","Pulaski County",4,62,485,246,239
050,51,155,"Virginia","Pulaski County",4,63,514,251,263
050,51,155,"Virginia","Pulaski County",4,64,506,249,257
050,51,155,"Virginia","Pulaski County",4,65,516,246,270
050,51,155,"Virginia","Pulaski County",4,66,501,239,262
050,51,155,"Virginia","Pulaski County",4,67,468,217,251
050,51,155,"Virginia","Pulaski County",4,68,472,221,251
050,51,155,"Virginia","Pulaski County",4,69,480,226,254
050,51,155,"Virginia","Pulaski County",4,70,451,211,240
050,51,155,"Virginia","Pulaski County",4,71,428,194,234
050,51,155,"Virginia","Pulaski County",4,72,415,178,237
050,51,155,"Virginia","Pulaski County",4,73,405,193,212
050,51,155,"Virginia","Pulaski County",4,74,442,222,220
050,51,155,"Virginia","Pulaski County",4,75,460,210,250
050,51,155,"Virginia","Pulaski County",4,76,332,156,176
050,51,155,"Virginia","Pulaski County",4,77,293,135,158
050,51,155,"Virginia","Pulaski County",4,78,284,124,160
050,51,155,"Virginia","Pulaski County",4,79,295,134,161
050,51,155,"Virginia","Pulaski County",4,80,231,102,129
050,51,155,"Virginia","Pulaski County",4,81,203,77,126
050,51,155,"Virginia","Pulaski County",4,82,194,76,118
050,51,155,"Virginia","Pulaski County",4,83,165,75,90
050,51,155,"Virginia","Pulaski County",4,84,144,70,74
050,51,155,"Virginia","Pulaski County",4,85,696,249,447
050,51,155,"Virginia","Pulaski County",5,0,294,158,136
050,51,155,"Virginia","Pulaski County",5,1,310,166,144
050,51,155,"Virginia","Pulaski County",5,2,300,143,157
050,51,155,"Virginia","Pulaski County",5,3,289,148,141
050,51,155,"Virginia","Pulaski County",5,4,288,143,145
050,51,155,"Virginia","Pulaski County",5,5,341,181,160
050,51,155,"Virginia","Pulaski County",5,6,341,176,165
050,51,155,"Virginia","Pulaski County",5,7,339,168,171
050,51,155,"Virginia","Pulaski County",5,8,322,165,157
050,51,155,"Virginia","Pulaski County",5,9,331,166,165
050,51,155,"Virginia","Pulaski County",5,10,334,165,169
050,51,155,"Virginia","Pulaski County",5,11,307,168,139
050,51,155,"Virginia","Pulaski County",5,12,320,163,157
050,51,155,"Virginia","Pulaski County",5,13,334,166,168
050,51,155,"Virginia","Pulaski County",5,14,358,167,191
050,51,155,"Virginia","Pulaski County",5,15,399,200,199
050,51,155,"Virginia","Pulaski County",5,16,369,175,194
050,51,155,"Virginia","Pulaski County",5,17,344,166,178
050,51,155,"Virginia","Pulaski County",5,18,305,176,129
050,51,155,"Virginia","Pulaski County",5,19,285,168,117
050,51,155,"Virginia","Pulaski County",5,20,289,162,127
050,51,155,"Virginia","Pulaski County",5,21,288,160,128
050,51,155,"Virginia","Pulaski County",5,22,355,195,160
050,51,155,"Virginia","Pulaski County",5,23,404,214,190
050,51,155,"Virginia","Pulaski County",5,24,418,220,198
050,51,155,"Virginia","Pulaski County",5,25,428,238,190
050,51,155,"Virginia","Pulaski County",5,26,421,218,203
050,51,155,"Virginia","Pulaski County",5,27,396,219,177
050,51,155,"Virginia","Pulaski County",5,28,421,240,181
050,51,155,"Virginia","Pulaski County",5,29,428,244,184
050,51,155,"Virginia","Pulaski County",5,30,442,237,205
050,51,155,"Virginia","Pulaski County",5,31,430,240,190
050,51,155,"Virginia","Pulaski County",5,32,436,230,206
050,51,155,"Virginia","Pulaski County",5,33,400,196,204
050,51,155,"Virginia","Pulaski County",5,34,395,212,183
050,51,155,"Virginia","Pulaski County",5,35,366,207,159
050,51,155,"Virginia","Pulaski County",5,36,392,217,175
050,51,155,"Virginia","Pulaski County",5,37,417,234,183
050,51,155,"Virginia","Pulaski County",5,38,388,195,193
050,51,155,"Virginia","Pulaski County",5,39,365,210,155
050,51,155,"Virginia","Pulaski County",5,40,305,158,147
050,51,155,"Virginia","Pulaski County",5,41,366,190,176
050,51,155,"Virginia","Pulaski County",5,42,386,229,157
050,51,155,"Virginia","Pulaski County",5,43,370,194,176
050,51,155,"Virginia","Pulaski County",5,44,334,176,158
050,51,155,"Virginia","Pulaski County",5,45,375,190,185
050,51,155,"Virginia","Pulaski County",5,46,382,199,183
050,51,155,"Virginia","Pulaski County",5,47,351,173,178
050,51,155,"Virginia","Pulaski County",5,48,431,229,202
050,51,155,"Virginia","Pulaski County",5,49,442,239,203
050,51,155,"Virginia","Pulaski County",5,50,452,240,212
050,51,155,"Virginia","Pulaski County",5,51,470,244,226
050,51,155,"Virginia","Pulaski County",5,52,543,260,283
050,51,155,"Virginia","Pulaski County",5,53,513,255,258
050,51,155,"Virginia","Pulaski County",5,54,511,243,268
050,51,155,"Virginia","Pulaski County",5,55,526,254,272
050,51,155,"Virginia","Pulaski County",5,56,470,250,220
050,51,155,"Virginia","Pulaski County",5,57,484,261,223
050,51,155,"Virginia","Pulaski County",5,58,498,268,230
050,51,155,"Virginia","Pulaski County",5,59,513,261,252
050,51,155,"Virginia","Pulaski County",5,60,515,256,259
050,51,155,"Virginia","Pulaski County",5,61,529,272,257
050,51,155,"Virginia","Pulaski County",5,62,516,258,258
050,51,155,"Virginia","Pulaski County",5,63,491,248,243
050,51,155,"Virginia","Pulaski County",5,64,503,243,260
050,51,155,"Virginia","Pulaski County",5,65,507,245,262
050,51,155,"Virginia","Pulaski County",5,66,520,244,276
050,51,155,"Virginia","Pulaski County",5,67,488,226,262
050,51,155,"Virginia","Pulaski County",5,68,450,210,240
050,51,155,"Virginia","Pulaski County",5,69,463,217,246
050,51,155,"Virginia","Pulaski County",5,70,471,220,251
050,51,155,"Virginia","Pulaski County",5,71,440,207,233
050,51,155,"Virginia","Pulaski County",5,72,414,187,227
050,51,155,"Virginia","Pulaski County",5,73,400,176,224
050,51,155,"Virginia","Pulaski County",5,74,393,185,208
050,51,155,"Virginia","Pulaski County",5,75,420,207,213
050,51,155,"Virginia","Pulaski County",5,76,439,199,240
050,51,155,"Virginia","Pulaski County",5,77,310,147,163
050,51,155,"Virginia","Pulaski County",5,78,291,135,156
050,51,155,"Virginia","Pulaski County",5,79,258,105,153
050,51,155,"Virginia","Pulaski County",5,80,276,121,155
050,51,155,"Virginia","Pulaski County",5,81,212,88,124
050,51,155,"Virginia","Pulaski County",5,82,192,73,119
050,51,155,"Virginia","Pulaski County",5,83,178,68,110
050,51,155,"Virginia","Pulaski County",5,84,145,66,79
050,51,155,"Virginia","Pulaski County",5,85,723,267,456
050,51,157,"Virginia","Rappahannock County",1,0,56,29,27
050,51,157,"Virginia","Rappahannock County",1,1,59,35,24
050,51,157,"Virginia","Rappahannock County",1,2,79,45,34
050,51,157,"Virginia","Rappahannock County",1,3,66,31,35
050,51,157,"Virginia","Rappahannock County",1,4,58,31,27
050,51,157,"Virginia","Rappahannock County",1,5,63,28,35
050,51,157,"Virginia","Rappahannock County",1,6,70,31,39
050,51,157,"Virginia","Rappahannock County",1,7,68,39,29
050,51,157,"Virginia","Rappahannock County",1,8,67,40,27
050,51,157,"Virginia","Rappahannock County",1,9,80,46,34
050,51,157,"Virginia","Rappahannock County",1,10,68,32,36
050,51,157,"Virginia","Rappahannock County",1,11,68,33,35
050,51,157,"Virginia","Rappahannock County",1,12,73,37,36
050,51,157,"Virginia","Rappahannock County",1,13,73,44,29
050,51,157,"Virginia","Rappahannock County",1,14,66,33,33
050,51,157,"Virginia","Rappahannock County",1,15,71,33,38
050,51,157,"Virginia","Rappahannock County",1,16,81,42,39
050,51,157,"Virginia","Rappahannock County",1,17,80,39,41
050,51,157,"Virginia","Rappahannock County",1,18,70,33,37
050,51,157,"Virginia","Rappahannock County",1,19,59,33,26
050,51,157,"Virginia","Rappahannock County",1,20,74,40,34
050,51,157,"Virginia","Rappahannock County",1,21,71,41,30
050,51,157,"Virginia","Rappahannock County",1,22,78,39,39
050,51,157,"Virginia","Rappahannock County",1,23,64,37,27
050,51,157,"Virginia","Rappahannock County",1,24,65,35,30
050,51,157,"Virginia","Rappahannock County",1,25,66,39,27
050,51,157,"Virginia","Rappahannock County",1,26,71,36,35
050,51,157,"Virginia","Rappahannock County",1,27,61,23,38
050,51,157,"Virginia","Rappahannock County",1,28,65,32,33
050,51,157,"Virginia","Rappahannock County",1,29,76,37,39
050,51,157,"Virginia","Rappahannock County",1,30,78,42,36
050,51,157,"Virginia","Rappahannock County",1,31,67,38,29
050,51,157,"Virginia","Rappahannock County",1,32,76,42,34
050,51,157,"Virginia","Rappahannock County",1,33,76,35,41
050,51,157,"Virginia","Rappahannock County",1,34,60,27,33
050,51,157,"Virginia","Rappahannock County",1,35,71,32,39
050,51,157,"Virginia","Rappahannock County",1,36,71,34,37
050,51,157,"Virginia","Rappahannock County",1,37,67,35,32
050,51,157,"Virginia","Rappahannock County",1,38,84,48,36
050,51,157,"Virginia","Rappahannock County",1,39,55,23,32
050,51,157,"Virginia","Rappahannock County",1,40,58,27,31
050,51,157,"Virginia","Rappahannock County",1,41,70,33,37
050,51,157,"Virginia","Rappahannock County",1,42,71,37,34
050,51,157,"Virginia","Rappahannock County",1,43,75,37,38
050,51,157,"Virginia","Rappahannock County",1,44,90,45,45
050,51,157,"Virginia","Rappahannock County",1,45,67,39,28
050,51,157,"Virginia","Rappahannock County",1,46,64,28,36
050,51,157,"Virginia","Rappahannock County",1,47,72,37,35
050,51,157,"Virginia","Rappahannock County",1,48,90,50,40
050,51,157,"Virginia","Rappahannock County",1,49,100,51,49
050,51,157,"Virginia","Rappahannock County",1,50,82,40,42
050,51,157,"Virginia","Rappahannock County",1,51,93,51,42
050,51,157,"Virginia","Rappahannock County",1,52,97,45,52
050,51,157,"Virginia","Rappahannock County",1,53,110,51,59
050,51,157,"Virginia","Rappahannock County",1,54,119,50,69
050,51,157,"Virginia","Rappahannock County",1,55,119,50,69
050,51,157,"Virginia","Rappahannock County",1,56,124,65,59
050,51,157,"Virginia","Rappahannock County",1,57,117,62,55
050,51,157,"Virginia","Rappahannock County",1,58,121,57,64
050,51,157,"Virginia","Rappahannock County",1,59,141,64,77
050,51,157,"Virginia","Rappahannock County",1,60,135,67,68
050,51,157,"Virginia","Rappahannock County",1,61,138,71,67
050,51,157,"Virginia","Rappahannock County",1,62,136,67,69
050,51,157,"Virginia","Rappahannock County",1,63,135,63,72
050,51,157,"Virginia","Rappahannock County",1,64,141,67,74
050,51,157,"Virginia","Rappahannock County",1,65,138,69,69
050,51,157,"Virginia","Rappahannock County",1,66,117,59,58
050,51,157,"Virginia","Rappahannock County",1,67,103,59,44
050,51,157,"Virginia","Rappahannock County",1,68,112,56,56
050,51,157,"Virginia","Rappahannock County",1,69,119,57,62
050,51,157,"Virginia","Rappahannock County",1,70,127,59,68
050,51,157,"Virginia","Rappahannock County",1,71,124,57,67
050,51,157,"Virginia","Rappahannock County",1,72,122,59,63
050,51,157,"Virginia","Rappahannock County",1,73,137,66,71
050,51,157,"Virginia","Rappahannock County",1,74,96,48,48
050,51,157,"Virginia","Rappahannock County",1,75,94,45,49
050,51,157,"Virginia","Rappahannock County",1,76,82,38,44
050,51,157,"Virginia","Rappahannock County",1,77,82,45,37
050,51,157,"Virginia","Rappahannock County",1,78,78,40,38
050,51,157,"Virginia","Rappahannock County",1,79,65,31,34
050,51,157,"Virginia","Rappahannock County",1,80,57,27,30
050,51,157,"Virginia","Rappahannock County",1,81,48,27,21
050,51,157,"Virginia","Rappahannock County",1,82,37,14,23
050,51,157,"Virginia","Rappahannock County",1,83,46,19,27
050,51,157,"Virginia","Rappahannock County",1,84,33,12,21
050,51,157,"Virginia","Rappahannock County",1,85,196,88,108
050,51,157,"Virginia","Rappahannock County",2,0,55,29,26
050,51,157,"Virginia","Rappahannock County",2,1,59,34,25
050,51,157,"Virginia","Rappahannock County",2,2,76,43,33
050,51,157,"Virginia","Rappahannock County",2,3,69,35,34
050,51,157,"Virginia","Rappahannock County",2,4,59,30,29
050,51,157,"Virginia","Rappahannock County",2,5,62,28,34
050,51,157,"Virginia","Rappahannock County",2,6,69,32,37
050,51,157,"Virginia","Rappahannock County",2,7,69,38,31
050,51,157,"Virginia","Rappahannock County",2,8,66,38,28
050,51,157,"Virginia","Rappahannock County",2,9,77,44,33
050,51,157,"Virginia","Rappahannock County",2,10,72,36,36
050,51,157,"Virginia","Rappahannock County",2,11,67,32,35
050,51,157,"Virginia","Rappahannock County",2,12,71,36,35
050,51,157,"Virginia","Rappahannock County",2,13,73,43,30
050,51,157,"Virginia","Rappahannock County",2,14,67,35,32
050,51,157,"Virginia","Rappahannock County",2,15,70,34,36
050,51,157,"Virginia","Rappahannock County",2,16,78,40,38
050,51,157,"Virginia","Rappahannock County",2,17,77,39,38
050,51,157,"Virginia","Rappahannock County",2,18,68,33,35
050,51,157,"Virginia","Rappahannock County",2,19,57,30,27
050,51,157,"Virginia","Rappahannock County",2,20,70,38,32
050,51,157,"Virginia","Rappahannock County",2,21,71,41,30
050,51,157,"Virginia","Rappahannock County",2,22,75,40,35
050,51,157,"Virginia","Rappahannock County",2,23,66,38,28
050,51,157,"Virginia","Rappahannock County",2,24,68,38,30
050,51,157,"Virginia","Rappahannock County",2,25,66,38,28
050,51,157,"Virginia","Rappahannock County",2,26,68,36,32
050,51,157,"Virginia","Rappahannock County",2,27,63,26,37
050,51,157,"Virginia","Rappahannock County",2,28,66,31,35
050,51,157,"Virginia","Rappahannock County",2,29,74,36,38
050,51,157,"Virginia","Rappahannock County",2,30,78,42,36
050,51,157,"Virginia","Rappahannock County",2,31,70,40,30
050,51,157,"Virginia","Rappahannock County",2,32,74,41,33
050,51,157,"Virginia","Rappahannock County",2,33,75,36,39
050,51,157,"Virginia","Rappahannock County",2,34,63,28,35
050,51,157,"Virginia","Rappahannock County",2,35,70,33,37
050,51,157,"Virginia","Rappahannock County",2,36,71,34,37
050,51,157,"Virginia","Rappahannock County",2,37,67,34,33
050,51,157,"Virginia","Rappahannock County",2,38,78,44,34
050,51,157,"Virginia","Rappahannock County",2,39,59,28,31
050,51,157,"Virginia","Rappahannock County",2,40,58,26,32
050,51,157,"Virginia","Rappahannock County",2,41,68,31,37
050,51,157,"Virginia","Rappahannock County",2,42,71,36,35
050,51,157,"Virginia","Rappahannock County",2,43,75,38,37
050,51,157,"Virginia","Rappahannock County",2,44,84,43,41
050,51,157,"Virginia","Rappahannock County",2,45,69,38,31
050,51,157,"Virginia","Rappahannock County",2,46,64,30,34
050,51,157,"Virginia","Rappahannock County",2,47,69,34,35
050,51,157,"Virginia","Rappahannock County",2,48,87,47,40
050,51,157,"Virginia","Rappahannock County",2,49,99,52,47
050,51,157,"Virginia","Rappahannock County",2,50,88,44,44
050,51,157,"Virginia","Rappahannock County",2,51,90,48,42
050,51,157,"Virginia","Rappahannock County",2,52,97,48,49
050,51,157,"Virginia","Rappahannock County",2,53,106,49,57
050,51,157,"Virginia","Rappahannock County",2,54,116,49,67
050,51,157,"Virginia","Rappahannock County",2,55,119,51,68
050,51,157,"Virginia","Rappahannock County",2,56,122,61,61
050,51,157,"Virginia","Rappahannock County",2,57,119,62,57
050,51,157,"Virginia","Rappahannock County",2,58,122,58,64
050,51,157,"Virginia","Rappahannock County",2,59,135,62,73
050,51,157,"Virginia","Rappahannock County",2,60,137,67,70
050,51,157,"Virginia","Rappahannock County",2,61,136,69,67
050,51,157,"Virginia","Rappahannock County",2,62,137,68,69
050,51,157,"Virginia","Rappahannock County",2,63,137,65,72
050,51,157,"Virginia","Rappahannock County",2,64,137,65,72
050,51,157,"Virginia","Rappahannock County",2,65,141,70,71
050,51,157,"Virginia","Rappahannock County",2,66,123,62,61
050,51,157,"Virginia","Rappahannock County",2,67,106,59,47
050,51,157,"Virginia","Rappahannock County",2,68,108,56,52
050,51,157,"Virginia","Rappahannock County",2,69,118,57,61
050,51,157,"Virginia","Rappahannock County",2,70,125,58,67
050,51,157,"Virginia","Rappahannock County",2,71,122,56,66
050,51,157,"Virginia","Rappahannock County",2,72,122,58,64
050,51,157,"Virginia","Rappahannock County",2,73,140,67,73
050,51,157,"Virginia","Rappahannock County",2,74,98,48,50
050,51,157,"Virginia","Rappahannock County",2,75,95,45,50
050,51,157,"Virginia","Rappahannock County",2,76,83,39,44
050,51,157,"Virginia","Rappahannock County",2,77,84,45,39
050,51,157,"Virginia","Rappahannock County",2,78,73,37,36
050,51,157,"Virginia","Rappahannock County",2,79,65,32,33
050,51,157,"Virginia","Rappahannock County",2,80,58,28,30
050,51,157,"Virginia","Rappahannock County",2,81,50,27,23
050,51,157,"Virginia","Rappahannock County",2,82,39,16,23
050,51,157,"Virginia","Rappahannock County",2,83,42,17,25
050,51,157,"Virginia","Rappahannock County",2,84,35,13,22
050,51,157,"Virginia","Rappahannock County",2,85,198,89,109
050,51,157,"Virginia","Rappahannock County",3,0,38,20,18
050,51,157,"Virginia","Rappahannock County",3,1,50,29,21
050,51,157,"Virginia","Rappahannock County",3,2,54,34,20
050,51,157,"Virginia","Rappahannock County",3,3,68,38,30
050,51,157,"Virginia","Rappahannock County",3,4,72,30,42
050,51,157,"Virginia","Rappahannock County",3,5,65,33,32
050,51,157,"Virginia","Rappahannock County",3,6,64,30,34
050,51,157,"Virginia","Rappahannock County",3,7,75,35,40
050,51,157,"Virginia","Rappahannock County",3,8,68,38,30
050,51,157,"Virginia","Rappahannock County",3,9,68,35,33
050,51,157,"Virginia","Rappahannock County",3,10,81,49,32
050,51,157,"Virginia","Rappahannock County",3,11,72,35,37
050,51,157,"Virginia","Rappahannock County",3,12,70,34,36
050,51,157,"Virginia","Rappahannock County",3,13,78,41,37
050,51,157,"Virginia","Rappahannock County",3,14,80,45,35
050,51,157,"Virginia","Rappahannock County",3,15,72,39,33
050,51,157,"Virginia","Rappahannock County",3,16,69,33,36
050,51,157,"Virginia","Rappahannock County",3,17,79,41,38
050,51,157,"Virginia","Rappahannock County",3,18,61,31,30
050,51,157,"Virginia","Rappahannock County",3,19,59,28,31
050,51,157,"Virginia","Rappahannock County",3,20,62,33,29
050,51,157,"Virginia","Rappahannock County",3,21,66,37,29
050,51,157,"Virginia","Rappahannock County",3,22,77,44,33
050,51,157,"Virginia","Rappahannock County",3,23,71,35,36
050,51,157,"Virginia","Rappahannock County",3,24,66,41,25
050,51,157,"Virginia","Rappahannock County",3,25,71,37,34
050,51,157,"Virginia","Rappahannock County",3,26,66,37,29
050,51,157,"Virginia","Rappahannock County",3,27,67,38,29
050,51,157,"Virginia","Rappahannock County",3,28,79,33,46
050,51,157,"Virginia","Rappahannock County",3,29,64,28,36
050,51,157,"Virginia","Rappahannock County",3,30,75,41,34
050,51,157,"Virginia","Rappahannock County",3,31,74,40,34
050,51,157,"Virginia","Rappahannock County",3,32,72,40,32
050,51,157,"Virginia","Rappahannock County",3,33,77,40,37
050,51,157,"Virginia","Rappahannock County",3,34,67,31,36
050,51,157,"Virginia","Rappahannock County",3,35,69,30,39
050,51,157,"Virginia","Rappahannock County",3,36,77,39,38
050,51,157,"Virginia","Rappahannock County",3,37,74,36,38
050,51,157,"Virginia","Rappahannock County",3,38,77,36,41
050,51,157,"Virginia","Rappahannock County",3,39,90,52,38
050,51,157,"Virginia","Rappahannock County",3,40,63,31,32
050,51,157,"Virginia","Rappahannock County",3,41,62,29,33
050,51,157,"Virginia","Rappahannock County",3,42,67,32,35
050,51,157,"Virginia","Rappahannock County",3,43,78,42,36
050,51,157,"Virginia","Rappahannock County",3,44,76,37,39
050,51,157,"Virginia","Rappahannock County",3,45,91,46,45
050,51,157,"Virginia","Rappahannock County",3,46,65,37,28
050,51,157,"Virginia","Rappahannock County",3,47,69,33,36
050,51,157,"Virginia","Rappahannock County",3,48,70,35,35
050,51,157,"Virginia","Rappahannock County",3,49,86,46,40
050,51,157,"Virginia","Rappahannock County",3,50,97,53,44
050,51,157,"Virginia","Rappahannock County",3,51,95,48,47
050,51,157,"Virginia","Rappahannock County",3,52,97,51,46
050,51,157,"Virginia","Rappahannock County",3,53,98,52,46
050,51,157,"Virginia","Rappahannock County",3,54,111,50,61
050,51,157,"Virginia","Rappahannock County",3,55,117,46,71
050,51,157,"Virginia","Rappahannock County",3,56,121,53,68
050,51,157,"Virginia","Rappahannock County",3,57,126,64,62
050,51,157,"Virginia","Rappahannock County",3,58,133,70,63
050,51,157,"Virginia","Rappahannock County",3,59,128,61,67
050,51,157,"Virginia","Rappahannock County",3,60,143,68,75
050,51,157,"Virginia","Rappahannock County",3,61,138,68,70
050,51,157,"Virginia","Rappahannock County",3,62,137,67,70
050,51,157,"Virginia","Rappahannock County",3,63,144,68,76
050,51,157,"Virginia","Rappahannock County",3,64,132,62,70
050,51,157,"Virginia","Rappahannock County",3,65,137,62,75
050,51,157,"Virginia","Rappahannock County",3,66,141,70,71
050,51,157,"Virginia","Rappahannock County",3,67,126,65,61
050,51,157,"Virginia","Rappahannock County",3,68,106,58,48
050,51,157,"Virginia","Rappahannock County",3,69,109,55,54
050,51,157,"Virginia","Rappahannock County",3,70,119,59,60
050,51,157,"Virginia","Rappahannock County",3,71,121,57,64
050,51,157,"Virginia","Rappahannock County",3,72,119,55,64
050,51,157,"Virginia","Rappahannock County",3,73,116,56,60
050,51,157,"Virginia","Rappahannock County",3,74,142,68,74
050,51,157,"Virginia","Rappahannock County",3,75,99,47,52
050,51,157,"Virginia","Rappahannock County",3,76,96,48,48
050,51,157,"Virginia","Rappahannock County",3,77,76,36,40
050,51,157,"Virginia","Rappahannock County",3,78,81,41,40
050,51,157,"Virginia","Rappahannock County",3,79,68,35,33
050,51,157,"Virginia","Rappahannock County",3,80,57,28,29
050,51,157,"Virginia","Rappahannock County",3,81,57,29,28
050,51,157,"Virginia","Rappahannock County",3,82,45,23,22
050,51,157,"Virginia","Rappahannock County",3,83,39,15,24
050,51,157,"Virginia","Rappahannock County",3,84,40,16,24
050,51,157,"Virginia","Rappahannock County",3,85,209,88,121
050,51,157,"Virginia","Rappahannock County",4,0,34,17,17
050,51,157,"Virginia","Rappahannock County",4,1,31,17,14
050,51,157,"Virginia","Rappahannock County",4,2,54,33,21
050,51,157,"Virginia","Rappahannock County",4,3,62,37,25
050,51,157,"Virginia","Rappahannock County",4,4,76,38,38
050,51,157,"Virginia","Rappahannock County",4,5,72,35,37
050,51,157,"Virginia","Rappahannock County",4,6,64,34,30
050,51,157,"Virginia","Rappahannock County",4,7,66,29,37
050,51,157,"Virginia","Rappahannock County",4,8,82,39,43
050,51,157,"Virginia","Rappahannock County",4,9,70,38,32
050,51,157,"Virginia","Rappahannock County",4,10,75,37,38
050,51,157,"Virginia","Rappahannock County",4,11,79,47,32
050,51,157,"Virginia","Rappahannock County",4,12,75,33,42
050,51,157,"Virginia","Rappahannock County",4,13,75,34,41
050,51,157,"Virginia","Rappahannock County",4,14,77,41,36
050,51,157,"Virginia","Rappahannock County",4,15,79,46,33
050,51,157,"Virginia","Rappahannock County",4,16,67,34,33
050,51,157,"Virginia","Rappahannock County",4,17,70,35,35
050,51,157,"Virginia","Rappahannock County",4,18,67,38,29
050,51,157,"Virginia","Rappahannock County",4,19,53,24,29
050,51,157,"Virginia","Rappahannock County",4,20,60,29,31
050,51,157,"Virginia","Rappahannock County",4,21,65,33,32
050,51,157,"Virginia","Rappahannock County",4,22,74,38,36
050,51,157,"Virginia","Rappahannock County",4,23,85,47,38
050,51,157,"Virginia","Rappahannock County",4,24,72,38,34
050,51,157,"Virginia","Rappahannock County",4,25,62,39,23
050,51,157,"Virginia","Rappahannock County",4,26,62,35,27
050,51,157,"Virginia","Rappahannock County",4,27,53,32,21
050,51,157,"Virginia","Rappahannock County",4,28,49,28,21
050,51,157,"Virginia","Rappahannock County",4,29,78,34,44
050,51,157,"Virginia","Rappahannock County",4,30,70,35,35
050,51,157,"Virginia","Rappahannock County",4,31,76,43,33
050,51,157,"Virginia","Rappahannock County",4,32,71,41,30
050,51,157,"Virginia","Rappahannock County",4,33,76,37,39
050,51,157,"Virginia","Rappahannock County",4,34,90,47,43
050,51,157,"Virginia","Rappahannock County",4,35,80,40,40
050,51,157,"Virginia","Rappahannock County",4,36,77,31,46
050,51,157,"Virginia","Rappahannock County",4,37,84,44,40
050,51,157,"Virginia","Rappahannock County",4,38,75,37,38
050,51,157,"Virginia","Rappahannock County",4,39,71,35,36
050,51,157,"Virginia","Rappahannock County",4,40,92,51,41
050,51,157,"Virginia","Rappahannock County",4,41,65,32,33
050,51,157,"Virginia","Rappahannock County",4,42,68,33,35
050,51,157,"Virginia","Rappahannock County",4,43,74,38,36
050,51,157,"Virginia","Rappahannock County",4,44,73,40,33
050,51,157,"Virginia","Rappahannock County",4,45,79,34,45
050,51,157,"Virginia","Rappahannock County",4,46,89,46,43
050,51,157,"Virginia","Rappahannock County",4,47,72,40,32
050,51,157,"Virginia","Rappahannock County",4,48,69,35,34
050,51,157,"Virginia","Rappahannock County",4,49,73,37,36
050,51,157,"Virginia","Rappahannock County",4,50,88,46,42
050,51,157,"Virginia","Rappahannock County",4,51,101,57,44
050,51,157,"Virginia","Rappahannock County",4,52,90,45,45
050,51,157,"Virginia","Rappahannock County",4,53,101,50,51
050,51,157,"Virginia","Rappahannock County",4,54,94,50,44
050,51,157,"Virginia","Rappahannock County",4,55,115,55,60
050,51,157,"Virginia","Rappahannock County",4,56,118,45,73
050,51,157,"Virginia","Rappahannock County",4,57,126,56,70
050,51,157,"Virginia","Rappahannock County",4,58,130,66,64
050,51,157,"Virginia","Rappahannock County",4,59,133,67,66
050,51,157,"Virginia","Rappahannock County",4,60,134,69,65
050,51,157,"Virginia","Rappahannock County",4,61,142,64,78
050,51,157,"Virginia","Rappahannock County",4,62,139,66,73
050,51,157,"Virginia","Rappahannock County",4,63,139,71,68
050,51,157,"Virginia","Rappahannock County",4,64,138,60,78
050,51,157,"Virginia","Rappahannock County",4,65,135,63,72
050,51,157,"Virginia","Rappahannock County",4,66,136,63,73
050,51,157,"Virginia","Rappahannock County",4,67,145,72,73
050,51,157,"Virginia","Rappahannock County",4,68,125,65,60
050,51,157,"Virginia","Rappahannock County",4,69,107,59,48
050,51,157,"Virginia","Rappahannock County",4,70,102,50,52
050,51,157,"Virginia","Rappahannock County",4,71,115,59,56
050,51,157,"Virginia","Rappahannock County",4,72,118,55,63
050,51,157,"Virginia","Rappahannock County",4,73,112,52,60
050,51,157,"Virginia","Rappahannock County",4,74,114,57,57
050,51,157,"Virginia","Rappahannock County",4,75,141,67,74
050,51,157,"Virginia","Rappahannock County",4,76,97,45,52
050,51,157,"Virginia","Rappahannock County",4,77,92,43,49
050,51,157,"Virginia","Rappahannock County",4,78,73,32,41
050,51,157,"Virginia","Rappahannock County",4,79,81,42,39
050,51,157,"Virginia","Rappahannock County",4,80,67,35,32
050,51,157,"Virginia","Rappahannock County",4,81,49,26,23
050,51,157,"Virginia","Rappahannock County",4,82,56,28,28
050,51,157,"Virginia","Rappahannock County",4,83,46,23,23
050,51,157,"Virginia","Rappahannock County",4,84,32,12,20
050,51,157,"Virginia","Rappahannock County",4,85,210,85,125
050,51,157,"Virginia","Rappahannock County",5,0,35,17,18
050,51,157,"Virginia","Rappahannock County",5,1,40,23,17
050,51,157,"Virginia","Rappahannock County",5,2,35,17,18
050,51,157,"Virginia","Rappahannock County",5,3,57,38,19
050,51,157,"Virginia","Rappahannock County",5,4,62,33,29
050,51,157,"Virginia","Rappahannock County",5,5,72,38,34
050,51,157,"Virginia","Rappahannock County",5,6,71,34,37
050,51,157,"Virginia","Rappahannock County",5,7,61,34,27
050,51,157,"Virginia","Rappahannock County",5,8,68,32,36
050,51,157,"Virginia","Rappahannock County",5,9,81,37,44
050,51,157,"Virginia","Rappahannock County",5,10,64,34,30
050,51,157,"Virginia","Rappahannock County",5,11,72,37,35
050,51,157,"Virginia","Rappahannock County",5,12,74,42,32
050,51,157,"Virginia","Rappahannock County",5,13,72,30,42
050,51,157,"Virginia","Rappahannock County",5,14,71,31,40
050,51,157,"Virginia","Rappahannock County",5,15,81,42,39
050,51,157,"Virginia","Rappahannock County",5,16,81,44,37
050,51,157,"Virginia","Rappahannock County",5,17,67,34,33
050,51,157,"Virginia","Rappahannock County",5,18,59,32,27
050,51,157,"Virginia","Rappahannock County",5,19,57,35,22
050,51,157,"Virginia","Rappahannock County",5,20,60,27,33
050,51,157,"Virginia","Rappahannock County",5,21,62,31,31
050,51,157,"Virginia","Rappahannock County",5,22,73,40,33
050,51,157,"Virginia","Rappahannock County",5,23,82,39,43
050,51,157,"Virginia","Rappahannock County",5,24,78,46,32
050,51,157,"Virginia","Rappahannock County",5,25,68,37,31
050,51,157,"Virginia","Rappahannock County",5,26,67,42,25
050,51,157,"Virginia","Rappahannock County",5,27,64,37,27
050,51,157,"Virginia","Rappahannock County",5,28,56,34,22
050,51,157,"Virginia","Rappahannock County",5,29,53,28,25
050,51,157,"Virginia","Rappahannock County",5,30,75,29,46
050,51,157,"Virginia","Rappahannock County",5,31,64,37,27
050,51,157,"Virginia","Rappahannock County",5,32,76,43,33
050,51,157,"Virginia","Rappahannock County",5,33,68,38,30
050,51,157,"Virginia","Rappahannock County",5,34,81,38,43
050,51,157,"Virginia","Rappahannock County",5,35,90,46,44
050,51,157,"Virginia","Rappahannock County",5,36,77,38,39
050,51,157,"Virginia","Rappahannock County",5,37,78,31,47
050,51,157,"Virginia","Rappahannock County",5,38,88,46,42
050,51,157,"Virginia","Rappahannock County",5,39,72,35,37
050,51,157,"Virginia","Rappahannock County",5,40,66,33,33
050,51,157,"Virginia","Rappahannock County",5,41,93,54,39
050,51,157,"Virginia","Rappahannock County",5,42,67,35,32
050,51,157,"Virginia","Rappahannock County",5,43,74,35,39
050,51,157,"Virginia","Rappahannock County",5,44,78,38,40
050,51,157,"Virginia","Rappahannock County",5,45,79,44,35
050,51,157,"Virginia","Rappahannock County",5,46,76,33,43
050,51,157,"Virginia","Rappahannock County",5,47,89,46,43
050,51,157,"Virginia","Rappahannock County",5,48,72,39,33
050,51,157,"Virginia","Rappahannock County",5,49,72,39,33
050,51,157,"Virginia","Rappahannock County",5,50,72,36,36
050,51,157,"Virginia","Rappahannock County",5,51,89,46,43
050,51,157,"Virginia","Rappahannock County",5,52,101,57,44
050,51,157,"Virginia","Rappahannock County",5,53,91,46,45
050,51,157,"Virginia","Rappahannock County",5,54,102,50,52
050,51,157,"Virginia","Rappahannock County",5,55,101,49,52
050,51,157,"Virginia","Rappahannock County",5,56,118,58,60
050,51,157,"Virginia","Rappahannock County",5,57,115,45,70
050,51,157,"Virginia","Rappahannock County",5,58,124,55,69
050,51,157,"Virginia","Rappahannock County",5,59,130,68,62
050,51,157,"Virginia","Rappahannock County",5,60,133,70,63
050,51,157,"Virginia","Rappahannock County",5,61,142,71,71
050,51,157,"Virginia","Rappahannock County",5,62,145,67,78
050,51,157,"Virginia","Rappahannock County",5,63,138,67,71
050,51,157,"Virginia","Rappahannock County",5,64,138,70,68
050,51,157,"Virginia","Rappahannock County",5,65,140,62,78
050,51,157,"Virginia","Rappahannock County",5,66,137,66,71
050,51,157,"Virginia","Rappahannock County",5,67,137,63,74
050,51,157,"Virginia","Rappahannock County",5,68,140,72,68
050,51,157,"Virginia","Rappahannock County",5,69,124,63,61
050,51,157,"Virginia","Rappahannock County",5,70,102,58,44
050,51,157,"Virginia","Rappahannock County",5,71,101,50,51
050,51,157,"Virginia","Rappahannock County",5,72,113,59,54
050,51,157,"Virginia","Rappahannock County",5,73,109,49,60
050,51,157,"Virginia","Rappahannock County",5,74,107,50,57
050,51,157,"Virginia","Rappahannock County",5,75,110,56,54
050,51,157,"Virginia","Rappahannock County",5,76,135,66,69
050,51,157,"Virginia","Rappahannock County",5,77,91,43,48
050,51,157,"Virginia","Rappahannock County",5,78,89,40,49
050,51,157,"Virginia","Rappahannock County",5,79,68,30,38
050,51,157,"Virginia","Rappahannock County",5,80,80,42,38
050,51,157,"Virginia","Rappahannock County",5,81,61,33,28
050,51,157,"Virginia","Rappahannock County",5,82,47,25,22
050,51,157,"Virginia","Rappahannock County",5,83,57,27,30
050,51,157,"Virginia","Rappahannock County",5,84,42,22,20
050,51,157,"Virginia","Rappahannock County",5,85,207,80,127
050,51,159,"Virginia","Richmond County",1,0,71,37,34
050,51,159,"Virginia","Richmond County",1,1,67,35,32
050,51,159,"Virginia","Richmond County",1,2,75,34,41
050,51,159,"Virginia","Richmond County",1,3,82,43,39
050,51,159,"Virginia","Richmond County",1,4,83,44,39
050,51,159,"Virginia","Richmond County",1,5,77,40,37
050,51,159,"Virginia","Richmond County",1,6,75,37,38
050,51,159,"Virginia","Richmond County",1,7,83,35,48
050,51,159,"Virginia","Richmond County",1,8,93,42,51
050,51,159,"Virginia","Richmond County",1,9,87,48,39
050,51,159,"Virginia","Richmond County",1,10,78,46,32
050,51,159,"Virginia","Richmond County",1,11,86,40,46
050,51,159,"Virginia","Richmond County",1,12,112,53,59
050,51,159,"Virginia","Richmond County",1,13,91,43,48
050,51,159,"Virginia","Richmond County",1,14,97,52,45
050,51,159,"Virginia","Richmond County",1,15,98,54,44
050,51,159,"Virginia","Richmond County",1,16,90,52,38
050,51,159,"Virginia","Richmond County",1,17,98,48,50
050,51,159,"Virginia","Richmond County",1,18,77,42,35
050,51,159,"Virginia","Richmond County",1,19,71,40,31
050,51,159,"Virginia","Richmond County",1,20,89,47,42
050,51,159,"Virginia","Richmond County",1,21,89,53,36
050,51,159,"Virginia","Richmond County",1,22,81,52,29
050,51,159,"Virginia","Richmond County",1,23,102,65,37
050,51,159,"Virginia","Richmond County",1,24,101,71,30
050,51,159,"Virginia","Richmond County",1,25,100,72,28
050,51,159,"Virginia","Richmond County",1,26,116,80,36
050,51,159,"Virginia","Richmond County",1,27,132,85,47
050,51,159,"Virginia","Richmond County",1,28,132,91,41
050,51,159,"Virginia","Richmond County",1,29,122,77,45
050,51,159,"Virginia","Richmond County",1,30,138,101,37
050,51,159,"Virginia","Richmond County",1,31,120,84,36
050,51,159,"Virginia","Richmond County",1,32,135,90,45
050,51,159,"Virginia","Richmond County",1,33,114,76,38
050,51,159,"Virginia","Richmond County",1,34,138,101,37
050,51,159,"Virginia","Richmond County",1,35,111,75,36
050,51,159,"Virginia","Richmond County",1,36,132,89,43
050,51,159,"Virginia","Richmond County",1,37,141,89,52
050,51,159,"Virginia","Richmond County",1,38,131,85,46
050,51,159,"Virginia","Richmond County",1,39,136,93,43
050,51,159,"Virginia","Richmond County",1,40,117,80,37
050,51,159,"Virginia","Richmond County",1,41,116,83,33
050,51,159,"Virginia","Richmond County",1,42,105,69,36
050,51,159,"Virginia","Richmond County",1,43,113,73,40
050,51,159,"Virginia","Richmond County",1,44,129,92,37
050,51,159,"Virginia","Richmond County",1,45,131,90,41
050,51,159,"Virginia","Richmond County",1,46,118,83,35
050,51,159,"Virginia","Richmond County",1,47,100,66,34
050,51,159,"Virginia","Richmond County",1,48,124,88,36
050,51,159,"Virginia","Richmond County",1,49,117,76,41
050,51,159,"Virginia","Richmond County",1,50,111,69,42
050,51,159,"Virginia","Richmond County",1,51,124,76,48
050,51,159,"Virginia","Richmond County",1,52,93,51,42
050,51,159,"Virginia","Richmond County",1,53,110,63,47
050,51,159,"Virginia","Richmond County",1,54,125,78,47
050,51,159,"Virginia","Richmond County",1,55,122,70,52
050,51,159,"Virginia","Richmond County",1,56,119,65,54
050,51,159,"Virginia","Richmond County",1,57,123,58,65
050,51,159,"Virginia","Richmond County",1,58,127,63,64
050,51,159,"Virginia","Richmond County",1,59,137,82,55
050,51,159,"Virginia","Richmond County",1,60,123,65,58
050,51,159,"Virginia","Richmond County",1,61,116,72,44
050,51,159,"Virginia","Richmond County",1,62,126,62,64
050,51,159,"Virginia","Richmond County",1,63,120,61,59
050,51,159,"Virginia","Richmond County",1,64,107,54,53
050,51,159,"Virginia","Richmond County",1,65,101,54,47
050,51,159,"Virginia","Richmond County",1,66,113,47,66
050,51,159,"Virginia","Richmond County",1,67,112,53,59
050,51,159,"Virginia","Richmond County",1,68,127,57,70
050,51,159,"Virginia","Richmond County",1,69,103,50,53
050,51,159,"Virginia","Richmond County",1,70,84,46,38
050,51,159,"Virginia","Richmond County",1,71,96,42,54
050,51,159,"Virginia","Richmond County",1,72,93,42,51
050,51,159,"Virginia","Richmond County",1,73,90,38,52
050,51,159,"Virginia","Richmond County",1,74,72,33,39
050,51,159,"Virginia","Richmond County",1,75,70,32,38
050,51,159,"Virginia","Richmond County",1,76,70,32,38
050,51,159,"Virginia","Richmond County",1,77,89,38,51
050,51,159,"Virginia","Richmond County",1,78,73,29,44
050,51,159,"Virginia","Richmond County",1,79,64,23,41
050,51,159,"Virginia","Richmond County",1,80,57,23,34
050,51,159,"Virginia","Richmond County",1,81,62,23,39
050,51,159,"Virginia","Richmond County",1,82,63,26,37
050,51,159,"Virginia","Richmond County",1,83,53,23,30
050,51,159,"Virginia","Richmond County",1,84,42,13,29
050,51,159,"Virginia","Richmond County",1,85,281,74,207
050,51,159,"Virginia","Richmond County",2,0,71,35,36
050,51,159,"Virginia","Richmond County",2,1,71,37,34
050,51,159,"Virginia","Richmond County",2,2,76,35,41
050,51,159,"Virginia","Richmond County",2,3,81,42,39
050,51,159,"Virginia","Richmond County",2,4,83,43,40
050,51,159,"Virginia","Richmond County",2,5,78,40,38
050,51,159,"Virginia","Richmond County",2,6,76,38,38
050,51,159,"Virginia","Richmond County",2,7,81,35,46
050,51,159,"Virginia","Richmond County",2,8,91,41,50
050,51,159,"Virginia","Richmond County",2,9,89,47,42
050,51,159,"Virginia","Richmond County",2,10,80,46,34
050,51,159,"Virginia","Richmond County",2,11,86,43,43
050,51,159,"Virginia","Richmond County",2,12,107,51,56
050,51,159,"Virginia","Richmond County",2,13,96,47,49
050,51,159,"Virginia","Richmond County",2,14,97,51,46
050,51,159,"Virginia","Richmond County",2,15,99,55,44
050,51,159,"Virginia","Richmond County",2,16,91,53,38
050,51,159,"Virginia","Richmond County",2,17,94,47,47
050,51,159,"Virginia","Richmond County",2,18,78,42,36
050,51,159,"Virginia","Richmond County",2,19,71,40,31
050,51,159,"Virginia","Richmond County",2,20,85,46,39
050,51,159,"Virginia","Richmond County",2,21,89,52,37
050,51,159,"Virginia","Richmond County",2,22,83,52,31
050,51,159,"Virginia","Richmond County",2,23,98,65,33
050,51,159,"Virginia","Richmond County",2,24,102,71,31
050,51,159,"Virginia","Richmond County",2,25,102,74,28
050,51,159,"Virginia","Richmond County",2,26,113,78,35
050,51,159,"Virginia","Richmond County",2,27,131,86,45
050,51,159,"Virginia","Richmond County",2,28,133,90,43
050,51,159,"Virginia","Richmond County",2,29,124,80,44
050,51,159,"Virginia","Richmond County",2,30,135,97,38
050,51,159,"Virginia","Richmond County",2,31,123,87,36
050,51,159,"Virginia","Richmond County",2,32,133,91,42
050,51,159,"Virginia","Richmond County",2,33,116,76,40
050,51,159,"Virginia","Richmond County",2,34,139,101,38
050,51,159,"Virginia","Richmond County",2,35,116,78,38
050,51,159,"Virginia","Richmond County",2,36,128,87,41
050,51,159,"Virginia","Richmond County",2,37,142,92,50
050,51,159,"Virginia","Richmond County",2,38,134,86,48
050,51,159,"Virginia","Richmond County",2,39,137,93,44
050,51,159,"Virginia","Richmond County",2,40,117,78,39
050,51,159,"Virginia","Richmond County",2,41,119,84,35
050,51,159,"Virginia","Richmond County",2,42,106,70,36
050,51,159,"Virginia","Richmond County",2,43,111,73,38
050,51,159,"Virginia","Richmond County",2,44,128,90,38
050,51,159,"Virginia","Richmond County",2,45,131,90,41
050,51,159,"Virginia","Richmond County",2,46,119,84,35
050,51,159,"Virginia","Richmond County",2,47,101,66,35
050,51,159,"Virginia","Richmond County",2,48,122,86,36
050,51,159,"Virginia","Richmond County",2,49,119,79,40
050,51,159,"Virginia","Richmond County",2,50,112,70,42
050,51,159,"Virginia","Richmond County",2,51,119,74,45
050,51,159,"Virginia","Richmond County",2,52,96,53,43
050,51,159,"Virginia","Richmond County",2,53,107,61,46
050,51,159,"Virginia","Richmond County",2,54,119,72,47
050,51,159,"Virginia","Richmond County",2,55,122,71,51
050,51,159,"Virginia","Richmond County",2,56,119,66,53
050,51,159,"Virginia","Richmond County",2,57,120,58,62
050,51,159,"Virginia","Richmond County",2,58,126,63,63
050,51,159,"Virginia","Richmond County",2,59,137,79,58
050,51,159,"Virginia","Richmond County",2,60,124,67,57
050,51,159,"Virginia","Richmond County",2,61,117,70,47
050,51,159,"Virginia","Richmond County",2,62,124,64,60
050,51,159,"Virginia","Richmond County",2,63,122,61,61
050,51,159,"Virginia","Richmond County",2,64,108,55,53
050,51,159,"Virginia","Richmond County",2,65,102,53,49
050,51,159,"Virginia","Richmond County",2,66,112,50,62
050,51,159,"Virginia","Richmond County",2,67,112,52,60
050,51,159,"Virginia","Richmond County",2,68,121,54,67
050,51,159,"Virginia","Richmond County",2,69,108,52,56
050,51,159,"Virginia","Richmond County",2,70,87,46,41
050,51,159,"Virginia","Richmond County",2,71,94,43,51
050,51,159,"Virginia","Richmond County",2,72,91,40,51
050,51,159,"Virginia","Richmond County",2,73,93,41,52
050,51,159,"Virginia","Richmond County",2,74,73,33,40
050,51,159,"Virginia","Richmond County",2,75,70,33,37
050,51,159,"Virginia","Richmond County",2,76,68,31,37
050,51,159,"Virginia","Richmond County",2,77,85,38,47
050,51,159,"Virginia","Richmond County",2,78,74,30,44
050,51,159,"Virginia","Richmond County",2,79,65,23,42
050,51,159,"Virginia","Richmond County",2,80,57,23,34
050,51,159,"Virginia","Richmond County",2,81,58,21,37
050,51,159,"Virginia","Richmond County",2,82,62,24,38
050,51,159,"Virginia","Richmond County",2,83,56,25,31
050,51,159,"Virginia","Richmond County",2,84,45,16,29
050,51,159,"Virginia","Richmond County",2,85,282,76,206
050,51,159,"Virginia","Richmond County",3,0,105,54,51
050,51,159,"Virginia","Richmond County",3,1,79,41,38
050,51,159,"Virginia","Richmond County",3,2,74,40,34
050,51,159,"Virginia","Richmond County",3,3,83,40,43
050,51,159,"Virginia","Richmond County",3,4,89,49,40
050,51,159,"Virginia","Richmond County",3,5,89,48,41
050,51,159,"Virginia","Richmond County",3,6,88,43,45
050,51,159,"Virginia","Richmond County",3,7,75,39,36
050,51,159,"Virginia","Richmond County",3,8,82,37,45
050,51,159,"Virginia","Richmond County",3,9,88,41,47
050,51,159,"Virginia","Richmond County",3,10,91,45,46
050,51,159,"Virginia","Richmond County",3,11,76,41,35
050,51,159,"Virginia","Richmond County",3,12,84,44,40
050,51,159,"Virginia","Richmond County",3,13,103,49,54
050,51,159,"Virginia","Richmond County",3,14,96,47,49
050,51,159,"Virginia","Richmond County",3,15,99,46,53
050,51,159,"Virginia","Richmond County",3,16,97,56,41
050,51,159,"Virginia","Richmond County",3,17,89,49,40
050,51,159,"Virginia","Richmond County",3,18,79,42,37
050,51,159,"Virginia","Richmond County",3,19,82,50,32
050,51,159,"Virginia","Richmond County",3,20,79,43,36
050,51,159,"Virginia","Richmond County",3,21,89,52,37
050,51,159,"Virginia","Richmond County",3,22,94,54,40
050,51,159,"Virginia","Richmond County",3,23,98,62,36
050,51,159,"Virginia","Richmond County",3,24,100,63,37
050,51,159,"Virginia","Richmond County",3,25,119,81,38
050,51,159,"Virginia","Richmond County",3,26,115,82,33
050,51,159,"Virginia","Richmond County",3,27,126,90,36
050,51,159,"Virginia","Richmond County",3,28,137,92,45
050,51,159,"Virginia","Richmond County",3,29,130,85,45
050,51,159,"Virginia","Richmond County",3,30,141,93,48
050,51,159,"Virginia","Richmond County",3,31,137,97,40
050,51,159,"Virginia","Richmond County",3,32,127,94,33
050,51,159,"Virginia","Richmond County",3,33,124,80,44
050,51,159,"Virginia","Richmond County",3,34,144,104,40
050,51,159,"Virginia","Richmond County",3,35,120,82,38
050,51,159,"Virginia","Richmond County",3,36,124,87,37
050,51,159,"Virginia","Richmond County",3,37,139,97,42
050,51,159,"Virginia","Richmond County",3,38,153,105,48
050,51,159,"Virginia","Richmond County",3,39,155,104,51
050,51,159,"Virginia","Richmond County",3,40,121,81,40
050,51,159,"Virginia","Richmond County",3,41,118,82,36
050,51,159,"Virginia","Richmond County",3,42,114,78,36
050,51,159,"Virginia","Richmond County",3,43,107,76,31
050,51,159,"Virginia","Richmond County",3,44,127,87,40
050,51,159,"Virginia","Richmond County",3,45,139,95,44
050,51,159,"Virginia","Richmond County",3,46,131,93,38
050,51,159,"Virginia","Richmond County",3,47,99,65,34
050,51,159,"Virginia","Richmond County",3,48,111,78,33
050,51,159,"Virginia","Richmond County",3,49,121,82,39
050,51,159,"Virginia","Richmond County",3,50,117,75,42
050,51,159,"Virginia","Richmond County",3,51,113,72,41
050,51,159,"Virginia","Richmond County",3,52,103,62,41
050,51,159,"Virginia","Richmond County",3,53,105,62,43
050,51,159,"Virginia","Richmond County",3,54,102,55,47
050,51,159,"Virginia","Richmond County",3,55,118,70,48
050,51,159,"Virginia","Richmond County",3,56,117,69,48
050,51,159,"Virginia","Richmond County",3,57,110,58,52
050,51,159,"Virginia","Richmond County",3,58,121,62,59
050,51,159,"Virginia","Richmond County",3,59,137,73,64
050,51,159,"Virginia","Richmond County",3,60,127,69,58
050,51,159,"Virginia","Richmond County",3,61,131,73,58
050,51,159,"Virginia","Richmond County",3,62,117,67,50
050,51,159,"Virginia","Richmond County",3,63,116,57,59
050,51,159,"Virginia","Richmond County",3,64,128,59,69
050,51,159,"Virginia","Richmond County",3,65,113,56,57
050,51,159,"Virginia","Richmond County",3,66,110,60,50
050,51,159,"Virginia","Richmond County",3,67,112,49,63
050,51,159,"Virginia","Richmond County",3,68,107,48,59
050,51,159,"Virginia","Richmond County",3,69,120,56,64
050,51,159,"Virginia","Richmond County",3,70,101,48,53
050,51,159,"Virginia","Richmond County",3,71,85,42,43
050,51,159,"Virginia","Richmond County",3,72,93,42,51
050,51,159,"Virginia","Richmond County",3,73,87,38,49
050,51,159,"Virginia","Richmond County",3,74,88,38,50
050,51,159,"Virginia","Richmond County",3,75,70,33,37
050,51,159,"Virginia","Richmond County",3,76,66,29,37
050,51,159,"Virginia","Richmond County",3,77,66,29,37
050,51,159,"Virginia","Richmond County",3,78,85,36,49
050,51,159,"Virginia","Richmond County",3,79,73,27,46
050,51,159,"Virginia","Richmond County",3,80,62,24,38
050,51,159,"Virginia","Richmond County",3,81,51,19,32
050,51,159,"Virginia","Richmond County",3,82,49,17,32
050,51,159,"Virginia","Richmond County",3,83,60,22,38
050,51,159,"Virginia","Richmond County",3,84,52,22,30
050,51,159,"Virginia","Richmond County",3,85,278,72,206
050,51,159,"Virginia","Richmond County",4,0,93,44,49
050,51,159,"Virginia","Richmond County",4,1,104,54,50
050,51,159,"Virginia","Richmond County",4,2,81,42,39
050,51,159,"Virginia","Richmond County",4,3,77,42,35
050,51,159,"Virginia","Richmond County",4,4,85,38,47
050,51,159,"Virginia","Richmond County",4,5,101,58,43
050,51,159,"Virginia","Richmond County",4,6,89,49,40
050,51,159,"Virginia","Richmond County",4,7,97,49,48
050,51,159,"Virginia","Richmond County",4,8,78,40,38
050,51,159,"Virginia","Richmond County",4,9,83,39,44
050,51,159,"Virginia","Richmond County",4,10,90,41,49
050,51,159,"Virginia","Richmond County",4,11,96,49,47
050,51,159,"Virginia","Richmond County",4,12,84,47,37
050,51,159,"Virginia","Richmond County",4,13,78,41,37
050,51,159,"Virginia","Richmond County",4,14,105,49,56
050,51,159,"Virginia","Richmond County",4,15,94,48,46
050,51,159,"Virginia","Richmond County",4,16,95,44,51
050,51,159,"Virginia","Richmond County",4,17,99,53,46
050,51,159,"Virginia","Richmond County",4,18,81,46,35
050,51,159,"Virginia","Richmond County",4,19,75,42,33
050,51,159,"Virginia","Richmond County",4,20,88,55,33
050,51,159,"Virginia","Richmond County",4,21,79,42,37
050,51,159,"Virginia","Richmond County",4,22,94,57,37
050,51,159,"Virginia","Richmond County",4,23,118,68,50
050,51,159,"Virginia","Richmond County",4,24,106,63,43
050,51,159,"Virginia","Richmond County",4,25,100,61,39
050,51,159,"Virginia","Richmond County",4,26,133,92,41
050,51,159,"Virginia","Richmond County",4,27,125,87,38
050,51,159,"Virginia","Richmond County",4,28,130,94,36
050,51,159,"Virginia","Richmond County",4,29,138,93,45
050,51,159,"Virginia","Richmond County",4,30,143,95,48
050,51,159,"Virginia","Richmond County",4,31,133,88,45
050,51,159,"Virginia","Richmond County",4,32,143,105,38
050,51,159,"Virginia","Richmond County",4,33,102,72,30
050,51,159,"Virginia","Richmond County",4,34,147,96,51
050,51,159,"Virginia","Richmond County",4,35,123,82,41
050,51,159,"Virginia","Richmond County",4,36,126,89,37
050,51,159,"Virginia","Richmond County",4,37,147,94,53
050,51,159,"Virginia","Richmond County",4,38,135,90,45
050,51,159,"Virginia","Richmond County",4,39,156,113,43
050,51,159,"Virginia","Richmond County",4,40,138,88,50
050,51,159,"Virginia","Richmond County",4,41,123,83,40
050,51,159,"Virginia","Richmond County",4,42,104,73,31
050,51,159,"Virginia","Richmond County",4,43,118,80,38
050,51,159,"Virginia","Richmond County",4,44,113,80,33
050,51,159,"Virginia","Richmond County",4,45,129,88,41
050,51,159,"Virginia","Richmond County",4,46,137,91,46
050,51,159,"Virginia","Richmond County",4,47,110,72,38
050,51,159,"Virginia","Richmond County",4,48,106,75,31
050,51,159,"Virginia","Richmond County",4,49,108,73,35
050,51,159,"Virginia","Richmond County",4,50,120,77,43
050,51,159,"Virginia","Richmond County",4,51,112,71,41
050,51,159,"Virginia","Richmond County",4,52,104,62,42
050,51,159,"Virginia","Richmond County",4,53,113,69,44
050,51,159,"Virginia","Richmond County",4,54,97,55,42
050,51,159,"Virginia","Richmond County",4,55,99,47,52
050,51,159,"Virginia","Richmond County",4,56,110,62,48
050,51,159,"Virginia","Richmond County",4,57,113,65,48
050,51,159,"Virginia","Richmond County",4,58,107,59,48
050,51,159,"Virginia","Richmond County",4,59,122,63,59
050,51,159,"Virginia","Richmond County",4,60,129,68,61
050,51,159,"Virginia","Richmond County",4,61,119,67,52
050,51,159,"Virginia","Richmond County",4,62,134,76,58
050,51,159,"Virginia","Richmond County",4,63,114,61,53
050,51,159,"Virginia","Richmond County",4,64,114,54,60
050,51,159,"Virginia","Richmond County",4,65,128,56,72
050,51,159,"Virginia","Richmond County",4,66,115,59,56
050,51,159,"Virginia","Richmond County",4,67,114,63,51
050,51,159,"Virginia","Richmond County",4,68,113,46,67
050,51,159,"Virginia","Richmond County",4,69,107,53,54
050,51,159,"Virginia","Richmond County",4,70,111,55,56
050,51,159,"Virginia","Richmond County",4,71,99,45,54
050,51,159,"Virginia","Richmond County",4,72,83,42,41
050,51,159,"Virginia","Richmond County",4,73,90,40,50
050,51,159,"Virginia","Richmond County",4,74,82,35,47
050,51,159,"Virginia","Richmond County",4,75,90,41,49
050,51,159,"Virginia","Richmond County",4,76,67,30,37
050,51,159,"Virginia","Richmond County",4,77,64,29,35
050,51,159,"Virginia","Richmond County",4,78,66,29,37
050,51,159,"Virginia","Richmond County",4,79,85,35,50
050,51,159,"Virginia","Richmond County",4,80,69,28,41
050,51,159,"Virginia","Richmond County",4,81,56,18,38
050,51,159,"Virginia","Richmond County",4,82,46,15,31
050,51,159,"Virginia","Richmond County",4,83,51,17,34
050,51,159,"Virginia","Richmond County",4,84,58,21,37
050,51,159,"Virginia","Richmond County",4,85,288,78,210
050,51,159,"Virginia","Richmond County",5,0,93,45,48
050,51,159,"Virginia","Richmond County",5,1,92,46,46
050,51,159,"Virginia","Richmond County",5,2,118,58,60
050,51,159,"Virginia","Richmond County",5,3,81,40,41
050,51,159,"Virginia","Richmond County",5,4,92,49,43
050,51,159,"Virginia","Richmond County",5,5,90,47,43
050,51,159,"Virginia","Richmond County",5,6,102,59,43
050,51,159,"Virginia","Richmond County",5,7,92,49,43
050,51,159,"Virginia","Richmond County",5,8,95,44,51
050,51,159,"Virginia","Richmond County",5,9,83,43,40
050,51,159,"Virginia","Richmond County",5,10,86,42,44
050,51,159,"Virginia","Richmond County",5,11,97,46,51
050,51,159,"Virginia","Richmond County",5,12,89,50,39
050,51,159,"Virginia","Richmond County",5,13,93,51,42
050,51,159,"Virginia","Richmond County",5,14,78,42,36
050,51,159,"Virginia","Richmond County",5,15,108,50,58
050,51,159,"Virginia","Richmond County",5,16,96,50,46
050,51,159,"Virginia","Richmond County",5,17,98,41,57
050,51,159,"Virginia","Richmond County",5,18,85,49,36
050,51,159,"Virginia","Richmond County",5,19,74,48,26
050,51,159,"Virginia","Richmond County",5,20,76,42,34
050,51,159,"Virginia","Richmond County",5,21,94,56,38
050,51,159,"Virginia","Richmond County",5,22,88,47,41
050,51,159,"Virginia","Richmond County",5,23,114,74,40
050,51,159,"Virginia","Richmond County",5,24,108,58,50
050,51,159,"Virginia","Richmond County",5,25,108,64,44
050,51,159,"Virginia","Richmond County",5,26,117,74,43
050,51,159,"Virginia","Richmond County",5,27,151,104,47
050,51,159,"Virginia","Richmond County",5,28,115,81,34
050,51,159,"Virginia","Richmond County",5,29,125,88,37
050,51,159,"Virginia","Richmond County",5,30,144,98,46
050,51,159,"Virginia","Richmond County",5,31,137,91,46
050,51,159,"Virginia","Richmond County",5,32,145,98,47
050,51,159,"Virginia","Richmond County",5,33,127,91,36
050,51,159,"Virginia","Richmond County",5,34,119,87,32
050,51,159,"Virginia","Richmond County",5,35,127,75,52
050,51,159,"Virginia","Richmond County",5,36,125,82,43
050,51,159,"Virginia","Richmond County",5,37,142,98,44
050,51,159,"Virginia","Richmond County",5,38,149,95,54
050,51,159,"Virginia","Richmond County",5,39,142,101,41
050,51,159,"Virginia","Richmond County",5,40,138,98,40
050,51,159,"Virginia","Richmond County",5,41,139,90,49
050,51,159,"Virginia","Richmond County",5,42,112,72,40
050,51,159,"Virginia","Richmond County",5,43,110,77,33
050,51,159,"Virginia","Richmond County",5,44,130,90,40
050,51,159,"Virginia","Richmond County",5,45,117,85,32
050,51,159,"Virginia","Richmond County",5,46,119,79,40
050,51,159,"Virginia","Richmond County",5,47,119,75,44
050,51,159,"Virginia","Richmond County",5,48,115,76,39
050,51,159,"Virginia","Richmond County",5,49,100,71,29
050,51,159,"Virginia","Richmond County",5,50,108,67,41
050,51,159,"Virginia","Richmond County",5,51,125,82,43
050,51,159,"Virginia","Richmond County",5,52,96,58,38
050,51,159,"Virginia","Richmond County",5,53,109,69,40
050,51,159,"Virginia","Richmond County",5,54,111,64,47
050,51,159,"Virginia","Richmond County",5,55,93,53,40
050,51,159,"Virginia","Richmond County",5,56,94,44,50
050,51,159,"Virginia","Richmond County",5,57,106,55,51
050,51,159,"Virginia","Richmond County",5,58,109,65,44
050,51,159,"Virginia","Richmond County",5,59,117,65,52
050,51,159,"Virginia","Richmond County",5,60,123,63,60
050,51,159,"Virginia","Richmond County",5,61,129,70,59
050,51,159,"Virginia","Richmond County",5,62,114,64,50
050,51,159,"Virginia","Richmond County",5,63,127,69,58
050,51,159,"Virginia","Richmond County",5,64,109,60,49
050,51,159,"Virginia","Richmond County",5,65,112,51,61
050,51,159,"Virginia","Richmond County",5,66,131,60,71
050,51,159,"Virginia","Richmond County",5,67,114,56,58
050,51,159,"Virginia","Richmond County",5,68,116,60,56
050,51,159,"Virginia","Richmond County",5,69,115,50,65
050,51,159,"Virginia","Richmond County",5,70,97,47,50
050,51,159,"Virginia","Richmond County",5,71,107,52,55
050,51,159,"Virginia","Richmond County",5,72,102,45,57
050,51,159,"Virginia","Richmond County",5,73,81,40,41
050,51,159,"Virginia","Richmond County",5,74,80,34,46
050,51,159,"Virginia","Richmond County",5,75,83,36,47
050,51,159,"Virginia","Richmond County",5,76,89,39,50
050,51,159,"Virginia","Richmond County",5,77,67,28,39
050,51,159,"Virginia","Richmond County",5,78,64,30,34
050,51,159,"Virginia","Richmond County",5,79,65,27,38
050,51,159,"Virginia","Richmond County",5,80,83,37,46
050,51,159,"Virginia","Richmond County",5,81,63,22,41
050,51,159,"Virginia","Richmond County",5,82,51,14,37
050,51,159,"Virginia","Richmond County",5,83,45,15,30
050,51,159,"Virginia","Richmond County",5,84,50,17,33
050,51,159,"Virginia","Richmond County",5,85,305,88,217
050,51,161,"Virginia","Roanoke County",1,0,798,404,394
050,51,161,"Virginia","Roanoke County",1,1,869,457,412
050,51,161,"Virginia","Roanoke County",1,2,878,469,409
050,51,161,"Virginia","Roanoke County",1,3,982,505,477
050,51,161,"Virginia","Roanoke County",1,4,975,497,478
050,51,161,"Virginia","Roanoke County",1,5,1001,532,469
050,51,161,"Virginia","Roanoke County",1,6,1038,565,473
050,51,161,"Virginia","Roanoke County",1,7,1065,545,520
050,51,161,"Virginia","Roanoke County",1,8,1065,555,510
050,51,161,"Virginia","Roanoke County",1,9,1135,595,540
050,51,161,"Virginia","Roanoke County",1,10,1174,598,576
050,51,161,"Virginia","Roanoke County",1,11,1166,620,546
050,51,161,"Virginia","Roanoke County",1,12,1235,640,595
050,51,161,"Virginia","Roanoke County",1,13,1248,643,605
050,51,161,"Virginia","Roanoke County",1,14,1231,638,593
050,51,161,"Virginia","Roanoke County",1,15,1231,622,609
050,51,161,"Virginia","Roanoke County",1,16,1259,624,635
050,51,161,"Virginia","Roanoke County",1,17,1249,625,624
050,51,161,"Virginia","Roanoke County",1,18,1125,585,540
050,51,161,"Virginia","Roanoke County",1,19,1001,454,547
050,51,161,"Virginia","Roanoke County",1,20,1052,516,536
050,51,161,"Virginia","Roanoke County",1,21,1096,534,562
050,51,161,"Virginia","Roanoke County",1,22,1059,520,539
050,51,161,"Virginia","Roanoke County",1,23,1000,487,513
050,51,161,"Virginia","Roanoke County",1,24,1046,541,505
050,51,161,"Virginia","Roanoke County",1,25,1070,538,532
050,51,161,"Virginia","Roanoke County",1,26,1096,553,543
050,51,161,"Virginia","Roanoke County",1,27,1110,563,547
050,51,161,"Virginia","Roanoke County",1,28,1137,565,572
050,51,161,"Virginia","Roanoke County",1,29,1186,579,607
050,51,161,"Virginia","Roanoke County",1,30,1124,553,571
050,51,161,"Virginia","Roanoke County",1,31,1063,551,512
050,51,161,"Virginia","Roanoke County",1,32,1067,522,545
050,51,161,"Virginia","Roanoke County",1,33,1139,571,568
050,51,161,"Virginia","Roanoke County",1,34,1202,576,626
050,51,161,"Virginia","Roanoke County",1,35,1148,587,561
050,51,161,"Virginia","Roanoke County",1,36,1156,586,570
050,51,161,"Virginia","Roanoke County",1,37,1191,581,610
050,51,161,"Virginia","Roanoke County",1,38,1213,590,623
050,51,161,"Virginia","Roanoke County",1,39,1146,562,584
050,51,161,"Virginia","Roanoke County",1,40,1112,560,552
050,51,161,"Virginia","Roanoke County",1,41,1155,605,550
050,51,161,"Virginia","Roanoke County",1,42,1212,618,594
050,51,161,"Virginia","Roanoke County",1,43,1126,550,576
050,51,161,"Virginia","Roanoke County",1,44,1179,565,614
050,51,161,"Virginia","Roanoke County",1,45,1187,580,607
050,51,161,"Virginia","Roanoke County",1,46,1159,601,558
050,51,161,"Virginia","Roanoke County",1,47,1243,630,613
050,51,161,"Virginia","Roanoke County",1,48,1331,655,676
050,51,161,"Virginia","Roanoke County",1,49,1463,701,762
050,51,161,"Virginia","Roanoke County",1,50,1398,691,707
050,51,161,"Virginia","Roanoke County",1,51,1267,647,620
050,51,161,"Virginia","Roanoke County",1,52,1247,632,615
050,51,161,"Virginia","Roanoke County",1,53,1256,630,626
050,51,161,"Virginia","Roanoke County",1,54,1264,597,667
050,51,161,"Virginia","Roanoke County",1,55,1337,632,705
050,51,161,"Virginia","Roanoke County",1,56,1418,709,709
050,51,161,"Virginia","Roanoke County",1,57,1401,689,712
050,51,161,"Virginia","Roanoke County",1,58,1429,682,747
050,51,161,"Virginia","Roanoke County",1,59,1362,638,724
050,51,161,"Virginia","Roanoke County",1,60,1340,671,669
050,51,161,"Virginia","Roanoke County",1,61,1367,665,702
050,51,161,"Virginia","Roanoke County",1,62,1372,663,709
050,51,161,"Virginia","Roanoke County",1,63,1319,625,694
050,51,161,"Virginia","Roanoke County",1,64,1297,594,703
050,51,161,"Virginia","Roanoke County",1,65,1344,634,710
050,51,161,"Virginia","Roanoke County",1,66,1292,624,668
050,51,161,"Virginia","Roanoke County",1,67,1276,601,675
050,51,161,"Virginia","Roanoke County",1,68,1284,598,686
050,51,161,"Virginia","Roanoke County",1,69,1195,571,624
050,51,161,"Virginia","Roanoke County",1,70,1196,550,646
050,51,161,"Virginia","Roanoke County",1,71,1158,517,641
050,51,161,"Virginia","Roanoke County",1,72,1229,543,686
050,51,161,"Virginia","Roanoke County",1,73,1274,586,688
050,51,161,"Virginia","Roanoke County",1,74,852,392,460
050,51,161,"Virginia","Roanoke County",1,75,780,352,428
050,51,161,"Virginia","Roanoke County",1,76,817,361,456
050,51,161,"Virginia","Roanoke County",1,77,827,369,458
050,51,161,"Virginia","Roanoke County",1,78,700,317,383
050,51,161,"Virginia","Roanoke County",1,79,613,268,345
050,51,161,"Virginia","Roanoke County",1,80,550,218,332
050,51,161,"Virginia","Roanoke County",1,81,567,224,343
050,51,161,"Virginia","Roanoke County",1,82,493,188,305
050,51,161,"Virginia","Roanoke County",1,83,435,170,265
050,51,161,"Virginia","Roanoke County",1,84,412,149,263
050,51,161,"Virginia","Roanoke County",1,85,2370,779,1591
050,51,161,"Virginia","Roanoke County",2,0,770,389,381
050,51,161,"Virginia","Roanoke County",2,1,854,447,407
050,51,161,"Virginia","Roanoke County",2,2,890,471,419
050,51,161,"Virginia","Roanoke County",2,3,955,495,460
050,51,161,"Virginia","Roanoke County",2,4,982,499,483
050,51,161,"Virginia","Roanoke County",2,5,1001,529,472
050,51,161,"Virginia","Roanoke County",2,6,1037,559,478
050,51,161,"Virginia","Roanoke County",2,7,1062,552,510
050,51,161,"Virginia","Roanoke County",2,8,1064,554,510
050,51,161,"Virginia","Roanoke County",2,9,1122,586,536
050,51,161,"Virginia","Roanoke County",2,10,1167,598,569
050,51,161,"Virginia","Roanoke County",2,11,1174,621,553
050,51,161,"Virginia","Roanoke County",2,12,1225,640,585
050,51,161,"Virginia","Roanoke County",2,13,1243,639,604
050,51,161,"Virginia","Roanoke County",2,14,1241,640,601
050,51,161,"Virginia","Roanoke County",2,15,1234,625,609
050,51,161,"Virginia","Roanoke County",2,16,1256,625,631
050,51,161,"Virginia","Roanoke County",2,17,1250,625,625
050,51,161,"Virginia","Roanoke County",2,18,1109,569,540
050,51,161,"Virginia","Roanoke County",2,19,1010,460,550
050,51,161,"Virginia","Roanoke County",2,20,1056,518,538
050,51,161,"Virginia","Roanoke County",2,21,1085,530,555
050,51,161,"Virginia","Roanoke County",2,22,1065,525,540
050,51,161,"Virginia","Roanoke County",2,23,1007,496,511
050,51,161,"Virginia","Roanoke County",2,24,1039,532,507
050,51,161,"Virginia","Roanoke County",2,25,1060,536,524
050,51,161,"Virginia","Roanoke County",2,26,1087,549,538
050,51,161,"Virginia","Roanoke County",2,27,1110,567,543
050,51,161,"Virginia","Roanoke County",2,28,1140,568,572
050,51,161,"Virginia","Roanoke County",2,29,1179,576,603
050,51,161,"Virginia","Roanoke County",2,30,1146,564,582
050,51,161,"Virginia","Roanoke County",2,31,1067,547,520
050,51,161,"Virginia","Roanoke County",2,32,1072,534,538
050,51,161,"Virginia","Roanoke County",2,33,1129,561,568
050,51,161,"Virginia","Roanoke County",2,34,1198,585,613
050,51,161,"Virginia","Roanoke County",2,35,1175,591,584
050,51,161,"Virginia","Roanoke County",2,36,1155,585,570
050,51,161,"Virginia","Roanoke County",2,37,1196,587,609
050,51,161,"Virginia","Roanoke County",2,38,1216,590,626
050,51,161,"Virginia","Roanoke County",2,39,1171,574,597
050,51,161,"Virginia","Roanoke County",2,40,1129,566,563
050,51,161,"Virginia","Roanoke County",2,41,1145,597,548
050,51,161,"Virginia","Roanoke County",2,42,1201,619,582
050,51,161,"Virginia","Roanoke County",2,43,1159,572,587
050,51,161,"Virginia","Roanoke County",2,44,1155,559,596
050,51,161,"Virginia","Roanoke County",2,45,1184,576,608
050,51,161,"Virginia","Roanoke County",2,46,1170,598,572
050,51,161,"Virginia","Roanoke County",2,47,1213,616,597
050,51,161,"Virginia","Roanoke County",2,48,1309,649,660
050,51,161,"Virginia","Roanoke County",2,49,1438,695,743
050,51,161,"Virginia","Roanoke County",2,50,1410,695,715
050,51,161,"Virginia","Roanoke County",2,51,1293,654,639
050,51,161,"Virginia","Roanoke County",2,52,1239,627,612
050,51,161,"Virginia","Roanoke County",2,53,1253,628,625
050,51,161,"Virginia","Roanoke County",2,54,1259,604,655
050,51,161,"Virginia","Roanoke County",2,55,1317,622,695
050,51,161,"Virginia","Roanoke County",2,56,1395,689,706
050,51,161,"Virginia","Roanoke County",2,57,1408,694,714
050,51,161,"Virginia","Roanoke County",2,58,1419,681,738
050,51,161,"Virginia","Roanoke County",2,59,1384,653,731
050,51,161,"Virginia","Roanoke County",2,60,1342,659,683
050,51,161,"Virginia","Roanoke County",2,61,1351,664,687
050,51,161,"Virginia","Roanoke County",2,62,1369,663,706
050,51,161,"Virginia","Roanoke County",2,63,1340,637,703
050,51,161,"Virginia","Roanoke County",2,64,1289,593,696
050,51,161,"Virginia","Roanoke County",2,65,1328,622,706
050,51,161,"Virginia","Roanoke County",2,66,1305,628,677
050,51,161,"Virginia","Roanoke County",2,67,1276,605,671
050,51,161,"Virginia","Roanoke County",2,68,1266,593,673
050,51,161,"Virginia","Roanoke County",2,69,1224,580,644
050,51,161,"Virginia","Roanoke County",2,70,1187,551,636
050,51,161,"Virginia","Roanoke County",2,71,1169,525,644
050,51,161,"Virginia","Roanoke County",2,72,1191,526,665
050,51,161,"Virginia","Roanoke County",2,73,1324,604,720
050,51,161,"Virginia","Roanoke County",2,74,893,412,481
050,51,161,"Virginia","Roanoke County",2,75,797,360,437
050,51,161,"Virginia","Roanoke County",2,76,791,350,441
050,51,161,"Virginia","Roanoke County",2,77,838,370,468
050,51,161,"Virginia","Roanoke County",2,78,714,322,392
050,51,161,"Virginia","Roanoke County",2,79,624,275,349
050,51,161,"Virginia","Roanoke County",2,80,559,228,331
050,51,161,"Virginia","Roanoke County",2,81,547,216,331
050,51,161,"Virginia","Roanoke County",2,82,506,192,314
050,51,161,"Virginia","Roanoke County",2,83,437,167,270
050,51,161,"Virginia","Roanoke County",2,84,406,147,259
050,51,161,"Virginia","Roanoke County",2,85,2371,782,1589
050,51,161,"Virginia","Roanoke County",3,0,700,353,347
050,51,161,"Virginia","Roanoke County",3,1,826,396,430
050,51,161,"Virginia","Roanoke County",3,2,875,450,425
050,51,161,"Virginia","Roanoke County",3,3,920,494,426
050,51,161,"Virginia","Roanoke County",3,4,966,492,474
050,51,161,"Virginia","Roanoke County",3,5,1018,512,506
050,51,161,"Virginia","Roanoke County",3,6,1003,525,478
050,51,161,"Virginia","Roanoke County",3,7,1041,542,499
050,51,161,"Virginia","Roanoke County",3,8,1070,557,513
050,51,161,"Virginia","Roanoke County",3,9,1065,551,514
050,51,161,"Virginia","Roanoke County",3,10,1115,576,539
050,51,161,"Virginia","Roanoke County",3,11,1166,606,560
050,51,161,"Virginia","Roanoke County",3,12,1177,617,560
050,51,161,"Virginia","Roanoke County",3,13,1233,639,594
050,51,161,"Virginia","Roanoke County",3,14,1261,638,623
050,51,161,"Virginia","Roanoke County",3,15,1254,650,604
050,51,161,"Virginia","Roanoke County",3,16,1215,621,594
050,51,161,"Virginia","Roanoke County",3,17,1250,631,619
050,51,161,"Virginia","Roanoke County",3,18,1112,548,564
050,51,161,"Virginia","Roanoke County",3,19,1016,462,554
050,51,161,"Virginia","Roanoke County",3,20,1038,513,525
050,51,161,"Virginia","Roanoke County",3,21,1081,525,556
050,51,161,"Virginia","Roanoke County",3,22,1092,545,547
050,51,161,"Virginia","Roanoke County",3,23,1072,550,522
050,51,161,"Virginia","Roanoke County",3,24,1039,522,517
050,51,161,"Virginia","Roanoke County",3,25,1034,526,508
050,51,161,"Virginia","Roanoke County",3,26,1023,499,524
050,51,161,"Virginia","Roanoke County",3,27,1109,559,550
050,51,161,"Virginia","Roanoke County",3,28,1155,576,579
050,51,161,"Virginia","Roanoke County",3,29,1155,569,586
050,51,161,"Virginia","Roanoke County",3,30,1180,583,597
050,51,161,"Virginia","Roanoke County",3,31,1155,566,589
050,51,161,"Virginia","Roanoke County",3,32,1124,561,563
050,51,161,"Virginia","Roanoke County",3,33,1092,525,567
050,51,161,"Virginia","Roanoke County",3,34,1145,576,569
050,51,161,"Virginia","Roanoke County",3,35,1208,580,628
050,51,161,"Virginia","Roanoke County",3,36,1209,614,595
050,51,161,"Virginia","Roanoke County",3,37,1182,606,576
050,51,161,"Virginia","Roanoke County",3,38,1151,555,596
050,51,161,"Virginia","Roanoke County",3,39,1233,606,627
050,51,161,"Virginia","Roanoke County",3,40,1198,584,614
050,51,161,"Virginia","Roanoke County",3,41,1142,568,574
050,51,161,"Virginia","Roanoke County",3,42,1179,622,557
050,51,161,"Virginia","Roanoke County",3,43,1185,606,579
050,51,161,"Virginia","Roanoke County",3,44,1127,564,563
050,51,161,"Virginia","Roanoke County",3,45,1150,565,585
050,51,161,"Virginia","Roanoke County",3,46,1195,591,604
050,51,161,"Virginia","Roanoke County",3,47,1154,583,571
050,51,161,"Virginia","Roanoke County",3,48,1187,605,582
050,51,161,"Virginia","Roanoke County",3,49,1313,654,659
050,51,161,"Virginia","Roanoke County",3,50,1445,703,742
050,51,161,"Virginia","Roanoke County",3,51,1405,680,725
050,51,161,"Virginia","Roanoke County",3,52,1271,648,623
050,51,161,"Virginia","Roanoke County",3,53,1241,625,616
050,51,161,"Virginia","Roanoke County",3,54,1242,609,633
050,51,161,"Virginia","Roanoke County",3,55,1268,601,667
050,51,161,"Virginia","Roanoke County",3,56,1315,623,692
050,51,161,"Virginia","Roanoke County",3,57,1384,688,696
050,51,161,"Virginia","Roanoke County",3,58,1392,680,712
050,51,161,"Virginia","Roanoke County",3,59,1398,675,723
050,51,161,"Virginia","Roanoke County",3,60,1364,645,719
050,51,161,"Virginia","Roanoke County",3,61,1325,650,675
050,51,161,"Virginia","Roanoke County",3,62,1363,669,694
050,51,161,"Virginia","Roanoke County",3,63,1325,633,692
050,51,161,"Virginia","Roanoke County",3,64,1314,625,689
050,51,161,"Virginia","Roanoke County",3,65,1264,593,671
050,51,161,"Virginia","Roanoke County",3,66,1319,607,712
050,51,161,"Virginia","Roanoke County",3,67,1284,618,666
050,51,161,"Virginia","Roanoke County",3,68,1251,598,653
050,51,161,"Virginia","Roanoke County",3,69,1253,577,676
050,51,161,"Virginia","Roanoke County",3,70,1205,567,638
050,51,161,"Virginia","Roanoke County",3,71,1159,524,635
050,51,161,"Virginia","Roanoke County",3,72,1152,512,640
050,51,161,"Virginia","Roanoke County",3,73,1166,505,661
050,51,161,"Virginia","Roanoke County",3,74,1290,585,705
050,51,161,"Virginia","Roanoke County",3,75,852,384,468
050,51,161,"Virginia","Roanoke County",3,76,768,357,411
050,51,161,"Virginia","Roanoke County",3,77,774,331,443
050,51,161,"Virginia","Roanoke County",3,78,798,346,452
050,51,161,"Virginia","Roanoke County",3,79,683,307,376
050,51,161,"Virginia","Roanoke County",3,80,602,263,339
050,51,161,"Virginia","Roanoke County",3,81,521,214,307
050,51,161,"Virginia","Roanoke County",3,82,516,195,321
050,51,161,"Virginia","Roanoke County",3,83,457,174,283
050,51,161,"Virginia","Roanoke County",3,84,399,148,251
050,51,161,"Virginia","Roanoke County",3,85,2316,764,1552
050,51,161,"Virginia","Roanoke County",4,0,706,374,332
050,51,161,"Virginia","Roanoke County",4,1,772,380,392
050,51,161,"Virginia","Roanoke County",4,2,860,425,435
050,51,161,"Virginia","Roanoke County",4,3,915,474,441
050,51,161,"Virginia","Roanoke County",4,4,961,513,448
050,51,161,"Virginia","Roanoke County",4,5,989,495,494
050,51,161,"Virginia","Roanoke County",4,6,1032,520,512
050,51,161,"Virginia","Roanoke County",4,7,1028,529,499
050,51,161,"Virginia","Roanoke County",4,8,1060,558,502
050,51,161,"Virginia","Roanoke County",4,9,1086,553,533
050,51,161,"Virginia","Roanoke County",4,10,1083,570,513
050,51,161,"Virginia","Roanoke County",4,11,1147,601,546
050,51,161,"Virginia","Roanoke County",4,12,1164,607,557
050,51,161,"Virginia","Roanoke County",4,13,1184,622,562
050,51,161,"Virginia","Roanoke County",4,14,1245,652,593
050,51,161,"Virginia","Roanoke County",4,15,1244,638,606
050,51,161,"Virginia","Roanoke County",4,16,1250,652,598
050,51,161,"Virginia","Roanoke County",4,17,1215,633,582
050,51,161,"Virginia","Roanoke County",4,18,1108,540,568
050,51,161,"Virginia","Roanoke County",4,19,984,435,549
050,51,161,"Virginia","Roanoke County",4,20,1033,515,518
050,51,161,"Virginia","Roanoke County",4,21,1065,514,551
050,51,161,"Virginia","Roanoke County",4,22,1075,534,541
050,51,161,"Virginia","Roanoke County",4,23,1077,545,532
050,51,161,"Virginia","Roanoke County",4,24,1101,561,540
050,51,161,"Virginia","Roanoke County",4,25,1023,499,524
050,51,161,"Virginia","Roanoke County",4,26,1062,540,522
050,51,161,"Virginia","Roanoke County",4,27,1062,524,538
050,51,161,"Virginia","Roanoke County",4,28,1151,583,568
050,51,161,"Virginia","Roanoke County",4,29,1164,551,613
050,51,161,"Virginia","Roanoke County",4,30,1196,597,599
050,51,161,"Virginia","Roanoke County",4,31,1229,619,610
050,51,161,"Virginia","Roanoke County",4,32,1176,576,600
050,51,161,"Virginia","Roanoke County",4,33,1188,584,604
050,51,161,"Virginia","Roanoke County",4,34,1135,560,575
050,51,161,"Virginia","Roanoke County",4,35,1192,592,600
050,51,161,"Virginia","Roanoke County",4,36,1210,582,628
050,51,161,"Virginia","Roanoke County",4,37,1225,617,608
050,51,161,"Virginia","Roanoke County",4,38,1185,587,598
050,51,161,"Virginia","Roanoke County",4,39,1188,586,602
050,51,161,"Virginia","Roanoke County",4,40,1228,599,629
050,51,161,"Virginia","Roanoke County",4,41,1225,610,615
050,51,161,"Virginia","Roanoke County",4,42,1170,603,567
050,51,161,"Virginia","Roanoke County",4,43,1181,605,576
050,51,161,"Virginia","Roanoke County",4,44,1207,610,597
050,51,161,"Virginia","Roanoke County",4,45,1115,558,557
050,51,161,"Virginia","Roanoke County",4,46,1177,578,599
050,51,161,"Virginia","Roanoke County",4,47,1193,593,600
050,51,161,"Virginia","Roanoke County",4,48,1115,564,551
050,51,161,"Virginia","Roanoke County",4,49,1198,608,590
050,51,161,"Virginia","Roanoke County",4,50,1313,647,666
050,51,161,"Virginia","Roanoke County",4,51,1414,691,723
050,51,161,"Virginia","Roanoke County",4,52,1394,683,711
050,51,161,"Virginia","Roanoke County",4,53,1267,652,615
050,51,161,"Virginia","Roanoke County",4,54,1230,608,622
050,51,161,"Virginia","Roanoke County",4,55,1230,593,637
050,51,161,"Virginia","Roanoke County",4,56,1244,594,650
050,51,161,"Virginia","Roanoke County",4,57,1301,619,682
050,51,161,"Virginia","Roanoke County",4,58,1358,676,682
050,51,161,"Virginia","Roanoke County",4,59,1355,654,701
050,51,161,"Virginia","Roanoke County",4,60,1382,666,716
050,51,161,"Virginia","Roanoke County",4,61,1366,663,703
050,51,161,"Virginia","Roanoke County",4,62,1312,643,669
050,51,161,"Virginia","Roanoke County",4,63,1330,650,680
050,51,161,"Virginia","Roanoke County",4,64,1293,617,676
050,51,161,"Virginia","Roanoke County",4,65,1302,613,689
050,51,161,"Virginia","Roanoke County",4,66,1250,574,676
050,51,161,"Virginia","Roanoke County",4,67,1306,596,710
050,51,161,"Virginia","Roanoke County",4,68,1271,612,659
050,51,161,"Virginia","Roanoke County",4,69,1242,596,646
050,51,161,"Virginia","Roanoke County",4,70,1220,556,664
050,51,161,"Virginia","Roanoke County",4,71,1189,558,631
050,51,161,"Virginia","Roanoke County",4,72,1139,505,634
050,51,161,"Virginia","Roanoke County",4,73,1134,503,631
050,51,161,"Virginia","Roanoke County",4,74,1124,478,646
050,51,161,"Virginia","Roanoke County",4,75,1247,553,694
050,51,161,"Virginia","Roanoke County",4,76,835,376,459
050,51,161,"Virginia","Roanoke County",4,77,752,344,408
050,51,161,"Virginia","Roanoke County",4,78,739,308,431
050,51,161,"Virginia","Roanoke County",4,79,771,325,446
050,51,161,"Virginia","Roanoke County",4,80,659,294,365
050,51,161,"Virginia","Roanoke County",4,81,560,248,312
050,51,161,"Virginia","Roanoke County",4,82,512,198,314
050,51,161,"Virginia","Roanoke County",4,83,474,178,296
050,51,161,"Virginia","Roanoke County",4,84,411,152,259
050,51,161,"Virginia","Roanoke County",4,85,2251,745,1506
050,51,161,"Virginia","Roanoke County",5,0,697,368,329
050,51,161,"Virginia","Roanoke County",5,1,721,390,331
050,51,161,"Virginia","Roanoke County",5,2,795,394,401
050,51,161,"Virginia","Roanoke County",5,3,867,413,454
050,51,161,"Virginia","Roanoke County",5,4,954,485,469
050,51,161,"Virginia","Roanoke County",5,5,995,532,463
050,51,161,"Virginia","Roanoke County",5,6,1006,500,506
050,51,161,"Virginia","Roanoke County",5,7,1049,518,531
050,51,161,"Virginia","Roanoke County",5,8,1020,514,506
050,51,161,"Virginia","Roanoke County",5,9,1078,568,510
050,51,161,"Virginia","Roanoke County",5,10,1097,580,517
050,51,161,"Virginia","Roanoke County",5,11,1113,593,520
050,51,161,"Virginia","Roanoke County",5,12,1150,589,561
050,51,161,"Virginia","Roanoke County",5,13,1166,608,558
050,51,161,"Virginia","Roanoke County",5,14,1214,633,581
050,51,161,"Virginia","Roanoke County",5,15,1264,656,608
050,51,161,"Virginia","Roanoke County",5,16,1277,665,612
050,51,161,"Virginia","Roanoke County",5,17,1249,642,607
050,51,161,"Virginia","Roanoke County",5,18,1072,550,522
050,51,161,"Virginia","Roanoke County",5,19,1010,443,567
050,51,161,"Virginia","Roanoke County",5,20,1027,487,540
050,51,161,"Virginia","Roanoke County",5,21,1102,548,554
050,51,161,"Virginia","Roanoke County",5,22,1074,542,532
050,51,161,"Virginia","Roanoke County",5,23,1104,553,551
050,51,161,"Virginia","Roanoke County",5,24,1074,539,535
050,51,161,"Virginia","Roanoke County",5,25,1110,564,546
050,51,161,"Virginia","Roanoke County",5,26,1011,502,509
050,51,161,"Virginia","Roanoke County",5,27,1051,531,520
050,51,161,"Virginia","Roanoke County",5,28,1074,543,531
050,51,161,"Virginia","Roanoke County",5,29,1159,583,576
050,51,161,"Virginia","Roanoke County",5,30,1160,550,610
050,51,161,"Virginia","Roanoke County",5,31,1239,611,628
050,51,161,"Virginia","Roanoke County",5,32,1267,646,621
050,51,161,"Virginia","Roanoke County",5,33,1172,559,613
050,51,161,"Virginia","Roanoke County",5,34,1177,562,615
050,51,161,"Virginia","Roanoke County",5,35,1133,551,582
050,51,161,"Virginia","Roanoke County",5,36,1188,578,610
050,51,161,"Virginia","Roanoke County",5,37,1215,573,642
050,51,161,"Virginia","Roanoke County",5,38,1237,618,619
050,51,161,"Virginia","Roanoke County",5,39,1217,606,611
050,51,161,"Virginia","Roanoke County",5,40,1219,585,634
050,51,161,"Virginia","Roanoke County",5,41,1239,599,640
050,51,161,"Virginia","Roanoke County",5,42,1283,644,639
050,51,161,"Virginia","Roanoke County",5,43,1158,590,568
050,51,161,"Virginia","Roanoke County",5,44,1184,604,580
050,51,161,"Virginia","Roanoke County",5,45,1192,612,580
050,51,161,"Virginia","Roanoke County",5,46,1149,580,569
050,51,161,"Virginia","Roanoke County",5,47,1194,594,600
050,51,161,"Virginia","Roanoke County",5,48,1192,580,612
050,51,161,"Virginia","Roanoke County",5,49,1138,583,555
050,51,161,"Virginia","Roanoke County",5,50,1198,604,594
050,51,161,"Virginia","Roanoke County",5,51,1314,639,675
050,51,161,"Virginia","Roanoke County",5,52,1393,690,703
050,51,161,"Virginia","Roanoke County",5,53,1393,686,707
050,51,161,"Virginia","Roanoke County",5,54,1253,636,617
050,51,161,"Virginia","Roanoke County",5,55,1253,610,643
050,51,161,"Virginia","Roanoke County",5,56,1205,587,618
050,51,161,"Virginia","Roanoke County",5,57,1243,593,650
050,51,161,"Virginia","Roanoke County",5,58,1296,614,682
050,51,161,"Virginia","Roanoke County",5,59,1335,665,670
050,51,161,"Virginia","Roanoke County",5,60,1373,670,703
050,51,161,"Virginia","Roanoke County",5,61,1385,674,711
050,51,161,"Virginia","Roanoke County",5,62,1358,656,702
050,51,161,"Virginia","Roanoke County",5,63,1287,623,664
050,51,161,"Virginia","Roanoke County",5,64,1332,656,676
050,51,161,"Virginia","Roanoke County",5,65,1302,617,685
050,51,161,"Virginia","Roanoke County",5,66,1322,610,712
050,51,161,"Virginia","Roanoke County",5,67,1248,569,679
050,51,161,"Virginia","Roanoke County",5,68,1307,598,709
050,51,161,"Virginia","Roanoke County",5,69,1252,598,654
050,51,161,"Virginia","Roanoke County",5,70,1226,580,646
050,51,161,"Virginia","Roanoke County",5,71,1193,545,648
050,51,161,"Virginia","Roanoke County",5,72,1176,540,636
050,51,161,"Virginia","Roanoke County",5,73,1114,489,625
050,51,161,"Virginia","Roanoke County",5,74,1111,490,621
050,51,161,"Virginia","Roanoke County",5,75,1100,462,638
050,51,161,"Virginia","Roanoke County",5,76,1210,537,673
050,51,161,"Virginia","Roanoke County",5,77,802,356,446
050,51,161,"Virginia","Roanoke County",5,78,717,328,389
050,51,161,"Virginia","Roanoke County",5,79,722,300,422
050,51,161,"Virginia","Roanoke County",5,80,744,306,438
050,51,161,"Virginia","Roanoke County",5,81,622,280,342
050,51,161,"Virginia","Roanoke County",5,82,546,230,316
050,51,161,"Virginia","Roanoke County",5,83,464,183,281
050,51,161,"Virginia","Roanoke County",5,84,434,160,274
050,51,161,"Virginia","Roanoke County",5,85,2263,773,1490
050,51,163,"Virginia","Rockbridge County",1,0,171,82,89
050,51,163,"Virginia","Rockbridge County",1,1,200,98,102
050,51,163,"Virginia","Rockbridge County",1,2,193,98,95
050,51,163,"Virginia","Rockbridge County",1,3,237,117,120
050,51,163,"Virginia","Rockbridge County",1,4,230,118,112
050,51,163,"Virginia","Rockbridge County",1,5,207,104,103
050,51,163,"Virginia","Rockbridge County",1,6,212,103,109
050,51,163,"Virginia","Rockbridge County",1,7,223,101,122
050,51,163,"Virginia","Rockbridge County",1,8,219,107,112
050,51,163,"Virginia","Rockbridge County",1,9,200,91,109
050,51,163,"Virginia","Rockbridge County",1,10,208,105,103
050,51,163,"Virginia","Rockbridge County",1,11,228,115,113
050,51,163,"Virginia","Rockbridge County",1,12,263,137,126
050,51,163,"Virginia","Rockbridge County",1,13,267,137,130
050,51,163,"Virginia","Rockbridge County",1,14,265,149,116
050,51,163,"Virginia","Rockbridge County",1,15,260,141,119
050,51,163,"Virginia","Rockbridge County",1,16,269,134,135
050,51,163,"Virginia","Rockbridge County",1,17,236,117,119
050,51,163,"Virginia","Rockbridge County",1,18,266,127,139
050,51,163,"Virginia","Rockbridge County",1,19,275,136,139
050,51,163,"Virginia","Rockbridge County",1,20,243,112,131
050,51,163,"Virginia","Rockbridge County",1,21,248,122,126
050,51,163,"Virginia","Rockbridge County",1,22,205,107,98
050,51,163,"Virginia","Rockbridge County",1,23,201,97,104
050,51,163,"Virginia","Rockbridge County",1,24,219,120,99
050,51,163,"Virginia","Rockbridge County",1,25,237,122,115
050,51,163,"Virginia","Rockbridge County",1,26,203,99,104
050,51,163,"Virginia","Rockbridge County",1,27,222,102,120
050,51,163,"Virginia","Rockbridge County",1,28,216,107,109
050,51,163,"Virginia","Rockbridge County",1,29,237,126,111
050,51,163,"Virginia","Rockbridge County",1,30,232,114,118
050,51,163,"Virginia","Rockbridge County",1,31,268,143,125
050,51,163,"Virginia","Rockbridge County",1,32,226,119,107
050,51,163,"Virginia","Rockbridge County",1,33,213,105,108
050,51,163,"Virginia","Rockbridge County",1,34,221,114,107
050,51,163,"Virginia","Rockbridge County",1,35,234,121,113
050,51,163,"Virginia","Rockbridge County",1,36,237,121,116
050,51,163,"Virginia","Rockbridge County",1,37,222,113,109
050,51,163,"Virginia","Rockbridge County",1,38,230,122,108
050,51,163,"Virginia","Rockbridge County",1,39,256,137,119
050,51,163,"Virginia","Rockbridge County",1,40,219,110,109
050,51,163,"Virginia","Rockbridge County",1,41,234,117,117
050,51,163,"Virginia","Rockbridge County",1,42,212,110,102
050,51,163,"Virginia","Rockbridge County",1,43,218,103,115
050,51,163,"Virginia","Rockbridge County",1,44,213,111,102
050,51,163,"Virginia","Rockbridge County",1,45,241,129,112
050,51,163,"Virginia","Rockbridge County",1,46,244,126,118
050,51,163,"Virginia","Rockbridge County",1,47,245,131,114
050,51,163,"Virginia","Rockbridge County",1,48,270,128,142
050,51,163,"Virginia","Rockbridge County",1,49,287,134,153
050,51,163,"Virginia","Rockbridge County",1,50,276,130,146
050,51,163,"Virginia","Rockbridge County",1,51,307,145,162
050,51,163,"Virginia","Rockbridge County",1,52,299,140,159
050,51,163,"Virginia","Rockbridge County",1,53,299,147,152
050,51,163,"Virginia","Rockbridge County",1,54,314,162,152
050,51,163,"Virginia","Rockbridge County",1,55,332,177,155
050,51,163,"Virginia","Rockbridge County",1,56,350,172,178
050,51,163,"Virginia","Rockbridge County",1,57,353,166,187
050,51,163,"Virginia","Rockbridge County",1,58,356,168,188
050,51,163,"Virginia","Rockbridge County",1,59,372,188,184
050,51,163,"Virginia","Rockbridge County",1,60,392,193,199
050,51,163,"Virginia","Rockbridge County",1,61,364,186,178
050,51,163,"Virginia","Rockbridge County",1,62,375,188,187
050,51,163,"Virginia","Rockbridge County",1,63,363,178,185
050,51,163,"Virginia","Rockbridge County",1,64,371,183,188
050,51,163,"Virginia","Rockbridge County",1,65,350,179,171
050,51,163,"Virginia","Rockbridge County",1,66,382,192,190
050,51,163,"Virginia","Rockbridge County",1,67,376,182,194
050,51,163,"Virginia","Rockbridge County",1,68,357,183,174
050,51,163,"Virginia","Rockbridge County",1,69,341,179,162
050,51,163,"Virginia","Rockbridge County",1,70,336,171,165
050,51,163,"Virginia","Rockbridge County",1,71,349,178,171
050,51,163,"Virginia","Rockbridge County",1,72,316,157,159
050,51,163,"Virginia","Rockbridge County",1,73,336,171,165
050,51,163,"Virginia","Rockbridge County",1,74,241,125,116
050,51,163,"Virginia","Rockbridge County",1,75,234,119,115
050,51,163,"Virginia","Rockbridge County",1,76,232,110,122
050,51,163,"Virginia","Rockbridge County",1,77,243,111,132
050,51,163,"Virginia","Rockbridge County",1,78,199,92,107
050,51,163,"Virginia","Rockbridge County",1,79,184,81,103
050,51,163,"Virginia","Rockbridge County",1,80,189,81,108
050,51,163,"Virginia","Rockbridge County",1,81,174,75,99
050,51,163,"Virginia","Rockbridge County",1,82,164,83,81
050,51,163,"Virginia","Rockbridge County",1,83,145,66,79
050,51,163,"Virginia","Rockbridge County",1,84,134,57,77
050,51,163,"Virginia","Rockbridge County",1,85,665,291,374
050,51,163,"Virginia","Rockbridge County",2,0,164,76,88
050,51,163,"Virginia","Rockbridge County",2,1,191,95,96
050,51,163,"Virginia","Rockbridge County",2,2,197,99,98
050,51,163,"Virginia","Rockbridge County",2,3,224,111,113
050,51,163,"Virginia","Rockbridge County",2,4,231,117,114
050,51,163,"Virginia","Rockbridge County",2,5,213,108,105
050,51,163,"Virginia","Rockbridge County",2,6,213,104,109
050,51,163,"Virginia","Rockbridge County",2,7,219,101,118
050,51,163,"Virginia","Rockbridge County",2,8,220,105,115
050,51,163,"Virginia","Rockbridge County",2,9,203,93,110
050,51,163,"Virginia","Rockbridge County",2,10,208,103,105
050,51,163,"Virginia","Rockbridge County",2,11,223,112,111
050,51,163,"Virginia","Rockbridge County",2,12,257,131,126
050,51,163,"Virginia","Rockbridge County",2,13,264,136,128
050,51,163,"Virginia","Rockbridge County",2,14,267,147,120
050,51,163,"Virginia","Rockbridge County",2,15,262,142,120
050,51,163,"Virginia","Rockbridge County",2,16,268,137,131
050,51,163,"Virginia","Rockbridge County",2,17,244,120,124
050,51,163,"Virginia","Rockbridge County",2,18,267,129,138
050,51,163,"Virginia","Rockbridge County",2,19,275,135,140
050,51,163,"Virginia","Rockbridge County",2,20,246,114,132
050,51,163,"Virginia","Rockbridge County",2,21,245,119,126
050,51,163,"Virginia","Rockbridge County",2,22,211,108,103
050,51,163,"Virginia","Rockbridge County",2,23,199,99,100
050,51,163,"Virginia","Rockbridge County",2,24,216,114,102
050,51,163,"Virginia","Rockbridge County",2,25,233,121,112
050,51,163,"Virginia","Rockbridge County",2,26,213,104,109
050,51,163,"Virginia","Rockbridge County",2,27,219,102,117
050,51,163,"Virginia","Rockbridge County",2,28,218,108,110
050,51,163,"Virginia","Rockbridge County",2,29,231,121,110
050,51,163,"Virginia","Rockbridge County",2,30,237,118,119
050,51,163,"Virginia","Rockbridge County",2,31,256,135,121
050,51,163,"Virginia","Rockbridge County",2,32,236,124,112
050,51,163,"Virginia","Rockbridge County",2,33,213,106,107
050,51,163,"Virginia","Rockbridge County",2,34,218,113,105
050,51,163,"Virginia","Rockbridge County",2,35,231,120,111
050,51,163,"Virginia","Rockbridge County",2,36,234,120,114
050,51,163,"Virginia","Rockbridge County",2,37,227,116,111
050,51,163,"Virginia","Rockbridge County",2,38,231,122,109
050,51,163,"Virginia","Rockbridge County",2,39,249,132,117
050,51,163,"Virginia","Rockbridge County",2,40,229,116,113
050,51,163,"Virginia","Rockbridge County",2,41,230,115,115
050,51,163,"Virginia","Rockbridge County",2,42,214,110,104
050,51,163,"Virginia","Rockbridge County",2,43,219,106,113
050,51,163,"Virginia","Rockbridge County",2,44,212,108,104
050,51,163,"Virginia","Rockbridge County",2,45,236,125,111
050,51,163,"Virginia","Rockbridge County",2,46,241,127,114
050,51,163,"Virginia","Rockbridge County",2,47,245,130,115
050,51,163,"Virginia","Rockbridge County",2,48,265,129,136
050,51,163,"Virginia","Rockbridge County",2,49,282,132,150
050,51,163,"Virginia","Rockbridge County",2,50,280,132,148
050,51,163,"Virginia","Rockbridge County",2,51,300,142,158
050,51,163,"Virginia","Rockbridge County",2,52,302,143,159
050,51,163,"Virginia","Rockbridge County",2,53,301,146,155
050,51,163,"Virginia","Rockbridge County",2,54,308,157,151
050,51,163,"Virginia","Rockbridge County",2,55,331,175,156
050,51,163,"Virginia","Rockbridge County",2,56,347,173,174
050,51,163,"Virginia","Rockbridge County",2,57,355,169,186
050,51,163,"Virginia","Rockbridge County",2,58,358,168,190
050,51,163,"Virginia","Rockbridge County",2,59,374,185,189
050,51,163,"Virginia","Rockbridge County",2,60,386,190,196
050,51,163,"Virginia","Rockbridge County",2,61,372,188,184
050,51,163,"Virginia","Rockbridge County",2,62,370,186,184
050,51,163,"Virginia","Rockbridge County",2,63,369,183,186
050,51,163,"Virginia","Rockbridge County",2,64,369,181,188
050,51,163,"Virginia","Rockbridge County",2,65,358,181,177
050,51,163,"Virginia","Rockbridge County",2,66,376,189,187
050,51,163,"Virginia","Rockbridge County",2,67,377,183,194
050,51,163,"Virginia","Rockbridge County",2,68,359,182,177
050,51,163,"Virginia","Rockbridge County",2,69,350,182,168
050,51,163,"Virginia","Rockbridge County",2,70,335,170,165
050,51,163,"Virginia","Rockbridge County",2,71,345,175,170
050,51,163,"Virginia","Rockbridge County",2,72,318,159,159
050,51,163,"Virginia","Rockbridge County",2,73,348,176,172
050,51,163,"Virginia","Rockbridge County",2,74,248,128,120
050,51,163,"Virginia","Rockbridge County",2,75,235,121,114
050,51,163,"Virginia","Rockbridge County",2,76,228,109,119
050,51,163,"Virginia","Rockbridge County",2,77,246,114,132
050,51,163,"Virginia","Rockbridge County",2,78,203,92,111
050,51,163,"Virginia","Rockbridge County",2,79,185,82,103
050,51,163,"Virginia","Rockbridge County",2,80,187,80,107
050,51,163,"Virginia","Rockbridge County",2,81,173,75,98
050,51,163,"Virginia","Rockbridge County",2,82,163,79,84
050,51,163,"Virginia","Rockbridge County",2,83,144,66,78
050,51,163,"Virginia","Rockbridge County",2,84,134,59,75
050,51,163,"Virginia","Rockbridge County",2,85,670,294,376
050,51,163,"Virginia","Rockbridge County",3,0,105,55,50
050,51,163,"Virginia","Rockbridge County",3,1,179,88,91
050,51,163,"Virginia","Rockbridge County",3,2,185,96,89
050,51,163,"Virginia","Rockbridge County",3,3,194,96,98
050,51,163,"Virginia","Rockbridge County",3,4,211,101,110
050,51,163,"Virginia","Rockbridge County",3,5,231,117,114
050,51,163,"Virginia","Rockbridge County",3,6,219,110,109
050,51,163,"Virginia","Rockbridge County",3,7,213,104,109
050,51,163,"Virginia","Rockbridge County",3,8,221,100,121
050,51,163,"Virginia","Rockbridge County",3,9,220,108,112
050,51,163,"Virginia","Rockbridge County",3,10,216,99,117
050,51,163,"Virginia","Rockbridge County",3,11,209,102,107
050,51,163,"Virginia","Rockbridge County",3,12,228,117,111
050,51,163,"Virginia","Rockbridge County",3,13,262,136,126
050,51,163,"Virginia","Rockbridge County",3,14,265,138,127
050,51,163,"Virginia","Rockbridge County",3,15,278,152,126
050,51,163,"Virginia","Rockbridge County",3,16,257,142,115
050,51,163,"Virginia","Rockbridge County",3,17,272,141,131
050,51,163,"Virginia","Rockbridge County",3,18,275,129,146
050,51,163,"Virginia","Rockbridge County",3,19,277,133,144
050,51,163,"Virginia","Rockbridge County",3,20,247,126,121
050,51,163,"Virginia","Rockbridge County",3,21,228,110,118
050,51,163,"Virginia","Rockbridge County",3,22,230,114,116
050,51,163,"Virginia","Rockbridge County",3,23,206,107,99
050,51,163,"Virginia","Rockbridge County",3,24,190,93,97
050,51,163,"Virginia","Rockbridge County",3,25,199,109,90
050,51,163,"Virginia","Rockbridge County",3,26,238,126,112
050,51,163,"Virginia","Rockbridge County",3,27,214,105,109
050,51,163,"Virginia","Rockbridge County",3,28,214,101,113
050,51,163,"Virginia","Rockbridge County",3,29,218,105,113
050,51,163,"Virginia","Rockbridge County",3,30,241,123,118
050,51,163,"Virginia","Rockbridge County",3,31,238,120,118
050,51,163,"Virginia","Rockbridge County",3,32,258,135,123
050,51,163,"Virginia","Rockbridge County",3,33,250,129,121
050,51,163,"Virginia","Rockbridge County",3,34,240,118,122
050,51,163,"Virginia","Rockbridge County",3,35,230,119,111
050,51,163,"Virginia","Rockbridge County",3,36,228,114,114
050,51,163,"Virginia","Rockbridge County",3,37,239,124,115
050,51,163,"Virginia","Rockbridge County",3,38,231,117,114
050,51,163,"Virginia","Rockbridge County",3,39,242,133,109
050,51,163,"Virginia","Rockbridge County",3,40,252,129,123
050,51,163,"Virginia","Rockbridge County",3,41,238,118,120
050,51,163,"Virginia","Rockbridge County",3,42,231,114,117
050,51,163,"Virginia","Rockbridge County",3,43,214,112,102
050,51,163,"Virginia","Rockbridge County",3,44,215,102,113
050,51,163,"Virginia","Rockbridge County",3,45,221,116,105
050,51,163,"Virginia","Rockbridge County",3,46,244,132,112
050,51,163,"Virginia","Rockbridge County",3,47,240,128,112
050,51,163,"Virginia","Rockbridge County",3,48,249,131,118
050,51,163,"Virginia","Rockbridge County",3,49,274,128,146
050,51,163,"Virginia","Rockbridge County",3,50,286,136,150
050,51,163,"Virginia","Rockbridge County",3,51,281,133,148
050,51,163,"Virginia","Rockbridge County",3,52,299,142,157
050,51,163,"Virginia","Rockbridge County",3,53,294,139,155
050,51,163,"Virginia","Rockbridge County",3,54,311,153,158
050,51,163,"Virginia","Rockbridge County",3,55,312,159,153
050,51,163,"Virginia","Rockbridge County",3,56,335,172,163
050,51,163,"Virginia","Rockbridge County",3,57,356,174,182
050,51,163,"Virginia","Rockbridge County",3,58,353,168,185
050,51,163,"Virginia","Rockbridge County",3,59,361,168,193
050,51,163,"Virginia","Rockbridge County",3,60,387,185,202
050,51,163,"Virginia","Rockbridge County",3,61,387,190,197
050,51,163,"Virginia","Rockbridge County",3,62,362,178,184
050,51,163,"Virginia","Rockbridge County",3,63,375,187,188
050,51,163,"Virginia","Rockbridge County",3,64,371,186,185
050,51,163,"Virginia","Rockbridge County",3,65,370,180,190
050,51,163,"Virginia","Rockbridge County",3,66,362,183,179
050,51,163,"Virginia","Rockbridge County",3,67,379,192,187
050,51,163,"Virginia","Rockbridge County",3,68,367,176,191
050,51,163,"Virginia","Rockbridge County",3,69,366,188,178
050,51,163,"Virginia","Rockbridge County",3,70,343,178,165
050,51,163,"Virginia","Rockbridge County",3,71,332,172,160
050,51,163,"Virginia","Rockbridge County",3,72,340,174,166
050,51,163,"Virginia","Rockbridge County",3,73,312,154,158
050,51,163,"Virginia","Rockbridge County",3,74,346,176,170
050,51,163,"Virginia","Rockbridge County",3,75,245,123,122
050,51,163,"Virginia","Rockbridge County",3,76,218,112,106
050,51,163,"Virginia","Rockbridge County",3,77,217,102,115
050,51,163,"Virginia","Rockbridge County",3,78,230,106,124
050,51,163,"Virginia","Rockbridge County",3,79,186,83,103
050,51,163,"Virginia","Rockbridge County",3,80,175,74,101
050,51,163,"Virginia","Rockbridge County",3,81,174,77,97
050,51,163,"Virginia","Rockbridge County",3,82,169,73,96
050,51,163,"Virginia","Rockbridge County",3,83,145,66,79
050,51,163,"Virginia","Rockbridge County",3,84,132,62,70
050,51,163,"Virginia","Rockbridge County",3,85,684,298,386
050,51,163,"Virginia","Rockbridge County",4,0,98,45,53
050,51,163,"Virginia","Rockbridge County",4,1,108,63,45
050,51,163,"Virginia","Rockbridge County",4,2,182,87,95
050,51,163,"Virginia","Rockbridge County",4,3,194,102,92
050,51,163,"Virginia","Rockbridge County",4,4,204,103,101
050,51,163,"Virginia","Rockbridge County",4,5,222,107,115
050,51,163,"Virginia","Rockbridge County",4,6,231,122,109
050,51,163,"Virginia","Rockbridge County",4,7,225,107,118
050,51,163,"Virginia","Rockbridge County",4,8,220,112,108
050,51,163,"Virginia","Rockbridge County",4,9,229,106,123
050,51,163,"Virginia","Rockbridge County",4,10,220,108,112
050,51,163,"Virginia","Rockbridge County",4,11,215,102,113
050,51,163,"Virginia","Rockbridge County",4,12,218,103,115
050,51,163,"Virginia","Rockbridge County",4,13,234,119,115
050,51,163,"Virginia","Rockbridge County",4,14,267,139,128
050,51,163,"Virginia","Rockbridge County",4,15,258,135,123
050,51,163,"Virginia","Rockbridge County",4,16,275,152,123
050,51,163,"Virginia","Rockbridge County",4,17,266,144,122
050,51,163,"Virginia","Rockbridge County",4,18,298,156,142
050,51,163,"Virginia","Rockbridge County",4,19,269,123,146
050,51,163,"Virginia","Rockbridge County",4,20,249,120,129
050,51,163,"Virginia","Rockbridge County",4,21,228,120,108
050,51,163,"Virginia","Rockbridge County",4,22,219,105,114
050,51,163,"Virginia","Rockbridge County",4,23,211,105,106
050,51,163,"Virginia","Rockbridge County",4,24,196,107,89
050,51,163,"Virginia","Rockbridge County",4,25,196,90,106
050,51,163,"Virginia","Rockbridge County",4,26,193,101,92
050,51,163,"Virginia","Rockbridge County",4,27,227,118,109
050,51,163,"Virginia","Rockbridge County",4,28,212,97,115
050,51,163,"Virginia","Rockbridge County",4,29,217,104,113
050,51,163,"Virginia","Rockbridge County",4,30,224,110,114
050,51,163,"Virginia","Rockbridge County",4,31,236,120,116
050,51,163,"Virginia","Rockbridge County",4,32,247,125,122
050,51,163,"Virginia","Rockbridge County",4,33,249,129,120
050,51,163,"Virginia","Rockbridge County",4,34,252,130,122
050,51,163,"Virginia","Rockbridge County",4,35,240,126,114
050,51,163,"Virginia","Rockbridge County",4,36,232,117,115
050,51,163,"Virginia","Rockbridge County",4,37,231,117,114
050,51,163,"Virginia","Rockbridge County",4,38,238,122,116
050,51,163,"Virginia","Rockbridge County",4,39,233,116,117
050,51,163,"Virginia","Rockbridge County",4,40,244,133,111
050,51,163,"Virginia","Rockbridge County",4,41,266,135,131
050,51,163,"Virginia","Rockbridge County",4,42,238,120,118
050,51,163,"Virginia","Rockbridge County",4,43,237,114,123
050,51,163,"Virginia","Rockbridge County",4,44,215,114,101
050,51,163,"Virginia","Rockbridge County",4,45,217,106,111
050,51,163,"Virginia","Rockbridge County",4,46,227,120,107
050,51,163,"Virginia","Rockbridge County",4,47,246,135,111
050,51,163,"Virginia","Rockbridge County",4,48,243,128,115
050,51,163,"Virginia","Rockbridge County",4,49,249,130,119
050,51,163,"Virginia","Rockbridge County",4,50,279,134,145
050,51,163,"Virginia","Rockbridge County",4,51,298,138,160
050,51,163,"Virginia","Rockbridge County",4,52,288,135,153
050,51,163,"Virginia","Rockbridge County",4,53,303,143,160
050,51,163,"Virginia","Rockbridge County",4,54,292,135,157
050,51,163,"Virginia","Rockbridge County",4,55,310,153,157
050,51,163,"Virginia","Rockbridge County",4,56,317,160,157
050,51,163,"Virginia","Rockbridge County",4,57,330,172,158
050,51,163,"Virginia","Rockbridge County",4,58,354,173,181
050,51,163,"Virginia","Rockbridge County",4,59,357,169,188
050,51,163,"Virginia","Rockbridge County",4,60,376,172,204
050,51,163,"Virginia","Rockbridge County",4,61,384,183,201
050,51,163,"Virginia","Rockbridge County",4,62,386,194,192
050,51,163,"Virginia","Rockbridge County",4,63,368,179,189
050,51,163,"Virginia","Rockbridge County",4,64,376,187,189
050,51,163,"Virginia","Rockbridge County",4,65,366,185,181
050,51,163,"Virginia","Rockbridge County",4,66,376,188,188
050,51,163,"Virginia","Rockbridge County",4,67,370,189,181
050,51,163,"Virginia","Rockbridge County",4,68,370,187,183
050,51,163,"Virginia","Rockbridge County",4,69,370,176,194
050,51,163,"Virginia","Rockbridge County",4,70,362,184,178
050,51,163,"Virginia","Rockbridge County",4,71,343,178,165
050,51,163,"Virginia","Rockbridge County",4,72,332,172,160
050,51,163,"Virginia","Rockbridge County",4,73,330,172,158
050,51,163,"Virginia","Rockbridge County",4,74,305,148,157
050,51,163,"Virginia","Rockbridge County",4,75,337,170,167
050,51,163,"Virginia","Rockbridge County",4,76,231,114,117
050,51,163,"Virginia","Rockbridge County",4,77,209,105,104
050,51,163,"Virginia","Rockbridge County",4,78,215,99,116
050,51,163,"Virginia","Rockbridge County",4,79,215,102,113
050,51,163,"Virginia","Rockbridge County",4,80,171,71,100
050,51,163,"Virginia","Rockbridge County",4,81,161,72,89
050,51,163,"Virginia","Rockbridge County",4,82,168,76,92
050,51,163,"Virginia","Rockbridge County",4,83,154,63,91
050,51,163,"Virginia","Rockbridge County",4,84,128,59,69
050,51,163,"Virginia","Rockbridge County",4,85,692,300,392
050,51,163,"Virginia","Rockbridge County",5,0,94,44,50
050,51,163,"Virginia","Rockbridge County",5,1,117,59,58
050,51,163,"Virginia","Rockbridge County",5,2,114,65,49
050,51,163,"Virginia","Rockbridge County",5,3,182,86,96
050,51,163,"Virginia","Rockbridge County",5,4,187,104,83
050,51,163,"Virginia","Rockbridge County",5,5,206,104,102
050,51,163,"Virginia","Rockbridge County",5,6,213,112,101
050,51,163,"Virginia","Rockbridge County",5,7,223,110,113
050,51,163,"Virginia","Rockbridge County",5,8,228,109,119
050,51,163,"Virginia","Rockbridge County",5,9,219,110,109
050,51,163,"Virginia","Rockbridge County",5,10,231,106,125
050,51,163,"Virginia","Rockbridge County",5,11,216,104,112
050,51,163,"Virginia","Rockbridge County",5,12,215,102,113
050,51,163,"Virginia","Rockbridge County",5,13,215,106,109
050,51,163,"Virginia","Rockbridge County",5,14,239,117,122
050,51,163,"Virginia","Rockbridge County",5,15,251,138,113
050,51,163,"Virginia","Rockbridge County",5,16,260,133,127
050,51,163,"Virginia","Rockbridge County",5,17,260,140,120
050,51,163,"Virginia","Rockbridge County",5,18,284,149,135
050,51,163,"Virginia","Rockbridge County",5,19,283,140,143
050,51,163,"Virginia","Rockbridge County",5,20,240,111,129
050,51,163,"Virginia","Rockbridge County",5,21,238,118,120
050,51,163,"Virginia","Rockbridge County",5,22,209,104,105
050,51,163,"Virginia","Rockbridge County",5,23,206,108,98
050,51,163,"Virginia","Rockbridge County",5,24,220,110,110
050,51,163,"Virginia","Rockbridge County",5,25,199,99,100
050,51,163,"Virginia","Rockbridge County",5,26,189,96,93
050,51,163,"Virginia","Rockbridge County",5,27,205,107,98
050,51,163,"Virginia","Rockbridge County",5,28,219,113,106
050,51,163,"Virginia","Rockbridge County",5,29,214,105,109
050,51,163,"Virginia","Rockbridge County",5,30,211,98,113
050,51,163,"Virginia","Rockbridge County",5,31,225,109,116
050,51,163,"Virginia","Rockbridge County",5,32,255,127,128
050,51,163,"Virginia","Rockbridge County",5,33,247,123,124
050,51,163,"Virginia","Rockbridge County",5,34,254,136,118
050,51,163,"Virginia","Rockbridge County",5,35,251,129,122
050,51,163,"Virginia","Rockbridge County",5,36,233,120,113
050,51,163,"Virginia","Rockbridge County",5,37,229,113,116
050,51,163,"Virginia","Rockbridge County",5,38,232,118,114
050,51,163,"Virginia","Rockbridge County",5,39,237,123,114
050,51,163,"Virginia","Rockbridge County",5,40,246,123,123
050,51,163,"Virginia","Rockbridge County",5,41,232,128,104
050,51,163,"Virginia","Rockbridge County",5,42,258,133,125
050,51,163,"Virginia","Rockbridge County",5,43,245,123,122
050,51,163,"Virginia","Rockbridge County",5,44,239,117,122
050,51,163,"Virginia","Rockbridge County",5,45,212,109,103
050,51,163,"Virginia","Rockbridge County",5,46,221,109,112
050,51,163,"Virginia","Rockbridge County",5,47,225,116,109
050,51,163,"Virginia","Rockbridge County",5,48,257,141,116
050,51,163,"Virginia","Rockbridge County",5,49,252,132,120
050,51,163,"Virginia","Rockbridge County",5,50,246,128,118
050,51,163,"Virginia","Rockbridge County",5,51,273,128,145
050,51,163,"Virginia","Rockbridge County",5,52,301,136,165
050,51,163,"Virginia","Rockbridge County",5,53,292,136,156
050,51,163,"Virginia","Rockbridge County",5,54,301,145,156
050,51,163,"Virginia","Rockbridge County",5,55,296,142,154
050,51,163,"Virginia","Rockbridge County",5,56,312,151,161
050,51,163,"Virginia","Rockbridge County",5,57,315,159,156
050,51,163,"Virginia","Rockbridge County",5,58,331,176,155
050,51,163,"Virginia","Rockbridge County",5,59,351,169,182
050,51,163,"Virginia","Rockbridge County",5,60,363,172,191
050,51,163,"Virginia","Rockbridge County",5,61,382,176,206
050,51,163,"Virginia","Rockbridge County",5,62,392,187,205
050,51,163,"Virginia","Rockbridge County",5,63,384,191,193
050,51,163,"Virginia","Rockbridge County",5,64,362,166,196
050,51,163,"Virginia","Rockbridge County",5,65,376,191,185
050,51,163,"Virginia","Rockbridge County",5,66,368,189,179
050,51,163,"Virginia","Rockbridge County",5,67,370,183,187
050,51,163,"Virginia","Rockbridge County",5,68,370,184,186
050,51,163,"Virginia","Rockbridge County",5,69,370,188,182
050,51,163,"Virginia","Rockbridge County",5,70,369,174,195
050,51,163,"Virginia","Rockbridge County",5,71,357,180,177
050,51,163,"Virginia","Rockbridge County",5,72,337,174,163
050,51,163,"Virginia","Rockbridge County",5,73,324,171,153
050,51,163,"Virginia","Rockbridge County",5,74,322,169,153
050,51,163,"Virginia","Rockbridge County",5,75,294,140,154
050,51,163,"Virginia","Rockbridge County",5,76,319,159,160
050,51,163,"Virginia","Rockbridge County",5,77,225,110,115
050,51,163,"Virginia","Rockbridge County",5,78,201,101,100
050,51,163,"Virginia","Rockbridge County",5,79,198,93,105
050,51,163,"Virginia","Rockbridge County",5,80,201,91,110
050,51,163,"Virginia","Rockbridge County",5,81,159,68,91
050,51,163,"Virginia","Rockbridge County",5,82,150,68,82
050,51,163,"Virginia","Rockbridge County",5,83,150,64,86
050,51,163,"Virginia","Rockbridge County",5,84,137,56,81
050,51,163,"Virginia","Rockbridge County",5,85,723,310,413
050,51,165,"Virginia","Rockingham County",1,0,893,456,437
050,51,165,"Virginia","Rockingham County",1,1,932,474,458
050,51,165,"Virginia","Rockingham County",1,2,974,478,496
050,51,165,"Virginia","Rockingham County",1,3,1017,519,498
050,51,165,"Virginia","Rockingham County",1,4,972,487,485
050,51,165,"Virginia","Rockingham County",1,5,969,495,474
050,51,165,"Virginia","Rockingham County",1,6,976,502,474
050,51,165,"Virginia","Rockingham County",1,7,1019,534,485
050,51,165,"Virginia","Rockingham County",1,8,1020,553,467
050,51,165,"Virginia","Rockingham County",1,9,1037,535,502
050,51,165,"Virginia","Rockingham County",1,10,1062,508,554
050,51,165,"Virginia","Rockingham County",1,11,1079,543,536
050,51,165,"Virginia","Rockingham County",1,12,1104,584,520
050,51,165,"Virginia","Rockingham County",1,13,1171,602,569
050,51,165,"Virginia","Rockingham County",1,14,1108,560,548
050,51,165,"Virginia","Rockingham County",1,15,1059,523,536
050,51,165,"Virginia","Rockingham County",1,16,1088,544,544
050,51,165,"Virginia","Rockingham County",1,17,1102,580,522
050,51,165,"Virginia","Rockingham County",1,18,1269,622,647
050,51,165,"Virginia","Rockingham County",1,19,1240,568,672
050,51,165,"Virginia","Rockingham County",1,20,1143,527,616
050,51,165,"Virginia","Rockingham County",1,21,1151,565,586
050,51,165,"Virginia","Rockingham County",1,22,1011,520,491
050,51,165,"Virginia","Rockingham County",1,23,926,448,478
050,51,165,"Virginia","Rockingham County",1,24,978,481,497
050,51,165,"Virginia","Rockingham County",1,25,911,464,447
050,51,165,"Virginia","Rockingham County",1,26,925,476,449
050,51,165,"Virginia","Rockingham County",1,27,985,489,496
050,51,165,"Virginia","Rockingham County",1,28,1000,499,501
050,51,165,"Virginia","Rockingham County",1,29,1041,530,511
050,51,165,"Virginia","Rockingham County",1,30,968,462,506
050,51,165,"Virginia","Rockingham County",1,31,950,496,454
050,51,165,"Virginia","Rockingham County",1,32,957,479,478
050,51,165,"Virginia","Rockingham County",1,33,953,460,493
050,51,165,"Virginia","Rockingham County",1,34,994,492,502
050,51,165,"Virginia","Rockingham County",1,35,958,471,487
050,51,165,"Virginia","Rockingham County",1,36,975,497,478
050,51,165,"Virginia","Rockingham County",1,37,1013,527,486
050,51,165,"Virginia","Rockingham County",1,38,1029,525,504
050,51,165,"Virginia","Rockingham County",1,39,1035,519,516
050,51,165,"Virginia","Rockingham County",1,40,1024,525,499
050,51,165,"Virginia","Rockingham County",1,41,1024,521,503
050,51,165,"Virginia","Rockingham County",1,42,956,483,473
050,51,165,"Virginia","Rockingham County",1,43,894,460,434
050,51,165,"Virginia","Rockingham County",1,44,901,446,455
050,51,165,"Virginia","Rockingham County",1,45,935,474,461
050,51,165,"Virginia","Rockingham County",1,46,930,487,443
050,51,165,"Virginia","Rockingham County",1,47,964,465,499
050,51,165,"Virginia","Rockingham County",1,48,1020,505,515
050,51,165,"Virginia","Rockingham County",1,49,1086,538,548
050,51,165,"Virginia","Rockingham County",1,50,1076,542,534
050,51,165,"Virginia","Rockingham County",1,51,1033,508,525
050,51,165,"Virginia","Rockingham County",1,52,1000,508,492
050,51,165,"Virginia","Rockingham County",1,53,1077,535,542
050,51,165,"Virginia","Rockingham County",1,54,1083,545,538
050,51,165,"Virginia","Rockingham County",1,55,1139,562,577
050,51,165,"Virginia","Rockingham County",1,56,1198,610,588
050,51,165,"Virginia","Rockingham County",1,57,1178,587,591
050,51,165,"Virginia","Rockingham County",1,58,1210,622,588
050,51,165,"Virginia","Rockingham County",1,59,1175,591,584
050,51,165,"Virginia","Rockingham County",1,60,1112,548,564
050,51,165,"Virginia","Rockingham County",1,61,1145,563,582
050,51,165,"Virginia","Rockingham County",1,62,1185,588,597
050,51,165,"Virginia","Rockingham County",1,63,1122,517,605
050,51,165,"Virginia","Rockingham County",1,64,1098,532,566
050,51,165,"Virginia","Rockingham County",1,65,1105,539,566
050,51,165,"Virginia","Rockingham County",1,66,1030,515,515
050,51,165,"Virginia","Rockingham County",1,67,1005,513,492
050,51,165,"Virginia","Rockingham County",1,68,992,508,484
050,51,165,"Virginia","Rockingham County",1,69,911,457,454
050,51,165,"Virginia","Rockingham County",1,70,888,446,442
050,51,165,"Virginia","Rockingham County",1,71,843,417,426
050,51,165,"Virginia","Rockingham County",1,72,876,430,446
050,51,165,"Virginia","Rockingham County",1,73,849,398,451
050,51,165,"Virginia","Rockingham County",1,74,602,278,324
050,51,165,"Virginia","Rockingham County",1,75,600,274,326
050,51,165,"Virginia","Rockingham County",1,76,649,294,355
050,51,165,"Virginia","Rockingham County",1,77,628,288,340
050,51,165,"Virginia","Rockingham County",1,78,576,260,316
050,51,165,"Virginia","Rockingham County",1,79,502,228,274
050,51,165,"Virginia","Rockingham County",1,80,469,212,257
050,51,165,"Virginia","Rockingham County",1,81,424,182,242
050,51,165,"Virginia","Rockingham County",1,82,418,179,239
050,51,165,"Virginia","Rockingham County",1,83,374,154,220
050,51,165,"Virginia","Rockingham County",1,84,346,134,212
050,51,165,"Virginia","Rockingham County",1,85,2117,748,1369
050,51,165,"Virginia","Rockingham County",2,0,887,458,429
050,51,165,"Virginia","Rockingham County",2,1,925,471,454
050,51,165,"Virginia","Rockingham County",2,2,973,483,490
050,51,165,"Virginia","Rockingham County",2,3,1005,506,499
050,51,165,"Virginia","Rockingham County",2,4,989,496,493
050,51,165,"Virginia","Rockingham County",2,5,972,492,480
050,51,165,"Virginia","Rockingham County",2,6,977,503,474
050,51,165,"Virginia","Rockingham County",2,7,1012,529,483
050,51,165,"Virginia","Rockingham County",2,8,1019,547,472
050,51,165,"Virginia","Rockingham County",2,9,1029,537,492
050,51,165,"Virginia","Rockingham County",2,10,1053,512,541
050,51,165,"Virginia","Rockingham County",2,11,1069,532,537
050,51,165,"Virginia","Rockingham County",2,12,1110,581,529
050,51,165,"Virginia","Rockingham County",2,13,1154,597,557
050,51,165,"Virginia","Rockingham County",2,14,1121,569,552
050,51,165,"Virginia","Rockingham County",2,15,1072,533,539
050,51,165,"Virginia","Rockingham County",2,16,1081,539,542
050,51,165,"Virginia","Rockingham County",2,17,1101,572,529
050,51,165,"Virginia","Rockingham County",2,18,1249,614,635
050,51,165,"Virginia","Rockingham County",2,19,1249,577,672
050,51,165,"Virginia","Rockingham County",2,20,1162,535,627
050,51,165,"Virginia","Rockingham County",2,21,1142,558,584
050,51,165,"Virginia","Rockingham County",2,22,1017,523,494
050,51,165,"Virginia","Rockingham County",2,23,926,455,471
050,51,165,"Virginia","Rockingham County",2,24,962,471,491
050,51,165,"Virginia","Rockingham County",2,25,926,470,456
050,51,165,"Virginia","Rockingham County",2,26,926,475,451
050,51,165,"Virginia","Rockingham County",2,27,965,482,483
050,51,165,"Virginia","Rockingham County",2,28,997,499,498
050,51,165,"Virginia","Rockingham County",2,29,1026,520,506
050,51,165,"Virginia","Rockingham County",2,30,991,483,508
050,51,165,"Virginia","Rockingham County",2,31,953,484,469
050,51,165,"Virginia","Rockingham County",2,32,955,482,473
050,51,165,"Virginia","Rockingham County",2,33,961,467,494
050,51,165,"Virginia","Rockingham County",2,34,987,488,499
050,51,165,"Virginia","Rockingham County",2,35,977,482,495
050,51,165,"Virginia","Rockingham County",2,36,966,489,477
050,51,165,"Virginia","Rockingham County",2,37,1011,525,486
050,51,165,"Virginia","Rockingham County",2,38,1025,524,501
050,51,165,"Virginia","Rockingham County",2,39,1036,522,514
050,51,165,"Virginia","Rockingham County",2,40,1036,528,508
050,51,165,"Virginia","Rockingham County",2,41,1023,521,502
050,51,165,"Virginia","Rockingham County",2,42,965,490,475
050,51,165,"Virginia","Rockingham County",2,43,913,467,446
050,51,165,"Virginia","Rockingham County",2,44,894,446,448
050,51,165,"Virginia","Rockingham County",2,45,931,473,458
050,51,165,"Virginia","Rockingham County",2,46,928,483,445
050,51,165,"Virginia","Rockingham County",2,47,947,465,482
050,51,165,"Virginia","Rockingham County",2,48,1005,493,512
050,51,165,"Virginia","Rockingham County",2,49,1075,533,542
050,51,165,"Virginia","Rockingham County",2,50,1078,541,537
050,51,165,"Virginia","Rockingham County",2,51,1037,511,526
050,51,165,"Virginia","Rockingham County",2,52,1003,503,500
050,51,165,"Virginia","Rockingham County",2,53,1055,525,530
050,51,165,"Virginia","Rockingham County",2,54,1080,541,539
050,51,165,"Virginia","Rockingham County",2,55,1125,558,567
050,51,165,"Virginia","Rockingham County",2,56,1187,597,590
050,51,165,"Virginia","Rockingham County",2,57,1180,591,589
050,51,165,"Virginia","Rockingham County",2,58,1199,611,588
050,51,165,"Virginia","Rockingham County",2,59,1192,604,588
050,51,165,"Virginia","Rockingham County",2,60,1120,554,566
050,51,165,"Virginia","Rockingham County",2,61,1136,560,576
050,51,165,"Virginia","Rockingham County",2,62,1174,581,593
050,51,165,"Virginia","Rockingham County",2,63,1144,539,605
050,51,165,"Virginia","Rockingham County",2,64,1096,526,570
050,51,165,"Virginia","Rockingham County",2,65,1100,535,565
050,51,165,"Virginia","Rockingham County",2,66,1044,519,525
050,51,165,"Virginia","Rockingham County",2,67,1008,510,498
050,51,165,"Virginia","Rockingham County",2,68,985,505,480
050,51,165,"Virginia","Rockingham County",2,69,935,473,462
050,51,165,"Virginia","Rockingham County",2,70,893,448,445
050,51,165,"Virginia","Rockingham County",2,71,852,421,431
050,51,165,"Virginia","Rockingham County",2,72,857,423,434
050,51,165,"Virginia","Rockingham County",2,73,889,423,466
050,51,165,"Virginia","Rockingham County",2,74,614,285,329
050,51,165,"Virginia","Rockingham County",2,75,604,277,327
050,51,165,"Virginia","Rockingham County",2,76,625,282,343
050,51,165,"Virginia","Rockingham County",2,77,647,297,350
050,51,165,"Virginia","Rockingham County",2,78,571,257,314
050,51,165,"Virginia","Rockingham County",2,79,512,235,277
050,51,165,"Virginia","Rockingham County",2,80,475,214,261
050,51,165,"Virginia","Rockingham County",2,81,424,185,239
050,51,165,"Virginia","Rockingham County",2,82,419,178,241
050,51,165,"Virginia","Rockingham County",2,83,374,156,218
050,51,165,"Virginia","Rockingham County",2,84,349,133,216
050,51,165,"Virginia","Rockingham County",2,85,2116,755,1361
050,51,165,"Virginia","Rockingham County",3,0,857,427,430
050,51,165,"Virginia","Rockingham County",3,1,951,478,473
050,51,165,"Virginia","Rockingham County",3,2,952,489,463
050,51,165,"Virginia","Rockingham County",3,3,1024,514,510
050,51,165,"Virginia","Rockingham County",3,4,1019,506,513
050,51,165,"Virginia","Rockingham County",3,5,1019,515,504
050,51,165,"Virginia","Rockingham County",3,6,1002,507,495
050,51,165,"Virginia","Rockingham County",3,7,1008,523,485
050,51,165,"Virginia","Rockingham County",3,8,1026,535,491
050,51,165,"Virginia","Rockingham County",3,9,1018,551,467
050,51,165,"Virginia","Rockingham County",3,10,1048,544,504
050,51,165,"Virginia","Rockingham County",3,11,1057,515,542
050,51,165,"Virginia","Rockingham County",3,12,1096,548,548
050,51,165,"Virginia","Rockingham County",3,13,1139,598,541
050,51,165,"Virginia","Rockingham County",3,14,1155,583,572
050,51,165,"Virginia","Rockingham County",3,15,1124,574,550
050,51,165,"Virginia","Rockingham County",3,16,1081,543,538
050,51,165,"Virginia","Rockingham County",3,17,1098,555,543
050,51,165,"Virginia","Rockingham County",3,18,1232,591,641
050,51,165,"Virginia","Rockingham County",3,19,1257,603,654
050,51,165,"Virginia","Rockingham County",3,20,1193,536,657
050,51,165,"Virginia","Rockingham County",3,21,1152,559,593
050,51,165,"Virginia","Rockingham County",3,22,1028,527,501
050,51,165,"Virginia","Rockingham County",3,23,916,484,432
050,51,165,"Virginia","Rockingham County",3,24,931,455,476
050,51,165,"Virginia","Rockingham County",3,25,957,474,483
050,51,165,"Virginia","Rockingham County",3,26,973,491,482
050,51,165,"Virginia","Rockingham County",3,27,949,482,467
050,51,165,"Virginia","Rockingham County",3,28,955,474,481
050,51,165,"Virginia","Rockingham County",3,29,997,495,502
050,51,165,"Virginia","Rockingham County",3,30,1046,527,519
050,51,165,"Virginia","Rockingham County",3,31,1009,501,508
050,51,165,"Virginia","Rockingham County",3,32,984,494,490
050,51,165,"Virginia","Rockingham County",3,33,960,482,478
050,51,165,"Virginia","Rockingham County",3,34,968,466,502
050,51,165,"Virginia","Rockingham County",3,35,994,488,506
050,51,165,"Virginia","Rockingham County",3,36,995,508,487
050,51,165,"Virginia","Rockingham County",3,37,990,503,487
050,51,165,"Virginia","Rockingham County",3,38,1048,539,509
050,51,165,"Virginia","Rockingham County",3,39,1042,521,521
050,51,165,"Virginia","Rockingham County",3,40,1053,536,517
050,51,165,"Virginia","Rockingham County",3,41,1024,518,506
050,51,165,"Virginia","Rockingham County",3,42,1040,525,515
050,51,165,"Virginia","Rockingham County",3,43,986,496,490
050,51,165,"Virginia","Rockingham County",3,44,927,474,453
050,51,165,"Virginia","Rockingham County",3,45,892,455,437
050,51,165,"Virginia","Rockingham County",3,46,957,496,461
050,51,165,"Virginia","Rockingham County",3,47,934,483,451
050,51,165,"Virginia","Rockingham County",3,48,938,459,479
050,51,165,"Virginia","Rockingham County",3,49,1001,493,508
050,51,165,"Virginia","Rockingham County",3,50,1082,538,544
050,51,165,"Virginia","Rockingham County",3,51,1083,551,532
050,51,165,"Virginia","Rockingham County",3,52,1044,514,530
050,51,165,"Virginia","Rockingham County",3,53,1015,507,508
050,51,165,"Virginia","Rockingham County",3,54,1078,540,538
050,51,165,"Virginia","Rockingham County",3,55,1071,540,531
050,51,165,"Virginia","Rockingham County",3,56,1134,568,566
050,51,165,"Virginia","Rockingham County",3,57,1168,592,576
050,51,165,"Virginia","Rockingham County",3,58,1177,584,593
050,51,165,"Virginia","Rockingham County",3,59,1210,621,589
050,51,165,"Virginia","Rockingham County",3,60,1168,592,576
050,51,165,"Virginia","Rockingham County",3,61,1118,555,563
050,51,165,"Virginia","Rockingham County",3,62,1111,543,568
050,51,165,"Virginia","Rockingham County",3,63,1166,575,591
050,51,165,"Virginia","Rockingham County",3,64,1147,539,608
050,51,165,"Virginia","Rockingham County",3,65,1087,522,565
050,51,165,"Virginia","Rockingham County",3,66,1090,529,561
050,51,165,"Virginia","Rockingham County",3,67,1035,501,534
050,51,165,"Virginia","Rockingham County",3,68,997,506,491
050,51,165,"Virginia","Rockingham County",3,69,978,495,483
050,51,165,"Virginia","Rockingham County",3,70,932,469,463
050,51,165,"Virginia","Rockingham County",3,71,894,449,445
050,51,165,"Virginia","Rockingham County",3,72,838,417,421
050,51,165,"Virginia","Rockingham County",3,73,855,425,430
050,51,165,"Virginia","Rockingham County",3,74,866,412,454
050,51,165,"Virginia","Rockingham County",3,75,598,279,319
050,51,165,"Virginia","Rockingham County",3,76,582,266,316
050,51,165,"Virginia","Rockingham County",3,77,605,268,337
050,51,165,"Virginia","Rockingham County",3,78,620,276,344
050,51,165,"Virginia","Rockingham County",3,79,543,241,302
050,51,165,"Virginia","Rockingham County",3,80,497,220,277
050,51,165,"Virginia","Rockingham County",3,81,450,200,250
050,51,165,"Virginia","Rockingham County",3,82,402,174,228
050,51,165,"Virginia","Rockingham County",3,83,382,168,214
050,51,165,"Virginia","Rockingham County",3,84,351,141,210
050,51,165,"Virginia","Rockingham County",3,85,2142,762,1380
050,51,165,"Virginia","Rockingham County",4,0,914,481,433
050,51,165,"Virginia","Rockingham County",4,1,877,437,440
050,51,165,"Virginia","Rockingham County",4,2,966,503,463
050,51,165,"Virginia","Rockingham County",4,3,989,510,479
050,51,165,"Virginia","Rockingham County",4,4,1032,527,505
050,51,165,"Virginia","Rockingham County",4,5,1053,535,518
050,51,165,"Virginia","Rockingham County",4,6,1060,547,513
050,51,165,"Virginia","Rockingham County",4,7,1026,530,496
050,51,165,"Virginia","Rockingham County",4,8,1036,546,490
050,51,165,"Virginia","Rockingham County",4,9,1051,552,499
050,51,165,"Virginia","Rockingham County",4,10,1047,575,472
050,51,165,"Virginia","Rockingham County",4,11,1066,546,520
050,51,165,"Virginia","Rockingham County",4,12,1083,525,558
050,51,165,"Virginia","Rockingham County",4,13,1132,576,556
050,51,165,"Virginia","Rockingham County",4,14,1133,596,537
050,51,165,"Virginia","Rockingham County",4,15,1176,603,573
050,51,165,"Virginia","Rockingham County",4,16,1120,573,547
050,51,165,"Virginia","Rockingham County",4,17,1099,560,539
050,51,165,"Virginia","Rockingham County",4,18,1208,572,636
050,51,165,"Virginia","Rockingham County",4,19,1208,563,645
050,51,165,"Virginia","Rockingham County",4,20,1181,564,617
050,51,165,"Virginia","Rockingham County",4,21,1181,552,629
050,51,165,"Virginia","Rockingham County",4,22,1065,543,522
050,51,165,"Virginia","Rockingham County",4,23,972,508,464
050,51,165,"Virginia","Rockingham County",4,24,940,500,440
050,51,165,"Virginia","Rockingham County",4,25,965,476,489
050,51,165,"Virginia","Rockingham County",4,26,968,488,480
050,51,165,"Virginia","Rockingham County",4,27,1014,502,512
050,51,165,"Virginia","Rockingham County",4,28,942,456,486
050,51,165,"Virginia","Rockingham County",4,29,978,483,495
050,51,165,"Virginia","Rockingham County",4,30,1003,497,506
050,51,165,"Virginia","Rockingham County",4,31,1091,555,536
050,51,165,"Virginia","Rockingham County",4,32,1008,500,508
050,51,165,"Virginia","Rockingham County",4,33,1002,509,493
050,51,165,"Virginia","Rockingham County",4,34,1009,505,504
050,51,165,"Virginia","Rockingham County",4,35,1016,476,540
050,51,165,"Virginia","Rockingham County",4,36,1017,497,520
050,51,165,"Virginia","Rockingham County",4,37,1018,534,484
050,51,165,"Virginia","Rockingham County",4,38,1021,529,492
050,51,165,"Virginia","Rockingham County",4,39,1058,536,522
050,51,165,"Virginia","Rockingham County",4,40,1060,538,522
050,51,165,"Virginia","Rockingham County",4,41,1080,546,534
050,51,165,"Virginia","Rockingham County",4,42,1038,526,512
050,51,165,"Virginia","Rockingham County",4,43,1050,532,518
050,51,165,"Virginia","Rockingham County",4,44,988,489,499
050,51,165,"Virginia","Rockingham County",4,45,945,484,461
050,51,165,"Virginia","Rockingham County",4,46,922,466,456
050,51,165,"Virginia","Rockingham County",4,47,947,491,456
050,51,165,"Virginia","Rockingham County",4,48,937,482,455
050,51,165,"Virginia","Rockingham County",4,49,942,459,483
050,51,165,"Virginia","Rockingham County",4,50,1014,493,521
050,51,165,"Virginia","Rockingham County",4,51,1073,532,541
050,51,165,"Virginia","Rockingham County",4,52,1100,566,534
050,51,165,"Virginia","Rockingham County",4,53,1042,508,534
050,51,165,"Virginia","Rockingham County",4,54,1019,503,516
050,51,165,"Virginia","Rockingham County",4,55,1067,547,520
050,51,165,"Virginia","Rockingham County",4,56,1084,544,540
050,51,165,"Virginia","Rockingham County",4,57,1107,555,552
050,51,165,"Virginia","Rockingham County",4,58,1153,579,574
050,51,165,"Virginia","Rockingham County",4,59,1187,591,596
050,51,165,"Virginia","Rockingham County",4,60,1180,599,581
050,51,165,"Virginia","Rockingham County",4,61,1168,589,579
050,51,165,"Virginia","Rockingham County",4,62,1110,554,556
050,51,165,"Virginia","Rockingham County",4,63,1122,549,573
050,51,165,"Virginia","Rockingham County",4,64,1142,562,580
050,51,165,"Virginia","Rockingham County",4,65,1143,542,601
050,51,165,"Virginia","Rockingham County",4,66,1083,520,563
050,51,165,"Virginia","Rockingham County",4,67,1080,514,566
050,51,165,"Virginia","Rockingham County",4,68,1025,494,531
050,51,165,"Virginia","Rockingham County",4,69,980,497,483
050,51,165,"Virginia","Rockingham County",4,70,965,485,480
050,51,165,"Virginia","Rockingham County",4,71,914,457,457
050,51,165,"Virginia","Rockingham County",4,72,888,447,441
050,51,165,"Virginia","Rockingham County",4,73,806,405,401
050,51,165,"Virginia","Rockingham County",4,74,841,411,430
050,51,165,"Virginia","Rockingham County",4,75,843,397,446
050,51,165,"Virginia","Rockingham County",4,76,578,267,311
050,51,165,"Virginia","Rockingham County",4,77,561,256,305
050,51,165,"Virginia","Rockingham County",4,78,590,255,335
050,51,165,"Virginia","Rockingham County",4,79,589,260,329
050,51,165,"Virginia","Rockingham County",4,80,522,223,299
050,51,165,"Virginia","Rockingham County",4,81,484,213,271
050,51,165,"Virginia","Rockingham County",4,82,425,185,240
050,51,165,"Virginia","Rockingham County",4,83,359,159,200
050,51,165,"Virginia","Rockingham County",4,84,357,141,216
050,51,165,"Virginia","Rockingham County",4,85,2179,774,1405
050,51,165,"Virginia","Rockingham County",5,0,909,480,429
050,51,165,"Virginia","Rockingham County",5,1,986,545,441
050,51,165,"Virginia","Rockingham County",5,2,905,454,451
050,51,165,"Virginia","Rockingham County",5,3,1002,520,482
050,51,165,"Virginia","Rockingham County",5,4,1007,519,488
050,51,165,"Virginia","Rockingham County",5,5,1060,528,532
050,51,165,"Virginia","Rockingham County",5,6,1074,557,517
050,51,165,"Virginia","Rockingham County",5,7,1072,531,541
050,51,165,"Virginia","Rockingham County",5,8,1067,544,523
050,51,165,"Virginia","Rockingham County",5,9,1075,573,502
050,51,165,"Virginia","Rockingham County",5,10,1075,565,510
050,51,165,"Virginia","Rockingham County",5,11,1071,577,494
050,51,165,"Virginia","Rockingham County",5,12,1093,563,530
050,51,165,"Virginia","Rockingham County",5,13,1107,534,573
050,51,165,"Virginia","Rockingham County",5,14,1152,588,564
050,51,165,"Virginia","Rockingham County",5,15,1156,613,543
050,51,165,"Virginia","Rockingham County",5,16,1164,598,566
050,51,165,"Virginia","Rockingham County",5,17,1138,586,552
050,51,165,"Virginia","Rockingham County",5,18,1198,570,628
050,51,165,"Virginia","Rockingham County",5,19,1232,563,669
050,51,165,"Virginia","Rockingham County",5,20,1154,532,622
050,51,165,"Virginia","Rockingham County",5,21,1178,588,590
050,51,165,"Virginia","Rockingham County",5,22,1098,532,566
050,51,165,"Virginia","Rockingham County",5,23,960,474,486
050,51,165,"Virginia","Rockingham County",5,24,998,503,495
050,51,165,"Virginia","Rockingham County",5,25,922,493,429
050,51,165,"Virginia","Rockingham County",5,26,970,471,499
050,51,165,"Virginia","Rockingham County",5,27,994,486,508
050,51,165,"Virginia","Rockingham County",5,28,1018,515,503
050,51,165,"Virginia","Rockingham County",5,29,961,464,497
050,51,165,"Virginia","Rockingham County",5,30,971,477,494
050,51,165,"Virginia","Rockingham County",5,31,1014,507,507
050,51,165,"Virginia","Rockingham County",5,32,1092,552,540
050,51,165,"Virginia","Rockingham County",5,33,1049,518,531
050,51,165,"Virginia","Rockingham County",5,34,1038,518,520
050,51,165,"Virginia","Rockingham County",5,35,1046,523,523
050,51,165,"Virginia","Rockingham County",5,36,1060,500,560
050,51,165,"Virginia","Rockingham County",5,37,1080,534,546
050,51,165,"Virginia","Rockingham County",5,38,1030,538,492
050,51,165,"Virginia","Rockingham County",5,39,1035,524,511
050,51,165,"Virginia","Rockingham County",5,40,1074,544,530
050,51,165,"Virginia","Rockingham County",5,41,1078,552,526
050,51,165,"Virginia","Rockingham County",5,42,1096,558,538
050,51,165,"Virginia","Rockingham County",5,43,1043,531,512
050,51,165,"Virginia","Rockingham County",5,44,1052,536,516
050,51,165,"Virginia","Rockingham County",5,45,994,493,501
050,51,165,"Virginia","Rockingham County",5,46,983,514,469
050,51,165,"Virginia","Rockingham County",5,47,955,483,472
050,51,165,"Virginia","Rockingham County",5,48,950,488,462
050,51,165,"Virginia","Rockingham County",5,49,954,494,460
050,51,165,"Virginia","Rockingham County",5,50,957,469,488
050,51,165,"Virginia","Rockingham County",5,51,1013,484,529
050,51,165,"Virginia","Rockingham County",5,52,1090,537,553
050,51,165,"Virginia","Rockingham County",5,53,1092,553,539
050,51,165,"Virginia","Rockingham County",5,54,1067,528,539
050,51,165,"Virginia","Rockingham County",5,55,1033,525,508
050,51,165,"Virginia","Rockingham County",5,56,1082,551,531
050,51,165,"Virginia","Rockingham County",5,57,1064,533,531
050,51,165,"Virginia","Rockingham County",5,58,1095,546,549
050,51,165,"Virginia","Rockingham County",5,59,1154,580,574
050,51,165,"Virginia","Rockingham County",5,60,1186,582,604
050,51,165,"Virginia","Rockingham County",5,61,1200,605,595
050,51,165,"Virginia","Rockingham County",5,62,1175,590,585
050,51,165,"Virginia","Rockingham County",5,63,1098,544,554
050,51,165,"Virginia","Rockingham County",5,64,1107,535,572
050,51,165,"Virginia","Rockingham County",5,65,1142,571,571
050,51,165,"Virginia","Rockingham County",5,66,1119,526,593
050,51,165,"Virginia","Rockingham County",5,67,1070,505,565
050,51,165,"Virginia","Rockingham County",5,68,1081,516,565
050,51,165,"Virginia","Rockingham County",5,69,1019,488,531
050,51,165,"Virginia","Rockingham County",5,70,979,496,483
050,51,165,"Virginia","Rockingham County",5,71,953,480,473
050,51,165,"Virginia","Rockingham County",5,72,904,456,448
050,51,165,"Virginia","Rockingham County",5,73,879,445,434
050,51,165,"Virginia","Rockingham County",5,74,796,395,401
050,51,165,"Virginia","Rockingham County",5,75,832,407,425
050,51,165,"Virginia","Rockingham County",5,76,821,381,440
050,51,165,"Virginia","Rockingham County",5,77,567,266,301
050,51,165,"Virginia","Rockingham County",5,78,538,240,298
050,51,165,"Virginia","Rockingham County",5,79,568,247,321
050,51,165,"Virginia","Rockingham County",5,80,575,239,336
050,51,165,"Virginia","Rockingham County",5,81,506,213,293
050,51,165,"Virginia","Rockingham County",5,82,461,200,261
050,51,165,"Virginia","Rockingham County",5,83,380,169,211
050,51,165,"Virginia","Rockingham County",5,84,336,136,200
050,51,165,"Virginia","Rockingham County",5,85,2239,802,1437
050,51,167,"Virginia","Russell County",1,0,253,129,124
050,51,167,"Virginia","Russell County",1,1,242,126,116
050,51,167,"Virginia","Russell County",1,2,247,116,131
050,51,167,"Virginia","Russell County",1,3,247,120,127
050,51,167,"Virginia","Russell County",1,4,254,121,133
050,51,167,"Virginia","Russell County",1,5,265,132,133
050,51,167,"Virginia","Russell County",1,6,270,145,125
050,51,167,"Virginia","Russell County",1,7,274,133,141
050,51,167,"Virginia","Russell County",1,8,247,120,127
050,51,167,"Virginia","Russell County",1,9,268,134,134
050,51,167,"Virginia","Russell County",1,10,285,152,133
050,51,167,"Virginia","Russell County",1,11,290,150,140
050,51,167,"Virginia","Russell County",1,12,298,151,147
050,51,167,"Virginia","Russell County",1,13,291,151,140
050,51,167,"Virginia","Russell County",1,14,311,162,149
050,51,167,"Virginia","Russell County",1,15,285,143,142
050,51,167,"Virginia","Russell County",1,16,284,130,154
050,51,167,"Virginia","Russell County",1,17,301,157,144
050,51,167,"Virginia","Russell County",1,18,255,133,122
050,51,167,"Virginia","Russell County",1,19,199,104,95
050,51,167,"Virginia","Russell County",1,20,232,119,113
050,51,167,"Virginia","Russell County",1,21,232,116,116
050,51,167,"Virginia","Russell County",1,22,250,133,117
050,51,167,"Virginia","Russell County",1,23,266,131,135
050,51,167,"Virginia","Russell County",1,24,270,143,127
050,51,167,"Virginia","Russell County",1,25,244,133,111
050,51,167,"Virginia","Russell County",1,26,270,136,134
050,51,167,"Virginia","Russell County",1,27,277,139,138
050,51,167,"Virginia","Russell County",1,28,275,142,133
050,51,167,"Virginia","Russell County",1,29,275,137,138
050,51,167,"Virginia","Russell County",1,30,304,153,151
050,51,167,"Virginia","Russell County",1,31,274,129,145
050,51,167,"Virginia","Russell County",1,32,262,122,140
050,51,167,"Virginia","Russell County",1,33,269,134,135
050,51,167,"Virginia","Russell County",1,34,258,124,134
050,51,167,"Virginia","Russell County",1,35,248,122,126
050,51,167,"Virginia","Russell County",1,36,269,153,116
050,51,167,"Virginia","Russell County",1,37,292,169,123
050,51,167,"Virginia","Russell County",1,38,292,152,140
050,51,167,"Virginia","Russell County",1,39,322,155,167
050,51,167,"Virginia","Russell County",1,40,308,153,155
050,51,167,"Virginia","Russell County",1,41,309,155,154
050,51,167,"Virginia","Russell County",1,42,298,155,143
050,51,167,"Virginia","Russell County",1,43,300,137,163
050,51,167,"Virginia","Russell County",1,44,301,159,142
050,51,167,"Virginia","Russell County",1,45,328,166,162
050,51,167,"Virginia","Russell County",1,46,336,162,174
050,51,167,"Virginia","Russell County",1,47,349,172,177
050,51,167,"Virginia","Russell County",1,48,360,178,182
050,51,167,"Virginia","Russell County",1,49,353,178,175
050,51,167,"Virginia","Russell County",1,50,355,183,172
050,51,167,"Virginia","Russell County",1,51,370,184,186
050,51,167,"Virginia","Russell County",1,52,364,179,185
050,51,167,"Virginia","Russell County",1,53,343,169,174
050,51,167,"Virginia","Russell County",1,54,366,180,186
050,51,167,"Virginia","Russell County",1,55,391,191,200
050,51,167,"Virginia","Russell County",1,56,360,175,185
050,51,167,"Virginia","Russell County",1,57,406,190,216
050,51,167,"Virginia","Russell County",1,58,438,216,222
050,51,167,"Virginia","Russell County",1,59,433,219,214
050,51,167,"Virginia","Russell County",1,60,434,214,220
050,51,167,"Virginia","Russell County",1,61,439,218,221
050,51,167,"Virginia","Russell County",1,62,451,229,222
050,51,167,"Virginia","Russell County",1,63,427,215,212
050,51,167,"Virginia","Russell County",1,64,408,194,214
050,51,167,"Virginia","Russell County",1,65,380,182,198
050,51,167,"Virginia","Russell County",1,66,414,205,209
050,51,167,"Virginia","Russell County",1,67,395,189,206
050,51,167,"Virginia","Russell County",1,68,355,164,191
050,51,167,"Virginia","Russell County",1,69,323,166,157
050,51,167,"Virginia","Russell County",1,70,342,183,159
050,51,167,"Virginia","Russell County",1,71,351,178,173
050,51,167,"Virginia","Russell County",1,72,351,177,174
050,51,167,"Virginia","Russell County",1,73,322,154,168
050,51,167,"Virginia","Russell County",1,74,231,102,129
050,51,167,"Virginia","Russell County",1,75,232,109,123
050,51,167,"Virginia","Russell County",1,76,238,111,127
050,51,167,"Virginia","Russell County",1,77,223,90,133
050,51,167,"Virginia","Russell County",1,78,194,78,116
050,51,167,"Virginia","Russell County",1,79,182,84,98
050,51,167,"Virginia","Russell County",1,80,151,63,88
050,51,167,"Virginia","Russell County",1,81,163,68,95
050,51,167,"Virginia","Russell County",1,82,135,55,80
050,51,167,"Virginia","Russell County",1,83,122,43,79
050,51,167,"Virginia","Russell County",1,84,118,46,72
050,51,167,"Virginia","Russell County",1,85,588,218,370
050,51,167,"Virginia","Russell County",2,0,229,113,116
050,51,167,"Virginia","Russell County",2,1,244,126,118
050,51,167,"Virginia","Russell County",2,2,246,119,127
050,51,167,"Virginia","Russell County",2,3,248,119,129
050,51,167,"Virginia","Russell County",2,4,255,122,133
050,51,167,"Virginia","Russell County",2,5,265,132,133
050,51,167,"Virginia","Russell County",2,6,270,143,127
050,51,167,"Virginia","Russell County",2,7,272,135,137
050,51,167,"Virginia","Russell County",2,8,254,123,131
050,51,167,"Virginia","Russell County",2,9,261,129,132
050,51,167,"Virginia","Russell County",2,10,282,148,134
050,51,167,"Virginia","Russell County",2,11,288,151,137
050,51,167,"Virginia","Russell County",2,12,296,151,145
050,51,167,"Virginia","Russell County",2,13,293,151,142
050,51,167,"Virginia","Russell County",2,14,307,160,147
050,51,167,"Virginia","Russell County",2,15,291,147,144
050,51,167,"Virginia","Russell County",2,16,286,133,153
050,51,167,"Virginia","Russell County",2,17,299,151,148
050,51,167,"Virginia","Russell County",2,18,252,133,119
050,51,167,"Virginia","Russell County",2,19,202,106,96
050,51,167,"Virginia","Russell County",2,20,231,118,113
050,51,167,"Virginia","Russell County",2,21,233,118,115
050,51,167,"Virginia","Russell County",2,22,251,132,119
050,51,167,"Virginia","Russell County",2,23,264,132,132
050,51,167,"Virginia","Russell County",2,24,271,143,128
050,51,167,"Virginia","Russell County",2,25,251,136,115
050,51,167,"Virginia","Russell County",2,26,264,135,129
050,51,167,"Virginia","Russell County",2,27,277,140,137
050,51,167,"Virginia","Russell County",2,28,275,142,133
050,51,167,"Virginia","Russell County",2,29,273,137,136
050,51,167,"Virginia","Russell County",2,30,296,149,147
050,51,167,"Virginia","Russell County",2,31,281,133,148
050,51,167,"Virginia","Russell County",2,32,266,124,142
050,51,167,"Virginia","Russell County",2,33,265,130,135
050,51,167,"Virginia","Russell County",2,34,262,129,133
050,51,167,"Virginia","Russell County",2,35,254,125,129
050,51,167,"Virginia","Russell County",2,36,265,148,117
050,51,167,"Virginia","Russell County",2,37,284,164,120
050,51,167,"Virginia","Russell County",2,38,294,156,138
050,51,167,"Virginia","Russell County",2,39,317,156,161
050,51,167,"Virginia","Russell County",2,40,315,156,159
050,51,167,"Virginia","Russell County",2,41,309,156,153
050,51,167,"Virginia","Russell County",2,42,298,152,146
050,51,167,"Virginia","Russell County",2,43,302,143,159
050,51,167,"Virginia","Russell County",2,44,296,151,145
050,51,167,"Virginia","Russell County",2,45,322,164,158
050,51,167,"Virginia","Russell County",2,46,333,163,170
050,51,167,"Virginia","Russell County",2,47,344,168,176
050,51,167,"Virginia","Russell County",2,48,357,177,180
050,51,167,"Virginia","Russell County",2,49,358,180,178
050,51,167,"Virginia","Russell County",2,50,357,183,174
050,51,167,"Virginia","Russell County",2,51,365,184,181
050,51,167,"Virginia","Russell County",2,52,362,177,185
050,51,167,"Virginia","Russell County",2,53,347,170,177
050,51,167,"Virginia","Russell County",2,54,359,176,183
050,51,167,"Virginia","Russell County",2,55,384,188,196
050,51,167,"Virginia","Russell County",2,56,370,179,191
050,51,167,"Virginia","Russell County",2,57,397,187,210
050,51,167,"Virginia","Russell County",2,58,431,210,221
050,51,167,"Virginia","Russell County",2,59,435,218,217
050,51,167,"Virginia","Russell County",2,60,430,214,216
050,51,167,"Virginia","Russell County",2,61,439,218,221
050,51,167,"Virginia","Russell County",2,62,444,224,220
050,51,167,"Virginia","Russell County",2,63,434,220,214
050,51,167,"Virginia","Russell County",2,64,410,198,212
050,51,167,"Virginia","Russell County",2,65,384,182,202
050,51,167,"Virginia","Russell County",2,66,404,198,206
050,51,167,"Virginia","Russell County",2,67,399,192,207
050,51,167,"Virginia","Russell County",2,68,361,169,192
050,51,167,"Virginia","Russell County",2,69,332,167,165
050,51,167,"Virginia","Russell County",2,70,336,178,158
050,51,167,"Virginia","Russell County",2,71,349,178,171
050,51,167,"Virginia","Russell County",2,72,343,174,169
050,51,167,"Virginia","Russell County",2,73,345,168,177
050,51,167,"Virginia","Russell County",2,74,237,108,129
050,51,167,"Virginia","Russell County",2,75,231,106,125
050,51,167,"Virginia","Russell County",2,76,231,109,122
050,51,167,"Virginia","Russell County",2,77,232,97,135
050,51,167,"Virginia","Russell County",2,78,193,77,116
050,51,167,"Virginia","Russell County",2,79,183,81,102
050,51,167,"Virginia","Russell County",2,80,158,69,89
050,51,167,"Virginia","Russell County",2,81,156,64,92
050,51,167,"Virginia","Russell County",2,82,139,57,82
050,51,167,"Virginia","Russell County",2,83,122,45,77
050,51,167,"Virginia","Russell County",2,84,117,45,72
050,51,167,"Virginia","Russell County",2,85,593,219,374
050,51,167,"Virginia","Russell County",3,0,240,124,116
050,51,167,"Virginia","Russell County",3,1,226,114,112
050,51,167,"Virginia","Russell County",3,2,257,135,122
050,51,167,"Virginia","Russell County",3,3,238,123,115
050,51,167,"Virginia","Russell County",3,4,257,131,126
050,51,167,"Virginia","Russell County",3,5,253,125,128
050,51,167,"Virginia","Russell County",3,6,263,131,132
050,51,167,"Virginia","Russell County",3,7,262,137,125
050,51,167,"Virginia","Russell County",3,8,288,144,144
050,51,167,"Virginia","Russell County",3,9,257,123,134
050,51,167,"Virginia","Russell County",3,10,266,144,122
050,51,167,"Virginia","Russell County",3,11,283,150,133
050,51,167,"Virginia","Russell County",3,12,279,144,135
050,51,167,"Virginia","Russell County",3,13,302,155,147
050,51,167,"Virginia","Russell County",3,14,290,152,138
050,51,167,"Virginia","Russell County",3,15,301,153,148
050,51,167,"Virginia","Russell County",3,16,299,150,149
050,51,167,"Virginia","Russell County",3,17,281,135,146
050,51,167,"Virginia","Russell County",3,18,253,135,118
050,51,167,"Virginia","Russell County",3,19,204,104,100
050,51,167,"Virginia","Russell County",3,20,224,115,109
050,51,167,"Virginia","Russell County",3,21,246,118,128
050,51,167,"Virginia","Russell County",3,22,262,130,132
050,51,167,"Virginia","Russell County",3,23,274,142,132
050,51,167,"Virginia","Russell County",3,24,260,132,128
050,51,167,"Virginia","Russell County",3,25,264,137,127
050,51,167,"Virginia","Russell County",3,26,258,142,116
050,51,167,"Virginia","Russell County",3,27,275,140,135
050,51,167,"Virginia","Russell County",3,28,282,142,140
050,51,167,"Virginia","Russell County",3,29,281,148,133
050,51,167,"Virginia","Russell County",3,30,271,139,132
050,51,167,"Virginia","Russell County",3,31,299,149,150
050,51,167,"Virginia","Russell County",3,32,275,135,140
050,51,167,"Virginia","Russell County",3,33,261,120,141
050,51,167,"Virginia","Russell County",3,34,272,131,141
050,51,167,"Virginia","Russell County",3,35,260,124,136
050,51,167,"Virginia","Russell County",3,36,260,130,130
050,51,167,"Virginia","Russell County",3,37,263,143,120
050,51,167,"Virginia","Russell County",3,38,277,153,124
050,51,167,"Virginia","Russell County",3,39,300,161,139
050,51,167,"Virginia","Russell County",3,40,321,159,162
050,51,167,"Virginia","Russell County",3,41,315,160,155
050,51,167,"Virginia","Russell County",3,42,304,152,152
050,51,167,"Virginia","Russell County",3,43,292,150,142
050,51,167,"Virginia","Russell County",3,44,302,146,156
050,51,167,"Virginia","Russell County",3,45,300,154,146
050,51,167,"Virginia","Russell County",3,46,325,164,161
050,51,167,"Virginia","Russell County",3,47,320,157,163
050,51,167,"Virginia","Russell County",3,48,345,167,178
050,51,167,"Virginia","Russell County",3,49,356,176,180
050,51,167,"Virginia","Russell County",3,50,360,179,181
050,51,167,"Virginia","Russell County",3,51,354,183,171
050,51,167,"Virginia","Russell County",3,52,358,182,176
050,51,167,"Virginia","Russell County",3,53,358,171,187
050,51,167,"Virginia","Russell County",3,54,337,168,169
050,51,167,"Virginia","Russell County",3,55,358,177,181
050,51,167,"Virginia","Russell County",3,56,375,181,194
050,51,167,"Virginia","Russell County",3,57,357,176,181
050,51,167,"Virginia","Russell County",3,58,381,179,202
050,51,167,"Virginia","Russell County",3,59,416,201,215
050,51,167,"Virginia","Russell County",3,60,427,210,217
050,51,167,"Virginia","Russell County",3,61,419,208,211
050,51,167,"Virginia","Russell County",3,62,434,212,222
050,51,167,"Virginia","Russell County",3,63,425,221,204
050,51,167,"Virginia","Russell County",3,64,426,216,210
050,51,167,"Virginia","Russell County",3,65,406,195,211
050,51,167,"Virginia","Russell County",3,66,375,173,202
050,51,167,"Virginia","Russell County",3,67,398,194,204
050,51,167,"Virginia","Russell County",3,68,391,189,202
050,51,167,"Virginia","Russell County",3,69,352,165,187
050,51,167,"Virginia","Russell County",3,70,330,165,165
050,51,167,"Virginia","Russell County",3,71,341,175,166
050,51,167,"Virginia","Russell County",3,72,338,173,165
050,51,167,"Virginia","Russell County",3,73,324,164,160
050,51,167,"Virginia","Russell County",3,74,339,164,175
050,51,167,"Virginia","Russell County",3,75,225,106,119
050,51,167,"Virginia","Russell County",3,76,220,102,118
050,51,167,"Virginia","Russell County",3,77,224,104,120
050,51,167,"Virginia","Russell County",3,78,218,88,130
050,51,167,"Virginia","Russell County",3,79,184,68,116
050,51,167,"Virginia","Russell County",3,80,162,74,88
050,51,167,"Virginia","Russell County",3,81,139,58,81
050,51,167,"Virginia","Russell County",3,82,146,58,88
050,51,167,"Virginia","Russell County",3,83,130,55,75
050,51,167,"Virginia","Russell County",3,84,116,40,76
050,51,167,"Virginia","Russell County",3,85,586,227,359
050,51,167,"Virginia","Russell County",4,0,264,144,120
050,51,167,"Virginia","Russell County",4,1,261,132,129
050,51,167,"Virginia","Russell County",4,2,221,112,109
050,51,167,"Virginia","Russell County",4,3,267,138,129
050,51,167,"Virginia","Russell County",4,4,236,116,120
050,51,167,"Virginia","Russell County",4,5,248,126,122
050,51,167,"Virginia","Russell County",4,6,261,131,130
050,51,167,"Virginia","Russell County",4,7,259,133,126
050,51,167,"Virginia","Russell County",4,8,277,146,131
050,51,167,"Virginia","Russell County",4,9,296,150,146
050,51,167,"Virginia","Russell County",4,10,257,125,132
050,51,167,"Virginia","Russell County",4,11,280,148,132
050,51,167,"Virginia","Russell County",4,12,284,145,139
050,51,167,"Virginia","Russell County",4,13,292,147,145
050,51,167,"Virginia","Russell County",4,14,316,160,156
050,51,167,"Virginia","Russell County",4,15,296,160,136
050,51,167,"Virginia","Russell County",4,16,288,149,139
050,51,167,"Virginia","Russell County",4,17,295,146,149
050,51,167,"Virginia","Russell County",4,18,229,113,116
050,51,167,"Virginia","Russell County",4,19,204,108,96
050,51,167,"Virginia","Russell County",4,20,218,108,110
050,51,167,"Virginia","Russell County",4,21,234,117,117
050,51,167,"Virginia","Russell County",4,22,260,123,137
050,51,167,"Virginia","Russell County",4,23,271,132,139
050,51,167,"Virginia","Russell County",4,24,277,144,133
050,51,167,"Virginia","Russell County",4,25,244,119,125
050,51,167,"Virginia","Russell County",4,26,261,141,120
050,51,167,"Virginia","Russell County",4,27,264,141,123
050,51,167,"Virginia","Russell County",4,28,287,140,147
050,51,167,"Virginia","Russell County",4,29,283,140,143
050,51,167,"Virginia","Russell County",4,30,280,143,137
050,51,167,"Virginia","Russell County",4,31,285,152,133
050,51,167,"Virginia","Russell County",4,32,292,149,143
050,51,167,"Virginia","Russell County",4,33,276,136,140
050,51,167,"Virginia","Russell County",4,34,261,121,140
050,51,167,"Virginia","Russell County",4,35,278,130,148
050,51,167,"Virginia","Russell County",4,36,265,127,138
050,51,167,"Virginia","Russell County",4,37,260,131,129
050,51,167,"Virginia","Russell County",4,38,265,140,125
050,51,167,"Virginia","Russell County",4,39,278,153,125
050,51,167,"Virginia","Russell County",4,40,302,163,139
050,51,167,"Virginia","Russell County",4,41,320,158,162
050,51,167,"Virginia","Russell County",4,42,309,154,155
050,51,167,"Virginia","Russell County",4,43,299,149,150
050,51,167,"Virginia","Russell County",4,44,293,152,141
050,51,167,"Virginia","Russell County",4,45,315,153,162
050,51,167,"Virginia","Russell County",4,46,296,155,141
050,51,167,"Virginia","Russell County",4,47,313,162,151
050,51,167,"Virginia","Russell County",4,48,320,158,162
050,51,167,"Virginia","Russell County",4,49,337,164,173
050,51,167,"Virginia","Russell County",4,50,361,176,185
050,51,167,"Virginia","Russell County",4,51,355,174,181
050,51,167,"Virginia","Russell County",4,52,349,183,166
050,51,167,"Virginia","Russell County",4,53,357,179,178
050,51,167,"Virginia","Russell County",4,54,357,168,189
050,51,167,"Virginia","Russell County",4,55,324,161,163
050,51,167,"Virginia","Russell County",4,56,357,175,182
050,51,167,"Virginia","Russell County",4,57,370,183,187
050,51,167,"Virginia","Russell County",4,58,349,169,180
050,51,167,"Virginia","Russell County",4,59,368,170,198
050,51,167,"Virginia","Russell County",4,60,410,193,217
050,51,167,"Virginia","Russell County",4,61,411,202,209
050,51,167,"Virginia","Russell County",4,62,416,201,215
050,51,167,"Virginia","Russell County",4,63,421,210,211
050,51,167,"Virginia","Russell County",4,64,427,220,207
050,51,167,"Virginia","Russell County",4,65,417,213,204
050,51,167,"Virginia","Russell County",4,66,406,190,216
050,51,167,"Virginia","Russell County",4,67,360,161,199
050,51,167,"Virginia","Russell County",4,68,390,189,201
050,51,167,"Virginia","Russell County",4,69,374,182,192
050,51,167,"Virginia","Russell County",4,70,347,161,186
050,51,167,"Virginia","Russell County",4,71,329,162,167
050,51,167,"Virginia","Russell County",4,72,337,177,160
050,51,167,"Virginia","Russell County",4,73,315,158,157
050,51,167,"Virginia","Russell County",4,74,318,162,156
050,51,167,"Virginia","Russell County",4,75,318,154,164
050,51,167,"Virginia","Russell County",4,76,220,107,113
050,51,167,"Virginia","Russell County",4,77,211,96,115
050,51,167,"Virginia","Russell County",4,78,207,97,110
050,51,167,"Virginia","Russell County",4,79,209,81,128
050,51,167,"Virginia","Russell County",4,80,167,63,104
050,51,167,"Virginia","Russell County",4,81,145,65,80
050,51,167,"Virginia","Russell County",4,82,129,52,77
050,51,167,"Virginia","Russell County",4,83,137,54,83
050,51,167,"Virginia","Russell County",4,84,122,49,73
050,51,167,"Virginia","Russell County",4,85,573,218,355
050,51,167,"Virginia","Russell County",5,0,262,142,120
050,51,167,"Virginia","Russell County",5,1,277,153,124
050,51,167,"Virginia","Russell County",5,2,260,135,125
050,51,167,"Virginia","Russell County",5,3,232,114,118
050,51,167,"Virginia","Russell County",5,4,273,143,130
050,51,167,"Virginia","Russell County",5,5,247,123,124
050,51,167,"Virginia","Russell County",5,6,253,128,125
050,51,167,"Virginia","Russell County",5,7,269,139,130
050,51,167,"Virginia","Russell County",5,8,264,138,126
050,51,167,"Virginia","Russell County",5,9,273,145,128
050,51,167,"Virginia","Russell County",5,10,306,159,147
050,51,167,"Virginia","Russell County",5,11,261,128,133
050,51,167,"Virginia","Russell County",5,12,273,148,125
050,51,167,"Virginia","Russell County",5,13,279,148,131
050,51,167,"Virginia","Russell County",5,14,286,145,141
050,51,167,"Virginia","Russell County",5,15,311,158,153
050,51,167,"Virginia","Russell County",5,16,297,161,136
050,51,167,"Virginia","Russell County",5,17,299,154,145
050,51,167,"Virginia","Russell County",5,18,249,130,119
050,51,167,"Virginia","Russell County",5,19,174,88,86
050,51,167,"Virginia","Russell County",5,20,228,123,105
050,51,167,"Virginia","Russell County",5,21,235,113,122
050,51,167,"Virginia","Russell County",5,22,257,126,131
050,51,167,"Virginia","Russell County",5,23,269,127,142
050,51,167,"Virginia","Russell County",5,24,281,141,140
050,51,167,"Virginia","Russell County",5,25,292,148,144
050,51,167,"Virginia","Russell County",5,26,255,126,129
050,51,167,"Virginia","Russell County",5,27,263,140,123
050,51,167,"Virginia","Russell County",5,28,286,157,129
050,51,167,"Virginia","Russell County",5,29,291,142,149
050,51,167,"Virginia","Russell County",5,30,294,149,145
050,51,167,"Virginia","Russell County",5,31,277,146,131
050,51,167,"Virginia","Russell County",5,32,289,157,132
050,51,167,"Virginia","Russell County",5,33,298,155,143
050,51,167,"Virginia","Russell County",5,34,282,133,149
050,51,167,"Virginia","Russell County",5,35,250,117,133
050,51,167,"Virginia","Russell County",5,36,269,132,137
050,51,167,"Virginia","Russell County",5,37,259,120,139
050,51,167,"Virginia","Russell County",5,38,261,132,129
050,51,167,"Virginia","Russell County",5,39,270,141,129
050,51,167,"Virginia","Russell County",5,40,286,153,133
050,51,167,"Virginia","Russell County",5,41,308,176,132
050,51,167,"Virginia","Russell County",5,42,328,160,168
050,51,167,"Virginia","Russell County",5,43,317,157,160
050,51,167,"Virginia","Russell County",5,44,311,155,156
050,51,167,"Virginia","Russell County",5,45,286,148,138
050,51,167,"Virginia","Russell County",5,46,324,159,165
050,51,167,"Virginia","Russell County",5,47,292,155,137
050,51,167,"Virginia","Russell County",5,48,308,161,147
050,51,167,"Virginia","Russell County",5,49,317,156,161
050,51,167,"Virginia","Russell County",5,50,348,169,179
050,51,167,"Virginia","Russell County",5,51,363,179,184
050,51,167,"Virginia","Russell County",5,52,346,166,180
050,51,167,"Virginia","Russell County",5,53,350,179,171
050,51,167,"Virginia","Russell County",5,54,359,179,180
050,51,167,"Virginia","Russell County",5,55,357,170,187
050,51,167,"Virginia","Russell County",5,56,321,158,163
050,51,167,"Virginia","Russell County",5,57,355,175,180
050,51,167,"Virginia","Russell County",5,58,366,181,185
050,51,167,"Virginia","Russell County",5,59,336,164,172
050,51,167,"Virginia","Russell County",5,60,350,160,190
050,51,167,"Virginia","Russell County",5,61,396,187,209
050,51,167,"Virginia","Russell County",5,62,410,190,220
050,51,167,"Virginia","Russell County",5,63,410,202,208
050,51,167,"Virginia","Russell County",5,64,421,209,212
050,51,167,"Virginia","Russell County",5,65,420,215,205
050,51,167,"Virginia","Russell County",5,66,410,206,204
050,51,167,"Virginia","Russell County",5,67,405,187,218
050,51,167,"Virginia","Russell County",5,68,350,154,196
050,51,167,"Virginia","Russell County",5,69,375,183,192
050,51,167,"Virginia","Russell County",5,70,367,178,189
050,51,167,"Virginia","Russell County",5,71,348,158,190
050,51,167,"Virginia","Russell County",5,72,318,160,158
050,51,167,"Virginia","Russell County",5,73,319,165,154
050,51,167,"Virginia","Russell County",5,74,309,156,153
050,51,167,"Virginia","Russell County",5,75,307,156,151
050,51,167,"Virginia","Russell County",5,76,308,152,156
050,51,167,"Virginia","Russell County",5,77,216,103,113
050,51,167,"Virginia","Russell County",5,78,196,88,108
050,51,167,"Virginia","Russell County",5,79,203,92,111
050,51,167,"Virginia","Russell County",5,80,189,77,112
050,51,167,"Virginia","Russell County",5,81,150,54,96
050,51,167,"Virginia","Russell County",5,82,130,58,72
050,51,167,"Virginia","Russell County",5,83,118,48,70
050,51,167,"Virginia","Russell County",5,84,130,47,83
050,51,167,"Virginia","Russell County",5,85,593,232,361
050,51,169,"Virginia","Scott County",1,0,156,80,76
050,51,169,"Virginia","Scott County",1,1,165,85,80
050,51,169,"Virginia","Scott County",1,2,161,90,71
050,51,169,"Virginia","Scott County",1,3,181,101,80
050,51,169,"Virginia","Scott County",1,4,186,94,92
050,51,169,"Virginia","Scott County",1,5,199,100,99
050,51,169,"Virginia","Scott County",1,6,203,103,100
050,51,169,"Virginia","Scott County",1,7,203,102,101
050,51,169,"Virginia","Scott County",1,8,218,103,115
050,51,169,"Virginia","Scott County",1,9,228,116,112
050,51,169,"Virginia","Scott County",1,10,249,131,118
050,51,169,"Virginia","Scott County",1,11,261,127,134
050,51,169,"Virginia","Scott County",1,12,233,108,125
050,51,169,"Virginia","Scott County",1,13,249,127,122
050,51,169,"Virginia","Scott County",1,14,250,135,115
050,51,169,"Virginia","Scott County",1,15,234,128,106
050,51,169,"Virginia","Scott County",1,16,244,120,124
050,51,169,"Virginia","Scott County",1,17,245,121,124
050,51,169,"Virginia","Scott County",1,18,211,113,98
050,51,169,"Virginia","Scott County",1,19,166,87,79
050,51,169,"Virginia","Scott County",1,20,191,104,87
050,51,169,"Virginia","Scott County",1,21,213,112,101
050,51,169,"Virginia","Scott County",1,22,209,107,102
050,51,169,"Virginia","Scott County",1,23,219,120,99
050,51,169,"Virginia","Scott County",1,24,229,121,108
050,51,169,"Virginia","Scott County",1,25,225,122,103
050,51,169,"Virginia","Scott County",1,26,195,108,87
050,51,169,"Virginia","Scott County",1,27,213,122,91
050,51,169,"Virginia","Scott County",1,28,226,128,98
050,51,169,"Virginia","Scott County",1,29,241,133,108
050,51,169,"Virginia","Scott County",1,30,250,127,123
050,51,169,"Virginia","Scott County",1,31,214,115,99
050,51,169,"Virginia","Scott County",1,32,223,120,103
050,51,169,"Virginia","Scott County",1,33,226,121,105
050,51,169,"Virginia","Scott County",1,34,235,123,112
050,51,169,"Virginia","Scott County",1,35,242,118,124
050,51,169,"Virginia","Scott County",1,36,236,121,115
050,51,169,"Virginia","Scott County",1,37,215,110,105
050,51,169,"Virginia","Scott County",1,38,233,120,113
050,51,169,"Virginia","Scott County",1,39,260,138,122
050,51,169,"Virginia","Scott County",1,40,254,135,119
050,51,169,"Virginia","Scott County",1,41,259,140,119
050,51,169,"Virginia","Scott County",1,42,265,141,124
050,51,169,"Virginia","Scott County",1,43,232,125,107
050,51,169,"Virginia","Scott County",1,44,244,134,110
050,51,169,"Virginia","Scott County",1,45,239,131,108
050,51,169,"Virginia","Scott County",1,46,272,142,130
050,51,169,"Virginia","Scott County",1,47,279,143,136
050,51,169,"Virginia","Scott County",1,48,301,155,146
050,51,169,"Virginia","Scott County",1,49,301,160,141
050,51,169,"Virginia","Scott County",1,50,285,143,142
050,51,169,"Virginia","Scott County",1,51,297,145,152
050,51,169,"Virginia","Scott County",1,52,316,170,146
050,51,169,"Virginia","Scott County",1,53,311,153,158
050,51,169,"Virginia","Scott County",1,54,310,158,152
050,51,169,"Virginia","Scott County",1,55,326,164,162
050,51,169,"Virginia","Scott County",1,56,325,171,154
050,51,169,"Virginia","Scott County",1,57,329,169,160
050,51,169,"Virginia","Scott County",1,58,353,180,173
050,51,169,"Virginia","Scott County",1,59,353,187,166
050,51,169,"Virginia","Scott County",1,60,320,173,147
050,51,169,"Virginia","Scott County",1,61,330,162,168
050,51,169,"Virginia","Scott County",1,62,331,165,166
050,51,169,"Virginia","Scott County",1,63,324,163,161
050,51,169,"Virginia","Scott County",1,64,321,165,156
050,51,169,"Virginia","Scott County",1,65,337,170,167
050,51,169,"Virginia","Scott County",1,66,314,156,158
050,51,169,"Virginia","Scott County",1,67,330,154,176
050,51,169,"Virginia","Scott County",1,68,317,167,150
050,51,169,"Virginia","Scott County",1,69,283,148,135
050,51,169,"Virginia","Scott County",1,70,300,142,158
050,51,169,"Virginia","Scott County",1,71,294,132,162
050,51,169,"Virginia","Scott County",1,72,286,116,170
050,51,169,"Virginia","Scott County",1,73,299,132,167
050,51,169,"Virginia","Scott County",1,74,235,117,118
050,51,169,"Virginia","Scott County",1,75,230,113,117
050,51,169,"Virginia","Scott County",1,76,230,109,121
050,51,169,"Virginia","Scott County",1,77,224,118,106
050,51,169,"Virginia","Scott County",1,78,182,96,86
050,51,169,"Virginia","Scott County",1,79,189,89,100
050,51,169,"Virginia","Scott County",1,80,157,65,92
050,51,169,"Virginia","Scott County",1,81,157,73,84
050,51,169,"Virginia","Scott County",1,82,143,67,76
050,51,169,"Virginia","Scott County",1,83,132,56,76
050,51,169,"Virginia","Scott County",1,84,124,55,69
050,51,169,"Virginia","Scott County",1,85,592,237,355
050,51,169,"Virginia","Scott County",2,0,158,77,81
050,51,169,"Virginia","Scott County",2,1,164,84,80
050,51,169,"Virginia","Scott County",2,2,164,89,75
050,51,169,"Virginia","Scott County",2,3,177,99,78
050,51,169,"Virginia","Scott County",2,4,188,97,91
050,51,169,"Virginia","Scott County",2,5,198,100,98
050,51,169,"Virginia","Scott County",2,6,203,103,100
050,51,169,"Virginia","Scott County",2,7,205,103,102
050,51,169,"Virginia","Scott County",2,8,216,104,112
050,51,169,"Virginia","Scott County",2,9,227,114,113
050,51,169,"Virginia","Scott County",2,10,245,128,117
050,51,169,"Virginia","Scott County",2,11,257,128,129
050,51,169,"Virginia","Scott County",2,12,240,114,126
050,51,169,"Virginia","Scott County",2,13,246,123,123
050,51,169,"Virginia","Scott County",2,14,249,133,116
050,51,169,"Virginia","Scott County",2,15,239,129,110
050,51,169,"Virginia","Scott County",2,16,244,123,121
050,51,169,"Virginia","Scott County",2,17,246,121,125
050,51,169,"Virginia","Scott County",2,18,211,112,99
050,51,169,"Virginia","Scott County",2,19,169,89,80
050,51,169,"Virginia","Scott County",2,20,192,105,87
050,51,169,"Virginia","Scott County",2,21,209,111,98
050,51,169,"Virginia","Scott County",2,22,213,110,103
050,51,169,"Virginia","Scott County",2,23,219,118,101
050,51,169,"Virginia","Scott County",2,24,231,123,108
050,51,169,"Virginia","Scott County",2,25,223,120,103
050,51,169,"Virginia","Scott County",2,26,201,111,90
050,51,169,"Virginia","Scott County",2,27,207,119,88
050,51,169,"Virginia","Scott County",2,28,229,130,99
050,51,169,"Virginia","Scott County",2,29,237,131,106
050,51,169,"Virginia","Scott County",2,30,252,132,120
050,51,169,"Virginia","Scott County",2,31,217,115,102
050,51,169,"Virginia","Scott County",2,32,224,121,103
050,51,169,"Virginia","Scott County",2,33,223,119,104
050,51,169,"Virginia","Scott County",2,34,234,123,111
050,51,169,"Virginia","Scott County",2,35,244,121,123
050,51,169,"Virginia","Scott County",2,36,232,119,113
050,51,169,"Virginia","Scott County",2,37,221,113,108
050,51,169,"Virginia","Scott County",2,38,231,119,112
050,51,169,"Virginia","Scott County",2,39,256,135,121
050,51,169,"Virginia","Scott County",2,40,258,139,119
050,51,169,"Virginia","Scott County",2,41,258,138,120
050,51,169,"Virginia","Scott County",2,42,266,142,124
050,51,169,"Virginia","Scott County",2,43,240,128,112
050,51,169,"Virginia","Scott County",2,44,240,133,107
050,51,169,"Virginia","Scott County",2,45,242,133,109
050,51,169,"Virginia","Scott County",2,46,265,140,125
050,51,169,"Virginia","Scott County",2,47,274,140,134
050,51,169,"Virginia","Scott County",2,48,298,154,144
050,51,169,"Virginia","Scott County",2,49,302,158,144
050,51,169,"Virginia","Scott County",2,50,291,149,142
050,51,169,"Virginia","Scott County",2,51,295,147,148
050,51,169,"Virginia","Scott County",2,52,308,162,146
050,51,169,"Virginia","Scott County",2,53,310,155,155
050,51,169,"Virginia","Scott County",2,54,310,158,152
050,51,169,"Virginia","Scott County",2,55,320,161,159
050,51,169,"Virginia","Scott County",2,56,328,171,157
050,51,169,"Virginia","Scott County",2,57,325,167,158
050,51,169,"Virginia","Scott County",2,58,349,180,169
050,51,169,"Virginia","Scott County",2,59,354,185,169
050,51,169,"Virginia","Scott County",2,60,326,174,152
050,51,169,"Virginia","Scott County",2,61,326,164,162
050,51,169,"Virginia","Scott County",2,62,331,165,166
050,51,169,"Virginia","Scott County",2,63,327,163,164
050,51,169,"Virginia","Scott County",2,64,320,164,156
050,51,169,"Virginia","Scott County",2,65,330,167,163
050,51,169,"Virginia","Scott County",2,66,322,160,162
050,51,169,"Virginia","Scott County",2,67,327,154,173
050,51,169,"Virginia","Scott County",2,68,318,163,155
050,51,169,"Virginia","Scott County",2,69,293,152,141
050,51,169,"Virginia","Scott County",2,70,295,142,153
050,51,169,"Virginia","Scott County",2,71,292,133,159
050,51,169,"Virginia","Scott County",2,72,282,116,166
050,51,169,"Virginia","Scott County",2,73,314,136,178
050,51,169,"Virginia","Scott County",2,74,232,112,120
050,51,169,"Virginia","Scott County",2,75,231,113,118
050,51,169,"Virginia","Scott County",2,76,225,106,119
050,51,169,"Virginia","Scott County",2,77,230,119,111
050,51,169,"Virginia","Scott County",2,78,186,97,89
050,51,169,"Virginia","Scott County",2,79,185,89,96
050,51,169,"Virginia","Scott County",2,80,160,69,91
050,51,169,"Virginia","Scott County",2,81,157,72,85
050,51,169,"Virginia","Scott County",2,82,141,65,76
050,51,169,"Virginia","Scott County",2,83,133,58,75
050,51,169,"Virginia","Scott County",2,84,125,55,70
050,51,169,"Virginia","Scott County",2,85,607,245,362
050,51,169,"Virginia","Scott County",3,0,165,87,78
050,51,169,"Virginia","Scott County",3,1,162,78,84
050,51,169,"Virginia","Scott County",3,2,169,86,83
050,51,169,"Virginia","Scott County",3,3,165,94,71
050,51,169,"Virginia","Scott County",3,4,177,100,77
050,51,169,"Virginia","Scott County",3,5,196,101,95
050,51,169,"Virginia","Scott County",3,6,186,95,91
050,51,169,"Virginia","Scott County",3,7,201,95,106
050,51,169,"Virginia","Scott County",3,8,219,111,108
050,51,169,"Virginia","Scott County",3,9,231,113,118
050,51,169,"Virginia","Scott County",3,10,221,112,109
050,51,169,"Virginia","Scott County",3,11,250,135,115
050,51,169,"Virginia","Scott County",3,12,274,138,136
050,51,169,"Virginia","Scott County",3,13,244,113,131
050,51,169,"Virginia","Scott County",3,14,249,120,129
050,51,169,"Virginia","Scott County",3,15,260,138,122
050,51,169,"Virginia","Scott County",3,16,247,133,114
050,51,169,"Virginia","Scott County",3,17,240,125,115
050,51,169,"Virginia","Scott County",3,18,212,110,102
050,51,169,"Virginia","Scott County",3,19,169,89,80
050,51,169,"Virginia","Scott County",3,20,189,99,90
050,51,169,"Virginia","Scott County",3,21,204,111,93
050,51,169,"Virginia","Scott County",3,22,222,111,111
050,51,169,"Virginia","Scott County",3,23,218,115,103
050,51,169,"Virginia","Scott County",3,24,222,119,103
050,51,169,"Virginia","Scott County",3,25,228,123,105
050,51,169,"Virginia","Scott County",3,26,223,117,106
050,51,169,"Virginia","Scott County",3,27,204,118,86
050,51,169,"Virginia","Scott County",3,28,224,128,96
050,51,169,"Virginia","Scott County",3,29,227,126,101
050,51,169,"Virginia","Scott County",3,30,252,141,111
050,51,169,"Virginia","Scott County",3,31,234,120,114
050,51,169,"Virginia","Scott County",3,32,240,130,110
050,51,169,"Virginia","Scott County",3,33,209,111,98
050,51,169,"Virginia","Scott County",3,34,220,117,103
050,51,169,"Virginia","Scott County",3,35,233,115,118
050,51,169,"Virginia","Scott County",3,36,230,118,112
050,51,169,"Virginia","Scott County",3,37,237,120,117
050,51,169,"Virginia","Scott County",3,38,219,110,109
050,51,169,"Virginia","Scott County",3,39,236,122,114
050,51,169,"Virginia","Scott County",3,40,251,131,120
050,51,169,"Virginia","Scott County",3,41,260,140,120
050,51,169,"Virginia","Scott County",3,42,266,143,123
050,51,169,"Virginia","Scott County",3,43,257,136,121
050,51,169,"Virginia","Scott County",3,44,256,139,117
050,51,169,"Virginia","Scott County",3,45,238,129,109
050,51,169,"Virginia","Scott County",3,46,243,131,112
050,51,169,"Virginia","Scott County",3,47,258,136,122
050,51,169,"Virginia","Scott County",3,48,282,144,138
050,51,169,"Virginia","Scott County",3,49,303,152,151
050,51,169,"Virginia","Scott County",3,50,304,163,141
050,51,169,"Virginia","Scott County",3,51,286,150,136
050,51,169,"Virginia","Scott County",3,52,292,146,146
050,51,169,"Virginia","Scott County",3,53,297,153,144
050,51,169,"Virginia","Scott County",3,54,304,150,154
050,51,169,"Virginia","Scott County",3,55,327,166,161
050,51,169,"Virginia","Scott County",3,56,316,160,156
050,51,169,"Virginia","Scott County",3,57,317,167,150
050,51,169,"Virginia","Scott County",3,58,328,170,158
050,51,169,"Virginia","Scott County",3,59,342,175,167
050,51,169,"Virginia","Scott County",3,60,348,177,171
050,51,169,"Virginia","Scott County",3,61,324,174,150
050,51,169,"Virginia","Scott County",3,62,329,162,167
050,51,169,"Virginia","Scott County",3,63,330,163,167
050,51,169,"Virginia","Scott County",3,64,326,166,160
050,51,169,"Virginia","Scott County",3,65,306,159,147
050,51,169,"Virginia","Scott County",3,66,327,166,161
050,51,169,"Virginia","Scott County",3,67,312,155,157
050,51,169,"Virginia","Scott County",3,68,328,156,172
050,51,169,"Virginia","Scott County",3,69,315,156,159
050,51,169,"Virginia","Scott County",3,70,286,147,139
050,51,169,"Virginia","Scott County",3,71,281,135,146
050,51,169,"Virginia","Scott County",3,72,288,128,160
050,51,169,"Virginia","Scott County",3,73,276,112,164
050,51,169,"Virginia","Scott County",3,74,295,127,168
050,51,169,"Virginia","Scott County",3,75,219,104,115
050,51,169,"Virginia","Scott County",3,76,224,109,115
050,51,169,"Virginia","Scott County",3,77,216,99,117
050,51,169,"Virginia","Scott County",3,78,215,110,105
050,51,169,"Virginia","Scott County",3,79,179,90,89
050,51,169,"Virginia","Scott County",3,80,170,85,85
050,51,169,"Virginia","Scott County",3,81,158,69,89
050,51,169,"Virginia","Scott County",3,82,138,58,80
050,51,169,"Virginia","Scott County",3,83,127,54,73
050,51,169,"Virginia","Scott County",3,84,120,55,65
050,51,169,"Virginia","Scott County",3,85,604,248,356
050,51,169,"Virginia","Scott County",4,0,178,96,82
050,51,169,"Virginia","Scott County",4,1,164,81,83
050,51,169,"Virginia","Scott County",4,2,170,77,93
050,51,169,"Virginia","Scott County",4,3,179,96,83
050,51,169,"Virginia","Scott County",4,4,177,99,78
050,51,169,"Virginia","Scott County",4,5,193,111,82
050,51,169,"Virginia","Scott County",4,6,209,107,102
050,51,169,"Virginia","Scott County",4,7,197,104,93
050,51,169,"Virginia","Scott County",4,8,207,105,102
050,51,169,"Virginia","Scott County",4,9,234,121,113
050,51,169,"Virginia","Scott County",4,10,233,110,123
050,51,169,"Virginia","Scott County",4,11,232,118,114
050,51,169,"Virginia","Scott County",4,12,248,133,115
050,51,169,"Virginia","Scott County",4,13,275,138,137
050,51,169,"Virginia","Scott County",4,14,242,107,135
050,51,169,"Virginia","Scott County",4,15,242,117,125
050,51,169,"Virginia","Scott County",4,16,257,138,119
050,51,169,"Virginia","Scott County",4,17,257,138,119
050,51,169,"Virginia","Scott County",4,18,194,109,85
050,51,169,"Virginia","Scott County",4,19,157,79,78
050,51,169,"Virginia","Scott County",4,20,188,102,86
050,51,169,"Virginia","Scott County",4,21,205,109,96
050,51,169,"Virginia","Scott County",4,22,201,109,92
050,51,169,"Virginia","Scott County",4,23,231,112,119
050,51,169,"Virginia","Scott County",4,24,224,117,107
050,51,169,"Virginia","Scott County",4,25,216,122,94
050,51,169,"Virginia","Scott County",4,26,223,122,101
050,51,169,"Virginia","Scott County",4,27,219,119,100
050,51,169,"Virginia","Scott County",4,28,221,123,98
050,51,169,"Virginia","Scott County",4,29,215,118,97
050,51,169,"Virginia","Scott County",4,30,248,143,105
050,51,169,"Virginia","Scott County",4,31,233,125,108
050,51,169,"Virginia","Scott County",4,32,266,137,129
050,51,169,"Virginia","Scott County",4,33,231,123,108
050,51,169,"Virginia","Scott County",4,34,213,119,94
050,51,169,"Virginia","Scott County",4,35,239,121,118
050,51,169,"Virginia","Scott County",4,36,234,117,117
050,51,169,"Virginia","Scott County",4,37,243,120,123
050,51,169,"Virginia","Scott County",4,38,238,121,117
050,51,169,"Virginia","Scott County",4,39,234,118,116
050,51,169,"Virginia","Scott County",4,40,237,121,116
050,51,169,"Virginia","Scott County",4,41,245,126,119
050,51,169,"Virginia","Scott County",4,42,264,140,124
050,51,169,"Virginia","Scott County",4,43,254,137,117
050,51,169,"Virginia","Scott County",4,44,255,139,116
050,51,169,"Virginia","Scott County",4,45,250,134,116
050,51,169,"Virginia","Scott County",4,46,242,133,109
050,51,169,"Virginia","Scott County",4,47,236,128,108
050,51,169,"Virginia","Scott County",4,48,259,140,119
050,51,169,"Virginia","Scott County",4,49,281,140,141
050,51,169,"Virginia","Scott County",4,50,304,156,148
050,51,169,"Virginia","Scott County",4,51,314,169,145
050,51,169,"Virginia","Scott County",4,52,274,139,135
050,51,169,"Virginia","Scott County",4,53,284,138,146
050,51,169,"Virginia","Scott County",4,54,301,156,145
050,51,169,"Virginia","Scott County",4,55,309,154,155
050,51,169,"Virginia","Scott County",4,56,326,168,158
050,51,169,"Virginia","Scott County",4,57,309,149,160
050,51,169,"Virginia","Scott County",4,58,319,172,147
050,51,169,"Virginia","Scott County",4,59,324,168,156
050,51,169,"Virginia","Scott County",4,60,343,176,167
050,51,169,"Virginia","Scott County",4,61,347,176,171
050,51,169,"Virginia","Scott County",4,62,328,173,155
050,51,169,"Virginia","Scott County",4,63,338,164,174
050,51,169,"Virginia","Scott County",4,64,325,162,163
050,51,169,"Virginia","Scott County",4,65,317,162,155
050,51,169,"Virginia","Scott County",4,66,306,156,150
050,51,169,"Virginia","Scott County",4,67,325,164,161
050,51,169,"Virginia","Scott County",4,68,316,162,154
050,51,169,"Virginia","Scott County",4,69,320,147,173
050,51,169,"Virginia","Scott County",4,70,304,146,158
050,51,169,"Virginia","Scott County",4,71,272,137,135
050,51,169,"Virginia","Scott County",4,72,277,130,147
050,51,169,"Virginia","Scott County",4,73,281,126,155
050,51,169,"Virginia","Scott County",4,74,268,111,157
050,51,169,"Virginia","Scott County",4,75,286,125,161
050,51,169,"Virginia","Scott County",4,76,215,104,111
050,51,169,"Virginia","Scott County",4,77,222,109,113
050,51,169,"Virginia","Scott County",4,78,199,90,109
050,51,169,"Virginia","Scott County",4,79,211,104,107
050,51,169,"Virginia","Scott County",4,80,166,84,82
050,51,169,"Virginia","Scott County",4,81,171,85,86
050,51,169,"Virginia","Scott County",4,82,138,57,81
050,51,169,"Virginia","Scott County",4,83,124,50,74
050,51,169,"Virginia","Scott County",4,84,110,48,62
050,51,169,"Virginia","Scott County",4,85,617,261,356
050,51,169,"Virginia","Scott County",5,0,176,95,81
050,51,169,"Virginia","Scott County",5,1,168,85,83
050,51,169,"Virginia","Scott County",5,2,173,90,83
050,51,169,"Virginia","Scott County",5,3,170,77,93
050,51,169,"Virginia","Scott County",5,4,192,102,90
050,51,169,"Virginia","Scott County",5,5,188,103,85
050,51,169,"Virginia","Scott County",5,6,202,123,79
050,51,169,"Virginia","Scott County",5,7,225,115,110
050,51,169,"Virginia","Scott County",5,8,200,103,97
050,51,169,"Virginia","Scott County",5,9,216,111,105
050,51,169,"Virginia","Scott County",5,10,237,121,116
050,51,169,"Virginia","Scott County",5,11,229,111,118
050,51,169,"Virginia","Scott County",5,12,231,119,112
050,51,169,"Virginia","Scott County",5,13,256,132,124
050,51,169,"Virginia","Scott County",5,14,276,139,137
050,51,169,"Virginia","Scott County",5,15,249,114,135
050,51,169,"Virginia","Scott County",5,16,249,119,130
050,51,169,"Virginia","Scott County",5,17,250,133,117
050,51,169,"Virginia","Scott County",5,18,224,125,99
050,51,169,"Virginia","Scott County",5,19,142,78,64
050,51,169,"Virginia","Scott County",5,20,180,92,88
050,51,169,"Virginia","Scott County",5,21,199,110,89
050,51,169,"Virginia","Scott County",5,22,220,116,104
050,51,169,"Virginia","Scott County",5,23,206,113,93
050,51,169,"Virginia","Scott County",5,24,244,125,119
050,51,169,"Virginia","Scott County",5,25,221,115,106
050,51,169,"Virginia","Scott County",5,26,217,113,104
050,51,169,"Virginia","Scott County",5,27,216,116,100
050,51,169,"Virginia","Scott County",5,28,252,134,118
050,51,169,"Virginia","Scott County",5,29,204,108,96
050,51,169,"Virginia","Scott County",5,30,239,130,109
050,51,169,"Virginia","Scott County",5,31,226,128,98
050,51,169,"Virginia","Scott County",5,32,256,143,113
050,51,169,"Virginia","Scott County",5,33,264,134,130
050,51,169,"Virginia","Scott County",5,34,234,123,111
050,51,169,"Virginia","Scott County",5,35,226,124,102
050,51,169,"Virginia","Scott County",5,36,241,121,120
050,51,169,"Virginia","Scott County",5,37,239,116,123
050,51,169,"Virginia","Scott County",5,38,247,122,125
050,51,169,"Virginia","Scott County",5,39,240,127,113
050,51,169,"Virginia","Scott County",5,40,233,123,110
050,51,169,"Virginia","Scott County",5,41,230,112,118
050,51,169,"Virginia","Scott County",5,42,247,129,118
050,51,169,"Virginia","Scott County",5,43,243,126,117
050,51,169,"Virginia","Scott County",5,44,262,143,119
050,51,169,"Virginia","Scott County",5,45,247,130,117
050,51,169,"Virginia","Scott County",5,46,265,142,123
050,51,169,"Virginia","Scott County",5,47,233,128,105
050,51,169,"Virginia","Scott County",5,48,243,130,113
050,51,169,"Virginia","Scott County",5,49,259,136,123
050,51,169,"Virginia","Scott County",5,50,280,142,138
050,51,169,"Virginia","Scott County",5,51,305,158,147
050,51,169,"Virginia","Scott County",5,52,310,167,143
050,51,169,"Virginia","Scott County",5,53,270,135,135
050,51,169,"Virginia","Scott County",5,54,281,138,143
050,51,169,"Virginia","Scott County",5,55,303,158,145
050,51,169,"Virginia","Scott County",5,56,309,155,154
050,51,169,"Virginia","Scott County",5,57,313,157,156
050,51,169,"Virginia","Scott County",5,58,312,151,161
050,51,169,"Virginia","Scott County",5,59,312,169,143
050,51,169,"Virginia","Scott County",5,60,324,163,161
050,51,169,"Virginia","Scott County",5,61,338,173,165
050,51,169,"Virginia","Scott County",5,62,343,172,171
050,51,169,"Virginia","Scott County",5,63,329,171,158
050,51,169,"Virginia","Scott County",5,64,330,161,169
050,51,169,"Virginia","Scott County",5,65,318,156,162
050,51,169,"Virginia","Scott County",5,66,327,171,156
050,51,169,"Virginia","Scott County",5,67,300,150,150
050,51,169,"Virginia","Scott County",5,68,324,168,156
050,51,169,"Virginia","Scott County",5,69,313,157,156
050,51,169,"Virginia","Scott County",5,70,315,145,170
050,51,169,"Virginia","Scott County",5,71,294,141,153
050,51,169,"Virginia","Scott County",5,72,270,132,138
050,51,169,"Virginia","Scott County",5,73,272,126,146
050,51,169,"Virginia","Scott County",5,74,262,119,143
050,51,169,"Virginia","Scott County",5,75,249,103,146
050,51,169,"Virginia","Scott County",5,76,282,124,158
050,51,169,"Virginia","Scott County",5,77,204,101,103
050,51,169,"Virginia","Scott County",5,78,207,100,107
050,51,169,"Virginia","Scott County",5,79,196,85,111
050,51,169,"Virginia","Scott County",5,80,195,98,97
050,51,169,"Virginia","Scott County",5,81,161,82,79
050,51,169,"Virginia","Scott County",5,82,150,71,79
050,51,169,"Virginia","Scott County",5,83,126,49,77
050,51,169,"Virginia","Scott County",5,84,107,42,65
050,51,169,"Virginia","Scott County",5,85,616,267,349
050,51,171,"Virginia","Shenandoah County",1,0,478,242,236
050,51,171,"Virginia","Shenandoah County",1,1,481,255,226
050,51,171,"Virginia","Shenandoah County",1,2,510,263,247
050,51,171,"Virginia","Shenandoah County",1,3,498,256,242
050,51,171,"Virginia","Shenandoah County",1,4,527,251,276
050,51,171,"Virginia","Shenandoah County",1,5,460,230,230
050,51,171,"Virginia","Shenandoah County",1,6,524,265,259
050,51,171,"Virginia","Shenandoah County",1,7,499,249,250
050,51,171,"Virginia","Shenandoah County",1,8,505,259,246
050,51,171,"Virginia","Shenandoah County",1,9,536,253,283
050,51,171,"Virginia","Shenandoah County",1,10,527,262,265
050,51,171,"Virginia","Shenandoah County",1,11,528,280,248
050,51,171,"Virginia","Shenandoah County",1,12,584,300,284
050,51,171,"Virginia","Shenandoah County",1,13,578,288,290
050,51,171,"Virginia","Shenandoah County",1,14,545,287,258
050,51,171,"Virginia","Shenandoah County",1,15,529,276,253
050,51,171,"Virginia","Shenandoah County",1,16,577,297,280
050,51,171,"Virginia","Shenandoah County",1,17,578,297,281
050,51,171,"Virginia","Shenandoah County",1,18,517,267,250
050,51,171,"Virginia","Shenandoah County",1,19,418,218,200
050,51,171,"Virginia","Shenandoah County",1,20,437,215,222
050,51,171,"Virginia","Shenandoah County",1,21,458,219,239
050,51,171,"Virginia","Shenandoah County",1,22,440,201,239
050,51,171,"Virginia","Shenandoah County",1,23,459,207,252
050,51,171,"Virginia","Shenandoah County",1,24,463,217,246
050,51,171,"Virginia","Shenandoah County",1,25,460,230,230
050,51,171,"Virginia","Shenandoah County",1,26,483,240,243
050,51,171,"Virginia","Shenandoah County",1,27,475,225,250
050,51,171,"Virginia","Shenandoah County",1,28,537,278,259
050,51,171,"Virginia","Shenandoah County",1,29,557,277,280
050,51,171,"Virginia","Shenandoah County",1,30,490,256,234
050,51,171,"Virginia","Shenandoah County",1,31,469,236,233
050,51,171,"Virginia","Shenandoah County",1,32,521,273,248
050,51,171,"Virginia","Shenandoah County",1,33,503,248,255
050,51,171,"Virginia","Shenandoah County",1,34,507,258,249
050,51,171,"Virginia","Shenandoah County",1,35,493,239,254
050,51,171,"Virginia","Shenandoah County",1,36,490,230,260
050,51,171,"Virginia","Shenandoah County",1,37,507,273,234
050,51,171,"Virginia","Shenandoah County",1,38,534,276,258
050,51,171,"Virginia","Shenandoah County",1,39,564,280,284
050,51,171,"Virginia","Shenandoah County",1,40,514,255,259
050,51,171,"Virginia","Shenandoah County",1,41,490,248,242
050,51,171,"Virginia","Shenandoah County",1,42,465,234,231
050,51,171,"Virginia","Shenandoah County",1,43,457,229,228
050,51,171,"Virginia","Shenandoah County",1,44,463,238,225
050,51,171,"Virginia","Shenandoah County",1,45,485,261,224
050,51,171,"Virginia","Shenandoah County",1,46,493,237,256
050,51,171,"Virginia","Shenandoah County",1,47,494,246,248
050,51,171,"Virginia","Shenandoah County",1,48,556,290,266
050,51,171,"Virginia","Shenandoah County",1,49,597,302,295
050,51,171,"Virginia","Shenandoah County",1,50,608,309,299
050,51,171,"Virginia","Shenandoah County",1,51,578,292,286
050,51,171,"Virginia","Shenandoah County",1,52,578,280,298
050,51,171,"Virginia","Shenandoah County",1,53,585,285,300
050,51,171,"Virginia","Shenandoah County",1,54,619,314,305
050,51,171,"Virginia","Shenandoah County",1,55,640,327,313
050,51,171,"Virginia","Shenandoah County",1,56,631,324,307
050,51,171,"Virginia","Shenandoah County",1,57,664,328,336
050,51,171,"Virginia","Shenandoah County",1,58,671,341,330
050,51,171,"Virginia","Shenandoah County",1,59,673,326,347
050,51,171,"Virginia","Shenandoah County",1,60,634,317,317
050,51,171,"Virginia","Shenandoah County",1,61,614,305,309
050,51,171,"Virginia","Shenandoah County",1,62,629,304,325
050,51,171,"Virginia","Shenandoah County",1,63,635,299,336
050,51,171,"Virginia","Shenandoah County",1,64,648,310,338
050,51,171,"Virginia","Shenandoah County",1,65,599,298,301
050,51,171,"Virginia","Shenandoah County",1,66,602,307,295
050,51,171,"Virginia","Shenandoah County",1,67,599,306,293
050,51,171,"Virginia","Shenandoah County",1,68,598,292,306
050,51,171,"Virginia","Shenandoah County",1,69,543,256,287
050,51,171,"Virginia","Shenandoah County",1,70,498,256,242
050,51,171,"Virginia","Shenandoah County",1,71,512,243,269
050,51,171,"Virginia","Shenandoah County",1,72,566,267,299
050,51,171,"Virginia","Shenandoah County",1,73,520,253,267
050,51,171,"Virginia","Shenandoah County",1,74,406,195,211
050,51,171,"Virginia","Shenandoah County",1,75,404,171,233
050,51,171,"Virginia","Shenandoah County",1,76,422,193,229
050,51,171,"Virginia","Shenandoah County",1,77,397,189,208
050,51,171,"Virginia","Shenandoah County",1,78,351,153,198
050,51,171,"Virginia","Shenandoah County",1,79,312,148,164
050,51,171,"Virginia","Shenandoah County",1,80,269,125,144
050,51,171,"Virginia","Shenandoah County",1,81,279,138,141
050,51,171,"Virginia","Shenandoah County",1,82,241,103,138
050,51,171,"Virginia","Shenandoah County",1,83,219,90,129
050,51,171,"Virginia","Shenandoah County",1,84,175,81,94
050,51,171,"Virginia","Shenandoah County",1,85,1011,369,642
050,51,171,"Virginia","Shenandoah County",2,0,493,252,241
050,51,171,"Virginia","Shenandoah County",2,1,482,252,230
050,51,171,"Virginia","Shenandoah County",2,2,506,262,244
050,51,171,"Virginia","Shenandoah County",2,3,502,259,243
050,51,171,"Virginia","Shenandoah County",2,4,518,252,266
050,51,171,"Virginia","Shenandoah County",2,5,476,234,242
050,51,171,"Virginia","Shenandoah County",2,6,512,258,254
050,51,171,"Virginia","Shenandoah County",2,7,504,253,251
050,51,171,"Virginia","Shenandoah County",2,8,506,258,248
050,51,171,"Virginia","Shenandoah County",2,9,527,254,273
050,51,171,"Virginia","Shenandoah County",2,10,530,260,270
050,51,171,"Virginia","Shenandoah County",2,11,526,274,252
050,51,171,"Virginia","Shenandoah County",2,12,571,293,278
050,51,171,"Virginia","Shenandoah County",2,13,581,293,288
050,51,171,"Virginia","Shenandoah County",2,14,554,289,265
050,51,171,"Virginia","Shenandoah County",2,15,535,279,256
050,51,171,"Virginia","Shenandoah County",2,16,568,293,275
050,51,171,"Virginia","Shenandoah County",2,17,580,298,282
050,51,171,"Virginia","Shenandoah County",2,18,515,268,247
050,51,171,"Virginia","Shenandoah County",2,19,429,221,208
050,51,171,"Virginia","Shenandoah County",2,20,441,219,222
050,51,171,"Virginia","Shenandoah County",2,21,456,219,237
050,51,171,"Virginia","Shenandoah County",2,22,446,205,241
050,51,171,"Virginia","Shenandoah County",2,23,465,212,253
050,51,171,"Virginia","Shenandoah County",2,24,465,216,249
050,51,171,"Virginia","Shenandoah County",2,25,462,227,235
050,51,171,"Virginia","Shenandoah County",2,26,481,240,241
050,51,171,"Virginia","Shenandoah County",2,27,487,235,252
050,51,171,"Virginia","Shenandoah County",2,28,529,269,260
050,51,171,"Virginia","Shenandoah County",2,29,560,284,276
050,51,171,"Virginia","Shenandoah County",2,30,506,262,244
050,51,171,"Virginia","Shenandoah County",2,31,475,244,231
050,51,171,"Virginia","Shenandoah County",2,32,508,262,246
050,51,171,"Virginia","Shenandoah County",2,33,508,255,253
050,51,171,"Virginia","Shenandoah County",2,34,504,253,251
050,51,171,"Virginia","Shenandoah County",2,35,497,242,255
050,51,171,"Virginia","Shenandoah County",2,36,487,231,256
050,51,171,"Virginia","Shenandoah County",2,37,508,267,241
050,51,171,"Virginia","Shenandoah County",2,38,533,278,255
050,51,171,"Virginia","Shenandoah County",2,39,554,279,275
050,51,171,"Virginia","Shenandoah County",2,40,530,262,268
050,51,171,"Virginia","Shenandoah County",2,41,494,250,244
050,51,171,"Virginia","Shenandoah County",2,42,471,236,235
050,51,171,"Virginia","Shenandoah County",2,43,461,230,231
050,51,171,"Virginia","Shenandoah County",2,44,458,236,222
050,51,171,"Virginia","Shenandoah County",2,45,484,260,224
050,51,171,"Virginia","Shenandoah County",2,46,490,243,247
050,51,171,"Virginia","Shenandoah County",2,47,495,245,250
050,51,171,"Virginia","Shenandoah County",2,48,540,277,263
050,51,171,"Virginia","Shenandoah County",2,49,590,301,289
050,51,171,"Virginia","Shenandoah County",2,50,607,308,299
050,51,171,"Virginia","Shenandoah County",2,51,586,296,290
050,51,171,"Virginia","Shenandoah County",2,52,576,281,295
050,51,171,"Virginia","Shenandoah County",2,53,585,285,300
050,51,171,"Virginia","Shenandoah County",2,54,608,306,302
050,51,171,"Virginia","Shenandoah County",2,55,632,321,311
050,51,171,"Virginia","Shenandoah County",2,56,638,325,313
050,51,171,"Virginia","Shenandoah County",2,57,656,326,330
050,51,171,"Virginia","Shenandoah County",2,58,671,340,331
050,51,171,"Virginia","Shenandoah County",2,59,676,331,345
050,51,171,"Virginia","Shenandoah County",2,60,643,317,326
050,51,171,"Virginia","Shenandoah County",2,61,619,307,312
050,51,171,"Virginia","Shenandoah County",2,62,624,303,321
050,51,171,"Virginia","Shenandoah County",2,63,637,303,334
050,51,171,"Virginia","Shenandoah County",2,64,640,305,335
050,51,171,"Virginia","Shenandoah County",2,65,613,301,312
050,51,171,"Virginia","Shenandoah County",2,66,606,306,300
050,51,171,"Virginia","Shenandoah County",2,67,599,304,295
050,51,171,"Virginia","Shenandoah County",2,68,601,299,302
050,51,171,"Virginia","Shenandoah County",2,69,556,263,293
050,51,171,"Virginia","Shenandoah County",2,70,506,253,253
050,51,171,"Virginia","Shenandoah County",2,71,506,244,262
050,51,171,"Virginia","Shenandoah County",2,72,545,258,287
050,51,171,"Virginia","Shenandoah County",2,73,555,268,287
050,51,171,"Virginia","Shenandoah County",2,74,401,191,210
050,51,171,"Virginia","Shenandoah County",2,75,401,174,227
050,51,171,"Virginia","Shenandoah County",2,76,408,181,227
050,51,171,"Virginia","Shenandoah County",2,77,411,193,218
050,51,171,"Virginia","Shenandoah County",2,78,355,157,198
050,51,171,"Virginia","Shenandoah County",2,79,314,145,169
050,51,171,"Virginia","Shenandoah County",2,80,276,128,148
050,51,171,"Virginia","Shenandoah County",2,81,273,135,138
050,51,171,"Virginia","Shenandoah County",2,82,246,107,139
050,51,171,"Virginia","Shenandoah County",2,83,213,86,127
050,51,171,"Virginia","Shenandoah County",2,84,176,81,95
050,51,171,"Virginia","Shenandoah County",2,85,1006,372,634
050,51,171,"Virginia","Shenandoah County",3,0,504,253,251
050,51,171,"Virginia","Shenandoah County",3,1,532,276,256
050,51,171,"Virginia","Shenandoah County",3,2,510,260,250
050,51,171,"Virginia","Shenandoah County",3,3,511,270,241
050,51,171,"Virginia","Shenandoah County",3,4,485,256,229
050,51,171,"Virginia","Shenandoah County",3,5,550,264,286
050,51,171,"Virginia","Shenandoah County",3,6,505,251,254
050,51,171,"Virginia","Shenandoah County",3,7,516,271,245
050,51,171,"Virginia","Shenandoah County",3,8,517,264,253
050,51,171,"Virginia","Shenandoah County",3,9,510,254,256
050,51,171,"Virginia","Shenandoah County",3,10,539,264,275
050,51,171,"Virginia","Shenandoah County",3,11,542,266,276
050,51,171,"Virginia","Shenandoah County",3,12,528,271,257
050,51,171,"Virginia","Shenandoah County",3,13,586,304,282
050,51,171,"Virginia","Shenandoah County",3,14,583,295,288
050,51,171,"Virginia","Shenandoah County",3,15,556,279,277
050,51,171,"Virginia","Shenandoah County",3,16,527,273,254
050,51,171,"Virginia","Shenandoah County",3,17,561,290,271
050,51,171,"Virginia","Shenandoah County",3,18,524,277,247
050,51,171,"Virginia","Shenandoah County",3,19,452,229,223
050,51,171,"Virginia","Shenandoah County",3,20,434,219,215
050,51,171,"Virginia","Shenandoah County",3,21,454,215,239
050,51,171,"Virginia","Shenandoah County",3,22,475,227,248
050,51,171,"Virginia","Shenandoah County",3,23,472,229,243
050,51,171,"Virginia","Shenandoah County",3,24,494,225,269
050,51,171,"Virginia","Shenandoah County",3,25,468,217,251
050,51,171,"Virginia","Shenandoah County",3,26,485,239,246
050,51,171,"Virginia","Shenandoah County",3,27,515,263,252
050,51,171,"Virginia","Shenandoah County",3,28,503,251,252
050,51,171,"Virginia","Shenandoah County",3,29,567,302,265
050,51,171,"Virginia","Shenandoah County",3,30,567,284,283
050,51,171,"Virginia","Shenandoah County",3,31,536,278,258
050,51,171,"Virginia","Shenandoah County",3,32,511,270,241
050,51,171,"Virginia","Shenandoah County",3,33,525,272,253
050,51,171,"Virginia","Shenandoah County",3,34,511,265,246
050,51,171,"Virginia","Shenandoah County",3,35,509,258,251
050,51,171,"Virginia","Shenandoah County",3,36,496,244,252
050,51,171,"Virginia","Shenandoah County",3,37,509,250,259
050,51,171,"Virginia","Shenandoah County",3,38,509,267,242
050,51,171,"Virginia","Shenandoah County",3,39,545,275,270
050,51,171,"Virginia","Shenandoah County",3,40,560,282,278
050,51,171,"Virginia","Shenandoah County",3,41,534,262,272
050,51,171,"Virginia","Shenandoah County",3,42,488,257,231
050,51,171,"Virginia","Shenandoah County",3,43,448,228,220
050,51,171,"Virginia","Shenandoah County",3,44,475,235,240
050,51,171,"Virginia","Shenandoah County",3,45,464,240,224
050,51,171,"Virginia","Shenandoah County",3,46,479,253,226
050,51,171,"Virginia","Shenandoah County",3,47,498,243,255
050,51,171,"Virginia","Shenandoah County",3,48,496,246,250
050,51,171,"Virginia","Shenandoah County",3,49,547,282,265
050,51,171,"Virginia","Shenandoah County",3,50,612,310,302
050,51,171,"Virginia","Shenandoah County",3,51,611,305,306
050,51,171,"Virginia","Shenandoah County",3,52,602,301,301
050,51,171,"Virginia","Shenandoah County",3,53,587,286,301
050,51,171,"Virginia","Shenandoah County",3,54,589,289,300
050,51,171,"Virginia","Shenandoah County",3,55,608,297,311
050,51,171,"Virginia","Shenandoah County",3,56,660,329,331
050,51,171,"Virginia","Shenandoah County",3,57,628,322,306
050,51,171,"Virginia","Shenandoah County",3,58,660,329,331
050,51,171,"Virginia","Shenandoah County",3,59,688,350,338
050,51,171,"Virginia","Shenandoah County",3,60,682,342,340
050,51,171,"Virginia","Shenandoah County",3,61,651,319,332
050,51,171,"Virginia","Shenandoah County",3,62,637,307,330
050,51,171,"Virginia","Shenandoah County",3,63,636,306,330
050,51,171,"Virginia","Shenandoah County",3,64,627,301,326
050,51,171,"Virginia","Shenandoah County",3,65,638,302,336
050,51,171,"Virginia","Shenandoah County",3,66,605,298,307
050,51,171,"Virginia","Shenandoah County",3,67,610,305,305
050,51,171,"Virginia","Shenandoah County",3,68,601,306,295
050,51,171,"Virginia","Shenandoah County",3,69,594,299,295
050,51,171,"Virginia","Shenandoah County",3,70,561,268,293
050,51,171,"Virginia","Shenandoah County",3,71,494,240,254
050,51,171,"Virginia","Shenandoah County",3,72,492,236,256
050,51,171,"Virginia","Shenandoah County",3,73,513,245,268
050,51,171,"Virginia","Shenandoah County",3,74,528,251,277
050,51,171,"Virginia","Shenandoah County",3,75,390,186,204
050,51,171,"Virginia","Shenandoah County",3,76,392,166,226
050,51,171,"Virginia","Shenandoah County",3,77,390,172,218
050,51,171,"Virginia","Shenandoah County",3,78,395,181,214
050,51,171,"Virginia","Shenandoah County",3,79,328,149,179
050,51,171,"Virginia","Shenandoah County",3,80,306,137,169
050,51,171,"Virginia","Shenandoah County",3,81,272,129,143
050,51,171,"Virginia","Shenandoah County",3,82,244,122,122
050,51,171,"Virginia","Shenandoah County",3,83,224,90,134
050,51,171,"Virginia","Shenandoah County",3,84,190,76,114
050,51,171,"Virginia","Shenandoah County",3,85,985,383,602
050,51,171,"Virginia","Shenandoah County",4,0,475,237,238
050,51,171,"Virginia","Shenandoah County",4,1,478,244,234
050,51,171,"Virginia","Shenandoah County",4,2,545,274,271
050,51,171,"Virginia","Shenandoah County",4,3,516,273,243
050,51,171,"Virginia","Shenandoah County",4,4,512,275,237
050,51,171,"Virginia","Shenandoah County",4,5,476,271,205
050,51,171,"Virginia","Shenandoah County",4,6,548,262,286
050,51,171,"Virginia","Shenandoah County",4,7,504,251,253
050,51,171,"Virginia","Shenandoah County",4,8,523,273,250
050,51,171,"Virginia","Shenandoah County",4,9,506,253,253
050,51,171,"Virginia","Shenandoah County",4,10,510,252,258
050,51,171,"Virginia","Shenandoah County",4,11,547,268,279
050,51,171,"Virginia","Shenandoah County",4,12,542,266,276
050,51,171,"Virginia","Shenandoah County",4,13,540,276,264
050,51,171,"Virginia","Shenandoah County",4,14,586,304,282
050,51,171,"Virginia","Shenandoah County",4,15,586,300,286
050,51,171,"Virginia","Shenandoah County",4,16,568,282,286
050,51,171,"Virginia","Shenandoah County",4,17,540,279,261
050,51,171,"Virginia","Shenandoah County",4,18,504,268,236
050,51,171,"Virginia","Shenandoah County",4,19,444,225,219
050,51,171,"Virginia","Shenandoah County",4,20,450,228,222
050,51,171,"Virginia","Shenandoah County",4,21,438,208,230
050,51,171,"Virginia","Shenandoah County",4,22,470,216,254
050,51,171,"Virginia","Shenandoah County",4,23,479,240,239
050,51,171,"Virginia","Shenandoah County",4,24,474,229,245
050,51,171,"Virginia","Shenandoah County",4,25,479,224,255
050,51,171,"Virginia","Shenandoah County",4,26,455,223,232
050,51,171,"Virginia","Shenandoah County",4,27,499,239,260
050,51,171,"Virginia","Shenandoah County",4,28,506,264,242
050,51,171,"Virginia","Shenandoah County",4,29,500,252,248
050,51,171,"Virginia","Shenandoah County",4,30,569,297,272
050,51,171,"Virginia","Shenandoah County",4,31,542,280,262
050,51,171,"Virginia","Shenandoah County",4,32,544,284,260
050,51,171,"Virginia","Shenandoah County",4,33,517,274,243
050,51,171,"Virginia","Shenandoah County",4,34,529,284,245
050,51,171,"Virginia","Shenandoah County",4,35,512,261,251
050,51,171,"Virginia","Shenandoah County",4,36,506,261,245
050,51,171,"Virginia","Shenandoah County",4,37,508,254,254
050,51,171,"Virginia","Shenandoah County",4,38,504,244,260
050,51,171,"Virginia","Shenandoah County",4,39,518,269,249
050,51,171,"Virginia","Shenandoah County",4,40,545,281,264
050,51,171,"Virginia","Shenandoah County",4,41,573,286,287
050,51,171,"Virginia","Shenandoah County",4,42,542,260,282
050,51,171,"Virginia","Shenandoah County",4,43,487,256,231
050,51,171,"Virginia","Shenandoah County",4,44,447,223,224
050,51,171,"Virginia","Shenandoah County",4,45,479,242,237
050,51,171,"Virginia","Shenandoah County",4,46,474,246,228
050,51,171,"Virginia","Shenandoah County",4,47,479,252,227
050,51,171,"Virginia","Shenandoah County",4,48,493,243,250
050,51,171,"Virginia","Shenandoah County",4,49,500,246,254
050,51,171,"Virginia","Shenandoah County",4,50,567,285,282
050,51,171,"Virginia","Shenandoah County",4,51,612,306,306
050,51,171,"Virginia","Shenandoah County",4,52,607,301,306
050,51,171,"Virginia","Shenandoah County",4,53,595,296,299
050,51,171,"Virginia","Shenandoah County",4,54,594,287,307
050,51,171,"Virginia","Shenandoah County",4,55,592,286,306
050,51,171,"Virginia","Shenandoah County",4,56,648,311,337
050,51,171,"Virginia","Shenandoah County",4,57,667,328,339
050,51,171,"Virginia","Shenandoah County",4,58,631,322,309
050,51,171,"Virginia","Shenandoah County",4,59,681,332,349
050,51,171,"Virginia","Shenandoah County",4,60,695,352,343
050,51,171,"Virginia","Shenandoah County",4,61,697,347,350
050,51,171,"Virginia","Shenandoah County",4,62,651,323,328
050,51,171,"Virginia","Shenandoah County",4,63,648,306,342
050,51,171,"Virginia","Shenandoah County",4,64,629,291,338
050,51,171,"Virginia","Shenandoah County",4,65,620,300,320
050,51,171,"Virginia","Shenandoah County",4,66,636,305,331
050,51,171,"Virginia","Shenandoah County",4,67,597,290,307
050,51,171,"Virginia","Shenandoah County",4,68,620,311,309
050,51,171,"Virginia","Shenandoah County",4,69,599,303,296
050,51,171,"Virginia","Shenandoah County",4,70,583,293,290
050,51,171,"Virginia","Shenandoah County",4,71,545,257,288
050,51,171,"Virginia","Shenandoah County",4,72,475,226,249
050,51,171,"Virginia","Shenandoah County",4,73,477,222,255
050,51,171,"Virginia","Shenandoah County",4,74,500,234,266
050,51,171,"Virginia","Shenandoah County",4,75,516,244,272
050,51,171,"Virginia","Shenandoah County",4,76,384,182,202
050,51,171,"Virginia","Shenandoah County",4,77,381,161,220
050,51,171,"Virginia","Shenandoah County",4,78,374,160,214
050,51,171,"Virginia","Shenandoah County",4,79,367,166,201
050,51,171,"Virginia","Shenandoah County",4,80,318,146,172
050,51,171,"Virginia","Shenandoah County",4,81,290,134,156
050,51,171,"Virginia","Shenandoah County",4,82,248,114,134
050,51,171,"Virginia","Shenandoah County",4,83,223,114,109
050,51,171,"Virginia","Shenandoah County",4,84,203,80,123
050,51,171,"Virginia","Shenandoah County",4,85,998,381,617
050,51,171,"Virginia","Shenandoah County",5,0,473,235,238
050,51,171,"Virginia","Shenandoah County",5,1,468,227,241
050,51,171,"Virginia","Shenandoah County",5,2,500,256,244
050,51,171,"Virginia","Shenandoah County",5,3,556,295,261
050,51,171,"Virginia","Shenandoah County",5,4,527,291,236
050,51,171,"Virginia","Shenandoah County",5,5,531,274,257
050,51,171,"Virginia","Shenandoah County",5,6,492,267,225
050,51,171,"Virginia","Shenandoah County",5,7,548,262,286
050,51,171,"Virginia","Shenandoah County",5,8,513,256,257
050,51,171,"Virginia","Shenandoah County",5,9,534,277,257
050,51,171,"Virginia","Shenandoah County",5,10,528,257,271
050,51,171,"Virginia","Shenandoah County",5,11,508,253,255
050,51,171,"Virginia","Shenandoah County",5,12,544,267,277
050,51,171,"Virginia","Shenandoah County",5,13,543,265,278
050,51,171,"Virginia","Shenandoah County",5,14,554,288,266
050,51,171,"Virginia","Shenandoah County",5,15,575,305,270
050,51,171,"Virginia","Shenandoah County",5,16,599,311,288
050,51,171,"Virginia","Shenandoah County",5,17,569,284,285
050,51,171,"Virginia","Shenandoah County",5,18,490,266,224
050,51,171,"Virginia","Shenandoah County",5,19,440,227,213
050,51,171,"Virginia","Shenandoah County",5,20,470,239,231
050,51,171,"Virginia","Shenandoah County",5,21,465,236,229
050,51,171,"Virginia","Shenandoah County",5,22,457,218,239
050,51,171,"Virginia","Shenandoah County",5,23,485,220,265
050,51,171,"Virginia","Shenandoah County",5,24,497,247,250
050,51,171,"Virginia","Shenandoah County",5,25,479,239,240
050,51,171,"Virginia","Shenandoah County",5,26,465,221,244
050,51,171,"Virginia","Shenandoah County",5,27,467,219,248
050,51,171,"Virginia","Shenandoah County",5,28,521,251,270
050,51,171,"Virginia","Shenandoah County",5,29,516,275,241
050,51,171,"Virginia","Shenandoah County",5,30,526,252,274
050,51,171,"Virginia","Shenandoah County",5,31,564,301,263
050,51,171,"Virginia","Shenandoah County",5,32,547,284,263
050,51,171,"Virginia","Shenandoah County",5,33,576,298,278
050,51,171,"Virginia","Shenandoah County",5,34,527,284,243
050,51,171,"Virginia","Shenandoah County",5,35,537,278,259
050,51,171,"Virginia","Shenandoah County",5,36,506,260,246
050,51,171,"Virginia","Shenandoah County",5,37,512,263,249
050,51,171,"Virginia","Shenandoah County",5,38,496,252,244
050,51,171,"Virginia","Shenandoah County",5,39,524,260,264
050,51,171,"Virginia","Shenandoah County",5,40,529,273,256
050,51,171,"Virginia","Shenandoah County",5,41,564,288,276
050,51,171,"Virginia","Shenandoah County",5,42,583,295,288
050,51,171,"Virginia","Shenandoah County",5,43,536,265,271
050,51,171,"Virginia","Shenandoah County",5,44,492,255,237
050,51,171,"Virginia","Shenandoah County",5,45,457,229,228
050,51,171,"Virginia","Shenandoah County",5,46,454,231,223
050,51,171,"Virginia","Shenandoah County",5,47,485,254,231
050,51,171,"Virginia","Shenandoah County",5,48,486,253,233
050,51,171,"Virginia","Shenandoah County",5,49,497,244,253
050,51,171,"Virginia","Shenandoah County",5,50,518,257,261
050,51,171,"Virginia","Shenandoah County",5,51,567,286,281
050,51,171,"Virginia","Shenandoah County",5,52,612,304,308
050,51,171,"Virginia","Shenandoah County",5,53,613,306,307
050,51,171,"Virginia","Shenandoah County",5,54,585,294,291
050,51,171,"Virginia","Shenandoah County",5,55,585,280,305
050,51,171,"Virginia","Shenandoah County",5,56,618,294,324
050,51,171,"Virginia","Shenandoah County",5,57,648,311,337
050,51,171,"Virginia","Shenandoah County",5,58,674,333,341
050,51,171,"Virginia","Shenandoah County",5,59,622,322,300
050,51,171,"Virginia","Shenandoah County",5,60,682,338,344
050,51,171,"Virginia","Shenandoah County",5,61,709,355,354
050,51,171,"Virginia","Shenandoah County",5,62,699,351,348
050,51,171,"Virginia","Shenandoah County",5,63,637,314,323
050,51,171,"Virginia","Shenandoah County",5,64,639,300,339
050,51,171,"Virginia","Shenandoah County",5,65,630,284,346
050,51,171,"Virginia","Shenandoah County",5,66,617,299,318
050,51,171,"Virginia","Shenandoah County",5,67,630,306,324
050,51,171,"Virginia","Shenandoah County",5,68,594,288,306
050,51,171,"Virginia","Shenandoah County",5,69,611,303,308
050,51,171,"Virginia","Shenandoah County",5,70,589,296,293
050,51,171,"Virginia","Shenandoah County",5,71,574,281,293
050,51,171,"Virginia","Shenandoah County",5,72,533,250,283
050,51,171,"Virginia","Shenandoah County",5,73,457,217,240
050,51,171,"Virginia","Shenandoah County",5,74,460,212,248
050,51,171,"Virginia","Shenandoah County",5,75,475,222,253
050,51,171,"Virginia","Shenandoah County",5,76,498,233,265
050,51,171,"Virginia","Shenandoah County",5,77,359,173,186
050,51,171,"Virginia","Shenandoah County",5,78,365,147,218
050,51,171,"Virginia","Shenandoah County",5,79,346,145,201
050,51,171,"Virginia","Shenandoah County",5,80,347,154,193
050,51,171,"Virginia","Shenandoah County",5,81,304,146,158
050,51,171,"Virginia","Shenandoah County",5,82,265,119,146
050,51,171,"Virginia","Shenandoah County",5,83,225,104,121
050,51,171,"Virginia","Shenandoah County",5,84,202,103,99
050,51,171,"Virginia","Shenandoah County",5,85,1027,391,636
050,51,173,"Virginia","Smyth County",1,0,255,129,126
050,51,173,"Virginia","Smyth County",1,1,271,133,138
050,51,173,"Virginia","Smyth County",1,2,265,128,137
050,51,173,"Virginia","Smyth County",1,3,295,149,146
050,51,173,"Virginia","Smyth County",1,4,273,130,143
050,51,173,"Virginia","Smyth County",1,5,304,155,149
050,51,173,"Virginia","Smyth County",1,6,293,146,147
050,51,173,"Virginia","Smyth County",1,7,307,158,149
050,51,173,"Virginia","Smyth County",1,8,314,161,153
050,51,173,"Virginia","Smyth County",1,9,327,163,164
050,51,173,"Virginia","Smyth County",1,10,316,153,163
050,51,173,"Virginia","Smyth County",1,11,332,168,164
050,51,173,"Virginia","Smyth County",1,12,369,198,171
050,51,173,"Virginia","Smyth County",1,13,387,207,180
050,51,173,"Virginia","Smyth County",1,14,392,215,177
050,51,173,"Virginia","Smyth County",1,15,356,195,161
050,51,173,"Virginia","Smyth County",1,16,374,195,179
050,51,173,"Virginia","Smyth County",1,17,362,186,176
050,51,173,"Virginia","Smyth County",1,18,329,179,150
050,51,173,"Virginia","Smyth County",1,19,265,135,130
050,51,173,"Virginia","Smyth County",1,20,262,126,136
050,51,173,"Virginia","Smyth County",1,21,304,164,140
050,51,173,"Virginia","Smyth County",1,22,308,167,141
050,51,173,"Virginia","Smyth County",1,23,302,158,144
050,51,173,"Virginia","Smyth County",1,24,311,186,125
050,51,173,"Virginia","Smyth County",1,25,328,170,158
050,51,173,"Virginia","Smyth County",1,26,351,175,176
050,51,173,"Virginia","Smyth County",1,27,352,180,172
050,51,173,"Virginia","Smyth County",1,28,350,176,174
050,51,173,"Virginia","Smyth County",1,29,375,185,190
050,51,173,"Virginia","Smyth County",1,30,349,173,176
050,51,173,"Virginia","Smyth County",1,31,355,208,147
050,51,173,"Virginia","Smyth County",1,32,325,180,145
050,51,173,"Virginia","Smyth County",1,33,295,157,138
050,51,173,"Virginia","Smyth County",1,34,330,166,164
050,51,173,"Virginia","Smyth County",1,35,286,156,130
050,51,173,"Virginia","Smyth County",1,36,293,148,145
050,51,173,"Virginia","Smyth County",1,37,308,153,155
050,51,173,"Virginia","Smyth County",1,38,314,151,163
050,51,173,"Virginia","Smyth County",1,39,335,158,177
050,51,173,"Virginia","Smyth County",1,40,341,168,173
050,51,173,"Virginia","Smyth County",1,41,350,179,171
050,51,173,"Virginia","Smyth County",1,42,353,190,163
050,51,173,"Virginia","Smyth County",1,43,343,175,168
050,51,173,"Virginia","Smyth County",1,44,328,170,158
050,51,173,"Virginia","Smyth County",1,45,364,173,191
050,51,173,"Virginia","Smyth County",1,46,402,196,206
050,51,173,"Virginia","Smyth County",1,47,405,187,218
050,51,173,"Virginia","Smyth County",1,48,434,228,206
050,51,173,"Virginia","Smyth County",1,49,453,217,236
050,51,173,"Virginia","Smyth County",1,50,427,192,235
050,51,173,"Virginia","Smyth County",1,51,416,206,210
050,51,173,"Virginia","Smyth County",1,52,420,209,211
050,51,173,"Virginia","Smyth County",1,53,451,230,221
050,51,173,"Virginia","Smyth County",1,54,434,220,214
050,51,173,"Virginia","Smyth County",1,55,418,211,207
050,51,173,"Virginia","Smyth County",1,56,440,228,212
050,51,173,"Virginia","Smyth County",1,57,462,251,211
050,51,173,"Virginia","Smyth County",1,58,439,225,214
050,51,173,"Virginia","Smyth County",1,59,458,222,236
050,51,173,"Virginia","Smyth County",1,60,418,201,217
050,51,173,"Virginia","Smyth County",1,61,424,207,217
050,51,173,"Virginia","Smyth County",1,62,428,217,211
050,51,173,"Virginia","Smyth County",1,63,412,193,219
050,51,173,"Virginia","Smyth County",1,64,441,207,234
050,51,173,"Virginia","Smyth County",1,65,458,219,239
050,51,173,"Virginia","Smyth County",1,66,439,218,221
050,51,173,"Virginia","Smyth County",1,67,416,195,221
050,51,173,"Virginia","Smyth County",1,68,384,175,209
050,51,173,"Virginia","Smyth County",1,69,372,169,203
050,51,173,"Virginia","Smyth County",1,70,370,166,204
050,51,173,"Virginia","Smyth County",1,71,377,178,199
050,51,173,"Virginia","Smyth County",1,72,388,185,203
050,51,173,"Virginia","Smyth County",1,73,382,173,209
050,51,173,"Virginia","Smyth County",1,74,272,122,150
050,51,173,"Virginia","Smyth County",1,75,245,112,133
050,51,173,"Virginia","Smyth County",1,76,272,124,148
050,51,173,"Virginia","Smyth County",1,77,271,117,154
050,51,173,"Virginia","Smyth County",1,78,234,94,140
050,51,173,"Virginia","Smyth County",1,79,207,92,115
050,51,173,"Virginia","Smyth County",1,80,186,82,104
050,51,173,"Virginia","Smyth County",1,81,185,85,100
050,51,173,"Virginia","Smyth County",1,82,178,83,95
050,51,173,"Virginia","Smyth County",1,83,141,61,80
050,51,173,"Virginia","Smyth County",1,84,139,57,82
050,51,173,"Virginia","Smyth County",1,85,805,279,526
050,51,173,"Virginia","Smyth County",2,0,250,124,126
050,51,173,"Virginia","Smyth County",2,1,267,132,135
050,51,173,"Virginia","Smyth County",2,2,268,131,137
050,51,173,"Virginia","Smyth County",2,3,289,144,145
050,51,173,"Virginia","Smyth County",2,4,281,136,145
050,51,173,"Virginia","Smyth County",2,5,300,151,149
050,51,173,"Virginia","Smyth County",2,6,299,151,148
050,51,173,"Virginia","Smyth County",2,7,305,156,149
050,51,173,"Virginia","Smyth County",2,8,311,160,151
050,51,173,"Virginia","Smyth County",2,9,324,163,161
050,51,173,"Virginia","Smyth County",2,10,319,155,164
050,51,173,"Virginia","Smyth County",2,11,325,163,162
050,51,173,"Virginia","Smyth County",2,12,363,192,171
050,51,173,"Virginia","Smyth County",2,13,387,208,179
050,51,173,"Virginia","Smyth County",2,14,390,212,178
050,51,173,"Virginia","Smyth County",2,15,366,198,168
050,51,173,"Virginia","Smyth County",2,16,369,195,174
050,51,173,"Virginia","Smyth County",2,17,367,189,178
050,51,173,"Virginia","Smyth County",2,18,321,172,149
050,51,173,"Virginia","Smyth County",2,19,266,138,128
050,51,173,"Virginia","Smyth County",2,20,275,133,142
050,51,173,"Virginia","Smyth County",2,21,295,155,140
050,51,173,"Virginia","Smyth County",2,22,310,168,142
050,51,173,"Virginia","Smyth County",2,23,305,163,142
050,51,173,"Virginia","Smyth County",2,24,308,178,130
050,51,173,"Virginia","Smyth County",2,25,327,174,153
050,51,173,"Virginia","Smyth County",2,26,351,178,173
050,51,173,"Virginia","Smyth County",2,27,349,176,173
050,51,173,"Virginia","Smyth County",2,28,351,178,173
050,51,173,"Virginia","Smyth County",2,29,370,184,186
050,51,173,"Virginia","Smyth County",2,30,358,177,181
050,51,173,"Virginia","Smyth County",2,31,358,203,155
050,51,173,"Virginia","Smyth County",2,32,332,184,148
050,51,173,"Virginia","Smyth County",2,33,303,163,140
050,51,173,"Virginia","Smyth County",2,34,320,164,156
050,51,173,"Virginia","Smyth County",2,35,299,160,139
050,51,173,"Virginia","Smyth County",2,36,289,148,141
050,51,173,"Virginia","Smyth County",2,37,306,154,152
050,51,173,"Virginia","Smyth County",2,38,311,151,160
050,51,173,"Virginia","Smyth County",2,39,328,156,172
050,51,173,"Virginia","Smyth County",2,40,339,165,174
050,51,173,"Virginia","Smyth County",2,41,347,176,171
050,51,173,"Virginia","Smyth County",2,42,351,187,164
050,51,173,"Virginia","Smyth County",2,43,348,181,167
050,51,173,"Virginia","Smyth County",2,44,325,167,158
050,51,173,"Virginia","Smyth County",2,45,358,174,184
050,51,173,"Virginia","Smyth County",2,46,390,188,202
050,51,173,"Virginia","Smyth County",2,47,405,189,216
050,51,173,"Virginia","Smyth County",2,48,428,219,209
050,51,173,"Virginia","Smyth County",2,49,451,221,230
050,51,173,"Virginia","Smyth County",2,50,434,196,238
050,51,173,"Virginia","Smyth County",2,51,419,202,217
050,51,173,"Virginia","Smyth County",2,52,418,208,210
050,51,173,"Virginia","Smyth County",2,53,445,227,218
050,51,173,"Virginia","Smyth County",2,54,436,223,213
050,51,173,"Virginia","Smyth County",2,55,419,212,207
050,51,173,"Virginia","Smyth County",2,56,438,226,212
050,51,173,"Virginia","Smyth County",2,57,458,246,212
050,51,173,"Virginia","Smyth County",2,58,447,232,215
050,51,173,"Virginia","Smyth County",2,59,455,225,230
050,51,173,"Virginia","Smyth County",2,60,426,204,222
050,51,173,"Virginia","Smyth County",2,61,417,202,215
050,51,173,"Virginia","Smyth County",2,62,424,213,211
050,51,173,"Virginia","Smyth County",2,63,417,197,220
050,51,173,"Virginia","Smyth County",2,64,433,203,230
050,51,173,"Virginia","Smyth County",2,65,456,217,239
050,51,173,"Virginia","Smyth County",2,66,442,216,226
050,51,173,"Virginia","Smyth County",2,67,419,198,221
050,51,173,"Virginia","Smyth County",2,68,384,176,208
050,51,173,"Virginia","Smyth County",2,69,379,173,206
050,51,173,"Virginia","Smyth County",2,70,369,165,204
050,51,173,"Virginia","Smyth County",2,71,378,178,200
050,51,173,"Virginia","Smyth County",2,72,376,178,198
050,51,173,"Virginia","Smyth County",2,73,404,186,218
050,51,173,"Virginia","Smyth County",2,74,278,125,153
050,51,173,"Virginia","Smyth County",2,75,249,113,136
050,51,173,"Virginia","Smyth County",2,76,259,118,141
050,51,173,"Virginia","Smyth County",2,77,274,118,156
050,51,173,"Virginia","Smyth County",2,78,239,98,141
050,51,173,"Virginia","Smyth County",2,79,209,91,118
050,51,173,"Virginia","Smyth County",2,80,188,81,107
050,51,173,"Virginia","Smyth County",2,81,180,80,100
050,51,173,"Virginia","Smyth County",2,82,176,83,93
050,51,173,"Virginia","Smyth County",2,83,148,65,83
050,51,173,"Virginia","Smyth County",2,84,139,59,80
050,51,173,"Virginia","Smyth County",2,85,801,278,523
050,51,173,"Virginia","Smyth County",3,0,281,142,139
050,51,173,"Virginia","Smyth County",3,1,254,137,117
050,51,173,"Virginia","Smyth County",3,2,284,149,135
050,51,173,"Virginia","Smyth County",3,3,276,133,143
050,51,173,"Virginia","Smyth County",3,4,294,148,146
050,51,173,"Virginia","Smyth County",3,5,283,137,146
050,51,173,"Virginia","Smyth County",3,6,304,155,149
050,51,173,"Virginia","Smyth County",3,7,295,147,148
050,51,173,"Virginia","Smyth County",3,8,309,158,151
050,51,173,"Virginia","Smyth County",3,9,316,157,159
050,51,173,"Virginia","Smyth County",3,10,318,160,158
050,51,173,"Virginia","Smyth County",3,11,330,159,171
050,51,173,"Virginia","Smyth County",3,12,335,168,167
050,51,173,"Virginia","Smyth County",3,13,366,190,176
050,51,173,"Virginia","Smyth County",3,14,377,204,173
050,51,173,"Virginia","Smyth County",3,15,382,208,174
050,51,173,"Virginia","Smyth County",3,16,365,197,168
050,51,173,"Virginia","Smyth County",3,17,365,189,176
050,51,173,"Virginia","Smyth County",3,18,313,161,152
050,51,173,"Virginia","Smyth County",3,19,250,129,121
050,51,173,"Virginia","Smyth County",3,20,299,155,144
050,51,173,"Virginia","Smyth County",3,21,286,146,140
050,51,173,"Virginia","Smyth County",3,22,314,165,149
050,51,173,"Virginia","Smyth County",3,23,324,169,155
050,51,173,"Virginia","Smyth County",3,24,338,184,154
050,51,173,"Virginia","Smyth County",3,25,321,183,138
050,51,173,"Virginia","Smyth County",3,26,346,189,157
050,51,173,"Virginia","Smyth County",3,27,330,161,169
050,51,173,"Virginia","Smyth County",3,28,347,179,168
050,51,173,"Virginia","Smyth County",3,29,358,179,179
050,51,173,"Virginia","Smyth County",3,30,375,187,188
050,51,173,"Virginia","Smyth County",3,31,370,184,186
050,51,173,"Virginia","Smyth County",3,32,348,193,155
050,51,173,"Virginia","Smyth County",3,33,340,183,157
050,51,173,"Virginia","Smyth County",3,34,300,166,134
050,51,173,"Virginia","Smyth County",3,35,315,162,153
050,51,173,"Virginia","Smyth County",3,36,310,163,147
050,51,173,"Virginia","Smyth County",3,37,290,152,138
050,51,173,"Virginia","Smyth County",3,38,301,148,153
050,51,173,"Virginia","Smyth County",3,39,300,153,147
050,51,173,"Virginia","Smyth County",3,40,319,152,167
050,51,173,"Virginia","Smyth County",3,41,335,166,169
050,51,173,"Virginia","Smyth County",3,42,344,177,167
050,51,173,"Virginia","Smyth County",3,43,359,194,165
050,51,173,"Virginia","Smyth County",3,44,344,181,163
050,51,173,"Virginia","Smyth County",3,45,321,168,153
050,51,173,"Virginia","Smyth County",3,46,352,167,185
050,51,173,"Virginia","Smyth County",3,47,387,190,197
050,51,173,"Virginia","Smyth County",3,48,414,195,219
050,51,173,"Virginia","Smyth County",3,49,430,225,205
050,51,173,"Virginia","Smyth County",3,50,451,216,235
050,51,173,"Virginia","Smyth County",3,51,428,186,242
050,51,173,"Virginia","Smyth County",3,52,417,205,212
050,51,173,"Virginia","Smyth County",3,53,424,212,212
050,51,173,"Virginia","Smyth County",3,54,444,230,214
050,51,173,"Virginia","Smyth County",3,55,427,219,208
050,51,173,"Virginia","Smyth County",3,56,423,208,215
050,51,173,"Virginia","Smyth County",3,57,424,218,206
050,51,173,"Virginia","Smyth County",3,58,453,238,215
050,51,173,"Virginia","Smyth County",3,59,437,226,211
050,51,173,"Virginia","Smyth County",3,60,457,226,231
050,51,173,"Virginia","Smyth County",3,61,415,199,216
050,51,173,"Virginia","Smyth County",3,62,410,201,209
050,51,173,"Virginia","Smyth County",3,63,423,210,213
050,51,173,"Virginia","Smyth County",3,64,407,191,216
050,51,173,"Virginia","Smyth County",3,65,413,192,221
050,51,173,"Virginia","Smyth County",3,66,448,210,238
050,51,173,"Virginia","Smyth County",3,67,422,203,219
050,51,173,"Virginia","Smyth County",3,68,402,190,212
050,51,173,"Virginia","Smyth County",3,69,382,180,202
050,51,173,"Virginia","Smyth County",3,70,373,167,206
050,51,173,"Virginia","Smyth County",3,71,352,161,191
050,51,173,"Virginia","Smyth County",3,72,363,170,193
050,51,173,"Virginia","Smyth County",3,73,359,169,190
050,51,173,"Virginia","Smyth County",3,74,386,176,210
050,51,173,"Virginia","Smyth County",3,75,257,112,145
050,51,173,"Virginia","Smyth County",3,76,234,106,128
050,51,173,"Virginia","Smyth County",3,77,253,107,146
050,51,173,"Virginia","Smyth County",3,78,263,107,156
050,51,173,"Virginia","Smyth County",3,79,221,93,128
050,51,173,"Virginia","Smyth County",3,80,196,83,113
050,51,173,"Virginia","Smyth County",3,81,174,69,105
050,51,173,"Virginia","Smyth County",3,82,160,77,83
050,51,173,"Virginia","Smyth County",3,83,163,70,93
050,51,173,"Virginia","Smyth County",3,84,146,64,82
050,51,173,"Virginia","Smyth County",3,85,787,285,502
050,51,173,"Virginia","Smyth County",4,0,279,152,127
050,51,173,"Virginia","Smyth County",4,1,289,154,135
050,51,173,"Virginia","Smyth County",4,2,252,136,116
050,51,173,"Virginia","Smyth County",4,3,288,151,137
050,51,173,"Virginia","Smyth County",4,4,273,138,135
050,51,173,"Virginia","Smyth County",4,5,292,144,148
050,51,173,"Virginia","Smyth County",4,6,287,133,154
050,51,173,"Virginia","Smyth County",4,7,306,157,149
050,51,173,"Virginia","Smyth County",4,8,302,146,156
050,51,173,"Virginia","Smyth County",4,9,320,168,152
050,51,173,"Virginia","Smyth County",4,10,318,155,163
050,51,173,"Virginia","Smyth County",4,11,320,156,164
050,51,173,"Virginia","Smyth County",4,12,331,159,172
050,51,173,"Virginia","Smyth County",4,13,333,171,162
050,51,173,"Virginia","Smyth County",4,14,370,191,179
050,51,173,"Virginia","Smyth County",4,15,387,211,176
050,51,173,"Virginia","Smyth County",4,16,387,217,170
050,51,173,"Virginia","Smyth County",4,17,365,199,166
050,51,173,"Virginia","Smyth County",4,18,319,172,147
050,51,173,"Virginia","Smyth County",4,19,247,129,118
050,51,173,"Virginia","Smyth County",4,20,273,146,127
050,51,173,"Virginia","Smyth County",4,21,299,158,141
050,51,173,"Virginia","Smyth County",4,22,303,152,151
050,51,173,"Virginia","Smyth County",4,23,319,163,156
050,51,173,"Virginia","Smyth County",4,24,337,180,157
050,51,173,"Virginia","Smyth County",4,25,333,183,150
050,51,173,"Virginia","Smyth County",4,26,312,181,131
050,51,173,"Virginia","Smyth County",4,27,334,184,150
050,51,173,"Virginia","Smyth County",4,28,334,164,170
050,51,173,"Virginia","Smyth County",4,29,347,184,163
050,51,173,"Virginia","Smyth County",4,30,360,168,192
050,51,173,"Virginia","Smyth County",4,31,387,196,191
050,51,173,"Virginia","Smyth County",4,32,369,183,186
050,51,173,"Virginia","Smyth County",4,33,350,196,154
050,51,173,"Virginia","Smyth County",4,34,342,180,162
050,51,173,"Virginia","Smyth County",4,35,297,158,139
050,51,173,"Virginia","Smyth County",4,36,320,161,159
050,51,173,"Virginia","Smyth County",4,37,312,170,142
050,51,173,"Virginia","Smyth County",4,38,285,144,141
050,51,173,"Virginia","Smyth County",4,39,307,151,156
050,51,173,"Virginia","Smyth County",4,40,298,150,148
050,51,173,"Virginia","Smyth County",4,41,330,161,169
050,51,173,"Virginia","Smyth County",4,42,346,170,176
050,51,173,"Virginia","Smyth County",4,43,344,181,163
050,51,173,"Virginia","Smyth County",4,44,350,184,166
050,51,173,"Virginia","Smyth County",4,45,349,179,170
050,51,173,"Virginia","Smyth County",4,46,330,176,154
050,51,173,"Virginia","Smyth County",4,47,357,169,188
050,51,173,"Virginia","Smyth County",4,48,389,194,195
050,51,173,"Virginia","Smyth County",4,49,400,189,211
050,51,173,"Virginia","Smyth County",4,50,419,216,203
050,51,173,"Virginia","Smyth County",4,51,448,213,235
050,51,173,"Virginia","Smyth County",4,52,424,185,239
050,51,173,"Virginia","Smyth County",4,53,423,203,220
050,51,173,"Virginia","Smyth County",4,54,413,207,206
050,51,173,"Virginia","Smyth County",4,55,438,225,213
050,51,173,"Virginia","Smyth County",4,56,429,222,207
050,51,173,"Virginia","Smyth County",4,57,416,201,215
050,51,173,"Virginia","Smyth County",4,58,418,214,204
050,51,173,"Virginia","Smyth County",4,59,440,234,206
050,51,173,"Virginia","Smyth County",4,60,432,222,210
050,51,173,"Virginia","Smyth County",4,61,460,225,235
050,51,173,"Virginia","Smyth County",4,62,416,199,217
050,51,173,"Virginia","Smyth County",4,63,415,205,210
050,51,173,"Virginia","Smyth County",4,64,416,205,211
050,51,173,"Virginia","Smyth County",4,65,394,189,205
050,51,173,"Virginia","Smyth County",4,66,404,190,214
050,51,173,"Virginia","Smyth County",4,67,438,205,233
050,51,173,"Virginia","Smyth County",4,68,419,201,218
050,51,173,"Virginia","Smyth County",4,69,394,192,202
050,51,173,"Virginia","Smyth County",4,70,369,169,200
050,51,173,"Virginia","Smyth County",4,71,360,162,198
050,51,173,"Virginia","Smyth County",4,72,339,152,187
050,51,173,"Virginia","Smyth County",4,73,345,160,185
050,51,173,"Virginia","Smyth County",4,74,350,163,187
050,51,173,"Virginia","Smyth County",4,75,365,167,198
050,51,173,"Virginia","Smyth County",4,76,239,110,129
050,51,173,"Virginia","Smyth County",4,77,223,98,125
050,51,173,"Virginia","Smyth County",4,78,235,94,141
050,51,173,"Virginia","Smyth County",4,79,246,104,142
050,51,173,"Virginia","Smyth County",4,80,203,79,124
050,51,173,"Virginia","Smyth County",4,81,185,73,112
050,51,173,"Virginia","Smyth County",4,82,147,63,84
050,51,173,"Virginia","Smyth County",4,83,142,66,76
050,51,173,"Virginia","Smyth County",4,84,154,66,88
050,51,173,"Virginia","Smyth County",4,85,772,291,481
050,51,173,"Virginia","Smyth County",5,0,278,151,127
050,51,173,"Virginia","Smyth County",5,1,289,157,132
050,51,173,"Virginia","Smyth County",5,2,292,161,131
050,51,173,"Virginia","Smyth County",5,3,258,137,121
050,51,173,"Virginia","Smyth County",5,4,296,154,142
050,51,173,"Virginia","Smyth County",5,5,280,140,140
050,51,173,"Virginia","Smyth County",5,6,297,148,149
050,51,173,"Virginia","Smyth County",5,7,284,136,148
050,51,173,"Virginia","Smyth County",5,8,308,154,154
050,51,173,"Virginia","Smyth County",5,9,301,147,154
050,51,173,"Virginia","Smyth County",5,10,322,169,153
050,51,173,"Virginia","Smyth County",5,11,325,154,171
050,51,173,"Virginia","Smyth County",5,12,323,161,162
050,51,173,"Virginia","Smyth County",5,13,332,161,171
050,51,173,"Virginia","Smyth County",5,14,334,178,156
050,51,173,"Virginia","Smyth County",5,15,369,191,178
050,51,173,"Virginia","Smyth County",5,16,372,202,170
050,51,173,"Virginia","Smyth County",5,17,381,216,165
050,51,173,"Virginia","Smyth County",5,18,307,174,133
050,51,173,"Virginia","Smyth County",5,19,254,140,114
050,51,173,"Virginia","Smyth County",5,20,266,141,125
050,51,173,"Virginia","Smyth County",5,21,282,153,129
050,51,173,"Virginia","Smyth County",5,22,309,164,145
050,51,173,"Virginia","Smyth County",5,23,321,157,164
050,51,173,"Virginia","Smyth County",5,24,334,178,156
050,51,173,"Virginia","Smyth County",5,25,346,189,157
050,51,173,"Virginia","Smyth County",5,26,351,195,156
050,51,173,"Virginia","Smyth County",5,27,312,171,141
050,51,173,"Virginia","Smyth County",5,28,321,183,138
050,51,173,"Virginia","Smyth County",5,29,340,171,169
050,51,173,"Virginia","Smyth County",5,30,335,173,162
050,51,173,"Virginia","Smyth County",5,31,384,188,196
050,51,173,"Virginia","Smyth County",5,32,387,192,195
050,51,173,"Virginia","Smyth County",5,33,349,164,185
050,51,173,"Virginia","Smyth County",5,34,355,203,152
050,51,173,"Virginia","Smyth County",5,35,347,182,165
050,51,173,"Virginia","Smyth County",5,36,295,163,132
050,51,173,"Virginia","Smyth County",5,37,323,163,160
050,51,173,"Virginia","Smyth County",5,38,316,166,150
050,51,173,"Virginia","Smyth County",5,39,285,144,141
050,51,173,"Virginia","Smyth County",5,40,296,145,151
050,51,173,"Virginia","Smyth County",5,41,303,151,152
050,51,173,"Virginia","Smyth County",5,42,325,154,171
050,51,173,"Virginia","Smyth County",5,43,343,171,172
050,51,173,"Virginia","Smyth County",5,44,341,174,167
050,51,173,"Virginia","Smyth County",5,45,356,185,171
050,51,173,"Virginia","Smyth County",5,46,350,178,172
050,51,173,"Virginia","Smyth County",5,47,331,173,158
050,51,173,"Virginia","Smyth County",5,48,354,166,188
050,51,173,"Virginia","Smyth County",5,49,384,191,193
050,51,173,"Virginia","Smyth County",5,50,395,182,213
050,51,173,"Virginia","Smyth County",5,51,419,212,207
050,51,173,"Virginia","Smyth County",5,52,443,214,229
050,51,173,"Virginia","Smyth County",5,53,424,180,244
050,51,173,"Virginia","Smyth County",5,54,434,207,227
050,51,173,"Virginia","Smyth County",5,55,418,206,212
050,51,173,"Virginia","Smyth County",5,56,445,237,208
050,51,173,"Virginia","Smyth County",5,57,421,212,209
050,51,173,"Virginia","Smyth County",5,58,409,196,213
050,51,173,"Virginia","Smyth County",5,59,415,206,209
050,51,173,"Virginia","Smyth County",5,60,440,234,206
050,51,173,"Virginia","Smyth County",5,61,430,220,210
050,51,173,"Virginia","Smyth County",5,62,452,220,232
050,51,173,"Virginia","Smyth County",5,63,419,200,219
050,51,173,"Virginia","Smyth County",5,64,411,200,211
050,51,173,"Virginia","Smyth County",5,65,398,200,198
050,51,173,"Virginia","Smyth County",5,66,390,189,201
050,51,173,"Virginia","Smyth County",5,67,391,184,207
050,51,173,"Virginia","Smyth County",5,68,426,201,225
050,51,173,"Virginia","Smyth County",5,69,404,196,208
050,51,173,"Virginia","Smyth County",5,70,379,179,200
050,51,173,"Virginia","Smyth County",5,71,359,166,193
050,51,173,"Virginia","Smyth County",5,72,350,161,189
050,51,173,"Virginia","Smyth County",5,73,328,143,185
050,51,173,"Virginia","Smyth County",5,74,331,153,178
050,51,173,"Virginia","Smyth County",5,75,329,154,175
050,51,173,"Virginia","Smyth County",5,76,346,164,182
050,51,173,"Virginia","Smyth County",5,77,231,104,127
050,51,173,"Virginia","Smyth County",5,78,207,85,122
050,51,173,"Virginia","Smyth County",5,79,212,90,122
050,51,173,"Virginia","Smyth County",5,80,232,91,141
050,51,173,"Virginia","Smyth County",5,81,189,68,121
050,51,173,"Virginia","Smyth County",5,82,157,68,89
050,51,173,"Virginia","Smyth County",5,83,132,52,80
050,51,173,"Virginia","Smyth County",5,84,137,60,77
050,51,173,"Virginia","Smyth County",5,85,770,298,472
050,51,175,"Virginia","Southampton County",1,0,161,82,79
050,51,175,"Virginia","Southampton County",1,1,187,95,92
050,51,175,"Virginia","Southampton County",1,2,168,83,85
050,51,175,"Virginia","Southampton County",1,3,160,89,71
050,51,175,"Virginia","Southampton County",1,4,182,91,91
050,51,175,"Virginia","Southampton County",1,5,181,83,98
050,51,175,"Virginia","Southampton County",1,6,192,101,91
050,51,175,"Virginia","Southampton County",1,7,187,93,94
050,51,175,"Virginia","Southampton County",1,8,166,94,72
050,51,175,"Virginia","Southampton County",1,9,186,96,90
050,51,175,"Virginia","Southampton County",1,10,202,99,103
050,51,175,"Virginia","Southampton County",1,11,198,105,93
050,51,175,"Virginia","Southampton County",1,12,236,121,115
050,51,175,"Virginia","Southampton County",1,13,204,116,88
050,51,175,"Virginia","Southampton County",1,14,199,107,92
050,51,175,"Virginia","Southampton County",1,15,219,118,101
050,51,175,"Virginia","Southampton County",1,16,218,112,106
050,51,175,"Virginia","Southampton County",1,17,229,106,123
050,51,175,"Virginia","Southampton County",1,18,192,95,97
050,51,175,"Virginia","Southampton County",1,19,148,75,73
050,51,175,"Virginia","Southampton County",1,20,155,85,70
050,51,175,"Virginia","Southampton County",1,21,169,90,79
050,51,175,"Virginia","Southampton County",1,22,159,80,79
050,51,175,"Virginia","Southampton County",1,23,163,82,81
050,51,175,"Virginia","Southampton County",1,24,182,96,86
050,51,175,"Virginia","Southampton County",1,25,190,98,92
050,51,175,"Virginia","Southampton County",1,26,208,110,98
050,51,175,"Virginia","Southampton County",1,27,206,116,90
050,51,175,"Virginia","Southampton County",1,28,192,91,101
050,51,175,"Virginia","Southampton County",1,29,197,94,103
050,51,175,"Virginia","Southampton County",1,30,213,118,95
050,51,175,"Virginia","Southampton County",1,31,191,94,97
050,51,175,"Virginia","Southampton County",1,32,171,86,85
050,51,175,"Virginia","Southampton County",1,33,187,91,96
050,51,175,"Virginia","Southampton County",1,34,199,108,91
050,51,175,"Virginia","Southampton County",1,35,193,99,94
050,51,175,"Virginia","Southampton County",1,36,188,93,95
050,51,175,"Virginia","Southampton County",1,37,192,87,105
050,51,175,"Virginia","Southampton County",1,38,197,95,102
050,51,175,"Virginia","Southampton County",1,39,213,110,103
050,51,175,"Virginia","Southampton County",1,40,185,91,94
050,51,175,"Virginia","Southampton County",1,41,185,99,86
050,51,175,"Virginia","Southampton County",1,42,204,112,92
050,51,175,"Virginia","Southampton County",1,43,167,81,86
050,51,175,"Virginia","Southampton County",1,44,193,101,92
050,51,175,"Virginia","Southampton County",1,45,201,105,96
050,51,175,"Virginia","Southampton County",1,46,229,133,96
050,51,175,"Virginia","Southampton County",1,47,246,142,104
050,51,175,"Virginia","Southampton County",1,48,285,171,114
050,51,175,"Virginia","Southampton County",1,49,287,169,118
050,51,175,"Virginia","Southampton County",1,50,273,154,119
050,51,175,"Virginia","Southampton County",1,51,289,178,111
050,51,175,"Virginia","Southampton County",1,52,285,169,116
050,51,175,"Virginia","Southampton County",1,53,302,151,151
050,51,175,"Virginia","Southampton County",1,54,289,151,138
050,51,175,"Virginia","Southampton County",1,55,303,166,137
050,51,175,"Virginia","Southampton County",1,56,311,167,144
050,51,175,"Virginia","Southampton County",1,57,332,181,151
050,51,175,"Virginia","Southampton County",1,58,311,178,133
050,51,175,"Virginia","Southampton County",1,59,324,185,139
050,51,175,"Virginia","Southampton County",1,60,309,161,148
050,51,175,"Virginia","Southampton County",1,61,284,154,130
050,51,175,"Virginia","Southampton County",1,62,293,160,133
050,51,175,"Virginia","Southampton County",1,63,301,159,142
050,51,175,"Virginia","Southampton County",1,64,294,157,137
050,51,175,"Virginia","Southampton County",1,65,266,130,136
050,51,175,"Virginia","Southampton County",1,66,277,148,129
050,51,175,"Virginia","Southampton County",1,67,248,126,122
050,51,175,"Virginia","Southampton County",1,68,241,130,111
050,51,175,"Virginia","Southampton County",1,69,209,101,108
050,51,175,"Virginia","Southampton County",1,70,210,106,104
050,51,175,"Virginia","Southampton County",1,71,206,97,109
050,51,175,"Virginia","Southampton County",1,72,218,112,106
050,51,175,"Virginia","Southampton County",1,73,201,102,99
050,51,175,"Virginia","Southampton County",1,74,150,75,75
050,51,175,"Virginia","Southampton County",1,75,139,66,73
050,51,175,"Virginia","Southampton County",1,76,149,75,74
050,51,175,"Virginia","Southampton County",1,77,154,73,81
050,51,175,"Virginia","Southampton County",1,78,136,56,80
050,51,175,"Virginia","Southampton County",1,79,109,52,57
050,51,175,"Virginia","Southampton County",1,80,101,46,55
050,51,175,"Virginia","Southampton County",1,81,96,40,56
050,51,175,"Virginia","Southampton County",1,82,85,42,43
050,51,175,"Virginia","Southampton County",1,83,83,34,49
050,51,175,"Virginia","Southampton County",1,84,80,32,48
050,51,175,"Virginia","Southampton County",1,85,380,131,249
050,51,175,"Virginia","Southampton County",2,0,154,73,81
050,51,175,"Virginia","Southampton County",2,1,181,92,89
050,51,175,"Virginia","Southampton County",2,2,173,86,87
050,51,175,"Virginia","Southampton County",2,3,165,89,76
050,51,175,"Virginia","Southampton County",2,4,176,90,86
050,51,175,"Virginia","Southampton County",2,5,183,87,96
050,51,175,"Virginia","Southampton County",2,6,190,97,93
050,51,175,"Virginia","Southampton County",2,7,185,94,91
050,51,175,"Virginia","Southampton County",2,8,170,93,77
050,51,175,"Virginia","Southampton County",2,9,181,97,84
050,51,175,"Virginia","Southampton County",2,10,198,100,98
050,51,175,"Virginia","Southampton County",2,11,197,103,94
050,51,175,"Virginia","Southampton County",2,12,226,117,109
050,51,175,"Virginia","Southampton County",2,13,213,119,94
050,51,175,"Virginia","Southampton County",2,14,198,109,89
050,51,175,"Virginia","Southampton County",2,15,213,116,97
050,51,175,"Virginia","Southampton County",2,16,221,116,105
050,51,175,"Virginia","Southampton County",2,17,225,108,117
050,51,175,"Virginia","Southampton County",2,18,192,94,98
050,51,175,"Virginia","Southampton County",2,19,153,79,74
050,51,175,"Virginia","Southampton County",2,20,154,83,71
050,51,175,"Virginia","Southampton County",2,21,167,90,77
050,51,175,"Virginia","Southampton County",2,22,159,80,79
050,51,175,"Virginia","Southampton County",2,23,164,83,81
050,51,175,"Virginia","Southampton County",2,24,179,93,86
050,51,175,"Virginia","Southampton County",2,25,185,96,89
050,51,175,"Virginia","Southampton County",2,26,204,109,95
050,51,175,"Virginia","Southampton County",2,27,208,115,93
050,51,175,"Virginia","Southampton County",2,28,197,97,100
050,51,175,"Virginia","Southampton County",2,29,196,94,102
050,51,175,"Virginia","Southampton County",2,30,210,113,97
050,51,175,"Virginia","Southampton County",2,31,196,99,97
050,51,175,"Virginia","Southampton County",2,32,173,85,88
050,51,175,"Virginia","Southampton County",2,33,186,90,96
050,51,175,"Virginia","Southampton County",2,34,197,106,91
050,51,175,"Virginia","Southampton County",2,35,194,101,93
050,51,175,"Virginia","Southampton County",2,36,187,93,94
050,51,175,"Virginia","Southampton County",2,37,191,89,102
050,51,175,"Virginia","Southampton County",2,38,195,92,103
050,51,175,"Virginia","Southampton County",2,39,210,108,102
050,51,175,"Virginia","Southampton County",2,40,195,96,99
050,51,175,"Virginia","Southampton County",2,41,185,96,89
050,51,175,"Virginia","Southampton County",2,42,199,108,91
050,51,175,"Virginia","Southampton County",2,43,173,86,87
050,51,175,"Virginia","Southampton County",2,44,186,98,88
050,51,175,"Virginia","Southampton County",2,45,199,106,93
050,51,175,"Virginia","Southampton County",2,46,225,128,97
050,51,175,"Virginia","Southampton County",2,47,245,143,102
050,51,175,"Virginia","Southampton County",2,48,281,170,111
050,51,175,"Virginia","Southampton County",2,49,284,167,117
050,51,175,"Virginia","Southampton County",2,50,275,156,119
050,51,175,"Virginia","Southampton County",2,51,289,175,114
050,51,175,"Virginia","Southampton County",2,52,285,170,115
050,51,175,"Virginia","Southampton County",2,53,294,151,143
050,51,175,"Virginia","Southampton County",2,54,291,151,140
050,51,175,"Virginia","Southampton County",2,55,294,158,136
050,51,175,"Virginia","Southampton County",2,56,306,165,141
050,51,175,"Virginia","Southampton County",2,57,326,177,149
050,51,175,"Virginia","Southampton County",2,58,313,176,137
050,51,175,"Virginia","Southampton County",2,59,323,185,138
050,51,175,"Virginia","Southampton County",2,60,313,166,147
050,51,175,"Virginia","Southampton County",2,61,289,153,136
050,51,175,"Virginia","Southampton County",2,62,292,161,131
050,51,175,"Virginia","Southampton County",2,63,298,160,138
050,51,175,"Virginia","Southampton County",2,64,291,154,137
050,51,175,"Virginia","Southampton County",2,65,272,136,136
050,51,175,"Virginia","Southampton County",2,66,277,145,132
050,51,175,"Virginia","Southampton County",2,67,250,127,123
050,51,175,"Virginia","Southampton County",2,68,242,130,112
050,51,175,"Virginia","Southampton County",2,69,216,107,109
050,51,175,"Virginia","Southampton County",2,70,207,105,102
050,51,175,"Virginia","Southampton County",2,71,203,100,103
050,51,175,"Virginia","Southampton County",2,72,209,105,104
050,51,175,"Virginia","Southampton County",2,73,213,108,105
050,51,175,"Virginia","Southampton County",2,74,152,75,77
050,51,175,"Virginia","Southampton County",2,75,141,68,73
050,51,175,"Virginia","Southampton County",2,76,142,71,71
050,51,175,"Virginia","Southampton County",2,77,155,76,79
050,51,175,"Virginia","Southampton County",2,78,134,58,76
050,51,175,"Virginia","Southampton County",2,79,114,52,62
050,51,175,"Virginia","Southampton County",2,80,103,48,55
050,51,175,"Virginia","Southampton County",2,81,96,41,55
050,51,175,"Virginia","Southampton County",2,82,88,41,47
050,51,175,"Virginia","Southampton County",2,83,83,36,47
050,51,175,"Virginia","Southampton County",2,84,77,30,47
050,51,175,"Virginia","Southampton County",2,85,382,136,246
050,51,175,"Virginia","Southampton County",3,0,102,59,43
050,51,175,"Virginia","Southampton County",3,1,140,65,75
050,51,175,"Virginia","Southampton County",3,2,179,87,92
050,51,175,"Virginia","Southampton County",3,3,177,90,87
050,51,175,"Virginia","Southampton County",3,4,174,88,86
050,51,175,"Virginia","Southampton County",3,5,183,95,88
050,51,175,"Virginia","Southampton County",3,6,200,91,109
050,51,175,"Virginia","Southampton County",3,7,194,98,96
050,51,175,"Virginia","Southampton County",3,8,199,106,93
050,51,175,"Virginia","Southampton County",3,9,188,100,88
050,51,175,"Virginia","Southampton County",3,10,172,94,78
050,51,175,"Virginia","Southampton County",3,11,204,98,106
050,51,175,"Virginia","Southampton County",3,12,198,104,94
050,51,175,"Virginia","Southampton County",3,13,230,116,114
050,51,175,"Virginia","Southampton County",3,14,207,110,97
050,51,175,"Virginia","Southampton County",3,15,213,113,100
050,51,175,"Virginia","Southampton County",3,16,211,120,91
050,51,175,"Virginia","Southampton County",3,17,220,114,106
050,51,175,"Virginia","Southampton County",3,18,190,98,92
050,51,175,"Virginia","Southampton County",3,19,163,83,80
050,51,175,"Virginia","Southampton County",3,20,148,73,75
050,51,175,"Virginia","Southampton County",3,21,174,98,76
050,51,175,"Virginia","Southampton County",3,22,168,84,84
050,51,175,"Virginia","Southampton County",3,23,157,83,74
050,51,175,"Virginia","Southampton County",3,24,175,89,86
050,51,175,"Virginia","Southampton County",3,25,167,83,84
050,51,175,"Virginia","Southampton County",3,26,199,107,92
050,51,175,"Virginia","Southampton County",3,27,208,116,92
050,51,175,"Virginia","Southampton County",3,28,209,112,97
050,51,175,"Virginia","Southampton County",3,29,197,96,101
050,51,175,"Virginia","Southampton County",3,30,203,98,105
050,51,175,"Virginia","Southampton County",3,31,231,121,110
050,51,175,"Virginia","Southampton County",3,32,205,101,104
050,51,175,"Virginia","Southampton County",3,33,195,98,97
050,51,175,"Virginia","Southampton County",3,34,194,100,94
050,51,175,"Virginia","Southampton County",3,35,196,100,96
050,51,175,"Virginia","Southampton County",3,36,199,103,96
050,51,175,"Virginia","Southampton County",3,37,196,97,99
050,51,175,"Virginia","Southampton County",3,38,193,93,100
050,51,175,"Virginia","Southampton County",3,39,204,98,106
050,51,175,"Virginia","Southampton County",3,40,211,107,104
050,51,175,"Virginia","Southampton County",3,41,194,96,98
050,51,175,"Virginia","Southampton County",3,42,197,101,96
050,51,175,"Virginia","Southampton County",3,43,189,97,92
050,51,175,"Virginia","Southampton County",3,44,188,98,90
050,51,175,"Virginia","Southampton County",3,45,189,106,83
050,51,175,"Virginia","Southampton County",3,46,220,122,98
050,51,175,"Virginia","Southampton County",3,47,238,146,92
050,51,175,"Virginia","Southampton County",3,48,259,160,99
050,51,175,"Virginia","Southampton County",3,49,284,170,114
050,51,175,"Virginia","Southampton County",3,50,268,155,113
050,51,175,"Virginia","Southampton County",3,51,292,171,121
050,51,175,"Virginia","Southampton County",3,52,291,180,111
050,51,175,"Virginia","Southampton County",3,53,266,153,113
050,51,175,"Virginia","Southampton County",3,54,288,148,140
050,51,175,"Virginia","Southampton County",3,55,288,146,142
050,51,175,"Virginia","Southampton County",3,56,293,156,137
050,51,175,"Virginia","Southampton County",3,57,303,160,143
050,51,175,"Virginia","Southampton County",3,58,318,167,151
050,51,175,"Virginia","Southampton County",3,59,311,179,132
050,51,175,"Virginia","Southampton County",3,60,314,182,132
050,51,175,"Virginia","Southampton County",3,61,314,164,150
050,51,175,"Virginia","Southampton County",3,62,298,166,132
050,51,175,"Virginia","Southampton County",3,63,291,163,128
050,51,175,"Virginia","Southampton County",3,64,291,147,144
050,51,175,"Virginia","Southampton County",3,65,283,149,134
050,51,175,"Virginia","Southampton County",3,66,273,146,127
050,51,175,"Virginia","Southampton County",3,67,262,129,133
050,51,175,"Virginia","Southampton County",3,68,250,133,117
050,51,175,"Virginia","Southampton County",3,69,226,118,108
050,51,175,"Virginia","Southampton County",3,70,218,110,108
050,51,175,"Virginia","Southampton County",3,71,213,109,104
050,51,175,"Virginia","Southampton County",3,72,185,91,94
050,51,175,"Virginia","Southampton County",3,73,209,103,106
050,51,175,"Virginia","Southampton County",3,74,207,103,104
050,51,175,"Virginia","Southampton County",3,75,147,72,75
050,51,175,"Virginia","Southampton County",3,76,137,63,74
050,51,175,"Virginia","Southampton County",3,77,138,69,69
050,51,175,"Virginia","Southampton County",3,78,145,69,76
050,51,175,"Virginia","Southampton County",3,79,123,54,69
050,51,175,"Virginia","Southampton County",3,80,106,46,60
050,51,175,"Virginia","Southampton County",3,81,101,47,54
050,51,175,"Virginia","Southampton County",3,82,91,39,52
050,51,175,"Virginia","Southampton County",3,83,84,38,46
050,51,175,"Virginia","Southampton County",3,84,77,33,44
050,51,175,"Virginia","Southampton County",3,85,392,137,255
050,51,175,"Virginia","Southampton County",4,0,107,61,46
050,51,175,"Virginia","Southampton County",4,1,124,77,47
050,51,175,"Virginia","Southampton County",4,2,149,69,80
050,51,175,"Virginia","Southampton County",4,3,186,90,96
050,51,175,"Virginia","Southampton County",4,4,186,97,89
050,51,175,"Virginia","Southampton County",4,5,181,99,82
050,51,175,"Virginia","Southampton County",4,6,184,90,94
050,51,175,"Virginia","Southampton County",4,7,208,96,112
050,51,175,"Virginia","Southampton County",4,8,195,96,99
050,51,175,"Virginia","Southampton County",4,9,196,98,98
050,51,175,"Virginia","Southampton County",4,10,178,97,81
050,51,175,"Virginia","Southampton County",4,11,184,103,81
050,51,175,"Virginia","Southampton County",4,12,200,98,102
050,51,175,"Virginia","Southampton County",4,13,199,106,93
050,51,175,"Virginia","Southampton County",4,14,229,115,114
050,51,175,"Virginia","Southampton County",4,15,208,107,101
050,51,175,"Virginia","Southampton County",4,16,210,112,98
050,51,175,"Virginia","Southampton County",4,17,216,117,99
050,51,175,"Virginia","Southampton County",4,18,179,94,85
050,51,175,"Virginia","Southampton County",4,19,153,78,75
050,51,175,"Virginia","Southampton County",4,20,162,81,81
050,51,175,"Virginia","Southampton County",4,21,156,79,77
050,51,175,"Virginia","Southampton County",4,22,188,99,89
050,51,175,"Virginia","Southampton County",4,23,172,85,87
050,51,175,"Virginia","Southampton County",4,24,183,94,89
050,51,175,"Virginia","Southampton County",4,25,154,77,77
050,51,175,"Virginia","Southampton County",4,26,160,80,80
050,51,175,"Virginia","Southampton County",4,27,199,115,84
050,51,175,"Virginia","Southampton County",4,28,212,111,101
050,51,175,"Virginia","Southampton County",4,29,206,110,96
050,51,175,"Virginia","Southampton County",4,30,201,101,100
050,51,175,"Virginia","Southampton County",4,31,208,103,105
050,51,175,"Virginia","Southampton County",4,32,240,128,112
050,51,175,"Virginia","Southampton County",4,33,217,93,124
050,51,175,"Virginia","Southampton County",4,34,202,111,91
050,51,175,"Virginia","Southampton County",4,35,191,99,92
050,51,175,"Virginia","Southampton County",4,36,189,94,95
050,51,175,"Virginia","Southampton County",4,37,195,101,94
050,51,175,"Virginia","Southampton County",4,38,187,94,93
050,51,175,"Virginia","Southampton County",4,39,202,90,112
050,51,175,"Virginia","Southampton County",4,40,194,94,100
050,51,175,"Virginia","Southampton County",4,41,198,105,93
050,51,175,"Virginia","Southampton County",4,42,204,104,100
050,51,175,"Virginia","Southampton County",4,43,187,88,99
050,51,175,"Virginia","Southampton County",4,44,185,98,87
050,51,175,"Virginia","Southampton County",4,45,203,114,89
050,51,175,"Virginia","Southampton County",4,46,206,116,90
050,51,175,"Virginia","Southampton County",4,47,227,129,98
050,51,175,"Virginia","Southampton County",4,48,256,168,88
050,51,175,"Virginia","Southampton County",4,49,248,148,100
050,51,175,"Virginia","Southampton County",4,50,268,157,111
050,51,175,"Virginia","Southampton County",4,51,272,158,114
050,51,175,"Virginia","Southampton County",4,52,302,180,122
050,51,175,"Virginia","Southampton County",4,53,272,161,111
050,51,175,"Virginia","Southampton County",4,54,265,157,108
050,51,175,"Virginia","Southampton County",4,55,277,142,135
050,51,175,"Virginia","Southampton County",4,56,285,141,144
050,51,175,"Virginia","Southampton County",4,57,290,152,138
050,51,175,"Virginia","Southampton County",4,58,288,145,143
050,51,175,"Virginia","Southampton County",4,59,318,169,149
050,51,175,"Virginia","Southampton County",4,60,303,168,135
050,51,175,"Virginia","Southampton County",4,61,299,167,132
050,51,175,"Virginia","Southampton County",4,62,315,165,150
050,51,175,"Virginia","Southampton County",4,63,299,171,128
050,51,175,"Virginia","Southampton County",4,64,283,155,128
050,51,175,"Virginia","Southampton County",4,65,288,148,140
050,51,175,"Virginia","Southampton County",4,66,285,155,130
050,51,175,"Virginia","Southampton County",4,67,254,131,123
050,51,175,"Virginia","Southampton County",4,68,265,132,133
050,51,175,"Virginia","Southampton County",4,69,236,119,117
050,51,175,"Virginia","Southampton County",4,70,225,117,108
050,51,175,"Virginia","Southampton County",4,71,219,108,111
050,51,175,"Virginia","Southampton County",4,72,204,103,101
050,51,175,"Virginia","Southampton County",4,73,184,90,94
050,51,175,"Virginia","Southampton County",4,74,200,97,103
050,51,175,"Virginia","Southampton County",4,75,194,98,96
050,51,175,"Virginia","Southampton County",4,76,142,69,73
050,51,175,"Virginia","Southampton County",4,77,138,65,73
050,51,175,"Virginia","Southampton County",4,78,125,59,66
050,51,175,"Virginia","Southampton County",4,79,136,65,71
050,51,175,"Virginia","Southampton County",4,80,111,50,61
050,51,175,"Virginia","Southampton County",4,81,93,40,53
050,51,175,"Virginia","Southampton County",4,82,94,46,48
050,51,175,"Virginia","Southampton County",4,83,86,33,53
050,51,175,"Virginia","Southampton County",4,84,80,36,44
050,51,175,"Virginia","Southampton County",4,85,400,140,260
050,51,175,"Virginia","Southampton County",5,0,107,60,47
050,51,175,"Virginia","Southampton County",5,1,131,61,70
050,51,175,"Virginia","Southampton County",5,2,121,70,51
050,51,175,"Virginia","Southampton County",5,3,156,70,86
050,51,175,"Virginia","Southampton County",5,4,182,95,87
050,51,175,"Virginia","Southampton County",5,5,194,95,99
050,51,175,"Virginia","Southampton County",5,6,184,93,91
050,51,175,"Virginia","Southampton County",5,7,186,89,97
050,51,175,"Virginia","Southampton County",5,8,209,100,109
050,51,175,"Virginia","Southampton County",5,9,198,100,98
050,51,175,"Virginia","Southampton County",5,10,201,105,96
050,51,175,"Virginia","Southampton County",5,11,174,97,77
050,51,175,"Virginia","Southampton County",5,12,193,110,83
050,51,175,"Virginia","Southampton County",5,13,210,107,103
050,51,175,"Virginia","Southampton County",5,14,209,108,101
050,51,175,"Virginia","Southampton County",5,15,228,119,109
050,51,175,"Virginia","Southampton County",5,16,204,105,99
050,51,175,"Virginia","Southampton County",5,17,198,106,92
050,51,175,"Virginia","Southampton County",5,18,171,97,74
050,51,175,"Virginia","Southampton County",5,19,163,93,70
050,51,175,"Virginia","Southampton County",5,20,157,79,78
050,51,175,"Virginia","Southampton County",5,21,184,92,92
050,51,175,"Virginia","Southampton County",5,22,165,74,91
050,51,175,"Virginia","Southampton County",5,23,198,104,94
050,51,175,"Virginia","Southampton County",5,24,186,93,93
050,51,175,"Virginia","Southampton County",5,25,175,92,83
050,51,175,"Virginia","Southampton County",5,26,159,78,81
050,51,175,"Virginia","Southampton County",5,27,163,86,77
050,51,175,"Virginia","Southampton County",5,28,203,108,95
050,51,175,"Virginia","Southampton County",5,29,209,104,105
050,51,175,"Virginia","Southampton County",5,30,203,114,89
050,51,175,"Virginia","Southampton County",5,31,210,102,108
050,51,175,"Virginia","Southampton County",5,32,208,103,105
050,51,175,"Virginia","Southampton County",5,33,244,125,119
050,51,175,"Virginia","Southampton County",5,34,216,100,116
050,51,175,"Virginia","Southampton County",5,35,204,108,96
050,51,175,"Virginia","Southampton County",5,36,203,100,103
050,51,175,"Virginia","Southampton County",5,37,193,98,95
050,51,175,"Virginia","Southampton County",5,38,196,107,89
050,51,175,"Virginia","Southampton County",5,39,201,104,97
050,51,175,"Virginia","Southampton County",5,40,205,87,118
050,51,175,"Virginia","Southampton County",5,41,195,96,99
050,51,175,"Virginia","Southampton County",5,42,207,111,96
050,51,175,"Virginia","Southampton County",5,43,196,93,103
050,51,175,"Virginia","Southampton County",5,44,199,101,98
050,51,175,"Virginia","Southampton County",5,45,197,108,89
050,51,175,"Virginia","Southampton County",5,46,214,123,91
050,51,175,"Virginia","Southampton County",5,47,217,127,90
050,51,175,"Virginia","Southampton County",5,48,258,153,105
050,51,175,"Virginia","Southampton County",5,49,251,164,87
050,51,175,"Virginia","Southampton County",5,50,237,137,100
050,51,175,"Virginia","Southampton County",5,51,281,167,114
050,51,175,"Virginia","Southampton County",5,52,285,168,117
050,51,175,"Virginia","Southampton County",5,53,287,167,120
050,51,175,"Virginia","Southampton County",5,54,264,154,110
050,51,175,"Virginia","Southampton County",5,55,264,149,115
050,51,175,"Virginia","Southampton County",5,56,273,139,134
050,51,175,"Virginia","Southampton County",5,57,280,137,143
050,51,175,"Virginia","Southampton County",5,58,277,140,137
050,51,175,"Virginia","Southampton County",5,59,298,153,145
050,51,175,"Virginia","Southampton County",5,60,318,164,154
050,51,175,"Virginia","Southampton County",5,61,295,159,136
050,51,175,"Virginia","Southampton County",5,62,310,180,130
050,51,175,"Virginia","Southampton County",5,63,318,164,154
050,51,175,"Virginia","Southampton County",5,64,291,163,128
050,51,175,"Virginia","Southampton County",5,65,284,154,130
050,51,175,"Virginia","Southampton County",5,66,298,158,140
050,51,175,"Virginia","Southampton County",5,67,267,140,127
050,51,175,"Virginia","Southampton County",5,68,261,137,124
050,51,175,"Virginia","Southampton County",5,69,253,120,133
050,51,175,"Virginia","Southampton County",5,70,233,114,119
050,51,175,"Virginia","Southampton County",5,71,222,116,106
050,51,175,"Virginia","Southampton County",5,72,206,97,109
050,51,175,"Virginia","Southampton County",5,73,200,99,101
050,51,175,"Virginia","Southampton County",5,74,182,88,94
050,51,175,"Virginia","Southampton County",5,75,191,95,96
050,51,175,"Virginia","Southampton County",5,76,191,94,97
050,51,175,"Virginia","Southampton County",5,77,141,71,70
050,51,175,"Virginia","Southampton County",5,78,126,57,69
050,51,175,"Virginia","Southampton County",5,79,112,52,60
050,51,175,"Virginia","Southampton County",5,80,123,60,63
050,51,175,"Virginia","Southampton County",5,81,97,44,53
050,51,175,"Virginia","Southampton County",5,82,89,40,49
050,51,175,"Virginia","Southampton County",5,83,90,41,49
050,51,175,"Virginia","Southampton County",5,84,81,31,50
050,51,175,"Virginia","Southampton County",5,85,415,150,265
050,51,177,"Virginia","Spotsylvania County",1,0,1547,787,760
050,51,177,"Virginia","Spotsylvania County",1,1,1622,844,778
050,51,177,"Virginia","Spotsylvania County",1,2,1781,904,877
050,51,177,"Virginia","Spotsylvania County",1,3,1732,872,860
050,51,177,"Virginia","Spotsylvania County",1,4,1841,948,893
050,51,177,"Virginia","Spotsylvania County",1,5,1876,965,911
050,51,177,"Virginia","Spotsylvania County",1,6,1855,942,913
050,51,177,"Virginia","Spotsylvania County",1,7,1851,955,896
050,51,177,"Virginia","Spotsylvania County",1,8,1909,981,928
050,51,177,"Virginia","Spotsylvania County",1,9,1931,974,957
050,51,177,"Virginia","Spotsylvania County",1,10,1918,1002,916
050,51,177,"Virginia","Spotsylvania County",1,11,2074,1073,1001
050,51,177,"Virginia","Spotsylvania County",1,12,2236,1130,1106
050,51,177,"Virginia","Spotsylvania County",1,13,2210,1132,1078
050,51,177,"Virginia","Spotsylvania County",1,14,2100,1101,999
050,51,177,"Virginia","Spotsylvania County",1,15,2152,1087,1065
050,51,177,"Virginia","Spotsylvania County",1,16,2124,1065,1059
050,51,177,"Virginia","Spotsylvania County",1,17,2157,1099,1058
050,51,177,"Virginia","Spotsylvania County",1,18,1836,980,856
050,51,177,"Virginia","Spotsylvania County",1,19,1485,794,691
050,51,177,"Virginia","Spotsylvania County",1,20,1543,820,723
050,51,177,"Virginia","Spotsylvania County",1,21,1605,839,766
050,51,177,"Virginia","Spotsylvania County",1,22,1665,848,817
050,51,177,"Virginia","Spotsylvania County",1,23,1670,834,836
050,51,177,"Virginia","Spotsylvania County",1,24,1677,857,820
050,51,177,"Virginia","Spotsylvania County",1,25,1691,814,877
050,51,177,"Virginia","Spotsylvania County",1,26,1759,880,879
050,51,177,"Virginia","Spotsylvania County",1,27,1733,915,818
050,51,177,"Virginia","Spotsylvania County",1,28,1774,889,885
050,51,177,"Virginia","Spotsylvania County",1,29,1757,872,885
050,51,177,"Virginia","Spotsylvania County",1,30,1763,873,890
050,51,177,"Virginia","Spotsylvania County",1,31,1888,913,975
050,51,177,"Virginia","Spotsylvania County",1,32,1838,909,929
050,51,177,"Virginia","Spotsylvania County",1,33,1768,867,901
050,51,177,"Virginia","Spotsylvania County",1,34,1759,852,907
050,51,177,"Virginia","Spotsylvania County",1,35,1778,837,941
050,51,177,"Virginia","Spotsylvania County",1,36,1806,897,909
050,51,177,"Virginia","Spotsylvania County",1,37,1897,969,928
050,51,177,"Virginia","Spotsylvania County",1,38,1975,1024,951
050,51,177,"Virginia","Spotsylvania County",1,39,1893,918,975
050,51,177,"Virginia","Spotsylvania County",1,40,1874,935,939
050,51,177,"Virginia","Spotsylvania County",1,41,1770,898,872
050,51,177,"Virginia","Spotsylvania County",1,42,1824,897,927
050,51,177,"Virginia","Spotsylvania County",1,43,1767,886,881
050,51,177,"Virginia","Spotsylvania County",1,44,1747,870,877
050,51,177,"Virginia","Spotsylvania County",1,45,1740,849,891
050,51,177,"Virginia","Spotsylvania County",1,46,1695,852,843
050,51,177,"Virginia","Spotsylvania County",1,47,1754,855,899
050,51,177,"Virginia","Spotsylvania County",1,48,1877,922,955
050,51,177,"Virginia","Spotsylvania County",1,49,2046,1024,1022
050,51,177,"Virginia","Spotsylvania County",1,50,1986,984,1002
050,51,177,"Virginia","Spotsylvania County",1,51,1908,957,951
050,51,177,"Virginia","Spotsylvania County",1,52,1921,919,1002
050,51,177,"Virginia","Spotsylvania County",1,53,2019,962,1057
050,51,177,"Virginia","Spotsylvania County",1,54,2010,1002,1008
050,51,177,"Virginia","Spotsylvania County",1,55,2074,1028,1046
050,51,177,"Virginia","Spotsylvania County",1,56,2026,1004,1022
050,51,177,"Virginia","Spotsylvania County",1,57,2032,1013,1019
050,51,177,"Virginia","Spotsylvania County",1,58,1976,993,983
050,51,177,"Virginia","Spotsylvania County",1,59,1922,952,970
050,51,177,"Virginia","Spotsylvania County",1,60,1842,886,956
050,51,177,"Virginia","Spotsylvania County",1,61,1788,873,915
050,51,177,"Virginia","Spotsylvania County",1,62,1736,850,886
050,51,177,"Virginia","Spotsylvania County",1,63,1621,805,816
050,51,177,"Virginia","Spotsylvania County",1,64,1647,817,830
050,51,177,"Virginia","Spotsylvania County",1,65,1555,747,808
050,51,177,"Virginia","Spotsylvania County",1,66,1431,686,745
050,51,177,"Virginia","Spotsylvania County",1,67,1335,641,694
050,51,177,"Virginia","Spotsylvania County",1,68,1287,610,677
050,51,177,"Virginia","Spotsylvania County",1,69,1244,579,665
050,51,177,"Virginia","Spotsylvania County",1,70,1158,541,617
050,51,177,"Virginia","Spotsylvania County",1,71,1186,550,636
050,51,177,"Virginia","Spotsylvania County",1,72,1244,563,681
050,51,177,"Virginia","Spotsylvania County",1,73,1251,563,688
050,51,177,"Virginia","Spotsylvania County",1,74,858,385,473
050,51,177,"Virginia","Spotsylvania County",1,75,814,366,448
050,51,177,"Virginia","Spotsylvania County",1,76,799,363,436
050,51,177,"Virginia","Spotsylvania County",1,77,775,350,425
050,51,177,"Virginia","Spotsylvania County",1,78,649,290,359
050,51,177,"Virginia","Spotsylvania County",1,79,565,243,322
050,51,177,"Virginia","Spotsylvania County",1,80,501,217,284
050,51,177,"Virginia","Spotsylvania County",1,81,440,196,244
050,51,177,"Virginia","Spotsylvania County",1,82,398,175,223
050,51,177,"Virginia","Spotsylvania County",1,83,330,143,187
050,51,177,"Virginia","Spotsylvania County",1,84,334,144,190
050,51,177,"Virginia","Spotsylvania County",1,85,1860,710,1150
050,51,177,"Virginia","Spotsylvania County",2,0,1544,792,752
050,51,177,"Virginia","Spotsylvania County",2,1,1618,836,782
050,51,177,"Virginia","Spotsylvania County",2,2,1762,895,867
050,51,177,"Virginia","Spotsylvania County",2,3,1753,884,869
050,51,177,"Virginia","Spotsylvania County",2,4,1831,936,895
050,51,177,"Virginia","Spotsylvania County",2,5,1883,967,916
050,51,177,"Virginia","Spotsylvania County",2,6,1873,953,920
050,51,177,"Virginia","Spotsylvania County",2,7,1863,955,908
050,51,177,"Virginia","Spotsylvania County",2,8,1902,976,926
050,51,177,"Virginia","Spotsylvania County",2,9,1934,981,953
050,51,177,"Virginia","Spotsylvania County",2,10,1933,1001,932
050,51,177,"Virginia","Spotsylvania County",2,11,2046,1061,985
050,51,177,"Virginia","Spotsylvania County",2,12,2222,1130,1092
050,51,177,"Virginia","Spotsylvania County",2,13,2222,1136,1086
050,51,177,"Virginia","Spotsylvania County",2,14,2136,1115,1021
050,51,177,"Virginia","Spotsylvania County",2,15,2146,1092,1054
050,51,177,"Virginia","Spotsylvania County",2,16,2140,1075,1065
050,51,177,"Virginia","Spotsylvania County",2,17,2144,1089,1055
050,51,177,"Virginia","Spotsylvania County",2,18,1835,973,862
050,51,177,"Virginia","Spotsylvania County",2,19,1506,805,701
050,51,177,"Virginia","Spotsylvania County",2,20,1576,834,742
050,51,177,"Virginia","Spotsylvania County",2,21,1604,838,766
050,51,177,"Virginia","Spotsylvania County",2,22,1664,849,815
050,51,177,"Virginia","Spotsylvania County",2,23,1687,848,839
050,51,177,"Virginia","Spotsylvania County",2,24,1681,851,830
050,51,177,"Virginia","Spotsylvania County",2,25,1703,832,871
050,51,177,"Virginia","Spotsylvania County",2,26,1764,878,886
050,51,177,"Virginia","Spotsylvania County",2,27,1753,911,842
050,51,177,"Virginia","Spotsylvania County",2,28,1778,900,878
050,51,177,"Virginia","Spotsylvania County",2,29,1772,879,893
050,51,177,"Virginia","Spotsylvania County",2,30,1791,888,903
050,51,177,"Virginia","Spotsylvania County",2,31,1873,913,960
050,51,177,"Virginia","Spotsylvania County",2,32,1852,907,945
050,51,177,"Virginia","Spotsylvania County",2,33,1784,875,909
050,51,177,"Virginia","Spotsylvania County",2,34,1771,856,915
050,51,177,"Virginia","Spotsylvania County",2,35,1798,853,945
050,51,177,"Virginia","Spotsylvania County",2,36,1802,885,917
050,51,177,"Virginia","Spotsylvania County",2,37,1898,966,932
050,51,177,"Virginia","Spotsylvania County",2,38,1971,1017,954
050,51,177,"Virginia","Spotsylvania County",2,39,1917,945,972
050,51,177,"Virginia","Spotsylvania County",2,40,1900,945,955
050,51,177,"Virginia","Spotsylvania County",2,41,1801,907,894
050,51,177,"Virginia","Spotsylvania County",2,42,1810,899,911
050,51,177,"Virginia","Spotsylvania County",2,43,1795,898,897
050,51,177,"Virginia","Spotsylvania County",2,44,1742,868,874
050,51,177,"Virginia","Spotsylvania County",2,45,1755,860,895
050,51,177,"Virginia","Spotsylvania County",2,46,1709,853,856
050,51,177,"Virginia","Spotsylvania County",2,47,1736,855,881
050,51,177,"Virginia","Spotsylvania County",2,48,1853,909,944
050,51,177,"Virginia","Spotsylvania County",2,49,2016,1004,1012
050,51,177,"Virginia","Spotsylvania County",2,50,1997,992,1005
050,51,177,"Virginia","Spotsylvania County",2,51,1919,958,961
050,51,177,"Virginia","Spotsylvania County",2,52,1918,930,988
050,51,177,"Virginia","Spotsylvania County",2,53,1990,951,1039
050,51,177,"Virginia","Spotsylvania County",2,54,2004,987,1017
050,51,177,"Virginia","Spotsylvania County",2,55,2058,1021,1037
050,51,177,"Virginia","Spotsylvania County",2,56,2031,1007,1024
050,51,177,"Virginia","Spotsylvania County",2,57,2022,1008,1014
050,51,177,"Virginia","Spotsylvania County",2,58,1982,994,988
050,51,177,"Virginia","Spotsylvania County",2,59,1932,961,971
050,51,177,"Virginia","Spotsylvania County",2,60,1855,898,957
050,51,177,"Virginia","Spotsylvania County",2,61,1793,871,922
050,51,177,"Virginia","Spotsylvania County",2,62,1740,851,889
050,51,177,"Virginia","Spotsylvania County",2,63,1665,819,846
050,51,177,"Virginia","Spotsylvania County",2,64,1632,809,823
050,51,177,"Virginia","Spotsylvania County",2,65,1576,767,809
050,51,177,"Virginia","Spotsylvania County",2,66,1465,704,761
050,51,177,"Virginia","Spotsylvania County",2,67,1350,646,704
050,51,177,"Virginia","Spotsylvania County",2,68,1281,610,671
050,51,177,"Virginia","Spotsylvania County",2,69,1260,588,672
050,51,177,"Virginia","Spotsylvania County",2,70,1178,550,628
050,51,177,"Virginia","Spotsylvania County",2,71,1178,548,630
050,51,177,"Virginia","Spotsylvania County",2,72,1212,552,660
050,51,177,"Virginia","Spotsylvania County",2,73,1293,582,711
050,51,177,"Virginia","Spotsylvania County",2,74,886,395,491
050,51,177,"Virginia","Spotsylvania County",2,75,819,368,451
050,51,177,"Virginia","Spotsylvania County",2,76,792,358,434
050,51,177,"Virginia","Spotsylvania County",2,77,789,357,432
050,51,177,"Virginia","Spotsylvania County",2,78,664,298,366
050,51,177,"Virginia","Spotsylvania County",2,79,567,250,317
050,51,177,"Virginia","Spotsylvania County",2,80,518,223,295
050,51,177,"Virginia","Spotsylvania County",2,81,449,196,253
050,51,177,"Virginia","Spotsylvania County",2,82,406,176,230
050,51,177,"Virginia","Spotsylvania County",2,83,334,141,193
050,51,177,"Virginia","Spotsylvania County",2,84,324,139,185
050,51,177,"Virginia","Spotsylvania County",2,85,1876,716,1160
050,51,177,"Virginia","Spotsylvania County",3,0,1490,760,730
050,51,177,"Virginia","Spotsylvania County",3,1,1600,816,784
050,51,177,"Virginia","Spotsylvania County",3,2,1662,881,781
050,51,177,"Virginia","Spotsylvania County",3,3,1857,953,904
050,51,177,"Virginia","Spotsylvania County",3,4,1818,943,875
050,51,177,"Virginia","Spotsylvania County",3,5,1899,974,925
050,51,177,"Virginia","Spotsylvania County",3,6,1920,972,948
050,51,177,"Virginia","Spotsylvania County",3,7,1942,976,966
050,51,177,"Virginia","Spotsylvania County",3,8,1934,996,938
050,51,177,"Virginia","Spotsylvania County",3,9,1968,1016,952
050,51,177,"Virginia","Spotsylvania County",3,10,1992,1017,975
050,51,177,"Virginia","Spotsylvania County",3,11,1974,1012,962
050,51,177,"Virginia","Spotsylvania County",3,12,2142,1111,1031
050,51,177,"Virginia","Spotsylvania County",3,13,2285,1152,1133
050,51,177,"Virginia","Spotsylvania County",3,14,2241,1159,1082
050,51,177,"Virginia","Spotsylvania County",3,15,2196,1137,1059
050,51,177,"Virginia","Spotsylvania County",3,16,2193,1116,1077
050,51,177,"Virginia","Spotsylvania County",3,17,2131,1081,1050
050,51,177,"Virginia","Spotsylvania County",3,18,1856,964,892
050,51,177,"Virginia","Spotsylvania County",3,19,1525,799,726
050,51,177,"Virginia","Spotsylvania County",3,20,1662,875,787
050,51,177,"Virginia","Spotsylvania County",3,21,1672,874,798
050,51,177,"Virginia","Spotsylvania County",3,22,1700,881,819
050,51,177,"Virginia","Spotsylvania County",3,23,1751,890,861
050,51,177,"Virginia","Spotsylvania County",3,24,1788,924,864
050,51,177,"Virginia","Spotsylvania County",3,25,1786,917,869
050,51,177,"Virginia","Spotsylvania County",3,26,1802,905,897
050,51,177,"Virginia","Spotsylvania County",3,27,1833,887,946
050,51,177,"Virginia","Spotsylvania County",3,28,1825,953,872
050,51,177,"Virginia","Spotsylvania County",3,29,1846,931,915
050,51,177,"Virginia","Spotsylvania County",3,30,1816,900,916
050,51,177,"Virginia","Spotsylvania County",3,31,1900,937,963
050,51,177,"Virginia","Spotsylvania County",3,32,1953,958,995
050,51,177,"Virginia","Spotsylvania County",3,33,1939,982,957
050,51,177,"Virginia","Spotsylvania County",3,34,1873,946,927
050,51,177,"Virginia","Spotsylvania County",3,35,1864,904,960
050,51,177,"Virginia","Spotsylvania County",3,36,1903,925,978
050,51,177,"Virginia","Spotsylvania County",3,37,1887,913,974
050,51,177,"Virginia","Spotsylvania County",3,38,1992,1022,970
050,51,177,"Virginia","Spotsylvania County",3,39,2003,1032,971
050,51,177,"Virginia","Spotsylvania County",3,40,1987,991,996
050,51,177,"Virginia","Spotsylvania County",3,41,1948,980,968
050,51,177,"Virginia","Spotsylvania County",3,42,1830,912,918
050,51,177,"Virginia","Spotsylvania County",3,43,1850,927,923
050,51,177,"Virginia","Spotsylvania County",3,44,1789,899,890
050,51,177,"Virginia","Spotsylvania County",3,45,1773,867,906
050,51,177,"Virginia","Spotsylvania County",3,46,1784,881,903
050,51,177,"Virginia","Spotsylvania County",3,47,1766,884,882
050,51,177,"Virginia","Spotsylvania County",3,48,1749,853,896
050,51,177,"Virginia","Spotsylvania County",3,49,1880,929,951
050,51,177,"Virginia","Spotsylvania County",3,50,2050,1020,1030
050,51,177,"Virginia","Spotsylvania County",3,51,2033,1021,1012
050,51,177,"Virginia","Spotsylvania County",3,52,1923,959,964
050,51,177,"Virginia","Spotsylvania County",3,53,1905,921,984
050,51,177,"Virginia","Spotsylvania County",3,54,1976,926,1050
050,51,177,"Virginia","Spotsylvania County",3,55,2018,995,1023
050,51,177,"Virginia","Spotsylvania County",3,56,2061,1028,1033
050,51,177,"Virginia","Spotsylvania County",3,57,2036,1008,1028
050,51,177,"Virginia","Spotsylvania County",3,58,2006,994,1012
050,51,177,"Virginia","Spotsylvania County",3,59,1971,990,981
050,51,177,"Virginia","Spotsylvania County",3,60,1906,946,960
050,51,177,"Virginia","Spotsylvania County",3,61,1848,899,949
050,51,177,"Virginia","Spotsylvania County",3,62,1772,858,914
050,51,177,"Virginia","Spotsylvania County",3,63,1714,819,895
050,51,177,"Virginia","Spotsylvania County",3,64,1693,831,862
050,51,177,"Virginia","Spotsylvania County",3,65,1672,823,849
050,51,177,"Virginia","Spotsylvania County",3,66,1590,767,823
050,51,177,"Virginia","Spotsylvania County",3,67,1457,683,774
050,51,177,"Virginia","Spotsylvania County",3,68,1326,620,706
050,51,177,"Virginia","Spotsylvania County",3,69,1293,606,687
050,51,177,"Virginia","Spotsylvania County",3,70,1268,589,679
050,51,177,"Virginia","Spotsylvania County",3,71,1185,546,639
050,51,177,"Virginia","Spotsylvania County",3,72,1188,544,644
050,51,177,"Virginia","Spotsylvania County",3,73,1190,543,647
050,51,177,"Virginia","Spotsylvania County",3,74,1269,554,715
050,51,177,"Virginia","Spotsylvania County",3,75,864,382,482
050,51,177,"Virginia","Spotsylvania County",3,76,799,355,444
050,51,177,"Virginia","Spotsylvania County",3,77,764,355,409
050,51,177,"Virginia","Spotsylvania County",3,78,771,348,423
050,51,177,"Virginia","Spotsylvania County",3,79,628,280,348
050,51,177,"Virginia","Spotsylvania County",3,80,535,230,305
050,51,177,"Virginia","Spotsylvania County",3,81,497,218,279
050,51,177,"Virginia","Spotsylvania County",3,82,432,196,236
050,51,177,"Virginia","Spotsylvania County",3,83,375,156,219
050,51,177,"Virginia","Spotsylvania County",3,84,311,131,180
050,51,177,"Virginia","Spotsylvania County",3,85,1901,732,1169
050,51,177,"Virginia","Spotsylvania County",4,0,1564,810,754
050,51,177,"Virginia","Spotsylvania County",4,1,1560,833,727
050,51,177,"Virginia","Spotsylvania County",4,2,1649,834,815
050,51,177,"Virginia","Spotsylvania County",4,3,1763,956,807
050,51,177,"Virginia","Spotsylvania County",4,4,1920,964,956
050,51,177,"Virginia","Spotsylvania County",4,5,1905,982,923
050,51,177,"Virginia","Spotsylvania County",4,6,1969,1022,947
050,51,177,"Virginia","Spotsylvania County",4,7,1997,1039,958
050,51,177,"Virginia","Spotsylvania County",4,8,2021,1040,981
050,51,177,"Virginia","Spotsylvania County",4,9,1995,1036,959
050,51,177,"Virginia","Spotsylvania County",4,10,2070,1061,1009
050,51,177,"Virginia","Spotsylvania County",4,11,2110,1090,1020
050,51,177,"Virginia","Spotsylvania County",4,12,2039,1041,998
050,51,177,"Virginia","Spotsylvania County",4,13,2208,1131,1077
050,51,177,"Virginia","Spotsylvania County",4,14,2308,1179,1129
050,51,177,"Virginia","Spotsylvania County",4,15,2300,1187,1113
050,51,177,"Virginia","Spotsylvania County",4,16,2210,1126,1084
050,51,177,"Virginia","Spotsylvania County",4,17,2230,1131,1099
050,51,177,"Virginia","Spotsylvania County",4,18,1854,951,903
050,51,177,"Virginia","Spotsylvania County",4,19,1515,782,733
050,51,177,"Virginia","Spotsylvania County",4,20,1597,827,770
050,51,177,"Virginia","Spotsylvania County",4,21,1732,883,849
050,51,177,"Virginia","Spotsylvania County",4,22,1791,923,868
050,51,177,"Virginia","Spotsylvania County",4,23,1767,921,846
050,51,177,"Virginia","Spotsylvania County",4,24,1798,929,869
050,51,177,"Virginia","Spotsylvania County",4,25,1777,880,897
050,51,177,"Virginia","Spotsylvania County",4,26,1822,936,886
050,51,177,"Virginia","Spotsylvania County",4,27,1836,915,921
050,51,177,"Virginia","Spotsylvania County",4,28,1870,906,964
050,51,177,"Virginia","Spotsylvania County",4,29,1860,947,913
050,51,177,"Virginia","Spotsylvania County",4,30,1895,946,949
050,51,177,"Virginia","Spotsylvania County",4,31,1876,940,936
050,51,177,"Virginia","Spotsylvania County",4,32,1969,957,1012
050,51,177,"Virginia","Spotsylvania County",4,33,2021,998,1023
050,51,177,"Virginia","Spotsylvania County",4,34,1977,998,979
050,51,177,"Virginia","Spotsylvania County",4,35,1926,948,978
050,51,177,"Virginia","Spotsylvania County",4,36,1928,934,994
050,51,177,"Virginia","Spotsylvania County",4,37,2001,993,1008
050,51,177,"Virginia","Spotsylvania County",4,38,1928,937,991
050,51,177,"Virginia","Spotsylvania County",4,39,2072,1067,1005
050,51,177,"Virginia","Spotsylvania County",4,40,2042,1058,984
050,51,177,"Virginia","Spotsylvania County",4,41,2027,1007,1020
050,51,177,"Virginia","Spotsylvania County",4,42,2031,1010,1021
050,51,177,"Virginia","Spotsylvania County",4,43,1855,924,931
050,51,177,"Virginia","Spotsylvania County",4,44,1895,957,938
050,51,177,"Virginia","Spotsylvania County",4,45,1828,933,895
050,51,177,"Virginia","Spotsylvania County",4,46,1785,879,906
050,51,177,"Virginia","Spotsylvania County",4,47,1822,918,904
050,51,177,"Virginia","Spotsylvania County",4,48,1808,896,912
050,51,177,"Virginia","Spotsylvania County",4,49,1779,851,928
050,51,177,"Virginia","Spotsylvania County",4,50,1894,943,951
050,51,177,"Virginia","Spotsylvania County",4,51,2041,1011,1030
050,51,177,"Virginia","Spotsylvania County",4,52,2016,997,1019
050,51,177,"Virginia","Spotsylvania County",4,53,1939,953,986
050,51,177,"Virginia","Spotsylvania County",4,54,1901,935,966
050,51,177,"Virginia","Spotsylvania County",4,55,1981,942,1039
050,51,177,"Virginia","Spotsylvania County",4,56,2021,1000,1021
050,51,177,"Virginia","Spotsylvania County",4,57,2068,1034,1034
050,51,177,"Virginia","Spotsylvania County",4,58,2010,1004,1006
050,51,177,"Virginia","Spotsylvania County",4,59,1978,974,1004
050,51,177,"Virginia","Spotsylvania County",4,60,1942,965,977
050,51,177,"Virginia","Spotsylvania County",4,61,1888,925,963
050,51,177,"Virginia","Spotsylvania County",4,62,1803,875,928
050,51,177,"Virginia","Spotsylvania County",4,63,1770,862,908
050,51,177,"Virginia","Spotsylvania County",4,64,1714,821,893
050,51,177,"Virginia","Spotsylvania County",4,65,1707,826,881
050,51,177,"Virginia","Spotsylvania County",4,66,1636,802,834
050,51,177,"Virginia","Spotsylvania County",4,67,1575,763,812
050,51,177,"Virginia","Spotsylvania County",4,68,1446,674,772
050,51,177,"Virginia","Spotsylvania County",4,69,1317,608,709
050,51,177,"Virginia","Spotsylvania County",4,70,1284,595,689
050,51,177,"Virginia","Spotsylvania County",4,71,1238,571,667
050,51,177,"Virginia","Spotsylvania County",4,72,1165,531,634
050,51,177,"Virginia","Spotsylvania County",4,73,1161,530,631
050,51,177,"Virginia","Spotsylvania County",4,74,1164,526,638
050,51,177,"Virginia","Spotsylvania County",4,75,1256,545,711
050,51,177,"Virginia","Spotsylvania County",4,76,868,383,485
050,51,177,"Virginia","Spotsylvania County",4,77,765,338,427
050,51,177,"Virginia","Spotsylvania County",4,78,751,347,404
050,51,177,"Virginia","Spotsylvania County",4,79,737,326,411
050,51,177,"Virginia","Spotsylvania County",4,80,599,258,341
050,51,177,"Virginia","Spotsylvania County",4,81,525,222,303
050,51,177,"Virginia","Spotsylvania County",4,82,478,212,266
050,51,177,"Virginia","Spotsylvania County",4,83,401,183,218
050,51,177,"Virginia","Spotsylvania County",4,84,349,145,204
050,51,177,"Virginia","Spotsylvania County",4,85,1938,759,1179
050,51,177,"Virginia","Spotsylvania County",5,0,1554,804,750
050,51,177,"Virginia","Spotsylvania County",5,1,1651,881,770
050,51,177,"Virginia","Spotsylvania County",5,2,1598,824,774
050,51,177,"Virginia","Spotsylvania County",5,3,1741,896,845
050,51,177,"Virginia","Spotsylvania County",5,4,1821,985,836
050,51,177,"Virginia","Spotsylvania County",5,5,2018,1003,1015
050,51,177,"Virginia","Spotsylvania County",5,6,2029,1072,957
050,51,177,"Virginia","Spotsylvania County",5,7,2058,1080,978
050,51,177,"Virginia","Spotsylvania County",5,8,2082,1056,1026
050,51,177,"Virginia","Spotsylvania County",5,9,2069,1065,1004
050,51,177,"Virginia","Spotsylvania County",5,10,2075,1102,973
050,51,177,"Virginia","Spotsylvania County",5,11,2139,1099,1040
050,51,177,"Virginia","Spotsylvania County",5,12,2176,1143,1033
050,51,177,"Virginia","Spotsylvania County",5,13,2071,1086,985
050,51,177,"Virginia","Spotsylvania County",5,14,2230,1152,1078
050,51,177,"Virginia","Spotsylvania County",5,15,2369,1202,1167
050,51,177,"Virginia","Spotsylvania County",5,16,2355,1216,1139
050,51,177,"Virginia","Spotsylvania County",5,17,2237,1128,1109
050,51,177,"Virginia","Spotsylvania County",5,18,1944,1013,931
050,51,177,"Virginia","Spotsylvania County",5,19,1551,793,758
050,51,177,"Virginia","Spotsylvania County",5,20,1688,854,834
050,51,177,"Virginia","Spotsylvania County",5,21,1707,882,825
050,51,177,"Virginia","Spotsylvania County",5,22,1825,913,912
050,51,177,"Virginia","Spotsylvania County",5,23,1866,950,916
050,51,177,"Virginia","Spotsylvania County",5,24,1784,941,843
050,51,177,"Virginia","Spotsylvania County",5,25,1808,925,883
050,51,177,"Virginia","Spotsylvania County",5,26,1789,872,917
050,51,177,"Virginia","Spotsylvania County",5,27,1845,939,906
050,51,177,"Virginia","Spotsylvania County",5,28,1847,922,925
050,51,177,"Virginia","Spotsylvania County",5,29,1911,918,993
050,51,177,"Virginia","Spotsylvania County",5,30,1882,964,918
050,51,177,"Virginia","Spotsylvania County",5,31,1896,934,962
050,51,177,"Virginia","Spotsylvania County",5,32,1927,963,964
050,51,177,"Virginia","Spotsylvania County",5,33,2027,1006,1021
050,51,177,"Virginia","Spotsylvania County",5,34,2082,1040,1042
050,51,177,"Virginia","Spotsylvania County",5,35,2072,1059,1013
050,51,177,"Virginia","Spotsylvania County",5,36,1967,962,1005
050,51,177,"Virginia","Spotsylvania County",5,37,2003,958,1045
050,51,177,"Virginia","Spotsylvania County",5,38,2017,999,1018
050,51,177,"Virginia","Spotsylvania County",5,39,1957,962,995
050,51,177,"Virginia","Spotsylvania County",5,40,2107,1060,1047
050,51,177,"Virginia","Spotsylvania County",5,41,2093,1085,1008
050,51,177,"Virginia","Spotsylvania County",5,42,2101,1045,1056
050,51,177,"Virginia","Spotsylvania County",5,43,2054,1034,1020
050,51,177,"Virginia","Spotsylvania County",5,44,1917,956,961
050,51,177,"Virginia","Spotsylvania County",5,45,1937,970,967
050,51,177,"Virginia","Spotsylvania County",5,46,1837,940,897
050,51,177,"Virginia","Spotsylvania County",5,47,1808,901,907
050,51,177,"Virginia","Spotsylvania County",5,48,1835,919,916
050,51,177,"Virginia","Spotsylvania County",5,49,1810,896,914
050,51,177,"Virginia","Spotsylvania County",5,50,1785,867,918
050,51,177,"Virginia","Spotsylvania County",5,51,1929,965,964
050,51,177,"Virginia","Spotsylvania County",5,52,2019,1003,1016
050,51,177,"Virginia","Spotsylvania County",5,53,2044,1011,1033
050,51,177,"Virginia","Spotsylvania County",5,54,1939,951,988
050,51,177,"Virginia","Spotsylvania County",5,55,1934,953,981
050,51,177,"Virginia","Spotsylvania County",5,56,1973,933,1040
050,51,177,"Virginia","Spotsylvania County",5,57,2002,1000,1002
050,51,177,"Virginia","Spotsylvania County",5,58,2052,1031,1021
050,51,177,"Virginia","Spotsylvania County",5,59,2007,1001,1006
050,51,177,"Virginia","Spotsylvania County",5,60,1990,970,1020
050,51,177,"Virginia","Spotsylvania County",5,61,1912,948,964
050,51,177,"Virginia","Spotsylvania County",5,62,1832,897,935
050,51,177,"Virginia","Spotsylvania County",5,63,1794,858,936
050,51,177,"Virginia","Spotsylvania County",5,64,1755,857,898
050,51,177,"Virginia","Spotsylvania County",5,65,1717,813,904
050,51,177,"Virginia","Spotsylvania County",5,66,1689,804,885
050,51,177,"Virginia","Spotsylvania County",5,67,1620,783,837
050,51,177,"Virginia","Spotsylvania County",5,68,1549,742,807
050,51,177,"Virginia","Spotsylvania County",5,69,1442,667,775
050,51,177,"Virginia","Spotsylvania County",5,70,1325,616,709
050,51,177,"Virginia","Spotsylvania County",5,71,1270,598,672
050,51,177,"Virginia","Spotsylvania County",5,72,1246,562,684
050,51,177,"Virginia","Spotsylvania County",5,73,1146,521,625
050,51,177,"Virginia","Spotsylvania County",5,74,1142,525,617
050,51,177,"Virginia","Spotsylvania County",5,75,1146,514,632
050,51,177,"Virginia","Spotsylvania County",5,76,1230,535,695
050,51,177,"Virginia","Spotsylvania County",5,77,843,372,471
050,51,177,"Virginia","Spotsylvania County",5,78,744,324,420
050,51,177,"Virginia","Spotsylvania County",5,79,729,333,396
050,51,177,"Virginia","Spotsylvania County",5,80,704,303,401
050,51,177,"Virginia","Spotsylvania County",5,81,583,249,334
050,51,177,"Virginia","Spotsylvania County",5,82,504,212,292
050,51,177,"Virginia","Spotsylvania County",5,83,446,201,245
050,51,177,"Virginia","Spotsylvania County",5,84,370,168,202
050,51,177,"Virginia","Spotsylvania County",5,85,2009,795,1214
050,51,179,"Virginia","Stafford County",1,0,1738,891,847
050,51,179,"Virginia","Stafford County",1,1,1821,937,884
050,51,179,"Virginia","Stafford County",1,2,2025,1047,978
050,51,179,"Virginia","Stafford County",1,3,2029,1041,988
050,51,179,"Virginia","Stafford County",1,4,2161,1141,1020
050,51,179,"Virginia","Stafford County",1,5,2195,1132,1063
050,51,179,"Virginia","Stafford County",1,6,2199,1155,1044
050,51,179,"Virginia","Stafford County",1,7,2268,1116,1152
050,51,179,"Virginia","Stafford County",1,8,2319,1139,1180
050,51,179,"Virginia","Stafford County",1,9,2338,1184,1154
050,51,179,"Virginia","Stafford County",1,10,2392,1241,1151
050,51,179,"Virginia","Stafford County",1,11,2484,1309,1175
050,51,179,"Virginia","Stafford County",1,12,2610,1343,1267
050,51,179,"Virginia","Stafford County",1,13,2570,1323,1247
050,51,179,"Virginia","Stafford County",1,14,2534,1298,1236
050,51,179,"Virginia","Stafford County",1,15,2577,1330,1247
050,51,179,"Virginia","Stafford County",1,16,2542,1275,1267
050,51,179,"Virginia","Stafford County",1,17,2579,1296,1283
050,51,179,"Virginia","Stafford County",1,18,2211,1131,1080
050,51,179,"Virginia","Stafford County",1,19,1936,994,942
050,51,179,"Virginia","Stafford County",1,20,1955,1029,926
050,51,179,"Virginia","Stafford County",1,21,1931,1012,919
050,51,179,"Virginia","Stafford County",1,22,2128,1125,1003
050,51,179,"Virginia","Stafford County",1,23,2337,1298,1039
050,51,179,"Virginia","Stafford County",1,24,2122,1177,945
050,51,179,"Virginia","Stafford County",1,25,2036,1120,916
050,51,179,"Virginia","Stafford County",1,26,1837,982,855
050,51,179,"Virginia","Stafford County",1,27,1890,987,903
050,51,179,"Virginia","Stafford County",1,28,1916,977,939
050,51,179,"Virginia","Stafford County",1,29,1996,1017,979
050,51,179,"Virginia","Stafford County",1,30,2018,1040,978
050,51,179,"Virginia","Stafford County",1,31,1960,995,965
050,51,179,"Virginia","Stafford County",1,32,1999,1045,954
050,51,179,"Virginia","Stafford County",1,33,2167,1116,1051
050,51,179,"Virginia","Stafford County",1,34,2326,1181,1145
050,51,179,"Virginia","Stafford County",1,35,2331,1156,1175
050,51,179,"Virginia","Stafford County",1,36,2349,1191,1158
050,51,179,"Virginia","Stafford County",1,37,2308,1141,1167
050,51,179,"Virginia","Stafford County",1,38,2273,1103,1170
050,51,179,"Virginia","Stafford County",1,39,2316,1158,1158
050,51,179,"Virginia","Stafford County",1,40,2299,1152,1147
050,51,179,"Virginia","Stafford County",1,41,2246,1130,1116
050,51,179,"Virginia","Stafford County",1,42,2206,1127,1079
050,51,179,"Virginia","Stafford County",1,43,2178,1096,1082
050,51,179,"Virginia","Stafford County",1,44,2208,1101,1107
050,51,179,"Virginia","Stafford County",1,45,2109,1100,1009
050,51,179,"Virginia","Stafford County",1,46,2091,1086,1005
050,51,179,"Virginia","Stafford County",1,47,2193,1103,1090
050,51,179,"Virginia","Stafford County",1,48,2246,1132,1114
050,51,179,"Virginia","Stafford County",1,49,2325,1189,1136
050,51,179,"Virginia","Stafford County",1,50,2281,1162,1119
050,51,179,"Virginia","Stafford County",1,51,2222,1092,1130
050,51,179,"Virginia","Stafford County",1,52,2170,1073,1097
050,51,179,"Virginia","Stafford County",1,53,2182,1069,1113
050,51,179,"Virginia","Stafford County",1,54,2281,1158,1123
050,51,179,"Virginia","Stafford County",1,55,2346,1187,1159
050,51,179,"Virginia","Stafford County",1,56,2314,1169,1145
050,51,179,"Virginia","Stafford County",1,57,2189,1078,1111
050,51,179,"Virginia","Stafford County",1,58,2097,1040,1057
050,51,179,"Virginia","Stafford County",1,59,1989,998,991
050,51,179,"Virginia","Stafford County",1,60,1910,951,959
050,51,179,"Virginia","Stafford County",1,61,1743,860,883
050,51,179,"Virginia","Stafford County",1,62,1632,841,791
050,51,179,"Virginia","Stafford County",1,63,1545,795,750
050,51,179,"Virginia","Stafford County",1,64,1383,711,672
050,51,179,"Virginia","Stafford County",1,65,1330,681,649
050,51,179,"Virginia","Stafford County",1,66,1283,631,652
050,51,179,"Virginia","Stafford County",1,67,1199,567,632
050,51,179,"Virginia","Stafford County",1,68,1138,534,604
050,51,179,"Virginia","Stafford County",1,69,1023,473,550
050,51,179,"Virginia","Stafford County",1,70,996,458,538
050,51,179,"Virginia","Stafford County",1,71,999,470,529
050,51,179,"Virginia","Stafford County",1,72,1013,466,547
050,51,179,"Virginia","Stafford County",1,73,999,492,507
050,51,179,"Virginia","Stafford County",1,74,685,330,355
050,51,179,"Virginia","Stafford County",1,75,716,329,387
050,51,179,"Virginia","Stafford County",1,76,682,292,390
050,51,179,"Virginia","Stafford County",1,77,647,297,350
050,51,179,"Virginia","Stafford County",1,78,547,221,326
050,51,179,"Virginia","Stafford County",1,79,495,218,277
050,51,179,"Virginia","Stafford County",1,80,432,187,245
050,51,179,"Virginia","Stafford County",1,81,391,166,225
050,51,179,"Virginia","Stafford County",1,82,333,135,198
050,51,179,"Virginia","Stafford County",1,83,296,123,173
050,51,179,"Virginia","Stafford County",1,84,241,107,134
050,51,179,"Virginia","Stafford County",1,85,1386,517,869
050,51,179,"Virginia","Stafford County",2,0,1760,917,843
050,51,179,"Virginia","Stafford County",2,1,1829,936,893
050,51,179,"Virginia","Stafford County",2,2,2005,1036,969
050,51,179,"Virginia","Stafford County",2,3,2046,1058,988
050,51,179,"Virginia","Stafford County",2,4,2153,1129,1024
050,51,179,"Virginia","Stafford County",2,5,2206,1144,1062
050,51,179,"Virginia","Stafford County",2,6,2222,1158,1064
050,51,179,"Virginia","Stafford County",2,7,2273,1137,1136
050,51,179,"Virginia","Stafford County",2,8,2321,1141,1180
050,51,179,"Virginia","Stafford County",2,9,2356,1188,1168
050,51,179,"Virginia","Stafford County",2,10,2398,1244,1154
050,51,179,"Virginia","Stafford County",2,11,2472,1300,1172
050,51,179,"Virginia","Stafford County",2,12,2610,1350,1260
050,51,179,"Virginia","Stafford County",2,13,2606,1341,1265
050,51,179,"Virginia","Stafford County",2,14,2575,1317,1258
050,51,179,"Virginia","Stafford County",2,15,2588,1333,1255
050,51,179,"Virginia","Stafford County",2,16,2574,1300,1274
050,51,179,"Virginia","Stafford County",2,17,2574,1290,1284
050,51,179,"Virginia","Stafford County",2,18,2225,1140,1085
050,51,179,"Virginia","Stafford County",2,19,1940,995,945
050,51,179,"Virginia","Stafford County",2,20,1983,1038,945
050,51,179,"Virginia","Stafford County",2,21,1940,1014,926
050,51,179,"Virginia","Stafford County",2,22,2123,1128,995
050,51,179,"Virginia","Stafford County",2,23,2324,1294,1030
050,51,179,"Virginia","Stafford County",2,24,2131,1176,955
050,51,179,"Virginia","Stafford County",2,25,2035,1122,913
050,51,179,"Virginia","Stafford County",2,26,1870,1000,870
050,51,179,"Virginia","Stafford County",2,27,1889,991,898
050,51,179,"Virginia","Stafford County",2,28,1933,987,946
050,51,179,"Virginia","Stafford County",2,29,2008,1023,985
050,51,179,"Virginia","Stafford County",2,30,2032,1041,991
050,51,179,"Virginia","Stafford County",2,31,1978,1011,967
050,51,179,"Virginia","Stafford County",2,32,2010,1043,967
050,51,179,"Virginia","Stafford County",2,33,2164,1120,1044
050,51,179,"Virginia","Stafford County",2,34,2306,1171,1135
050,51,179,"Virginia","Stafford County",2,35,2368,1184,1184
050,51,179,"Virginia","Stafford County",2,36,2349,1184,1165
050,51,179,"Virginia","Stafford County",2,37,2345,1169,1176
050,51,179,"Virginia","Stafford County",2,38,2306,1124,1182
050,51,179,"Virginia","Stafford County",2,39,2315,1149,1166
050,51,179,"Virginia","Stafford County",2,40,2335,1174,1161
050,51,179,"Virginia","Stafford County",2,41,2266,1141,1125
050,51,179,"Virginia","Stafford County",2,42,2206,1126,1080
050,51,179,"Virginia","Stafford County",2,43,2207,1115,1092
050,51,179,"Virginia","Stafford County",2,44,2195,1099,1096
050,51,179,"Virginia","Stafford County",2,45,2148,1105,1043
050,51,179,"Virginia","Stafford County",2,46,2103,1095,1008
050,51,179,"Virginia","Stafford County",2,47,2165,1096,1069
050,51,179,"Virginia","Stafford County",2,48,2241,1129,1112
050,51,179,"Virginia","Stafford County",2,49,2310,1181,1129
050,51,179,"Virginia","Stafford County",2,50,2300,1174,1126
050,51,179,"Virginia","Stafford County",2,51,2228,1110,1118
050,51,179,"Virginia","Stafford County",2,52,2177,1077,1100
050,51,179,"Virginia","Stafford County",2,53,2173,1070,1103
050,51,179,"Virginia","Stafford County",2,54,2241,1130,1111
050,51,179,"Virginia","Stafford County",2,55,2322,1174,1148
050,51,179,"Virginia","Stafford County",2,56,2319,1167,1152
050,51,179,"Virginia","Stafford County",2,57,2218,1095,1123
050,51,179,"Virginia","Stafford County",2,58,2109,1042,1067
050,51,179,"Virginia","Stafford County",2,59,2005,1002,1003
050,51,179,"Virginia","Stafford County",2,60,1919,955,964
050,51,179,"Virginia","Stafford County",2,61,1766,875,891
050,51,179,"Virginia","Stafford County",2,62,1649,841,808
050,51,179,"Virginia","Stafford County",2,63,1564,807,757
050,51,179,"Virginia","Stafford County",2,64,1410,724,686
050,51,179,"Virginia","Stafford County",2,65,1336,683,653
050,51,179,"Virginia","Stafford County",2,66,1295,640,655
050,51,179,"Virginia","Stafford County",2,67,1211,576,635
050,51,179,"Virginia","Stafford County",2,68,1134,528,606
050,51,179,"Virginia","Stafford County",2,69,1050,486,564
050,51,179,"Virginia","Stafford County",2,70,1002,461,541
050,51,179,"Virginia","Stafford County",2,71,1002,470,532
050,51,179,"Virginia","Stafford County",2,72,991,457,534
050,51,179,"Virginia","Stafford County",2,73,1047,508,539
050,51,179,"Virginia","Stafford County",2,74,718,346,372
050,51,179,"Virginia","Stafford County",2,75,705,328,377
050,51,179,"Virginia","Stafford County",2,76,681,298,383
050,51,179,"Virginia","Stafford County",2,77,668,301,367
050,51,179,"Virginia","Stafford County",2,78,562,235,327
050,51,179,"Virginia","Stafford County",2,79,503,214,289
050,51,179,"Virginia","Stafford County",2,80,441,194,247
050,51,179,"Virginia","Stafford County",2,81,398,169,229
050,51,179,"Virginia","Stafford County",2,82,349,143,206
050,51,179,"Virginia","Stafford County",2,83,302,125,177
050,51,179,"Virginia","Stafford County",2,84,250,107,143
050,51,179,"Virginia","Stafford County",2,85,1402,526,876
050,51,179,"Virginia","Stafford County",3,0,1704,878,826
050,51,179,"Virginia","Stafford County",3,1,1919,997,922
050,51,179,"Virginia","Stafford County",3,2,1990,1009,981
050,51,179,"Virginia","Stafford County",3,3,2086,1090,996
050,51,179,"Virginia","Stafford County",3,4,2174,1133,1041
050,51,179,"Virginia","Stafford County",3,5,2274,1178,1096
050,51,179,"Virginia","Stafford County",3,6,2336,1214,1122
050,51,179,"Virginia","Stafford County",3,7,2290,1197,1093
050,51,179,"Virginia","Stafford County",3,8,2359,1182,1177
050,51,179,"Virginia","Stafford County",3,9,2355,1188,1167
050,51,179,"Virginia","Stafford County",3,10,2469,1245,1224
050,51,179,"Virginia","Stafford County",3,11,2464,1277,1187
050,51,179,"Virginia","Stafford County",3,12,2548,1361,1187
050,51,179,"Virginia","Stafford County",3,13,2719,1420,1299
050,51,179,"Virginia","Stafford County",3,14,2735,1400,1335
050,51,179,"Virginia","Stafford County",3,15,2644,1355,1289
050,51,179,"Virginia","Stafford County",3,16,2684,1365,1319
050,51,179,"Virginia","Stafford County",3,17,2620,1323,1297
050,51,179,"Virginia","Stafford County",3,18,2304,1179,1125
050,51,179,"Virginia","Stafford County",3,19,1971,1027,944
050,51,179,"Virginia","Stafford County",3,20,2027,1070,957
050,51,179,"Virginia","Stafford County",3,21,2050,1068,982
050,51,179,"Virginia","Stafford County",3,22,2119,1148,971
050,51,179,"Virginia","Stafford County",3,23,2368,1346,1022
050,51,179,"Virginia","Stafford County",3,24,2166,1159,1007
050,51,179,"Virginia","Stafford County",3,25,2051,1143,908
050,51,179,"Virginia","Stafford County",3,26,2023,1080,943
050,51,179,"Virginia","Stafford County",3,27,2004,1092,912
050,51,179,"Virginia","Stafford County",3,28,1917,991,926
050,51,179,"Virginia","Stafford County",3,29,1999,1022,977
050,51,179,"Virginia","Stafford County",3,30,2021,1024,997
050,51,179,"Virginia","Stafford County",3,31,2094,1055,1039
050,51,179,"Virginia","Stafford County",3,32,2029,1021,1008
050,51,179,"Virginia","Stafford County",3,33,2132,1106,1026
050,51,179,"Virginia","Stafford County",3,34,2281,1149,1132
050,51,179,"Virginia","Stafford County",3,35,2444,1221,1223
050,51,179,"Virginia","Stafford County",3,36,2484,1229,1255
050,51,179,"Virginia","Stafford County",3,37,2454,1241,1213
050,51,179,"Virginia","Stafford County",3,38,2452,1220,1232
050,51,179,"Virginia","Stafford County",3,39,2407,1184,1223
050,51,179,"Virginia","Stafford County",3,40,2461,1216,1245
050,51,179,"Virginia","Stafford County",3,41,2438,1218,1220
050,51,179,"Virginia","Stafford County",3,42,2337,1171,1166
050,51,179,"Virginia","Stafford County",3,43,2306,1171,1135
050,51,179,"Virginia","Stafford County",3,44,2238,1132,1106
050,51,179,"Virginia","Stafford County",3,45,2215,1116,1099
050,51,179,"Virginia","Stafford County",3,46,2203,1156,1047
050,51,179,"Virginia","Stafford County",3,47,2095,1074,1021
050,51,179,"Virginia","Stafford County",3,48,2235,1135,1100
050,51,179,"Virginia","Stafford County",3,49,2260,1153,1107
050,51,179,"Virginia","Stafford County",3,50,2307,1173,1134
050,51,179,"Virginia","Stafford County",3,51,2303,1179,1124
050,51,179,"Virginia","Stafford County",3,52,2244,1114,1130
050,51,179,"Virginia","Stafford County",3,53,2107,1039,1068
050,51,179,"Virginia","Stafford County",3,54,2147,1064,1083
050,51,179,"Virginia","Stafford County",3,55,2213,1123,1090
050,51,179,"Virginia","Stafford County",3,56,2283,1136,1147
050,51,179,"Virginia","Stafford County",3,57,2300,1163,1137
050,51,179,"Virginia","Stafford County",3,58,2187,1084,1103
050,51,179,"Virginia","Stafford County",3,59,2050,1024,1026
050,51,179,"Virginia","Stafford County",3,60,1957,960,997
050,51,179,"Virginia","Stafford County",3,61,1870,933,937
050,51,179,"Virginia","Stafford County",3,62,1697,827,870
050,51,179,"Virginia","Stafford County",3,63,1568,795,773
050,51,179,"Virginia","Stafford County",3,64,1513,780,733
050,51,179,"Virginia","Stafford County",3,65,1385,700,685
050,51,179,"Virginia","Stafford County",3,66,1317,660,657
050,51,179,"Virginia","Stafford County",3,67,1285,634,651
050,51,179,"Virginia","Stafford County",3,68,1196,571,625
050,51,179,"Virginia","Stafford County",3,69,1106,512,594
050,51,179,"Virginia","Stafford County",3,70,1033,470,563
050,51,179,"Virginia","Stafford County",3,71,1006,468,538
050,51,179,"Virginia","Stafford County",3,72,988,454,534
050,51,179,"Virginia","Stafford County",3,73,981,450,531
050,51,179,"Virginia","Stafford County",3,74,1021,490,531
050,51,179,"Virginia","Stafford County",3,75,719,339,380
050,51,179,"Virginia","Stafford County",3,76,692,320,372
050,51,179,"Virginia","Stafford County",3,77,657,288,369
050,51,179,"Virginia","Stafford County",3,78,642,290,352
050,51,179,"Virginia","Stafford County",3,79,533,210,323
050,51,179,"Virginia","Stafford County",3,80,471,206,265
050,51,179,"Virginia","Stafford County",3,81,420,177,243
050,51,179,"Virginia","Stafford County",3,82,379,164,215
050,51,179,"Virginia","Stafford County",3,83,337,134,203
050,51,179,"Virginia","Stafford County",3,84,282,109,173
050,51,179,"Virginia","Stafford County",3,85,1417,541,876
050,51,179,"Virginia","Stafford County",4,0,1754,888,866
050,51,179,"Virginia","Stafford County",4,1,1804,888,916
050,51,179,"Virginia","Stafford County",4,2,1985,1026,959
050,51,179,"Virginia","Stafford County",4,3,2091,1074,1017
050,51,179,"Virginia","Stafford County",4,4,2184,1142,1042
050,51,179,"Virginia","Stafford County",4,5,2223,1166,1057
050,51,179,"Virginia","Stafford County",4,6,2378,1246,1132
050,51,179,"Virginia","Stafford County",4,7,2455,1273,1182
050,51,179,"Virginia","Stafford County",4,8,2371,1193,1178
050,51,179,"Virginia","Stafford County",4,9,2455,1220,1235
050,51,179,"Virginia","Stafford County",4,10,2425,1223,1202
050,51,179,"Virginia","Stafford County",4,11,2562,1304,1258
050,51,179,"Virginia","Stafford County",4,12,2489,1294,1195
050,51,179,"Virginia","Stafford County",4,13,2627,1373,1254
050,51,179,"Virginia","Stafford County",4,14,2753,1436,1317
050,51,179,"Virginia","Stafford County",4,15,2768,1428,1340
050,51,179,"Virginia","Stafford County",4,16,2663,1340,1323
050,51,179,"Virginia","Stafford County",4,17,2657,1343,1314
050,51,179,"Virginia","Stafford County",4,18,2300,1204,1096
050,51,179,"Virginia","Stafford County",4,19,1967,1007,960
050,51,179,"Virginia","Stafford County",4,20,2006,1075,931
050,51,179,"Virginia","Stafford County",4,21,2026,1060,966
050,51,179,"Virginia","Stafford County",4,22,2135,1145,990
050,51,179,"Virginia","Stafford County",4,23,2258,1300,958
050,51,179,"Virginia","Stafford County",4,24,2022,1104,918
050,51,179,"Virginia","Stafford County",4,25,2005,1070,935
050,51,179,"Virginia","Stafford County",4,26,1898,1009,889
050,51,179,"Virginia","Stafford County",4,27,2010,1070,940
050,51,179,"Virginia","Stafford County",4,28,1934,1039,895
050,51,179,"Virginia","Stafford County",4,29,1958,1022,936
050,51,179,"Virginia","Stafford County",4,30,2028,1012,1016
050,51,179,"Virginia","Stafford County",4,31,2067,1067,1000
050,51,179,"Virginia","Stafford County",4,32,2136,1049,1087
050,51,179,"Virginia","Stafford County",4,33,2175,1113,1062
050,51,179,"Virginia","Stafford County",4,34,2261,1143,1118
050,51,179,"Virginia","Stafford County",4,35,2343,1157,1186
050,51,179,"Virginia","Stafford County",4,36,2517,1238,1279
050,51,179,"Virginia","Stafford County",4,37,2583,1281,1302
050,51,179,"Virginia","Stafford County",4,38,2518,1257,1261
050,51,179,"Virginia","Stafford County",4,39,2483,1251,1232
050,51,179,"Virginia","Stafford County",4,40,2475,1243,1232
050,51,179,"Virginia","Stafford County",4,41,2562,1303,1259
050,51,179,"Virginia","Stafford County",4,42,2451,1240,1211
050,51,179,"Virginia","Stafford County",4,43,2389,1188,1201
050,51,179,"Virginia","Stafford County",4,44,2316,1168,1148
050,51,179,"Virginia","Stafford County",4,45,2291,1151,1140
050,51,179,"Virginia","Stafford County",4,46,2295,1170,1125
050,51,179,"Virginia","Stafford County",4,47,2217,1159,1058
050,51,179,"Virginia","Stafford County",4,48,2162,1140,1022
050,51,179,"Virginia","Stafford County",4,49,2220,1158,1062
050,51,179,"Virginia","Stafford County",4,50,2237,1137,1100
050,51,179,"Virginia","Stafford County",4,51,2287,1171,1116
050,51,179,"Virginia","Stafford County",4,52,2278,1172,1106
050,51,179,"Virginia","Stafford County",4,53,2214,1095,1119
050,51,179,"Virginia","Stafford County",4,54,2097,1038,1059
050,51,179,"Virginia","Stafford County",4,55,2105,1040,1065
050,51,179,"Virginia","Stafford County",4,56,2186,1110,1076
050,51,179,"Virginia","Stafford County",4,57,2232,1106,1126
050,51,179,"Virginia","Stafford County",4,58,2219,1116,1103
050,51,179,"Virginia","Stafford County",4,59,2137,1069,1068
050,51,179,"Virginia","Stafford County",4,60,1984,984,1000
050,51,179,"Virginia","Stafford County",4,61,1888,946,942
050,51,179,"Virginia","Stafford County",4,62,1790,902,888
050,51,179,"Virginia","Stafford County",4,63,1678,805,873
050,51,179,"Virginia","Stafford County",4,64,1533,770,763
050,51,179,"Virginia","Stafford County",4,65,1488,743,745
050,51,179,"Virginia","Stafford County",4,66,1343,659,684
050,51,179,"Virginia","Stafford County",4,67,1305,652,653
050,51,179,"Virginia","Stafford County",4,68,1268,615,653
050,51,179,"Virginia","Stafford County",4,69,1168,552,616
050,51,179,"Virginia","Stafford County",4,70,1072,486,586
050,51,179,"Virginia","Stafford County",4,71,1049,475,574
050,51,179,"Virginia","Stafford County",4,72,990,446,544
050,51,179,"Virginia","Stafford County",4,73,959,439,520
050,51,179,"Virginia","Stafford County",4,74,939,429,510
050,51,179,"Virginia","Stafford County",4,75,996,472,524
050,51,179,"Virginia","Stafford County",4,76,692,329,363
050,51,179,"Virginia","Stafford County",4,77,652,304,348
050,51,179,"Virginia","Stafford County",4,78,651,287,364
050,51,179,"Virginia","Stafford County",4,79,625,277,348
050,51,179,"Virginia","Stafford County",4,80,500,199,301
050,51,179,"Virginia","Stafford County",4,81,451,195,256
050,51,179,"Virginia","Stafford County",4,82,398,171,227
050,51,179,"Virginia","Stafford County",4,83,349,142,207
050,51,179,"Virginia","Stafford County",4,84,312,122,190
050,51,179,"Virginia","Stafford County",4,85,1445,562,883
050,51,179,"Virginia","Stafford County",5,0,1742,880,862
050,51,179,"Virginia","Stafford County",5,1,1903,940,963
050,51,179,"Virginia","Stafford County",5,2,1912,964,948
050,51,179,"Virginia","Stafford County",5,3,2104,1095,1009
050,51,179,"Virginia","Stafford County",5,4,2150,1126,1024
050,51,179,"Virginia","Stafford County",5,5,2291,1197,1094
050,51,179,"Virginia","Stafford County",5,6,2313,1191,1122
050,51,179,"Virginia","Stafford County",5,7,2518,1312,1206
050,51,179,"Virginia","Stafford County",5,8,2512,1309,1203
050,51,179,"Virginia","Stafford County",5,9,2487,1247,1240
050,51,179,"Virginia","Stafford County",5,10,2515,1261,1254
050,51,179,"Virginia","Stafford County",5,11,2505,1254,1251
050,51,179,"Virginia","Stafford County",5,12,2612,1333,1279
050,51,179,"Virginia","Stafford County",5,13,2546,1323,1223
050,51,179,"Virginia","Stafford County",5,14,2703,1423,1280
050,51,179,"Virginia","Stafford County",5,15,2761,1438,1323
050,51,179,"Virginia","Stafford County",5,16,2785,1426,1359
050,51,179,"Virginia","Stafford County",5,17,2667,1358,1309
050,51,179,"Virginia","Stafford County",5,18,2391,1240,1151
050,51,179,"Virginia","Stafford County",5,19,1940,1021,919
050,51,179,"Virginia","Stafford County",5,20,2040,1083,957
050,51,179,"Virginia","Stafford County",5,21,2100,1112,988
050,51,179,"Virginia","Stafford County",5,22,2187,1170,1017
050,51,179,"Virginia","Stafford County",5,23,2347,1353,994
050,51,179,"Virginia","Stafford County",5,24,2086,1176,910
050,51,179,"Virginia","Stafford County",5,25,2048,1108,940
050,51,179,"Virginia","Stafford County",5,26,1942,1004,938
050,51,179,"Virginia","Stafford County",5,27,1923,986,937
050,51,179,"Virginia","Stafford County",5,28,1961,1035,926
050,51,179,"Virginia","Stafford County",5,29,1979,1053,926
050,51,179,"Virginia","Stafford County",5,30,1996,1025,971
050,51,179,"Virginia","Stafford County",5,31,2086,1048,1038
050,51,179,"Virginia","Stafford County",5,32,2131,1095,1036
050,51,179,"Virginia","Stafford County",5,33,2216,1070,1146
050,51,179,"Virginia","Stafford County",5,34,2269,1156,1113
050,51,179,"Virginia","Stafford County",5,35,2311,1165,1146
050,51,179,"Virginia","Stafford County",5,36,2462,1214,1248
050,51,179,"Virginia","Stafford County",5,37,2584,1254,1330
050,51,179,"Virginia","Stafford County",5,38,2601,1288,1313
050,51,179,"Virginia","Stafford County",5,39,2628,1318,1310
050,51,179,"Virginia","Stafford County",5,40,2516,1306,1210
050,51,179,"Virginia","Stafford County",5,41,2547,1284,1263
050,51,179,"Virginia","Stafford County",5,42,2602,1333,1269
050,51,179,"Virginia","Stafford County",5,43,2500,1269,1231
050,51,179,"Virginia","Stafford County",5,44,2458,1250,1208
050,51,179,"Virginia","Stafford County",5,45,2354,1190,1164
050,51,179,"Virginia","Stafford County",5,46,2305,1163,1142
050,51,179,"Virginia","Stafford County",5,47,2263,1147,1116
050,51,179,"Virginia","Stafford County",5,48,2203,1175,1028
050,51,179,"Virginia","Stafford County",5,49,2182,1156,1026
050,51,179,"Virginia","Stafford County",5,50,2191,1128,1063
050,51,179,"Virginia","Stafford County",5,51,2192,1112,1080
050,51,179,"Virginia","Stafford County",5,52,2252,1143,1109
050,51,179,"Virginia","Stafford County",5,53,2252,1165,1087
050,51,179,"Virginia","Stafford County",5,54,2189,1085,1104
050,51,179,"Virginia","Stafford County",5,55,2047,1000,1047
050,51,179,"Virginia","Stafford County",5,56,2053,1018,1035
050,51,179,"Virginia","Stafford County",5,57,2096,1066,1030
050,51,179,"Virginia","Stafford County",5,58,2161,1074,1087
050,51,179,"Virginia","Stafford County",5,59,2130,1063,1067
050,51,179,"Virginia","Stafford County",5,60,2097,1042,1055
050,51,179,"Virginia","Stafford County",5,61,1947,971,976
050,51,179,"Virginia","Stafford County",5,62,1804,901,903
050,51,179,"Virginia","Stafford County",5,63,1711,849,862
050,51,179,"Virginia","Stafford County",5,64,1631,778,853
050,51,179,"Virginia","Stafford County",5,65,1507,751,756
050,51,179,"Virginia","Stafford County",5,66,1474,724,750
050,51,179,"Virginia","Stafford County",5,67,1307,639,668
050,51,179,"Virginia","Stafford County",5,68,1286,636,650
050,51,179,"Virginia","Stafford County",5,69,1229,591,638
050,51,179,"Virginia","Stafford County",5,70,1152,536,616
050,51,179,"Virginia","Stafford County",5,71,1066,483,583
050,51,179,"Virginia","Stafford County",5,72,1012,447,565
050,51,179,"Virginia","Stafford County",5,73,970,441,529
050,51,179,"Virginia","Stafford County",5,74,933,425,508
050,51,179,"Virginia","Stafford County",5,75,927,418,509
050,51,179,"Virginia","Stafford County",5,76,987,456,531
050,51,179,"Virginia","Stafford County",5,77,673,317,356
050,51,179,"Virginia","Stafford County",5,78,639,291,348
050,51,179,"Virginia","Stafford County",5,79,628,272,356
050,51,179,"Virginia","Stafford County",5,80,582,266,316
050,51,179,"Virginia","Stafford County",5,81,483,183,300
050,51,179,"Virginia","Stafford County",5,82,427,189,238
050,51,179,"Virginia","Stafford County",5,83,364,144,220
050,51,179,"Virginia","Stafford County",5,84,320,124,196
050,51,179,"Virginia","Stafford County",5,85,1525,603,922
050,51,181,"Virginia","Surry County",1,0,60,30,30
050,51,181,"Virginia","Surry County",1,1,72,35,37
050,51,181,"Virginia","Surry County",1,2,63,32,31
050,51,181,"Virginia","Surry County",1,3,53,24,29
050,51,181,"Virginia","Surry County",1,4,52,25,27
050,51,181,"Virginia","Surry County",1,5,57,29,28
050,51,181,"Virginia","Surry County",1,6,52,27,25
050,51,181,"Virginia","Surry County",1,7,56,28,28
050,51,181,"Virginia","Surry County",1,8,54,23,31
050,51,181,"Virginia","Surry County",1,9,53,34,19
050,51,181,"Virginia","Surry County",1,10,62,36,26
050,51,181,"Virginia","Surry County",1,11,62,31,31
050,51,181,"Virginia","Surry County",1,12,60,34,26
050,51,181,"Virginia","Surry County",1,13,70,42,28
050,51,181,"Virginia","Surry County",1,14,73,41,32
050,51,181,"Virginia","Surry County",1,15,68,31,37
050,51,181,"Virginia","Surry County",1,16,65,40,25
050,51,181,"Virginia","Surry County",1,17,67,33,34
050,51,181,"Virginia","Surry County",1,18,67,35,32
050,51,181,"Virginia","Surry County",1,19,49,23,26
050,51,181,"Virginia","Surry County",1,20,60,29,31
050,51,181,"Virginia","Surry County",1,21,51,23,28
050,51,181,"Virginia","Surry County",1,22,54,24,30
050,51,181,"Virginia","Surry County",1,23,71,29,42
050,51,181,"Virginia","Surry County",1,24,60,33,27
050,51,181,"Virginia","Surry County",1,25,75,34,41
050,51,181,"Virginia","Surry County",1,26,70,42,28
050,51,181,"Virginia","Surry County",1,27,75,45,30
050,51,181,"Virginia","Surry County",1,28,70,40,30
050,51,181,"Virginia","Surry County",1,29,71,38,33
050,51,181,"Virginia","Surry County",1,30,63,36,27
050,51,181,"Virginia","Surry County",1,31,73,39,34
050,51,181,"Virginia","Surry County",1,32,97,51,46
050,51,181,"Virginia","Surry County",1,33,75,42,33
050,51,181,"Virginia","Surry County",1,34,65,36,29
050,51,181,"Virginia","Surry County",1,35,68,32,36
050,51,181,"Virginia","Surry County",1,36,60,26,34
050,51,181,"Virginia","Surry County",1,37,47,21,26
050,51,181,"Virginia","Surry County",1,38,57,29,28
050,51,181,"Virginia","Surry County",1,39,79,44,35
050,51,181,"Virginia","Surry County",1,40,74,43,31
050,51,181,"Virginia","Surry County",1,41,52,20,32
050,51,181,"Virginia","Surry County",1,42,49,24,25
050,51,181,"Virginia","Surry County",1,43,61,26,35
050,51,181,"Virginia","Surry County",1,44,68,35,33
050,51,181,"Virginia","Surry County",1,45,60,33,27
050,51,181,"Virginia","Surry County",1,46,61,25,36
050,51,181,"Virginia","Surry County",1,47,64,30,34
050,51,181,"Virginia","Surry County",1,48,71,37,34
050,51,181,"Virginia","Surry County",1,49,92,41,51
050,51,181,"Virginia","Surry County",1,50,76,41,35
050,51,181,"Virginia","Surry County",1,51,102,51,51
050,51,181,"Virginia","Surry County",1,52,90,43,47
050,51,181,"Virginia","Surry County",1,53,93,46,47
050,51,181,"Virginia","Surry County",1,54,105,55,50
050,51,181,"Virginia","Surry County",1,55,129,61,68
050,51,181,"Virginia","Surry County",1,56,138,70,68
050,51,181,"Virginia","Surry County",1,57,143,78,65
050,51,181,"Virginia","Surry County",1,58,147,74,73
050,51,181,"Virginia","Surry County",1,59,133,66,67
050,51,181,"Virginia","Surry County",1,60,129,62,67
050,51,181,"Virginia","Surry County",1,61,130,62,68
050,51,181,"Virginia","Surry County",1,62,141,75,66
050,51,181,"Virginia","Surry County",1,63,124,59,65
050,51,181,"Virginia","Surry County",1,64,104,48,56
050,51,181,"Virginia","Surry County",1,65,116,52,64
050,51,181,"Virginia","Surry County",1,66,119,61,58
050,51,181,"Virginia","Surry County",1,67,98,50,48
050,51,181,"Virginia","Surry County",1,68,96,48,48
050,51,181,"Virginia","Surry County",1,69,100,47,53
050,51,181,"Virginia","Surry County",1,70,91,47,44
050,51,181,"Virginia","Surry County",1,71,92,42,50
050,51,181,"Virginia","Surry County",1,72,95,51,44
050,51,181,"Virginia","Surry County",1,73,98,50,48
050,51,181,"Virginia","Surry County",1,74,63,34,29
050,51,181,"Virginia","Surry County",1,75,53,22,31
050,51,181,"Virginia","Surry County",1,76,58,26,32
050,51,181,"Virginia","Surry County",1,77,66,28,38
050,51,181,"Virginia","Surry County",1,78,66,33,33
050,51,181,"Virginia","Surry County",1,79,45,22,23
050,51,181,"Virginia","Surry County",1,80,31,18,13
050,51,181,"Virginia","Surry County",1,81,33,13,20
050,51,181,"Virginia","Surry County",1,82,44,20,24
050,51,181,"Virginia","Surry County",1,83,40,17,23
050,51,181,"Virginia","Surry County",1,84,27,11,16
050,51,181,"Virginia","Surry County",1,85,135,45,90
050,51,181,"Virginia","Surry County",2,0,65,36,29
050,51,181,"Virginia","Surry County",2,1,69,34,35
050,51,181,"Virginia","Surry County",2,2,66,33,33
050,51,181,"Virginia","Surry County",2,3,54,25,29
050,51,181,"Virginia","Surry County",2,4,51,24,27
050,51,181,"Virginia","Surry County",2,5,55,27,28
050,51,181,"Virginia","Surry County",2,6,54,28,26
050,51,181,"Virginia","Surry County",2,7,55,28,27
050,51,181,"Virginia","Surry County",2,8,55,24,31
050,51,181,"Virginia","Surry County",2,9,53,32,21
050,51,181,"Virginia","Surry County",2,10,60,35,25
050,51,181,"Virginia","Surry County",2,11,62,32,30
050,51,181,"Virginia","Surry County",2,12,60,33,27
050,51,181,"Virginia","Surry County",2,13,69,39,30
050,51,181,"Virginia","Surry County",2,14,72,41,31
050,51,181,"Virginia","Surry County",2,15,70,33,37
050,51,181,"Virginia","Surry County",2,16,68,39,29
050,51,181,"Virginia","Surry County",2,17,65,33,32
050,51,181,"Virginia","Surry County",2,18,66,34,32
050,51,181,"Virginia","Surry County",2,19,50,24,26
050,51,181,"Virginia","Surry County",2,20,59,29,30
050,51,181,"Virginia","Surry County",2,21,54,25,29
050,51,181,"Virginia","Surry County",2,22,55,24,31
050,51,181,"Virginia","Surry County",2,23,67,29,38
050,51,181,"Virginia","Surry County",2,24,62,32,30
050,51,181,"Virginia","Surry County",2,25,73,35,38
050,51,181,"Virginia","Surry County",2,26,69,40,29
050,51,181,"Virginia","Surry County",2,27,76,45,31
050,51,181,"Virginia","Surry County",2,28,72,42,30
050,51,181,"Virginia","Surry County",2,29,70,39,31
050,51,181,"Virginia","Surry County",2,30,64,37,27
050,51,181,"Virginia","Surry County",2,31,71,38,33
050,51,181,"Virginia","Surry County",2,32,89,47,42
050,51,181,"Virginia","Surry County",2,33,81,44,37
050,51,181,"Virginia","Surry County",2,34,68,38,30
050,51,181,"Virginia","Surry County",2,35,68,33,35
050,51,181,"Virginia","Surry County",2,36,61,27,34
050,51,181,"Virginia","Surry County",2,37,52,24,28
050,51,181,"Virginia","Surry County",2,38,54,27,27
050,51,181,"Virginia","Surry County",2,39,73,40,33
050,51,181,"Virginia","Surry County",2,40,77,44,33
050,51,181,"Virginia","Surry County",2,41,57,25,32
050,51,181,"Virginia","Surry County",2,42,50,23,27
050,51,181,"Virginia","Surry County",2,43,60,26,34
050,51,181,"Virginia","Surry County",2,44,66,33,33
050,51,181,"Virginia","Surry County",2,45,62,33,29
050,51,181,"Virginia","Surry County",2,46,61,27,34
050,51,181,"Virginia","Surry County",2,47,62,28,34
050,51,181,"Virginia","Surry County",2,48,70,36,34
050,51,181,"Virginia","Surry County",2,49,86,39,47
050,51,181,"Virginia","Surry County",2,50,79,40,39
050,51,181,"Virginia","Surry County",2,51,94,48,46
050,51,181,"Virginia","Surry County",2,52,93,45,48
050,51,181,"Virginia","Surry County",2,53,92,46,46
050,51,181,"Virginia","Surry County",2,54,104,54,50
050,51,181,"Virginia","Surry County",2,55,122,58,64
050,51,181,"Virginia","Surry County",2,56,137,69,68
050,51,181,"Virginia","Surry County",2,57,143,76,67
050,51,181,"Virginia","Surry County",2,58,142,73,69
050,51,181,"Virginia","Surry County",2,59,137,68,69
050,51,181,"Virginia","Surry County",2,60,129,62,67
050,51,181,"Virginia","Surry County",2,61,129,62,67
050,51,181,"Virginia","Surry County",2,62,138,72,66
050,51,181,"Virginia","Surry County",2,63,128,63,65
050,51,181,"Virginia","Surry County",2,64,107,49,58
050,51,181,"Virginia","Surry County",2,65,113,51,62
050,51,181,"Virginia","Surry County",2,66,119,60,59
050,51,181,"Virginia","Surry County",2,67,100,50,50
050,51,181,"Virginia","Surry County",2,68,95,47,48
050,51,181,"Virginia","Surry County",2,69,100,48,52
050,51,181,"Virginia","Surry County",2,70,93,47,46
050,51,181,"Virginia","Surry County",2,71,90,42,48
050,51,181,"Virginia","Surry County",2,72,95,50,45
050,51,181,"Virginia","Surry County",2,73,102,52,50
050,51,181,"Virginia","Surry County",2,74,65,34,31
050,51,181,"Virginia","Surry County",2,75,55,25,30
050,51,181,"Virginia","Surry County",2,76,55,24,31
050,51,181,"Virginia","Surry County",2,77,64,28,36
050,51,181,"Virginia","Surry County",2,78,65,32,33
050,51,181,"Virginia","Surry County",2,79,48,24,24
050,51,181,"Virginia","Surry County",2,80,35,19,16
050,51,181,"Virginia","Surry County",2,81,30,12,18
050,51,181,"Virginia","Surry County",2,82,42,19,23
050,51,181,"Virginia","Surry County",2,83,41,18,23
050,51,181,"Virginia","Surry County",2,84,29,12,17
050,51,181,"Virginia","Surry County",2,85,133,46,87
050,51,181,"Virginia","Surry County",3,0,63,36,27
050,51,181,"Virginia","Surry County",3,1,75,42,33
050,51,181,"Virginia","Surry County",3,2,69,33,36
050,51,181,"Virginia","Surry County",3,3,67,33,34
050,51,181,"Virginia","Surry County",3,4,62,30,32
050,51,181,"Virginia","Surry County",3,5,49,23,26
050,51,181,"Virginia","Surry County",3,6,56,27,29
050,51,181,"Virginia","Surry County",3,7,54,29,25
050,51,181,"Virginia","Surry County",3,8,52,27,25
050,51,181,"Virginia","Surry County",3,9,58,25,33
050,51,181,"Virginia","Surry County",3,10,58,36,22
050,51,181,"Virginia","Surry County",3,11,55,34,21
050,51,181,"Virginia","Surry County",3,12,55,25,30
050,51,181,"Virginia","Surry County",3,13,61,32,29
050,51,181,"Virginia","Surry County",3,14,73,40,33
050,51,181,"Virginia","Surry County",3,15,65,39,26
050,51,181,"Virginia","Surry County",3,16,66,33,33
050,51,181,"Virginia","Surry County",3,17,60,38,22
050,51,181,"Virginia","Surry County",3,18,53,30,23
050,51,181,"Virginia","Surry County",3,19,54,26,28
050,51,181,"Virginia","Surry County",3,20,54,24,30
050,51,181,"Virginia","Surry County",3,21,60,32,28
050,51,181,"Virginia","Surry County",3,22,56,27,29
050,51,181,"Virginia","Surry County",3,23,63,29,34
050,51,181,"Virginia","Surry County",3,24,71,34,37
050,51,181,"Virginia","Surry County",3,25,71,34,37
050,51,181,"Virginia","Surry County",3,26,71,33,38
050,51,181,"Virginia","Surry County",3,27,62,37,25
050,51,181,"Virginia","Surry County",3,28,82,48,34
050,51,181,"Virginia","Surry County",3,29,65,35,30
050,51,181,"Virginia","Surry County",3,30,74,46,28
050,51,181,"Virginia","Surry County",3,31,65,34,31
050,51,181,"Virginia","Surry County",3,32,75,42,33
050,51,181,"Virginia","Surry County",3,33,83,45,38
050,51,181,"Virginia","Surry County",3,34,81,43,38
050,51,181,"Virginia","Surry County",3,35,67,36,31
050,51,181,"Virginia","Surry County",3,36,69,35,34
050,51,181,"Virginia","Surry County",3,37,61,31,30
050,51,181,"Virginia","Surry County",3,38,49,22,27
050,51,181,"Virginia","Surry County",3,39,53,26,27
050,51,181,"Virginia","Surry County",3,40,67,34,33
050,51,181,"Virginia","Surry County",3,41,77,43,34
050,51,181,"Virginia","Surry County",3,42,62,25,37
050,51,181,"Virginia","Surry County",3,43,57,28,29
050,51,181,"Virginia","Surry County",3,44,64,30,34
050,51,181,"Virginia","Surry County",3,45,61,32,29
050,51,181,"Virginia","Surry County",3,46,60,34,26
050,51,181,"Virginia","Surry County",3,47,60,27,33
050,51,181,"Virginia","Surry County",3,48,60,28,32
050,51,181,"Virginia","Surry County",3,49,69,34,35
050,51,181,"Virginia","Surry County",3,50,87,40,47
050,51,181,"Virginia","Surry County",3,51,79,41,38
050,51,181,"Virginia","Surry County",3,52,98,52,46
050,51,181,"Virginia","Surry County",3,53,95,47,48
050,51,181,"Virginia","Surry County",3,54,83,43,40
050,51,181,"Virginia","Surry County",3,55,102,54,48
050,51,181,"Virginia","Surry County",3,56,125,57,68
050,51,181,"Virginia","Surry County",3,57,138,71,67
050,51,181,"Virginia","Surry County",3,58,141,78,63
050,51,181,"Virginia","Surry County",3,59,135,71,64
050,51,181,"Virginia","Surry County",3,60,142,70,72
050,51,181,"Virginia","Surry County",3,61,123,60,63
050,51,181,"Virginia","Surry County",3,62,118,55,63
050,51,181,"Virginia","Surry County",3,63,135,71,64
050,51,181,"Virginia","Surry County",3,64,127,63,64
050,51,181,"Virginia","Surry County",3,65,104,48,56
050,51,181,"Virginia","Surry County",3,66,112,52,60
050,51,181,"Virginia","Surry County",3,67,118,60,58
050,51,181,"Virginia","Surry County",3,68,98,48,50
050,51,181,"Virginia","Surry County",3,69,93,46,47
050,51,181,"Virginia","Surry County",3,70,99,48,51
050,51,181,"Virginia","Surry County",3,71,93,47,46
050,51,181,"Virginia","Surry County",3,72,87,40,47
050,51,181,"Virginia","Surry County",3,73,94,49,45
050,51,181,"Virginia","Surry County",3,74,100,54,46
050,51,181,"Virginia","Surry County",3,75,64,33,31
050,51,181,"Virginia","Surry County",3,76,51,22,29
050,51,181,"Virginia","Surry County",3,77,56,24,32
050,51,181,"Virginia","Surry County",3,78,65,28,37
050,51,181,"Virginia","Surry County",3,79,65,31,34
050,51,181,"Virginia","Surry County",3,80,44,23,21
050,51,181,"Virginia","Surry County",3,81,34,18,16
050,51,181,"Virginia","Surry County",3,82,28,12,16
050,51,181,"Virginia","Surry County",3,83,43,19,24
050,51,181,"Virginia","Surry County",3,84,41,18,23
050,51,181,"Virginia","Surry County",3,85,142,47,95
050,51,181,"Virginia","Surry County",4,0,67,34,33
050,51,181,"Virginia","Surry County",4,1,65,33,32
050,51,181,"Virginia","Surry County",4,2,64,32,32
050,51,181,"Virginia","Surry County",4,3,66,29,37
050,51,181,"Virginia","Surry County",4,4,69,32,37
050,51,181,"Virginia","Surry County",4,5,55,24,31
050,51,181,"Virginia","Surry County",4,6,48,24,24
050,51,181,"Virginia","Surry County",4,7,61,31,30
050,51,181,"Virginia","Surry County",4,8,55,29,26
050,51,181,"Virginia","Surry County",4,9,61,31,30
050,51,181,"Virginia","Surry County",4,10,60,30,30
050,51,181,"Virginia","Surry County",4,11,51,31,20
050,51,181,"Virginia","Surry County",4,12,54,38,16
050,51,181,"Virginia","Surry County",4,13,59,27,32
050,51,181,"Virginia","Surry County",4,14,57,29,28
050,51,181,"Virginia","Surry County",4,15,77,43,34
050,51,181,"Virginia","Surry County",4,16,68,41,27
050,51,181,"Virginia","Surry County",4,17,70,34,36
050,51,181,"Virginia","Surry County",4,18,52,32,20
050,51,181,"Virginia","Surry County",4,19,36,20,16
050,51,181,"Virginia","Surry County",4,20,55,27,28
050,51,181,"Virginia","Surry County",4,21,61,26,35
050,51,181,"Virginia","Surry County",4,22,65,32,33
050,51,181,"Virginia","Surry County",4,23,53,23,30
050,51,181,"Virginia","Surry County",4,24,69,32,37
050,51,181,"Virginia","Surry County",4,25,70,30,40
050,51,181,"Virginia","Surry County",4,26,83,43,40
050,51,181,"Virginia","Surry County",4,27,72,34,38
050,51,181,"Virginia","Surry County",4,28,63,37,26
050,51,181,"Virginia","Surry County",4,29,82,49,33
050,51,181,"Virginia","Surry County",4,30,70,38,32
050,51,181,"Virginia","Surry County",4,31,73,44,29
050,51,181,"Virginia","Surry County",4,32,69,36,33
050,51,181,"Virginia","Surry County",4,33,79,46,33
050,51,181,"Virginia","Surry County",4,34,83,46,37
050,51,181,"Virginia","Surry County",4,35,77,41,36
050,51,181,"Virginia","Surry County",4,36,64,34,30
050,51,181,"Virginia","Surry County",4,37,75,36,39
050,51,181,"Virginia","Surry County",4,38,64,35,29
050,51,181,"Virginia","Surry County",4,39,51,25,26
050,51,181,"Virginia","Surry County",4,40,58,27,31
050,51,181,"Virginia","Surry County",4,41,71,40,31
050,51,181,"Virginia","Surry County",4,42,78,46,32
050,51,181,"Virginia","Surry County",4,43,65,29,36
050,51,181,"Virginia","Surry County",4,44,54,25,29
050,51,181,"Virginia","Surry County",4,45,63,29,34
050,51,181,"Virginia","Surry County",4,46,59,32,27
050,51,181,"Virginia","Surry County",4,47,59,33,26
050,51,181,"Virginia","Surry County",4,48,61,27,34
050,51,181,"Virginia","Surry County",4,49,62,28,34
050,51,181,"Virginia","Surry County",4,50,65,33,32
050,51,181,"Virginia","Surry County",4,51,89,38,51
050,51,181,"Virginia","Surry County",4,52,73,39,34
050,51,181,"Virginia","Surry County",4,53,89,43,46
050,51,181,"Virginia","Surry County",4,54,89,38,51
050,51,181,"Virginia","Surry County",4,55,86,46,40
050,51,181,"Virginia","Surry County",4,56,108,59,49
050,51,181,"Virginia","Surry County",4,57,124,57,67
050,51,181,"Virginia","Surry County",4,58,133,70,63
050,51,181,"Virginia","Surry County",4,59,140,76,64
050,51,181,"Virginia","Surry County",4,60,129,68,61
050,51,181,"Virginia","Surry County",4,61,141,71,70
050,51,181,"Virginia","Surry County",4,62,124,60,64
050,51,181,"Virginia","Surry County",4,63,120,57,63
050,51,181,"Virginia","Surry County",4,64,137,70,67
050,51,181,"Virginia","Surry County",4,65,124,62,62
050,51,181,"Virginia","Surry County",4,66,103,47,56
050,51,181,"Virginia","Surry County",4,67,109,51,58
050,51,181,"Virginia","Surry County",4,68,114,55,59
050,51,181,"Virginia","Surry County",4,69,100,51,49
050,51,181,"Virginia","Surry County",4,70,92,46,46
050,51,181,"Virginia","Surry County",4,71,100,49,51
050,51,181,"Virginia","Surry County",4,72,85,43,42
050,51,181,"Virginia","Surry County",4,73,83,37,46
050,51,181,"Virginia","Surry County",4,74,93,48,45
050,51,181,"Virginia","Surry County",4,75,97,52,45
050,51,181,"Virginia","Surry County",4,76,63,32,31
050,51,181,"Virginia","Surry County",4,77,46,20,26
050,51,181,"Virginia","Surry County",4,78,52,21,31
050,51,181,"Virginia","Surry County",4,79,67,28,39
050,51,181,"Virginia","Surry County",4,80,58,28,30
050,51,181,"Virginia","Surry County",4,81,44,23,21
050,51,181,"Virginia","Surry County",4,82,33,17,16
050,51,181,"Virginia","Surry County",4,83,24,12,12
050,51,181,"Virginia","Surry County",4,84,37,15,22
050,51,181,"Virginia","Surry County",4,85,153,50,103
050,51,181,"Virginia","Surry County",5,0,67,34,33
050,51,181,"Virginia","Surry County",5,1,58,29,29
050,51,181,"Virginia","Surry County",5,2,77,38,39
050,51,181,"Virginia","Surry County",5,3,59,29,30
050,51,181,"Virginia","Surry County",5,4,68,32,36
050,51,181,"Virginia","Surry County",5,5,73,36,37
050,51,181,"Virginia","Surry County",5,6,58,28,30
050,51,181,"Virginia","Surry County",5,7,51,24,27
050,51,181,"Virginia","Surry County",5,8,64,33,31
050,51,181,"Virginia","Surry County",5,9,61,36,25
050,51,181,"Virginia","Surry County",5,10,64,30,34
050,51,181,"Virginia","Surry County",5,11,60,29,31
050,51,181,"Virginia","Surry County",5,12,55,35,20
050,51,181,"Virginia","Surry County",5,13,63,43,20
050,51,181,"Virginia","Surry County",5,14,57,28,29
050,51,181,"Virginia","Surry County",5,15,60,30,30
050,51,181,"Virginia","Surry County",5,16,74,36,38
050,51,181,"Virginia","Surry County",5,17,66,40,26
050,51,181,"Virginia","Surry County",5,18,58,30,28
050,51,181,"Virginia","Surry County",5,19,42,25,17
050,51,181,"Virginia","Surry County",5,20,38,22,16
050,51,181,"Virginia","Surry County",5,21,54,23,31
050,51,181,"Virginia","Surry County",5,22,68,31,37
050,51,181,"Virginia","Surry County",5,23,76,35,41
050,51,181,"Virginia","Surry County",5,24,54,22,32
050,51,181,"Virginia","Surry County",5,25,70,34,36
050,51,181,"Virginia","Surry County",5,26,68,32,36
050,51,181,"Virginia","Surry County",5,27,87,47,40
050,51,181,"Virginia","Surry County",5,28,62,30,32
050,51,181,"Virginia","Surry County",5,29,64,39,25
050,51,181,"Virginia","Surry County",5,30,92,54,38
050,51,181,"Virginia","Surry County",5,31,72,37,35
050,51,181,"Virginia","Surry County",5,32,76,44,32
050,51,181,"Virginia","Surry County",5,33,72,39,33
050,51,181,"Virginia","Surry County",5,34,75,40,35
050,51,181,"Virginia","Surry County",5,35,81,42,39
050,51,181,"Virginia","Surry County",5,36,84,43,41
050,51,181,"Virginia","Surry County",5,37,64,35,29
050,51,181,"Virginia","Surry County",5,38,78,40,38
050,51,181,"Virginia","Surry County",5,39,68,34,34
050,51,181,"Virginia","Surry County",5,40,54,27,27
050,51,181,"Virginia","Surry County",5,41,62,31,31
050,51,181,"Virginia","Surry County",5,42,70,38,32
050,51,181,"Virginia","Surry County",5,43,79,48,31
050,51,181,"Virginia","Surry County",5,44,70,32,38
050,51,181,"Virginia","Surry County",5,45,50,23,27
050,51,181,"Virginia","Surry County",5,46,69,35,34
050,51,181,"Virginia","Surry County",5,47,61,32,29
050,51,181,"Virginia","Surry County",5,48,59,33,26
050,51,181,"Virginia","Surry County",5,49,64,27,37
050,51,181,"Virginia","Surry County",5,50,64,29,35
050,51,181,"Virginia","Surry County",5,51,73,37,36
050,51,181,"Virginia","Surry County",5,52,88,36,52
050,51,181,"Virginia","Surry County",5,53,76,42,34
050,51,181,"Virginia","Surry County",5,54,95,50,45
050,51,181,"Virginia","Surry County",5,55,87,37,50
050,51,181,"Virginia","Surry County",5,56,93,47,46
050,51,181,"Virginia","Surry County",5,57,108,60,48
050,51,181,"Virginia","Surry County",5,58,114,52,62
050,51,181,"Virginia","Surry County",5,59,130,68,62
050,51,181,"Virginia","Surry County",5,60,142,77,65
050,51,181,"Virginia","Surry County",5,61,137,73,64
050,51,181,"Virginia","Surry County",5,62,140,70,70
050,51,181,"Virginia","Surry County",5,63,121,57,64
050,51,181,"Virginia","Surry County",5,64,119,55,64
050,51,181,"Virginia","Surry County",5,65,135,72,63
050,51,181,"Virginia","Surry County",5,66,120,60,60
050,51,181,"Virginia","Surry County",5,67,100,47,53
050,51,181,"Virginia","Surry County",5,68,107,50,57
050,51,181,"Virginia","Surry County",5,69,116,57,59
050,51,181,"Virginia","Surry County",5,70,92,50,42
050,51,181,"Virginia","Surry County",5,71,91,45,46
050,51,181,"Virginia","Surry County",5,72,93,46,47
050,51,181,"Virginia","Surry County",5,73,82,41,41
050,51,181,"Virginia","Surry County",5,74,82,36,46
050,51,181,"Virginia","Surry County",5,75,92,47,45
050,51,181,"Virginia","Surry County",5,76,96,52,44
050,51,181,"Virginia","Surry County",5,77,60,32,28
050,51,181,"Virginia","Surry County",5,78,41,18,23
050,51,181,"Virginia","Surry County",5,79,48,17,31
050,51,181,"Virginia","Surry County",5,80,63,28,35
050,51,181,"Virginia","Surry County",5,81,56,28,28
050,51,181,"Virginia","Surry County",5,82,45,23,22
050,51,181,"Virginia","Surry County",5,83,28,17,11
050,51,181,"Virginia","Surry County",5,84,22,12,10
050,51,181,"Virginia","Surry County",5,85,161,48,113
050,51,183,"Virginia","Sussex County",1,0,82,40,42
050,51,183,"Virginia","Sussex County",1,1,82,37,45
050,51,183,"Virginia","Sussex County",1,2,94,44,50
050,51,183,"Virginia","Sussex County",1,3,90,49,41
050,51,183,"Virginia","Sussex County",1,4,96,48,48
050,51,183,"Virginia","Sussex County",1,5,95,51,44
050,51,183,"Virginia","Sussex County",1,6,111,52,59
050,51,183,"Virginia","Sussex County",1,7,102,52,50
050,51,183,"Virginia","Sussex County",1,8,100,54,46
050,51,183,"Virginia","Sussex County",1,9,101,47,54
050,51,183,"Virginia","Sussex County",1,10,93,44,49
050,51,183,"Virginia","Sussex County",1,11,102,54,48
050,51,183,"Virginia","Sussex County",1,12,103,52,51
050,51,183,"Virginia","Sussex County",1,13,96,46,50
050,51,183,"Virginia","Sussex County",1,14,96,43,53
050,51,183,"Virginia","Sussex County",1,15,94,47,47
050,51,183,"Virginia","Sussex County",1,16,103,49,54
050,51,183,"Virginia","Sussex County",1,17,96,50,46
050,51,183,"Virginia","Sussex County",1,18,95,53,42
050,51,183,"Virginia","Sussex County",1,19,95,53,42
050,51,183,"Virginia","Sussex County",1,20,115,72,43
050,51,183,"Virginia","Sussex County",1,21,136,97,39
050,51,183,"Virginia","Sussex County",1,22,141,108,33
050,51,183,"Virginia","Sussex County",1,23,162,125,37
050,51,183,"Virginia","Sussex County",1,24,171,122,49
050,51,183,"Virginia","Sussex County",1,25,199,144,55
050,51,183,"Virginia","Sussex County",1,26,195,138,57
050,51,183,"Virginia","Sussex County",1,27,199,146,53
050,51,183,"Virginia","Sussex County",1,28,198,151,47
050,51,183,"Virginia","Sussex County",1,29,201,147,54
050,51,183,"Virginia","Sussex County",1,30,179,128,51
050,51,183,"Virginia","Sussex County",1,31,185,130,55
050,51,183,"Virginia","Sussex County",1,32,173,123,50
050,51,183,"Virginia","Sussex County",1,33,160,116,44
050,51,183,"Virginia","Sussex County",1,34,168,122,46
050,51,183,"Virginia","Sussex County",1,35,145,97,48
050,51,183,"Virginia","Sussex County",1,36,159,109,50
050,51,183,"Virginia","Sussex County",1,37,140,98,42
050,51,183,"Virginia","Sussex County",1,38,152,103,49
050,51,183,"Virginia","Sussex County",1,39,154,102,52
050,51,183,"Virginia","Sussex County",1,40,134,89,45
050,51,183,"Virginia","Sussex County",1,41,108,71,37
050,51,183,"Virginia","Sussex County",1,42,130,89,41
050,51,183,"Virginia","Sussex County",1,43,121,83,38
050,51,183,"Virginia","Sussex County",1,44,116,80,36
050,51,183,"Virginia","Sussex County",1,45,117,78,39
050,51,183,"Virginia","Sussex County",1,46,127,76,51
050,51,183,"Virginia","Sussex County",1,47,124,66,58
050,51,183,"Virginia","Sussex County",1,48,154,95,59
050,51,183,"Virginia","Sussex County",1,49,157,91,66
050,51,183,"Virginia","Sussex County",1,50,132,79,53
050,51,183,"Virginia","Sussex County",1,51,147,83,64
050,51,183,"Virginia","Sussex County",1,52,137,68,69
050,51,183,"Virginia","Sussex County",1,53,159,88,71
050,51,183,"Virginia","Sussex County",1,54,157,80,77
050,51,183,"Virginia","Sussex County",1,55,156,74,82
050,51,183,"Virginia","Sussex County",1,56,159,87,72
050,51,183,"Virginia","Sussex County",1,57,154,82,72
050,51,183,"Virginia","Sussex County",1,58,166,87,79
050,51,183,"Virginia","Sussex County",1,59,161,94,67
050,51,183,"Virginia","Sussex County",1,60,147,76,71
050,51,183,"Virginia","Sussex County",1,61,138,71,67
050,51,183,"Virginia","Sussex County",1,62,144,75,69
050,51,183,"Virginia","Sussex County",1,63,162,80,82
050,51,183,"Virginia","Sussex County",1,64,141,72,69
050,51,183,"Virginia","Sussex County",1,65,137,63,74
050,51,183,"Virginia","Sussex County",1,66,153,76,77
050,51,183,"Virginia","Sussex County",1,67,144,77,67
050,51,183,"Virginia","Sussex County",1,68,128,68,60
050,51,183,"Virginia","Sussex County",1,69,125,74,51
050,51,183,"Virginia","Sussex County",1,70,117,63,54
050,51,183,"Virginia","Sussex County",1,71,124,55,69
050,51,183,"Virginia","Sussex County",1,72,110,42,68
050,51,183,"Virginia","Sussex County",1,73,104,50,54
050,51,183,"Virginia","Sussex County",1,74,84,38,46
050,51,183,"Virginia","Sussex County",1,75,81,35,46
050,51,183,"Virginia","Sussex County",1,76,63,29,34
050,51,183,"Virginia","Sussex County",1,77,71,27,44
050,51,183,"Virginia","Sussex County",1,78,70,30,40
050,51,183,"Virginia","Sussex County",1,79,64,26,38
050,51,183,"Virginia","Sussex County",1,80,59,21,38
050,51,183,"Virginia","Sussex County",1,81,54,16,38
050,51,183,"Virginia","Sussex County",1,82,57,13,44
050,51,183,"Virginia","Sussex County",1,83,40,12,28
050,51,183,"Virginia","Sussex County",1,84,32,13,19
050,51,183,"Virginia","Sussex County",1,85,204,93,111
050,51,183,"Virginia","Sussex County",2,0,86,43,43
050,51,183,"Virginia","Sussex County",2,1,84,39,45
050,51,183,"Virginia","Sussex County",2,2,92,42,50
050,51,183,"Virginia","Sussex County",2,3,91,47,44
050,51,183,"Virginia","Sussex County",2,4,93,47,46
050,51,183,"Virginia","Sussex County",2,5,95,49,46
050,51,183,"Virginia","Sussex County",2,6,108,53,55
050,51,183,"Virginia","Sussex County",2,7,103,51,52
050,51,183,"Virginia","Sussex County",2,8,102,54,48
050,51,183,"Virginia","Sussex County",2,9,99,48,51
050,51,183,"Virginia","Sussex County",2,10,95,45,50
050,51,183,"Virginia","Sussex County",2,11,99,52,47
050,51,183,"Virginia","Sussex County",2,12,102,53,49
050,51,183,"Virginia","Sussex County",2,13,97,47,50
050,51,183,"Virginia","Sussex County",2,14,96,44,52
050,51,183,"Virginia","Sussex County",2,15,94,46,48
050,51,183,"Virginia","Sussex County",2,16,100,47,53
050,51,183,"Virginia","Sussex County",2,17,98,50,48
050,51,183,"Virginia","Sussex County",2,18,92,52,40
050,51,183,"Virginia","Sussex County",2,19,93,52,41
050,51,183,"Virginia","Sussex County",2,20,117,72,45
050,51,183,"Virginia","Sussex County",2,21,135,95,40
050,51,183,"Virginia","Sussex County",2,22,144,109,35
050,51,183,"Virginia","Sussex County",2,23,163,126,37
050,51,183,"Virginia","Sussex County",2,24,169,121,48
050,51,183,"Virginia","Sussex County",2,25,199,144,55
050,51,183,"Virginia","Sussex County",2,26,190,135,55
050,51,183,"Virginia","Sussex County",2,27,198,145,53
050,51,183,"Virginia","Sussex County",2,28,199,150,49
050,51,183,"Virginia","Sussex County",2,29,198,147,51
050,51,183,"Virginia","Sussex County",2,30,180,128,52
050,51,183,"Virginia","Sussex County",2,31,183,129,54
050,51,183,"Virginia","Sussex County",2,32,170,120,50
050,51,183,"Virginia","Sussex County",2,33,159,115,44
050,51,183,"Virginia","Sussex County",2,34,170,124,46
050,51,183,"Virginia","Sussex County",2,35,149,101,48
050,51,183,"Virginia","Sussex County",2,36,159,110,49
050,51,183,"Virginia","Sussex County",2,37,139,94,45
050,51,183,"Virginia","Sussex County",2,38,157,107,50
050,51,183,"Virginia","Sussex County",2,39,153,102,51
050,51,183,"Virginia","Sussex County",2,40,135,88,47
050,51,183,"Virginia","Sussex County",2,41,114,76,38
050,51,183,"Virginia","Sussex County",2,42,125,86,39
050,51,183,"Virginia","Sussex County",2,43,122,84,38
050,51,183,"Virginia","Sussex County",2,44,113,77,36
050,51,183,"Virginia","Sussex County",2,45,119,81,38
050,51,183,"Virginia","Sussex County",2,46,121,73,48
050,51,183,"Virginia","Sussex County",2,47,121,66,55
050,51,183,"Virginia","Sussex County",2,48,152,92,60
050,51,183,"Virginia","Sussex County",2,49,152,89,63
050,51,183,"Virginia","Sussex County",2,50,137,81,56
050,51,183,"Virginia","Sussex County",2,51,142,81,61
050,51,183,"Virginia","Sussex County",2,52,137,70,67
050,51,183,"Virginia","Sussex County",2,53,154,83,71
050,51,183,"Virginia","Sussex County",2,54,157,80,77
050,51,183,"Virginia","Sussex County",2,55,155,74,81
050,51,183,"Virginia","Sussex County",2,56,159,84,75
050,51,183,"Virginia","Sussex County",2,57,153,82,71
050,51,183,"Virginia","Sussex County",2,58,162,85,77
050,51,183,"Virginia","Sussex County",2,59,161,92,69
050,51,183,"Virginia","Sussex County",2,60,149,79,70
050,51,183,"Virginia","Sussex County",2,61,138,70,68
050,51,183,"Virginia","Sussex County",2,62,143,75,68
050,51,183,"Virginia","Sussex County",2,63,159,79,80
050,51,183,"Virginia","Sussex County",2,64,142,72,70
050,51,183,"Virginia","Sussex County",2,65,139,65,74
050,51,183,"Virginia","Sussex County",2,66,148,72,76
050,51,183,"Virginia","Sussex County",2,67,148,78,70
050,51,183,"Virginia","Sussex County",2,68,127,68,59
050,51,183,"Virginia","Sussex County",2,69,126,72,54
050,51,183,"Virginia","Sussex County",2,70,116,62,54
050,51,183,"Virginia","Sussex County",2,71,119,54,65
050,51,183,"Virginia","Sussex County",2,72,112,45,67
050,51,183,"Virginia","Sussex County",2,73,109,50,59
050,51,183,"Virginia","Sussex County",2,74,84,39,45
050,51,183,"Virginia","Sussex County",2,75,81,35,46
050,51,183,"Virginia","Sussex County",2,76,66,29,37
050,51,183,"Virginia","Sussex County",2,77,67,27,40
050,51,183,"Virginia","Sussex County",2,78,68,27,41
050,51,183,"Virginia","Sussex County",2,79,65,27,38
050,51,183,"Virginia","Sussex County",2,80,59,22,37
050,51,183,"Virginia","Sussex County",2,81,52,16,36
050,51,183,"Virginia","Sussex County",2,82,54,12,42
050,51,183,"Virginia","Sussex County",2,83,41,11,30
050,51,183,"Virginia","Sussex County",2,84,33,12,21
050,51,183,"Virginia","Sussex County",2,85,201,91,110
050,51,183,"Virginia","Sussex County",3,0,84,43,41
050,51,183,"Virginia","Sussex County",3,1,94,56,38
050,51,183,"Virginia","Sussex County",3,2,84,39,45
050,51,183,"Virginia","Sussex County",3,3,88,48,40
050,51,183,"Virginia","Sussex County",3,4,87,44,43
050,51,183,"Virginia","Sussex County",3,5,92,45,47
050,51,183,"Virginia","Sussex County",3,6,84,46,38
050,51,183,"Virginia","Sussex County",3,7,103,51,52
050,51,183,"Virginia","Sussex County",3,8,99,50,49
050,51,183,"Virginia","Sussex County",3,9,102,52,50
050,51,183,"Virginia","Sussex County",3,10,97,48,49
050,51,183,"Virginia","Sussex County",3,11,94,47,47
050,51,183,"Virginia","Sussex County",3,12,95,54,41
050,51,183,"Virginia","Sussex County",3,13,109,57,52
050,51,183,"Virginia","Sussex County",3,14,93,39,54
050,51,183,"Virginia","Sussex County",3,15,97,43,54
050,51,183,"Virginia","Sussex County",3,16,96,45,51
050,51,183,"Virginia","Sussex County",3,17,101,49,52
050,51,183,"Virginia","Sussex County",3,18,90,48,42
050,51,183,"Virginia","Sussex County",3,19,89,53,36
050,51,183,"Virginia","Sussex County",3,20,111,65,46
050,51,183,"Virginia","Sussex County",3,21,141,97,44
050,51,183,"Virginia","Sussex County",3,22,158,116,42
050,51,183,"Virginia","Sussex County",3,23,170,126,44
050,51,183,"Virginia","Sussex County",3,24,167,127,40
050,51,183,"Virginia","Sussex County",3,25,196,148,48
050,51,183,"Virginia","Sussex County",3,26,182,130,52
050,51,183,"Virginia","Sussex County",3,27,205,151,54
050,51,183,"Virginia","Sussex County",3,28,207,159,48
050,51,183,"Virginia","Sussex County",3,29,193,147,46
050,51,183,"Virginia","Sussex County",3,30,188,135,53
050,51,183,"Virginia","Sussex County",3,31,188,138,50
050,51,183,"Virginia","Sussex County",3,32,177,125,52
050,51,183,"Virginia","Sussex County",3,33,180,128,52
050,51,183,"Virginia","Sussex County",3,34,165,122,43
050,51,183,"Virginia","Sussex County",3,35,148,105,43
050,51,183,"Virginia","Sussex County",3,36,169,123,46
050,51,183,"Virginia","Sussex County",3,37,134,87,47
050,51,183,"Virginia","Sussex County",3,38,159,108,51
050,51,183,"Virginia","Sussex County",3,39,163,112,51
050,51,183,"Virginia","Sussex County",3,40,133,84,49
050,51,183,"Virginia","Sussex County",3,41,142,89,53
050,51,183,"Virginia","Sussex County",3,42,124,88,36
050,51,183,"Virginia","Sussex County",3,43,128,89,39
050,51,183,"Virginia","Sussex County",3,44,117,76,41
050,51,183,"Virginia","Sussex County",3,45,125,88,37
050,51,183,"Virginia","Sussex County",3,46,115,77,38
050,51,183,"Virginia","Sussex County",3,47,114,63,51
050,51,183,"Virginia","Sussex County",3,48,134,75,59
050,51,183,"Virginia","Sussex County",3,49,150,89,61
050,51,183,"Virginia","Sussex County",3,50,144,85,59
050,51,183,"Virginia","Sussex County",3,51,143,90,53
050,51,183,"Virginia","Sussex County",3,52,131,73,58
050,51,183,"Virginia","Sussex County",3,53,140,72,68
050,51,183,"Virginia","Sussex County",3,54,151,78,73
050,51,183,"Virginia","Sussex County",3,55,151,76,75
050,51,183,"Virginia","Sussex County",3,56,161,84,77
050,51,183,"Virginia","Sussex County",3,57,155,84,71
050,51,183,"Virginia","Sussex County",3,58,143,75,68
050,51,183,"Virginia","Sussex County",3,59,162,87,75
050,51,183,"Virginia","Sussex County",3,60,153,89,64
050,51,183,"Virginia","Sussex County",3,61,145,78,67
050,51,183,"Virginia","Sussex County",3,62,144,75,69
050,51,183,"Virginia","Sussex County",3,63,141,71,70
050,51,183,"Virginia","Sussex County",3,64,147,72,75
050,51,183,"Virginia","Sussex County",3,65,134,65,69
050,51,183,"Virginia","Sussex County",3,66,137,61,76
050,51,183,"Virginia","Sussex County",3,67,149,77,72
050,51,183,"Virginia","Sussex County",3,68,142,70,72
050,51,183,"Virginia","Sussex County",3,69,126,69,57
050,51,183,"Virginia","Sussex County",3,70,111,60,51
050,51,183,"Virginia","Sussex County",3,71,115,60,55
050,51,183,"Virginia","Sussex County",3,72,112,50,62
050,51,183,"Virginia","Sussex County",3,73,104,40,64
050,51,183,"Virginia","Sussex County",3,74,99,41,58
050,51,183,"Virginia","Sussex County",3,75,80,37,43
050,51,183,"Virginia","Sussex County",3,76,80,35,45
050,51,183,"Virginia","Sussex County",3,77,66,30,36
050,51,183,"Virginia","Sussex County",3,78,64,26,38
050,51,183,"Virginia","Sussex County",3,79,66,28,38
050,51,183,"Virginia","Sussex County",3,80,62,25,37
050,51,183,"Virginia","Sussex County",3,81,51,21,30
050,51,183,"Virginia","Sussex County",3,82,49,13,36
050,51,183,"Virginia","Sussex County",3,83,49,11,38
050,51,183,"Virginia","Sussex County",3,84,38,10,28
050,51,183,"Virginia","Sussex County",3,85,209,93,116
050,51,183,"Virginia","Sussex County",4,0,84,37,47
050,51,183,"Virginia","Sussex County",4,1,91,48,43
050,51,183,"Virginia","Sussex County",4,2,100,62,38
050,51,183,"Virginia","Sussex County",4,3,85,45,40
050,51,183,"Virginia","Sussex County",4,4,93,50,43
050,51,183,"Virginia","Sussex County",4,5,76,40,36
050,51,183,"Virginia","Sussex County",4,6,92,46,46
050,51,183,"Virginia","Sussex County",4,7,85,41,44
050,51,183,"Virginia","Sussex County",4,8,98,52,46
050,51,183,"Virginia","Sussex County",4,9,103,59,44
050,51,183,"Virginia","Sussex County",4,10,100,49,51
050,51,183,"Virginia","Sussex County",4,11,93,49,44
050,51,183,"Virginia","Sussex County",4,12,90,44,46
050,51,183,"Virginia","Sussex County",4,13,90,46,44
050,51,183,"Virginia","Sussex County",4,14,100,53,47
050,51,183,"Virginia","Sussex County",4,15,95,48,47
050,51,183,"Virginia","Sussex County",4,16,91,43,48
050,51,183,"Virginia","Sussex County",4,17,98,51,47
050,51,183,"Virginia","Sussex County",4,18,96,52,44
050,51,183,"Virginia","Sussex County",4,19,88,50,38
050,51,183,"Virginia","Sussex County",4,20,103,69,34
050,51,183,"Virginia","Sussex County",4,21,138,89,49
050,51,183,"Virginia","Sussex County",4,22,155,117,38
050,51,183,"Virginia","Sussex County",4,23,174,129,45
050,51,183,"Virginia","Sussex County",4,24,167,123,44
050,51,183,"Virginia","Sussex County",4,25,192,149,43
050,51,183,"Virginia","Sussex County",4,26,180,132,48
050,51,183,"Virginia","Sussex County",4,27,180,132,48
050,51,183,"Virginia","Sussex County",4,28,207,151,56
050,51,183,"Virginia","Sussex County",4,29,207,157,50
050,51,183,"Virginia","Sussex County",4,30,173,124,49
050,51,183,"Virginia","Sussex County",4,31,183,134,49
050,51,183,"Virginia","Sussex County",4,32,168,119,49
050,51,183,"Virginia","Sussex County",4,33,176,120,56
050,51,183,"Virginia","Sussex County",4,34,185,132,53
050,51,183,"Virginia","Sussex County",4,35,151,107,44
050,51,183,"Virginia","Sussex County",4,36,166,120,46
050,51,183,"Virginia","Sussex County",4,37,143,94,49
050,51,183,"Virginia","Sussex County",4,38,152,102,50
050,51,183,"Virginia","Sussex County",4,39,159,109,50
050,51,183,"Virginia","Sussex County",4,40,145,91,54
050,51,183,"Virginia","Sussex County",4,41,129,82,47
050,51,183,"Virginia","Sussex County",4,42,139,92,47
050,51,183,"Virginia","Sussex County",4,43,117,81,36
050,51,183,"Virginia","Sussex County",4,44,125,83,42
050,51,183,"Virginia","Sussex County",4,45,121,85,36
050,51,183,"Virginia","Sussex County",4,46,107,69,38
050,51,183,"Virginia","Sussex County",4,47,97,61,36
050,51,183,"Virginia","Sussex County",4,48,128,81,47
050,51,183,"Virginia","Sussex County",4,49,123,68,55
050,51,183,"Virginia","Sussex County",4,50,143,81,62
050,51,183,"Virginia","Sussex County",4,51,143,86,57
050,51,183,"Virginia","Sussex County",4,52,132,79,53
050,51,183,"Virginia","Sussex County",4,53,130,72,58
050,51,183,"Virginia","Sussex County",4,54,132,64,68
050,51,183,"Virginia","Sussex County",4,55,137,68,69
050,51,183,"Virginia","Sussex County",4,56,142,73,69
050,51,183,"Virginia","Sussex County",4,57,158,84,74
050,51,183,"Virginia","Sussex County",4,58,145,80,65
050,51,183,"Virginia","Sussex County",4,59,143,71,72
050,51,183,"Virginia","Sussex County",4,60,152,78,74
050,51,183,"Virginia","Sussex County",4,61,152,87,65
050,51,183,"Virginia","Sussex County",4,62,139,75,64
050,51,183,"Virginia","Sussex County",4,63,141,72,69
050,51,183,"Virginia","Sussex County",4,64,142,73,69
050,51,183,"Virginia","Sussex County",4,65,141,70,71
050,51,183,"Virginia","Sussex County",4,66,130,59,71
050,51,183,"Virginia","Sussex County",4,67,136,62,74
050,51,183,"Virginia","Sussex County",4,68,138,69,69
050,51,183,"Virginia","Sussex County",4,69,139,69,70
050,51,183,"Virginia","Sussex County",4,70,111,57,54
050,51,183,"Virginia","Sussex County",4,71,110,58,52
050,51,183,"Virginia","Sussex County",4,72,109,54,55
050,51,183,"Virginia","Sussex County",4,73,108,47,61
050,51,183,"Virginia","Sussex County",4,74,95,32,63
050,51,183,"Virginia","Sussex County",4,75,98,39,59
050,51,183,"Virginia","Sussex County",4,76,76,36,40
050,51,183,"Virginia","Sussex County",4,77,80,36,44
050,51,183,"Virginia","Sussex County",4,78,61,26,35
050,51,183,"Virginia","Sussex County",4,79,64,25,39
050,51,183,"Virginia","Sussex County",4,80,62,26,36
050,51,183,"Virginia","Sussex County",4,81,57,25,32
050,51,183,"Virginia","Sussex County",4,82,52,17,35
050,51,183,"Virginia","Sussex County",4,83,41,14,27
050,51,183,"Virginia","Sussex County",4,84,48,11,37
050,51,183,"Virginia","Sussex County",4,85,215,90,125
050,51,183,"Virginia","Sussex County",5,0,82,37,45
050,51,183,"Virginia","Sussex County",5,1,87,38,49
050,51,183,"Virginia","Sussex County",5,2,88,48,40
050,51,183,"Virginia","Sussex County",5,3,103,65,38
050,51,183,"Virginia","Sussex County",5,4,93,52,41
050,51,183,"Virginia","Sussex County",5,5,99,51,48
050,51,183,"Virginia","Sussex County",5,6,93,54,39
050,51,183,"Virginia","Sussex County",5,7,91,42,49
050,51,183,"Virginia","Sussex County",5,8,90,46,44
050,51,183,"Virginia","Sussex County",5,9,96,50,46
050,51,183,"Virginia","Sussex County",5,10,103,57,46
050,51,183,"Virginia","Sussex County",5,11,103,50,53
050,51,183,"Virginia","Sussex County",5,12,100,49,51
050,51,183,"Virginia","Sussex County",5,13,96,47,49
050,51,183,"Virginia","Sussex County",5,14,92,47,45
050,51,183,"Virginia","Sussex County",5,15,103,51,52
050,51,183,"Virginia","Sussex County",5,16,97,50,47
050,51,183,"Virginia","Sussex County",5,17,98,41,57
050,51,183,"Virginia","Sussex County",5,18,90,51,39
050,51,183,"Virginia","Sussex County",5,19,97,54,43
050,51,183,"Virginia","Sussex County",5,20,109,70,39
050,51,183,"Virginia","Sussex County",5,21,127,92,35
050,51,183,"Virginia","Sussex County",5,22,161,105,56
050,51,183,"Virginia","Sussex County",5,23,170,134,36
050,51,183,"Virginia","Sussex County",5,24,173,126,47
050,51,183,"Virginia","Sussex County",5,25,190,143,47
050,51,183,"Virginia","Sussex County",5,26,180,136,44
050,51,183,"Virginia","Sussex County",5,27,196,137,59
050,51,183,"Virginia","Sussex County",5,28,183,138,45
050,51,183,"Virginia","Sussex County",5,29,218,154,64
050,51,183,"Virginia","Sussex County",5,30,188,131,57
050,51,183,"Virginia","Sussex County",5,31,177,127,50
050,51,183,"Virginia","Sussex County",5,32,180,125,55
050,51,183,"Virginia","Sussex County",5,33,173,121,52
050,51,183,"Virginia","Sussex County",5,34,190,132,58
050,51,183,"Virginia","Sussex County",5,35,155,105,50
050,51,183,"Virginia","Sussex County",5,36,165,117,48
050,51,183,"Virginia","Sussex County",5,37,135,86,49
050,51,183,"Virginia","Sussex County",5,38,175,123,52
050,51,183,"Virginia","Sussex County",5,39,157,101,56
050,51,183,"Virginia","Sussex County",5,40,137,89,48
050,51,183,"Virginia","Sussex County",5,41,142,87,55
050,51,183,"Virginia","Sussex County",5,42,133,86,47
050,51,183,"Virginia","Sussex County",5,43,152,94,58
050,51,183,"Virginia","Sussex County",5,44,121,79,42
050,51,183,"Virginia","Sussex County",5,45,133,92,41
050,51,183,"Virginia","Sussex County",5,46,114,76,38
050,51,183,"Virginia","Sussex County",5,47,100,58,42
050,51,183,"Virginia","Sussex County",5,48,109,73,36
050,51,183,"Virginia","Sussex County",5,49,124,73,51
050,51,183,"Virginia","Sussex County",5,50,117,64,53
050,51,183,"Virginia","Sussex County",5,51,147,84,63
050,51,183,"Virginia","Sussex County",5,52,132,78,54
050,51,183,"Virginia","Sussex County",5,53,132,75,57
050,51,183,"Virginia","Sussex County",5,54,128,66,62
050,51,183,"Virginia","Sussex County",5,55,121,57,64
050,51,183,"Virginia","Sussex County",5,56,133,70,63
050,51,183,"Virginia","Sussex County",5,57,146,73,73
050,51,183,"Virginia","Sussex County",5,58,153,82,71
050,51,183,"Virginia","Sussex County",5,59,148,78,70
050,51,183,"Virginia","Sussex County",5,60,139,66,73
050,51,183,"Virginia","Sussex County",5,61,158,81,77
050,51,183,"Virginia","Sussex County",5,62,157,91,66
050,51,183,"Virginia","Sussex County",5,63,144,78,66
050,51,183,"Virginia","Sussex County",5,64,133,66,67
050,51,183,"Virginia","Sussex County",5,65,137,67,70
050,51,183,"Virginia","Sussex County",5,66,142,68,74
050,51,183,"Virginia","Sussex County",5,67,127,58,69
050,51,183,"Virginia","Sussex County",5,68,127,56,71
050,51,183,"Virginia","Sussex County",5,69,137,68,69
050,51,183,"Virginia","Sussex County",5,70,126,60,66
050,51,183,"Virginia","Sussex County",5,71,109,55,54
050,51,183,"Virginia","Sussex County",5,72,108,56,52
050,51,183,"Virginia","Sussex County",5,73,107,53,54
050,51,183,"Virginia","Sussex County",5,74,99,40,59
050,51,183,"Virginia","Sussex County",5,75,90,31,59
050,51,183,"Virginia","Sussex County",5,76,93,38,55
050,51,183,"Virginia","Sussex County",5,77,75,36,39
050,51,183,"Virginia","Sussex County",5,78,72,31,41
050,51,183,"Virginia","Sussex County",5,79,61,26,35
050,51,183,"Virginia","Sussex County",5,80,60,22,38
050,51,183,"Virginia","Sussex County",5,81,56,25,31
050,51,183,"Virginia","Sussex County",5,82,55,20,35
050,51,183,"Virginia","Sussex County",5,83,43,16,27
050,51,183,"Virginia","Sussex County",5,84,42,14,28
050,51,183,"Virginia","Sussex County",5,85,235,89,146
050,51,185,"Virginia","Tazewell County",1,0,365,187,178
050,51,185,"Virginia","Tazewell County",1,1,383,191,192
050,51,185,"Virginia","Tazewell County",1,2,403,196,207
050,51,185,"Virginia","Tazewell County",1,3,402,207,195
050,51,185,"Virginia","Tazewell County",1,4,435,208,227
050,51,185,"Virginia","Tazewell County",1,5,425,196,229
050,51,185,"Virginia","Tazewell County",1,6,424,214,210
050,51,185,"Virginia","Tazewell County",1,7,421,232,189
050,51,185,"Virginia","Tazewell County",1,8,396,200,196
050,51,185,"Virginia","Tazewell County",1,9,423,219,204
050,51,185,"Virginia","Tazewell County",1,10,418,218,200
050,51,185,"Virginia","Tazewell County",1,11,461,230,231
050,51,185,"Virginia","Tazewell County",1,12,470,228,242
050,51,185,"Virginia","Tazewell County",1,13,476,230,246
050,51,185,"Virginia","Tazewell County",1,14,488,253,235
050,51,185,"Virginia","Tazewell County",1,15,501,250,251
050,51,185,"Virginia","Tazewell County",1,16,493,255,238
050,51,185,"Virginia","Tazewell County",1,17,485,241,244
050,51,185,"Virginia","Tazewell County",1,18,446,229,217
050,51,185,"Virginia","Tazewell County",1,19,400,197,203
050,51,185,"Virginia","Tazewell County",1,20,408,205,203
050,51,185,"Virginia","Tazewell County",1,21,425,231,194
050,51,185,"Virginia","Tazewell County",1,22,446,244,202
050,51,185,"Virginia","Tazewell County",1,23,417,216,201
050,51,185,"Virginia","Tazewell County",1,24,453,251,202
050,51,185,"Virginia","Tazewell County",1,25,453,237,216
050,51,185,"Virginia","Tazewell County",1,26,462,263,199
050,51,185,"Virginia","Tazewell County",1,27,474,267,207
050,51,185,"Virginia","Tazewell County",1,28,463,255,208
050,51,185,"Virginia","Tazewell County",1,29,441,234,207
050,51,185,"Virginia","Tazewell County",1,30,447,265,182
050,51,185,"Virginia","Tazewell County",1,31,429,241,188
050,51,185,"Virginia","Tazewell County",1,32,442,236,206
050,51,185,"Virginia","Tazewell County",1,33,443,248,195
050,51,185,"Virginia","Tazewell County",1,34,463,264,199
050,51,185,"Virginia","Tazewell County",1,35,440,238,202
050,51,185,"Virginia","Tazewell County",1,36,429,240,189
050,51,185,"Virginia","Tazewell County",1,37,454,254,200
050,51,185,"Virginia","Tazewell County",1,38,484,267,217
050,51,185,"Virginia","Tazewell County",1,39,446,241,205
050,51,185,"Virginia","Tazewell County",1,40,484,269,215
050,51,185,"Virginia","Tazewell County",1,41,522,285,237
050,51,185,"Virginia","Tazewell County",1,42,498,254,244
050,51,185,"Virginia","Tazewell County",1,43,481,246,235
050,51,185,"Virginia","Tazewell County",1,44,487,261,226
050,51,185,"Virginia","Tazewell County",1,45,512,276,236
050,51,185,"Virginia","Tazewell County",1,46,529,281,248
050,51,185,"Virginia","Tazewell County",1,47,535,280,255
050,51,185,"Virginia","Tazewell County",1,48,535,271,264
050,51,185,"Virginia","Tazewell County",1,49,554,289,265
050,51,185,"Virginia","Tazewell County",1,50,519,269,250
050,51,185,"Virginia","Tazewell County",1,51,507,242,265
050,51,185,"Virginia","Tazewell County",1,52,510,262,248
050,51,185,"Virginia","Tazewell County",1,53,478,236,242
050,51,185,"Virginia","Tazewell County",1,54,497,247,250
050,51,185,"Virginia","Tazewell County",1,55,560,262,298
050,51,185,"Virginia","Tazewell County",1,56,601,295,306
050,51,185,"Virginia","Tazewell County",1,57,585,292,293
050,51,185,"Virginia","Tazewell County",1,58,536,249,287
050,51,185,"Virginia","Tazewell County",1,59,554,260,294
050,51,185,"Virginia","Tazewell County",1,60,599,281,318
050,51,185,"Virginia","Tazewell County",1,61,599,294,305
050,51,185,"Virginia","Tazewell County",1,62,637,308,329
050,51,185,"Virginia","Tazewell County",1,63,654,323,331
050,51,185,"Virginia","Tazewell County",1,64,647,301,346
050,51,185,"Virginia","Tazewell County",1,65,598,275,323
050,51,185,"Virginia","Tazewell County",1,66,601,281,320
050,51,185,"Virginia","Tazewell County",1,67,628,314,314
050,51,185,"Virginia","Tazewell County",1,68,611,298,313
050,51,185,"Virginia","Tazewell County",1,69,570,279,291
050,51,185,"Virginia","Tazewell County",1,70,567,274,293
050,51,185,"Virginia","Tazewell County",1,71,538,258,280
050,51,185,"Virginia","Tazewell County",1,72,538,256,282
050,51,185,"Virginia","Tazewell County",1,73,535,261,274
050,51,185,"Virginia","Tazewell County",1,74,360,169,191
050,51,185,"Virginia","Tazewell County",1,75,366,166,200
050,51,185,"Virginia","Tazewell County",1,76,367,174,193
050,51,185,"Virginia","Tazewell County",1,77,336,149,187
050,51,185,"Virginia","Tazewell County",1,78,300,128,172
050,51,185,"Virginia","Tazewell County",1,79,266,110,156
050,51,185,"Virginia","Tazewell County",1,80,231,88,143
050,51,185,"Virginia","Tazewell County",1,81,220,95,125
050,51,185,"Virginia","Tazewell County",1,82,217,90,127
050,51,185,"Virginia","Tazewell County",1,83,191,75,116
050,51,185,"Virginia","Tazewell County",1,84,156,66,90
050,51,185,"Virginia","Tazewell County",1,85,987,334,653
050,51,185,"Virginia","Tazewell County",2,0,376,197,179
050,51,185,"Virginia","Tazewell County",2,1,375,188,187
050,51,185,"Virginia","Tazewell County",2,2,400,197,203
050,51,185,"Virginia","Tazewell County",2,3,402,205,197
050,51,185,"Virginia","Tazewell County",2,4,428,208,220
050,51,185,"Virginia","Tazewell County",2,5,430,201,229
050,51,185,"Virginia","Tazewell County",2,6,426,211,215
050,51,185,"Virginia","Tazewell County",2,7,419,226,193
050,51,185,"Virginia","Tazewell County",2,8,400,208,192
050,51,185,"Virginia","Tazewell County",2,9,416,213,203
050,51,185,"Virginia","Tazewell County",2,10,419,217,202
050,51,185,"Virginia","Tazewell County",2,11,452,227,225
050,51,185,"Virginia","Tazewell County",2,12,471,231,240
050,51,185,"Virginia","Tazewell County",2,13,475,229,246
050,51,185,"Virginia","Tazewell County",2,14,489,250,239
050,51,185,"Virginia","Tazewell County",2,15,498,251,247
050,51,185,"Virginia","Tazewell County",2,16,497,255,242
050,51,185,"Virginia","Tazewell County",2,17,489,246,243
050,51,185,"Virginia","Tazewell County",2,18,445,226,219
050,51,185,"Virginia","Tazewell County",2,19,407,200,207
050,51,185,"Virginia","Tazewell County",2,20,414,208,206
050,51,185,"Virginia","Tazewell County",2,21,427,229,198
050,51,185,"Virginia","Tazewell County",2,22,445,243,202
050,51,185,"Virginia","Tazewell County",2,23,427,223,204
050,51,185,"Virginia","Tazewell County",2,24,450,245,205
050,51,185,"Virginia","Tazewell County",2,25,457,243,214
050,51,185,"Virginia","Tazewell County",2,26,458,254,204
050,51,185,"Virginia","Tazewell County",2,27,473,269,204
050,51,185,"Virginia","Tazewell County",2,28,463,257,206
050,51,185,"Virginia","Tazewell County",2,29,444,238,206
050,51,185,"Virginia","Tazewell County",2,30,452,262,190
050,51,185,"Virginia","Tazewell County",2,31,431,244,187
050,51,185,"Virginia","Tazewell County",2,32,435,233,202
050,51,185,"Virginia","Tazewell County",2,33,445,248,197
050,51,185,"Virginia","Tazewell County",2,34,458,260,198
050,51,185,"Virginia","Tazewell County",2,35,440,240,200
050,51,185,"Virginia","Tazewell County",2,36,429,239,190
050,51,185,"Virginia","Tazewell County",2,37,452,253,199
050,51,185,"Virginia","Tazewell County",2,38,480,266,214
050,51,185,"Virginia","Tazewell County",2,39,451,244,207
050,51,185,"Virginia","Tazewell County",2,40,479,264,215
050,51,185,"Virginia","Tazewell County",2,41,517,284,233
050,51,185,"Virginia","Tazewell County",2,42,495,254,241
050,51,185,"Virginia","Tazewell County",2,43,488,250,238
050,51,185,"Virginia","Tazewell County",2,44,482,257,225
050,51,185,"Virginia","Tazewell County",2,45,510,272,238
050,51,185,"Virginia","Tazewell County",2,46,523,278,245
050,51,185,"Virginia","Tazewell County",2,47,537,283,254
050,51,185,"Virginia","Tazewell County",2,48,535,270,265
050,51,185,"Virginia","Tazewell County",2,49,553,289,264
050,51,185,"Virginia","Tazewell County",2,50,526,272,254
050,51,185,"Virginia","Tazewell County",2,51,509,248,261
050,51,185,"Virginia","Tazewell County",2,52,504,255,249
050,51,185,"Virginia","Tazewell County",2,53,483,238,245
050,51,185,"Virginia","Tazewell County",2,54,489,243,246
050,51,185,"Virginia","Tazewell County",2,55,545,259,286
050,51,185,"Virginia","Tazewell County",2,56,590,287,303
050,51,185,"Virginia","Tazewell County",2,57,589,290,299
050,51,185,"Virginia","Tazewell County",2,58,545,255,290
050,51,185,"Virginia","Tazewell County",2,59,551,256,295
050,51,185,"Virginia","Tazewell County",2,60,583,274,309
050,51,185,"Virginia","Tazewell County",2,61,592,290,302
050,51,185,"Virginia","Tazewell County",2,62,626,303,323
050,51,185,"Virginia","Tazewell County",2,63,649,318,331
050,51,185,"Virginia","Tazewell County",2,64,643,303,340
050,51,185,"Virginia","Tazewell County",2,65,605,279,326
050,51,185,"Virginia","Tazewell County",2,66,597,278,319
050,51,185,"Virginia","Tazewell County",2,67,616,301,315
050,51,185,"Virginia","Tazewell County",2,68,608,297,311
050,51,185,"Virginia","Tazewell County",2,69,582,284,298
050,51,185,"Virginia","Tazewell County",2,70,565,274,291
050,51,185,"Virginia","Tazewell County",2,71,544,260,284
050,51,185,"Virginia","Tazewell County",2,72,525,247,278
050,51,185,"Virginia","Tazewell County",2,73,560,270,290
050,51,185,"Virginia","Tazewell County",2,74,374,178,196
050,51,185,"Virginia","Tazewell County",2,75,364,164,200
050,51,185,"Virginia","Tazewell County",2,76,354,166,188
050,51,185,"Virginia","Tazewell County",2,77,348,156,192
050,51,185,"Virginia","Tazewell County",2,78,302,128,174
050,51,185,"Virginia","Tazewell County",2,79,268,111,157
050,51,185,"Virginia","Tazewell County",2,80,236,90,146
050,51,185,"Virginia","Tazewell County",2,81,217,92,125
050,51,185,"Virginia","Tazewell County",2,82,216,90,126
050,51,185,"Virginia","Tazewell County",2,83,189,76,113
050,51,185,"Virginia","Tazewell County",2,84,161,67,94
050,51,185,"Virginia","Tazewell County",2,85,988,340,648
050,51,185,"Virginia","Tazewell County",3,0,297,150,147
050,51,185,"Virginia","Tazewell County",3,1,385,191,194
050,51,185,"Virginia","Tazewell County",3,2,363,183,180
050,51,185,"Virginia","Tazewell County",3,3,408,191,217
050,51,185,"Virginia","Tazewell County",3,4,388,195,193
050,51,185,"Virginia","Tazewell County",3,5,428,208,220
050,51,185,"Virginia","Tazewell County",3,6,441,212,229
050,51,185,"Virginia","Tazewell County",3,7,430,213,217
050,51,185,"Virginia","Tazewell County",3,8,400,213,187
050,51,185,"Virginia","Tazewell County",3,9,403,213,190
050,51,185,"Virginia","Tazewell County",3,10,429,218,211
050,51,185,"Virginia","Tazewell County",3,11,433,224,209
050,51,185,"Virginia","Tazewell County",3,12,457,226,231
050,51,185,"Virginia","Tazewell County",3,13,483,234,249
050,51,185,"Virginia","Tazewell County",3,14,482,237,245
050,51,185,"Virginia","Tazewell County",3,15,483,246,237
050,51,185,"Virginia","Tazewell County",3,16,491,241,250
050,51,185,"Virginia","Tazewell County",3,17,499,257,242
050,51,185,"Virginia","Tazewell County",3,18,465,236,229
050,51,185,"Virginia","Tazewell County",3,19,418,202,216
050,51,185,"Virginia","Tazewell County",3,20,408,211,197
050,51,185,"Virginia","Tazewell County",3,21,415,216,199
050,51,185,"Virginia","Tazewell County",3,22,446,252,194
050,51,185,"Virginia","Tazewell County",3,23,441,232,209
050,51,185,"Virginia","Tazewell County",3,24,444,241,203
050,51,185,"Virginia","Tazewell County",3,25,456,259,197
050,51,185,"Virginia","Tazewell County",3,26,433,235,198
050,51,185,"Virginia","Tazewell County",3,27,464,257,207
050,51,185,"Virginia","Tazewell County",3,28,469,260,209
050,51,185,"Virginia","Tazewell County",3,29,434,233,201
050,51,185,"Virginia","Tazewell County",3,30,450,249,201
050,51,185,"Virginia","Tazewell County",3,31,457,266,191
050,51,185,"Virginia","Tazewell County",3,32,432,236,196
050,51,185,"Virginia","Tazewell County",3,33,463,261,202
050,51,185,"Virginia","Tazewell County",3,34,433,244,189
050,51,185,"Virginia","Tazewell County",3,35,428,230,198
050,51,185,"Virginia","Tazewell County",3,36,447,240,207
050,51,185,"Virginia","Tazewell County",3,37,431,241,190
050,51,185,"Virginia","Tazewell County",3,38,465,260,205
050,51,185,"Virginia","Tazewell County",3,39,478,261,217
050,51,185,"Virginia","Tazewell County",3,40,461,253,208
050,51,185,"Virginia","Tazewell County",3,41,494,274,220
050,51,185,"Virginia","Tazewell County",3,42,504,265,239
050,51,185,"Virginia","Tazewell County",3,43,515,271,244
050,51,185,"Virginia","Tazewell County",3,44,491,257,234
050,51,185,"Virginia","Tazewell County",3,45,472,246,226
050,51,185,"Virginia","Tazewell County",3,46,513,276,237
050,51,185,"Virginia","Tazewell County",3,47,520,288,232
050,51,185,"Virginia","Tazewell County",3,48,524,272,252
050,51,185,"Virginia","Tazewell County",3,49,541,279,262
050,51,185,"Virginia","Tazewell County",3,50,551,287,264
050,51,185,"Virginia","Tazewell County",3,51,532,270,262
050,51,185,"Virginia","Tazewell County",3,52,493,248,245
050,51,185,"Virginia","Tazewell County",3,53,494,246,248
050,51,185,"Virginia","Tazewell County",3,54,486,239,247
050,51,185,"Virginia","Tazewell County",3,55,489,241,248
050,51,185,"Virginia","Tazewell County",3,56,546,261,285
050,51,185,"Virginia","Tazewell County",3,57,573,275,298
050,51,185,"Virginia","Tazewell County",3,58,572,277,295
050,51,185,"Virginia","Tazewell County",3,59,531,242,289
050,51,185,"Virginia","Tazewell County",3,60,531,244,287
050,51,185,"Virginia","Tazewell County",3,61,575,277,298
050,51,185,"Virginia","Tazewell County",3,62,583,286,297
050,51,185,"Virginia","Tazewell County",3,63,603,290,313
050,51,185,"Virginia","Tazewell County",3,64,629,306,323
050,51,185,"Virginia","Tazewell County",3,65,614,286,328
050,51,185,"Virginia","Tazewell County",3,66,587,269,318
050,51,185,"Virginia","Tazewell County",3,67,576,271,305
050,51,185,"Virginia","Tazewell County",3,68,586,278,308
050,51,185,"Virginia","Tazewell County",3,69,580,287,293
050,51,185,"Virginia","Tazewell County",3,70,566,276,290
050,51,185,"Virginia","Tazewell County",3,71,555,263,292
050,51,185,"Virginia","Tazewell County",3,72,503,235,268
050,51,185,"Virginia","Tazewell County",3,73,519,241,278
050,51,185,"Virginia","Tazewell County",3,74,530,257,273
050,51,185,"Virginia","Tazewell County",3,75,354,166,188
050,51,185,"Virginia","Tazewell County",3,76,335,154,181
050,51,185,"Virginia","Tazewell County",3,77,335,153,182
050,51,185,"Virginia","Tazewell County",3,78,333,146,187
050,51,185,"Virginia","Tazewell County",3,79,275,116,159
050,51,185,"Virginia","Tazewell County",3,80,252,104,148
050,51,185,"Virginia","Tazewell County",3,81,223,84,139
050,51,185,"Virginia","Tazewell County",3,82,202,85,117
050,51,185,"Virginia","Tazewell County",3,83,194,83,111
050,51,185,"Virginia","Tazewell County",3,84,166,68,98
050,51,185,"Virginia","Tazewell County",3,85,965,339,626
050,51,185,"Virginia","Tazewell County",4,0,260,132,128
050,51,185,"Virginia","Tazewell County",4,1,302,154,148
050,51,185,"Virginia","Tazewell County",4,2,402,198,204
050,51,185,"Virginia","Tazewell County",4,3,369,187,182
050,51,185,"Virginia","Tazewell County",4,4,407,196,211
050,51,185,"Virginia","Tazewell County",4,5,397,201,196
050,51,185,"Virginia","Tazewell County",4,6,446,216,230
050,51,185,"Virginia","Tazewell County",4,7,445,214,231
050,51,185,"Virginia","Tazewell County",4,8,437,215,222
050,51,185,"Virginia","Tazewell County",4,9,416,215,201
050,51,185,"Virginia","Tazewell County",4,10,410,218,192
050,51,185,"Virginia","Tazewell County",4,11,447,227,220
050,51,185,"Virginia","Tazewell County",4,12,439,229,210
050,51,185,"Virginia","Tazewell County",4,13,471,238,233
050,51,185,"Virginia","Tazewell County",4,14,474,236,238
050,51,185,"Virginia","Tazewell County",4,15,487,242,245
050,51,185,"Virginia","Tazewell County",4,16,494,257,237
050,51,185,"Virginia","Tazewell County",4,17,499,246,253
050,51,185,"Virginia","Tazewell County",4,18,470,255,215
050,51,185,"Virginia","Tazewell County",4,19,415,201,214
050,51,185,"Virginia","Tazewell County",4,20,422,209,213
050,51,185,"Virginia","Tazewell County",4,21,422,231,191
050,51,185,"Virginia","Tazewell County",4,22,410,223,187
050,51,185,"Virginia","Tazewell County",4,23,446,250,196
050,51,185,"Virginia","Tazewell County",4,24,474,257,217
050,51,185,"Virginia","Tazewell County",4,25,432,236,196
050,51,185,"Virginia","Tazewell County",4,26,439,255,184
050,51,185,"Virginia","Tazewell County",4,27,434,238,196
050,51,185,"Virginia","Tazewell County",4,28,437,239,198
050,51,185,"Virginia","Tazewell County",4,29,447,237,210
050,51,185,"Virginia","Tazewell County",4,30,445,242,203
050,51,185,"Virginia","Tazewell County",4,31,442,246,196
050,51,185,"Virginia","Tazewell County",4,32,467,272,195
050,51,185,"Virginia","Tazewell County",4,33,452,249,203
050,51,185,"Virginia","Tazewell County",4,34,467,268,199
050,51,185,"Virginia","Tazewell County",4,35,421,226,195
050,51,185,"Virginia","Tazewell County",4,36,438,237,201
050,51,185,"Virginia","Tazewell County",4,37,441,235,206
050,51,185,"Virginia","Tazewell County",4,38,432,239,193
050,51,185,"Virginia","Tazewell County",4,39,461,250,211
050,51,185,"Virginia","Tazewell County",4,40,468,251,217
050,51,185,"Virginia","Tazewell County",4,41,471,264,207
050,51,185,"Virginia","Tazewell County",4,42,484,259,225
050,51,185,"Virginia","Tazewell County",4,43,508,269,239
050,51,185,"Virginia","Tazewell County",4,44,512,269,243
050,51,185,"Virginia","Tazewell County",4,45,477,240,237
050,51,185,"Virginia","Tazewell County",4,46,470,241,229
050,51,185,"Virginia","Tazewell County",4,47,520,282,238
050,51,185,"Virginia","Tazewell County",4,48,505,276,229
050,51,185,"Virginia","Tazewell County",4,49,528,275,253
050,51,185,"Virginia","Tazewell County",4,50,531,274,257
050,51,185,"Virginia","Tazewell County",4,51,539,277,262
050,51,185,"Virginia","Tazewell County",4,52,526,267,259
050,51,185,"Virginia","Tazewell County",4,53,482,236,246
050,51,185,"Virginia","Tazewell County",4,54,492,243,249
050,51,185,"Virginia","Tazewell County",4,55,480,238,242
050,51,185,"Virginia","Tazewell County",4,56,505,258,247
050,51,185,"Virginia","Tazewell County",4,57,536,248,288
050,51,185,"Virginia","Tazewell County",4,58,570,271,299
050,51,185,"Virginia","Tazewell County",4,59,556,274,282
050,51,185,"Virginia","Tazewell County",4,60,526,231,295
050,51,185,"Virginia","Tazewell County",4,61,522,241,281
050,51,185,"Virginia","Tazewell County",4,62,560,265,295
050,51,185,"Virginia","Tazewell County",4,63,565,271,294
050,51,185,"Virginia","Tazewell County",4,64,592,283,309
050,51,185,"Virginia","Tazewell County",4,65,624,300,324
050,51,185,"Virginia","Tazewell County",4,66,602,276,326
050,51,185,"Virginia","Tazewell County",4,67,580,264,316
050,51,185,"Virginia","Tazewell County",4,68,565,259,306
050,51,185,"Virginia","Tazewell County",4,69,565,266,299
050,51,185,"Virginia","Tazewell County",4,70,565,278,287
050,51,185,"Virginia","Tazewell County",4,71,543,266,277
050,51,185,"Virginia","Tazewell County",4,72,533,252,281
050,51,185,"Virginia","Tazewell County",4,73,491,233,258
050,51,185,"Virginia","Tazewell County",4,74,487,225,262
050,51,185,"Virginia","Tazewell County",4,75,508,242,266
050,51,185,"Virginia","Tazewell County",4,76,328,155,173
050,51,185,"Virginia","Tazewell County",4,77,306,142,164
050,51,185,"Virginia","Tazewell County",4,78,325,146,179
050,51,185,"Virginia","Tazewell County",4,79,300,130,170
050,51,185,"Virginia","Tazewell County",4,80,267,114,153
050,51,185,"Virginia","Tazewell County",4,81,236,97,139
050,51,185,"Virginia","Tazewell County",4,82,199,69,130
050,51,185,"Virginia","Tazewell County",4,83,188,82,106
050,51,185,"Virginia","Tazewell County",4,84,170,72,98
050,51,185,"Virginia","Tazewell County",4,85,940,348,592
050,51,185,"Virginia","Tazewell County",5,0,239,120,119
050,51,185,"Virginia","Tazewell County",5,1,275,146,129
050,51,185,"Virginia","Tazewell County",5,2,296,155,141
050,51,185,"Virginia","Tazewell County",5,3,415,212,203
050,51,185,"Virginia","Tazewell County",5,4,368,191,177
050,51,185,"Virginia","Tazewell County",5,5,412,197,215
050,51,185,"Virginia","Tazewell County",5,6,409,215,194
050,51,185,"Virginia","Tazewell County",5,7,447,219,228
050,51,185,"Virginia","Tazewell County",5,8,441,210,231
050,51,185,"Virginia","Tazewell County",5,9,445,221,224
050,51,185,"Virginia","Tazewell County",5,10,428,225,203
050,51,185,"Virginia","Tazewell County",5,11,410,219,191
050,51,185,"Virginia","Tazewell County",5,12,441,215,226
050,51,185,"Virginia","Tazewell County",5,13,457,241,216
050,51,185,"Virginia","Tazewell County",5,14,478,238,240
050,51,185,"Virginia","Tazewell County",5,15,487,243,244
050,51,185,"Virginia","Tazewell County",5,16,490,242,248
050,51,185,"Virginia","Tazewell County",5,17,492,253,239
050,51,185,"Virginia","Tazewell County",5,18,466,227,239
050,51,185,"Virginia","Tazewell County",5,19,419,216,203
050,51,185,"Virginia","Tazewell County",5,20,436,223,213
050,51,185,"Virginia","Tazewell County",5,21,432,225,207
050,51,185,"Virginia","Tazewell County",5,22,424,241,183
050,51,185,"Virginia","Tazewell County",5,23,403,216,187
050,51,185,"Virginia","Tazewell County",5,24,464,262,202
050,51,185,"Virginia","Tazewell County",5,25,461,256,205
050,51,185,"Virginia","Tazewell County",5,26,407,224,183
050,51,185,"Virginia","Tazewell County",5,27,450,262,188
050,51,185,"Virginia","Tazewell County",5,28,423,237,186
050,51,185,"Virginia","Tazewell County",5,29,444,236,208
050,51,185,"Virginia","Tazewell County",5,30,462,257,205
050,51,185,"Virginia","Tazewell County",5,31,452,236,216
050,51,185,"Virginia","Tazewell County",5,32,429,247,182
050,51,185,"Virginia","Tazewell County",5,33,495,292,203
050,51,185,"Virginia","Tazewell County",5,34,439,234,205
050,51,185,"Virginia","Tazewell County",5,35,448,252,196
050,51,185,"Virginia","Tazewell County",5,36,432,230,202
050,51,185,"Virginia","Tazewell County",5,37,450,253,197
050,51,185,"Virginia","Tazewell County",5,38,439,241,198
050,51,185,"Virginia","Tazewell County",5,39,422,227,195
050,51,185,"Virginia","Tazewell County",5,40,465,251,214
050,51,185,"Virginia","Tazewell County",5,41,473,259,214
050,51,185,"Virginia","Tazewell County",5,42,443,238,205
050,51,185,"Virginia","Tazewell County",5,43,490,263,227
050,51,185,"Virginia","Tazewell County",5,44,498,269,229
050,51,185,"Virginia","Tazewell County",5,45,499,257,242
050,51,185,"Virginia","Tazewell County",5,46,480,242,238
050,51,185,"Virginia","Tazewell County",5,47,471,247,224
050,51,185,"Virginia","Tazewell County",5,48,503,267,236
050,51,185,"Virginia","Tazewell County",5,49,501,270,231
050,51,185,"Virginia","Tazewell County",5,50,520,270,250
050,51,185,"Virginia","Tazewell County",5,51,519,264,255
050,51,185,"Virginia","Tazewell County",5,52,531,274,257
050,51,185,"Virginia","Tazewell County",5,53,522,256,266
050,51,185,"Virginia","Tazewell County",5,54,477,230,247
050,51,185,"Virginia","Tazewell County",5,55,492,239,253
050,51,185,"Virginia","Tazewell County",5,56,488,248,240
050,51,185,"Virginia","Tazewell County",5,57,495,253,242
050,51,185,"Virginia","Tazewell County",5,58,518,237,281
050,51,185,"Virginia","Tazewell County",5,59,564,272,292
050,51,185,"Virginia","Tazewell County",5,60,550,263,287
050,51,185,"Virginia","Tazewell County",5,61,522,234,288
050,51,185,"Virginia","Tazewell County",5,62,509,230,279
050,51,185,"Virginia","Tazewell County",5,63,525,245,280
050,51,185,"Virginia","Tazewell County",5,64,561,267,294
050,51,185,"Virginia","Tazewell County",5,65,567,274,293
050,51,185,"Virginia","Tazewell County",5,66,619,300,319
050,51,185,"Virginia","Tazewell County",5,67,588,270,318
050,51,185,"Virginia","Tazewell County",5,68,576,251,325
050,51,185,"Virginia","Tazewell County",5,69,543,244,299
050,51,185,"Virginia","Tazewell County",5,70,547,259,288
050,51,185,"Virginia","Tazewell County",5,71,549,272,277
050,51,185,"Virginia","Tazewell County",5,72,519,253,266
050,51,185,"Virginia","Tazewell County",5,73,513,242,271
050,51,185,"Virginia","Tazewell County",5,74,466,221,245
050,51,185,"Virginia","Tazewell County",5,75,467,211,256
050,51,185,"Virginia","Tazewell County",5,76,481,228,253
050,51,185,"Virginia","Tazewell County",5,77,310,142,168
050,51,185,"Virginia","Tazewell County",5,78,293,131,162
050,51,185,"Virginia","Tazewell County",5,79,296,136,160
050,51,185,"Virginia","Tazewell County",5,80,288,124,164
050,51,185,"Virginia","Tazewell County",5,81,252,106,146
050,51,185,"Virginia","Tazewell County",5,82,216,85,131
050,51,185,"Virginia","Tazewell County",5,83,179,66,113
050,51,185,"Virginia","Tazewell County",5,84,170,74,96
050,51,185,"Virginia","Tazewell County",5,85,938,366,572
050,51,187,"Virginia","Warren County",1,0,498,254,244
050,51,187,"Virginia","Warren County",1,1,500,253,247
050,51,187,"Virginia","Warren County",1,2,486,245,241
050,51,187,"Virginia","Warren County",1,3,477,238,239
050,51,187,"Virginia","Warren County",1,4,477,250,227
050,51,187,"Virginia","Warren County",1,5,522,265,257
050,51,187,"Virginia","Warren County",1,6,491,256,235
050,51,187,"Virginia","Warren County",1,7,470,241,229
050,51,187,"Virginia","Warren County",1,8,460,244,216
050,51,187,"Virginia","Warren County",1,9,461,235,226
050,51,187,"Virginia","Warren County",1,10,447,243,204
050,51,187,"Virginia","Warren County",1,11,486,246,240
050,51,187,"Virginia","Warren County",1,12,535,274,261
050,51,187,"Virginia","Warren County",1,13,533,274,259
050,51,187,"Virginia","Warren County",1,14,513,272,241
050,51,187,"Virginia","Warren County",1,15,506,254,252
050,51,187,"Virginia","Warren County",1,16,522,270,252
050,51,187,"Virginia","Warren County",1,17,521,269,252
050,51,187,"Virginia","Warren County",1,18,459,225,234
050,51,187,"Virginia","Warren County",1,19,453,229,224
050,51,187,"Virginia","Warren County",1,20,469,249,220
050,51,187,"Virginia","Warren County",1,21,475,247,228
050,51,187,"Virginia","Warren County",1,22,474,252,222
050,51,187,"Virginia","Warren County",1,23,470,239,231
050,51,187,"Virginia","Warren County",1,24,479,252,227
050,51,187,"Virginia","Warren County",1,25,496,242,254
050,51,187,"Virginia","Warren County",1,26,490,253,237
050,51,187,"Virginia","Warren County",1,27,535,276,259
050,51,187,"Virginia","Warren County",1,28,537,276,261
050,51,187,"Virginia","Warren County",1,29,533,273,260
050,51,187,"Virginia","Warren County",1,30,571,273,298
050,51,187,"Virginia","Warren County",1,31,566,297,269
050,51,187,"Virginia","Warren County",1,32,543,273,270
050,51,187,"Virginia","Warren County",1,33,588,299,289
050,51,187,"Virginia","Warren County",1,34,514,278,236
050,51,187,"Virginia","Warren County",1,35,510,280,230
050,51,187,"Virginia","Warren County",1,36,484,254,230
050,51,187,"Virginia","Warren County",1,37,481,244,237
050,51,187,"Virginia","Warren County",1,38,532,281,251
050,51,187,"Virginia","Warren County",1,39,511,265,246
050,51,187,"Virginia","Warren County",1,40,477,240,237
050,51,187,"Virginia","Warren County",1,41,475,258,217
050,51,187,"Virginia","Warren County",1,42,486,262,224
050,51,187,"Virginia","Warren County",1,43,441,223,218
050,51,187,"Virginia","Warren County",1,44,456,231,225
050,51,187,"Virginia","Warren County",1,45,458,242,216
050,51,187,"Virginia","Warren County",1,46,475,241,234
050,51,187,"Virginia","Warren County",1,47,500,244,256
050,51,187,"Virginia","Warren County",1,48,520,257,263
050,51,187,"Virginia","Warren County",1,49,586,291,295
050,51,187,"Virginia","Warren County",1,50,537,286,251
050,51,187,"Virginia","Warren County",1,51,526,280,246
050,51,187,"Virginia","Warren County",1,52,539,274,265
050,51,187,"Virginia","Warren County",1,53,596,302,294
050,51,187,"Virginia","Warren County",1,54,638,331,307
050,51,187,"Virginia","Warren County",1,55,674,345,329
050,51,187,"Virginia","Warren County",1,56,670,347,323
050,51,187,"Virginia","Warren County",1,57,663,344,319
050,51,187,"Virginia","Warren County",1,58,637,331,306
050,51,187,"Virginia","Warren County",1,59,670,341,329
050,51,187,"Virginia","Warren County",1,60,642,328,314
050,51,187,"Virginia","Warren County",1,61,603,295,308
050,51,187,"Virginia","Warren County",1,62,586,301,285
050,51,187,"Virginia","Warren County",1,63,558,276,282
050,51,187,"Virginia","Warren County",1,64,547,272,275
050,51,187,"Virginia","Warren County",1,65,518,267,251
050,51,187,"Virginia","Warren County",1,66,498,259,239
050,51,187,"Virginia","Warren County",1,67,446,227,219
050,51,187,"Virginia","Warren County",1,68,472,244,228
050,51,187,"Virginia","Warren County",1,69,405,190,215
050,51,187,"Virginia","Warren County",1,70,387,195,192
050,51,187,"Virginia","Warren County",1,71,385,202,183
050,51,187,"Virginia","Warren County",1,72,389,170,219
050,51,187,"Virginia","Warren County",1,73,380,185,195
050,51,187,"Virginia","Warren County",1,74,272,126,146
050,51,187,"Virginia","Warren County",1,75,268,117,151
050,51,187,"Virginia","Warren County",1,76,253,116,137
050,51,187,"Virginia","Warren County",1,77,264,129,135
050,51,187,"Virginia","Warren County",1,78,217,103,114
050,51,187,"Virginia","Warren County",1,79,185,94,91
050,51,187,"Virginia","Warren County",1,80,181,85,96
050,51,187,"Virginia","Warren County",1,81,159,64,95
050,51,187,"Virginia","Warren County",1,82,128,54,74
050,51,187,"Virginia","Warren County",1,83,121,49,72
050,51,187,"Virginia","Warren County",1,84,138,67,71
050,51,187,"Virginia","Warren County",1,85,620,214,406
050,51,187,"Virginia","Warren County",2,0,491,254,237
050,51,187,"Virginia","Warren County",2,1,499,251,248
050,51,187,"Virginia","Warren County",2,2,490,248,242
050,51,187,"Virginia","Warren County",2,3,475,239,236
050,51,187,"Virginia","Warren County",2,4,476,245,231
050,51,187,"Virginia","Warren County",2,5,510,260,250
050,51,187,"Virginia","Warren County",2,6,501,261,240
050,51,187,"Virginia","Warren County",2,7,477,248,229
050,51,187,"Virginia","Warren County",2,8,461,242,219
050,51,187,"Virginia","Warren County",2,9,460,238,222
050,51,187,"Virginia","Warren County",2,10,450,238,212
050,51,187,"Virginia","Warren County",2,11,476,245,231
050,51,187,"Virginia","Warren County",2,12,527,269,258
050,51,187,"Virginia","Warren County",2,13,534,276,258
050,51,187,"Virginia","Warren County",2,14,519,272,247
050,51,187,"Virginia","Warren County",2,15,508,259,249
050,51,187,"Virginia","Warren County",2,16,522,269,253
050,51,187,"Virginia","Warren County",2,17,522,268,254
050,51,187,"Virginia","Warren County",2,18,461,232,229
050,51,187,"Virginia","Warren County",2,19,449,225,224
050,51,187,"Virginia","Warren County",2,20,473,250,223
050,51,187,"Virginia","Warren County",2,21,476,252,224
050,51,187,"Virginia","Warren County",2,22,471,247,224
050,51,187,"Virginia","Warren County",2,23,471,242,229
050,51,187,"Virginia","Warren County",2,24,477,247,230
050,51,187,"Virginia","Warren County",2,25,489,243,246
050,51,187,"Virginia","Warren County",2,26,501,256,245
050,51,187,"Virginia","Warren County",2,27,523,269,254
050,51,187,"Virginia","Warren County",2,28,540,277,263
050,51,187,"Virginia","Warren County",2,29,536,272,264
050,51,187,"Virginia","Warren County",2,30,567,275,292
050,51,187,"Virginia","Warren County",2,31,566,290,276
050,51,187,"Virginia","Warren County",2,32,546,279,267
050,51,187,"Virginia","Warren County",2,33,570,289,281
050,51,187,"Virginia","Warren County",2,34,533,284,249
050,51,187,"Virginia","Warren County",2,35,519,284,235
050,51,187,"Virginia","Warren County",2,36,486,257,229
050,51,187,"Virginia","Warren County",2,37,483,245,238
050,51,187,"Virginia","Warren County",2,38,527,275,252
050,51,187,"Virginia","Warren County",2,39,513,266,247
050,51,187,"Virginia","Warren County",2,40,493,252,241
050,51,187,"Virginia","Warren County",2,41,475,252,223
050,51,187,"Virginia","Warren County",2,42,483,260,223
050,51,187,"Virginia","Warren County",2,43,454,233,221
050,51,187,"Virginia","Warren County",2,44,447,227,220
050,51,187,"Virginia","Warren County",2,45,459,240,219
050,51,187,"Virginia","Warren County",2,46,470,241,229
050,51,187,"Virginia","Warren County",2,47,496,246,250
050,51,187,"Virginia","Warren County",2,48,515,255,260
050,51,187,"Virginia","Warren County",2,49,573,285,288
050,51,187,"Virginia","Warren County",2,50,551,288,263
050,51,187,"Virginia","Warren County",2,51,529,282,247
050,51,187,"Virginia","Warren County",2,52,534,274,260
050,51,187,"Virginia","Warren County",2,53,583,297,286
050,51,187,"Virginia","Warren County",2,54,629,325,304
050,51,187,"Virginia","Warren County",2,55,665,340,325
050,51,187,"Virginia","Warren County",2,56,673,349,324
050,51,187,"Virginia","Warren County",2,57,665,346,319
050,51,187,"Virginia","Warren County",2,58,643,334,309
050,51,187,"Virginia","Warren County",2,59,667,342,325
050,51,187,"Virginia","Warren County",2,60,644,329,315
050,51,187,"Virginia","Warren County",2,61,606,300,306
050,51,187,"Virginia","Warren County",2,62,588,297,291
050,51,187,"Virginia","Warren County",2,63,568,283,285
050,51,187,"Virginia","Warren County",2,64,541,270,271
050,51,187,"Virginia","Warren County",2,65,524,267,257
050,51,187,"Virginia","Warren County",2,66,501,260,241
050,51,187,"Virginia","Warren County",2,67,459,233,226
050,51,187,"Virginia","Warren County",2,68,461,238,223
050,51,187,"Virginia","Warren County",2,69,423,203,220
050,51,187,"Virginia","Warren County",2,70,387,190,197
050,51,187,"Virginia","Warren County",2,71,387,199,188
050,51,187,"Virginia","Warren County",2,72,383,175,208
050,51,187,"Virginia","Warren County",2,73,401,192,209
050,51,187,"Virginia","Warren County",2,74,280,132,148
050,51,187,"Virginia","Warren County",2,75,271,120,151
050,51,187,"Virginia","Warren County",2,76,252,114,138
050,51,187,"Virginia","Warren County",2,77,265,125,140
050,51,187,"Virginia","Warren County",2,78,222,106,116
050,51,187,"Virginia","Warren County",2,79,187,93,94
050,51,187,"Virginia","Warren County",2,80,181,87,94
050,51,187,"Virginia","Warren County",2,81,163,67,96
050,51,187,"Virginia","Warren County",2,82,134,56,78
050,51,187,"Virginia","Warren County",2,83,122,49,73
050,51,187,"Virginia","Warren County",2,84,135,63,72
050,51,187,"Virginia","Warren County",2,85,628,221,407
050,51,187,"Virginia","Warren County",3,0,425,204,221
050,51,187,"Virginia","Warren County",3,1,495,258,237
050,51,187,"Virginia","Warren County",3,2,526,264,262
050,51,187,"Virginia","Warren County",3,3,494,254,240
050,51,187,"Virginia","Warren County",3,4,496,247,249
050,51,187,"Virginia","Warren County",3,5,457,237,220
050,51,187,"Virginia","Warren County",3,6,523,272,251
050,51,187,"Virginia","Warren County",3,7,497,260,237
050,51,187,"Virginia","Warren County",3,8,496,266,230
050,51,187,"Virginia","Warren County",3,9,456,240,216
050,51,187,"Virginia","Warren County",3,10,457,234,223
050,51,187,"Virginia","Warren County",3,11,442,226,216
050,51,187,"Virginia","Warren County",3,12,482,247,235
050,51,187,"Virginia","Warren County",3,13,531,276,255
050,51,187,"Virginia","Warren County",3,14,532,280,252
050,51,187,"Virginia","Warren County",3,15,517,274,243
050,51,187,"Virginia","Warren County",3,16,515,263,252
050,51,187,"Virginia","Warren County",3,17,538,272,266
050,51,187,"Virginia","Warren County",3,18,489,261,228
050,51,187,"Virginia","Warren County",3,19,446,219,227
050,51,187,"Virginia","Warren County",3,20,448,226,222
050,51,187,"Virginia","Warren County",3,21,497,260,237
050,51,187,"Virginia","Warren County",3,22,456,231,225
050,51,187,"Virginia","Warren County",3,23,466,244,222
050,51,187,"Virginia","Warren County",3,24,446,230,216
050,51,187,"Virginia","Warren County",3,25,478,260,218
050,51,187,"Virginia","Warren County",3,26,494,243,251
050,51,187,"Virginia","Warren County",3,27,498,258,240
050,51,187,"Virginia","Warren County",3,28,537,268,269
050,51,187,"Virginia","Warren County",3,29,559,279,280
050,51,187,"Virginia","Warren County",3,30,565,286,279
050,51,187,"Virginia","Warren County",3,31,586,291,295
050,51,187,"Virginia","Warren County",3,32,567,289,278
050,51,187,"Virginia","Warren County",3,33,553,281,272
050,51,187,"Virginia","Warren County",3,34,583,296,287
050,51,187,"Virginia","Warren County",3,35,552,307,245
050,51,187,"Virginia","Warren County",3,36,510,273,237
050,51,187,"Virginia","Warren County",3,37,501,266,235
050,51,187,"Virginia","Warren County",3,38,507,258,249
050,51,187,"Virginia","Warren County",3,39,541,282,259
050,51,187,"Virginia","Warren County",3,40,531,284,247
050,51,187,"Virginia","Warren County",3,41,506,251,255
050,51,187,"Virginia","Warren County",3,42,492,263,229
050,51,187,"Virginia","Warren County",3,43,500,268,232
050,51,187,"Virginia","Warren County",3,44,464,241,223
050,51,187,"Virginia","Warren County",3,45,439,232,207
050,51,187,"Virginia","Warren County",3,46,447,231,216
050,51,187,"Virginia","Warren County",3,47,470,247,223
050,51,187,"Virginia","Warren County",3,48,484,244,240
050,51,187,"Virginia","Warren County",3,49,522,255,267
050,51,187,"Virginia","Warren County",3,50,576,292,284
050,51,187,"Virginia","Warren County",3,51,550,288,262
050,51,187,"Virginia","Warren County",3,52,514,267,247
050,51,187,"Virginia","Warren County",3,53,517,263,254
050,51,187,"Virginia","Warren County",3,54,583,303,280
050,51,187,"Virginia","Warren County",3,55,614,321,293
050,51,187,"Virginia","Warren County",3,56,673,341,332
050,51,187,"Virginia","Warren County",3,57,669,346,323
050,51,187,"Virginia","Warren County",3,58,639,333,306
050,51,187,"Virginia","Warren County",3,59,642,337,305
050,51,187,"Virginia","Warren County",3,60,637,325,312
050,51,187,"Virginia","Warren County",3,61,638,321,317
050,51,187,"Virginia","Warren County",3,62,611,307,304
050,51,187,"Virginia","Warren County",3,63,563,283,280
050,51,187,"Virginia","Warren County",3,64,547,274,273
050,51,187,"Virginia","Warren County",3,65,536,271,265
050,51,187,"Virginia","Warren County",3,66,520,274,246
050,51,187,"Virginia","Warren County",3,67,479,243,236
050,51,187,"Virginia","Warren County",3,68,452,229,223
050,51,187,"Virginia","Warren County",3,69,446,226,220
050,51,187,"Virginia","Warren County",3,70,415,199,216
050,51,187,"Virginia","Warren County",3,71,378,182,196
050,51,187,"Virginia","Warren County",3,72,374,191,183
050,51,187,"Virginia","Warren County",3,73,359,160,199
050,51,187,"Virginia","Warren County",3,74,392,185,207
050,51,187,"Virginia","Warren County",3,75,271,131,140
050,51,187,"Virginia","Warren County",3,76,251,111,140
050,51,187,"Virginia","Warren County",3,77,242,100,142
050,51,187,"Virginia","Warren County",3,78,251,112,139
050,51,187,"Virginia","Warren County",3,79,206,103,103
050,51,187,"Virginia","Warren County",3,80,177,87,90
050,51,187,"Virginia","Warren County",3,81,184,85,99
050,51,187,"Virginia","Warren County",3,82,146,57,89
050,51,187,"Virginia","Warren County",3,83,125,55,70
050,51,187,"Virginia","Warren County",3,84,124,49,75
050,51,187,"Virginia","Warren County",3,85,651,231,420
050,51,187,"Virginia","Warren County",4,0,450,233,217
050,51,187,"Virginia","Warren County",4,1,453,227,226
050,51,187,"Virginia","Warren County",4,2,497,258,239
050,51,187,"Virginia","Warren County",4,3,522,256,266
050,51,187,"Virginia","Warren County",4,4,515,265,250
050,51,187,"Virginia","Warren County",4,5,517,262,255
050,51,187,"Virginia","Warren County",4,6,458,240,218
050,51,187,"Virginia","Warren County",4,7,525,264,261
050,51,187,"Virginia","Warren County",4,8,511,262,249
050,51,187,"Virginia","Warren County",4,9,501,272,229
050,51,187,"Virginia","Warren County",4,10,445,233,212
050,51,187,"Virginia","Warren County",4,11,481,242,239
050,51,187,"Virginia","Warren County",4,12,452,231,221
050,51,187,"Virginia","Warren County",4,13,489,247,242
050,51,187,"Virginia","Warren County",4,14,537,281,256
050,51,187,"Virginia","Warren County",4,15,536,287,249
050,51,187,"Virginia","Warren County",4,16,503,269,234
050,51,187,"Virginia","Warren County",4,17,529,264,265
050,51,187,"Virginia","Warren County",4,18,511,277,234
050,51,187,"Virginia","Warren County",4,19,430,228,202
050,51,187,"Virginia","Warren County",4,20,448,215,233
050,51,187,"Virginia","Warren County",4,21,467,231,236
050,51,187,"Virginia","Warren County",4,22,505,253,252
050,51,187,"Virginia","Warren County",4,23,449,223,226
050,51,187,"Virginia","Warren County",4,24,495,254,241
050,51,187,"Virginia","Warren County",4,25,447,225,222
050,51,187,"Virginia","Warren County",4,26,514,273,241
050,51,187,"Virginia","Warren County",4,27,515,256,259
050,51,187,"Virginia","Warren County",4,28,512,265,247
050,51,187,"Virginia","Warren County",4,29,567,286,281
050,51,187,"Virginia","Warren County",4,30,568,283,285
050,51,187,"Virginia","Warren County",4,31,590,293,297
050,51,187,"Virginia","Warren County",4,32,607,313,294
050,51,187,"Virginia","Warren County",4,33,576,297,279
050,51,187,"Virginia","Warren County",4,34,571,282,289
050,51,187,"Virginia","Warren County",4,35,588,298,290
050,51,187,"Virginia","Warren County",4,36,566,315,251
050,51,187,"Virginia","Warren County",4,37,527,278,249
050,51,187,"Virginia","Warren County",4,38,529,292,237
050,51,187,"Virginia","Warren County",4,39,520,272,248
050,51,187,"Virginia","Warren County",4,40,564,301,263
050,51,187,"Virginia","Warren County",4,41,541,278,263
050,51,187,"Virginia","Warren County",4,42,517,256,261
050,51,187,"Virginia","Warren County",4,43,501,268,233
050,51,187,"Virginia","Warren County",4,44,499,263,236
050,51,187,"Virginia","Warren County",4,45,443,231,212
050,51,187,"Virginia","Warren County",4,46,455,233,222
050,51,187,"Virginia","Warren County",4,47,456,236,220
050,51,187,"Virginia","Warren County",4,48,463,244,219
050,51,187,"Virginia","Warren County",4,49,499,251,248
050,51,187,"Virginia","Warren County",4,50,511,242,269
050,51,187,"Virginia","Warren County",4,51,582,306,276
050,51,187,"Virginia","Warren County",4,52,553,288,265
050,51,187,"Virginia","Warren County",4,53,507,264,243
050,51,187,"Virginia","Warren County",4,54,525,269,256
050,51,187,"Virginia","Warren County",4,55,579,314,265
050,51,187,"Virginia","Warren County",4,56,606,322,284
050,51,187,"Virginia","Warren County",4,57,666,341,325
050,51,187,"Virginia","Warren County",4,58,686,363,323
050,51,187,"Virginia","Warren County",4,59,636,327,309
050,51,187,"Virginia","Warren County",4,60,624,323,301
050,51,187,"Virginia","Warren County",4,61,620,312,308
050,51,187,"Virginia","Warren County",4,62,629,319,310
050,51,187,"Virginia","Warren County",4,63,611,305,306
050,51,187,"Virginia","Warren County",4,64,558,284,274
050,51,187,"Virginia","Warren County",4,65,542,266,276
050,51,187,"Virginia","Warren County",4,66,534,268,266
050,51,187,"Virginia","Warren County",4,67,501,267,234
050,51,187,"Virginia","Warren County",4,68,458,235,223
050,51,187,"Virginia","Warren County",4,69,441,225,216
050,51,187,"Virginia","Warren County",4,70,429,219,210
050,51,187,"Virginia","Warren County",4,71,414,196,218
050,51,187,"Virginia","Warren County",4,72,368,178,190
050,51,187,"Virginia","Warren County",4,73,351,178,173
050,51,187,"Virginia","Warren County",4,74,352,153,199
050,51,187,"Virginia","Warren County",4,75,373,177,196
050,51,187,"Virginia","Warren County",4,76,251,125,126
050,51,187,"Virginia","Warren County",4,77,232,92,140
050,51,187,"Virginia","Warren County",4,78,230,91,139
050,51,187,"Virginia","Warren County",4,79,240,113,127
050,51,187,"Virginia","Warren County",4,80,192,94,98
050,51,187,"Virginia","Warren County",4,81,174,79,95
050,51,187,"Virginia","Warren County",4,82,157,72,85
050,51,187,"Virginia","Warren County",4,83,141,57,84
050,51,187,"Virginia","Warren County",4,84,128,57,71
050,51,187,"Virginia","Warren County",4,85,642,223,419
050,51,187,"Virginia","Warren County",5,0,443,231,212
050,51,187,"Virginia","Warren County",5,1,467,237,230
050,51,187,"Virginia","Warren County",5,2,484,241,243
050,51,187,"Virginia","Warren County",5,3,502,253,249
050,51,187,"Virginia","Warren County",5,4,533,261,272
050,51,187,"Virginia","Warren County",5,5,519,265,254
050,51,187,"Virginia","Warren County",5,6,513,266,247
050,51,187,"Virginia","Warren County",5,7,482,250,232
050,51,187,"Virginia","Warren County",5,8,513,272,241
050,51,187,"Virginia","Warren County",5,9,512,272,240
050,51,187,"Virginia","Warren County",5,10,499,272,227
050,51,187,"Virginia","Warren County",5,11,461,231,230
050,51,187,"Virginia","Warren County",5,12,485,243,242
050,51,187,"Virginia","Warren County",5,13,451,232,219
050,51,187,"Virginia","Warren County",5,14,502,261,241
050,51,187,"Virginia","Warren County",5,15,545,278,267
050,51,187,"Virginia","Warren County",5,16,563,297,266
050,51,187,"Virginia","Warren County",5,17,515,268,247
050,51,187,"Virginia","Warren County",5,18,495,260,235
050,51,187,"Virginia","Warren County",5,19,467,245,222
050,51,187,"Virginia","Warren County",5,20,452,236,216
050,51,187,"Virginia","Warren County",5,21,467,231,236
050,51,187,"Virginia","Warren County",5,22,490,223,267
050,51,187,"Virginia","Warren County",5,23,543,279,264
050,51,187,"Virginia","Warren County",5,24,466,232,234
050,51,187,"Virginia","Warren County",5,25,512,271,241
050,51,187,"Virginia","Warren County",5,26,460,220,240
050,51,187,"Virginia","Warren County",5,27,520,275,245
050,51,187,"Virginia","Warren County",5,28,517,259,258
050,51,187,"Virginia","Warren County",5,29,542,273,269
050,51,187,"Virginia","Warren County",5,30,581,292,289
050,51,187,"Virginia","Warren County",5,31,597,293,304
050,51,187,"Virginia","Warren County",5,32,579,292,287
050,51,187,"Virginia","Warren County",5,33,618,321,297
050,51,187,"Virginia","Warren County",5,34,584,307,277
050,51,187,"Virginia","Warren County",5,35,571,285,286
050,51,187,"Virginia","Warren County",5,36,598,299,299
050,51,187,"Virginia","Warren County",5,37,572,312,260
050,51,187,"Virginia","Warren County",5,38,549,306,243
050,51,187,"Virginia","Warren County",5,39,517,291,226
050,51,187,"Virginia","Warren County",5,40,535,288,247
050,51,187,"Virginia","Warren County",5,41,554,295,259
050,51,187,"Virginia","Warren County",5,42,552,287,265
050,51,187,"Virginia","Warren County",5,43,522,262,260
050,51,187,"Virginia","Warren County",5,44,494,264,230
050,51,187,"Virginia","Warren County",5,45,480,257,223
050,51,187,"Virginia","Warren County",5,46,445,228,217
050,51,187,"Virginia","Warren County",5,47,458,241,217
050,51,187,"Virginia","Warren County",5,48,444,228,216
050,51,187,"Virginia","Warren County",5,49,461,239,222
050,51,187,"Virginia","Warren County",5,50,499,249,250
050,51,187,"Virginia","Warren County",5,51,530,255,275
050,51,187,"Virginia","Warren County",5,52,594,310,284
050,51,187,"Virginia","Warren County",5,53,578,301,277
050,51,187,"Virginia","Warren County",5,54,527,277,250
050,51,187,"Virginia","Warren County",5,55,526,268,258
050,51,187,"Virginia","Warren County",5,56,582,315,267
050,51,187,"Virginia","Warren County",5,57,597,314,283
050,51,187,"Virginia","Warren County",5,58,673,342,331
050,51,187,"Virginia","Warren County",5,59,680,359,321
050,51,187,"Virginia","Warren County",5,60,627,319,308
050,51,187,"Virginia","Warren County",5,61,608,313,295
050,51,187,"Virginia","Warren County",5,62,614,315,299
050,51,187,"Virginia","Warren County",5,63,625,319,306
050,51,187,"Virginia","Warren County",5,64,597,296,301
050,51,187,"Virginia","Warren County",5,65,538,268,270
050,51,187,"Virginia","Warren County",5,66,535,265,270
050,51,187,"Virginia","Warren County",5,67,518,253,265
050,51,187,"Virginia","Warren County",5,68,485,262,223
050,51,187,"Virginia","Warren County",5,69,454,235,219
050,51,187,"Virginia","Warren County",5,70,435,223,212
050,51,187,"Virginia","Warren County",5,71,425,217,208
050,51,187,"Virginia","Warren County",5,72,414,196,218
050,51,187,"Virginia","Warren County",5,73,348,166,182
050,51,187,"Virginia","Warren County",5,74,335,169,166
050,51,187,"Virginia","Warren County",5,75,344,150,194
050,51,187,"Virginia","Warren County",5,76,356,176,180
050,51,187,"Virginia","Warren County",5,77,228,109,119
050,51,187,"Virginia","Warren County",5,78,222,81,141
050,51,187,"Virginia","Warren County",5,79,209,84,125
050,51,187,"Virginia","Warren County",5,80,224,102,122
050,51,187,"Virginia","Warren County",5,81,186,84,102
050,51,187,"Virginia","Warren County",5,82,149,68,81
050,51,187,"Virginia","Warren County",5,83,152,72,80
050,51,187,"Virginia","Warren County",5,84,140,56,84
050,51,187,"Virginia","Warren County",5,85,658,234,424
050,51,191,"Virginia","Washington County",1,0,452,232,220
050,51,191,"Virginia","Washington County",1,1,432,220,212
050,51,191,"Virginia","Washington County",1,2,439,205,234
050,51,191,"Virginia","Washington County",1,3,454,231,223
050,51,191,"Virginia","Washington County",1,4,500,270,230
050,51,191,"Virginia","Washington County",1,5,459,248,211
050,51,191,"Virginia","Washington County",1,6,487,267,220
050,51,191,"Virginia","Washington County",1,7,498,250,248
050,51,191,"Virginia","Washington County",1,8,531,271,260
050,51,191,"Virginia","Washington County",1,9,535,288,247
050,51,191,"Virginia","Washington County",1,10,602,323,279
050,51,191,"Virginia","Washington County",1,11,623,330,293
050,51,191,"Virginia","Washington County",1,12,618,309,309
050,51,191,"Virginia","Washington County",1,13,602,296,306
050,51,191,"Virginia","Washington County",1,14,599,302,297
050,51,191,"Virginia","Washington County",1,15,580,297,283
050,51,191,"Virginia","Washington County",1,16,628,322,306
050,51,191,"Virginia","Washington County",1,17,630,305,325
050,51,191,"Virginia","Washington County",1,18,639,329,310
050,51,191,"Virginia","Washington County",1,19,656,356,300
050,51,191,"Virginia","Washington County",1,20,607,309,298
050,51,191,"Virginia","Washington County",1,21,621,325,296
050,51,191,"Virginia","Washington County",1,22,563,295,268
050,51,191,"Virginia","Washington County",1,23,540,287,253
050,51,191,"Virginia","Washington County",1,24,546,291,255
050,51,191,"Virginia","Washington County",1,25,542,294,248
050,51,191,"Virginia","Washington County",1,26,539,270,269
050,51,191,"Virginia","Washington County",1,27,592,303,289
050,51,191,"Virginia","Washington County",1,28,575,311,264
050,51,191,"Virginia","Washington County",1,29,609,317,292
050,51,191,"Virginia","Washington County",1,30,556,295,261
050,51,191,"Virginia","Washington County",1,31,565,298,267
050,51,191,"Virginia","Washington County",1,32,551,285,266
050,51,191,"Virginia","Washington County",1,33,552,286,266
050,51,191,"Virginia","Washington County",1,34,581,301,280
050,51,191,"Virginia","Washington County",1,35,536,286,250
050,51,191,"Virginia","Washington County",1,36,544,285,259
050,51,191,"Virginia","Washington County",1,37,627,315,312
050,51,191,"Virginia","Washington County",1,38,646,334,312
050,51,191,"Virginia","Washington County",1,39,625,324,301
050,51,191,"Virginia","Washington County",1,40,668,316,352
050,51,191,"Virginia","Washington County",1,41,637,311,326
050,51,191,"Virginia","Washington County",1,42,607,304,303
050,51,191,"Virginia","Washington County",1,43,588,311,277
050,51,191,"Virginia","Washington County",1,44,605,318,287
050,51,191,"Virginia","Washington County",1,45,680,343,337
050,51,191,"Virginia","Washington County",1,46,674,329,345
050,51,191,"Virginia","Washington County",1,47,728,387,341
050,51,191,"Virginia","Washington County",1,48,735,370,365
050,51,191,"Virginia","Washington County",1,49,781,383,398
050,51,191,"Virginia","Washington County",1,50,703,354,349
050,51,191,"Virginia","Washington County",1,51,712,357,355
050,51,191,"Virginia","Washington County",1,52,720,361,359
050,51,191,"Virginia","Washington County",1,53,742,387,355
050,51,191,"Virginia","Washington County",1,54,778,408,370
050,51,191,"Virginia","Washington County",1,55,805,408,397
050,51,191,"Virginia","Washington County",1,56,812,394,418
050,51,191,"Virginia","Washington County",1,57,818,392,426
050,51,191,"Virginia","Washington County",1,58,814,408,406
050,51,191,"Virginia","Washington County",1,59,872,429,443
050,51,191,"Virginia","Washington County",1,60,904,406,498
050,51,191,"Virginia","Washington County",1,61,839,386,453
050,51,191,"Virginia","Washington County",1,62,818,393,425
050,51,191,"Virginia","Washington County",1,63,812,396,416
050,51,191,"Virginia","Washington County",1,64,846,404,442
050,51,191,"Virginia","Washington County",1,65,842,418,424
050,51,191,"Virginia","Washington County",1,66,848,416,432
050,51,191,"Virginia","Washington County",1,67,800,382,418
050,51,191,"Virginia","Washington County",1,68,755,377,378
050,51,191,"Virginia","Washington County",1,69,735,351,384
050,51,191,"Virginia","Washington County",1,70,733,344,389
050,51,191,"Virginia","Washington County",1,71,766,388,378
050,51,191,"Virginia","Washington County",1,72,750,355,395
050,51,191,"Virginia","Washington County",1,73,741,345,396
050,51,191,"Virginia","Washington County",1,74,507,232,275
050,51,191,"Virginia","Washington County",1,75,548,270,278
050,51,191,"Virginia","Washington County",1,76,509,238,271
050,51,191,"Virginia","Washington County",1,77,507,218,289
050,51,191,"Virginia","Washington County",1,78,449,208,241
050,51,191,"Virginia","Washington County",1,79,416,181,235
050,51,191,"Virginia","Washington County",1,80,369,167,202
050,51,191,"Virginia","Washington County",1,81,356,162,194
050,51,191,"Virginia","Washington County",1,82,328,152,176
050,51,191,"Virginia","Washington County",1,83,282,133,149
050,51,191,"Virginia","Washington County",1,84,265,119,146
050,51,191,"Virginia","Washington County",1,85,1251,451,800
050,51,191,"Virginia","Washington County",2,0,449,236,213
050,51,191,"Virginia","Washington County",2,1,436,221,215
050,51,191,"Virginia","Washington County",2,2,439,209,230
050,51,191,"Virginia","Washington County",2,3,450,225,225
050,51,191,"Virginia","Washington County",2,4,490,261,229
050,51,191,"Virginia","Washington County",2,5,469,254,215
050,51,191,"Virginia","Washington County",2,6,479,261,218
050,51,191,"Virginia","Washington County",2,7,496,255,241
050,51,191,"Virginia","Washington County",2,8,520,265,255
050,51,191,"Virginia","Washington County",2,9,532,283,249
050,51,191,"Virginia","Washington County",2,10,586,314,272
050,51,191,"Virginia","Washington County",2,11,615,327,288
050,51,191,"Virginia","Washington County",2,12,620,314,306
050,51,191,"Virginia","Washington County",2,13,604,298,306
050,51,191,"Virginia","Washington County",2,14,597,298,299
050,51,191,"Virginia","Washington County",2,15,585,301,284
050,51,191,"Virginia","Washington County",2,16,618,317,301
050,51,191,"Virginia","Washington County",2,17,632,310,322
050,51,191,"Virginia","Washington County",2,18,637,326,311
050,51,191,"Virginia","Washington County",2,19,654,353,301
050,51,191,"Virginia","Washington County",2,20,616,311,305
050,51,191,"Virginia","Washington County",2,21,621,324,297
050,51,191,"Virginia","Washington County",2,22,572,299,273
050,51,191,"Virginia","Washington County",2,23,533,281,252
050,51,191,"Virginia","Washington County",2,24,543,289,254
050,51,191,"Virginia","Washington County",2,25,543,291,252
050,51,191,"Virginia","Washington County",2,26,537,272,265
050,51,191,"Virginia","Washington County",2,27,580,298,282
050,51,191,"Virginia","Washington County",2,28,584,312,272
050,51,191,"Virginia","Washington County",2,29,595,311,284
050,51,191,"Virginia","Washington County",2,30,568,300,268
050,51,191,"Virginia","Washington County",2,31,555,292,263
050,51,191,"Virginia","Washington County",2,32,552,286,266
050,51,191,"Virginia","Washington County",2,33,557,288,269
050,51,191,"Virginia","Washington County",2,34,571,295,276
050,51,191,"Virginia","Washington County",2,35,551,292,259
050,51,191,"Virginia","Washington County",2,36,539,284,255
050,51,191,"Virginia","Washington County",2,37,616,311,305
050,51,191,"Virginia","Washington County",2,38,645,329,316
050,51,191,"Virginia","Washington County",2,39,631,327,304
050,51,191,"Virginia","Washington County",2,40,660,319,341
050,51,191,"Virginia","Washington County",2,41,643,311,332
050,51,191,"Virginia","Washington County",2,42,608,302,306
050,51,191,"Virginia","Washington County",2,43,595,309,286
050,51,191,"Virginia","Washington County",2,44,604,315,289
050,51,191,"Virginia","Washington County",2,45,666,338,328
050,51,191,"Virginia","Washington County",2,46,673,332,341
050,51,191,"Virginia","Washington County",2,47,715,375,340
050,51,191,"Virginia","Washington County",2,48,736,377,359
050,51,191,"Virginia","Washington County",2,49,774,383,391
050,51,191,"Virginia","Washington County",2,50,719,359,360
050,51,191,"Virginia","Washington County",2,51,710,357,353
050,51,191,"Virginia","Washington County",2,52,712,356,356
050,51,191,"Virginia","Washington County",2,53,738,381,357
050,51,191,"Virginia","Washington County",2,54,771,405,366
050,51,191,"Virginia","Washington County",2,55,792,405,387
050,51,191,"Virginia","Washington County",2,56,810,395,415
050,51,191,"Virginia","Washington County",2,57,820,394,426
050,51,191,"Virginia","Washington County",2,58,817,404,413
050,51,191,"Virginia","Washington County",2,59,867,429,438
050,51,191,"Virginia","Washington County",2,60,891,408,483
050,51,191,"Virginia","Washington County",2,61,851,387,464
050,51,191,"Virginia","Washington County",2,62,823,392,431
050,51,191,"Virginia","Washington County",2,63,824,401,423
050,51,191,"Virginia","Washington County",2,64,830,399,431
050,51,191,"Virginia","Washington County",2,65,845,414,431
050,51,191,"Virginia","Washington County",2,66,851,418,433
050,51,191,"Virginia","Washington County",2,67,809,390,419
050,51,191,"Virginia","Washington County",2,68,763,377,386
050,51,191,"Virginia","Washington County",2,69,738,354,384
050,51,191,"Virginia","Washington County",2,70,729,344,385
050,51,191,"Virginia","Washington County",2,71,746,373,373
050,51,191,"Virginia","Washington County",2,72,739,356,383
050,51,191,"Virginia","Washington County",2,73,779,365,414
050,51,191,"Virginia","Washington County",2,74,528,243,285
050,51,191,"Virginia","Washington County",2,75,538,259,279
050,51,191,"Virginia","Washington County",2,76,510,241,269
050,51,191,"Virginia","Washington County",2,77,518,228,290
050,51,191,"Virginia","Washington County",2,78,451,207,244
050,51,191,"Virginia","Washington County",2,79,417,182,235
050,51,191,"Virginia","Washington County",2,80,375,167,208
050,51,191,"Virginia","Washington County",2,81,353,160,193
050,51,191,"Virginia","Washington County",2,82,330,151,179
050,51,191,"Virginia","Washington County",2,83,285,133,152
050,51,191,"Virginia","Washington County",2,84,265,121,144
050,51,191,"Virginia","Washington County",2,85,1260,457,803
050,51,191,"Virginia","Washington County",3,0,464,237,227
050,51,191,"Virginia","Washington County",3,1,451,229,222
050,51,191,"Virginia","Washington County",3,2,447,221,226
050,51,191,"Virginia","Washington County",3,3,457,210,247
050,51,191,"Virginia","Washington County",3,4,464,230,234
050,51,191,"Virginia","Washington County",3,5,503,271,232
050,51,191,"Virginia","Washington County",3,6,459,257,202
050,51,191,"Virginia","Washington County",3,7,496,278,218
050,51,191,"Virginia","Washington County",3,8,500,254,246
050,51,191,"Virginia","Washington County",3,9,517,267,250
050,51,191,"Virginia","Washington County",3,10,537,284,253
050,51,191,"Virginia","Washington County",3,11,582,313,269
050,51,191,"Virginia","Washington County",3,12,609,320,289
050,51,191,"Virginia","Washington County",3,13,617,306,311
050,51,191,"Virginia","Washington County",3,14,620,309,311
050,51,191,"Virginia","Washington County",3,15,599,303,296
050,51,191,"Virginia","Washington County",3,16,589,306,283
050,51,191,"Virginia","Washington County",3,17,616,314,302
050,51,191,"Virginia","Washington County",3,18,662,336,326
050,51,191,"Virginia","Washington County",3,19,638,352,286
050,51,191,"Virginia","Washington County",3,20,608,301,307
050,51,191,"Virginia","Washington County",3,21,658,334,324
050,51,191,"Virginia","Washington County",3,22,583,298,285
050,51,191,"Virginia","Washington County",3,23,570,301,269
050,51,191,"Virginia","Washington County",3,24,531,286,245
050,51,191,"Virginia","Washington County",3,25,533,281,252
050,51,191,"Virginia","Washington County",3,26,534,282,252
050,51,191,"Virginia","Washington County",3,27,534,276,258
050,51,191,"Virginia","Washington County",3,28,561,289,272
050,51,191,"Virginia","Washington County",3,29,584,313,271
050,51,191,"Virginia","Washington County",3,30,595,319,276
050,51,191,"Virginia","Washington County",3,31,565,294,271
050,51,191,"Virginia","Washington County",3,32,570,301,269
050,51,191,"Virginia","Washington County",3,33,578,299,279
050,51,191,"Virginia","Washington County",3,34,568,292,276
050,51,191,"Virginia","Washington County",3,35,576,301,275
050,51,191,"Virginia","Washington County",3,36,556,305,251
050,51,191,"Virginia","Washington County",3,37,552,280,272
050,51,191,"Virginia","Washington County",3,38,612,307,305
050,51,191,"Virginia","Washington County",3,39,655,333,322
050,51,191,"Virginia","Washington County",3,40,623,319,304
050,51,191,"Virginia","Washington County",3,41,661,313,348
050,51,191,"Virginia","Washington County",3,42,629,305,324
050,51,191,"Virginia","Washington County",3,43,597,303,294
050,51,191,"Virginia","Washington County",3,44,600,307,293
050,51,191,"Virginia","Washington County",3,45,598,306,292
050,51,191,"Virginia","Washington County",3,46,655,333,322
050,51,191,"Virginia","Washington County",3,47,702,351,351
050,51,191,"Virginia","Washington County",3,48,710,373,337
050,51,191,"Virginia","Washington County",3,49,734,362,372
050,51,191,"Virginia","Washington County",3,50,762,378,384
050,51,191,"Virginia","Washington County",3,51,730,362,368
050,51,191,"Virginia","Washington County",3,52,694,341,353
050,51,191,"Virginia","Washington County",3,53,724,371,353
050,51,191,"Virginia","Washington County",3,54,738,383,355
050,51,191,"Virginia","Washington County",3,55,758,400,358
050,51,191,"Virginia","Washington County",3,56,792,410,382
050,51,191,"Virginia","Washington County",3,57,817,396,421
050,51,191,"Virginia","Washington County",3,58,805,382,423
050,51,191,"Virginia","Washington County",3,59,815,409,406
050,51,191,"Virginia","Washington County",3,60,856,418,438
050,51,191,"Virginia","Washington County",3,61,882,413,469
050,51,191,"Virginia","Washington County",3,62,855,381,474
050,51,191,"Virginia","Washington County",3,63,828,394,434
050,51,191,"Virginia","Washington County",3,64,790,383,407
050,51,191,"Virginia","Washington County",3,65,835,399,436
050,51,191,"Virginia","Washington County",3,66,821,397,424
050,51,191,"Virginia","Washington County",3,67,848,422,426
050,51,191,"Virginia","Washington County",3,68,801,378,423
050,51,191,"Virginia","Washington County",3,69,755,373,382
050,51,191,"Virginia","Washington County",3,70,732,348,384
050,51,191,"Virginia","Washington County",3,71,696,323,373
050,51,191,"Virginia","Washington County",3,72,719,353,366
050,51,191,"Virginia","Washington County",3,73,724,353,371
050,51,191,"Virginia","Washington County",3,74,762,352,410
050,51,191,"Virginia","Washington County",3,75,523,238,285
050,51,191,"Virginia","Washington County",3,76,513,246,267
050,51,191,"Virginia","Washington County",3,77,488,230,258
050,51,191,"Virginia","Washington County",3,78,477,213,264
050,51,191,"Virginia","Washington County",3,79,454,205,249
050,51,191,"Virginia","Washington County",3,80,381,159,222
050,51,191,"Virginia","Washington County",3,81,362,162,200
050,51,191,"Virginia","Washington County",3,82,326,150,176
050,51,191,"Virginia","Washington County",3,83,299,135,164
050,51,191,"Virginia","Washington County",3,84,253,122,131
050,51,191,"Virginia","Washington County",3,85,1261,482,779
050,51,191,"Virginia","Washington County",4,0,447,232,215
050,51,191,"Virginia","Washington County",4,1,463,230,233
050,51,191,"Virginia","Washington County",4,2,454,227,227
050,51,191,"Virginia","Washington County",4,3,452,223,229
050,51,191,"Virginia","Washington County",4,4,472,223,249
050,51,191,"Virginia","Washington County",4,5,477,243,234
050,51,191,"Virginia","Washington County",4,6,503,272,231
050,51,191,"Virginia","Washington County",4,7,480,266,214
050,51,191,"Virginia","Washington County",4,8,493,274,219
050,51,191,"Virginia","Washington County",4,9,505,251,254
050,51,191,"Virginia","Washington County",4,10,524,267,257
050,51,191,"Virginia","Washington County",4,11,539,279,260
050,51,191,"Virginia","Washington County",4,12,586,315,271
050,51,191,"Virginia","Washington County",4,13,615,325,290
050,51,191,"Virginia","Washington County",4,14,625,305,320
050,51,191,"Virginia","Washington County",4,15,626,312,314
050,51,191,"Virginia","Washington County",4,16,620,303,317
050,51,191,"Virginia","Washington County",4,17,576,298,278
050,51,191,"Virginia","Washington County",4,18,636,335,301
050,51,191,"Virginia","Washington County",4,19,635,342,293
050,51,191,"Virginia","Washington County",4,20,590,300,290
050,51,191,"Virginia","Washington County",4,21,634,319,315
050,51,191,"Virginia","Washington County",4,22,620,306,314
050,51,191,"Virginia","Washington County",4,23,546,285,261
050,51,191,"Virginia","Washington County",4,24,592,309,283
050,51,191,"Virginia","Washington County",4,25,548,290,258
050,51,191,"Virginia","Washington County",4,26,526,266,260
050,51,191,"Virginia","Washington County",4,27,550,298,252
050,51,191,"Virginia","Washington County",4,28,552,293,259
050,51,191,"Virginia","Washington County",4,29,572,289,283
050,51,191,"Virginia","Washington County",4,30,591,330,261
050,51,191,"Virginia","Washington County",4,31,580,306,274
050,51,191,"Virginia","Washington County",4,32,579,307,272
050,51,191,"Virginia","Washington County",4,33,591,310,281
050,51,191,"Virginia","Washington County",4,34,562,290,272
050,51,191,"Virginia","Washington County",4,35,575,298,277
050,51,191,"Virginia","Washington County",4,36,575,295,280
050,51,191,"Virginia","Washington County",4,37,560,305,255
050,51,191,"Virginia","Washington County",4,38,549,275,274
050,51,191,"Virginia","Washington County",4,39,646,327,319
050,51,191,"Virginia","Washington County",4,40,639,325,314
050,51,191,"Virginia","Washington County",4,41,649,328,321
050,51,191,"Virginia","Washington County",4,42,662,315,347
050,51,191,"Virginia","Washington County",4,43,642,321,321
050,51,191,"Virginia","Washington County",4,44,606,311,295
050,51,191,"Virginia","Washington County",4,45,605,309,296
050,51,191,"Virginia","Washington County",4,46,596,298,298
050,51,191,"Virginia","Washington County",4,47,670,344,326
050,51,191,"Virginia","Washington County",4,48,699,351,348
050,51,191,"Virginia","Washington County",4,49,720,370,350
050,51,191,"Virginia","Washington County",4,50,710,349,361
050,51,191,"Virginia","Washington County",4,51,774,385,389
050,51,191,"Virginia","Washington County",4,52,724,359,365
050,51,191,"Virginia","Washington County",4,53,715,359,356
050,51,191,"Virginia","Washington County",4,54,739,376,363
050,51,191,"Virginia","Washington County",4,55,747,385,362
050,51,191,"Virginia","Washington County",4,56,758,395,363
050,51,191,"Virginia","Washington County",4,57,785,400,385
050,51,191,"Virginia","Washington County",4,58,824,400,424
050,51,191,"Virginia","Washington County",4,59,812,386,426
050,51,191,"Virginia","Washington County",4,60,787,396,391
050,51,191,"Virginia","Washington County",4,61,863,421,442
050,51,191,"Virginia","Washington County",4,62,886,416,470
050,51,191,"Virginia","Washington County",4,63,853,370,483
050,51,191,"Virginia","Washington County",4,64,820,389,431
050,51,191,"Virginia","Washington County",4,65,787,376,411
050,51,191,"Virginia","Washington County",4,66,820,383,437
050,51,191,"Virginia","Washington County",4,67,820,395,425
050,51,191,"Virginia","Washington County",4,68,851,417,434
050,51,191,"Virginia","Washington County",4,69,788,374,414
050,51,191,"Virginia","Washington County",4,70,769,377,392
050,51,191,"Virginia","Washington County",4,71,706,334,372
050,51,191,"Virginia","Washington County",4,72,687,319,368
050,51,191,"Virginia","Washington County",4,73,696,340,356
050,51,191,"Virginia","Washington County",4,74,709,341,368
050,51,191,"Virginia","Washington County",4,75,759,347,412
050,51,191,"Virginia","Washington County",4,76,502,229,273
050,51,191,"Virginia","Washington County",4,77,503,239,264
050,51,191,"Virginia","Washington County",4,78,460,212,248
050,51,191,"Virginia","Washington County",4,79,464,202,262
050,51,191,"Virginia","Washington County",4,80,427,193,234
050,51,191,"Virginia","Washington County",4,81,358,143,215
050,51,191,"Virginia","Washington County",4,82,350,157,193
050,51,191,"Virginia","Washington County",4,83,303,134,169
050,51,191,"Virginia","Washington County",4,84,276,128,148
050,51,191,"Virginia","Washington County",4,85,1269,508,761
050,51,191,"Virginia","Washington County",5,0,447,235,212
050,51,191,"Virginia","Washington County",5,1,453,242,211
050,51,191,"Virginia","Washington County",5,2,487,240,247
050,51,191,"Virginia","Washington County",5,3,446,226,220
050,51,191,"Virginia","Washington County",5,4,464,234,230
050,51,191,"Virginia","Washington County",5,5,471,222,249
050,51,191,"Virginia","Washington County",5,6,497,255,242
050,51,191,"Virginia","Washington County",5,7,517,272,245
050,51,191,"Virginia","Washington County",5,8,487,271,216
050,51,191,"Virginia","Washington County",5,9,515,287,228
050,51,191,"Virginia","Washington County",5,10,518,262,256
050,51,191,"Virginia","Washington County",5,11,531,268,263
050,51,191,"Virginia","Washington County",5,12,553,280,273
050,51,191,"Virginia","Washington County",5,13,606,329,277
050,51,191,"Virginia","Washington County",5,14,618,321,297
050,51,191,"Virginia","Washington County",5,15,643,306,337
050,51,191,"Virginia","Washington County",5,16,619,305,314
050,51,191,"Virginia","Washington County",5,17,643,319,324
050,51,191,"Virginia","Washington County",5,18,598,322,276
050,51,191,"Virginia","Washington County",5,19,630,348,282
050,51,191,"Virginia","Washington County",5,20,594,300,294
050,51,191,"Virginia","Washington County",5,21,615,317,298
050,51,191,"Virginia","Washington County",5,22,608,307,301
050,51,191,"Virginia","Washington County",5,23,582,297,285
050,51,191,"Virginia","Washington County",5,24,564,304,260
050,51,191,"Virginia","Washington County",5,25,600,318,282
050,51,191,"Virginia","Washington County",5,26,525,275,250
050,51,191,"Virginia","Washington County",5,27,539,276,263
050,51,191,"Virginia","Washington County",5,28,550,295,255
050,51,191,"Virginia","Washington County",5,29,563,296,267
050,51,191,"Virginia","Washington County",5,30,604,310,294
050,51,191,"Virginia","Washington County",5,31,583,324,259
050,51,191,"Virginia","Washington County",5,32,570,294,276
050,51,191,"Virginia","Washington County",5,33,617,333,284
050,51,191,"Virginia","Washington County",5,34,605,318,287
050,51,191,"Virginia","Washington County",5,35,562,295,267
050,51,191,"Virginia","Washington County",5,36,571,284,287
050,51,191,"Virginia","Washington County",5,37,617,319,298
050,51,191,"Virginia","Washington County",5,38,560,296,264
050,51,191,"Virginia","Washington County",5,39,557,290,267
050,51,191,"Virginia","Washington County",5,40,649,328,321
050,51,191,"Virginia","Washington County",5,41,642,311,331
050,51,191,"Virginia","Washington County",5,42,643,323,320
050,51,191,"Virginia","Washington County",5,43,664,330,334
050,51,191,"Virginia","Washington County",5,44,639,320,319
050,51,191,"Virginia","Washington County",5,45,595,302,293
050,51,191,"Virginia","Washington County",5,46,607,307,300
050,51,191,"Virginia","Washington County",5,47,628,327,301
050,51,191,"Virginia","Washington County",5,48,674,352,322
050,51,191,"Virginia","Washington County",5,49,699,341,358
050,51,191,"Virginia","Washington County",5,50,706,358,348
050,51,191,"Virginia","Washington County",5,51,730,360,370
050,51,191,"Virginia","Washington County",5,52,759,381,378
050,51,191,"Virginia","Washington County",5,53,730,371,359
050,51,191,"Virginia","Washington County",5,54,705,353,352
050,51,191,"Virginia","Washington County",5,55,754,382,372
050,51,191,"Virginia","Washington County",5,56,754,388,366
050,51,191,"Virginia","Washington County",5,57,762,392,370
050,51,191,"Virginia","Washington County",5,58,792,405,387
050,51,191,"Virginia","Washington County",5,59,830,410,420
050,51,191,"Virginia","Washington County",5,60,818,385,433
050,51,191,"Virginia","Washington County",5,61,797,396,401
050,51,191,"Virginia","Washington County",5,62,870,421,449
050,51,191,"Virginia","Washington County",5,63,878,410,468
050,51,191,"Virginia","Washington County",5,64,831,365,466
050,51,191,"Virginia","Washington County",5,65,819,389,430
050,51,191,"Virginia","Washington County",5,66,783,368,415
050,51,191,"Virginia","Washington County",5,67,821,389,432
050,51,191,"Virginia","Washington County",5,68,817,390,427
050,51,191,"Virginia","Washington County",5,69,833,408,425
050,51,191,"Virginia","Washington County",5,70,793,375,418
050,51,191,"Virginia","Washington County",5,71,734,358,376
050,51,191,"Virginia","Washington County",5,72,686,322,364
050,51,191,"Virginia","Washington County",5,73,660,306,354
050,51,191,"Virginia","Washington County",5,74,686,333,353
050,51,191,"Virginia","Washington County",5,75,692,333,359
050,51,191,"Virginia","Washington County",5,76,734,335,399
050,51,191,"Virginia","Washington County",5,77,491,224,267
050,51,191,"Virginia","Washington County",5,78,476,220,256
050,51,191,"Virginia","Washington County",5,79,453,205,248
050,51,191,"Virginia","Washington County",5,80,429,185,244
050,51,191,"Virginia","Washington County",5,81,405,178,227
050,51,191,"Virginia","Washington County",5,82,343,137,206
050,51,191,"Virginia","Washington County",5,83,315,139,176
050,51,191,"Virginia","Washington County",5,84,280,127,153
050,51,191,"Virginia","Washington County",5,85,1315,542,773
050,51,193,"Virginia","Westmoreland County",1,0,180,92,88
050,51,193,"Virginia","Westmoreland County",1,1,193,92,101
050,51,193,"Virginia","Westmoreland County",1,2,184,96,88
050,51,193,"Virginia","Westmoreland County",1,3,192,102,90
050,51,193,"Virginia","Westmoreland County",1,4,200,101,99
050,51,193,"Virginia","Westmoreland County",1,5,202,103,99
050,51,193,"Virginia","Westmoreland County",1,6,183,98,85
050,51,193,"Virginia","Westmoreland County",1,7,181,91,90
050,51,193,"Virginia","Westmoreland County",1,8,180,90,90
050,51,193,"Virginia","Westmoreland County",1,9,183,96,87
050,51,193,"Virginia","Westmoreland County",1,10,192,104,88
050,51,193,"Virginia","Westmoreland County",1,11,193,105,88
050,51,193,"Virginia","Westmoreland County",1,12,206,103,103
050,51,193,"Virginia","Westmoreland County",1,13,214,124,90
050,51,193,"Virginia","Westmoreland County",1,14,204,104,100
050,51,193,"Virginia","Westmoreland County",1,15,201,104,97
050,51,193,"Virginia","Westmoreland County",1,16,208,101,107
050,51,193,"Virginia","Westmoreland County",1,17,197,91,106
050,51,193,"Virginia","Westmoreland County",1,18,174,95,79
050,51,193,"Virginia","Westmoreland County",1,19,134,67,67
050,51,193,"Virginia","Westmoreland County",1,20,152,78,74
050,51,193,"Virginia","Westmoreland County",1,21,158,69,89
050,51,193,"Virginia","Westmoreland County",1,22,163,73,90
050,51,193,"Virginia","Westmoreland County",1,23,173,82,91
050,51,193,"Virginia","Westmoreland County",1,24,194,99,95
050,51,193,"Virginia","Westmoreland County",1,25,202,93,109
050,51,193,"Virginia","Westmoreland County",1,26,197,95,102
050,51,193,"Virginia","Westmoreland County",1,27,216,113,103
050,51,193,"Virginia","Westmoreland County",1,28,217,131,86
050,51,193,"Virginia","Westmoreland County",1,29,235,129,106
050,51,193,"Virginia","Westmoreland County",1,30,222,108,114
050,51,193,"Virginia","Westmoreland County",1,31,201,105,96
050,51,193,"Virginia","Westmoreland County",1,32,210,105,105
050,51,193,"Virginia","Westmoreland County",1,33,195,103,92
050,51,193,"Virginia","Westmoreland County",1,34,184,91,93
050,51,193,"Virginia","Westmoreland County",1,35,211,105,106
050,51,193,"Virginia","Westmoreland County",1,36,199,103,96
050,51,193,"Virginia","Westmoreland County",1,37,206,114,92
050,51,193,"Virginia","Westmoreland County",1,38,185,91,94
050,51,193,"Virginia","Westmoreland County",1,39,183,87,96
050,51,193,"Virginia","Westmoreland County",1,40,187,103,84
050,51,193,"Virginia","Westmoreland County",1,41,174,86,88
050,51,193,"Virginia","Westmoreland County",1,42,158,76,82
050,51,193,"Virginia","Westmoreland County",1,43,155,75,80
050,51,193,"Virginia","Westmoreland County",1,44,190,87,103
050,51,193,"Virginia","Westmoreland County",1,45,175,78,97
050,51,193,"Virginia","Westmoreland County",1,46,175,83,92
050,51,193,"Virginia","Westmoreland County",1,47,199,89,110
050,51,193,"Virginia","Westmoreland County",1,48,192,92,100
050,51,193,"Virginia","Westmoreland County",1,49,205,110,95
050,51,193,"Virginia","Westmoreland County",1,50,186,99,87
050,51,193,"Virginia","Westmoreland County",1,51,196,96,100
050,51,193,"Virginia","Westmoreland County",1,52,224,105,119
050,51,193,"Virginia","Westmoreland County",1,53,262,137,125
050,51,193,"Virginia","Westmoreland County",1,54,242,123,119
050,51,193,"Virginia","Westmoreland County",1,55,254,115,139
050,51,193,"Virginia","Westmoreland County",1,56,298,129,169
050,51,193,"Virginia","Westmoreland County",1,57,320,145,175
050,51,193,"Virginia","Westmoreland County",1,58,296,145,151
050,51,193,"Virginia","Westmoreland County",1,59,297,151,146
050,51,193,"Virginia","Westmoreland County",1,60,323,154,169
050,51,193,"Virginia","Westmoreland County",1,61,321,158,163
050,51,193,"Virginia","Westmoreland County",1,62,309,151,158
050,51,193,"Virginia","Westmoreland County",1,63,335,170,165
050,51,193,"Virginia","Westmoreland County",1,64,337,168,169
050,51,193,"Virginia","Westmoreland County",1,65,308,157,151
050,51,193,"Virginia","Westmoreland County",1,66,303,149,154
050,51,193,"Virginia","Westmoreland County",1,67,301,147,154
050,51,193,"Virginia","Westmoreland County",1,68,295,150,145
050,51,193,"Virginia","Westmoreland County",1,69,297,132,165
050,51,193,"Virginia","Westmoreland County",1,70,274,132,142
050,51,193,"Virginia","Westmoreland County",1,71,263,115,148
050,51,193,"Virginia","Westmoreland County",1,72,267,113,154
050,51,193,"Virginia","Westmoreland County",1,73,271,133,138
050,51,193,"Virginia","Westmoreland County",1,74,199,95,104
050,51,193,"Virginia","Westmoreland County",1,75,211,95,116
050,51,193,"Virginia","Westmoreland County",1,76,237,127,110
050,51,193,"Virginia","Westmoreland County",1,77,214,111,103
050,51,193,"Virginia","Westmoreland County",1,78,166,72,94
050,51,193,"Virginia","Westmoreland County",1,79,146,62,84
050,51,193,"Virginia","Westmoreland County",1,80,143,68,75
050,51,193,"Virginia","Westmoreland County",1,81,133,65,68
050,51,193,"Virginia","Westmoreland County",1,82,117,53,64
050,51,193,"Virginia","Westmoreland County",1,83,114,48,66
050,51,193,"Virginia","Westmoreland County",1,84,84,39,45
050,51,193,"Virginia","Westmoreland County",1,85,422,171,251
050,51,193,"Virginia","Westmoreland County",2,0,175,89,86
050,51,193,"Virginia","Westmoreland County",2,1,189,91,98
050,51,193,"Virginia","Westmoreland County",2,2,187,97,90
050,51,193,"Virginia","Westmoreland County",2,3,189,100,89
050,51,193,"Virginia","Westmoreland County",2,4,194,99,95
050,51,193,"Virginia","Westmoreland County",2,5,200,104,96
050,51,193,"Virginia","Westmoreland County",2,6,184,97,87
050,51,193,"Virginia","Westmoreland County",2,7,181,92,89
050,51,193,"Virginia","Westmoreland County",2,8,178,89,89
050,51,193,"Virginia","Westmoreland County",2,9,183,96,87
050,51,193,"Virginia","Westmoreland County",2,10,187,100,87
050,51,193,"Virginia","Westmoreland County",2,11,192,102,90
050,51,193,"Virginia","Westmoreland County",2,12,202,103,99
050,51,193,"Virginia","Westmoreland County",2,13,214,119,95
050,51,193,"Virginia","Westmoreland County",2,14,207,109,98
050,51,193,"Virginia","Westmoreland County",2,15,203,103,100
050,51,193,"Virginia","Westmoreland County",2,16,209,102,107
050,51,193,"Virginia","Westmoreland County",2,17,201,93,108
050,51,193,"Virginia","Westmoreland County",2,18,172,90,82
050,51,193,"Virginia","Westmoreland County",2,19,135,70,65
050,51,193,"Virginia","Westmoreland County",2,20,153,77,76
050,51,193,"Virginia","Westmoreland County",2,21,157,71,86
050,51,193,"Virginia","Westmoreland County",2,22,166,73,93
050,51,193,"Virginia","Westmoreland County",2,23,176,83,93
050,51,193,"Virginia","Westmoreland County",2,24,189,95,94
050,51,193,"Virginia","Westmoreland County",2,25,201,95,106
050,51,193,"Virginia","Westmoreland County",2,26,201,96,105
050,51,193,"Virginia","Westmoreland County",2,27,213,111,102
050,51,193,"Virginia","Westmoreland County",2,28,220,128,92
050,51,193,"Virginia","Westmoreland County",2,29,230,127,103
050,51,193,"Virginia","Westmoreland County",2,30,223,112,111
050,51,193,"Virginia","Westmoreland County",2,31,203,105,98
050,51,193,"Virginia","Westmoreland County",2,32,208,104,104
050,51,193,"Virginia","Westmoreland County",2,33,200,103,97
050,51,193,"Virginia","Westmoreland County",2,34,189,95,94
050,51,193,"Virginia","Westmoreland County",2,35,206,103,103
050,51,193,"Virginia","Westmoreland County",2,36,203,104,99
050,51,193,"Virginia","Westmoreland County",2,37,203,110,93
050,51,193,"Virginia","Westmoreland County",2,38,192,97,95
050,51,193,"Virginia","Westmoreland County",2,39,183,88,95
050,51,193,"Virginia","Westmoreland County",2,40,187,100,87
050,51,193,"Virginia","Westmoreland County",2,41,178,90,88
050,51,193,"Virginia","Westmoreland County",2,42,161,78,83
050,51,193,"Virginia","Westmoreland County",2,43,161,78,83
050,51,193,"Virginia","Westmoreland County",2,44,179,84,95
050,51,193,"Virginia","Westmoreland County",2,45,178,80,98
050,51,193,"Virginia","Westmoreland County",2,46,178,83,95
050,51,193,"Virginia","Westmoreland County",2,47,193,88,105
050,51,193,"Virginia","Westmoreland County",2,48,193,92,101
050,51,193,"Virginia","Westmoreland County",2,49,203,106,97
050,51,193,"Virginia","Westmoreland County",2,50,192,102,90
050,51,193,"Virginia","Westmoreland County",2,51,193,96,97
050,51,193,"Virginia","Westmoreland County",2,52,220,104,116
050,51,193,"Virginia","Westmoreland County",2,53,252,129,123
050,51,193,"Virginia","Westmoreland County",2,54,244,125,119
050,51,193,"Virginia","Westmoreland County",2,55,250,117,133
050,51,193,"Virginia","Westmoreland County",2,56,294,129,165
050,51,193,"Virginia","Westmoreland County",2,57,319,144,175
050,51,193,"Virginia","Westmoreland County",2,58,305,148,157
050,51,193,"Virginia","Westmoreland County",2,59,301,151,150
050,51,193,"Virginia","Westmoreland County",2,60,318,155,163
050,51,193,"Virginia","Westmoreland County",2,61,323,158,165
050,51,193,"Virginia","Westmoreland County",2,62,309,149,160
050,51,193,"Virginia","Westmoreland County",2,63,334,169,165
050,51,193,"Virginia","Westmoreland County",2,64,338,170,168
050,51,193,"Virginia","Westmoreland County",2,65,319,162,157
050,51,193,"Virginia","Westmoreland County",2,66,305,152,153
050,51,193,"Virginia","Westmoreland County",2,67,301,148,153
050,51,193,"Virginia","Westmoreland County",2,68,293,146,147
050,51,193,"Virginia","Westmoreland County",2,69,297,135,162
050,51,193,"Virginia","Westmoreland County",2,70,281,134,147
050,51,193,"Virginia","Westmoreland County",2,71,264,118,146
050,51,193,"Virginia","Westmoreland County",2,72,262,113,149
050,51,193,"Virginia","Westmoreland County",2,73,281,132,149
050,51,193,"Virginia","Westmoreland County",2,74,203,97,106
050,51,193,"Virginia","Westmoreland County",2,75,208,95,113
050,51,193,"Virginia","Westmoreland County",2,76,229,119,110
050,51,193,"Virginia","Westmoreland County",2,77,224,118,106
050,51,193,"Virginia","Westmoreland County",2,78,172,78,94
050,51,193,"Virginia","Westmoreland County",2,79,147,63,84
050,51,193,"Virginia","Westmoreland County",2,80,144,68,76
050,51,193,"Virginia","Westmoreland County",2,81,131,64,67
050,51,193,"Virginia","Westmoreland County",2,82,119,56,63
050,51,193,"Virginia","Westmoreland County",2,83,113,49,64
050,51,193,"Virginia","Westmoreland County",2,84,89,42,47
050,51,193,"Virginia","Westmoreland County",2,85,428,173,255
050,51,193,"Virginia","Westmoreland County",3,0,174,85,89
050,51,193,"Virginia","Westmoreland County",3,1,182,95,87
050,51,193,"Virginia","Westmoreland County",3,2,186,94,92
050,51,193,"Virginia","Westmoreland County",3,3,186,96,90
050,51,193,"Virginia","Westmoreland County",3,4,198,105,93
050,51,193,"Virginia","Westmoreland County",3,5,212,108,104
050,51,193,"Virginia","Westmoreland County",3,6,210,113,97
050,51,193,"Virginia","Westmoreland County",3,7,187,98,89
050,51,193,"Virginia","Westmoreland County",3,8,191,102,89
050,51,193,"Virginia","Westmoreland County",3,9,177,86,91
050,51,193,"Virginia","Westmoreland County",3,10,180,92,88
050,51,193,"Virginia","Westmoreland County",3,11,186,100,86
050,51,193,"Virginia","Westmoreland County",3,12,206,110,96
050,51,193,"Virginia","Westmoreland County",3,13,201,103,98
050,51,193,"Virginia","Westmoreland County",3,14,213,114,99
050,51,193,"Virginia","Westmoreland County",3,15,201,107,94
050,51,193,"Virginia","Westmoreland County",3,16,199,105,94
050,51,193,"Virginia","Westmoreland County",3,17,207,104,103
050,51,193,"Virginia","Westmoreland County",3,18,164,74,90
050,51,193,"Virginia","Westmoreland County",3,19,151,80,71
050,51,193,"Virginia","Westmoreland County",3,20,140,64,76
050,51,193,"Virginia","Westmoreland County",3,21,161,79,82
050,51,193,"Virginia","Westmoreland County",3,22,162,76,86
050,51,193,"Virginia","Westmoreland County",3,23,173,82,91
050,51,193,"Virginia","Westmoreland County",3,24,183,93,90
050,51,193,"Virginia","Westmoreland County",3,25,184,88,96
050,51,193,"Virginia","Westmoreland County",3,26,208,95,113
050,51,193,"Virginia","Westmoreland County",3,27,205,102,103
050,51,193,"Virginia","Westmoreland County",3,28,221,108,113
050,51,193,"Virginia","Westmoreland County",3,29,213,120,93
050,51,193,"Virginia","Westmoreland County",3,30,238,130,108
050,51,193,"Virginia","Westmoreland County",3,31,219,110,109
050,51,193,"Virginia","Westmoreland County",3,32,204,102,102
050,51,193,"Virginia","Westmoreland County",3,33,209,98,111
050,51,193,"Virginia","Westmoreland County",3,34,211,106,105
050,51,193,"Virginia","Westmoreland County",3,35,191,89,102
050,51,193,"Virginia","Westmoreland County",3,36,200,100,100
050,51,193,"Virginia","Westmoreland County",3,37,220,113,107
050,51,193,"Virginia","Westmoreland County",3,38,205,111,94
050,51,193,"Virginia","Westmoreland County",3,39,199,107,92
050,51,193,"Virginia","Westmoreland County",3,40,186,92,94
050,51,193,"Virginia","Westmoreland County",3,41,187,97,90
050,51,193,"Virginia","Westmoreland County",3,42,182,100,82
050,51,193,"Virginia","Westmoreland County",3,43,160,77,83
050,51,193,"Virginia","Westmoreland County",3,44,173,87,86
050,51,193,"Virginia","Westmoreland County",3,45,179,88,91
050,51,193,"Virginia","Westmoreland County",3,46,184,81,103
050,51,193,"Virginia","Westmoreland County",3,47,183,86,97
050,51,193,"Virginia","Westmoreland County",3,48,197,95,102
050,51,193,"Virginia","Westmoreland County",3,49,215,107,108
050,51,193,"Virginia","Westmoreland County",3,50,210,104,106
050,51,193,"Virginia","Westmoreland County",3,51,213,116,97
050,51,193,"Virginia","Westmoreland County",3,52,194,98,96
050,51,193,"Virginia","Westmoreland County",3,53,234,114,120
050,51,193,"Virginia","Westmoreland County",3,54,270,141,129
050,51,193,"Virginia","Westmoreland County",3,55,244,127,117
050,51,193,"Virginia","Westmoreland County",3,56,258,117,141
050,51,193,"Virginia","Westmoreland County",3,57,308,136,172
050,51,193,"Virginia","Westmoreland County",3,58,319,140,179
050,51,193,"Virginia","Westmoreland County",3,59,297,142,155
050,51,193,"Virginia","Westmoreland County",3,60,321,169,152
050,51,193,"Virginia","Westmoreland County",3,61,326,161,165
050,51,193,"Virginia","Westmoreland County",3,62,330,161,169
050,51,193,"Virginia","Westmoreland County",3,63,328,155,173
050,51,193,"Virginia","Westmoreland County",3,64,329,169,160
050,51,193,"Virginia","Westmoreland County",3,65,344,168,176
050,51,193,"Virginia","Westmoreland County",3,66,324,164,160
050,51,193,"Virginia","Westmoreland County",3,67,309,154,155
050,51,193,"Virginia","Westmoreland County",3,68,308,150,158
050,51,193,"Virginia","Westmoreland County",3,69,305,149,156
050,51,193,"Virginia","Westmoreland County",3,70,285,128,157
050,51,193,"Virginia","Westmoreland County",3,71,272,129,143
050,51,193,"Virginia","Westmoreland County",3,72,265,118,147
050,51,193,"Virginia","Westmoreland County",3,73,254,112,142
050,51,193,"Virginia","Westmoreland County",3,74,265,119,146
050,51,193,"Virginia","Westmoreland County",3,75,199,98,101
050,51,193,"Virginia","Westmoreland County",3,76,195,88,107
050,51,193,"Virginia","Westmoreland County",3,77,213,111,102
050,51,193,"Virginia","Westmoreland County",3,78,216,111,105
050,51,193,"Virginia","Westmoreland County",3,79,160,69,91
050,51,193,"Virginia","Westmoreland County",3,80,142,57,85
050,51,193,"Virginia","Westmoreland County",3,81,133,65,68
050,51,193,"Virginia","Westmoreland County",3,82,128,61,67
050,51,193,"Virginia","Westmoreland County",3,83,112,53,59
050,51,193,"Virginia","Westmoreland County",3,84,107,50,57
050,51,193,"Virginia","Westmoreland County",3,85,452,185,267
050,51,193,"Virginia","Westmoreland County",4,0,167,76,91
050,51,193,"Virginia","Westmoreland County",4,1,194,103,91
050,51,193,"Virginia","Westmoreland County",4,2,208,114,94
050,51,193,"Virginia","Westmoreland County",4,3,199,97,102
050,51,193,"Virginia","Westmoreland County",4,4,166,88,78
050,51,193,"Virginia","Westmoreland County",4,5,188,107,81
050,51,193,"Virginia","Westmoreland County",4,6,191,100,91
050,51,193,"Virginia","Westmoreland County",4,7,198,106,92
050,51,193,"Virginia","Westmoreland County",4,8,180,97,83
050,51,193,"Virginia","Westmoreland County",4,9,196,106,90
050,51,193,"Virginia","Westmoreland County",4,10,176,90,86
050,51,193,"Virginia","Westmoreland County",4,11,169,83,86
050,51,193,"Virginia","Westmoreland County",4,12,185,98,87
050,51,193,"Virginia","Westmoreland County",4,13,195,103,92
050,51,193,"Virginia","Westmoreland County",4,14,208,110,98
050,51,193,"Virginia","Westmoreland County",4,15,202,110,92
050,51,193,"Virginia","Westmoreland County",4,16,190,105,85
050,51,193,"Virginia","Westmoreland County",4,17,193,109,84
050,51,193,"Virginia","Westmoreland County",4,18,172,86,86
050,51,193,"Virginia","Westmoreland County",4,19,126,61,65
050,51,193,"Virginia","Westmoreland County",4,20,166,90,76
050,51,193,"Virginia","Westmoreland County",4,21,154,71,83
050,51,193,"Virginia","Westmoreland County",4,22,180,91,89
050,51,193,"Virginia","Westmoreland County",4,23,177,85,92
050,51,193,"Virginia","Westmoreland County",4,24,179,80,99
050,51,193,"Virginia","Westmoreland County",4,25,176,92,84
050,51,193,"Virginia","Westmoreland County",4,26,188,94,94
050,51,193,"Virginia","Westmoreland County",4,27,211,93,118
050,51,193,"Virginia","Westmoreland County",4,28,201,99,102
050,51,193,"Virginia","Westmoreland County",4,29,203,107,96
050,51,193,"Virginia","Westmoreland County",4,30,193,110,83
050,51,193,"Virginia","Westmoreland County",4,31,233,125,108
050,51,193,"Virginia","Westmoreland County",4,32,216,104,112
050,51,193,"Virginia","Westmoreland County",4,33,205,109,96
050,51,193,"Virginia","Westmoreland County",4,34,215,104,111
050,51,193,"Virginia","Westmoreland County",4,35,213,110,103
050,51,193,"Virginia","Westmoreland County",4,36,193,99,94
050,51,193,"Virginia","Westmoreland County",4,37,188,101,87
050,51,193,"Virginia","Westmoreland County",4,38,201,102,99
050,51,193,"Virginia","Westmoreland County",4,39,219,111,108
050,51,193,"Virginia","Westmoreland County",4,40,197,105,92
050,51,193,"Virginia","Westmoreland County",4,41,182,91,91
050,51,193,"Virginia","Westmoreland County",4,42,190,98,92
050,51,193,"Virginia","Westmoreland County",4,43,181,99,82
050,51,193,"Virginia","Westmoreland County",4,44,162,79,83
050,51,193,"Virginia","Westmoreland County",4,45,171,87,84
050,51,193,"Virginia","Westmoreland County",4,46,179,85,94
050,51,193,"Virginia","Westmoreland County",4,47,186,83,103
050,51,193,"Virginia","Westmoreland County",4,48,181,83,98
050,51,193,"Virginia","Westmoreland County",4,49,196,99,97
050,51,193,"Virginia","Westmoreland County",4,50,216,107,109
050,51,193,"Virginia","Westmoreland County",4,51,211,104,107
050,51,193,"Virginia","Westmoreland County",4,52,220,119,101
050,51,193,"Virginia","Westmoreland County",4,53,192,95,97
050,51,193,"Virginia","Westmoreland County",4,54,237,113,124
050,51,193,"Virginia","Westmoreland County",4,55,265,137,128
050,51,193,"Virginia","Westmoreland County",4,56,242,123,119
050,51,193,"Virginia","Westmoreland County",4,57,271,123,148
050,51,193,"Virginia","Westmoreland County",4,58,314,132,182
050,51,193,"Virginia","Westmoreland County",4,59,346,151,195
050,51,193,"Virginia","Westmoreland County",4,60,309,143,166
050,51,193,"Virginia","Westmoreland County",4,61,322,164,158
050,51,193,"Virginia","Westmoreland County",4,62,336,162,174
050,51,193,"Virginia","Westmoreland County",4,63,348,166,182
050,51,193,"Virginia","Westmoreland County",4,64,331,159,172
050,51,193,"Virginia","Westmoreland County",4,65,329,167,162
050,51,193,"Virginia","Westmoreland County",4,66,345,174,171
050,51,193,"Virginia","Westmoreland County",4,67,330,163,167
050,51,193,"Virginia","Westmoreland County",4,68,320,160,160
050,51,193,"Virginia","Westmoreland County",4,69,310,153,157
050,51,193,"Virginia","Westmoreland County",4,70,303,151,152
050,51,193,"Virginia","Westmoreland County",4,71,285,126,159
050,51,193,"Virginia","Westmoreland County",4,72,265,125,140
050,51,193,"Virginia","Westmoreland County",4,73,258,117,141
050,51,193,"Virginia","Westmoreland County",4,74,250,114,136
050,51,193,"Virginia","Westmoreland County",4,75,256,113,143
050,51,193,"Virginia","Westmoreland County",4,76,191,94,97
050,51,193,"Virginia","Westmoreland County",4,77,184,85,99
050,51,193,"Virginia","Westmoreland County",4,78,213,109,104
050,51,193,"Virginia","Westmoreland County",4,79,199,101,98
050,51,193,"Virginia","Westmoreland County",4,80,156,64,92
050,51,193,"Virginia","Westmoreland County",4,81,139,58,81
050,51,193,"Virginia","Westmoreland County",4,82,127,61,66
050,51,193,"Virginia","Westmoreland County",4,83,121,57,64
050,51,193,"Virginia","Westmoreland County",4,84,101,53,48
050,51,193,"Virginia","Westmoreland County",4,85,484,207,277
050,51,193,"Virginia","Westmoreland County",5,0,168,76,92
050,51,193,"Virginia","Westmoreland County",5,1,149,70,79
050,51,193,"Virginia","Westmoreland County",5,2,191,99,92
050,51,193,"Virginia","Westmoreland County",5,3,203,107,96
050,51,193,"Virginia","Westmoreland County",5,4,201,97,104
050,51,193,"Virginia","Westmoreland County",5,5,157,81,76
050,51,193,"Virginia","Westmoreland County",5,6,190,106,84
050,51,193,"Virginia","Westmoreland County",5,7,196,103,93
050,51,193,"Virginia","Westmoreland County",5,8,201,108,93
050,51,193,"Virginia","Westmoreland County",5,9,197,101,96
050,51,193,"Virginia","Westmoreland County",5,10,200,108,92
050,51,193,"Virginia","Westmoreland County",5,11,191,101,90
050,51,193,"Virginia","Westmoreland County",5,12,176,85,91
050,51,193,"Virginia","Westmoreland County",5,13,182,91,91
050,51,193,"Virginia","Westmoreland County",5,14,205,110,95
050,51,193,"Virginia","Westmoreland County",5,15,214,112,102
050,51,193,"Virginia","Westmoreland County",5,16,199,112,87
050,51,193,"Virginia","Westmoreland County",5,17,192,104,88
050,51,193,"Virginia","Westmoreland County",5,18,162,90,72
050,51,193,"Virginia","Westmoreland County",5,19,143,75,68
050,51,193,"Virginia","Westmoreland County",5,20,131,67,64
050,51,193,"Virginia","Westmoreland County",5,21,165,93,72
050,51,193,"Virginia","Westmoreland County",5,22,167,79,88
050,51,193,"Virginia","Westmoreland County",5,23,176,82,94
050,51,193,"Virginia","Westmoreland County",5,24,186,86,100
050,51,193,"Virginia","Westmoreland County",5,25,194,94,100
050,51,193,"Virginia","Westmoreland County",5,26,184,100,84
050,51,193,"Virginia","Westmoreland County",5,27,186,95,91
050,51,193,"Virginia","Westmoreland County",5,28,225,106,119
050,51,193,"Virginia","Westmoreland County",5,29,210,105,105
050,51,193,"Virginia","Westmoreland County",5,30,211,109,102
050,51,193,"Virginia","Westmoreland County",5,31,194,116,78
050,51,193,"Virginia","Westmoreland County",5,32,240,129,111
050,51,193,"Virginia","Westmoreland County",5,33,208,101,107
050,51,193,"Virginia","Westmoreland County",5,34,207,108,99
050,51,193,"Virginia","Westmoreland County",5,35,200,93,107
050,51,193,"Virginia","Westmoreland County",5,36,222,114,108
050,51,193,"Virginia","Westmoreland County",5,37,172,90,82
050,51,193,"Virginia","Westmoreland County",5,38,198,104,94
050,51,193,"Virginia","Westmoreland County",5,39,207,101,106
050,51,193,"Virginia","Westmoreland County",5,40,227,116,111
050,51,193,"Virginia","Westmoreland County",5,41,207,112,95
050,51,193,"Virginia","Westmoreland County",5,42,184,95,89
050,51,193,"Virginia","Westmoreland County",5,43,195,98,97
050,51,193,"Virginia","Westmoreland County",5,44,193,108,85
050,51,193,"Virginia","Westmoreland County",5,45,167,80,87
050,51,193,"Virginia","Westmoreland County",5,46,177,88,89
050,51,193,"Virginia","Westmoreland County",5,47,173,83,90
050,51,193,"Virginia","Westmoreland County",5,48,194,84,110
050,51,193,"Virginia","Westmoreland County",5,49,190,85,105
050,51,193,"Virginia","Westmoreland County",5,50,201,103,98
050,51,193,"Virginia","Westmoreland County",5,51,212,104,108
050,51,193,"Virginia","Westmoreland County",5,52,225,108,117
050,51,193,"Virginia","Westmoreland County",5,53,228,120,108
050,51,193,"Virginia","Westmoreland County",5,54,205,96,109
050,51,193,"Virginia","Westmoreland County",5,55,254,122,132
050,51,193,"Virginia","Westmoreland County",5,56,271,139,132
050,51,193,"Virginia","Westmoreland County",5,57,248,123,125
050,51,193,"Virginia","Westmoreland County",5,58,275,127,148
050,51,193,"Virginia","Westmoreland County",5,59,332,138,194
050,51,193,"Virginia","Westmoreland County",5,60,354,149,205
050,51,193,"Virginia","Westmoreland County",5,61,322,156,166
050,51,193,"Virginia","Westmoreland County",5,62,337,170,167
050,51,193,"Virginia","Westmoreland County",5,63,341,163,178
050,51,193,"Virginia","Westmoreland County",5,64,366,175,191
050,51,193,"Virginia","Westmoreland County",5,65,341,161,180
050,51,193,"Virginia","Westmoreland County",5,66,343,170,173
050,51,193,"Virginia","Westmoreland County",5,67,353,178,175
050,51,193,"Virginia","Westmoreland County",5,68,333,164,169
050,51,193,"Virginia","Westmoreland County",5,69,326,164,162
050,51,193,"Virginia","Westmoreland County",5,70,302,152,150
050,51,193,"Virginia","Westmoreland County",5,71,289,140,149
050,51,193,"Virginia","Westmoreland County",5,72,277,122,155
050,51,193,"Virginia","Westmoreland County",5,73,257,124,133
050,51,193,"Virginia","Westmoreland County",5,74,246,112,134
050,51,193,"Virginia","Westmoreland County",5,75,240,112,128
050,51,193,"Virginia","Westmoreland County",5,76,245,105,140
050,51,193,"Virginia","Westmoreland County",5,77,186,94,92
050,51,193,"Virginia","Westmoreland County",5,78,176,79,97
050,51,193,"Virginia","Westmoreland County",5,79,192,97,95
050,51,193,"Virginia","Westmoreland County",5,80,185,90,95
050,51,193,"Virginia","Westmoreland County",5,81,151,64,87
050,51,193,"Virginia","Westmoreland County",5,82,133,55,78
050,51,193,"Virginia","Westmoreland County",5,83,114,55,59
050,51,193,"Virginia","Westmoreland County",5,84,116,59,57
050,51,193,"Virginia","Westmoreland County",5,85,530,237,293
050,51,195,"Virginia","Wise County",1,0,345,177,168
050,51,195,"Virginia","Wise County",1,1,330,171,159
050,51,195,"Virginia","Wise County",1,2,308,171,137
050,51,195,"Virginia","Wise County",1,3,358,191,167
050,51,195,"Virginia","Wise County",1,4,366,166,200
050,51,195,"Virginia","Wise County",1,5,349,169,180
050,51,195,"Virginia","Wise County",1,6,391,192,199
050,51,195,"Virginia","Wise County",1,7,390,209,181
050,51,195,"Virginia","Wise County",1,8,376,196,180
050,51,195,"Virginia","Wise County",1,9,402,196,206
050,51,195,"Virginia","Wise County",1,10,429,203,226
050,51,195,"Virginia","Wise County",1,11,422,227,195
050,51,195,"Virginia","Wise County",1,12,446,230,216
050,51,195,"Virginia","Wise County",1,13,433,222,211
050,51,195,"Virginia","Wise County",1,14,414,210,204
050,51,195,"Virginia","Wise County",1,15,426,215,211
050,51,195,"Virginia","Wise County",1,16,409,201,208
050,51,195,"Virginia","Wise County",1,17,415,199,216
050,51,195,"Virginia","Wise County",1,18,446,232,214
050,51,195,"Virginia","Wise County",1,19,444,250,194
050,51,195,"Virginia","Wise County",1,20,434,254,180
050,51,195,"Virginia","Wise County",1,21,450,269,181
050,51,195,"Virginia","Wise County",1,22,441,261,180
050,51,195,"Virginia","Wise County",1,23,445,269,176
050,51,195,"Virginia","Wise County",1,24,468,293,175
050,51,195,"Virginia","Wise County",1,25,477,282,195
050,51,195,"Virginia","Wise County",1,26,459,279,180
050,51,195,"Virginia","Wise County",1,27,485,284,201
050,51,195,"Virginia","Wise County",1,28,545,324,221
050,51,195,"Virginia","Wise County",1,29,489,288,201
050,51,195,"Virginia","Wise County",1,30,506,303,203
050,51,195,"Virginia","Wise County",1,31,520,311,209
050,51,195,"Virginia","Wise County",1,32,486,290,196
050,51,195,"Virginia","Wise County",1,33,464,269,195
050,51,195,"Virginia","Wise County",1,34,400,221,179
050,51,195,"Virginia","Wise County",1,35,419,234,185
050,51,195,"Virginia","Wise County",1,36,424,237,187
050,51,195,"Virginia","Wise County",1,37,463,268,195
050,51,195,"Virginia","Wise County",1,38,449,234,215
050,51,195,"Virginia","Wise County",1,39,452,243,209
050,51,195,"Virginia","Wise County",1,40,439,244,195
050,51,195,"Virginia","Wise County",1,41,423,236,187
050,51,195,"Virginia","Wise County",1,42,453,251,202
050,51,195,"Virginia","Wise County",1,43,491,275,216
050,51,195,"Virginia","Wise County",1,44,439,229,210
050,51,195,"Virginia","Wise County",1,45,450,227,223
050,51,195,"Virginia","Wise County",1,46,484,257,227
050,51,195,"Virginia","Wise County",1,47,493,281,212
050,51,195,"Virginia","Wise County",1,48,504,263,241
050,51,195,"Virginia","Wise County",1,49,517,263,254
050,51,195,"Virginia","Wise County",1,50,497,250,247
050,51,195,"Virginia","Wise County",1,51,480,266,214
050,51,195,"Virginia","Wise County",1,52,492,266,226
050,51,195,"Virginia","Wise County",1,53,480,242,238
050,51,195,"Virginia","Wise County",1,54,439,223,216
050,51,195,"Virginia","Wise County",1,55,447,222,225
050,51,195,"Virginia","Wise County",1,56,468,255,213
050,51,195,"Virginia","Wise County",1,57,475,260,215
050,51,195,"Virginia","Wise County",1,58,476,248,228
050,51,195,"Virginia","Wise County",1,59,501,241,260
050,51,195,"Virginia","Wise County",1,60,501,226,275
050,51,195,"Virginia","Wise County",1,61,520,247,273
050,51,195,"Virginia","Wise County",1,62,517,253,264
050,51,195,"Virginia","Wise County",1,63,530,256,274
050,51,195,"Virginia","Wise County",1,64,501,242,259
050,51,195,"Virginia","Wise County",1,65,500,248,252
050,51,195,"Virginia","Wise County",1,66,494,250,244
050,51,195,"Virginia","Wise County",1,67,481,234,247
050,51,195,"Virginia","Wise County",1,68,495,231,264
050,51,195,"Virginia","Wise County",1,69,459,207,252
050,51,195,"Virginia","Wise County",1,70,422,200,222
050,51,195,"Virginia","Wise County",1,71,422,201,221
050,51,195,"Virginia","Wise County",1,72,424,210,214
050,51,195,"Virginia","Wise County",1,73,394,187,207
050,51,195,"Virginia","Wise County",1,74,260,115,145
050,51,195,"Virginia","Wise County",1,75,256,115,141
050,51,195,"Virginia","Wise County",1,76,257,131,126
050,51,195,"Virginia","Wise County",1,77,267,130,137
050,51,195,"Virginia","Wise County",1,78,227,106,121
050,51,195,"Virginia","Wise County",1,79,201,93,108
050,51,195,"Virginia","Wise County",1,80,182,87,95
050,51,195,"Virginia","Wise County",1,81,165,72,93
050,51,195,"Virginia","Wise County",1,82,161,68,93
050,51,195,"Virginia","Wise County",1,83,134,55,79
050,51,195,"Virginia","Wise County",1,84,98,43,55
050,51,195,"Virginia","Wise County",1,85,627,238,389
050,51,195,"Virginia","Wise County",2,0,346,174,172
050,51,195,"Virginia","Wise County",2,1,333,172,161
050,51,195,"Virginia","Wise County",2,2,319,173,146
050,51,195,"Virginia","Wise County",2,3,347,187,160
050,51,195,"Virginia","Wise County",2,4,368,173,195
050,51,195,"Virginia","Wise County",2,5,357,170,187
050,51,195,"Virginia","Wise County",2,6,379,185,194
050,51,195,"Virginia","Wise County",2,7,392,206,186
050,51,195,"Virginia","Wise County",2,8,377,197,180
050,51,195,"Virginia","Wise County",2,9,393,193,200
050,51,195,"Virginia","Wise County",2,10,423,202,221
050,51,195,"Virginia","Wise County",2,11,421,218,203
050,51,195,"Virginia","Wise County",2,12,441,230,211
050,51,195,"Virginia","Wise County",2,13,436,225,211
050,51,195,"Virginia","Wise County",2,14,421,214,207
050,51,195,"Virginia","Wise County",2,15,420,212,208
050,51,195,"Virginia","Wise County",2,16,409,202,207
050,51,195,"Virginia","Wise County",2,17,418,202,216
050,51,195,"Virginia","Wise County",2,18,436,225,211
050,51,195,"Virginia","Wise County",2,19,445,247,198
050,51,195,"Virginia","Wise County",2,20,439,255,184
050,51,195,"Virginia","Wise County",2,21,447,269,178
050,51,195,"Virginia","Wise County",2,22,448,268,180
050,51,195,"Virginia","Wise County",2,23,444,267,177
050,51,195,"Virginia","Wise County",2,24,470,294,176
050,51,195,"Virginia","Wise County",2,25,473,282,191
050,51,195,"Virginia","Wise County",2,26,458,275,183
050,51,195,"Virginia","Wise County",2,27,484,287,197
050,51,195,"Virginia","Wise County",2,28,534,319,215
050,51,195,"Virginia","Wise County",2,29,497,291,206
050,51,195,"Virginia","Wise County",2,30,514,306,208
050,51,195,"Virginia","Wise County",2,31,511,305,206
050,51,195,"Virginia","Wise County",2,32,488,289,199
050,51,195,"Virginia","Wise County",2,33,467,274,193
050,51,195,"Virginia","Wise County",2,34,414,229,185
050,51,195,"Virginia","Wise County",2,35,422,235,187
050,51,195,"Virginia","Wise County",2,36,418,233,185
050,51,195,"Virginia","Wise County",2,37,454,263,191
050,51,195,"Virginia","Wise County",2,38,446,235,211
050,51,195,"Virginia","Wise County",2,39,452,243,209
050,51,195,"Virginia","Wise County",2,40,440,241,199
050,51,195,"Virginia","Wise County",2,41,430,241,189
050,51,195,"Virginia","Wise County",2,42,445,246,199
050,51,195,"Virginia","Wise County",2,43,484,270,214
050,51,195,"Virginia","Wise County",2,44,437,230,207
050,51,195,"Virginia","Wise County",2,45,451,229,222
050,51,195,"Virginia","Wise County",2,46,477,252,225
050,51,195,"Virginia","Wise County",2,47,486,271,215
050,51,195,"Virginia","Wise County",2,48,498,264,234
050,51,195,"Virginia","Wise County",2,49,516,265,251
050,51,195,"Virginia","Wise County",2,50,500,252,248
050,51,195,"Virginia","Wise County",2,51,479,259,220
050,51,195,"Virginia","Wise County",2,52,485,262,223
050,51,195,"Virginia","Wise County",2,53,481,244,237
050,51,195,"Virginia","Wise County",2,54,445,226,219
050,51,195,"Virginia","Wise County",2,55,446,224,222
050,51,195,"Virginia","Wise County",2,56,460,245,215
050,51,195,"Virginia","Wise County",2,57,472,258,214
050,51,195,"Virginia","Wise County",2,58,470,245,225
050,51,195,"Virginia","Wise County",2,59,493,240,253
050,51,195,"Virginia","Wise County",2,60,492,226,266
050,51,195,"Virginia","Wise County",2,61,515,242,273
050,51,195,"Virginia","Wise County",2,62,511,247,264
050,51,195,"Virginia","Wise County",2,63,526,257,269
050,51,195,"Virginia","Wise County",2,64,502,243,259
050,51,195,"Virginia","Wise County",2,65,499,246,253
050,51,195,"Virginia","Wise County",2,66,497,250,247
050,51,195,"Virginia","Wise County",2,67,482,237,245
050,51,195,"Virginia","Wise County",2,68,488,231,257
050,51,195,"Virginia","Wise County",2,69,473,217,256
050,51,195,"Virginia","Wise County",2,70,425,199,226
050,51,195,"Virginia","Wise County",2,71,419,200,219
050,51,195,"Virginia","Wise County",2,72,416,204,212
050,51,195,"Virginia","Wise County",2,73,420,201,219
050,51,195,"Virginia","Wise County",2,74,269,122,147
050,51,195,"Virginia","Wise County",2,75,254,113,141
050,51,195,"Virginia","Wise County",2,76,249,123,126
050,51,195,"Virginia","Wise County",2,77,272,133,139
050,51,195,"Virginia","Wise County",2,78,228,108,120
050,51,195,"Virginia","Wise County",2,79,201,94,107
050,51,195,"Virginia","Wise County",2,80,182,86,96
050,51,195,"Virginia","Wise County",2,81,164,74,90
050,51,195,"Virginia","Wise County",2,82,160,69,91
050,51,195,"Virginia","Wise County",2,83,137,56,81
050,51,195,"Virginia","Wise County",2,84,106,45,61
050,51,195,"Virginia","Wise County",2,85,621,234,387
050,51,195,"Virginia","Wise County",3,0,316,169,147
050,51,195,"Virginia","Wise County",3,1,347,179,168
050,51,195,"Virginia","Wise County",3,2,322,164,158
050,51,195,"Virginia","Wise County",3,3,334,181,153
050,51,195,"Virginia","Wise County",3,4,351,191,160
050,51,195,"Virginia","Wise County",3,5,362,164,198
050,51,195,"Virginia","Wise County",3,6,348,162,186
050,51,195,"Virginia","Wise County",3,7,389,188,201
050,51,195,"Virginia","Wise County",3,8,394,204,190
050,51,195,"Virginia","Wise County",3,9,370,189,181
050,51,195,"Virginia","Wise County",3,10,392,184,208
050,51,195,"Virginia","Wise County",3,11,429,210,219
050,51,195,"Virginia","Wise County",3,12,421,221,200
050,51,195,"Virginia","Wise County",3,13,449,233,216
050,51,195,"Virginia","Wise County",3,14,450,236,214
050,51,195,"Virginia","Wise County",3,15,419,212,207
050,51,195,"Virginia","Wise County",3,16,420,210,210
050,51,195,"Virginia","Wise County",3,17,415,216,199
050,51,195,"Virginia","Wise County",3,18,421,213,208
050,51,195,"Virginia","Wise County",3,19,427,226,201
050,51,195,"Virginia","Wise County",3,20,460,251,209
050,51,195,"Virginia","Wise County",3,21,435,271,164
050,51,195,"Virginia","Wise County",3,22,436,265,171
050,51,195,"Virginia","Wise County",3,23,457,266,191
050,51,195,"Virginia","Wise County",3,24,470,292,178
050,51,195,"Virginia","Wise County",3,25,457,291,166
050,51,195,"Virginia","Wise County",3,26,444,274,170
050,51,195,"Virginia","Wise County",3,27,473,287,186
050,51,195,"Virginia","Wise County",3,28,491,298,193
050,51,195,"Virginia","Wise County",3,29,493,283,210
050,51,195,"Virginia","Wise County",3,30,518,311,207
050,51,195,"Virginia","Wise County",3,31,500,288,212
050,51,195,"Virginia","Wise County",3,32,485,288,197
050,51,195,"Virginia","Wise County",3,33,495,291,204
050,51,195,"Virginia","Wise County",3,34,465,268,197
050,51,195,"Virginia","Wise County",3,35,432,245,187
050,51,195,"Virginia","Wise County",3,36,421,231,190
050,51,195,"Virginia","Wise County",3,37,426,245,181
050,51,195,"Virginia","Wise County",3,38,429,238,191
050,51,195,"Virginia","Wise County",3,39,458,251,207
050,51,195,"Virginia","Wise County",3,40,429,226,203
050,51,195,"Virginia","Wise County",3,41,452,249,203
050,51,195,"Virginia","Wise County",3,42,423,240,183
050,51,195,"Virginia","Wise County",3,43,444,252,192
050,51,195,"Virginia","Wise County",3,44,456,248,208
050,51,195,"Virginia","Wise County",3,45,440,232,208
050,51,195,"Virginia","Wise County",3,46,469,249,220
050,51,195,"Virginia","Wise County",3,47,463,244,219
050,51,195,"Virginia","Wise County",3,48,480,260,220
050,51,195,"Virginia","Wise County",3,49,481,249,232
050,51,195,"Virginia","Wise County",3,50,512,271,241
050,51,195,"Virginia","Wise County",3,51,491,243,248
050,51,195,"Virginia","Wise County",3,52,468,254,214
050,51,195,"Virginia","Wise County",3,53,474,249,225
050,51,195,"Virginia","Wise County",3,54,487,248,239
050,51,195,"Virginia","Wise County",3,55,440,225,215
050,51,195,"Virginia","Wise County",3,56,429,208,221
050,51,195,"Virginia","Wise County",3,57,451,240,211
050,51,195,"Virginia","Wise County",3,58,455,251,204
050,51,195,"Virginia","Wise County",3,59,458,239,219
050,51,195,"Virginia","Wise County",3,60,475,219,256
050,51,195,"Virginia","Wise County",3,61,477,219,258
050,51,195,"Virginia","Wise County",3,62,486,229,257
050,51,195,"Virginia","Wise County",3,63,506,244,262
050,51,195,"Virginia","Wise County",3,64,520,257,263
050,51,195,"Virginia","Wise County",3,65,486,235,251
050,51,195,"Virginia","Wise County",3,66,489,243,246
050,51,195,"Virginia","Wise County",3,67,480,239,241
050,51,195,"Virginia","Wise County",3,68,464,230,234
050,51,195,"Virginia","Wise County",3,69,480,229,251
050,51,195,"Virginia","Wise County",3,70,446,203,243
050,51,195,"Virginia","Wise County",3,71,400,182,218
050,51,195,"Virginia","Wise County",3,72,412,195,217
050,51,195,"Virginia","Wise County",3,73,394,190,204
050,51,195,"Virginia","Wise County",3,74,400,189,211
050,51,195,"Virginia","Wise County",3,75,256,114,142
050,51,195,"Virginia","Wise County",3,76,234,104,130
050,51,195,"Virginia","Wise County",3,77,239,114,125
050,51,195,"Virginia","Wise County",3,78,248,118,130
050,51,195,"Virginia","Wise County",3,79,211,101,110
050,51,195,"Virginia","Wise County",3,80,183,87,96
050,51,195,"Virginia","Wise County",3,81,164,76,88
050,51,195,"Virginia","Wise County",3,82,158,71,87
050,51,195,"Virginia","Wise County",3,83,141,56,85
050,51,195,"Virginia","Wise County",3,84,125,50,75
050,51,195,"Virginia","Wise County",3,85,584,222,362
050,51,195,"Virginia","Wise County",4,0,345,187,158
050,51,195,"Virginia","Wise County",4,1,304,166,138
050,51,195,"Virginia","Wise County",4,2,363,191,172
050,51,195,"Virginia","Wise County",4,3,331,169,162
050,51,195,"Virginia","Wise County",4,4,331,179,152
050,51,195,"Virginia","Wise County",4,5,352,187,165
050,51,195,"Virginia","Wise County",4,6,362,161,201
050,51,195,"Virginia","Wise County",4,7,345,163,182
050,51,195,"Virginia","Wise County",4,8,388,192,196
050,51,195,"Virginia","Wise County",4,9,387,194,193
050,51,195,"Virginia","Wise County",4,10,362,186,176
050,51,195,"Virginia","Wise County",4,11,396,192,204
050,51,195,"Virginia","Wise County",4,12,443,221,222
050,51,195,"Virginia","Wise County",4,13,417,226,191
050,51,195,"Virginia","Wise County",4,14,442,224,218
050,51,195,"Virginia","Wise County",4,15,446,226,220
050,51,195,"Virginia","Wise County",4,16,412,210,202
050,51,195,"Virginia","Wise County",4,17,432,215,217
050,51,195,"Virginia","Wise County",4,18,399,215,184
050,51,195,"Virginia","Wise County",4,19,407,218,189
050,51,195,"Virginia","Wise County",4,20,419,221,198
050,51,195,"Virginia","Wise County",4,21,460,263,197
050,51,195,"Virginia","Wise County",4,22,457,284,173
050,51,195,"Virginia","Wise County",4,23,431,269,162
050,51,195,"Virginia","Wise County",4,24,491,303,188
050,51,195,"Virginia","Wise County",4,25,458,287,171
050,51,195,"Virginia","Wise County",4,26,450,280,170
050,51,195,"Virginia","Wise County",4,27,454,282,172
050,51,195,"Virginia","Wise County",4,28,473,290,183
050,51,195,"Virginia","Wise County",4,29,464,274,190
050,51,195,"Virginia","Wise County",4,30,514,290,224
050,51,195,"Virginia","Wise County",4,31,502,287,215
050,51,195,"Virginia","Wise County",4,32,474,271,203
050,51,195,"Virginia","Wise County",4,33,487,289,198
050,51,195,"Virginia","Wise County",4,34,483,280,203
050,51,195,"Virginia","Wise County",4,35,456,263,193
050,51,195,"Virginia","Wise County",4,36,426,234,192
050,51,195,"Virginia","Wise County",4,37,432,249,183
050,51,195,"Virginia","Wise County",4,38,402,214,188
050,51,195,"Virginia","Wise County",4,39,452,258,194
050,51,195,"Virginia","Wise County",4,40,449,235,214
050,51,195,"Virginia","Wise County",4,41,441,236,205
050,51,195,"Virginia","Wise County",4,42,456,251,205
050,51,195,"Virginia","Wise County",4,43,417,235,182
050,51,195,"Virginia","Wise County",4,44,423,226,197
050,51,195,"Virginia","Wise County",4,45,463,255,208
050,51,195,"Virginia","Wise County",4,46,472,260,212
050,51,195,"Virginia","Wise County",4,47,451,235,216
050,51,195,"Virginia","Wise County",4,48,445,231,214
050,51,195,"Virginia","Wise County",4,49,465,247,218
050,51,195,"Virginia","Wise County",4,50,484,250,234
050,51,195,"Virginia","Wise County",4,51,489,256,233
050,51,195,"Virginia","Wise County",4,52,477,232,245
050,51,195,"Virginia","Wise County",4,53,456,244,212
050,51,195,"Virginia","Wise County",4,54,460,243,217
050,51,195,"Virginia","Wise County",4,55,477,240,237
050,51,195,"Virginia","Wise County",4,56,434,218,216
050,51,195,"Virginia","Wise County",4,57,425,211,214
050,51,195,"Virginia","Wise County",4,58,441,231,210
050,51,195,"Virginia","Wise County",4,59,450,249,201
050,51,195,"Virginia","Wise County",4,60,454,240,214
050,51,195,"Virginia","Wise County",4,61,471,219,252
050,51,195,"Virginia","Wise County",4,62,448,207,241
050,51,195,"Virginia","Wise County",4,63,474,220,254
050,51,195,"Virginia","Wise County",4,64,502,238,264
050,51,195,"Virginia","Wise County",4,65,509,251,258
050,51,195,"Virginia","Wise County",4,66,478,231,247
050,51,195,"Virginia","Wise County",4,67,473,229,244
050,51,195,"Virginia","Wise County",4,68,473,238,235
050,51,195,"Virginia","Wise County",4,69,450,226,224
050,51,195,"Virginia","Wise County",4,70,457,221,236
050,51,195,"Virginia","Wise County",4,71,428,190,238
050,51,195,"Virginia","Wise County",4,72,393,181,212
050,51,195,"Virginia","Wise County",4,73,383,177,206
050,51,195,"Virginia","Wise County",4,74,380,183,197
050,51,195,"Virginia","Wise County",4,75,372,172,200
050,51,195,"Virginia","Wise County",4,76,241,108,133
050,51,195,"Virginia","Wise County",4,77,225,94,131
050,51,195,"Virginia","Wise County",4,78,223,108,115
050,51,195,"Virginia","Wise County",4,79,232,110,122
050,51,195,"Virginia","Wise County",4,80,194,96,98
050,51,195,"Virginia","Wise County",4,81,157,70,87
050,51,195,"Virginia","Wise County",4,82,156,73,83
050,51,195,"Virginia","Wise County",4,83,137,58,79
050,51,195,"Virginia","Wise County",4,84,129,50,79
050,51,195,"Virginia","Wise County",4,85,564,216,348
050,51,195,"Virginia","Wise County",5,0,350,193,157
050,51,195,"Virginia","Wise County",5,1,348,183,165
050,51,195,"Virginia","Wise County",5,2,306,167,139
050,51,195,"Virginia","Wise County",5,3,361,193,168
050,51,195,"Virginia","Wise County",5,4,333,167,166
050,51,195,"Virginia","Wise County",5,5,329,178,151
050,51,195,"Virginia","Wise County",5,6,351,188,163
050,51,195,"Virginia","Wise County",5,7,359,163,196
050,51,195,"Virginia","Wise County",5,8,350,165,185
050,51,195,"Virginia","Wise County",5,9,396,202,194
050,51,195,"Virginia","Wise County",5,10,403,205,198
050,51,195,"Virginia","Wise County",5,11,366,188,178
050,51,195,"Virginia","Wise County",5,12,402,197,205
050,51,195,"Virginia","Wise County",5,13,437,217,220
050,51,195,"Virginia","Wise County",5,14,421,237,184
050,51,195,"Virginia","Wise County",5,15,453,228,225
050,51,195,"Virginia","Wise County",5,16,449,219,230
050,51,195,"Virginia","Wise County",5,17,424,213,211
050,51,195,"Virginia","Wise County",5,18,420,227,193
050,51,195,"Virginia","Wise County",5,19,399,218,181
050,51,195,"Virginia","Wise County",5,20,411,216,195
050,51,195,"Virginia","Wise County",5,21,442,242,200
050,51,195,"Virginia","Wise County",5,22,469,263,206
050,51,195,"Virginia","Wise County",5,23,483,296,187
050,51,195,"Virginia","Wise County",5,24,476,303,173
050,51,195,"Virginia","Wise County",5,25,489,307,182
050,51,195,"Virginia","Wise County",5,26,445,278,167
050,51,195,"Virginia","Wise County",5,27,449,289,160
050,51,195,"Virginia","Wise County",5,28,451,287,164
050,51,195,"Virginia","Wise County",5,29,438,254,184
050,51,195,"Virginia","Wise County",5,30,480,286,194
050,51,195,"Virginia","Wise County",5,31,481,264,217
050,51,195,"Virginia","Wise County",5,32,483,268,215
050,51,195,"Virginia","Wise County",5,33,478,265,213
050,51,195,"Virginia","Wise County",5,34,459,264,195
050,51,195,"Virginia","Wise County",5,35,490,282,208
050,51,195,"Virginia","Wise County",5,36,449,249,200
050,51,195,"Virginia","Wise County",5,37,417,239,178
050,51,195,"Virginia","Wise County",5,38,416,229,187
050,51,195,"Virginia","Wise County",5,39,410,221,189
050,51,195,"Virginia","Wise County",5,40,434,243,191
050,51,195,"Virginia","Wise County",5,41,452,245,207
050,51,195,"Virginia","Wise County",5,42,436,240,196
050,51,195,"Virginia","Wise County",5,43,454,255,199
050,51,195,"Virginia","Wise County",5,44,397,213,184
050,51,195,"Virginia","Wise County",5,45,444,244,200
050,51,195,"Virginia","Wise County",5,46,475,268,207
050,51,195,"Virginia","Wise County",5,47,450,248,202
050,51,195,"Virginia","Wise County",5,48,444,226,218
050,51,195,"Virginia","Wise County",5,49,441,227,214
050,51,195,"Virginia","Wise County",5,50,466,246,220
050,51,195,"Virginia","Wise County",5,51,469,244,225
050,51,195,"Virginia","Wise County",5,52,491,263,228
050,51,195,"Virginia","Wise County",5,53,471,225,246
050,51,195,"Virginia","Wise County",5,54,448,244,204
050,51,195,"Virginia","Wise County",5,55,463,243,220
050,51,195,"Virginia","Wise County",5,56,463,228,235
050,51,195,"Virginia","Wise County",5,57,428,212,216
050,51,195,"Virginia","Wise County",5,58,415,200,215
050,51,195,"Virginia","Wise County",5,59,446,240,206
050,51,195,"Virginia","Wise County",5,60,444,247,197
050,51,195,"Virginia","Wise County",5,61,445,235,210
050,51,195,"Virginia","Wise County",5,62,461,213,248
050,51,195,"Virginia","Wise County",5,63,448,204,244
050,51,195,"Virginia","Wise County",5,64,472,215,257
050,51,195,"Virginia","Wise County",5,65,486,231,255
050,51,195,"Virginia","Wise County",5,66,505,248,257
050,51,195,"Virginia","Wise County",5,67,460,217,243
050,51,195,"Virginia","Wise County",5,68,462,223,239
050,51,195,"Virginia","Wise County",5,69,467,236,231
050,51,195,"Virginia","Wise County",5,70,437,221,216
050,51,195,"Virginia","Wise County",5,71,441,213,228
050,51,195,"Virginia","Wise County",5,72,424,193,231
050,51,195,"Virginia","Wise County",5,73,378,168,210
050,51,195,"Virginia","Wise County",5,74,372,171,201
050,51,195,"Virginia","Wise County",5,75,349,164,185
050,51,195,"Virginia","Wise County",5,76,351,162,189
050,51,195,"Virginia","Wise County",5,77,231,100,131
050,51,195,"Virginia","Wise County",5,78,209,86,123
050,51,195,"Virginia","Wise County",5,79,208,100,108
050,51,195,"Virginia","Wise County",5,80,214,105,109
050,51,195,"Virginia","Wise County",5,81,178,85,93
050,51,195,"Virginia","Wise County",5,82,149,64,85
050,51,195,"Virginia","Wise County",5,83,140,62,78
050,51,195,"Virginia","Wise County",5,84,121,53,68
050,51,195,"Virginia","Wise County",5,85,562,216,346
050,51,197,"Virginia","Wythe County",1,0,255,133,122
050,51,197,"Virginia","Wythe County",1,1,285,144,141
050,51,197,"Virginia","Wythe County",1,2,291,144,147
050,51,197,"Virginia","Wythe County",1,3,289,145,144
050,51,197,"Virginia","Wythe County",1,4,269,143,126
050,51,197,"Virginia","Wythe County",1,5,298,158,140
050,51,197,"Virginia","Wythe County",1,6,275,127,148
050,51,197,"Virginia","Wythe County",1,7,296,148,148
050,51,197,"Virginia","Wythe County",1,8,325,175,150
050,51,197,"Virginia","Wythe County",1,9,302,146,156
050,51,197,"Virginia","Wythe County",1,10,299,154,145
050,51,197,"Virginia","Wythe County",1,11,336,181,155
050,51,197,"Virginia","Wythe County",1,12,328,168,160
050,51,197,"Virginia","Wythe County",1,13,360,194,166
050,51,197,"Virginia","Wythe County",1,14,357,184,173
050,51,197,"Virginia","Wythe County",1,15,346,178,168
050,51,197,"Virginia","Wythe County",1,16,351,187,164
050,51,197,"Virginia","Wythe County",1,17,351,192,159
050,51,197,"Virginia","Wythe County",1,18,296,154,142
050,51,197,"Virginia","Wythe County",1,19,243,115,128
050,51,197,"Virginia","Wythe County",1,20,264,136,128
050,51,197,"Virginia","Wythe County",1,21,268,139,129
050,51,197,"Virginia","Wythe County",1,22,239,125,114
050,51,197,"Virginia","Wythe County",1,23,261,135,126
050,51,197,"Virginia","Wythe County",1,24,275,141,134
050,51,197,"Virginia","Wythe County",1,25,302,166,136
050,51,197,"Virginia","Wythe County",1,26,325,166,159
050,51,197,"Virginia","Wythe County",1,27,328,161,167
050,51,197,"Virginia","Wythe County",1,28,299,141,158
050,51,197,"Virginia","Wythe County",1,29,333,161,172
050,51,197,"Virginia","Wythe County",1,30,320,152,168
050,51,197,"Virginia","Wythe County",1,31,309,155,154
050,51,197,"Virginia","Wythe County",1,32,305,162,143
050,51,197,"Virginia","Wythe County",1,33,298,152,146
050,51,197,"Virginia","Wythe County",1,34,319,159,160
050,51,197,"Virginia","Wythe County",1,35,327,170,157
050,51,197,"Virginia","Wythe County",1,36,337,165,172
050,51,197,"Virginia","Wythe County",1,37,331,163,168
050,51,197,"Virginia","Wythe County",1,38,295,146,149
050,51,197,"Virginia","Wythe County",1,39,324,158,166
050,51,197,"Virginia","Wythe County",1,40,333,158,175
050,51,197,"Virginia","Wythe County",1,41,307,152,155
050,51,197,"Virginia","Wythe County",1,42,318,162,156
050,51,197,"Virginia","Wythe County",1,43,337,176,161
050,51,197,"Virginia","Wythe County",1,44,336,163,173
050,51,197,"Virginia","Wythe County",1,45,364,184,180
050,51,197,"Virginia","Wythe County",1,46,354,176,178
050,51,197,"Virginia","Wythe County",1,47,391,202,189
050,51,197,"Virginia","Wythe County",1,48,442,225,217
050,51,197,"Virginia","Wythe County",1,49,465,238,227
050,51,197,"Virginia","Wythe County",1,50,400,209,191
050,51,197,"Virginia","Wythe County",1,51,418,199,219
050,51,197,"Virginia","Wythe County",1,52,420,194,226
050,51,197,"Virginia","Wythe County",1,53,414,207,207
050,51,197,"Virginia","Wythe County",1,54,441,229,212
050,51,197,"Virginia","Wythe County",1,55,454,234,220
050,51,197,"Virginia","Wythe County",1,56,436,225,211
050,51,197,"Virginia","Wythe County",1,57,442,214,228
050,51,197,"Virginia","Wythe County",1,58,415,198,217
050,51,197,"Virginia","Wythe County",1,59,385,184,201
050,51,197,"Virginia","Wythe County",1,60,407,186,221
050,51,197,"Virginia","Wythe County",1,61,420,200,220
050,51,197,"Virginia","Wythe County",1,62,432,209,223
050,51,197,"Virginia","Wythe County",1,63,422,206,216
050,51,197,"Virginia","Wythe County",1,64,417,197,220
050,51,197,"Virginia","Wythe County",1,65,396,184,212
050,51,197,"Virginia","Wythe County",1,66,419,192,227
050,51,197,"Virginia","Wythe County",1,67,401,195,206
050,51,197,"Virginia","Wythe County",1,68,386,183,203
050,51,197,"Virginia","Wythe County",1,69,372,186,186
050,51,197,"Virginia","Wythe County",1,70,375,190,185
050,51,197,"Virginia","Wythe County",1,71,358,168,190
050,51,197,"Virginia","Wythe County",1,72,361,165,196
050,51,197,"Virginia","Wythe County",1,73,326,148,178
050,51,197,"Virginia","Wythe County",1,74,239,121,118
050,51,197,"Virginia","Wythe County",1,75,236,112,124
050,51,197,"Virginia","Wythe County",1,76,258,127,131
050,51,197,"Virginia","Wythe County",1,77,239,108,131
050,51,197,"Virginia","Wythe County",1,78,219,86,133
050,51,197,"Virginia","Wythe County",1,79,191,83,108
050,51,197,"Virginia","Wythe County",1,80,185,88,97
050,51,197,"Virginia","Wythe County",1,81,175,75,100
050,51,197,"Virginia","Wythe County",1,82,139,60,79
050,51,197,"Virginia","Wythe County",1,83,118,50,68
050,51,197,"Virginia","Wythe County",1,84,116,53,63
050,51,197,"Virginia","Wythe County",1,85,601,207,394
050,51,197,"Virginia","Wythe County",2,0,275,143,132
050,51,197,"Virginia","Wythe County",2,1,278,140,138
050,51,197,"Virginia","Wythe County",2,2,293,145,148
050,51,197,"Virginia","Wythe County",2,3,288,146,142
050,51,197,"Virginia","Wythe County",2,4,276,144,132
050,51,197,"Virginia","Wythe County",2,5,292,154,138
050,51,197,"Virginia","Wythe County",2,6,282,135,147
050,51,197,"Virginia","Wythe County",2,7,290,143,147
050,51,197,"Virginia","Wythe County",2,8,315,167,148
050,51,197,"Virginia","Wythe County",2,9,306,152,154
050,51,197,"Virginia","Wythe County",2,10,298,150,148
050,51,197,"Virginia","Wythe County",2,11,325,174,151
050,51,197,"Virginia","Wythe County",2,12,335,175,160
050,51,197,"Virginia","Wythe County",2,13,353,188,165
050,51,197,"Virginia","Wythe County",2,14,359,188,171
050,51,197,"Virginia","Wythe County",2,15,349,180,169
050,51,197,"Virginia","Wythe County",2,16,351,185,166
050,51,197,"Virginia","Wythe County",2,17,350,190,160
050,51,197,"Virginia","Wythe County",2,18,294,156,138
050,51,197,"Virginia","Wythe County",2,19,241,116,125
050,51,197,"Virginia","Wythe County",2,20,270,136,134
050,51,197,"Virginia","Wythe County",2,21,268,138,130
050,51,197,"Virginia","Wythe County",2,22,247,129,118
050,51,197,"Virginia","Wythe County",2,23,261,135,126
050,51,197,"Virginia","Wythe County",2,24,274,143,131
050,51,197,"Virginia","Wythe County",2,25,299,160,139
050,51,197,"Virginia","Wythe County",2,26,322,167,155
050,51,197,"Virginia","Wythe County",2,27,324,161,163
050,51,197,"Virginia","Wythe County",2,28,308,146,162
050,51,197,"Virginia","Wythe County",2,29,327,157,170
050,51,197,"Virginia","Wythe County",2,30,325,155,170
050,51,197,"Virginia","Wythe County",2,31,313,156,157
050,51,197,"Virginia","Wythe County",2,32,306,160,146
050,51,197,"Virginia","Wythe County",2,33,302,156,146
050,51,197,"Virginia","Wythe County",2,34,316,159,157
050,51,197,"Virginia","Wythe County",2,35,328,168,160
050,51,197,"Virginia","Wythe County",2,36,334,166,168
050,51,197,"Virginia","Wythe County",2,37,330,163,167
050,51,197,"Virginia","Wythe County",2,38,305,151,154
050,51,197,"Virginia","Wythe County",2,39,321,157,164
050,51,197,"Virginia","Wythe County",2,40,332,160,172
050,51,197,"Virginia","Wythe County",2,41,312,153,159
050,51,197,"Virginia","Wythe County",2,42,310,156,154
050,51,197,"Virginia","Wythe County",2,43,336,174,162
050,51,197,"Virginia","Wythe County",2,44,336,166,170
050,51,197,"Virginia","Wythe County",2,45,357,179,178
050,51,197,"Virginia","Wythe County",2,46,355,177,178
050,51,197,"Virginia","Wythe County",2,47,381,195,186
050,51,197,"Virginia","Wythe County",2,48,429,217,212
050,51,197,"Virginia","Wythe County",2,49,463,235,228
050,51,197,"Virginia","Wythe County",2,50,417,216,201
050,51,197,"Virginia","Wythe County",2,51,414,202,212
050,51,197,"Virginia","Wythe County",2,52,419,196,223
050,51,197,"Virginia","Wythe County",2,53,418,206,212
050,51,197,"Virginia","Wythe County",2,54,434,222,212
050,51,197,"Virginia","Wythe County",2,55,449,232,217
050,51,197,"Virginia","Wythe County",2,56,443,228,215
050,51,197,"Virginia","Wythe County",2,57,442,218,224
050,51,197,"Virginia","Wythe County",2,58,420,203,217
050,51,197,"Virginia","Wythe County",2,59,394,190,204
050,51,197,"Virginia","Wythe County",2,60,398,183,215
050,51,197,"Virginia","Wythe County",2,61,417,197,220
050,51,197,"Virginia","Wythe County",2,62,429,206,223
050,51,197,"Virginia","Wythe County",2,63,427,209,218
050,51,197,"Virginia","Wythe County",2,64,413,194,219
050,51,197,"Virginia","Wythe County",2,65,400,186,214
050,51,197,"Virginia","Wythe County",2,66,417,193,224
050,51,197,"Virginia","Wythe County",2,67,407,195,212
050,51,197,"Virginia","Wythe County",2,68,387,185,202
050,51,197,"Virginia","Wythe County",2,69,378,186,192
050,51,197,"Virginia","Wythe County",2,70,374,190,184
050,51,197,"Virginia","Wythe County",2,71,362,172,190
050,51,197,"Virginia","Wythe County",2,72,352,163,189
050,51,197,"Virginia","Wythe County",2,73,354,161,193
050,51,197,"Virginia","Wythe County",2,74,243,119,124
050,51,197,"Virginia","Wythe County",2,75,232,111,121
050,51,197,"Virginia","Wythe County",2,76,247,118,129
050,51,197,"Virginia","Wythe County",2,77,247,115,132
050,51,197,"Virginia","Wythe County",2,78,217,88,129
050,51,197,"Virginia","Wythe County",2,79,195,83,112
050,51,197,"Virginia","Wythe County",2,80,185,87,98
050,51,197,"Virginia","Wythe County",2,81,171,75,96
050,51,197,"Virginia","Wythe County",2,82,147,63,84
050,51,197,"Virginia","Wythe County",2,83,121,51,70
050,51,197,"Virginia","Wythe County",2,84,112,49,63
050,51,197,"Virginia","Wythe County",2,85,601,211,390
050,51,197,"Virginia","Wythe County",3,0,255,120,135
050,51,197,"Virginia","Wythe County",3,1,265,127,138
050,51,197,"Virginia","Wythe County",3,2,283,143,140
050,51,197,"Virginia","Wythe County",3,3,288,146,142
050,51,197,"Virginia","Wythe County",3,4,281,148,133
050,51,197,"Virginia","Wythe County",3,5,274,141,133
050,51,197,"Virginia","Wythe County",3,6,281,150,131
050,51,197,"Virginia","Wythe County",3,7,274,132,142
050,51,197,"Virginia","Wythe County",3,8,302,150,152
050,51,197,"Virginia","Wythe County",3,9,308,170,138
050,51,197,"Virginia","Wythe County",3,10,311,160,151
050,51,197,"Virginia","Wythe County",3,11,304,154,150
050,51,197,"Virginia","Wythe County",3,12,330,175,155
050,51,197,"Virginia","Wythe County",3,13,346,179,167
050,51,197,"Virginia","Wythe County",3,14,357,191,166
050,51,197,"Virginia","Wythe County",3,15,365,193,172
050,51,197,"Virginia","Wythe County",3,16,334,171,163
050,51,197,"Virginia","Wythe County",3,17,358,184,174
050,51,197,"Virginia","Wythe County",3,18,309,175,134
050,51,197,"Virginia","Wythe County",3,19,234,121,113
050,51,197,"Virginia","Wythe County",3,20,249,118,131
050,51,197,"Virginia","Wythe County",3,21,284,146,138
050,51,197,"Virginia","Wythe County",3,22,284,147,137
050,51,197,"Virginia","Wythe County",3,23,253,135,118
050,51,197,"Virginia","Wythe County",3,24,262,127,135
050,51,197,"Virginia","Wythe County",3,25,276,140,136
050,51,197,"Virginia","Wythe County",3,26,309,161,148
050,51,197,"Virginia","Wythe County",3,27,336,178,158
050,51,197,"Virginia","Wythe County",3,28,332,171,161
050,51,197,"Virginia","Wythe County",3,29,318,148,170
050,51,197,"Virginia","Wythe County",3,30,330,157,173
050,51,197,"Virginia","Wythe County",3,31,331,158,173
050,51,197,"Virginia","Wythe County",3,32,311,153,158
050,51,197,"Virginia","Wythe County",3,33,323,169,154
050,51,197,"Virginia","Wythe County",3,34,303,156,147
050,51,197,"Virginia","Wythe County",3,35,323,169,154
050,51,197,"Virginia","Wythe County",3,36,337,175,162
050,51,197,"Virginia","Wythe County",3,37,338,169,169
050,51,197,"Virginia","Wythe County",3,38,334,164,170
050,51,197,"Virginia","Wythe County",3,39,311,152,159
050,51,197,"Virginia","Wythe County",3,40,324,162,162
050,51,197,"Virginia","Wythe County",3,41,333,157,176
050,51,197,"Virginia","Wythe County",3,42,318,152,166
050,51,197,"Virginia","Wythe County",3,43,313,158,155
050,51,197,"Virginia","Wythe County",3,44,331,172,159
050,51,197,"Virginia","Wythe County",3,45,333,168,165
050,51,197,"Virginia","Wythe County",3,46,349,178,171
050,51,197,"Virginia","Wythe County",3,47,356,182,174
050,51,197,"Virginia","Wythe County",3,48,382,192,190
050,51,197,"Virginia","Wythe County",3,49,424,214,210
050,51,197,"Virginia","Wythe County",3,50,449,225,224
050,51,197,"Virginia","Wythe County",3,51,426,218,208
050,51,197,"Virginia","Wythe County",3,52,404,199,205
050,51,197,"Virginia","Wythe County",3,53,419,196,223
050,51,197,"Virginia","Wythe County",3,54,399,198,201
050,51,197,"Virginia","Wythe County",3,55,449,219,230
050,51,197,"Virginia","Wythe County",3,56,446,229,217
050,51,197,"Virginia","Wythe County",3,57,455,234,221
050,51,197,"Virginia","Wythe County",3,58,435,210,225
050,51,197,"Virginia","Wythe County",3,59,412,201,211
050,51,197,"Virginia","Wythe County",3,60,386,185,201
050,51,197,"Virginia","Wythe County",3,61,384,173,211
050,51,197,"Virginia","Wythe County",3,62,407,190,217
050,51,197,"Virginia","Wythe County",3,63,430,205,225
050,51,197,"Virginia","Wythe County",3,64,424,207,217
050,51,197,"Virginia","Wythe County",3,65,410,190,220
050,51,197,"Virginia","Wythe County",3,66,390,182,208
050,51,197,"Virginia","Wythe County",3,67,408,188,220
050,51,197,"Virginia","Wythe County",3,68,391,185,206
050,51,197,"Virginia","Wythe County",3,69,383,183,200
050,51,197,"Virginia","Wythe County",3,70,369,178,191
050,51,197,"Virginia","Wythe County",3,71,364,186,178
050,51,197,"Virginia","Wythe County",3,72,346,161,185
050,51,197,"Virginia","Wythe County",3,73,340,155,185
050,51,197,"Virginia","Wythe County",3,74,341,155,186
050,51,197,"Virginia","Wythe County",3,75,230,113,117
050,51,197,"Virginia","Wythe County",3,76,227,109,118
050,51,197,"Virginia","Wythe County",3,77,233,112,121
050,51,197,"Virginia","Wythe County",3,78,239,107,132
050,51,197,"Virginia","Wythe County",3,79,205,83,122
050,51,197,"Virginia","Wythe County",3,80,183,80,103
050,51,197,"Virginia","Wythe County",3,81,161,76,85
050,51,197,"Virginia","Wythe County",3,82,162,69,93
050,51,197,"Virginia","Wythe County",3,83,138,59,79
050,51,197,"Virginia","Wythe County",3,84,107,41,66
050,51,197,"Virginia","Wythe County",3,85,583,201,382
050,51,197,"Virginia","Wythe County",4,0,277,127,150
050,51,197,"Virginia","Wythe County",4,1,248,120,128
050,51,197,"Virginia","Wythe County",4,2,272,126,146
050,51,197,"Virginia","Wythe County",4,3,289,144,145
050,51,197,"Virginia","Wythe County",4,4,277,138,139
050,51,197,"Virginia","Wythe County",4,5,298,163,135
050,51,197,"Virginia","Wythe County",4,6,292,153,139
050,51,197,"Virginia","Wythe County",4,7,286,159,127
050,51,197,"Virginia","Wythe County",4,8,283,140,143
050,51,197,"Virginia","Wythe County",4,9,303,151,152
050,51,197,"Virginia","Wythe County",4,10,312,175,137
050,51,197,"Virginia","Wythe County",4,11,316,167,149
050,51,197,"Virginia","Wythe County",4,12,306,154,152
050,51,197,"Virginia","Wythe County",4,13,328,177,151
050,51,197,"Virginia","Wythe County",4,14,346,181,165
050,51,197,"Virginia","Wythe County",4,15,357,193,164
050,51,197,"Virginia","Wythe County",4,16,357,191,166
050,51,197,"Virginia","Wythe County",4,17,341,176,165
050,51,197,"Virginia","Wythe County",4,18,286,150,136
050,51,197,"Virginia","Wythe County",4,19,241,135,106
050,51,197,"Virginia","Wythe County",4,20,252,132,120
050,51,197,"Virginia","Wythe County",4,21,260,119,141
050,51,197,"Virginia","Wythe County",4,22,295,152,143
050,51,197,"Virginia","Wythe County",4,23,306,162,144
050,51,197,"Virginia","Wythe County",4,24,255,137,118
050,51,197,"Virginia","Wythe County",4,25,260,129,131
050,51,197,"Virginia","Wythe County",4,26,283,145,138
050,51,197,"Virginia","Wythe County",4,27,326,168,158
050,51,197,"Virginia","Wythe County",4,28,338,179,159
050,51,197,"Virginia","Wythe County",4,29,327,169,158
050,51,197,"Virginia","Wythe County",4,30,327,152,175
050,51,197,"Virginia","Wythe County",4,31,339,165,174
050,51,197,"Virginia","Wythe County",4,32,324,156,168
050,51,197,"Virginia","Wythe County",4,33,310,155,155
050,51,197,"Virginia","Wythe County",4,34,315,166,149
050,51,197,"Virginia","Wythe County",4,35,292,150,142
050,51,197,"Virginia","Wythe County",4,36,325,170,155
050,51,197,"Virginia","Wythe County",4,37,344,172,172
050,51,197,"Virginia","Wythe County",4,38,340,166,174
050,51,197,"Virginia","Wythe County",4,39,343,166,177
050,51,197,"Virginia","Wythe County",4,40,307,151,156
050,51,197,"Virginia","Wythe County",4,41,327,164,163
050,51,197,"Virginia","Wythe County",4,42,331,159,172
050,51,197,"Virginia","Wythe County",4,43,336,161,175
050,51,197,"Virginia","Wythe County",4,44,322,162,160
050,51,197,"Virginia","Wythe County",4,45,314,166,148
050,51,197,"Virginia","Wythe County",4,46,332,162,170
050,51,197,"Virginia","Wythe County",4,47,352,176,176
050,51,197,"Virginia","Wythe County",4,48,358,180,178
050,51,197,"Virginia","Wythe County",4,49,385,196,189
050,51,197,"Virginia","Wythe County",4,50,427,210,217
050,51,197,"Virginia","Wythe County",4,51,433,221,212
050,51,197,"Virginia","Wythe County",4,52,425,213,212
050,51,197,"Virginia","Wythe County",4,53,401,196,205
050,51,197,"Virginia","Wythe County",4,54,426,199,227
050,51,197,"Virginia","Wythe County",4,55,388,190,198
050,51,197,"Virginia","Wythe County",4,56,445,210,235
050,51,197,"Virginia","Wythe County",4,57,435,218,217
050,51,197,"Virginia","Wythe County",4,58,452,230,222
050,51,197,"Virginia","Wythe County",4,59,440,215,225
050,51,197,"Virginia","Wythe County",4,60,416,202,214
050,51,197,"Virginia","Wythe County",4,61,390,185,205
050,51,197,"Virginia","Wythe County",4,62,387,178,209
050,51,197,"Virginia","Wythe County",4,63,417,197,220
050,51,197,"Virginia","Wythe County",4,64,426,200,226
050,51,197,"Virginia","Wythe County",4,65,430,214,216
050,51,197,"Virginia","Wythe County",4,66,398,181,217
050,51,197,"Virginia","Wythe County",4,67,386,177,209
050,51,197,"Virginia","Wythe County",4,68,401,187,214
050,51,197,"Virginia","Wythe County",4,69,388,183,205
050,51,197,"Virginia","Wythe County",4,70,360,170,190
050,51,197,"Virginia","Wythe County",4,71,360,171,189
050,51,197,"Virginia","Wythe County",4,72,344,176,168
050,51,197,"Virginia","Wythe County",4,73,327,149,178
050,51,197,"Virginia","Wythe County",4,74,331,151,180
050,51,197,"Virginia","Wythe County",4,75,326,147,179
050,51,197,"Virginia","Wythe County",4,76,222,109,113
050,51,197,"Virginia","Wythe County",4,77,214,99,115
050,51,197,"Virginia","Wythe County",4,78,224,105,119
050,51,197,"Virginia","Wythe County",4,79,223,99,124
050,51,197,"Virginia","Wythe County",4,80,190,77,113
050,51,197,"Virginia","Wythe County",4,81,160,65,95
050,51,197,"Virginia","Wythe County",4,82,156,77,79
050,51,197,"Virginia","Wythe County",4,83,148,62,86
050,51,197,"Virginia","Wythe County",4,84,125,53,72
050,51,197,"Virginia","Wythe County",4,85,554,195,359
050,51,197,"Virginia","Wythe County",5,0,278,125,153
050,51,197,"Virginia","Wythe County",5,1,276,117,159
050,51,197,"Virginia","Wythe County",5,2,246,122,124
050,51,197,"Virginia","Wythe County",5,3,277,127,150
050,51,197,"Virginia","Wythe County",5,4,287,149,138
050,51,197,"Virginia","Wythe County",5,5,267,133,134
050,51,197,"Virginia","Wythe County",5,6,304,159,145
050,51,197,"Virginia","Wythe County",5,7,304,155,149
050,51,197,"Virginia","Wythe County",5,8,280,158,122
050,51,197,"Virginia","Wythe County",5,9,287,143,144
050,51,197,"Virginia","Wythe County",5,10,316,164,152
050,51,197,"Virginia","Wythe County",5,11,308,176,132
050,51,197,"Virginia","Wythe County",5,12,325,171,154
050,51,197,"Virginia","Wythe County",5,13,303,149,154
050,51,197,"Virginia","Wythe County",5,14,333,187,146
050,51,197,"Virginia","Wythe County",5,15,345,182,163
050,51,197,"Virginia","Wythe County",5,16,357,194,163
050,51,197,"Virginia","Wythe County",5,17,361,191,170
050,51,197,"Virginia","Wythe County",5,18,292,159,133
050,51,197,"Virginia","Wythe County",5,19,227,119,108
050,51,197,"Virginia","Wythe County",5,20,264,146,118
050,51,197,"Virginia","Wythe County",5,21,269,137,132
050,51,197,"Virginia","Wythe County",5,22,292,137,155
050,51,197,"Virginia","Wythe County",5,23,313,158,155
050,51,197,"Virginia","Wythe County",5,24,303,161,142
050,51,197,"Virginia","Wythe County",5,25,248,130,118
050,51,197,"Virginia","Wythe County",5,26,250,120,130
050,51,197,"Virginia","Wythe County",5,27,282,150,132
050,51,197,"Virginia","Wythe County",5,28,331,175,156
050,51,197,"Virginia","Wythe County",5,29,333,168,165
050,51,197,"Virginia","Wythe County",5,30,311,163,148
050,51,197,"Virginia","Wythe County",5,31,343,157,186
050,51,197,"Virginia","Wythe County",5,32,332,153,179
050,51,197,"Virginia","Wythe County",5,33,331,161,170
050,51,197,"Virginia","Wythe County",5,34,309,152,157
050,51,197,"Virginia","Wythe County",5,35,317,168,149
050,51,197,"Virginia","Wythe County",5,36,312,154,158
050,51,197,"Virginia","Wythe County",5,37,341,178,163
050,51,197,"Virginia","Wythe County",5,38,357,175,182
050,51,197,"Virginia","Wythe County",5,39,348,170,178
050,51,197,"Virginia","Wythe County",5,40,346,175,171
050,51,197,"Virginia","Wythe County",5,41,313,155,158
050,51,197,"Virginia","Wythe County",5,42,329,160,169
050,51,197,"Virginia","Wythe County",5,43,334,163,171
050,51,197,"Virginia","Wythe County",5,44,329,160,169
050,51,197,"Virginia","Wythe County",5,45,323,163,160
050,51,197,"Virginia","Wythe County",5,46,318,166,152
050,51,197,"Virginia","Wythe County",5,47,332,163,169
050,51,197,"Virginia","Wythe County",5,48,349,176,173
050,51,197,"Virginia","Wythe County",5,49,359,175,184
050,51,197,"Virginia","Wythe County",5,50,388,199,189
050,51,197,"Virginia","Wythe County",5,51,429,212,217
050,51,197,"Virginia","Wythe County",5,52,431,220,211
050,51,197,"Virginia","Wythe County",5,53,437,223,214
050,51,197,"Virginia","Wythe County",5,54,396,196,200
050,51,197,"Virginia","Wythe County",5,55,415,195,220
050,51,197,"Virginia","Wythe County",5,56,386,186,200
050,51,197,"Virginia","Wythe County",5,57,444,206,238
050,51,197,"Virginia","Wythe County",5,58,437,221,216
050,51,197,"Virginia","Wythe County",5,59,445,227,218
050,51,197,"Virginia","Wythe County",5,60,438,212,226
050,51,197,"Virginia","Wythe County",5,61,412,199,213
050,51,197,"Virginia","Wythe County",5,62,389,184,205
050,51,197,"Virginia","Wythe County",5,63,382,181,201
050,51,197,"Virginia","Wythe County",5,64,409,195,214
050,51,197,"Virginia","Wythe County",5,65,419,199,220
050,51,197,"Virginia","Wythe County",5,66,420,207,213
050,51,197,"Virginia","Wythe County",5,67,389,172,217
050,51,197,"Virginia","Wythe County",5,68,382,173,209
050,51,197,"Virginia","Wythe County",5,69,400,182,218
050,51,197,"Virginia","Wythe County",5,70,386,185,201
050,51,197,"Virginia","Wythe County",5,71,354,161,193
050,51,197,"Virginia","Wythe County",5,72,349,164,185
050,51,197,"Virginia","Wythe County",5,73,330,169,161
050,51,197,"Virginia","Wythe County",5,74,320,147,173
050,51,197,"Virginia","Wythe County",5,75,323,149,174
050,51,197,"Virginia","Wythe County",5,76,315,144,171
050,51,197,"Virginia","Wythe County",5,77,214,103,111
050,51,197,"Virginia","Wythe County",5,78,198,90,108
050,51,197,"Virginia","Wythe County",5,79,210,98,112
050,51,197,"Virginia","Wythe County",5,80,207,91,116
050,51,197,"Virginia","Wythe County",5,81,161,61,100
050,51,197,"Virginia","Wythe County",5,82,153,64,89
050,51,197,"Virginia","Wythe County",5,83,148,73,75
050,51,197,"Virginia","Wythe County",5,84,130,55,75
050,51,197,"Virginia","Wythe County",5,85,567,210,357
050,51,199,"Virginia","York County",1,0,624,323,301
050,51,199,"Virginia","York County",1,1,697,373,324
050,51,199,"Virginia","York County",1,2,773,395,378
050,51,199,"Virginia","York County",1,3,836,410,426
050,51,199,"Virginia","York County",1,4,825,409,416
050,51,199,"Virginia","York County",1,5,911,452,459
050,51,199,"Virginia","York County",1,6,957,494,463
050,51,199,"Virginia","York County",1,7,941,478,463
050,51,199,"Virginia","York County",1,8,974,511,463
050,51,199,"Virginia","York County",1,9,971,508,463
050,51,199,"Virginia","York County",1,10,953,458,495
050,51,199,"Virginia","York County",1,11,987,491,496
050,51,199,"Virginia","York County",1,12,1020,513,507
050,51,199,"Virginia","York County",1,13,1008,497,511
050,51,199,"Virginia","York County",1,14,1033,508,525
050,51,199,"Virginia","York County",1,15,1029,528,501
050,51,199,"Virginia","York County",1,16,1021,539,482
050,51,199,"Virginia","York County",1,17,1021,493,528
050,51,199,"Virginia","York County",1,18,896,458,438
050,51,199,"Virginia","York County",1,19,823,490,333
050,51,199,"Virginia","York County",1,20,956,581,375
050,51,199,"Virginia","York County",1,21,865,505,360
050,51,199,"Virginia","York County",1,22,843,475,368
050,51,199,"Virginia","York County",1,23,800,453,347
050,51,199,"Virginia","York County",1,24,822,426,396
050,51,199,"Virginia","York County",1,25,804,437,367
050,51,199,"Virginia","York County",1,26,763,408,355
050,51,199,"Virginia","York County",1,27,714,385,329
050,51,199,"Virginia","York County",1,28,783,411,372
050,51,199,"Virginia","York County",1,29,798,395,403
050,51,199,"Virginia","York County",1,30,795,402,393
050,51,199,"Virginia","York County",1,31,800,390,410
050,51,199,"Virginia","York County",1,32,828,389,439
050,51,199,"Virginia","York County",1,33,872,442,430
050,51,199,"Virginia","York County",1,34,929,454,475
050,51,199,"Virginia","York County",1,35,950,478,472
050,51,199,"Virginia","York County",1,36,1006,515,491
050,51,199,"Virginia","York County",1,37,1064,532,532
050,51,199,"Virginia","York County",1,38,1051,501,550
050,51,199,"Virginia","York County",1,39,1049,518,531
050,51,199,"Virginia","York County",1,40,971,481,490
050,51,199,"Virginia","York County",1,41,942,467,475
050,51,199,"Virginia","York County",1,42,908,461,447
050,51,199,"Virginia","York County",1,43,909,454,455
050,51,199,"Virginia","York County",1,44,843,433,410
050,51,199,"Virginia","York County",1,45,820,394,426
050,51,199,"Virginia","York County",1,46,757,382,375
050,51,199,"Virginia","York County",1,47,782,395,387
050,51,199,"Virginia","York County",1,48,835,392,443
050,51,199,"Virginia","York County",1,49,917,445,472
050,51,199,"Virginia","York County",1,50,893,445,448
050,51,199,"Virginia","York County",1,51,857,404,453
050,51,199,"Virginia","York County",1,52,838,416,422
050,51,199,"Virginia","York County",1,53,861,418,443
050,51,199,"Virginia","York County",1,54,867,422,445
050,51,199,"Virginia","York County",1,55,994,482,512
050,51,199,"Virginia","York County",1,56,1042,481,561
050,51,199,"Virginia","York County",1,57,1052,524,528
050,51,199,"Virginia","York County",1,58,1038,510,528
050,51,199,"Virginia","York County",1,59,990,485,505
050,51,199,"Virginia","York County",1,60,975,482,493
050,51,199,"Virginia","York County",1,61,951,462,489
050,51,199,"Virginia","York County",1,62,919,454,465
050,51,199,"Virginia","York County",1,63,883,434,449
050,51,199,"Virginia","York County",1,64,824,403,421
050,51,199,"Virginia","York County",1,65,789,374,415
050,51,199,"Virginia","York County",1,66,732,362,370
050,51,199,"Virginia","York County",1,67,725,350,375
050,51,199,"Virginia","York County",1,68,666,321,345
050,51,199,"Virginia","York County",1,69,638,293,345
050,51,199,"Virginia","York County",1,70,631,301,330
050,51,199,"Virginia","York County",1,71,664,315,349
050,51,199,"Virginia","York County",1,72,703,356,347
050,51,199,"Virginia","York County",1,73,660,313,347
050,51,199,"Virginia","York County",1,74,448,210,238
050,51,199,"Virginia","York County",1,75,478,216,262
050,51,199,"Virginia","York County",1,76,508,234,274
050,51,199,"Virginia","York County",1,77,492,236,256
050,51,199,"Virginia","York County",1,78,423,193,230
050,51,199,"Virginia","York County",1,79,378,171,207
050,51,199,"Virginia","York County",1,80,330,153,177
050,51,199,"Virginia","York County",1,81,315,139,176
050,51,199,"Virginia","York County",1,82,286,125,161
050,51,199,"Virginia","York County",1,83,239,103,136
050,51,199,"Virginia","York County",1,84,246,99,147
050,51,199,"Virginia","York County",1,85,1241,451,790
050,51,199,"Virginia","York County",2,0,636,334,302
050,51,199,"Virginia","York County",2,1,694,368,326
050,51,199,"Virginia","York County",2,2,769,394,375
050,51,199,"Virginia","York County",2,3,828,411,417
050,51,199,"Virginia","York County",2,4,845,418,427
050,51,199,"Virginia","York County",2,5,904,450,454
050,51,199,"Virginia","York County",2,6,954,488,466
050,51,199,"Virginia","York County",2,7,951,484,467
050,51,199,"Virginia","York County",2,8,966,504,462
050,51,199,"Virginia","York County",2,9,973,504,469
050,51,199,"Virginia","York County",2,10,960,468,492
050,51,199,"Virginia","York County",2,11,978,484,494
050,51,199,"Virginia","York County",2,12,1020,513,507
050,51,199,"Virginia","York County",2,13,1011,500,511
050,51,199,"Virginia","York County",2,14,1025,503,522
050,51,199,"Virginia","York County",2,15,1027,521,506
050,51,199,"Virginia","York County",2,16,1018,530,488
050,51,199,"Virginia","York County",2,17,1017,499,518
050,51,199,"Virginia","York County",2,18,889,457,432
050,51,199,"Virginia","York County",2,19,838,495,343
050,51,199,"Virginia","York County",2,20,959,583,376
050,51,199,"Virginia","York County",2,21,866,504,362
050,51,199,"Virginia","York County",2,22,837,473,364
050,51,199,"Virginia","York County",2,23,807,449,358
050,51,199,"Virginia","York County",2,24,812,430,382
050,51,199,"Virginia","York County",2,25,803,431,372
050,51,199,"Virginia","York County",2,26,760,405,355
050,51,199,"Virginia","York County",2,27,731,393,338
050,51,199,"Virginia","York County",2,28,771,403,368
050,51,199,"Virginia","York County",2,29,803,402,401
050,51,199,"Virginia","York County",2,30,810,407,403
050,51,199,"Virginia","York County",2,31,811,398,413
050,51,199,"Virginia","York County",2,32,829,391,438
050,51,199,"Virginia","York County",2,33,872,433,439
050,51,199,"Virginia","York County",2,34,925,457,468
050,51,199,"Virginia","York County",2,35,960,482,478
050,51,199,"Virginia","York County",2,36,1004,514,490
050,51,199,"Virginia","York County",2,37,1059,529,530
050,51,199,"Virginia","York County",2,38,1075,519,556
050,51,199,"Virginia","York County",2,39,1050,515,535
050,51,199,"Virginia","York County",2,40,992,495,497
050,51,199,"Virginia","York County",2,41,943,469,474
050,51,199,"Virginia","York County",2,42,916,462,454
050,51,199,"Virginia","York County",2,43,912,459,453
050,51,199,"Virginia","York County",2,44,852,435,417
050,51,199,"Virginia","York County",2,45,832,406,426
050,51,199,"Virginia","York County",2,46,768,380,388
050,51,199,"Virginia","York County",2,47,770,388,382
050,51,199,"Virginia","York County",2,48,820,393,427
050,51,199,"Virginia","York County",2,49,901,438,463
050,51,199,"Virginia","York County",2,50,899,444,455
050,51,199,"Virginia","York County",2,51,858,411,447
050,51,199,"Virginia","York County",2,52,839,410,429
050,51,199,"Virginia","York County",2,53,849,415,434
050,51,199,"Virginia","York County",2,54,861,419,442
050,51,199,"Virginia","York County",2,55,961,464,497
050,51,199,"Virginia","York County",2,56,1023,478,545
050,51,199,"Virginia","York County",2,57,1051,515,536
050,51,199,"Virginia","York County",2,58,1033,509,524
050,51,199,"Virginia","York County",2,59,1000,491,509
050,51,199,"Virginia","York County",2,60,976,480,496
050,51,199,"Virginia","York County",2,61,955,465,490
050,51,199,"Virginia","York County",2,62,928,456,472
050,51,199,"Virginia","York County",2,63,896,442,454
050,51,199,"Virginia","York County",2,64,830,406,424
050,51,199,"Virginia","York County",2,65,796,381,415
050,51,199,"Virginia","York County",2,66,752,369,383
050,51,199,"Virginia","York County",2,67,720,351,369
050,51,199,"Virginia","York County",2,68,674,326,348
050,51,199,"Virginia","York County",2,69,647,299,348
050,51,199,"Virginia","York County",2,70,631,298,333
050,51,199,"Virginia","York County",2,71,655,312,343
050,51,199,"Virginia","York County",2,72,683,342,341
050,51,199,"Virginia","York County",2,73,702,341,361
050,51,199,"Virginia","York County",2,74,467,218,249
050,51,199,"Virginia","York County",2,75,476,215,261
050,51,199,"Virginia","York County",2,76,497,227,270
050,51,199,"Virginia","York County",2,77,509,241,268
050,51,199,"Virginia","York County",2,78,429,197,232
050,51,199,"Virginia","York County",2,79,382,173,209
050,51,199,"Virginia","York County",2,80,337,155,182
050,51,199,"Virginia","York County",2,81,313,142,171
050,51,199,"Virginia","York County",2,82,291,126,165
050,51,199,"Virginia","York County",2,83,250,108,142
050,51,199,"Virginia","York County",2,84,242,102,140
050,51,199,"Virginia","York County",2,85,1267,464,803
050,51,199,"Virginia","York County",3,0,574,277,297
050,51,199,"Virginia","York County",3,1,700,383,317
050,51,199,"Virginia","York County",3,2,776,408,368
050,51,199,"Virginia","York County",3,3,823,409,414
050,51,199,"Virginia","York County",3,4,889,435,454
050,51,199,"Virginia","York County",3,5,930,457,473
050,51,199,"Virginia","York County",3,6,951,448,503
050,51,199,"Virginia","York County",3,7,952,499,453
050,51,199,"Virginia","York County",3,8,1000,523,477
050,51,199,"Virginia","York County",3,9,986,525,461
050,51,199,"Virginia","York County",3,10,981,500,481
050,51,199,"Virginia","York County",3,11,961,474,487
050,51,199,"Virginia","York County",3,12,975,495,480
050,51,199,"Virginia","York County",3,13,1028,507,521
050,51,199,"Virginia","York County",3,14,1009,498,511
050,51,199,"Virginia","York County",3,15,1012,498,514
050,51,199,"Virginia","York County",3,16,1042,516,526
050,51,199,"Virginia","York County",3,17,1024,517,507
050,51,199,"Virginia","York County",3,18,898,471,427
050,51,199,"Virginia","York County",3,19,837,489,348
050,51,199,"Virginia","York County",3,20,967,598,369
050,51,199,"Virginia","York County",3,21,934,524,410
050,51,199,"Virginia","York County",3,22,844,470,374
050,51,199,"Virginia","York County",3,23,831,470,361
050,51,199,"Virginia","York County",3,24,831,450,381
050,51,199,"Virginia","York County",3,25,791,406,385
050,51,199,"Virginia","York County",3,26,788,422,366
050,51,199,"Virginia","York County",3,27,765,406,359
050,51,199,"Virginia","York County",3,28,727,385,342
050,51,199,"Virginia","York County",3,29,805,401,404
050,51,199,"Virginia","York County",3,30,781,393,388
050,51,199,"Virginia","York County",3,31,866,419,447
050,51,199,"Virginia","York County",3,32,868,428,440
050,51,199,"Virginia","York County",3,33,913,440,473
050,51,199,"Virginia","York County",3,34,932,467,465
050,51,199,"Virginia","York County",3,35,984,499,485
050,51,199,"Virginia","York County",3,36,1001,501,500
050,51,199,"Virginia","York County",3,37,1025,529,496
050,51,199,"Virginia","York County",3,38,1099,534,565
050,51,199,"Virginia","York County",3,39,1095,533,562
050,51,199,"Virginia","York County",3,40,1053,513,540
050,51,199,"Virginia","York County",3,41,1046,529,517
050,51,199,"Virginia","York County",3,42,980,496,484
050,51,199,"Virginia","York County",3,43,950,477,473
050,51,199,"Virginia","York County",3,44,915,459,456
050,51,199,"Virginia","York County",3,45,859,427,432
050,51,199,"Virginia","York County",3,46,825,398,427
050,51,199,"Virginia","York County",3,47,771,394,377
050,51,199,"Virginia","York County",3,48,757,369,388
050,51,199,"Virginia","York County",3,49,817,397,420
050,51,199,"Virginia","York County",3,50,882,419,463
050,51,199,"Virginia","York County",3,51,884,434,450
050,51,199,"Virginia","York County",3,52,848,408,440
050,51,199,"Virginia","York County",3,53,827,416,411
050,51,199,"Virginia","York County",3,54,855,420,435
050,51,199,"Virginia","York County",3,55,846,410,436
050,51,199,"Virginia","York County",3,56,942,458,484
050,51,199,"Virginia","York County",3,57,1020,474,546
050,51,199,"Virginia","York County",3,58,1033,505,528
050,51,199,"Virginia","York County",3,59,1037,513,524
050,51,199,"Virginia","York County",3,60,986,473,513
050,51,199,"Virginia","York County",3,61,947,458,489
050,51,199,"Virginia","York County",3,62,926,450,476
050,51,199,"Virginia","York County",3,63,900,443,457
050,51,199,"Virginia","York County",3,64,867,419,448
050,51,199,"Virginia","York County",3,65,827,410,417
050,51,199,"Virginia","York County",3,66,803,387,416
050,51,199,"Virginia","York County",3,67,742,367,375
050,51,199,"Virginia","York County",3,68,715,346,369
050,51,199,"Virginia","York County",3,69,667,318,349
050,51,199,"Virginia","York County",3,70,654,303,351
050,51,199,"Virginia","York County",3,71,614,288,326
050,51,199,"Virginia","York County",3,72,642,303,339
050,51,199,"Virginia","York County",3,73,671,333,338
050,51,199,"Virginia","York County",3,74,692,328,364
050,51,199,"Virginia","York County",3,75,455,209,246
050,51,199,"Virginia","York County",3,76,459,206,253
050,51,199,"Virginia","York County",3,77,490,215,275
050,51,199,"Virginia","York County",3,78,503,233,270
050,51,199,"Virginia","York County",3,79,415,188,227
050,51,199,"Virginia","York County",3,80,367,168,199
050,51,199,"Virginia","York County",3,81,316,144,172
050,51,199,"Virginia","York County",3,82,301,129,172
050,51,199,"Virginia","York County",3,83,267,112,155
050,51,199,"Virginia","York County",3,84,234,98,136
050,51,199,"Virginia","York County",3,85,1302,493,809
050,51,199,"Virginia","York County",4,0,594,313,281
050,51,199,"Virginia","York County",4,1,635,300,335
050,51,199,"Virginia","York County",4,2,738,398,340
050,51,199,"Virginia","York County",4,3,802,420,382
050,51,199,"Virginia","York County",4,4,818,418,400
050,51,199,"Virginia","York County",4,5,902,441,461
050,51,199,"Virginia","York County",4,6,962,481,481
050,51,199,"Virginia","York County",4,7,955,449,506
050,51,199,"Virginia","York County",4,8,963,507,456
050,51,199,"Virginia","York County",4,9,1008,538,470
050,51,199,"Virginia","York County",4,10,1009,531,478
050,51,199,"Virginia","York County",4,11,1011,504,507
050,51,199,"Virginia","York County",4,12,975,498,477
050,51,199,"Virginia","York County",4,13,978,511,467
050,51,199,"Virginia","York County",4,14,1000,490,510
050,51,199,"Virginia","York County",4,15,996,494,502
050,51,199,"Virginia","York County",4,16,1032,522,510
050,51,199,"Virginia","York County",4,17,999,489,510
050,51,199,"Virginia","York County",4,18,883,479,404
050,51,199,"Virginia","York County",4,19,801,475,326
050,51,199,"Virginia","York County",4,20,948,579,369
050,51,199,"Virginia","York County",4,21,895,519,376
050,51,199,"Virginia","York County",4,22,907,466,441
050,51,199,"Virginia","York County",4,23,820,439,381
050,51,199,"Virginia","York County",4,24,783,456,327
050,51,199,"Virginia","York County",4,25,808,435,373
050,51,199,"Virginia","York County",4,26,788,391,397
050,51,199,"Virginia","York County",4,27,783,402,381
050,51,199,"Virginia","York County",4,28,750,403,347
050,51,199,"Virginia","York County",4,29,738,390,348
050,51,199,"Virginia","York County",4,30,810,402,408
050,51,199,"Virginia","York County",4,31,838,402,436
050,51,199,"Virginia","York County",4,32,878,432,446
050,51,199,"Virginia","York County",4,33,906,437,469
050,51,199,"Virginia","York County",4,34,943,456,487
050,51,199,"Virginia","York County",4,35,986,486,500
050,51,199,"Virginia","York County",4,36,1050,529,521
050,51,199,"Virginia","York County",4,37,1072,532,540
050,51,199,"Virginia","York County",4,38,1028,533,495
050,51,199,"Virginia","York County",4,39,1100,541,559
050,51,199,"Virginia","York County",4,40,1063,511,552
050,51,199,"Virginia","York County",4,41,1082,523,559
050,51,199,"Virginia","York County",4,42,1037,530,507
050,51,199,"Virginia","York County",4,43,1010,537,473
050,51,199,"Virginia","York County",4,44,936,481,455
050,51,199,"Virginia","York County",4,45,886,438,448
050,51,199,"Virginia","York County",4,46,866,432,434
050,51,199,"Virginia","York County",4,47,799,382,417
050,51,199,"Virginia","York County",4,48,760,389,371
050,51,199,"Virginia","York County",4,49,742,374,368
050,51,199,"Virginia","York County",4,50,822,402,420
050,51,199,"Virginia","York County",4,51,875,420,455
050,51,199,"Virginia","York County",4,52,846,407,439
050,51,199,"Virginia","York County",4,53,828,395,433
050,51,199,"Virginia","York County",4,54,809,404,405
050,51,199,"Virginia","York County",4,55,865,426,439
050,51,199,"Virginia","York County",4,56,829,397,432
050,51,199,"Virginia","York County",4,57,904,442,462
050,51,199,"Virginia","York County",4,58,1010,473,537
050,51,199,"Virginia","York County",4,59,994,475,519
050,51,199,"Virginia","York County",4,60,1015,501,514
050,51,199,"Virginia","York County",4,61,971,466,505
050,51,199,"Virginia","York County",4,62,919,449,470
050,51,199,"Virginia","York County",4,63,931,453,478
050,51,199,"Virginia","York County",4,64,879,430,449
050,51,199,"Virginia","York County",4,65,847,403,444
050,51,199,"Virginia","York County",4,66,826,399,427
050,51,199,"Virginia","York County",4,67,795,387,408
050,51,199,"Virginia","York County",4,68,740,364,376
050,51,199,"Virginia","York County",4,69,714,345,369
050,51,199,"Virginia","York County",4,70,681,324,357
050,51,199,"Virginia","York County",4,71,642,296,346
050,51,199,"Virginia","York County",4,72,605,283,322
050,51,199,"Virginia","York County",4,73,637,298,339
050,51,199,"Virginia","York County",4,74,666,325,341
050,51,199,"Virginia","York County",4,75,694,327,367
050,51,199,"Virginia","York County",4,76,445,206,239
050,51,199,"Virginia","York County",4,77,446,194,252
050,51,199,"Virginia","York County",4,78,478,206,272
050,51,199,"Virginia","York County",4,79,488,224,264
050,51,199,"Virginia","York County",4,80,397,179,218
050,51,199,"Virginia","York County",4,81,345,158,187
050,51,199,"Virginia","York County",4,82,299,129,170
050,51,199,"Virginia","York County",4,83,280,126,154
050,51,199,"Virginia","York County",4,84,248,108,140
050,51,199,"Virginia","York County",4,85,1321,511,810
050,51,199,"Virginia","York County",5,0,591,312,279
050,51,199,"Virginia","York County",5,1,615,328,287
050,51,199,"Virginia","York County",5,2,701,330,371
050,51,199,"Virginia","York County",5,3,744,390,354
050,51,199,"Virginia","York County",5,4,806,427,379
050,51,199,"Virginia","York County",5,5,857,429,428
050,51,199,"Virginia","York County",5,6,894,432,462
050,51,199,"Virginia","York County",5,7,1009,509,500
050,51,199,"Virginia","York County",5,8,973,469,504
050,51,199,"Virginia","York County",5,9,982,515,467
050,51,199,"Virginia","York County",5,10,1009,532,477
050,51,199,"Virginia","York County",5,11,1006,531,475
050,51,199,"Virginia","York County",5,12,1016,501,515
050,51,199,"Virginia","York County",5,13,949,478,471
050,51,199,"Virginia","York County",5,14,983,513,470
050,51,199,"Virginia","York County",5,15,1001,498,503
050,51,199,"Virginia","York County",5,16,988,489,499
050,51,199,"Virginia","York County",5,17,1006,516,490
050,51,199,"Virginia","York County",5,18,862,451,411
050,51,199,"Virginia","York County",5,19,823,509,314
050,51,199,"Virginia","York County",5,20,922,557,365
050,51,199,"Virginia","York County",5,21,938,538,400
050,51,199,"Virginia","York County",5,22,863,463,400
050,51,199,"Virginia","York County",5,23,851,429,422
050,51,199,"Virginia","York County",5,24,799,422,377
050,51,199,"Virginia","York County",5,25,743,410,333
050,51,199,"Virginia","York County",5,26,719,385,334
050,51,199,"Virginia","York County",5,27,751,396,355
050,51,199,"Virginia","York County",5,28,748,380,368
050,51,199,"Virginia","York County",5,29,757,396,361
050,51,199,"Virginia","York County",5,30,742,370,372
050,51,199,"Virginia","York County",5,31,806,399,407
050,51,199,"Virginia","York County",5,32,825,400,425
050,51,199,"Virginia","York County",5,33,894,437,457
050,51,199,"Virginia","York County",5,34,938,467,471
050,51,199,"Virginia","York County",5,35,971,477,494
050,51,199,"Virginia","York County",5,36,1045,533,512
050,51,199,"Virginia","York County",5,37,1087,543,544
050,51,199,"Virginia","York County",5,38,1080,543,537
050,51,199,"Virginia","York County",5,39,1042,538,504
050,51,199,"Virginia","York County",5,40,1074,528,546
050,51,199,"Virginia","York County",5,41,1052,517,535
050,51,199,"Virginia","York County",5,42,1084,527,557
050,51,199,"Virginia","York County",5,43,1002,513,489
050,51,199,"Virginia","York County",5,44,971,506,465
050,51,199,"Virginia","York County",5,45,899,439,460
050,51,199,"Virginia","York County",5,46,876,427,449
050,51,199,"Virginia","York County",5,47,844,418,426
050,51,199,"Virginia","York County",5,48,794,379,415
050,51,199,"Virginia","York County",5,49,753,392,361
050,51,199,"Virginia","York County",5,50,747,377,370
050,51,199,"Virginia","York County",5,51,804,391,413
050,51,199,"Virginia","York County",5,52,853,397,456
050,51,199,"Virginia","York County",5,53,836,393,443
050,51,199,"Virginia","York County",5,54,829,389,440
050,51,199,"Virginia","York County",5,55,820,403,417
050,51,199,"Virginia","York County",5,56,845,416,429
050,51,199,"Virginia","York County",5,57,843,401,442
050,51,199,"Virginia","York County",5,58,881,426,455
050,51,199,"Virginia","York County",5,59,987,460,527
050,51,199,"Virginia","York County",5,60,1004,481,523
050,51,199,"Virginia","York County",5,61,995,487,508
050,51,199,"Virginia","York County",5,62,962,465,497
050,51,199,"Virginia","York County",5,63,908,446,462
050,51,199,"Virginia","York County",5,64,920,443,477
050,51,199,"Virginia","York County",5,65,876,428,448
050,51,199,"Virginia","York County",5,66,842,399,443
050,51,199,"Virginia","York County",5,67,824,396,428
050,51,199,"Virginia","York County",5,68,793,380,413
050,51,199,"Virginia","York County",5,69,728,354,374
050,51,199,"Virginia","York County",5,70,709,336,373
050,51,199,"Virginia","York County",5,71,670,310,360
050,51,199,"Virginia","York County",5,72,634,286,348
050,51,199,"Virginia","York County",5,73,581,273,308
050,51,199,"Virginia","York County",5,74,630,289,341
050,51,199,"Virginia","York County",5,75,660,316,344
050,51,199,"Virginia","York County",5,76,663,307,356
050,51,199,"Virginia","York County",5,77,430,198,232
050,51,199,"Virginia","York County",5,78,439,187,252
050,51,199,"Virginia","York County",5,79,464,202,262
050,51,199,"Virginia","York County",5,80,475,223,252
050,51,199,"Virginia","York County",5,81,375,166,209
050,51,199,"Virginia","York County",5,82,331,143,188
050,51,199,"Virginia","York County",5,83,279,120,159
050,51,199,"Virginia","York County",5,84,263,117,146
050,51,199,"Virginia","York County",5,85,1367,537,830
050,51,510,"Virginia","Alexandria city",1,0,2571,1315,1256
050,51,510,"Virginia","Alexandria city",1,1,2421,1231,1190
050,51,510,"Virginia","Alexandria city",1,2,2237,1183,1054
050,51,510,"Virginia","Alexandria city",1,3,2095,1091,1004
050,51,510,"Virginia","Alexandria city",1,4,1954,1008,946
050,51,510,"Virginia","Alexandria city",1,5,1793,923,870
050,51,510,"Virginia","Alexandria city",1,6,1617,834,783
050,51,510,"Virginia","Alexandria city",1,7,1507,786,721
050,51,510,"Virginia","Alexandria city",1,8,1422,724,698
050,51,510,"Virginia","Alexandria city",1,9,1451,748,703
050,51,510,"Virginia","Alexandria city",1,10,1461,745,716
050,51,510,"Virginia","Alexandria city",1,11,1377,710,667
050,51,510,"Virginia","Alexandria city",1,12,1423,712,711
050,51,510,"Virginia","Alexandria city",1,13,1391,726,665
050,51,510,"Virginia","Alexandria city",1,14,1269,640,629
050,51,510,"Virginia","Alexandria city",1,15,1158,612,546
050,51,510,"Virginia","Alexandria city",1,16,1260,630,630
050,51,510,"Virginia","Alexandria city",1,17,1267,615,652
050,51,510,"Virginia","Alexandria city",1,18,1072,535,537
050,51,510,"Virginia","Alexandria city",1,19,951,454,497
050,51,510,"Virginia","Alexandria city",1,20,1022,465,557
050,51,510,"Virginia","Alexandria city",1,21,1110,542,568
050,51,510,"Virginia","Alexandria city",1,22,1319,613,706
050,51,510,"Virginia","Alexandria city",1,23,1717,782,935
050,51,510,"Virginia","Alexandria city",1,24,2077,921,1156
050,51,510,"Virginia","Alexandria city",1,25,2412,1078,1334
050,51,510,"Virginia","Alexandria city",1,26,2743,1191,1552
050,51,510,"Virginia","Alexandria city",1,27,2989,1364,1625
050,51,510,"Virginia","Alexandria city",1,28,3162,1450,1712
050,51,510,"Virginia","Alexandria city",1,29,3422,1607,1815
050,51,510,"Virginia","Alexandria city",1,30,3477,1680,1797
050,51,510,"Virginia","Alexandria city",1,31,3597,1718,1879
050,51,510,"Virginia","Alexandria city",1,32,3546,1679,1867
050,51,510,"Virginia","Alexandria city",1,33,3492,1711,1781
050,51,510,"Virginia","Alexandria city",1,34,3645,1804,1841
050,51,510,"Virginia","Alexandria city",1,35,3592,1762,1830
050,51,510,"Virginia","Alexandria city",1,36,3520,1750,1770
050,51,510,"Virginia","Alexandria city",1,37,3415,1737,1678
050,51,510,"Virginia","Alexandria city",1,38,3214,1628,1586
050,51,510,"Virginia","Alexandria city",1,39,3071,1564,1507
050,51,510,"Virginia","Alexandria city",1,40,2944,1470,1474
050,51,510,"Virginia","Alexandria city",1,41,2618,1321,1297
050,51,510,"Virginia","Alexandria city",1,42,2633,1327,1306
050,51,510,"Virginia","Alexandria city",1,43,2484,1310,1174
050,51,510,"Virginia","Alexandria city",1,44,2337,1187,1150
050,51,510,"Virginia","Alexandria city",1,45,2364,1201,1163
050,51,510,"Virginia","Alexandria city",1,46,2203,1113,1090
050,51,510,"Virginia","Alexandria city",1,47,2134,1097,1037
050,51,510,"Virginia","Alexandria city",1,48,2139,1034,1105
050,51,510,"Virginia","Alexandria city",1,49,2323,1155,1168
050,51,510,"Virginia","Alexandria city",1,50,2223,1097,1126
050,51,510,"Virginia","Alexandria city",1,51,2086,1015,1071
050,51,510,"Virginia","Alexandria city",1,52,1959,918,1041
050,51,510,"Virginia","Alexandria city",1,53,1964,938,1026
050,51,510,"Virginia","Alexandria city",1,54,1997,949,1048
050,51,510,"Virginia","Alexandria city",1,55,1961,981,980
050,51,510,"Virginia","Alexandria city",1,56,1959,986,973
050,51,510,"Virginia","Alexandria city",1,57,1973,985,988
050,51,510,"Virginia","Alexandria city",1,58,1880,941,939
050,51,510,"Virginia","Alexandria city",1,59,1817,905,912
050,51,510,"Virginia","Alexandria city",1,60,1783,872,911
050,51,510,"Virginia","Alexandria city",1,61,1770,851,919
050,51,510,"Virginia","Alexandria city",1,62,1637,761,876
050,51,510,"Virginia","Alexandria city",1,63,1539,715,824
050,51,510,"Virginia","Alexandria city",1,64,1482,690,792
050,51,510,"Virginia","Alexandria city",1,65,1454,670,784
050,51,510,"Virginia","Alexandria city",1,66,1392,642,750
050,51,510,"Virginia","Alexandria city",1,67,1302,570,732
050,51,510,"Virginia","Alexandria city",1,68,1234,533,701
050,51,510,"Virginia","Alexandria city",1,69,1190,519,671
050,51,510,"Virginia","Alexandria city",1,70,1147,532,615
050,51,510,"Virginia","Alexandria city",1,71,1151,536,615
050,51,510,"Virginia","Alexandria city",1,72,1126,500,626
050,51,510,"Virginia","Alexandria city",1,73,1102,476,626
050,51,510,"Virginia","Alexandria city",1,74,825,370,455
050,51,510,"Virginia","Alexandria city",1,75,814,370,444
050,51,510,"Virginia","Alexandria city",1,76,713,324,389
050,51,510,"Virginia","Alexandria city",1,77,688,323,365
050,51,510,"Virginia","Alexandria city",1,78,580,267,313
050,51,510,"Virginia","Alexandria city",1,79,477,202,275
050,51,510,"Virginia","Alexandria city",1,80,407,173,234
050,51,510,"Virginia","Alexandria city",1,81,403,175,228
050,51,510,"Virginia","Alexandria city",1,82,380,176,204
050,51,510,"Virginia","Alexandria city",1,83,313,126,187
050,51,510,"Virginia","Alexandria city",1,84,281,109,172
050,51,510,"Virginia","Alexandria city",1,85,2037,649,1388
050,51,510,"Virginia","Alexandria city",2,0,2500,1284,1216
050,51,510,"Virginia","Alexandria city",2,1,2392,1218,1174
050,51,510,"Virginia","Alexandria city",2,2,2231,1167,1064
050,51,510,"Virginia","Alexandria city",2,3,2079,1087,992
050,51,510,"Virginia","Alexandria city",2,4,1953,1011,942
050,51,510,"Virginia","Alexandria city",2,5,1795,923,872
050,51,510,"Virginia","Alexandria city",2,6,1633,844,789
050,51,510,"Virginia","Alexandria city",2,7,1508,783,725
050,51,510,"Virginia","Alexandria city",2,8,1424,731,693
050,51,510,"Virginia","Alexandria city",2,9,1431,736,695
050,51,510,"Virginia","Alexandria city",2,10,1438,737,701
050,51,510,"Virginia","Alexandria city",2,11,1372,705,667
050,51,510,"Virginia","Alexandria city",2,12,1404,711,693
050,51,510,"Virginia","Alexandria city",2,13,1385,716,669
050,51,510,"Virginia","Alexandria city",2,14,1288,654,634
050,51,510,"Virginia","Alexandria city",2,15,1180,614,566
050,51,510,"Virginia","Alexandria city",2,16,1244,632,612
050,51,510,"Virginia","Alexandria city",2,17,1252,608,644
050,51,510,"Virginia","Alexandria city",2,18,1082,542,540
050,51,510,"Virginia","Alexandria city",2,19,954,461,493
050,51,510,"Virginia","Alexandria city",2,20,1038,480,558
050,51,510,"Virginia","Alexandria city",2,21,1129,538,591
050,51,510,"Virginia","Alexandria city",2,22,1349,635,714
050,51,510,"Virginia","Alexandria city",2,23,1715,785,930
050,51,510,"Virginia","Alexandria city",2,24,2060,922,1138
050,51,510,"Virginia","Alexandria city",2,25,2396,1063,1333
050,51,510,"Virginia","Alexandria city",2,26,2711,1185,1526
050,51,510,"Virginia","Alexandria city",2,27,2957,1333,1624
050,51,510,"Virginia","Alexandria city",2,28,3161,1453,1708
050,51,510,"Virginia","Alexandria city",2,29,3368,1582,1786
050,51,510,"Virginia","Alexandria city",2,30,3478,1679,1799
050,51,510,"Virginia","Alexandria city",2,31,3546,1700,1846
050,51,510,"Virginia","Alexandria city",2,32,3520,1672,1848
050,51,510,"Virginia","Alexandria city",2,33,3476,1698,1778
050,51,510,"Virginia","Alexandria city",2,34,3570,1764,1806
050,51,510,"Virginia","Alexandria city",2,35,3592,1764,1828
050,51,510,"Virginia","Alexandria city",2,36,3481,1731,1750
050,51,510,"Virginia","Alexandria city",2,37,3405,1725,1680
050,51,510,"Virginia","Alexandria city",2,38,3240,1645,1595
050,51,510,"Virginia","Alexandria city",2,39,3062,1558,1504
050,51,510,"Virginia","Alexandria city",2,40,2955,1481,1474
050,51,510,"Virginia","Alexandria city",2,41,2671,1337,1334
050,51,510,"Virginia","Alexandria city",2,42,2586,1303,1283
050,51,510,"Virginia","Alexandria city",2,43,2501,1304,1197
050,51,510,"Virginia","Alexandria city",2,44,2335,1198,1137
050,51,510,"Virginia","Alexandria city",2,45,2352,1196,1156
050,51,510,"Virginia","Alexandria city",2,46,2222,1128,1094
050,51,510,"Virginia","Alexandria city",2,47,2132,1092,1040
050,51,510,"Virginia","Alexandria city",2,48,2128,1043,1085
050,51,510,"Virginia","Alexandria city",2,49,2278,1126,1152
050,51,510,"Virginia","Alexandria city",2,50,2238,1107,1131
050,51,510,"Virginia","Alexandria city",2,51,2100,1028,1072
050,51,510,"Virginia","Alexandria city",2,52,1985,937,1048
050,51,510,"Virginia","Alexandria city",2,53,1956,926,1030
050,51,510,"Virginia","Alexandria city",2,54,1976,944,1032
050,51,510,"Virginia","Alexandria city",2,55,1954,964,990
050,51,510,"Virginia","Alexandria city",2,56,1958,981,977
050,51,510,"Virginia","Alexandria city",2,57,1963,981,982
050,51,510,"Virginia","Alexandria city",2,58,1889,944,945
050,51,510,"Virginia","Alexandria city",2,59,1825,907,918
050,51,510,"Virginia","Alexandria city",2,60,1781,874,907
050,51,510,"Virginia","Alexandria city",2,61,1765,855,910
050,51,510,"Virginia","Alexandria city",2,62,1656,773,883
050,51,510,"Virginia","Alexandria city",2,63,1568,729,839
050,51,510,"Virginia","Alexandria city",2,64,1471,688,783
050,51,510,"Virginia","Alexandria city",2,65,1440,664,776
050,51,510,"Virginia","Alexandria city",2,66,1390,638,752
050,51,510,"Virginia","Alexandria city",2,67,1309,577,732
050,51,510,"Virginia","Alexandria city",2,68,1233,533,700
050,51,510,"Virginia","Alexandria city",2,69,1198,523,675
050,51,510,"Virginia","Alexandria city",2,70,1146,523,623
050,51,510,"Virginia","Alexandria city",2,71,1140,529,611
050,51,510,"Virginia","Alexandria city",2,72,1111,498,613
050,51,510,"Virginia","Alexandria city",2,73,1152,502,650
050,51,510,"Virginia","Alexandria city",2,74,840,371,469
050,51,510,"Virginia","Alexandria city",2,75,807,365,442
050,51,510,"Virginia","Alexandria city",2,76,724,326,398
050,51,510,"Virginia","Alexandria city",2,77,702,329,373
050,51,510,"Virginia","Alexandria city",2,78,590,274,316
050,51,510,"Virginia","Alexandria city",2,79,492,211,281
050,51,510,"Virginia","Alexandria city",2,80,418,178,240
050,51,510,"Virginia","Alexandria city",2,81,395,171,224
050,51,510,"Virginia","Alexandria city",2,82,381,174,207
050,51,510,"Virginia","Alexandria city",2,83,320,133,187
050,51,510,"Virginia","Alexandria city",2,84,278,108,170
050,51,510,"Virginia","Alexandria city",2,85,2029,648,1381
050,51,510,"Virginia","Alexandria city",3,0,2301,1144,1157
050,51,510,"Virginia","Alexandria city",3,1,2137,1090,1047
050,51,510,"Virginia","Alexandria city",3,2,2113,1079,1034
050,51,510,"Virginia","Alexandria city",3,3,2012,1033,979
050,51,510,"Virginia","Alexandria city",3,4,1887,984,903
050,51,510,"Virginia","Alexandria city",3,5,1768,915,853
050,51,510,"Virginia","Alexandria city",3,6,1635,856,779
050,51,510,"Virginia","Alexandria city",3,7,1545,805,740
050,51,510,"Virginia","Alexandria city",3,8,1443,738,705
050,51,510,"Virginia","Alexandria city",3,9,1357,699,658
050,51,510,"Virginia","Alexandria city",3,10,1349,690,659
050,51,510,"Virginia","Alexandria city",3,11,1342,686,656
050,51,510,"Virginia","Alexandria city",3,12,1335,691,644
050,51,510,"Virginia","Alexandria city",3,13,1361,697,664
050,51,510,"Virginia","Alexandria city",3,14,1332,681,651
050,51,510,"Virginia","Alexandria city",3,15,1249,641,608
050,51,510,"Virginia","Alexandria city",3,16,1226,651,575
050,51,510,"Virginia","Alexandria city",3,17,1220,601,619
050,51,510,"Virginia","Alexandria city",3,18,1078,522,556
050,51,510,"Virginia","Alexandria city",3,19,941,456,485
050,51,510,"Virginia","Alexandria city",3,20,1046,476,570
050,51,510,"Virginia","Alexandria city",3,21,1060,482,578
050,51,510,"Virginia","Alexandria city",3,22,1263,571,692
050,51,510,"Virginia","Alexandria city",3,23,1594,749,845
050,51,510,"Virginia","Alexandria city",3,24,1946,832,1114
050,51,510,"Virginia","Alexandria city",3,25,2236,1058,1178
050,51,510,"Virginia","Alexandria city",3,26,2610,1163,1447
050,51,510,"Virginia","Alexandria city",3,27,2872,1303,1569
050,51,510,"Virginia","Alexandria city",3,28,3006,1404,1602
050,51,510,"Virginia","Alexandria city",3,29,3053,1438,1615
050,51,510,"Virginia","Alexandria city",3,30,3343,1631,1712
050,51,510,"Virginia","Alexandria city",3,31,3376,1659,1717
050,51,510,"Virginia","Alexandria city",3,32,3365,1626,1739
050,51,510,"Virginia","Alexandria city",3,33,3398,1670,1728
050,51,510,"Virginia","Alexandria city",3,34,3338,1643,1695
050,51,510,"Virginia","Alexandria city",3,35,3351,1653,1698
050,51,510,"Virginia","Alexandria city",3,36,3404,1666,1738
050,51,510,"Virginia","Alexandria city",3,37,3247,1602,1645
050,51,510,"Virginia","Alexandria city",3,38,3218,1662,1556
050,51,510,"Virginia","Alexandria city",3,39,2976,1519,1457
050,51,510,"Virginia","Alexandria city",3,40,2808,1421,1387
050,51,510,"Virginia","Alexandria city",3,41,2758,1368,1390
050,51,510,"Virginia","Alexandria city",3,42,2500,1246,1254
050,51,510,"Virginia","Alexandria city",3,43,2407,1219,1188
050,51,510,"Virginia","Alexandria city",3,44,2392,1215,1177
050,51,510,"Virginia","Alexandria city",3,45,2248,1146,1102
050,51,510,"Virginia","Alexandria city",3,46,2235,1157,1078
050,51,510,"Virginia","Alexandria city",3,47,2107,1069,1038
050,51,510,"Virginia","Alexandria city",3,48,2045,1032,1013
050,51,510,"Virginia","Alexandria city",3,49,2077,1037,1040
050,51,510,"Virginia","Alexandria city",3,50,2166,1063,1103
050,51,510,"Virginia","Alexandria city",3,51,2187,1079,1108
050,51,510,"Virginia","Alexandria city",3,52,2039,1007,1032
050,51,510,"Virginia","Alexandria city",3,53,1931,913,1018
050,51,510,"Virginia","Alexandria city",3,54,1890,905,985
050,51,510,"Virginia","Alexandria city",3,55,1908,910,998
050,51,510,"Virginia","Alexandria city",3,56,1905,944,961
050,51,510,"Virginia","Alexandria city",3,57,1872,933,939
050,51,510,"Virginia","Alexandria city",3,58,1785,888,897
050,51,510,"Virginia","Alexandria city",3,59,1804,905,899
050,51,510,"Virginia","Alexandria city",3,60,1744,842,902
050,51,510,"Virginia","Alexandria city",3,61,1686,855,831
050,51,510,"Virginia","Alexandria city",3,62,1660,801,859
050,51,510,"Virginia","Alexandria city",3,63,1535,718,817
050,51,510,"Virginia","Alexandria city",3,64,1472,687,785
050,51,510,"Virginia","Alexandria city",3,65,1395,665,730
050,51,510,"Virginia","Alexandria city",3,66,1346,617,729
050,51,510,"Virginia","Alexandria city",3,67,1342,613,729
050,51,510,"Virginia","Alexandria city",3,68,1273,562,711
050,51,510,"Virginia","Alexandria city",3,69,1176,514,662
050,51,510,"Virginia","Alexandria city",3,70,1159,498,661
050,51,510,"Virginia","Alexandria city",3,71,1103,495,608
050,51,510,"Virginia","Alexandria city",3,72,1101,504,597
050,51,510,"Virginia","Alexandria city",3,73,1085,483,602
050,51,510,"Virginia","Alexandria city",3,74,1121,493,628
050,51,510,"Virginia","Alexandria city",3,75,807,349,458
050,51,510,"Virginia","Alexandria city",3,76,767,336,431
050,51,510,"Virginia","Alexandria city",3,77,723,322,401
050,51,510,"Virginia","Alexandria city",3,78,685,323,362
050,51,510,"Virginia","Alexandria city",3,79,588,272,316
050,51,510,"Virginia","Alexandria city",3,80,468,196,272
050,51,510,"Virginia","Alexandria city",3,81,388,168,220
050,51,510,"Virginia","Alexandria city",3,82,384,176,208
050,51,510,"Virginia","Alexandria city",3,83,354,157,197
050,51,510,"Virginia","Alexandria city",3,84,279,114,165
050,51,510,"Virginia","Alexandria city",3,85,2067,660,1407
050,51,510,"Virginia","Alexandria city",4,0,2285,1128,1157
050,51,510,"Virginia","Alexandria city",4,1,2069,1052,1017
050,51,510,"Virginia","Alexandria city",4,2,1952,986,966
050,51,510,"Virginia","Alexandria city",4,3,1881,929,952
050,51,510,"Virginia","Alexandria city",4,4,1866,970,896
050,51,510,"Virginia","Alexandria city",4,5,1693,870,823
050,51,510,"Virginia","Alexandria city",4,6,1656,867,789
050,51,510,"Virginia","Alexandria city",4,7,1508,796,712
050,51,510,"Virginia","Alexandria city",4,8,1446,756,690
050,51,510,"Virginia","Alexandria city",4,9,1407,717,690
050,51,510,"Virginia","Alexandria city",4,10,1339,688,651
050,51,510,"Virginia","Alexandria city",4,11,1334,706,628
050,51,510,"Virginia","Alexandria city",4,12,1310,668,642
050,51,510,"Virginia","Alexandria city",4,13,1319,673,646
050,51,510,"Virginia","Alexandria city",4,14,1333,663,670
050,51,510,"Virginia","Alexandria city",4,15,1298,673,625
050,51,510,"Virginia","Alexandria city",4,16,1319,672,647
050,51,510,"Virginia","Alexandria city",4,17,1215,609,606
050,51,510,"Virginia","Alexandria city",4,18,1062,544,518
050,51,510,"Virginia","Alexandria city",4,19,910,426,484
050,51,510,"Virginia","Alexandria city",4,20,1051,491,560
050,51,510,"Virginia","Alexandria city",4,21,1151,525,626
050,51,510,"Virginia","Alexandria city",4,22,1276,589,687
050,51,510,"Virginia","Alexandria city",4,23,1640,765,875
050,51,510,"Virginia","Alexandria city",4,24,1991,945,1046
050,51,510,"Virginia","Alexandria city",4,25,2359,1088,1271
050,51,510,"Virginia","Alexandria city",4,26,2651,1247,1404
050,51,510,"Virginia","Alexandria city",4,27,2895,1311,1584
050,51,510,"Virginia","Alexandria city",4,28,3072,1461,1611
050,51,510,"Virginia","Alexandria city",4,29,3191,1500,1691
050,51,510,"Virginia","Alexandria city",4,30,3152,1509,1643
050,51,510,"Virginia","Alexandria city",4,31,3411,1641,1770
050,51,510,"Virginia","Alexandria city",4,32,3496,1750,1746
050,51,510,"Virginia","Alexandria city",4,33,3302,1628,1674
050,51,510,"Virginia","Alexandria city",4,34,3203,1578,1625
050,51,510,"Virginia","Alexandria city",4,35,3249,1623,1626
050,51,510,"Virginia","Alexandria city",4,36,3258,1596,1662
050,51,510,"Virginia","Alexandria city",4,37,3288,1618,1670
050,51,510,"Virginia","Alexandria city",4,38,3075,1511,1564
050,51,510,"Virginia","Alexandria city",4,39,3042,1596,1446
050,51,510,"Virginia","Alexandria city",4,40,2826,1448,1378
050,51,510,"Virginia","Alexandria city",4,41,2711,1389,1322
050,51,510,"Virginia","Alexandria city",4,42,2663,1317,1346
050,51,510,"Virginia","Alexandria city",4,43,2345,1147,1198
050,51,510,"Virginia","Alexandria city",4,44,2317,1161,1156
050,51,510,"Virginia","Alexandria city",4,45,2288,1145,1143
050,51,510,"Virginia","Alexandria city",4,46,2160,1103,1057
050,51,510,"Virginia","Alexandria city",4,47,2117,1087,1030
050,51,510,"Virginia","Alexandria city",4,48,2049,1011,1038
050,51,510,"Virginia","Alexandria city",4,49,2006,1000,1006
050,51,510,"Virginia","Alexandria city",4,50,2005,965,1040
050,51,510,"Virginia","Alexandria city",4,51,2180,1061,1119
050,51,510,"Virginia","Alexandria city",4,52,2140,1066,1074
050,51,510,"Virginia","Alexandria city",4,53,1982,991,991
050,51,510,"Virginia","Alexandria city",4,54,1902,908,994
050,51,510,"Virginia","Alexandria city",4,55,1847,886,961
050,51,510,"Virginia","Alexandria city",4,56,1846,874,972
050,51,510,"Virginia","Alexandria city",4,57,1831,911,920
050,51,510,"Virginia","Alexandria city",4,58,1829,877,952
050,51,510,"Virginia","Alexandria city",4,59,1732,864,868
050,51,510,"Virginia","Alexandria city",4,60,1731,874,857
050,51,510,"Virginia","Alexandria city",4,61,1692,832,860
050,51,510,"Virginia","Alexandria city",4,62,1615,822,793
050,51,510,"Virginia","Alexandria city",4,63,1607,769,838
050,51,510,"Virginia","Alexandria city",4,64,1499,706,793
050,51,510,"Virginia","Alexandria city",4,65,1428,672,756
050,51,510,"Virginia","Alexandria city",4,66,1341,625,716
050,51,510,"Virginia","Alexandria city",4,67,1293,605,688
050,51,510,"Virginia","Alexandria city",4,68,1281,572,709
050,51,510,"Virginia","Alexandria city",4,69,1220,525,695
050,51,510,"Virginia","Alexandria city",4,70,1138,486,652
050,51,510,"Virginia","Alexandria city",4,71,1122,486,636
050,51,510,"Virginia","Alexandria city",4,72,1072,477,595
050,51,510,"Virginia","Alexandria city",4,73,1100,498,602
050,51,510,"Virginia","Alexandria city",4,74,1043,460,583
050,51,510,"Virginia","Alexandria city",4,75,1092,474,618
050,51,510,"Virginia","Alexandria city",4,76,787,334,453
050,51,510,"Virginia","Alexandria city",4,77,758,333,425
050,51,510,"Virginia","Alexandria city",4,78,709,312,397
050,51,510,"Virginia","Alexandria city",4,79,661,314,347
050,51,510,"Virginia","Alexandria city",4,80,565,254,311
050,51,510,"Virginia","Alexandria city",4,81,451,189,262
050,51,510,"Virginia","Alexandria city",4,82,375,174,201
050,51,510,"Virginia","Alexandria city",4,83,361,156,205
050,51,510,"Virginia","Alexandria city",4,84,322,144,178
050,51,510,"Virginia","Alexandria city",4,85,2051,659,1392
050,51,510,"Virginia","Alexandria city",5,0,2304,1144,1160
050,51,510,"Virginia","Alexandria city",5,1,2005,993,1012
050,51,510,"Virginia","Alexandria city",5,2,1882,942,940
050,51,510,"Virginia","Alexandria city",5,3,1803,922,881
050,51,510,"Virginia","Alexandria city",5,4,1766,883,883
050,51,510,"Virginia","Alexandria city",5,5,1699,873,826
050,51,510,"Virginia","Alexandria city",5,6,1594,826,768
050,51,510,"Virginia","Alexandria city",5,7,1558,806,752
050,51,510,"Virginia","Alexandria city",5,8,1418,742,676
050,51,510,"Virginia","Alexandria city",5,9,1437,755,682
050,51,510,"Virginia","Alexandria city",5,10,1356,687,669
050,51,510,"Virginia","Alexandria city",5,11,1283,669,614
050,51,510,"Virginia","Alexandria city",5,12,1264,663,601
050,51,510,"Virginia","Alexandria city",5,13,1266,651,615
050,51,510,"Virginia","Alexandria city",5,14,1278,647,631
050,51,510,"Virginia","Alexandria city",5,15,1303,665,638
050,51,510,"Virginia","Alexandria city",5,16,1387,710,677
050,51,510,"Virginia","Alexandria city",5,17,1270,618,652
050,51,510,"Virginia","Alexandria city",5,18,1063,547,516
050,51,510,"Virginia","Alexandria city",5,19,881,432,449
050,51,510,"Virginia","Alexandria city",5,20,1029,493,536
050,51,510,"Virginia","Alexandria city",5,21,1138,507,631
050,51,510,"Virginia","Alexandria city",5,22,1289,589,700
050,51,510,"Virginia","Alexandria city",5,23,1619,754,865
050,51,510,"Virginia","Alexandria city",5,24,1959,886,1073
050,51,510,"Virginia","Alexandria city",5,25,2443,1137,1306
050,51,510,"Virginia","Alexandria city",5,26,2656,1223,1433
050,51,510,"Virginia","Alexandria city",5,27,2897,1364,1533
050,51,510,"Virginia","Alexandria city",5,28,3065,1404,1661
050,51,510,"Virginia","Alexandria city",5,29,3264,1553,1711
050,51,510,"Virginia","Alexandria city",5,30,3246,1533,1713
050,51,510,"Virginia","Alexandria city",5,31,3266,1562,1704
050,51,510,"Virginia","Alexandria city",5,32,3430,1649,1781
050,51,510,"Virginia","Alexandria city",5,33,3537,1794,1743
050,51,510,"Virginia","Alexandria city",5,34,3240,1597,1643
050,51,510,"Virginia","Alexandria city",5,35,3151,1578,1573
050,51,510,"Virginia","Alexandria city",5,36,3132,1594,1538
050,51,510,"Virginia","Alexandria city",5,37,3143,1524,1619
050,51,510,"Virginia","Alexandria city",5,38,3092,1556,1536
050,51,510,"Virginia","Alexandria city",5,39,2935,1422,1513
050,51,510,"Virginia","Alexandria city",5,40,2900,1509,1391
050,51,510,"Virginia","Alexandria city",5,41,2731,1440,1291
050,51,510,"Virginia","Alexandria city",5,42,2594,1354,1240
050,51,510,"Virginia","Alexandria city",5,43,2566,1275,1291
050,51,510,"Virginia","Alexandria city",5,44,2282,1104,1178
050,51,510,"Virginia","Alexandria city",5,45,2176,1082,1094
050,51,510,"Virginia","Alexandria city",5,46,2186,1059,1127
050,51,510,"Virginia","Alexandria city",5,47,2113,1058,1055
050,51,510,"Virginia","Alexandria city",5,48,2064,1037,1027
050,51,510,"Virginia","Alexandria city",5,49,2029,1002,1027
050,51,510,"Virginia","Alexandria city",5,50,1940,960,980
050,51,510,"Virginia","Alexandria city",5,51,2010,984,1026
050,51,510,"Virginia","Alexandria city",5,52,2124,1028,1096
050,51,510,"Virginia","Alexandria city",5,53,2093,1022,1071
050,51,510,"Virginia","Alexandria city",5,54,1971,998,973
050,51,510,"Virginia","Alexandria city",5,55,1870,903,967
050,51,510,"Virginia","Alexandria city",5,56,1800,843,957
050,51,510,"Virginia","Alexandria city",5,57,1818,872,946
050,51,510,"Virginia","Alexandria city",5,58,1774,869,905
050,51,510,"Virginia","Alexandria city",5,59,1774,864,910
050,51,510,"Virginia","Alexandria city",5,60,1692,838,854
050,51,510,"Virginia","Alexandria city",5,61,1696,856,840
050,51,510,"Virginia","Alexandria city",5,62,1609,786,823
050,51,510,"Virginia","Alexandria city",5,63,1577,803,774
050,51,510,"Virginia","Alexandria city",5,64,1556,745,811
050,51,510,"Virginia","Alexandria city",5,65,1495,713,782
050,51,510,"Virginia","Alexandria city",5,66,1381,658,723
050,51,510,"Virginia","Alexandria city",5,67,1279,588,691
050,51,510,"Virginia","Alexandria city",5,68,1259,592,667
050,51,510,"Virginia","Alexandria city",5,69,1239,543,696
050,51,510,"Virginia","Alexandria city",5,70,1205,512,693
050,51,510,"Virginia","Alexandria city",5,71,1103,474,629
050,51,510,"Virginia","Alexandria city",5,72,1098,473,625
050,51,510,"Virginia","Alexandria city",5,73,1065,479,586
050,51,510,"Virginia","Alexandria city",5,74,1080,489,591
050,51,510,"Virginia","Alexandria city",5,75,1034,448,586
050,51,510,"Virginia","Alexandria city",5,76,1050,451,599
050,51,510,"Virginia","Alexandria city",5,77,781,330,451
050,51,510,"Virginia","Alexandria city",5,78,744,326,418
050,51,510,"Virginia","Alexandria city",5,79,684,297,387
050,51,510,"Virginia","Alexandria city",5,80,658,307,351
050,51,510,"Virginia","Alexandria city",5,81,540,244,296
050,51,510,"Virginia","Alexandria city",5,82,442,187,255
050,51,510,"Virginia","Alexandria city",5,83,338,153,185
050,51,510,"Virginia","Alexandria city",5,84,325,140,185
050,51,510,"Virginia","Alexandria city",5,85,2137,711,1426
050,51,520,"Virginia","Bristol city",1,0,177,90,87
050,51,520,"Virginia","Bristol city",1,1,194,90,104
050,51,520,"Virginia","Bristol city",1,2,179,96,83
050,51,520,"Virginia","Bristol city",1,3,190,101,89
050,51,520,"Virginia","Bristol city",1,4,214,107,107
050,51,520,"Virginia","Bristol city",1,5,204,109,95
050,51,520,"Virginia","Bristol city",1,6,201,105,96
050,51,520,"Virginia","Bristol city",1,7,207,94,113
050,51,520,"Virginia","Bristol city",1,8,196,97,99
050,51,520,"Virginia","Bristol city",1,9,195,92,103
050,51,520,"Virginia","Bristol city",1,10,197,91,106
050,51,520,"Virginia","Bristol city",1,11,184,98,86
050,51,520,"Virginia","Bristol city",1,12,210,110,100
050,51,520,"Virginia","Bristol city",1,13,217,107,110
050,51,520,"Virginia","Bristol city",1,14,210,103,107
050,51,520,"Virginia","Bristol city",1,15,207,101,106
050,51,520,"Virginia","Bristol city",1,16,201,105,96
050,51,520,"Virginia","Bristol city",1,17,201,108,93
050,51,520,"Virginia","Bristol city",1,18,187,108,79
050,51,520,"Virginia","Bristol city",1,19,129,68,61
050,51,520,"Virginia","Bristol city",1,20,152,84,68
050,51,520,"Virginia","Bristol city",1,21,159,86,73
050,51,520,"Virginia","Bristol city",1,22,185,95,90
050,51,520,"Virginia","Bristol city",1,23,169,74,95
050,51,520,"Virginia","Bristol city",1,24,171,84,87
050,51,520,"Virginia","Bristol city",1,25,184,96,88
050,51,520,"Virginia","Bristol city",1,26,221,114,107
050,51,520,"Virginia","Bristol city",1,27,214,111,103
050,51,520,"Virginia","Bristol city",1,28,244,112,132
050,51,520,"Virginia","Bristol city",1,29,250,126,124
050,51,520,"Virginia","Bristol city",1,30,251,124,127
050,51,520,"Virginia","Bristol city",1,31,212,106,106
050,51,520,"Virginia","Bristol city",1,32,214,118,96
050,51,520,"Virginia","Bristol city",1,33,217,109,108
050,51,520,"Virginia","Bristol city",1,34,211,107,104
050,51,520,"Virginia","Bristol city",1,35,182,86,96
050,51,520,"Virginia","Bristol city",1,36,218,97,121
050,51,520,"Virginia","Bristol city",1,37,241,114,127
050,51,520,"Virginia","Bristol city",1,38,215,108,107
050,51,520,"Virginia","Bristol city",1,39,195,89,106
050,51,520,"Virginia","Bristol city",1,40,204,103,101
050,51,520,"Virginia","Bristol city",1,41,209,101,108
050,51,520,"Virginia","Bristol city",1,42,201,97,104
050,51,520,"Virginia","Bristol city",1,43,190,82,108
050,51,520,"Virginia","Bristol city",1,44,205,94,111
050,51,520,"Virginia","Bristol city",1,45,195,104,91
050,51,520,"Virginia","Bristol city",1,46,186,101,85
050,51,520,"Virginia","Bristol city",1,47,199,103,96
050,51,520,"Virginia","Bristol city",1,48,239,113,126
050,51,520,"Virginia","Bristol city",1,49,237,112,125
050,51,520,"Virginia","Bristol city",1,50,202,104,98
050,51,520,"Virginia","Bristol city",1,51,209,103,106
050,51,520,"Virginia","Bristol city",1,52,211,107,104
050,51,520,"Virginia","Bristol city",1,53,228,116,112
050,51,520,"Virginia","Bristol city",1,54,221,116,105
050,51,520,"Virginia","Bristol city",1,55,226,122,104
050,51,520,"Virginia","Bristol city",1,56,252,116,136
050,51,520,"Virginia","Bristol city",1,57,227,106,121
050,51,520,"Virginia","Bristol city",1,58,218,111,107
050,51,520,"Virginia","Bristol city",1,59,239,117,122
050,51,520,"Virginia","Bristol city",1,60,219,103,116
050,51,520,"Virginia","Bristol city",1,61,214,113,101
050,51,520,"Virginia","Bristol city",1,62,243,116,127
050,51,520,"Virginia","Bristol city",1,63,241,115,126
050,51,520,"Virginia","Bristol city",1,64,243,114,129
050,51,520,"Virginia","Bristol city",1,65,221,104,117
050,51,520,"Virginia","Bristol city",1,66,209,86,123
050,51,520,"Virginia","Bristol city",1,67,229,89,140
050,51,520,"Virginia","Bristol city",1,68,228,96,132
050,51,520,"Virginia","Bristol city",1,69,220,106,114
050,51,520,"Virginia","Bristol city",1,70,187,84,103
050,51,520,"Virginia","Bristol city",1,71,204,94,110
050,51,520,"Virginia","Bristol city",1,72,201,86,115
050,51,520,"Virginia","Bristol city",1,73,192,79,113
050,51,520,"Virginia","Bristol city",1,74,146,52,94
050,51,520,"Virginia","Bristol city",1,75,134,43,91
050,51,520,"Virginia","Bristol city",1,76,157,73,84
050,51,520,"Virginia","Bristol city",1,77,174,77,97
050,51,520,"Virginia","Bristol city",1,78,133,51,82
050,51,520,"Virginia","Bristol city",1,79,133,43,90
050,51,520,"Virginia","Bristol city",1,80,107,31,76
050,51,520,"Virginia","Bristol city",1,81,102,35,67
050,51,520,"Virginia","Bristol city",1,82,113,49,64
050,51,520,"Virginia","Bristol city",1,83,96,38,58
050,51,520,"Virginia","Bristol city",1,84,84,37,47
050,51,520,"Virginia","Bristol city",1,85,486,147,339
050,51,520,"Virginia","Bristol city",2,0,188,92,96
050,51,520,"Virginia","Bristol city",2,1,189,90,99
050,51,520,"Virginia","Bristol city",2,2,183,95,88
050,51,520,"Virginia","Bristol city",2,3,188,100,88
050,51,520,"Virginia","Bristol city",2,4,209,107,102
050,51,520,"Virginia","Bristol city",2,5,207,109,98
050,51,520,"Virginia","Bristol city",2,6,206,107,99
050,51,520,"Virginia","Bristol city",2,7,208,97,111
050,51,520,"Virginia","Bristol city",2,8,201,98,103
050,51,520,"Virginia","Bristol city",2,9,194,92,102
050,51,520,"Virginia","Bristol city",2,10,198,93,105
050,51,520,"Virginia","Bristol city",2,11,189,97,92
050,51,520,"Virginia","Bristol city",2,12,206,107,99
050,51,520,"Virginia","Bristol city",2,13,216,108,108
050,51,520,"Virginia","Bristol city",2,14,213,105,108
050,51,520,"Virginia","Bristol city",2,15,209,102,107
050,51,520,"Virginia","Bristol city",2,16,201,103,98
050,51,520,"Virginia","Bristol city",2,17,201,107,94
050,51,520,"Virginia","Bristol city",2,18,183,105,78
050,51,520,"Virginia","Bristol city",2,19,139,77,62
050,51,520,"Virginia","Bristol city",2,20,153,83,70
050,51,520,"Virginia","Bristol city",2,21,161,87,74
050,51,520,"Virginia","Bristol city",2,22,183,94,89
050,51,520,"Virginia","Bristol city",2,23,175,80,95
050,51,520,"Virginia","Bristol city",2,24,173,82,91
050,51,520,"Virginia","Bristol city",2,25,182,91,91
050,51,520,"Virginia","Bristol city",2,26,216,110,106
050,51,520,"Virginia","Bristol city",2,27,217,113,104
050,51,520,"Virginia","Bristol city",2,28,237,113,124
050,51,520,"Virginia","Bristol city",2,29,250,125,125
050,51,520,"Virginia","Bristol city",2,30,252,125,127
050,51,520,"Virginia","Bristol city",2,31,222,111,111
050,51,520,"Virginia","Bristol city",2,32,217,118,99
050,51,520,"Virginia","Bristol city",2,33,217,111,106
050,51,520,"Virginia","Bristol city",2,34,215,109,106
050,51,520,"Virginia","Bristol city",2,35,194,92,102
050,51,520,"Virginia","Bristol city",2,36,210,94,116
050,51,520,"Virginia","Bristol city",2,37,234,111,123
050,51,520,"Virginia","Bristol city",2,38,220,109,111
050,51,520,"Virginia","Bristol city",2,39,201,96,105
050,51,520,"Virginia","Bristol city",2,40,204,101,103
050,51,520,"Virginia","Bristol city",2,41,210,104,106
050,51,520,"Virginia","Bristol city",2,42,198,96,102
050,51,520,"Virginia","Bristol city",2,43,194,87,107
050,51,520,"Virginia","Bristol city",2,44,199,91,108
050,51,520,"Virginia","Bristol city",2,45,200,102,98
050,51,520,"Virginia","Bristol city",2,46,188,101,87
050,51,520,"Virginia","Bristol city",2,47,199,104,95
050,51,520,"Virginia","Bristol city",2,48,230,111,119
050,51,520,"Virginia","Bristol city",2,49,240,112,128
050,51,520,"Virginia","Bristol city",2,50,209,103,106
050,51,520,"Virginia","Bristol city",2,51,208,104,104
050,51,520,"Virginia","Bristol city",2,52,209,104,105
050,51,520,"Virginia","Bristol city",2,53,227,115,112
050,51,520,"Virginia","Bristol city",2,54,224,117,107
050,51,520,"Virginia","Bristol city",2,55,228,123,105
050,51,520,"Virginia","Bristol city",2,56,248,118,130
050,51,520,"Virginia","Bristol city",2,57,233,109,124
050,51,520,"Virginia","Bristol city",2,58,222,110,112
050,51,520,"Virginia","Bristol city",2,59,232,114,118
050,51,520,"Virginia","Bristol city",2,60,224,107,117
050,51,520,"Virginia","Bristol city",2,61,217,113,104
050,51,520,"Virginia","Bristol city",2,62,234,114,120
050,51,520,"Virginia","Bristol city",2,63,244,118,126
050,51,520,"Virginia","Bristol city",2,64,238,112,126
050,51,520,"Virginia","Bristol city",2,65,225,106,119
050,51,520,"Virginia","Bristol city",2,66,215,91,124
050,51,520,"Virginia","Bristol city",2,67,223,89,134
050,51,520,"Virginia","Bristol city",2,68,226,94,132
050,51,520,"Virginia","Bristol city",2,69,223,104,119
050,51,520,"Virginia","Bristol city",2,70,196,90,106
050,51,520,"Virginia","Bristol city",2,71,202,93,109
050,51,520,"Virginia","Bristol city",2,72,197,86,111
050,51,520,"Virginia","Bristol city",2,73,202,83,119
050,51,520,"Virginia","Bristol city",2,74,147,54,93
050,51,520,"Virginia","Bristol city",2,75,137,43,94
050,51,520,"Virginia","Bristol city",2,76,151,66,85
050,51,520,"Virginia","Bristol city",2,77,171,76,95
050,51,520,"Virginia","Bristol city",2,78,141,57,84
050,51,520,"Virginia","Bristol city",2,79,133,44,89
050,51,520,"Virginia","Bristol city",2,80,112,34,78
050,51,520,"Virginia","Bristol city",2,81,102,35,67
050,51,520,"Virginia","Bristol city",2,82,110,46,64
050,51,520,"Virginia","Bristol city",2,83,101,41,60
050,51,520,"Virginia","Bristol city",2,84,87,37,50
050,51,520,"Virginia","Bristol city",2,85,482,148,334
050,51,520,"Virginia","Bristol city",3,0,155,80,75
050,51,520,"Virginia","Bristol city",3,1,167,84,83
050,51,520,"Virginia","Bristol city",3,2,171,84,87
050,51,520,"Virginia","Bristol city",3,3,185,106,79
050,51,520,"Virginia","Bristol city",3,4,178,99,79
050,51,520,"Virginia","Bristol city",3,5,184,97,87
050,51,520,"Virginia","Bristol city",3,6,213,113,100
050,51,520,"Virginia","Bristol city",3,7,209,108,101
050,51,520,"Virginia","Bristol city",3,8,195,96,99
050,51,520,"Virginia","Bristol city",3,9,196,105,91
050,51,520,"Virginia","Bristol city",3,10,185,89,96
050,51,520,"Virginia","Bristol city",3,11,198,94,104
050,51,520,"Virginia","Bristol city",3,12,194,99,95
050,51,520,"Virginia","Bristol city",3,13,217,118,99
050,51,520,"Virginia","Bristol city",3,14,212,114,98
050,51,520,"Virginia","Bristol city",3,15,214,104,110
050,51,520,"Virginia","Bristol city",3,16,200,100,100
050,51,520,"Virginia","Bristol city",3,17,194,105,89
050,51,520,"Virginia","Bristol city",3,18,162,91,71
050,51,520,"Virginia","Bristol city",3,19,158,92,66
050,51,520,"Virginia","Bristol city",3,20,153,87,66
050,51,520,"Virginia","Bristol city",3,21,155,82,73
050,51,520,"Virginia","Bristol city",3,22,174,94,80
050,51,520,"Virginia","Bristol city",3,23,175,85,90
050,51,520,"Virginia","Bristol city",3,24,177,77,100
050,51,520,"Virginia","Bristol city",3,25,211,101,110
050,51,520,"Virginia","Bristol city",3,26,205,108,97
050,51,520,"Virginia","Bristol city",3,27,212,113,99
050,51,520,"Virginia","Bristol city",3,28,220,116,104
050,51,520,"Virginia","Bristol city",3,29,233,116,117
050,51,520,"Virginia","Bristol city",3,30,262,127,135
050,51,520,"Virginia","Bristol city",3,31,240,119,121
050,51,520,"Virginia","Bristol city",3,32,211,109,102
050,51,520,"Virginia","Bristol city",3,33,212,109,103
050,51,520,"Virginia","Bristol city",3,34,207,107,100
050,51,520,"Virginia","Bristol city",3,35,195,92,103
050,51,520,"Virginia","Bristol city",3,36,199,97,102
050,51,520,"Virginia","Bristol city",3,37,192,98,94
050,51,520,"Virginia","Bristol city",3,38,235,117,118
050,51,520,"Virginia","Bristol city",3,39,210,102,108
050,51,520,"Virginia","Bristol city",3,40,196,89,107
050,51,520,"Virginia","Bristol city",3,41,216,106,110
050,51,520,"Virginia","Bristol city",3,42,196,96,100
050,51,520,"Virginia","Bristol city",3,43,181,81,100
050,51,520,"Virginia","Bristol city",3,44,199,91,108
050,51,520,"Virginia","Bristol city",3,45,203,94,109
050,51,520,"Virginia","Bristol city",3,46,196,96,100
050,51,520,"Virginia","Bristol city",3,47,189,102,87
050,51,520,"Virginia","Bristol city",3,48,193,105,88
050,51,520,"Virginia","Bristol city",3,49,227,109,118
050,51,520,"Virginia","Bristol city",3,50,241,109,132
050,51,520,"Virginia","Bristol city",3,51,220,101,119
050,51,520,"Virginia","Bristol city",3,52,225,113,112
050,51,520,"Virginia","Bristol city",3,53,209,104,105
050,51,520,"Virginia","Bristol city",3,54,226,111,115
050,51,520,"Virginia","Bristol city",3,55,223,116,107
050,51,520,"Virginia","Bristol city",3,56,221,116,105
050,51,520,"Virginia","Bristol city",3,57,247,116,131
050,51,520,"Virginia","Bristol city",3,58,237,103,134
050,51,520,"Virginia","Bristol city",3,59,210,99,111
050,51,520,"Virginia","Bristol city",3,60,236,115,121
050,51,520,"Virginia","Bristol city",3,61,240,116,124
050,51,520,"Virginia","Bristol city",3,62,210,107,103
050,51,520,"Virginia","Bristol city",3,63,230,111,119
050,51,520,"Virginia","Bristol city",3,64,235,106,129
050,51,520,"Virginia","Bristol city",3,65,239,116,123
050,51,520,"Virginia","Bristol city",3,66,221,103,118
050,51,520,"Virginia","Bristol city",3,67,210,88,122
050,51,520,"Virginia","Bristol city",3,68,225,88,137
050,51,520,"Virginia","Bristol city",3,69,225,94,131
050,51,520,"Virginia","Bristol city",3,70,214,96,118
050,51,520,"Virginia","Bristol city",3,71,190,88,102
050,51,520,"Virginia","Bristol city",3,72,195,90,105
050,51,520,"Virginia","Bristol city",3,73,192,83,109
050,51,520,"Virginia","Bristol city",3,74,201,85,116
050,51,520,"Virginia","Bristol city",3,75,145,50,95
050,51,520,"Virginia","Bristol city",3,76,128,37,91
050,51,520,"Virginia","Bristol city",3,77,142,59,83
050,51,520,"Virginia","Bristol city",3,78,160,66,94
050,51,520,"Virginia","Bristol city",3,79,139,57,82
050,51,520,"Virginia","Bristol city",3,80,125,41,84
050,51,520,"Virginia","Bristol city",3,81,91,27,64
050,51,520,"Virginia","Bristol city",3,82,91,31,60
050,51,520,"Virginia","Bristol city",3,83,99,41,58
050,51,520,"Virginia","Bristol city",3,84,91,37,54
050,51,520,"Virginia","Bristol city",3,85,471,155,316
050,51,520,"Virginia","Bristol city",4,0,179,97,82
050,51,520,"Virginia","Bristol city",4,1,172,85,87
050,51,520,"Virginia","Bristol city",4,2,172,84,88
050,51,520,"Virginia","Bristol city",4,3,173,92,81
050,51,520,"Virginia","Bristol city",4,4,181,102,79
050,51,520,"Virginia","Bristol city",4,5,183,104,79
050,51,520,"Virginia","Bristol city",4,6,180,95,85
050,51,520,"Virginia","Bristol city",4,7,199,102,97
050,51,520,"Virginia","Bristol city",4,8,205,108,97
050,51,520,"Virginia","Bristol city",4,9,199,102,97
050,51,520,"Virginia","Bristol city",4,10,195,104,91
050,51,520,"Virginia","Bristol city",4,11,188,88,100
050,51,520,"Virginia","Bristol city",4,12,191,93,98
050,51,520,"Virginia","Bristol city",4,13,201,105,96
050,51,520,"Virginia","Bristol city",4,14,212,114,98
050,51,520,"Virginia","Bristol city",4,15,208,104,104
050,51,520,"Virginia","Bristol city",4,16,215,109,106
050,51,520,"Virginia","Bristol city",4,17,196,100,96
050,51,520,"Virginia","Bristol city",4,18,177,103,74
050,51,520,"Virginia","Bristol city",4,19,121,63,58
050,51,520,"Virginia","Bristol city",4,20,169,96,73
050,51,520,"Virginia","Bristol city",4,21,160,89,71
050,51,520,"Virginia","Bristol city",4,22,173,91,82
050,51,520,"Virginia","Bristol city",4,23,192,97,95
050,51,520,"Virginia","Bristol city",4,24,180,87,93
050,51,520,"Virginia","Bristol city",4,25,186,76,110
050,51,520,"Virginia","Bristol city",4,26,205,104,101
050,51,520,"Virginia","Bristol city",4,27,218,117,101
050,51,520,"Virginia","Bristol city",4,28,210,110,100
050,51,520,"Virginia","Bristol city",4,29,226,131,95
050,51,520,"Virginia","Bristol city",4,30,253,122,131
050,51,520,"Virginia","Bristol city",4,31,237,105,132
050,51,520,"Virginia","Bristol city",4,32,244,129,115
050,51,520,"Virginia","Bristol city",4,33,190,96,94
050,51,520,"Virginia","Bristol city",4,34,209,107,102
050,51,520,"Virginia","Bristol city",4,35,217,111,106
050,51,520,"Virginia","Bristol city",4,36,196,98,98
050,51,520,"Virginia","Bristol city",4,37,187,90,97
050,51,520,"Virginia","Bristol city",4,38,205,113,92
050,51,520,"Virginia","Bristol city",4,39,225,113,112
050,51,520,"Virginia","Bristol city",4,40,212,104,108
050,51,520,"Virginia","Bristol city",4,41,201,99,102
050,51,520,"Virginia","Bristol city",4,42,204,91,113
050,51,520,"Virginia","Bristol city",4,43,190,92,98
050,51,520,"Virginia","Bristol city",4,44,175,78,97
050,51,520,"Virginia","Bristol city",4,45,193,92,101
050,51,520,"Virginia","Bristol city",4,46,202,92,110
050,51,520,"Virginia","Bristol city",4,47,204,104,100
050,51,520,"Virginia","Bristol city",4,48,174,89,85
050,51,520,"Virginia","Bristol city",4,49,202,104,98
050,51,520,"Virginia","Bristol city",4,50,225,104,121
050,51,520,"Virginia","Bristol city",4,51,244,113,131
050,51,520,"Virginia","Bristol city",4,52,217,99,118
050,51,520,"Virginia","Bristol city",4,53,236,113,123
050,51,520,"Virginia","Bristol city",4,54,199,97,102
050,51,520,"Virginia","Bristol city",4,55,221,111,110
050,51,520,"Virginia","Bristol city",4,56,221,113,108
050,51,520,"Virginia","Bristol city",4,57,209,113,96
050,51,520,"Virginia","Bristol city",4,58,239,109,130
050,51,520,"Virginia","Bristol city",4,59,224,98,126
050,51,520,"Virginia","Bristol city",4,60,204,91,113
050,51,520,"Virginia","Bristol city",4,61,248,126,122
050,51,520,"Virginia","Bristol city",4,62,232,112,120
050,51,520,"Virginia","Bristol city",4,63,213,110,103
050,51,520,"Virginia","Bristol city",4,64,222,104,118
050,51,520,"Virginia","Bristol city",4,65,232,104,128
050,51,520,"Virginia","Bristol city",4,66,235,109,126
050,51,520,"Virginia","Bristol city",4,67,208,96,112
050,51,520,"Virginia","Bristol city",4,68,211,88,123
050,51,520,"Virginia","Bristol city",4,69,225,90,135
050,51,520,"Virginia","Bristol city",4,70,216,85,131
050,51,520,"Virginia","Bristol city",4,71,207,92,115
050,51,520,"Virginia","Bristol city",4,72,187,87,100
050,51,520,"Virginia","Bristol city",4,73,194,85,109
050,51,520,"Virginia","Bristol city",4,74,187,81,106
050,51,520,"Virginia","Bristol city",4,75,202,87,115
050,51,520,"Virginia","Bristol city",4,76,131,44,87
050,51,520,"Virginia","Bristol city",4,77,120,33,87
050,51,520,"Virginia","Bristol city",4,78,132,53,79
050,51,520,"Virginia","Bristol city",4,79,153,66,87
050,51,520,"Virginia","Bristol city",4,80,128,53,75
050,51,520,"Virginia","Bristol city",4,81,111,36,75
050,51,520,"Virginia","Bristol city",4,82,84,24,60
050,51,520,"Virginia","Bristol city",4,83,77,25,52
050,51,520,"Virginia","Bristol city",4,84,85,36,49
050,51,520,"Virginia","Bristol city",4,85,475,157,318
050,51,520,"Virginia","Bristol city",5,0,183,97,86
050,51,520,"Virginia","Bristol city",5,1,179,97,82
050,51,520,"Virginia","Bristol city",5,2,165,82,83
050,51,520,"Virginia","Bristol city",5,3,164,77,87
050,51,520,"Virginia","Bristol city",5,4,167,89,78
050,51,520,"Virginia","Bristol city",5,5,183,100,83
050,51,520,"Virginia","Bristol city",5,6,164,87,77
050,51,520,"Virginia","Bristol city",5,7,177,96,81
050,51,520,"Virginia","Bristol city",5,8,195,99,96
050,51,520,"Virginia","Bristol city",5,9,211,106,105
050,51,520,"Virginia","Bristol city",5,10,196,99,97
050,51,520,"Virginia","Bristol city",5,11,191,103,88
050,51,520,"Virginia","Bristol city",5,12,188,93,95
050,51,520,"Virginia","Bristol city",5,13,179,82,97
050,51,520,"Virginia","Bristol city",5,14,200,108,92
050,51,520,"Virginia","Bristol city",5,15,208,114,94
050,51,520,"Virginia","Bristol city",5,16,200,104,96
050,51,520,"Virginia","Bristol city",5,17,206,110,96
050,51,520,"Virginia","Bristol city",5,18,168,92,76
050,51,520,"Virginia","Bristol city",5,19,152,84,68
050,51,520,"Virginia","Bristol city",5,20,148,77,71
050,51,520,"Virginia","Bristol city",5,21,180,101,79
050,51,520,"Virginia","Bristol city",5,22,182,100,82
050,51,520,"Virginia","Bristol city",5,23,163,81,82
050,51,520,"Virginia","Bristol city",5,24,184,90,94
050,51,520,"Virginia","Bristol city",5,25,185,99,86
050,51,520,"Virginia","Bristol city",5,26,190,80,110
050,51,520,"Virginia","Bristol city",5,27,203,105,98
050,51,520,"Virginia","Bristol city",5,28,207,104,103
050,51,520,"Virginia","Bristol city",5,29,211,107,104
050,51,520,"Virginia","Bristol city",5,30,225,136,89
050,51,520,"Virginia","Bristol city",5,31,249,119,130
050,51,520,"Virginia","Bristol city",5,32,236,105,131
050,51,520,"Virginia","Bristol city",5,33,229,115,114
050,51,520,"Virginia","Bristol city",5,34,196,100,96
050,51,520,"Virginia","Bristol city",5,35,211,111,100
050,51,520,"Virginia","Bristol city",5,36,206,110,96
050,51,520,"Virginia","Bristol city",5,37,192,91,101
050,51,520,"Virginia","Bristol city",5,38,189,93,96
050,51,520,"Virginia","Bristol city",5,39,197,100,97
050,51,520,"Virginia","Bristol city",5,40,226,114,112
050,51,520,"Virginia","Bristol city",5,41,223,111,112
050,51,520,"Virginia","Bristol city",5,42,209,108,101
050,51,520,"Virginia","Bristol city",5,43,206,95,111
050,51,520,"Virginia","Bristol city",5,44,197,95,102
050,51,520,"Virginia","Bristol city",5,45,183,81,102
050,51,520,"Virginia","Bristol city",5,46,195,86,109
050,51,520,"Virginia","Bristol city",5,47,208,95,113
050,51,520,"Virginia","Bristol city",5,48,199,103,96
050,51,520,"Virginia","Bristol city",5,49,186,95,91
050,51,520,"Virginia","Bristol city",5,50,209,111,98
050,51,520,"Virginia","Bristol city",5,51,222,103,119
050,51,520,"Virginia","Bristol city",5,52,260,121,139
050,51,520,"Virginia","Bristol city",5,53,206,101,105
050,51,520,"Virginia","Bristol city",5,54,229,113,116
050,51,520,"Virginia","Bristol city",5,55,195,91,104
050,51,520,"Virginia","Bristol city",5,56,219,104,115
050,51,520,"Virginia","Bristol city",5,57,220,109,111
050,51,520,"Virginia","Bristol city",5,58,203,111,92
050,51,520,"Virginia","Bristol city",5,59,237,115,122
050,51,520,"Virginia","Bristol city",5,60,224,95,129
050,51,520,"Virginia","Bristol city",5,61,205,95,110
050,51,520,"Virginia","Bristol city",5,62,248,129,119
050,51,520,"Virginia","Bristol city",5,63,235,114,121
050,51,520,"Virginia","Bristol city",5,64,207,104,103
050,51,520,"Virginia","Bristol city",5,65,215,107,108
050,51,520,"Virginia","Bristol city",5,66,226,102,124
050,51,520,"Virginia","Bristol city",5,67,224,106,118
050,51,520,"Virginia","Bristol city",5,68,211,97,114
050,51,520,"Virginia","Bristol city",5,69,208,89,119
050,51,520,"Virginia","Bristol city",5,70,215,86,129
050,51,520,"Virginia","Bristol city",5,71,208,84,124
050,51,520,"Virginia","Bristol city",5,72,200,92,108
050,51,520,"Virginia","Bristol city",5,73,182,82,100
050,51,520,"Virginia","Bristol city",5,74,189,85,104
050,51,520,"Virginia","Bristol city",5,75,178,75,103
050,51,520,"Virginia","Bristol city",5,76,190,85,105
050,51,520,"Virginia","Bristol city",5,77,123,40,83
050,51,520,"Virginia","Bristol city",5,78,115,29,86
050,51,520,"Virginia","Bristol city",5,79,127,51,76
050,51,520,"Virginia","Bristol city",5,80,145,65,80
050,51,520,"Virginia","Bristol city",5,81,114,47,67
050,51,520,"Virginia","Bristol city",5,82,100,33,67
050,51,520,"Virginia","Bristol city",5,83,77,21,56
050,51,520,"Virginia","Bristol city",5,84,70,21,49
050,51,520,"Virginia","Bristol city",5,85,480,166,314
050,51,530,"Virginia","Buena Vista city",1,0,91,48,43
050,51,530,"Virginia","Buena Vista city",1,1,80,44,36
050,51,530,"Virginia","Buena Vista city",1,2,84,37,47
050,51,530,"Virginia","Buena Vista city",1,3,71,30,41
050,51,530,"Virginia","Buena Vista city",1,4,67,19,48
050,51,530,"Virginia","Buena Vista city",1,5,77,24,53
050,51,530,"Virginia","Buena Vista city",1,6,68,35,33
050,51,530,"Virginia","Buena Vista city",1,7,87,41,46
050,51,530,"Virginia","Buena Vista city",1,8,74,37,37
050,51,530,"Virginia","Buena Vista city",1,9,69,37,32
050,51,530,"Virginia","Buena Vista city",1,10,75,41,34
050,51,530,"Virginia","Buena Vista city",1,11,85,46,39
050,51,530,"Virginia","Buena Vista city",1,12,74,42,32
050,51,530,"Virginia","Buena Vista city",1,13,73,41,32
050,51,530,"Virginia","Buena Vista city",1,14,80,42,38
050,51,530,"Virginia","Buena Vista city",1,15,81,33,48
050,51,530,"Virginia","Buena Vista city",1,16,81,37,44
050,51,530,"Virginia","Buena Vista city",1,17,80,35,45
050,51,530,"Virginia","Buena Vista city",1,18,162,87,75
050,51,530,"Virginia","Buena Vista city",1,19,214,76,138
050,51,530,"Virginia","Buena Vista city",1,20,148,58,90
050,51,530,"Virginia","Buena Vista city",1,21,141,55,86
050,51,530,"Virginia","Buena Vista city",1,22,117,59,58
050,51,530,"Virginia","Buena Vista city",1,23,131,72,59
050,51,530,"Virginia","Buena Vista city",1,24,106,61,45
050,51,530,"Virginia","Buena Vista city",1,25,99,54,45
050,51,530,"Virginia","Buena Vista city",1,26,97,48,49
050,51,530,"Virginia","Buena Vista city",1,27,90,46,44
050,51,530,"Virginia","Buena Vista city",1,28,85,42,43
050,51,530,"Virginia","Buena Vista city",1,29,78,36,42
050,51,530,"Virginia","Buena Vista city",1,30,72,39,33
050,51,530,"Virginia","Buena Vista city",1,31,82,40,42
050,51,530,"Virginia","Buena Vista city",1,32,67,32,35
050,51,530,"Virginia","Buena Vista city",1,33,59,26,33
050,51,530,"Virginia","Buena Vista city",1,34,70,36,34
050,51,530,"Virginia","Buena Vista city",1,35,66,42,24
050,51,530,"Virginia","Buena Vista city",1,36,53,28,25
050,51,530,"Virginia","Buena Vista city",1,37,65,33,32
050,51,530,"Virginia","Buena Vista city",1,38,57,29,28
050,51,530,"Virginia","Buena Vista city",1,39,72,36,36
050,51,530,"Virginia","Buena Vista city",1,40,80,38,42
050,51,530,"Virginia","Buena Vista city",1,41,70,33,37
050,51,530,"Virginia","Buena Vista city",1,42,75,38,37
050,51,530,"Virginia","Buena Vista city",1,43,62,31,31
050,51,530,"Virginia","Buena Vista city",1,44,65,32,33
050,51,530,"Virginia","Buena Vista city",1,45,72,36,36
050,51,530,"Virginia","Buena Vista city",1,46,69,37,32
050,51,530,"Virginia","Buena Vista city",1,47,56,22,34
050,51,530,"Virginia","Buena Vista city",1,48,60,27,33
050,51,530,"Virginia","Buena Vista city",1,49,66,34,32
050,51,530,"Virginia","Buena Vista city",1,50,83,42,41
050,51,530,"Virginia","Buena Vista city",1,51,80,39,41
050,51,530,"Virginia","Buena Vista city",1,52,86,40,46
050,51,530,"Virginia","Buena Vista city",1,53,78,39,39
050,51,530,"Virginia","Buena Vista city",1,54,83,48,35
050,51,530,"Virginia","Buena Vista city",1,55,78,42,36
050,51,530,"Virginia","Buena Vista city",1,56,86,44,42
050,51,530,"Virginia","Buena Vista city",1,57,87,38,49
050,51,530,"Virginia","Buena Vista city",1,58,69,36,33
050,51,530,"Virginia","Buena Vista city",1,59,73,31,42
050,51,530,"Virginia","Buena Vista city",1,60,78,36,42
050,51,530,"Virginia","Buena Vista city",1,61,79,38,41
050,51,530,"Virginia","Buena Vista city",1,62,79,32,47
050,51,530,"Virginia","Buena Vista city",1,63,73,31,42
050,51,530,"Virginia","Buena Vista city",1,64,76,36,40
050,51,530,"Virginia","Buena Vista city",1,65,80,37,43
050,51,530,"Virginia","Buena Vista city",1,66,92,42,50
050,51,530,"Virginia","Buena Vista city",1,67,67,27,40
050,51,530,"Virginia","Buena Vista city",1,68,68,27,41
050,51,530,"Virginia","Buena Vista city",1,69,69,31,38
050,51,530,"Virginia","Buena Vista city",1,70,71,29,42
050,51,530,"Virginia","Buena Vista city",1,71,73,31,42
050,51,530,"Virginia","Buena Vista city",1,72,67,28,39
050,51,530,"Virginia","Buena Vista city",1,73,75,36,39
050,51,530,"Virginia","Buena Vista city",1,74,54,25,29
050,51,530,"Virginia","Buena Vista city",1,75,50,23,27
050,51,530,"Virginia","Buena Vista city",1,76,47,19,28
050,51,530,"Virginia","Buena Vista city",1,77,49,16,33
050,51,530,"Virginia","Buena Vista city",1,78,39,17,22
050,51,530,"Virginia","Buena Vista city",1,79,49,23,26
050,51,530,"Virginia","Buena Vista city",1,80,43,17,26
050,51,530,"Virginia","Buena Vista city",1,81,33,9,24
050,51,530,"Virginia","Buena Vista city",1,82,30,9,21
050,51,530,"Virginia","Buena Vista city",1,83,36,17,19
050,51,530,"Virginia","Buena Vista city",1,84,31,15,16
050,51,530,"Virginia","Buena Vista city",1,85,127,42,85
050,51,530,"Virginia","Buena Vista city",2,0,88,50,38
050,51,530,"Virginia","Buena Vista city",2,1,80,44,36
050,51,530,"Virginia","Buena Vista city",2,2,81,39,42
050,51,530,"Virginia","Buena Vista city",2,3,71,31,40
050,51,530,"Virginia","Buena Vista city",2,4,69,22,47
050,51,530,"Virginia","Buena Vista city",2,5,72,23,49
050,51,530,"Virginia","Buena Vista city",2,6,70,33,37
050,51,530,"Virginia","Buena Vista city",2,7,82,40,42
050,51,530,"Virginia","Buena Vista city",2,8,75,36,39
050,51,530,"Virginia","Buena Vista city",2,9,68,36,32
050,51,530,"Virginia","Buena Vista city",2,10,74,40,34
050,51,530,"Virginia","Buena Vista city",2,11,83,45,38
050,51,530,"Virginia","Buena Vista city",2,12,77,43,34
050,51,530,"Virginia","Buena Vista city",2,13,73,41,32
050,51,530,"Virginia","Buena Vista city",2,14,80,42,38
050,51,530,"Virginia","Buena Vista city",2,15,83,36,47
050,51,530,"Virginia","Buena Vista city",2,16,83,37,46
050,51,530,"Virginia","Buena Vista city",2,17,81,36,45
050,51,530,"Virginia","Buena Vista city",2,18,161,83,78
050,51,530,"Virginia","Buena Vista city",2,19,212,77,135
050,51,530,"Virginia","Buena Vista city",2,20,151,59,92
050,51,530,"Virginia","Buena Vista city",2,21,141,57,84
050,51,530,"Virginia","Buena Vista city",2,22,121,62,59
050,51,530,"Virginia","Buena Vista city",2,23,126,69,57
050,51,530,"Virginia","Buena Vista city",2,24,110,63,47
050,51,530,"Virginia","Buena Vista city",2,25,98,54,44
050,51,530,"Virginia","Buena Vista city",2,26,96,48,48
050,51,530,"Virginia","Buena Vista city",2,27,87,45,42
050,51,530,"Virginia","Buena Vista city",2,28,87,43,44
050,51,530,"Virginia","Buena Vista city",2,29,78,37,41
050,51,530,"Virginia","Buena Vista city",2,30,72,38,34
050,51,530,"Virginia","Buena Vista city",2,31,79,39,40
050,51,530,"Virginia","Buena Vista city",2,32,69,33,36
050,51,530,"Virginia","Buena Vista city",2,33,61,27,34
050,51,530,"Virginia","Buena Vista city",2,34,68,33,35
050,51,530,"Virginia","Buena Vista city",2,35,66,40,26
050,51,530,"Virginia","Buena Vista city",2,36,55,31,24
050,51,530,"Virginia","Buena Vista city",2,37,62,32,30
050,51,530,"Virginia","Buena Vista city",2,38,61,31,30
050,51,530,"Virginia","Buena Vista city",2,39,67,34,33
050,51,530,"Virginia","Buena Vista city",2,40,79,38,41
050,51,530,"Virginia","Buena Vista city",2,41,73,35,38
050,51,530,"Virginia","Buena Vista city",2,42,72,36,36
050,51,530,"Virginia","Buena Vista city",2,43,65,33,32
050,51,530,"Virginia","Buena Vista city",2,44,65,32,33
050,51,530,"Virginia","Buena Vista city",2,45,71,36,35
050,51,530,"Virginia","Buena Vista city",2,46,69,36,33
050,51,530,"Virginia","Buena Vista city",2,47,59,26,33
050,51,530,"Virginia","Buena Vista city",2,48,57,25,32
050,51,530,"Virginia","Buena Vista city",2,49,65,33,32
050,51,530,"Virginia","Buena Vista city",2,50,78,40,38
050,51,530,"Virginia","Buena Vista city",2,51,82,40,42
050,51,530,"Virginia","Buena Vista city",2,52,84,39,45
050,51,530,"Virginia","Buena Vista city",2,53,80,40,40
050,51,530,"Virginia","Buena Vista city",2,54,80,46,34
050,51,530,"Virginia","Buena Vista city",2,55,79,43,36
050,51,530,"Virginia","Buena Vista city",2,56,85,44,41
050,51,530,"Virginia","Buena Vista city",2,57,86,39,47
050,51,530,"Virginia","Buena Vista city",2,58,73,36,37
050,51,530,"Virginia","Buena Vista city",2,59,72,32,40
050,51,530,"Virginia","Buena Vista city",2,60,78,36,42
050,51,530,"Virginia","Buena Vista city",2,61,78,37,41
050,51,530,"Virginia","Buena Vista city",2,62,77,32,45
050,51,530,"Virginia","Buena Vista city",2,63,76,32,44
050,51,530,"Virginia","Buena Vista city",2,64,74,34,40
050,51,530,"Virginia","Buena Vista city",2,65,78,37,41
050,51,530,"Virginia","Buena Vista city",2,66,89,40,49
050,51,530,"Virginia","Buena Vista city",2,67,72,30,42
050,51,530,"Virginia","Buena Vista city",2,68,68,27,41
050,51,530,"Virginia","Buena Vista city",2,69,68,30,38
050,51,530,"Virginia","Buena Vista city",2,70,70,29,41
050,51,530,"Virginia","Buena Vista city",2,71,74,31,43
050,51,530,"Virginia","Buena Vista city",2,72,65,27,38
050,51,530,"Virginia","Buena Vista city",2,73,76,35,41
050,51,530,"Virginia","Buena Vista city",2,74,54,25,29
050,51,530,"Virginia","Buena Vista city",2,75,51,23,28
050,51,530,"Virginia","Buena Vista city",2,76,48,20,28
050,51,530,"Virginia","Buena Vista city",2,77,52,18,34
050,51,530,"Virginia","Buena Vista city",2,78,39,17,22
050,51,530,"Virginia","Buena Vista city",2,79,46,22,24
050,51,530,"Virginia","Buena Vista city",2,80,43,19,24
050,51,530,"Virginia","Buena Vista city",2,81,34,9,25
050,51,530,"Virginia","Buena Vista city",2,82,30,9,21
050,51,530,"Virginia","Buena Vista city",2,83,33,15,18
050,51,530,"Virginia","Buena Vista city",2,84,31,15,16
050,51,530,"Virginia","Buena Vista city",2,85,126,42,84
050,51,530,"Virginia","Buena Vista city",3,0,94,46,48
050,51,530,"Virginia","Buena Vista city",3,1,82,47,35
050,51,530,"Virginia","Buena Vista city",3,2,77,41,36
050,51,530,"Virginia","Buena Vista city",3,3,85,40,45
050,51,530,"Virginia","Buena Vista city",3,4,73,32,41
050,51,530,"Virginia","Buena Vista city",3,5,74,28,46
050,51,530,"Virginia","Buena Vista city",3,6,70,22,48
050,51,530,"Virginia","Buena Vista city",3,7,71,36,35
050,51,530,"Virginia","Buena Vista city",3,8,84,42,42
050,51,530,"Virginia","Buena Vista city",3,9,79,37,42
050,51,530,"Virginia","Buena Vista city",3,10,64,37,27
050,51,530,"Virginia","Buena Vista city",3,11,79,44,35
050,51,530,"Virginia","Buena Vista city",3,12,82,43,39
050,51,530,"Virginia","Buena Vista city",3,13,76,42,34
050,51,530,"Virginia","Buena Vista city",3,14,73,38,35
050,51,530,"Virginia","Buena Vista city",3,15,78,43,35
050,51,530,"Virginia","Buena Vista city",3,16,86,37,49
050,51,530,"Virginia","Buena Vista city",3,17,82,38,44
050,51,530,"Virginia","Buena Vista city",3,18,155,71,84
050,51,530,"Virginia","Buena Vista city",3,19,209,77,132
050,51,530,"Virginia","Buena Vista city",3,20,150,59,91
050,51,530,"Virginia","Buena Vista city",3,21,140,58,82
050,51,530,"Virginia","Buena Vista city",3,22,125,68,57
050,51,530,"Virginia","Buena Vista city",3,23,123,69,54
050,51,530,"Virginia","Buena Vista city",3,24,120,69,51
050,51,530,"Virginia","Buena Vista city",3,25,104,52,52
050,51,530,"Virginia","Buena Vista city",3,26,96,46,50
050,51,530,"Virginia","Buena Vista city",3,27,91,49,42
050,51,530,"Virginia","Buena Vista city",3,28,88,44,44
050,51,530,"Virginia","Buena Vista city",3,29,82,38,44
050,51,530,"Virginia","Buena Vista city",3,30,80,42,38
050,51,530,"Virginia","Buena Vista city",3,31,80,45,35
050,51,530,"Virginia","Buena Vista city",3,32,84,43,41
050,51,530,"Virginia","Buena Vista city",3,33,68,32,36
050,51,530,"Virginia","Buena Vista city",3,34,59,30,29
050,51,530,"Virginia","Buena Vista city",3,35,67,36,31
050,51,530,"Virginia","Buena Vista city",3,36,65,38,27
050,51,530,"Virginia","Buena Vista city",3,37,55,31,24
050,51,530,"Virginia","Buena Vista city",3,38,65,35,30
050,51,530,"Virginia","Buena Vista city",3,39,59,33,26
050,51,530,"Virginia","Buena Vista city",3,40,67,35,32
050,51,530,"Virginia","Buena Vista city",3,41,78,38,40
050,51,530,"Virginia","Buena Vista city",3,42,65,33,32
050,51,530,"Virginia","Buena Vista city",3,43,71,36,35
050,51,530,"Virginia","Buena Vista city",3,44,60,29,31
050,51,530,"Virginia","Buena Vista city",3,45,57,28,29
050,51,530,"Virginia","Buena Vista city",3,46,68,34,34
050,51,530,"Virginia","Buena Vista city",3,47,63,29,34
050,51,530,"Virginia","Buena Vista city",3,48,57,26,31
050,51,530,"Virginia","Buena Vista city",3,49,54,21,33
050,51,530,"Virginia","Buena Vista city",3,50,71,39,32
050,51,530,"Virginia","Buena Vista city",3,51,79,39,40
050,51,530,"Virginia","Buena Vista city",3,52,76,33,43
050,51,530,"Virginia","Buena Vista city",3,53,87,42,45
050,51,530,"Virginia","Buena Vista city",3,54,77,37,40
050,51,530,"Virginia","Buena Vista city",3,55,81,46,35
050,51,530,"Virginia","Buena Vista city",3,56,79,42,37
050,51,530,"Virginia","Buena Vista city",3,57,81,43,38
050,51,530,"Virginia","Buena Vista city",3,58,82,38,44
050,51,530,"Virginia","Buena Vista city",3,59,70,34,36
050,51,530,"Virginia","Buena Vista city",3,60,70,31,39
050,51,530,"Virginia","Buena Vista city",3,61,77,39,38
050,51,530,"Virginia","Buena Vista city",3,62,76,35,41
050,51,530,"Virginia","Buena Vista city",3,63,76,32,44
050,51,530,"Virginia","Buena Vista city",3,64,74,28,46
050,51,530,"Virginia","Buena Vista city",3,65,75,33,42
050,51,530,"Virginia","Buena Vista city",3,66,76,35,41
050,51,530,"Virginia","Buena Vista city",3,67,86,40,46
050,51,530,"Virginia","Buena Vista city",3,68,70,29,41
050,51,530,"Virginia","Buena Vista city",3,69,66,23,43
050,51,530,"Virginia","Buena Vista city",3,70,66,29,37
050,51,530,"Virginia","Buena Vista city",3,71,66,28,38
050,51,530,"Virginia","Buena Vista city",3,72,72,29,43
050,51,530,"Virginia","Buena Vista city",3,73,61,24,37
050,51,530,"Virginia","Buena Vista city",3,74,75,35,40
050,51,530,"Virginia","Buena Vista city",3,75,51,24,27
050,51,530,"Virginia","Buena Vista city",3,76,47,21,26
050,51,530,"Virginia","Buena Vista city",3,77,53,21,32
050,51,530,"Virginia","Buena Vista city",3,78,43,16,27
050,51,530,"Virginia","Buena Vista city",3,79,35,13,22
050,51,530,"Virginia","Buena Vista city",3,80,43,23,20
050,51,530,"Virginia","Buena Vista city",3,81,42,17,25
050,51,530,"Virginia","Buena Vista city",3,82,32,8,24
050,51,530,"Virginia","Buena Vista city",3,83,25,8,17
050,51,530,"Virginia","Buena Vista city",3,84,34,14,20
050,51,530,"Virginia","Buena Vista city",3,85,134,47,87
050,51,530,"Virginia","Buena Vista city",4,0,80,40,40
050,51,530,"Virginia","Buena Vista city",4,1,86,38,48
050,51,530,"Virginia","Buena Vista city",4,2,77,44,33
050,51,530,"Virginia","Buena Vista city",4,3,68,37,31
050,51,530,"Virginia","Buena Vista city",4,4,89,48,41
050,51,530,"Virginia","Buena Vista city",4,5,72,31,41
050,51,530,"Virginia","Buena Vista city",4,6,70,22,48
050,51,530,"Virginia","Buena Vista city",4,7,73,26,47
050,51,530,"Virginia","Buena Vista city",4,8,70,36,34
050,51,530,"Virginia","Buena Vista city",4,9,83,43,40
050,51,530,"Virginia","Buena Vista city",4,10,89,43,46
050,51,530,"Virginia","Buena Vista city",4,11,59,36,23
050,51,530,"Virginia","Buena Vista city",4,12,78,47,31
050,51,530,"Virginia","Buena Vista city",4,13,78,44,34
050,51,530,"Virginia","Buena Vista city",4,14,78,41,37
050,51,530,"Virginia","Buena Vista city",4,15,80,41,39
050,51,530,"Virginia","Buena Vista city",4,16,78,41,37
050,51,530,"Virginia","Buena Vista city",4,17,86,37,49
050,51,530,"Virginia","Buena Vista city",4,18,160,75,85
050,51,530,"Virginia","Buena Vista city",4,19,197,68,129
050,51,530,"Virginia","Buena Vista city",4,20,138,53,85
050,51,530,"Virginia","Buena Vista city",4,21,141,60,81
050,51,530,"Virginia","Buena Vista city",4,22,134,72,62
050,51,530,"Virginia","Buena Vista city",4,23,126,62,64
050,51,530,"Virginia","Buena Vista city",4,24,107,64,43
050,51,530,"Virginia","Buena Vista city",4,25,111,63,48
050,51,530,"Virginia","Buena Vista city",4,26,96,52,44
050,51,530,"Virginia","Buena Vista city",4,27,90,44,46
050,51,530,"Virginia","Buena Vista city",4,28,93,46,47
050,51,530,"Virginia","Buena Vista city",4,29,73,34,39
050,51,530,"Virginia","Buena Vista city",4,30,89,39,50
050,51,530,"Virginia","Buena Vista city",4,31,73,37,36
050,51,530,"Virginia","Buena Vista city",4,32,78,43,35
050,51,530,"Virginia","Buena Vista city",4,33,75,32,43
050,51,530,"Virginia","Buena Vista city",4,34,72,35,37
050,51,530,"Virginia","Buena Vista city",4,35,60,31,29
050,51,530,"Virginia","Buena Vista city",4,36,73,41,32
050,51,530,"Virginia","Buena Vista city",4,37,69,43,26
050,51,530,"Virginia","Buena Vista city",4,38,58,31,27
050,51,530,"Virginia","Buena Vista city",4,39,63,33,30
050,51,530,"Virginia","Buena Vista city",4,40,60,34,26
050,51,530,"Virginia","Buena Vista city",4,41,63,32,31
050,51,530,"Virginia","Buena Vista city",4,42,73,37,36
050,51,530,"Virginia","Buena Vista city",4,43,60,31,29
050,51,530,"Virginia","Buena Vista city",4,44,68,34,34
050,51,530,"Virginia","Buena Vista city",4,45,52,27,25
050,51,530,"Virginia","Buena Vista city",4,46,52,25,27
050,51,530,"Virginia","Buena Vista city",4,47,66,31,35
050,51,530,"Virginia","Buena Vista city",4,48,64,30,34
050,51,530,"Virginia","Buena Vista city",4,49,54,24,30
050,51,530,"Virginia","Buena Vista city",4,50,56,24,32
050,51,530,"Virginia","Buena Vista city",4,51,73,39,34
050,51,530,"Virginia","Buena Vista city",4,52,75,34,41
050,51,530,"Virginia","Buena Vista city",4,53,79,34,45
050,51,530,"Virginia","Buena Vista city",4,54,90,44,46
050,51,530,"Virginia","Buena Vista city",4,55,76,34,42
050,51,530,"Virginia","Buena Vista city",4,56,74,41,33
050,51,530,"Virginia","Buena Vista city",4,57,81,41,40
050,51,530,"Virginia","Buena Vista city",4,58,87,45,42
050,51,530,"Virginia","Buena Vista city",4,59,75,34,41
050,51,530,"Virginia","Buena Vista city",4,60,68,34,34
050,51,530,"Virginia","Buena Vista city",4,61,83,37,46
050,51,530,"Virginia","Buena Vista city",4,62,73,38,35
050,51,530,"Virginia","Buena Vista city",4,63,75,33,42
050,51,530,"Virginia","Buena Vista city",4,64,73,28,45
050,51,530,"Virginia","Buena Vista city",4,65,68,28,40
050,51,530,"Virginia","Buena Vista city",4,66,70,31,39
050,51,530,"Virginia","Buena Vista city",4,67,75,36,39
050,51,530,"Virginia","Buena Vista city",4,68,84,39,45
050,51,530,"Virginia","Buena Vista city",4,69,74,32,42
050,51,530,"Virginia","Buena Vista city",4,70,65,22,43
050,51,530,"Virginia","Buena Vista city",4,71,62,27,35
050,51,530,"Virginia","Buena Vista city",4,72,61,25,36
050,51,530,"Virginia","Buena Vista city",4,73,70,29,41
050,51,530,"Virginia","Buena Vista city",4,74,62,25,37
050,51,530,"Virginia","Buena Vista city",4,75,70,32,38
050,51,530,"Virginia","Buena Vista city",4,76,47,22,25
050,51,530,"Virginia","Buena Vista city",4,77,52,21,31
050,51,530,"Virginia","Buena Vista city",4,78,42,18,24
050,51,530,"Virginia","Buena Vista city",4,79,38,12,26
050,51,530,"Virginia","Buena Vista city",4,80,32,13,19
050,51,530,"Virginia","Buena Vista city",4,81,43,21,22
050,51,530,"Virginia","Buena Vista city",4,82,41,15,26
050,51,530,"Virginia","Buena Vista city",4,83,24,7,17
050,51,530,"Virginia","Buena Vista city",4,84,28,8,20
050,51,530,"Virginia","Buena Vista city",4,85,141,51,90
050,51,530,"Virginia","Buena Vista city",5,0,79,40,39
050,51,530,"Virginia","Buena Vista city",5,1,93,40,53
050,51,530,"Virginia","Buena Vista city",5,2,80,35,45
050,51,530,"Virginia","Buena Vista city",5,3,78,46,32
050,51,530,"Virginia","Buena Vista city",5,4,70,38,32
050,51,530,"Virginia","Buena Vista city",5,5,88,45,43
050,51,530,"Virginia","Buena Vista city",5,6,73,32,41
050,51,530,"Virginia","Buena Vista city",5,7,67,23,44
050,51,530,"Virginia","Buena Vista city",5,8,77,26,51
050,51,530,"Virginia","Buena Vista city",5,9,66,38,28
050,51,530,"Virginia","Buena Vista city",5,10,81,45,36
050,51,530,"Virginia","Buena Vista city",5,11,90,43,47
050,51,530,"Virginia","Buena Vista city",5,12,58,37,21
050,51,530,"Virginia","Buena Vista city",5,13,85,51,34
050,51,530,"Virginia","Buena Vista city",5,14,75,41,34
050,51,530,"Virginia","Buena Vista city",5,15,84,43,41
050,51,530,"Virginia","Buena Vista city",5,16,80,42,38
050,51,530,"Virginia","Buena Vista city",5,17,89,45,44
050,51,530,"Virginia","Buena Vista city",5,18,169,76,93
050,51,530,"Virginia","Buena Vista city",5,19,203,72,131
050,51,530,"Virginia","Buena Vista city",5,20,139,50,89
050,51,530,"Virginia","Buena Vista city",5,21,132,62,70
050,51,530,"Virginia","Buena Vista city",5,22,147,73,74
050,51,530,"Virginia","Buena Vista city",5,23,144,87,57
050,51,530,"Virginia","Buena Vista city",5,24,111,56,55
050,51,530,"Virginia","Buena Vista city",5,25,99,55,44
050,51,530,"Virginia","Buena Vista city",5,26,99,55,44
050,51,530,"Virginia","Buena Vista city",5,27,86,47,39
050,51,530,"Virginia","Buena Vista city",5,28,88,42,46
050,51,530,"Virginia","Buena Vista city",5,29,79,39,40
050,51,530,"Virginia","Buena Vista city",5,30,70,35,35
050,51,530,"Virginia","Buena Vista city",5,31,78,32,46
050,51,530,"Virginia","Buena Vista city",5,32,68,35,33
050,51,530,"Virginia","Buena Vista city",5,33,76,42,34
050,51,530,"Virginia","Buena Vista city",5,34,84,35,49
050,51,530,"Virginia","Buena Vista city",5,35,67,33,34
050,51,530,"Virginia","Buena Vista city",5,36,66,36,30
050,51,530,"Virginia","Buena Vista city",5,37,71,41,30
050,51,530,"Virginia","Buena Vista city",5,38,69,43,26
050,51,530,"Virginia","Buena Vista city",5,39,65,33,32
050,51,530,"Virginia","Buena Vista city",5,40,62,34,28
050,51,530,"Virginia","Buena Vista city",5,41,66,35,31
050,51,530,"Virginia","Buena Vista city",5,42,59,29,30
050,51,530,"Virginia","Buena Vista city",5,43,69,35,34
050,51,530,"Virginia","Buena Vista city",5,44,61,32,29
050,51,530,"Virginia","Buena Vista city",5,45,67,36,31
050,51,530,"Virginia","Buena Vista city",5,46,50,25,25
050,51,530,"Virginia","Buena Vista city",5,47,57,29,28
050,51,530,"Virginia","Buena Vista city",5,48,64,30,34
050,51,530,"Virginia","Buena Vista city",5,49,68,33,35
050,51,530,"Virginia","Buena Vista city",5,50,55,25,30
050,51,530,"Virginia","Buena Vista city",5,51,57,23,34
050,51,530,"Virginia","Buena Vista city",5,52,66,36,30
050,51,530,"Virginia","Buena Vista city",5,53,71,32,39
050,51,530,"Virginia","Buena Vista city",5,54,86,40,46
050,51,530,"Virginia","Buena Vista city",5,55,92,44,48
050,51,530,"Virginia","Buena Vista city",5,56,73,29,44
050,51,530,"Virginia","Buena Vista city",5,57,70,37,33
050,51,530,"Virginia","Buena Vista city",5,58,73,37,36
050,51,530,"Virginia","Buena Vista city",5,59,81,43,38
050,51,530,"Virginia","Buena Vista city",5,60,74,34,40
050,51,530,"Virginia","Buena Vista city",5,61,69,34,35
050,51,530,"Virginia","Buena Vista city",5,62,76,36,40
050,51,530,"Virginia","Buena Vista city",5,63,72,39,33
050,51,530,"Virginia","Buena Vista city",5,64,72,31,41
050,51,530,"Virginia","Buena Vista city",5,65,63,23,40
050,51,530,"Virginia","Buena Vista city",5,66,66,26,40
050,51,530,"Virginia","Buena Vista city",5,67,67,30,37
050,51,530,"Virginia","Buena Vista city",5,68,74,36,38
050,51,530,"Virginia","Buena Vista city",5,69,81,39,42
050,51,530,"Virginia","Buena Vista city",5,70,67,28,39
050,51,530,"Virginia","Buena Vista city",5,71,62,22,40
050,51,530,"Virginia","Buena Vista city",5,72,57,23,34
050,51,530,"Virginia","Buena Vista city",5,73,59,23,36
050,51,530,"Virginia","Buena Vista city",5,74,71,29,42
050,51,530,"Virginia","Buena Vista city",5,75,54,21,33
050,51,530,"Virginia","Buena Vista city",5,76,66,30,36
050,51,530,"Virginia","Buena Vista city",5,77,52,22,30
050,51,530,"Virginia","Buena Vista city",5,78,39,18,21
050,51,530,"Virginia","Buena Vista city",5,79,40,17,23
050,51,530,"Virginia","Buena Vista city",5,80,32,11,21
050,51,530,"Virginia","Buena Vista city",5,81,33,12,21
050,51,530,"Virginia","Buena Vista city",5,82,42,21,21
050,51,530,"Virginia","Buena Vista city",5,83,35,12,23
050,51,530,"Virginia","Buena Vista city",5,84,27,7,20
050,51,530,"Virginia","Buena Vista city",5,85,146,52,94
050,51,540,"Virginia","Charlottesville city",1,0,537,275,262
050,51,540,"Virginia","Charlottesville city",1,1,526,276,250
050,51,540,"Virginia","Charlottesville city",1,2,481,246,235
050,51,540,"Virginia","Charlottesville city",1,3,453,232,221
050,51,540,"Virginia","Charlottesville city",1,4,430,212,218
050,51,540,"Virginia","Charlottesville city",1,5,454,213,241
050,51,540,"Virginia","Charlottesville city",1,6,414,202,212
050,51,540,"Virginia","Charlottesville city",1,7,414,210,204
050,51,540,"Virginia","Charlottesville city",1,8,412,216,196
050,51,540,"Virginia","Charlottesville city",1,9,405,209,196
050,51,540,"Virginia","Charlottesville city",1,10,395,208,187
050,51,540,"Virginia","Charlottesville city",1,11,384,199,185
050,51,540,"Virginia","Charlottesville city",1,12,393,212,181
050,51,540,"Virginia","Charlottesville city",1,13,374,190,184
050,51,540,"Virginia","Charlottesville city",1,14,335,186,149
050,51,540,"Virginia","Charlottesville city",1,15,300,162,138
050,51,540,"Virginia","Charlottesville city",1,16,313,166,147
050,51,540,"Virginia","Charlottesville city",1,17,349,171,178
050,51,540,"Virginia","Charlottesville city",1,18,452,229,223
050,51,540,"Virginia","Charlottesville city",1,19,959,413,546
050,51,540,"Virginia","Charlottesville city",1,20,2078,892,1186
050,51,540,"Virginia","Charlottesville city",1,21,2156,1031,1125
050,51,540,"Virginia","Charlottesville city",1,22,1466,824,642
050,51,540,"Virginia","Charlottesville city",1,23,953,463,490
050,51,540,"Virginia","Charlottesville city",1,24,1011,477,534
050,51,540,"Virginia","Charlottesville city",1,25,939,457,482
050,51,540,"Virginia","Charlottesville city",1,26,944,468,476
050,51,540,"Virginia","Charlottesville city",1,27,947,452,495
050,51,540,"Virginia","Charlottesville city",1,28,952,488,464
050,51,540,"Virginia","Charlottesville city",1,29,956,492,464
050,51,540,"Virginia","Charlottesville city",1,30,918,466,452
050,51,540,"Virginia","Charlottesville city",1,31,922,472,450
050,51,540,"Virginia","Charlottesville city",1,32,866,424,442
050,51,540,"Virginia","Charlottesville city",1,33,812,417,395
050,51,540,"Virginia","Charlottesville city",1,34,785,394,391
050,51,540,"Virginia","Charlottesville city",1,35,761,375,386
050,51,540,"Virginia","Charlottesville city",1,36,648,324,324
050,51,540,"Virginia","Charlottesville city",1,37,667,306,361
050,51,540,"Virginia","Charlottesville city",1,38,615,292,323
050,51,540,"Virginia","Charlottesville city",1,39,643,300,343
050,51,540,"Virginia","Charlottesville city",1,40,630,309,321
050,51,540,"Virginia","Charlottesville city",1,41,555,272,283
050,51,540,"Virginia","Charlottesville city",1,42,560,279,281
050,51,540,"Virginia","Charlottesville city",1,43,492,244,248
050,51,540,"Virginia","Charlottesville city",1,44,463,233,230
050,51,540,"Virginia","Charlottesville city",1,45,419,202,217
050,51,540,"Virginia","Charlottesville city",1,46,443,224,219
050,51,540,"Virginia","Charlottesville city",1,47,440,224,216
050,51,540,"Virginia","Charlottesville city",1,48,449,218,231
050,51,540,"Virginia","Charlottesville city",1,49,491,226,265
050,51,540,"Virginia","Charlottesville city",1,50,488,236,252
050,51,540,"Virginia","Charlottesville city",1,51,450,209,241
050,51,540,"Virginia","Charlottesville city",1,52,448,221,227
050,51,540,"Virginia","Charlottesville city",1,53,454,209,245
050,51,540,"Virginia","Charlottesville city",1,54,472,228,244
050,51,540,"Virginia","Charlottesville city",1,55,474,247,227
050,51,540,"Virginia","Charlottesville city",1,56,471,212,259
050,51,540,"Virginia","Charlottesville city",1,57,492,241,251
050,51,540,"Virginia","Charlottesville city",1,58,465,211,254
050,51,540,"Virginia","Charlottesville city",1,59,454,208,246
050,51,540,"Virginia","Charlottesville city",1,60,502,232,270
050,51,540,"Virginia","Charlottesville city",1,61,466,210,256
050,51,540,"Virginia","Charlottesville city",1,62,453,230,223
050,51,540,"Virginia","Charlottesville city",1,63,470,243,227
050,51,540,"Virginia","Charlottesville city",1,64,481,230,251
050,51,540,"Virginia","Charlottesville city",1,65,455,205,250
050,51,540,"Virginia","Charlottesville city",1,66,441,210,231
050,51,540,"Virginia","Charlottesville city",1,67,461,227,234
050,51,540,"Virginia","Charlottesville city",1,68,430,200,230
050,51,540,"Virginia","Charlottesville city",1,69,396,174,222
050,51,540,"Virginia","Charlottesville city",1,70,357,151,206
050,51,540,"Virginia","Charlottesville city",1,71,350,137,213
050,51,540,"Virginia","Charlottesville city",1,72,333,149,184
050,51,540,"Virginia","Charlottesville city",1,73,314,160,154
050,51,540,"Virginia","Charlottesville city",1,74,214,97,117
050,51,540,"Virginia","Charlottesville city",1,75,203,87,116
050,51,540,"Virginia","Charlottesville city",1,76,198,81,117
050,51,540,"Virginia","Charlottesville city",1,77,194,91,103
050,51,540,"Virginia","Charlottesville city",1,78,165,73,92
050,51,540,"Virginia","Charlottesville city",1,79,152,59,93
050,51,540,"Virginia","Charlottesville city",1,80,118,45,73
050,51,540,"Virginia","Charlottesville city",1,81,111,41,70
050,51,540,"Virginia","Charlottesville city",1,82,126,46,80
050,51,540,"Virginia","Charlottesville city",1,83,107,44,63
050,51,540,"Virginia","Charlottesville city",1,84,93,40,53
050,51,540,"Virginia","Charlottesville city",1,85,534,190,344
050,51,540,"Virginia","Charlottesville city",2,0,537,283,254
050,51,540,"Virginia","Charlottesville city",2,1,519,271,248
050,51,540,"Virginia","Charlottesville city",2,2,489,252,237
050,51,540,"Virginia","Charlottesville city",2,3,456,232,224
050,51,540,"Virginia","Charlottesville city",2,4,437,217,220
050,51,540,"Virginia","Charlottesville city",2,5,445,210,235
050,51,540,"Virginia","Charlottesville city",2,6,419,204,215
050,51,540,"Virginia","Charlottesville city",2,7,405,206,199
050,51,540,"Virginia","Charlottesville city",2,8,404,211,193
050,51,540,"Virginia","Charlottesville city",2,9,399,208,191
050,51,540,"Virginia","Charlottesville city",2,10,394,207,187
050,51,540,"Virginia","Charlottesville city",2,11,382,198,184
050,51,540,"Virginia","Charlottesville city",2,12,390,206,184
050,51,540,"Virginia","Charlottesville city",2,13,373,192,181
050,51,540,"Virginia","Charlottesville city",2,14,339,183,156
050,51,540,"Virginia","Charlottesville city",2,15,311,168,143
050,51,540,"Virginia","Charlottesville city",2,16,310,164,146
050,51,540,"Virginia","Charlottesville city",2,17,337,169,168
050,51,540,"Virginia","Charlottesville city",2,18,450,224,226
050,51,540,"Virginia","Charlottesville city",2,19,962,412,550
050,51,540,"Virginia","Charlottesville city",2,20,2086,892,1194
050,51,540,"Virginia","Charlottesville city",2,21,2149,1025,1124
050,51,540,"Virginia","Charlottesville city",2,22,1460,822,638
050,51,540,"Virginia","Charlottesville city",2,23,967,467,500
050,51,540,"Virginia","Charlottesville city",2,24,984,462,522
050,51,540,"Virginia","Charlottesville city",2,25,938,455,483
050,51,540,"Virginia","Charlottesville city",2,26,937,460,477
050,51,540,"Virginia","Charlottesville city",2,27,927,446,481
050,51,540,"Virginia","Charlottesville city",2,28,944,481,463
050,51,540,"Virginia","Charlottesville city",2,29,941,484,457
050,51,540,"Virginia","Charlottesville city",2,30,916,465,451
050,51,540,"Virginia","Charlottesville city",2,31,904,459,445
050,51,540,"Virginia","Charlottesville city",2,32,861,426,435
050,51,540,"Virginia","Charlottesville city",2,33,812,413,399
050,51,540,"Virginia","Charlottesville city",2,34,783,393,390
050,51,540,"Virginia","Charlottesville city",2,35,756,372,384
050,51,540,"Virginia","Charlottesville city",2,36,661,327,334
050,51,540,"Virginia","Charlottesville city",2,37,655,308,347
050,51,540,"Virginia","Charlottesville city",2,38,629,296,333
050,51,540,"Virginia","Charlottesville city",2,39,627,293,334
050,51,540,"Virginia","Charlottesville city",2,40,632,307,325
050,51,540,"Virginia","Charlottesville city",2,41,569,278,291
050,51,540,"Virginia","Charlottesville city",2,42,552,274,278
050,51,540,"Virginia","Charlottesville city",2,43,509,254,255
050,51,540,"Virginia","Charlottesville city",2,44,465,233,232
050,51,540,"Virginia","Charlottesville city",2,45,429,209,220
050,51,540,"Virginia","Charlottesville city",2,46,436,218,218
050,51,540,"Virginia","Charlottesville city",2,47,438,224,214
050,51,540,"Virginia","Charlottesville city",2,48,442,215,227
050,51,540,"Virginia","Charlottesville city",2,49,482,224,258
050,51,540,"Virginia","Charlottesville city",2,50,485,232,253
050,51,540,"Virginia","Charlottesville city",2,51,452,212,240
050,51,540,"Virginia","Charlottesville city",2,52,440,214,226
050,51,540,"Virginia","Charlottesville city",2,53,445,209,236
050,51,540,"Virginia","Charlottesville city",2,54,462,223,239
050,51,540,"Virginia","Charlottesville city",2,55,472,242,230
050,51,540,"Virginia","Charlottesville city",2,56,474,221,253
050,51,540,"Virginia","Charlottesville city",2,57,483,233,250
050,51,540,"Virginia","Charlottesville city",2,58,472,218,254
050,51,540,"Virginia","Charlottesville city",2,59,463,213,250
050,51,540,"Virginia","Charlottesville city",2,60,491,229,262
050,51,540,"Virginia","Charlottesville city",2,61,476,216,260
050,51,540,"Virginia","Charlottesville city",2,62,451,222,229
050,51,540,"Virginia","Charlottesville city",2,63,465,238,227
050,51,540,"Virginia","Charlottesville city",2,64,477,232,245
050,51,540,"Virginia","Charlottesville city",2,65,459,209,250
050,51,540,"Virginia","Charlottesville city",2,66,445,208,237
050,51,540,"Virginia","Charlottesville city",2,67,454,222,232
050,51,540,"Virginia","Charlottesville city",2,68,434,204,230
050,51,540,"Virginia","Charlottesville city",2,69,405,180,225
050,51,540,"Virginia","Charlottesville city",2,70,367,157,210
050,51,540,"Virginia","Charlottesville city",2,71,350,140,210
050,51,540,"Virginia","Charlottesville city",2,72,330,143,187
050,51,540,"Virginia","Charlottesville city",2,73,329,161,168
050,51,540,"Virginia","Charlottesville city",2,74,225,104,121
050,51,540,"Virginia","Charlottesville city",2,75,206,90,116
050,51,540,"Virginia","Charlottesville city",2,76,194,81,113
050,51,540,"Virginia","Charlottesville city",2,77,197,90,107
050,51,540,"Virginia","Charlottesville city",2,78,169,76,93
050,51,540,"Virginia","Charlottesville city",2,79,153,61,92
050,51,540,"Virginia","Charlottesville city",2,80,122,47,75
050,51,540,"Virginia","Charlottesville city",2,81,110,41,69
050,51,540,"Virginia","Charlottesville city",2,82,125,45,80
050,51,540,"Virginia","Charlottesville city",2,83,108,42,66
050,51,540,"Virginia","Charlottesville city",2,84,97,42,55
050,51,540,"Virginia","Charlottesville city",2,85,533,191,342
050,51,540,"Virginia","Charlottesville city",3,0,588,315,273
050,51,540,"Virginia","Charlottesville city",3,1,481,263,218
050,51,540,"Virginia","Charlottesville city",3,2,480,252,228
050,51,540,"Virginia","Charlottesville city",3,3,465,227,238
050,51,540,"Virginia","Charlottesville city",3,4,439,235,204
050,51,540,"Virginia","Charlottesville city",3,5,414,206,208
050,51,540,"Virginia","Charlottesville city",3,6,419,195,224
050,51,540,"Virginia","Charlottesville city",3,7,390,184,206
050,51,540,"Virginia","Charlottesville city",3,8,390,216,174
050,51,540,"Virginia","Charlottesville city",3,9,392,203,189
050,51,540,"Virginia","Charlottesville city",3,10,395,203,192
050,51,540,"Virginia","Charlottesville city",3,11,400,204,196
050,51,540,"Virginia","Charlottesville city",3,12,374,186,188
050,51,540,"Virginia","Charlottesville city",3,13,403,212,191
050,51,540,"Virginia","Charlottesville city",3,14,357,192,165
050,51,540,"Virginia","Charlottesville city",3,15,331,177,154
050,51,540,"Virginia","Charlottesville city",3,16,287,149,138
050,51,540,"Virginia","Charlottesville city",3,17,307,154,153
050,51,540,"Virginia","Charlottesville city",3,18,451,225,226
050,51,540,"Virginia","Charlottesville city",3,19,964,410,554
050,51,540,"Virginia","Charlottesville city",3,20,2070,883,1187
050,51,540,"Virginia","Charlottesville city",3,21,2137,1010,1127
050,51,540,"Virginia","Charlottesville city",3,22,1470,831,639
050,51,540,"Virginia","Charlottesville city",3,23,893,441,452
050,51,540,"Virginia","Charlottesville city",3,24,894,412,482
050,51,540,"Virginia","Charlottesville city",3,25,923,453,470
050,51,540,"Virginia","Charlottesville city",3,26,858,420,438
050,51,540,"Virginia","Charlottesville city",3,27,814,395,419
050,51,540,"Virginia","Charlottesville city",3,28,868,419,449
050,51,540,"Virginia","Charlottesville city",3,29,859,438,421
050,51,540,"Virginia","Charlottesville city",3,30,867,434,433
050,51,540,"Virginia","Charlottesville city",3,31,819,411,408
050,51,540,"Virginia","Charlottesville city",3,32,809,407,402
050,51,540,"Virginia","Charlottesville city",3,33,797,402,395
050,51,540,"Virginia","Charlottesville city",3,34,765,390,375
050,51,540,"Virginia","Charlottesville city",3,35,734,364,370
050,51,540,"Virginia","Charlottesville city",3,36,703,343,360
050,51,540,"Virginia","Charlottesville city",3,37,590,294,296
050,51,540,"Virginia","Charlottesville city",3,38,634,305,329
050,51,540,"Virginia","Charlottesville city",3,39,582,285,297
050,51,540,"Virginia","Charlottesville city",3,40,611,292,319
050,51,540,"Virginia","Charlottesville city",3,41,597,281,316
050,51,540,"Virginia","Charlottesville city",3,42,529,262,267
050,51,540,"Virginia","Charlottesville city",3,43,559,283,276
050,51,540,"Virginia","Charlottesville city",3,44,499,247,252
050,51,540,"Virginia","Charlottesville city",3,45,464,230,234
050,51,540,"Virginia","Charlottesville city",3,46,430,209,221
050,51,540,"Virginia","Charlottesville city",3,47,426,219,207
050,51,540,"Virginia","Charlottesville city",3,48,439,223,216
050,51,540,"Virginia","Charlottesville city",3,49,437,213,224
050,51,540,"Virginia","Charlottesville city",3,50,479,222,257
050,51,540,"Virginia","Charlottesville city",3,51,460,214,246
050,51,540,"Virginia","Charlottesville city",3,52,450,210,240
050,51,540,"Virginia","Charlottesville city",3,53,431,206,225
050,51,540,"Virginia","Charlottesville city",3,54,445,212,233
050,51,540,"Virginia","Charlottesville city",3,55,456,215,241
050,51,540,"Virginia","Charlottesville city",3,56,479,248,231
050,51,540,"Virginia","Charlottesville city",3,57,481,228,253
050,51,540,"Virginia","Charlottesville city",3,58,470,222,248
050,51,540,"Virginia","Charlottesville city",3,59,463,214,249
050,51,540,"Virginia","Charlottesville city",3,60,437,201,236
050,51,540,"Virginia","Charlottesville city",3,61,475,219,256
050,51,540,"Virginia","Charlottesville city",3,62,485,222,263
050,51,540,"Virginia","Charlottesville city",3,63,440,210,230
050,51,540,"Virginia","Charlottesville city",3,64,450,231,219
050,51,540,"Virginia","Charlottesville city",3,65,459,223,236
050,51,540,"Virginia","Charlottesville city",3,66,451,205,246
050,51,540,"Virginia","Charlottesville city",3,67,434,202,232
050,51,540,"Virginia","Charlottesville city",3,68,440,215,225
050,51,540,"Virginia","Charlottesville city",3,69,426,199,227
050,51,540,"Virginia","Charlottesville city",3,70,404,181,223
050,51,540,"Virginia","Charlottesville city",3,71,364,153,211
050,51,540,"Virginia","Charlottesville city",3,72,353,135,218
050,51,540,"Virginia","Charlottesville city",3,73,308,135,173
050,51,540,"Virginia","Charlottesville city",3,74,331,156,175
050,51,540,"Virginia","Charlottesville city",3,75,212,103,109
050,51,540,"Virginia","Charlottesville city",3,76,203,87,116
050,51,540,"Virginia","Charlottesville city",3,77,191,76,115
050,51,540,"Virginia","Charlottesville city",3,78,187,82,105
050,51,540,"Virginia","Charlottesville city",3,79,164,76,88
050,51,540,"Virginia","Charlottesville city",3,80,139,52,87
050,51,540,"Virginia","Charlottesville city",3,81,117,43,74
050,51,540,"Virginia","Charlottesville city",3,82,111,43,68
050,51,540,"Virginia","Charlottesville city",3,83,112,37,75
050,51,540,"Virginia","Charlottesville city",3,84,100,41,59
050,51,540,"Virginia","Charlottesville city",3,85,535,195,340
050,51,540,"Virginia","Charlottesville city",4,0,585,317,268
050,51,540,"Virginia","Charlottesville city",4,1,526,296,230
050,51,540,"Virginia","Charlottesville city",4,2,473,255,218
050,51,540,"Virginia","Charlottesville city",4,3,462,249,213
050,51,540,"Virginia","Charlottesville city",4,4,430,202,228
050,51,540,"Virginia","Charlottesville city",4,5,431,222,209
050,51,540,"Virginia","Charlottesville city",4,6,409,208,201
050,51,540,"Virginia","Charlottesville city",4,7,397,187,210
050,51,540,"Virginia","Charlottesville city",4,8,398,188,210
050,51,540,"Virginia","Charlottesville city",4,9,387,211,176
050,51,540,"Virginia","Charlottesville city",4,10,387,203,184
050,51,540,"Virginia","Charlottesville city",4,11,390,200,190
050,51,540,"Virginia","Charlottesville city",4,12,401,196,205
050,51,540,"Virginia","Charlottesville city",4,13,378,183,195
050,51,540,"Virginia","Charlottesville city",4,14,411,220,191
050,51,540,"Virginia","Charlottesville city",4,15,357,187,170
050,51,540,"Virginia","Charlottesville city",4,16,332,177,155
050,51,540,"Virginia","Charlottesville city",4,17,292,144,148
050,51,540,"Virginia","Charlottesville city",4,18,433,213,220
050,51,540,"Virginia","Charlottesville city",4,19,953,409,544
050,51,540,"Virginia","Charlottesville city",4,20,2045,854,1191
050,51,540,"Virginia","Charlottesville city",4,21,2177,1035,1142
050,51,540,"Virginia","Charlottesville city",4,22,1483,832,651
050,51,540,"Virginia","Charlottesville city",4,23,866,426,440
050,51,540,"Virginia","Charlottesville city",4,24,828,403,425
050,51,540,"Virginia","Charlottesville city",4,25,824,390,434
050,51,540,"Virginia","Charlottesville city",4,26,889,428,461
050,51,540,"Virginia","Charlottesville city",4,27,804,367,437
050,51,540,"Virginia","Charlottesville city",4,28,760,382,378
050,51,540,"Virginia","Charlottesville city",4,29,793,377,416
050,51,540,"Virginia","Charlottesville city",4,30,793,400,393
050,51,540,"Virginia","Charlottesville city",4,31,781,393,388
050,51,540,"Virginia","Charlottesville city",4,32,752,379,373
050,51,540,"Virginia","Charlottesville city",4,33,732,383,349
050,51,540,"Virginia","Charlottesville city",4,34,700,336,364
050,51,540,"Virginia","Charlottesville city",4,35,665,332,333
050,51,540,"Virginia","Charlottesville city",4,36,676,346,330
050,51,540,"Virginia","Charlottesville city",4,37,671,333,338
050,51,540,"Virginia","Charlottesville city",4,38,575,274,301
050,51,540,"Virginia","Charlottesville city",4,39,597,289,308
050,51,540,"Virginia","Charlottesville city",4,40,576,286,290
050,51,540,"Virginia","Charlottesville city",4,41,602,281,321
050,51,540,"Virginia","Charlottesville city",4,42,591,281,310
050,51,540,"Virginia","Charlottesville city",4,43,540,270,270
050,51,540,"Virginia","Charlottesville city",4,44,557,281,276
050,51,540,"Virginia","Charlottesville city",4,45,476,232,244
050,51,540,"Virginia","Charlottesville city",4,46,458,234,224
050,51,540,"Virginia","Charlottesville city",4,47,436,214,222
050,51,540,"Virginia","Charlottesville city",4,48,398,196,202
050,51,540,"Virginia","Charlottesville city",4,49,436,222,214
050,51,540,"Virginia","Charlottesville city",4,50,437,217,220
050,51,540,"Virginia","Charlottesville city",4,51,471,214,257
050,51,540,"Virginia","Charlottesville city",4,52,433,197,236
050,51,540,"Virginia","Charlottesville city",4,53,444,201,243
050,51,540,"Virginia","Charlottesville city",4,54,416,193,223
050,51,540,"Virginia","Charlottesville city",4,55,427,209,218
050,51,540,"Virginia","Charlottesville city",4,56,457,218,239
050,51,540,"Virginia","Charlottesville city",4,57,454,232,222
050,51,540,"Virginia","Charlottesville city",4,58,458,218,240
050,51,540,"Virginia","Charlottesville city",4,59,459,213,246
050,51,540,"Virginia","Charlottesville city",4,60,474,224,250
050,51,540,"Virginia","Charlottesville city",4,61,430,192,238
050,51,540,"Virginia","Charlottesville city",4,62,461,208,253
050,51,540,"Virginia","Charlottesville city",4,63,475,219,256
050,51,540,"Virginia","Charlottesville city",4,64,427,201,226
050,51,540,"Virginia","Charlottesville city",4,65,431,223,208
050,51,540,"Virginia","Charlottesville city",4,66,463,224,239
050,51,540,"Virginia","Charlottesville city",4,67,437,204,233
050,51,540,"Virginia","Charlottesville city",4,68,434,200,234
050,51,540,"Virginia","Charlottesville city",4,69,427,200,227
050,51,540,"Virginia","Charlottesville city",4,70,430,201,229
050,51,540,"Virginia","Charlottesville city",4,71,396,173,223
050,51,540,"Virginia","Charlottesville city",4,72,352,145,207
050,51,540,"Virginia","Charlottesville city",4,73,345,133,212
050,51,540,"Virginia","Charlottesville city",4,74,307,133,174
050,51,540,"Virginia","Charlottesville city",4,75,318,152,166
050,51,540,"Virginia","Charlottesville city",4,76,206,95,111
050,51,540,"Virginia","Charlottesville city",4,77,195,84,111
050,51,540,"Virginia","Charlottesville city",4,78,176,66,110
050,51,540,"Virginia","Charlottesville city",4,79,183,82,101
050,51,540,"Virginia","Charlottesville city",4,80,155,69,86
050,51,540,"Virginia","Charlottesville city",4,81,134,49,85
050,51,540,"Virginia","Charlottesville city",4,82,117,45,72
050,51,540,"Virginia","Charlottesville city",4,83,95,38,57
050,51,540,"Virginia","Charlottesville city",4,84,102,32,70
050,51,540,"Virginia","Charlottesville city",4,85,533,191,342
050,51,540,"Virginia","Charlottesville city",5,0,582,314,268
050,51,540,"Virginia","Charlottesville city",5,1,536,280,256
050,51,540,"Virginia","Charlottesville city",5,2,511,281,230
050,51,540,"Virginia","Charlottesville city",5,3,456,240,216
050,51,540,"Virginia","Charlottesville city",5,4,448,249,199
050,51,540,"Virginia","Charlottesville city",5,5,413,201,212
050,51,540,"Virginia","Charlottesville city",5,6,416,219,197
050,51,540,"Virginia","Charlottesville city",5,7,418,213,205
050,51,540,"Virginia","Charlottesville city",5,8,401,188,213
050,51,540,"Virginia","Charlottesville city",5,9,400,188,212
050,51,540,"Virginia","Charlottesville city",5,10,386,209,177
050,51,540,"Virginia","Charlottesville city",5,11,397,206,191
050,51,540,"Virginia","Charlottesville city",5,12,383,196,187
050,51,540,"Virginia","Charlottesville city",5,13,395,181,214
050,51,540,"Virginia","Charlottesville city",5,14,387,193,194
050,51,540,"Virginia","Charlottesville city",5,15,409,218,191
050,51,540,"Virginia","Charlottesville city",5,16,360,187,173
050,51,540,"Virginia","Charlottesville city",5,17,349,183,166
050,51,540,"Virginia","Charlottesville city",5,18,411,198,213
050,51,540,"Virginia","Charlottesville city",5,19,936,395,541
050,51,540,"Virginia","Charlottesville city",5,20,2064,876,1188
050,51,540,"Virginia","Charlottesville city",5,21,2141,999,1142
050,51,540,"Virginia","Charlottesville city",5,22,1524,867,657
050,51,540,"Virginia","Charlottesville city",5,23,902,438,464
050,51,540,"Virginia","Charlottesville city",5,24,815,397,418
050,51,540,"Virginia","Charlottesville city",5,25,756,380,376
050,51,540,"Virginia","Charlottesville city",5,26,797,382,415
050,51,540,"Virginia","Charlottesville city",5,27,792,359,433
050,51,540,"Virginia","Charlottesville city",5,28,789,361,428
050,51,540,"Virginia","Charlottesville city",5,29,717,373,344
050,51,540,"Virginia","Charlottesville city",5,30,725,350,375
050,51,540,"Virginia","Charlottesville city",5,31,724,351,373
050,51,540,"Virginia","Charlottesville city",5,32,708,362,346
050,51,540,"Virginia","Charlottesville city",5,33,711,363,348
050,51,540,"Virginia","Charlottesville city",5,34,633,326,307
050,51,540,"Virginia","Charlottesville city",5,35,664,314,350
050,51,540,"Virginia","Charlottesville city",5,36,624,320,304
050,51,540,"Virginia","Charlottesville city",5,37,646,326,320
050,51,540,"Virginia","Charlottesville city",5,38,664,333,331
050,51,540,"Virginia","Charlottesville city",5,39,561,258,303
050,51,540,"Virginia","Charlottesville city",5,40,618,298,320
050,51,540,"Virginia","Charlottesville city",5,41,534,249,285
050,51,540,"Virginia","Charlottesville city",5,42,591,276,315
050,51,540,"Virginia","Charlottesville city",5,43,578,263,315
050,51,540,"Virginia","Charlottesville city",5,44,519,262,257
050,51,540,"Virginia","Charlottesville city",5,45,528,259,269
050,51,540,"Virginia","Charlottesville city",5,46,479,237,242
050,51,540,"Virginia","Charlottesville city",5,47,459,238,221
050,51,540,"Virginia","Charlottesville city",5,48,426,206,220
050,51,540,"Virginia","Charlottesville city",5,49,391,183,208
050,51,540,"Virginia","Charlottesville city",5,50,422,214,208
050,51,540,"Virginia","Charlottesville city",5,51,414,203,211
050,51,540,"Virginia","Charlottesville city",5,52,478,218,260
050,51,540,"Virginia","Charlottesville city",5,53,438,207,231
050,51,540,"Virginia","Charlottesville city",5,54,425,194,231
050,51,540,"Virginia","Charlottesville city",5,55,397,193,204
050,51,540,"Virginia","Charlottesville city",5,56,416,201,215
050,51,540,"Virginia","Charlottesville city",5,57,450,216,234
050,51,540,"Virginia","Charlottesville city",5,58,454,238,216
050,51,540,"Virginia","Charlottesville city",5,59,443,210,233
050,51,540,"Virginia","Charlottesville city",5,60,429,196,233
050,51,540,"Virginia","Charlottesville city",5,61,463,216,247
050,51,540,"Virginia","Charlottesville city",5,62,424,189,235
050,51,540,"Virginia","Charlottesville city",5,63,451,203,248
050,51,540,"Virginia","Charlottesville city",5,64,470,218,252
050,51,540,"Virginia","Charlottesville city",5,65,412,196,216
050,51,540,"Virginia","Charlottesville city",5,66,433,222,211
050,51,540,"Virginia","Charlottesville city",5,67,444,217,227
050,51,540,"Virginia","Charlottesville city",5,68,430,200,230
050,51,540,"Virginia","Charlottesville city",5,69,419,196,223
050,51,540,"Virginia","Charlottesville city",5,70,415,197,218
050,51,540,"Virginia","Charlottesville city",5,71,417,193,224
050,51,540,"Virginia","Charlottesville city",5,72,386,167,219
050,51,540,"Virginia","Charlottesville city",5,73,335,143,192
050,51,540,"Virginia","Charlottesville city",5,74,337,129,208
050,51,540,"Virginia","Charlottesville city",5,75,297,132,165
050,51,540,"Virginia","Charlottesville city",5,76,309,145,164
050,51,540,"Virginia","Charlottesville city",5,77,194,86,108
050,51,540,"Virginia","Charlottesville city",5,78,180,73,107
050,51,540,"Virginia","Charlottesville city",5,79,174,68,106
050,51,540,"Virginia","Charlottesville city",5,80,166,71,95
050,51,540,"Virginia","Charlottesville city",5,81,145,64,81
050,51,540,"Virginia","Charlottesville city",5,82,139,52,87
050,51,540,"Virginia","Charlottesville city",5,83,102,38,64
050,51,540,"Virginia","Charlottesville city",5,84,80,32,48
050,51,540,"Virginia","Charlottesville city",5,85,521,176,345
050,51,550,"Virginia","Chesapeake city",1,0,2914,1489,1425
050,51,550,"Virginia","Chesapeake city",1,1,3033,1520,1513
050,51,550,"Virginia","Chesapeake city",1,2,3130,1583,1547
050,51,550,"Virginia","Chesapeake city",1,3,3142,1650,1492
050,51,550,"Virginia","Chesapeake city",1,4,3370,1684,1686
050,51,550,"Virginia","Chesapeake city",1,5,3351,1717,1634
050,51,550,"Virginia","Chesapeake city",1,6,3332,1716,1616
050,51,550,"Virginia","Chesapeake city",1,7,3277,1658,1619
050,51,550,"Virginia","Chesapeake city",1,8,3420,1775,1645
050,51,550,"Virginia","Chesapeake city",1,9,3340,1677,1663
050,51,550,"Virginia","Chesapeake city",1,10,3407,1753,1654
050,51,550,"Virginia","Chesapeake city",1,11,3533,1812,1721
050,51,550,"Virginia","Chesapeake city",1,12,3674,1910,1764
050,51,550,"Virginia","Chesapeake city",1,13,3737,1904,1833
050,51,550,"Virginia","Chesapeake city",1,14,3635,1803,1832
050,51,550,"Virginia","Chesapeake city",1,15,3561,1810,1751
050,51,550,"Virginia","Chesapeake city",1,16,3696,1897,1799
050,51,550,"Virginia","Chesapeake city",1,17,3588,1841,1747
050,51,550,"Virginia","Chesapeake city",1,18,3013,1597,1416
050,51,550,"Virginia","Chesapeake city",1,19,2546,1348,1198
050,51,550,"Virginia","Chesapeake city",1,20,2687,1399,1288
050,51,550,"Virginia","Chesapeake city",1,21,2793,1441,1352
050,51,550,"Virginia","Chesapeake city",1,22,2850,1473,1377
050,51,550,"Virginia","Chesapeake city",1,23,2999,1478,1521
050,51,550,"Virginia","Chesapeake city",1,24,3062,1575,1487
050,51,550,"Virginia","Chesapeake city",1,25,3088,1614,1474
050,51,550,"Virginia","Chesapeake city",1,26,3272,1721,1551
050,51,550,"Virginia","Chesapeake city",1,27,3345,1729,1616
050,51,550,"Virginia","Chesapeake city",1,28,3380,1696,1684
050,51,550,"Virginia","Chesapeake city",1,29,3420,1725,1695
050,51,550,"Virginia","Chesapeake city",1,30,3557,1739,1818
050,51,550,"Virginia","Chesapeake city",1,31,3659,1783,1876
050,51,550,"Virginia","Chesapeake city",1,32,3629,1763,1866
050,51,550,"Virginia","Chesapeake city",1,33,3740,1863,1877
050,51,550,"Virginia","Chesapeake city",1,34,3740,1865,1875
050,51,550,"Virginia","Chesapeake city",1,35,3748,1873,1875
050,51,550,"Virginia","Chesapeake city",1,36,3808,1863,1945
050,51,550,"Virginia","Chesapeake city",1,37,3928,1958,1970
050,51,550,"Virginia","Chesapeake city",1,38,3856,1923,1933
050,51,550,"Virginia","Chesapeake city",1,39,3816,1901,1915
050,51,550,"Virginia","Chesapeake city",1,40,3682,1821,1861
050,51,550,"Virginia","Chesapeake city",1,41,3408,1691,1717
050,51,550,"Virginia","Chesapeake city",1,42,3364,1671,1693
050,51,550,"Virginia","Chesapeake city",1,43,3219,1561,1658
050,51,550,"Virginia","Chesapeake city",1,44,3121,1511,1610
050,51,550,"Virginia","Chesapeake city",1,45,3094,1482,1612
050,51,550,"Virginia","Chesapeake city",1,46,2961,1482,1479
050,51,550,"Virginia","Chesapeake city",1,47,2963,1462,1501
050,51,550,"Virginia","Chesapeake city",1,48,3142,1531,1611
050,51,550,"Virginia","Chesapeake city",1,49,3401,1668,1733
050,51,550,"Virginia","Chesapeake city",1,50,3155,1587,1568
050,51,550,"Virginia","Chesapeake city",1,51,3050,1514,1536
050,51,550,"Virginia","Chesapeake city",1,52,2897,1416,1481
050,51,550,"Virginia","Chesapeake city",1,53,3037,1455,1582
050,51,550,"Virginia","Chesapeake city",1,54,3123,1495,1628
050,51,550,"Virginia","Chesapeake city",1,55,3355,1579,1776
050,51,550,"Virginia","Chesapeake city",1,56,3482,1670,1812
050,51,550,"Virginia","Chesapeake city",1,57,3494,1714,1780
050,51,550,"Virginia","Chesapeake city",1,58,3473,1666,1807
050,51,550,"Virginia","Chesapeake city",1,59,3420,1675,1745
050,51,550,"Virginia","Chesapeake city",1,60,3323,1579,1744
050,51,550,"Virginia","Chesapeake city",1,61,3316,1577,1739
050,51,550,"Virginia","Chesapeake city",1,62,3241,1558,1683
050,51,550,"Virginia","Chesapeake city",1,63,2975,1443,1532
050,51,550,"Virginia","Chesapeake city",1,64,2842,1308,1534
050,51,550,"Virginia","Chesapeake city",1,65,2650,1220,1430
050,51,550,"Virginia","Chesapeake city",1,66,2578,1183,1395
050,51,550,"Virginia","Chesapeake city",1,67,2439,1130,1309
050,51,550,"Virginia","Chesapeake city",1,68,2266,1027,1239
050,51,550,"Virginia","Chesapeake city",1,69,2039,952,1087
050,51,550,"Virginia","Chesapeake city",1,70,1952,876,1076
050,51,550,"Virginia","Chesapeake city",1,71,1971,897,1074
050,51,550,"Virginia","Chesapeake city",1,72,1934,873,1061
050,51,550,"Virginia","Chesapeake city",1,73,1905,848,1057
050,51,550,"Virginia","Chesapeake city",1,74,1358,591,767
050,51,550,"Virginia","Chesapeake city",1,75,1384,615,769
050,51,550,"Virginia","Chesapeake city",1,76,1303,576,727
050,51,550,"Virginia","Chesapeake city",1,77,1272,539,733
050,51,550,"Virginia","Chesapeake city",1,78,1035,453,582
050,51,550,"Virginia","Chesapeake city",1,79,941,395,546
050,51,550,"Virginia","Chesapeake city",1,80,848,361,487
050,51,550,"Virginia","Chesapeake city",1,81,801,326,475
050,51,550,"Virginia","Chesapeake city",1,82,727,289,438
050,51,550,"Virginia","Chesapeake city",1,83,649,266,383
050,51,550,"Virginia","Chesapeake city",1,84,600,228,372
050,51,550,"Virginia","Chesapeake city",1,85,3103,1053,2050
050,51,550,"Virginia","Chesapeake city",2,0,2877,1469,1408
050,51,550,"Virginia","Chesapeake city",2,1,3019,1518,1501
050,51,550,"Virginia","Chesapeake city",2,2,3131,1586,1545
050,51,550,"Virginia","Chesapeake city",2,3,3165,1653,1512
050,51,550,"Virginia","Chesapeake city",2,4,3326,1682,1644
050,51,550,"Virginia","Chesapeake city",2,5,3365,1714,1651
050,51,550,"Virginia","Chesapeake city",2,6,3345,1719,1626
050,51,550,"Virginia","Chesapeake city",2,7,3304,1684,1620
050,51,550,"Virginia","Chesapeake city",2,8,3387,1738,1649
050,51,550,"Virginia","Chesapeake city",2,9,3368,1704,1664
050,51,550,"Virginia","Chesapeake city",2,10,3402,1734,1668
050,51,550,"Virginia","Chesapeake city",2,11,3515,1802,1713
050,51,550,"Virginia","Chesapeake city",2,12,3671,1903,1768
050,51,550,"Virginia","Chesapeake city",2,13,3731,1910,1821
050,51,550,"Virginia","Chesapeake city",2,14,3660,1827,1833
050,51,550,"Virginia","Chesapeake city",2,15,3586,1810,1776
050,51,550,"Virginia","Chesapeake city",2,16,3667,1875,1792
050,51,550,"Virginia","Chesapeake city",2,17,3602,1853,1749
050,51,550,"Virginia","Chesapeake city",2,18,3022,1600,1422
050,51,550,"Virginia","Chesapeake city",2,19,2574,1366,1208
050,51,550,"Virginia","Chesapeake city",2,20,2726,1420,1306
050,51,550,"Virginia","Chesapeake city",2,21,2777,1433,1344
050,51,550,"Virginia","Chesapeake city",2,22,2871,1476,1395
050,51,550,"Virginia","Chesapeake city",2,23,2991,1497,1494
050,51,550,"Virginia","Chesapeake city",2,24,3039,1551,1488
050,51,550,"Virginia","Chesapeake city",2,25,3085,1604,1481
050,51,550,"Virginia","Chesapeake city",2,26,3244,1703,1541
050,51,550,"Virginia","Chesapeake city",2,27,3334,1726,1608
050,51,550,"Virginia","Chesapeake city",2,28,3384,1714,1670
050,51,550,"Virginia","Chesapeake city",2,29,3435,1726,1709
050,51,550,"Virginia","Chesapeake city",2,30,3569,1764,1805
050,51,550,"Virginia","Chesapeake city",2,31,3634,1775,1859
050,51,550,"Virginia","Chesapeake city",2,32,3640,1768,1872
050,51,550,"Virginia","Chesapeake city",2,33,3733,1844,1889
050,51,550,"Virginia","Chesapeake city",2,34,3757,1868,1889
050,51,550,"Virginia","Chesapeake city",2,35,3802,1895,1907
050,51,550,"Virginia","Chesapeake city",2,36,3785,1852,1933
050,51,550,"Virginia","Chesapeake city",2,37,3919,1936,1983
050,51,550,"Virginia","Chesapeake city",2,38,3893,1938,1955
050,51,550,"Virginia","Chesapeake city",2,39,3820,1906,1914
050,51,550,"Virginia","Chesapeake city",2,40,3742,1856,1886
050,51,550,"Virginia","Chesapeake city",2,41,3469,1721,1748
050,51,550,"Virginia","Chesapeake city",2,42,3353,1668,1685
050,51,550,"Virginia","Chesapeake city",2,43,3262,1595,1667
050,51,550,"Virginia","Chesapeake city",2,44,3122,1517,1605
050,51,550,"Virginia","Chesapeake city",2,45,3110,1491,1619
050,51,550,"Virginia","Chesapeake city",2,46,2985,1481,1504
050,51,550,"Virginia","Chesapeake city",2,47,2941,1452,1489
050,51,550,"Virginia","Chesapeake city",2,48,3077,1501,1576
050,51,550,"Virginia","Chesapeake city",2,49,3345,1639,1706
050,51,550,"Virginia","Chesapeake city",2,50,3212,1601,1611
050,51,550,"Virginia","Chesapeake city",2,51,3049,1513,1536
050,51,550,"Virginia","Chesapeake city",2,52,2929,1434,1495
050,51,550,"Virginia","Chesapeake city",2,53,2991,1435,1556
050,51,550,"Virginia","Chesapeake city",2,54,3088,1474,1614
050,51,550,"Virginia","Chesapeake city",2,55,3287,1547,1740
050,51,550,"Virginia","Chesapeake city",2,56,3442,1644,1798
050,51,550,"Virginia","Chesapeake city",2,57,3492,1705,1787
050,51,550,"Virginia","Chesapeake city",2,58,3459,1668,1791
050,51,550,"Virginia","Chesapeake city",2,59,3442,1676,1766
050,51,550,"Virginia","Chesapeake city",2,60,3334,1594,1740
050,51,550,"Virginia","Chesapeake city",2,61,3296,1565,1731
050,51,550,"Virginia","Chesapeake city",2,62,3238,1556,1682
050,51,550,"Virginia","Chesapeake city",2,63,3054,1476,1578
050,51,550,"Virginia","Chesapeake city",2,64,2850,1327,1523
050,51,550,"Virginia","Chesapeake city",2,65,2681,1231,1450
050,51,550,"Virginia","Chesapeake city",2,66,2596,1190,1406
050,51,550,"Virginia","Chesapeake city",2,67,2454,1132,1322
050,51,550,"Virginia","Chesapeake city",2,68,2287,1039,1248
050,51,550,"Virginia","Chesapeake city",2,69,2100,971,1129
050,51,550,"Virginia","Chesapeake city",2,70,1959,882,1077
050,51,550,"Virginia","Chesapeake city",2,71,1962,891,1071
050,51,550,"Virginia","Chesapeake city",2,72,1906,859,1047
050,51,550,"Virginia","Chesapeake city",2,73,1991,890,1101
050,51,550,"Virginia","Chesapeake city",2,74,1409,614,795
050,51,550,"Virginia","Chesapeake city",2,75,1376,604,772
050,51,550,"Virginia","Chesapeake city",2,76,1299,576,723
050,51,550,"Virginia","Chesapeake city",2,77,1291,551,740
050,51,550,"Virginia","Chesapeake city",2,78,1053,460,593
050,51,550,"Virginia","Chesapeake city",2,79,943,404,539
050,51,550,"Virginia","Chesapeake city",2,80,860,364,496
050,51,550,"Virginia","Chesapeake city",2,81,794,326,468
050,51,550,"Virginia","Chesapeake city",2,82,729,290,439
050,51,550,"Virginia","Chesapeake city",2,83,657,267,390
050,51,550,"Virginia","Chesapeake city",2,84,600,231,369
050,51,550,"Virginia","Chesapeake city",2,85,3110,1055,2055
050,51,550,"Virginia","Chesapeake city",3,0,2886,1480,1406
050,51,550,"Virginia","Chesapeake city",3,1,2989,1532,1457
050,51,550,"Virginia","Chesapeake city",3,2,3139,1550,1589
050,51,550,"Virginia","Chesapeake city",3,3,3146,1596,1550
050,51,550,"Virginia","Chesapeake city",3,4,3235,1683,1552
050,51,550,"Virginia","Chesapeake city",3,5,3383,1705,1678
050,51,550,"Virginia","Chesapeake city",3,6,3448,1762,1686
050,51,550,"Virginia","Chesapeake city",3,7,3419,1781,1638
050,51,550,"Virginia","Chesapeake city",3,8,3358,1722,1636
050,51,550,"Virginia","Chesapeake city",3,9,3485,1770,1715
050,51,550,"Virginia","Chesapeake city",3,10,3452,1734,1718
050,51,550,"Virginia","Chesapeake city",3,11,3447,1758,1689
050,51,550,"Virginia","Chesapeake city",3,12,3547,1813,1734
050,51,550,"Virginia","Chesapeake city",3,13,3642,1898,1744
050,51,550,"Virginia","Chesapeake city",3,14,3739,1911,1828
050,51,550,"Virginia","Chesapeake city",3,15,3651,1827,1824
050,51,550,"Virginia","Chesapeake city",3,16,3617,1818,1799
050,51,550,"Virginia","Chesapeake city",3,17,3667,1870,1797
050,51,550,"Virginia","Chesapeake city",3,18,3109,1670,1439
050,51,550,"Virginia","Chesapeake city",3,19,2545,1367,1178
050,51,550,"Virginia","Chesapeake city",3,20,2764,1456,1308
050,51,550,"Virginia","Chesapeake city",3,21,2843,1459,1384
050,51,550,"Virginia","Chesapeake city",3,22,2931,1503,1428
050,51,550,"Virginia","Chesapeake city",3,23,2961,1541,1420
050,51,550,"Virginia","Chesapeake city",3,24,3024,1542,1482
050,51,550,"Virginia","Chesapeake city",3,25,3053,1595,1458
050,51,550,"Virginia","Chesapeake city",3,26,3142,1623,1519
050,51,550,"Virginia","Chesapeake city",3,27,3235,1680,1555
050,51,550,"Virginia","Chesapeake city",3,28,3415,1742,1673
050,51,550,"Virginia","Chesapeake city",3,29,3434,1690,1744
050,51,550,"Virginia","Chesapeake city",3,30,3557,1778,1779
050,51,550,"Virginia","Chesapeake city",3,31,3621,1797,1824
050,51,550,"Virginia","Chesapeake city",3,32,3736,1859,1877
050,51,550,"Virginia","Chesapeake city",3,33,3700,1784,1916
050,51,550,"Virginia","Chesapeake city",3,34,3858,1924,1934
050,51,550,"Virginia","Chesapeake city",3,35,3918,1936,1982
050,51,550,"Virginia","Chesapeake city",3,36,3865,1902,1963
050,51,550,"Virginia","Chesapeake city",3,37,3863,1906,1957
050,51,550,"Virginia","Chesapeake city",3,38,3985,1977,2008
050,51,550,"Virginia","Chesapeake city",3,39,3971,2017,1954
050,51,550,"Virginia","Chesapeake city",3,40,3857,1925,1932
050,51,550,"Virginia","Chesapeake city",3,41,3787,1883,1904
050,51,550,"Virginia","Chesapeake city",3,42,3537,1784,1753
050,51,550,"Virginia","Chesapeake city",3,43,3357,1679,1678
050,51,550,"Virginia","Chesapeake city",3,44,3250,1590,1660
050,51,550,"Virginia","Chesapeake city",3,45,3139,1502,1637
050,51,550,"Virginia","Chesapeake city",3,46,3106,1527,1579
050,51,550,"Virginia","Chesapeake city",3,47,2958,1467,1491
050,51,550,"Virginia","Chesapeake city",3,48,2858,1404,1454
050,51,550,"Virginia","Chesapeake city",3,49,3059,1483,1576
050,51,550,"Virginia","Chesapeake city",3,50,3284,1584,1700
050,51,550,"Virginia","Chesapeake city",3,51,3172,1575,1597
050,51,550,"Virginia","Chesapeake city",3,52,3000,1489,1511
050,51,550,"Virginia","Chesapeake city",3,53,2889,1410,1479
050,51,550,"Virginia","Chesapeake city",3,54,2980,1422,1558
050,51,550,"Virginia","Chesapeake city",3,55,3011,1428,1583
050,51,550,"Virginia","Chesapeake city",3,56,3235,1526,1709
050,51,550,"Virginia","Chesapeake city",3,57,3380,1616,1764
050,51,550,"Virginia","Chesapeake city",3,58,3428,1681,1747
050,51,550,"Virginia","Chesapeake city",3,59,3438,1650,1788
050,51,550,"Virginia","Chesapeake city",3,60,3384,1643,1741
050,51,550,"Virginia","Chesapeake city",3,61,3242,1553,1689
050,51,550,"Virginia","Chesapeake city",3,62,3231,1547,1684
050,51,550,"Virginia","Chesapeake city",3,63,3141,1506,1635
050,51,550,"Virginia","Chesapeake city",3,64,2980,1431,1549
050,51,550,"Virginia","Chesapeake city",3,65,2787,1275,1512
050,51,550,"Virginia","Chesapeake city",3,66,2635,1203,1432
050,51,550,"Virginia","Chesapeake city",3,67,2574,1170,1404
050,51,550,"Virginia","Chesapeake city",3,68,2412,1112,1300
050,51,550,"Virginia","Chesapeake city",3,69,2241,1010,1231
050,51,550,"Virginia","Chesapeake city",3,70,2060,947,1113
050,51,550,"Virginia","Chesapeake city",3,71,1912,853,1059
050,51,550,"Virginia","Chesapeake city",3,72,1891,843,1048
050,51,550,"Virginia","Chesapeake city",3,73,1853,830,1023
050,51,550,"Virginia","Chesapeake city",3,74,1931,853,1078
050,51,550,"Virginia","Chesapeake city",3,75,1359,585,774
050,51,550,"Virginia","Chesapeake city",3,76,1333,571,762
050,51,550,"Virginia","Chesapeake city",3,77,1259,556,703
050,51,550,"Virginia","Chesapeake city",3,78,1239,511,728
050,51,550,"Virginia","Chesapeake city",3,79,999,434,565
050,51,550,"Virginia","Chesapeake city",3,80,891,375,516
050,51,550,"Virginia","Chesapeake city",3,81,807,338,469
050,51,550,"Virginia","Chesapeake city",3,82,725,293,432
050,51,550,"Virginia","Chesapeake city",3,83,670,256,414
050,51,550,"Virginia","Chesapeake city",3,84,587,234,353
050,51,550,"Virginia","Chesapeake city",3,85,3115,1073,2042
050,51,550,"Virginia","Chesapeake city",4,0,2964,1540,1424
050,51,550,"Virginia","Chesapeake city",4,1,2897,1476,1421
050,51,550,"Virginia","Chesapeake city",4,2,3070,1561,1509
050,51,550,"Virginia","Chesapeake city",4,3,3185,1534,1651
050,51,550,"Virginia","Chesapeake city",4,4,3184,1590,1594
050,51,550,"Virginia","Chesapeake city",4,5,3296,1727,1569
050,51,550,"Virginia","Chesapeake city",4,6,3441,1726,1715
050,51,550,"Virginia","Chesapeake city",4,7,3475,1788,1687
050,51,550,"Virginia","Chesapeake city",4,8,3447,1787,1660
050,51,550,"Virginia","Chesapeake city",4,9,3407,1743,1664
050,51,550,"Virginia","Chesapeake city",4,10,3503,1790,1713
050,51,550,"Virginia","Chesapeake city",4,11,3499,1761,1738
050,51,550,"Virginia","Chesapeake city",4,12,3455,1760,1695
050,51,550,"Virginia","Chesapeake city",4,13,3601,1824,1777
050,51,550,"Virginia","Chesapeake city",4,14,3630,1848,1782
050,51,550,"Virginia","Chesapeake city",4,15,3700,1878,1822
050,51,550,"Virginia","Chesapeake city",4,16,3611,1808,1803
050,51,550,"Virginia","Chesapeake city",4,17,3563,1796,1767
050,51,550,"Virginia","Chesapeake city",4,18,3137,1660,1477
050,51,550,"Virginia","Chesapeake city",4,19,2544,1380,1164
050,51,550,"Virginia","Chesapeake city",4,20,2667,1406,1261
050,51,550,"Virginia","Chesapeake city",4,21,2834,1482,1352
050,51,550,"Virginia","Chesapeake city",4,22,2982,1524,1458
050,51,550,"Virginia","Chesapeake city",4,23,3070,1585,1485
050,51,550,"Virginia","Chesapeake city",4,24,2958,1560,1398
050,51,550,"Virginia","Chesapeake city",4,25,2984,1532,1452
050,51,550,"Virginia","Chesapeake city",4,26,3098,1607,1491
050,51,550,"Virginia","Chesapeake city",4,27,3109,1646,1463
050,51,550,"Virginia","Chesapeake city",4,28,3246,1648,1598
050,51,550,"Virginia","Chesapeake city",4,29,3468,1767,1701
050,51,550,"Virginia","Chesapeake city",4,30,3525,1783,1742
050,51,550,"Virginia","Chesapeake city",4,31,3637,1792,1845
050,51,550,"Virginia","Chesapeake city",4,32,3701,1832,1869
050,51,550,"Virginia","Chesapeake city",4,33,3792,1861,1931
050,51,550,"Virginia","Chesapeake city",4,34,3753,1825,1928
050,51,550,"Virginia","Chesapeake city",4,35,3956,1968,1988
050,51,550,"Virginia","Chesapeake city",4,36,3922,1928,1994
050,51,550,"Virginia","Chesapeake city",4,37,3915,1929,1986
050,51,550,"Virginia","Chesapeake city",4,38,3897,1922,1975
050,51,550,"Virginia","Chesapeake city",4,39,4028,2023,2005
050,51,550,"Virginia","Chesapeake city",4,40,3960,1995,1965
050,51,550,"Virginia","Chesapeake city",4,41,3837,1911,1926
050,51,550,"Virginia","Chesapeake city",4,42,3783,1891,1892
050,51,550,"Virginia","Chesapeake city",4,43,3484,1768,1716
050,51,550,"Virginia","Chesapeake city",4,44,3377,1698,1679
050,51,550,"Virginia","Chesapeake city",4,45,3243,1563,1680
050,51,550,"Virginia","Chesapeake city",4,46,3120,1491,1629
050,51,550,"Virginia","Chesapeake city",4,47,3034,1480,1554
050,51,550,"Virginia","Chesapeake city",4,48,2926,1449,1477
050,51,550,"Virginia","Chesapeake city",4,49,2821,1374,1447
050,51,550,"Virginia","Chesapeake city",4,50,3020,1474,1546
050,51,550,"Virginia","Chesapeake city",4,51,3242,1570,1672
050,51,550,"Virginia","Chesapeake city",4,52,3174,1574,1600
050,51,550,"Virginia","Chesapeake city",4,53,2972,1464,1508
050,51,550,"Virginia","Chesapeake city",4,54,2857,1399,1458
050,51,550,"Virginia","Chesapeake city",4,55,2932,1394,1538
050,51,550,"Virginia","Chesapeake city",4,56,2976,1402,1574
050,51,550,"Virginia","Chesapeake city",4,57,3202,1509,1693
050,51,550,"Virginia","Chesapeake city",4,58,3324,1572,1752
050,51,550,"Virginia","Chesapeake city",4,59,3371,1648,1723
050,51,550,"Virginia","Chesapeake city",4,60,3343,1573,1770
050,51,550,"Virginia","Chesapeake city",4,61,3316,1593,1723
050,51,550,"Virginia","Chesapeake city",4,62,3210,1526,1684
050,51,550,"Virginia","Chesapeake city",4,63,3169,1522,1647
050,51,550,"Virginia","Chesapeake city",4,64,3085,1458,1627
050,51,550,"Virginia","Chesapeake city",4,65,2925,1392,1533
050,51,550,"Virginia","Chesapeake city",4,66,2784,1274,1510
050,51,550,"Virginia","Chesapeake city",4,67,2580,1165,1415
050,51,550,"Virginia","Chesapeake city",4,68,2531,1138,1393
050,51,550,"Virginia","Chesapeake city",4,69,2357,1088,1269
050,51,550,"Virginia","Chesapeake city",4,70,2195,976,1219
050,51,550,"Virginia","Chesapeake city",4,71,2031,930,1101
050,51,550,"Virginia","Chesapeake city",4,72,1878,835,1043
050,51,550,"Virginia","Chesapeake city",4,73,1852,816,1036
050,51,550,"Virginia","Chesapeake city",4,74,1768,791,977
050,51,550,"Virginia","Chesapeake city",4,75,1854,802,1052
050,51,550,"Virginia","Chesapeake city",4,76,1289,554,735
050,51,550,"Virginia","Chesapeake city",4,77,1272,542,730
050,51,550,"Virginia","Chesapeake city",4,78,1175,511,664
050,51,550,"Virginia","Chesapeake city",4,79,1186,488,698
050,51,550,"Virginia","Chesapeake city",4,80,957,405,552
050,51,550,"Virginia","Chesapeake city",4,81,828,342,486
050,51,550,"Virginia","Chesapeake city",4,82,737,300,437
050,51,550,"Virginia","Chesapeake city",4,83,655,255,400
050,51,550,"Virginia","Chesapeake city",4,84,597,226,371
050,51,550,"Virginia","Chesapeake city",4,85,3079,1093,1986
050,51,550,"Virginia","Chesapeake city",5,0,2957,1532,1425
050,51,550,"Virginia","Chesapeake city",5,1,3014,1558,1456
050,51,550,"Virginia","Chesapeake city",5,2,2988,1521,1467
050,51,550,"Virginia","Chesapeake city",5,3,3111,1567,1544
050,51,550,"Virginia","Chesapeake city",5,4,3224,1573,1651
050,51,550,"Virginia","Chesapeake city",5,5,3277,1626,1651
050,51,550,"Virginia","Chesapeake city",5,6,3398,1752,1646
050,51,550,"Virginia","Chesapeake city",5,7,3493,1725,1768
050,51,550,"Virginia","Chesapeake city",5,8,3594,1848,1746
050,51,550,"Virginia","Chesapeake city",5,9,3482,1802,1680
050,51,550,"Virginia","Chesapeake city",5,10,3464,1770,1694
050,51,550,"Virginia","Chesapeake city",5,11,3581,1841,1740
050,51,550,"Virginia","Chesapeake city",5,12,3501,1768,1733
050,51,550,"Virginia","Chesapeake city",5,13,3464,1775,1689
050,51,550,"Virginia","Chesapeake city",5,14,3587,1837,1750
050,51,550,"Virginia","Chesapeake city",5,15,3658,1874,1784
050,51,550,"Virginia","Chesapeake city",5,16,3703,1898,1805
050,51,550,"Virginia","Chesapeake city",5,17,3612,1811,1801
050,51,550,"Virginia","Chesapeake city",5,18,3067,1613,1454
050,51,550,"Virginia","Chesapeake city",5,19,2626,1407,1219
050,51,550,"Virginia","Chesapeake city",5,20,2716,1462,1254
050,51,550,"Virginia","Chesapeake city",5,21,2765,1439,1326
050,51,550,"Virginia","Chesapeake city",5,22,2997,1524,1473
050,51,550,"Virginia","Chesapeake city",5,23,3062,1560,1502
050,51,550,"Virginia","Chesapeake city",5,24,3043,1616,1427
050,51,550,"Virginia","Chesapeake city",5,25,2932,1567,1365
050,51,550,"Virginia","Chesapeake city",5,26,2986,1515,1471
050,51,550,"Virginia","Chesapeake city",5,27,3118,1632,1486
050,51,550,"Virginia","Chesapeake city",5,28,3129,1638,1491
050,51,550,"Virginia","Chesapeake city",5,29,3324,1662,1662
050,51,550,"Virginia","Chesapeake city",5,30,3484,1777,1707
050,51,550,"Virginia","Chesapeake city",5,31,3598,1810,1788
050,51,550,"Virginia","Chesapeake city",5,32,3755,1854,1901
050,51,550,"Virginia","Chesapeake city",5,33,3768,1840,1928
050,51,550,"Virginia","Chesapeake city",5,34,3791,1838,1953
050,51,550,"Virginia","Chesapeake city",5,35,3857,1902,1955
050,51,550,"Virginia","Chesapeake city",5,36,3984,1967,2017
050,51,550,"Virginia","Chesapeake city",5,37,3953,1949,2004
050,51,550,"Virginia","Chesapeake city",5,38,3917,1967,1950
050,51,550,"Virginia","Chesapeake city",5,39,3895,1904,1991
050,51,550,"Virginia","Chesapeake city",5,40,4024,2035,1989
050,51,550,"Virginia","Chesapeake city",5,41,3939,1978,1961
050,51,550,"Virginia","Chesapeake city",5,42,3861,1952,1909
050,51,550,"Virginia","Chesapeake city",5,43,3711,1832,1879
050,51,550,"Virginia","Chesapeake city",5,44,3467,1754,1713
050,51,550,"Virginia","Chesapeake city",5,45,3342,1654,1688
050,51,550,"Virginia","Chesapeake city",5,46,3278,1602,1676
050,51,550,"Virginia","Chesapeake city",5,47,3058,1458,1600
050,51,550,"Virginia","Chesapeake city",5,48,2978,1452,1526
050,51,550,"Virginia","Chesapeake city",5,49,2887,1441,1446
050,51,550,"Virginia","Chesapeake city",5,50,2818,1355,1463
050,51,550,"Virginia","Chesapeake city",5,51,3003,1460,1543
050,51,550,"Virginia","Chesapeake city",5,52,3201,1546,1655
050,51,550,"Virginia","Chesapeake city",5,53,3147,1570,1577
050,51,550,"Virginia","Chesapeake city",5,54,2964,1459,1505
050,51,550,"Virginia","Chesapeake city",5,55,2809,1363,1446
050,51,550,"Virginia","Chesapeake city",5,56,2889,1379,1510
050,51,550,"Virginia","Chesapeake city",5,57,2952,1389,1563
050,51,550,"Virginia","Chesapeake city",5,58,3143,1476,1667
050,51,550,"Virginia","Chesapeake city",5,59,3334,1567,1767
050,51,550,"Virginia","Chesapeake city",5,60,3291,1604,1687
050,51,550,"Virginia","Chesapeake city",5,61,3278,1543,1735
050,51,550,"Virginia","Chesapeake city",5,62,3269,1580,1689
050,51,550,"Virginia","Chesapeake city",5,63,3175,1494,1681
050,51,550,"Virginia","Chesapeake city",5,64,3116,1466,1650
050,51,550,"Virginia","Chesapeake city",5,65,3044,1429,1615
050,51,550,"Virginia","Chesapeake city",5,66,2872,1356,1516
050,51,550,"Virginia","Chesapeake city",5,67,2745,1260,1485
050,51,550,"Virginia","Chesapeake city",5,68,2542,1139,1403
050,51,550,"Virginia","Chesapeake city",5,69,2464,1106,1358
050,51,550,"Virginia","Chesapeake city",5,70,2328,1069,1259
050,51,550,"Virginia","Chesapeake city",5,71,2140,959,1181
050,51,550,"Virginia","Chesapeake city",5,72,1996,918,1078
050,51,550,"Virginia","Chesapeake city",5,73,1855,823,1032
050,51,550,"Virginia","Chesapeake city",5,74,1792,777,1015
050,51,550,"Virginia","Chesapeake city",5,75,1729,765,964
050,51,550,"Virginia","Chesapeake city",5,76,1768,755,1013
050,51,550,"Virginia","Chesapeake city",5,77,1234,526,708
050,51,550,"Virginia","Chesapeake city",5,78,1244,533,711
050,51,550,"Virginia","Chesapeake city",5,79,1116,486,630
050,51,550,"Virginia","Chesapeake city",5,80,1152,462,690
050,51,550,"Virginia","Chesapeake city",5,81,899,374,525
050,51,550,"Virginia","Chesapeake city",5,82,748,292,456
050,51,550,"Virginia","Chesapeake city",5,83,698,275,423
050,51,550,"Virginia","Chesapeake city",5,84,596,225,371
050,51,550,"Virginia","Chesapeake city",5,85,3115,1128,1987
050,51,570,"Virginia","Colonial Heights city",1,0,237,123,114
050,51,570,"Virginia","Colonial Heights city",1,1,222,119,103
050,51,570,"Virginia","Colonial Heights city",1,2,229,109,120
050,51,570,"Virginia","Colonial Heights city",1,3,207,96,111
050,51,570,"Virginia","Colonial Heights city",1,4,234,113,121
050,51,570,"Virginia","Colonial Heights city",1,5,212,111,101
050,51,570,"Virginia","Colonial Heights city",1,6,233,111,122
050,51,570,"Virginia","Colonial Heights city",1,7,229,124,105
050,51,570,"Virginia","Colonial Heights city",1,8,219,113,106
050,51,570,"Virginia","Colonial Heights city",1,9,224,114,110
050,51,570,"Virginia","Colonial Heights city",1,10,246,126,120
050,51,570,"Virginia","Colonial Heights city",1,11,254,126,128
050,51,570,"Virginia","Colonial Heights city",1,12,256,130,126
050,51,570,"Virginia","Colonial Heights city",1,13,237,116,121
050,51,570,"Virginia","Colonial Heights city",1,14,258,136,122
050,51,570,"Virginia","Colonial Heights city",1,15,259,118,141
050,51,570,"Virginia","Colonial Heights city",1,16,226,110,116
050,51,570,"Virginia","Colonial Heights city",1,17,259,126,133
050,51,570,"Virginia","Colonial Heights city",1,18,222,115,107
050,51,570,"Virginia","Colonial Heights city",1,19,170,86,84
050,51,570,"Virginia","Colonial Heights city",1,20,170,86,84
050,51,570,"Virginia","Colonial Heights city",1,21,204,99,105
050,51,570,"Virginia","Colonial Heights city",1,22,192,94,98
050,51,570,"Virginia","Colonial Heights city",1,23,204,101,103
050,51,570,"Virginia","Colonial Heights city",1,24,197,98,99
050,51,570,"Virginia","Colonial Heights city",1,25,236,113,123
050,51,570,"Virginia","Colonial Heights city",1,26,248,120,128
050,51,570,"Virginia","Colonial Heights city",1,27,250,122,128
050,51,570,"Virginia","Colonial Heights city",1,28,251,135,116
050,51,570,"Virginia","Colonial Heights city",1,29,278,148,130
050,51,570,"Virginia","Colonial Heights city",1,30,242,124,118
050,51,570,"Virginia","Colonial Heights city",1,31,246,117,129
050,51,570,"Virginia","Colonial Heights city",1,32,226,95,131
050,51,570,"Virginia","Colonial Heights city",1,33,218,99,119
050,51,570,"Virginia","Colonial Heights city",1,34,227,98,129
050,51,570,"Virginia","Colonial Heights city",1,35,207,91,116
050,51,570,"Virginia","Colonial Heights city",1,36,207,80,127
050,51,570,"Virginia","Colonial Heights city",1,37,218,97,121
050,51,570,"Virginia","Colonial Heights city",1,38,228,115,113
050,51,570,"Virginia","Colonial Heights city",1,39,205,84,121
050,51,570,"Virginia","Colonial Heights city",1,40,222,100,122
050,51,570,"Virginia","Colonial Heights city",1,41,226,119,107
050,51,570,"Virginia","Colonial Heights city",1,42,192,93,99
050,51,570,"Virginia","Colonial Heights city",1,43,183,81,102
050,51,570,"Virginia","Colonial Heights city",1,44,200,87,113
050,51,570,"Virginia","Colonial Heights city",1,45,194,88,106
050,51,570,"Virginia","Colonial Heights city",1,46,212,111,101
050,51,570,"Virginia","Colonial Heights city",1,47,206,98,108
050,51,570,"Virginia","Colonial Heights city",1,48,235,116,119
050,51,570,"Virginia","Colonial Heights city",1,49,221,104,117
050,51,570,"Virginia","Colonial Heights city",1,50,212,85,127
050,51,570,"Virginia","Colonial Heights city",1,51,241,105,136
050,51,570,"Virginia","Colonial Heights city",1,52,228,88,140
050,51,570,"Virginia","Colonial Heights city",1,53,206,89,117
050,51,570,"Virginia","Colonial Heights city",1,54,219,102,117
050,51,570,"Virginia","Colonial Heights city",1,55,247,122,125
050,51,570,"Virginia","Colonial Heights city",1,56,245,122,123
050,51,570,"Virginia","Colonial Heights city",1,57,242,123,119
050,51,570,"Virginia","Colonial Heights city",1,58,266,133,133
050,51,570,"Virginia","Colonial Heights city",1,59,282,135,147
050,51,570,"Virginia","Colonial Heights city",1,60,254,111,143
050,51,570,"Virginia","Colonial Heights city",1,61,240,103,137
050,51,570,"Virginia","Colonial Heights city",1,62,229,107,122
050,51,570,"Virginia","Colonial Heights city",1,63,198,88,110
050,51,570,"Virginia","Colonial Heights city",1,64,211,97,114
050,51,570,"Virginia","Colonial Heights city",1,65,213,101,112
050,51,570,"Virginia","Colonial Heights city",1,66,192,85,107
050,51,570,"Virginia","Colonial Heights city",1,67,186,64,122
050,51,570,"Virginia","Colonial Heights city",1,68,175,66,109
050,51,570,"Virginia","Colonial Heights city",1,69,156,65,91
050,51,570,"Virginia","Colonial Heights city",1,70,171,68,103
050,51,570,"Virginia","Colonial Heights city",1,71,175,73,102
050,51,570,"Virginia","Colonial Heights city",1,72,202,87,115
050,51,570,"Virginia","Colonial Heights city",1,73,217,95,122
050,51,570,"Virginia","Colonial Heights city",1,74,150,63,87
050,51,570,"Virginia","Colonial Heights city",1,75,149,60,89
050,51,570,"Virginia","Colonial Heights city",1,76,142,66,76
050,51,570,"Virginia","Colonial Heights city",1,77,143,70,73
050,51,570,"Virginia","Colonial Heights city",1,78,120,49,71
050,51,570,"Virginia","Colonial Heights city",1,79,114,48,66
050,51,570,"Virginia","Colonial Heights city",1,80,103,39,64
050,51,570,"Virginia","Colonial Heights city",1,81,102,41,61
050,51,570,"Virginia","Colonial Heights city",1,82,93,31,62
050,51,570,"Virginia","Colonial Heights city",1,83,93,31,62
050,51,570,"Virginia","Colonial Heights city",1,84,78,25,53
050,51,570,"Virginia","Colonial Heights city",1,85,498,162,336
050,51,570,"Virginia","Colonial Heights city",2,0,246,127,119
050,51,570,"Virginia","Colonial Heights city",2,1,226,122,104
050,51,570,"Virginia","Colonial Heights city",2,2,227,113,114
050,51,570,"Virginia","Colonial Heights city",2,3,216,103,113
050,51,570,"Virginia","Colonial Heights city",2,4,229,110,119
050,51,570,"Virginia","Colonial Heights city",2,5,216,109,107
050,51,570,"Virginia","Colonial Heights city",2,6,229,111,118
050,51,570,"Virginia","Colonial Heights city",2,7,227,119,108
050,51,570,"Virginia","Colonial Heights city",2,8,221,116,105
050,51,570,"Virginia","Colonial Heights city",2,9,227,116,111
050,51,570,"Virginia","Colonial Heights city",2,10,245,125,120
050,51,570,"Virginia","Colonial Heights city",2,11,253,128,125
050,51,570,"Virginia","Colonial Heights city",2,12,258,128,130
050,51,570,"Virginia","Colonial Heights city",2,13,243,121,122
050,51,570,"Virginia","Colonial Heights city",2,14,254,132,122
050,51,570,"Virginia","Colonial Heights city",2,15,256,122,134
050,51,570,"Virginia","Colonial Heights city",2,16,241,117,124
050,51,570,"Virginia","Colonial Heights city",2,17,252,122,130
050,51,570,"Virginia","Colonial Heights city",2,18,217,111,106
050,51,570,"Virginia","Colonial Heights city",2,19,174,89,85
050,51,570,"Virginia","Colonial Heights city",2,20,180,90,90
050,51,570,"Virginia","Colonial Heights city",2,21,199,97,102
050,51,570,"Virginia","Colonial Heights city",2,22,197,97,100
050,51,570,"Virginia","Colonial Heights city",2,23,197,97,100
050,51,570,"Virginia","Colonial Heights city",2,24,201,99,102
050,51,570,"Virginia","Colonial Heights city",2,25,226,108,118
050,51,570,"Virginia","Colonial Heights city",2,26,247,120,127
050,51,570,"Virginia","Colonial Heights city",2,27,248,122,126
050,51,570,"Virginia","Colonial Heights city",2,28,257,135,122
050,51,570,"Virginia","Colonial Heights city",2,29,275,146,129
050,51,570,"Virginia","Colonial Heights city",2,30,253,132,121
050,51,570,"Virginia","Colonial Heights city",2,31,244,118,126
050,51,570,"Virginia","Colonial Heights city",2,32,231,102,129
050,51,570,"Virginia","Colonial Heights city",2,33,221,98,123
050,51,570,"Virginia","Colonial Heights city",2,34,229,101,128
050,51,570,"Virginia","Colonial Heights city",2,35,214,93,121
050,51,570,"Virginia","Colonial Heights city",2,36,204,82,122
050,51,570,"Virginia","Colonial Heights city",2,37,215,95,120
050,51,570,"Virginia","Colonial Heights city",2,38,225,110,115
050,51,570,"Virginia","Colonial Heights city",2,39,209,91,118
050,51,570,"Virginia","Colonial Heights city",2,40,221,98,123
050,51,570,"Virginia","Colonial Heights city",2,41,219,113,106
050,51,570,"Virginia","Colonial Heights city",2,42,198,98,100
050,51,570,"Virginia","Colonial Heights city",2,43,188,85,103
050,51,570,"Virginia","Colonial Heights city",2,44,197,86,111
050,51,570,"Virginia","Colonial Heights city",2,45,199,91,108
050,51,570,"Virginia","Colonial Heights city",2,46,210,107,103
050,51,570,"Virginia","Colonial Heights city",2,47,212,103,109
050,51,570,"Virginia","Colonial Heights city",2,48,229,111,118
050,51,570,"Virginia","Colonial Heights city",2,49,224,106,118
050,51,570,"Virginia","Colonial Heights city",2,50,221,91,130
050,51,570,"Virginia","Colonial Heights city",2,51,230,96,134
050,51,570,"Virginia","Colonial Heights city",2,52,226,89,137
050,51,570,"Virginia","Colonial Heights city",2,53,209,88,121
050,51,570,"Virginia","Colonial Heights city",2,54,213,98,115
050,51,570,"Virginia","Colonial Heights city",2,55,239,118,121
050,51,570,"Virginia","Colonial Heights city",2,56,246,124,122
050,51,570,"Virginia","Colonial Heights city",2,57,246,124,122
050,51,570,"Virginia","Colonial Heights city",2,58,258,130,128
050,51,570,"Virginia","Colonial Heights city",2,59,280,135,145
050,51,570,"Virginia","Colonial Heights city",2,60,259,115,144
050,51,570,"Virginia","Colonial Heights city",2,61,243,105,138
050,51,570,"Virginia","Colonial Heights city",2,62,229,104,125
050,51,570,"Virginia","Colonial Heights city",2,63,207,94,113
050,51,570,"Virginia","Colonial Heights city",2,64,206,94,112
050,51,570,"Virginia","Colonial Heights city",2,65,210,98,112
050,51,570,"Virginia","Colonial Heights city",2,66,194,87,107
050,51,570,"Virginia","Colonial Heights city",2,67,187,69,118
050,51,570,"Virginia","Colonial Heights city",2,68,177,66,111
050,51,570,"Virginia","Colonial Heights city",2,69,160,64,96
050,51,570,"Virginia","Colonial Heights city",2,70,164,65,99
050,51,570,"Virginia","Colonial Heights city",2,71,171,69,102
050,51,570,"Virginia","Colonial Heights city",2,72,193,82,111
050,51,570,"Virginia","Colonial Heights city",2,73,222,96,126
050,51,570,"Virginia","Colonial Heights city",2,74,155,66,89
050,51,570,"Virginia","Colonial Heights city",2,75,147,59,88
050,51,570,"Virginia","Colonial Heights city",2,76,139,63,76
050,51,570,"Virginia","Colonial Heights city",2,77,143,70,73
050,51,570,"Virginia","Colonial Heights city",2,78,122,51,71
050,51,570,"Virginia","Colonial Heights city",2,79,116,48,68
050,51,570,"Virginia","Colonial Heights city",2,80,103,39,64
050,51,570,"Virginia","Colonial Heights city",2,81,97,38,59
050,51,570,"Virginia","Colonial Heights city",2,82,95,34,61
050,51,570,"Virginia","Colonial Heights city",2,83,88,30,58
050,51,570,"Virginia","Colonial Heights city",2,84,78,26,52
050,51,570,"Virginia","Colonial Heights city",2,85,490,156,334
050,51,570,"Virginia","Colonial Heights city",3,0,262,131,131
050,51,570,"Virginia","Colonial Heights city",3,1,252,130,122
050,51,570,"Virginia","Colonial Heights city",3,2,230,120,110
050,51,570,"Virginia","Colonial Heights city",3,3,225,108,117
050,51,570,"Virginia","Colonial Heights city",3,4,243,122,121
050,51,570,"Virginia","Colonial Heights city",3,5,222,110,112
050,51,570,"Virginia","Colonial Heights city",3,6,222,112,110
050,51,570,"Virginia","Colonial Heights city",3,7,248,125,123
050,51,570,"Virginia","Colonial Heights city",3,8,247,131,116
050,51,570,"Virginia","Colonial Heights city",3,9,222,118,104
050,51,570,"Virginia","Colonial Heights city",3,10,217,110,107
050,51,570,"Virginia","Colonial Heights city",3,11,254,128,126
050,51,570,"Virginia","Colonial Heights city",3,12,264,139,125
050,51,570,"Virginia","Colonial Heights city",3,13,265,137,128
050,51,570,"Virginia","Colonial Heights city",3,14,247,124,123
050,51,570,"Virginia","Colonial Heights city",3,15,259,128,131
050,51,570,"Virginia","Colonial Heights city",3,16,267,132,135
050,51,570,"Virginia","Colonial Heights city",3,17,237,113,124
050,51,570,"Virginia","Colonial Heights city",3,18,205,103,102
050,51,570,"Virginia","Colonial Heights city",3,19,179,88,91
050,51,570,"Virginia","Colonial Heights city",3,20,187,94,93
050,51,570,"Virginia","Colonial Heights city",3,21,194,103,91
050,51,570,"Virginia","Colonial Heights city",3,22,207,95,112
050,51,570,"Virginia","Colonial Heights city",3,23,196,91,105
050,51,570,"Virginia","Colonial Heights city",3,24,191,97,94
050,51,570,"Virginia","Colonial Heights city",3,25,211,107,104
050,51,570,"Virginia","Colonial Heights city",3,26,243,121,122
050,51,570,"Virginia","Colonial Heights city",3,27,240,113,127
050,51,570,"Virginia","Colonial Heights city",3,28,249,134,115
050,51,570,"Virginia","Colonial Heights city",3,29,240,129,111
050,51,570,"Virginia","Colonial Heights city",3,30,251,131,120
050,51,570,"Virginia","Colonial Heights city",3,31,266,146,120
050,51,570,"Virginia","Colonial Heights city",3,32,268,128,140
050,51,570,"Virginia","Colonial Heights city",3,33,238,106,132
050,51,570,"Virginia","Colonial Heights city",3,34,230,108,122
050,51,570,"Virginia","Colonial Heights city",3,35,233,95,138
050,51,570,"Virginia","Colonial Heights city",3,36,219,98,121
050,51,570,"Virginia","Colonial Heights city",3,37,202,81,121
050,51,570,"Virginia","Colonial Heights city",3,38,209,91,118
050,51,570,"Virginia","Colonial Heights city",3,39,233,111,122
050,51,570,"Virginia","Colonial Heights city",3,40,210,91,119
050,51,570,"Virginia","Colonial Heights city",3,41,225,98,127
050,51,570,"Virginia","Colonial Heights city",3,42,216,112,104
050,51,570,"Virginia","Colonial Heights city",3,43,186,84,102
050,51,570,"Virginia","Colonial Heights city",3,44,190,86,104
050,51,570,"Virginia","Colonial Heights city",3,45,195,81,114
050,51,570,"Virginia","Colonial Heights city",3,46,191,83,108
050,51,570,"Virginia","Colonial Heights city",3,47,194,100,94
050,51,570,"Virginia","Colonial Heights city",3,48,211,102,109
050,51,570,"Virginia","Colonial Heights city",3,49,241,117,124
050,51,570,"Virginia","Colonial Heights city",3,50,227,112,115
050,51,570,"Virginia","Colonial Heights city",3,51,225,90,135
050,51,570,"Virginia","Colonial Heights city",3,52,218,88,130
050,51,570,"Virginia","Colonial Heights city",3,53,228,89,139
050,51,570,"Virginia","Colonial Heights city",3,54,211,92,119
050,51,570,"Virginia","Colonial Heights city",3,55,215,101,114
050,51,570,"Virginia","Colonial Heights city",3,56,244,117,127
050,51,570,"Virginia","Colonial Heights city",3,57,238,122,116
050,51,570,"Virginia","Colonial Heights city",3,58,230,120,110
050,51,570,"Virginia","Colonial Heights city",3,59,245,121,124
050,51,570,"Virginia","Colonial Heights city",3,60,275,133,142
050,51,570,"Virginia","Colonial Heights city",3,61,253,113,140
050,51,570,"Virginia","Colonial Heights city",3,62,243,108,135
050,51,570,"Virginia","Colonial Heights city",3,63,223,104,119
050,51,570,"Virginia","Colonial Heights city",3,64,204,94,110
050,51,570,"Virginia","Colonial Heights city",3,65,200,88,112
050,51,570,"Virginia","Colonial Heights city",3,66,197,93,104
050,51,570,"Virginia","Colonial Heights city",3,67,187,84,103
050,51,570,"Virginia","Colonial Heights city",3,68,179,64,115
050,51,570,"Virginia","Colonial Heights city",3,69,171,65,106
050,51,570,"Virginia","Colonial Heights city",3,70,158,65,93
050,51,570,"Virginia","Colonial Heights city",3,71,157,61,96
050,51,570,"Virginia","Colonial Heights city",3,72,174,69,105
050,51,570,"Virginia","Colonial Heights city",3,73,192,79,113
050,51,570,"Virginia","Colonial Heights city",3,74,200,82,118
050,51,570,"Virginia","Colonial Heights city",3,75,143,64,79
050,51,570,"Virginia","Colonial Heights city",3,76,141,59,82
050,51,570,"Virginia","Colonial Heights city",3,77,129,59,70
050,51,570,"Virginia","Colonial Heights city",3,78,133,64,69
050,51,570,"Virginia","Colonial Heights city",3,79,127,53,74
050,51,570,"Virginia","Colonial Heights city",3,80,102,43,59
050,51,570,"Virginia","Colonial Heights city",3,81,91,31,60
050,51,570,"Virginia","Colonial Heights city",3,82,86,31,55
050,51,570,"Virginia","Colonial Heights city",3,83,83,30,53
050,51,570,"Virginia","Colonial Heights city",3,84,75,27,48
050,51,570,"Virginia","Colonial Heights city",3,85,488,155,333
050,51,570,"Virginia","Colonial Heights city",4,0,272,146,126
050,51,570,"Virginia","Colonial Heights city",4,1,261,131,130
050,51,570,"Virginia","Colonial Heights city",4,2,233,123,110
050,51,570,"Virginia","Colonial Heights city",4,3,233,125,108
050,51,570,"Virginia","Colonial Heights city",4,4,241,112,129
050,51,570,"Virginia","Colonial Heights city",4,5,251,126,125
050,51,570,"Virginia","Colonial Heights city",4,6,237,113,124
050,51,570,"Virginia","Colonial Heights city",4,7,222,111,111
050,51,570,"Virginia","Colonial Heights city",4,8,273,133,140
050,51,570,"Virginia","Colonial Heights city",4,9,253,135,118
050,51,570,"Virginia","Colonial Heights city",4,10,224,124,100
050,51,570,"Virginia","Colonial Heights city",4,11,233,124,109
050,51,570,"Virginia","Colonial Heights city",4,12,261,124,137
050,51,570,"Virginia","Colonial Heights city",4,13,268,140,128
050,51,570,"Virginia","Colonial Heights city",4,14,268,131,137
050,51,570,"Virginia","Colonial Heights city",4,15,258,121,137
050,51,570,"Virginia","Colonial Heights city",4,16,258,132,126
050,51,570,"Virginia","Colonial Heights city",4,17,260,121,139
050,51,570,"Virginia","Colonial Heights city",4,18,203,98,105
050,51,570,"Virginia","Colonial Heights city",4,19,166,86,80
050,51,570,"Virginia","Colonial Heights city",4,20,177,88,89
050,51,570,"Virginia","Colonial Heights city",4,21,195,97,98
050,51,570,"Virginia","Colonial Heights city",4,22,206,110,96
050,51,570,"Virginia","Colonial Heights city",4,23,214,98,116
050,51,570,"Virginia","Colonial Heights city",4,24,182,84,98
050,51,570,"Virginia","Colonial Heights city",4,25,185,91,94
050,51,570,"Virginia","Colonial Heights city",4,26,220,108,112
050,51,570,"Virginia","Colonial Heights city",4,27,261,135,126
050,51,570,"Virginia","Colonial Heights city",4,28,248,111,137
050,51,570,"Virginia","Colonial Heights city",4,29,230,119,111
050,51,570,"Virginia","Colonial Heights city",4,30,230,130,100
050,51,570,"Virginia","Colonial Heights city",4,31,268,134,134
050,51,570,"Virginia","Colonial Heights city",4,32,268,150,118
050,51,570,"Virginia","Colonial Heights city",4,33,288,142,146
050,51,570,"Virginia","Colonial Heights city",4,34,248,124,124
050,51,570,"Virginia","Colonial Heights city",4,35,219,102,117
050,51,570,"Virginia","Colonial Heights city",4,36,242,106,136
050,51,570,"Virginia","Colonial Heights city",4,37,224,99,125
050,51,570,"Virginia","Colonial Heights city",4,38,202,83,119
050,51,570,"Virginia","Colonial Heights city",4,39,212,94,118
050,51,570,"Virginia","Colonial Heights city",4,40,231,106,125
050,51,570,"Virginia","Colonial Heights city",4,41,216,93,123
050,51,570,"Virginia","Colonial Heights city",4,42,219,98,121
050,51,570,"Virginia","Colonial Heights city",4,43,230,118,112
050,51,570,"Virginia","Colonial Heights city",4,44,200,86,114
050,51,570,"Virginia","Colonial Heights city",4,45,183,87,96
050,51,570,"Virginia","Colonial Heights city",4,46,198,80,118
050,51,570,"Virginia","Colonial Heights city",4,47,188,82,106
050,51,570,"Virginia","Colonial Heights city",4,48,201,101,100
050,51,570,"Virginia","Colonial Heights city",4,49,214,98,116
050,51,570,"Virginia","Colonial Heights city",4,50,222,103,119
050,51,570,"Virginia","Colonial Heights city",4,51,230,111,119
050,51,570,"Virginia","Colonial Heights city",4,52,226,92,134
050,51,570,"Virginia","Colonial Heights city",4,53,227,95,132
050,51,570,"Virginia","Colonial Heights city",4,54,221,83,138
050,51,570,"Virginia","Colonial Heights city",4,55,205,86,119
050,51,570,"Virginia","Colonial Heights city",4,56,210,97,113
050,51,570,"Virginia","Colonial Heights city",4,57,243,117,126
050,51,570,"Virginia","Colonial Heights city",4,58,245,123,122
050,51,570,"Virginia","Colonial Heights city",4,59,235,125,110
050,51,570,"Virginia","Colonial Heights city",4,60,238,119,119
050,51,570,"Virginia","Colonial Heights city",4,61,264,133,131
050,51,570,"Virginia","Colonial Heights city",4,62,248,110,138
050,51,570,"Virginia","Colonial Heights city",4,63,238,105,133
050,51,570,"Virginia","Colonial Heights city",4,64,214,104,110
050,51,570,"Virginia","Colonial Heights city",4,65,202,89,113
050,51,570,"Virginia","Colonial Heights city",4,66,188,81,107
050,51,570,"Virginia","Colonial Heights city",4,67,189,91,98
050,51,570,"Virginia","Colonial Heights city",4,68,170,75,95
050,51,570,"Virginia","Colonial Heights city",4,69,168,63,105
050,51,570,"Virginia","Colonial Heights city",4,70,166,63,103
050,51,570,"Virginia","Colonial Heights city",4,71,148,58,90
050,51,570,"Virginia","Colonial Heights city",4,72,161,61,100
050,51,570,"Virginia","Colonial Heights city",4,73,161,60,101
050,51,570,"Virginia","Colonial Heights city",4,74,181,73,108
050,51,570,"Virginia","Colonial Heights city",4,75,190,82,108
050,51,570,"Virginia","Colonial Heights city",4,76,133,58,75
050,51,570,"Virginia","Colonial Heights city",4,77,130,51,79
050,51,570,"Virginia","Colonial Heights city",4,78,121,54,67
050,51,570,"Virginia","Colonial Heights city",4,79,132,66,66
050,51,570,"Virginia","Colonial Heights city",4,80,116,46,70
050,51,570,"Virginia","Colonial Heights city",4,81,81,33,48
050,51,570,"Virginia","Colonial Heights city",4,82,84,24,60
050,51,570,"Virginia","Colonial Heights city",4,83,78,28,50
050,51,570,"Virginia","Colonial Heights city",4,84,67,26,41
050,51,570,"Virginia","Colonial Heights city",4,85,472,149,323
050,51,570,"Virginia","Colonial Heights city",5,0,272,145,127
050,51,570,"Virginia","Colonial Heights city",5,1,261,137,124
050,51,570,"Virginia","Colonial Heights city",5,2,251,122,129
050,51,570,"Virginia","Colonial Heights city",5,3,240,124,116
050,51,570,"Virginia","Colonial Heights city",5,4,220,115,105
050,51,570,"Virginia","Colonial Heights city",5,5,247,123,124
050,51,570,"Virginia","Colonial Heights city",5,6,263,128,135
050,51,570,"Virginia","Colonial Heights city",5,7,246,125,121
050,51,570,"Virginia","Colonial Heights city",5,8,237,118,119
050,51,570,"Virginia","Colonial Heights city",5,9,279,134,145
050,51,570,"Virginia","Colonial Heights city",5,10,263,140,123
050,51,570,"Virginia","Colonial Heights city",5,11,240,128,112
050,51,570,"Virginia","Colonial Heights city",5,12,235,133,102
050,51,570,"Virginia","Colonial Heights city",5,13,257,123,134
050,51,570,"Virginia","Colonial Heights city",5,14,278,150,128
050,51,570,"Virginia","Colonial Heights city",5,15,288,139,149
050,51,570,"Virginia","Colonial Heights city",5,16,271,134,137
050,51,570,"Virginia","Colonial Heights city",5,17,249,124,125
050,51,570,"Virginia","Colonial Heights city",5,18,222,107,115
050,51,570,"Virginia","Colonial Heights city",5,19,164,83,81
050,51,570,"Virginia","Colonial Heights city",5,20,174,89,85
050,51,570,"Virginia","Colonial Heights city",5,21,185,90,95
050,51,570,"Virginia","Colonial Heights city",5,22,213,107,106
050,51,570,"Virginia","Colonial Heights city",5,23,233,129,104
050,51,570,"Virginia","Colonial Heights city",5,24,221,100,121
050,51,570,"Virginia","Colonial Heights city",5,25,197,91,106
050,51,570,"Virginia","Colonial Heights city",5,26,168,82,86
050,51,570,"Virginia","Colonial Heights city",5,27,251,128,123
050,51,570,"Virginia","Colonial Heights city",5,28,257,130,127
050,51,570,"Virginia","Colonial Heights city",5,29,258,123,135
050,51,570,"Virginia","Colonial Heights city",5,30,240,115,125
050,51,570,"Virginia","Colonial Heights city",5,31,253,132,121
050,51,570,"Virginia","Colonial Heights city",5,32,254,128,126
050,51,570,"Virginia","Colonial Heights city",5,33,273,149,124
050,51,570,"Virginia","Colonial Heights city",5,34,288,143,145
050,51,570,"Virginia","Colonial Heights city",5,35,250,125,125
050,51,570,"Virginia","Colonial Heights city",5,36,245,120,125
050,51,570,"Virginia","Colonial Heights city",5,37,241,103,138
050,51,570,"Virginia","Colonial Heights city",5,38,221,97,124
050,51,570,"Virginia","Colonial Heights city",5,39,202,89,113
050,51,570,"Virginia","Colonial Heights city",5,40,217,94,123
050,51,570,"Virginia","Colonial Heights city",5,41,215,96,119
050,51,570,"Virginia","Colonial Heights city",5,42,224,92,132
050,51,570,"Virginia","Colonial Heights city",5,43,211,98,113
050,51,570,"Virginia","Colonial Heights city",5,44,226,119,107
050,51,570,"Virginia","Colonial Heights city",5,45,203,93,110
050,51,570,"Virginia","Colonial Heights city",5,46,181,83,98
050,51,570,"Virginia","Colonial Heights city",5,47,190,77,113
050,51,570,"Virginia","Colonial Heights city",5,48,192,84,108
050,51,570,"Virginia","Colonial Heights city",5,49,206,102,104
050,51,570,"Virginia","Colonial Heights city",5,50,205,96,109
050,51,570,"Virginia","Colonial Heights city",5,51,226,102,124
050,51,570,"Virginia","Colonial Heights city",5,52,233,101,132
050,51,570,"Virginia","Colonial Heights city",5,53,243,101,142
050,51,570,"Virginia","Colonial Heights city",5,54,237,109,128
050,51,570,"Virginia","Colonial Heights city",5,55,225,88,137
050,51,570,"Virginia","Colonial Heights city",5,56,201,83,118
050,51,570,"Virginia","Colonial Heights city",5,57,216,99,117
050,51,570,"Virginia","Colonial Heights city",5,58,231,113,118
050,51,570,"Virginia","Colonial Heights city",5,59,236,114,122
050,51,570,"Virginia","Colonial Heights city",5,60,231,122,109
050,51,570,"Virginia","Colonial Heights city",5,61,244,122,122
050,51,570,"Virginia","Colonial Heights city",5,62,253,124,129
050,51,570,"Virginia","Colonial Heights city",5,63,240,109,131
050,51,570,"Virginia","Colonial Heights city",5,64,232,102,130
050,51,570,"Virginia","Colonial Heights city",5,65,212,103,109
050,51,570,"Virginia","Colonial Heights city",5,66,184,77,107
050,51,570,"Virginia","Colonial Heights city",5,67,181,78,103
050,51,570,"Virginia","Colonial Heights city",5,68,178,84,94
050,51,570,"Virginia","Colonial Heights city",5,69,166,79,87
050,51,570,"Virginia","Colonial Heights city",5,70,156,59,97
050,51,570,"Virginia","Colonial Heights city",5,71,154,56,98
050,51,570,"Virginia","Colonial Heights city",5,72,137,55,82
050,51,570,"Virginia","Colonial Heights city",5,73,153,56,97
050,51,570,"Virginia","Colonial Heights city",5,74,151,55,96
050,51,570,"Virginia","Colonial Heights city",5,75,167,67,100
050,51,570,"Virginia","Colonial Heights city",5,76,177,77,100
050,51,570,"Virginia","Colonial Heights city",5,77,125,54,71
050,51,570,"Virginia","Colonial Heights city",5,78,126,46,80
050,51,570,"Virginia","Colonial Heights city",5,79,119,55,64
050,51,570,"Virginia","Colonial Heights city",5,80,118,59,59
050,51,570,"Virginia","Colonial Heights city",5,81,102,39,63
050,51,570,"Virginia","Colonial Heights city",5,82,67,25,42
050,51,570,"Virginia","Colonial Heights city",5,83,77,21,56
050,51,570,"Virginia","Colonial Heights city",5,84,66,26,40
050,51,570,"Virginia","Colonial Heights city",5,85,452,145,307
050,51,580,"Virginia","Covington city",1,0,82,42,40
050,51,580,"Virginia","Covington city",1,1,80,38,42
050,51,580,"Virginia","Covington city",1,2,72,28,44
050,51,580,"Virginia","Covington city",1,3,89,37,52
050,51,580,"Virginia","Covington city",1,4,84,24,60
050,51,580,"Virginia","Covington city",1,5,49,23,26
050,51,580,"Virginia","Covington city",1,6,64,35,29
050,51,580,"Virginia","Covington city",1,7,65,37,28
050,51,580,"Virginia","Covington city",1,8,80,37,43
050,51,580,"Virginia","Covington city",1,9,75,46,29
050,51,580,"Virginia","Covington city",1,10,67,35,32
050,51,580,"Virginia","Covington city",1,11,71,38,33
050,51,580,"Virginia","Covington city",1,12,71,37,34
050,51,580,"Virginia","Covington city",1,13,71,40,31
050,51,580,"Virginia","Covington city",1,14,70,39,31
050,51,580,"Virginia","Covington city",1,15,76,38,38
050,51,580,"Virginia","Covington city",1,16,77,37,40
050,51,580,"Virginia","Covington city",1,17,69,39,30
050,51,580,"Virginia","Covington city",1,18,66,34,32
050,51,580,"Virginia","Covington city",1,19,54,24,30
050,51,580,"Virginia","Covington city",1,20,63,26,37
050,51,580,"Virginia","Covington city",1,21,64,31,33
050,51,580,"Virginia","Covington city",1,22,52,24,28
050,51,580,"Virginia","Covington city",1,23,63,31,32
050,51,580,"Virginia","Covington city",1,24,76,43,33
050,51,580,"Virginia","Covington city",1,25,73,37,36
050,51,580,"Virginia","Covington city",1,26,72,37,35
050,51,580,"Virginia","Covington city",1,27,63,33,30
050,51,580,"Virginia","Covington city",1,28,76,40,36
050,51,580,"Virginia","Covington city",1,29,78,48,30
050,51,580,"Virginia","Covington city",1,30,69,36,33
050,51,580,"Virginia","Covington city",1,31,62,30,32
050,51,580,"Virginia","Covington city",1,32,68,32,36
050,51,580,"Virginia","Covington city",1,33,68,37,31
050,51,580,"Virginia","Covington city",1,34,61,33,28
050,51,580,"Virginia","Covington city",1,35,66,34,32
050,51,580,"Virginia","Covington city",1,36,69,33,36
050,51,580,"Virginia","Covington city",1,37,55,26,29
050,51,580,"Virginia","Covington city",1,38,56,27,29
050,51,580,"Virginia","Covington city",1,39,65,26,39
050,51,580,"Virginia","Covington city",1,40,60,25,35
050,51,580,"Virginia","Covington city",1,41,57,29,28
050,51,580,"Virginia","Covington city",1,42,62,29,33
050,51,580,"Virginia","Covington city",1,43,66,33,33
050,51,580,"Virginia","Covington city",1,44,59,31,28
050,51,580,"Virginia","Covington city",1,45,69,39,30
050,51,580,"Virginia","Covington city",1,46,56,31,25
050,51,580,"Virginia","Covington city",1,47,66,35,31
050,51,580,"Virginia","Covington city",1,48,78,33,45
050,51,580,"Virginia","Covington city",1,49,74,35,39
050,51,580,"Virginia","Covington city",1,50,74,42,32
050,51,580,"Virginia","Covington city",1,51,74,46,28
050,51,580,"Virginia","Covington city",1,52,77,44,33
050,51,580,"Virginia","Covington city",1,53,85,35,50
050,51,580,"Virginia","Covington city",1,54,77,31,46
050,51,580,"Virginia","Covington city",1,55,73,35,38
050,51,580,"Virginia","Covington city",1,56,92,48,44
050,51,580,"Virginia","Covington city",1,57,93,43,50
050,51,580,"Virginia","Covington city",1,58,83,41,42
050,51,580,"Virginia","Covington city",1,59,83,48,35
050,51,580,"Virginia","Covington city",1,60,92,48,44
050,51,580,"Virginia","Covington city",1,61,94,44,50
050,51,580,"Virginia","Covington city",1,62,86,38,48
050,51,580,"Virginia","Covington city",1,63,74,39,35
050,51,580,"Virginia","Covington city",1,64,72,38,34
050,51,580,"Virginia","Covington city",1,65,81,46,35
050,51,580,"Virginia","Covington city",1,66,66,35,31
050,51,580,"Virginia","Covington city",1,67,62,36,26
050,51,580,"Virginia","Covington city",1,68,57,28,29
050,51,580,"Virginia","Covington city",1,69,60,24,36
050,51,580,"Virginia","Covington city",1,70,59,25,34
050,51,580,"Virginia","Covington city",1,71,69,34,35
050,51,580,"Virginia","Covington city",1,72,73,32,41
050,51,580,"Virginia","Covington city",1,73,74,28,46
050,51,580,"Virginia","Covington city",1,74,58,24,34
050,51,580,"Virginia","Covington city",1,75,57,23,34
050,51,580,"Virginia","Covington city",1,76,47,18,29
050,51,580,"Virginia","Covington city",1,77,50,24,26
050,51,580,"Virginia","Covington city",1,78,47,24,23
050,51,580,"Virginia","Covington city",1,79,31,9,22
050,51,580,"Virginia","Covington city",1,80,34,10,24
050,51,580,"Virginia","Covington city",1,81,27,6,21
050,51,580,"Virginia","Covington city",1,82,23,7,16
050,51,580,"Virginia","Covington city",1,83,19,5,14
050,51,580,"Virginia","Covington city",1,84,26,11,15
050,51,580,"Virginia","Covington city",1,85,100,21,79
050,51,580,"Virginia","Covington city",2,0,82,45,37
050,51,580,"Virginia","Covington city",2,1,79,38,41
050,51,580,"Virginia","Covington city",2,2,73,30,43
050,51,580,"Virginia","Covington city",2,3,84,35,49
050,51,580,"Virginia","Covington city",2,4,85,27,58
050,51,580,"Virginia","Covington city",2,5,58,24,34
050,51,580,"Virginia","Covington city",2,6,63,34,29
050,51,580,"Virginia","Covington city",2,7,67,37,30
050,51,580,"Virginia","Covington city",2,8,78,37,41
050,51,580,"Virginia","Covington city",2,9,76,44,32
050,51,580,"Virginia","Covington city",2,10,70,38,32
050,51,580,"Virginia","Covington city",2,11,68,36,32
050,51,580,"Virginia","Covington city",2,12,72,38,34
050,51,580,"Virginia","Covington city",2,13,70,39,31
050,51,580,"Virginia","Covington city",2,14,69,39,30
050,51,580,"Virginia","Covington city",2,15,75,39,36
050,51,580,"Virginia","Covington city",2,16,77,37,40
050,51,580,"Virginia","Covington city",2,17,69,38,31
050,51,580,"Virginia","Covington city",2,18,65,35,30
050,51,580,"Virginia","Covington city",2,19,56,26,30
050,51,580,"Virginia","Covington city",2,20,64,27,37
050,51,580,"Virginia","Covington city",2,21,65,31,34
050,51,580,"Virginia","Covington city",2,22,54,25,29
050,51,580,"Virginia","Covington city",2,23,64,32,32
050,51,580,"Virginia","Covington city",2,24,71,39,32
050,51,580,"Virginia","Covington city",2,25,72,38,34
050,51,580,"Virginia","Covington city",2,26,73,37,36
050,51,580,"Virginia","Covington city",2,27,67,35,32
050,51,580,"Virginia","Covington city",2,28,72,39,33
050,51,580,"Virginia","Covington city",2,29,77,45,32
050,51,580,"Virginia","Covington city",2,30,73,39,34
050,51,580,"Virginia","Covington city",2,31,62,31,31
050,51,580,"Virginia","Covington city",2,32,65,31,34
050,51,580,"Virginia","Covington city",2,33,68,36,32
050,51,580,"Virginia","Covington city",2,34,61,33,28
050,51,580,"Virginia","Covington city",2,35,65,34,31
050,51,580,"Virginia","Covington city",2,36,67,32,35
050,51,580,"Virginia","Covington city",2,37,58,28,30
050,51,580,"Virginia","Covington city",2,38,55,27,28
050,51,580,"Virginia","Covington city",2,39,63,26,37
050,51,580,"Virginia","Covington city",2,40,61,25,36
050,51,580,"Virginia","Covington city",2,41,57,27,30
050,51,580,"Virginia","Covington city",2,42,61,29,32
050,51,580,"Virginia","Covington city",2,43,66,32,34
050,51,580,"Virginia","Covington city",2,44,59,31,28
050,51,580,"Virginia","Covington city",2,45,68,38,30
050,51,580,"Virginia","Covington city",2,46,59,33,26
050,51,580,"Virginia","Covington city",2,47,65,35,30
050,51,580,"Virginia","Covington city",2,48,76,34,42
050,51,580,"Virginia","Covington city",2,49,75,34,41
050,51,580,"Virginia","Covington city",2,50,74,40,34
050,51,580,"Virginia","Covington city",2,51,74,45,29
050,51,580,"Virginia","Covington city",2,52,76,44,32
050,51,580,"Virginia","Covington city",2,53,83,36,47
050,51,580,"Virginia","Covington city",2,54,81,33,48
050,51,580,"Virginia","Covington city",2,55,73,33,40
050,51,580,"Virginia","Covington city",2,56,87,45,42
050,51,580,"Virginia","Covington city",2,57,93,45,48
050,51,580,"Virginia","Covington city",2,58,84,40,44
050,51,580,"Virginia","Covington city",2,59,84,47,37
050,51,580,"Virginia","Covington city",2,60,89,47,42
050,51,580,"Virginia","Covington city",2,61,93,45,48
050,51,580,"Virginia","Covington city",2,62,88,40,48
050,51,580,"Virginia","Covington city",2,63,76,38,38
050,51,580,"Virginia","Covington city",2,64,71,37,34
050,51,580,"Virginia","Covington city",2,65,78,44,34
050,51,580,"Virginia","Covington city",2,66,71,38,33
050,51,580,"Virginia","Covington city",2,67,64,36,28
050,51,580,"Virginia","Covington city",2,68,56,29,27
050,51,580,"Virginia","Covington city",2,69,59,24,35
050,51,580,"Virginia","Covington city",2,70,58,24,34
050,51,580,"Virginia","Covington city",2,71,67,32,35
050,51,580,"Virginia","Covington city",2,72,72,33,39
050,51,580,"Virginia","Covington city",2,73,76,30,46
050,51,580,"Virginia","Covington city",2,74,57,23,34
050,51,580,"Virginia","Covington city",2,75,57,23,34
050,51,580,"Virginia","Covington city",2,76,47,19,28
050,51,580,"Virginia","Covington city",2,77,50,22,28
050,51,580,"Virginia","Covington city",2,78,46,23,23
050,51,580,"Virginia","Covington city",2,79,36,13,23
050,51,580,"Virginia","Covington city",2,80,34,10,24
050,51,580,"Virginia","Covington city",2,81,27,5,22
050,51,580,"Virginia","Covington city",2,82,24,7,17
050,51,580,"Virginia","Covington city",2,83,18,5,13
050,51,580,"Virginia","Covington city",2,84,24,9,15
050,51,580,"Virginia","Covington city",2,85,99,21,78
050,51,580,"Virginia","Covington city",3,0,88,45,43
050,51,580,"Virginia","Covington city",3,1,73,40,33
050,51,580,"Virginia","Covington city",3,2,74,37,37
050,51,580,"Virginia","Covington city",3,3,74,30,44
050,51,580,"Virginia","Covington city",3,4,85,37,48
050,51,580,"Virginia","Covington city",3,5,84,30,54
050,51,580,"Virginia","Covington city",3,6,61,24,37
050,51,580,"Virginia","Covington city",3,7,64,34,30
050,51,580,"Virginia","Covington city",3,8,67,35,32
050,51,580,"Virginia","Covington city",3,9,79,40,39
050,51,580,"Virginia","Covington city",3,10,75,45,30
050,51,580,"Virginia","Covington city",3,11,73,38,35
050,51,580,"Virginia","Covington city",3,12,73,40,33
050,51,580,"Virginia","Covington city",3,13,78,42,36
050,51,580,"Virginia","Covington city",3,14,70,38,32
050,51,580,"Virginia","Covington city",3,15,74,41,33
050,51,580,"Virginia","Covington city",3,16,72,36,36
050,51,580,"Virginia","Covington city",3,17,74,36,38
050,51,580,"Virginia","Covington city",3,18,61,39,22
050,51,580,"Virginia","Covington city",3,19,45,26,19
050,51,580,"Virginia","Covington city",3,20,63,29,34
050,51,580,"Virginia","Covington city",3,21,69,30,39
050,51,580,"Virginia","Covington city",3,22,69,32,37
050,51,580,"Virginia","Covington city",3,23,54,29,25
050,51,580,"Virginia","Covington city",3,24,67,35,32
050,51,580,"Virginia","Covington city",3,25,75,40,35
050,51,580,"Virginia","Covington city",3,26,75,36,39
050,51,580,"Virginia","Covington city",3,27,76,34,42
050,51,580,"Virginia","Covington city",3,28,65,37,28
050,51,580,"Virginia","Covington city",3,29,68,34,34
050,51,580,"Virginia","Covington city",3,30,90,53,37
050,51,580,"Virginia","Covington city",3,31,70,38,32
050,51,580,"Virginia","Covington city",3,32,67,34,33
050,51,580,"Virginia","Covington city",3,33,66,34,32
050,51,580,"Virginia","Covington city",3,34,71,34,37
050,51,580,"Virginia","Covington city",3,35,60,32,28
050,51,580,"Virginia","Covington city",3,36,67,36,31
050,51,580,"Virginia","Covington city",3,37,69,30,39
050,51,580,"Virginia","Covington city",3,38,60,29,31
050,51,580,"Virginia","Covington city",3,39,55,27,28
050,51,580,"Virginia","Covington city",3,40,58,26,32
050,51,580,"Virginia","Covington city",3,41,58,21,37
050,51,580,"Virginia","Covington city",3,42,55,25,30
050,51,580,"Virginia","Covington city",3,43,60,29,31
050,51,580,"Virginia","Covington city",3,44,66,32,34
050,51,580,"Virginia","Covington city",3,45,53,26,27
050,51,580,"Virginia","Covington city",3,46,61,31,30
050,51,580,"Virginia","Covington city",3,47,64,36,28
050,51,580,"Virginia","Covington city",3,48,68,38,30
050,51,580,"Virginia","Covington city",3,49,72,30,42
050,51,580,"Virginia","Covington city",3,50,73,34,39
050,51,580,"Virginia","Covington city",3,51,76,39,37
050,51,580,"Virginia","Covington city",3,52,70,44,26
050,51,580,"Virginia","Covington city",3,53,79,48,31
050,51,580,"Virginia","Covington city",3,54,84,37,47
050,51,580,"Virginia","Covington city",3,55,77,31,46
050,51,580,"Virginia","Covington city",3,56,70,31,39
050,51,580,"Virginia","Covington city",3,57,82,44,38
050,51,580,"Virginia","Covington city",3,58,91,44,47
050,51,580,"Virginia","Covington city",3,59,86,40,46
050,51,580,"Virginia","Covington city",3,60,81,46,35
050,51,580,"Virginia","Covington city",3,61,86,45,41
050,51,580,"Virginia","Covington city",3,62,90,43,47
050,51,580,"Virginia","Covington city",3,63,88,40,48
050,51,580,"Virginia","Covington city",3,64,71,35,36
050,51,580,"Virginia","Covington city",3,65,65,33,32
050,51,580,"Virginia","Covington city",3,66,76,42,34
050,51,580,"Virginia","Covington city",3,67,68,37,31
050,51,580,"Virginia","Covington city",3,68,62,35,27
050,51,580,"Virginia","Covington city",3,69,52,27,25
050,51,580,"Virginia","Covington city",3,70,54,21,33
050,51,580,"Virginia","Covington city",3,71,55,22,33
050,51,580,"Virginia","Covington city",3,72,64,31,33
050,51,580,"Virginia","Covington city",3,73,65,32,33
050,51,580,"Virginia","Covington city",3,74,72,28,44
050,51,580,"Virginia","Covington city",3,75,56,22,34
050,51,580,"Virginia","Covington city",3,76,53,21,32
050,51,580,"Virginia","Covington city",3,77,45,19,26
050,51,580,"Virginia","Covington city",3,78,45,19,26
050,51,580,"Virginia","Covington city",3,79,39,20,19
050,51,580,"Virginia","Covington city",3,80,32,9,23
050,51,580,"Virginia","Covington city",3,81,31,9,22
050,51,580,"Virginia","Covington city",3,82,25,5,20
050,51,580,"Virginia","Covington city",3,83,20,7,13
050,51,580,"Virginia","Covington city",3,84,17,5,12
050,51,580,"Virginia","Covington city",3,85,101,25,76
050,51,580,"Virginia","Covington city",4,0,72,33,39
050,51,580,"Virginia","Covington city",4,1,83,43,40
050,51,580,"Virginia","Covington city",4,2,72,41,31
050,51,580,"Virginia","Covington city",4,3,67,32,35
050,51,580,"Virginia","Covington city",4,4,78,34,44
050,51,580,"Virginia","Covington city",4,5,70,33,37
050,51,580,"Virginia","Covington city",4,6,81,34,47
050,51,580,"Virginia","Covington city",4,7,68,26,42
050,51,580,"Virginia","Covington city",4,8,68,34,34
050,51,580,"Virginia","Covington city",4,9,68,36,32
050,51,580,"Virginia","Covington city",4,10,86,44,42
050,51,580,"Virginia","Covington city",4,11,75,46,29
050,51,580,"Virginia","Covington city",4,12,72,33,39
050,51,580,"Virginia","Covington city",4,13,72,40,32
050,51,580,"Virginia","Covington city",4,14,82,46,36
050,51,580,"Virginia","Covington city",4,15,65,37,28
050,51,580,"Virginia","Covington city",4,16,70,35,35
050,51,580,"Virginia","Covington city",4,17,67,34,33
050,51,580,"Virginia","Covington city",4,18,64,35,29
050,51,580,"Virginia","Covington city",4,19,47,28,19
050,51,580,"Virginia","Covington city",4,20,50,25,25
050,51,580,"Virginia","Covington city",4,21,71,35,36
050,51,580,"Virginia","Covington city",4,22,73,31,42
050,51,580,"Virginia","Covington city",4,23,75,38,37
050,51,580,"Virginia","Covington city",4,24,60,29,31
050,51,580,"Virginia","Covington city",4,25,63,34,29
050,51,580,"Virginia","Covington city",4,26,75,42,33
050,51,580,"Virginia","Covington city",4,27,75,39,36
050,51,580,"Virginia","Covington city",4,28,73,37,36
050,51,580,"Virginia","Covington city",4,29,64,32,32
050,51,580,"Virginia","Covington city",4,30,72,36,36
050,51,580,"Virginia","Covington city",4,31,86,52,34
050,51,580,"Virginia","Covington city",4,32,67,37,30
050,51,580,"Virginia","Covington city",4,33,70,35,35
050,51,580,"Virginia","Covington city",4,34,59,31,28
050,51,580,"Virginia","Covington city",4,35,72,35,37
050,51,580,"Virginia","Covington city",4,36,63,36,27
050,51,580,"Virginia","Covington city",4,37,65,36,29
050,51,580,"Virginia","Covington city",4,38,67,30,37
050,51,580,"Virginia","Covington city",4,39,56,31,25
050,51,580,"Virginia","Covington city",4,40,50,24,26
050,51,580,"Virginia","Covington city",4,41,57,27,30
050,51,580,"Virginia","Covington city",4,42,58,23,35
050,51,580,"Virginia","Covington city",4,43,53,23,30
050,51,580,"Virginia","Covington city",4,44,57,26,31
050,51,580,"Virginia","Covington city",4,45,63,28,35
050,51,580,"Virginia","Covington city",4,46,60,33,27
050,51,580,"Virginia","Covington city",4,47,58,27,31
050,51,580,"Virginia","Covington city",4,48,64,35,29
050,51,580,"Virginia","Covington city",4,49,64,34,30
050,51,580,"Virginia","Covington city",4,50,74,32,42
050,51,580,"Virginia","Covington city",4,51,71,32,39
050,51,580,"Virginia","Covington city",4,52,74,38,36
050,51,580,"Virginia","Covington city",4,53,68,43,25
050,51,580,"Virginia","Covington city",4,54,78,48,30
050,51,580,"Virginia","Covington city",4,55,78,34,44
050,51,580,"Virginia","Covington city",4,56,75,28,47
050,51,580,"Virginia","Covington city",4,57,66,29,37
050,51,580,"Virginia","Covington city",4,58,79,41,38
050,51,580,"Virginia","Covington city",4,59,89,43,46
050,51,580,"Virginia","Covington city",4,60,86,37,49
050,51,580,"Virginia","Covington city",4,61,82,44,38
050,51,580,"Virginia","Covington city",4,62,85,42,43
050,51,580,"Virginia","Covington city",4,63,87,41,46
050,51,580,"Virginia","Covington city",4,64,85,36,49
050,51,580,"Virginia","Covington city",4,65,72,34,38
050,51,580,"Virginia","Covington city",4,66,63,31,32
050,51,580,"Virginia","Covington city",4,67,71,39,32
050,51,580,"Virginia","Covington city",4,68,62,34,28
050,51,580,"Virginia","Covington city",4,69,60,35,25
050,51,580,"Virginia","Covington city",4,70,47,25,22
050,51,580,"Virginia","Covington city",4,71,48,20,28
050,51,580,"Virginia","Covington city",4,72,56,21,35
050,51,580,"Virginia","Covington city",4,73,59,30,29
050,51,580,"Virginia","Covington city",4,74,63,30,33
050,51,580,"Virginia","Covington city",4,75,70,26,44
050,51,580,"Virginia","Covington city",4,76,57,24,33
050,51,580,"Virginia","Covington city",4,77,50,19,31
050,51,580,"Virginia","Covington city",4,78,41,16,25
050,51,580,"Virginia","Covington city",4,79,40,16,24
050,51,580,"Virginia","Covington city",4,80,33,14,19
050,51,580,"Virginia","Covington city",4,81,29,7,22
050,51,580,"Virginia","Covington city",4,82,31,8,23
050,51,580,"Virginia","Covington city",4,83,20,2,18
050,51,580,"Virginia","Covington city",4,84,20,7,13
050,51,580,"Virginia","Covington city",4,85,97,23,74
050,51,580,"Virginia","Covington city",5,0,72,33,39
050,51,580,"Virginia","Covington city",5,1,69,32,37
050,51,580,"Virginia","Covington city",5,2,78,39,39
050,51,580,"Virginia","Covington city",5,3,71,40,31
050,51,580,"Virginia","Covington city",5,4,69,32,37
050,51,580,"Virginia","Covington city",5,5,78,35,43
050,51,580,"Virginia","Covington city",5,6,67,34,33
050,51,580,"Virginia","Covington city",5,7,87,36,51
050,51,580,"Virginia","Covington city",5,8,65,27,38
050,51,580,"Virginia","Covington city",5,9,63,32,31
050,51,580,"Virginia","Covington city",5,10,63,34,29
050,51,580,"Virginia","Covington city",5,11,79,38,41
050,51,580,"Virginia","Covington city",5,12,73,46,27
050,51,580,"Virginia","Covington city",5,13,73,35,38
050,51,580,"Virginia","Covington city",5,14,74,37,37
050,51,580,"Virginia","Covington city",5,15,85,48,37
050,51,580,"Virginia","Covington city",5,16,65,38,27
050,51,580,"Virginia","Covington city",5,17,73,39,34
050,51,580,"Virginia","Covington city",5,18,58,32,26
050,51,580,"Virginia","Covington city",5,19,54,29,25
050,51,580,"Virginia","Covington city",5,20,57,32,25
050,51,580,"Virginia","Covington city",5,21,60,28,32
050,51,580,"Virginia","Covington city",5,22,74,33,41
050,51,580,"Virginia","Covington city",5,23,77,34,43
050,51,580,"Virginia","Covington city",5,24,68,32,36
050,51,580,"Virginia","Covington city",5,25,56,28,28
050,51,580,"Virginia","Covington city",5,26,58,33,25
050,51,580,"Virginia","Covington city",5,27,68,38,30
050,51,580,"Virginia","Covington city",5,28,71,40,31
050,51,580,"Virginia","Covington city",5,29,63,33,30
050,51,580,"Virginia","Covington city",5,30,70,36,34
050,51,580,"Virginia","Covington city",5,31,64,31,33
050,51,580,"Virginia","Covington city",5,32,89,54,35
050,51,580,"Virginia","Covington city",5,33,61,31,30
050,51,580,"Virginia","Covington city",5,34,69,35,34
050,51,580,"Virginia","Covington city",5,35,60,31,29
050,51,580,"Virginia","Covington city",5,36,73,36,37
050,51,580,"Virginia","Covington city",5,37,58,34,24
050,51,580,"Virginia","Covington city",5,38,66,36,30
050,51,580,"Virginia","Covington city",5,39,66,31,35
050,51,580,"Virginia","Covington city",5,40,48,26,22
050,51,580,"Virginia","Covington city",5,41,49,25,24
050,51,580,"Virginia","Covington city",5,42,58,25,33
050,51,580,"Virginia","Covington city",5,43,59,21,38
050,51,580,"Virginia","Covington city",5,44,55,25,30
050,51,580,"Virginia","Covington city",5,45,58,26,32
050,51,580,"Virginia","Covington city",5,46,61,28,33
050,51,580,"Virginia","Covington city",5,47,59,31,28
050,51,580,"Virginia","Covington city",5,48,60,29,31
050,51,580,"Virginia","Covington city",5,49,66,36,30
050,51,580,"Virginia","Covington city",5,50,67,37,30
050,51,580,"Virginia","Covington city",5,51,69,30,39
050,51,580,"Virginia","Covington city",5,52,66,28,38
050,51,580,"Virginia","Covington city",5,53,70,36,34
050,51,580,"Virginia","Covington city",5,54,70,46,24
050,51,580,"Virginia","Covington city",5,55,72,48,24
050,51,580,"Virginia","Covington city",5,56,77,32,45
050,51,580,"Virginia","Covington city",5,57,72,27,45
050,51,580,"Virginia","Covington city",5,58,63,30,33
050,51,580,"Virginia","Covington city",5,59,78,41,37
050,51,580,"Virginia","Covington city",5,60,85,39,46
050,51,580,"Virginia","Covington city",5,61,86,38,48
050,51,580,"Virginia","Covington city",5,62,79,41,38
050,51,580,"Virginia","Covington city",5,63,85,41,44
050,51,580,"Virginia","Covington city",5,64,88,43,45
050,51,580,"Virginia","Covington city",5,65,84,35,49
050,51,580,"Virginia","Covington city",5,66,74,34,40
050,51,580,"Virginia","Covington city",5,67,60,30,30
050,51,580,"Virginia","Covington city",5,68,69,38,31
050,51,580,"Virginia","Covington city",5,69,60,35,25
050,51,580,"Virginia","Covington city",5,70,54,32,22
050,51,580,"Virginia","Covington city",5,71,49,26,23
050,51,580,"Virginia","Covington city",5,72,43,19,24
050,51,580,"Virginia","Covington city",5,73,51,20,31
050,51,580,"Virginia","Covington city",5,74,58,28,30
050,51,580,"Virginia","Covington city",5,75,60,29,31
050,51,580,"Virginia","Covington city",5,76,68,26,42
050,51,580,"Virginia","Covington city",5,77,52,21,31
050,51,580,"Virginia","Covington city",5,78,45,15,30
050,51,580,"Virginia","Covington city",5,79,37,14,23
050,51,580,"Virginia","Covington city",5,80,36,12,24
050,51,580,"Virginia","Covington city",5,81,32,13,19
050,51,580,"Virginia","Covington city",5,82,28,6,22
050,51,580,"Virginia","Covington city",5,83,26,6,20
050,51,580,"Virginia","Covington city",5,84,20,2,18
050,51,580,"Virginia","Covington city",5,85,95,23,72
050,51,590,"Virginia","Danville city",1,0,490,254,236
050,51,590,"Virginia","Danville city",1,1,491,253,238
050,51,590,"Virginia","Danville city",1,2,489,261,228
050,51,590,"Virginia","Danville city",1,3,512,251,261
050,51,590,"Virginia","Danville city",1,4,503,240,263
050,51,590,"Virginia","Danville city",1,5,538,274,264
050,51,590,"Virginia","Danville city",1,6,517,267,250
050,51,590,"Virginia","Danville city",1,7,552,281,271
050,51,590,"Virginia","Danville city",1,8,515,263,252
050,51,590,"Virginia","Danville city",1,9,500,263,237
050,51,590,"Virginia","Danville city",1,10,558,306,252
050,51,590,"Virginia","Danville city",1,11,586,296,290
050,51,590,"Virginia","Danville city",1,12,590,293,297
050,51,590,"Virginia","Danville city",1,13,565,262,303
050,51,590,"Virginia","Danville city",1,14,508,254,254
050,51,590,"Virginia","Danville city",1,15,505,256,249
050,51,590,"Virginia","Danville city",1,16,549,274,275
050,51,590,"Virginia","Danville city",1,17,528,283,245
050,51,590,"Virginia","Danville city",1,18,533,294,239
050,51,590,"Virginia","Danville city",1,19,567,315,252
050,51,590,"Virginia","Danville city",1,20,579,330,249
050,51,590,"Virginia","Danville city",1,21,532,268,264
050,51,590,"Virginia","Danville city",1,22,514,242,272
050,51,590,"Virginia","Danville city",1,23,452,215,237
050,51,590,"Virginia","Danville city",1,24,483,232,251
050,51,590,"Virginia","Danville city",1,25,497,242,255
050,51,590,"Virginia","Danville city",1,26,481,227,254
050,51,590,"Virginia","Danville city",1,27,516,246,270
050,51,590,"Virginia","Danville city",1,28,533,234,299
050,51,590,"Virginia","Danville city",1,29,584,271,313
050,51,590,"Virginia","Danville city",1,30,589,281,308
050,51,590,"Virginia","Danville city",1,31,546,256,290
050,51,590,"Virginia","Danville city",1,32,555,279,276
050,51,590,"Virginia","Danville city",1,33,502,246,256
050,51,590,"Virginia","Danville city",1,34,501,224,277
050,51,590,"Virginia","Danville city",1,35,498,238,260
050,51,590,"Virginia","Danville city",1,36,420,217,203
050,51,590,"Virginia","Danville city",1,37,446,228,218
050,51,590,"Virginia","Danville city",1,38,459,233,226
050,51,590,"Virginia","Danville city",1,39,477,215,262
050,51,590,"Virginia","Danville city",1,40,473,207,266
050,51,590,"Virginia","Danville city",1,41,435,189,246
050,51,590,"Virginia","Danville city",1,42,417,179,238
050,51,590,"Virginia","Danville city",1,43,392,169,223
050,51,590,"Virginia","Danville city",1,44,392,177,215
050,51,590,"Virginia","Danville city",1,45,388,172,216
050,51,590,"Virginia","Danville city",1,46,430,195,235
050,51,590,"Virginia","Danville city",1,47,457,226,231
050,51,590,"Virginia","Danville city",1,48,418,189,229
050,51,590,"Virginia","Danville city",1,49,469,215,254
050,51,590,"Virginia","Danville city",1,50,524,244,280
050,51,590,"Virginia","Danville city",1,51,517,241,276
050,51,590,"Virginia","Danville city",1,52,477,219,258
050,51,590,"Virginia","Danville city",1,53,511,227,284
050,51,590,"Virginia","Danville city",1,54,545,237,308
050,51,590,"Virginia","Danville city",1,55,617,278,339
050,51,590,"Virginia","Danville city",1,56,568,239,329
050,51,590,"Virginia","Danville city",1,57,571,244,327
050,51,590,"Virginia","Danville city",1,58,563,257,306
050,51,590,"Virginia","Danville city",1,59,603,287,316
050,51,590,"Virginia","Danville city",1,60,618,285,333
050,51,590,"Virginia","Danville city",1,61,628,276,352
050,51,590,"Virginia","Danville city",1,62,665,297,368
050,51,590,"Virginia","Danville city",1,63,656,285,371
050,51,590,"Virginia","Danville city",1,64,645,272,373
050,51,590,"Virginia","Danville city",1,65,595,264,331
050,51,590,"Virginia","Danville city",1,66,579,270,309
050,51,590,"Virginia","Danville city",1,67,573,255,318
050,51,590,"Virginia","Danville city",1,68,531,242,289
050,51,590,"Virginia","Danville city",1,69,515,234,281
050,51,590,"Virginia","Danville city",1,70,493,212,281
050,51,590,"Virginia","Danville city",1,71,477,199,278
050,51,590,"Virginia","Danville city",1,72,459,180,279
050,51,590,"Virginia","Danville city",1,73,485,207,278
050,51,590,"Virginia","Danville city",1,74,374,152,222
050,51,590,"Virginia","Danville city",1,75,347,145,202
050,51,590,"Virginia","Danville city",1,76,312,117,195
050,51,590,"Virginia","Danville city",1,77,307,127,180
050,51,590,"Virginia","Danville city",1,78,272,117,155
050,51,590,"Virginia","Danville city",1,79,269,107,162
050,51,590,"Virginia","Danville city",1,80,230,93,137
050,51,590,"Virginia","Danville city",1,81,223,80,143
050,51,590,"Virginia","Danville city",1,82,233,83,150
050,51,590,"Virginia","Danville city",1,83,214,67,147
050,51,590,"Virginia","Danville city",1,84,199,48,151
050,51,590,"Virginia","Danville city",1,85,1164,298,866
050,51,590,"Virginia","Danville city",2,0,500,254,246
050,51,590,"Virginia","Danville city",2,1,490,254,236
050,51,590,"Virginia","Danville city",2,2,490,258,232
050,51,590,"Virginia","Danville city",2,3,504,251,253
050,51,590,"Virginia","Danville city",2,4,508,242,266
050,51,590,"Virginia","Danville city",2,5,531,267,264
050,51,590,"Virginia","Danville city",2,6,526,270,256
050,51,590,"Virginia","Danville city",2,7,545,280,265
050,51,590,"Virginia","Danville city",2,8,526,268,258
050,51,590,"Virginia","Danville city",2,9,505,263,242
050,51,590,"Virginia","Danville city",2,10,543,295,248
050,51,590,"Virginia","Danville city",2,11,579,299,280
050,51,590,"Virginia","Danville city",2,12,589,291,298
050,51,590,"Virginia","Danville city",2,13,572,270,302
050,51,590,"Virginia","Danville city",2,14,521,254,267
050,51,590,"Virginia","Danville city",2,15,508,257,251
050,51,590,"Virginia","Danville city",2,16,538,270,268
050,51,590,"Virginia","Danville city",2,17,533,281,252
050,51,590,"Virginia","Danville city",2,18,530,293,237
050,51,590,"Virginia","Danville city",2,19,566,314,252
050,51,590,"Virginia","Danville city",2,20,581,327,254
050,51,590,"Virginia","Danville city",2,21,540,279,261
050,51,590,"Virginia","Danville city",2,22,518,246,272
050,51,590,"Virginia","Danville city",2,23,468,222,246
050,51,590,"Virginia","Danville city",2,24,481,231,250
050,51,590,"Virginia","Danville city",2,25,494,239,255
050,51,590,"Virginia","Danville city",2,26,481,227,254
050,51,590,"Virginia","Danville city",2,27,504,236,268
050,51,590,"Virginia","Danville city",2,28,528,238,290
050,51,590,"Virginia","Danville city",2,29,570,263,307
050,51,590,"Virginia","Danville city",2,30,591,281,310
050,51,590,"Virginia","Danville city",2,31,555,262,293
050,51,590,"Virginia","Danville city",2,32,550,272,278
050,51,590,"Virginia","Danville city",2,33,507,246,261
050,51,590,"Virginia","Danville city",2,34,500,226,274
050,51,590,"Virginia","Danville city",2,35,496,234,262
050,51,590,"Virginia","Danville city",2,36,434,221,213
050,51,590,"Virginia","Danville city",2,37,438,225,213
050,51,590,"Virginia","Danville city",2,38,458,231,227
050,51,590,"Virginia","Danville city",2,39,475,221,254
050,51,590,"Virginia","Danville city",2,40,481,210,271
050,51,590,"Virginia","Danville city",2,41,441,191,250
050,51,590,"Virginia","Danville city",2,42,421,181,240
050,51,590,"Virginia","Danville city",2,43,402,173,229
050,51,590,"Virginia","Danville city",2,44,388,172,216
050,51,590,"Virginia","Danville city",2,45,396,178,218
050,51,590,"Virginia","Danville city",2,46,416,189,227
050,51,590,"Virginia","Danville city",2,47,448,216,232
050,51,590,"Virginia","Danville city",2,48,423,195,228
050,51,590,"Virginia","Danville city",2,49,460,211,249
050,51,590,"Virginia","Danville city",2,50,515,239,276
050,51,590,"Virginia","Danville city",2,51,510,238,272
050,51,590,"Virginia","Danville city",2,52,488,226,262
050,51,590,"Virginia","Danville city",2,53,500,224,276
050,51,590,"Virginia","Danville city",2,54,538,235,303
050,51,590,"Virginia","Danville city",2,55,601,270,331
050,51,590,"Virginia","Danville city",2,56,581,249,332
050,51,590,"Virginia","Danville city",2,57,568,240,328
050,51,590,"Virginia","Danville city",2,58,566,255,311
050,51,590,"Virginia","Danville city",2,59,594,281,313
050,51,590,"Virginia","Danville city",2,60,615,285,330
050,51,590,"Virginia","Danville city",2,61,621,275,346
050,51,590,"Virginia","Danville city",2,62,653,291,362
050,51,590,"Virginia","Danville city",2,63,660,290,370
050,51,590,"Virginia","Danville city",2,64,631,267,364
050,51,590,"Virginia","Danville city",2,65,605,267,338
050,51,590,"Virginia","Danville city",2,66,586,268,318
050,51,590,"Virginia","Danville city",2,67,572,257,315
050,51,590,"Virginia","Danville city",2,68,535,240,295
050,51,590,"Virginia","Danville city",2,69,521,236,285
050,51,590,"Virginia","Danville city",2,70,494,214,280
050,51,590,"Virginia","Danville city",2,71,477,199,278
050,51,590,"Virginia","Danville city",2,72,452,180,272
050,51,590,"Virginia","Danville city",2,73,497,210,287
050,51,590,"Virginia","Danville city",2,74,376,153,223
050,51,590,"Virginia","Danville city",2,75,354,148,206
050,51,590,"Virginia","Danville city",2,76,318,122,196
050,51,590,"Virginia","Danville city",2,77,309,127,182
050,51,590,"Virginia","Danville city",2,78,268,113,155
050,51,590,"Virginia","Danville city",2,79,260,103,157
050,51,590,"Virginia","Danville city",2,80,236,98,138
050,51,590,"Virginia","Danville city",2,81,221,81,140
050,51,590,"Virginia","Danville city",2,82,229,80,149
050,51,590,"Virginia","Danville city",2,83,216,68,148
050,51,590,"Virginia","Danville city",2,84,204,54,150
050,51,590,"Virginia","Danville city",2,85,1159,295,864
050,51,590,"Virginia","Danville city",3,0,455,237,218
050,51,590,"Virginia","Danville city",3,1,513,254,259
050,51,590,"Virginia","Danville city",3,2,502,262,240
050,51,590,"Virginia","Danville city",3,3,509,274,235
050,51,590,"Virginia","Danville city",3,4,502,251,251
050,51,590,"Virginia","Danville city",3,5,505,245,260
050,51,590,"Virginia","Danville city",3,6,533,265,268
050,51,590,"Virginia","Danville city",3,7,532,276,256
050,51,590,"Virginia","Danville city",3,8,544,284,260
050,51,590,"Virginia","Danville city",3,9,508,263,245
050,51,590,"Virginia","Danville city",3,10,498,254,244
050,51,590,"Virginia","Danville city",3,11,551,292,259
050,51,590,"Virginia","Danville city",3,12,564,287,277
050,51,590,"Virginia","Danville city",3,13,584,289,295
050,51,590,"Virginia","Danville city",3,14,572,261,311
050,51,590,"Virginia","Danville city",3,15,529,253,276
050,51,590,"Virginia","Danville city",3,16,520,267,253
050,51,590,"Virginia","Danville city",3,17,551,275,276
050,51,590,"Virginia","Danville city",3,18,539,297,242
050,51,590,"Virginia","Danville city",3,19,561,310,251
050,51,590,"Virginia","Danville city",3,20,575,303,272
050,51,590,"Virginia","Danville city",3,21,561,295,266
050,51,590,"Virginia","Danville city",3,22,527,265,262
050,51,590,"Virginia","Danville city",3,23,509,229,280
050,51,590,"Virginia","Danville city",3,24,465,219,246
050,51,590,"Virginia","Danville city",3,25,472,232,240
050,51,590,"Virginia","Danville city",3,26,489,229,260
050,51,590,"Virginia","Danville city",3,27,487,218,269
050,51,590,"Virginia","Danville city",3,28,510,232,278
050,51,590,"Virginia","Danville city",3,29,507,220,287
050,51,590,"Virginia","Danville city",3,30,560,256,304
050,51,590,"Virginia","Danville city",3,31,583,263,320
050,51,590,"Virginia","Danville city",3,32,546,266,280
050,51,590,"Virginia","Danville city",3,33,529,259,270
050,51,590,"Virginia","Danville city",3,34,514,256,258
050,51,590,"Virginia","Danville city",3,35,496,221,275
050,51,590,"Virginia","Danville city",3,36,484,227,257
050,51,590,"Virginia","Danville city",3,37,435,208,227
050,51,590,"Virginia","Danville city",3,38,445,225,220
050,51,590,"Virginia","Danville city",3,39,466,235,231
050,51,590,"Virginia","Danville city",3,40,482,229,253
050,51,590,"Virginia","Danville city",3,41,470,197,273
050,51,590,"Virginia","Danville city",3,42,449,194,255
050,51,590,"Virginia","Danville city",3,43,412,187,225
050,51,590,"Virginia","Danville city",3,44,404,176,228
050,51,590,"Virginia","Danville city",3,45,404,189,215
050,51,590,"Virginia","Danville city",3,46,393,177,216
050,51,590,"Virginia","Danville city",3,47,420,183,237
050,51,590,"Virginia","Danville city",3,48,460,221,239
050,51,590,"Virginia","Danville city",3,49,421,199,222
050,51,590,"Virginia","Danville city",3,50,469,220,249
050,51,590,"Virginia","Danville city",3,51,497,225,272
050,51,590,"Virginia","Danville city",3,52,489,232,257
050,51,590,"Virginia","Danville city",3,53,477,214,263
050,51,590,"Virginia","Danville city",3,54,498,218,280
050,51,590,"Virginia","Danville city",3,55,540,234,306
050,51,590,"Virginia","Danville city",3,56,594,268,326
050,51,590,"Virginia","Danville city",3,57,581,247,334
050,51,590,"Virginia","Danville city",3,58,565,242,323
050,51,590,"Virginia","Danville city",3,59,566,256,310
050,51,590,"Virginia","Danville city",3,60,572,269,303
050,51,590,"Virginia","Danville city",3,61,615,278,337
050,51,590,"Virginia","Danville city",3,62,628,276,352
050,51,590,"Virginia","Danville city",3,63,645,286,359
050,51,590,"Virginia","Danville city",3,64,645,278,367
050,51,590,"Virginia","Danville city",3,65,607,264,343
050,51,590,"Virginia","Danville city",3,66,587,252,335
050,51,590,"Virginia","Danville city",3,67,570,262,308
050,51,590,"Virginia","Danville city",3,68,556,248,308
050,51,590,"Virginia","Danville city",3,69,520,234,286
050,51,590,"Virginia","Danville city",3,70,505,229,276
050,51,590,"Virginia","Danville city",3,71,474,200,274
050,51,590,"Virginia","Danville city",3,72,449,183,266
050,51,590,"Virginia","Danville city",3,73,445,176,269
050,51,590,"Virginia","Danville city",3,74,466,193,273
050,51,590,"Virginia","Danville city",3,75,354,142,212
050,51,590,"Virginia","Danville city",3,76,334,137,197
050,51,590,"Virginia","Danville city",3,77,300,113,187
050,51,590,"Virginia","Danville city",3,78,285,112,173
050,51,590,"Virginia","Danville city",3,79,237,99,138
050,51,590,"Virginia","Danville city",3,80,236,97,139
050,51,590,"Virginia","Danville city",3,81,216,82,134
050,51,590,"Virginia","Danville city",3,82,205,73,132
050,51,590,"Virginia","Danville city",3,83,213,71,142
050,51,590,"Virginia","Danville city",3,84,196,55,141
050,51,590,"Virginia","Danville city",3,85,1102,267,835
050,51,590,"Virginia","Danville city",4,0,456,228,228
050,51,590,"Virginia","Danville city",4,1,448,223,225
050,51,590,"Virginia","Danville city",4,2,509,252,257
050,51,590,"Virginia","Danville city",4,3,509,268,241
050,51,590,"Virginia","Danville city",4,4,490,254,236
050,51,590,"Virginia","Danville city",4,5,510,260,250
050,51,590,"Virginia","Danville city",4,6,503,239,264
050,51,590,"Virginia","Danville city",4,7,519,259,260
050,51,590,"Virginia","Danville city",4,8,553,289,264
050,51,590,"Virginia","Danville city",4,9,547,284,263
050,51,590,"Virginia","Danville city",4,10,507,258,249
050,51,590,"Virginia","Danville city",4,11,505,251,254
050,51,590,"Virginia","Danville city",4,12,560,294,266
050,51,590,"Virginia","Danville city",4,13,568,287,281
050,51,590,"Virginia","Danville city",4,14,585,292,293
050,51,590,"Virginia","Danville city",4,15,589,280,309
050,51,590,"Virginia","Danville city",4,16,538,264,274
050,51,590,"Virginia","Danville city",4,17,507,257,250
050,51,590,"Virginia","Danville city",4,18,539,284,255
050,51,590,"Virginia","Danville city",4,19,576,318,258
050,51,590,"Virginia","Danville city",4,20,564,307,257
050,51,590,"Virginia","Danville city",4,21,546,276,270
050,51,590,"Virginia","Danville city",4,22,564,296,268
050,51,590,"Virginia","Danville city",4,23,506,253,253
050,51,590,"Virginia","Danville city",4,24,510,233,277
050,51,590,"Virginia","Danville city",4,25,476,226,250
050,51,590,"Virginia","Danville city",4,26,488,247,241
050,51,590,"Virginia","Danville city",4,27,487,238,249
050,51,590,"Virginia","Danville city",4,28,489,225,264
050,51,590,"Virginia","Danville city",4,29,510,231,279
050,51,590,"Virginia","Danville city",4,30,508,224,284
050,51,590,"Virginia","Danville city",4,31,525,241,284
050,51,590,"Virginia","Danville city",4,32,597,276,321
050,51,590,"Virginia","Danville city",4,33,534,257,277
050,51,590,"Virginia","Danville city",4,34,523,255,268
050,51,590,"Virginia","Danville city",4,35,501,235,266
050,51,590,"Virginia","Danville city",4,36,477,207,270
050,51,590,"Virginia","Danville city",4,37,484,226,258
050,51,590,"Virginia","Danville city",4,38,452,217,235
050,51,590,"Virginia","Danville city",4,39,452,227,225
050,51,590,"Virginia","Danville city",4,40,462,229,233
050,51,590,"Virginia","Danville city",4,41,483,229,254
050,51,590,"Virginia","Danville city",4,42,464,199,265
050,51,590,"Virginia","Danville city",4,43,448,194,254
050,51,590,"Virginia","Danville city",4,44,420,188,232
050,51,590,"Virginia","Danville city",4,45,424,189,235
050,51,590,"Virginia","Danville city",4,46,401,182,219
050,51,590,"Virginia","Danville city",4,47,391,178,213
050,51,590,"Virginia","Danville city",4,48,420,182,238
050,51,590,"Virginia","Danville city",4,49,475,224,251
050,51,590,"Virginia","Danville city",4,50,438,212,226
050,51,590,"Virginia","Danville city",4,51,457,208,249
050,51,590,"Virginia","Danville city",4,52,489,217,272
050,51,590,"Virginia","Danville city",4,53,500,237,263
050,51,590,"Virginia","Danville city",4,54,463,207,256
050,51,590,"Virginia","Danville city",4,55,506,215,291
050,51,590,"Virginia","Danville city",4,56,537,236,301
050,51,590,"Virginia","Danville city",4,57,594,262,332
050,51,590,"Virginia","Danville city",4,58,569,245,324
050,51,590,"Virginia","Danville city",4,59,548,237,311
050,51,590,"Virginia","Danville city",4,60,569,255,314
050,51,590,"Virginia","Danville city",4,61,559,254,305
050,51,590,"Virginia","Danville city",4,62,610,280,330
050,51,590,"Virginia","Danville city",4,63,610,272,338
050,51,590,"Virginia","Danville city",4,64,615,271,344
050,51,590,"Virginia","Danville city",4,65,619,260,359
050,51,590,"Virginia","Danville city",4,66,591,252,339
050,51,590,"Virginia","Danville city",4,67,569,246,323
050,51,590,"Virginia","Danville city",4,68,546,243,303
050,51,590,"Virginia","Danville city",4,69,530,237,293
050,51,590,"Virginia","Danville city",4,70,508,229,279
050,51,590,"Virginia","Danville city",4,71,479,219,260
050,51,590,"Virginia","Danville city",4,72,452,185,267
050,51,590,"Virginia","Danville city",4,73,438,180,258
050,51,590,"Virginia","Danville city",4,74,416,152,264
050,51,590,"Virginia","Danville city",4,75,450,189,261
050,51,590,"Virginia","Danville city",4,76,335,133,202
050,51,590,"Virginia","Danville city",4,77,324,133,191
050,51,590,"Virginia","Danville city",4,78,272,95,177
050,51,590,"Virginia","Danville city",4,79,263,102,161
050,51,590,"Virginia","Danville city",4,80,223,96,127
050,51,590,"Virginia","Danville city",4,81,202,72,130
050,51,590,"Virginia","Danville city",4,82,205,78,127
050,51,590,"Virginia","Danville city",4,83,195,65,130
050,51,590,"Virginia","Danville city",4,84,191,56,135
050,51,590,"Virginia","Danville city",4,85,1046,236,810
050,51,590,"Virginia","Danville city",5,0,421,211,210
050,51,590,"Virginia","Danville city",5,1,498,239,259
050,51,590,"Virginia","Danville city",5,2,469,244,225
050,51,590,"Virginia","Danville city",5,3,538,278,260
050,51,590,"Virginia","Danville city",5,4,518,272,246
050,51,590,"Virginia","Danville city",5,5,517,269,248
050,51,590,"Virginia","Danville city",5,6,513,258,255
050,51,590,"Virginia","Danville city",5,7,510,245,265
050,51,590,"Virginia","Danville city",5,8,544,275,269
050,51,590,"Virginia","Danville city",5,9,532,267,265
050,51,590,"Virginia","Danville city",5,10,541,280,261
050,51,590,"Virginia","Danville city",5,11,506,254,252
050,51,590,"Virginia","Danville city",5,12,493,241,252
050,51,590,"Virginia","Danville city",5,13,567,301,266
050,51,590,"Virginia","Danville city",5,14,555,284,271
050,51,590,"Virginia","Danville city",5,15,585,295,290
050,51,590,"Virginia","Danville city",5,16,585,266,319
050,51,590,"Virginia","Danville city",5,17,549,266,283
050,51,590,"Virginia","Danville city",5,18,506,267,239
050,51,590,"Virginia","Danville city",5,19,557,295,262
050,51,590,"Virginia","Danville city",5,20,581,308,273
050,51,590,"Virginia","Danville city",5,21,564,292,272
050,51,590,"Virginia","Danville city",5,22,562,274,288
050,51,590,"Virginia","Danville city",5,23,553,286,267
050,51,590,"Virginia","Danville city",5,24,505,261,244
050,51,590,"Virginia","Danville city",5,25,527,240,287
050,51,590,"Virginia","Danville city",5,26,471,223,248
050,51,590,"Virginia","Danville city",5,27,501,241,260
050,51,590,"Virginia","Danville city",5,28,480,223,257
050,51,590,"Virginia","Danville city",5,29,473,222,251
050,51,590,"Virginia","Danville city",5,30,516,236,280
050,51,590,"Virginia","Danville city",5,31,531,236,295
050,51,590,"Virginia","Danville city",5,32,545,255,290
050,51,590,"Virginia","Danville city",5,33,600,275,325
050,51,590,"Virginia","Danville city",5,34,530,261,269
050,51,590,"Virginia","Danville city",5,35,502,243,259
050,51,590,"Virginia","Danville city",5,36,475,219,256
050,51,590,"Virginia","Danville city",5,37,474,201,273
050,51,590,"Virginia","Danville city",5,38,487,221,266
050,51,590,"Virginia","Danville city",5,39,455,218,237
050,51,590,"Virginia","Danville city",5,40,440,215,225
050,51,590,"Virginia","Danville city",5,41,456,219,237
050,51,590,"Virginia","Danville city",5,42,478,229,249
050,51,590,"Virginia","Danville city",5,43,457,201,256
050,51,590,"Virginia","Danville city",5,44,435,187,248
050,51,590,"Virginia","Danville city",5,45,439,203,236
050,51,590,"Virginia","Danville city",5,46,417,191,226
050,51,590,"Virginia","Danville city",5,47,392,173,219
050,51,590,"Virginia","Danville city",5,48,386,172,214
050,51,590,"Virginia","Danville city",5,49,417,185,232
050,51,590,"Virginia","Danville city",5,50,491,233,258
050,51,590,"Virginia","Danville city",5,51,434,205,229
050,51,590,"Virginia","Danville city",5,52,450,200,250
050,51,590,"Virginia","Danville city",5,53,483,206,277
050,51,590,"Virginia","Danville city",5,54,497,234,263
050,51,590,"Virginia","Danville city",5,55,465,208,257
050,51,590,"Virginia","Danville city",5,56,486,203,283
050,51,590,"Virginia","Danville city",5,57,533,234,299
050,51,590,"Virginia","Danville city",5,58,585,266,319
050,51,590,"Virginia","Danville city",5,59,558,240,318
050,51,590,"Virginia","Danville city",5,60,552,236,316
050,51,590,"Virginia","Danville city",5,61,556,254,302
050,51,590,"Virginia","Danville city",5,62,565,266,299
050,51,590,"Virginia","Danville city",5,63,598,271,327
050,51,590,"Virginia","Danville city",5,64,580,253,327
050,51,590,"Virginia","Danville city",5,65,594,267,327
050,51,590,"Virginia","Danville city",5,66,597,252,345
050,51,590,"Virginia","Danville city",5,67,570,246,324
050,51,590,"Virginia","Danville city",5,68,545,230,315
050,51,590,"Virginia","Danville city",5,69,523,238,285
050,51,590,"Virginia","Danville city",5,70,510,228,282
050,51,590,"Virginia","Danville city",5,71,485,222,263
050,51,590,"Virginia","Danville city",5,72,452,203,249
050,51,590,"Virginia","Danville city",5,73,447,183,264
050,51,590,"Virginia","Danville city",5,74,411,160,251
050,51,590,"Virginia","Danville city",5,75,394,144,250
050,51,590,"Virginia","Danville city",5,76,429,176,253
050,51,590,"Virginia","Danville city",5,77,321,128,193
050,51,590,"Virginia","Danville city",5,78,301,118,183
050,51,590,"Virginia","Danville city",5,79,249,83,166
050,51,590,"Virginia","Danville city",5,80,249,98,151
050,51,590,"Virginia","Danville city",5,81,195,73,122
050,51,590,"Virginia","Danville city",5,82,189,67,122
050,51,590,"Virginia","Danville city",5,83,198,72,126
050,51,590,"Virginia","Danville city",5,84,181,54,127
050,51,590,"Virginia","Danville city",5,85,1011,225,786
050,51,595,"Virginia","Emporia city",1,0,78,39,39
050,51,595,"Virginia","Emporia city",1,1,80,41,39
050,51,595,"Virginia","Emporia city",1,2,96,53,43
050,51,595,"Virginia","Emporia city",1,3,87,48,39
050,51,595,"Virginia","Emporia city",1,4,77,38,39
050,51,595,"Virginia","Emporia city",1,5,77,42,35
050,51,595,"Virginia","Emporia city",1,6,80,44,36
050,51,595,"Virginia","Emporia city",1,7,54,22,32
050,51,595,"Virginia","Emporia city",1,8,65,33,32
050,51,595,"Virginia","Emporia city",1,9,91,45,46
050,51,595,"Virginia","Emporia city",1,10,77,30,47
050,51,595,"Virginia","Emporia city",1,11,104,53,51
050,51,595,"Virginia","Emporia city",1,12,91,57,34
050,51,595,"Virginia","Emporia city",1,13,88,46,42
050,51,595,"Virginia","Emporia city",1,14,69,34,35
050,51,595,"Virginia","Emporia city",1,15,79,43,36
050,51,595,"Virginia","Emporia city",1,16,87,49,38
050,51,595,"Virginia","Emporia city",1,17,85,42,43
050,51,595,"Virginia","Emporia city",1,18,73,38,35
050,51,595,"Virginia","Emporia city",1,19,68,33,35
050,51,595,"Virginia","Emporia city",1,20,65,29,36
050,51,595,"Virginia","Emporia city",1,21,53,27,26
050,51,595,"Virginia","Emporia city",1,22,64,32,32
050,51,595,"Virginia","Emporia city",1,23,67,30,37
050,51,595,"Virginia","Emporia city",1,24,58,25,33
050,51,595,"Virginia","Emporia city",1,25,59,28,31
050,51,595,"Virginia","Emporia city",1,26,53,25,28
050,51,595,"Virginia","Emporia city",1,27,71,28,43
050,51,595,"Virginia","Emporia city",1,28,84,43,41
050,51,595,"Virginia","Emporia city",1,29,87,39,48
050,51,595,"Virginia","Emporia city",1,30,75,31,44
050,51,595,"Virginia","Emporia city",1,31,65,27,38
050,51,595,"Virginia","Emporia city",1,32,74,41,33
050,51,595,"Virginia","Emporia city",1,33,72,29,43
050,51,595,"Virginia","Emporia city",1,34,66,31,35
050,51,595,"Virginia","Emporia city",1,35,57,27,30
050,51,595,"Virginia","Emporia city",1,36,62,28,34
050,51,595,"Virginia","Emporia city",1,37,61,24,37
050,51,595,"Virginia","Emporia city",1,38,53,20,33
050,51,595,"Virginia","Emporia city",1,39,65,20,45
050,51,595,"Virginia","Emporia city",1,40,66,32,34
050,51,595,"Virginia","Emporia city",1,41,53,23,30
050,51,595,"Virginia","Emporia city",1,42,51,18,33
050,51,595,"Virginia","Emporia city",1,43,54,23,31
050,51,595,"Virginia","Emporia city",1,44,60,30,30
050,51,595,"Virginia","Emporia city",1,45,68,32,36
050,51,595,"Virginia","Emporia city",1,46,53,23,30
050,51,595,"Virginia","Emporia city",1,47,68,31,37
050,51,595,"Virginia","Emporia city",1,48,76,33,43
050,51,595,"Virginia","Emporia city",1,49,79,41,38
050,51,595,"Virginia","Emporia city",1,50,61,27,34
050,51,595,"Virginia","Emporia city",1,51,64,36,28
050,51,595,"Virginia","Emporia city",1,52,76,40,36
050,51,595,"Virginia","Emporia city",1,53,75,33,42
050,51,595,"Virginia","Emporia city",1,54,71,31,40
050,51,595,"Virginia","Emporia city",1,55,82,37,45
050,51,595,"Virginia","Emporia city",1,56,82,39,43
050,51,595,"Virginia","Emporia city",1,57,78,33,45
050,51,595,"Virginia","Emporia city",1,58,82,34,48
050,51,595,"Virginia","Emporia city",1,59,70,30,40
050,51,595,"Virginia","Emporia city",1,60,71,33,38
050,51,595,"Virginia","Emporia city",1,61,79,36,43
050,51,595,"Virginia","Emporia city",1,62,74,33,41
050,51,595,"Virginia","Emporia city",1,63,75,37,38
050,51,595,"Virginia","Emporia city",1,64,76,36,40
050,51,595,"Virginia","Emporia city",1,65,74,36,38
050,51,595,"Virginia","Emporia city",1,66,76,45,31
050,51,595,"Virginia","Emporia city",1,67,57,30,27
050,51,595,"Virginia","Emporia city",1,68,54,24,30
050,51,595,"Virginia","Emporia city",1,69,60,31,29
050,51,595,"Virginia","Emporia city",1,70,50,23,27
050,51,595,"Virginia","Emporia city",1,71,44,17,27
050,51,595,"Virginia","Emporia city",1,72,61,24,37
050,51,595,"Virginia","Emporia city",1,73,61,23,38
050,51,595,"Virginia","Emporia city",1,74,47,18,29
050,51,595,"Virginia","Emporia city",1,75,44,16,28
050,51,595,"Virginia","Emporia city",1,76,43,22,21
050,51,595,"Virginia","Emporia city",1,77,48,25,23
050,51,595,"Virginia","Emporia city",1,78,40,22,18
050,51,595,"Virginia","Emporia city",1,79,25,9,16
050,51,595,"Virginia","Emporia city",1,80,32,15,17
050,51,595,"Virginia","Emporia city",1,81,32,12,20
050,51,595,"Virginia","Emporia city",1,82,25,7,18
050,51,595,"Virginia","Emporia city",1,83,24,9,15
050,51,595,"Virginia","Emporia city",1,84,16,6,10
050,51,595,"Virginia","Emporia city",1,85,190,54,136
050,51,595,"Virginia","Emporia city",2,0,73,35,38
050,51,595,"Virginia","Emporia city",2,1,77,40,37
050,51,595,"Virginia","Emporia city",2,2,90,51,39
050,51,595,"Virginia","Emporia city",2,3,86,47,39
050,51,595,"Virginia","Emporia city",2,4,78,39,39
050,51,595,"Virginia","Emporia city",2,5,75,40,35
050,51,595,"Virginia","Emporia city",2,6,79,44,35
050,51,595,"Virginia","Emporia city",2,7,61,27,34
050,51,595,"Virginia","Emporia city",2,8,66,32,34
050,51,595,"Virginia","Emporia city",2,9,86,43,43
050,51,595,"Virginia","Emporia city",2,10,81,34,47
050,51,595,"Virginia","Emporia city",2,11,94,47,47
050,51,595,"Virginia","Emporia city",2,12,95,56,39
050,51,595,"Virginia","Emporia city",2,13,86,46,40
050,51,595,"Virginia","Emporia city",2,14,72,37,35
050,51,595,"Virginia","Emporia city",2,15,75,40,35
050,51,595,"Virginia","Emporia city",2,16,85,46,39
050,51,595,"Virginia","Emporia city",2,17,83,42,41
050,51,595,"Virginia","Emporia city",2,18,72,37,35
050,51,595,"Virginia","Emporia city",2,19,67,33,34
050,51,595,"Virginia","Emporia city",2,20,64,30,34
050,51,595,"Virginia","Emporia city",2,21,55,27,28
050,51,595,"Virginia","Emporia city",2,22,62,31,31
050,51,595,"Virginia","Emporia city",2,23,65,29,36
050,51,595,"Virginia","Emporia city",2,24,58,24,34
050,51,595,"Virginia","Emporia city",2,25,58,27,31
050,51,595,"Virginia","Emporia city",2,26,52,24,28
050,51,595,"Virginia","Emporia city",2,27,68,28,40
050,51,595,"Virginia","Emporia city",2,28,82,40,42
050,51,595,"Virginia","Emporia city",2,29,85,39,46
050,51,595,"Virginia","Emporia city",2,30,78,33,45
050,51,595,"Virginia","Emporia city",2,31,68,28,40
050,51,595,"Virginia","Emporia city",2,32,71,38,33
050,51,595,"Virginia","Emporia city",2,33,71,31,40
050,51,595,"Virginia","Emporia city",2,34,65,29,36
050,51,595,"Virginia","Emporia city",2,35,60,29,31
050,51,595,"Virginia","Emporia city",2,36,61,27,34
050,51,595,"Virginia","Emporia city",2,37,60,24,36
050,51,595,"Virginia","Emporia city",2,38,55,21,34
050,51,595,"Virginia","Emporia city",2,39,61,20,41
050,51,595,"Virginia","Emporia city",2,40,65,29,36
050,51,595,"Virginia","Emporia city",2,41,56,25,31
050,51,595,"Virginia","Emporia city",2,42,52,20,32
050,51,595,"Virginia","Emporia city",2,43,55,23,32
050,51,595,"Virginia","Emporia city",2,44,60,29,31
050,51,595,"Virginia","Emporia city",2,45,67,32,35
050,51,595,"Virginia","Emporia city",2,46,56,25,31
050,51,595,"Virginia","Emporia city",2,47,66,30,36
050,51,595,"Virginia","Emporia city",2,48,72,31,41
050,51,595,"Virginia","Emporia city",2,49,77,38,39
050,51,595,"Virginia","Emporia city",2,50,63,29,34
050,51,595,"Virginia","Emporia city",2,51,64,34,30
050,51,595,"Virginia","Emporia city",2,52,72,38,34
050,51,595,"Virginia","Emporia city",2,53,73,34,39
050,51,595,"Virginia","Emporia city",2,54,72,31,41
050,51,595,"Virginia","Emporia city",2,55,79,36,43
050,51,595,"Virginia","Emporia city",2,56,82,37,45
050,51,595,"Virginia","Emporia city",2,57,79,33,46
050,51,595,"Virginia","Emporia city",2,58,80,34,46
050,51,595,"Virginia","Emporia city",2,59,70,30,40
050,51,595,"Virginia","Emporia city",2,60,72,33,39
050,51,595,"Virginia","Emporia city",2,61,77,35,42
050,51,595,"Virginia","Emporia city",2,62,73,32,41
050,51,595,"Virginia","Emporia city",2,63,74,35,39
050,51,595,"Virginia","Emporia city",2,64,75,36,39
050,51,595,"Virginia","Emporia city",2,65,72,36,36
050,51,595,"Virginia","Emporia city",2,66,77,44,33
050,51,595,"Virginia","Emporia city",2,67,60,33,27
050,51,595,"Virginia","Emporia city",2,68,54,25,29
050,51,595,"Virginia","Emporia city",2,69,60,31,29
050,51,595,"Virginia","Emporia city",2,70,52,24,28
050,51,595,"Virginia","Emporia city",2,71,43,18,25
050,51,595,"Virginia","Emporia city",2,72,54,20,34
050,51,595,"Virginia","Emporia city",2,73,64,25,39
050,51,595,"Virginia","Emporia city",2,74,47,19,28
050,51,595,"Virginia","Emporia city",2,75,43,16,27
050,51,595,"Virginia","Emporia city",2,76,43,21,22
050,51,595,"Virginia","Emporia city",2,77,46,24,22
050,51,595,"Virginia","Emporia city",2,78,40,21,19
050,51,595,"Virginia","Emporia city",2,79,27,10,17
050,51,595,"Virginia","Emporia city",2,80,33,15,18
050,51,595,"Virginia","Emporia city",2,81,31,12,19
050,51,595,"Virginia","Emporia city",2,82,24,8,16
050,51,595,"Virginia","Emporia city",2,83,23,8,15
050,51,595,"Virginia","Emporia city",2,84,17,6,11
050,51,595,"Virginia","Emporia city",2,85,186,52,134
050,51,595,"Virginia","Emporia city",3,0,67,42,25
050,51,595,"Virginia","Emporia city",3,1,77,43,34
050,51,595,"Virginia","Emporia city",3,2,86,48,38
050,51,595,"Virginia","Emporia city",3,3,89,50,39
050,51,595,"Virginia","Emporia city",3,4,80,44,36
050,51,595,"Virginia","Emporia city",3,5,83,41,42
050,51,595,"Virginia","Emporia city",3,6,84,42,42
050,51,595,"Virginia","Emporia city",3,7,83,45,38
050,51,595,"Virginia","Emporia city",3,8,69,30,39
050,51,595,"Virginia","Emporia city",3,9,65,32,33
050,51,595,"Virginia","Emporia city",3,10,81,40,41
050,51,595,"Virginia","Emporia city",3,11,84,35,49
050,51,595,"Virginia","Emporia city",3,12,88,45,43
050,51,595,"Virginia","Emporia city",3,13,92,55,37
050,51,595,"Virginia","Emporia city",3,14,86,46,40
050,51,595,"Virginia","Emporia city",3,15,68,34,34
050,51,595,"Virginia","Emporia city",3,16,78,41,37
050,51,595,"Virginia","Emporia city",3,17,84,44,40
050,51,595,"Virginia","Emporia city",3,18,66,32,34
050,51,595,"Virginia","Emporia city",3,19,57,30,27
050,51,595,"Virginia","Emporia city",3,20,68,32,36
050,51,595,"Virginia","Emporia city",3,21,67,32,35
050,51,595,"Virginia","Emporia city",3,22,58,29,29
050,51,595,"Virginia","Emporia city",3,23,63,33,30
050,51,595,"Virginia","Emporia city",3,24,57,23,34
050,51,595,"Virginia","Emporia city",3,25,58,24,34
050,51,595,"Virginia","Emporia city",3,26,58,29,29
050,51,595,"Virginia","Emporia city",3,27,57,23,34
050,51,595,"Virginia","Emporia city",3,28,68,25,43
050,51,595,"Virginia","Emporia city",3,29,75,35,40
050,51,595,"Virginia","Emporia city",3,30,87,41,46
050,51,595,"Virginia","Emporia city",3,31,79,34,45
050,51,595,"Virginia","Emporia city",3,32,77,32,45
050,51,595,"Virginia","Emporia city",3,33,70,38,32
050,51,595,"Virginia","Emporia city",3,34,66,30,36
050,51,595,"Virginia","Emporia city",3,35,66,30,36
050,51,595,"Virginia","Emporia city",3,36,60,28,32
050,51,595,"Virginia","Emporia city",3,37,57,22,35
050,51,595,"Virginia","Emporia city",3,38,59,23,36
050,51,595,"Virginia","Emporia city",3,39,50,19,31
050,51,595,"Virginia","Emporia city",3,40,59,20,39
050,51,595,"Virginia","Emporia city",3,41,72,30,42
050,51,595,"Virginia","Emporia city",3,42,52,23,29
050,51,595,"Virginia","Emporia city",3,43,47,16,31
050,51,595,"Virginia","Emporia city",3,44,50,21,29
050,51,595,"Virginia","Emporia city",3,45,53,22,31
050,51,595,"Virginia","Emporia city",3,46,68,34,34
050,51,595,"Virginia","Emporia city",3,47,55,25,30
050,51,595,"Virginia","Emporia city",3,48,68,32,36
050,51,595,"Virginia","Emporia city",3,49,72,28,44
050,51,595,"Virginia","Emporia city",3,50,70,35,35
050,51,595,"Virginia","Emporia city",3,51,65,31,34
050,51,595,"Virginia","Emporia city",3,52,65,35,30
050,51,595,"Virginia","Emporia city",3,53,73,40,33
050,51,595,"Virginia","Emporia city",3,54,74,32,42
050,51,595,"Virginia","Emporia city",3,55,69,31,38
050,51,595,"Virginia","Emporia city",3,56,76,36,40
050,51,595,"Virginia","Emporia city",3,57,78,35,43
050,51,595,"Virginia","Emporia city",3,58,77,32,45
050,51,595,"Virginia","Emporia city",3,59,78,32,46
050,51,595,"Virginia","Emporia city",3,60,74,34,40
050,51,595,"Virginia","Emporia city",3,61,70,31,39
050,51,595,"Virginia","Emporia city",3,62,73,31,42
050,51,595,"Virginia","Emporia city",3,63,77,34,43
050,51,595,"Virginia","Emporia city",3,64,71,34,37
050,51,595,"Virginia","Emporia city",3,65,72,33,39
050,51,595,"Virginia","Emporia city",3,66,71,36,35
050,51,595,"Virginia","Emporia city",3,67,73,42,31
050,51,595,"Virginia","Emporia city",3,68,58,29,29
050,51,595,"Virginia","Emporia city",3,69,56,25,31
050,51,595,"Virginia","Emporia city",3,70,53,26,27
050,51,595,"Virginia","Emporia city",3,71,49,21,28
050,51,595,"Virginia","Emporia city",3,72,41,15,26
050,51,595,"Virginia","Emporia city",3,73,50,19,31
050,51,595,"Virginia","Emporia city",3,74,65,27,38
050,51,595,"Virginia","Emporia city",3,75,43,16,27
050,51,595,"Virginia","Emporia city",3,76,41,15,26
050,51,595,"Virginia","Emporia city",3,77,39,21,18
050,51,595,"Virginia","Emporia city",3,78,36,20,16
050,51,595,"Virginia","Emporia city",3,79,34,18,16
050,51,595,"Virginia","Emporia city",3,80,32,12,20
050,51,595,"Virginia","Emporia city",3,81,29,12,17
050,51,595,"Virginia","Emporia city",3,82,23,8,15
050,51,595,"Virginia","Emporia city",3,83,24,9,15
050,51,595,"Virginia","Emporia city",3,84,15,6,9
050,51,595,"Virginia","Emporia city",3,85,181,51,130
050,51,595,"Virginia","Emporia city",4,0,70,38,32
050,51,595,"Virginia","Emporia city",4,1,68,40,28
050,51,595,"Virginia","Emporia city",4,2,78,42,36
050,51,595,"Virginia","Emporia city",4,3,79,42,37
050,51,595,"Virginia","Emporia city",4,4,89,56,33
050,51,595,"Virginia","Emporia city",4,5,78,41,37
050,51,595,"Virginia","Emporia city",4,6,84,42,42
050,51,595,"Virginia","Emporia city",4,7,80,40,40
050,51,595,"Virginia","Emporia city",4,8,81,43,38
050,51,595,"Virginia","Emporia city",4,9,74,30,44
050,51,595,"Virginia","Emporia city",4,10,61,29,32
050,51,595,"Virginia","Emporia city",4,11,83,42,41
050,51,595,"Virginia","Emporia city",4,12,84,36,48
050,51,595,"Virginia","Emporia city",4,13,90,45,45
050,51,595,"Virginia","Emporia city",4,14,86,49,37
050,51,595,"Virginia","Emporia city",4,15,85,46,39
050,51,595,"Virginia","Emporia city",4,16,73,38,35
050,51,595,"Virginia","Emporia city",4,17,71,37,34
050,51,595,"Virginia","Emporia city",4,18,79,38,41
050,51,595,"Virginia","Emporia city",4,19,58,28,30
050,51,595,"Virginia","Emporia city",4,20,58,32,26
050,51,595,"Virginia","Emporia city",4,21,59,30,29
050,51,595,"Virginia","Emporia city",4,22,74,36,38
050,51,595,"Virginia","Emporia city",4,23,55,24,31
050,51,595,"Virginia","Emporia city",4,24,59,27,32
050,51,595,"Virginia","Emporia city",4,25,55,24,31
050,51,595,"Virginia","Emporia city",4,26,53,25,28
050,51,595,"Virginia","Emporia city",4,27,59,32,27
050,51,595,"Virginia","Emporia city",4,28,54,23,31
050,51,595,"Virginia","Emporia city",4,29,66,22,44
050,51,595,"Virginia","Emporia city",4,30,65,26,39
050,51,595,"Virginia","Emporia city",4,31,87,40,47
050,51,595,"Virginia","Emporia city",4,32,76,32,44
050,51,595,"Virginia","Emporia city",4,33,70,28,42
050,51,595,"Virginia","Emporia city",4,34,65,35,30
050,51,595,"Virginia","Emporia city",4,35,63,27,36
050,51,595,"Virginia","Emporia city",4,36,71,33,38
050,51,595,"Virginia","Emporia city",4,37,59,26,33
050,51,595,"Virginia","Emporia city",4,38,55,22,33
050,51,595,"Virginia","Emporia city",4,39,61,23,38
050,51,595,"Virginia","Emporia city",4,40,46,18,28
050,51,595,"Virginia","Emporia city",4,41,61,20,41
050,51,595,"Virginia","Emporia city",4,42,73,31,42
050,51,595,"Virginia","Emporia city",4,43,50,23,27
050,51,595,"Virginia","Emporia city",4,44,50,17,33
050,51,595,"Virginia","Emporia city",4,45,53,21,32
050,51,595,"Virginia","Emporia city",4,46,58,24,34
050,51,595,"Virginia","Emporia city",4,47,75,41,34
050,51,595,"Virginia","Emporia city",4,48,53,27,26
050,51,595,"Virginia","Emporia city",4,49,68,30,38
050,51,595,"Virginia","Emporia city",4,50,66,28,38
050,51,595,"Virginia","Emporia city",4,51,70,36,34
050,51,595,"Virginia","Emporia city",4,52,65,31,34
050,51,595,"Virginia","Emporia city",4,53,64,38,26
050,51,595,"Virginia","Emporia city",4,54,70,36,34
050,51,595,"Virginia","Emporia city",4,55,66,30,36
050,51,595,"Virginia","Emporia city",4,56,65,32,33
050,51,595,"Virginia","Emporia city",4,57,71,31,40
050,51,595,"Virginia","Emporia city",4,58,74,33,41
050,51,595,"Virginia","Emporia city",4,59,70,28,42
050,51,595,"Virginia","Emporia city",4,60,81,33,48
050,51,595,"Virginia","Emporia city",4,61,71,34,37
050,51,595,"Virginia","Emporia city",4,62,65,26,39
050,51,595,"Virginia","Emporia city",4,63,70,31,39
050,51,595,"Virginia","Emporia city",4,64,78,35,43
050,51,595,"Virginia","Emporia city",4,65,66,29,37
050,51,595,"Virginia","Emporia city",4,66,73,34,39
050,51,595,"Virginia","Emporia city",4,67,69,35,34
050,51,595,"Virginia","Emporia city",4,68,68,38,30
050,51,595,"Virginia","Emporia city",4,69,61,30,31
050,51,595,"Virginia","Emporia city",4,70,53,20,33
050,51,595,"Virginia","Emporia city",4,71,49,26,23
050,51,595,"Virginia","Emporia city",4,72,47,19,28
050,51,595,"Virginia","Emporia city",4,73,40,13,27
050,51,595,"Virginia","Emporia city",4,74,51,21,30
050,51,595,"Virginia","Emporia city",4,75,61,26,35
050,51,595,"Virginia","Emporia city",4,76,43,17,26
050,51,595,"Virginia","Emporia city",4,77,38,14,24
050,51,595,"Virginia","Emporia city",4,78,33,18,15
050,51,595,"Virginia","Emporia city",4,79,30,18,12
050,51,595,"Virginia","Emporia city",4,80,38,21,17
050,51,595,"Virginia","Emporia city",4,81,30,11,19
050,51,595,"Virginia","Emporia city",4,82,23,7,16
050,51,595,"Virginia","Emporia city",4,83,21,9,12
050,51,595,"Virginia","Emporia city",4,84,18,8,10
050,51,595,"Virginia","Emporia city",4,85,173,50,123
050,51,595,"Virginia","Emporia city",5,0,67,36,31
050,51,595,"Virginia","Emporia city",5,1,66,34,32
050,51,595,"Virginia","Emporia city",5,2,69,42,27
050,51,595,"Virginia","Emporia city",5,3,78,42,36
050,51,595,"Virginia","Emporia city",5,4,80,43,37
050,51,595,"Virginia","Emporia city",5,5,93,58,35
050,51,595,"Virginia","Emporia city",5,6,89,50,39
050,51,595,"Virginia","Emporia city",5,7,86,44,42
050,51,595,"Virginia","Emporia city",5,8,82,39,43
050,51,595,"Virginia","Emporia city",5,9,74,42,32
050,51,595,"Virginia","Emporia city",5,10,67,27,40
050,51,595,"Virginia","Emporia city",5,11,66,30,36
050,51,595,"Virginia","Emporia city",5,12,81,45,36
050,51,595,"Virginia","Emporia city",5,13,84,41,43
050,51,595,"Virginia","Emporia city",5,14,85,41,44
050,51,595,"Virginia","Emporia city",5,15,87,48,39
050,51,595,"Virginia","Emporia city",5,16,85,46,39
050,51,595,"Virginia","Emporia city",5,17,82,43,39
050,51,595,"Virginia","Emporia city",5,18,63,33,30
050,51,595,"Virginia","Emporia city",5,19,62,32,30
050,51,595,"Virginia","Emporia city",5,20,55,29,26
050,51,595,"Virginia","Emporia city",5,21,54,30,24
050,51,595,"Virginia","Emporia city",5,22,66,30,36
050,51,595,"Virginia","Emporia city",5,23,73,35,38
050,51,595,"Virginia","Emporia city",5,24,57,26,31
050,51,595,"Virginia","Emporia city",5,25,64,30,34
050,51,595,"Virginia","Emporia city",5,26,60,24,36
050,51,595,"Virginia","Emporia city",5,27,53,26,27
050,51,595,"Virginia","Emporia city",5,28,57,26,31
050,51,595,"Virginia","Emporia city",5,29,56,26,30
050,51,595,"Virginia","Emporia city",5,30,61,18,43
050,51,595,"Virginia","Emporia city",5,31,72,30,42
050,51,595,"Virginia","Emporia city",5,32,86,35,51
050,51,595,"Virginia","Emporia city",5,33,77,34,43
050,51,595,"Virginia","Emporia city",5,34,60,22,38
050,51,595,"Virginia","Emporia city",5,35,62,33,29
050,51,595,"Virginia","Emporia city",5,36,64,27,37
050,51,595,"Virginia","Emporia city",5,37,70,35,35
050,51,595,"Virginia","Emporia city",5,38,55,25,30
050,51,595,"Virginia","Emporia city",5,39,55,23,32
050,51,595,"Virginia","Emporia city",5,40,58,25,33
050,51,595,"Virginia","Emporia city",5,41,47,18,29
050,51,595,"Virginia","Emporia city",5,42,64,27,37
050,51,595,"Virginia","Emporia city",5,43,73,31,42
050,51,595,"Virginia","Emporia city",5,44,46,21,25
050,51,595,"Virginia","Emporia city",5,45,52,22,30
050,51,595,"Virginia","Emporia city",5,46,44,15,29
050,51,595,"Virginia","Emporia city",5,47,58,24,34
050,51,595,"Virginia","Emporia city",5,48,73,37,36
050,51,595,"Virginia","Emporia city",5,49,49,27,22
050,51,595,"Virginia","Emporia city",5,50,66,29,37
050,51,595,"Virginia","Emporia city",5,51,56,22,34
050,51,595,"Virginia","Emporia city",5,52,67,32,35
050,51,595,"Virginia","Emporia city",5,53,66,30,36
050,51,595,"Virginia","Emporia city",5,54,58,34,24
050,51,595,"Virginia","Emporia city",5,55,67,36,31
050,51,595,"Virginia","Emporia city",5,56,63,28,35
050,51,595,"Virginia","Emporia city",5,57,64,29,35
050,51,595,"Virginia","Emporia city",5,58,68,32,36
050,51,595,"Virginia","Emporia city",5,59,75,34,41
050,51,595,"Virginia","Emporia city",5,60,73,28,45
050,51,595,"Virginia","Emporia city",5,61,79,32,47
050,51,595,"Virginia","Emporia city",5,62,69,30,39
050,51,595,"Virginia","Emporia city",5,63,61,26,35
050,51,595,"Virginia","Emporia city",5,64,76,34,42
050,51,595,"Virginia","Emporia city",5,65,76,34,42
050,51,595,"Virginia","Emporia city",5,66,66,29,37
050,51,595,"Virginia","Emporia city",5,67,70,31,39
050,51,595,"Virginia","Emporia city",5,68,67,31,36
050,51,595,"Virginia","Emporia city",5,69,71,38,33
050,51,595,"Virginia","Emporia city",5,70,60,30,30
050,51,595,"Virginia","Emporia city",5,71,49,19,30
050,51,595,"Virginia","Emporia city",5,72,48,24,24
050,51,595,"Virginia","Emporia city",5,73,45,18,27
050,51,595,"Virginia","Emporia city",5,74,38,15,23
050,51,595,"Virginia","Emporia city",5,75,49,21,28
050,51,595,"Virginia","Emporia city",5,76,61,27,34
050,51,595,"Virginia","Emporia city",5,77,39,17,22
050,51,595,"Virginia","Emporia city",5,78,32,10,22
050,51,595,"Virginia","Emporia city",5,79,28,15,13
050,51,595,"Virginia","Emporia city",5,80,32,19,13
050,51,595,"Virginia","Emporia city",5,81,32,17,15
050,51,595,"Virginia","Emporia city",5,82,23,5,18
050,51,595,"Virginia","Emporia city",5,83,26,9,17
050,51,595,"Virginia","Emporia city",5,84,15,8,7
050,51,595,"Virginia","Emporia city",5,85,161,50,111
050,51,600,"Virginia","Fairfax city",1,0,490,253,237
050,51,600,"Virginia","Fairfax city",1,1,321,161,160
050,51,600,"Virginia","Fairfax city",1,2,315,158,157
050,51,600,"Virginia","Fairfax city",1,3,349,184,165
050,51,600,"Virginia","Fairfax city",1,4,351,177,174
050,51,600,"Virginia","Fairfax city",1,5,301,153,148
050,51,600,"Virginia","Fairfax city",1,6,293,147,146
050,51,600,"Virginia","Fairfax city",1,7,276,142,134
050,51,600,"Virginia","Fairfax city",1,8,293,155,138
050,51,600,"Virginia","Fairfax city",1,9,290,150,140
050,51,600,"Virginia","Fairfax city",1,10,312,158,154
050,51,600,"Virginia","Fairfax city",1,11,254,136,118
050,51,600,"Virginia","Fairfax city",1,12,285,149,136
050,51,600,"Virginia","Fairfax city",1,13,295,155,140
050,51,600,"Virginia","Fairfax city",1,14,287,154,133
050,51,600,"Virginia","Fairfax city",1,15,295,152,143
050,51,600,"Virginia","Fairfax city",1,16,281,133,148
050,51,600,"Virginia","Fairfax city",1,17,275,140,135
050,51,600,"Virginia","Fairfax city",1,18,260,132,128
050,51,600,"Virginia","Fairfax city",1,19,240,113,127
050,51,600,"Virginia","Fairfax city",1,20,283,125,158
050,51,600,"Virginia","Fairfax city",1,21,299,151,148
050,51,600,"Virginia","Fairfax city",1,22,339,160,179
050,51,600,"Virginia","Fairfax city",1,23,332,165,167
050,51,600,"Virginia","Fairfax city",1,24,341,175,166
050,51,600,"Virginia","Fairfax city",1,25,331,164,167
050,51,600,"Virginia","Fairfax city",1,26,313,160,153
050,51,600,"Virginia","Fairfax city",1,27,331,177,154
050,51,600,"Virginia","Fairfax city",1,28,333,173,160
050,51,600,"Virginia","Fairfax city",1,29,345,177,168
050,51,600,"Virginia","Fairfax city",1,30,373,213,160
050,51,600,"Virginia","Fairfax city",1,31,330,166,164
050,51,600,"Virginia","Fairfax city",1,32,373,201,172
050,51,600,"Virginia","Fairfax city",1,33,363,184,179
050,51,600,"Virginia","Fairfax city",1,34,338,178,160
050,51,600,"Virginia","Fairfax city",1,35,338,168,170
050,51,600,"Virginia","Fairfax city",1,36,332,169,163
050,51,600,"Virginia","Fairfax city",1,37,343,162,181
050,51,600,"Virginia","Fairfax city",1,38,330,162,168
050,51,600,"Virginia","Fairfax city",1,39,326,166,160
050,51,600,"Virginia","Fairfax city",1,40,364,192,172
050,51,600,"Virginia","Fairfax city",1,41,321,153,168
050,51,600,"Virginia","Fairfax city",1,42,318,155,163
050,51,600,"Virginia","Fairfax city",1,43,293,137,156
050,51,600,"Virginia","Fairfax city",1,44,292,130,162
050,51,600,"Virginia","Fairfax city",1,45,314,160,154
050,51,600,"Virginia","Fairfax city",1,46,277,134,143
050,51,600,"Virginia","Fairfax city",1,47,293,155,138
050,51,600,"Virginia","Fairfax city",1,48,329,171,158
050,51,600,"Virginia","Fairfax city",1,49,354,174,180
050,51,600,"Virginia","Fairfax city",1,50,326,167,159
050,51,600,"Virginia","Fairfax city",1,51,309,161,148
050,51,600,"Virginia","Fairfax city",1,52,303,165,138
050,51,600,"Virginia","Fairfax city",1,53,302,146,156
050,51,600,"Virginia","Fairfax city",1,54,322,154,168
050,51,600,"Virginia","Fairfax city",1,55,327,149,178
050,51,600,"Virginia","Fairfax city",1,56,368,177,191
050,51,600,"Virginia","Fairfax city",1,57,344,168,176
050,51,600,"Virginia","Fairfax city",1,58,353,175,178
050,51,600,"Virginia","Fairfax city",1,59,327,156,171
050,51,600,"Virginia","Fairfax city",1,60,306,146,160
050,51,600,"Virginia","Fairfax city",1,61,317,165,152
050,51,600,"Virginia","Fairfax city",1,62,320,160,160
050,51,600,"Virginia","Fairfax city",1,63,270,134,136
050,51,600,"Virginia","Fairfax city",1,64,272,136,136
050,51,600,"Virginia","Fairfax city",1,65,264,136,128
050,51,600,"Virginia","Fairfax city",1,66,216,102,114
050,51,600,"Virginia","Fairfax city",1,67,199,87,112
050,51,600,"Virginia","Fairfax city",1,68,219,97,122
050,51,600,"Virginia","Fairfax city",1,69,220,100,120
050,51,600,"Virginia","Fairfax city",1,70,213,102,111
050,51,600,"Virginia","Fairfax city",1,71,216,97,119
050,51,600,"Virginia","Fairfax city",1,72,223,102,121
050,51,600,"Virginia","Fairfax city",1,73,207,98,109
050,51,600,"Virginia","Fairfax city",1,74,143,68,75
050,51,600,"Virginia","Fairfax city",1,75,142,51,91
050,51,600,"Virginia","Fairfax city",1,76,132,53,79
050,51,600,"Virginia","Fairfax city",1,77,127,60,67
050,51,600,"Virginia","Fairfax city",1,78,97,46,51
050,51,600,"Virginia","Fairfax city",1,79,90,35,55
050,51,600,"Virginia","Fairfax city",1,80,96,48,48
050,51,600,"Virginia","Fairfax city",1,81,89,41,48
050,51,600,"Virginia","Fairfax city",1,82,85,35,50
050,51,600,"Virginia","Fairfax city",1,83,70,24,46
050,51,600,"Virginia","Fairfax city",1,84,62,21,41
050,51,600,"Virginia","Fairfax city",1,85,360,98,262
050,51,600,"Virginia","Fairfax city",2,0,521,274,247
050,51,600,"Virginia","Fairfax city",2,1,357,183,174
050,51,600,"Virginia","Fairfax city",2,2,316,159,157
050,51,600,"Virginia","Fairfax city",2,3,342,175,167
050,51,600,"Virginia","Fairfax city",2,4,347,175,172
050,51,600,"Virginia","Fairfax city",2,5,313,159,154
050,51,600,"Virginia","Fairfax city",2,6,294,148,146
050,51,600,"Virginia","Fairfax city",2,7,280,144,136
050,51,600,"Virginia","Fairfax city",2,8,285,150,135
050,51,600,"Virginia","Fairfax city",2,9,296,153,143
050,51,600,"Virginia","Fairfax city",2,10,306,157,149
050,51,600,"Virginia","Fairfax city",2,11,267,140,127
050,51,600,"Virginia","Fairfax city",2,12,277,144,133
050,51,600,"Virginia","Fairfax city",2,13,288,151,137
050,51,600,"Virginia","Fairfax city",2,14,293,157,136
050,51,600,"Virginia","Fairfax city",2,15,296,152,144
050,51,600,"Virginia","Fairfax city",2,16,287,139,148
050,51,600,"Virginia","Fairfax city",2,17,278,139,139
050,51,600,"Virginia","Fairfax city",2,18,257,131,126
050,51,600,"Virginia","Fairfax city",2,19,248,117,131
050,51,600,"Virginia","Fairfax city",2,20,288,131,157
050,51,600,"Virginia","Fairfax city",2,21,298,150,148
050,51,600,"Virginia","Fairfax city",2,22,327,158,169
050,51,600,"Virginia","Fairfax city",2,23,332,165,167
050,51,600,"Virginia","Fairfax city",2,24,335,169,166
050,51,600,"Virginia","Fairfax city",2,25,328,165,163
050,51,600,"Virginia","Fairfax city",2,26,318,162,156
050,51,600,"Virginia","Fairfax city",2,27,329,174,155
050,51,600,"Virginia","Fairfax city",2,28,328,170,158
050,51,600,"Virginia","Fairfax city",2,29,347,180,167
050,51,600,"Virginia","Fairfax city",2,30,365,200,165
050,51,600,"Virginia","Fairfax city",2,31,340,175,165
050,51,600,"Virginia","Fairfax city",2,32,369,193,176
050,51,600,"Virginia","Fairfax city",2,33,362,186,176
050,51,600,"Virginia","Fairfax city",2,34,343,180,163
050,51,600,"Virginia","Fairfax city",2,35,338,173,165
050,51,600,"Virginia","Fairfax city",2,36,332,167,165
050,51,600,"Virginia","Fairfax city",2,37,339,162,177
050,51,600,"Virginia","Fairfax city",2,38,329,161,168
050,51,600,"Virginia","Fairfax city",2,39,322,163,159
050,51,600,"Virginia","Fairfax city",2,40,353,183,170
050,51,600,"Virginia","Fairfax city",2,41,331,162,169
050,51,600,"Virginia","Fairfax city",2,42,315,153,162
050,51,600,"Virginia","Fairfax city",2,43,303,142,161
050,51,600,"Virginia","Fairfax city",2,44,292,130,162
050,51,600,"Virginia","Fairfax city",2,45,307,151,156
050,51,600,"Virginia","Fairfax city",2,46,283,141,142
050,51,600,"Virginia","Fairfax city",2,47,286,149,137
050,51,600,"Virginia","Fairfax city",2,48,319,167,152
050,51,600,"Virginia","Fairfax city",2,49,347,172,175
050,51,600,"Virginia","Fairfax city",2,50,332,168,164
050,51,600,"Virginia","Fairfax city",2,51,311,161,150
050,51,600,"Virginia","Fairfax city",2,52,305,164,141
050,51,600,"Virginia","Fairfax city",2,53,300,149,151
050,51,600,"Virginia","Fairfax city",2,54,313,151,162
050,51,600,"Virginia","Fairfax city",2,55,325,150,175
050,51,600,"Virginia","Fairfax city",2,56,356,170,186
050,51,600,"Virginia","Fairfax city",2,57,346,168,178
050,51,600,"Virginia","Fairfax city",2,58,347,171,176
050,51,600,"Virginia","Fairfax city",2,59,334,162,172
050,51,600,"Virginia","Fairfax city",2,60,310,146,164
050,51,600,"Virginia","Fairfax city",2,61,311,159,152
050,51,600,"Virginia","Fairfax city",2,62,314,159,155
050,51,600,"Virginia","Fairfax city",2,63,281,140,141
050,51,600,"Virginia","Fairfax city",2,64,267,133,134
050,51,600,"Virginia","Fairfax city",2,65,263,133,130
050,51,600,"Virginia","Fairfax city",2,66,227,109,118
050,51,600,"Virginia","Fairfax city",2,67,202,91,111
050,51,600,"Virginia","Fairfax city",2,68,210,92,118
050,51,600,"Virginia","Fairfax city",2,69,218,98,120
050,51,600,"Virginia","Fairfax city",2,70,211,99,112
050,51,600,"Virginia","Fairfax city",2,71,214,98,116
050,51,600,"Virginia","Fairfax city",2,72,218,99,119
050,51,600,"Virginia","Fairfax city",2,73,216,102,114
050,51,600,"Virginia","Fairfax city",2,74,146,70,76
050,51,600,"Virginia","Fairfax city",2,75,141,56,85
050,51,600,"Virginia","Fairfax city",2,76,132,51,81
050,51,600,"Virginia","Fairfax city",2,77,127,57,70
050,51,600,"Virginia","Fairfax city",2,78,103,48,55
050,51,600,"Virginia","Fairfax city",2,79,90,36,54
050,51,600,"Virginia","Fairfax city",2,80,93,44,49
050,51,600,"Virginia","Fairfax city",2,81,88,41,47
050,51,600,"Virginia","Fairfax city",2,82,85,35,50
050,51,600,"Virginia","Fairfax city",2,83,73,27,46
050,51,600,"Virginia","Fairfax city",2,84,64,22,42
050,51,600,"Virginia","Fairfax city",2,85,351,93,258
050,51,600,"Virginia","Fairfax city",3,0,589,305,284
050,51,600,"Virginia","Fairfax city",3,1,491,265,226
050,51,600,"Virginia","Fairfax city",3,2,367,177,190
050,51,600,"Virginia","Fairfax city",3,3,289,144,145
050,51,600,"Virginia","Fairfax city",3,4,318,167,151
050,51,600,"Virginia","Fairfax city",3,5,323,164,159
050,51,600,"Virginia","Fairfax city",3,6,285,152,133
050,51,600,"Virginia","Fairfax city",3,7,284,141,143
050,51,600,"Virginia","Fairfax city",3,8,282,144,138
050,51,600,"Virginia","Fairfax city",3,9,271,138,133
050,51,600,"Virginia","Fairfax city",3,10,298,160,138
050,51,600,"Virginia","Fairfax city",3,11,317,163,154
050,51,600,"Virginia","Fairfax city",3,12,250,137,113
050,51,600,"Virginia","Fairfax city",3,13,272,137,135
050,51,600,"Virginia","Fairfax city",3,14,280,149,131
050,51,600,"Virginia","Fairfax city",3,15,291,158,133
050,51,600,"Virginia","Fairfax city",3,16,283,147,136
050,51,600,"Virginia","Fairfax city",3,17,291,136,155
050,51,600,"Virginia","Fairfax city",3,18,256,130,126
050,51,600,"Virginia","Fairfax city",3,19,244,123,121
050,51,600,"Virginia","Fairfax city",3,20,277,128,149
050,51,600,"Virginia","Fairfax city",3,21,307,153,154
050,51,600,"Virginia","Fairfax city",3,22,346,170,176
050,51,600,"Virginia","Fairfax city",3,23,331,159,172
050,51,600,"Virginia","Fairfax city",3,24,334,159,175
050,51,600,"Virginia","Fairfax city",3,25,325,178,147
050,51,600,"Virginia","Fairfax city",3,26,381,189,192
050,51,600,"Virginia","Fairfax city",3,27,317,159,158
050,51,600,"Virginia","Fairfax city",3,28,322,162,160
050,51,600,"Virginia","Fairfax city",3,29,373,204,169
050,51,600,"Virginia","Fairfax city",3,30,346,179,167
050,51,600,"Virginia","Fairfax city",3,31,383,207,176
050,51,600,"Virginia","Fairfax city",3,32,355,188,167
050,51,600,"Virginia","Fairfax city",3,33,367,187,180
050,51,600,"Virginia","Fairfax city",3,34,368,180,188
050,51,600,"Virginia","Fairfax city",3,35,339,175,164
050,51,600,"Virginia","Fairfax city",3,36,340,188,152
050,51,600,"Virginia","Fairfax city",3,37,332,171,161
050,51,600,"Virginia","Fairfax city",3,38,338,160,178
050,51,600,"Virginia","Fairfax city",3,39,332,156,176
050,51,600,"Virginia","Fairfax city",3,40,318,153,165
050,51,600,"Virginia","Fairfax city",3,41,343,181,162
050,51,600,"Virginia","Fairfax city",3,42,330,152,178
050,51,600,"Virginia","Fairfax city",3,43,303,151,152
050,51,600,"Virginia","Fairfax city",3,44,284,132,152
050,51,600,"Virginia","Fairfax city",3,45,284,128,156
050,51,600,"Virginia","Fairfax city",3,46,300,144,156
050,51,600,"Virginia","Fairfax city",3,47,277,140,137
050,51,600,"Virginia","Fairfax city",3,48,285,143,142
050,51,600,"Virginia","Fairfax city",3,49,304,164,140
050,51,600,"Virginia","Fairfax city",3,50,341,167,174
050,51,600,"Virginia","Fairfax city",3,51,321,168,153
050,51,600,"Virginia","Fairfax city",3,52,310,162,148
050,51,600,"Virginia","Fairfax city",3,53,297,153,144
050,51,600,"Virginia","Fairfax city",3,54,283,132,151
050,51,600,"Virginia","Fairfax city",3,55,301,144,157
050,51,600,"Virginia","Fairfax city",3,56,327,147,180
050,51,600,"Virginia","Fairfax city",3,57,358,168,190
050,51,600,"Virginia","Fairfax city",3,58,349,171,178
050,51,600,"Virginia","Fairfax city",3,59,336,168,168
050,51,600,"Virginia","Fairfax city",3,60,331,152,179
050,51,600,"Virginia","Fairfax city",3,61,302,145,157
050,51,600,"Virginia","Fairfax city",3,62,300,150,150
050,51,600,"Virginia","Fairfax city",3,63,301,158,143
050,51,600,"Virginia","Fairfax city",3,64,278,136,142
050,51,600,"Virginia","Fairfax city",3,65,270,133,137
050,51,600,"Virginia","Fairfax city",3,66,255,130,125
050,51,600,"Virginia","Fairfax city",3,67,230,110,120
050,51,600,"Virginia","Fairfax city",3,68,198,92,106
050,51,600,"Virginia","Fairfax city",3,69,208,91,117
050,51,600,"Virginia","Fairfax city",3,70,208,94,114
050,51,600,"Virginia","Fairfax city",3,71,204,94,110
050,51,600,"Virginia","Fairfax city",3,72,206,91,115
050,51,600,"Virginia","Fairfax city",3,73,199,87,112
050,51,600,"Virginia","Fairfax city",3,74,200,94,106
050,51,600,"Virginia","Fairfax city",3,75,135,63,72
050,51,600,"Virginia","Fairfax city",3,76,130,51,79
050,51,600,"Virginia","Fairfax city",3,77,119,46,73
050,51,600,"Virginia","Fairfax city",3,78,122,55,67
050,51,600,"Virginia","Fairfax city",3,79,96,46,50
050,51,600,"Virginia","Fairfax city",3,80,86,33,53
050,51,600,"Virginia","Fairfax city",3,81,83,37,46
050,51,600,"Virginia","Fairfax city",3,82,88,40,48
050,51,600,"Virginia","Fairfax city",3,83,74,30,44
050,51,600,"Virginia","Fairfax city",3,84,65,25,40
050,51,600,"Virginia","Fairfax city",3,85,320,72,248
050,51,600,"Virginia","Fairfax city",4,0,620,327,293
050,51,600,"Virginia","Fairfax city",4,1,563,265,298
050,51,600,"Virginia","Fairfax city",4,2,453,236,217
050,51,600,"Virginia","Fairfax city",4,3,382,186,196
050,51,600,"Virginia","Fairfax city",4,4,288,139,149
050,51,600,"Virginia","Fairfax city",4,5,318,167,151
050,51,600,"Virginia","Fairfax city",4,6,325,167,158
050,51,600,"Virginia","Fairfax city",4,7,308,163,145
050,51,600,"Virginia","Fairfax city",4,8,282,146,136
050,51,600,"Virginia","Fairfax city",4,9,294,152,142
050,51,600,"Virginia","Fairfax city",4,10,303,161,142
050,51,600,"Virginia","Fairfax city",4,11,325,179,146
050,51,600,"Virginia","Fairfax city",4,12,315,162,153
050,51,600,"Virginia","Fairfax city",4,13,271,148,123
050,51,600,"Virginia","Fairfax city",4,14,285,143,142
050,51,600,"Virginia","Fairfax city",4,15,292,156,136
050,51,600,"Virginia","Fairfax city",4,16,296,156,140
050,51,600,"Virginia","Fairfax city",4,17,288,139,149
050,51,600,"Virginia","Fairfax city",4,18,269,133,136
050,51,600,"Virginia","Fairfax city",4,19,249,114,135
050,51,600,"Virginia","Fairfax city",4,20,271,136,135
050,51,600,"Virginia","Fairfax city",4,21,302,147,155
050,51,600,"Virginia","Fairfax city",4,22,333,156,177
050,51,600,"Virginia","Fairfax city",4,23,346,170,176
050,51,600,"Virginia","Fairfax city",4,24,313,151,162
050,51,600,"Virginia","Fairfax city",4,25,370,195,175
050,51,600,"Virginia","Fairfax city",4,26,307,154,153
050,51,600,"Virginia","Fairfax city",4,27,338,166,172
050,51,600,"Virginia","Fairfax city",4,28,299,148,151
050,51,600,"Virginia","Fairfax city",4,29,326,185,141
050,51,600,"Virginia","Fairfax city",4,30,386,205,181
050,51,600,"Virginia","Fairfax city",4,31,393,184,209
050,51,600,"Virginia","Fairfax city",4,32,380,209,171
050,51,600,"Virginia","Fairfax city",4,33,368,197,171
050,51,600,"Virginia","Fairfax city",4,34,383,205,178
050,51,600,"Virginia","Fairfax city",4,35,336,166,170
050,51,600,"Virginia","Fairfax city",4,36,351,178,173
050,51,600,"Virginia","Fairfax city",4,37,347,192,155
050,51,600,"Virginia","Fairfax city",4,38,330,170,160
050,51,600,"Virginia","Fairfax city",4,39,344,170,174
050,51,600,"Virginia","Fairfax city",4,40,335,152,183
050,51,600,"Virginia","Fairfax city",4,41,334,166,168
050,51,600,"Virginia","Fairfax city",4,42,335,174,161
050,51,600,"Virginia","Fairfax city",4,43,341,164,177
050,51,600,"Virginia","Fairfax city",4,44,304,151,153
050,51,600,"Virginia","Fairfax city",4,45,278,126,152
050,51,600,"Virginia","Fairfax city",4,46,291,134,157
050,51,600,"Virginia","Fairfax city",4,47,290,138,152
050,51,600,"Virginia","Fairfax city",4,48,276,135,141
050,51,600,"Virginia","Fairfax city",4,49,280,141,139
050,51,600,"Virginia","Fairfax city",4,50,299,154,145
050,51,600,"Virginia","Fairfax city",4,51,339,165,174
050,51,600,"Virginia","Fairfax city",4,52,323,165,158
050,51,600,"Virginia","Fairfax city",4,53,305,146,159
050,51,600,"Virginia","Fairfax city",4,54,289,146,143
050,51,600,"Virginia","Fairfax city",4,55,280,139,141
050,51,600,"Virginia","Fairfax city",4,56,299,140,159
050,51,600,"Virginia","Fairfax city",4,57,312,137,175
050,51,600,"Virginia","Fairfax city",4,58,344,169,175
050,51,600,"Virginia","Fairfax city",4,59,321,155,166
050,51,600,"Virginia","Fairfax city",4,60,317,154,163
050,51,600,"Virginia","Fairfax city",4,61,332,152,180
050,51,600,"Virginia","Fairfax city",4,62,283,133,150
050,51,600,"Virginia","Fairfax city",4,63,294,151,143
050,51,600,"Virginia","Fairfax city",4,64,301,152,149
050,51,600,"Virginia","Fairfax city",4,65,262,132,130
050,51,600,"Virginia","Fairfax city",4,66,258,124,134
050,51,600,"Virginia","Fairfax city",4,67,243,122,121
050,51,600,"Virginia","Fairfax city",4,68,210,100,110
050,51,600,"Virginia","Fairfax city",4,69,187,85,102
050,51,600,"Virginia","Fairfax city",4,70,196,88,108
050,51,600,"Virginia","Fairfax city",4,71,205,91,114
050,51,600,"Virginia","Fairfax city",4,72,199,90,109
050,51,600,"Virginia","Fairfax city",4,73,193,81,112
050,51,600,"Virginia","Fairfax city",4,74,189,81,108
050,51,600,"Virginia","Fairfax city",4,75,196,91,105
050,51,600,"Virginia","Fairfax city",4,76,134,61,73
050,51,600,"Virginia","Fairfax city",4,77,120,46,74
050,51,600,"Virginia","Fairfax city",4,78,119,44,75
050,51,600,"Virginia","Fairfax city",4,79,103,47,56
050,51,600,"Virginia","Fairfax city",4,80,96,45,51
050,51,600,"Virginia","Fairfax city",4,81,67,23,44
050,51,600,"Virginia","Fairfax city",4,82,79,33,46
050,51,600,"Virginia","Fairfax city",4,83,78,37,41
050,51,600,"Virginia","Fairfax city",4,84,61,27,34
050,51,600,"Virginia","Fairfax city",4,85,306,60,246
050,51,600,"Virginia","Fairfax city",5,0,611,327,284
050,51,600,"Virginia","Fairfax city",5,1,563,326,237
050,51,600,"Virginia","Fairfax city",5,2,539,262,277
050,51,600,"Virginia","Fairfax city",5,3,448,235,213
050,51,600,"Virginia","Fairfax city",5,4,377,188,189
050,51,600,"Virginia","Fairfax city",5,5,296,143,153
050,51,600,"Virginia","Fairfax city",5,6,322,171,151
050,51,600,"Virginia","Fairfax city",5,7,330,172,158
050,51,600,"Virginia","Fairfax city",5,8,308,161,147
050,51,600,"Virginia","Fairfax city",5,9,280,152,128
050,51,600,"Virginia","Fairfax city",5,10,320,168,152
050,51,600,"Virginia","Fairfax city",5,11,304,163,141
050,51,600,"Virginia","Fairfax city",5,12,316,176,140
050,51,600,"Virginia","Fairfax city",5,13,323,154,169
050,51,600,"Virginia","Fairfax city",5,14,273,152,121
050,51,600,"Virginia","Fairfax city",5,15,306,160,146
050,51,600,"Virginia","Fairfax city",5,16,294,161,133
050,51,600,"Virginia","Fairfax city",5,17,308,154,154
050,51,600,"Virginia","Fairfax city",5,18,258,122,136
050,51,600,"Virginia","Fairfax city",5,19,259,128,131
050,51,600,"Virginia","Fairfax city",5,20,286,127,159
050,51,600,"Virginia","Fairfax city",5,21,288,153,135
050,51,600,"Virginia","Fairfax city",5,22,334,148,186
050,51,600,"Virginia","Fairfax city",5,23,353,156,197
050,51,600,"Virginia","Fairfax city",5,24,331,177,154
050,51,600,"Virginia","Fairfax city",5,25,334,184,150
050,51,600,"Virginia","Fairfax city",5,26,401,201,200
050,51,600,"Virginia","Fairfax city",5,27,316,158,158
050,51,600,"Virginia","Fairfax city",5,28,340,171,169
050,51,600,"Virginia","Fairfax city",5,29,319,165,154
050,51,600,"Virginia","Fairfax city",5,30,347,184,163
050,51,600,"Virginia","Fairfax city",5,31,384,185,199
050,51,600,"Virginia","Fairfax city",5,32,365,174,191
050,51,600,"Virginia","Fairfax city",5,33,357,198,159
050,51,600,"Virginia","Fairfax city",5,34,350,189,161
050,51,600,"Virginia","Fairfax city",5,35,369,198,171
050,51,600,"Virginia","Fairfax city",5,36,339,165,174
050,51,600,"Virginia","Fairfax city",5,37,343,170,173
050,51,600,"Virginia","Fairfax city",5,38,353,193,160
050,51,600,"Virginia","Fairfax city",5,39,331,167,164
050,51,600,"Virginia","Fairfax city",5,40,342,171,171
050,51,600,"Virginia","Fairfax city",5,41,338,153,185
050,51,600,"Virginia","Fairfax city",5,42,336,163,173
050,51,600,"Virginia","Fairfax city",5,43,348,181,167
050,51,600,"Virginia","Fairfax city",5,44,345,173,172
050,51,600,"Virginia","Fairfax city",5,45,308,153,155
050,51,600,"Virginia","Fairfax city",5,46,279,134,145
050,51,600,"Virginia","Fairfax city",5,47,297,148,149
050,51,600,"Virginia","Fairfax city",5,48,292,145,147
050,51,600,"Virginia","Fairfax city",5,49,277,135,142
050,51,600,"Virginia","Fairfax city",5,50,288,149,139
050,51,600,"Virginia","Fairfax city",5,51,293,158,135
050,51,600,"Virginia","Fairfax city",5,52,341,164,177
050,51,600,"Virginia","Fairfax city",5,53,310,154,156
050,51,600,"Virginia","Fairfax city",5,54,311,156,155
050,51,600,"Virginia","Fairfax city",5,55,279,150,129
050,51,600,"Virginia","Fairfax city",5,56,279,139,140
050,51,600,"Virginia","Fairfax city",5,57,283,129,154
050,51,600,"Virginia","Fairfax city",5,58,308,132,176
050,51,600,"Virginia","Fairfax city",5,59,339,170,169
050,51,600,"Virginia","Fairfax city",5,60,317,150,167
050,51,600,"Virginia","Fairfax city",5,61,307,155,152
050,51,600,"Virginia","Fairfax city",5,62,320,143,177
050,51,600,"Virginia","Fairfax city",5,63,269,131,138
050,51,600,"Virginia","Fairfax city",5,64,277,138,139
050,51,600,"Virginia","Fairfax city",5,65,290,145,145
050,51,600,"Virginia","Fairfax city",5,66,249,124,125
050,51,600,"Virginia","Fairfax city",5,67,259,126,133
050,51,600,"Virginia","Fairfax city",5,68,225,114,111
050,51,600,"Virginia","Fairfax city",5,69,212,101,111
050,51,600,"Virginia","Fairfax city",5,70,181,80,101
050,51,600,"Virginia","Fairfax city",5,71,194,85,109
050,51,600,"Virginia","Fairfax city",5,72,201,83,118
050,51,600,"Virginia","Fairfax city",5,73,195,86,109
050,51,600,"Virginia","Fairfax city",5,74,186,77,109
050,51,600,"Virginia","Fairfax city",5,75,179,77,102
050,51,600,"Virginia","Fairfax city",5,76,184,81,103
050,51,600,"Virginia","Fairfax city",5,77,125,60,65
050,51,600,"Virginia","Fairfax city",5,78,116,46,70
050,51,600,"Virginia","Fairfax city",5,79,109,37,72
050,51,600,"Virginia","Fairfax city",5,80,109,46,63
050,51,600,"Virginia","Fairfax city",5,81,78,34,44
050,51,600,"Virginia","Fairfax city",5,82,60,21,39
050,51,600,"Virginia","Fairfax city",5,83,72,30,42
050,51,600,"Virginia","Fairfax city",5,84,63,34,29
050,51,600,"Virginia","Fairfax city",5,85,299,60,239
050,51,610,"Virginia","Falls Church city",1,0,170,88,82
050,51,610,"Virginia","Falls Church city",1,1,158,92,66
050,51,610,"Virginia","Falls Church city",1,2,136,76,60
050,51,610,"Virginia","Falls Church city",1,3,168,80,88
050,51,610,"Virginia","Falls Church city",1,4,161,80,81
050,51,610,"Virginia","Falls Church city",1,5,186,101,85
050,51,610,"Virginia","Falls Church city",1,6,191,102,89
050,51,610,"Virginia","Falls Church city",1,7,190,104,86
050,51,610,"Virginia","Falls Church city",1,8,201,115,86
050,51,610,"Virginia","Falls Church city",1,9,204,98,106
050,51,610,"Virginia","Falls Church city",1,10,207,103,104
050,51,610,"Virginia","Falls Church city",1,11,232,106,126
050,51,610,"Virginia","Falls Church city",1,12,239,129,110
050,51,610,"Virginia","Falls Church city",1,13,226,101,125
050,51,610,"Virginia","Falls Church city",1,14,214,113,101
050,51,610,"Virginia","Falls Church city",1,15,231,122,109
050,51,610,"Virginia","Falls Church city",1,16,241,126,115
050,51,610,"Virginia","Falls Church city",1,17,218,122,96
050,51,610,"Virginia","Falls Church city",1,18,170,86,84
050,51,610,"Virginia","Falls Church city",1,19,142,71,71
050,51,610,"Virginia","Falls Church city",1,20,133,69,64
050,51,610,"Virginia","Falls Church city",1,21,132,61,71
050,51,610,"Virginia","Falls Church city",1,22,132,67,65
050,51,610,"Virginia","Falls Church city",1,23,167,74,93
050,51,610,"Virginia","Falls Church city",1,24,175,87,88
050,51,610,"Virginia","Falls Church city",1,25,183,97,86
050,51,610,"Virginia","Falls Church city",1,26,183,96,87
050,51,610,"Virginia","Falls Church city",1,27,188,99,89
050,51,610,"Virginia","Falls Church city",1,28,182,87,95
050,51,610,"Virginia","Falls Church city",1,29,166,94,72
050,51,610,"Virginia","Falls Church city",1,30,181,97,84
050,51,610,"Virginia","Falls Church city",1,31,177,89,88
050,51,610,"Virginia","Falls Church city",1,32,147,82,65
050,51,610,"Virginia","Falls Church city",1,33,160,86,74
050,51,610,"Virginia","Falls Church city",1,34,176,90,86
050,51,610,"Virginia","Falls Church city",1,35,187,84,103
050,51,610,"Virginia","Falls Church city",1,36,182,80,102
050,51,610,"Virginia","Falls Church city",1,37,205,94,111
050,51,610,"Virginia","Falls Church city",1,38,205,90,115
050,51,610,"Virginia","Falls Church city",1,39,188,93,95
050,51,610,"Virginia","Falls Church city",1,40,201,91,110
050,51,610,"Virginia","Falls Church city",1,41,231,105,126
050,51,610,"Virginia","Falls Church city",1,42,222,104,118
050,51,610,"Virginia","Falls Church city",1,43,213,103,110
050,51,610,"Virginia","Falls Church city",1,44,246,125,121
050,51,610,"Virginia","Falls Church city",1,45,230,114,116
050,51,610,"Virginia","Falls Church city",1,46,232,126,106
050,51,610,"Virginia","Falls Church city",1,47,218,110,108
050,51,610,"Virginia","Falls Church city",1,48,238,127,111
050,51,610,"Virginia","Falls Church city",1,49,233,117,116
050,51,610,"Virginia","Falls Church city",1,50,212,110,102
050,51,610,"Virginia","Falls Church city",1,51,217,106,111
050,51,610,"Virginia","Falls Church city",1,52,213,98,115
050,51,610,"Virginia","Falls Church city",1,53,198,97,101
050,51,610,"Virginia","Falls Church city",1,54,189,96,93
050,51,610,"Virginia","Falls Church city",1,55,207,104,103
050,51,610,"Virginia","Falls Church city",1,56,190,95,95
050,51,610,"Virginia","Falls Church city",1,57,184,95,89
050,51,610,"Virginia","Falls Church city",1,58,178,93,85
050,51,610,"Virginia","Falls Church city",1,59,178,106,72
050,51,610,"Virginia","Falls Church city",1,60,209,114,95
050,51,610,"Virginia","Falls Church city",1,61,198,95,103
050,51,610,"Virginia","Falls Church city",1,62,174,86,88
050,51,610,"Virginia","Falls Church city",1,63,172,88,84
050,51,610,"Virginia","Falls Church city",1,64,154,70,84
050,51,610,"Virginia","Falls Church city",1,65,162,78,84
050,51,610,"Virginia","Falls Church city",1,66,155,82,73
050,51,610,"Virginia","Falls Church city",1,67,153,77,76
050,51,610,"Virginia","Falls Church city",1,68,125,55,70
050,51,610,"Virginia","Falls Church city",1,69,126,56,70
050,51,610,"Virginia","Falls Church city",1,70,123,58,65
050,51,610,"Virginia","Falls Church city",1,71,129,60,69
050,51,610,"Virginia","Falls Church city",1,72,124,46,78
050,51,610,"Virginia","Falls Church city",1,73,127,55,72
050,51,610,"Virginia","Falls Church city",1,74,100,44,56
050,51,610,"Virginia","Falls Church city",1,75,89,35,54
050,51,610,"Virginia","Falls Church city",1,76,83,39,44
050,51,610,"Virginia","Falls Church city",1,77,74,33,41
050,51,610,"Virginia","Falls Church city",1,78,61,24,37
050,51,610,"Virginia","Falls Church city",1,79,61,25,36
050,51,610,"Virginia","Falls Church city",1,80,52,22,30
050,51,610,"Virginia","Falls Church city",1,81,61,29,32
050,51,610,"Virginia","Falls Church city",1,82,52,15,37
050,51,610,"Virginia","Falls Church city",1,83,40,10,30
050,51,610,"Virginia","Falls Church city",1,84,38,19,19
050,51,610,"Virginia","Falls Church city",1,85,255,77,178
050,51,610,"Virginia","Falls Church city",2,0,187,91,96
050,51,610,"Virginia","Falls Church city",2,1,165,94,71
050,51,610,"Virginia","Falls Church city",2,2,143,80,63
050,51,610,"Virginia","Falls Church city",2,3,164,83,81
050,51,610,"Virginia","Falls Church city",2,4,168,83,85
050,51,610,"Virginia","Falls Church city",2,5,179,94,85
050,51,610,"Virginia","Falls Church city",2,6,191,102,89
050,51,610,"Virginia","Falls Church city",2,7,191,103,88
050,51,610,"Virginia","Falls Church city",2,8,199,111,88
050,51,610,"Virginia","Falls Church city",2,9,202,102,100
050,51,610,"Virginia","Falls Church city",2,10,205,99,106
050,51,610,"Virginia","Falls Church city",2,11,226,106,120
050,51,610,"Virginia","Falls Church city",2,12,236,122,114
050,51,610,"Virginia","Falls Church city",2,13,230,108,122
050,51,610,"Virginia","Falls Church city",2,14,220,110,110
050,51,610,"Virginia","Falls Church city",2,15,228,119,109
050,51,610,"Virginia","Falls Church city",2,16,239,126,113
050,51,610,"Virginia","Falls Church city",2,17,224,122,102
050,51,610,"Virginia","Falls Church city",2,18,172,90,82
050,51,610,"Virginia","Falls Church city",2,19,141,70,71
050,51,610,"Virginia","Falls Church city",2,20,141,72,69
050,51,610,"Virginia","Falls Church city",2,21,134,65,69
050,51,610,"Virginia","Falls Church city",2,22,137,67,70
050,51,610,"Virginia","Falls Church city",2,23,161,74,87
050,51,610,"Virginia","Falls Church city",2,24,174,86,88
050,51,610,"Virginia","Falls Church city",2,25,179,94,85
050,51,610,"Virginia","Falls Church city",2,26,186,99,87
050,51,610,"Virginia","Falls Church city",2,27,188,98,90
050,51,610,"Virginia","Falls Church city",2,28,178,90,88
050,51,610,"Virginia","Falls Church city",2,29,168,93,75
050,51,610,"Virginia","Falls Church city",2,30,175,94,81
050,51,610,"Virginia","Falls Church city",2,31,174,88,86
050,51,610,"Virginia","Falls Church city",2,32,154,83,71
050,51,610,"Virginia","Falls Church city",2,33,156,84,72
050,51,610,"Virginia","Falls Church city",2,34,173,89,84
050,51,610,"Virginia","Falls Church city",2,35,184,85,99
050,51,610,"Virginia","Falls Church city",2,36,183,82,101
050,51,610,"Virginia","Falls Church city",2,37,199,92,107
050,51,610,"Virginia","Falls Church city",2,38,206,92,114
050,51,610,"Virginia","Falls Church city",2,39,193,92,101
050,51,610,"Virginia","Falls Church city",2,40,202,92,110
050,51,610,"Virginia","Falls Church city",2,41,227,101,126
050,51,610,"Virginia","Falls Church city",2,42,225,105,120
050,51,610,"Virginia","Falls Church city",2,43,220,105,115
050,51,610,"Virginia","Falls Church city",2,44,233,117,116
050,51,610,"Virginia","Falls Church city",2,45,233,117,116
050,51,610,"Virginia","Falls Church city",2,46,229,121,108
050,51,610,"Virginia","Falls Church city",2,47,220,113,107
050,51,610,"Virginia","Falls Church city",2,48,232,122,110
050,51,610,"Virginia","Falls Church city",2,49,235,120,115
050,51,610,"Virginia","Falls Church city",2,50,216,109,107
050,51,610,"Virginia","Falls Church city",2,51,216,108,108
050,51,610,"Virginia","Falls Church city",2,52,213,100,113
050,51,610,"Virginia","Falls Church city",2,53,200,98,102
050,51,610,"Virginia","Falls Church city",2,54,192,97,95
050,51,610,"Virginia","Falls Church city",2,55,200,102,98
050,51,610,"Virginia","Falls Church city",2,56,194,98,96
050,51,610,"Virginia","Falls Church city",2,57,186,96,90
050,51,610,"Virginia","Falls Church city",2,58,181,95,86
050,51,610,"Virginia","Falls Church city",2,59,178,103,75
050,51,610,"Virginia","Falls Church city",2,60,200,110,90
050,51,610,"Virginia","Falls Church city",2,61,197,98,99
050,51,610,"Virginia","Falls Church city",2,62,180,88,92
050,51,610,"Virginia","Falls Church city",2,63,174,89,85
050,51,610,"Virginia","Falls Church city",2,64,155,73,82
050,51,610,"Virginia","Falls Church city",2,65,155,74,81
050,51,610,"Virginia","Falls Church city",2,66,156,82,74
050,51,610,"Virginia","Falls Church city",2,67,152,77,75
050,51,610,"Virginia","Falls Church city",2,68,131,60,71
050,51,610,"Virginia","Falls Church city",2,69,125,55,70
050,51,610,"Virginia","Falls Church city",2,70,123,57,66
050,51,610,"Virginia","Falls Church city",2,71,123,56,67
050,51,610,"Virginia","Falls Church city",2,72,123,48,75
050,51,610,"Virginia","Falls Church city",2,73,133,55,78
050,51,610,"Virginia","Falls Church city",2,74,99,43,56
050,51,610,"Virginia","Falls Church city",2,75,92,38,54
050,51,610,"Virginia","Falls Church city",2,76,87,39,48
050,51,610,"Virginia","Falls Church city",2,77,79,36,43
050,51,610,"Virginia","Falls Church city",2,78,63,26,37
050,51,610,"Virginia","Falls Church city",2,79,60,24,36
050,51,610,"Virginia","Falls Church city",2,80,55,23,32
050,51,610,"Virginia","Falls Church city",2,81,56,26,30
050,51,610,"Virginia","Falls Church city",2,82,54,18,36
050,51,610,"Virginia","Falls Church city",2,83,40,11,29
050,51,610,"Virginia","Falls Church city",2,84,34,14,20
050,51,610,"Virginia","Falls Church city",2,85,250,77,173
050,51,610,"Virginia","Falls Church city",3,0,154,85,69
050,51,610,"Virginia","Falls Church city",3,1,175,99,76
050,51,610,"Virginia","Falls Church city",3,2,146,83,63
050,51,610,"Virginia","Falls Church city",3,3,153,81,72
050,51,610,"Virginia","Falls Church city",3,4,167,85,82
050,51,610,"Virginia","Falls Church city",3,5,175,85,90
050,51,610,"Virginia","Falls Church city",3,6,184,92,92
050,51,610,"Virginia","Falls Church city",3,7,197,108,89
050,51,610,"Virginia","Falls Church city",3,8,189,97,92
050,51,610,"Virginia","Falls Church city",3,9,192,105,87
050,51,610,"Virginia","Falls Church city",3,10,201,92,109
050,51,610,"Virginia","Falls Church city",3,11,198,97,101
050,51,610,"Virginia","Falls Church city",3,12,217,104,113
050,51,610,"Virginia","Falls Church city",3,13,244,129,115
050,51,610,"Virginia","Falls Church city",3,14,228,113,115
050,51,610,"Virginia","Falls Church city",3,15,219,110,109
050,51,610,"Virginia","Falls Church city",3,16,226,121,105
050,51,610,"Virginia","Falls Church city",3,17,233,127,106
050,51,610,"Virginia","Falls Church city",3,18,188,111,77
050,51,610,"Virginia","Falls Church city",3,19,138,73,65
050,51,610,"Virginia","Falls Church city",3,20,130,63,67
050,51,610,"Virginia","Falls Church city",3,21,138,71,67
050,51,610,"Virginia","Falls Church city",3,22,143,64,79
050,51,610,"Virginia","Falls Church city",3,23,156,84,72
050,51,610,"Virginia","Falls Church city",3,24,170,76,94
050,51,610,"Virginia","Falls Church city",3,25,196,86,110
050,51,610,"Virginia","Falls Church city",3,26,204,103,101
050,51,610,"Virginia","Falls Church city",3,27,210,116,94
050,51,610,"Virginia","Falls Church city",3,28,176,91,85
050,51,610,"Virginia","Falls Church city",3,29,169,92,77
050,51,610,"Virginia","Falls Church city",3,30,159,88,71
050,51,610,"Virginia","Falls Church city",3,31,164,95,69
050,51,610,"Virginia","Falls Church city",3,32,168,84,84
050,51,610,"Virginia","Falls Church city",3,33,152,90,62
050,51,610,"Virginia","Falls Church city",3,34,140,74,66
050,51,610,"Virginia","Falls Church city",3,35,177,90,87
050,51,610,"Virginia","Falls Church city",3,36,178,82,96
050,51,610,"Virginia","Falls Church city",3,37,188,81,107
050,51,610,"Virginia","Falls Church city",3,38,186,83,103
050,51,610,"Virginia","Falls Church city",3,39,201,94,107
050,51,610,"Virginia","Falls Church city",3,40,204,96,108
050,51,610,"Virginia","Falls Church city",3,41,209,98,111
050,51,610,"Virginia","Falls Church city",3,42,221,97,124
050,51,610,"Virginia","Falls Church city",3,43,232,119,113
050,51,610,"Virginia","Falls Church city",3,44,213,97,116
050,51,610,"Virginia","Falls Church city",3,45,230,111,119
050,51,610,"Virginia","Falls Church city",3,46,212,101,111
050,51,610,"Virginia","Falls Church city",3,47,216,118,98
050,51,610,"Virginia","Falls Church city",3,48,221,111,110
050,51,610,"Virginia","Falls Church city",3,49,235,122,113
050,51,610,"Virginia","Falls Church city",3,50,233,122,111
050,51,610,"Virginia","Falls Church city",3,51,207,110,97
050,51,610,"Virginia","Falls Church city",3,52,212,111,101
050,51,610,"Virginia","Falls Church city",3,53,206,93,113
050,51,610,"Virginia","Falls Church city",3,54,199,98,101
050,51,610,"Virginia","Falls Church city",3,55,189,90,99
050,51,610,"Virginia","Falls Church city",3,56,192,96,96
050,51,610,"Virginia","Falls Church city",3,57,189,93,96
050,51,610,"Virginia","Falls Church city",3,58,179,95,84
050,51,610,"Virginia","Falls Church city",3,59,166,86,80
050,51,610,"Virginia","Falls Church city",3,60,166,97,69
050,51,610,"Virginia","Falls Church city",3,61,196,107,89
050,51,610,"Virginia","Falls Church city",3,62,192,96,96
050,51,610,"Virginia","Falls Church city",3,63,178,84,94
050,51,610,"Virginia","Falls Church city",3,64,168,79,89
050,51,610,"Virginia","Falls Church city",3,65,149,72,77
050,51,610,"Virginia","Falls Church city",3,66,157,75,82
050,51,610,"Virginia","Falls Church city",3,67,149,78,71
050,51,610,"Virginia","Falls Church city",3,68,146,75,71
050,51,610,"Virginia","Falls Church city",3,69,127,56,71
050,51,610,"Virginia","Falls Church city",3,70,121,55,66
050,51,610,"Virginia","Falls Church city",3,71,111,49,62
050,51,610,"Virginia","Falls Church city",3,72,120,55,65
050,51,610,"Virginia","Falls Church city",3,73,121,46,75
050,51,610,"Virginia","Falls Church city",3,74,130,54,76
050,51,610,"Virginia","Falls Church city",3,75,94,38,56
050,51,610,"Virginia","Falls Church city",3,76,93,38,55
050,51,610,"Virginia","Falls Church city",3,77,80,35,45
050,51,610,"Virginia","Falls Church city",3,78,77,32,45
050,51,610,"Virginia","Falls Church city",3,79,60,26,34
050,51,610,"Virginia","Falls Church city",3,80,58,21,37
050,51,610,"Virginia","Falls Church city",3,81,52,21,31
050,51,610,"Virginia","Falls Church city",3,82,55,26,29
050,51,610,"Virginia","Falls Church city",3,83,52,15,37
050,51,610,"Virginia","Falls Church city",3,84,37,9,28
050,51,610,"Virginia","Falls Church city",3,85,233,64,169
050,51,610,"Virginia","Falls Church city",4,0,171,106,65
050,51,610,"Virginia","Falls Church city",4,1,172,89,83
050,51,610,"Virginia","Falls Church city",4,2,163,91,72
050,51,610,"Virginia","Falls Church city",4,3,147,84,63
050,51,610,"Virginia","Falls Church city",4,4,170,94,76
050,51,610,"Virginia","Falls Church city",4,5,165,80,85
050,51,610,"Virginia","Falls Church city",4,6,185,87,98
050,51,610,"Virginia","Falls Church city",4,7,193,98,95
050,51,610,"Virginia","Falls Church city",4,8,207,117,90
050,51,610,"Virginia","Falls Church city",4,9,190,97,93
050,51,610,"Virginia","Falls Church city",4,10,199,107,92
050,51,610,"Virginia","Falls Church city",4,11,199,92,107
050,51,610,"Virginia","Falls Church city",4,12,210,105,105
050,51,610,"Virginia","Falls Church city",4,13,230,113,117
050,51,610,"Virginia","Falls Church city",4,14,237,127,110
050,51,610,"Virginia","Falls Church city",4,15,226,108,118
050,51,610,"Virginia","Falls Church city",4,16,222,118,104
050,51,610,"Virginia","Falls Church city",4,17,218,117,101
050,51,610,"Virginia","Falls Church city",4,18,200,111,89
050,51,610,"Virginia","Falls Church city",4,19,141,85,56
050,51,610,"Virginia","Falls Church city",4,20,140,73,67
050,51,610,"Virginia","Falls Church city",4,21,135,69,66
050,51,610,"Virginia","Falls Church city",4,22,150,76,74
050,51,610,"Virginia","Falls Church city",4,23,168,81,87
050,51,610,"Virginia","Falls Church city",4,24,164,91,73
050,51,610,"Virginia","Falls Church city",4,25,180,91,89
050,51,610,"Virginia","Falls Church city",4,26,194,84,110
050,51,610,"Virginia","Falls Church city",4,27,199,102,97
050,51,610,"Virginia","Falls Church city",4,28,197,107,90
050,51,610,"Virginia","Falls Church city",4,29,182,100,82
050,51,610,"Virginia","Falls Church city",4,30,160,96,64
050,51,610,"Virginia","Falls Church city",4,31,168,96,72
050,51,610,"Virginia","Falls Church city",4,32,151,84,67
050,51,610,"Virginia","Falls Church city",4,33,179,86,93
050,51,610,"Virginia","Falls Church city",4,34,158,86,72
050,51,610,"Virginia","Falls Church city",4,35,140,69,71
050,51,610,"Virginia","Falls Church city",4,36,180,86,94
050,51,610,"Virginia","Falls Church city",4,37,174,84,90
050,51,610,"Virginia","Falls Church city",4,38,187,76,111
050,51,610,"Virginia","Falls Church city",4,39,190,87,103
050,51,610,"Virginia","Falls Church city",4,40,213,92,121
050,51,610,"Virginia","Falls Church city",4,41,202,94,108
050,51,610,"Virginia","Falls Church city",4,42,216,102,114
050,51,610,"Virginia","Falls Church city",4,43,203,98,105
050,51,610,"Virginia","Falls Church city",4,44,230,121,109
050,51,610,"Virginia","Falls Church city",4,45,217,101,116
050,51,610,"Virginia","Falls Church city",4,46,231,109,122
050,51,610,"Virginia","Falls Church city",4,47,216,106,110
050,51,610,"Virginia","Falls Church city",4,48,226,120,106
050,51,610,"Virginia","Falls Church city",4,49,216,110,106
050,51,610,"Virginia","Falls Church city",4,50,229,121,108
050,51,610,"Virginia","Falls Church city",4,51,216,109,107
050,51,610,"Virginia","Falls Church city",4,52,211,109,102
050,51,610,"Virginia","Falls Church city",4,53,211,106,105
050,51,610,"Virginia","Falls Church city",4,54,213,103,110
050,51,610,"Virginia","Falls Church city",4,55,186,87,99
050,51,610,"Virginia","Falls Church city",4,56,175,86,89
050,51,610,"Virginia","Falls Church city",4,57,172,79,93
050,51,610,"Virginia","Falls Church city",4,58,183,92,91
050,51,610,"Virginia","Falls Church city",4,59,171,91,80
050,51,610,"Virginia","Falls Church city",4,60,156,80,76
050,51,610,"Virginia","Falls Church city",4,61,168,93,75
050,51,610,"Virginia","Falls Church city",4,62,183,101,82
050,51,610,"Virginia","Falls Church city",4,63,181,93,88
050,51,610,"Virginia","Falls Church city",4,64,170,82,88
050,51,610,"Virginia","Falls Church city",4,65,165,77,88
050,51,610,"Virginia","Falls Church city",4,66,140,73,67
050,51,610,"Virginia","Falls Church city",4,67,139,66,73
050,51,610,"Virginia","Falls Church city",4,68,142,70,72
050,51,610,"Virginia","Falls Church city",4,69,151,74,77
050,51,610,"Virginia","Falls Church city",4,70,129,50,79
050,51,610,"Virginia","Falls Church city",4,71,109,48,61
050,51,610,"Virginia","Falls Church city",4,72,106,45,61
050,51,610,"Virginia","Falls Church city",4,73,111,48,63
050,51,610,"Virginia","Falls Church city",4,74,120,43,77
050,51,610,"Virginia","Falls Church city",4,75,122,49,73
050,51,610,"Virginia","Falls Church city",4,76,95,39,56
050,51,610,"Virginia","Falls Church city",4,77,90,36,54
050,51,610,"Virginia","Falls Church city",4,78,76,33,43
050,51,610,"Virginia","Falls Church city",4,79,73,32,41
050,51,610,"Virginia","Falls Church city",4,80,57,25,32
050,51,610,"Virginia","Falls Church city",4,81,52,20,32
050,51,610,"Virginia","Falls Church city",4,82,55,21,34
050,51,610,"Virginia","Falls Church city",4,83,55,25,30
050,51,610,"Virginia","Falls Church city",4,84,50,16,34
050,51,610,"Virginia","Falls Church city",4,85,216,54,162
050,51,610,"Virginia","Falls Church city",5,0,174,105,69
050,51,610,"Virginia","Falls Church city",5,1,163,106,57
050,51,610,"Virginia","Falls Church city",5,2,148,71,77
050,51,610,"Virginia","Falls Church city",5,3,152,88,64
050,51,610,"Virginia","Falls Church city",5,4,153,85,68
050,51,610,"Virginia","Falls Church city",5,5,177,98,79
050,51,610,"Virginia","Falls Church city",5,6,171,93,78
050,51,610,"Virginia","Falls Church city",5,7,193,88,105
050,51,610,"Virginia","Falls Church city",5,8,215,108,107
050,51,610,"Virginia","Falls Church city",5,9,205,107,98
050,51,610,"Virginia","Falls Church city",5,10,190,96,94
050,51,610,"Virginia","Falls Church city",5,11,202,113,89
050,51,610,"Virginia","Falls Church city",5,12,201,101,100
050,51,610,"Virginia","Falls Church city",5,13,215,111,104
050,51,610,"Virginia","Falls Church city",5,14,236,116,120
050,51,610,"Virginia","Falls Church city",5,15,258,138,120
050,51,610,"Virginia","Falls Church city",5,16,236,113,123
050,51,610,"Virginia","Falls Church city",5,17,229,122,107
050,51,610,"Virginia","Falls Church city",5,18,177,92,85
050,51,610,"Virginia","Falls Church city",5,19,157,91,66
050,51,610,"Virginia","Falls Church city",5,20,152,92,60
050,51,610,"Virginia","Falls Church city",5,21,139,75,64
050,51,610,"Virginia","Falls Church city",5,22,148,72,76
050,51,610,"Virginia","Falls Church city",5,23,181,97,84
050,51,610,"Virginia","Falls Church city",5,24,171,86,85
050,51,610,"Virginia","Falls Church city",5,25,187,101,86
050,51,610,"Virginia","Falls Church city",5,26,202,97,105
050,51,610,"Virginia","Falls Church city",5,27,224,106,118
050,51,610,"Virginia","Falls Church city",5,28,203,105,98
050,51,610,"Virginia","Falls Church city",5,29,194,110,84
050,51,610,"Virginia","Falls Church city",5,30,190,95,95
050,51,610,"Virginia","Falls Church city",5,31,173,96,77
050,51,610,"Virginia","Falls Church city",5,32,166,100,66
050,51,610,"Virginia","Falls Church city",5,33,171,93,78
050,51,610,"Virginia","Falls Church city",5,34,183,85,98
050,51,610,"Virginia","Falls Church city",5,35,170,82,88
050,51,610,"Virginia","Falls Church city",5,36,137,68,69
050,51,610,"Virginia","Falls Church city",5,37,186,95,91
050,51,610,"Virginia","Falls Church city",5,38,192,95,97
050,51,610,"Virginia","Falls Church city",5,39,189,82,107
050,51,610,"Virginia","Falls Church city",5,40,189,81,108
050,51,610,"Virginia","Falls Church city",5,41,225,97,128
050,51,610,"Virginia","Falls Church city",5,42,204,98,106
050,51,610,"Virginia","Falls Church city",5,43,218,105,113
050,51,610,"Virginia","Falls Church city",5,44,192,92,100
050,51,610,"Virginia","Falls Church city",5,45,237,129,108
050,51,610,"Virginia","Falls Church city",5,46,222,102,120
050,51,610,"Virginia","Falls Church city",5,47,221,108,113
050,51,610,"Virginia","Falls Church city",5,48,222,109,113
050,51,610,"Virginia","Falls Church city",5,49,226,123,103
050,51,610,"Virginia","Falls Church city",5,50,217,115,102
050,51,610,"Virginia","Falls Church city",5,51,228,123,105
050,51,610,"Virginia","Falls Church city",5,52,222,110,112
050,51,610,"Virginia","Falls Church city",5,53,219,115,104
050,51,610,"Virginia","Falls Church city",5,54,208,100,108
050,51,610,"Virginia","Falls Church city",5,55,204,99,105
050,51,610,"Virginia","Falls Church city",5,56,191,93,98
050,51,610,"Virginia","Falls Church city",5,57,168,79,89
050,51,610,"Virginia","Falls Church city",5,58,172,77,95
050,51,610,"Virginia","Falls Church city",5,59,168,85,83
050,51,610,"Virginia","Falls Church city",5,60,166,88,78
050,51,610,"Virginia","Falls Church city",5,61,157,82,75
050,51,610,"Virginia","Falls Church city",5,62,167,90,77
050,51,610,"Virginia","Falls Church city",5,63,176,99,77
050,51,610,"Virginia","Falls Church city",5,64,181,92,89
050,51,610,"Virginia","Falls Church city",5,65,175,86,89
050,51,610,"Virginia","Falls Church city",5,66,151,77,74
050,51,610,"Virginia","Falls Church city",5,67,126,66,60
050,51,610,"Virginia","Falls Church city",5,68,130,61,69
050,51,610,"Virginia","Falls Church city",5,69,146,73,73
050,51,610,"Virginia","Falls Church city",5,70,124,60,64
050,51,610,"Virginia","Falls Church city",5,71,115,44,71
050,51,610,"Virginia","Falls Church city",5,72,104,44,60
050,51,610,"Virginia","Falls Church city",5,73,103,41,62
050,51,610,"Virginia","Falls Church city",5,74,113,49,64
050,51,610,"Virginia","Falls Church city",5,75,110,35,75
050,51,610,"Virginia","Falls Church city",5,76,117,46,71
050,51,610,"Virginia","Falls Church city",5,77,89,34,55
050,51,610,"Virginia","Falls Church city",5,78,89,35,54
050,51,610,"Virginia","Falls Church city",5,79,73,32,41
050,51,610,"Virginia","Falls Church city",5,80,70,30,40
050,51,610,"Virginia","Falls Church city",5,81,54,21,33
050,51,610,"Virginia","Falls Church city",5,82,51,21,30
050,51,610,"Virginia","Falls Church city",5,83,50,16,34
050,51,610,"Virginia","Falls Church city",5,84,57,27,30
050,51,610,"Virginia","Falls Church city",5,85,228,56,172
050,51,620,"Virginia","Franklin city",1,0,129,65,64
050,51,620,"Virginia","Franklin city",1,1,121,62,59
050,51,620,"Virginia","Franklin city",1,2,121,73,48
050,51,620,"Virginia","Franklin city",1,3,106,64,42
050,51,620,"Virginia","Franklin city",1,4,108,52,56
050,51,620,"Virginia","Franklin city",1,5,124,63,61
050,51,620,"Virginia","Franklin city",1,6,114,60,54
050,51,620,"Virginia","Franklin city",1,7,114,57,57
050,51,620,"Virginia","Franklin city",1,8,131,61,70
050,51,620,"Virginia","Franklin city",1,9,117,62,55
050,51,620,"Virginia","Franklin city",1,10,114,55,59
050,51,620,"Virginia","Franklin city",1,11,110,54,56
050,51,620,"Virginia","Franklin city",1,12,112,61,51
050,51,620,"Virginia","Franklin city",1,13,119,66,53
050,51,620,"Virginia","Franklin city",1,14,117,60,57
050,51,620,"Virginia","Franklin city",1,15,116,68,48
050,51,620,"Virginia","Franklin city",1,16,122,65,57
050,51,620,"Virginia","Franklin city",1,17,110,55,55
050,51,620,"Virginia","Franklin city",1,18,107,60,47
050,51,620,"Virginia","Franklin city",1,19,80,46,34
050,51,620,"Virginia","Franklin city",1,20,80,32,48
050,51,620,"Virginia","Franklin city",1,21,71,38,33
050,51,620,"Virginia","Franklin city",1,22,83,39,44
050,51,620,"Virginia","Franklin city",1,23,86,43,43
050,51,620,"Virginia","Franklin city",1,24,81,36,45
050,51,620,"Virginia","Franklin city",1,25,86,40,46
050,51,620,"Virginia","Franklin city",1,26,102,49,53
050,51,620,"Virginia","Franklin city",1,27,81,37,44
050,51,620,"Virginia","Franklin city",1,28,103,48,55
050,51,620,"Virginia","Franklin city",1,29,101,45,56
050,51,620,"Virginia","Franklin city",1,30,109,48,61
050,51,620,"Virginia","Franklin city",1,31,93,48,45
050,51,620,"Virginia","Franklin city",1,32,105,51,54
050,51,620,"Virginia","Franklin city",1,33,100,46,54
050,51,620,"Virginia","Franklin city",1,34,93,37,56
050,51,620,"Virginia","Franklin city",1,35,103,40,63
050,51,620,"Virginia","Franklin city",1,36,83,31,52
050,51,620,"Virginia","Franklin city",1,37,94,44,50
050,51,620,"Virginia","Franklin city",1,38,75,36,39
050,51,620,"Virginia","Franklin city",1,39,86,37,49
050,51,620,"Virginia","Franklin city",1,40,89,41,48
050,51,620,"Virginia","Franklin city",1,41,80,40,40
050,51,620,"Virginia","Franklin city",1,42,71,33,38
050,51,620,"Virginia","Franklin city",1,43,73,32,41
050,51,620,"Virginia","Franklin city",1,44,72,34,38
050,51,620,"Virginia","Franklin city",1,45,83,38,45
050,51,620,"Virginia","Franklin city",1,46,73,30,43
050,51,620,"Virginia","Franklin city",1,47,76,34,42
050,51,620,"Virginia","Franklin city",1,48,94,47,47
050,51,620,"Virginia","Franklin city",1,49,98,49,49
050,51,620,"Virginia","Franklin city",1,50,99,44,55
050,51,620,"Virginia","Franklin city",1,51,85,33,52
050,51,620,"Virginia","Franklin city",1,52,102,41,61
050,51,620,"Virginia","Franklin city",1,53,103,39,64
050,51,620,"Virginia","Franklin city",1,54,103,40,63
050,51,620,"Virginia","Franklin city",1,55,91,39,52
050,51,620,"Virginia","Franklin city",1,56,118,51,67
050,51,620,"Virginia","Franklin city",1,57,118,49,69
050,51,620,"Virginia","Franklin city",1,58,116,51,65
050,51,620,"Virginia","Franklin city",1,59,128,54,74
050,51,620,"Virginia","Franklin city",1,60,119,53,66
050,51,620,"Virginia","Franklin city",1,61,131,60,71
050,51,620,"Virginia","Franklin city",1,62,132,57,75
050,51,620,"Virginia","Franklin city",1,63,132,54,78
050,51,620,"Virginia","Franklin city",1,64,110,41,69
050,51,620,"Virginia","Franklin city",1,65,110,46,64
050,51,620,"Virginia","Franklin city",1,66,100,38,62
050,51,620,"Virginia","Franklin city",1,67,84,35,49
050,51,620,"Virginia","Franklin city",1,68,93,46,47
050,51,620,"Virginia","Franklin city",1,69,85,41,44
050,51,620,"Virginia","Franklin city",1,70,90,40,50
050,51,620,"Virginia","Franklin city",1,71,97,41,56
050,51,620,"Virginia","Franklin city",1,72,89,42,47
050,51,620,"Virginia","Franklin city",1,73,95,42,53
050,51,620,"Virginia","Franklin city",1,74,67,34,33
050,51,620,"Virginia","Franklin city",1,75,79,33,46
050,51,620,"Virginia","Franklin city",1,76,61,29,32
050,51,620,"Virginia","Franklin city",1,77,60,30,30
050,51,620,"Virginia","Franklin city",1,78,53,17,36
050,51,620,"Virginia","Franklin city",1,79,42,16,26
050,51,620,"Virginia","Franklin city",1,80,43,20,23
050,51,620,"Virginia","Franklin city",1,81,48,17,31
050,51,620,"Virginia","Franklin city",1,82,43,15,28
050,51,620,"Virginia","Franklin city",1,83,36,13,23
050,51,620,"Virginia","Franklin city",1,84,24,9,15
050,51,620,"Virginia","Franklin city",1,85,174,43,131
050,51,620,"Virginia","Franklin city",2,0,118,61,57
050,51,620,"Virginia","Franklin city",2,1,123,64,59
050,51,620,"Virginia","Franklin city",2,2,121,71,50
050,51,620,"Virginia","Franklin city",2,3,109,65,44
050,51,620,"Virginia","Franklin city",2,4,108,55,53
050,51,620,"Virginia","Franklin city",2,5,118,60,58
050,51,620,"Virginia","Franklin city",2,6,117,61,56
050,51,620,"Virginia","Franklin city",2,7,118,60,58
050,51,620,"Virginia","Franklin city",2,8,126,61,65
050,51,620,"Virginia","Franklin city",2,9,118,60,58
050,51,620,"Virginia","Franklin city",2,10,113,56,57
050,51,620,"Virginia","Franklin city",2,11,109,53,56
050,51,620,"Virginia","Franklin city",2,12,114,60,54
050,51,620,"Virginia","Franklin city",2,13,116,64,52
050,51,620,"Virginia","Franklin city",2,14,116,61,55
050,51,620,"Virginia","Franklin city",2,15,115,65,50
050,51,620,"Virginia","Franklin city",2,16,119,64,55
050,51,620,"Virginia","Franklin city",2,17,114,57,57
050,51,620,"Virginia","Franklin city",2,18,101,55,46
050,51,620,"Virginia","Franklin city",2,19,82,47,35
050,51,620,"Virginia","Franklin city",2,20,83,38,45
050,51,620,"Virginia","Franklin city",2,21,75,38,37
050,51,620,"Virginia","Franklin city",2,22,80,38,42
050,51,620,"Virginia","Franklin city",2,23,85,43,42
050,51,620,"Virginia","Franklin city",2,24,82,38,44
050,51,620,"Virginia","Franklin city",2,25,84,39,45
050,51,620,"Virginia","Franklin city",2,26,93,44,49
050,51,620,"Virginia","Franklin city",2,27,82,39,43
050,51,620,"Virginia","Franklin city",2,28,97,44,53
050,51,620,"Virginia","Franklin city",2,29,102,46,56
050,51,620,"Virginia","Franklin city",2,30,106,48,58
050,51,620,"Virginia","Franklin city",2,31,97,48,49
050,51,620,"Virginia","Franklin city",2,32,101,49,52
050,51,620,"Virginia","Franklin city",2,33,102,47,55
050,51,620,"Virginia","Franklin city",2,34,96,40,56
050,51,620,"Virginia","Franklin city",2,35,102,40,62
050,51,620,"Virginia","Franklin city",2,36,90,35,55
050,51,620,"Virginia","Franklin city",2,37,92,42,50
050,51,620,"Virginia","Franklin city",2,38,79,37,42
050,51,620,"Virginia","Franklin city",2,39,82,36,46
050,51,620,"Virginia","Franklin city",2,40,89,40,49
050,51,620,"Virginia","Franklin city",2,41,82,41,41
050,51,620,"Virginia","Franklin city",2,42,72,34,38
050,51,620,"Virginia","Franklin city",2,43,75,33,42
050,51,620,"Virginia","Franklin city",2,44,72,34,38
050,51,620,"Virginia","Franklin city",2,45,85,39,46
050,51,620,"Virginia","Franklin city",2,46,76,32,44
050,51,620,"Virginia","Franklin city",2,47,75,33,42
050,51,620,"Virginia","Franklin city",2,48,90,44,46
050,51,620,"Virginia","Franklin city",2,49,96,48,48
050,51,620,"Virginia","Franklin city",2,50,97,45,52
050,51,620,"Virginia","Franklin city",2,51,89,35,54
050,51,620,"Virginia","Franklin city",2,52,101,41,60
050,51,620,"Virginia","Franklin city",2,53,101,38,63
050,51,620,"Virginia","Franklin city",2,54,101,39,62
050,51,620,"Virginia","Franklin city",2,55,89,36,53
050,51,620,"Virginia","Franklin city",2,56,111,48,63
050,51,620,"Virginia","Franklin city",2,57,118,49,69
050,51,620,"Virginia","Franklin city",2,58,118,51,67
050,51,620,"Virginia","Franklin city",2,59,126,54,72
050,51,620,"Virginia","Franklin city",2,60,121,54,67
050,51,620,"Virginia","Franklin city",2,61,129,59,70
050,51,620,"Virginia","Franklin city",2,62,129,56,73
050,51,620,"Virginia","Franklin city",2,63,130,53,77
050,51,620,"Virginia","Franklin city",2,64,115,44,71
050,51,620,"Virginia","Franklin city",2,65,108,43,65
050,51,620,"Virginia","Franklin city",2,66,102,39,63
050,51,620,"Virginia","Franklin city",2,67,88,36,52
050,51,620,"Virginia","Franklin city",2,68,89,43,46
050,51,620,"Virginia","Franklin city",2,69,85,41,44
050,51,620,"Virginia","Franklin city",2,70,88,40,48
050,51,620,"Virginia","Franklin city",2,71,92,38,54
050,51,620,"Virginia","Franklin city",2,72,90,42,48
050,51,620,"Virginia","Franklin city",2,73,98,44,54
050,51,620,"Virginia","Franklin city",2,74,70,34,36
050,51,620,"Virginia","Franklin city",2,75,74,33,41
050,51,620,"Virginia","Franklin city",2,76,64,30,34
050,51,620,"Virginia","Franklin city",2,77,61,30,31
050,51,620,"Virginia","Franklin city",2,78,53,18,35
050,51,620,"Virginia","Franklin city",2,79,44,17,27
050,51,620,"Virginia","Franklin city",2,80,43,19,24
050,51,620,"Virginia","Franklin city",2,81,46,17,29
050,51,620,"Virginia","Franklin city",2,82,45,16,29
050,51,620,"Virginia","Franklin city",2,83,36,14,22
050,51,620,"Virginia","Franklin city",2,84,26,9,17
050,51,620,"Virginia","Franklin city",2,85,172,42,130
050,51,620,"Virginia","Franklin city",3,0,166,87,79
050,51,620,"Virginia","Franklin city",3,1,128,67,61
050,51,620,"Virginia","Franklin city",3,2,128,65,63
050,51,620,"Virginia","Franklin city",3,3,123,73,50
050,51,620,"Virginia","Franklin city",3,4,116,68,48
050,51,620,"Virginia","Franklin city",3,5,110,54,56
050,51,620,"Virginia","Franklin city",3,6,110,54,56
050,51,620,"Virginia","Franklin city",3,7,118,58,60
050,51,620,"Virginia","Franklin city",3,8,121,60,61
050,51,620,"Virginia","Franklin city",3,9,125,57,68
050,51,620,"Virginia","Franklin city",3,10,123,64,59
050,51,620,"Virginia","Franklin city",3,11,114,57,57
050,51,620,"Virginia","Franklin city",3,12,101,46,55
050,51,620,"Virginia","Franklin city",3,13,112,60,52
050,51,620,"Virginia","Franklin city",3,14,114,63,51
050,51,620,"Virginia","Franklin city",3,15,112,58,54
050,51,620,"Virginia","Franklin city",3,16,125,65,60
050,51,620,"Virginia","Franklin city",3,17,116,64,52
050,51,620,"Virginia","Franklin city",3,18,103,53,50
050,51,620,"Virginia","Franklin city",3,19,89,49,40
050,51,620,"Virginia","Franklin city",3,20,88,46,42
050,51,620,"Virginia","Franklin city",3,21,90,44,46
050,51,620,"Virginia","Franklin city",3,22,85,43,42
050,51,620,"Virginia","Franklin city",3,23,81,43,38
050,51,620,"Virginia","Franklin city",3,24,84,39,45
050,51,620,"Virginia","Franklin city",3,25,79,34,45
050,51,620,"Virginia","Franklin city",3,26,89,37,52
050,51,620,"Virginia","Franklin city",3,27,96,44,52
050,51,620,"Virginia","Franklin city",3,28,95,45,50
050,51,620,"Virginia","Franklin city",3,29,106,52,54
050,51,620,"Virginia","Franklin city",3,30,102,47,55
050,51,620,"Virginia","Franklin city",3,31,109,55,54
050,51,620,"Virginia","Franklin city",3,32,91,42,49
050,51,620,"Virginia","Franklin city",3,33,101,49,52
050,51,620,"Virginia","Franklin city",3,34,109,48,61
050,51,620,"Virginia","Franklin city",3,35,99,43,56
050,51,620,"Virginia","Franklin city",3,36,94,37,57
050,51,620,"Virginia","Franklin city",3,37,87,34,53
050,51,620,"Virginia","Franklin city",3,38,93,39,54
050,51,620,"Virginia","Franklin city",3,39,70,31,39
050,51,620,"Virginia","Franklin city",3,40,86,41,45
050,51,620,"Virginia","Franklin city",3,41,90,39,51
050,51,620,"Virginia","Franklin city",3,42,75,33,42
050,51,620,"Virginia","Franklin city",3,43,71,32,39
050,51,620,"Virginia","Franklin city",3,44,69,27,42
050,51,620,"Virginia","Franklin city",3,45,68,32,36
050,51,620,"Virginia","Franklin city",3,46,90,42,48
050,51,620,"Virginia","Franklin city",3,47,87,39,48
050,51,620,"Virginia","Franklin city",3,48,60,29,31
050,51,620,"Virginia","Franklin city",3,49,86,44,42
050,51,620,"Virginia","Franklin city",3,50,98,48,50
050,51,620,"Virginia","Franklin city",3,51,92,44,48
050,51,620,"Virginia","Franklin city",3,52,79,27,52
050,51,620,"Virginia","Franklin city",3,53,105,39,66
050,51,620,"Virginia","Franklin city",3,54,104,42,62
050,51,620,"Virginia","Franklin city",3,55,94,34,60
050,51,620,"Virginia","Franklin city",3,56,84,33,51
050,51,620,"Virginia","Franklin city",3,57,107,46,61
050,51,620,"Virginia","Franklin city",3,58,106,45,61
050,51,620,"Virginia","Franklin city",3,59,115,50,65
050,51,620,"Virginia","Franklin city",3,60,136,56,80
050,51,620,"Virginia","Franklin city",3,61,124,55,69
050,51,620,"Virginia","Franklin city",3,62,120,54,66
050,51,620,"Virginia","Franklin city",3,63,121,53,68
050,51,620,"Virginia","Franklin city",3,64,126,51,75
050,51,620,"Virginia","Franklin city",3,65,104,41,63
050,51,620,"Virginia","Franklin city",3,66,105,41,64
050,51,620,"Virginia","Franklin city",3,67,101,38,63
050,51,620,"Virginia","Franklin city",3,68,84,36,48
050,51,620,"Virginia","Franklin city",3,69,82,38,44
050,51,620,"Virginia","Franklin city",3,70,76,36,40
050,51,620,"Virginia","Franklin city",3,71,89,41,48
050,51,620,"Virginia","Franklin city",3,72,84,33,51
050,51,620,"Virginia","Franklin city",3,73,84,39,45
050,51,620,"Virginia","Franklin city",3,74,100,45,55
050,51,620,"Virginia","Franklin city",3,75,69,33,36
050,51,620,"Virginia","Franklin city",3,76,69,32,37
050,51,620,"Virginia","Franklin city",3,77,55,28,27
050,51,620,"Virginia","Franklin city",3,78,59,26,33
050,51,620,"Virginia","Franklin city",3,79,49,18,31
050,51,620,"Virginia","Franklin city",3,80,42,17,25
050,51,620,"Virginia","Franklin city",3,81,41,17,24
050,51,620,"Virginia","Franklin city",3,82,33,11,22
050,51,620,"Virginia","Franklin city",3,83,38,12,26
050,51,620,"Virginia","Franklin city",3,84,28,11,17
050,51,620,"Virginia","Franklin city",3,85,165,38,127
050,51,620,"Virginia","Franklin city",4,0,158,89,69
050,51,620,"Virginia","Franklin city",4,1,159,92,67
050,51,620,"Virginia","Franklin city",4,2,135,72,63
050,51,620,"Virginia","Franklin city",4,3,131,68,63
050,51,620,"Virginia","Franklin city",4,4,134,76,58
050,51,620,"Virginia","Franklin city",4,5,120,68,52
050,51,620,"Virginia","Franklin city",4,6,111,57,54
050,51,620,"Virginia","Franklin city",4,7,117,59,58
050,51,620,"Virginia","Franklin city",4,8,120,55,65
050,51,620,"Virginia","Franklin city",4,9,123,62,61
050,51,620,"Virginia","Franklin city",4,10,107,44,63
050,51,620,"Virginia","Franklin city",4,11,130,68,62
050,51,620,"Virginia","Franklin city",4,12,115,60,55
050,51,620,"Virginia","Franklin city",4,13,114,56,58
050,51,620,"Virginia","Franklin city",4,14,120,60,60
050,51,620,"Virginia","Franklin city",4,15,119,68,51
050,51,620,"Virginia","Franklin city",4,16,119,56,63
050,51,620,"Virginia","Franklin city",4,17,122,66,56
050,51,620,"Virginia","Franklin city",4,18,103,58,45
050,51,620,"Virginia","Franklin city",4,19,93,45,48
050,51,620,"Virginia","Franklin city",4,20,87,46,41
050,51,620,"Virginia","Franklin city",4,21,102,50,52
050,51,620,"Virginia","Franklin city",4,22,88,44,44
050,51,620,"Virginia","Franklin city",4,23,86,40,46
050,51,620,"Virginia","Franklin city",4,24,76,42,34
050,51,620,"Virginia","Franklin city",4,25,93,39,54
050,51,620,"Virginia","Franklin city",4,26,78,34,44
050,51,620,"Virginia","Franklin city",4,27,87,37,50
050,51,620,"Virginia","Franklin city",4,28,96,41,55
050,51,620,"Virginia","Franklin city",4,29,87,33,54
050,51,620,"Virginia","Franklin city",4,30,114,59,55
050,51,620,"Virginia","Franklin city",4,31,116,55,61
050,51,620,"Virginia","Franklin city",4,32,107,50,57
050,51,620,"Virginia","Franklin city",4,33,90,42,48
050,51,620,"Virginia","Franklin city",4,34,96,44,52
050,51,620,"Virginia","Franklin city",4,35,102,43,59
050,51,620,"Virginia","Franklin city",4,36,105,50,55
050,51,620,"Virginia","Franklin city",4,37,100,43,57
050,51,620,"Virginia","Franklin city",4,38,89,33,56
050,51,620,"Virginia","Franklin city",4,39,85,37,48
050,51,620,"Virginia","Franklin city",4,40,76,32,44
050,51,620,"Virginia","Franklin city",4,41,90,41,49
050,51,620,"Virginia","Franklin city",4,42,89,39,50
050,51,620,"Virginia","Franklin city",4,43,78,36,42
050,51,620,"Virginia","Franklin city",4,44,73,28,45
050,51,620,"Virginia","Franklin city",4,45,65,22,43
050,51,620,"Virginia","Franklin city",4,46,70,32,38
050,51,620,"Virginia","Franklin city",4,47,88,42,46
050,51,620,"Virginia","Franklin city",4,48,88,40,48
050,51,620,"Virginia","Franklin city",4,49,72,34,38
050,51,620,"Virginia","Franklin city",4,50,89,43,46
050,51,620,"Virginia","Franklin city",4,51,96,45,51
050,51,620,"Virginia","Franklin city",4,52,92,43,49
050,51,620,"Virginia","Franklin city",4,53,77,27,50
050,51,620,"Virginia","Franklin city",4,54,107,40,67
050,51,620,"Virginia","Franklin city",4,55,104,38,66
050,51,620,"Virginia","Franklin city",4,56,99,34,65
050,51,620,"Virginia","Franklin city",4,57,96,38,58
050,51,620,"Virginia","Franklin city",4,58,106,44,62
050,51,620,"Virginia","Franklin city",4,59,112,48,64
050,51,620,"Virginia","Franklin city",4,60,112,48,64
050,51,620,"Virginia","Franklin city",4,61,132,53,79
050,51,620,"Virginia","Franklin city",4,62,122,54,68
050,51,620,"Virginia","Franklin city",4,63,115,53,62
050,51,620,"Virginia","Franklin city",4,64,116,49,67
050,51,620,"Virginia","Franklin city",4,65,118,47,71
050,51,620,"Virginia","Franklin city",4,66,99,35,64
050,51,620,"Virginia","Franklin city",4,67,107,41,66
050,51,620,"Virginia","Franklin city",4,68,93,38,55
050,51,620,"Virginia","Franklin city",4,69,81,33,48
050,51,620,"Virginia","Franklin city",4,70,80,34,46
050,51,620,"Virginia","Franklin city",4,71,74,34,40
050,51,620,"Virginia","Franklin city",4,72,83,35,48
050,51,620,"Virginia","Franklin city",4,73,76,30,46
050,51,620,"Virginia","Franklin city",4,74,85,40,45
050,51,620,"Virginia","Franklin city",4,75,99,41,58
050,51,620,"Virginia","Franklin city",4,76,64,31,33
050,51,620,"Virginia","Franklin city",4,77,62,31,31
050,51,620,"Virginia","Franklin city",4,78,52,25,27
050,51,620,"Virginia","Franklin city",4,79,56,26,30
050,51,620,"Virginia","Franklin city",4,80,49,21,28
050,51,620,"Virginia","Franklin city",4,81,39,13,26
050,51,620,"Virginia","Franklin city",4,82,32,16,16
050,51,620,"Virginia","Franklin city",4,83,36,14,22
050,51,620,"Virginia","Franklin city",4,84,32,10,22
050,51,620,"Virginia","Franklin city",4,85,159,34,125
050,51,620,"Virginia","Franklin city",5,0,155,86,69
050,51,620,"Virginia","Franklin city",5,1,167,94,73
050,51,620,"Virginia","Franklin city",5,2,168,94,74
050,51,620,"Virginia","Franklin city",5,3,139,74,65
050,51,620,"Virginia","Franklin city",5,4,137,71,66
050,51,620,"Virginia","Franklin city",5,5,127,77,50
050,51,620,"Virginia","Franklin city",5,6,119,63,56
050,51,620,"Virginia","Franklin city",5,7,118,60,58
050,51,620,"Virginia","Franklin city",5,8,117,62,55
050,51,620,"Virginia","Franklin city",5,9,111,51,60
050,51,620,"Virginia","Franklin city",5,10,126,64,62
050,51,620,"Virginia","Franklin city",5,11,110,46,64
050,51,620,"Virginia","Franklin city",5,12,125,60,65
050,51,620,"Virginia","Franklin city",5,13,118,57,61
050,51,620,"Virginia","Franklin city",5,14,114,53,61
050,51,620,"Virginia","Franklin city",5,15,122,62,60
050,51,620,"Virginia","Franklin city",5,16,129,70,59
050,51,620,"Virginia","Franklin city",5,17,119,57,62
050,51,620,"Virginia","Franklin city",5,18,113,61,52
050,51,620,"Virginia","Franklin city",5,19,95,50,45
050,51,620,"Virginia","Franklin city",5,20,92,45,47
050,51,620,"Virginia","Franklin city",5,21,94,48,46
050,51,620,"Virginia","Franklin city",5,22,107,52,55
050,51,620,"Virginia","Franklin city",5,23,90,42,48
050,51,620,"Virginia","Franklin city",5,24,92,44,48
050,51,620,"Virginia","Franklin city",5,25,79,39,40
050,51,620,"Virginia","Franklin city",5,26,82,36,46
050,51,620,"Virginia","Franklin city",5,27,73,32,41
050,51,620,"Virginia","Franklin city",5,28,89,41,48
050,51,620,"Virginia","Franklin city",5,29,106,52,54
050,51,620,"Virginia","Franklin city",5,30,103,46,57
050,51,620,"Virginia","Franklin city",5,31,108,54,54
050,51,620,"Virginia","Franklin city",5,32,124,60,64
050,51,620,"Virginia","Franklin city",5,33,107,49,58
050,51,620,"Virginia","Franklin city",5,34,99,46,53
050,51,620,"Virginia","Franklin city",5,35,92,43,49
050,51,620,"Virginia","Franklin city",5,36,104,46,58
050,51,620,"Virginia","Franklin city",5,37,112,49,63
050,51,620,"Virginia","Franklin city",5,38,93,39,54
050,51,620,"Virginia","Franklin city",5,39,86,31,55
050,51,620,"Virginia","Franklin city",5,40,97,40,57
050,51,620,"Virginia","Franklin city",5,41,81,36,45
050,51,620,"Virginia","Franklin city",5,42,90,43,47
050,51,620,"Virginia","Franklin city",5,43,90,36,54
050,51,620,"Virginia","Franklin city",5,44,70,33,37
050,51,620,"Virginia","Franklin city",5,45,81,35,46
050,51,620,"Virginia","Franklin city",5,46,68,23,45
050,51,620,"Virginia","Franklin city",5,47,74,37,37
050,51,620,"Virginia","Franklin city",5,48,80,38,42
050,51,620,"Virginia","Franklin city",5,49,85,38,47
050,51,620,"Virginia","Franklin city",5,50,64,30,34
050,51,620,"Virginia","Franklin city",5,51,84,43,41
050,51,620,"Virginia","Franklin city",5,52,95,44,51
050,51,620,"Virginia","Franklin city",5,53,84,38,46
050,51,620,"Virginia","Franklin city",5,54,87,34,53
050,51,620,"Virginia","Franklin city",5,55,104,41,63
050,51,620,"Virginia","Franklin city",5,56,105,37,68
050,51,620,"Virginia","Franklin city",5,57,103,34,69
050,51,620,"Virginia","Franklin city",5,58,91,36,55
050,51,620,"Virginia","Franklin city",5,59,102,41,61
050,51,620,"Virginia","Franklin city",5,60,111,45,66
050,51,620,"Virginia","Franklin city",5,61,112,51,61
050,51,620,"Virginia","Franklin city",5,62,120,41,79
050,51,620,"Virginia","Franklin city",5,63,118,52,66
050,51,620,"Virginia","Franklin city",5,64,109,51,58
050,51,620,"Virginia","Franklin city",5,65,112,50,62
050,51,620,"Virginia","Franklin city",5,66,109,42,67
050,51,620,"Virginia","Franklin city",5,67,98,34,64
050,51,620,"Virginia","Franklin city",5,68,98,38,60
050,51,620,"Virginia","Franklin city",5,69,97,36,61
050,51,620,"Virginia","Franklin city",5,70,75,29,46
050,51,620,"Virginia","Franklin city",5,71,77,31,46
050,51,620,"Virginia","Franklin city",5,72,66,28,38
050,51,620,"Virginia","Franklin city",5,73,77,33,44
050,51,620,"Virginia","Franklin city",5,74,79,31,48
050,51,620,"Virginia","Franklin city",5,75,77,34,43
050,51,620,"Virginia","Franklin city",5,76,91,40,51
050,51,620,"Virginia","Franklin city",5,77,56,28,28
050,51,620,"Virginia","Franklin city",5,78,59,28,31
050,51,620,"Virginia","Franklin city",5,79,49,25,24
050,51,620,"Virginia","Franklin city",5,80,58,28,30
050,51,620,"Virginia","Franklin city",5,81,44,17,27
050,51,620,"Virginia","Franklin city",5,82,28,11,17
050,51,620,"Virginia","Franklin city",5,83,31,15,16
050,51,620,"Virginia","Franklin city",5,84,32,12,20
050,51,620,"Virginia","Franklin city",5,85,160,34,126
050,51,630,"Virginia","Fredericksburg city",1,0,368,192,176
050,51,630,"Virginia","Fredericksburg city",1,1,370,203,167
050,51,630,"Virginia","Fredericksburg city",1,2,336,178,158
050,51,630,"Virginia","Fredericksburg city",1,3,385,192,193
050,51,630,"Virginia","Fredericksburg city",1,4,355,192,163
050,51,630,"Virginia","Fredericksburg city",1,5,375,186,189
050,51,630,"Virginia","Fredericksburg city",1,6,370,189,181
050,51,630,"Virginia","Fredericksburg city",1,7,339,184,155
050,51,630,"Virginia","Fredericksburg city",1,8,348,193,155
050,51,630,"Virginia","Fredericksburg city",1,9,347,196,151
050,51,630,"Virginia","Fredericksburg city",1,10,291,148,143
050,51,630,"Virginia","Fredericksburg city",1,11,336,168,168
050,51,630,"Virginia","Fredericksburg city",1,12,325,163,162
050,51,630,"Virginia","Fredericksburg city",1,13,313,149,164
050,51,630,"Virginia","Fredericksburg city",1,14,277,138,139
050,51,630,"Virginia","Fredericksburg city",1,15,273,135,138
050,51,630,"Virginia","Fredericksburg city",1,16,289,143,146
050,51,630,"Virginia","Fredericksburg city",1,17,257,131,126
050,51,630,"Virginia","Fredericksburg city",1,18,660,232,428
050,51,630,"Virginia","Fredericksburg city",1,19,963,376,587
050,51,630,"Virginia","Fredericksburg city",1,20,975,404,571
050,51,630,"Virginia","Fredericksburg city",1,21,926,327,599
050,51,630,"Virginia","Fredericksburg city",1,22,727,328,399
050,51,630,"Virginia","Fredericksburg city",1,23,543,254,289
050,51,630,"Virginia","Fredericksburg city",1,24,489,217,272
050,51,630,"Virginia","Fredericksburg city",1,25,525,254,271
050,51,630,"Virginia","Fredericksburg city",1,26,488,239,249
050,51,630,"Virginia","Fredericksburg city",1,27,477,258,219
050,51,630,"Virginia","Fredericksburg city",1,28,482,253,229
050,51,630,"Virginia","Fredericksburg city",1,29,437,218,219
050,51,630,"Virginia","Fredericksburg city",1,30,475,218,257
050,51,630,"Virginia","Fredericksburg city",1,31,453,213,240
050,51,630,"Virginia","Fredericksburg city",1,32,443,219,224
050,51,630,"Virginia","Fredericksburg city",1,33,381,203,178
050,51,630,"Virginia","Fredericksburg city",1,34,369,184,185
050,51,630,"Virginia","Fredericksburg city",1,35,340,180,160
050,51,630,"Virginia","Fredericksburg city",1,36,327,163,164
050,51,630,"Virginia","Fredericksburg city",1,37,328,169,159
050,51,630,"Virginia","Fredericksburg city",1,38,324,157,167
050,51,630,"Virginia","Fredericksburg city",1,39,330,167,163
050,51,630,"Virginia","Fredericksburg city",1,40,337,158,179
050,51,630,"Virginia","Fredericksburg city",1,41,325,155,170
050,51,630,"Virginia","Fredericksburg city",1,42,316,163,153
050,51,630,"Virginia","Fredericksburg city",1,43,285,135,150
050,51,630,"Virginia","Fredericksburg city",1,44,271,122,149
050,51,630,"Virginia","Fredericksburg city",1,45,276,137,139
050,51,630,"Virginia","Fredericksburg city",1,46,311,145,166
050,51,630,"Virginia","Fredericksburg city",1,47,284,133,151
050,51,630,"Virginia","Fredericksburg city",1,48,282,131,151
050,51,630,"Virginia","Fredericksburg city",1,49,313,146,167
050,51,630,"Virginia","Fredericksburg city",1,50,309,152,157
050,51,630,"Virginia","Fredericksburg city",1,51,302,150,152
050,51,630,"Virginia","Fredericksburg city",1,52,308,147,161
050,51,630,"Virginia","Fredericksburg city",1,53,310,149,161
050,51,630,"Virginia","Fredericksburg city",1,54,312,139,173
050,51,630,"Virginia","Fredericksburg city",1,55,327,149,178
050,51,630,"Virginia","Fredericksburg city",1,56,296,161,135
050,51,630,"Virginia","Fredericksburg city",1,57,327,162,165
050,51,630,"Virginia","Fredericksburg city",1,58,299,151,148
050,51,630,"Virginia","Fredericksburg city",1,59,294,131,163
050,51,630,"Virginia","Fredericksburg city",1,60,271,109,162
050,51,630,"Virginia","Fredericksburg city",1,61,250,111,139
050,51,630,"Virginia","Fredericksburg city",1,62,278,134,144
050,51,630,"Virginia","Fredericksburg city",1,63,281,132,149
050,51,630,"Virginia","Fredericksburg city",1,64,265,129,136
050,51,630,"Virginia","Fredericksburg city",1,65,254,131,123
050,51,630,"Virginia","Fredericksburg city",1,66,216,90,126
050,51,630,"Virginia","Fredericksburg city",1,67,202,92,110
050,51,630,"Virginia","Fredericksburg city",1,68,189,71,118
050,51,630,"Virginia","Fredericksburg city",1,69,193,85,108
050,51,630,"Virginia","Fredericksburg city",1,70,199,85,114
050,51,630,"Virginia","Fredericksburg city",1,71,181,81,100
050,51,630,"Virginia","Fredericksburg city",1,72,177,70,107
050,51,630,"Virginia","Fredericksburg city",1,73,200,87,113
050,51,630,"Virginia","Fredericksburg city",1,74,121,60,61
050,51,630,"Virginia","Fredericksburg city",1,75,118,55,63
050,51,630,"Virginia","Fredericksburg city",1,76,118,52,66
050,51,630,"Virginia","Fredericksburg city",1,77,108,45,63
050,51,630,"Virginia","Fredericksburg city",1,78,98,44,54
050,51,630,"Virginia","Fredericksburg city",1,79,94,31,63
050,51,630,"Virginia","Fredericksburg city",1,80,67,28,39
050,51,630,"Virginia","Fredericksburg city",1,81,82,40,42
050,51,630,"Virginia","Fredericksburg city",1,82,88,36,52
050,51,630,"Virginia","Fredericksburg city",1,83,67,27,40
050,51,630,"Virginia","Fredericksburg city",1,84,60,24,36
050,51,630,"Virginia","Fredericksburg city",1,85,296,91,205
050,51,630,"Virginia","Fredericksburg city",2,0,352,182,170
050,51,630,"Virginia","Fredericksburg city",2,1,369,202,167
050,51,630,"Virginia","Fredericksburg city",2,2,343,183,160
050,51,630,"Virginia","Fredericksburg city",2,3,369,187,182
050,51,630,"Virginia","Fredericksburg city",2,4,362,192,170
050,51,630,"Virginia","Fredericksburg city",2,5,368,186,182
050,51,630,"Virginia","Fredericksburg city",2,6,369,189,180
050,51,630,"Virginia","Fredericksburg city",2,7,347,186,161
050,51,630,"Virginia","Fredericksburg city",2,8,347,191,156
050,51,630,"Virginia","Fredericksburg city",2,9,343,191,152
050,51,630,"Virginia","Fredericksburg city",2,10,305,161,144
050,51,630,"Virginia","Fredericksburg city",2,11,323,164,159
050,51,630,"Virginia","Fredericksburg city",2,12,329,165,164
050,51,630,"Virginia","Fredericksburg city",2,13,312,152,160
050,51,630,"Virginia","Fredericksburg city",2,14,282,139,143
050,51,630,"Virginia","Fredericksburg city",2,15,275,137,138
050,51,630,"Virginia","Fredericksburg city",2,16,282,139,143
050,51,630,"Virginia","Fredericksburg city",2,17,263,133,130
050,51,630,"Virginia","Fredericksburg city",2,18,652,229,423
050,51,630,"Virginia","Fredericksburg city",2,19,969,381,588
050,51,630,"Virginia","Fredericksburg city",2,20,983,402,581
050,51,630,"Virginia","Fredericksburg city",2,21,930,334,596
050,51,630,"Virginia","Fredericksburg city",2,22,736,332,404
050,51,630,"Virginia","Fredericksburg city",2,23,547,254,293
050,51,630,"Virginia","Fredericksburg city",2,24,492,222,270
050,51,630,"Virginia","Fredericksburg city",2,25,514,243,271
050,51,630,"Virginia","Fredericksburg city",2,26,484,239,245
050,51,630,"Virginia","Fredericksburg city",2,27,476,252,224
050,51,630,"Virginia","Fredericksburg city",2,28,473,253,220
050,51,630,"Virginia","Fredericksburg city",2,29,441,224,217
050,51,630,"Virginia","Fredericksburg city",2,30,463,215,248
050,51,630,"Virginia","Fredericksburg city",2,31,453,211,242
050,51,630,"Virginia","Fredericksburg city",2,32,439,218,221
050,51,630,"Virginia","Fredericksburg city",2,33,390,203,187
050,51,630,"Virginia","Fredericksburg city",2,34,367,187,180
050,51,630,"Virginia","Fredericksburg city",2,35,350,185,165
050,51,630,"Virginia","Fredericksburg city",2,36,324,164,160
050,51,630,"Virginia","Fredericksburg city",2,37,325,165,160
050,51,630,"Virginia","Fredericksburg city",2,38,323,158,165
050,51,630,"Virginia","Fredericksburg city",2,39,326,161,165
050,51,630,"Virginia","Fredericksburg city",2,40,336,159,177
050,51,630,"Virginia","Fredericksburg city",2,41,327,157,170
050,51,630,"Virginia","Fredericksburg city",2,42,317,161,156
050,51,630,"Virginia","Fredericksburg city",2,43,297,143,154
050,51,630,"Virginia","Fredericksburg city",2,44,269,121,148
050,51,630,"Virginia","Fredericksburg city",2,45,276,133,143
050,51,630,"Virginia","Fredericksburg city",2,46,300,141,159
050,51,630,"Virginia","Fredericksburg city",2,47,287,132,155
050,51,630,"Virginia","Fredericksburg city",2,48,284,131,153
050,51,630,"Virginia","Fredericksburg city",2,49,307,144,163
050,51,630,"Virginia","Fredericksburg city",2,50,311,151,160
050,51,630,"Virginia","Fredericksburg city",2,51,306,153,153
050,51,630,"Virginia","Fredericksburg city",2,52,307,147,160
050,51,630,"Virginia","Fredericksburg city",2,53,308,145,163
050,51,630,"Virginia","Fredericksburg city",2,54,310,141,169
050,51,630,"Virginia","Fredericksburg city",2,55,320,147,173
050,51,630,"Virginia","Fredericksburg city",2,56,307,160,147
050,51,630,"Virginia","Fredericksburg city",2,57,320,165,155
050,51,630,"Virginia","Fredericksburg city",2,58,303,151,152
050,51,630,"Virginia","Fredericksburg city",2,59,297,135,162
050,51,630,"Virginia","Fredericksburg city",2,60,272,111,161
050,51,630,"Virginia","Fredericksburg city",2,61,254,110,144
050,51,630,"Virginia","Fredericksburg city",2,62,272,128,144
050,51,630,"Virginia","Fredericksburg city",2,63,284,136,148
050,51,630,"Virginia","Fredericksburg city",2,64,266,128,138
050,51,630,"Virginia","Fredericksburg city",2,65,257,131,126
050,51,630,"Virginia","Fredericksburg city",2,66,225,101,124
050,51,630,"Virginia","Fredericksburg city",2,67,205,91,114
050,51,630,"Virginia","Fredericksburg city",2,68,189,74,115
050,51,630,"Virginia","Fredericksburg city",2,69,194,82,112
050,51,630,"Virginia","Fredericksburg city",2,70,196,84,112
050,51,630,"Virginia","Fredericksburg city",2,71,186,83,103
050,51,630,"Virginia","Fredericksburg city",2,72,175,70,105
050,51,630,"Virginia","Fredericksburg city",2,73,201,86,115
050,51,630,"Virginia","Fredericksburg city",2,74,131,62,69
050,51,630,"Virginia","Fredericksburg city",2,75,118,57,61
050,51,630,"Virginia","Fredericksburg city",2,76,114,51,63
050,51,630,"Virginia","Fredericksburg city",2,77,113,49,64
050,51,630,"Virginia","Fredericksburg city",2,78,100,43,57
050,51,630,"Virginia","Fredericksburg city",2,79,93,34,59
050,51,630,"Virginia","Fredericksburg city",2,80,73,28,45
050,51,630,"Virginia","Fredericksburg city",2,81,78,38,40
050,51,630,"Virginia","Fredericksburg city",2,82,86,38,48
050,51,630,"Virginia","Fredericksburg city",2,83,68,27,41
050,51,630,"Virginia","Fredericksburg city",2,84,59,21,38
050,51,630,"Virginia","Fredericksburg city",2,85,296,91,205
050,51,630,"Virginia","Fredericksburg city",3,0,393,190,203
050,51,630,"Virginia","Fredericksburg city",3,1,350,187,163
050,51,630,"Virginia","Fredericksburg city",3,2,355,198,157
050,51,630,"Virginia","Fredericksburg city",3,3,337,164,173
050,51,630,"Virginia","Fredericksburg city",3,4,370,171,199
050,51,630,"Virginia","Fredericksburg city",3,5,361,197,164
050,51,630,"Virginia","Fredericksburg city",3,6,368,189,179
050,51,630,"Virginia","Fredericksburg city",3,7,372,185,187
050,51,630,"Virginia","Fredericksburg city",3,8,332,178,154
050,51,630,"Virginia","Fredericksburg city",3,9,359,188,171
050,51,630,"Virginia","Fredericksburg city",3,10,354,195,159
050,51,630,"Virginia","Fredericksburg city",3,11,315,159,156
050,51,630,"Virginia","Fredericksburg city",3,12,307,155,152
050,51,630,"Virginia","Fredericksburg city",3,13,333,167,166
050,51,630,"Virginia","Fredericksburg city",3,14,314,157,157
050,51,630,"Virginia","Fredericksburg city",3,15,278,138,140
050,51,630,"Virginia","Fredericksburg city",3,16,261,129,132
050,51,630,"Virginia","Fredericksburg city",3,17,275,134,141
050,51,630,"Virginia","Fredericksburg city",3,18,654,232,422
050,51,630,"Virginia","Fredericksburg city",3,19,971,375,596
050,51,630,"Virginia","Fredericksburg city",3,20,969,390,579
050,51,630,"Virginia","Fredericksburg city",3,21,930,337,593
050,51,630,"Virginia","Fredericksburg city",3,22,713,321,392
050,51,630,"Virginia","Fredericksburg city",3,23,564,270,294
050,51,630,"Virginia","Fredericksburg city",3,24,516,220,296
050,51,630,"Virginia","Fredericksburg city",3,25,513,226,287
050,51,630,"Virginia","Fredericksburg city",3,26,498,238,260
050,51,630,"Virginia","Fredericksburg city",3,27,489,237,252
050,51,630,"Virginia","Fredericksburg city",3,28,494,243,251
050,51,630,"Virginia","Fredericksburg city",3,29,476,254,222
050,51,630,"Virginia","Fredericksburg city",3,30,460,227,233
050,51,630,"Virginia","Fredericksburg city",3,31,455,210,245
050,51,630,"Virginia","Fredericksburg city",3,32,481,241,240
050,51,630,"Virginia","Fredericksburg city",3,33,401,203,198
050,51,630,"Virginia","Fredericksburg city",3,34,396,206,190
050,51,630,"Virginia","Fredericksburg city",3,35,361,181,180
050,51,630,"Virginia","Fredericksburg city",3,36,347,179,168
050,51,630,"Virginia","Fredericksburg city",3,37,319,170,149
050,51,630,"Virginia","Fredericksburg city",3,38,320,160,160
050,51,630,"Virginia","Fredericksburg city",3,39,336,173,163
050,51,630,"Virginia","Fredericksburg city",3,40,309,150,159
050,51,630,"Virginia","Fredericksburg city",3,41,313,144,169
050,51,630,"Virginia","Fredericksburg city",3,42,328,162,166
050,51,630,"Virginia","Fredericksburg city",3,43,318,167,151
050,51,630,"Virginia","Fredericksburg city",3,44,306,140,166
050,51,630,"Virginia","Fredericksburg city",3,45,264,123,141
050,51,630,"Virginia","Fredericksburg city",3,46,306,152,154
050,51,630,"Virginia","Fredericksburg city",3,47,284,132,152
050,51,630,"Virginia","Fredericksburg city",3,48,296,128,168
050,51,630,"Virginia","Fredericksburg city",3,49,297,134,163
050,51,630,"Virginia","Fredericksburg city",3,50,300,140,160
050,51,630,"Virginia","Fredericksburg city",3,51,325,159,166
050,51,630,"Virginia","Fredericksburg city",3,52,323,155,168
050,51,630,"Virginia","Fredericksburg city",3,53,310,154,156
050,51,630,"Virginia","Fredericksburg city",3,54,301,146,155
050,51,630,"Virginia","Fredericksburg city",3,55,299,140,159
050,51,630,"Virginia","Fredericksburg city",3,56,312,142,170
050,51,630,"Virginia","Fredericksburg city",3,57,300,160,140
050,51,630,"Virginia","Fredericksburg city",3,58,318,168,150
050,51,630,"Virginia","Fredericksburg city",3,59,312,150,162
050,51,630,"Virginia","Fredericksburg city",3,60,280,124,156
050,51,630,"Virginia","Fredericksburg city",3,61,278,123,155
050,51,630,"Virginia","Fredericksburg city",3,62,272,117,155
050,51,630,"Virginia","Fredericksburg city",3,63,268,130,138
050,51,630,"Virginia","Fredericksburg city",3,64,259,123,136
050,51,630,"Virginia","Fredericksburg city",3,65,253,117,136
050,51,630,"Virginia","Fredericksburg city",3,66,249,124,125
050,51,630,"Virginia","Fredericksburg city",3,67,231,103,128
050,51,630,"Virginia","Fredericksburg city",3,68,196,86,110
050,51,630,"Virginia","Fredericksburg city",3,69,183,71,112
050,51,630,"Virginia","Fredericksburg city",3,70,189,79,110
050,51,630,"Virginia","Fredericksburg city",3,71,193,81,112
050,51,630,"Virginia","Fredericksburg city",3,72,176,80,96
050,51,630,"Virginia","Fredericksburg city",3,73,164,62,102
050,51,630,"Virginia","Fredericksburg city",3,74,195,87,108
050,51,630,"Virginia","Fredericksburg city",3,75,132,63,69
050,51,630,"Virginia","Fredericksburg city",3,76,113,57,56
050,51,630,"Virginia","Fredericksburg city",3,77,117,51,66
050,51,630,"Virginia","Fredericksburg city",3,78,114,45,69
050,51,630,"Virginia","Fredericksburg city",3,79,89,39,50
050,51,630,"Virginia","Fredericksburg city",3,80,91,33,58
050,51,630,"Virginia","Fredericksburg city",3,81,67,28,39
050,51,630,"Virginia","Fredericksburg city",3,82,75,36,39
050,51,630,"Virginia","Fredericksburg city",3,83,83,32,51
050,51,630,"Virginia","Fredericksburg city",3,84,69,26,43
050,51,630,"Virginia","Fredericksburg city",3,85,283,90,193
050,51,630,"Virginia","Fredericksburg city",4,0,351,165,186
050,51,630,"Virginia","Fredericksburg city",4,1,380,187,193
050,51,630,"Virginia","Fredericksburg city",4,2,383,209,174
050,51,630,"Virginia","Fredericksburg city",4,3,351,198,153
050,51,630,"Virginia","Fredericksburg city",4,4,325,164,161
050,51,630,"Virginia","Fredericksburg city",4,5,369,175,194
050,51,630,"Virginia","Fredericksburg city",4,6,355,213,142
050,51,630,"Virginia","Fredericksburg city",4,7,353,165,188
050,51,630,"Virginia","Fredericksburg city",4,8,357,182,175
050,51,630,"Virginia","Fredericksburg city",4,9,343,181,162
050,51,630,"Virginia","Fredericksburg city",4,10,343,185,158
050,51,630,"Virginia","Fredericksburg city",4,11,354,205,149
050,51,630,"Virginia","Fredericksburg city",4,12,311,147,164
050,51,630,"Virginia","Fredericksburg city",4,13,309,167,142
050,51,630,"Virginia","Fredericksburg city",4,14,317,145,172
050,51,630,"Virginia","Fredericksburg city",4,15,294,140,154
050,51,630,"Virginia","Fredericksburg city",4,16,278,143,135
050,51,630,"Virginia","Fredericksburg city",4,17,284,140,144
050,51,630,"Virginia","Fredericksburg city",4,18,653,220,433
050,51,630,"Virginia","Fredericksburg city",4,19,975,386,589
050,51,630,"Virginia","Fredericksburg city",4,20,992,394,598
050,51,630,"Virginia","Fredericksburg city",4,21,931,336,595
050,51,630,"Virginia","Fredericksburg city",4,22,724,324,400
050,51,630,"Virginia","Fredericksburg city",4,23,527,257,270
050,51,630,"Virginia","Fredericksburg city",4,24,522,252,270
050,51,630,"Virginia","Fredericksburg city",4,25,500,231,269
050,51,630,"Virginia","Fredericksburg city",4,26,501,245,256
050,51,630,"Virginia","Fredericksburg city",4,27,483,244,239
050,51,630,"Virginia","Fredericksburg city",4,28,471,227,244
050,51,630,"Virginia","Fredericksburg city",4,29,495,241,254
050,51,630,"Virginia","Fredericksburg city",4,30,463,238,225
050,51,630,"Virginia","Fredericksburg city",4,31,442,222,220
050,51,630,"Virginia","Fredericksburg city",4,32,496,243,253
050,51,630,"Virginia","Fredericksburg city",4,33,445,218,227
050,51,630,"Virginia","Fredericksburg city",4,34,388,198,190
050,51,630,"Virginia","Fredericksburg city",4,35,381,192,189
050,51,630,"Virginia","Fredericksburg city",4,36,381,191,190
050,51,630,"Virginia","Fredericksburg city",4,37,345,183,162
050,51,630,"Virginia","Fredericksburg city",4,38,320,155,165
050,51,630,"Virginia","Fredericksburg city",4,39,302,150,152
050,51,630,"Virginia","Fredericksburg city",4,40,321,160,161
050,51,630,"Virginia","Fredericksburg city",4,41,321,149,172
050,51,630,"Virginia","Fredericksburg city",4,42,318,159,159
050,51,630,"Virginia","Fredericksburg city",4,43,336,169,167
050,51,630,"Virginia","Fredericksburg city",4,44,331,169,162
050,51,630,"Virginia","Fredericksburg city",4,45,294,129,165
050,51,630,"Virginia","Fredericksburg city",4,46,256,122,134
050,51,630,"Virginia","Fredericksburg city",4,47,315,151,164
050,51,630,"Virginia","Fredericksburg city",4,48,288,126,162
050,51,630,"Virginia","Fredericksburg city",4,49,300,145,155
050,51,630,"Virginia","Fredericksburg city",4,50,292,134,158
050,51,630,"Virginia","Fredericksburg city",4,51,313,146,167
050,51,630,"Virginia","Fredericksburg city",4,52,329,161,168
050,51,630,"Virginia","Fredericksburg city",4,53,313,153,160
050,51,630,"Virginia","Fredericksburg city",4,54,293,137,156
050,51,630,"Virginia","Fredericksburg city",4,55,284,143,141
050,51,630,"Virginia","Fredericksburg city",4,56,302,141,161
050,51,630,"Virginia","Fredericksburg city",4,57,320,144,176
050,51,630,"Virginia","Fredericksburg city",4,58,299,154,145
050,51,630,"Virginia","Fredericksburg city",4,59,317,160,157
050,51,630,"Virginia","Fredericksburg city",4,60,302,147,155
050,51,630,"Virginia","Fredericksburg city",4,61,293,129,164
050,51,630,"Virginia","Fredericksburg city",4,62,267,111,156
050,51,630,"Virginia","Fredericksburg city",4,63,257,116,141
050,51,630,"Virginia","Fredericksburg city",4,64,268,130,138
050,51,630,"Virginia","Fredericksburg city",4,65,257,128,129
050,51,630,"Virginia","Fredericksburg city",4,66,244,114,130
050,51,630,"Virginia","Fredericksburg city",4,67,237,118,119
050,51,630,"Virginia","Fredericksburg city",4,68,223,102,121
050,51,630,"Virginia","Fredericksburg city",4,69,192,82,110
050,51,630,"Virginia","Fredericksburg city",4,70,180,72,108
050,51,630,"Virginia","Fredericksburg city",4,71,178,75,103
050,51,630,"Virginia","Fredericksburg city",4,72,188,82,106
050,51,630,"Virginia","Fredericksburg city",4,73,166,75,91
050,51,630,"Virginia","Fredericksburg city",4,74,159,61,98
050,51,630,"Virginia","Fredericksburg city",4,75,194,88,106
050,51,630,"Virginia","Fredericksburg city",4,76,126,61,65
050,51,630,"Virginia","Fredericksburg city",4,77,107,53,54
050,51,630,"Virginia","Fredericksburg city",4,78,113,49,64
050,51,630,"Virginia","Fredericksburg city",4,79,100,34,66
050,51,630,"Virginia","Fredericksburg city",4,80,85,37,48
050,51,630,"Virginia","Fredericksburg city",4,81,83,30,53
050,51,630,"Virginia","Fredericksburg city",4,82,66,26,40
050,51,630,"Virginia","Fredericksburg city",4,83,69,31,38
050,51,630,"Virginia","Fredericksburg city",4,84,81,31,50
050,51,630,"Virginia","Fredericksburg city",4,85,277,87,190
050,51,630,"Virginia","Fredericksburg city",5,0,349,164,185
050,51,630,"Virginia","Fredericksburg city",5,1,340,179,161
050,51,630,"Virginia","Fredericksburg city",5,2,393,195,198
050,51,630,"Virginia","Fredericksburg city",5,3,400,220,180
050,51,630,"Virginia","Fredericksburg city",5,4,359,208,151
050,51,630,"Virginia","Fredericksburg city",5,5,304,158,146
050,51,630,"Virginia","Fredericksburg city",5,6,354,174,180
050,51,630,"Virginia","Fredericksburg city",5,7,331,193,138
050,51,630,"Virginia","Fredericksburg city",5,8,351,163,188
050,51,630,"Virginia","Fredericksburg city",5,9,342,171,171
050,51,630,"Virginia","Fredericksburg city",5,10,350,188,162
050,51,630,"Virginia","Fredericksburg city",5,11,354,199,155
050,51,630,"Virginia","Fredericksburg city",5,12,363,202,161
050,51,630,"Virginia","Fredericksburg city",5,13,309,145,164
050,51,630,"Virginia","Fredericksburg city",5,14,302,164,138
050,51,630,"Virginia","Fredericksburg city",5,15,316,144,172
050,51,630,"Virginia","Fredericksburg city",5,16,289,136,153
050,51,630,"Virginia","Fredericksburg city",5,17,292,140,152
050,51,630,"Virginia","Fredericksburg city",5,18,660,228,432
050,51,630,"Virginia","Fredericksburg city",5,19,978,370,608
050,51,630,"Virginia","Fredericksburg city",5,20,1003,404,599
050,51,630,"Virginia","Fredericksburg city",5,21,930,316,614
050,51,630,"Virginia","Fredericksburg city",5,22,735,342,393
050,51,630,"Virginia","Fredericksburg city",5,23,550,256,294
050,51,630,"Virginia","Fredericksburg city",5,24,467,225,242
050,51,630,"Virginia","Fredericksburg city",5,25,534,265,269
050,51,630,"Virginia","Fredericksburg city",5,26,472,224,248
050,51,630,"Virginia","Fredericksburg city",5,27,491,236,255
050,51,630,"Virginia","Fredericksburg city",5,28,494,238,256
050,51,630,"Virginia","Fredericksburg city",5,29,457,222,235
050,51,630,"Virginia","Fredericksburg city",5,30,486,248,238
050,51,630,"Virginia","Fredericksburg city",5,31,458,237,221
050,51,630,"Virginia","Fredericksburg city",5,32,468,240,228
050,51,630,"Virginia","Fredericksburg city",5,33,477,239,238
050,51,630,"Virginia","Fredericksburg city",5,34,435,227,208
050,51,630,"Virginia","Fredericksburg city",5,35,403,206,197
050,51,630,"Virginia","Fredericksburg city",5,36,383,188,195
050,51,630,"Virginia","Fredericksburg city",5,37,367,180,187
050,51,630,"Virginia","Fredericksburg city",5,38,339,174,165
050,51,630,"Virginia","Fredericksburg city",5,39,343,164,179
050,51,630,"Virginia","Fredericksburg city",5,40,294,140,154
050,51,630,"Virginia","Fredericksburg city",5,41,345,170,175
050,51,630,"Virginia","Fredericksburg city",5,42,327,150,177
050,51,630,"Virginia","Fredericksburg city",5,43,319,160,159
050,51,630,"Virginia","Fredericksburg city",5,44,335,170,165
050,51,630,"Virginia","Fredericksburg city",5,45,316,169,147
050,51,630,"Virginia","Fredericksburg city",5,46,308,138,170
050,51,630,"Virginia","Fredericksburg city",5,47,284,143,141
050,51,630,"Virginia","Fredericksburg city",5,48,305,149,156
050,51,630,"Virginia","Fredericksburg city",5,49,296,143,153
050,51,630,"Virginia","Fredericksburg city",5,50,295,146,149
050,51,630,"Virginia","Fredericksburg city",5,51,292,134,158
050,51,630,"Virginia","Fredericksburg city",5,52,322,160,162
050,51,630,"Virginia","Fredericksburg city",5,53,315,155,160
050,51,630,"Virginia","Fredericksburg city",5,54,317,165,152
050,51,630,"Virginia","Fredericksburg city",5,55,273,129,144
050,51,630,"Virginia","Fredericksburg city",5,56,292,149,143
050,51,630,"Virginia","Fredericksburg city",5,57,290,137,153
050,51,630,"Virginia","Fredericksburg city",5,58,309,134,175
050,51,630,"Virginia","Fredericksburg city",5,59,296,147,149
050,51,630,"Virginia","Fredericksburg city",5,60,296,155,141
050,51,630,"Virginia","Fredericksburg city",5,61,278,133,145
050,51,630,"Virginia","Fredericksburg city",5,62,291,128,163
050,51,630,"Virginia","Fredericksburg city",5,63,259,112,147
050,51,630,"Virginia","Fredericksburg city",5,64,246,106,140
050,51,630,"Virginia","Fredericksburg city",5,65,255,120,135
050,51,630,"Virginia","Fredericksburg city",5,66,230,117,113
050,51,630,"Virginia","Fredericksburg city",5,67,234,107,127
050,51,630,"Virginia","Fredericksburg city",5,68,234,121,113
050,51,630,"Virginia","Fredericksburg city",5,69,222,104,118
050,51,630,"Virginia","Fredericksburg city",5,70,186,79,107
050,51,630,"Virginia","Fredericksburg city",5,71,172,71,101
050,51,630,"Virginia","Fredericksburg city",5,72,172,75,97
050,51,630,"Virginia","Fredericksburg city",5,73,170,67,103
050,51,630,"Virginia","Fredericksburg city",5,74,161,71,90
050,51,630,"Virginia","Fredericksburg city",5,75,158,58,100
050,51,630,"Virginia","Fredericksburg city",5,76,193,89,104
050,51,630,"Virginia","Fredericksburg city",5,77,122,57,65
050,51,630,"Virginia","Fredericksburg city",5,78,107,55,52
050,51,630,"Virginia","Fredericksburg city",5,79,105,45,60
050,51,630,"Virginia","Fredericksburg city",5,80,97,33,64
050,51,630,"Virginia","Fredericksburg city",5,81,78,35,43
050,51,630,"Virginia","Fredericksburg city",5,82,81,31,50
050,51,630,"Virginia","Fredericksburg city",5,83,63,21,42
050,51,630,"Virginia","Fredericksburg city",5,84,71,35,36
050,51,630,"Virginia","Fredericksburg city",5,85,289,97,192
050,51,640,"Virginia","Galax city",1,0,92,49,43
050,51,640,"Virginia","Galax city",1,1,91,51,40
050,51,640,"Virginia","Galax city",1,2,81,42,39
050,51,640,"Virginia","Galax city",1,3,89,46,43
050,51,640,"Virginia","Galax city",1,4,102,53,49
050,51,640,"Virginia","Galax city",1,5,88,37,51
050,51,640,"Virginia","Galax city",1,6,78,40,38
050,51,640,"Virginia","Galax city",1,7,95,46,49
050,51,640,"Virginia","Galax city",1,8,92,51,41
050,51,640,"Virginia","Galax city",1,9,100,54,46
050,51,640,"Virginia","Galax city",1,10,97,51,46
050,51,640,"Virginia","Galax city",1,11,92,43,49
050,51,640,"Virginia","Galax city",1,12,93,48,45
050,51,640,"Virginia","Galax city",1,13,101,57,44
050,51,640,"Virginia","Galax city",1,14,99,55,44
050,51,640,"Virginia","Galax city",1,15,79,36,43
050,51,640,"Virginia","Galax city",1,16,89,46,43
050,51,640,"Virginia","Galax city",1,17,93,50,43
050,51,640,"Virginia","Galax city",1,18,92,44,48
050,51,640,"Virginia","Galax city",1,19,66,30,36
050,51,640,"Virginia","Galax city",1,20,68,33,35
050,51,640,"Virginia","Galax city",1,21,84,37,47
050,51,640,"Virginia","Galax city",1,22,88,45,43
050,51,640,"Virginia","Galax city",1,23,81,39,42
050,51,640,"Virginia","Galax city",1,24,79,44,35
050,51,640,"Virginia","Galax city",1,25,72,34,38
050,51,640,"Virginia","Galax city",1,26,84,45,39
050,51,640,"Virginia","Galax city",1,27,87,45,42
050,51,640,"Virginia","Galax city",1,28,74,31,43
050,51,640,"Virginia","Galax city",1,29,77,29,48
050,51,640,"Virginia","Galax city",1,30,82,39,43
050,51,640,"Virginia","Galax city",1,31,83,36,47
050,51,640,"Virginia","Galax city",1,32,71,39,32
050,51,640,"Virginia","Galax city",1,33,79,44,35
050,51,640,"Virginia","Galax city",1,34,74,35,39
050,51,640,"Virginia","Galax city",1,35,87,47,40
050,51,640,"Virginia","Galax city",1,36,66,33,33
050,51,640,"Virginia","Galax city",1,37,47,23,24
050,51,640,"Virginia","Galax city",1,38,64,34,30
050,51,640,"Virginia","Galax city",1,39,71,32,39
050,51,640,"Virginia","Galax city",1,40,85,39,46
050,51,640,"Virginia","Galax city",1,41,73,30,43
050,51,640,"Virginia","Galax city",1,42,64,24,40
050,51,640,"Virginia","Galax city",1,43,75,41,34
050,51,640,"Virginia","Galax city",1,44,88,45,43
050,51,640,"Virginia","Galax city",1,45,81,39,42
050,51,640,"Virginia","Galax city",1,46,80,41,39
050,51,640,"Virginia","Galax city",1,47,91,46,45
050,51,640,"Virginia","Galax city",1,48,90,45,45
050,51,640,"Virginia","Galax city",1,49,84,40,44
050,51,640,"Virginia","Galax city",1,50,89,44,45
050,51,640,"Virginia","Galax city",1,51,103,51,52
050,51,640,"Virginia","Galax city",1,52,97,45,52
050,51,640,"Virginia","Galax city",1,53,110,50,60
050,51,640,"Virginia","Galax city",1,54,102,46,56
050,51,640,"Virginia","Galax city",1,55,104,49,55
050,51,640,"Virginia","Galax city",1,56,74,35,39
050,51,640,"Virginia","Galax city",1,57,69,38,31
050,51,640,"Virginia","Galax city",1,58,88,46,42
050,51,640,"Virginia","Galax city",1,59,87,36,51
050,51,640,"Virginia","Galax city",1,60,88,33,55
050,51,640,"Virginia","Galax city",1,61,84,39,45
050,51,640,"Virginia","Galax city",1,62,101,49,52
050,51,640,"Virginia","Galax city",1,63,102,49,53
050,51,640,"Virginia","Galax city",1,64,98,38,60
050,51,640,"Virginia","Galax city",1,65,100,50,50
050,51,640,"Virginia","Galax city",1,66,81,40,41
050,51,640,"Virginia","Galax city",1,67,61,28,33
050,51,640,"Virginia","Galax city",1,68,67,32,35
050,51,640,"Virginia","Galax city",1,69,64,27,37
050,51,640,"Virginia","Galax city",1,70,65,32,33
050,51,640,"Virginia","Galax city",1,71,61,19,42
050,51,640,"Virginia","Galax city",1,72,55,16,39
050,51,640,"Virginia","Galax city",1,73,62,24,38
050,51,640,"Virginia","Galax city",1,74,38,15,23
050,51,640,"Virginia","Galax city",1,75,45,15,30
050,51,640,"Virginia","Galax city",1,76,46,17,29
050,51,640,"Virginia","Galax city",1,77,44,15,29
050,51,640,"Virginia","Galax city",1,78,34,13,21
050,51,640,"Virginia","Galax city",1,79,45,20,25
050,51,640,"Virginia","Galax city",1,80,25,10,15
050,51,640,"Virginia","Galax city",1,81,28,15,13
050,51,640,"Virginia","Galax city",1,82,24,8,16
050,51,640,"Virginia","Galax city",1,83,26,10,16
050,51,640,"Virginia","Galax city",1,84,25,4,21
050,51,640,"Virginia","Galax city",1,85,195,45,150
050,51,640,"Virginia","Galax city",2,0,95,54,41
050,51,640,"Virginia","Galax city",2,1,92,51,41
050,51,640,"Virginia","Galax city",2,2,84,45,39
050,51,640,"Virginia","Galax city",2,3,87,44,43
050,51,640,"Virginia","Galax city",2,4,100,51,49
050,51,640,"Virginia","Galax city",2,5,91,40,51
050,51,640,"Virginia","Galax city",2,6,81,39,42
050,51,640,"Virginia","Galax city",2,7,91,45,46
050,51,640,"Virginia","Galax city",2,8,92,49,43
050,51,640,"Virginia","Galax city",2,9,98,52,46
050,51,640,"Virginia","Galax city",2,10,98,52,46
050,51,640,"Virginia","Galax city",2,11,91,44,47
050,51,640,"Virginia","Galax city",2,12,94,47,47
050,51,640,"Virginia","Galax city",2,13,99,55,44
050,51,640,"Virginia","Galax city",2,14,99,54,45
050,51,640,"Virginia","Galax city",2,15,82,39,43
050,51,640,"Virginia","Galax city",2,16,86,44,42
050,51,640,"Virginia","Galax city",2,17,92,48,44
050,51,640,"Virginia","Galax city",2,18,89,44,45
050,51,640,"Virginia","Galax city",2,19,68,32,36
050,51,640,"Virginia","Galax city",2,20,69,32,37
050,51,640,"Virginia","Galax city",2,21,83,38,45
050,51,640,"Virginia","Galax city",2,22,89,44,45
050,51,640,"Virginia","Galax city",2,23,83,40,43
050,51,640,"Virginia","Galax city",2,24,80,42,38
050,51,640,"Virginia","Galax city",2,25,74,37,37
050,51,640,"Virginia","Galax city",2,26,81,42,39
050,51,640,"Virginia","Galax city",2,27,87,45,42
050,51,640,"Virginia","Galax city",2,28,78,35,43
050,51,640,"Virginia","Galax city",2,29,75,28,47
050,51,640,"Virginia","Galax city",2,30,82,37,45
050,51,640,"Virginia","Galax city",2,31,82,37,45
050,51,640,"Virginia","Galax city",2,32,75,39,36
050,51,640,"Virginia","Galax city",2,33,76,42,34
050,51,640,"Virginia","Galax city",2,34,75,37,38
050,51,640,"Virginia","Galax city",2,35,85,44,41
050,51,640,"Virginia","Galax city",2,36,69,36,33
050,51,640,"Virginia","Galax city",2,37,52,25,27
050,51,640,"Virginia","Galax city",2,38,61,33,28
050,51,640,"Virginia","Galax city",2,39,68,31,37
050,51,640,"Virginia","Galax city",2,40,80,37,43
050,51,640,"Virginia","Galax city",2,41,76,32,44
050,51,640,"Virginia","Galax city",2,42,65,26,39
050,51,640,"Virginia","Galax city",2,43,75,38,37
050,51,640,"Virginia","Galax city",2,44,82,42,40
050,51,640,"Virginia","Galax city",2,45,85,41,44
050,51,640,"Virginia","Galax city",2,46,79,40,39
050,51,640,"Virginia","Galax city",2,47,88,45,43
050,51,640,"Virginia","Galax city",2,48,90,46,44
050,51,640,"Virginia","Galax city",2,49,85,41,44
050,51,640,"Virginia","Galax city",2,50,87,43,44
050,51,640,"Virginia","Galax city",2,51,100,49,51
050,51,640,"Virginia","Galax city",2,52,100,47,53
050,51,640,"Virginia","Galax city",2,53,104,47,57
050,51,640,"Virginia","Galax city",2,54,102,46,56
050,51,640,"Virginia","Galax city",2,55,103,48,55
050,51,640,"Virginia","Galax city",2,56,81,38,43
050,51,640,"Virginia","Galax city",2,57,71,37,34
050,51,640,"Virginia","Galax city",2,58,84,45,39
050,51,640,"Virginia","Galax city",2,59,88,38,50
050,51,640,"Virginia","Galax city",2,60,89,35,54
050,51,640,"Virginia","Galax city",2,61,84,37,47
050,51,640,"Virginia","Galax city",2,62,94,45,49
050,51,640,"Virginia","Galax city",2,63,102,49,53
050,51,640,"Virginia","Galax city",2,64,98,40,58
050,51,640,"Virginia","Galax city",2,65,98,48,50
050,51,640,"Virginia","Galax city",2,66,85,42,43
050,51,640,"Virginia","Galax city",2,67,63,29,34
050,51,640,"Virginia","Galax city",2,68,65,30,35
050,51,640,"Virginia","Galax city",2,69,66,29,37
050,51,640,"Virginia","Galax city",2,70,66,32,34
050,51,640,"Virginia","Galax city",2,71,60,21,39
050,51,640,"Virginia","Galax city",2,72,55,17,38
050,51,640,"Virginia","Galax city",2,73,61,21,40
050,51,640,"Virginia","Galax city",2,74,41,16,25
050,51,640,"Virginia","Galax city",2,75,40,15,25
050,51,640,"Virginia","Galax city",2,76,45,16,29
050,51,640,"Virginia","Galax city",2,77,45,16,29
050,51,640,"Virginia","Galax city",2,78,36,12,24
050,51,640,"Virginia","Galax city",2,79,43,19,24
050,51,640,"Virginia","Galax city",2,80,30,12,18
050,51,640,"Virginia","Galax city",2,81,23,11,12
050,51,640,"Virginia","Galax city",2,82,26,10,16
050,51,640,"Virginia","Galax city",2,83,25,9,16
050,51,640,"Virginia","Galax city",2,84,23,4,19
050,51,640,"Virginia","Galax city",2,85,194,44,150
050,51,640,"Virginia","Galax city",3,0,108,55,53
050,51,640,"Virginia","Galax city",3,1,96,55,41
050,51,640,"Virginia","Galax city",3,2,87,46,41
050,51,640,"Virginia","Galax city",3,3,80,44,36
050,51,640,"Virginia","Galax city",3,4,82,43,39
050,51,640,"Virginia","Galax city",3,5,94,47,47
050,51,640,"Virginia","Galax city",3,6,85,39,46
050,51,640,"Virginia","Galax city",3,7,79,40,39
050,51,640,"Virginia","Galax city",3,8,99,51,48
050,51,640,"Virginia","Galax city",3,9,97,49,48
050,51,640,"Virginia","Galax city",3,10,101,55,46
050,51,640,"Virginia","Galax city",3,11,99,55,44
050,51,640,"Virginia","Galax city",3,12,88,43,45
050,51,640,"Virginia","Galax city",3,13,103,52,51
050,51,640,"Virginia","Galax city",3,14,103,56,47
050,51,640,"Virginia","Galax city",3,15,103,55,48
050,51,640,"Virginia","Galax city",3,16,81,37,44
050,51,640,"Virginia","Galax city",3,17,85,42,43
050,51,640,"Virginia","Galax city",3,18,84,48,36
050,51,640,"Virginia","Galax city",3,19,73,37,36
050,51,640,"Virginia","Galax city",3,20,71,32,39
050,51,640,"Virginia","Galax city",3,21,69,31,38
050,51,640,"Virginia","Galax city",3,22,75,35,40
050,51,640,"Virginia","Galax city",3,23,87,40,47
050,51,640,"Virginia","Galax city",3,24,79,41,38
050,51,640,"Virginia","Galax city",3,25,86,47,39
050,51,640,"Virginia","Galax city",3,26,78,40,38
050,51,640,"Virginia","Galax city",3,27,88,45,43
050,51,640,"Virginia","Galax city",3,28,84,44,40
050,51,640,"Virginia","Galax city",3,29,79,33,46
050,51,640,"Virginia","Galax city",3,30,72,25,47
050,51,640,"Virginia","Galax city",3,31,82,30,52
050,51,640,"Virginia","Galax city",3,32,80,39,41
050,51,640,"Virginia","Galax city",3,33,71,36,35
050,51,640,"Virginia","Galax city",3,34,72,38,34
050,51,640,"Virginia","Galax city",3,35,72,32,40
050,51,640,"Virginia","Galax city",3,36,84,44,40
050,51,640,"Virginia","Galax city",3,37,66,36,30
050,51,640,"Virginia","Galax city",3,38,59,32,27
050,51,640,"Virginia","Galax city",3,39,61,34,27
050,51,640,"Virginia","Galax city",3,40,68,31,37
050,51,640,"Virginia","Galax city",3,41,84,37,47
050,51,640,"Virginia","Galax city",3,42,82,35,47
050,51,640,"Virginia","Galax city",3,43,67,28,39
050,51,640,"Virginia","Galax city",3,44,74,38,36
050,51,640,"Virginia","Galax city",3,45,81,41,40
050,51,640,"Virginia","Galax city",3,46,87,43,44
050,51,640,"Virginia","Galax city",3,47,84,45,39
050,51,640,"Virginia","Galax city",3,48,82,43,39
050,51,640,"Virginia","Galax city",3,49,94,47,47
050,51,640,"Virginia","Galax city",3,50,79,38,41
050,51,640,"Virginia","Galax city",3,51,88,44,44
050,51,640,"Virginia","Galax city",3,52,97,47,50
050,51,640,"Virginia","Galax city",3,53,96,45,51
050,51,640,"Virginia","Galax city",3,54,100,44,56
050,51,640,"Virginia","Galax city",3,55,107,51,56
050,51,640,"Virginia","Galax city",3,56,98,43,55
050,51,640,"Virginia","Galax city",3,57,82,38,44
050,51,640,"Virginia","Galax city",3,58,69,39,30
050,51,640,"Virginia","Galax city",3,59,83,44,39
050,51,640,"Virginia","Galax city",3,60,84,35,49
050,51,640,"Virginia","Galax city",3,61,84,32,52
050,51,640,"Virginia","Galax city",3,62,82,34,48
050,51,640,"Virginia","Galax city",3,63,84,41,43
050,51,640,"Virginia","Galax city",3,64,96,45,51
050,51,640,"Virginia","Galax city",3,65,94,38,56
050,51,640,"Virginia","Galax city",3,66,91,47,44
050,51,640,"Virginia","Galax city",3,67,75,36,39
050,51,640,"Virginia","Galax city",3,68,58,25,33
050,51,640,"Virginia","Galax city",3,69,62,28,34
050,51,640,"Virginia","Galax city",3,70,65,25,40
050,51,640,"Virginia","Galax city",3,71,59,31,28
050,51,640,"Virginia","Galax city",3,72,59,20,39
050,51,640,"Virginia","Galax city",3,73,51,13,38
050,51,640,"Virginia","Galax city",3,74,56,21,35
050,51,640,"Virginia","Galax city",3,75,36,14,22
050,51,640,"Virginia","Galax city",3,76,37,15,22
050,51,640,"Virginia","Galax city",3,77,40,13,27
050,51,640,"Virginia","Galax city",3,78,39,12,27
050,51,640,"Virginia","Galax city",3,79,34,13,21
050,51,640,"Virginia","Galax city",3,80,37,15,22
050,51,640,"Virginia","Galax city",3,81,25,10,15
050,51,640,"Virginia","Galax city",3,82,27,11,16
050,51,640,"Virginia","Galax city",3,83,27,8,19
050,51,640,"Virginia","Galax city",3,84,20,8,12
050,51,640,"Virginia","Galax city",3,85,187,41,146
050,51,640,"Virginia","Galax city",4,0,119,59,60
050,51,640,"Virginia","Galax city",4,1,106,60,46
050,51,640,"Virginia","Galax city",4,2,98,57,41
050,51,640,"Virginia","Galax city",4,3,92,50,42
050,51,640,"Virginia","Galax city",4,4,92,49,43
050,51,640,"Virginia","Galax city",4,5,83,42,41
050,51,640,"Virginia","Galax city",4,6,105,47,58
050,51,640,"Virginia","Galax city",4,7,86,40,46
050,51,640,"Virginia","Galax city",4,8,85,41,44
050,51,640,"Virginia","Galax city",4,9,100,48,52
050,51,640,"Virginia","Galax city",4,10,100,55,45
050,51,640,"Virginia","Galax city",4,11,97,52,45
050,51,640,"Virginia","Galax city",4,12,106,57,49
050,51,640,"Virginia","Galax city",4,13,86,41,45
050,51,640,"Virginia","Galax city",4,14,96,47,49
050,51,640,"Virginia","Galax city",4,15,105,52,53
050,51,640,"Virginia","Galax city",4,16,110,60,50
050,51,640,"Virginia","Galax city",4,17,82,39,43
050,51,640,"Virginia","Galax city",4,18,81,38,43
050,51,640,"Virginia","Galax city",4,19,68,39,29
050,51,640,"Virginia","Galax city",4,20,70,33,37
050,51,640,"Virginia","Galax city",4,21,79,38,41
050,51,640,"Virginia","Galax city",4,22,74,33,41
050,51,640,"Virginia","Galax city",4,23,79,33,46
050,51,640,"Virginia","Galax city",4,24,84,39,45
050,51,640,"Virginia","Galax city",4,25,79,39,40
050,51,640,"Virginia","Galax city",4,26,93,51,42
050,51,640,"Virginia","Galax city",4,27,82,42,40
050,51,640,"Virginia","Galax city",4,28,78,39,39
050,51,640,"Virginia","Galax city",4,29,85,43,42
050,51,640,"Virginia","Galax city",4,30,80,33,47
050,51,640,"Virginia","Galax city",4,31,73,28,45
050,51,640,"Virginia","Galax city",4,32,80,30,50
050,51,640,"Virginia","Galax city",4,33,88,42,46
050,51,640,"Virginia","Galax city",4,34,65,31,34
050,51,640,"Virginia","Galax city",4,35,78,43,35
050,51,640,"Virginia","Galax city",4,36,71,33,38
050,51,640,"Virginia","Galax city",4,37,75,36,39
050,51,640,"Virginia","Galax city",4,38,68,39,29
050,51,640,"Virginia","Galax city",4,39,58,30,28
050,51,640,"Virginia","Galax city",4,40,59,35,24
050,51,640,"Virginia","Galax city",4,41,64,30,34
050,51,640,"Virginia","Galax city",4,42,81,35,46
050,51,640,"Virginia","Galax city",4,43,83,37,46
050,51,640,"Virginia","Galax city",4,44,63,26,37
050,51,640,"Virginia","Galax city",4,45,72,38,34
050,51,640,"Virginia","Galax city",4,46,76,38,38
050,51,640,"Virginia","Galax city",4,47,90,41,49
050,51,640,"Virginia","Galax city",4,48,81,43,38
050,51,640,"Virginia","Galax city",4,49,87,47,40
050,51,640,"Virginia","Galax city",4,50,96,47,49
050,51,640,"Virginia","Galax city",4,51,88,44,44
050,51,640,"Virginia","Galax city",4,52,95,46,49
050,51,640,"Virginia","Galax city",4,53,99,50,49
050,51,640,"Virginia","Galax city",4,54,89,43,46
050,51,640,"Virginia","Galax city",4,55,103,46,57
050,51,640,"Virginia","Galax city",4,56,108,47,61
050,51,640,"Virginia","Galax city",4,57,103,46,57
050,51,640,"Virginia","Galax city",4,58,88,38,50
050,51,640,"Virginia","Galax city",4,59,65,36,29
050,51,640,"Virginia","Galax city",4,60,78,42,36
050,51,640,"Virginia","Galax city",4,61,82,36,46
050,51,640,"Virginia","Galax city",4,62,86,33,53
050,51,640,"Virginia","Galax city",4,63,84,35,49
050,51,640,"Virginia","Galax city",4,64,86,40,46
050,51,640,"Virginia","Galax city",4,65,89,41,48
050,51,640,"Virginia","Galax city",4,66,80,33,47
050,51,640,"Virginia","Galax city",4,67,79,41,38
050,51,640,"Virginia","Galax city",4,68,73,33,40
050,51,640,"Virginia","Galax city",4,69,56,23,33
050,51,640,"Virginia","Galax city",4,70,61,27,34
050,51,640,"Virginia","Galax city",4,71,56,22,34
050,51,640,"Virginia","Galax city",4,72,59,30,29
050,51,640,"Virginia","Galax city",4,73,56,19,37
050,51,640,"Virginia","Galax city",4,74,46,12,34
050,51,640,"Virginia","Galax city",4,75,50,19,31
050,51,640,"Virginia","Galax city",4,76,30,14,16
050,51,640,"Virginia","Galax city",4,77,29,12,17
050,51,640,"Virginia","Galax city",4,78,36,9,27
050,51,640,"Virginia","Galax city",4,79,41,16,25
050,51,640,"Virginia","Galax city",4,80,27,10,17
050,51,640,"Virginia","Galax city",4,81,34,15,19
050,51,640,"Virginia","Galax city",4,82,25,7,18
050,51,640,"Virginia","Galax city",4,83,28,8,20
050,51,640,"Virginia","Galax city",4,84,23,7,16
050,51,640,"Virginia","Galax city",4,85,182,43,139
050,51,640,"Virginia","Galax city",5,0,120,61,59
050,51,640,"Virginia","Galax city",5,1,125,62,63
050,51,640,"Virginia","Galax city",5,2,103,56,47
050,51,640,"Virginia","Galax city",5,3,98,58,40
050,51,640,"Virginia","Galax city",5,4,86,45,41
050,51,640,"Virginia","Galax city",5,5,92,48,44
050,51,640,"Virginia","Galax city",5,6,84,41,43
050,51,640,"Virginia","Galax city",5,7,108,44,64
050,51,640,"Virginia","Galax city",5,8,88,42,46
050,51,640,"Virginia","Galax city",5,9,94,46,48
050,51,640,"Virginia","Galax city",5,10,102,46,56
050,51,640,"Virginia","Galax city",5,11,103,57,46
050,51,640,"Virginia","Galax city",5,12,105,56,49
050,51,640,"Virginia","Galax city",5,13,106,59,47
050,51,640,"Virginia","Galax city",5,14,86,40,46
050,51,640,"Virginia","Galax city",5,15,97,46,51
050,51,640,"Virginia","Galax city",5,16,103,50,53
050,51,640,"Virginia","Galax city",5,17,110,63,47
050,51,640,"Virginia","Galax city",5,18,78,39,39
050,51,640,"Virginia","Galax city",5,19,73,37,36
050,51,640,"Virginia","Galax city",5,20,68,37,31
050,51,640,"Virginia","Galax city",5,21,81,40,41
050,51,640,"Virginia","Galax city",5,22,81,37,44
050,51,640,"Virginia","Galax city",5,23,76,33,43
050,51,640,"Virginia","Galax city",5,24,79,34,45
050,51,640,"Virginia","Galax city",5,25,82,36,46
050,51,640,"Virginia","Galax city",5,26,82,42,40
050,51,640,"Virginia","Galax city",5,27,91,51,40
050,51,640,"Virginia","Galax city",5,28,80,42,38
050,51,640,"Virginia","Galax city",5,29,74,34,40
050,51,640,"Virginia","Galax city",5,30,92,45,47
050,51,640,"Virginia","Galax city",5,31,79,31,48
050,51,640,"Virginia","Galax city",5,32,71,26,45
050,51,640,"Virginia","Galax city",5,33,82,35,47
050,51,640,"Virginia","Galax city",5,34,83,42,41
050,51,640,"Virginia","Galax city",5,35,66,32,34
050,51,640,"Virginia","Galax city",5,36,78,45,33
050,51,640,"Virginia","Galax city",5,37,72,31,41
050,51,640,"Virginia","Galax city",5,38,79,41,38
050,51,640,"Virginia","Galax city",5,39,71,35,36
050,51,640,"Virginia","Galax city",5,40,61,36,25
050,51,640,"Virginia","Galax city",5,41,63,34,29
050,51,640,"Virginia","Galax city",5,42,66,29,37
050,51,640,"Virginia","Galax city",5,43,79,35,44
050,51,640,"Virginia","Galax city",5,44,84,39,45
050,51,640,"Virginia","Galax city",5,45,62,23,39
050,51,640,"Virginia","Galax city",5,46,82,44,38
050,51,640,"Virginia","Galax city",5,47,73,37,36
050,51,640,"Virginia","Galax city",5,48,87,42,45
050,51,640,"Virginia","Galax city",5,49,78,46,32
050,51,640,"Virginia","Galax city",5,50,88,47,41
050,51,640,"Virginia","Galax city",5,51,97,47,50
050,51,640,"Virginia","Galax city",5,52,84,42,42
050,51,640,"Virginia","Galax city",5,53,95,45,50
050,51,640,"Virginia","Galax city",5,54,88,44,44
050,51,640,"Virginia","Galax city",5,55,92,45,47
050,51,640,"Virginia","Galax city",5,56,102,43,59
050,51,640,"Virginia","Galax city",5,57,103,45,58
050,51,640,"Virginia","Galax city",5,58,105,50,55
050,51,640,"Virginia","Galax city",5,59,87,43,44
050,51,640,"Virginia","Galax city",5,60,52,28,24
050,51,640,"Virginia","Galax city",5,61,79,43,36
050,51,640,"Virginia","Galax city",5,62,80,33,47
050,51,640,"Virginia","Galax city",5,63,85,31,54
050,51,640,"Virginia","Galax city",5,64,86,37,49
050,51,640,"Virginia","Galax city",5,65,86,41,45
050,51,640,"Virginia","Galax city",5,66,82,38,44
050,51,640,"Virginia","Galax city",5,67,73,32,41
050,51,640,"Virginia","Galax city",5,68,73,37,36
050,51,640,"Virginia","Galax city",5,69,67,28,39
050,51,640,"Virginia","Galax city",5,70,58,24,34
050,51,640,"Virginia","Galax city",5,71,54,27,27
050,51,640,"Virginia","Galax city",5,72,56,23,33
050,51,640,"Virginia","Galax city",5,73,53,25,28
050,51,640,"Virginia","Galax city",5,74,51,19,32
050,51,640,"Virginia","Galax city",5,75,42,10,32
050,51,640,"Virginia","Galax city",5,76,42,17,25
050,51,640,"Virginia","Galax city",5,77,22,10,12
050,51,640,"Virginia","Galax city",5,78,26,11,15
050,51,640,"Virginia","Galax city",5,79,34,11,23
050,51,640,"Virginia","Galax city",5,80,35,14,21
050,51,640,"Virginia","Galax city",5,81,20,8,12
050,51,640,"Virginia","Galax city",5,82,31,10,21
050,51,640,"Virginia","Galax city",5,83,26,6,20
050,51,640,"Virginia","Galax city",5,84,23,7,16
050,51,640,"Virginia","Galax city",5,85,177,41,136
050,51,650,"Virginia","Hampton city",1,0,1677,855,822
050,51,650,"Virginia","Hampton city",1,1,1721,877,844
050,51,650,"Virginia","Hampton city",1,2,1713,928,785
050,51,650,"Virginia","Hampton city",1,3,1766,901,865
050,51,650,"Virginia","Hampton city",1,4,1629,830,799
050,51,650,"Virginia","Hampton city",1,5,1612,817,795
050,51,650,"Virginia","Hampton city",1,6,1579,808,771
050,51,650,"Virginia","Hampton city",1,7,1615,796,819
050,51,650,"Virginia","Hampton city",1,8,1584,801,783
050,51,650,"Virginia","Hampton city",1,9,1578,816,762
050,51,650,"Virginia","Hampton city",1,10,1644,828,816
050,51,650,"Virginia","Hampton city",1,11,1638,841,797
050,51,650,"Virginia","Hampton city",1,12,1753,902,851
050,51,650,"Virginia","Hampton city",1,13,1663,828,835
050,51,650,"Virginia","Hampton city",1,14,1589,830,759
050,51,650,"Virginia","Hampton city",1,15,1596,820,776
050,51,650,"Virginia","Hampton city",1,16,1607,811,796
050,51,650,"Virginia","Hampton city",1,17,1570,813,757
050,51,650,"Virginia","Hampton city",1,18,1967,948,1019
050,51,650,"Virginia","Hampton city",1,19,2098,965,1133
050,51,650,"Virginia","Hampton city",1,20,2067,1017,1050
050,51,650,"Virginia","Hampton city",1,21,2025,1018,1007
050,51,650,"Virginia","Hampton city",1,22,2051,1100,951
050,51,650,"Virginia","Hampton city",1,23,2207,1147,1060
050,51,650,"Virginia","Hampton city",1,24,2249,1184,1065
050,51,650,"Virginia","Hampton city",1,25,2261,1201,1060
050,51,650,"Virginia","Hampton city",1,26,2298,1208,1090
050,51,650,"Virginia","Hampton city",1,27,2305,1177,1128
050,51,650,"Virginia","Hampton city",1,28,2179,1119,1060
050,51,650,"Virginia","Hampton city",1,29,2222,1121,1101
050,51,650,"Virginia","Hampton city",1,30,2237,1132,1105
050,51,650,"Virginia","Hampton city",1,31,2157,1059,1098
050,51,650,"Virginia","Hampton city",1,32,2030,995,1035
050,51,650,"Virginia","Hampton city",1,33,1884,928,956
050,51,650,"Virginia","Hampton city",1,34,1917,929,988
050,51,650,"Virginia","Hampton city",1,35,1863,925,938
050,51,650,"Virginia","Hampton city",1,36,1820,888,932
050,51,650,"Virginia","Hampton city",1,37,1809,861,948
050,51,650,"Virginia","Hampton city",1,38,1787,859,928
050,51,650,"Virginia","Hampton city",1,39,1747,834,913
050,51,650,"Virginia","Hampton city",1,40,1716,823,893
050,51,650,"Virginia","Hampton city",1,41,1545,715,830
050,51,650,"Virginia","Hampton city",1,42,1449,671,778
050,51,650,"Virginia","Hampton city",1,43,1431,693,738
050,51,650,"Virginia","Hampton city",1,44,1335,629,706
050,51,650,"Virginia","Hampton city",1,45,1302,609,693
050,51,650,"Virginia","Hampton city",1,46,1253,583,670
050,51,650,"Virginia","Hampton city",1,47,1333,612,721
050,51,650,"Virginia","Hampton city",1,48,1398,642,756
050,51,650,"Virginia","Hampton city",1,49,1516,685,831
050,51,650,"Virginia","Hampton city",1,50,1545,695,850
050,51,650,"Virginia","Hampton city",1,51,1453,657,796
050,51,650,"Virginia","Hampton city",1,52,1453,665,788
050,51,650,"Virginia","Hampton city",1,53,1460,686,774
050,51,650,"Virginia","Hampton city",1,54,1704,794,910
050,51,650,"Virginia","Hampton city",1,55,1806,802,1004
050,51,650,"Virginia","Hampton city",1,56,1859,849,1010
050,51,650,"Virginia","Hampton city",1,57,1963,960,1003
050,51,650,"Virginia","Hampton city",1,58,1984,977,1007
050,51,650,"Virginia","Hampton city",1,59,1988,953,1035
050,51,650,"Virginia","Hampton city",1,60,1992,918,1074
050,51,650,"Virginia","Hampton city",1,61,1892,872,1020
050,51,650,"Virginia","Hampton city",1,62,1839,867,972
050,51,650,"Virginia","Hampton city",1,63,1823,869,954
050,51,650,"Virginia","Hampton city",1,64,1760,836,924
050,51,650,"Virginia","Hampton city",1,65,1663,794,869
050,51,650,"Virginia","Hampton city",1,66,1541,711,830
050,51,650,"Virginia","Hampton city",1,67,1443,665,778
050,51,650,"Virginia","Hampton city",1,68,1386,623,763
050,51,650,"Virginia","Hampton city",1,69,1282,576,706
050,51,650,"Virginia","Hampton city",1,70,1270,566,704
050,51,650,"Virginia","Hampton city",1,71,1210,534,676
050,51,650,"Virginia","Hampton city",1,72,1166,500,666
050,51,650,"Virginia","Hampton city",1,73,1123,482,641
050,51,650,"Virginia","Hampton city",1,74,890,385,505
050,51,650,"Virginia","Hampton city",1,75,913,379,534
050,51,650,"Virginia","Hampton city",1,76,879,377,502
050,51,650,"Virginia","Hampton city",1,77,795,341,454
050,51,650,"Virginia","Hampton city",1,78,706,292,414
050,51,650,"Virginia","Hampton city",1,79,658,265,393
050,51,650,"Virginia","Hampton city",1,80,601,255,346
050,51,650,"Virginia","Hampton city",1,81,559,227,332
050,51,650,"Virginia","Hampton city",1,82,481,184,297
050,51,650,"Virginia","Hampton city",1,83,456,164,292
050,51,650,"Virginia","Hampton city",1,84,403,151,252
050,51,650,"Virginia","Hampton city",1,85,2219,765,1454
050,51,650,"Virginia","Hampton city",2,0,1634,841,793
050,51,650,"Virginia","Hampton city",2,1,1698,874,824
050,51,650,"Virginia","Hampton city",2,2,1720,916,804
050,51,650,"Virginia","Hampton city",2,3,1750,906,844
050,51,650,"Virginia","Hampton city",2,4,1659,848,811
050,51,650,"Virginia","Hampton city",2,5,1614,821,793
050,51,650,"Virginia","Hampton city",2,6,1585,808,777
050,51,650,"Virginia","Hampton city",2,7,1607,800,807
050,51,650,"Virginia","Hampton city",2,8,1590,799,791
050,51,650,"Virginia","Hampton city",2,9,1577,811,766
050,51,650,"Virginia","Hampton city",2,10,1622,824,798
050,51,650,"Virginia","Hampton city",2,11,1644,843,801
050,51,650,"Virginia","Hampton city",2,12,1736,892,844
050,51,650,"Virginia","Hampton city",2,13,1681,843,838
050,51,650,"Virginia","Hampton city",2,14,1601,824,777
050,51,650,"Virginia","Hampton city",2,15,1593,824,769
050,51,650,"Virginia","Hampton city",2,16,1611,818,793
050,51,650,"Virginia","Hampton city",2,17,1584,817,767
050,51,650,"Virginia","Hampton city",2,18,1961,946,1015
050,51,650,"Virginia","Hampton city",2,19,2110,969,1141
050,51,650,"Virginia","Hampton city",2,20,2088,1027,1061
050,51,650,"Virginia","Hampton city",2,21,2034,1021,1013
050,51,650,"Virginia","Hampton city",2,22,2068,1096,972
050,51,650,"Virginia","Hampton city",2,23,2174,1131,1043
050,51,650,"Virginia","Hampton city",2,24,2218,1169,1049
050,51,650,"Virginia","Hampton city",2,25,2254,1199,1055
050,51,650,"Virginia","Hampton city",2,26,2293,1204,1089
050,51,650,"Virginia","Hampton city",2,27,2281,1174,1107
050,51,650,"Virginia","Hampton city",2,28,2192,1121,1071
050,51,650,"Virginia","Hampton city",2,29,2209,1119,1090
050,51,650,"Virginia","Hampton city",2,30,2234,1132,1102
050,51,650,"Virginia","Hampton city",2,31,2167,1074,1093
050,51,650,"Virginia","Hampton city",2,32,2038,998,1040
050,51,650,"Virginia","Hampton city",2,33,1908,940,968
050,51,650,"Virginia","Hampton city",2,34,1911,935,976
050,51,650,"Virginia","Hampton city",2,35,1884,930,954
050,51,650,"Virginia","Hampton city",2,36,1810,886,924
050,51,650,"Virginia","Hampton city",2,37,1815,866,949
050,51,650,"Virginia","Hampton city",2,38,1798,860,938
050,51,650,"Virginia","Hampton city",2,39,1747,837,910
050,51,650,"Virginia","Hampton city",2,40,1733,830,903
050,51,650,"Virginia","Hampton city",2,41,1579,737,842
050,51,650,"Virginia","Hampton city",2,42,1468,681,787
050,51,650,"Virginia","Hampton city",2,43,1441,691,750
050,51,650,"Virginia","Hampton city",2,44,1344,639,705
050,51,650,"Virginia","Hampton city",2,45,1324,624,700
050,51,650,"Virginia","Hampton city",2,46,1263,586,677
050,51,650,"Virginia","Hampton city",2,47,1310,603,707
050,51,650,"Virginia","Hampton city",2,48,1379,634,745
050,51,650,"Virginia","Hampton city",2,49,1493,674,819
050,51,650,"Virginia","Hampton city",2,50,1544,696,848
050,51,650,"Virginia","Hampton city",2,51,1464,660,804
050,51,650,"Virginia","Hampton city",2,52,1449,661,788
050,51,650,"Virginia","Hampton city",2,53,1460,683,777
050,51,650,"Virginia","Hampton city",2,54,1644,767,877
050,51,650,"Virginia","Hampton city",2,55,1777,796,981
050,51,650,"Virginia","Hampton city",2,56,1848,841,1007
050,51,650,"Virginia","Hampton city",2,57,1936,934,1002
050,51,650,"Virginia","Hampton city",2,58,1983,979,1004
050,51,650,"Virginia","Hampton city",2,59,1994,963,1031
050,51,650,"Virginia","Hampton city",2,60,1991,928,1063
050,51,650,"Virginia","Hampton city",2,61,1902,874,1028
050,51,650,"Virginia","Hampton city",2,62,1850,865,985
050,51,650,"Virginia","Hampton city",2,63,1832,869,963
050,51,650,"Virginia","Hampton city",2,64,1756,835,921
050,51,650,"Virginia","Hampton city",2,65,1680,800,880
050,51,650,"Virginia","Hampton city",2,66,1573,732,841
050,51,650,"Virginia","Hampton city",2,67,1457,669,788
050,51,650,"Virginia","Hampton city",2,68,1384,627,757
050,51,650,"Virginia","Hampton city",2,69,1310,588,722
050,51,650,"Virginia","Hampton city",2,70,1260,559,701
050,51,650,"Virginia","Hampton city",2,71,1212,533,679
050,51,650,"Virginia","Hampton city",2,72,1160,500,660
050,51,650,"Virginia","Hampton city",2,73,1167,500,667
050,51,650,"Virginia","Hampton city",2,74,892,383,509
050,51,650,"Virginia","Hampton city",2,75,906,380,526
050,51,650,"Virginia","Hampton city",2,76,875,374,501
050,51,650,"Virginia","Hampton city",2,77,818,348,470
050,51,650,"Virginia","Hampton city",2,78,709,297,412
050,51,650,"Virginia","Hampton city",2,79,662,266,396
050,51,650,"Virginia","Hampton city",2,80,613,258,355
050,51,650,"Virginia","Hampton city",2,81,559,230,329
050,51,650,"Virginia","Hampton city",2,82,493,189,304
050,51,650,"Virginia","Hampton city",2,83,452,164,288
050,51,650,"Virginia","Hampton city",2,84,409,154,255
050,51,650,"Virginia","Hampton city",2,85,2225,770,1455
050,51,650,"Virginia","Hampton city",3,0,1611,825,786
050,51,650,"Virginia","Hampton city",3,1,1646,863,783
050,51,650,"Virginia","Hampton city",3,2,1707,912,795
050,51,650,"Virginia","Hampton city",3,3,1700,910,790
050,51,650,"Virginia","Hampton city",3,4,1771,933,838
050,51,650,"Virginia","Hampton city",3,5,1642,837,805
050,51,650,"Virginia","Hampton city",3,6,1687,858,829
050,51,650,"Virginia","Hampton city",3,7,1611,821,790
050,51,650,"Virginia","Hampton city",3,8,1633,817,816
050,51,650,"Virginia","Hampton city",3,9,1643,814,829
050,51,650,"Virginia","Hampton city",3,10,1600,823,777
050,51,650,"Virginia","Hampton city",3,11,1642,832,810
050,51,650,"Virginia","Hampton city",3,12,1648,846,802
050,51,650,"Virginia","Hampton city",3,13,1713,878,835
050,51,650,"Virginia","Hampton city",3,14,1664,838,826
050,51,650,"Virginia","Hampton city",3,15,1619,835,784
050,51,650,"Virginia","Hampton city",3,16,1584,827,757
050,51,650,"Virginia","Hampton city",3,17,1664,848,816
050,51,650,"Virginia","Hampton city",3,18,1898,921,977
050,51,650,"Virginia","Hampton city",3,19,2098,965,1133
050,51,650,"Virginia","Hampton city",3,20,2125,1043,1082
050,51,650,"Virginia","Hampton city",3,21,2146,1072,1074
050,51,650,"Virginia","Hampton city",3,22,2124,1103,1021
050,51,650,"Virginia","Hampton city",3,23,2116,1088,1028
050,51,650,"Virginia","Hampton city",3,24,2214,1171,1043
050,51,650,"Virginia","Hampton city",3,25,2153,1126,1027
050,51,650,"Virginia","Hampton city",3,26,2316,1194,1122
050,51,650,"Virginia","Hampton city",3,27,2320,1208,1112
050,51,650,"Virginia","Hampton city",3,28,2207,1137,1070
050,51,650,"Virginia","Hampton city",3,29,2154,1063,1091
050,51,650,"Virginia","Hampton city",3,30,2154,1066,1088
050,51,650,"Virginia","Hampton city",3,31,2204,1126,1078
050,51,650,"Virginia","Hampton city",3,32,2128,1037,1091
050,51,650,"Virginia","Hampton city",3,33,2005,963,1042
050,51,650,"Virginia","Hampton city",3,34,1945,972,973
050,51,650,"Virginia","Hampton city",3,35,1867,913,954
050,51,650,"Virginia","Hampton city",3,36,1857,899,958
050,51,650,"Virginia","Hampton city",3,37,1801,876,925
050,51,650,"Virginia","Hampton city",3,38,1834,872,962
050,51,650,"Virginia","Hampton city",3,39,1786,845,941
050,51,650,"Virginia","Hampton city",3,40,1745,827,918
050,51,650,"Virginia","Hampton city",3,41,1705,810,895
050,51,650,"Virginia","Hampton city",3,42,1601,764,837
050,51,650,"Virginia","Hampton city",3,43,1460,671,789
050,51,650,"Virginia","Hampton city",3,44,1394,648,746
050,51,650,"Virginia","Hampton city",3,45,1344,641,703
050,51,650,"Virginia","Hampton city",3,46,1316,612,704
050,51,650,"Virginia","Hampton city",3,47,1236,552,684
050,51,650,"Virginia","Hampton city",3,48,1277,600,677
050,51,650,"Virginia","Hampton city",3,49,1366,620,746
050,51,650,"Virginia","Hampton city",3,50,1517,684,833
050,51,650,"Virginia","Hampton city",3,51,1485,666,819
050,51,650,"Virginia","Hampton city",3,52,1430,648,782
050,51,650,"Virginia","Hampton city",3,53,1419,656,763
050,51,650,"Virginia","Hampton city",3,54,1456,687,769
050,51,650,"Virginia","Hampton city",3,55,1613,747,866
050,51,650,"Virginia","Hampton city",3,56,1748,781,967
050,51,650,"Virginia","Hampton city",3,57,1836,833,1003
050,51,650,"Virginia","Hampton city",3,58,1925,917,1008
050,51,650,"Virginia","Hampton city",3,59,1910,948,962
050,51,650,"Virginia","Hampton city",3,60,1978,951,1027
050,51,650,"Virginia","Hampton city",3,61,1974,901,1073
050,51,650,"Virginia","Hampton city",3,62,1866,856,1010
050,51,650,"Virginia","Hampton city",3,63,1833,867,966
050,51,650,"Virginia","Hampton city",3,64,1784,840,944
050,51,650,"Virginia","Hampton city",3,65,1695,784,911
050,51,650,"Virginia","Hampton city",3,66,1631,772,859
050,51,650,"Virginia","Hampton city",3,67,1542,715,827
050,51,650,"Virginia","Hampton city",3,68,1444,655,789
050,51,650,"Virginia","Hampton city",3,69,1332,598,734
050,51,650,"Virginia","Hampton city",3,70,1274,557,717
050,51,650,"Virginia","Hampton city",3,71,1217,528,689
050,51,650,"Virginia","Hampton city",3,72,1190,530,660
050,51,650,"Virginia","Hampton city",3,73,1105,476,629
050,51,650,"Virginia","Hampton city",3,74,1148,487,661
050,51,650,"Virginia","Hampton city",3,75,852,368,484
050,51,650,"Virginia","Hampton city",3,76,852,358,494
050,51,650,"Virginia","Hampton city",3,77,825,345,480
050,51,650,"Virginia","Hampton city",3,78,799,338,461
050,51,650,"Virginia","Hampton city",3,79,673,282,391
050,51,650,"Virginia","Hampton city",3,80,610,242,368
050,51,650,"Virginia","Hampton city",3,81,571,240,331
050,51,650,"Virginia","Hampton city",3,82,502,201,301
050,51,650,"Virginia","Hampton city",3,83,455,165,290
050,51,650,"Virginia","Hampton city",3,84,385,131,254
050,51,650,"Virginia","Hampton city",3,85,2203,749,1454
050,51,650,"Virginia","Hampton city",4,0,1624,837,787
050,51,650,"Virginia","Hampton city",4,1,1619,844,775
050,51,650,"Virginia","Hampton city",4,2,1594,829,765
050,51,650,"Virginia","Hampton city",4,3,1691,905,786
050,51,650,"Virginia","Hampton city",4,4,1723,917,806
050,51,650,"Virginia","Hampton city",4,5,1751,907,844
050,51,650,"Virginia","Hampton city",4,6,1661,821,840
050,51,650,"Virginia","Hampton city",4,7,1653,847,806
050,51,650,"Virginia","Hampton city",4,8,1661,837,824
050,51,650,"Virginia","Hampton city",4,9,1620,821,799
050,51,650,"Virginia","Hampton city",4,10,1647,822,825
050,51,650,"Virginia","Hampton city",4,11,1626,823,803
050,51,650,"Virginia","Hampton city",4,12,1665,841,824
050,51,650,"Virginia","Hampton city",4,13,1641,846,795
050,51,650,"Virginia","Hampton city",4,14,1715,872,843
050,51,650,"Virginia","Hampton city",4,15,1671,834,837
050,51,650,"Virginia","Hampton city",4,16,1623,830,793
050,51,650,"Virginia","Hampton city",4,17,1601,822,779
050,51,650,"Virginia","Hampton city",4,18,1961,944,1017
050,51,650,"Virginia","Hampton city",4,19,1993,918,1075
050,51,650,"Virginia","Hampton city",4,20,2102,1027,1075
050,51,650,"Virginia","Hampton city",4,21,2200,1129,1071
050,51,650,"Virginia","Hampton city",4,22,2202,1141,1061
050,51,650,"Virginia","Hampton city",4,23,2182,1125,1057
050,51,650,"Virginia","Hampton city",4,24,2151,1133,1018
050,51,650,"Virginia","Hampton city",4,25,2224,1143,1081
050,51,650,"Virginia","Hampton city",4,26,2138,1120,1018
050,51,650,"Virginia","Hampton city",4,27,2280,1160,1120
050,51,650,"Virginia","Hampton city",4,28,2262,1155,1107
050,51,650,"Virginia","Hampton city",4,29,2174,1099,1075
050,51,650,"Virginia","Hampton city",4,30,2135,1031,1104
050,51,650,"Virginia","Hampton city",4,31,2113,1058,1055
050,51,650,"Virginia","Hampton city",4,32,2179,1083,1096
050,51,650,"Virginia","Hampton city",4,33,2075,997,1078
050,51,650,"Virginia","Hampton city",4,34,1986,951,1035
050,51,650,"Virginia","Hampton city",4,35,1945,986,959
050,51,650,"Virginia","Hampton city",4,36,1870,901,969
050,51,650,"Virginia","Hampton city",4,37,1792,874,918
050,51,650,"Virginia","Hampton city",4,38,1807,876,931
050,51,650,"Virginia","Hampton city",4,39,1809,829,980
050,51,650,"Virginia","Hampton city",4,40,1760,821,939
050,51,650,"Virginia","Hampton city",4,41,1735,815,920
050,51,650,"Virginia","Hampton city",4,42,1672,793,879
050,51,650,"Virginia","Hampton city",4,43,1581,753,828
050,51,650,"Virginia","Hampton city",4,44,1465,653,812
050,51,650,"Virginia","Hampton city",4,45,1368,650,718
050,51,650,"Virginia","Hampton city",4,46,1320,613,707
050,51,650,"Virginia","Hampton city",4,47,1293,604,689
050,51,650,"Virginia","Hampton city",4,48,1227,541,686
050,51,650,"Virginia","Hampton city",4,49,1262,577,685
050,51,650,"Virginia","Hampton city",4,50,1362,619,743
050,51,650,"Virginia","Hampton city",4,51,1505,671,834
050,51,650,"Virginia","Hampton city",4,52,1482,673,809
050,51,650,"Virginia","Hampton city",4,53,1409,633,776
050,51,650,"Virginia","Hampton city",4,54,1433,677,756
050,51,650,"Virginia","Hampton city",4,55,1439,691,748
050,51,650,"Virginia","Hampton city",4,56,1584,720,864
050,51,650,"Virginia","Hampton city",4,57,1740,779,961
050,51,650,"Virginia","Hampton city",4,58,1780,804,976
050,51,650,"Virginia","Hampton city",4,59,1867,880,987
050,51,650,"Virginia","Hampton city",4,60,1905,935,970
050,51,650,"Virginia","Hampton city",4,61,1927,920,1007
050,51,650,"Virginia","Hampton city",4,62,1932,877,1055
050,51,650,"Virginia","Hampton city",4,63,1806,843,963
050,51,650,"Virginia","Hampton city",4,64,1790,834,956
050,51,650,"Virginia","Hampton city",4,65,1743,812,931
050,51,650,"Virginia","Hampton city",4,66,1653,750,903
050,51,650,"Virginia","Hampton city",4,67,1559,725,834
050,51,650,"Virginia","Hampton city",4,68,1515,697,818
050,51,650,"Virginia","Hampton city",4,69,1410,644,766
050,51,650,"Virginia","Hampton city",4,70,1298,583,715
050,51,650,"Virginia","Hampton city",4,71,1248,532,716
050,51,650,"Virginia","Hampton city",4,72,1198,522,676
050,51,650,"Virginia","Hampton city",4,73,1152,504,648
050,51,650,"Virginia","Hampton city",4,74,1060,458,602
050,51,650,"Virginia","Hampton city",4,75,1104,465,639
050,51,650,"Virginia","Hampton city",4,76,803,345,458
050,51,650,"Virginia","Hampton city",4,77,791,322,469
050,51,650,"Virginia","Hampton city",4,78,804,330,474
050,51,650,"Virginia","Hampton city",4,79,762,319,443
050,51,650,"Virginia","Hampton city",4,80,625,258,367
050,51,650,"Virginia","Hampton city",4,81,570,223,347
050,51,650,"Virginia","Hampton city",4,82,522,215,307
050,51,650,"Virginia","Hampton city",4,83,470,181,289
050,51,650,"Virginia","Hampton city",4,84,400,140,260
050,51,650,"Virginia","Hampton city",4,85,2161,711,1450
050,51,650,"Virginia","Hampton city",5,0,1612,832,780
050,51,650,"Virginia","Hampton city",5,1,1673,872,801
050,51,650,"Virginia","Hampton city",5,2,1565,837,728
050,51,650,"Virginia","Hampton city",5,3,1612,830,782
050,51,650,"Virginia","Hampton city",5,4,1635,888,747
050,51,650,"Virginia","Hampton city",5,5,1662,886,776
050,51,650,"Virginia","Hampton city",5,6,1694,873,821
050,51,650,"Virginia","Hampton city",5,7,1648,829,819
050,51,650,"Virginia","Hampton city",5,8,1645,863,782
050,51,650,"Virginia","Hampton city",5,9,1639,838,801
050,51,650,"Virginia","Hampton city",5,10,1614,809,805
050,51,650,"Virginia","Hampton city",5,11,1622,807,815
050,51,650,"Virginia","Hampton city",5,12,1594,806,788
050,51,650,"Virginia","Hampton city",5,13,1673,866,807
050,51,650,"Virginia","Hampton city",5,14,1639,831,808
050,51,650,"Virginia","Hampton city",5,15,1686,864,822
050,51,650,"Virginia","Hampton city",5,16,1671,836,835
050,51,650,"Virginia","Hampton city",5,17,1628,842,786
050,51,650,"Virginia","Hampton city",5,18,1874,896,978
050,51,650,"Virginia","Hampton city",5,19,2025,936,1089
050,51,650,"Virginia","Hampton city",5,20,1983,983,1000
050,51,650,"Virginia","Hampton city",5,21,2013,1018,995
050,51,650,"Virginia","Hampton city",5,22,2213,1160,1053
050,51,650,"Virginia","Hampton city",5,23,2206,1123,1083
050,51,650,"Virginia","Hampton city",5,24,2098,1107,991
050,51,650,"Virginia","Hampton city",5,25,2103,1125,978
050,51,650,"Virginia","Hampton city",5,26,2214,1159,1055
050,51,650,"Virginia","Hampton city",5,27,2043,1059,984
050,51,650,"Virginia","Hampton city",5,28,2201,1116,1085
050,51,650,"Virginia","Hampton city",5,29,2207,1117,1090
050,51,650,"Virginia","Hampton city",5,30,2129,1065,1064
050,51,650,"Virginia","Hampton city",5,31,2078,991,1087
050,51,650,"Virginia","Hampton city",5,32,2123,1065,1058
050,51,650,"Virginia","Hampton city",5,33,2164,1090,1074
050,51,650,"Virginia","Hampton city",5,34,2025,1002,1023
050,51,650,"Virginia","Hampton city",5,35,1934,913,1021
050,51,650,"Virginia","Hampton city",5,36,1932,948,984
050,51,650,"Virginia","Hampton city",5,37,1920,912,1008
050,51,650,"Virginia","Hampton city",5,38,1792,868,924
050,51,650,"Virginia","Hampton city",5,39,1785,840,945
050,51,650,"Virginia","Hampton city",5,40,1769,828,941
050,51,650,"Virginia","Hampton city",5,41,1759,840,919
050,51,650,"Virginia","Hampton city",5,42,1717,804,913
050,51,650,"Virginia","Hampton city",5,43,1644,774,870
050,51,650,"Virginia","Hampton city",5,44,1546,733,813
050,51,650,"Virginia","Hampton city",5,45,1473,660,813
050,51,650,"Virginia","Hampton city",5,46,1332,603,729
050,51,650,"Virginia","Hampton city",5,47,1296,603,693
050,51,650,"Virginia","Hampton city",5,48,1295,608,687
050,51,650,"Virginia","Hampton city",5,49,1225,534,691
050,51,650,"Virginia","Hampton city",5,50,1228,555,673
050,51,650,"Virginia","Hampton city",5,51,1366,613,753
050,51,650,"Virginia","Hampton city",5,52,1483,667,816
050,51,650,"Virginia","Hampton city",5,53,1458,667,791
050,51,650,"Virginia","Hampton city",5,54,1370,605,765
050,51,650,"Virginia","Hampton city",5,55,1392,639,753
050,51,650,"Virginia","Hampton city",5,56,1409,674,735
050,51,650,"Virginia","Hampton city",5,57,1534,688,846
050,51,650,"Virginia","Hampton city",5,58,1706,761,945
050,51,650,"Virginia","Hampton city",5,59,1758,783,975
050,51,650,"Virginia","Hampton city",5,60,1846,869,977
050,51,650,"Virginia","Hampton city",5,61,1883,919,964
050,51,650,"Virginia","Hampton city",5,62,1915,925,990
050,51,650,"Virginia","Hampton city",5,63,1913,867,1046
050,51,650,"Virginia","Hampton city",5,64,1786,819,967
050,51,650,"Virginia","Hampton city",5,65,1742,805,937
050,51,650,"Virginia","Hampton city",5,66,1735,810,925
050,51,650,"Virginia","Hampton city",5,67,1620,734,886
050,51,650,"Virginia","Hampton city",5,68,1532,705,827
050,51,650,"Virginia","Hampton city",5,69,1483,674,809
050,51,650,"Virginia","Hampton city",5,70,1361,623,738
050,51,650,"Virginia","Hampton city",5,71,1269,555,714
050,51,650,"Virginia","Hampton city",5,72,1217,523,694
050,51,650,"Virginia","Hampton city",5,73,1151,496,655
050,51,650,"Virginia","Hampton city",5,74,1101,485,616
050,51,650,"Virginia","Hampton city",5,75,1034,437,597
050,51,650,"Virginia","Hampton city",5,76,1042,439,603
050,51,650,"Virginia","Hampton city",5,77,756,318,438
050,51,650,"Virginia","Hampton city",5,78,756,303,453
050,51,650,"Virginia","Hampton city",5,79,760,309,451
050,51,650,"Virginia","Hampton city",5,80,716,296,420
050,51,650,"Virginia","Hampton city",5,81,588,241,347
050,51,650,"Virginia","Hampton city",5,82,517,205,312
050,51,650,"Virginia","Hampton city",5,83,480,195,285
050,51,650,"Virginia","Hampton city",5,84,410,155,255
050,51,650,"Virginia","Hampton city",5,85,2151,685,1466
050,51,660,"Virginia","Harrisonburg city",1,0,578,296,282
050,51,660,"Virginia","Harrisonburg city",1,1,533,275,258
050,51,660,"Virginia","Harrisonburg city",1,2,532,280,252
050,51,660,"Virginia","Harrisonburg city",1,3,519,264,255
050,51,660,"Virginia","Harrisonburg city",1,4,551,262,289
050,51,660,"Virginia","Harrisonburg city",1,5,478,243,235
050,51,660,"Virginia","Harrisonburg city",1,6,507,257,250
050,51,660,"Virginia","Harrisonburg city",1,7,513,260,253
050,51,660,"Virginia","Harrisonburg city",1,8,480,241,239
050,51,660,"Virginia","Harrisonburg city",1,9,479,260,219
050,51,660,"Virginia","Harrisonburg city",1,10,466,258,208
050,51,660,"Virginia","Harrisonburg city",1,11,458,243,215
050,51,660,"Virginia","Harrisonburg city",1,12,466,228,238
050,51,660,"Virginia","Harrisonburg city",1,13,454,242,212
050,51,660,"Virginia","Harrisonburg city",1,14,467,240,227
050,51,660,"Virginia","Harrisonburg city",1,15,440,224,216
050,51,660,"Virginia","Harrisonburg city",1,16,452,218,234
050,51,660,"Virginia","Harrisonburg city",1,17,438,216,222
050,51,660,"Virginia","Harrisonburg city",1,18,2287,821,1466
050,51,660,"Virginia","Harrisonburg city",1,19,3748,1496,2252
050,51,660,"Virginia","Harrisonburg city",1,20,3116,1399,1717
050,51,660,"Virginia","Harrisonburg city",1,21,3058,1377,1681
050,51,660,"Virginia","Harrisonburg city",1,22,2099,1061,1038
050,51,660,"Virginia","Harrisonburg city",1,23,1186,592,594
050,51,660,"Virginia","Harrisonburg city",1,24,865,451,414
050,51,660,"Virginia","Harrisonburg city",1,25,770,372,398
050,51,660,"Virginia","Harrisonburg city",1,26,717,355,362
050,51,660,"Virginia","Harrisonburg city",1,27,711,370,341
050,51,660,"Virginia","Harrisonburg city",1,28,689,362,327
050,51,660,"Virginia","Harrisonburg city",1,29,671,355,316
050,51,660,"Virginia","Harrisonburg city",1,30,716,366,350
050,51,660,"Virginia","Harrisonburg city",1,31,688,359,329
050,51,660,"Virginia","Harrisonburg city",1,32,649,331,318
050,51,660,"Virginia","Harrisonburg city",1,33,650,335,315
050,51,660,"Virginia","Harrisonburg city",1,34,664,327,337
050,51,660,"Virginia","Harrisonburg city",1,35,675,346,329
050,51,660,"Virginia","Harrisonburg city",1,36,679,349,330
050,51,660,"Virginia","Harrisonburg city",1,37,639,326,313
050,51,660,"Virginia","Harrisonburg city",1,38,600,315,285
050,51,660,"Virginia","Harrisonburg city",1,39,610,329,281
050,51,660,"Virginia","Harrisonburg city",1,40,601,313,288
050,51,660,"Virginia","Harrisonburg city",1,41,554,292,262
050,51,660,"Virginia","Harrisonburg city",1,42,553,293,260
050,51,660,"Virginia","Harrisonburg city",1,43,561,297,264
050,51,660,"Virginia","Harrisonburg city",1,44,497,267,230
050,51,660,"Virginia","Harrisonburg city",1,45,491,268,223
050,51,660,"Virginia","Harrisonburg city",1,46,459,249,210
050,51,660,"Virginia","Harrisonburg city",1,47,474,252,222
050,51,660,"Virginia","Harrisonburg city",1,48,479,262,217
050,51,660,"Virginia","Harrisonburg city",1,49,483,256,227
050,51,660,"Virginia","Harrisonburg city",1,50,465,240,225
050,51,660,"Virginia","Harrisonburg city",1,51,441,233,208
050,51,660,"Virginia","Harrisonburg city",1,52,458,245,213
050,51,660,"Virginia","Harrisonburg city",1,53,451,233,218
050,51,660,"Virginia","Harrisonburg city",1,54,420,206,214
050,51,660,"Virginia","Harrisonburg city",1,55,418,203,215
050,51,660,"Virginia","Harrisonburg city",1,56,441,199,242
050,51,660,"Virginia","Harrisonburg city",1,57,447,206,241
050,51,660,"Virginia","Harrisonburg city",1,58,404,207,197
050,51,660,"Virginia","Harrisonburg city",1,59,388,193,195
050,51,660,"Virginia","Harrisonburg city",1,60,393,181,212
050,51,660,"Virginia","Harrisonburg city",1,61,388,190,198
050,51,660,"Virginia","Harrisonburg city",1,62,380,199,181
050,51,660,"Virginia","Harrisonburg city",1,63,413,201,212
050,51,660,"Virginia","Harrisonburg city",1,64,367,179,188
050,51,660,"Virginia","Harrisonburg city",1,65,342,168,174
050,51,660,"Virginia","Harrisonburg city",1,66,372,189,183
050,51,660,"Virginia","Harrisonburg city",1,67,366,191,175
050,51,660,"Virginia","Harrisonburg city",1,68,334,149,185
050,51,660,"Virginia","Harrisonburg city",1,69,293,125,168
050,51,660,"Virginia","Harrisonburg city",1,70,296,137,159
050,51,660,"Virginia","Harrisonburg city",1,71,260,115,145
050,51,660,"Virginia","Harrisonburg city",1,72,263,109,154
050,51,660,"Virginia","Harrisonburg city",1,73,232,101,131
050,51,660,"Virginia","Harrisonburg city",1,74,171,74,97
050,51,660,"Virginia","Harrisonburg city",1,75,176,87,89
050,51,660,"Virginia","Harrisonburg city",1,76,176,83,93
050,51,660,"Virginia","Harrisonburg city",1,77,190,82,108
050,51,660,"Virginia","Harrisonburg city",1,78,150,69,81
050,51,660,"Virginia","Harrisonburg city",1,79,138,58,80
050,51,660,"Virginia","Harrisonburg city",1,80,127,43,84
050,51,660,"Virginia","Harrisonburg city",1,81,130,56,74
050,51,660,"Virginia","Harrisonburg city",1,82,119,48,71
050,51,660,"Virginia","Harrisonburg city",1,83,113,54,59
050,51,660,"Virginia","Harrisonburg city",1,84,114,42,72
050,51,660,"Virginia","Harrisonburg city",1,85,724,232,492
050,51,660,"Virginia","Harrisonburg city",2,0,615,316,299
050,51,660,"Virginia","Harrisonburg city",2,1,536,274,262
050,51,660,"Virginia","Harrisonburg city",2,2,527,276,251
050,51,660,"Virginia","Harrisonburg city",2,3,516,265,251
050,51,660,"Virginia","Harrisonburg city",2,4,538,262,276
050,51,660,"Virginia","Harrisonburg city",2,5,494,248,246
050,51,660,"Virginia","Harrisonburg city",2,6,498,252,246
050,51,660,"Virginia","Harrisonburg city",2,7,507,255,252
050,51,660,"Virginia","Harrisonburg city",2,8,483,243,240
050,51,660,"Virginia","Harrisonburg city",2,9,474,254,220
050,51,660,"Virginia","Harrisonburg city",2,10,463,257,206
050,51,660,"Virginia","Harrisonburg city",2,11,456,243,213
050,51,660,"Virginia","Harrisonburg city",2,12,462,233,229
050,51,660,"Virginia","Harrisonburg city",2,13,453,238,215
050,51,660,"Virginia","Harrisonburg city",2,14,458,238,220
050,51,660,"Virginia","Harrisonburg city",2,15,442,226,216
050,51,660,"Virginia","Harrisonburg city",2,16,444,217,227
050,51,660,"Virginia","Harrisonburg city",2,17,444,215,229
050,51,660,"Virginia","Harrisonburg city",2,18,2283,815,1468
050,51,660,"Virginia","Harrisonburg city",2,19,3735,1487,2248
050,51,660,"Virginia","Harrisonburg city",2,20,3151,1415,1736
050,51,660,"Virginia","Harrisonburg city",2,21,3069,1387,1682
050,51,660,"Virginia","Harrisonburg city",2,22,2085,1059,1026
050,51,660,"Virginia","Harrisonburg city",2,23,1171,587,584
050,51,660,"Virginia","Harrisonburg city",2,24,860,450,410
050,51,660,"Virginia","Harrisonburg city",2,25,753,359,394
050,51,660,"Virginia","Harrisonburg city",2,26,724,361,363
050,51,660,"Virginia","Harrisonburg city",2,27,702,362,340
050,51,660,"Virginia","Harrisonburg city",2,28,686,360,326
050,51,660,"Virginia","Harrisonburg city",2,29,665,352,313
050,51,660,"Virginia","Harrisonburg city",2,30,698,360,338
050,51,660,"Virginia","Harrisonburg city",2,31,677,355,322
050,51,660,"Virginia","Harrisonburg city",2,32,647,334,313
050,51,660,"Virginia","Harrisonburg city",2,33,638,328,310
050,51,660,"Virginia","Harrisonburg city",2,34,653,325,328
050,51,660,"Virginia","Harrisonburg city",2,35,670,341,329
050,51,660,"Virginia","Harrisonburg city",2,36,666,343,323
050,51,660,"Virginia","Harrisonburg city",2,37,640,326,314
050,51,660,"Virginia","Harrisonburg city",2,38,608,317,291
050,51,660,"Virginia","Harrisonburg city",2,39,602,324,278
050,51,660,"Virginia","Harrisonburg city",2,40,601,317,284
050,51,660,"Virginia","Harrisonburg city",2,41,557,292,265
050,51,660,"Virginia","Harrisonburg city",2,42,552,293,259
050,51,660,"Virginia","Harrisonburg city",2,43,560,295,265
050,51,660,"Virginia","Harrisonburg city",2,44,504,270,234
050,51,660,"Virginia","Harrisonburg city",2,45,492,265,227
050,51,660,"Virginia","Harrisonburg city",2,46,467,252,215
050,51,660,"Virginia","Harrisonburg city",2,47,467,248,219
050,51,660,"Virginia","Harrisonburg city",2,48,475,258,217
050,51,660,"Virginia","Harrisonburg city",2,49,481,257,224
050,51,660,"Virginia","Harrisonburg city",2,50,467,242,225
050,51,660,"Virginia","Harrisonburg city",2,51,444,233,211
050,51,660,"Virginia","Harrisonburg city",2,52,458,243,215
050,51,660,"Virginia","Harrisonburg city",2,53,448,234,214
050,51,660,"Virginia","Harrisonburg city",2,54,424,213,211
050,51,660,"Virginia","Harrisonburg city",2,55,418,201,217
050,51,660,"Virginia","Harrisonburg city",2,56,433,200,233
050,51,660,"Virginia","Harrisonburg city",2,57,442,202,240
050,51,660,"Virginia","Harrisonburg city",2,58,410,203,207
050,51,660,"Virginia","Harrisonburg city",2,59,389,193,196
050,51,660,"Virginia","Harrisonburg city",2,60,390,183,207
050,51,660,"Virginia","Harrisonburg city",2,61,387,187,200
050,51,660,"Virginia","Harrisonburg city",2,62,372,189,183
050,51,660,"Virginia","Harrisonburg city",2,63,405,201,204
050,51,660,"Virginia","Harrisonburg city",2,64,369,178,191
050,51,660,"Virginia","Harrisonburg city",2,65,345,170,175
050,51,660,"Virginia","Harrisonburg city",2,66,365,184,181
050,51,660,"Virginia","Harrisonburg city",2,67,368,190,178
050,51,660,"Virginia","Harrisonburg city",2,68,336,156,180
050,51,660,"Virginia","Harrisonburg city",2,69,302,130,172
050,51,660,"Virginia","Harrisonburg city",2,70,295,135,160
050,51,660,"Virginia","Harrisonburg city",2,71,264,117,147
050,51,660,"Virginia","Harrisonburg city",2,72,257,108,149
050,51,660,"Virginia","Harrisonburg city",2,73,250,108,142
050,51,660,"Virginia","Harrisonburg city",2,74,175,75,100
050,51,660,"Virginia","Harrisonburg city",2,75,171,83,88
050,51,660,"Virginia","Harrisonburg city",2,76,169,80,89
050,51,660,"Virginia","Harrisonburg city",2,77,193,85,108
050,51,660,"Virginia","Harrisonburg city",2,78,153,68,85
050,51,660,"Virginia","Harrisonburg city",2,79,138,58,80
050,51,660,"Virginia","Harrisonburg city",2,80,126,44,82
050,51,660,"Virginia","Harrisonburg city",2,81,126,54,72
050,51,660,"Virginia","Harrisonburg city",2,82,123,51,72
050,51,660,"Virginia","Harrisonburg city",2,83,110,49,61
050,51,660,"Virginia","Harrisonburg city",2,84,115,44,71
050,51,660,"Virginia","Harrisonburg city",2,85,720,231,489
050,51,660,"Virginia","Harrisonburg city",3,0,580,318,262
050,51,660,"Virginia","Harrisonburg city",3,1,579,318,261
050,51,660,"Virginia","Harrisonburg city",3,2,523,257,266
050,51,660,"Virginia","Harrisonburg city",3,3,510,266,244
050,51,660,"Virginia","Harrisonburg city",3,4,512,264,248
050,51,660,"Virginia","Harrisonburg city",3,5,531,271,260
050,51,660,"Virginia","Harrisonburg city",3,6,472,240,232
050,51,660,"Virginia","Harrisonburg city",3,7,495,252,243
050,51,660,"Virginia","Harrisonburg city",3,8,485,236,249
050,51,660,"Virginia","Harrisonburg city",3,9,474,227,247
050,51,660,"Virginia","Harrisonburg city",3,10,466,248,218
050,51,660,"Virginia","Harrisonburg city",3,11,466,251,215
050,51,660,"Virginia","Harrisonburg city",3,12,447,231,216
050,51,660,"Virginia","Harrisonburg city",3,13,461,232,229
050,51,660,"Virginia","Harrisonburg city",3,14,445,240,205
050,51,660,"Virginia","Harrisonburg city",3,15,432,225,207
050,51,660,"Virginia","Harrisonburg city",3,16,443,227,216
050,51,660,"Virginia","Harrisonburg city",3,17,455,218,237
050,51,660,"Virginia","Harrisonburg city",3,18,2304,828,1476
050,51,660,"Virginia","Harrisonburg city",3,19,3764,1491,2273
050,51,660,"Virginia","Harrisonburg city",3,20,3205,1437,1768
050,51,660,"Virginia","Harrisonburg city",3,21,3170,1442,1728
050,51,660,"Virginia","Harrisonburg city",3,22,2091,1081,1010
050,51,660,"Virginia","Harrisonburg city",3,23,1144,591,553
050,51,660,"Virginia","Harrisonburg city",3,24,842,440,402
050,51,660,"Virginia","Harrisonburg city",3,25,705,338,367
050,51,660,"Virginia","Harrisonburg city",3,26,721,356,365
050,51,660,"Virginia","Harrisonburg city",3,27,653,342,311
050,51,660,"Virginia","Harrisonburg city",3,28,684,348,336
050,51,660,"Virginia","Harrisonburg city",3,29,659,357,302
050,51,660,"Virginia","Harrisonburg city",3,30,600,326,274
050,51,660,"Virginia","Harrisonburg city",3,31,654,341,313
050,51,660,"Virginia","Harrisonburg city",3,32,636,336,300
050,51,660,"Virginia","Harrisonburg city",3,33,599,300,299
050,51,660,"Virginia","Harrisonburg city",3,34,618,323,295
050,51,660,"Virginia","Harrisonburg city",3,35,634,319,315
050,51,660,"Virginia","Harrisonburg city",3,36,633,308,325
050,51,660,"Virginia","Harrisonburg city",3,37,649,324,325
050,51,660,"Virginia","Harrisonburg city",3,38,608,303,305
050,51,660,"Virginia","Harrisonburg city",3,39,600,312,288
050,51,660,"Virginia","Harrisonburg city",3,40,590,317,273
050,51,660,"Virginia","Harrisonburg city",3,41,599,312,287
050,51,660,"Virginia","Harrisonburg city",3,42,543,285,258
050,51,660,"Virginia","Harrisonburg city",3,43,542,289,253
050,51,660,"Virginia","Harrisonburg city",3,44,547,285,262
050,51,660,"Virginia","Harrisonburg city",3,45,497,259,238
050,51,660,"Virginia","Harrisonburg city",3,46,485,260,225
050,51,660,"Virginia","Harrisonburg city",3,47,449,244,205
050,51,660,"Virginia","Harrisonburg city",3,48,452,240,212
050,51,660,"Virginia","Harrisonburg city",3,49,464,252,212
050,51,660,"Virginia","Harrisonburg city",3,50,465,248,217
050,51,660,"Virginia","Harrisonburg city",3,51,451,235,216
050,51,660,"Virginia","Harrisonburg city",3,52,434,226,208
050,51,660,"Virginia","Harrisonburg city",3,53,438,231,207
050,51,660,"Virginia","Harrisonburg city",3,54,436,224,212
050,51,660,"Virginia","Harrisonburg city",3,55,422,212,210
050,51,660,"Virginia","Harrisonburg city",3,56,408,190,218
050,51,660,"Virginia","Harrisonburg city",3,57,430,196,234
050,51,660,"Virginia","Harrisonburg city",3,58,437,213,224
050,51,660,"Virginia","Harrisonburg city",3,59,398,190,208
050,51,660,"Virginia","Harrisonburg city",3,60,365,177,188
050,51,660,"Virginia","Harrisonburg city",3,61,389,193,196
050,51,660,"Virginia","Harrisonburg city",3,62,383,187,196
050,51,660,"Virginia","Harrisonburg city",3,63,375,187,188
050,51,660,"Virginia","Harrisonburg city",3,64,384,193,191
050,51,660,"Virginia","Harrisonburg city",3,65,354,168,186
050,51,660,"Virginia","Harrisonburg city",3,66,346,176,170
050,51,660,"Virginia","Harrisonburg city",3,67,355,176,179
050,51,660,"Virginia","Harrisonburg city",3,68,355,178,177
050,51,660,"Virginia","Harrisonburg city",3,69,320,153,167
050,51,660,"Virginia","Harrisonburg city",3,70,289,122,167
050,51,660,"Virginia","Harrisonburg city",3,71,281,126,155
050,51,660,"Virginia","Harrisonburg city",3,72,268,121,147
050,51,660,"Virginia","Harrisonburg city",3,73,248,101,147
050,51,660,"Virginia","Harrisonburg city",3,74,242,102,140
050,51,660,"Virginia","Harrisonburg city",3,75,171,77,94
050,51,660,"Virginia","Harrisonburg city",3,76,154,73,81
050,51,660,"Virginia","Harrisonburg city",3,77,170,79,91
050,51,660,"Virginia","Harrisonburg city",3,78,178,78,100
050,51,660,"Virginia","Harrisonburg city",3,79,144,67,77
050,51,660,"Virginia","Harrisonburg city",3,80,119,49,70
050,51,660,"Virginia","Harrisonburg city",3,81,123,40,83
050,51,660,"Virginia","Harrisonburg city",3,82,124,56,68
050,51,660,"Virginia","Harrisonburg city",3,83,116,49,67
050,51,660,"Virginia","Harrisonburg city",3,84,100,32,68
050,51,660,"Virginia","Harrisonburg city",3,85,708,233,475
050,51,660,"Virginia","Harrisonburg city",4,0,596,304,292
050,51,660,"Virginia","Harrisonburg city",4,1,552,291,261
050,51,660,"Virginia","Harrisonburg city",4,2,554,298,256
050,51,660,"Virginia","Harrisonburg city",4,3,513,252,261
050,51,660,"Virginia","Harrisonburg city",4,4,500,250,250
050,51,660,"Virginia","Harrisonburg city",4,5,495,247,248
050,51,660,"Virginia","Harrisonburg city",4,6,495,251,244
050,51,660,"Virginia","Harrisonburg city",4,7,481,253,228
050,51,660,"Virginia","Harrisonburg city",4,8,499,265,234
050,51,660,"Virginia","Harrisonburg city",4,9,473,241,232
050,51,660,"Virginia","Harrisonburg city",4,10,438,202,236
050,51,660,"Virginia","Harrisonburg city",4,11,467,247,220
050,51,660,"Virginia","Harrisonburg city",4,12,449,246,203
050,51,660,"Virginia","Harrisonburg city",4,13,437,223,214
050,51,660,"Virginia","Harrisonburg city",4,14,466,227,239
050,51,660,"Virginia","Harrisonburg city",4,15,455,234,221
050,51,660,"Virginia","Harrisonburg city",4,16,428,215,213
050,51,660,"Virginia","Harrisonburg city",4,17,481,239,242
050,51,660,"Virginia","Harrisonburg city",4,18,2294,810,1484
050,51,660,"Virginia","Harrisonburg city",4,19,3733,1478,2255
050,51,660,"Virginia","Harrisonburg city",4,20,3211,1449,1762
050,51,660,"Virginia","Harrisonburg city",4,21,3238,1472,1766
050,51,660,"Virginia","Harrisonburg city",4,22,2191,1139,1052
050,51,660,"Virginia","Harrisonburg city",4,23,1132,599,533
050,51,660,"Virginia","Harrisonburg city",4,24,822,448,374
050,51,660,"Virginia","Harrisonburg city",4,25,710,316,394
050,51,660,"Virginia","Harrisonburg city",4,26,664,340,324
050,51,660,"Virginia","Harrisonburg city",4,27,629,323,306
050,51,660,"Virginia","Harrisonburg city",4,28,600,327,273
050,51,660,"Virginia","Harrisonburg city",4,29,604,307,297
050,51,660,"Virginia","Harrisonburg city",4,30,628,319,309
050,51,660,"Virginia","Harrisonburg city",4,31,574,307,267
050,51,660,"Virginia","Harrisonburg city",4,32,657,338,319
050,51,660,"Virginia","Harrisonburg city",4,33,600,313,287
050,51,660,"Virginia","Harrisonburg city",4,34,577,288,289
050,51,660,"Virginia","Harrisonburg city",4,35,593,319,274
050,51,660,"Virginia","Harrisonburg city",4,36,625,320,305
050,51,660,"Virginia","Harrisonburg city",4,37,592,287,305
050,51,660,"Virginia","Harrisonburg city",4,38,579,288,291
050,51,660,"Virginia","Harrisonburg city",4,39,593,304,289
050,51,660,"Virginia","Harrisonburg city",4,40,584,316,268
050,51,660,"Virginia","Harrisonburg city",4,41,579,312,267
050,51,660,"Virginia","Harrisonburg city",4,42,577,295,282
050,51,660,"Virginia","Harrisonburg city",4,43,534,269,265
050,51,660,"Virginia","Harrisonburg city",4,44,544,291,253
050,51,660,"Virginia","Harrisonburg city",4,45,521,259,262
050,51,660,"Virginia","Harrisonburg city",4,46,474,261,213
050,51,660,"Virginia","Harrisonburg city",4,47,465,253,212
050,51,660,"Virginia","Harrisonburg city",4,48,429,234,195
050,51,660,"Virginia","Harrisonburg city",4,49,433,239,194
050,51,660,"Virginia","Harrisonburg city",4,50,473,259,214
050,51,660,"Virginia","Harrisonburg city",4,51,438,234,204
050,51,660,"Virginia","Harrisonburg city",4,52,441,230,211
050,51,660,"Virginia","Harrisonburg city",4,53,432,224,208
050,51,660,"Virginia","Harrisonburg city",4,54,423,224,199
050,51,660,"Virginia","Harrisonburg city",4,55,448,233,215
050,51,660,"Virginia","Harrisonburg city",4,56,391,201,190
050,51,660,"Virginia","Harrisonburg city",4,57,403,186,217
050,51,660,"Virginia","Harrisonburg city",4,58,408,193,215
050,51,660,"Virginia","Harrisonburg city",4,59,415,194,221
050,51,660,"Virginia","Harrisonburg city",4,60,395,191,204
050,51,660,"Virginia","Harrisonburg city",4,61,358,184,174
050,51,660,"Virginia","Harrisonburg city",4,62,387,187,200
050,51,660,"Virginia","Harrisonburg city",4,63,384,185,199
050,51,660,"Virginia","Harrisonburg city",4,64,345,174,171
050,51,660,"Virginia","Harrisonburg city",4,65,370,185,185
050,51,660,"Virginia","Harrisonburg city",4,66,341,164,177
050,51,660,"Virginia","Harrisonburg city",4,67,341,173,168
050,51,660,"Virginia","Harrisonburg city",4,68,339,161,178
050,51,660,"Virginia","Harrisonburg city",4,69,350,178,172
050,51,660,"Virginia","Harrisonburg city",4,70,314,151,163
050,51,660,"Virginia","Harrisonburg city",4,71,279,120,159
050,51,660,"Virginia","Harrisonburg city",4,72,282,128,154
050,51,660,"Virginia","Harrisonburg city",4,73,260,115,145
050,51,660,"Virginia","Harrisonburg city",4,74,237,102,135
050,51,660,"Virginia","Harrisonburg city",4,75,235,106,129
050,51,660,"Virginia","Harrisonburg city",4,76,154,69,85
050,51,660,"Virginia","Harrisonburg city",4,77,152,69,83
050,51,660,"Virginia","Harrisonburg city",4,78,152,72,80
050,51,660,"Virginia","Harrisonburg city",4,79,173,76,97
050,51,660,"Virginia","Harrisonburg city",4,80,132,56,76
050,51,660,"Virginia","Harrisonburg city",4,81,113,47,66
050,51,660,"Virginia","Harrisonburg city",4,82,121,45,76
050,51,660,"Virginia","Harrisonburg city",4,83,113,53,60
050,51,660,"Virginia","Harrisonburg city",4,84,110,36,74
050,51,660,"Virginia","Harrisonburg city",4,85,676,222,454
050,51,660,"Virginia","Harrisonburg city",5,0,597,307,290
050,51,660,"Virginia","Harrisonburg city",5,1,583,292,291
050,51,660,"Virginia","Harrisonburg city",5,2,562,294,268
050,51,660,"Virginia","Harrisonburg city",5,3,535,284,251
050,51,660,"Virginia","Harrisonburg city",5,4,536,251,285
050,51,660,"Virginia","Harrisonburg city",5,5,482,242,240
050,51,660,"Virginia","Harrisonburg city",5,6,494,246,248
050,51,660,"Virginia","Harrisonburg city",5,7,499,261,238
050,51,660,"Virginia","Harrisonburg city",5,8,491,267,224
050,51,660,"Virginia","Harrisonburg city",5,9,476,249,227
050,51,660,"Virginia","Harrisonburg city",5,10,464,228,236
050,51,660,"Virginia","Harrisonburg city",5,11,444,214,230
050,51,660,"Virginia","Harrisonburg city",5,12,466,239,227
050,51,660,"Virginia","Harrisonburg city",5,13,445,243,202
050,51,660,"Virginia","Harrisonburg city",5,14,430,222,208
050,51,660,"Virginia","Harrisonburg city",5,15,466,225,241
050,51,660,"Virginia","Harrisonburg city",5,16,467,237,230
050,51,660,"Virginia","Harrisonburg city",5,17,468,228,240
050,51,660,"Virginia","Harrisonburg city",5,18,2313,837,1476
050,51,660,"Virginia","Harrisonburg city",5,19,3743,1480,2263
050,51,660,"Virginia","Harrisonburg city",5,20,3172,1407,1765
050,51,660,"Virginia","Harrisonburg city",5,21,3209,1453,1756
050,51,660,"Virginia","Harrisonburg city",5,22,2217,1129,1088
050,51,660,"Virginia","Harrisonburg city",5,23,1196,640,556
050,51,660,"Virginia","Harrisonburg city",5,24,803,447,356
050,51,660,"Virginia","Harrisonburg city",5,25,679,339,340
050,51,660,"Virginia","Harrisonburg city",5,26,692,334,358
050,51,660,"Virginia","Harrisonburg city",5,27,576,298,278
050,51,660,"Virginia","Harrisonburg city",5,28,612,306,306
050,51,660,"Virginia","Harrisonburg city",5,29,548,299,249
050,51,660,"Virginia","Harrisonburg city",5,30,559,280,279
050,51,660,"Virginia","Harrisonburg city",5,31,611,318,293
050,51,660,"Virginia","Harrisonburg city",5,32,567,308,259
050,51,660,"Virginia","Harrisonburg city",5,33,647,331,316
050,51,660,"Virginia","Harrisonburg city",5,34,577,306,271
050,51,660,"Virginia","Harrisonburg city",5,35,564,288,276
050,51,660,"Virginia","Harrisonburg city",5,36,566,312,254
050,51,660,"Virginia","Harrisonburg city",5,37,579,296,283
050,51,660,"Virginia","Harrisonburg city",5,38,590,278,312
050,51,660,"Virginia","Harrisonburg city",5,39,575,294,281
050,51,660,"Virginia","Harrisonburg city",5,40,569,288,281
050,51,660,"Virginia","Harrisonburg city",5,41,574,301,273
050,51,660,"Virginia","Harrisonburg city",5,42,542,283,259
050,51,660,"Virginia","Harrisonburg city",5,43,579,293,286
050,51,660,"Virginia","Harrisonburg city",5,44,541,278,263
050,51,660,"Virginia","Harrisonburg city",5,45,525,274,251
050,51,660,"Virginia","Harrisonburg city",5,46,514,251,263
050,51,660,"Virginia","Harrisonburg city",5,47,452,252,200
050,51,660,"Virginia","Harrisonburg city",5,48,450,244,206
050,51,660,"Virginia","Harrisonburg city",5,49,417,230,187
050,51,660,"Virginia","Harrisonburg city",5,50,421,227,194
050,51,660,"Virginia","Harrisonburg city",5,51,478,271,207
050,51,660,"Virginia","Harrisonburg city",5,52,415,228,187
050,51,660,"Virginia","Harrisonburg city",5,53,426,216,210
050,51,660,"Virginia","Harrisonburg city",5,54,432,221,211
050,51,660,"Virginia","Harrisonburg city",5,55,429,234,195
050,51,660,"Virginia","Harrisonburg city",5,56,432,219,213
050,51,660,"Virginia","Harrisonburg city",5,57,385,201,184
050,51,660,"Virginia","Harrisonburg city",5,58,384,176,208
050,51,660,"Virginia","Harrisonburg city",5,59,394,183,211
050,51,660,"Virginia","Harrisonburg city",5,60,390,182,208
050,51,660,"Virginia","Harrisonburg city",5,61,382,190,192
050,51,660,"Virginia","Harrisonburg city",5,62,335,168,167
050,51,660,"Virginia","Harrisonburg city",5,63,388,189,199
050,51,660,"Virginia","Harrisonburg city",5,64,355,174,181
050,51,660,"Virginia","Harrisonburg city",5,65,327,158,169
050,51,660,"Virginia","Harrisonburg city",5,66,379,189,190
050,51,660,"Virginia","Harrisonburg city",5,67,341,162,179
050,51,660,"Virginia","Harrisonburg city",5,68,332,162,170
050,51,660,"Virginia","Harrisonburg city",5,69,328,157,171
050,51,660,"Virginia","Harrisonburg city",5,70,339,165,174
050,51,660,"Virginia","Harrisonburg city",5,71,306,145,161
050,51,660,"Virginia","Harrisonburg city",5,72,290,125,165
050,51,660,"Virginia","Harrisonburg city",5,73,276,126,150
050,51,660,"Virginia","Harrisonburg city",5,74,243,108,135
050,51,660,"Virginia","Harrisonburg city",5,75,225,101,124
050,51,660,"Virginia","Harrisonburg city",5,76,223,99,124
050,51,660,"Virginia","Harrisonburg city",5,77,151,67,84
050,51,660,"Virginia","Harrisonburg city",5,78,141,67,74
050,51,660,"Virginia","Harrisonburg city",5,79,153,71,82
050,51,660,"Virginia","Harrisonburg city",5,80,160,68,92
050,51,660,"Virginia","Harrisonburg city",5,81,133,56,77
050,51,660,"Virginia","Harrisonburg city",5,82,107,46,61
050,51,660,"Virginia","Harrisonburg city",5,83,111,42,69
050,51,660,"Virginia","Harrisonburg city",5,84,110,43,67
050,51,660,"Virginia","Harrisonburg city",5,85,698,230,468
050,51,670,"Virginia","Hopewell city",1,0,337,175,162
050,51,670,"Virginia","Hopewell city",1,1,325,163,162
050,51,670,"Virginia","Hopewell city",1,2,305,149,156
050,51,670,"Virginia","Hopewell city",1,3,362,178,184
050,51,670,"Virginia","Hopewell city",1,4,334,175,159
050,51,670,"Virginia","Hopewell city",1,5,333,170,163
050,51,670,"Virginia","Hopewell city",1,6,325,165,160
050,51,670,"Virginia","Hopewell city",1,7,337,170,167
050,51,670,"Virginia","Hopewell city",1,8,310,166,144
050,51,670,"Virginia","Hopewell city",1,9,325,170,155
050,51,670,"Virginia","Hopewell city",1,10,345,188,157
050,51,670,"Virginia","Hopewell city",1,11,326,166,160
050,51,670,"Virginia","Hopewell city",1,12,349,175,174
050,51,670,"Virginia","Hopewell city",1,13,338,183,155
050,51,670,"Virginia","Hopewell city",1,14,326,167,159
050,51,670,"Virginia","Hopewell city",1,15,313,156,157
050,51,670,"Virginia","Hopewell city",1,16,351,163,188
050,51,670,"Virginia","Hopewell city",1,17,295,154,141
050,51,670,"Virginia","Hopewell city",1,18,266,141,125
050,51,670,"Virginia","Hopewell city",1,19,242,129,113
050,51,670,"Virginia","Hopewell city",1,20,235,115,120
050,51,670,"Virginia","Hopewell city",1,21,251,117,134
050,51,670,"Virginia","Hopewell city",1,22,262,129,133
050,51,670,"Virginia","Hopewell city",1,23,267,130,137
050,51,670,"Virginia","Hopewell city",1,24,297,152,145
050,51,670,"Virginia","Hopewell city",1,25,315,141,174
050,51,670,"Virginia","Hopewell city",1,26,351,158,193
050,51,670,"Virginia","Hopewell city",1,27,368,193,175
050,51,670,"Virginia","Hopewell city",1,28,364,163,201
050,51,670,"Virginia","Hopewell city",1,29,345,167,178
050,51,670,"Virginia","Hopewell city",1,30,337,155,182
050,51,670,"Virginia","Hopewell city",1,31,316,148,168
050,51,670,"Virginia","Hopewell city",1,32,311,138,173
050,51,670,"Virginia","Hopewell city",1,33,340,162,178
050,51,670,"Virginia","Hopewell city",1,34,342,154,188
050,51,670,"Virginia","Hopewell city",1,35,349,171,178
050,51,670,"Virginia","Hopewell city",1,36,277,130,147
050,51,670,"Virginia","Hopewell city",1,37,277,130,147
050,51,670,"Virginia","Hopewell city",1,38,289,138,151
050,51,670,"Virginia","Hopewell city",1,39,273,122,151
050,51,670,"Virginia","Hopewell city",1,40,282,133,149
050,51,670,"Virginia","Hopewell city",1,41,244,125,119
050,51,670,"Virginia","Hopewell city",1,42,240,104,136
050,51,670,"Virginia","Hopewell city",1,43,241,96,145
050,51,670,"Virginia","Hopewell city",1,44,234,107,127
050,51,670,"Virginia","Hopewell city",1,45,255,128,127
050,51,670,"Virginia","Hopewell city",1,46,243,113,130
050,51,670,"Virginia","Hopewell city",1,47,238,119,119
050,51,670,"Virginia","Hopewell city",1,48,289,141,148
050,51,670,"Virginia","Hopewell city",1,49,295,142,153
050,51,670,"Virginia","Hopewell city",1,50,291,150,141
050,51,670,"Virginia","Hopewell city",1,51,267,134,133
050,51,670,"Virginia","Hopewell city",1,52,276,122,154
050,51,670,"Virginia","Hopewell city",1,53,282,120,162
050,51,670,"Virginia","Hopewell city",1,54,292,139,153
050,51,670,"Virginia","Hopewell city",1,55,309,129,180
050,51,670,"Virginia","Hopewell city",1,56,294,131,163
050,51,670,"Virginia","Hopewell city",1,57,293,137,156
050,51,670,"Virginia","Hopewell city",1,58,297,132,165
050,51,670,"Virginia","Hopewell city",1,59,322,136,186
050,51,670,"Virginia","Hopewell city",1,60,314,137,177
050,51,670,"Virginia","Hopewell city",1,61,283,134,149
050,51,670,"Virginia","Hopewell city",1,62,272,119,153
050,51,670,"Virginia","Hopewell city",1,63,266,114,152
050,51,670,"Virginia","Hopewell city",1,64,253,114,139
050,51,670,"Virginia","Hopewell city",1,65,241,110,131
050,51,670,"Virginia","Hopewell city",1,66,252,116,136
050,51,670,"Virginia","Hopewell city",1,67,217,98,119
050,51,670,"Virginia","Hopewell city",1,68,212,85,127
050,51,670,"Virginia","Hopewell city",1,69,214,78,136
050,51,670,"Virginia","Hopewell city",1,70,202,79,123
050,51,670,"Virginia","Hopewell city",1,71,193,90,103
050,51,670,"Virginia","Hopewell city",1,72,200,89,111
050,51,670,"Virginia","Hopewell city",1,73,207,89,118
050,51,670,"Virginia","Hopewell city",1,74,129,49,80
050,51,670,"Virginia","Hopewell city",1,75,133,55,78
050,51,670,"Virginia","Hopewell city",1,76,158,74,84
050,51,670,"Virginia","Hopewell city",1,77,156,73,83
050,51,670,"Virginia","Hopewell city",1,78,127,52,75
050,51,670,"Virginia","Hopewell city",1,79,108,43,65
050,51,670,"Virginia","Hopewell city",1,80,97,39,58
050,51,670,"Virginia","Hopewell city",1,81,93,33,60
050,51,670,"Virginia","Hopewell city",1,82,98,39,59
050,51,670,"Virginia","Hopewell city",1,83,80,34,46
050,51,670,"Virginia","Hopewell city",1,84,64,21,43
050,51,670,"Virginia","Hopewell city",1,85,368,82,286
050,51,670,"Virginia","Hopewell city",2,0,341,179,162
050,51,670,"Virginia","Hopewell city",2,1,323,163,160
050,51,670,"Virginia","Hopewell city",2,2,314,155,159
050,51,670,"Virginia","Hopewell city",2,3,346,172,174
050,51,670,"Virginia","Hopewell city",2,4,344,176,168
050,51,670,"Virginia","Hopewell city",2,5,328,169,159
050,51,670,"Virginia","Hopewell city",2,6,324,165,159
050,51,670,"Virginia","Hopewell city",2,7,331,169,162
050,51,670,"Virginia","Hopewell city",2,8,312,165,147
050,51,670,"Virginia","Hopewell city",2,9,318,168,150
050,51,670,"Virginia","Hopewell city",2,10,338,183,155
050,51,670,"Virginia","Hopewell city",2,11,324,168,156
050,51,670,"Virginia","Hopewell city",2,12,341,171,170
050,51,670,"Virginia","Hopewell city",2,13,341,179,162
050,51,670,"Virginia","Hopewell city",2,14,327,170,157
050,51,670,"Virginia","Hopewell city",2,15,320,159,161
050,51,670,"Virginia","Hopewell city",2,16,337,159,178
050,51,670,"Virginia","Hopewell city",2,17,310,156,154
050,51,670,"Virginia","Hopewell city",2,18,264,138,126
050,51,670,"Virginia","Hopewell city",2,19,236,123,113
050,51,670,"Virginia","Hopewell city",2,20,239,119,120
050,51,670,"Virginia","Hopewell city",2,21,245,114,131
050,51,670,"Virginia","Hopewell city",2,22,261,125,136
050,51,670,"Virginia","Hopewell city",2,23,266,130,136
050,51,670,"Virginia","Hopewell city",2,24,288,146,142
050,51,670,"Virginia","Hopewell city",2,25,313,146,167
050,51,670,"Virginia","Hopewell city",2,26,342,154,188
050,51,670,"Virginia","Hopewell city",2,27,363,183,180
050,51,670,"Virginia","Hopewell city",2,28,362,171,191
050,51,670,"Virginia","Hopewell city",2,29,346,166,180
050,51,670,"Virginia","Hopewell city",2,30,340,159,181
050,51,670,"Virginia","Hopewell city",2,31,318,147,171
050,51,670,"Virginia","Hopewell city",2,32,312,141,171
050,51,670,"Virginia","Hopewell city",2,33,335,156,179
050,51,670,"Virginia","Hopewell city",2,34,346,159,187
050,51,670,"Virginia","Hopewell city",2,35,349,169,180
050,51,670,"Virginia","Hopewell city",2,36,290,136,154
050,51,670,"Virginia","Hopewell city",2,37,279,131,148
050,51,670,"Virginia","Hopewell city",2,38,286,137,149
050,51,670,"Virginia","Hopewell city",2,39,275,125,150
050,51,670,"Virginia","Hopewell city",2,40,282,132,150
050,51,670,"Virginia","Hopewell city",2,41,250,125,125
050,51,670,"Virginia","Hopewell city",2,42,236,105,131
050,51,670,"Virginia","Hopewell city",2,43,238,95,143
050,51,670,"Virginia","Hopewell city",2,44,233,104,129
050,51,670,"Virginia","Hopewell city",2,45,247,120,127
050,51,670,"Virginia","Hopewell city",2,46,243,116,127
050,51,670,"Virginia","Hopewell city",2,47,241,121,120
050,51,670,"Virginia","Hopewell city",2,48,276,134,142
050,51,670,"Virginia","Hopewell city",2,49,296,144,152
050,51,670,"Virginia","Hopewell city",2,50,291,148,143
050,51,670,"Virginia","Hopewell city",2,51,274,138,136
050,51,670,"Virginia","Hopewell city",2,52,269,123,146
050,51,670,"Virginia","Hopewell city",2,53,281,122,159
050,51,670,"Virginia","Hopewell city",2,54,291,135,156
050,51,670,"Virginia","Hopewell city",2,55,302,129,173
050,51,670,"Virginia","Hopewell city",2,56,301,133,168
050,51,670,"Virginia","Hopewell city",2,57,296,136,160
050,51,670,"Virginia","Hopewell city",2,58,297,134,163
050,51,670,"Virginia","Hopewell city",2,59,317,135,182
050,51,670,"Virginia","Hopewell city",2,60,318,136,182
050,51,670,"Virginia","Hopewell city",2,61,292,137,155
050,51,670,"Virginia","Hopewell city",2,62,273,123,150
050,51,670,"Virginia","Hopewell city",2,63,270,115,155
050,51,670,"Virginia","Hopewell city",2,64,253,112,141
050,51,670,"Virginia","Hopewell city",2,65,243,113,130
050,51,670,"Virginia","Hopewell city",2,66,246,112,134
050,51,670,"Virginia","Hopewell city",2,67,224,100,124
050,51,670,"Virginia","Hopewell city",2,68,212,87,125
050,51,670,"Virginia","Hopewell city",2,69,212,77,135
050,51,670,"Virginia","Hopewell city",2,70,202,78,124
050,51,670,"Virginia","Hopewell city",2,71,190,85,105
050,51,670,"Virginia","Hopewell city",2,72,193,85,108
050,51,670,"Virginia","Hopewell city",2,73,212,92,120
050,51,670,"Virginia","Hopewell city",2,74,140,55,85
050,51,670,"Virginia","Hopewell city",2,75,133,55,78
050,51,670,"Virginia","Hopewell city",2,76,148,69,79
050,51,670,"Virginia","Hopewell city",2,77,160,75,85
050,51,670,"Virginia","Hopewell city",2,78,134,57,77
050,51,670,"Virginia","Hopewell city",2,79,111,45,66
050,51,670,"Virginia","Hopewell city",2,80,97,38,59
050,51,670,"Virginia","Hopewell city",2,81,95,35,60
050,51,670,"Virginia","Hopewell city",2,82,95,36,59
050,51,670,"Virginia","Hopewell city",2,83,83,35,48
050,51,670,"Virginia","Hopewell city",2,84,69,24,45
050,51,670,"Virginia","Hopewell city",2,85,369,80,289
050,51,670,"Virginia","Hopewell city",3,0,299,159,140
050,51,670,"Virginia","Hopewell city",3,1,335,179,156
050,51,670,"Virginia","Hopewell city",3,2,327,176,151
050,51,670,"Virginia","Hopewell city",3,3,320,163,157
050,51,670,"Virginia","Hopewell city",3,4,337,171,166
050,51,670,"Virginia","Hopewell city",3,5,349,180,169
050,51,670,"Virginia","Hopewell city",3,6,340,172,168
050,51,670,"Virginia","Hopewell city",3,7,320,164,156
050,51,670,"Virginia","Hopewell city",3,8,354,182,172
050,51,670,"Virginia","Hopewell city",3,9,318,180,138
050,51,670,"Virginia","Hopewell city",3,10,326,165,161
050,51,670,"Virginia","Hopewell city",3,11,345,191,154
050,51,670,"Virginia","Hopewell city",3,12,331,166,165
050,51,670,"Virginia","Hopewell city",3,13,345,164,181
050,51,670,"Virginia","Hopewell city",3,14,343,182,161
050,51,670,"Virginia","Hopewell city",3,15,327,167,160
050,51,670,"Virginia","Hopewell city",3,16,314,154,160
050,51,670,"Virginia","Hopewell city",3,17,344,163,181
050,51,670,"Virginia","Hopewell city",3,18,272,149,123
050,51,670,"Virginia","Hopewell city",3,19,232,119,113
050,51,670,"Virginia","Hopewell city",3,20,255,137,118
050,51,670,"Virginia","Hopewell city",3,21,256,135,121
050,51,670,"Virginia","Hopewell city",3,22,277,135,142
050,51,670,"Virginia","Hopewell city",3,23,276,135,141
050,51,670,"Virginia","Hopewell city",3,24,256,112,144
050,51,670,"Virginia","Hopewell city",3,25,322,164,158
050,51,670,"Virginia","Hopewell city",3,26,346,166,180
050,51,670,"Virginia","Hopewell city",3,27,347,148,199
050,51,670,"Virginia","Hopewell city",3,28,381,196,185
050,51,670,"Virginia","Hopewell city",3,29,333,139,194
050,51,670,"Virginia","Hopewell city",3,30,342,162,180
050,51,670,"Virginia","Hopewell city",3,31,327,143,184
050,51,670,"Virginia","Hopewell city",3,32,345,165,180
050,51,670,"Virginia","Hopewell city",3,33,324,146,178
050,51,670,"Virginia","Hopewell city",3,34,335,159,176
050,51,670,"Virginia","Hopewell city",3,35,342,154,188
050,51,670,"Virginia","Hopewell city",3,36,319,151,168
050,51,670,"Virginia","Hopewell city",3,37,286,136,150
050,51,670,"Virginia","Hopewell city",3,38,273,127,146
050,51,670,"Virginia","Hopewell city",3,39,285,145,140
050,51,670,"Virginia","Hopewell city",3,40,282,129,153
050,51,670,"Virginia","Hopewell city",3,41,287,137,150
050,51,670,"Virginia","Hopewell city",3,42,259,127,132
050,51,670,"Virginia","Hopewell city",3,43,227,93,134
050,51,670,"Virginia","Hopewell city",3,44,224,88,136
050,51,670,"Virginia","Hopewell city",3,45,227,98,129
050,51,670,"Virginia","Hopewell city",3,46,259,127,132
050,51,670,"Virginia","Hopewell city",3,47,249,126,123
050,51,670,"Virginia","Hopewell city",3,48,244,119,125
050,51,670,"Virginia","Hopewell city",3,49,281,135,146
050,51,670,"Virginia","Hopewell city",3,50,297,140,157
050,51,670,"Virginia","Hopewell city",3,51,274,136,138
050,51,670,"Virginia","Hopewell city",3,52,265,137,128
050,51,670,"Virginia","Hopewell city",3,53,273,113,160
050,51,670,"Virginia","Hopewell city",3,54,288,129,159
050,51,670,"Virginia","Hopewell city",3,55,282,132,150
050,51,670,"Virginia","Hopewell city",3,56,281,117,164
050,51,670,"Virginia","Hopewell city",3,57,311,146,165
050,51,670,"Virginia","Hopewell city",3,58,296,136,160
050,51,670,"Virginia","Hopewell city",3,59,308,139,169
050,51,670,"Virginia","Hopewell city",3,60,314,130,184
050,51,670,"Virginia","Hopewell city",3,61,295,136,159
050,51,670,"Virginia","Hopewell city",3,62,286,129,157
050,51,670,"Virginia","Hopewell city",3,63,250,107,143
050,51,670,"Virginia","Hopewell city",3,64,271,113,158
050,51,670,"Virginia","Hopewell city",3,65,246,115,131
050,51,670,"Virginia","Hopewell city",3,66,240,106,134
050,51,670,"Virginia","Hopewell city",3,67,234,105,129
050,51,670,"Virginia","Hopewell city",3,68,209,96,113
050,51,670,"Virginia","Hopewell city",3,69,196,74,122
050,51,670,"Virginia","Hopewell city",3,70,206,73,133
050,51,670,"Virginia","Hopewell city",3,71,191,78,113
050,51,670,"Virginia","Hopewell city",3,72,181,82,99
050,51,670,"Virginia","Hopewell city",3,73,188,87,101
050,51,670,"Virginia","Hopewell city",3,74,198,85,113
050,51,670,"Virginia","Hopewell city",3,75,135,51,84
050,51,670,"Virginia","Hopewell city",3,76,114,47,67
050,51,670,"Virginia","Hopewell city",3,77,136,62,74
050,51,670,"Virginia","Hopewell city",3,78,159,75,84
050,51,670,"Virginia","Hopewell city",3,79,119,50,69
050,51,670,"Virginia","Hopewell city",3,80,101,42,59
050,51,670,"Virginia","Hopewell city",3,81,92,33,59
050,51,670,"Virginia","Hopewell city",3,82,88,34,54
050,51,670,"Virginia","Hopewell city",3,83,82,30,52
050,51,670,"Virginia","Hopewell city",3,84,75,27,48
050,51,670,"Virginia","Hopewell city",3,85,348,76,272
050,51,670,"Virginia","Hopewell city",4,0,310,151,159
050,51,670,"Virginia","Hopewell city",4,1,262,142,120
050,51,670,"Virginia","Hopewell city",4,2,326,169,157
050,51,670,"Virginia","Hopewell city",4,3,324,172,152
050,51,670,"Virginia","Hopewell city",4,4,328,174,154
050,51,670,"Virginia","Hopewell city",4,5,329,171,158
050,51,670,"Virginia","Hopewell city",4,6,329,180,149
050,51,670,"Virginia","Hopewell city",4,7,316,159,157
050,51,670,"Virginia","Hopewell city",4,8,325,164,161
050,51,670,"Virginia","Hopewell city",4,9,337,170,167
050,51,670,"Virginia","Hopewell city",4,10,315,179,136
050,51,670,"Virginia","Hopewell city",4,11,317,147,170
050,51,670,"Virginia","Hopewell city",4,12,343,186,157
050,51,670,"Virginia","Hopewell city",4,13,319,173,146
050,51,670,"Virginia","Hopewell city",4,14,334,160,174
050,51,670,"Virginia","Hopewell city",4,15,328,172,156
050,51,670,"Virginia","Hopewell city",4,16,318,164,154
050,51,670,"Virginia","Hopewell city",4,17,313,156,157
050,51,670,"Virginia","Hopewell city",4,18,294,143,151
050,51,670,"Virginia","Hopewell city",4,19,232,134,98
050,51,670,"Virginia","Hopewell city",4,20,244,119,125
050,51,670,"Virginia","Hopewell city",4,21,271,154,117
050,51,670,"Virginia","Hopewell city",4,22,286,136,150
050,51,670,"Virginia","Hopewell city",4,23,278,117,161
050,51,670,"Virginia","Hopewell city",4,24,276,137,139
050,51,670,"Virginia","Hopewell city",4,25,253,109,144
050,51,670,"Virginia","Hopewell city",4,26,336,170,166
050,51,670,"Virginia","Hopewell city",4,27,336,162,174
050,51,670,"Virginia","Hopewell city",4,28,324,135,189
050,51,670,"Virginia","Hopewell city",4,29,362,185,177
050,51,670,"Virginia","Hopewell city",4,30,335,143,192
050,51,670,"Virginia","Hopewell city",4,31,366,167,199
050,51,670,"Virginia","Hopewell city",4,32,317,134,183
050,51,670,"Virginia","Hopewell city",4,33,348,170,178
050,51,670,"Virginia","Hopewell city",4,34,318,149,169
050,51,670,"Virginia","Hopewell city",4,35,324,147,177
050,51,670,"Virginia","Hopewell city",4,36,346,160,186
050,51,670,"Virginia","Hopewell city",4,37,318,152,166
050,51,670,"Virginia","Hopewell city",4,38,283,132,151
050,51,670,"Virginia","Hopewell city",4,39,277,125,152
050,51,670,"Virginia","Hopewell city",4,40,273,142,131
050,51,670,"Virginia","Hopewell city",4,41,267,124,143
050,51,670,"Virginia","Hopewell city",4,42,295,141,154
050,51,670,"Virginia","Hopewell city",4,43,240,112,128
050,51,670,"Virginia","Hopewell city",4,44,223,98,125
050,51,670,"Virginia","Hopewell city",4,45,228,87,141
050,51,670,"Virginia","Hopewell city",4,46,228,98,130
050,51,670,"Virginia","Hopewell city",4,47,241,114,127
050,51,670,"Virginia","Hopewell city",4,48,247,126,121
050,51,670,"Virginia","Hopewell city",4,49,236,120,116
050,51,670,"Virginia","Hopewell city",4,50,293,140,153
050,51,670,"Virginia","Hopewell city",4,51,292,135,157
050,51,670,"Virginia","Hopewell city",4,52,266,130,136
050,51,670,"Virginia","Hopewell city",4,53,273,131,142
050,51,670,"Virginia","Hopewell city",4,54,275,119,156
050,51,670,"Virginia","Hopewell city",4,55,280,115,165
050,51,670,"Virginia","Hopewell city",4,56,290,136,154
050,51,670,"Virginia","Hopewell city",4,57,287,118,169
050,51,670,"Virginia","Hopewell city",4,58,314,142,172
050,51,670,"Virginia","Hopewell city",4,59,288,128,160
050,51,670,"Virginia","Hopewell city",4,60,292,131,161
050,51,670,"Virginia","Hopewell city",4,61,284,122,162
050,51,670,"Virginia","Hopewell city",4,62,289,130,159
050,51,670,"Virginia","Hopewell city",4,63,252,111,141
050,51,670,"Virginia","Hopewell city",4,64,260,100,160
050,51,670,"Virginia","Hopewell city",4,65,254,109,145
050,51,670,"Virginia","Hopewell city",4,66,242,109,133
050,51,670,"Virginia","Hopewell city",4,67,234,104,130
050,51,670,"Virginia","Hopewell city",4,68,233,105,128
050,51,670,"Virginia","Hopewell city",4,69,206,88,118
050,51,670,"Virginia","Hopewell city",4,70,188,71,117
050,51,670,"Virginia","Hopewell city",4,71,196,68,128
050,51,670,"Virginia","Hopewell city",4,72,188,72,116
050,51,670,"Virginia","Hopewell city",4,73,180,84,96
050,51,670,"Virginia","Hopewell city",4,74,180,83,97
050,51,670,"Virginia","Hopewell city",4,75,200,84,116
050,51,670,"Virginia","Hopewell city",4,76,116,42,74
050,51,670,"Virginia","Hopewell city",4,77,110,48,62
050,51,670,"Virginia","Hopewell city",4,78,131,58,73
050,51,670,"Virginia","Hopewell city",4,79,148,71,77
050,51,670,"Virginia","Hopewell city",4,80,106,44,62
050,51,670,"Virginia","Hopewell city",4,81,96,35,61
050,51,670,"Virginia","Hopewell city",4,82,86,32,54
050,51,670,"Virginia","Hopewell city",4,83,76,27,49
050,51,670,"Virginia","Hopewell city",4,84,71,26,45
050,51,670,"Virginia","Hopewell city",4,85,339,75,264
050,51,670,"Virginia","Hopewell city",5,0,314,152,162
050,51,670,"Virginia","Hopewell city",5,1,304,156,148
050,51,670,"Virginia","Hopewell city",5,2,293,159,134
050,51,670,"Virginia","Hopewell city",5,3,332,175,157
050,51,670,"Virginia","Hopewell city",5,4,332,187,145
050,51,670,"Virginia","Hopewell city",5,5,321,165,156
050,51,670,"Virginia","Hopewell city",5,6,320,172,148
050,51,670,"Virginia","Hopewell city",5,7,331,179,152
050,51,670,"Virginia","Hopewell city",5,8,315,155,160
050,51,670,"Virginia","Hopewell city",5,9,323,158,165
050,51,670,"Virginia","Hopewell city",5,10,345,176,169
050,51,670,"Virginia","Hopewell city",5,11,332,182,150
050,51,670,"Virginia","Hopewell city",5,12,319,152,167
050,51,670,"Virginia","Hopewell city",5,13,340,184,156
050,51,670,"Virginia","Hopewell city",5,14,314,170,144
050,51,670,"Virginia","Hopewell city",5,15,328,154,174
050,51,670,"Virginia","Hopewell city",5,16,320,167,153
050,51,670,"Virginia","Hopewell city",5,17,320,171,149
050,51,670,"Virginia","Hopewell city",5,18,271,140,131
050,51,670,"Virginia","Hopewell city",5,19,239,113,126
050,51,670,"Virginia","Hopewell city",5,20,258,137,121
050,51,670,"Virginia","Hopewell city",5,21,254,110,144
050,51,670,"Virginia","Hopewell city",5,22,296,161,135
050,51,670,"Virginia","Hopewell city",5,23,276,128,148
050,51,670,"Virginia","Hopewell city",5,24,276,115,161
050,51,670,"Virginia","Hopewell city",5,25,289,137,152
050,51,670,"Virginia","Hopewell city",5,26,269,118,151
050,51,670,"Virginia","Hopewell city",5,27,332,169,163
050,51,670,"Virginia","Hopewell city",5,28,348,171,177
050,51,670,"Virginia","Hopewell city",5,29,331,145,186
050,51,670,"Virginia","Hopewell city",5,30,364,188,176
050,51,670,"Virginia","Hopewell city",5,31,344,144,200
050,51,670,"Virginia","Hopewell city",5,32,382,180,202
050,51,670,"Virginia","Hopewell city",5,33,334,148,186
050,51,670,"Virginia","Hopewell city",5,34,338,172,166
050,51,670,"Virginia","Hopewell city",5,35,313,133,180
050,51,670,"Virginia","Hopewell city",5,36,325,141,184
050,51,670,"Virginia","Hopewell city",5,37,337,155,182
050,51,670,"Virginia","Hopewell city",5,38,320,151,169
050,51,670,"Virginia","Hopewell city",5,39,287,129,158
050,51,670,"Virginia","Hopewell city",5,40,268,125,143
050,51,670,"Virginia","Hopewell city",5,41,265,130,135
050,51,670,"Virginia","Hopewell city",5,42,256,117,139
050,51,670,"Virginia","Hopewell city",5,43,285,135,150
050,51,670,"Virginia","Hopewell city",5,44,238,106,132
050,51,670,"Virginia","Hopewell city",5,45,234,99,135
050,51,670,"Virginia","Hopewell city",5,46,217,79,138
050,51,670,"Virginia","Hopewell city",5,47,218,102,116
050,51,670,"Virginia","Hopewell city",5,48,231,109,122
050,51,670,"Virginia","Hopewell city",5,49,235,117,118
050,51,670,"Virginia","Hopewell city",5,50,242,119,123
050,51,670,"Virginia","Hopewell city",5,51,286,143,143
050,51,670,"Virginia","Hopewell city",5,52,280,132,148
050,51,670,"Virginia","Hopewell city",5,53,264,124,140
050,51,670,"Virginia","Hopewell city",5,54,263,126,137
050,51,670,"Virginia","Hopewell city",5,55,267,115,152
050,51,670,"Virginia","Hopewell city",5,56,264,110,154
050,51,670,"Virginia","Hopewell city",5,57,294,136,158
050,51,670,"Virginia","Hopewell city",5,58,287,119,168
050,51,670,"Virginia","Hopewell city",5,59,309,136,173
050,51,670,"Virginia","Hopewell city",5,60,273,119,154
050,51,670,"Virginia","Hopewell city",5,61,286,132,154
050,51,670,"Virginia","Hopewell city",5,62,268,115,153
050,51,670,"Virginia","Hopewell city",5,63,283,122,161
050,51,670,"Virginia","Hopewell city",5,64,257,109,148
050,51,670,"Virginia","Hopewell city",5,65,248,96,152
050,51,670,"Virginia","Hopewell city",5,66,246,102,144
050,51,670,"Virginia","Hopewell city",5,67,235,107,128
050,51,670,"Virginia","Hopewell city",5,68,227,102,125
050,51,670,"Virginia","Hopewell city",5,69,226,96,130
050,51,670,"Virginia","Hopewell city",5,70,200,88,112
050,51,670,"Virginia","Hopewell city",5,71,183,66,117
050,51,670,"Virginia","Hopewell city",5,72,193,64,129
050,51,670,"Virginia","Hopewell city",5,73,189,73,116
050,51,670,"Virginia","Hopewell city",5,74,176,81,95
050,51,670,"Virginia","Hopewell city",5,75,176,79,97
050,51,670,"Virginia","Hopewell city",5,76,174,67,107
050,51,670,"Virginia","Hopewell city",5,77,110,41,69
050,51,670,"Virginia","Hopewell city",5,78,105,45,60
050,51,670,"Virginia","Hopewell city",5,79,117,55,62
050,51,670,"Virginia","Hopewell city",5,80,126,61,65
050,51,670,"Virginia","Hopewell city",5,81,104,39,65
050,51,670,"Virginia","Hopewell city",5,82,94,37,57
050,51,670,"Virginia","Hopewell city",5,83,72,26,46
050,51,670,"Virginia","Hopewell city",5,84,66,23,43
050,51,670,"Virginia","Hopewell city",5,85,329,73,256
050,51,678,"Virginia","Lexington city",1,0,71,37,34
050,51,678,"Virginia","Lexington city",1,1,47,25,22
050,51,678,"Virginia","Lexington city",1,2,43,21,22
050,51,678,"Virginia","Lexington city",1,3,26,14,12
050,51,678,"Virginia","Lexington city",1,4,34,21,13
050,51,678,"Virginia","Lexington city",1,5,73,50,23
050,51,678,"Virginia","Lexington city",1,6,41,21,20
050,51,678,"Virginia","Lexington city",1,7,55,33,22
050,51,678,"Virginia","Lexington city",1,8,54,30,24
050,51,678,"Virginia","Lexington city",1,9,43,20,23
050,51,678,"Virginia","Lexington city",1,10,48,27,21
050,51,678,"Virginia","Lexington city",1,11,47,23,24
050,51,678,"Virginia","Lexington city",1,12,54,27,27
050,51,678,"Virginia","Lexington city",1,13,42,21,21
050,51,678,"Virginia","Lexington city",1,14,48,24,24
050,51,678,"Virginia","Lexington city",1,15,54,21,33
050,51,678,"Virginia","Lexington city",1,16,39,22,17
050,51,678,"Virginia","Lexington city",1,17,50,29,21
050,51,678,"Virginia","Lexington city",1,18,491,209,282
050,51,678,"Virginia","Lexington city",1,19,1020,495,525
050,51,678,"Virginia","Lexington city",1,20,804,414,390
050,51,678,"Virginia","Lexington city",1,21,409,236,173
050,51,678,"Virginia","Lexington city",1,22,237,143,94
050,51,678,"Virginia","Lexington city",1,23,115,70,45
050,51,678,"Virginia","Lexington city",1,24,88,40,48
050,51,678,"Virginia","Lexington city",1,25,78,41,37
050,51,678,"Virginia","Lexington city",1,26,74,34,40
050,51,678,"Virginia","Lexington city",1,27,75,36,39
050,51,678,"Virginia","Lexington city",1,28,67,35,32
050,51,678,"Virginia","Lexington city",1,29,74,41,33
050,51,678,"Virginia","Lexington city",1,30,51,26,25
050,51,678,"Virginia","Lexington city",1,31,51,26,25
050,51,678,"Virginia","Lexington city",1,32,58,32,26
050,51,678,"Virginia","Lexington city",1,33,47,26,21
050,51,678,"Virginia","Lexington city",1,34,56,22,34
050,51,678,"Virginia","Lexington city",1,35,60,30,30
050,51,678,"Virginia","Lexington city",1,36,55,27,28
050,51,678,"Virginia","Lexington city",1,37,56,26,30
050,51,678,"Virginia","Lexington city",1,38,52,27,25
050,51,678,"Virginia","Lexington city",1,39,52,23,29
050,51,678,"Virginia","Lexington city",1,40,39,20,19
050,51,678,"Virginia","Lexington city",1,41,64,31,33
050,51,678,"Virginia","Lexington city",1,42,49,23,26
050,51,678,"Virginia","Lexington city",1,43,32,14,18
050,51,678,"Virginia","Lexington city",1,44,47,22,25
050,51,678,"Virginia","Lexington city",1,45,46,22,24
050,51,678,"Virginia","Lexington city",1,46,53,27,26
050,51,678,"Virginia","Lexington city",1,47,42,18,24
050,51,678,"Virginia","Lexington city",1,48,62,34,28
050,51,678,"Virginia","Lexington city",1,49,67,38,29
050,51,678,"Virginia","Lexington city",1,50,57,29,28
050,51,678,"Virginia","Lexington city",1,51,46,25,21
050,51,678,"Virginia","Lexington city",1,52,37,20,17
050,51,678,"Virginia","Lexington city",1,53,42,18,24
050,51,678,"Virginia","Lexington city",1,54,50,26,24
050,51,678,"Virginia","Lexington city",1,55,55,27,28
050,51,678,"Virginia","Lexington city",1,56,55,29,26
050,51,678,"Virginia","Lexington city",1,57,56,25,31
050,51,678,"Virginia","Lexington city",1,58,52,23,29
050,51,678,"Virginia","Lexington city",1,59,58,24,34
050,51,678,"Virginia","Lexington city",1,60,46,20,26
050,51,678,"Virginia","Lexington city",1,61,58,26,32
050,51,678,"Virginia","Lexington city",1,62,62,28,34
050,51,678,"Virginia","Lexington city",1,63,63,23,40
050,51,678,"Virginia","Lexington city",1,64,57,20,37
050,51,678,"Virginia","Lexington city",1,65,48,21,27
050,51,678,"Virginia","Lexington city",1,66,54,24,30
050,51,678,"Virginia","Lexington city",1,67,68,30,38
050,51,678,"Virginia","Lexington city",1,68,70,38,32
050,51,678,"Virginia","Lexington city",1,69,58,26,32
050,51,678,"Virginia","Lexington city",1,70,54,26,28
050,51,678,"Virginia","Lexington city",1,71,56,28,28
050,51,678,"Virginia","Lexington city",1,72,58,24,34
050,51,678,"Virginia","Lexington city",1,73,56,19,37
050,51,678,"Virginia","Lexington city",1,74,46,16,30
050,51,678,"Virginia","Lexington city",1,75,49,18,31
050,51,678,"Virginia","Lexington city",1,76,56,27,29
050,51,678,"Virginia","Lexington city",1,77,49,22,27
050,51,678,"Virginia","Lexington city",1,78,43,16,27
050,51,678,"Virginia","Lexington city",1,79,39,20,19
050,51,678,"Virginia","Lexington city",1,80,34,15,19
050,51,678,"Virginia","Lexington city",1,81,27,12,15
050,51,678,"Virginia","Lexington city",1,82,20,10,10
050,51,678,"Virginia","Lexington city",1,83,25,8,17
050,51,678,"Virginia","Lexington city",1,84,20,4,16
050,51,678,"Virginia","Lexington city",1,85,157,40,117
050,51,678,"Virginia","Lexington city",2,0,75,37,38
050,51,678,"Virginia","Lexington city",2,1,53,28,25
050,51,678,"Virginia","Lexington city",2,2,43,22,21
050,51,678,"Virginia","Lexington city",2,3,29,14,15
050,51,678,"Virginia","Lexington city",2,4,34,20,14
050,51,678,"Virginia","Lexington city",2,5,62,42,20
050,51,678,"Virginia","Lexington city",2,6,50,29,21
050,51,678,"Virginia","Lexington city",2,7,53,30,23
050,51,678,"Virginia","Lexington city",2,8,53,30,23
050,51,678,"Virginia","Lexington city",2,9,46,23,23
050,51,678,"Virginia","Lexington city",2,10,48,26,22
050,51,678,"Virginia","Lexington city",2,11,45,23,22
050,51,678,"Virginia","Lexington city",2,12,52,26,26
050,51,678,"Virginia","Lexington city",2,13,45,22,23
050,51,678,"Virginia","Lexington city",2,14,46,23,23
050,51,678,"Virginia","Lexington city",2,15,52,23,29
050,51,678,"Virginia","Lexington city",2,16,43,22,21
050,51,678,"Virginia","Lexington city",2,17,48,26,22
050,51,678,"Virginia","Lexington city",2,18,489,209,280
050,51,678,"Virginia","Lexington city",2,19,1012,492,520
050,51,678,"Virginia","Lexington city",2,20,806,414,392
050,51,678,"Virginia","Lexington city",2,21,409,237,172
050,51,678,"Virginia","Lexington city",2,22,235,140,95
050,51,678,"Virginia","Lexington city",2,23,117,72,45
050,51,678,"Virginia","Lexington city",2,24,87,41,46
050,51,678,"Virginia","Lexington city",2,25,80,42,38
050,51,678,"Virginia","Lexington city",2,26,73,34,39
050,51,678,"Virginia","Lexington city",2,27,76,35,41
050,51,678,"Virginia","Lexington city",2,28,69,37,32
050,51,678,"Virginia","Lexington city",2,29,71,38,33
050,51,678,"Virginia","Lexington city",2,30,55,28,27
050,51,678,"Virginia","Lexington city",2,31,51,26,25
050,51,678,"Virginia","Lexington city",2,32,55,30,25
050,51,678,"Virginia","Lexington city",2,33,51,27,24
050,51,678,"Virginia","Lexington city",2,34,56,24,32
050,51,678,"Virginia","Lexington city",2,35,60,28,32
050,51,678,"Virginia","Lexington city",2,36,55,27,28
050,51,678,"Virginia","Lexington city",2,37,58,28,30
050,51,678,"Virginia","Lexington city",2,38,54,28,26
050,51,678,"Virginia","Lexington city",2,39,51,24,27
050,51,678,"Virginia","Lexington city",2,40,43,22,21
050,51,678,"Virginia","Lexington city",2,41,58,27,31
050,51,678,"Virginia","Lexington city",2,42,51,24,27
050,51,678,"Virginia","Lexington city",2,43,36,16,20
050,51,678,"Virginia","Lexington city",2,44,41,19,22
050,51,678,"Virginia","Lexington city",2,45,46,22,24
050,51,678,"Virginia","Lexington city",2,46,52,27,25
050,51,678,"Virginia","Lexington city",2,47,44,20,24
050,51,678,"Virginia","Lexington city",2,48,58,31,27
050,51,678,"Virginia","Lexington city",2,49,67,38,29
050,51,678,"Virginia","Lexington city",2,50,58,31,27
050,51,678,"Virginia","Lexington city",2,51,48,25,23
050,51,678,"Virginia","Lexington city",2,52,39,22,17
050,51,678,"Virginia","Lexington city",2,53,41,18,23
050,51,678,"Virginia","Lexington city",2,54,48,25,23
050,51,678,"Virginia","Lexington city",2,55,54,27,27
050,51,678,"Virginia","Lexington city",2,56,56,29,27
050,51,678,"Virginia","Lexington city",2,57,55,25,30
050,51,678,"Virginia","Lexington city",2,58,52,24,28
050,51,678,"Virginia","Lexington city",2,59,57,24,33
050,51,678,"Virginia","Lexington city",2,60,49,21,28
050,51,678,"Virginia","Lexington city",2,61,56,24,32
050,51,678,"Virginia","Lexington city",2,62,61,28,33
050,51,678,"Virginia","Lexington city",2,63,67,26,41
050,51,678,"Virginia","Lexington city",2,64,56,21,35
050,51,678,"Virginia","Lexington city",2,65,50,22,28
050,51,678,"Virginia","Lexington city",2,66,53,23,30
050,51,678,"Virginia","Lexington city",2,67,62,27,35
050,51,678,"Virginia","Lexington city",2,68,69,36,33
050,51,678,"Virginia","Lexington city",2,69,60,28,32
050,51,678,"Virginia","Lexington city",2,70,55,26,29
050,51,678,"Virginia","Lexington city",2,71,56,28,28
050,51,678,"Virginia","Lexington city",2,72,54,25,29
050,51,678,"Virginia","Lexington city",2,73,60,22,38
050,51,678,"Virginia","Lexington city",2,74,45,15,30
050,51,678,"Virginia","Lexington city",2,75,49,18,31
050,51,678,"Virginia","Lexington city",2,76,55,25,30
050,51,678,"Virginia","Lexington city",2,77,53,24,29
050,51,678,"Virginia","Lexington city",2,78,45,17,28
050,51,678,"Virginia","Lexington city",2,79,40,19,21
050,51,678,"Virginia","Lexington city",2,80,36,16,20
050,51,678,"Virginia","Lexington city",2,81,28,13,15
050,51,678,"Virginia","Lexington city",2,82,19,9,10
050,51,678,"Virginia","Lexington city",2,83,24,8,16
050,51,678,"Virginia","Lexington city",2,84,19,5,14
050,51,678,"Virginia","Lexington city",2,85,152,37,115
050,51,678,"Virginia","Lexington city",3,0,113,58,55
050,51,678,"Virginia","Lexington city",3,1,65,36,29
050,51,678,"Virginia","Lexington city",3,2,55,30,25
050,51,678,"Virginia","Lexington city",3,3,42,22,20
050,51,678,"Virginia","Lexington city",3,4,34,20,14
050,51,678,"Virginia","Lexington city",3,5,35,20,15
050,51,678,"Virginia","Lexington city",3,6,60,41,19
050,51,678,"Virginia","Lexington city",3,7,43,23,20
050,51,678,"Virginia","Lexington city",3,8,53,29,24
050,51,678,"Virginia","Lexington city",3,9,56,32,24
050,51,678,"Virginia","Lexington city",3,10,46,22,24
050,51,678,"Virginia","Lexington city",3,11,47,25,22
050,51,678,"Virginia","Lexington city",3,12,45,23,22
050,51,678,"Virginia","Lexington city",3,13,58,29,29
050,51,678,"Virginia","Lexington city",3,14,44,23,21
050,51,678,"Virginia","Lexington city",3,15,52,28,24
050,51,678,"Virginia","Lexington city",3,16,57,26,31
050,51,678,"Virginia","Lexington city",3,17,53,25,28
050,51,678,"Virginia","Lexington city",3,18,500,215,285
050,51,678,"Virginia","Lexington city",3,19,1021,502,519
050,51,678,"Virginia","Lexington city",3,20,794,407,387
050,51,678,"Virginia","Lexington city",3,21,414,241,173
050,51,678,"Virginia","Lexington city",3,22,236,135,101
050,51,678,"Virginia","Lexington city",3,23,119,76,43
050,51,678,"Virginia","Lexington city",3,24,93,45,48
050,51,678,"Virginia","Lexington city",3,25,94,47,47
050,51,678,"Virginia","Lexington city",3,26,62,26,36
050,51,678,"Virginia","Lexington city",3,27,69,33,36
050,51,678,"Virginia","Lexington city",3,28,65,39,26
050,51,678,"Virginia","Lexington city",3,29,57,34,23
050,51,678,"Virginia","Lexington city",3,30,63,32,31
050,51,678,"Virginia","Lexington city",3,31,48,19,29
050,51,678,"Virginia","Lexington city",3,32,59,28,31
050,51,678,"Virginia","Lexington city",3,33,58,26,32
050,51,678,"Virginia","Lexington city",3,34,47,25,22
050,51,678,"Virginia","Lexington city",3,35,57,26,31
050,51,678,"Virginia","Lexington city",3,36,60,29,31
050,51,678,"Virginia","Lexington city",3,37,55,26,29
050,51,678,"Virginia","Lexington city",3,38,61,26,35
050,51,678,"Virginia","Lexington city",3,39,53,24,29
050,51,678,"Virginia","Lexington city",3,40,57,30,27
050,51,678,"Virginia","Lexington city",3,41,49,26,23
050,51,678,"Virginia","Lexington city",3,42,58,30,28
050,51,678,"Virginia","Lexington city",3,43,51,25,26
050,51,678,"Virginia","Lexington city",3,44,43,23,20
050,51,678,"Virginia","Lexington city",3,45,47,22,25
050,51,678,"Virginia","Lexington city",3,46,46,25,21
050,51,678,"Virginia","Lexington city",3,47,59,30,29
050,51,678,"Virginia","Lexington city",3,48,48,22,26
050,51,678,"Virginia","Lexington city",3,49,60,31,29
050,51,678,"Virginia","Lexington city",3,50,69,39,30
050,51,678,"Virginia","Lexington city",3,51,60,33,27
050,51,678,"Virginia","Lexington city",3,52,50,27,23
050,51,678,"Virginia","Lexington city",3,53,44,21,23
050,51,678,"Virginia","Lexington city",3,54,38,17,21
050,51,678,"Virginia","Lexington city",3,55,47,25,22
050,51,678,"Virginia","Lexington city",3,56,52,26,26
050,51,678,"Virginia","Lexington city",3,57,57,28,29
050,51,678,"Virginia","Lexington city",3,58,56,26,30
050,51,678,"Virginia","Lexington city",3,59,53,22,31
050,51,678,"Virginia","Lexington city",3,60,55,27,28
050,51,678,"Virginia","Lexington city",3,61,50,23,27
050,51,678,"Virginia","Lexington city",3,62,67,32,35
050,51,678,"Virginia","Lexington city",3,63,75,30,45
050,51,678,"Virginia","Lexington city",3,64,65,28,37
050,51,678,"Virginia","Lexington city",3,65,57,26,31
050,51,678,"Virginia","Lexington city",3,66,51,24,27
050,51,678,"Virginia","Lexington city",3,67,50,22,28
050,51,678,"Virginia","Lexington city",3,68,59,23,36
050,51,678,"Virginia","Lexington city",3,69,66,33,33
050,51,678,"Virginia","Lexington city",3,70,59,26,33
050,51,678,"Virginia","Lexington city",3,71,55,26,29
050,51,678,"Virginia","Lexington city",3,72,52,27,25
050,51,678,"Virginia","Lexington city",3,73,50,21,29
050,51,678,"Virginia","Lexington city",3,74,55,20,35
050,51,678,"Virginia","Lexington city",3,75,41,14,27
050,51,678,"Virginia","Lexington city",3,76,47,16,31
050,51,678,"Virginia","Lexington city",3,77,50,23,27
050,51,678,"Virginia","Lexington city",3,78,49,22,27
050,51,678,"Virginia","Lexington city",3,79,44,18,26
050,51,678,"Virginia","Lexington city",3,80,35,14,21
050,51,678,"Virginia","Lexington city",3,81,39,15,24
050,51,678,"Virginia","Lexington city",3,82,24,11,13
050,51,678,"Virginia","Lexington city",3,83,18,5,13
050,51,678,"Virginia","Lexington city",3,84,20,8,12
050,51,678,"Virginia","Lexington city",3,85,135,36,99
050,51,678,"Virginia","Lexington city",4,0,123,66,57
050,51,678,"Virginia","Lexington city",4,1,100,49,51
050,51,678,"Virginia","Lexington city",4,2,61,30,31
050,51,678,"Virginia","Lexington city",4,3,55,32,23
050,51,678,"Virginia","Lexington city",4,4,41,21,20
050,51,678,"Virginia","Lexington city",4,5,38,24,14
050,51,678,"Virginia","Lexington city",4,6,36,22,14
050,51,678,"Virginia","Lexington city",4,7,58,40,18
050,51,678,"Virginia","Lexington city",4,8,43,17,26
050,51,678,"Virginia","Lexington city",4,9,52,27,25
050,51,678,"Virginia","Lexington city",4,10,55,31,24
050,51,678,"Virginia","Lexington city",4,11,50,27,23
050,51,678,"Virginia","Lexington city",4,12,47,25,22
050,51,678,"Virginia","Lexington city",4,13,46,23,23
050,51,678,"Virginia","Lexington city",4,14,59,28,31
050,51,678,"Virginia","Lexington city",4,15,43,25,18
050,51,678,"Virginia","Lexington city",4,16,54,28,26
050,51,678,"Virginia","Lexington city",4,17,68,28,40
050,51,678,"Virginia","Lexington city",4,18,496,211,285
050,51,678,"Virginia","Lexington city",4,19,1029,501,528
050,51,678,"Virginia","Lexington city",4,20,812,424,388
050,51,678,"Virginia","Lexington city",4,21,412,237,175
050,51,678,"Virginia","Lexington city",4,22,238,131,107
050,51,678,"Virginia","Lexington city",4,23,109,63,46
050,51,678,"Virginia","Lexington city",4,24,89,47,42
050,51,678,"Virginia","Lexington city",4,25,81,45,36
050,51,678,"Virginia","Lexington city",4,26,83,33,50
050,51,678,"Virginia","Lexington city",4,27,62,25,37
050,51,678,"Virginia","Lexington city",4,28,64,34,30
050,51,678,"Virginia","Lexington city",4,29,62,35,27
050,51,678,"Virginia","Lexington city",4,30,49,25,24
050,51,678,"Virginia","Lexington city",4,31,55,25,30
050,51,678,"Virginia","Lexington city",4,32,47,25,22
050,51,678,"Virginia","Lexington city",4,33,74,37,37
050,51,678,"Virginia","Lexington city",4,34,60,28,32
050,51,678,"Virginia","Lexington city",4,35,49,30,19
050,51,678,"Virginia","Lexington city",4,36,51,24,27
050,51,678,"Virginia","Lexington city",4,37,54,25,29
050,51,678,"Virginia","Lexington city",4,38,55,26,29
050,51,678,"Virginia","Lexington city",4,39,53,18,35
050,51,678,"Virginia","Lexington city",4,40,52,25,27
050,51,678,"Virginia","Lexington city",4,41,61,33,28
050,51,678,"Virginia","Lexington city",4,42,44,22,22
050,51,678,"Virginia","Lexington city",4,43,57,30,27
050,51,678,"Virginia","Lexington city",4,44,50,25,25
050,51,678,"Virginia","Lexington city",4,45,44,25,19
050,51,678,"Virginia","Lexington city",4,46,48,23,25
050,51,678,"Virginia","Lexington city",4,47,46,24,22
050,51,678,"Virginia","Lexington city",4,48,60,34,26
050,51,678,"Virginia","Lexington city",4,49,48,23,25
050,51,678,"Virginia","Lexington city",4,50,58,32,26
050,51,678,"Virginia","Lexington city",4,51,68,39,29
050,51,678,"Virginia","Lexington city",4,52,56,34,22
050,51,678,"Virginia","Lexington city",4,53,56,26,30
050,51,678,"Virginia","Lexington city",4,54,43,22,21
050,51,678,"Virginia","Lexington city",4,55,41,18,23
050,51,678,"Virginia","Lexington city",4,56,40,23,17
050,51,678,"Virginia","Lexington city",4,57,47,18,29
050,51,678,"Virginia","Lexington city",4,58,56,28,28
050,51,678,"Virginia","Lexington city",4,59,60,25,35
050,51,678,"Virginia","Lexington city",4,60,48,24,24
050,51,678,"Virginia","Lexington city",4,61,50,23,27
050,51,678,"Virginia","Lexington city",4,62,52,24,28
050,51,678,"Virginia","Lexington city",4,63,77,30,47
050,51,678,"Virginia","Lexington city",4,64,67,29,38
050,51,678,"Virginia","Lexington city",4,65,57,28,29
050,51,678,"Virginia","Lexington city",4,66,62,29,33
050,51,678,"Virginia","Lexington city",4,67,49,22,27
050,51,678,"Virginia","Lexington city",4,68,49,21,28
050,51,678,"Virginia","Lexington city",4,69,58,23,35
050,51,678,"Virginia","Lexington city",4,70,71,33,38
050,51,678,"Virginia","Lexington city",4,71,58,24,34
050,51,678,"Virginia","Lexington city",4,72,58,28,30
050,51,678,"Virginia","Lexington city",4,73,49,24,25
050,51,678,"Virginia","Lexington city",4,74,49,20,29
050,51,678,"Virginia","Lexington city",4,75,55,21,34
050,51,678,"Virginia","Lexington city",4,76,41,13,28
050,51,678,"Virginia","Lexington city",4,77,40,14,26
050,51,678,"Virginia","Lexington city",4,78,51,22,29
050,51,678,"Virginia","Lexington city",4,79,51,26,25
050,51,678,"Virginia","Lexington city",4,80,37,12,25
050,51,678,"Virginia","Lexington city",4,81,32,13,19
050,51,678,"Virginia","Lexington city",4,82,33,13,20
050,51,678,"Virginia","Lexington city",4,83,28,10,18
050,51,678,"Virginia","Lexington city",4,84,15,6,9
050,51,678,"Virginia","Lexington city",4,85,121,36,85
050,51,678,"Virginia","Lexington city",5,0,121,64,57
050,51,678,"Virginia","Lexington city",5,1,118,69,49
050,51,678,"Virginia","Lexington city",5,2,81,33,48
050,51,678,"Virginia","Lexington city",5,3,58,30,28
050,51,678,"Virginia","Lexington city",5,4,56,30,26
050,51,678,"Virginia","Lexington city",5,5,42,21,21
050,51,678,"Virginia","Lexington city",5,6,33,19,14
050,51,678,"Virginia","Lexington city",5,7,31,21,10
050,51,678,"Virginia","Lexington city",5,8,57,41,16
050,51,678,"Virginia","Lexington city",5,9,49,21,28
050,51,678,"Virginia","Lexington city",5,10,50,27,23
050,51,678,"Virginia","Lexington city",5,11,58,33,25
050,51,678,"Virginia","Lexington city",5,12,48,26,22
050,51,678,"Virginia","Lexington city",5,13,42,19,23
050,51,678,"Virginia","Lexington city",5,14,45,22,23
050,51,678,"Virginia","Lexington city",5,15,57,25,32
050,51,678,"Virginia","Lexington city",5,16,44,25,19
050,51,678,"Virginia","Lexington city",5,17,59,33,26
050,51,678,"Virginia","Lexington city",5,18,500,209,291
050,51,678,"Virginia","Lexington city",5,19,1024,500,524
050,51,678,"Virginia","Lexington city",5,20,808,417,391
050,51,678,"Virginia","Lexington city",5,21,418,246,172
050,51,678,"Virginia","Lexington city",5,22,238,136,102
050,51,678,"Virginia","Lexington city",5,23,114,65,49
050,51,678,"Virginia","Lexington city",5,24,95,42,53
050,51,678,"Virginia","Lexington city",5,25,92,53,39
050,51,678,"Virginia","Lexington city",5,26,62,32,30
050,51,678,"Virginia","Lexington city",5,27,64,30,34
050,51,678,"Virginia","Lexington city",5,28,52,29,23
050,51,678,"Virginia","Lexington city",5,29,59,29,30
050,51,678,"Virginia","Lexington city",5,30,58,28,30
050,51,678,"Virginia","Lexington city",5,31,45,21,24
050,51,678,"Virginia","Lexington city",5,32,55,25,30
050,51,678,"Virginia","Lexington city",5,33,53,22,31
050,51,678,"Virginia","Lexington city",5,34,63,31,32
050,51,678,"Virginia","Lexington city",5,35,56,25,31
050,51,678,"Virginia","Lexington city",5,36,49,28,21
050,51,678,"Virginia","Lexington city",5,37,49,22,27
050,51,678,"Virginia","Lexington city",5,38,53,26,27
050,51,678,"Virginia","Lexington city",5,39,51,21,30
050,51,678,"Virginia","Lexington city",5,40,47,19,28
050,51,678,"Virginia","Lexington city",5,41,58,27,31
050,51,678,"Virginia","Lexington city",5,42,57,29,28
050,51,678,"Virginia","Lexington city",5,43,49,25,24
050,51,678,"Virginia","Lexington city",5,44,57,30,27
050,51,678,"Virginia","Lexington city",5,45,55,29,26
050,51,678,"Virginia","Lexington city",5,46,51,29,22
050,51,678,"Virginia","Lexington city",5,47,48,23,25
050,51,678,"Virginia","Lexington city",5,48,50,27,23
050,51,678,"Virginia","Lexington city",5,49,58,30,28
050,51,678,"Virginia","Lexington city",5,50,52,26,26
050,51,678,"Virginia","Lexington city",5,51,59,33,26
050,51,678,"Virginia","Lexington city",5,52,68,40,28
050,51,678,"Virginia","Lexington city",5,53,61,35,26
050,51,678,"Virginia","Lexington city",5,54,51,27,24
050,51,678,"Virginia","Lexington city",5,55,40,20,20
050,51,678,"Virginia","Lexington city",5,56,38,18,20
050,51,678,"Virginia","Lexington city",5,57,44,23,21
050,51,678,"Virginia","Lexington city",5,58,49,20,29
050,51,678,"Virginia","Lexington city",5,59,63,30,33
050,51,678,"Virginia","Lexington city",5,60,55,26,29
050,51,678,"Virginia","Lexington city",5,61,48,24,24
050,51,678,"Virginia","Lexington city",5,62,54,27,27
050,51,678,"Virginia","Lexington city",5,63,66,26,40
050,51,678,"Virginia","Lexington city",5,64,69,29,40
050,51,678,"Virginia","Lexington city",5,65,61,29,32
050,51,678,"Virginia","Lexington city",5,66,57,28,29
050,51,678,"Virginia","Lexington city",5,67,64,31,33
050,51,678,"Virginia","Lexington city",5,68,47,21,26
050,51,678,"Virginia","Lexington city",5,69,50,20,30
050,51,678,"Virginia","Lexington city",5,70,57,23,34
050,51,678,"Virginia","Lexington city",5,71,65,28,37
050,51,678,"Virginia","Lexington city",5,72,60,26,34
050,51,678,"Virginia","Lexington city",5,73,60,28,32
050,51,678,"Virginia","Lexington city",5,74,47,24,23
050,51,678,"Virginia","Lexington city",5,75,47,20,27
050,51,678,"Virginia","Lexington city",5,76,49,20,29
050,51,678,"Virginia","Lexington city",5,77,37,12,25
050,51,678,"Virginia","Lexington city",5,78,43,14,29
050,51,678,"Virginia","Lexington city",5,79,51,23,28
050,51,678,"Virginia","Lexington city",5,80,42,20,22
050,51,678,"Virginia","Lexington city",5,81,37,12,25
050,51,678,"Virginia","Lexington city",5,82,26,11,15
050,51,678,"Virginia","Lexington city",5,83,37,12,25
050,51,678,"Virginia","Lexington city",5,84,24,10,14
050,51,678,"Virginia","Lexington city",5,85,113,34,79
050,51,680,"Virginia","Lynchburg city",1,0,1004,516,488
050,51,680,"Virginia","Lynchburg city",1,1,933,482,451
050,51,680,"Virginia","Lynchburg city",1,2,901,481,420
050,51,680,"Virginia","Lynchburg city",1,3,873,449,424
050,51,680,"Virginia","Lynchburg city",1,4,887,452,435
050,51,680,"Virginia","Lynchburg city",1,5,847,444,403
050,51,680,"Virginia","Lynchburg city",1,6,827,429,398
050,51,680,"Virginia","Lynchburg city",1,7,804,428,376
050,51,680,"Virginia","Lynchburg city",1,8,815,396,419
050,51,680,"Virginia","Lynchburg city",1,9,789,386,403
050,51,680,"Virginia","Lynchburg city",1,10,766,366,400
050,51,680,"Virginia","Lynchburg city",1,11,811,404,407
050,51,680,"Virginia","Lynchburg city",1,12,821,425,396
050,51,680,"Virginia","Lynchburg city",1,13,807,429,378
050,51,680,"Virginia","Lynchburg city",1,14,815,439,376
050,51,680,"Virginia","Lynchburg city",1,15,771,410,361
050,51,680,"Virginia","Lynchburg city",1,16,833,418,415
050,51,680,"Virginia","Lynchburg city",1,17,887,429,458
050,51,680,"Virginia","Lynchburg city",1,18,2211,978,1233
050,51,680,"Virginia","Lynchburg city",1,19,3713,1573,2140
050,51,680,"Virginia","Lynchburg city",1,20,3544,1573,1971
050,51,680,"Virginia","Lynchburg city",1,21,3235,1535,1700
050,51,680,"Virginia","Lynchburg city",1,22,2905,1331,1574
050,51,680,"Virginia","Lynchburg city",1,23,1848,925,923
050,51,680,"Virginia","Lynchburg city",1,24,1736,862,874
050,51,680,"Virginia","Lynchburg city",1,25,1547,753,794
050,51,680,"Virginia","Lynchburg city",1,26,1469,714,755
050,51,680,"Virginia","Lynchburg city",1,27,1260,641,619
050,51,680,"Virginia","Lynchburg city",1,28,1217,594,623
050,51,680,"Virginia","Lynchburg city",1,29,1219,614,605
050,51,680,"Virginia","Lynchburg city",1,30,1075,547,528
050,51,680,"Virginia","Lynchburg city",1,31,993,498,495
050,51,680,"Virginia","Lynchburg city",1,32,933,457,476
050,51,680,"Virginia","Lynchburg city",1,33,879,439,440
050,51,680,"Virginia","Lynchburg city",1,34,851,401,450
050,51,680,"Virginia","Lynchburg city",1,35,786,372,414
050,51,680,"Virginia","Lynchburg city",1,36,767,374,393
050,51,680,"Virginia","Lynchburg city",1,37,781,390,391
050,51,680,"Virginia","Lynchburg city",1,38,771,374,397
050,51,680,"Virginia","Lynchburg city",1,39,767,357,410
050,51,680,"Virginia","Lynchburg city",1,40,732,349,383
050,51,680,"Virginia","Lynchburg city",1,41,707,333,374
050,51,680,"Virginia","Lynchburg city",1,42,668,307,361
050,51,680,"Virginia","Lynchburg city",1,43,613,277,336
050,51,680,"Virginia","Lynchburg city",1,44,608,286,322
050,51,680,"Virginia","Lynchburg city",1,45,637,303,334
050,51,680,"Virginia","Lynchburg city",1,46,637,322,315
050,51,680,"Virginia","Lynchburg city",1,47,671,330,341
050,51,680,"Virginia","Lynchburg city",1,48,656,306,350
050,51,680,"Virginia","Lynchburg city",1,49,702,327,375
050,51,680,"Virginia","Lynchburg city",1,50,695,325,370
050,51,680,"Virginia","Lynchburg city",1,51,712,325,387
050,51,680,"Virginia","Lynchburg city",1,52,713,317,396
050,51,680,"Virginia","Lynchburg city",1,53,714,324,390
050,51,680,"Virginia","Lynchburg city",1,54,759,364,395
050,51,680,"Virginia","Lynchburg city",1,55,774,364,410
050,51,680,"Virginia","Lynchburg city",1,56,800,378,422
050,51,680,"Virginia","Lynchburg city",1,57,803,388,415
050,51,680,"Virginia","Lynchburg city",1,58,791,369,422
050,51,680,"Virginia","Lynchburg city",1,59,785,379,406
050,51,680,"Virginia","Lynchburg city",1,60,769,353,416
050,51,680,"Virginia","Lynchburg city",1,61,796,358,438
050,51,680,"Virginia","Lynchburg city",1,62,794,358,436
050,51,680,"Virginia","Lynchburg city",1,63,765,353,412
050,51,680,"Virginia","Lynchburg city",1,64,778,366,412
050,51,680,"Virginia","Lynchburg city",1,65,706,322,384
050,51,680,"Virginia","Lynchburg city",1,66,700,308,392
050,51,680,"Virginia","Lynchburg city",1,67,660,286,374
050,51,680,"Virginia","Lynchburg city",1,68,678,298,380
050,51,680,"Virginia","Lynchburg city",1,69,587,265,322
050,51,680,"Virginia","Lynchburg city",1,70,583,261,322
050,51,680,"Virginia","Lynchburg city",1,71,580,248,332
050,51,680,"Virginia","Lynchburg city",1,72,574,243,331
050,51,680,"Virginia","Lynchburg city",1,73,591,267,324
050,51,680,"Virginia","Lynchburg city",1,74,451,201,250
050,51,680,"Virginia","Lynchburg city",1,75,436,187,249
050,51,680,"Virginia","Lynchburg city",1,76,429,163,266
050,51,680,"Virginia","Lynchburg city",1,77,446,192,254
050,51,680,"Virginia","Lynchburg city",1,78,358,141,217
050,51,680,"Virginia","Lynchburg city",1,79,349,137,212
050,51,680,"Virginia","Lynchburg city",1,80,326,128,198
050,51,680,"Virginia","Lynchburg city",1,81,323,127,196
050,51,680,"Virginia","Lynchburg city",1,82,299,118,181
050,51,680,"Virginia","Lynchburg city",1,83,246,93,153
050,51,680,"Virginia","Lynchburg city",1,84,223,84,139
050,51,680,"Virginia","Lynchburg city",1,85,1685,520,1165
050,51,680,"Virginia","Lynchburg city",2,0,1047,535,512
050,51,680,"Virginia","Lynchburg city",2,1,937,482,455
050,51,680,"Virginia","Lynchburg city",2,2,898,475,423
050,51,680,"Virginia","Lynchburg city",2,3,866,452,414
050,51,680,"Virginia","Lynchburg city",2,4,873,446,427
050,51,680,"Virginia","Lynchburg city",2,5,851,443,408
050,51,680,"Virginia","Lynchburg city",2,6,827,431,396
050,51,680,"Virginia","Lynchburg city",2,7,804,423,381
050,51,680,"Virginia","Lynchburg city",2,8,801,398,403
050,51,680,"Virginia","Lynchburg city",2,9,795,388,407
050,51,680,"Virginia","Lynchburg city",2,10,770,371,399
050,51,680,"Virginia","Lynchburg city",2,11,797,393,404
050,51,680,"Virginia","Lynchburg city",2,12,822,425,397
050,51,680,"Virginia","Lynchburg city",2,13,812,429,383
050,51,680,"Virginia","Lynchburg city",2,14,811,435,376
050,51,680,"Virginia","Lynchburg city",2,15,777,413,364
050,51,680,"Virginia","Lynchburg city",2,16,820,416,404
050,51,680,"Virginia","Lynchburg city",2,17,882,425,457
050,51,680,"Virginia","Lynchburg city",2,18,2200,967,1233
050,51,680,"Virginia","Lynchburg city",2,19,3705,1568,2137
050,51,680,"Virginia","Lynchburg city",2,20,3572,1581,1991
050,51,680,"Virginia","Lynchburg city",2,21,3236,1541,1695
050,51,680,"Virginia","Lynchburg city",2,22,2937,1336,1601
050,51,680,"Virginia","Lynchburg city",2,23,1818,909,909
050,51,680,"Virginia","Lynchburg city",2,24,1713,855,858
050,51,680,"Virginia","Lynchburg city",2,25,1531,742,789
050,51,680,"Virginia","Lynchburg city",2,26,1450,714,736
050,51,680,"Virginia","Lynchburg city",2,27,1257,635,622
050,51,680,"Virginia","Lynchburg city",2,28,1216,602,614
050,51,680,"Virginia","Lynchburg city",2,29,1201,599,602
050,51,680,"Virginia","Lynchburg city",2,30,1095,554,541
050,51,680,"Virginia","Lynchburg city",2,31,993,499,494
050,51,680,"Virginia","Lynchburg city",2,32,938,462,476
050,51,680,"Virginia","Lynchburg city",2,33,884,438,446
050,51,680,"Virginia","Lynchburg city",2,34,852,409,443
050,51,680,"Virginia","Lynchburg city",2,35,804,379,425
050,51,680,"Virginia","Lynchburg city",2,36,764,372,392
050,51,680,"Virginia","Lynchburg city",2,37,779,389,390
050,51,680,"Virginia","Lynchburg city",2,38,772,378,394
050,51,680,"Virginia","Lynchburg city",2,39,758,355,403
050,51,680,"Virginia","Lynchburg city",2,40,745,357,388
050,51,680,"Virginia","Lynchburg city",2,41,712,335,377
050,51,680,"Virginia","Lynchburg city",2,42,673,311,362
050,51,680,"Virginia","Lynchburg city",2,43,634,289,345
050,51,680,"Virginia","Lynchburg city",2,44,606,283,323
050,51,680,"Virginia","Lynchburg city",2,45,636,303,333
050,51,680,"Virginia","Lynchburg city",2,46,635,315,320
050,51,680,"Virginia","Lynchburg city",2,47,665,328,337
050,51,680,"Virginia","Lynchburg city",2,48,656,309,347
050,51,680,"Virginia","Lynchburg city",2,49,695,327,368
050,51,680,"Virginia","Lynchburg city",2,50,705,328,377
050,51,680,"Virginia","Lynchburg city",2,51,706,321,385
050,51,680,"Virginia","Lynchburg city",2,52,711,319,392
050,51,680,"Virginia","Lynchburg city",2,53,703,315,388
050,51,680,"Virginia","Lynchburg city",2,54,745,355,390
050,51,680,"Virginia","Lynchburg city",2,55,764,359,405
050,51,680,"Virginia","Lynchburg city",2,56,801,379,422
050,51,680,"Virginia","Lynchburg city",2,57,805,390,415
050,51,680,"Virginia","Lynchburg city",2,58,788,367,421
050,51,680,"Virginia","Lynchburg city",2,59,778,377,401
050,51,680,"Virginia","Lynchburg city",2,60,771,357,414
050,51,680,"Virginia","Lynchburg city",2,61,787,355,432
050,51,680,"Virginia","Lynchburg city",2,62,794,359,435
050,51,680,"Virginia","Lynchburg city",2,63,769,349,420
050,51,680,"Virginia","Lynchburg city",2,64,761,355,406
050,51,680,"Virginia","Lynchburg city",2,65,719,331,388
050,51,680,"Virginia","Lynchburg city",2,66,702,310,392
050,51,680,"Virginia","Lynchburg city",2,67,670,291,379
050,51,680,"Virginia","Lynchburg city",2,68,666,293,373
050,51,680,"Virginia","Lynchburg city",2,69,610,271,339
050,51,680,"Virginia","Lynchburg city",2,70,577,257,320
050,51,680,"Virginia","Lynchburg city",2,71,574,248,326
050,51,680,"Virginia","Lynchburg city",2,72,565,240,325
050,51,680,"Virginia","Lynchburg city",2,73,607,267,340
050,51,680,"Virginia","Lynchburg city",2,74,457,204,253
050,51,680,"Virginia","Lynchburg city",2,75,438,191,247
050,51,680,"Virginia","Lynchburg city",2,76,426,166,260
050,51,680,"Virginia","Lynchburg city",2,77,443,186,257
050,51,680,"Virginia","Lynchburg city",2,78,367,149,218
050,51,680,"Virginia","Lynchburg city",2,79,350,136,214
050,51,680,"Virginia","Lynchburg city",2,80,328,127,201
050,51,680,"Virginia","Lynchburg city",2,81,320,129,191
050,51,680,"Virginia","Lynchburg city",2,82,305,121,184
050,51,680,"Virginia","Lynchburg city",2,83,255,93,162
050,51,680,"Virginia","Lynchburg city",2,84,218,84,134
050,51,680,"Virginia","Lynchburg city",2,85,1672,513,1159
050,51,680,"Virginia","Lynchburg city",3,0,1218,641,577
050,51,680,"Virginia","Lynchburg city",3,1,1011,519,492
050,51,680,"Virginia","Lynchburg city",3,2,880,441,439
050,51,680,"Virginia","Lynchburg city",3,3,851,436,415
050,51,680,"Virginia","Lynchburg city",3,4,851,442,409
050,51,680,"Virginia","Lynchburg city",3,5,821,425,396
050,51,680,"Virginia","Lynchburg city",3,6,831,432,399
050,51,680,"Virginia","Lynchburg city",3,7,809,430,379
050,51,680,"Virginia","Lynchburg city",3,8,780,398,382
050,51,680,"Virginia","Lynchburg city",3,9,785,393,392
050,51,680,"Virginia","Lynchburg city",3,10,776,389,387
050,51,680,"Virginia","Lynchburg city",3,11,766,364,402
050,51,680,"Virginia","Lynchburg city",3,12,777,399,378
050,51,680,"Virginia","Lynchburg city",3,13,803,408,395
050,51,680,"Virginia","Lynchburg city",3,14,814,427,387
050,51,680,"Virginia","Lynchburg city",3,15,802,423,379
050,51,680,"Virginia","Lynchburg city",3,16,794,423,371
050,51,680,"Virginia","Lynchburg city",3,17,864,434,430
050,51,680,"Virginia","Lynchburg city",3,18,2232,979,1253
050,51,680,"Virginia","Lynchburg city",3,19,3692,1563,2129
050,51,680,"Virginia","Lynchburg city",3,20,3559,1589,1970
050,51,680,"Virginia","Lynchburg city",3,21,3232,1556,1676
050,51,680,"Virginia","Lynchburg city",3,22,2972,1352,1620
050,51,680,"Virginia","Lynchburg city",3,23,1840,909,931
050,51,680,"Virginia","Lynchburg city",3,24,1701,841,860
050,51,680,"Virginia","Lynchburg city",3,25,1489,735,754
050,51,680,"Virginia","Lynchburg city",3,26,1419,696,723
050,51,680,"Virginia","Lynchburg city",3,27,1278,651,627
050,51,680,"Virginia","Lynchburg city",3,28,1246,633,613
050,51,680,"Virginia","Lynchburg city",3,29,1191,601,590
050,51,680,"Virginia","Lynchburg city",3,30,1138,557,581
050,51,680,"Virginia","Lynchburg city",3,31,1052,525,527
050,51,680,"Virginia","Lynchburg city",3,32,956,481,475
050,51,680,"Virginia","Lynchburg city",3,33,938,463,475
050,51,680,"Virginia","Lynchburg city",3,34,864,450,414
050,51,680,"Virginia","Lynchburg city",3,35,819,399,420
050,51,680,"Virginia","Lynchburg city",3,36,791,364,427
050,51,680,"Virginia","Lynchburg city",3,37,721,353,368
050,51,680,"Virginia","Lynchburg city",3,38,760,381,379
050,51,680,"Virginia","Lynchburg city",3,39,773,370,403
050,51,680,"Virginia","Lynchburg city",3,40,737,356,381
050,51,680,"Virginia","Lynchburg city",3,41,754,373,381
050,51,680,"Virginia","Lynchburg city",3,42,714,325,389
050,51,680,"Virginia","Lynchburg city",3,43,653,296,357
050,51,680,"Virginia","Lynchburg city",3,44,626,287,339
050,51,680,"Virginia","Lynchburg city",3,45,624,283,341
050,51,680,"Virginia","Lynchburg city",3,46,641,308,333
050,51,680,"Virginia","Lynchburg city",3,47,634,314,320
050,51,680,"Virginia","Lynchburg city",3,48,614,307,307
050,51,680,"Virginia","Lynchburg city",3,49,685,329,356
050,51,680,"Virginia","Lynchburg city",3,50,703,317,386
050,51,680,"Virginia","Lynchburg city",3,51,688,312,376
050,51,680,"Virginia","Lynchburg city",3,52,688,325,363
050,51,680,"Virginia","Lynchburg city",3,53,691,301,390
050,51,680,"Virginia","Lynchburg city",3,54,699,321,378
050,51,680,"Virginia","Lynchburg city",3,55,741,352,389
050,51,680,"Virginia","Lynchburg city",3,56,780,362,418
050,51,680,"Virginia","Lynchburg city",3,57,790,386,404
050,51,680,"Virginia","Lynchburg city",3,58,825,388,437
050,51,680,"Virginia","Lynchburg city",3,59,762,359,403
050,51,680,"Virginia","Lynchburg city",3,60,776,357,419
050,51,680,"Virginia","Lynchburg city",3,61,753,348,405
050,51,680,"Virginia","Lynchburg city",3,62,783,354,429
050,51,680,"Virginia","Lynchburg city",3,63,773,333,440
050,51,680,"Virginia","Lynchburg city",3,64,744,344,400
050,51,680,"Virginia","Lynchburg city",3,65,727,332,395
050,51,680,"Virginia","Lynchburg city",3,66,719,332,387
050,51,680,"Virginia","Lynchburg city",3,67,672,285,387
050,51,680,"Virginia","Lynchburg city",3,68,656,290,366
050,51,680,"Virginia","Lynchburg city",3,69,658,283,375
050,51,680,"Virginia","Lynchburg city",3,70,589,261,328
050,51,680,"Virginia","Lynchburg city",3,71,550,239,311
050,51,680,"Virginia","Lynchburg city",3,72,566,244,322
050,51,680,"Virginia","Lynchburg city",3,73,547,231,316
050,51,680,"Virginia","Lynchburg city",3,74,588,261,327
050,51,680,"Virginia","Lynchburg city",3,75,439,190,249
050,51,680,"Virginia","Lynchburg city",3,76,423,179,244
050,51,680,"Virginia","Lynchburg city",3,77,397,156,241
050,51,680,"Virginia","Lynchburg city",3,78,429,179,250
050,51,680,"Virginia","Lynchburg city",3,79,360,146,214
050,51,680,"Virginia","Lynchburg city",3,80,332,127,205
050,51,680,"Virginia","Lynchburg city",3,81,313,123,190
050,51,680,"Virginia","Lynchburg city",3,82,292,121,171
050,51,680,"Virginia","Lynchburg city",3,83,302,114,188
050,51,680,"Virginia","Lynchburg city",3,84,223,92,131
050,51,680,"Virginia","Lynchburg city",3,85,1558,457,1101
050,51,680,"Virginia","Lynchburg city",4,0,1186,594,592
050,51,680,"Virginia","Lynchburg city",4,1,1138,601,537
050,51,680,"Virginia","Lynchburg city",4,2,941,466,475
050,51,680,"Virginia","Lynchburg city",4,3,853,430,423
050,51,680,"Virginia","Lynchburg city",4,4,832,433,399
050,51,680,"Virginia","Lynchburg city",4,5,838,437,401
050,51,680,"Virginia","Lynchburg city",4,6,789,393,396
050,51,680,"Virginia","Lynchburg city",4,7,833,428,405
050,51,680,"Virginia","Lynchburg city",4,8,810,420,390
050,51,680,"Virginia","Lynchburg city",4,9,761,393,368
050,51,680,"Virginia","Lynchburg city",4,10,772,381,391
050,51,680,"Virginia","Lynchburg city",4,11,784,392,392
050,51,680,"Virginia","Lynchburg city",4,12,751,364,387
050,51,680,"Virginia","Lynchburg city",4,13,788,401,387
050,51,680,"Virginia","Lynchburg city",4,14,818,425,393
050,51,680,"Virginia","Lynchburg city",4,15,814,431,383
050,51,680,"Virginia","Lynchburg city",4,16,824,444,380
050,51,680,"Virginia","Lynchburg city",4,17,839,440,399
050,51,680,"Virginia","Lynchburg city",4,18,2187,969,1218
050,51,680,"Virginia","Lynchburg city",4,19,3707,1563,2144
050,51,680,"Virginia","Lynchburg city",4,20,3562,1578,1984
050,51,680,"Virginia","Lynchburg city",4,21,3318,1599,1719
050,51,680,"Virginia","Lynchburg city",4,22,3024,1369,1655
050,51,680,"Virginia","Lynchburg city",4,23,1823,905,918
050,51,680,"Virginia","Lynchburg city",4,24,1672,813,859
050,51,680,"Virginia","Lynchburg city",4,25,1539,744,795
050,51,680,"Virginia","Lynchburg city",4,26,1392,708,684
050,51,680,"Virginia","Lynchburg city",4,27,1263,630,633
050,51,680,"Virginia","Lynchburg city",4,28,1202,592,610
050,51,680,"Virginia","Lynchburg city",4,29,1185,614,571
050,51,680,"Virginia","Lynchburg city",4,30,1131,574,557
050,51,680,"Virginia","Lynchburg city",4,31,1101,534,567
050,51,680,"Virginia","Lynchburg city",4,32,1004,496,508
050,51,680,"Virginia","Lynchburg city",4,33,942,472,470
050,51,680,"Virginia","Lynchburg city",4,34,918,443,475
050,51,680,"Virginia","Lynchburg city",4,35,833,421,412
050,51,680,"Virginia","Lynchburg city",4,36,804,386,418
050,51,680,"Virginia","Lynchburg city",4,37,784,378,406
050,51,680,"Virginia","Lynchburg city",4,38,719,364,355
050,51,680,"Virginia","Lynchburg city",4,39,742,361,381
050,51,680,"Virginia","Lynchburg city",4,40,750,359,391
050,51,680,"Virginia","Lynchburg city",4,41,722,348,374
050,51,680,"Virginia","Lynchburg city",4,42,734,357,377
050,51,680,"Virginia","Lynchburg city",4,43,703,311,392
050,51,680,"Virginia","Lynchburg city",4,44,649,291,358
050,51,680,"Virginia","Lynchburg city",4,45,628,287,341
050,51,680,"Virginia","Lynchburg city",4,46,620,279,341
050,51,680,"Virginia","Lynchburg city",4,47,630,294,336
050,51,680,"Virginia","Lynchburg city",4,48,589,292,297
050,51,680,"Virginia","Lynchburg city",4,49,625,306,319
050,51,680,"Virginia","Lynchburg city",4,50,693,323,370
050,51,680,"Virginia","Lynchburg city",4,51,690,299,391
050,51,680,"Virginia","Lynchburg city",4,52,664,311,353
050,51,680,"Virginia","Lynchburg city",4,53,668,309,359
050,51,680,"Virginia","Lynchburg city",4,54,694,298,396
050,51,680,"Virginia","Lynchburg city",4,55,689,305,384
050,51,680,"Virginia","Lynchburg city",4,56,736,346,390
050,51,680,"Virginia","Lynchburg city",4,57,767,370,397
050,51,680,"Virginia","Lynchburg city",4,58,787,366,421
050,51,680,"Virginia","Lynchburg city",4,59,801,383,418
050,51,680,"Virginia","Lynchburg city",4,60,764,345,419
050,51,680,"Virginia","Lynchburg city",4,61,739,341,398
050,51,680,"Virginia","Lynchburg city",4,62,764,360,404
050,51,680,"Virginia","Lynchburg city",4,63,757,339,418
050,51,680,"Virginia","Lynchburg city",4,64,763,324,439
050,51,680,"Virginia","Lynchburg city",4,65,707,327,380
050,51,680,"Virginia","Lynchburg city",4,66,698,307,391
050,51,680,"Virginia","Lynchburg city",4,67,700,314,386
050,51,680,"Virginia","Lynchburg city",4,68,652,283,369
050,51,680,"Virginia","Lynchburg city",4,69,645,281,364
050,51,680,"Virginia","Lynchburg city",4,70,624,262,362
050,51,680,"Virginia","Lynchburg city",4,71,572,248,324
050,51,680,"Virginia","Lynchburg city",4,72,536,234,302
050,51,680,"Virginia","Lynchburg city",4,73,520,220,300
050,51,680,"Virginia","Lynchburg city",4,74,532,227,305
050,51,680,"Virginia","Lynchburg city",4,75,563,247,316
050,51,680,"Virginia","Lynchburg city",4,76,423,177,246
050,51,680,"Virginia","Lynchburg city",4,77,405,171,234
050,51,680,"Virginia","Lynchburg city",4,78,385,152,233
050,51,680,"Virginia","Lynchburg city",4,79,423,173,250
050,51,680,"Virginia","Lynchburg city",4,80,341,134,207
050,51,680,"Virginia","Lynchburg city",4,81,317,121,196
050,51,680,"Virginia","Lynchburg city",4,82,287,113,174
050,51,680,"Virginia","Lynchburg city",4,83,295,109,186
050,51,680,"Virginia","Lynchburg city",4,84,274,116,158
050,51,680,"Virginia","Lynchburg city",4,85,1480,420,1060
050,51,680,"Virginia","Lynchburg city",5,0,1140,571,569
050,51,680,"Virginia","Lynchburg city",5,1,1101,569,532
050,51,680,"Virginia","Lynchburg city",5,2,1080,581,499
050,51,680,"Virginia","Lynchburg city",5,3,933,460,473
050,51,680,"Virginia","Lynchburg city",5,4,828,427,401
050,51,680,"Virginia","Lynchburg city",5,5,825,440,385
050,51,680,"Virginia","Lynchburg city",5,6,809,413,396
050,51,680,"Virginia","Lynchburg city",5,7,770,377,393
050,51,680,"Virginia","Lynchburg city",5,8,827,416,411
050,51,680,"Virginia","Lynchburg city",5,9,807,423,384
050,51,680,"Virginia","Lynchburg city",5,10,776,390,386
050,51,680,"Virginia","Lynchburg city",5,11,789,389,400
050,51,680,"Virginia","Lynchburg city",5,12,775,388,387
050,51,680,"Virginia","Lynchburg city",5,13,764,363,401
050,51,680,"Virginia","Lynchburg city",5,14,788,396,392
050,51,680,"Virginia","Lynchburg city",5,15,832,428,404
050,51,680,"Virginia","Lynchburg city",5,16,812,439,373
050,51,680,"Virginia","Lynchburg city",5,17,863,462,401
050,51,680,"Virginia","Lynchburg city",5,18,2148,961,1187
050,51,680,"Virginia","Lynchburg city",5,19,3689,1564,2125
050,51,680,"Virginia","Lynchburg city",5,20,3544,1575,1969
050,51,680,"Virginia","Lynchburg city",5,21,3290,1580,1710
050,51,680,"Virginia","Lynchburg city",5,22,3098,1418,1680
050,51,680,"Virginia","Lynchburg city",5,23,1904,925,979
050,51,680,"Virginia","Lynchburg city",5,24,1687,824,863
050,51,680,"Virginia","Lynchburg city",5,25,1457,719,738
050,51,680,"Virginia","Lynchburg city",5,26,1393,689,704
050,51,680,"Virginia","Lynchburg city",5,27,1237,638,599
050,51,680,"Virginia","Lynchburg city",5,28,1196,606,590
050,51,680,"Virginia","Lynchburg city",5,29,1177,587,590
050,51,680,"Virginia","Lynchburg city",5,30,1105,568,537
050,51,680,"Virginia","Lynchburg city",5,31,1088,569,519
050,51,680,"Virginia","Lynchburg city",5,32,1051,506,545
050,51,680,"Virginia","Lynchburg city",5,33,989,493,496
050,51,680,"Virginia","Lynchburg city",5,34,928,466,462
050,51,680,"Virginia","Lynchburg city",5,35,888,434,454
050,51,680,"Virginia","Lynchburg city",5,36,808,408,400
050,51,680,"Virginia","Lynchburg city",5,37,804,395,409
050,51,680,"Virginia","Lynchburg city",5,38,782,377,405
050,51,680,"Virginia","Lynchburg city",5,39,703,340,363
050,51,680,"Virginia","Lynchburg city",5,40,750,364,386
050,51,680,"Virginia","Lynchburg city",5,41,734,349,385
050,51,680,"Virginia","Lynchburg city",5,42,714,341,373
050,51,680,"Virginia","Lynchburg city",5,43,711,343,368
050,51,680,"Virginia","Lynchburg city",5,44,716,307,409
050,51,680,"Virginia","Lynchburg city",5,45,646,285,361
050,51,680,"Virginia","Lynchburg city",5,46,629,291,338
050,51,680,"Virginia","Lynchburg city",5,47,635,282,353
050,51,680,"Virginia","Lynchburg city",5,48,605,282,323
050,51,680,"Virginia","Lynchburg city",5,49,590,303,287
050,51,680,"Virginia","Lynchburg city",5,50,653,317,336
050,51,680,"Virginia","Lynchburg city",5,51,689,305,384
050,51,680,"Virginia","Lynchburg city",5,52,693,310,383
050,51,680,"Virginia","Lynchburg city",5,53,655,289,366
050,51,680,"Virginia","Lynchburg city",5,54,665,304,361
050,51,680,"Virginia","Lynchburg city",5,55,675,282,393
050,51,680,"Virginia","Lynchburg city",5,56,711,325,386
050,51,680,"Virginia","Lynchburg city",5,57,721,345,376
050,51,680,"Virginia","Lynchburg city",5,58,764,349,415
050,51,680,"Virginia","Lynchburg city",5,59,767,375,392
050,51,680,"Virginia","Lynchburg city",5,60,786,363,423
050,51,680,"Virginia","Lynchburg city",5,61,764,344,420
050,51,680,"Virginia","Lynchburg city",5,62,749,344,405
050,51,680,"Virginia","Lynchburg city",5,63,748,338,410
050,51,680,"Virginia","Lynchburg city",5,64,742,331,411
050,51,680,"Virginia","Lynchburg city",5,65,712,302,410
050,51,680,"Virginia","Lynchburg city",5,66,704,319,385
050,51,680,"Virginia","Lynchburg city",5,67,698,306,392
050,51,680,"Virginia","Lynchburg city",5,68,682,314,368
050,51,680,"Virginia","Lynchburg city",5,69,643,271,372
050,51,680,"Virginia","Lynchburg city",5,70,603,259,344
050,51,680,"Virginia","Lynchburg city",5,71,608,255,353
050,51,680,"Virginia","Lynchburg city",5,72,568,245,323
050,51,680,"Virginia","Lynchburg city",5,73,513,223,290
050,51,680,"Virginia","Lynchburg city",5,74,520,218,302
050,51,680,"Virginia","Lynchburg city",5,75,513,216,297
050,51,680,"Virginia","Lynchburg city",5,76,552,230,322
050,51,680,"Virginia","Lynchburg city",5,77,398,164,234
050,51,680,"Virginia","Lynchburg city",5,78,396,172,224
050,51,680,"Virginia","Lynchburg city",5,79,377,151,226
050,51,680,"Virginia","Lynchburg city",5,80,408,166,242
050,51,680,"Virginia","Lynchburg city",5,81,319,127,192
050,51,680,"Virginia","Lynchburg city",5,82,295,116,179
050,51,680,"Virginia","Lynchburg city",5,83,282,100,182
050,51,680,"Virginia","Lynchburg city",5,84,258,105,153
050,51,680,"Virginia","Lynchburg city",5,85,1489,420,1069
050,51,683,"Virginia","Manassas city",1,0,698,359,339
050,51,683,"Virginia","Manassas city",1,1,644,339,305
050,51,683,"Virginia","Manassas city",1,2,721,376,345
050,51,683,"Virginia","Manassas city",1,3,687,366,321
050,51,683,"Virginia","Manassas city",1,4,676,348,328
050,51,683,"Virginia","Manassas city",1,5,686,367,319
050,51,683,"Virginia","Manassas city",1,6,634,344,290
050,51,683,"Virginia","Manassas city",1,7,632,319,313
050,51,683,"Virginia","Manassas city",1,8,639,302,337
050,51,683,"Virginia","Manassas city",1,9,615,329,286
050,51,683,"Virginia","Manassas city",1,10,614,305,309
050,51,683,"Virginia","Manassas city",1,11,644,322,322
050,51,683,"Virginia","Manassas city",1,12,668,345,323
050,51,683,"Virginia","Manassas city",1,13,674,371,303
050,51,683,"Virginia","Manassas city",1,14,652,335,317
050,51,683,"Virginia","Manassas city",1,15,605,306,299
050,51,683,"Virginia","Manassas city",1,16,578,289,289
050,51,683,"Virginia","Manassas city",1,17,604,317,287
050,51,683,"Virginia","Manassas city",1,18,505,278,227
050,51,683,"Virginia","Manassas city",1,19,460,232,228
050,51,683,"Virginia","Manassas city",1,20,498,253,245
050,51,683,"Virginia","Manassas city",1,21,529,274,255
050,51,683,"Virginia","Manassas city",1,22,541,271,270
050,51,683,"Virginia","Manassas city",1,23,580,297,283
050,51,683,"Virginia","Manassas city",1,24,602,305,297
050,51,683,"Virginia","Manassas city",1,25,630,321,309
050,51,683,"Virginia","Manassas city",1,26,656,318,338
050,51,683,"Virginia","Manassas city",1,27,664,334,330
050,51,683,"Virginia","Manassas city",1,28,627,307,320
050,51,683,"Virginia","Manassas city",1,29,629,303,326
050,51,683,"Virginia","Manassas city",1,30,658,339,319
050,51,683,"Virginia","Manassas city",1,31,643,332,311
050,51,683,"Virginia","Manassas city",1,32,609,327,282
050,51,683,"Virginia","Manassas city",1,33,578,308,270
050,51,683,"Virginia","Manassas city",1,34,636,354,282
050,51,683,"Virginia","Manassas city",1,35,631,322,309
050,51,683,"Virginia","Manassas city",1,36,626,321,305
050,51,683,"Virginia","Manassas city",1,37,622,325,297
050,51,683,"Virginia","Manassas city",1,38,615,323,292
050,51,683,"Virginia","Manassas city",1,39,662,363,299
050,51,683,"Virginia","Manassas city",1,40,640,328,312
050,51,683,"Virginia","Manassas city",1,41,631,337,294
050,51,683,"Virginia","Manassas city",1,42,652,336,316
050,51,683,"Virginia","Manassas city",1,43,599,324,275
050,51,683,"Virginia","Manassas city",1,44,542,264,278
050,51,683,"Virginia","Manassas city",1,45,587,328,259
050,51,683,"Virginia","Manassas city",1,46,580,320,260
050,51,683,"Virginia","Manassas city",1,47,548,280,268
050,51,683,"Virginia","Manassas city",1,48,550,281,269
050,51,683,"Virginia","Manassas city",1,49,564,296,268
050,51,683,"Virginia","Manassas city",1,50,563,302,261
050,51,683,"Virginia","Manassas city",1,51,522,271,251
050,51,683,"Virginia","Manassas city",1,52,509,267,242
050,51,683,"Virginia","Manassas city",1,53,502,256,246
050,51,683,"Virginia","Manassas city",1,54,526,252,274
050,51,683,"Virginia","Manassas city",1,55,563,271,292
050,51,683,"Virginia","Manassas city",1,56,563,260,303
050,51,683,"Virginia","Manassas city",1,57,556,263,293
050,51,683,"Virginia","Manassas city",1,58,582,270,312
050,51,683,"Virginia","Manassas city",1,59,522,238,284
050,51,683,"Virginia","Manassas city",1,60,509,254,255
050,51,683,"Virginia","Manassas city",1,61,506,245,261
050,51,683,"Virginia","Manassas city",1,62,459,239,220
050,51,683,"Virginia","Manassas city",1,63,456,221,235
050,51,683,"Virginia","Manassas city",1,64,400,186,214
050,51,683,"Virginia","Manassas city",1,65,335,151,184
050,51,683,"Virginia","Manassas city",1,66,350,178,172
050,51,683,"Virginia","Manassas city",1,67,346,179,167
050,51,683,"Virginia","Manassas city",1,68,331,160,171
050,51,683,"Virginia","Manassas city",1,69,281,129,152
050,51,683,"Virginia","Manassas city",1,70,278,129,149
050,51,683,"Virginia","Manassas city",1,71,260,123,137
050,51,683,"Virginia","Manassas city",1,72,269,124,145
050,51,683,"Virginia","Manassas city",1,73,238,111,127
050,51,683,"Virginia","Manassas city",1,74,164,84,80
050,51,683,"Virginia","Manassas city",1,75,168,74,94
050,51,683,"Virginia","Manassas city",1,76,154,68,86
050,51,683,"Virginia","Manassas city",1,77,135,61,74
050,51,683,"Virginia","Manassas city",1,78,131,62,69
050,51,683,"Virginia","Manassas city",1,79,105,50,55
050,51,683,"Virginia","Manassas city",1,80,91,39,52
050,51,683,"Virginia","Manassas city",1,81,90,40,50
050,51,683,"Virginia","Manassas city",1,82,78,26,52
050,51,683,"Virginia","Manassas city",1,83,74,37,37
050,51,683,"Virginia","Manassas city",1,84,59,24,35
050,51,683,"Virginia","Manassas city",1,85,333,102,231
050,51,683,"Virginia","Manassas city",2,0,676,346,330
050,51,683,"Virginia","Manassas city",2,1,663,348,315
050,51,683,"Virginia","Manassas city",2,2,697,365,332
050,51,683,"Virginia","Manassas city",2,3,684,361,323
050,51,683,"Virginia","Manassas city",2,4,678,354,324
050,51,683,"Virginia","Manassas city",2,5,677,358,319
050,51,683,"Virginia","Manassas city",2,6,639,345,294
050,51,683,"Virginia","Manassas city",2,7,630,322,308
050,51,683,"Virginia","Manassas city",2,8,628,302,326
050,51,683,"Virginia","Manassas city",2,9,614,317,297
050,51,683,"Virginia","Manassas city",2,10,608,308,300
050,51,683,"Virginia","Manassas city",2,11,632,315,317
050,51,683,"Virginia","Manassas city",2,12,659,337,322
050,51,683,"Virginia","Manassas city",2,13,668,360,308
050,51,683,"Virginia","Manassas city",2,14,649,336,313
050,51,683,"Virginia","Manassas city",2,15,613,311,302
050,51,683,"Virginia","Manassas city",2,16,585,294,291
050,51,683,"Virginia","Manassas city",2,17,591,310,281
050,51,683,"Virginia","Manassas city",2,18,509,277,232
050,51,683,"Virginia","Manassas city",2,19,463,238,225
050,51,683,"Virginia","Manassas city",2,20,499,254,245
050,51,683,"Virginia","Manassas city",2,21,528,271,257
050,51,683,"Virginia","Manassas city",2,22,544,274,270
050,51,683,"Virginia","Manassas city",2,23,578,293,285
050,51,683,"Virginia","Manassas city",2,24,604,306,298
050,51,683,"Virginia","Manassas city",2,25,633,322,311
050,51,683,"Virginia","Manassas city",2,26,658,329,329
050,51,683,"Virginia","Manassas city",2,27,655,329,326
050,51,683,"Virginia","Manassas city",2,28,633,311,322
050,51,683,"Virginia","Manassas city",2,29,627,304,323
050,51,683,"Virginia","Manassas city",2,30,654,335,319
050,51,683,"Virginia","Manassas city",2,31,645,336,309
050,51,683,"Virginia","Manassas city",2,32,615,328,287
050,51,683,"Virginia","Manassas city",2,33,586,315,271
050,51,683,"Virginia","Manassas city",2,34,618,339,279
050,51,683,"Virginia","Manassas city",2,35,631,329,302
050,51,683,"Virginia","Manassas city",2,36,614,315,299
050,51,683,"Virginia","Manassas city",2,37,618,322,296
050,51,683,"Virginia","Manassas city",2,38,621,325,296
050,51,683,"Virginia","Manassas city",2,39,644,349,295
050,51,683,"Virginia","Manassas city",2,40,649,339,310
050,51,683,"Virginia","Manassas city",2,41,633,334,299
050,51,683,"Virginia","Manassas city",2,42,639,333,306
050,51,683,"Virginia","Manassas city",2,43,609,324,285
050,51,683,"Virginia","Manassas city",2,44,554,280,274
050,51,683,"Virginia","Manassas city",2,45,573,311,262
050,51,683,"Virginia","Manassas city",2,46,582,321,261
050,51,683,"Virginia","Manassas city",2,47,554,288,266
050,51,683,"Virginia","Manassas city",2,48,550,282,268
050,51,683,"Virginia","Manassas city",2,49,567,298,269
050,51,683,"Virginia","Manassas city",2,50,564,302,262
050,51,683,"Virginia","Manassas city",2,51,526,275,251
050,51,683,"Virginia","Manassas city",2,52,511,269,242
050,51,683,"Virginia","Manassas city",2,53,502,257,245
050,51,683,"Virginia","Manassas city",2,54,519,250,269
050,51,683,"Virginia","Manassas city",2,55,554,265,289
050,51,683,"Virginia","Manassas city",2,56,558,259,299
050,51,683,"Virginia","Manassas city",2,57,555,258,297
050,51,683,"Virginia","Manassas city",2,58,571,267,304
050,51,683,"Virginia","Manassas city",2,59,531,244,287
050,51,683,"Virginia","Manassas city",2,60,508,246,262
050,51,683,"Virginia","Manassas city",2,61,501,244,257
050,51,683,"Virginia","Manassas city",2,62,467,238,229
050,51,683,"Virginia","Manassas city",2,63,452,220,232
050,51,683,"Virginia","Manassas city",2,64,403,187,216
050,51,683,"Virginia","Manassas city",2,65,348,158,190
050,51,683,"Virginia","Manassas city",2,66,347,172,175
050,51,683,"Virginia","Manassas city",2,67,341,176,165
050,51,683,"Virginia","Manassas city",2,68,331,163,168
050,51,683,"Virginia","Manassas city",2,69,290,136,154
050,51,683,"Virginia","Manassas city",2,70,277,129,148
050,51,683,"Virginia","Manassas city",2,71,261,124,137
050,51,683,"Virginia","Manassas city",2,72,261,121,140
050,51,683,"Virginia","Manassas city",2,73,252,118,134
050,51,683,"Virginia","Manassas city",2,74,169,83,86
050,51,683,"Virginia","Manassas city",2,75,167,75,92
050,51,683,"Virginia","Manassas city",2,76,156,67,89
050,51,683,"Virginia","Manassas city",2,77,141,64,77
050,51,683,"Virginia","Manassas city",2,78,127,59,68
050,51,683,"Virginia","Manassas city",2,79,108,50,58
050,51,683,"Virginia","Manassas city",2,80,94,41,53
050,51,683,"Virginia","Manassas city",2,81,88,39,49
050,51,683,"Virginia","Manassas city",2,82,78,28,50
050,51,683,"Virginia","Manassas city",2,83,73,35,38
050,51,683,"Virginia","Manassas city",2,84,59,25,34
050,51,683,"Virginia","Manassas city",2,85,324,104,220
050,51,683,"Virginia","Manassas city",3,0,691,351,340
050,51,683,"Virginia","Manassas city",3,1,699,364,335
050,51,683,"Virginia","Manassas city",3,2,661,342,319
050,51,683,"Virginia","Manassas city",3,3,696,351,345
050,51,683,"Virginia","Manassas city",3,4,641,347,294
050,51,683,"Virginia","Manassas city",3,5,632,333,299
050,51,683,"Virginia","Manassas city",3,6,656,338,318
050,51,683,"Virginia","Manassas city",3,7,623,328,295
050,51,683,"Virginia","Manassas city",3,8,631,319,312
050,51,683,"Virginia","Manassas city",3,9,601,287,314
050,51,683,"Virginia","Manassas city",3,10,590,303,287
050,51,683,"Virginia","Manassas city",3,11,593,305,288
050,51,683,"Virginia","Manassas city",3,12,615,310,305
050,51,683,"Virginia","Manassas city",3,13,643,334,309
050,51,683,"Virginia","Manassas city",3,14,652,342,310
050,51,683,"Virginia","Manassas city",3,15,675,342,333
050,51,683,"Virginia","Manassas city",3,16,593,300,293
050,51,683,"Virginia","Manassas city",3,17,576,286,290
050,51,683,"Virginia","Manassas city",3,18,533,286,247
050,51,683,"Virginia","Manassas city",3,19,472,252,220
050,51,683,"Virginia","Manassas city",3,20,490,248,242
050,51,683,"Virginia","Manassas city",3,21,530,273,257
050,51,683,"Virginia","Manassas city",3,22,553,291,262
050,51,683,"Virginia","Manassas city",3,23,594,312,282
050,51,683,"Virginia","Manassas city",3,24,634,317,317
050,51,683,"Virginia","Manassas city",3,25,630,306,324
050,51,683,"Virginia","Manassas city",3,26,658,331,327
050,51,683,"Virginia","Manassas city",3,27,641,329,312
050,51,683,"Virginia","Manassas city",3,28,676,336,340
050,51,683,"Virginia","Manassas city",3,29,612,298,314
050,51,683,"Virginia","Manassas city",3,30,626,310,316
050,51,683,"Virginia","Manassas city",3,31,660,340,320
050,51,683,"Virginia","Manassas city",3,32,636,331,305
050,51,683,"Virginia","Manassas city",3,33,607,318,289
050,51,683,"Virginia","Manassas city",3,34,612,330,282
050,51,683,"Virginia","Manassas city",3,35,613,330,283
050,51,683,"Virginia","Manassas city",3,36,638,335,303
050,51,683,"Virginia","Manassas city",3,37,588,311,277
050,51,683,"Virginia","Manassas city",3,38,608,328,280
050,51,683,"Virginia","Manassas city",3,39,605,311,294
050,51,683,"Virginia","Manassas city",3,40,639,351,288
050,51,683,"Virginia","Manassas city",3,41,659,347,312
050,51,683,"Virginia","Manassas city",3,42,602,316,286
050,51,683,"Virginia","Manassas city",3,43,628,341,287
050,51,683,"Virginia","Manassas city",3,44,598,313,285
050,51,683,"Virginia","Manassas city",3,45,574,295,279
050,51,683,"Virginia","Manassas city",3,46,570,297,273
050,51,683,"Virginia","Manassas city",3,47,554,297,257
050,51,683,"Virginia","Manassas city",3,48,536,278,258
050,51,683,"Virginia","Manassas city",3,49,544,285,259
050,51,683,"Virginia","Manassas city",3,50,563,294,269
050,51,683,"Virginia","Manassas city",3,51,574,316,258
050,51,683,"Virginia","Manassas city",3,52,522,266,256
050,51,683,"Virginia","Manassas city",3,53,535,288,247
050,51,683,"Virginia","Manassas city",3,54,483,248,235
050,51,683,"Virginia","Manassas city",3,55,523,249,274
050,51,683,"Virginia","Manassas city",3,56,529,262,267
050,51,683,"Virginia","Manassas city",3,57,532,251,281
050,51,683,"Virginia","Manassas city",3,58,536,255,281
050,51,683,"Virginia","Manassas city",3,59,558,256,302
050,51,683,"Virginia","Manassas city",3,60,499,234,265
050,51,683,"Virginia","Manassas city",3,61,484,236,248
050,51,683,"Virginia","Manassas city",3,62,479,226,253
050,51,683,"Virginia","Manassas city",3,63,457,234,223
050,51,683,"Virginia","Manassas city",3,64,451,228,223
050,51,683,"Virginia","Manassas city",3,65,403,181,222
050,51,683,"Virginia","Manassas city",3,66,338,144,194
050,51,683,"Virginia","Manassas city",3,67,336,167,169
050,51,683,"Virginia","Manassas city",3,68,332,177,155
050,51,683,"Virginia","Manassas city",3,69,323,159,164
050,51,683,"Virginia","Manassas city",3,70,279,131,148
050,51,683,"Virginia","Manassas city",3,71,270,124,146
050,51,683,"Virginia","Manassas city",3,72,252,121,131
050,51,683,"Virginia","Manassas city",3,73,251,116,135
050,51,683,"Virginia","Manassas city",3,74,242,110,132
050,51,683,"Virginia","Manassas city",3,75,168,81,87
050,51,683,"Virginia","Manassas city",3,76,157,71,86
050,51,683,"Virginia","Manassas city",3,77,142,64,78
050,51,683,"Virginia","Manassas city",3,78,126,56,70
050,51,683,"Virginia","Manassas city",3,79,118,55,63
050,51,683,"Virginia","Manassas city",3,80,103,49,54
050,51,683,"Virginia","Manassas city",3,81,90,37,53
050,51,683,"Virginia","Manassas city",3,82,80,36,44
050,51,683,"Virginia","Manassas city",3,83,70,26,44
050,51,683,"Virginia","Manassas city",3,84,68,33,35
050,51,683,"Virginia","Manassas city",3,85,303,100,203
050,51,683,"Virginia","Manassas city",4,0,688,358,330
050,51,683,"Virginia","Manassas city",4,1,700,362,338
050,51,683,"Virginia","Manassas city",4,2,647,333,314
050,51,683,"Virginia","Manassas city",4,3,668,353,315
050,51,683,"Virginia","Manassas city",4,4,690,351,339
050,51,683,"Virginia","Manassas city",4,5,673,375,298
050,51,683,"Virginia","Manassas city",4,6,637,325,312
050,51,683,"Virginia","Manassas city",4,7,648,324,324
050,51,683,"Virginia","Manassas city",4,8,630,334,296
050,51,683,"Virginia","Manassas city",4,9,614,324,290
050,51,683,"Virginia","Manassas city",4,10,576,277,299
050,51,683,"Virginia","Manassas city",4,11,575,297,278
050,51,683,"Virginia","Manassas city",4,12,566,298,268
050,51,683,"Virginia","Manassas city",4,13,629,327,302
050,51,683,"Virginia","Manassas city",4,14,613,324,289
050,51,683,"Virginia","Manassas city",4,15,635,344,291
050,51,683,"Virginia","Manassas city",4,16,672,345,327
050,51,683,"Virginia","Manassas city",4,17,620,295,325
050,51,683,"Virginia","Manassas city",4,18,503,229,274
050,51,683,"Virginia","Manassas city",4,19,487,238,249
050,51,683,"Virginia","Manassas city",4,20,483,253,230
050,51,683,"Virginia","Manassas city",4,21,482,258,224
050,51,683,"Virginia","Manassas city",4,22,559,284,275
050,51,683,"Virginia","Manassas city",4,23,556,292,264
050,51,683,"Virginia","Manassas city",4,24,580,303,277
050,51,683,"Virginia","Manassas city",4,25,668,348,320
050,51,683,"Virginia","Manassas city",4,26,637,317,320
050,51,683,"Virginia","Manassas city",4,27,629,311,318
050,51,683,"Virginia","Manassas city",4,28,631,333,298
050,51,683,"Virginia","Manassas city",4,29,691,338,353
050,51,683,"Virginia","Manassas city",4,30,648,324,324
050,51,683,"Virginia","Manassas city",4,31,639,294,345
050,51,683,"Virginia","Manassas city",4,32,676,359,317
050,51,683,"Virginia","Manassas city",4,33,644,329,315
050,51,683,"Virginia","Manassas city",4,34,640,330,310
050,51,683,"Virginia","Manassas city",4,35,638,343,295
050,51,683,"Virginia","Manassas city",4,36,600,339,261
050,51,683,"Virginia","Manassas city",4,37,616,322,294
050,51,683,"Virginia","Manassas city",4,38,595,312,283
050,51,683,"Virginia","Manassas city",4,39,640,369,271
050,51,683,"Virginia","Manassas city",4,40,608,328,280
050,51,683,"Virginia","Manassas city",4,41,641,343,298
050,51,683,"Virginia","Manassas city",4,42,625,326,299
050,51,683,"Virginia","Manassas city",4,43,601,310,291
050,51,683,"Virginia","Manassas city",4,44,599,323,276
050,51,683,"Virginia","Manassas city",4,45,576,302,274
050,51,683,"Virginia","Manassas city",4,46,543,275,268
050,51,683,"Virginia","Manassas city",4,47,559,298,261
050,51,683,"Virginia","Manassas city",4,48,548,287,261
050,51,683,"Virginia","Manassas city",4,49,499,263,236
050,51,683,"Virginia","Manassas city",4,50,535,274,261
050,51,683,"Virginia","Manassas city",4,51,557,302,255
050,51,683,"Virginia","Manassas city",4,52,567,316,251
050,51,683,"Virginia","Manassas city",4,53,509,254,255
050,51,683,"Virginia","Manassas city",4,54,516,275,241
050,51,683,"Virginia","Manassas city",4,55,472,243,229
050,51,683,"Virginia","Manassas city",4,56,484,228,256
050,51,683,"Virginia","Manassas city",4,57,499,255,244
050,51,683,"Virginia","Manassas city",4,58,527,254,273
050,51,683,"Virginia","Manassas city",4,59,533,251,282
050,51,683,"Virginia","Manassas city",4,60,536,244,292
050,51,683,"Virginia","Manassas city",4,61,477,233,244
050,51,683,"Virginia","Manassas city",4,62,472,234,238
050,51,683,"Virginia","Manassas city",4,63,449,211,238
050,51,683,"Virginia","Manassas city",4,64,440,226,214
050,51,683,"Virginia","Manassas city",4,65,435,224,211
050,51,683,"Virginia","Manassas city",4,66,398,172,226
050,51,683,"Virginia","Manassas city",4,67,329,142,187
050,51,683,"Virginia","Manassas city",4,68,326,166,160
050,51,683,"Virginia","Manassas city",4,69,308,162,146
050,51,683,"Virginia","Manassas city",4,70,313,154,159
050,51,683,"Virginia","Manassas city",4,71,271,125,146
050,51,683,"Virginia","Manassas city",4,72,258,119,139
050,51,683,"Virginia","Manassas city",4,73,243,117,126
050,51,683,"Virginia","Manassas city",4,74,235,109,126
050,51,683,"Virginia","Manassas city",4,75,225,104,121
050,51,683,"Virginia","Manassas city",4,76,157,74,83
050,51,683,"Virginia","Manassas city",4,77,142,66,76
050,51,683,"Virginia","Manassas city",4,78,129,58,71
050,51,683,"Virginia","Manassas city",4,79,114,53,61
050,51,683,"Virginia","Manassas city",4,80,114,51,63
050,51,683,"Virginia","Manassas city",4,81,96,41,55
050,51,683,"Virginia","Manassas city",4,82,82,36,46
050,51,683,"Virginia","Manassas city",4,83,72,33,39
050,51,683,"Virginia","Manassas city",4,84,59,19,40
050,51,683,"Virginia","Manassas city",4,85,272,90,182
050,51,683,"Virginia","Manassas city",5,0,684,354,330
050,51,683,"Virginia","Manassas city",5,1,703,371,332
050,51,683,"Virginia","Manassas city",5,2,663,343,320
050,51,683,"Virginia","Manassas city",5,3,646,343,303
050,51,683,"Virginia","Manassas city",5,4,643,325,318
050,51,683,"Virginia","Manassas city",5,5,685,347,338
050,51,683,"Virginia","Manassas city",5,6,653,358,295
050,51,683,"Virginia","Manassas city",5,7,626,322,304
050,51,683,"Virginia","Manassas city",5,8,652,337,315
050,51,683,"Virginia","Manassas city",5,9,611,329,282
050,51,683,"Virginia","Manassas city",5,10,617,332,285
050,51,683,"Virginia","Manassas city",5,11,568,272,296
050,51,683,"Virginia","Manassas city",5,12,574,302,272
050,51,683,"Virginia","Manassas city",5,13,588,308,280
050,51,683,"Virginia","Manassas city",5,14,610,319,291
050,51,683,"Virginia","Manassas city",5,15,614,332,282
050,51,683,"Virginia","Manassas city",5,16,646,341,305
050,51,683,"Virginia","Manassas city",5,17,698,351,347
050,51,683,"Virginia","Manassas city",5,18,563,270,293
050,51,683,"Virginia","Manassas city",5,19,452,202,250
050,51,683,"Virginia","Manassas city",5,20,500,245,255
050,51,683,"Virginia","Manassas city",5,21,481,249,232
050,51,683,"Virginia","Manassas city",5,22,503,262,241
050,51,683,"Virginia","Manassas city",5,23,583,296,287
050,51,683,"Virginia","Manassas city",5,24,561,293,268
050,51,683,"Virginia","Manassas city",5,25,604,321,283
050,51,683,"Virginia","Manassas city",5,26,674,354,320
050,51,683,"Virginia","Manassas city",5,27,591,287,304
050,51,683,"Virginia","Manassas city",5,28,649,324,325
050,51,683,"Virginia","Manassas city",5,29,660,353,307
050,51,683,"Virginia","Manassas city",5,30,674,341,333
050,51,683,"Virginia","Manassas city",5,31,650,326,324
050,51,683,"Virginia","Manassas city",5,32,610,290,320
050,51,683,"Virginia","Manassas city",5,33,685,363,322
050,51,683,"Virginia","Manassas city",5,34,636,312,324
050,51,683,"Virginia","Manassas city",5,35,634,317,317
050,51,683,"Virginia","Manassas city",5,36,637,353,284
050,51,683,"Virginia","Manassas city",5,37,580,326,254
050,51,683,"Virginia","Manassas city",5,38,606,315,291
050,51,683,"Virginia","Manassas city",5,39,608,324,284
050,51,683,"Virginia","Manassas city",5,40,622,353,269
050,51,683,"Virginia","Manassas city",5,41,584,306,278
050,51,683,"Virginia","Manassas city",5,42,640,345,295
050,51,683,"Virginia","Manassas city",5,43,656,349,307
050,51,683,"Virginia","Manassas city",5,44,587,301,286
050,51,683,"Virginia","Manassas city",5,45,585,307,278
050,51,683,"Virginia","Manassas city",5,46,563,299,264
050,51,683,"Virginia","Manassas city",5,47,538,279,259
050,51,683,"Virginia","Manassas city",5,48,547,284,263
050,51,683,"Virginia","Manassas city",5,49,538,286,252
050,51,683,"Virginia","Manassas city",5,50,483,257,226
050,51,683,"Virginia","Manassas city",5,51,531,263,268
050,51,683,"Virginia","Manassas city",5,52,557,299,258
050,51,683,"Virginia","Manassas city",5,53,562,317,245
050,51,683,"Virginia","Manassas city",5,54,507,250,257
050,51,683,"Virginia","Manassas city",5,55,502,267,235
050,51,683,"Virginia","Manassas city",5,56,464,251,213
050,51,683,"Virginia","Manassas city",5,57,482,226,256
050,51,683,"Virginia","Manassas city",5,58,494,252,242
050,51,683,"Virginia","Manassas city",5,59,514,247,267
050,51,683,"Virginia","Manassas city",5,60,521,252,269
050,51,683,"Virginia","Manassas city",5,61,518,235,283
050,51,683,"Virginia","Manassas city",5,62,448,229,219
050,51,683,"Virginia","Manassas city",5,63,437,219,218
050,51,683,"Virginia","Manassas city",5,64,420,196,224
050,51,683,"Virginia","Manassas city",5,65,420,217,203
050,51,683,"Virginia","Manassas city",5,66,423,216,207
050,51,683,"Virginia","Manassas city",5,67,398,177,221
050,51,683,"Virginia","Manassas city",5,68,327,142,185
050,51,683,"Virginia","Manassas city",5,69,315,155,160
050,51,683,"Virginia","Manassas city",5,70,303,163,140
050,51,683,"Virginia","Manassas city",5,71,306,153,153
050,51,683,"Virginia","Manassas city",5,72,254,113,141
050,51,683,"Virginia","Manassas city",5,73,253,113,140
050,51,683,"Virginia","Manassas city",5,74,237,110,127
050,51,683,"Virginia","Manassas city",5,75,225,104,121
050,51,683,"Virginia","Manassas city",5,76,208,93,115
050,51,683,"Virginia","Manassas city",5,77,150,71,79
050,51,683,"Virginia","Manassas city",5,78,135,62,73
050,51,683,"Virginia","Manassas city",5,79,118,51,67
050,51,683,"Virginia","Manassas city",5,80,110,49,61
050,51,683,"Virginia","Manassas city",5,81,99,41,58
050,51,683,"Virginia","Manassas city",5,82,89,38,51
050,51,683,"Virginia","Manassas city",5,83,77,34,43
050,51,683,"Virginia","Manassas city",5,84,65,28,37
050,51,683,"Virginia","Manassas city",5,85,262,78,184
050,51,685,"Virginia","Manassas Park city",1,0,196,100,96
050,51,685,"Virginia","Manassas Park city",1,1,274,130,144
050,51,685,"Virginia","Manassas Park city",1,2,232,126,106
050,51,685,"Virginia","Manassas Park city",1,3,244,116,128
050,51,685,"Virginia","Manassas Park city",1,4,248,105,143
050,51,685,"Virginia","Manassas Park city",1,5,233,121,112
050,51,685,"Virginia","Manassas Park city",1,6,213,120,93
050,51,685,"Virginia","Manassas Park city",1,7,237,148,89
050,51,685,"Virginia","Manassas Park city",1,8,219,115,104
050,51,685,"Virginia","Manassas Park city",1,9,217,104,113
050,51,685,"Virginia","Manassas Park city",1,10,235,130,105
050,51,685,"Virginia","Manassas Park city",1,11,254,140,114
050,51,685,"Virginia","Manassas Park city",1,12,305,153,152
050,51,685,"Virginia","Manassas Park city",1,13,288,141,147
050,51,685,"Virginia","Manassas Park city",1,14,241,130,111
050,51,685,"Virginia","Manassas Park city",1,15,246,127,119
050,51,685,"Virginia","Manassas Park city",1,16,229,105,124
050,51,685,"Virginia","Manassas Park city",1,17,239,116,123
050,51,685,"Virginia","Manassas Park city",1,18,218,115,103
050,51,685,"Virginia","Manassas Park city",1,19,210,115,95
050,51,685,"Virginia","Manassas Park city",1,20,219,128,91
050,51,685,"Virginia","Manassas Park city",1,21,214,111,103
050,51,685,"Virginia","Manassas Park city",1,22,236,120,116
050,51,685,"Virginia","Manassas Park city",1,23,223,122,101
050,51,685,"Virginia","Manassas Park city",1,24,256,134,122
050,51,685,"Virginia","Manassas Park city",1,25,263,145,118
050,51,685,"Virginia","Manassas Park city",1,26,275,142,133
050,51,685,"Virginia","Manassas Park city",1,27,274,130,144
050,51,685,"Virginia","Manassas Park city",1,28,281,147,134
050,51,685,"Virginia","Manassas Park city",1,29,274,146,128
050,51,685,"Virginia","Manassas Park city",1,30,271,138,133
050,51,685,"Virginia","Manassas Park city",1,31,275,131,144
050,51,685,"Virginia","Manassas Park city",1,32,267,135,132
050,51,685,"Virginia","Manassas Park city",1,33,273,152,121
050,51,685,"Virginia","Manassas Park city",1,34,296,159,137
050,51,685,"Virginia","Manassas Park city",1,35,277,140,137
050,51,685,"Virginia","Manassas Park city",1,36,253,130,123
050,51,685,"Virginia","Manassas Park city",1,37,287,139,148
050,51,685,"Virginia","Manassas Park city",1,38,282,144,138
050,51,685,"Virginia","Manassas Park city",1,39,271,145,126
050,51,685,"Virginia","Manassas Park city",1,40,276,151,125
050,51,685,"Virginia","Manassas Park city",1,41,251,133,118
050,51,685,"Virginia","Manassas Park city",1,42,248,134,114
050,51,685,"Virginia","Manassas Park city",1,43,262,144,118
050,51,685,"Virginia","Manassas Park city",1,44,248,137,111
050,51,685,"Virginia","Manassas Park city",1,45,264,148,116
050,51,685,"Virginia","Manassas Park city",1,46,260,147,113
050,51,685,"Virginia","Manassas Park city",1,47,259,142,117
050,51,685,"Virginia","Manassas Park city",1,48,286,153,133
050,51,685,"Virginia","Manassas Park city",1,49,281,154,127
050,51,685,"Virginia","Manassas Park city",1,50,265,139,126
050,51,685,"Virginia","Manassas Park city",1,51,246,123,123
050,51,685,"Virginia","Manassas Park city",1,52,245,116,129
050,51,685,"Virginia","Manassas Park city",1,53,261,148,113
050,51,685,"Virginia","Manassas Park city",1,54,258,140,118
050,51,685,"Virginia","Manassas Park city",1,55,233,120,113
050,51,685,"Virginia","Manassas Park city",1,56,207,96,111
050,51,685,"Virginia","Manassas Park city",1,57,220,109,111
050,51,685,"Virginia","Manassas Park city",1,58,214,118,96
050,51,685,"Virginia","Manassas Park city",1,59,203,110,93
050,51,685,"Virginia","Manassas Park city",1,60,206,110,96
050,51,685,"Virginia","Manassas Park city",1,61,162,80,82
050,51,685,"Virginia","Manassas Park city",1,62,161,77,84
050,51,685,"Virginia","Manassas Park city",1,63,150,81,69
050,51,685,"Virginia","Manassas Park city",1,64,116,64,52
050,51,685,"Virginia","Manassas Park city",1,65,113,57,56
050,51,685,"Virginia","Manassas Park city",1,66,103,60,43
050,51,685,"Virginia","Manassas Park city",1,67,103,52,51
050,51,685,"Virginia","Manassas Park city",1,68,97,51,46
050,51,685,"Virginia","Manassas Park city",1,69,81,40,41
050,51,685,"Virginia","Manassas Park city",1,70,81,37,44
050,51,685,"Virginia","Manassas Park city",1,71,70,38,32
050,51,685,"Virginia","Manassas Park city",1,72,80,36,44
050,51,685,"Virginia","Manassas Park city",1,73,90,38,52
050,51,685,"Virginia","Manassas Park city",1,74,59,25,34
050,51,685,"Virginia","Manassas Park city",1,75,54,22,32
050,51,685,"Virginia","Manassas Park city",1,76,42,16,26
050,51,685,"Virginia","Manassas Park city",1,77,50,20,30
050,51,685,"Virginia","Manassas Park city",1,78,45,16,29
050,51,685,"Virginia","Manassas Park city",1,79,38,18,20
050,51,685,"Virginia","Manassas Park city",1,80,28,13,15
050,51,685,"Virginia","Manassas Park city",1,81,36,14,22
050,51,685,"Virginia","Manassas Park city",1,82,31,13,18
050,51,685,"Virginia","Manassas Park city",1,83,31,15,16
050,51,685,"Virginia","Manassas Park city",1,84,26,7,19
050,51,685,"Virginia","Manassas Park city",1,85,132,50,82
050,51,685,"Virginia","Manassas Park city",2,0,165,80,85
050,51,685,"Virginia","Manassas Park city",2,1,252,123,129
050,51,685,"Virginia","Manassas Park city",2,2,237,123,114
050,51,685,"Virginia","Manassas Park city",2,3,238,116,122
050,51,685,"Virginia","Manassas Park city",2,4,247,107,140
050,51,685,"Virginia","Manassas Park city",2,5,233,117,116
050,51,685,"Virginia","Manassas Park city",2,6,217,121,96
050,51,685,"Virginia","Manassas Park city",2,7,229,141,88
050,51,685,"Virginia","Manassas Park city",2,8,221,122,99
050,51,685,"Virginia","Manassas Park city",2,9,216,106,110
050,51,685,"Virginia","Manassas Park city",2,10,228,124,104
050,51,685,"Virginia","Manassas Park city",2,11,247,136,111
050,51,685,"Virginia","Manassas Park city",2,12,293,148,145
050,51,685,"Virginia","Manassas Park city",2,13,287,140,147
050,51,685,"Virginia","Manassas Park city",2,14,252,133,119
050,51,685,"Virginia","Manassas Park city",2,15,243,126,117
050,51,685,"Virginia","Manassas Park city",2,16,234,111,123
050,51,685,"Virginia","Manassas Park city",2,17,235,112,123
050,51,685,"Virginia","Manassas Park city",2,18,217,114,103
050,51,685,"Virginia","Manassas Park city",2,19,207,113,94
050,51,685,"Virginia","Manassas Park city",2,20,221,125,96
050,51,685,"Virginia","Manassas Park city",2,21,219,117,102
050,51,685,"Virginia","Manassas Park city",2,22,233,118,115
050,51,685,"Virginia","Manassas Park city",2,23,232,123,109
050,51,685,"Virginia","Manassas Park city",2,24,247,131,116
050,51,685,"Virginia","Manassas Park city",2,25,264,142,122
050,51,685,"Virginia","Manassas Park city",2,26,277,143,134
050,51,685,"Virginia","Manassas Park city",2,27,278,136,142
050,51,685,"Virginia","Manassas Park city",2,28,278,144,134
050,51,685,"Virginia","Manassas Park city",2,29,275,145,130
050,51,685,"Virginia","Manassas Park city",2,30,274,141,133
050,51,685,"Virginia","Manassas Park city",2,31,272,132,140
050,51,685,"Virginia","Manassas Park city",2,32,261,131,130
050,51,685,"Virginia","Manassas Park city",2,33,268,146,122
050,51,685,"Virginia","Manassas Park city",2,34,291,157,134
050,51,685,"Virginia","Manassas Park city",2,35,280,143,137
050,51,685,"Virginia","Manassas Park city",2,36,252,129,123
050,51,685,"Virginia","Manassas Park city",2,37,272,134,138
050,51,685,"Virginia","Manassas Park city",2,38,282,144,138
050,51,685,"Virginia","Manassas Park city",2,39,269,143,126
050,51,685,"Virginia","Manassas Park city",2,40,273,149,124
050,51,685,"Virginia","Manassas Park city",2,41,258,139,119
050,51,685,"Virginia","Manassas Park city",2,42,247,135,112
050,51,685,"Virginia","Manassas Park city",2,43,265,145,120
050,51,685,"Virginia","Manassas Park city",2,44,253,141,112
050,51,685,"Virginia","Manassas Park city",2,45,258,145,113
050,51,685,"Virginia","Manassas Park city",2,46,256,144,112
050,51,685,"Virginia","Manassas Park city",2,47,261,143,118
050,51,685,"Virginia","Manassas Park city",2,48,281,151,130
050,51,685,"Virginia","Manassas Park city",2,49,282,153,129
050,51,685,"Virginia","Manassas Park city",2,50,269,142,127
050,51,685,"Virginia","Manassas Park city",2,51,248,125,123
050,51,685,"Virginia","Manassas Park city",2,52,247,118,129
050,51,685,"Virginia","Manassas Park city",2,53,256,141,115
050,51,685,"Virginia","Manassas Park city",2,54,255,140,115
050,51,685,"Virginia","Manassas Park city",2,55,241,126,115
050,51,685,"Virginia","Manassas Park city",2,56,214,102,112
050,51,685,"Virginia","Manassas Park city",2,57,219,107,112
050,51,685,"Virginia","Manassas Park city",2,58,219,116,103
050,51,685,"Virginia","Manassas Park city",2,59,206,113,93
050,51,685,"Virginia","Manassas Park city",2,60,203,109,94
050,51,685,"Virginia","Manassas Park city",2,61,170,85,85
050,51,685,"Virginia","Manassas Park city",2,62,161,79,82
050,51,685,"Virginia","Manassas Park city",2,63,152,81,71
050,51,685,"Virginia","Manassas Park city",2,64,122,66,56
050,51,685,"Virginia","Manassas Park city",2,65,113,58,55
050,51,685,"Virginia","Manassas Park city",2,66,103,58,45
050,51,685,"Virginia","Manassas Park city",2,67,103,54,49
050,51,685,"Virginia","Manassas Park city",2,68,96,48,48
050,51,685,"Virginia","Manassas Park city",2,69,87,43,44
050,51,685,"Virginia","Manassas Park city",2,70,79,37,42
050,51,685,"Virginia","Manassas Park city",2,71,73,38,35
050,51,685,"Virginia","Manassas Park city",2,72,78,36,42
050,51,685,"Virginia","Manassas Park city",2,73,90,38,52
050,51,685,"Virginia","Manassas Park city",2,74,63,27,36
050,51,685,"Virginia","Manassas Park city",2,75,55,23,32
050,51,685,"Virginia","Manassas Park city",2,76,45,17,28
050,51,685,"Virginia","Manassas Park city",2,77,48,19,29
050,51,685,"Virginia","Manassas Park city",2,78,44,15,29
050,51,685,"Virginia","Manassas Park city",2,79,39,18,21
050,51,685,"Virginia","Manassas Park city",2,80,30,14,16
050,51,685,"Virginia","Manassas Park city",2,81,36,15,21
050,51,685,"Virginia","Manassas Park city",2,82,32,13,19
050,51,685,"Virginia","Manassas Park city",2,83,31,14,17
050,51,685,"Virginia","Manassas Park city",2,84,24,7,17
050,51,685,"Virginia","Manassas Park city",2,85,134,50,84
050,51,685,"Virginia","Manassas Park city",3,0,76,38,38
050,51,685,"Virginia","Manassas Park city",3,1,187,81,106
050,51,685,"Virginia","Manassas Park city",3,2,262,117,145
050,51,685,"Virginia","Manassas Park city",3,3,223,112,111
050,51,685,"Virginia","Manassas Park city",3,4,243,120,123
050,51,685,"Virginia","Manassas Park city",3,5,240,114,126
050,51,685,"Virginia","Manassas Park city",3,6,229,113,116
050,51,685,"Virginia","Manassas Park city",3,7,223,125,98
050,51,685,"Virginia","Manassas Park city",3,8,229,133,96
050,51,685,"Virginia","Manassas Park city",3,9,217,117,100
050,51,685,"Virginia","Manassas Park city",3,10,224,114,110
050,51,685,"Virginia","Manassas Park city",3,11,242,126,116
050,51,685,"Virginia","Manassas Park city",3,12,257,141,116
050,51,685,"Virginia","Manassas Park city",3,13,285,145,140
050,51,685,"Virginia","Manassas Park city",3,14,293,141,152
050,51,685,"Virginia","Manassas Park city",3,15,237,132,105
050,51,685,"Virginia","Manassas Park city",3,16,242,126,116
050,51,685,"Virginia","Manassas Park city",3,17,228,110,118
050,51,685,"Virginia","Manassas Park city",3,18,212,106,106
050,51,685,"Virginia","Manassas Park city",3,19,204,100,104
050,51,685,"Virginia","Manassas Park city",3,20,212,115,97
050,51,685,"Virginia","Manassas Park city",3,21,213,119,94
050,51,685,"Virginia","Manassas Park city",3,22,228,117,111
050,51,685,"Virginia","Manassas Park city",3,23,256,129,127
050,51,685,"Virginia","Manassas Park city",3,24,268,144,124
050,51,685,"Virginia","Manassas Park city",3,25,233,119,114
050,51,685,"Virginia","Manassas Park city",3,26,253,130,123
050,51,685,"Virginia","Manassas Park city",3,27,266,136,130
050,51,685,"Virginia","Manassas Park city",3,28,298,143,155
050,51,685,"Virginia","Manassas Park city",3,29,279,144,135
050,51,685,"Virginia","Manassas Park city",3,30,278,147,131
050,51,685,"Virginia","Manassas Park city",3,31,284,159,125
050,51,685,"Virginia","Manassas Park city",3,32,285,152,133
050,51,685,"Virginia","Manassas Park city",3,33,252,132,120
050,51,685,"Virginia","Manassas Park city",3,34,264,145,119
050,51,685,"Virginia","Manassas Park city",3,35,268,147,121
050,51,685,"Virginia","Manassas Park city",3,36,282,142,140
050,51,685,"Virginia","Manassas Park city",3,37,262,130,132
050,51,685,"Virginia","Manassas Park city",3,38,287,145,142
050,51,685,"Virginia","Manassas Park city",3,39,279,151,128
050,51,685,"Virginia","Manassas Park city",3,40,265,144,121
050,51,685,"Virginia","Manassas Park city",3,41,276,146,130
050,51,685,"Virginia","Manassas Park city",3,42,255,140,115
050,51,685,"Virginia","Manassas Park city",3,43,252,143,109
050,51,685,"Virginia","Manassas Park city",3,44,258,141,117
050,51,685,"Virginia","Manassas Park city",3,45,235,126,109
050,51,685,"Virginia","Manassas Park city",3,46,268,150,118
050,51,685,"Virginia","Manassas Park city",3,47,246,136,110
050,51,685,"Virginia","Manassas Park city",3,48,254,137,117
050,51,685,"Virginia","Manassas Park city",3,49,273,149,124
050,51,685,"Virginia","Manassas Park city",3,50,259,142,117
050,51,685,"Virginia","Manassas Park city",3,51,270,143,127
050,51,685,"Virginia","Manassas Park city",3,52,244,120,124
050,51,685,"Virginia","Manassas Park city",3,53,231,110,121
050,51,685,"Virginia","Manassas Park city",3,54,242,138,104
050,51,685,"Virginia","Manassas Park city",3,55,251,138,113
050,51,685,"Virginia","Manassas Park city",3,56,242,130,112
050,51,685,"Virginia","Manassas Park city",3,57,216,103,113
050,51,685,"Virginia","Manassas Park city",3,58,197,93,104
050,51,685,"Virginia","Manassas Park city",3,59,206,111,95
050,51,685,"Virginia","Manassas Park city",3,60,195,105,90
050,51,685,"Virginia","Manassas Park city",3,61,198,104,94
050,51,685,"Virginia","Manassas Park city",3,62,167,80,87
050,51,685,"Virginia","Manassas Park city",3,63,161,85,76
050,51,685,"Virginia","Manassas Park city",3,64,146,82,64
050,51,685,"Virginia","Manassas Park city",3,65,122,67,55
050,51,685,"Virginia","Manassas Park city",3,66,115,58,57
050,51,685,"Virginia","Manassas Park city",3,67,102,57,45
050,51,685,"Virginia","Manassas Park city",3,68,100,52,48
050,51,685,"Virginia","Manassas Park city",3,69,93,47,46
050,51,685,"Virginia","Manassas Park city",3,70,81,38,43
050,51,685,"Virginia","Manassas Park city",3,71,77,36,41
050,51,685,"Virginia","Manassas Park city",3,72,76,38,38
050,51,685,"Virginia","Manassas Park city",3,73,75,33,42
050,51,685,"Virginia","Manassas Park city",3,74,84,36,48
050,51,685,"Virginia","Manassas Park city",3,75,65,27,38
050,51,685,"Virginia","Manassas Park city",3,76,55,22,33
050,51,685,"Virginia","Manassas Park city",3,77,45,17,28
050,51,685,"Virginia","Manassas Park city",3,78,39,15,24
050,51,685,"Virginia","Manassas Park city",3,79,41,15,26
050,51,685,"Virginia","Manassas Park city",3,80,35,15,20
050,51,685,"Virginia","Manassas Park city",3,81,31,15,16
050,51,685,"Virginia","Manassas Park city",3,82,33,14,19
050,51,685,"Virginia","Manassas Park city",3,83,32,13,19
050,51,685,"Virginia","Manassas Park city",3,84,32,13,19
050,51,685,"Virginia","Manassas Park city",3,85,149,56,93
050,51,685,"Virginia","Manassas Park city",4,0,114,47,67
050,51,685,"Virginia","Manassas Park city",4,1,118,58,60
050,51,685,"Virginia","Manassas Park city",4,2,188,90,98
050,51,685,"Virginia","Manassas Park city",4,3,228,110,118
050,51,685,"Virginia","Manassas Park city",4,4,223,118,105
050,51,685,"Virginia","Manassas Park city",4,5,232,114,118
050,51,685,"Virginia","Manassas Park city",4,6,236,109,127
050,51,685,"Virginia","Manassas Park city",4,7,222,114,108
050,51,685,"Virginia","Manassas Park city",4,8,205,121,84
050,51,685,"Virginia","Manassas Park city",4,9,231,127,104
050,51,685,"Virginia","Manassas Park city",4,10,217,123,94
050,51,685,"Virginia","Manassas Park city",4,11,203,95,108
050,51,685,"Virginia","Manassas Park city",4,12,225,114,111
050,51,685,"Virginia","Manassas Park city",4,13,244,135,109
050,51,685,"Virginia","Manassas Park city",4,14,270,136,134
050,51,685,"Virginia","Manassas Park city",4,15,275,134,141
050,51,685,"Virginia","Manassas Park city",4,16,229,129,100
050,51,685,"Virginia","Manassas Park city",4,17,247,128,119
050,51,685,"Virginia","Manassas Park city",4,18,213,111,102
050,51,685,"Virginia","Manassas Park city",4,19,193,94,99
050,51,685,"Virginia","Manassas Park city",4,20,206,104,102
050,51,685,"Virginia","Manassas Park city",4,21,205,100,105
050,51,685,"Virginia","Manassas Park city",4,22,234,123,111
050,51,685,"Virginia","Manassas Park city",4,23,259,127,132
050,51,685,"Virginia","Manassas Park city",4,24,275,138,137
050,51,685,"Virginia","Manassas Park city",4,25,259,131,128
050,51,685,"Virginia","Manassas Park city",4,26,250,127,123
050,51,685,"Virginia","Manassas Park city",4,27,237,122,115
050,51,685,"Virginia","Manassas Park city",4,28,275,150,125
050,51,685,"Virginia","Manassas Park city",4,29,270,127,143
050,51,685,"Virginia","Manassas Park city",4,30,270,138,132
050,51,685,"Virginia","Manassas Park city",4,31,254,133,121
050,51,685,"Virginia","Manassas Park city",4,32,257,141,116
050,51,685,"Virginia","Manassas Park city",4,33,254,124,130
050,51,685,"Virginia","Manassas Park city",4,34,258,144,114
050,51,685,"Virginia","Manassas Park city",4,35,264,147,117
050,51,685,"Virginia","Manassas Park city",4,36,258,129,129
050,51,685,"Virginia","Manassas Park city",4,37,259,128,131
050,51,685,"Virginia","Manassas Park city",4,38,255,128,127
050,51,685,"Virginia","Manassas Park city",4,39,246,126,120
050,51,685,"Virginia","Manassas Park city",4,40,267,138,129
050,51,685,"Virginia","Manassas Park city",4,41,256,136,120
050,51,685,"Virginia","Manassas Park city",4,42,278,146,132
050,51,685,"Virginia","Manassas Park city",4,43,240,136,104
050,51,685,"Virginia","Manassas Park city",4,44,241,139,102
050,51,685,"Virginia","Manassas Park city",4,45,259,140,119
050,51,685,"Virginia","Manassas Park city",4,46,240,129,111
050,51,685,"Virginia","Manassas Park city",4,47,247,131,116
050,51,685,"Virginia","Manassas Park city",4,48,236,131,105
050,51,685,"Virginia","Manassas Park city",4,49,245,134,111
050,51,685,"Virginia","Manassas Park city",4,50,267,147,120
050,51,685,"Virginia","Manassas Park city",4,51,249,134,115
050,51,685,"Virginia","Manassas Park city",4,52,264,135,129
050,51,685,"Virginia","Manassas Park city",4,53,220,106,114
050,51,685,"Virginia","Manassas Park city",4,54,235,113,122
050,51,685,"Virginia","Manassas Park city",4,55,225,120,105
050,51,685,"Virginia","Manassas Park city",4,56,245,137,108
050,51,685,"Virginia","Manassas Park city",4,57,240,127,113
050,51,685,"Virginia","Manassas Park city",4,58,209,99,110
050,51,685,"Virginia","Manassas Park city",4,59,189,90,99
050,51,685,"Virginia","Manassas Park city",4,60,205,110,95
050,51,685,"Virginia","Manassas Park city",4,61,181,96,85
050,51,685,"Virginia","Manassas Park city",4,62,190,107,83
050,51,685,"Virginia","Manassas Park city",4,63,152,75,77
050,51,685,"Virginia","Manassas Park city",4,64,157,82,75
050,51,685,"Virginia","Manassas Park city",4,65,146,80,66
050,51,685,"Virginia","Manassas Park city",4,66,122,69,53
050,51,685,"Virginia","Manassas Park city",4,67,111,47,64
050,51,685,"Virginia","Manassas Park city",4,68,111,65,46
050,51,685,"Virginia","Manassas Park city",4,69,95,47,48
050,51,685,"Virginia","Manassas Park city",4,70,86,42,44
050,51,685,"Virginia","Manassas Park city",4,71,82,39,43
050,51,685,"Virginia","Manassas Park city",4,72,81,38,43
050,51,685,"Virginia","Manassas Park city",4,73,72,37,35
050,51,685,"Virginia","Manassas Park city",4,74,76,34,42
050,51,685,"Virginia","Manassas Park city",4,75,86,36,50
050,51,685,"Virginia","Manassas Park city",4,76,62,24,38
050,51,685,"Virginia","Manassas Park city",4,77,55,25,30
050,51,685,"Virginia","Manassas Park city",4,78,43,16,27
050,51,685,"Virginia","Manassas Park city",4,79,39,17,22
050,51,685,"Virginia","Manassas Park city",4,80,43,16,27
050,51,685,"Virginia","Manassas Park city",4,81,32,12,20
050,51,685,"Virginia","Manassas Park city",4,82,28,15,13
050,51,685,"Virginia","Manassas Park city",4,83,30,13,17
050,51,685,"Virginia","Manassas Park city",4,84,35,12,23
050,51,685,"Virginia","Manassas Park city",4,85,163,57,106
050,51,685,"Virginia","Manassas Park city",5,0,105,44,61
050,51,685,"Virginia","Manassas Park city",5,1,156,67,89
050,51,685,"Virginia","Manassas Park city",5,2,128,70,58
050,51,685,"Virginia","Manassas Park city",5,3,187,89,98
050,51,685,"Virginia","Manassas Park city",5,4,236,118,118
050,51,685,"Virginia","Manassas Park city",5,5,222,109,113
050,51,685,"Virginia","Manassas Park city",5,6,216,107,109
050,51,685,"Virginia","Manassas Park city",5,7,237,111,126
050,51,685,"Virginia","Manassas Park city",5,8,204,106,98
050,51,685,"Virginia","Manassas Park city",5,9,196,111,85
050,51,685,"Virginia","Manassas Park city",5,10,219,124,95
050,51,685,"Virginia","Manassas Park city",5,11,205,114,91
050,51,685,"Virginia","Manassas Park city",5,12,197,95,102
050,51,685,"Virginia","Manassas Park city",5,13,209,107,102
050,51,685,"Virginia","Manassas Park city",5,14,229,121,108
050,51,685,"Virginia","Manassas Park city",5,15,252,130,122
050,51,685,"Virginia","Manassas Park city",5,16,261,131,130
050,51,685,"Virginia","Manassas Park city",5,17,220,130,90
050,51,685,"Virginia","Manassas Park city",5,18,220,117,103
050,51,685,"Virginia","Manassas Park city",5,19,190,99,91
050,51,685,"Virginia","Manassas Park city",5,20,192,93,99
050,51,685,"Virginia","Manassas Park city",5,21,218,112,106
050,51,685,"Virginia","Manassas Park city",5,22,214,106,108
050,51,685,"Virginia","Manassas Park city",5,23,260,122,138
050,51,685,"Virginia","Manassas Park city",5,24,260,133,127
050,51,685,"Virginia","Manassas Park city",5,25,299,153,146
050,51,685,"Virginia","Manassas Park city",5,26,265,128,137
050,51,685,"Virginia","Manassas Park city",5,27,258,133,125
050,51,685,"Virginia","Manassas Park city",5,28,231,128,103
050,51,685,"Virginia","Manassas Park city",5,29,251,134,117
050,51,685,"Virginia","Manassas Park city",5,30,250,117,133
050,51,685,"Virginia","Manassas Park city",5,31,259,128,131
050,51,685,"Virginia","Manassas Park city",5,32,241,127,114
050,51,685,"Virginia","Manassas Park city",5,33,246,138,108
050,51,685,"Virginia","Manassas Park city",5,34,263,132,131
050,51,685,"Virginia","Manassas Park city",5,35,256,148,108
050,51,685,"Virginia","Manassas Park city",5,36,268,148,120
050,51,685,"Virginia","Manassas Park city",5,37,241,122,119
050,51,685,"Virginia","Manassas Park city",5,38,247,125,122
050,51,685,"Virginia","Manassas Park city",5,39,234,120,114
050,51,685,"Virginia","Manassas Park city",5,40,220,116,104
050,51,685,"Virginia","Manassas Park city",5,41,260,137,123
050,51,685,"Virginia","Manassas Park city",5,42,263,143,120
050,51,685,"Virginia","Manassas Park city",5,43,258,135,123
050,51,685,"Virginia","Manassas Park city",5,44,239,138,101
050,51,685,"Virginia","Manassas Park city",5,45,234,132,102
050,51,685,"Virginia","Manassas Park city",5,46,251,134,117
050,51,685,"Virginia","Manassas Park city",5,47,236,125,111
050,51,685,"Virginia","Manassas Park city",5,48,241,125,116
050,51,685,"Virginia","Manassas Park city",5,49,237,131,106
050,51,685,"Virginia","Manassas Park city",5,50,236,133,103
050,51,685,"Virginia","Manassas Park city",5,51,268,154,114
050,51,685,"Virginia","Manassas Park city",5,52,240,133,107
050,51,685,"Virginia","Manassas Park city",5,53,253,129,124
050,51,685,"Virginia","Manassas Park city",5,54,208,101,107
050,51,685,"Virginia","Manassas Park city",5,55,221,111,110
050,51,685,"Virginia","Manassas Park city",5,56,217,116,101
050,51,685,"Virginia","Manassas Park city",5,57,229,128,101
050,51,685,"Virginia","Manassas Park city",5,58,243,129,114
050,51,685,"Virginia","Manassas Park city",5,59,204,100,104
050,51,685,"Virginia","Manassas Park city",5,60,184,86,98
050,51,685,"Virginia","Manassas Park city",5,61,198,110,88
050,51,685,"Virginia","Manassas Park city",5,62,170,91,79
050,51,685,"Virginia","Manassas Park city",5,63,180,97,83
050,51,685,"Virginia","Manassas Park city",5,64,147,70,77
050,51,685,"Virginia","Manassas Park city",5,65,163,83,80
050,51,685,"Virginia","Manassas Park city",5,66,141,78,63
050,51,685,"Virginia","Manassas Park city",5,67,118,64,54
050,51,685,"Virginia","Manassas Park city",5,68,106,46,60
050,51,685,"Virginia","Manassas Park city",5,69,104,63,41
050,51,685,"Virginia","Manassas Park city",5,70,92,48,44
050,51,685,"Virginia","Manassas Park city",5,71,86,42,44
050,51,685,"Virginia","Manassas Park city",5,72,85,41,44
050,51,685,"Virginia","Manassas Park city",5,73,74,34,40
050,51,685,"Virginia","Manassas Park city",5,74,72,37,35
050,51,685,"Virginia","Manassas Park city",5,75,72,32,40
050,51,685,"Virginia","Manassas Park city",5,76,86,37,49
050,51,685,"Virginia","Manassas Park city",5,77,60,24,36
050,51,685,"Virginia","Manassas Park city",5,78,49,24,25
050,51,685,"Virginia","Manassas Park city",5,79,32,9,23
050,51,685,"Virginia","Manassas Park city",5,80,38,16,22
050,51,685,"Virginia","Manassas Park city",5,81,41,13,28
050,51,685,"Virginia","Manassas Park city",5,82,30,12,18
050,51,685,"Virginia","Manassas Park city",5,83,28,16,12
050,51,685,"Virginia","Manassas Park city",5,84,30,13,17
050,51,685,"Virginia","Manassas Park city",5,85,175,59,116
050,51,690,"Virginia","Martinsville city",1,0,190,96,94
050,51,690,"Virginia","Martinsville city",1,1,175,88,87
050,51,690,"Virginia","Martinsville city",1,2,146,75,71
050,51,690,"Virginia","Martinsville city",1,3,175,78,97
050,51,690,"Virginia","Martinsville city",1,4,211,120,91
050,51,690,"Virginia","Martinsville city",1,5,202,103,99
050,51,690,"Virginia","Martinsville city",1,6,185,88,97
050,51,690,"Virginia","Martinsville city",1,7,186,96,90
050,51,690,"Virginia","Martinsville city",1,8,195,103,92
050,51,690,"Virginia","Martinsville city",1,9,193,109,84
050,51,690,"Virginia","Martinsville city",1,10,183,104,79
050,51,690,"Virginia","Martinsville city",1,11,212,112,100
050,51,690,"Virginia","Martinsville city",1,12,224,107,117
050,51,690,"Virginia","Martinsville city",1,13,213,103,110
050,51,690,"Virginia","Martinsville city",1,14,184,98,86
050,51,690,"Virginia","Martinsville city",1,15,190,93,97
050,51,690,"Virginia","Martinsville city",1,16,184,92,92
050,51,690,"Virginia","Martinsville city",1,17,185,109,76
050,51,690,"Virginia","Martinsville city",1,18,145,79,66
050,51,690,"Virginia","Martinsville city",1,19,132,65,67
050,51,690,"Virginia","Martinsville city",1,20,142,73,69
050,51,690,"Virginia","Martinsville city",1,21,146,85,61
050,51,690,"Virginia","Martinsville city",1,22,147,77,70
050,51,690,"Virginia","Martinsville city",1,23,146,73,73
050,51,690,"Virginia","Martinsville city",1,24,148,80,68
050,51,690,"Virginia","Martinsville city",1,25,179,85,94
050,51,690,"Virginia","Martinsville city",1,26,181,81,100
050,51,690,"Virginia","Martinsville city",1,27,161,71,90
050,51,690,"Virginia","Martinsville city",1,28,172,87,85
050,51,690,"Virginia","Martinsville city",1,29,149,66,83
050,51,690,"Virginia","Martinsville city",1,30,161,67,94
050,51,690,"Virginia","Martinsville city",1,31,155,75,80
050,51,690,"Virginia","Martinsville city",1,32,157,86,71
050,51,690,"Virginia","Martinsville city",1,33,155,74,81
050,51,690,"Virginia","Martinsville city",1,34,158,72,86
050,51,690,"Virginia","Martinsville city",1,35,142,72,70
050,51,690,"Virginia","Martinsville city",1,36,142,60,82
050,51,690,"Virginia","Martinsville city",1,37,145,67,78
050,51,690,"Virginia","Martinsville city",1,38,143,66,77
050,51,690,"Virginia","Martinsville city",1,39,141,65,76
050,51,690,"Virginia","Martinsville city",1,40,158,76,82
050,51,690,"Virginia","Martinsville city",1,41,159,81,78
050,51,690,"Virginia","Martinsville city",1,42,165,82,83
050,51,690,"Virginia","Martinsville city",1,43,150,73,77
050,51,690,"Virginia","Martinsville city",1,44,132,66,66
050,51,690,"Virginia","Martinsville city",1,45,122,61,61
050,51,690,"Virginia","Martinsville city",1,46,136,66,70
050,51,690,"Virginia","Martinsville city",1,47,161,63,98
050,51,690,"Virginia","Martinsville city",1,48,152,66,86
050,51,690,"Virginia","Martinsville city",1,49,176,79,97
050,51,690,"Virginia","Martinsville city",1,50,182,97,85
050,51,690,"Virginia","Martinsville city",1,51,165,78,87
050,51,690,"Virginia","Martinsville city",1,52,173,87,86
050,51,690,"Virginia","Martinsville city",1,53,175,86,89
050,51,690,"Virginia","Martinsville city",1,54,196,80,116
050,51,690,"Virginia","Martinsville city",1,55,195,86,109
050,51,690,"Virginia","Martinsville city",1,56,201,92,109
050,51,690,"Virginia","Martinsville city",1,57,193,92,101
050,51,690,"Virginia","Martinsville city",1,58,189,87,102
050,51,690,"Virginia","Martinsville city",1,59,186,85,101
050,51,690,"Virginia","Martinsville city",1,60,193,91,102
050,51,690,"Virginia","Martinsville city",1,61,200,91,109
050,51,690,"Virginia","Martinsville city",1,62,205,97,108
050,51,690,"Virginia","Martinsville city",1,63,192,74,118
050,51,690,"Virginia","Martinsville city",1,64,177,78,99
050,51,690,"Virginia","Martinsville city",1,65,164,69,95
050,51,690,"Virginia","Martinsville city",1,66,173,79,94
050,51,690,"Virginia","Martinsville city",1,67,142,64,78
050,51,690,"Virginia","Martinsville city",1,68,155,77,78
050,51,690,"Virginia","Martinsville city",1,69,134,57,77
050,51,690,"Virginia","Martinsville city",1,70,133,54,79
050,51,690,"Virginia","Martinsville city",1,71,148,66,82
050,51,690,"Virginia","Martinsville city",1,72,146,69,77
050,51,690,"Virginia","Martinsville city",1,73,138,60,78
050,51,690,"Virginia","Martinsville city",1,74,104,46,58
050,51,690,"Virginia","Martinsville city",1,75,90,43,47
050,51,690,"Virginia","Martinsville city",1,76,83,27,56
050,51,690,"Virginia","Martinsville city",1,77,92,31,61
050,51,690,"Virginia","Martinsville city",1,78,77,28,49
050,51,690,"Virginia","Martinsville city",1,79,68,25,43
050,51,690,"Virginia","Martinsville city",1,80,73,23,50
050,51,690,"Virginia","Martinsville city",1,81,63,26,37
050,51,690,"Virginia","Martinsville city",1,82,66,29,37
050,51,690,"Virginia","Martinsville city",1,83,50,19,31
050,51,690,"Virginia","Martinsville city",1,84,48,18,30
050,51,690,"Virginia","Martinsville city",1,85,220,26,194
050,51,690,"Virginia","Martinsville city",2,0,205,111,94
050,51,690,"Virginia","Martinsville city",2,1,179,90,89
050,51,690,"Virginia","Martinsville city",2,2,152,77,75
050,51,690,"Virginia","Martinsville city",2,3,166,77,89
050,51,690,"Virginia","Martinsville city",2,4,201,110,91
050,51,690,"Virginia","Martinsville city",2,5,206,107,99
050,51,690,"Virginia","Martinsville city",2,6,191,92,99
050,51,690,"Virginia","Martinsville city",2,7,182,92,90
050,51,690,"Virginia","Martinsville city",2,8,192,101,91
050,51,690,"Virginia","Martinsville city",2,9,193,107,86
050,51,690,"Virginia","Martinsville city",2,10,183,104,79
050,51,690,"Virginia","Martinsville city",2,11,207,110,97
050,51,690,"Virginia","Martinsville city",2,12,220,109,111
050,51,690,"Virginia","Martinsville city",2,13,213,103,110
050,51,690,"Virginia","Martinsville city",2,14,190,99,91
050,51,690,"Virginia","Martinsville city",2,15,189,94,95
050,51,690,"Virginia","Martinsville city",2,16,185,94,91
050,51,690,"Virginia","Martinsville city",2,17,181,103,78
050,51,690,"Virginia","Martinsville city",2,18,150,83,67
050,51,690,"Virginia","Martinsville city",2,19,131,67,64
050,51,690,"Virginia","Martinsville city",2,20,145,74,71
050,51,690,"Virginia","Martinsville city",2,21,142,80,62
050,51,690,"Virginia","Martinsville city",2,22,146,79,67
050,51,690,"Virginia","Martinsville city",2,23,147,74,73
050,51,690,"Virginia","Martinsville city",2,24,147,78,69
050,51,690,"Virginia","Martinsville city",2,25,172,83,89
050,51,690,"Virginia","Martinsville city",2,26,182,83,99
050,51,690,"Virginia","Martinsville city",2,27,169,76,93
050,51,690,"Virginia","Martinsville city",2,28,169,82,87
050,51,690,"Virginia","Martinsville city",2,29,154,68,86
050,51,690,"Virginia","Martinsville city",2,30,160,68,92
050,51,690,"Virginia","Martinsville city",2,31,154,74,80
050,51,690,"Virginia","Martinsville city",2,32,157,85,72
050,51,690,"Virginia","Martinsville city",2,33,155,77,78
050,51,690,"Virginia","Martinsville city",2,34,154,70,84
050,51,690,"Virginia","Martinsville city",2,35,144,71,73
050,51,690,"Virginia","Martinsville city",2,36,142,62,80
050,51,690,"Virginia","Martinsville city",2,37,146,67,79
050,51,690,"Virginia","Martinsville city",2,38,144,67,77
050,51,690,"Virginia","Martinsville city",2,39,139,63,76
050,51,690,"Virginia","Martinsville city",2,40,157,76,81
050,51,690,"Virginia","Martinsville city",2,41,156,78,78
050,51,690,"Virginia","Martinsville city",2,42,164,81,83
050,51,690,"Virginia","Martinsville city",2,43,156,76,80
050,51,690,"Virginia","Martinsville city",2,44,132,66,66
050,51,690,"Virginia","Martinsville city",2,45,124,61,63
050,51,690,"Virginia","Martinsville city",2,46,133,66,67
050,51,690,"Virginia","Martinsville city",2,47,151,61,90
050,51,690,"Virginia","Martinsville city",2,48,157,67,90
050,51,690,"Virginia","Martinsville city",2,49,170,76,94
050,51,690,"Virginia","Martinsville city",2,50,183,94,89
050,51,690,"Virginia","Martinsville city",2,51,163,79,84
050,51,690,"Virginia","Martinsville city",2,52,173,87,86
050,51,690,"Virginia","Martinsville city",2,53,172,84,88
050,51,690,"Virginia","Martinsville city",2,54,190,80,110
050,51,690,"Virginia","Martinsville city",2,55,198,86,112
050,51,690,"Virginia","Martinsville city",2,56,200,90,110
050,51,690,"Virginia","Martinsville city",2,57,195,93,102
050,51,690,"Virginia","Martinsville city",2,58,191,88,103
050,51,690,"Virginia","Martinsville city",2,59,185,82,103
050,51,690,"Virginia","Martinsville city",2,60,192,91,101
050,51,690,"Virginia","Martinsville city",2,61,198,91,107
050,51,690,"Virginia","Martinsville city",2,62,206,96,110
050,51,690,"Virginia","Martinsville city",2,63,195,78,117
050,51,690,"Virginia","Martinsville city",2,64,181,78,103
050,51,690,"Virginia","Martinsville city",2,65,166,71,95
050,51,690,"Virginia","Martinsville city",2,66,170,76,94
050,51,690,"Virginia","Martinsville city",2,67,148,67,81
050,51,690,"Virginia","Martinsville city",2,68,151,74,77
050,51,690,"Virginia","Martinsville city",2,69,137,61,76
050,51,690,"Virginia","Martinsville city",2,70,135,56,79
050,51,690,"Virginia","Martinsville city",2,71,146,64,82
050,51,690,"Virginia","Martinsville city",2,72,144,68,76
050,51,690,"Virginia","Martinsville city",2,73,144,63,81
050,51,690,"Virginia","Martinsville city",2,74,103,45,58
050,51,690,"Virginia","Martinsville city",2,75,94,43,51
050,51,690,"Virginia","Martinsville city",2,76,86,32,54
050,51,690,"Virginia","Martinsville city",2,77,88,29,59
050,51,690,"Virginia","Martinsville city",2,78,79,30,49
050,51,690,"Virginia","Martinsville city",2,79,66,24,42
050,51,690,"Virginia","Martinsville city",2,80,68,22,46
050,51,690,"Virginia","Martinsville city",2,81,63,26,37
050,51,690,"Virginia","Martinsville city",2,82,64,27,37
050,51,690,"Virginia","Martinsville city",2,83,52,20,32
050,51,690,"Virginia","Martinsville city",2,84,46,18,28
050,51,690,"Virginia","Martinsville city",2,85,218,25,193
050,51,690,"Virginia","Martinsville city",3,0,260,124,136
050,51,690,"Virginia","Martinsville city",3,1,184,108,76
050,51,690,"Virginia","Martinsville city",3,2,185,93,92
050,51,690,"Virginia","Martinsville city",3,3,166,86,80
050,51,690,"Virginia","Martinsville city",3,4,163,74,89
050,51,690,"Virginia","Martinsville city",3,5,211,108,103
050,51,690,"Virginia","Martinsville city",3,6,213,113,100
050,51,690,"Virginia","Martinsville city",3,7,196,92,104
050,51,690,"Virginia","Martinsville city",3,8,200,103,97
050,51,690,"Virginia","Martinsville city",3,9,182,97,85
050,51,690,"Virginia","Martinsville city",3,10,194,110,84
050,51,690,"Virginia","Martinsville city",3,11,188,104,84
050,51,690,"Virginia","Martinsville city",3,12,211,114,97
050,51,690,"Virginia","Martinsville city",3,13,221,107,114
050,51,690,"Virginia","Martinsville city",3,14,217,106,111
050,51,690,"Virginia","Martinsville city",3,15,204,106,98
050,51,690,"Virginia","Martinsville city",3,16,182,89,93
050,51,690,"Virginia","Martinsville city",3,17,195,97,98
050,51,690,"Virginia","Martinsville city",3,18,157,89,68
050,51,690,"Virginia","Martinsville city",3,19,136,68,68
050,51,690,"Virginia","Martinsville city",3,20,125,68,57
050,51,690,"Virginia","Martinsville city",3,21,155,75,80
050,51,690,"Virginia","Martinsville city",3,22,155,80,75
050,51,690,"Virginia","Martinsville city",3,23,156,85,71
050,51,690,"Virginia","Martinsville city",3,24,158,76,82
050,51,690,"Virginia","Martinsville city",3,25,147,74,73
050,51,690,"Virginia","Martinsville city",3,26,169,82,87
050,51,690,"Virginia","Martinsville city",3,27,167,80,87
050,51,690,"Virginia","Martinsville city",3,28,184,84,100
050,51,690,"Virginia","Martinsville city",3,29,179,78,101
050,51,690,"Virginia","Martinsville city",3,30,159,72,87
050,51,690,"Virginia","Martinsville city",3,31,170,78,92
050,51,690,"Virginia","Martinsville city",3,32,154,77,77
050,51,690,"Virginia","Martinsville city",3,33,171,91,80
050,51,690,"Virginia","Martinsville city",3,34,143,71,72
050,51,690,"Virginia","Martinsville city",3,35,160,67,93
050,51,690,"Virginia","Martinsville city",3,36,138,69,69
050,51,690,"Virginia","Martinsville city",3,37,147,66,81
050,51,690,"Virginia","Martinsville city",3,38,151,68,83
050,51,690,"Virginia","Martinsville city",3,39,142,66,76
050,51,690,"Virginia","Martinsville city",3,40,147,67,80
050,51,690,"Virginia","Martinsville city",3,41,153,66,87
050,51,690,"Virginia","Martinsville city",3,42,162,80,82
050,51,690,"Virginia","Martinsville city",3,43,165,85,80
050,51,690,"Virginia","Martinsville city",3,44,146,77,69
050,51,690,"Virginia","Martinsville city",3,45,127,64,63
050,51,690,"Virginia","Martinsville city",3,46,131,62,69
050,51,690,"Virginia","Martinsville city",3,47,140,62,78
050,51,690,"Virginia","Martinsville city",3,48,157,67,90
050,51,690,"Virginia","Martinsville city",3,49,152,67,85
050,51,690,"Virginia","Martinsville city",3,50,177,81,96
050,51,690,"Virginia","Martinsville city",3,51,172,85,87
050,51,690,"Virginia","Martinsville city",3,52,167,90,77
050,51,690,"Virginia","Martinsville city",3,53,171,85,86
050,51,690,"Virginia","Martinsville city",3,54,173,79,94
050,51,690,"Virginia","Martinsville city",3,55,187,84,103
050,51,690,"Virginia","Martinsville city",3,56,196,88,108
050,51,690,"Virginia","Martinsville city",3,57,184,85,99
050,51,690,"Virginia","Martinsville city",3,58,197,93,104
050,51,690,"Virginia","Martinsville city",3,59,183,80,103
050,51,690,"Virginia","Martinsville city",3,60,172,75,97
050,51,690,"Virginia","Martinsville city",3,61,185,85,100
050,51,690,"Virginia","Martinsville city",3,62,194,88,106
050,51,690,"Virginia","Martinsville city",3,63,191,83,108
050,51,690,"Virginia","Martinsville city",3,64,206,85,121
050,51,690,"Virginia","Martinsville city",3,65,162,64,98
050,51,690,"Virginia","Martinsville city",3,66,167,74,93
050,51,690,"Virginia","Martinsville city",3,67,161,72,89
050,51,690,"Virginia","Martinsville city",3,68,149,70,79
050,51,690,"Virginia","Martinsville city",3,69,134,63,71
050,51,690,"Virginia","Martinsville city",3,70,127,56,71
050,51,690,"Virginia","Martinsville city",3,71,130,55,75
050,51,690,"Virginia","Martinsville city",3,72,138,62,76
050,51,690,"Virginia","Martinsville city",3,73,129,61,68
050,51,690,"Virginia","Martinsville city",3,74,126,57,69
050,51,690,"Virginia","Martinsville city",3,75,95,41,54
050,51,690,"Virginia","Martinsville city",3,76,83,37,46
050,51,690,"Virginia","Martinsville city",3,77,75,25,50
050,51,690,"Virginia","Martinsville city",3,78,82,26,56
050,51,690,"Virginia","Martinsville city",3,79,69,26,43
050,51,690,"Virginia","Martinsville city",3,80,64,20,44
050,51,690,"Virginia","Martinsville city",3,81,60,24,36
050,51,690,"Virginia","Martinsville city",3,82,54,20,34
050,51,690,"Virginia","Martinsville city",3,83,55,22,33
050,51,690,"Virginia","Martinsville city",3,84,40,16,24
050,51,690,"Virginia","Martinsville city",3,85,204,25,179
050,51,690,"Virginia","Martinsville city",4,0,264,121,143
050,51,690,"Virginia","Martinsville city",4,1,280,136,144
050,51,690,"Virginia","Martinsville city",4,2,209,118,91
050,51,690,"Virginia","Martinsville city",4,3,189,94,95
050,51,690,"Virginia","Martinsville city",4,4,168,92,76
050,51,690,"Virginia","Martinsville city",4,5,166,74,92
050,51,690,"Virginia","Martinsville city",4,6,219,109,110
050,51,690,"Virginia","Martinsville city",4,7,212,108,104
050,51,690,"Virginia","Martinsville city",4,8,199,99,100
050,51,690,"Virginia","Martinsville city",4,9,200,108,92
050,51,690,"Virginia","Martinsville city",4,10,198,100,98
050,51,690,"Virginia","Martinsville city",4,11,212,121,91
050,51,690,"Virginia","Martinsville city",4,12,186,102,84
050,51,690,"Virginia","Martinsville city",4,13,214,117,97
050,51,690,"Virginia","Martinsville city",4,14,207,108,99
050,51,690,"Virginia","Martinsville city",4,15,215,107,108
050,51,690,"Virginia","Martinsville city",4,16,194,98,96
050,51,690,"Virginia","Martinsville city",4,17,187,92,95
050,51,690,"Virginia","Martinsville city",4,18,170,90,80
050,51,690,"Virginia","Martinsville city",4,19,142,78,64
050,51,690,"Virginia","Martinsville city",4,20,149,75,74
050,51,690,"Virginia","Martinsville city",4,21,130,68,62
050,51,690,"Virginia","Martinsville city",4,22,166,81,85
050,51,690,"Virginia","Martinsville city",4,23,142,76,66
050,51,690,"Virginia","Martinsville city",4,24,157,79,78
050,51,690,"Virginia","Martinsville city",4,25,166,83,83
050,51,690,"Virginia","Martinsville city",4,26,147,78,69
050,51,690,"Virginia","Martinsville city",4,27,166,82,84
050,51,690,"Virginia","Martinsville city",4,28,179,84,95
050,51,690,"Virginia","Martinsville city",4,29,207,94,113
050,51,690,"Virginia","Martinsville city",4,30,180,75,105
050,51,690,"Virginia","Martinsville city",4,31,158,72,86
050,51,690,"Virginia","Martinsville city",4,32,172,81,91
050,51,690,"Virginia","Martinsville city",4,33,153,73,80
050,51,690,"Virginia","Martinsville city",4,34,176,92,84
050,51,690,"Virginia","Martinsville city",4,35,146,72,74
050,51,690,"Virginia","Martinsville city",4,36,164,68,96
050,51,690,"Virginia","Martinsville city",4,37,145,71,74
050,51,690,"Virginia","Martinsville city",4,38,148,71,77
050,51,690,"Virginia","Martinsville city",4,39,150,65,85
050,51,690,"Virginia","Martinsville city",4,40,147,66,81
050,51,690,"Virginia","Martinsville city",4,41,147,68,79
050,51,690,"Virginia","Martinsville city",4,42,168,74,94
050,51,690,"Virginia","Martinsville city",4,43,181,94,87
050,51,690,"Virginia","Martinsville city",4,44,152,75,77
050,51,690,"Virginia","Martinsville city",4,45,148,73,75
050,51,690,"Virginia","Martinsville city",4,46,132,75,57
050,51,690,"Virginia","Martinsville city",4,47,130,58,72
050,51,690,"Virginia","Martinsville city",4,48,143,70,73
050,51,690,"Virginia","Martinsville city",4,49,148,63,85
050,51,690,"Virginia","Martinsville city",4,50,158,79,79
050,51,690,"Virginia","Martinsville city",4,51,167,72,95
050,51,690,"Virginia","Martinsville city",4,52,176,89,87
050,51,690,"Virginia","Martinsville city",4,53,161,85,76
050,51,690,"Virginia","Martinsville city",4,54,172,81,91
050,51,690,"Virginia","Martinsville city",4,55,168,80,88
050,51,690,"Virginia","Martinsville city",4,56,190,86,104
050,51,690,"Virginia","Martinsville city",4,57,195,90,105
050,51,690,"Virginia","Martinsville city",4,58,187,81,106
050,51,690,"Virginia","Martinsville city",4,59,193,91,102
050,51,690,"Virginia","Martinsville city",4,60,180,80,100
050,51,690,"Virginia","Martinsville city",4,61,171,76,95
050,51,690,"Virginia","Martinsville city",4,62,179,87,92
050,51,690,"Virginia","Martinsville city",4,63,184,81,103
050,51,690,"Virginia","Martinsville city",4,64,193,93,100
050,51,690,"Virginia","Martinsville city",4,65,179,69,110
050,51,690,"Virginia","Martinsville city",4,66,163,69,94
050,51,690,"Virginia","Martinsville city",4,67,161,68,93
050,51,690,"Virginia","Martinsville city",4,68,156,69,87
050,51,690,"Virginia","Martinsville city",4,69,141,64,77
050,51,690,"Virginia","Martinsville city",4,70,128,62,66
050,51,690,"Virginia","Martinsville city",4,71,122,54,68
050,51,690,"Virginia","Martinsville city",4,72,120,51,69
050,51,690,"Virginia","Martinsville city",4,73,131,56,75
050,51,690,"Virginia","Martinsville city",4,74,114,55,59
050,51,690,"Virginia","Martinsville city",4,75,115,51,64
050,51,690,"Virginia","Martinsville city",4,76,88,37,51
050,51,690,"Virginia","Martinsville city",4,77,78,33,45
050,51,690,"Virginia","Martinsville city",4,78,76,28,48
050,51,690,"Virginia","Martinsville city",4,79,73,23,50
050,51,690,"Virginia","Martinsville city",4,80,64,23,41
050,51,690,"Virginia","Martinsville city",4,81,58,23,35
050,51,690,"Virginia","Martinsville city",4,82,51,19,32
050,51,690,"Virginia","Martinsville city",4,83,48,15,33
050,51,690,"Virginia","Martinsville city",4,84,46,17,29
050,51,690,"Virginia","Martinsville city",4,85,183,25,158
050,51,690,"Virginia","Martinsville city",5,0,263,120,143
050,51,690,"Virginia","Martinsville city",5,1,255,121,134
050,51,690,"Virginia","Martinsville city",5,2,274,129,145
050,51,690,"Virginia","Martinsville city",5,3,200,116,84
050,51,690,"Virginia","Martinsville city",5,4,191,95,96
050,51,690,"Virginia","Martinsville city",5,5,164,90,74
050,51,690,"Virginia","Martinsville city",5,6,179,77,102
050,51,690,"Virginia","Martinsville city",5,7,213,103,110
050,51,690,"Virginia","Martinsville city",5,8,215,111,104
050,51,690,"Virginia","Martinsville city",5,9,198,95,103
050,51,690,"Virginia","Martinsville city",5,10,200,107,93
050,51,690,"Virginia","Martinsville city",5,11,193,98,95
050,51,690,"Virginia","Martinsville city",5,12,200,111,89
050,51,690,"Virginia","Martinsville city",5,13,196,111,85
050,51,690,"Virginia","Martinsville city",5,14,228,129,99
050,51,690,"Virginia","Martinsville city",5,15,216,117,99
050,51,690,"Virginia","Martinsville city",5,16,236,120,116
050,51,690,"Virginia","Martinsville city",5,17,196,106,90
050,51,690,"Virginia","Martinsville city",5,18,161,81,80
050,51,690,"Virginia","Martinsville city",5,19,145,74,71
050,51,690,"Virginia","Martinsville city",5,20,161,88,73
050,51,690,"Virginia","Martinsville city",5,21,163,82,81
050,51,690,"Virginia","Martinsville city",5,22,138,73,65
050,51,690,"Virginia","Martinsville city",5,23,165,83,82
050,51,690,"Virginia","Martinsville city",5,24,156,78,78
050,51,690,"Virginia","Martinsville city",5,25,158,77,81
050,51,690,"Virginia","Martinsville city",5,26,162,78,84
050,51,690,"Virginia","Martinsville city",5,27,149,77,72
050,51,690,"Virginia","Martinsville city",5,28,163,79,84
050,51,690,"Virginia","Martinsville city",5,29,187,85,102
050,51,690,"Virginia","Martinsville city",5,30,196,88,108
050,51,690,"Virginia","Martinsville city",5,31,160,61,99
050,51,690,"Virginia","Martinsville city",5,32,152,71,81
050,51,690,"Virginia","Martinsville city",5,33,174,86,88
050,51,690,"Virginia","Martinsville city",5,34,147,72,75
050,51,690,"Virginia","Martinsville city",5,35,174,89,85
050,51,690,"Virginia","Martinsville city",5,36,147,69,78
050,51,690,"Virginia","Martinsville city",5,37,160,69,91
050,51,690,"Virginia","Martinsville city",5,38,147,78,69
050,51,690,"Virginia","Martinsville city",5,39,145,64,81
050,51,690,"Virginia","Martinsville city",5,40,151,63,88
050,51,690,"Virginia","Martinsville city",5,41,151,70,81
050,51,690,"Virginia","Martinsville city",5,42,164,74,90
050,51,690,"Virginia","Martinsville city",5,43,176,81,95
050,51,690,"Virginia","Martinsville city",5,44,168,85,83
050,51,690,"Virginia","Martinsville city",5,45,153,72,81
050,51,690,"Virginia","Martinsville city",5,46,151,75,76
050,51,690,"Virginia","Martinsville city",5,47,136,72,64
050,51,690,"Virginia","Martinsville city",5,48,139,62,77
050,51,690,"Virginia","Martinsville city",5,49,138,69,69
050,51,690,"Virginia","Martinsville city",5,50,153,65,88
050,51,690,"Virginia","Martinsville city",5,51,158,80,78
050,51,690,"Virginia","Martinsville city",5,52,168,80,88
050,51,690,"Virginia","Martinsville city",5,53,181,90,91
050,51,690,"Virginia","Martinsville city",5,54,152,71,81
050,51,690,"Virginia","Martinsville city",5,55,175,82,93
050,51,690,"Virginia","Martinsville city",5,56,177,85,92
050,51,690,"Virginia","Martinsville city",5,57,182,79,103
050,51,690,"Virginia","Martinsville city",5,58,192,85,107
050,51,690,"Virginia","Martinsville city",5,59,185,80,105
050,51,690,"Virginia","Martinsville city",5,60,190,88,102
050,51,690,"Virginia","Martinsville city",5,61,184,78,106
050,51,690,"Virginia","Martinsville city",5,62,179,86,93
050,51,690,"Virginia","Martinsville city",5,63,175,85,90
050,51,690,"Virginia","Martinsville city",5,64,178,85,93
050,51,690,"Virginia","Martinsville city",5,65,171,77,94
050,51,690,"Virginia","Martinsville city",5,66,183,74,109
050,51,690,"Virginia","Martinsville city",5,67,151,63,88
050,51,690,"Virginia","Martinsville city",5,68,161,70,91
050,51,690,"Virginia","Martinsville city",5,69,143,61,82
050,51,690,"Virginia","Martinsville city",5,70,139,63,76
050,51,690,"Virginia","Martinsville city",5,71,119,60,59
050,51,690,"Virginia","Martinsville city",5,72,117,52,65
050,51,690,"Virginia","Martinsville city",5,73,111,47,64
050,51,690,"Virginia","Martinsville city",5,74,122,50,72
050,51,690,"Virginia","Martinsville city",5,75,94,45,49
050,51,690,"Virginia","Martinsville city",5,76,110,49,61
050,51,690,"Virginia","Martinsville city",5,77,82,34,48
050,51,690,"Virginia","Martinsville city",5,78,77,35,42
050,51,690,"Virginia","Martinsville city",5,79,70,25,45
050,51,690,"Virginia","Martinsville city",5,80,69,21,48
050,51,690,"Virginia","Martinsville city",5,81,53,23,30
050,51,690,"Virginia","Martinsville city",5,82,48,16,32
050,51,690,"Virginia","Martinsville city",5,83,44,14,30
050,51,690,"Virginia","Martinsville city",5,84,40,12,28
050,51,690,"Virginia","Martinsville city",5,85,176,26,150
050,51,700,"Virginia","Newport News city",1,0,2698,1367,1331
050,51,700,"Virginia","Newport News city",1,1,2616,1330,1286
050,51,700,"Virginia","Newport News city",1,2,2702,1363,1339
050,51,700,"Virginia","Newport News city",1,3,2624,1378,1246
050,51,700,"Virginia","Newport News city",1,4,2722,1415,1307
050,51,700,"Virginia","Newport News city",1,5,2585,1320,1265
050,51,700,"Virginia","Newport News city",1,6,2437,1241,1196
050,51,700,"Virginia","Newport News city",1,7,2445,1246,1199
050,51,700,"Virginia","Newport News city",1,8,2380,1214,1166
050,51,700,"Virginia","Newport News city",1,9,2362,1215,1147
050,51,700,"Virginia","Newport News city",1,10,2337,1176,1161
050,51,700,"Virginia","Newport News city",1,11,2361,1182,1179
050,51,700,"Virginia","Newport News city",1,12,2359,1206,1153
050,51,700,"Virginia","Newport News city",1,13,2320,1224,1096
050,51,700,"Virginia","Newport News city",1,14,2276,1197,1079
050,51,700,"Virginia","Newport News city",1,15,2172,1123,1049
050,51,700,"Virginia","Newport News city",1,16,2141,1094,1047
050,51,700,"Virginia","Newport News city",1,17,2123,1105,1018
050,51,700,"Virginia","Newport News city",1,18,2727,1410,1317
050,51,700,"Virginia","Newport News city",1,19,3504,1854,1650
050,51,700,"Virginia","Newport News city",1,20,3301,1757,1544
050,51,700,"Virginia","Newport News city",1,21,3073,1597,1476
050,51,700,"Virginia","Newport News city",1,22,2864,1521,1343
050,51,700,"Virginia","Newport News city",1,23,2965,1576,1389
050,51,700,"Virginia","Newport News city",1,24,3065,1635,1430
050,51,700,"Virginia","Newport News city",1,25,3128,1648,1480
050,51,700,"Virginia","Newport News city",1,26,3134,1615,1519
050,51,700,"Virginia","Newport News city",1,27,3277,1696,1581
050,51,700,"Virginia","Newport News city",1,28,3288,1658,1630
050,51,700,"Virginia","Newport News city",1,29,3407,1684,1723
050,51,700,"Virginia","Newport News city",1,30,3256,1594,1662
050,51,700,"Virginia","Newport News city",1,31,3152,1553,1599
050,51,700,"Virginia","Newport News city",1,32,3041,1483,1558
050,51,700,"Virginia","Newport News city",1,33,2993,1437,1556
050,51,700,"Virginia","Newport News city",1,34,2893,1482,1411
050,51,700,"Virginia","Newport News city",1,35,2691,1327,1364
050,51,700,"Virginia","Newport News city",1,36,2714,1351,1363
050,51,700,"Virginia","Newport News city",1,37,2659,1302,1357
050,51,700,"Virginia","Newport News city",1,38,2508,1245,1263
050,51,700,"Virginia","Newport News city",1,39,2363,1189,1174
050,51,700,"Virginia","Newport News city",1,40,2301,1143,1158
050,51,700,"Virginia","Newport News city",1,41,2205,1086,1119
050,51,700,"Virginia","Newport News city",1,42,2200,1049,1151
050,51,700,"Virginia","Newport News city",1,43,2015,931,1084
050,51,700,"Virginia","Newport News city",1,44,1783,852,931
050,51,700,"Virginia","Newport News city",1,45,1783,864,919
050,51,700,"Virginia","Newport News city",1,46,1835,867,968
050,51,700,"Virginia","Newport News city",1,47,1789,836,953
050,51,700,"Virginia","Newport News city",1,48,1964,909,1055
050,51,700,"Virginia","Newport News city",1,49,2083,984,1099
050,51,700,"Virginia","Newport News city",1,50,1946,902,1044
050,51,700,"Virginia","Newport News city",1,51,1871,875,996
050,51,700,"Virginia","Newport News city",1,52,1901,900,1001
050,51,700,"Virginia","Newport News city",1,53,1972,907,1065
050,51,700,"Virginia","Newport News city",1,54,2107,988,1119
050,51,700,"Virginia","Newport News city",1,55,2214,1020,1194
050,51,700,"Virginia","Newport News city",1,56,2382,1130,1252
050,51,700,"Virginia","Newport News city",1,57,2339,1095,1244
050,51,700,"Virginia","Newport News city",1,58,2350,1122,1228
050,51,700,"Virginia","Newport News city",1,59,2331,1107,1224
050,51,700,"Virginia","Newport News city",1,60,2257,1050,1207
050,51,700,"Virginia","Newport News city",1,61,2300,1077,1223
050,51,700,"Virginia","Newport News city",1,62,2185,1028,1157
050,51,700,"Virginia","Newport News city",1,63,2039,974,1065
050,51,700,"Virginia","Newport News city",1,64,2005,933,1072
050,51,700,"Virginia","Newport News city",1,65,1858,856,1002
050,51,700,"Virginia","Newport News city",1,66,1761,765,996
050,51,700,"Virginia","Newport News city",1,67,1620,722,898
050,51,700,"Virginia","Newport News city",1,68,1491,652,839
050,51,700,"Virginia","Newport News city",1,69,1459,617,842
050,51,700,"Virginia","Newport News city",1,70,1415,597,818
050,51,700,"Virginia","Newport News city",1,71,1329,577,752
050,51,700,"Virginia","Newport News city",1,72,1359,605,754
050,51,700,"Virginia","Newport News city",1,73,1276,571,705
050,51,700,"Virginia","Newport News city",1,74,957,405,552
050,51,700,"Virginia","Newport News city",1,75,949,400,549
050,51,700,"Virginia","Newport News city",1,76,980,410,570
050,51,700,"Virginia","Newport News city",1,77,944,384,560
050,51,700,"Virginia","Newport News city",1,78,793,317,476
050,51,700,"Virginia","Newport News city",1,79,685,284,401
050,51,700,"Virginia","Newport News city",1,80,617,234,383
050,51,700,"Virginia","Newport News city",1,81,603,228,375
050,51,700,"Virginia","Newport News city",1,82,610,246,364
050,51,700,"Virginia","Newport News city",1,83,526,191,335
050,51,700,"Virginia","Newport News city",1,84,457,148,309
050,51,700,"Virginia","Newport News city",1,85,2736,858,1878
050,51,700,"Virginia","Newport News city",2,0,2651,1359,1292
050,51,700,"Virginia","Newport News city",2,1,2617,1329,1288
050,51,700,"Virginia","Newport News city",2,2,2664,1351,1313
050,51,700,"Virginia","Newport News city",2,3,2619,1364,1255
050,51,700,"Virginia","Newport News city",2,4,2675,1391,1284
050,51,700,"Virginia","Newport News city",2,5,2602,1330,1272
050,51,700,"Virginia","Newport News city",2,6,2464,1251,1213
050,51,700,"Virginia","Newport News city",2,7,2429,1230,1199
050,51,700,"Virginia","Newport News city",2,8,2378,1212,1166
050,51,700,"Virginia","Newport News city",2,9,2361,1211,1150
050,51,700,"Virginia","Newport News city",2,10,2325,1174,1151
050,51,700,"Virginia","Newport News city",2,11,2327,1161,1166
050,51,700,"Virginia","Newport News city",2,12,2357,1201,1156
050,51,700,"Virginia","Newport News city",2,13,2324,1220,1104
050,51,700,"Virginia","Newport News city",2,14,2280,1205,1075
050,51,700,"Virginia","Newport News city",2,15,2198,1143,1055
050,51,700,"Virginia","Newport News city",2,16,2149,1106,1043
050,51,700,"Virginia","Newport News city",2,17,2127,1101,1026
050,51,700,"Virginia","Newport News city",2,18,2734,1420,1314
050,51,700,"Virginia","Newport News city",2,19,3481,1841,1640
050,51,700,"Virginia","Newport News city",2,20,3337,1773,1564
050,51,700,"Virginia","Newport News city",2,21,3060,1591,1469
050,51,700,"Virginia","Newport News city",2,22,2897,1550,1347
050,51,700,"Virginia","Newport News city",2,23,2946,1567,1379
050,51,700,"Virginia","Newport News city",2,24,3010,1594,1416
050,51,700,"Virginia","Newport News city",2,25,3093,1628,1465
050,51,700,"Virginia","Newport News city",2,26,3121,1619,1502
050,51,700,"Virginia","Newport News city",2,27,3216,1658,1558
050,51,700,"Virginia","Newport News city",2,28,3293,1672,1621
050,51,700,"Virginia","Newport News city",2,29,3369,1670,1699
050,51,700,"Virginia","Newport News city",2,30,3280,1607,1673
050,51,700,"Virginia","Newport News city",2,31,3145,1542,1603
050,51,700,"Virginia","Newport News city",2,32,3054,1497,1557
050,51,700,"Virginia","Newport News city",2,33,2975,1433,1542
050,51,700,"Virginia","Newport News city",2,34,2884,1455,1429
050,51,700,"Virginia","Newport News city",2,35,2729,1357,1372
050,51,700,"Virginia","Newport News city",2,36,2679,1334,1345
050,51,700,"Virginia","Newport News city",2,37,2653,1306,1347
050,51,700,"Virginia","Newport News city",2,38,2534,1255,1279
050,51,700,"Virginia","Newport News city",2,39,2373,1190,1183
050,51,700,"Virginia","Newport News city",2,40,2327,1158,1169
050,51,700,"Virginia","Newport News city",2,41,2219,1089,1130
050,51,700,"Virginia","Newport News city",2,42,2182,1042,1140
050,51,700,"Virginia","Newport News city",2,43,2058,954,1104
050,51,700,"Virginia","Newport News city",2,44,1813,857,956
050,51,700,"Virginia","Newport News city",2,45,1785,859,926
050,51,700,"Virginia","Newport News city",2,46,1805,859,946
050,51,700,"Virginia","Newport News city",2,47,1791,839,952
050,51,700,"Virginia","Newport News city",2,48,1921,893,1028
050,51,700,"Virginia","Newport News city",2,49,2049,963,1086
050,51,700,"Virginia","Newport News city",2,50,1973,918,1055
050,51,700,"Virginia","Newport News city",2,51,1877,876,1001
050,51,700,"Virginia","Newport News city",2,52,1894,898,996
050,51,700,"Virginia","Newport News city",2,53,1946,897,1049
050,51,700,"Virginia","Newport News city",2,54,2066,962,1104
050,51,700,"Virginia","Newport News city",2,55,2184,1010,1174
050,51,700,"Virginia","Newport News city",2,56,2344,1105,1239
050,51,700,"Virginia","Newport News city",2,57,2346,1103,1243
050,51,700,"Virginia","Newport News city",2,58,2340,1109,1231
050,51,700,"Virginia","Newport News city",2,59,2326,1103,1223
050,51,700,"Virginia","Newport News city",2,60,2264,1059,1205
050,51,700,"Virginia","Newport News city",2,61,2275,1061,1214
050,51,700,"Virginia","Newport News city",2,62,2191,1027,1164
050,51,700,"Virginia","Newport News city",2,63,2090,993,1097
050,51,700,"Virginia","Newport News city",2,64,1994,934,1060
050,51,700,"Virginia","Newport News city",2,65,1868,856,1012
050,51,700,"Virginia","Newport News city",2,66,1775,778,997
050,51,700,"Virginia","Newport News city",2,67,1638,724,914
050,51,700,"Virginia","Newport News city",2,68,1503,657,846
050,51,700,"Virginia","Newport News city",2,69,1463,625,838
050,51,700,"Virginia","Newport News city",2,70,1409,598,811
050,51,700,"Virginia","Newport News city",2,71,1343,576,767
050,51,700,"Virginia","Newport News city",2,72,1332,591,741
050,51,700,"Virginia","Newport News city",2,73,1344,598,746
050,51,700,"Virginia","Newport News city",2,74,973,415,558
050,51,700,"Virginia","Newport News city",2,75,944,397,547
050,51,700,"Virginia","Newport News city",2,76,959,400,559
050,51,700,"Virginia","Newport News city",2,77,958,390,568
050,51,700,"Virginia","Newport News city",2,78,809,327,482
050,51,700,"Virginia","Newport News city",2,79,699,283,416
050,51,700,"Virginia","Newport News city",2,80,624,242,382
050,51,700,"Virginia","Newport News city",2,81,592,223,369
050,51,700,"Virginia","Newport News city",2,82,602,239,363
050,51,700,"Virginia","Newport News city",2,83,531,195,336
050,51,700,"Virginia","Newport News city",2,84,460,151,309
050,51,700,"Virginia","Newport News city",2,85,2751,868,1883
050,51,700,"Virginia","Newport News city",3,0,2550,1357,1193
050,51,700,"Virginia","Newport News city",3,1,2642,1318,1324
050,51,700,"Virginia","Newport News city",3,2,2522,1233,1289
050,51,700,"Virginia","Newport News city",3,3,2582,1320,1262
050,51,700,"Virginia","Newport News city",3,4,2499,1282,1217
050,51,700,"Virginia","Newport News city",3,5,2617,1348,1269
050,51,700,"Virginia","Newport News city",3,6,2468,1269,1199
050,51,700,"Virginia","Newport News city",3,7,2455,1266,1189
050,51,700,"Virginia","Newport News city",3,8,2314,1171,1143
050,51,700,"Virginia","Newport News city",3,9,2350,1209,1141
050,51,700,"Virginia","Newport News city",3,10,2301,1190,1111
050,51,700,"Virginia","Newport News city",3,11,2260,1129,1131
050,51,700,"Virginia","Newport News city",3,12,2276,1158,1118
050,51,700,"Virginia","Newport News city",3,13,2339,1206,1133
050,51,700,"Virginia","Newport News city",3,14,2308,1203,1105
050,51,700,"Virginia","Newport News city",3,15,2269,1199,1070
050,51,700,"Virginia","Newport News city",3,16,2209,1142,1067
050,51,700,"Virginia","Newport News city",3,17,2107,1083,1024
050,51,700,"Virginia","Newport News city",3,18,2696,1381,1315
050,51,700,"Virginia","Newport News city",3,19,3410,1818,1592
050,51,700,"Virginia","Newport News city",3,20,3265,1729,1536
050,51,700,"Virginia","Newport News city",3,21,3078,1600,1478
050,51,700,"Virginia","Newport News city",3,22,2977,1605,1372
050,51,700,"Virginia","Newport News city",3,23,2952,1586,1366
050,51,700,"Virginia","Newport News city",3,24,2885,1483,1402
050,51,700,"Virginia","Newport News city",3,25,2884,1515,1369
050,51,700,"Virginia","Newport News city",3,26,3042,1572,1470
050,51,700,"Virginia","Newport News city",3,27,3090,1588,1502
050,51,700,"Virginia","Newport News city",3,28,3141,1605,1536
050,51,700,"Virginia","Newport News city",3,29,3257,1646,1611
050,51,700,"Virginia","Newport News city",3,30,3220,1589,1631
050,51,700,"Virginia","Newport News city",3,31,3071,1528,1543
050,51,700,"Virginia","Newport News city",3,32,3043,1502,1541
050,51,700,"Virginia","Newport News city",3,33,2968,1423,1545
050,51,700,"Virginia","Newport News city",3,34,2845,1351,1494
050,51,700,"Virginia","Newport News city",3,35,2773,1377,1396
050,51,700,"Virginia","Newport News city",3,36,2716,1378,1338
050,51,700,"Virginia","Newport News city",3,37,2628,1296,1332
050,51,700,"Virginia","Newport News city",3,38,2524,1237,1287
050,51,700,"Virginia","Newport News city",3,39,2437,1221,1216
050,51,700,"Virginia","Newport News city",3,40,2300,1148,1152
050,51,700,"Virginia","Newport News city",3,41,2212,1068,1144
050,51,700,"Virginia","Newport News city",3,42,2164,1033,1131
050,51,700,"Virginia","Newport News city",3,43,2107,1006,1101
050,51,700,"Virginia","Newport News city",3,44,2030,927,1103
050,51,700,"Virginia","Newport News city",3,45,1765,813,952
050,51,700,"Virginia","Newport News city",3,46,1743,839,904
050,51,700,"Virginia","Newport News city",3,47,1773,845,928
050,51,700,"Virginia","Newport News city",3,48,1774,816,958
050,51,700,"Virginia","Newport News city",3,49,1907,886,1021
050,51,700,"Virginia","Newport News city",3,50,2042,937,1105
050,51,700,"Virginia","Newport News city",3,51,1995,926,1069
050,51,700,"Virginia","Newport News city",3,52,1879,871,1008
050,51,700,"Virginia","Newport News city",3,53,1892,883,1009
050,51,700,"Virginia","Newport News city",3,54,1930,879,1051
050,51,700,"Virginia","Newport News city",3,55,2028,938,1090
050,51,700,"Virginia","Newport News city",3,56,2163,988,1175
050,51,700,"Virginia","Newport News city",3,57,2289,1076,1213
050,51,700,"Virginia","Newport News city",3,58,2281,1057,1224
050,51,700,"Virginia","Newport News city",3,59,2329,1101,1228
050,51,700,"Virginia","Newport News city",3,60,2278,1090,1188
050,51,700,"Virginia","Newport News city",3,61,2219,1046,1173
050,51,700,"Virginia","Newport News city",3,62,2205,1024,1181
050,51,700,"Virginia","Newport News city",3,63,2158,1016,1142
050,51,700,"Virginia","Newport News city",3,64,2037,961,1076
050,51,700,"Virginia","Newport News city",3,65,1948,913,1035
050,51,700,"Virginia","Newport News city",3,66,1848,834,1014
050,51,700,"Virginia","Newport News city",3,67,1736,754,982
050,51,700,"Virginia","Newport News city",3,68,1584,690,894
050,51,700,"Virginia","Newport News city",3,69,1454,635,819
050,51,700,"Virginia","Newport News city",3,70,1424,602,822
050,51,700,"Virginia","Newport News city",3,71,1352,560,792
050,51,700,"Virginia","Newport News city",3,72,1308,569,739
050,51,700,"Virginia","Newport News city",3,73,1292,570,722
050,51,700,"Virginia","Newport News city",3,74,1306,579,727
050,51,700,"Virginia","Newport News city",3,75,946,384,562
050,51,700,"Virginia","Newport News city",3,76,907,374,533
050,51,700,"Virginia","Newport News city",3,77,909,389,520
050,51,700,"Virginia","Newport News city",3,78,914,373,541
050,51,700,"Virginia","Newport News city",3,79,753,294,459
050,51,700,"Virginia","Newport News city",3,80,645,257,388
050,51,700,"Virginia","Newport News city",3,81,598,222,376
050,51,700,"Virginia","Newport News city",3,82,539,201,338
050,51,700,"Virginia","Newport News city",3,83,553,219,334
050,51,700,"Virginia","Newport News city",3,84,491,179,312
050,51,700,"Virginia","Newport News city",3,85,2714,839,1875
050,51,700,"Virginia","Newport News city",4,0,2494,1316,1178
050,51,700,"Virginia","Newport News city",4,1,2468,1310,1158
050,51,700,"Virginia","Newport News city",4,2,2612,1326,1286
050,51,700,"Virginia","Newport News city",4,3,2462,1207,1255
050,51,700,"Virginia","Newport News city",4,4,2527,1309,1218
050,51,700,"Virginia","Newport News city",4,5,2437,1272,1165
050,51,700,"Virginia","Newport News city",4,6,2531,1292,1239
050,51,700,"Virginia","Newport News city",4,7,2454,1240,1214
050,51,700,"Virginia","Newport News city",4,8,2375,1222,1153
050,51,700,"Virginia","Newport News city",4,9,2239,1148,1091
050,51,700,"Virginia","Newport News city",4,10,2318,1187,1131
050,51,700,"Virginia","Newport News city",4,11,2287,1191,1096
050,51,700,"Virginia","Newport News city",4,12,2257,1123,1134
050,51,700,"Virginia","Newport News city",4,13,2239,1124,1115
050,51,700,"Virginia","Newport News city",4,14,2330,1197,1133
050,51,700,"Virginia","Newport News city",4,15,2294,1203,1091
050,51,700,"Virginia","Newport News city",4,16,2236,1182,1054
050,51,700,"Virginia","Newport News city",4,17,2195,1111,1084
050,51,700,"Virginia","Newport News city",4,18,2667,1386,1281
050,51,700,"Virginia","Newport News city",4,19,3332,1785,1547
050,51,700,"Virginia","Newport News city",4,20,3179,1675,1504
050,51,700,"Virginia","Newport News city",4,21,3094,1624,1470
050,51,700,"Virginia","Newport News city",4,22,3029,1672,1357
050,51,700,"Virginia","Newport News city",4,23,3024,1600,1424
050,51,700,"Virginia","Newport News city",4,24,2969,1586,1383
050,51,700,"Virginia","Newport News city",4,25,2840,1470,1370
050,51,700,"Virginia","Newport News city",4,26,2849,1504,1345
050,51,700,"Virginia","Newport News city",4,27,2988,1502,1486
050,51,700,"Virginia","Newport News city",4,28,3086,1579,1507
050,51,700,"Virginia","Newport News city",4,29,3176,1606,1570
050,51,700,"Virginia","Newport News city",4,30,3049,1565,1484
050,51,700,"Virginia","Newport News city",4,31,3128,1510,1618
050,51,700,"Virginia","Newport News city",4,32,3051,1532,1519
050,51,700,"Virginia","Newport News city",4,33,2928,1443,1485
050,51,700,"Virginia","Newport News city",4,34,2905,1395,1510
050,51,700,"Virginia","Newport News city",4,35,2732,1280,1452
050,51,700,"Virginia","Newport News city",4,36,2678,1355,1323
050,51,700,"Virginia","Newport News city",4,37,2693,1325,1368
050,51,700,"Virginia","Newport News city",4,38,2538,1221,1317
050,51,700,"Virginia","Newport News city",4,39,2488,1212,1276
050,51,700,"Virginia","Newport News city",4,40,2415,1203,1212
050,51,700,"Virginia","Newport News city",4,41,2232,1116,1116
050,51,700,"Virginia","Newport News city",4,42,2167,1049,1118
050,51,700,"Virginia","Newport News city",4,43,2079,959,1120
050,51,700,"Virginia","Newport News city",4,44,2028,954,1074
050,51,700,"Virginia","Newport News city",4,45,1988,891,1097
050,51,700,"Virginia","Newport News city",4,46,1754,806,948
050,51,700,"Virginia","Newport News city",4,47,1737,825,912
050,51,700,"Virginia","Newport News city",4,48,1756,822,934
050,51,700,"Virginia","Newport News city",4,49,1752,800,952
050,51,700,"Virginia","Newport News city",4,50,1894,893,1001
050,51,700,"Virginia","Newport News city",4,51,2020,920,1100
050,51,700,"Virginia","Newport News city",4,52,1962,918,1044
050,51,700,"Virginia","Newport News city",4,53,1852,854,998
050,51,700,"Virginia","Newport News city",4,54,1840,847,993
050,51,700,"Virginia","Newport News city",4,55,1907,854,1053
050,51,700,"Virginia","Newport News city",4,56,2001,928,1073
050,51,700,"Virginia","Newport News city",4,57,2159,974,1185
050,51,700,"Virginia","Newport News city",4,58,2268,1069,1199
050,51,700,"Virginia","Newport News city",4,59,2240,1048,1192
050,51,700,"Virginia","Newport News city",4,60,2240,1047,1193
050,51,700,"Virginia","Newport News city",4,61,2217,1052,1165
050,51,700,"Virginia","Newport News city",4,62,2145,1011,1134
050,51,700,"Virginia","Newport News city",4,63,2172,1024,1148
050,51,700,"Virginia","Newport News city",4,64,2107,977,1130
050,51,700,"Virginia","Newport News city",4,65,1948,922,1026
050,51,700,"Virginia","Newport News city",4,66,1889,883,1006
050,51,700,"Virginia","Newport News city",4,67,1809,809,1000
050,51,700,"Virginia","Newport News city",4,68,1689,728,961
050,51,700,"Virginia","Newport News city",4,69,1533,670,863
050,51,700,"Virginia","Newport News city",4,70,1417,623,794
050,51,700,"Virginia","Newport News city",4,71,1383,585,798
050,51,700,"Virginia","Newport News city",4,72,1316,555,761
050,51,700,"Virginia","Newport News city",4,73,1255,532,723
050,51,700,"Virginia","Newport News city",4,74,1276,563,713
050,51,700,"Virginia","Newport News city",4,75,1247,546,701
050,51,700,"Virginia","Newport News city",4,76,915,363,552
050,51,700,"Virginia","Newport News city",4,77,866,357,509
050,51,700,"Virginia","Newport News city",4,78,865,367,498
050,51,700,"Virginia","Newport News city",4,79,848,338,510
050,51,700,"Virginia","Newport News city",4,80,714,277,437
050,51,700,"Virginia","Newport News city",4,81,607,231,376
050,51,700,"Virginia","Newport News city",4,82,550,208,342
050,51,700,"Virginia","Newport News city",4,83,499,178,321
050,51,700,"Virginia","Newport News city",4,84,513,197,316
050,51,700,"Virginia","Newport News city",4,85,2731,854,1877
050,51,700,"Virginia","Newport News city",5,0,2471,1310,1161
050,51,700,"Virginia","Newport News city",5,1,2478,1297,1181
050,51,700,"Virginia","Newport News city",5,2,2488,1324,1164
050,51,700,"Virginia","Newport News city",5,3,2476,1247,1229
050,51,700,"Virginia","Newport News city",5,4,2459,1205,1254
050,51,700,"Virginia","Newport News city",5,5,2450,1259,1191
050,51,700,"Virginia","Newport News city",5,6,2388,1236,1152
050,51,700,"Virginia","Newport News city",5,7,2483,1258,1225
050,51,700,"Virginia","Newport News city",5,8,2400,1190,1210
050,51,700,"Virginia","Newport News city",5,9,2340,1191,1149
050,51,700,"Virginia","Newport News city",5,10,2198,1136,1062
050,51,700,"Virginia","Newport News city",5,11,2294,1168,1126
050,51,700,"Virginia","Newport News city",5,12,2287,1192,1095
050,51,700,"Virginia","Newport News city",5,13,2240,1111,1129
050,51,700,"Virginia","Newport News city",5,14,2173,1092,1081
050,51,700,"Virginia","Newport News city",5,15,2295,1197,1098
050,51,700,"Virginia","Newport News city",5,16,2271,1174,1097
050,51,700,"Virginia","Newport News city",5,17,2211,1167,1044
050,51,700,"Virginia","Newport News city",5,18,2754,1437,1317
050,51,700,"Virginia","Newport News city",5,19,3297,1752,1545
050,51,700,"Virginia","Newport News city",5,20,3112,1676,1436
050,51,700,"Virginia","Newport News city",5,21,2955,1527,1428
050,51,700,"Virginia","Newport News city",5,22,3015,1659,1356
050,51,700,"Virginia","Newport News city",5,23,3002,1625,1377
050,51,700,"Virginia","Newport News city",5,24,2956,1554,1402
050,51,700,"Virginia","Newport News city",5,25,2936,1544,1392
050,51,700,"Virginia","Newport News city",5,26,2813,1431,1382
050,51,700,"Virginia","Newport News city",5,27,2779,1433,1346
050,51,700,"Virginia","Newport News city",5,28,2939,1479,1460
050,51,700,"Virginia","Newport News city",5,29,2978,1560,1418
050,51,700,"Virginia","Newport News city",5,30,3026,1539,1487
050,51,700,"Virginia","Newport News city",5,31,2956,1514,1442
050,51,700,"Virginia","Newport News city",5,32,3077,1482,1595
050,51,700,"Virginia","Newport News city",5,33,2943,1400,1543
050,51,700,"Virginia","Newport News city",5,34,2930,1443,1487
050,51,700,"Virginia","Newport News city",5,35,2839,1356,1483
050,51,700,"Virginia","Newport News city",5,36,2686,1281,1405
050,51,700,"Virginia","Newport News city",5,37,2572,1286,1286
050,51,700,"Virginia","Newport News city",5,38,2627,1272,1355
050,51,700,"Virginia","Newport News city",5,39,2484,1205,1279
050,51,700,"Virginia","Newport News city",5,40,2422,1178,1244
050,51,700,"Virginia","Newport News city",5,41,2418,1184,1234
050,51,700,"Virginia","Newport News city",5,42,2183,1092,1091
050,51,700,"Virginia","Newport News city",5,43,2121,1014,1107
050,51,700,"Virginia","Newport News city",5,44,2041,959,1082
050,51,700,"Virginia","Newport News city",5,45,2013,936,1077
050,51,700,"Virginia","Newport News city",5,46,1918,863,1055
050,51,700,"Virginia","Newport News city",5,47,1744,780,964
050,51,700,"Virginia","Newport News city",5,48,1711,809,902
050,51,700,"Virginia","Newport News city",5,49,1714,801,913
050,51,700,"Virginia","Newport News city",5,50,1713,781,932
050,51,700,"Virginia","Newport News city",5,51,1852,860,992
050,51,700,"Virginia","Newport News city",5,52,2020,913,1107
050,51,700,"Virginia","Newport News city",5,53,1937,865,1072
050,51,700,"Virginia","Newport News city",5,54,1841,845,996
050,51,700,"Virginia","Newport News city",5,55,1796,814,982
050,51,700,"Virginia","Newport News city",5,56,1881,826,1055
050,51,700,"Virginia","Newport News city",5,57,1990,914,1076
050,51,700,"Virginia","Newport News city",5,58,2120,949,1171
050,51,700,"Virginia","Newport News city",5,59,2251,1068,1183
050,51,700,"Virginia","Newport News city",5,60,2204,1028,1176
050,51,700,"Virginia","Newport News city",5,61,2188,1019,1169
050,51,700,"Virginia","Newport News city",5,62,2161,1026,1135
050,51,700,"Virginia","Newport News city",5,63,2079,990,1089
050,51,700,"Virginia","Newport News city",5,64,2122,1004,1118
050,51,700,"Virginia","Newport News city",5,65,2046,944,1102
050,51,700,"Virginia","Newport News city",5,66,1920,912,1008
050,51,700,"Virginia","Newport News city",5,67,1836,841,995
050,51,700,"Virginia","Newport News city",5,68,1758,788,970
050,51,700,"Virginia","Newport News city",5,69,1645,708,937
050,51,700,"Virginia","Newport News city",5,70,1506,652,854
050,51,700,"Virginia","Newport News city",5,71,1364,598,766
050,51,700,"Virginia","Newport News city",5,72,1344,571,773
050,51,700,"Virginia","Newport News city",5,73,1269,525,744
050,51,700,"Virginia","Newport News city",5,74,1220,522,698
050,51,700,"Virginia","Newport News city",5,75,1211,531,680
050,51,700,"Virginia","Newport News city",5,76,1204,521,683
050,51,700,"Virginia","Newport News city",5,77,875,349,526
050,51,700,"Virginia","Newport News city",5,78,824,338,486
050,51,700,"Virginia","Newport News city",5,79,805,332,473
050,51,700,"Virginia","Newport News city",5,80,795,313,482
050,51,700,"Virginia","Newport News city",5,81,684,256,428
050,51,700,"Virginia","Newport News city",5,82,559,219,340
050,51,700,"Virginia","Newport News city",5,83,502,184,318
050,51,700,"Virginia","Newport News city",5,84,451,153,298
050,51,700,"Virginia","Newport News city",5,85,2782,876,1906
050,51,710,"Virginia","Norfolk city",1,0,3400,1740,1660
050,51,710,"Virginia","Norfolk city",1,1,3296,1729,1567
050,51,710,"Virginia","Norfolk city",1,2,3191,1612,1579
050,51,710,"Virginia","Norfolk city",1,3,3092,1572,1520
050,51,710,"Virginia","Norfolk city",1,4,3117,1565,1552
050,51,710,"Virginia","Norfolk city",1,5,2938,1501,1437
050,51,710,"Virginia","Norfolk city",1,6,2805,1383,1422
050,51,710,"Virginia","Norfolk city",1,7,2699,1375,1324
050,51,710,"Virginia","Norfolk city",1,8,2746,1412,1334
050,51,710,"Virginia","Norfolk city",1,9,2666,1380,1286
050,51,710,"Virginia","Norfolk city",1,10,2598,1305,1293
050,51,710,"Virginia","Norfolk city",1,11,2644,1363,1281
050,51,710,"Virginia","Norfolk city",1,12,2627,1338,1289
050,51,710,"Virginia","Norfolk city",1,13,2450,1234,1216
050,51,710,"Virginia","Norfolk city",1,14,2361,1205,1156
050,51,710,"Virginia","Norfolk city",1,15,2288,1151,1137
050,51,710,"Virginia","Norfolk city",1,16,2248,1137,1111
050,51,710,"Virginia","Norfolk city",1,17,2238,1111,1127
050,51,710,"Virginia","Norfolk city",1,18,3453,1734,1719
050,51,710,"Virginia","Norfolk city",1,19,4910,2697,2213
050,51,710,"Virginia","Norfolk city",1,20,5506,3224,2282
050,51,710,"Virginia","Norfolk city",1,21,5773,3450,2323
050,51,710,"Virginia","Norfolk city",1,22,5519,3282,2237
050,51,710,"Virginia","Norfolk city",1,23,5302,3118,2184
050,51,710,"Virginia","Norfolk city",1,24,5324,3110,2214
050,51,710,"Virginia","Norfolk city",1,25,5137,2868,2269
050,51,710,"Virginia","Norfolk city",1,26,5078,2757,2321
050,51,710,"Virginia","Norfolk city",1,27,5054,2689,2365
050,51,710,"Virginia","Norfolk city",1,28,4914,2610,2304
050,51,710,"Virginia","Norfolk city",1,29,4641,2480,2161
050,51,710,"Virginia","Norfolk city",1,30,4501,2338,2163
050,51,710,"Virginia","Norfolk city",1,31,4306,2260,2046
050,51,710,"Virginia","Norfolk city",1,32,4110,2203,1907
050,51,710,"Virginia","Norfolk city",1,33,3875,2053,1822
050,51,710,"Virginia","Norfolk city",1,34,3676,1907,1769
050,51,710,"Virginia","Norfolk city",1,35,3506,1845,1661
050,51,710,"Virginia","Norfolk city",1,36,3370,1781,1589
050,51,710,"Virginia","Norfolk city",1,37,3293,1753,1540
050,51,710,"Virginia","Norfolk city",1,38,3104,1613,1491
050,51,710,"Virginia","Norfolk city",1,39,2980,1518,1462
050,51,710,"Virginia","Norfolk city",1,40,2769,1399,1370
050,51,710,"Virginia","Norfolk city",1,41,2589,1322,1267
050,51,710,"Virginia","Norfolk city",1,42,2515,1271,1244
050,51,710,"Virginia","Norfolk city",1,43,2433,1195,1238
050,51,710,"Virginia","Norfolk city",1,44,2311,1153,1158
050,51,710,"Virginia","Norfolk city",1,45,2199,1099,1100
050,51,710,"Virginia","Norfolk city",1,46,2106,1042,1064
050,51,710,"Virginia","Norfolk city",1,47,2252,1114,1138
050,51,710,"Virginia","Norfolk city",1,48,2341,1155,1186
050,51,710,"Virginia","Norfolk city",1,49,2424,1140,1284
050,51,710,"Virginia","Norfolk city",1,50,2335,1113,1222
050,51,710,"Virginia","Norfolk city",1,51,2396,1152,1244
050,51,710,"Virginia","Norfolk city",1,52,2354,1129,1225
050,51,710,"Virginia","Norfolk city",1,53,2313,1083,1230
050,51,710,"Virginia","Norfolk city",1,54,2440,1188,1252
050,51,710,"Virginia","Norfolk city",1,55,2630,1267,1363
050,51,710,"Virginia","Norfolk city",1,56,2718,1286,1432
050,51,710,"Virginia","Norfolk city",1,57,2670,1275,1395
050,51,710,"Virginia","Norfolk city",1,58,2764,1315,1449
050,51,710,"Virginia","Norfolk city",1,59,2843,1346,1497
050,51,710,"Virginia","Norfolk city",1,60,2744,1276,1468
050,51,710,"Virginia","Norfolk city",1,61,2766,1320,1446
050,51,710,"Virginia","Norfolk city",1,62,2711,1270,1441
050,51,710,"Virginia","Norfolk city",1,63,2548,1205,1343
050,51,710,"Virginia","Norfolk city",1,64,2492,1154,1338
050,51,710,"Virginia","Norfolk city",1,65,2372,1114,1258
050,51,710,"Virginia","Norfolk city",1,66,2226,1033,1193
050,51,710,"Virginia","Norfolk city",1,67,2101,946,1155
050,51,710,"Virginia","Norfolk city",1,68,1985,890,1095
050,51,710,"Virginia","Norfolk city",1,69,1709,751,958
050,51,710,"Virginia","Norfolk city",1,70,1719,770,949
050,51,710,"Virginia","Norfolk city",1,71,1656,763,893
050,51,710,"Virginia","Norfolk city",1,72,1601,715,886
050,51,710,"Virginia","Norfolk city",1,73,1519,679,840
050,51,710,"Virginia","Norfolk city",1,74,1106,486,620
050,51,710,"Virginia","Norfolk city",1,75,1103,468,635
050,51,710,"Virginia","Norfolk city",1,76,1025,427,598
050,51,710,"Virginia","Norfolk city",1,77,988,423,565
050,51,710,"Virginia","Norfolk city",1,78,801,342,459
050,51,710,"Virginia","Norfolk city",1,79,724,288,436
050,51,710,"Virginia","Norfolk city",1,80,702,274,428
050,51,710,"Virginia","Norfolk city",1,81,655,255,400
050,51,710,"Virginia","Norfolk city",1,82,569,224,345
050,51,710,"Virginia","Norfolk city",1,83,524,203,321
050,51,710,"Virginia","Norfolk city",1,84,472,178,294
050,51,710,"Virginia","Norfolk city",1,85,3047,1008,2039
050,51,710,"Virginia","Norfolk city",2,0,3303,1693,1610
050,51,710,"Virginia","Norfolk city",2,1,3276,1705,1571
050,51,710,"Virginia","Norfolk city",2,2,3177,1624,1553
050,51,710,"Virginia","Norfolk city",2,3,3071,1563,1508
050,51,710,"Virginia","Norfolk city",2,4,3081,1553,1528
050,51,710,"Virginia","Norfolk city",2,5,2961,1500,1461
050,51,710,"Virginia","Norfolk city",2,6,2810,1400,1410
050,51,710,"Virginia","Norfolk city",2,7,2700,1365,1335
050,51,710,"Virginia","Norfolk city",2,8,2713,1391,1322
050,51,710,"Virginia","Norfolk city",2,9,2659,1375,1284
050,51,710,"Virginia","Norfolk city",2,10,2588,1316,1272
050,51,710,"Virginia","Norfolk city",2,11,2598,1331,1267
050,51,710,"Virginia","Norfolk city",2,12,2621,1336,1285
050,51,710,"Virginia","Norfolk city",2,13,2483,1254,1229
050,51,710,"Virginia","Norfolk city",2,14,2368,1201,1167
050,51,710,"Virginia","Norfolk city",2,15,2296,1160,1136
050,51,710,"Virginia","Norfolk city",2,16,2259,1138,1121
050,51,710,"Virginia","Norfolk city",2,17,2249,1123,1126
050,51,710,"Virginia","Norfolk city",2,18,3469,1739,1730
050,51,710,"Virginia","Norfolk city",2,19,4927,2711,2216
050,51,710,"Virginia","Norfolk city",2,20,5524,3223,2301
050,51,710,"Virginia","Norfolk city",2,21,5742,3427,2315
050,51,710,"Virginia","Norfolk city",2,22,5523,3290,2233
050,51,710,"Virginia","Norfolk city",2,23,5275,3096,2179
050,51,710,"Virginia","Norfolk city",2,24,5254,3067,2187
050,51,710,"Virginia","Norfolk city",2,25,5113,2864,2249
050,51,710,"Virginia","Norfolk city",2,26,5057,2757,2300
050,51,710,"Virginia","Norfolk city",2,27,5022,2684,2338
050,51,710,"Virginia","Norfolk city",2,28,4885,2596,2289
050,51,710,"Virginia","Norfolk city",2,29,4640,2471,2169
050,51,710,"Virginia","Norfolk city",2,30,4519,2364,2155
050,51,710,"Virginia","Norfolk city",2,31,4312,2260,2052
050,51,710,"Virginia","Norfolk city",2,32,4108,2195,1913
050,51,710,"Virginia","Norfolk city",2,33,3886,2063,1823
050,51,710,"Virginia","Norfolk city",2,34,3691,1920,1771
050,51,710,"Virginia","Norfolk city",2,35,3533,1851,1682
050,51,710,"Virginia","Norfolk city",2,36,3362,1782,1580
050,51,710,"Virginia","Norfolk city",2,37,3292,1744,1548
050,51,710,"Virginia","Norfolk city",2,38,3145,1639,1506
050,51,710,"Virginia","Norfolk city",2,39,2968,1517,1451
050,51,710,"Virginia","Norfolk city",2,40,2823,1426,1397
050,51,710,"Virginia","Norfolk city",2,41,2630,1339,1291
050,51,710,"Virginia","Norfolk city",2,42,2498,1264,1234
050,51,710,"Virginia","Norfolk city",2,43,2463,1216,1247
050,51,710,"Virginia","Norfolk city",2,44,2310,1150,1160
050,51,710,"Virginia","Norfolk city",2,45,2213,1101,1112
050,51,710,"Virginia","Norfolk city",2,46,2110,1042,1068
050,51,710,"Virginia","Norfolk city",2,47,2221,1101,1120
050,51,710,"Virginia","Norfolk city",2,48,2312,1135,1177
050,51,710,"Virginia","Norfolk city",2,49,2408,1149,1259
050,51,710,"Virginia","Norfolk city",2,50,2355,1117,1238
050,51,710,"Virginia","Norfolk city",2,51,2360,1137,1223
050,51,710,"Virginia","Norfolk city",2,52,2357,1128,1229
050,51,710,"Virginia","Norfolk city",2,53,2315,1089,1226
050,51,710,"Virginia","Norfolk city",2,54,2401,1158,1243
050,51,710,"Virginia","Norfolk city",2,55,2574,1239,1335
050,51,710,"Virginia","Norfolk city",2,56,2688,1278,1410
050,51,710,"Virginia","Norfolk city",2,57,2669,1270,1399
050,51,710,"Virginia","Norfolk city",2,58,2726,1295,1431
050,51,710,"Virginia","Norfolk city",2,59,2810,1329,1481
050,51,710,"Virginia","Norfolk city",2,60,2759,1280,1479
050,51,710,"Virginia","Norfolk city",2,61,2753,1305,1448
050,51,710,"Virginia","Norfolk city",2,62,2696,1264,1432
050,51,710,"Virginia","Norfolk city",2,63,2597,1219,1378
050,51,710,"Virginia","Norfolk city",2,64,2469,1149,1320
050,51,710,"Virginia","Norfolk city",2,65,2376,1114,1262
050,51,710,"Virginia","Norfolk city",2,66,2244,1045,1199
050,51,710,"Virginia","Norfolk city",2,67,2117,961,1156
050,51,710,"Virginia","Norfolk city",2,68,1988,889,1099
050,51,710,"Virginia","Norfolk city",2,69,1775,783,992
050,51,710,"Virginia","Norfolk city",2,70,1698,759,939
050,51,710,"Virginia","Norfolk city",2,71,1655,755,900
050,51,710,"Virginia","Norfolk city",2,72,1587,713,874
050,51,710,"Virginia","Norfolk city",2,73,1586,708,878
050,51,710,"Virginia","Norfolk city",2,74,1136,498,638
050,51,710,"Virginia","Norfolk city",2,75,1100,469,631
050,51,710,"Virginia","Norfolk city",2,76,1031,431,600
050,51,710,"Virginia","Norfolk city",2,77,998,421,577
050,51,710,"Virginia","Norfolk city",2,78,826,351,475
050,51,710,"Virginia","Norfolk city",2,79,739,298,441
050,51,710,"Virginia","Norfolk city",2,80,701,274,427
050,51,710,"Virginia","Norfolk city",2,81,654,254,400
050,51,710,"Virginia","Norfolk city",2,82,585,228,357
050,51,710,"Virginia","Norfolk city",2,83,515,200,315
050,51,710,"Virginia","Norfolk city",2,84,471,176,295
050,51,710,"Virginia","Norfolk city",2,85,3030,994,2036
050,51,710,"Virginia","Norfolk city",3,0,3073,1578,1495
050,51,710,"Virginia","Norfolk city",3,1,3061,1542,1519
050,51,710,"Virginia","Norfolk city",3,2,3138,1620,1518
050,51,710,"Virginia","Norfolk city",3,3,2995,1529,1466
050,51,710,"Virginia","Norfolk city",3,4,2931,1492,1439
050,51,710,"Virginia","Norfolk city",3,5,2887,1456,1431
050,51,710,"Virginia","Norfolk city",3,6,2780,1433,1347
050,51,710,"Virginia","Norfolk city",3,7,2622,1313,1309
050,51,710,"Virginia","Norfolk city",3,8,2546,1271,1275
050,51,710,"Virginia","Norfolk city",3,9,2587,1354,1233
050,51,710,"Virginia","Norfolk city",3,10,2513,1301,1212
050,51,710,"Virginia","Norfolk city",3,11,2502,1289,1213
050,51,710,"Virginia","Norfolk city",3,12,2531,1305,1226
050,51,710,"Virginia","Norfolk city",3,13,2575,1293,1282
050,51,710,"Virginia","Norfolk city",3,14,2436,1208,1228
050,51,710,"Virginia","Norfolk city",3,15,2293,1144,1149
050,51,710,"Virginia","Norfolk city",3,16,2236,1134,1102
050,51,710,"Virginia","Norfolk city",3,17,2206,1098,1108
050,51,710,"Virginia","Norfolk city",3,18,3422,1707,1715
050,51,710,"Virginia","Norfolk city",3,19,4865,2664,2201
050,51,710,"Virginia","Norfolk city",3,20,5424,3170,2254
050,51,710,"Virginia","Norfolk city",3,21,5638,3375,2263
050,51,710,"Virginia","Norfolk city",3,22,5461,3241,2220
050,51,710,"Virginia","Norfolk city",3,23,5090,2991,2099
050,51,710,"Virginia","Norfolk city",3,24,5088,2975,2113
050,51,710,"Virginia","Norfolk city",3,25,4907,2789,2118
050,51,710,"Virginia","Norfolk city",3,26,4831,2604,2227
050,51,710,"Virginia","Norfolk city",3,27,4858,2676,2182
050,51,710,"Virginia","Norfolk city",3,28,4772,2535,2237
050,51,710,"Virginia","Norfolk city",3,29,4596,2442,2154
050,51,710,"Virginia","Norfolk city",3,30,4537,2415,2122
050,51,710,"Virginia","Norfolk city",3,31,4347,2286,2061
050,51,710,"Virginia","Norfolk city",3,32,4056,2137,1919
050,51,710,"Virginia","Norfolk city",3,33,3910,2098,1812
050,51,710,"Virginia","Norfolk city",3,34,3745,1966,1779
050,51,710,"Virginia","Norfolk city",3,35,3513,1857,1656
050,51,710,"Virginia","Norfolk city",3,36,3424,1805,1619
050,51,710,"Virginia","Norfolk city",3,37,3154,1664,1490
050,51,710,"Virginia","Norfolk city",3,38,3127,1634,1493
050,51,710,"Virginia","Norfolk city",3,39,3025,1519,1506
050,51,710,"Virginia","Norfolk city",3,40,2774,1369,1405
050,51,710,"Virginia","Norfolk city",3,41,2761,1388,1373
050,51,710,"Virginia","Norfolk city",3,42,2536,1280,1256
050,51,710,"Virginia","Norfolk city",3,43,2452,1231,1221
050,51,710,"Virginia","Norfolk city",3,44,2365,1168,1197
050,51,710,"Virginia","Norfolk city",3,45,2205,1103,1102
050,51,710,"Virginia","Norfolk city",3,46,2160,1045,1115
050,51,710,"Virginia","Norfolk city",3,47,2120,1046,1074
050,51,710,"Virginia","Norfolk city",3,48,2154,1065,1089
050,51,710,"Virginia","Norfolk city",3,49,2270,1116,1154
050,51,710,"Virginia","Norfolk city",3,50,2319,1096,1223
050,51,710,"Virginia","Norfolk city",3,51,2335,1122,1213
050,51,710,"Virginia","Norfolk city",3,52,2324,1126,1198
050,51,710,"Virginia","Norfolk city",3,53,2323,1084,1239
050,51,710,"Virginia","Norfolk city",3,54,2296,1079,1217
050,51,710,"Virginia","Norfolk city",3,55,2392,1149,1243
050,51,710,"Virginia","Norfolk city",3,56,2584,1241,1343
050,51,710,"Virginia","Norfolk city",3,57,2634,1231,1403
050,51,710,"Virginia","Norfolk city",3,58,2645,1249,1396
050,51,710,"Virginia","Norfolk city",3,59,2695,1291,1404
050,51,710,"Virginia","Norfolk city",3,60,2741,1295,1446
050,51,710,"Virginia","Norfolk city",3,61,2718,1274,1444
050,51,710,"Virginia","Norfolk city",3,62,2669,1253,1416
050,51,710,"Virginia","Norfolk city",3,63,2590,1195,1395
050,51,710,"Virginia","Norfolk city",3,64,2491,1155,1336
050,51,710,"Virginia","Norfolk city",3,65,2369,1094,1275
050,51,710,"Virginia","Norfolk city",3,66,2341,1094,1247
050,51,710,"Virginia","Norfolk city",3,67,2155,1002,1153
050,51,710,"Virginia","Norfolk city",3,68,2070,925,1145
050,51,710,"Virginia","Norfolk city",3,69,1954,876,1078
050,51,710,"Virginia","Norfolk city",3,70,1728,763,965
050,51,710,"Virginia","Norfolk city",3,71,1663,752,911
050,51,710,"Virginia","Norfolk city",3,72,1594,708,886
050,51,710,"Virginia","Norfolk city",3,73,1543,687,856
050,51,710,"Virginia","Norfolk city",3,74,1508,660,848
050,51,710,"Virginia","Norfolk city",3,75,1101,477,624
050,51,710,"Virginia","Norfolk city",3,76,1048,444,604
050,51,710,"Virginia","Norfolk city",3,77,976,400,576
050,51,710,"Virginia","Norfolk city",3,78,933,382,551
050,51,710,"Virginia","Norfolk city",3,79,793,330,463
050,51,710,"Virginia","Norfolk city",3,80,700,277,423
050,51,710,"Virginia","Norfolk city",3,81,662,258,404
050,51,710,"Virginia","Norfolk city",3,82,600,214,386
050,51,710,"Virginia","Norfolk city",3,83,527,209,318
050,51,710,"Virginia","Norfolk city",3,84,458,175,283
050,51,710,"Virginia","Norfolk city",3,85,2884,940,1944
050,51,710,"Virginia","Norfolk city",4,0,3086,1574,1512
050,51,710,"Virginia","Norfolk city",4,1,2989,1453,1536
050,51,710,"Virginia","Norfolk city",4,2,2926,1480,1446
050,51,710,"Virginia","Norfolk city",4,3,2969,1537,1432
050,51,710,"Virginia","Norfolk city",4,4,2931,1494,1437
050,51,710,"Virginia","Norfolk city",4,5,2820,1396,1424
050,51,710,"Virginia","Norfolk city",4,6,2773,1383,1390
050,51,710,"Virginia","Norfolk city",4,7,2659,1386,1273
050,51,710,"Virginia","Norfolk city",4,8,2534,1292,1242
050,51,710,"Virginia","Norfolk city",4,9,2449,1235,1214
050,51,710,"Virginia","Norfolk city",4,10,2492,1308,1184
050,51,710,"Virginia","Norfolk city",4,11,2468,1273,1195
050,51,710,"Virginia","Norfolk city",4,12,2424,1243,1181
050,51,710,"Virginia","Norfolk city",4,13,2428,1253,1175
050,51,710,"Virginia","Norfolk city",4,14,2530,1268,1262
050,51,710,"Virginia","Norfolk city",4,15,2349,1176,1173
050,51,710,"Virginia","Norfolk city",4,16,2257,1128,1129
050,51,710,"Virginia","Norfolk city",4,17,2211,1117,1094
050,51,710,"Virginia","Norfolk city",4,18,3325,1651,1674
050,51,710,"Virginia","Norfolk city",4,19,4761,2615,2146
050,51,710,"Virginia","Norfolk city",4,20,5400,3151,2249
050,51,710,"Virginia","Norfolk city",4,21,5558,3332,2226
050,51,710,"Virginia","Norfolk city",4,22,5375,3208,2167
050,51,710,"Virginia","Norfolk city",4,23,5062,2919,2143
050,51,710,"Virginia","Norfolk city",4,24,4890,2800,2090
050,51,710,"Virginia","Norfolk city",4,25,4744,2667,2077
050,51,710,"Virginia","Norfolk city",4,26,4682,2606,2076
050,51,710,"Virginia","Norfolk city",4,27,4644,2503,2141
050,51,710,"Virginia","Norfolk city",4,28,4597,2491,2106
050,51,710,"Virginia","Norfolk city",4,29,4550,2413,2137
050,51,710,"Virginia","Norfolk city",4,30,4363,2271,2092
050,51,710,"Virginia","Norfolk city",4,31,4320,2263,2057
050,51,710,"Virginia","Norfolk city",4,32,4108,2156,1952
050,51,710,"Virginia","Norfolk city",4,33,3874,2003,1871
050,51,710,"Virginia","Norfolk city",4,34,3739,1999,1740
050,51,710,"Virginia","Norfolk city",4,35,3613,1926,1687
050,51,710,"Virginia","Norfolk city",4,36,3414,1833,1581
050,51,710,"Virginia","Norfolk city",4,37,3266,1682,1584
050,51,710,"Virginia","Norfolk city",4,38,3063,1609,1454
050,51,710,"Virginia","Norfolk city",4,39,3031,1566,1465
050,51,710,"Virginia","Norfolk city",4,40,2859,1423,1436
050,51,710,"Virginia","Norfolk city",4,41,2689,1317,1372
050,51,710,"Virginia","Norfolk city",4,42,2645,1321,1324
050,51,710,"Virginia","Norfolk city",4,43,2511,1229,1282
050,51,710,"Virginia","Norfolk city",4,44,2452,1229,1223
050,51,710,"Virginia","Norfolk city",4,45,2270,1100,1170
050,51,710,"Virginia","Norfolk city",4,46,2164,1068,1096
050,51,710,"Virginia","Norfolk city",4,47,2167,1056,1111
050,51,710,"Virginia","Norfolk city",4,48,2020,978,1042
050,51,710,"Virginia","Norfolk city",4,49,2091,1052,1039
050,51,710,"Virginia","Norfolk city",4,50,2247,1081,1166
050,51,710,"Virginia","Norfolk city",4,51,2320,1095,1225
050,51,710,"Virginia","Norfolk city",4,52,2276,1079,1197
050,51,710,"Virginia","Norfolk city",4,53,2266,1088,1178
050,51,710,"Virginia","Norfolk city",4,54,2277,1058,1219
050,51,710,"Virginia","Norfolk city",4,55,2200,1012,1188
050,51,710,"Virginia","Norfolk city",4,56,2410,1179,1231
050,51,710,"Virginia","Norfolk city",4,57,2494,1183,1311
050,51,710,"Virginia","Norfolk city",4,58,2598,1201,1397
050,51,710,"Virginia","Norfolk city",4,59,2582,1223,1359
050,51,710,"Virginia","Norfolk city",4,60,2576,1215,1361
050,51,710,"Virginia","Norfolk city",4,61,2690,1286,1404
050,51,710,"Virginia","Norfolk city",4,62,2652,1234,1418
050,51,710,"Virginia","Norfolk city",4,63,2567,1203,1364
050,51,710,"Virginia","Norfolk city",4,64,2526,1166,1360
050,51,710,"Virginia","Norfolk city",4,65,2396,1106,1290
050,51,710,"Virginia","Norfolk city",4,66,2299,1048,1251
050,51,710,"Virginia","Norfolk city",4,67,2258,1038,1220
050,51,710,"Virginia","Norfolk city",4,68,2102,964,1138
050,51,710,"Virginia","Norfolk city",4,69,1996,886,1110
050,51,710,"Virginia","Norfolk city",4,70,1898,846,1052
050,51,710,"Virginia","Norfolk city",4,71,1658,731,927
050,51,710,"Virginia","Norfolk city",4,72,1593,715,878
050,51,710,"Virginia","Norfolk city",4,73,1524,668,856
050,51,710,"Virginia","Norfolk city",4,74,1475,642,833
050,51,710,"Virginia","Norfolk city",4,75,1476,634,842
050,51,710,"Virginia","Norfolk city",4,76,1064,459,605
050,51,710,"Virginia","Norfolk city",4,77,980,420,560
050,51,710,"Virginia","Norfolk city",4,78,893,353,540
050,51,710,"Virginia","Norfolk city",4,79,910,366,544
050,51,710,"Virginia","Norfolk city",4,80,760,318,442
050,51,710,"Virginia","Norfolk city",4,81,662,261,401
050,51,710,"Virginia","Norfolk city",4,82,604,220,384
050,51,710,"Virginia","Norfolk city",4,83,550,188,362
050,51,710,"Virginia","Norfolk city",4,84,481,193,288
050,51,710,"Virginia","Norfolk city",4,85,2756,906,1850
050,51,710,"Virginia","Norfolk city",5,0,3070,1562,1508
050,51,710,"Virginia","Norfolk city",5,1,2960,1488,1472
050,51,710,"Virginia","Norfolk city",5,2,2864,1427,1437
050,51,710,"Virginia","Norfolk city",5,3,2834,1451,1383
050,51,710,"Virginia","Norfolk city",5,4,2870,1516,1354
050,51,710,"Virginia","Norfolk city",5,5,2802,1406,1396
050,51,710,"Virginia","Norfolk city",5,6,2701,1335,1366
050,51,710,"Virginia","Norfolk city",5,7,2674,1366,1308
050,51,710,"Virginia","Norfolk city",5,8,2528,1320,1208
050,51,710,"Virginia","Norfolk city",5,9,2437,1243,1194
050,51,710,"Virginia","Norfolk city",5,10,2386,1184,1202
050,51,710,"Virginia","Norfolk city",5,11,2424,1280,1144
050,51,710,"Virginia","Norfolk city",5,12,2358,1211,1147
050,51,710,"Virginia","Norfolk city",5,13,2367,1192,1175
050,51,710,"Virginia","Norfolk city",5,14,2376,1234,1142
050,51,710,"Virginia","Norfolk city",5,15,2460,1238,1222
050,51,710,"Virginia","Norfolk city",5,16,2316,1170,1146
050,51,710,"Virginia","Norfolk city",5,17,2202,1116,1086
050,51,710,"Virginia","Norfolk city",5,18,3321,1670,1651
050,51,710,"Virginia","Norfolk city",5,19,4628,2536,2092
050,51,710,"Virginia","Norfolk city",5,20,5196,3024,2172
050,51,710,"Virginia","Norfolk city",5,21,5557,3295,2262
050,51,710,"Virginia","Norfolk city",5,22,5312,3212,2100
050,51,710,"Virginia","Norfolk city",5,23,5068,2975,2093
050,51,710,"Virginia","Norfolk city",5,24,4839,2791,2048
050,51,710,"Virginia","Norfolk city",5,25,4590,2528,2062
050,51,710,"Virginia","Norfolk city",5,26,4567,2447,2120
050,51,710,"Virginia","Norfolk city",5,27,4546,2500,2046
050,51,710,"Virginia","Norfolk city",5,28,4343,2347,1996
050,51,710,"Virginia","Norfolk city",5,29,4375,2347,2028
050,51,710,"Virginia","Norfolk city",5,30,4301,2242,2059
050,51,710,"Virginia","Norfolk city",5,31,4225,2205,2020
050,51,710,"Virginia","Norfolk city",5,32,4159,2170,1989
050,51,710,"Virginia","Norfolk city",5,33,3962,2063,1899
050,51,710,"Virginia","Norfolk city",5,34,3798,1948,1850
050,51,710,"Virginia","Norfolk city",5,35,3614,1913,1701
050,51,710,"Virginia","Norfolk city",5,36,3540,1873,1667
050,51,710,"Virginia","Norfolk city",5,37,3311,1756,1555
050,51,710,"Virginia","Norfolk city",5,38,3175,1611,1564
050,51,710,"Virginia","Norfolk city",5,39,2944,1513,1431
050,51,710,"Virginia","Norfolk city",5,40,2925,1501,1424
050,51,710,"Virginia","Norfolk city",5,41,2816,1395,1421
050,51,710,"Virginia","Norfolk city",5,42,2643,1282,1361
050,51,710,"Virginia","Norfolk city",5,43,2609,1304,1305
050,51,710,"Virginia","Norfolk city",5,44,2449,1196,1253
050,51,710,"Virginia","Norfolk city",5,45,2320,1155,1165
050,51,710,"Virginia","Norfolk city",5,46,2193,1059,1134
050,51,710,"Virginia","Norfolk city",5,47,2131,1050,1081
050,51,710,"Virginia","Norfolk city",5,48,2119,1016,1103
050,51,710,"Virginia","Norfolk city",5,49,2000,973,1027
050,51,710,"Virginia","Norfolk city",5,50,2052,1041,1011
050,51,710,"Virginia","Norfolk city",5,51,2213,1081,1132
050,51,710,"Virginia","Norfolk city",5,52,2300,1080,1220
050,51,710,"Virginia","Norfolk city",5,53,2209,1034,1175
050,51,710,"Virginia","Norfolk city",5,54,2243,1068,1175
050,51,710,"Virginia","Norfolk city",5,55,2223,1043,1180
050,51,710,"Virginia","Norfolk city",5,56,2200,1016,1184
050,51,710,"Virginia","Norfolk city",5,57,2355,1145,1210
050,51,710,"Virginia","Norfolk city",5,58,2450,1153,1297
050,51,710,"Virginia","Norfolk city",5,59,2523,1145,1378
050,51,710,"Virginia","Norfolk city",5,60,2495,1170,1325
050,51,710,"Virginia","Norfolk city",5,61,2498,1172,1326
050,51,710,"Virginia","Norfolk city",5,62,2628,1256,1372
050,51,710,"Virginia","Norfolk city",5,63,2577,1177,1400
050,51,710,"Virginia","Norfolk city",5,64,2454,1131,1323
050,51,710,"Virginia","Norfolk city",5,65,2465,1130,1335
050,51,710,"Virginia","Norfolk city",5,66,2320,1069,1251
050,51,710,"Virginia","Norfolk city",5,67,2267,1021,1246
050,51,710,"Virginia","Norfolk city",5,68,2212,1006,1206
050,51,710,"Virginia","Norfolk city",5,69,2042,942,1100
050,51,710,"Virginia","Norfolk city",5,70,1940,861,1079
050,51,710,"Virginia","Norfolk city",5,71,1841,820,1021
050,51,710,"Virginia","Norfolk city",5,72,1606,700,906
050,51,710,"Virginia","Norfolk city",5,73,1520,679,841
050,51,710,"Virginia","Norfolk city",5,74,1458,640,818
050,51,710,"Virginia","Norfolk city",5,75,1432,608,824
050,51,710,"Virginia","Norfolk city",5,76,1414,610,804
050,51,710,"Virginia","Norfolk city",5,77,1009,436,573
050,51,710,"Virginia","Norfolk city",5,78,921,389,532
050,51,710,"Virginia","Norfolk city",5,79,871,338,533
050,51,710,"Virginia","Norfolk city",5,80,872,348,524
050,51,710,"Virginia","Norfolk city",5,81,728,301,427
050,51,710,"Virginia","Norfolk city",5,82,601,224,377
050,51,710,"Virginia","Norfolk city",5,83,563,198,365
050,51,710,"Virginia","Norfolk city",5,84,507,172,335
050,51,710,"Virginia","Norfolk city",5,85,2716,935,1781
050,51,720,"Virginia","Norton city",1,0,43,21,22
050,51,720,"Virginia","Norton city",1,1,47,21,26
050,51,720,"Virginia","Norton city",1,2,48,27,21
050,51,720,"Virginia","Norton city",1,3,47,23,24
050,51,720,"Virginia","Norton city",1,4,43,19,24
050,51,720,"Virginia","Norton city",1,5,46,25,21
050,51,720,"Virginia","Norton city",1,6,61,30,31
050,51,720,"Virginia","Norton city",1,7,43,25,18
050,51,720,"Virginia","Norton city",1,8,36,15,21
050,51,720,"Virginia","Norton city",1,9,37,16,21
050,51,720,"Virginia","Norton city",1,10,44,21,23
050,51,720,"Virginia","Norton city",1,11,58,26,32
050,51,720,"Virginia","Norton city",1,12,50,26,24
050,51,720,"Virginia","Norton city",1,13,48,27,21
050,51,720,"Virginia","Norton city",1,14,37,17,20
050,51,720,"Virginia","Norton city",1,15,41,22,19
050,51,720,"Virginia","Norton city",1,16,51,25,26
050,51,720,"Virginia","Norton city",1,17,56,27,29
050,51,720,"Virginia","Norton city",1,18,40,22,18
050,51,720,"Virginia","Norton city",1,19,32,18,14
050,51,720,"Virginia","Norton city",1,20,33,17,16
050,51,720,"Virginia","Norton city",1,21,36,19,17
050,51,720,"Virginia","Norton city",1,22,35,19,16
050,51,720,"Virginia","Norton city",1,23,35,18,17
050,51,720,"Virginia","Norton city",1,24,47,27,20
050,51,720,"Virginia","Norton city",1,25,51,27,24
050,51,720,"Virginia","Norton city",1,26,61,31,30
050,51,720,"Virginia","Norton city",1,27,58,32,26
050,51,720,"Virginia","Norton city",1,28,48,18,30
050,51,720,"Virginia","Norton city",1,29,59,25,34
050,51,720,"Virginia","Norton city",1,30,51,26,25
050,51,720,"Virginia","Norton city",1,31,44,22,22
050,51,720,"Virginia","Norton city",1,32,52,29,23
050,51,720,"Virginia","Norton city",1,33,57,31,26
050,51,720,"Virginia","Norton city",1,34,49,26,23
050,51,720,"Virginia","Norton city",1,35,44,21,23
050,51,720,"Virginia","Norton city",1,36,53,26,27
050,51,720,"Virginia","Norton city",1,37,43,22,21
050,51,720,"Virginia","Norton city",1,38,47,23,24
050,51,720,"Virginia","Norton city",1,39,52,28,24
050,51,720,"Virginia","Norton city",1,40,42,21,21
050,51,720,"Virginia","Norton city",1,41,35,15,20
050,51,720,"Virginia","Norton city",1,42,39,19,20
050,51,720,"Virginia","Norton city",1,43,50,25,25
050,51,720,"Virginia","Norton city",1,44,48,16,32
050,51,720,"Virginia","Norton city",1,45,39,17,22
050,51,720,"Virginia","Norton city",1,46,48,28,20
050,51,720,"Virginia","Norton city",1,47,42,20,22
050,51,720,"Virginia","Norton city",1,48,52,22,30
050,51,720,"Virginia","Norton city",1,49,44,23,21
050,51,720,"Virginia","Norton city",1,50,49,25,24
050,51,720,"Virginia","Norton city",1,51,43,28,15
050,51,720,"Virginia","Norton city",1,52,38,19,19
050,51,720,"Virginia","Norton city",1,53,44,24,20
050,51,720,"Virginia","Norton city",1,54,59,26,33
050,51,720,"Virginia","Norton city",1,55,38,18,20
050,51,720,"Virginia","Norton city",1,56,44,23,21
050,51,720,"Virginia","Norton city",1,57,45,22,23
050,51,720,"Virginia","Norton city",1,58,47,21,26
050,51,720,"Virginia","Norton city",1,59,50,24,26
050,51,720,"Virginia","Norton city",1,60,56,31,25
050,51,720,"Virginia","Norton city",1,61,49,23,26
050,51,720,"Virginia","Norton city",1,62,57,22,35
050,51,720,"Virginia","Norton city",1,63,48,16,32
050,51,720,"Virginia","Norton city",1,64,44,19,25
050,51,720,"Virginia","Norton city",1,65,49,24,25
050,51,720,"Virginia","Norton city",1,66,47,22,25
050,51,720,"Virginia","Norton city",1,67,40,16,24
050,51,720,"Virginia","Norton city",1,68,36,11,25
050,51,720,"Virginia","Norton city",1,69,50,18,32
050,51,720,"Virginia","Norton city",1,70,46,17,29
050,51,720,"Virginia","Norton city",1,71,37,12,25
050,51,720,"Virginia","Norton city",1,72,31,14,17
050,51,720,"Virginia","Norton city",1,73,36,17,19
050,51,720,"Virginia","Norton city",1,74,24,10,14
050,51,720,"Virginia","Norton city",1,75,20,7,13
050,51,720,"Virginia","Norton city",1,76,28,9,19
050,51,720,"Virginia","Norton city",1,77,32,11,21
050,51,720,"Virginia","Norton city",1,78,22,7,15
050,51,720,"Virginia","Norton city",1,79,20,7,13
050,51,720,"Virginia","Norton city",1,80,19,8,11
050,51,720,"Virginia","Norton city",1,81,22,11,11
050,51,720,"Virginia","Norton city",1,82,19,7,12
050,51,720,"Virginia","Norton city",1,83,15,6,9
050,51,720,"Virginia","Norton city",1,84,14,5,9
050,51,720,"Virginia","Norton city",1,85,77,26,51
050,51,720,"Virginia","Norton city",2,0,42,19,23
050,51,720,"Virginia","Norton city",2,1,46,21,25
050,51,720,"Virginia","Norton city",2,2,47,25,22
050,51,720,"Virginia","Norton city",2,3,46,23,23
050,51,720,"Virginia","Norton city",2,4,44,21,23
050,51,720,"Virginia","Norton city",2,5,46,24,22
050,51,720,"Virginia","Norton city",2,6,59,31,28
050,51,720,"Virginia","Norton city",2,7,46,26,20
050,51,720,"Virginia","Norton city",2,8,37,17,20
050,51,720,"Virginia","Norton city",2,9,38,17,21
050,51,720,"Virginia","Norton city",2,10,43,21,22
050,51,720,"Virginia","Norton city",2,11,54,25,29
050,51,720,"Virginia","Norton city",2,12,51,26,25
050,51,720,"Virginia","Norton city",2,13,48,26,22
050,51,720,"Virginia","Norton city",2,14,40,20,20
050,51,720,"Virginia","Norton city",2,15,40,21,19
050,51,720,"Virginia","Norton city",2,16,50,25,25
050,51,720,"Virginia","Norton city",2,17,55,27,28
050,51,720,"Virginia","Norton city",2,18,40,21,19
050,51,720,"Virginia","Norton city",2,19,32,18,14
050,51,720,"Virginia","Norton city",2,20,35,19,16
050,51,720,"Virginia","Norton city",2,21,37,19,18
050,51,720,"Virginia","Norton city",2,22,36,19,17
050,51,720,"Virginia","Norton city",2,23,37,19,18
050,51,720,"Virginia","Norton city",2,24,46,25,21
050,51,720,"Virginia","Norton city",2,25,52,28,24
050,51,720,"Virginia","Norton city",2,26,60,32,28
050,51,720,"Virginia","Norton city",2,27,58,31,27
050,51,720,"Virginia","Norton city",2,28,51,21,30
050,51,720,"Virginia","Norton city",2,29,55,22,33
050,51,720,"Virginia","Norton city",2,30,52,25,27
050,51,720,"Virginia","Norton city",2,31,44,22,22
050,51,720,"Virginia","Norton city",2,32,48,26,22
050,51,720,"Virginia","Norton city",2,33,55,30,25
050,51,720,"Virginia","Norton city",2,34,51,27,24
050,51,720,"Virginia","Norton city",2,35,46,23,23
050,51,720,"Virginia","Norton city",2,36,49,25,24
050,51,720,"Virginia","Norton city",2,37,44,22,22
050,51,720,"Virginia","Norton city",2,38,46,23,23
050,51,720,"Virginia","Norton city",2,39,48,25,23
050,51,720,"Virginia","Norton city",2,40,44,22,22
050,51,720,"Virginia","Norton city",2,41,35,16,19
050,51,720,"Virginia","Norton city",2,42,37,17,20
050,51,720,"Virginia","Norton city",2,43,49,24,25
050,51,720,"Virginia","Norton city",2,44,47,18,29
050,51,720,"Virginia","Norton city",2,45,44,18,26
050,51,720,"Virginia","Norton city",2,46,45,25,20
050,51,720,"Virginia","Norton city",2,47,45,23,22
050,51,720,"Virginia","Norton city",2,48,50,23,27
050,51,720,"Virginia","Norton city",2,49,46,23,23
050,51,720,"Virginia","Norton city",2,50,48,25,23
050,51,720,"Virginia","Norton city",2,51,44,27,17
050,51,720,"Virginia","Norton city",2,52,40,22,18
050,51,720,"Virginia","Norton city",2,53,43,23,20
050,51,720,"Virginia","Norton city",2,54,56,26,30
050,51,720,"Virginia","Norton city",2,55,42,19,23
050,51,720,"Virginia","Norton city",2,56,42,22,20
050,51,720,"Virginia","Norton city",2,57,42,21,21
050,51,720,"Virginia","Norton city",2,58,47,22,25
050,51,720,"Virginia","Norton city",2,59,49,23,26
050,51,720,"Virginia","Norton city",2,60,55,30,25
050,51,720,"Virginia","Norton city",2,61,51,25,26
050,51,720,"Virginia","Norton city",2,62,55,22,33
050,51,720,"Virginia","Norton city",2,63,51,18,33
050,51,720,"Virginia","Norton city",2,64,43,18,25
050,51,720,"Virginia","Norton city",2,65,46,22,24
050,51,720,"Virginia","Norton city",2,66,48,22,26
050,51,720,"Virginia","Norton city",2,67,41,17,24
050,51,720,"Virginia","Norton city",2,68,35,11,24
050,51,720,"Virginia","Norton city",2,69,48,16,32
050,51,720,"Virginia","Norton city",2,70,47,17,30
050,51,720,"Virginia","Norton city",2,71,38,12,26
050,51,720,"Virginia","Norton city",2,72,32,13,19
050,51,720,"Virginia","Norton city",2,73,37,17,20
050,51,720,"Virginia","Norton city",2,74,22,8,14
050,51,720,"Virginia","Norton city",2,75,20,7,13
050,51,720,"Virginia","Norton city",2,76,26,9,17
050,51,720,"Virginia","Norton city",2,77,32,11,21
050,51,720,"Virginia","Norton city",2,78,25,8,17
050,51,720,"Virginia","Norton city",2,79,19,7,12
050,51,720,"Virginia","Norton city",2,80,20,8,12
050,51,720,"Virginia","Norton city",2,81,20,10,10
050,51,720,"Virginia","Norton city",2,82,18,8,10
050,51,720,"Virginia","Norton city",2,83,15,6,9
050,51,720,"Virginia","Norton city",2,84,14,5,9
050,51,720,"Virginia","Norton city",2,85,74,26,48
050,51,720,"Virginia","Norton city",3,0,35,16,19
050,51,720,"Virginia","Norton city",3,1,44,17,27
050,51,720,"Virginia","Norton city",3,2,49,24,25
050,51,720,"Virginia","Norton city",3,3,38,20,18
050,51,720,"Virginia","Norton city",3,4,42,22,20
050,51,720,"Virginia","Norton city",3,5,47,24,23
050,51,720,"Virginia","Norton city",3,6,47,23,24
050,51,720,"Virginia","Norton city",3,7,56,29,27
050,51,720,"Virginia","Norton city",3,8,49,26,23
050,51,720,"Virginia","Norton city",3,9,45,23,22
050,51,720,"Virginia","Norton city",3,10,42,20,22
050,51,720,"Virginia","Norton city",3,11,42,21,21
050,51,720,"Virginia","Norton city",3,12,58,27,31
050,51,720,"Virginia","Norton city",3,13,49,23,26
050,51,720,"Virginia","Norton city",3,14,46,24,22
050,51,720,"Virginia","Norton city",3,15,40,22,18
050,51,720,"Virginia","Norton city",3,16,43,22,21
050,51,720,"Virginia","Norton city",3,17,48,24,24
050,51,720,"Virginia","Norton city",3,18,48,25,23
050,51,720,"Virginia","Norton city",3,19,28,15,13
050,51,720,"Virginia","Norton city",3,20,30,18,12
050,51,720,"Virginia","Norton city",3,21,42,20,22
050,51,720,"Virginia","Norton city",3,22,47,24,23
050,51,720,"Virginia","Norton city",3,23,29,19,10
050,51,720,"Virginia","Norton city",3,24,44,22,22
050,51,720,"Virginia","Norton city",3,25,53,27,26
050,51,720,"Virginia","Norton city",3,26,47,28,19
050,51,720,"Virginia","Norton city",3,27,59,31,28
050,51,720,"Virginia","Norton city",3,28,54,29,25
050,51,720,"Virginia","Norton city",3,29,52,22,30
050,51,720,"Virginia","Norton city",3,30,56,23,33
050,51,720,"Virginia","Norton city",3,31,52,22,30
050,51,720,"Virginia","Norton city",3,32,43,20,23
050,51,720,"Virginia","Norton city",3,33,54,30,24
050,51,720,"Virginia","Norton city",3,34,58,28,30
050,51,720,"Virginia","Norton city",3,35,43,22,21
050,51,720,"Virginia","Norton city",3,36,48,23,25
050,51,720,"Virginia","Norton city",3,37,53,27,26
050,51,720,"Virginia","Norton city",3,38,47,23,24
050,51,720,"Virginia","Norton city",3,39,46,25,21
050,51,720,"Virginia","Norton city",3,40,48,25,23
050,51,720,"Virginia","Norton city",3,41,39,19,20
050,51,720,"Virginia","Norton city",3,42,35,16,19
050,51,720,"Virginia","Norton city",3,43,33,14,19
050,51,720,"Virginia","Norton city",3,44,46,23,23
050,51,720,"Virginia","Norton city",3,45,49,19,30
050,51,720,"Virginia","Norton city",3,46,50,23,27
050,51,720,"Virginia","Norton city",3,47,42,24,18
050,51,720,"Virginia","Norton city",3,48,37,18,19
050,51,720,"Virginia","Norton city",3,49,45,21,24
050,51,720,"Virginia","Norton city",3,50,49,24,25
050,51,720,"Virginia","Norton city",3,51,44,23,21
050,51,720,"Virginia","Norton city",3,52,41,26,15
050,51,720,"Virginia","Norton city",3,53,38,21,17
050,51,720,"Virginia","Norton city",3,54,41,24,17
050,51,720,"Virginia","Norton city",3,55,54,25,29
050,51,720,"Virginia","Norton city",3,56,40,17,23
050,51,720,"Virginia","Norton city",3,57,40,20,20
050,51,720,"Virginia","Norton city",3,58,41,21,20
050,51,720,"Virginia","Norton city",3,59,45,20,25
050,51,720,"Virginia","Norton city",3,60,47,22,25
050,51,720,"Virginia","Norton city",3,61,53,29,24
050,51,720,"Virginia","Norton city",3,62,56,27,29
050,51,720,"Virginia","Norton city",3,63,54,21,33
050,51,720,"Virginia","Norton city",3,64,50,17,33
050,51,720,"Virginia","Norton city",3,65,38,16,22
050,51,720,"Virginia","Norton city",3,66,43,19,24
050,51,720,"Virginia","Norton city",3,67,49,22,27
050,51,720,"Virginia","Norton city",3,68,39,15,24
050,51,720,"Virginia","Norton city",3,69,37,11,26
050,51,720,"Virginia","Norton city",3,70,45,14,31
050,51,720,"Virginia","Norton city",3,71,44,15,29
050,51,720,"Virginia","Norton city",3,72,36,10,26
050,51,720,"Virginia","Norton city",3,73,32,14,18
050,51,720,"Virginia","Norton city",3,74,34,15,19
050,51,720,"Virginia","Norton city",3,75,20,6,14
050,51,720,"Virginia","Norton city",3,76,18,7,11
050,51,720,"Virginia","Norton city",3,77,22,7,15
050,51,720,"Virginia","Norton city",3,78,32,11,21
050,51,720,"Virginia","Norton city",3,79,24,7,17
050,51,720,"Virginia","Norton city",3,80,17,7,10
050,51,720,"Virginia","Norton city",3,81,18,6,12
050,51,720,"Virginia","Norton city",3,82,20,11,9
050,51,720,"Virginia","Norton city",3,83,14,7,7
050,51,720,"Virginia","Norton city",3,84,15,6,9
050,51,720,"Virginia","Norton city",3,85,65,24,41
050,51,720,"Virginia","Norton city",4,0,39,22,17
050,51,720,"Virginia","Norton city",4,1,44,19,25
050,51,720,"Virginia","Norton city",4,2,41,14,27
050,51,720,"Virginia","Norton city",4,3,49,22,27
050,51,720,"Virginia","Norton city",4,4,45,23,22
050,51,720,"Virginia","Norton city",4,5,43,21,22
050,51,720,"Virginia","Norton city",4,6,44,23,21
050,51,720,"Virginia","Norton city",4,7,52,24,28
050,51,720,"Virginia","Norton city",4,8,58,29,29
050,51,720,"Virginia","Norton city",4,9,51,27,24
050,51,720,"Virginia","Norton city",4,10,46,24,22
050,51,720,"Virginia","Norton city",4,11,38,16,22
050,51,720,"Virginia","Norton city",4,12,42,24,18
050,51,720,"Virginia","Norton city",4,13,60,23,37
050,51,720,"Virginia","Norton city",4,14,49,26,23
050,51,720,"Virginia","Norton city",4,15,40,20,20
050,51,720,"Virginia","Norton city",4,16,37,20,17
050,51,720,"Virginia","Norton city",4,17,41,20,21
050,51,720,"Virginia","Norton city",4,18,44,22,22
050,51,720,"Virginia","Norton city",4,19,42,20,22
050,51,720,"Virginia","Norton city",4,20,34,20,14
050,51,720,"Virginia","Norton city",4,21,37,20,17
050,51,720,"Virginia","Norton city",4,22,40,19,21
050,51,720,"Virginia","Norton city",4,23,46,22,24
050,51,720,"Virginia","Norton city",4,24,38,22,16
050,51,720,"Virginia","Norton city",4,25,44,26,18
050,51,720,"Virginia","Norton city",4,26,58,26,32
050,51,720,"Virginia","Norton city",4,27,53,30,23
050,51,720,"Virginia","Norton city",4,28,56,31,25
050,51,720,"Virginia","Norton city",4,29,58,30,28
050,51,720,"Virginia","Norton city",4,30,50,27,23
050,51,720,"Virginia","Norton city",4,31,61,29,32
050,51,720,"Virginia","Norton city",4,32,50,20,30
050,51,720,"Virginia","Norton city",4,33,39,17,22
050,51,720,"Virginia","Norton city",4,34,60,28,32
050,51,720,"Virginia","Norton city",4,35,56,30,26
050,51,720,"Virginia","Norton city",4,36,44,25,19
050,51,720,"Virginia","Norton city",4,37,54,28,26
050,51,720,"Virginia","Norton city",4,38,51,27,24
050,51,720,"Virginia","Norton city",4,39,41,20,21
050,51,720,"Virginia","Norton city",4,40,44,25,19
050,51,720,"Virginia","Norton city",4,41,46,23,23
050,51,720,"Virginia","Norton city",4,42,45,22,23
050,51,720,"Virginia","Norton city",4,43,35,16,19
050,51,720,"Virginia","Norton city",4,44,34,15,19
050,51,720,"Virginia","Norton city",4,45,41,23,18
050,51,720,"Virginia","Norton city",4,46,46,19,27
050,51,720,"Virginia","Norton city",4,47,53,24,29
050,51,720,"Virginia","Norton city",4,48,44,23,21
050,51,720,"Virginia","Norton city",4,49,34,16,18
050,51,720,"Virginia","Norton city",4,50,42,21,21
050,51,720,"Virginia","Norton city",4,51,47,22,25
050,51,720,"Virginia","Norton city",4,52,48,26,22
050,51,720,"Virginia","Norton city",4,53,42,27,15
050,51,720,"Virginia","Norton city",4,54,35,21,14
050,51,720,"Virginia","Norton city",4,55,41,24,17
050,51,720,"Virginia","Norton city",4,56,49,24,25
050,51,720,"Virginia","Norton city",4,57,38,14,24
050,51,720,"Virginia","Norton city",4,58,35,19,16
050,51,720,"Virginia","Norton city",4,59,35,17,18
050,51,720,"Virginia","Norton city",4,60,41,20,21
050,51,720,"Virginia","Norton city",4,61,49,21,28
050,51,720,"Virginia","Norton city",4,62,47,24,23
050,51,720,"Virginia","Norton city",4,63,48,25,23
050,51,720,"Virginia","Norton city",4,64,51,18,33
050,51,720,"Virginia","Norton city",4,65,46,15,31
050,51,720,"Virginia","Norton city",4,66,39,16,23
050,51,720,"Virginia","Norton city",4,67,40,18,22
050,51,720,"Virginia","Norton city",4,68,45,18,27
050,51,720,"Virginia","Norton city",4,69,40,15,25
050,51,720,"Virginia","Norton city",4,70,31,9,22
050,51,720,"Virginia","Norton city",4,71,46,13,33
050,51,720,"Virginia","Norton city",4,72,39,14,25
050,51,720,"Virginia","Norton city",4,73,33,9,24
050,51,720,"Virginia","Norton city",4,74,28,12,16
050,51,720,"Virginia","Norton city",4,75,35,16,19
050,51,720,"Virginia","Norton city",4,76,17,6,11
050,51,720,"Virginia","Norton city",4,77,18,6,12
050,51,720,"Virginia","Norton city",4,78,19,6,13
050,51,720,"Virginia","Norton city",4,79,28,10,18
050,51,720,"Virginia","Norton city",4,80,23,7,16
050,51,720,"Virginia","Norton city",4,81,12,2,10
050,51,720,"Virginia","Norton city",4,82,18,6,12
050,51,720,"Virginia","Norton city",4,83,18,10,8
050,51,720,"Virginia","Norton city",4,84,15,7,8
050,51,720,"Virginia","Norton city",4,85,54,17,37
050,51,720,"Virginia","Norton city",5,0,41,23,18
050,51,720,"Virginia","Norton city",5,1,40,19,21
050,51,720,"Virginia","Norton city",5,2,44,17,27
050,51,720,"Virginia","Norton city",5,3,40,11,29
050,51,720,"Virginia","Norton city",5,4,47,20,27
050,51,720,"Virginia","Norton city",5,5,45,21,24
050,51,720,"Virginia","Norton city",5,6,43,22,21
050,51,720,"Virginia","Norton city",5,7,40,21,19
050,51,720,"Virginia","Norton city",5,8,51,21,30
050,51,720,"Virginia","Norton city",5,9,52,24,28
050,51,720,"Virginia","Norton city",5,10,46,25,21
050,51,720,"Virginia","Norton city",5,11,42,21,21
050,51,720,"Virginia","Norton city",5,12,42,18,24
050,51,720,"Virginia","Norton city",5,13,34,24,10
050,51,720,"Virginia","Norton city",5,14,60,19,41
050,51,720,"Virginia","Norton city",5,15,45,24,21
050,51,720,"Virginia","Norton city",5,16,42,21,21
050,51,720,"Virginia","Norton city",5,17,36,21,15
050,51,720,"Virginia","Norton city",5,18,33,17,16
050,51,720,"Virginia","Norton city",5,19,35,19,16
050,51,720,"Virginia","Norton city",5,20,48,23,25
050,51,720,"Virginia","Norton city",5,21,39,22,17
050,51,720,"Virginia","Norton city",5,22,40,22,18
050,51,720,"Virginia","Norton city",5,23,44,22,22
050,51,720,"Virginia","Norton city",5,24,39,18,21
050,51,720,"Virginia","Norton city",5,25,36,22,14
050,51,720,"Virginia","Norton city",5,26,39,25,14
050,51,720,"Virginia","Norton city",5,27,55,23,32
050,51,720,"Virginia","Norton city",5,28,60,35,25
050,51,720,"Virginia","Norton city",5,29,55,31,24
050,51,720,"Virginia","Norton city",5,30,55,32,23
050,51,720,"Virginia","Norton city",5,31,48,27,21
050,51,720,"Virginia","Norton city",5,32,60,27,33
050,51,720,"Virginia","Norton city",5,33,45,23,22
050,51,720,"Virginia","Norton city",5,34,41,19,22
050,51,720,"Virginia","Norton city",5,35,64,31,33
050,51,720,"Virginia","Norton city",5,36,54,29,25
050,51,720,"Virginia","Norton city",5,37,47,25,22
050,51,720,"Virginia","Norton city",5,38,53,27,26
050,51,720,"Virginia","Norton city",5,39,53,29,24
050,51,720,"Virginia","Norton city",5,40,40,20,20
050,51,720,"Virginia","Norton city",5,41,48,26,22
050,51,720,"Virginia","Norton city",5,42,46,20,26
050,51,720,"Virginia","Norton city",5,43,43,17,26
050,51,720,"Virginia","Norton city",5,44,30,9,21
050,51,720,"Virginia","Norton city",5,45,28,10,18
050,51,720,"Virginia","Norton city",5,46,48,24,24
050,51,720,"Virginia","Norton city",5,47,44,19,25
050,51,720,"Virginia","Norton city",5,48,54,25,29
050,51,720,"Virginia","Norton city",5,49,42,22,20
050,51,720,"Virginia","Norton city",5,50,35,17,18
050,51,720,"Virginia","Norton city",5,51,40,20,20
050,51,720,"Virginia","Norton city",5,52,45,19,26
050,51,720,"Virginia","Norton city",5,53,42,22,20
050,51,720,"Virginia","Norton city",5,54,43,26,17
050,51,720,"Virginia","Norton city",5,55,33,19,14
050,51,720,"Virginia","Norton city",5,56,38,21,17
050,51,720,"Virginia","Norton city",5,57,47,23,24
050,51,720,"Virginia","Norton city",5,58,36,13,23
050,51,720,"Virginia","Norton city",5,59,31,17,14
050,51,720,"Virginia","Norton city",5,60,34,18,16
050,51,720,"Virginia","Norton city",5,61,42,22,20
050,51,720,"Virginia","Norton city",5,62,46,18,28
050,51,720,"Virginia","Norton city",5,63,44,22,22
050,51,720,"Virginia","Norton city",5,64,45,23,22
050,51,720,"Virginia","Norton city",5,65,48,17,31
050,51,720,"Virginia","Norton city",5,66,45,15,30
050,51,720,"Virginia","Norton city",5,67,40,14,26
050,51,720,"Virginia","Norton city",5,68,36,14,22
050,51,720,"Virginia","Norton city",5,69,45,18,27
050,51,720,"Virginia","Norton city",5,70,36,13,23
050,51,720,"Virginia","Norton city",5,71,31,10,21
050,51,720,"Virginia","Norton city",5,72,43,11,32
050,51,720,"Virginia","Norton city",5,73,37,12,25
050,51,720,"Virginia","Norton city",5,74,28,7,21
050,51,720,"Virginia","Norton city",5,75,25,9,16
050,51,720,"Virginia","Norton city",5,76,34,17,17
050,51,720,"Virginia","Norton city",5,77,15,4,11
050,51,720,"Virginia","Norton city",5,78,17,5,12
050,51,720,"Virginia","Norton city",5,79,16,5,11
050,51,720,"Virginia","Norton city",5,80,27,9,18
050,51,720,"Virginia","Norton city",5,81,17,4,13
050,51,720,"Virginia","Norton city",5,82,13,2,11
050,51,720,"Virginia","Norton city",5,83,15,5,10
050,51,720,"Virginia","Norton city",5,84,17,9,8
050,51,720,"Virginia","Norton city",5,85,50,14,36
050,51,730,"Virginia","Petersburg city",1,0,600,308,292
050,51,730,"Virginia","Petersburg city",1,1,450,223,227
050,51,730,"Virginia","Petersburg city",1,2,461,230,231
050,51,730,"Virginia","Petersburg city",1,3,435,236,199
050,51,730,"Virginia","Petersburg city",1,4,471,238,233
050,51,730,"Virginia","Petersburg city",1,5,461,224,237
050,51,730,"Virginia","Petersburg city",1,6,430,231,199
050,51,730,"Virginia","Petersburg city",1,7,406,216,190
050,51,730,"Virginia","Petersburg city",1,8,440,220,220
050,51,730,"Virginia","Petersburg city",1,9,400,214,186
050,51,730,"Virginia","Petersburg city",1,10,401,222,179
050,51,730,"Virginia","Petersburg city",1,11,397,205,192
050,51,730,"Virginia","Petersburg city",1,12,376,179,197
050,51,730,"Virginia","Petersburg city",1,13,373,181,192
050,51,730,"Virginia","Petersburg city",1,14,331,161,170
050,51,730,"Virginia","Petersburg city",1,15,336,172,164
050,51,730,"Virginia","Petersburg city",1,16,321,157,164
050,51,730,"Virginia","Petersburg city",1,17,339,169,170
050,51,730,"Virginia","Petersburg city",1,18,330,165,165
050,51,730,"Virginia","Petersburg city",1,19,320,171,149
050,51,730,"Virginia","Petersburg city",1,20,357,178,179
050,51,730,"Virginia","Petersburg city",1,21,389,176,213
050,51,730,"Virginia","Petersburg city",1,22,442,193,249
050,51,730,"Virginia","Petersburg city",1,23,508,220,288
050,51,730,"Virginia","Petersburg city",1,24,546,248,298
050,51,730,"Virginia","Petersburg city",1,25,586,263,323
050,51,730,"Virginia","Petersburg city",1,26,630,288,342
050,51,730,"Virginia","Petersburg city",1,27,658,322,336
050,51,730,"Virginia","Petersburg city",1,28,610,275,335
050,51,730,"Virginia","Petersburg city",1,29,602,262,340
050,51,730,"Virginia","Petersburg city",1,30,604,260,344
050,51,730,"Virginia","Petersburg city",1,31,539,253,286
050,51,730,"Virginia","Petersburg city",1,32,464,213,251
050,51,730,"Virginia","Petersburg city",1,33,468,207,261
050,51,730,"Virginia","Petersburg city",1,34,471,225,246
050,51,730,"Virginia","Petersburg city",1,35,406,177,229
050,51,730,"Virginia","Petersburg city",1,36,343,144,199
050,51,730,"Virginia","Petersburg city",1,37,362,166,196
050,51,730,"Virginia","Petersburg city",1,38,388,177,211
050,51,730,"Virginia","Petersburg city",1,39,353,164,189
050,51,730,"Virginia","Petersburg city",1,40,360,159,201
050,51,730,"Virginia","Petersburg city",1,41,362,160,202
050,51,730,"Virginia","Petersburg city",1,42,333,161,172
050,51,730,"Virginia","Petersburg city",1,43,312,161,151
050,51,730,"Virginia","Petersburg city",1,44,293,149,144
050,51,730,"Virginia","Petersburg city",1,45,285,141,144
050,51,730,"Virginia","Petersburg city",1,46,298,142,156
050,51,730,"Virginia","Petersburg city",1,47,302,136,166
050,51,730,"Virginia","Petersburg city",1,48,344,157,187
050,51,730,"Virginia","Petersburg city",1,49,403,175,228
050,51,730,"Virginia","Petersburg city",1,50,381,177,204
050,51,730,"Virginia","Petersburg city",1,51,377,157,220
050,51,730,"Virginia","Petersburg city",1,52,430,206,224
050,51,730,"Virginia","Petersburg city",1,53,444,213,231
050,51,730,"Virginia","Petersburg city",1,54,481,227,254
050,51,730,"Virginia","Petersburg city",1,55,509,241,268
050,51,730,"Virginia","Petersburg city",1,56,481,228,253
050,51,730,"Virginia","Petersburg city",1,57,484,235,249
050,51,730,"Virginia","Petersburg city",1,58,470,212,258
050,51,730,"Virginia","Petersburg city",1,59,453,202,251
050,51,730,"Virginia","Petersburg city",1,60,446,206,240
050,51,730,"Virginia","Petersburg city",1,61,438,192,246
050,51,730,"Virginia","Petersburg city",1,62,481,200,281
050,51,730,"Virginia","Petersburg city",1,63,444,172,272
050,51,730,"Virginia","Petersburg city",1,64,432,181,251
050,51,730,"Virginia","Petersburg city",1,65,428,200,228
050,51,730,"Virginia","Petersburg city",1,66,411,192,219
050,51,730,"Virginia","Petersburg city",1,67,382,150,232
050,51,730,"Virginia","Petersburg city",1,68,357,156,201
050,51,730,"Virginia","Petersburg city",1,69,359,161,198
050,51,730,"Virginia","Petersburg city",1,70,325,136,189
050,51,730,"Virginia","Petersburg city",1,71,300,140,160
050,51,730,"Virginia","Petersburg city",1,72,305,132,173
050,51,730,"Virginia","Petersburg city",1,73,307,121,186
050,51,730,"Virginia","Petersburg city",1,74,203,79,124
050,51,730,"Virginia","Petersburg city",1,75,219,89,130
050,51,730,"Virginia","Petersburg city",1,76,241,99,142
050,51,730,"Virginia","Petersburg city",1,77,209,69,140
050,51,730,"Virginia","Petersburg city",1,78,172,62,110
050,51,730,"Virginia","Petersburg city",1,79,159,59,100
050,51,730,"Virginia","Petersburg city",1,80,157,56,101
050,51,730,"Virginia","Petersburg city",1,81,128,49,79
050,51,730,"Virginia","Petersburg city",1,82,114,39,75
050,51,730,"Virginia","Petersburg city",1,83,112,36,76
050,51,730,"Virginia","Petersburg city",1,84,105,34,71
050,51,730,"Virginia","Petersburg city",1,85,623,147,476
050,51,730,"Virginia","Petersburg city",2,0,576,291,285
050,51,730,"Virginia","Petersburg city",2,1,479,240,239
050,51,730,"Virginia","Petersburg city",2,2,455,228,227
050,51,730,"Virginia","Petersburg city",2,3,438,234,204
050,51,730,"Virginia","Petersburg city",2,4,454,234,220
050,51,730,"Virginia","Petersburg city",2,5,460,226,234
050,51,730,"Virginia","Petersburg city",2,6,434,227,207
050,51,730,"Virginia","Petersburg city",2,7,411,219,192
050,51,730,"Virginia","Petersburg city",2,8,426,218,208
050,51,730,"Virginia","Petersburg city",2,9,413,221,192
050,51,730,"Virginia","Petersburg city",2,10,404,223,181
050,51,730,"Virginia","Petersburg city",2,11,392,207,185
050,51,730,"Virginia","Petersburg city",2,12,384,185,199
050,51,730,"Virginia","Petersburg city",2,13,374,179,195
050,51,730,"Virginia","Petersburg city",2,14,345,169,176
050,51,730,"Virginia","Petersburg city",2,15,334,169,165
050,51,730,"Virginia","Petersburg city",2,16,331,163,168
050,51,730,"Virginia","Petersburg city",2,17,338,167,171
050,51,730,"Virginia","Petersburg city",2,18,329,166,163
050,51,730,"Virginia","Petersburg city",2,19,320,168,152
050,51,730,"Virginia","Petersburg city",2,20,356,177,179
050,51,730,"Virginia","Petersburg city",2,21,390,179,211
050,51,730,"Virginia","Petersburg city",2,22,443,194,249
050,51,730,"Virginia","Petersburg city",2,23,500,219,281
050,51,730,"Virginia","Petersburg city",2,24,537,240,297
050,51,730,"Virginia","Petersburg city",2,25,577,260,317
050,51,730,"Virginia","Petersburg city",2,26,623,289,334
050,51,730,"Virginia","Petersburg city",2,27,640,308,332
050,51,730,"Virginia","Petersburg city",2,28,607,280,327
050,51,730,"Virginia","Petersburg city",2,29,602,264,338
050,51,730,"Virginia","Petersburg city",2,30,601,261,340
050,51,730,"Virginia","Petersburg city",2,31,546,253,293
050,51,730,"Virginia","Petersburg city",2,32,476,217,259
050,51,730,"Virginia","Petersburg city",2,33,467,209,258
050,51,730,"Virginia","Petersburg city",2,34,458,213,245
050,51,730,"Virginia","Petersburg city",2,35,423,187,236
050,51,730,"Virginia","Petersburg city",2,36,354,149,205
050,51,730,"Virginia","Petersburg city",2,37,356,157,199
050,51,730,"Virginia","Petersburg city",2,38,379,174,205
050,51,730,"Virginia","Petersburg city",2,39,357,165,192
050,51,730,"Virginia","Petersburg city",2,40,365,163,202
050,51,730,"Virginia","Petersburg city",2,41,361,162,199
050,51,730,"Virginia","Petersburg city",2,42,340,160,180
050,51,730,"Virginia","Petersburg city",2,43,321,161,160
050,51,730,"Virginia","Petersburg city",2,44,297,151,146
050,51,730,"Virginia","Petersburg city",2,45,289,143,146
050,51,730,"Virginia","Petersburg city",2,46,295,142,153
050,51,730,"Virginia","Petersburg city",2,47,300,138,162
050,51,730,"Virginia","Petersburg city",2,48,337,155,182
050,51,730,"Virginia","Petersburg city",2,49,389,172,217
050,51,730,"Virginia","Petersburg city",2,50,384,175,209
050,51,730,"Virginia","Petersburg city",2,51,370,160,210
050,51,730,"Virginia","Petersburg city",2,52,417,194,223
050,51,730,"Virginia","Petersburg city",2,53,436,208,228
050,51,730,"Virginia","Petersburg city",2,54,467,221,246
050,51,730,"Virginia","Petersburg city",2,55,501,237,264
050,51,730,"Virginia","Petersburg city",2,56,484,228,256
050,51,730,"Virginia","Petersburg city",2,57,484,235,249
050,51,730,"Virginia","Petersburg city",2,58,472,216,256
050,51,730,"Virginia","Petersburg city",2,59,457,204,253
050,51,730,"Virginia","Petersburg city",2,60,447,207,240
050,51,730,"Virginia","Petersburg city",2,61,435,194,241
050,51,730,"Virginia","Petersburg city",2,62,460,193,267
050,51,730,"Virginia","Petersburg city",2,63,454,179,275
050,51,730,"Virginia","Petersburg city",2,64,427,173,254
050,51,730,"Virginia","Petersburg city",2,65,431,198,233
050,51,730,"Virginia","Petersburg city",2,66,411,193,218
050,51,730,"Virginia","Petersburg city",2,67,385,159,226
050,51,730,"Virginia","Petersburg city",2,68,359,153,206
050,51,730,"Virginia","Petersburg city",2,69,360,159,201
050,51,730,"Virginia","Petersburg city",2,70,324,140,184
050,51,730,"Virginia","Petersburg city",2,71,304,138,166
050,51,730,"Virginia","Petersburg city",2,72,297,131,166
050,51,730,"Virginia","Petersburg city",2,73,308,125,183
050,51,730,"Virginia","Petersburg city",2,74,212,81,131
050,51,730,"Virginia","Petersburg city",2,75,214,84,130
050,51,730,"Virginia","Petersburg city",2,76,229,93,136
050,51,730,"Virginia","Petersburg city",2,77,212,71,141
050,51,730,"Virginia","Petersburg city",2,78,177,63,114
050,51,730,"Virginia","Petersburg city",2,79,160,58,102
050,51,730,"Virginia","Petersburg city",2,80,154,55,99
050,51,730,"Virginia","Petersburg city",2,81,130,49,81
050,51,730,"Virginia","Petersburg city",2,82,118,41,77
050,51,730,"Virginia","Petersburg city",2,83,109,38,71
050,51,730,"Virginia","Petersburg city",2,84,102,32,70
050,51,730,"Virginia","Petersburg city",2,85,622,147,475
050,51,730,"Virginia","Petersburg city",3,0,734,375,359
050,51,730,"Virginia","Petersburg city",3,1,522,254,268
050,51,730,"Virginia","Petersburg city",3,2,479,226,253
050,51,730,"Virginia","Petersburg city",3,3,447,235,212
050,51,730,"Virginia","Petersburg city",3,4,438,226,212
050,51,730,"Virginia","Petersburg city",3,5,462,237,225
050,51,730,"Virginia","Petersburg city",3,6,434,213,221
050,51,730,"Virginia","Petersburg city",3,7,410,212,198
050,51,730,"Virginia","Petersburg city",3,8,395,205,190
050,51,730,"Virginia","Petersburg city",3,9,419,211,208
050,51,730,"Virginia","Petersburg city",3,10,414,231,183
050,51,730,"Virginia","Petersburg city",3,11,393,221,172
050,51,730,"Virginia","Petersburg city",3,12,385,198,187
050,51,730,"Virginia","Petersburg city",3,13,398,197,201
050,51,730,"Virginia","Petersburg city",3,14,385,191,194
050,51,730,"Virginia","Petersburg city",3,15,353,181,172
050,51,730,"Virginia","Petersburg city",3,16,332,173,159
050,51,730,"Virginia","Petersburg city",3,17,329,159,170
050,51,730,"Virginia","Petersburg city",3,18,294,151,143
050,51,730,"Virginia","Petersburg city",3,19,327,162,165
050,51,730,"Virginia","Petersburg city",3,20,372,172,200
050,51,730,"Virginia","Petersburg city",3,21,421,184,237
050,51,730,"Virginia","Petersburg city",3,22,444,188,256
050,51,730,"Virginia","Petersburg city",3,23,522,226,296
050,51,730,"Virginia","Petersburg city",3,24,510,224,286
050,51,730,"Virginia","Petersburg city",3,25,543,231,312
050,51,730,"Virginia","Petersburg city",3,26,561,249,312
050,51,730,"Virginia","Petersburg city",3,27,573,248,325
050,51,730,"Virginia","Petersburg city",3,28,593,265,328
050,51,730,"Virginia","Petersburg city",3,29,579,266,313
050,51,730,"Virginia","Petersburg city",3,30,541,219,322
050,51,730,"Virginia","Petersburg city",3,31,595,262,333
050,51,730,"Virginia","Petersburg city",3,32,487,232,255
050,51,730,"Virginia","Petersburg city",3,33,440,199,241
050,51,730,"Virginia","Petersburg city",3,34,452,208,244
050,51,730,"Virginia","Petersburg city",3,35,454,208,246
050,51,730,"Virginia","Petersburg city",3,36,420,189,231
050,51,730,"Virginia","Petersburg city",3,37,328,136,192
050,51,730,"Virginia","Petersburg city",3,38,360,158,202
050,51,730,"Virginia","Petersburg city",3,39,351,161,190
050,51,730,"Virginia","Petersburg city",3,40,358,172,186
050,51,730,"Virginia","Petersburg city",3,41,372,174,198
050,51,730,"Virginia","Petersburg city",3,42,344,150,194
050,51,730,"Virginia","Petersburg city",3,43,348,165,183
050,51,730,"Virginia","Petersburg city",3,44,328,171,157
050,51,730,"Virginia","Petersburg city",3,45,301,150,151
050,51,730,"Virginia","Petersburg city",3,46,299,146,153
050,51,730,"Virginia","Petersburg city",3,47,300,143,157
050,51,730,"Virginia","Petersburg city",3,48,308,135,173
050,51,730,"Virginia","Petersburg city",3,49,361,160,201
050,51,730,"Virginia","Petersburg city",3,50,393,178,215
050,51,730,"Virginia","Petersburg city",3,51,377,167,210
050,51,730,"Virginia","Petersburg city",3,52,360,146,214
050,51,730,"Virginia","Petersburg city",3,53,420,200,220
050,51,730,"Virginia","Petersburg city",3,54,442,205,237
050,51,730,"Virginia","Petersburg city",3,55,454,213,241
050,51,730,"Virginia","Petersburg city",3,56,506,240,266
050,51,730,"Virginia","Petersburg city",3,57,478,222,256
050,51,730,"Virginia","Petersburg city",3,58,489,230,259
050,51,730,"Virginia","Petersburg city",3,59,469,215,254
050,51,730,"Virginia","Petersburg city",3,60,437,198,239
050,51,730,"Virginia","Petersburg city",3,61,437,202,235
050,51,730,"Virginia","Petersburg city",3,62,417,185,232
050,51,730,"Virginia","Petersburg city",3,63,451,185,266
050,51,730,"Virginia","Petersburg city",3,64,447,169,278
050,51,730,"Virginia","Petersburg city",3,65,414,161,253
050,51,730,"Virginia","Petersburg city",3,66,416,191,225
050,51,730,"Virginia","Petersburg city",3,67,401,191,210
050,51,730,"Virginia","Petersburg city",3,68,362,148,214
050,51,730,"Virginia","Petersburg city",3,69,347,145,202
050,51,730,"Virginia","Petersburg city",3,70,337,148,189
050,51,730,"Virginia","Petersburg city",3,71,315,143,172
050,51,730,"Virginia","Petersburg city",3,72,282,126,156
050,51,730,"Virginia","Petersburg city",3,73,289,124,165
050,51,730,"Virginia","Petersburg city",3,74,295,115,180
050,51,730,"Virginia","Petersburg city",3,75,186,66,120
050,51,730,"Virginia","Petersburg city",3,76,200,75,125
050,51,730,"Virginia","Petersburg city",3,77,212,84,128
050,51,730,"Virginia","Petersburg city",3,78,198,71,127
050,51,730,"Virginia","Petersburg city",3,79,157,52,105
050,51,730,"Virginia","Petersburg city",3,80,150,54,96
050,51,730,"Virginia","Petersburg city",3,81,135,44,91
050,51,730,"Virginia","Petersburg city",3,82,127,47,80
050,51,730,"Virginia","Petersburg city",3,83,109,40,69
050,51,730,"Virginia","Petersburg city",3,84,90,27,63
050,51,730,"Virginia","Petersburg city",3,85,597,141,456
050,51,730,"Virginia","Petersburg city",4,0,727,387,340
050,51,730,"Virginia","Petersburg city",4,1,668,343,325
050,51,730,"Virginia","Petersburg city",4,2,528,259,269
050,51,730,"Virginia","Petersburg city",4,3,488,239,249
050,51,730,"Virginia","Petersburg city",4,4,439,228,211
050,51,730,"Virginia","Petersburg city",4,5,424,227,197
050,51,730,"Virginia","Petersburg city",4,6,445,225,220
050,51,730,"Virginia","Petersburg city",4,7,443,211,232
050,51,730,"Virginia","Petersburg city",4,8,403,210,193
050,51,730,"Virginia","Petersburg city",4,9,381,186,195
050,51,730,"Virginia","Petersburg city",4,10,420,214,206
050,51,730,"Virginia","Petersburg city",4,11,419,234,185
050,51,730,"Virginia","Petersburg city",4,12,406,228,178
050,51,730,"Virginia","Petersburg city",4,13,392,196,196
050,51,730,"Virginia","Petersburg city",4,14,399,194,205
050,51,730,"Virginia","Petersburg city",4,15,403,195,208
050,51,730,"Virginia","Petersburg city",4,16,362,184,178
050,51,730,"Virginia","Petersburg city",4,17,344,179,165
050,51,730,"Virginia","Petersburg city",4,18,288,140,148
050,51,730,"Virginia","Petersburg city",4,19,277,135,142
050,51,730,"Virginia","Petersburg city",4,20,351,157,194
050,51,730,"Virginia","Petersburg city",4,21,385,166,219
050,51,730,"Virginia","Petersburg city",4,22,465,184,281
050,51,730,"Virginia","Petersburg city",4,23,493,227,266
050,51,730,"Virginia","Petersburg city",4,24,487,214,273
050,51,730,"Virginia","Petersburg city",4,25,477,222,255
050,51,730,"Virginia","Petersburg city",4,26,540,240,300
050,51,730,"Virginia","Petersburg city",4,27,541,231,310
050,51,730,"Virginia","Petersburg city",4,28,564,261,303
050,51,730,"Virginia","Petersburg city",4,29,566,256,310
050,51,730,"Virginia","Petersburg city",4,30,550,245,305
050,51,730,"Virginia","Petersburg city",4,31,542,220,322
050,51,730,"Virginia","Petersburg city",4,32,583,257,326
050,51,730,"Virginia","Petersburg city",4,33,482,210,272
050,51,730,"Virginia","Petersburg city",4,34,441,192,249
050,51,730,"Virginia","Petersburg city",4,35,449,208,241
050,51,730,"Virginia","Petersburg city",4,36,461,210,251
050,51,730,"Virginia","Petersburg city",4,37,409,172,237
050,51,730,"Virginia","Petersburg city",4,38,359,147,212
050,51,730,"Virginia","Petersburg city",4,39,377,164,213
050,51,730,"Virginia","Petersburg city",4,40,347,161,186
050,51,730,"Virginia","Petersburg city",4,41,352,150,202
050,51,730,"Virginia","Petersburg city",4,42,372,175,197
050,51,730,"Virginia","Petersburg city",4,43,373,173,200
050,51,730,"Virginia","Petersburg city",4,44,330,154,176
050,51,730,"Virginia","Petersburg city",4,45,324,161,163
050,51,730,"Virginia","Petersburg city",4,46,291,143,148
050,51,730,"Virginia","Petersburg city",4,47,290,136,154
050,51,730,"Virginia","Petersburg city",4,48,295,140,155
050,51,730,"Virginia","Petersburg city",4,49,299,118,181
050,51,730,"Virginia","Petersburg city",4,50,357,154,203
050,51,730,"Virginia","Petersburg city",4,51,385,175,210
050,51,730,"Virginia","Petersburg city",4,52,362,153,209
050,51,730,"Virginia","Petersburg city",4,53,366,155,211
050,51,730,"Virginia","Petersburg city",4,54,419,203,216
050,51,730,"Virginia","Petersburg city",4,55,443,200,243
050,51,730,"Virginia","Petersburg city",4,56,428,195,233
050,51,730,"Virginia","Petersburg city",4,57,496,240,256
050,51,730,"Virginia","Petersburg city",4,58,464,214,250
050,51,730,"Virginia","Petersburg city",4,59,506,243,263
050,51,730,"Virginia","Petersburg city",4,60,456,207,249
050,51,730,"Virginia","Petersburg city",4,61,431,190,241
050,51,730,"Virginia","Petersburg city",4,62,406,180,226
050,51,730,"Virginia","Petersburg city",4,63,416,191,225
050,51,730,"Virginia","Petersburg city",4,64,443,175,268
050,51,730,"Virginia","Petersburg city",4,65,437,156,281
050,51,730,"Virginia","Petersburg city",4,66,385,150,235
050,51,730,"Virginia","Petersburg city",4,67,400,178,222
050,51,730,"Virginia","Petersburg city",4,68,381,180,201
050,51,730,"Virginia","Petersburg city",4,69,350,141,209
050,51,730,"Virginia","Petersburg city",4,70,332,136,196
050,51,730,"Virginia","Petersburg city",4,71,325,149,176
050,51,730,"Virginia","Petersburg city",4,72,296,133,163
050,51,730,"Virginia","Petersburg city",4,73,274,121,153
050,51,730,"Virginia","Petersburg city",4,74,269,117,152
050,51,730,"Virginia","Petersburg city",4,75,267,99,168
050,51,730,"Virginia","Petersburg city",4,76,167,54,113
050,51,730,"Virginia","Petersburg city",4,77,192,68,124
050,51,730,"Virginia","Petersburg city",4,78,203,83,120
050,51,730,"Virginia","Petersburg city",4,79,172,61,111
050,51,730,"Virginia","Petersburg city",4,80,149,49,100
050,51,730,"Virginia","Petersburg city",4,81,134,46,88
050,51,730,"Virginia","Petersburg city",4,82,125,41,84
050,51,730,"Virginia","Petersburg city",4,83,110,44,66
050,51,730,"Virginia","Petersburg city",4,84,89,31,58
050,51,730,"Virginia","Petersburg city",4,85,576,134,442
050,51,730,"Virginia","Petersburg city",5,0,731,390,341
050,51,730,"Virginia","Petersburg city",5,1,610,304,306
050,51,730,"Virginia","Petersburg city",5,2,628,338,290
050,51,730,"Virginia","Petersburg city",5,3,520,252,268
050,51,730,"Virginia","Petersburg city",5,4,446,209,237
050,51,730,"Virginia","Petersburg city",5,5,434,232,202
050,51,730,"Virginia","Petersburg city",5,6,405,214,191
050,51,730,"Virginia","Petersburg city",5,7,434,219,215
050,51,730,"Virginia","Petersburg city",5,8,450,212,238
050,51,730,"Virginia","Petersburg city",5,9,395,200,195
050,51,730,"Virginia","Petersburg city",5,10,403,201,202
050,51,730,"Virginia","Petersburg city",5,11,412,209,203
050,51,730,"Virginia","Petersburg city",5,12,418,233,185
050,51,730,"Virginia","Petersburg city",5,13,402,221,181
050,51,730,"Virginia","Petersburg city",5,14,408,201,207
050,51,730,"Virginia","Petersburg city",5,15,403,205,198
050,51,730,"Virginia","Petersburg city",5,16,418,209,209
050,51,730,"Virginia","Petersburg city",5,17,364,189,175
050,51,730,"Virginia","Petersburg city",5,18,316,171,145
050,51,730,"Virginia","Petersburg city",5,19,286,135,151
050,51,730,"Virginia","Petersburg city",5,20,306,141,165
050,51,730,"Virginia","Petersburg city",5,21,382,183,199
050,51,730,"Virginia","Petersburg city",5,22,375,162,213
050,51,730,"Virginia","Petersburg city",5,23,508,205,303
050,51,730,"Virginia","Petersburg city",5,24,482,215,267
050,51,730,"Virginia","Petersburg city",5,25,496,223,273
050,51,730,"Virginia","Petersburg city",5,26,488,218,270
050,51,730,"Virginia","Petersburg city",5,27,477,209,268
050,51,730,"Virginia","Petersburg city",5,28,516,222,294
050,51,730,"Virginia","Petersburg city",5,29,582,262,320
050,51,730,"Virginia","Petersburg city",5,30,564,260,304
050,51,730,"Virginia","Petersburg city",5,31,551,239,312
050,51,730,"Virginia","Petersburg city",5,32,511,209,302
050,51,730,"Virginia","Petersburg city",5,33,547,234,313
050,51,730,"Virginia","Petersburg city",5,34,494,222,272
050,51,730,"Virginia","Petersburg city",5,35,430,187,243
050,51,730,"Virginia","Petersburg city",5,36,428,201,227
050,51,730,"Virginia","Petersburg city",5,37,443,220,223
050,51,730,"Virginia","Petersburg city",5,38,408,163,245
050,51,730,"Virginia","Petersburg city",5,39,341,144,197
050,51,730,"Virginia","Petersburg city",5,40,380,166,214
050,51,730,"Virginia","Petersburg city",5,41,361,157,204
050,51,730,"Virginia","Petersburg city",5,42,336,145,191
050,51,730,"Virginia","Petersburg city",5,43,397,185,212
050,51,730,"Virginia","Petersburg city",5,44,364,166,198
050,51,730,"Virginia","Petersburg city",5,45,327,149,178
050,51,730,"Virginia","Petersburg city",5,46,319,148,171
050,51,730,"Virginia","Petersburg city",5,47,283,127,156
050,51,730,"Virginia","Petersburg city",5,48,300,136,164
050,51,730,"Virginia","Petersburg city",5,49,285,125,160
050,51,730,"Virginia","Petersburg city",5,50,281,107,174
050,51,730,"Virginia","Petersburg city",5,51,349,144,205
050,51,730,"Virginia","Petersburg city",5,52,384,179,205
050,51,730,"Virginia","Petersburg city",5,53,354,156,198
050,51,730,"Virginia","Petersburg city",5,54,370,156,214
050,51,730,"Virginia","Petersburg city",5,55,383,175,208
050,51,730,"Virginia","Petersburg city",5,56,433,200,233
050,51,730,"Virginia","Petersburg city",5,57,428,192,236
050,51,730,"Virginia","Petersburg city",5,58,499,241,258
050,51,730,"Virginia","Petersburg city",5,59,463,214,249
050,51,730,"Virginia","Petersburg city",5,60,490,236,254
050,51,730,"Virginia","Petersburg city",5,61,425,191,234
050,51,730,"Virginia","Petersburg city",5,62,430,187,243
050,51,730,"Virginia","Petersburg city",5,63,397,167,230
050,51,730,"Virginia","Petersburg city",5,64,403,174,229
050,51,730,"Virginia","Petersburg city",5,65,446,168,278
050,51,730,"Virginia","Petersburg city",5,66,417,141,276
050,51,730,"Virginia","Petersburg city",5,67,367,137,230
050,51,730,"Virginia","Petersburg city",5,68,383,170,213
050,51,730,"Virginia","Petersburg city",5,69,366,175,191
050,51,730,"Virginia","Petersburg city",5,70,320,127,193
050,51,730,"Virginia","Petersburg city",5,71,319,137,182
050,51,730,"Virginia","Petersburg city",5,72,311,140,171
050,51,730,"Virginia","Petersburg city",5,73,289,130,159
050,51,730,"Virginia","Petersburg city",5,74,252,110,142
050,51,730,"Virginia","Petersburg city",5,75,245,101,144
050,51,730,"Virginia","Petersburg city",5,76,241,87,154
050,51,730,"Virginia","Petersburg city",5,77,160,49,111
050,51,730,"Virginia","Petersburg city",5,78,180,68,112
050,51,730,"Virginia","Petersburg city",5,79,184,76,108
050,51,730,"Virginia","Petersburg city",5,80,157,55,102
050,51,730,"Virginia","Petersburg city",5,81,131,38,93
050,51,730,"Virginia","Petersburg city",5,82,127,42,85
050,51,730,"Virginia","Petersburg city",5,83,112,38,74
050,51,730,"Virginia","Petersburg city",5,84,91,38,53
050,51,730,"Virginia","Petersburg city",5,85,558,136,422
050,51,735,"Virginia","Poquoson city",1,0,97,49,48
050,51,735,"Virginia","Poquoson city",1,1,104,54,50
050,51,735,"Virginia","Poquoson city",1,2,104,48,56
050,51,735,"Virginia","Poquoson city",1,3,132,80,52
050,51,735,"Virginia","Poquoson city",1,4,119,59,60
050,51,735,"Virginia","Poquoson city",1,5,157,87,70
050,51,735,"Virginia","Poquoson city",1,6,149,80,69
050,51,735,"Virginia","Poquoson city",1,7,141,71,70
050,51,735,"Virginia","Poquoson city",1,8,178,89,89
050,51,735,"Virginia","Poquoson city",1,9,170,74,96
050,51,735,"Virginia","Poquoson city",1,10,162,79,83
050,51,735,"Virginia","Poquoson city",1,11,191,101,90
050,51,735,"Virginia","Poquoson city",1,12,189,100,89
050,51,735,"Virginia","Poquoson city",1,13,189,91,98
050,51,735,"Virginia","Poquoson city",1,14,188,90,98
050,51,735,"Virginia","Poquoson city",1,15,216,108,108
050,51,735,"Virginia","Poquoson city",1,16,196,105,91
050,51,735,"Virginia","Poquoson city",1,17,184,99,85
050,51,735,"Virginia","Poquoson city",1,18,149,74,75
050,51,735,"Virginia","Poquoson city",1,19,116,65,51
050,51,735,"Virginia","Poquoson city",1,20,116,65,51
050,51,735,"Virginia","Poquoson city",1,21,140,78,62
050,51,735,"Virginia","Poquoson city",1,22,134,76,58
050,51,735,"Virginia","Poquoson city",1,23,127,67,60
050,51,735,"Virginia","Poquoson city",1,24,111,59,52
050,51,735,"Virginia","Poquoson city",1,25,108,60,48
050,51,735,"Virginia","Poquoson city",1,26,119,65,54
050,51,735,"Virginia","Poquoson city",1,27,98,57,41
050,51,735,"Virginia","Poquoson city",1,28,121,64,57
050,51,735,"Virginia","Poquoson city",1,29,125,66,59
050,51,735,"Virginia","Poquoson city",1,30,119,63,56
050,51,735,"Virginia","Poquoson city",1,31,130,73,57
050,51,735,"Virginia","Poquoson city",1,32,131,76,55
050,51,735,"Virginia","Poquoson city",1,33,137,68,69
050,51,735,"Virginia","Poquoson city",1,34,153,72,81
050,51,735,"Virginia","Poquoson city",1,35,160,79,81
050,51,735,"Virginia","Poquoson city",1,36,192,89,103
050,51,735,"Virginia","Poquoson city",1,37,185,98,87
050,51,735,"Virginia","Poquoson city",1,38,164,90,74
050,51,735,"Virginia","Poquoson city",1,39,173,91,82
050,51,735,"Virginia","Poquoson city",1,40,179,92,87
050,51,735,"Virginia","Poquoson city",1,41,170,81,89
050,51,735,"Virginia","Poquoson city",1,42,154,81,73
050,51,735,"Virginia","Poquoson city",1,43,163,81,82
050,51,735,"Virginia","Poquoson city",1,44,148,69,79
050,51,735,"Virginia","Poquoson city",1,45,143,71,72
050,51,735,"Virginia","Poquoson city",1,46,157,79,78
050,51,735,"Virginia","Poquoson city",1,47,166,82,84
050,51,735,"Virginia","Poquoson city",1,48,174,92,82
050,51,735,"Virginia","Poquoson city",1,49,163,84,79
050,51,735,"Virginia","Poquoson city",1,50,165,77,88
050,51,735,"Virginia","Poquoson city",1,51,156,82,74
050,51,735,"Virginia","Poquoson city",1,52,159,72,87
050,51,735,"Virginia","Poquoson city",1,53,157,74,83
050,51,735,"Virginia","Poquoson city",1,54,179,95,84
050,51,735,"Virginia","Poquoson city",1,55,193,106,87
050,51,735,"Virginia","Poquoson city",1,56,200,104,96
050,51,735,"Virginia","Poquoson city",1,57,212,112,100
050,51,735,"Virginia","Poquoson city",1,58,193,95,98
050,51,735,"Virginia","Poquoson city",1,59,169,87,82
050,51,735,"Virginia","Poquoson city",1,60,157,68,89
050,51,735,"Virginia","Poquoson city",1,61,159,74,85
050,51,735,"Virginia","Poquoson city",1,62,155,77,78
050,51,735,"Virginia","Poquoson city",1,63,159,81,78
050,51,735,"Virginia","Poquoson city",1,64,155,82,73
050,51,735,"Virginia","Poquoson city",1,65,139,69,70
050,51,735,"Virginia","Poquoson city",1,66,148,62,86
050,51,735,"Virginia","Poquoson city",1,67,129,65,64
050,51,735,"Virginia","Poquoson city",1,68,144,74,70
050,51,735,"Virginia","Poquoson city",1,69,129,74,55
050,51,735,"Virginia","Poquoson city",1,70,123,56,67
050,51,735,"Virginia","Poquoson city",1,71,118,54,64
050,51,735,"Virginia","Poquoson city",1,72,144,63,81
050,51,735,"Virginia","Poquoson city",1,73,160,76,84
050,51,735,"Virginia","Poquoson city",1,74,106,54,52
050,51,735,"Virginia","Poquoson city",1,75,115,61,54
050,51,735,"Virginia","Poquoson city",1,76,109,55,54
050,51,735,"Virginia","Poquoson city",1,77,99,45,54
050,51,735,"Virginia","Poquoson city",1,78,82,34,48
050,51,735,"Virginia","Poquoson city",1,79,78,36,42
050,51,735,"Virginia","Poquoson city",1,80,70,38,32
050,51,735,"Virginia","Poquoson city",1,81,71,31,40
050,51,735,"Virginia","Poquoson city",1,82,64,29,35
050,51,735,"Virginia","Poquoson city",1,83,55,26,29
050,51,735,"Virginia","Poquoson city",1,84,54,25,29
050,51,735,"Virginia","Poquoson city",1,85,260,93,167
050,51,735,"Virginia","Poquoson city",2,0,103,52,51
050,51,735,"Virginia","Poquoson city",2,1,102,51,51
050,51,735,"Virginia","Poquoson city",2,2,106,50,56
050,51,735,"Virginia","Poquoson city",2,3,127,72,55
050,51,735,"Virginia","Poquoson city",2,4,126,65,61
050,51,735,"Virginia","Poquoson city",2,5,151,81,70
050,51,735,"Virginia","Poquoson city",2,6,151,81,70
050,51,735,"Virginia","Poquoson city",2,7,145,75,70
050,51,735,"Virginia","Poquoson city",2,8,170,85,85
050,51,735,"Virginia","Poquoson city",2,9,173,79,94
050,51,735,"Virginia","Poquoson city",2,10,169,81,88
050,51,735,"Virginia","Poquoson city",2,11,186,97,89
050,51,735,"Virginia","Poquoson city",2,12,194,102,92
050,51,735,"Virginia","Poquoson city",2,13,191,92,99
050,51,735,"Virginia","Poquoson city",2,14,190,91,99
050,51,735,"Virginia","Poquoson city",2,15,207,101,106
050,51,735,"Virginia","Poquoson city",2,16,202,106,96
050,51,735,"Virginia","Poquoson city",2,17,187,99,88
050,51,735,"Virginia","Poquoson city",2,18,149,76,73
050,51,735,"Virginia","Poquoson city",2,19,115,62,53
050,51,735,"Virginia","Poquoson city",2,20,117,65,52
050,51,735,"Virginia","Poquoson city",2,21,135,76,59
050,51,735,"Virginia","Poquoson city",2,22,134,75,59
050,51,735,"Virginia","Poquoson city",2,23,126,68,58
050,51,735,"Virginia","Poquoson city",2,24,111,59,52
050,51,735,"Virginia","Poquoson city",2,25,108,58,50
050,51,735,"Virginia","Poquoson city",2,26,113,62,51
050,51,735,"Virginia","Poquoson city",2,27,102,58,44
050,51,735,"Virginia","Poquoson city",2,28,114,61,53
050,51,735,"Virginia","Poquoson city",2,29,125,67,58
050,51,735,"Virginia","Poquoson city",2,30,124,65,59
050,51,735,"Virginia","Poquoson city",2,31,128,72,56
050,51,735,"Virginia","Poquoson city",2,32,134,76,58
050,51,735,"Virginia","Poquoson city",2,33,136,69,67
050,51,735,"Virginia","Poquoson city",2,34,153,73,80
050,51,735,"Virginia","Poquoson city",2,35,164,81,83
050,51,735,"Virginia","Poquoson city",2,36,188,90,98
050,51,735,"Virginia","Poquoson city",2,37,188,97,91
050,51,735,"Virginia","Poquoson city",2,38,170,92,78
050,51,735,"Virginia","Poquoson city",2,39,171,90,81
050,51,735,"Virginia","Poquoson city",2,40,178,93,85
050,51,735,"Virginia","Poquoson city",2,41,173,85,88
050,51,735,"Virginia","Poquoson city",2,42,161,84,77
050,51,735,"Virginia","Poquoson city",2,43,165,83,82
050,51,735,"Virginia","Poquoson city",2,44,149,70,79
050,51,735,"Virginia","Poquoson city",2,45,145,71,74
050,51,735,"Virginia","Poquoson city",2,46,155,78,77
050,51,735,"Virginia","Poquoson city",2,47,164,81,83
050,51,735,"Virginia","Poquoson city",2,48,172,89,83
050,51,735,"Virginia","Poquoson city",2,49,170,89,81
050,51,735,"Virginia","Poquoson city",2,50,163,79,84
050,51,735,"Virginia","Poquoson city",2,51,156,79,77
050,51,735,"Virginia","Poquoson city",2,52,158,74,84
050,51,735,"Virginia","Poquoson city",2,53,157,73,84
050,51,735,"Virginia","Poquoson city",2,54,173,90,83
050,51,735,"Virginia","Poquoson city",2,55,186,102,84
050,51,735,"Virginia","Poquoson city",2,56,199,105,94
050,51,735,"Virginia","Poquoson city",2,57,208,110,98
050,51,735,"Virginia","Poquoson city",2,58,193,97,96
050,51,735,"Virginia","Poquoson city",2,59,172,88,84
050,51,735,"Virginia","Poquoson city",2,60,158,71,87
050,51,735,"Virginia","Poquoson city",2,61,157,71,86
050,51,735,"Virginia","Poquoson city",2,62,156,77,79
050,51,735,"Virginia","Poquoson city",2,63,158,80,78
050,51,735,"Virginia","Poquoson city",2,64,152,80,72
050,51,735,"Virginia","Poquoson city",2,65,140,70,70
050,51,735,"Virginia","Poquoson city",2,66,144,63,81
050,51,735,"Virginia","Poquoson city",2,67,133,65,68
050,51,735,"Virginia","Poquoson city",2,68,139,71,68
050,51,735,"Virginia","Poquoson city",2,69,133,74,59
050,51,735,"Virginia","Poquoson city",2,70,124,59,65
050,51,735,"Virginia","Poquoson city",2,71,121,55,66
050,51,735,"Virginia","Poquoson city",2,72,138,60,78
050,51,735,"Virginia","Poquoson city",2,73,162,77,85
050,51,735,"Virginia","Poquoson city",2,74,112,56,56
050,51,735,"Virginia","Poquoson city",2,75,112,59,53
050,51,735,"Virginia","Poquoson city",2,76,106,55,51
050,51,735,"Virginia","Poquoson city",2,77,101,46,55
050,51,735,"Virginia","Poquoson city",2,78,84,36,48
050,51,735,"Virginia","Poquoson city",2,79,80,37,43
050,51,735,"Virginia","Poquoson city",2,80,71,37,34
050,51,735,"Virginia","Poquoson city",2,81,68,31,37
050,51,735,"Virginia","Poquoson city",2,82,64,29,35
050,51,735,"Virginia","Poquoson city",2,83,56,26,30
050,51,735,"Virginia","Poquoson city",2,84,55,26,29
050,51,735,"Virginia","Poquoson city",2,85,267,95,172
050,51,735,"Virginia","Poquoson city",3,0,130,61,69
050,51,735,"Virginia","Poquoson city",3,1,96,52,44
050,51,735,"Virginia","Poquoson city",3,2,122,64,58
050,51,735,"Virginia","Poquoson city",3,3,111,48,63
050,51,735,"Virginia","Poquoson city",3,4,154,92,62
050,51,735,"Virginia","Poquoson city",3,5,122,63,59
050,51,735,"Virginia","Poquoson city",3,6,177,95,82
050,51,735,"Virginia","Poquoson city",3,7,153,76,77
050,51,735,"Virginia","Poquoson city",3,8,151,75,76
050,51,735,"Virginia","Poquoson city",3,9,193,100,93
050,51,735,"Virginia","Poquoson city",3,10,175,78,97
050,51,735,"Virginia","Poquoson city",3,11,177,79,98
050,51,735,"Virginia","Poquoson city",3,12,192,103,89
050,51,735,"Virginia","Poquoson city",3,13,199,105,94
050,51,735,"Virginia","Poquoson city",3,14,192,97,95
050,51,735,"Virginia","Poquoson city",3,15,191,97,94
050,51,735,"Virginia","Poquoson city",3,16,207,101,106
050,51,735,"Virginia","Poquoson city",3,17,194,102,92
050,51,735,"Virginia","Poquoson city",3,18,152,80,72
050,51,735,"Virginia","Poquoson city",3,19,109,54,55
050,51,735,"Virginia","Poquoson city",3,20,124,69,55
050,51,735,"Virginia","Poquoson city",3,21,120,66,54
050,51,735,"Virginia","Poquoson city",3,22,148,80,68
050,51,735,"Virginia","Poquoson city",3,23,139,73,66
050,51,735,"Virginia","Poquoson city",3,24,115,58,57
050,51,735,"Virginia","Poquoson city",3,25,108,61,47
050,51,735,"Virginia","Poquoson city",3,26,113,65,48
050,51,735,"Virginia","Poquoson city",3,27,100,53,47
050,51,735,"Virginia","Poquoson city",3,28,100,51,49
050,51,735,"Virginia","Poquoson city",3,29,111,57,54
050,51,735,"Virginia","Poquoson city",3,30,146,75,71
050,51,735,"Virginia","Poquoson city",3,31,136,63,73
050,51,735,"Virginia","Poquoson city",3,32,144,78,66
050,51,735,"Virginia","Poquoson city",3,33,154,87,67
050,51,735,"Virginia","Poquoson city",3,34,135,67,68
050,51,735,"Virginia","Poquoson city",3,35,163,73,90
050,51,735,"Virginia","Poquoson city",3,36,180,90,90
050,51,735,"Virginia","Poquoson city",3,37,187,89,98
050,51,735,"Virginia","Poquoson city",3,38,207,104,103
050,51,735,"Virginia","Poquoson city",3,39,173,92,81
050,51,735,"Virginia","Poquoson city",3,40,186,101,85
050,51,735,"Virginia","Poquoson city",3,41,184,97,87
050,51,735,"Virginia","Poquoson city",3,42,170,77,93
050,51,735,"Virginia","Poquoson city",3,43,159,91,68
050,51,735,"Virginia","Poquoson city",3,44,176,86,90
050,51,735,"Virginia","Poquoson city",3,45,149,74,75
050,51,735,"Virginia","Poquoson city",3,46,148,71,77
050,51,735,"Virginia","Poquoson city",3,47,156,78,78
050,51,735,"Virginia","Poquoson city",3,48,168,79,89
050,51,735,"Virginia","Poquoson city",3,49,175,93,82
050,51,735,"Virginia","Poquoson city",3,50,169,94,75
050,51,735,"Virginia","Poquoson city",3,51,167,81,86
050,51,735,"Virginia","Poquoson city",3,52,151,79,72
050,51,735,"Virginia","Poquoson city",3,53,154,69,85
050,51,735,"Virginia","Poquoson city",3,54,159,72,87
050,51,735,"Virginia","Poquoson city",3,55,169,86,83
050,51,735,"Virginia","Poquoson city",3,56,178,94,84
050,51,735,"Virginia","Poquoson city",3,57,195,107,88
050,51,735,"Virginia","Poquoson city",3,58,204,109,95
050,51,735,"Virginia","Poquoson city",3,59,185,91,94
050,51,735,"Virginia","Poquoson city",3,60,173,87,86
050,51,735,"Virginia","Poquoson city",3,61,156,69,87
050,51,735,"Virginia","Poquoson city",3,62,163,71,92
050,51,735,"Virginia","Poquoson city",3,63,154,81,73
050,51,735,"Virginia","Poquoson city",3,64,163,83,80
050,51,735,"Virginia","Poquoson city",3,65,143,80,63
050,51,735,"Virginia","Poquoson city",3,66,142,71,71
050,51,735,"Virginia","Poquoson city",3,67,137,59,78
050,51,735,"Virginia","Poquoson city",3,68,130,65,65
050,51,735,"Virginia","Poquoson city",3,69,139,73,66
050,51,735,"Virginia","Poquoson city",3,70,128,67,61
050,51,735,"Virginia","Poquoson city",3,71,121,60,61
050,51,735,"Virginia","Poquoson city",3,72,118,49,69
050,51,735,"Virginia","Poquoson city",3,73,132,58,74
050,51,735,"Virginia","Poquoson city",3,74,162,77,85
050,51,735,"Virginia","Poquoson city",3,75,110,55,55
050,51,735,"Virginia","Poquoson city",3,76,106,55,51
050,51,735,"Virginia","Poquoson city",3,77,99,50,49
050,51,735,"Virginia","Poquoson city",3,78,100,46,54
050,51,735,"Virginia","Poquoson city",3,79,73,33,40
050,51,735,"Virginia","Poquoson city",3,80,73,34,39
050,51,735,"Virginia","Poquoson city",3,81,61,32,29
050,51,735,"Virginia","Poquoson city",3,82,60,25,35
050,51,735,"Virginia","Poquoson city",3,83,59,28,31
050,51,735,"Virginia","Poquoson city",3,84,50,23,27
050,51,735,"Virginia","Poquoson city",3,85,274,108,166
050,51,735,"Virginia","Poquoson city",4,0,132,62,70
050,51,735,"Virginia","Poquoson city",4,1,136,64,72
050,51,735,"Virginia","Poquoson city",4,2,106,59,47
050,51,735,"Virginia","Poquoson city",4,3,132,69,63
050,51,735,"Virginia","Poquoson city",4,4,118,50,68
050,51,735,"Virginia","Poquoson city",4,5,153,89,64
050,51,735,"Virginia","Poquoson city",4,6,135,66,69
050,51,735,"Virginia","Poquoson city",4,7,191,98,93
050,51,735,"Virginia","Poquoson city",4,8,158,80,78
050,51,735,"Virginia","Poquoson city",4,9,156,80,76
050,51,735,"Virginia","Poquoson city",4,10,196,95,101
050,51,735,"Virginia","Poquoson city",4,11,167,78,89
050,51,735,"Virginia","Poquoson city",4,12,175,84,91
050,51,735,"Virginia","Poquoson city",4,13,188,103,85
050,51,735,"Virginia","Poquoson city",4,14,189,105,84
050,51,735,"Virginia","Poquoson city",4,15,195,99,96
050,51,735,"Virginia","Poquoson city",4,16,190,92,98
050,51,735,"Virginia","Poquoson city",4,17,206,103,103
050,51,735,"Virginia","Poquoson city",4,18,168,91,77
050,51,735,"Virginia","Poquoson city",4,19,113,58,55
050,51,735,"Virginia","Poquoson city",4,20,112,52,60
050,51,735,"Virginia","Poquoson city",4,21,131,68,63
050,51,735,"Virginia","Poquoson city",4,22,115,68,47
050,51,735,"Virginia","Poquoson city",4,23,150,87,63
050,51,735,"Virginia","Poquoson city",4,24,123,67,56
050,51,735,"Virginia","Poquoson city",4,25,110,58,52
050,51,735,"Virginia","Poquoson city",4,26,93,54,39
050,51,735,"Virginia","Poquoson city",4,27,117,66,51
050,51,735,"Virginia","Poquoson city",4,28,111,56,55
050,51,735,"Virginia","Poquoson city",4,29,100,52,48
050,51,735,"Virginia","Poquoson city",4,30,120,57,63
050,51,735,"Virginia","Poquoson city",4,31,158,79,79
050,51,735,"Virginia","Poquoson city",4,32,143,67,76
050,51,735,"Virginia","Poquoson city",4,33,144,76,68
050,51,735,"Virginia","Poquoson city",4,34,163,94,69
050,51,735,"Virginia","Poquoson city",4,35,147,70,77
050,51,735,"Virginia","Poquoson city",4,36,170,69,101
050,51,735,"Virginia","Poquoson city",4,37,178,94,84
050,51,735,"Virginia","Poquoson city",4,38,192,92,100
050,51,735,"Virginia","Poquoson city",4,39,219,113,106
050,51,735,"Virginia","Poquoson city",4,40,180,93,87
050,51,735,"Virginia","Poquoson city",4,41,197,103,94
050,51,735,"Virginia","Poquoson city",4,42,180,99,81
050,51,735,"Virginia","Poquoson city",4,43,168,77,91
050,51,735,"Virginia","Poquoson city",4,44,161,93,68
050,51,735,"Virginia","Poquoson city",4,45,175,91,84
050,51,735,"Virginia","Poquoson city",4,46,150,74,76
050,51,735,"Virginia","Poquoson city",4,47,151,72,79
050,51,735,"Virginia","Poquoson city",4,48,158,77,81
050,51,735,"Virginia","Poquoson city",4,49,160,77,83
050,51,735,"Virginia","Poquoson city",4,50,167,86,81
050,51,735,"Virginia","Poquoson city",4,51,166,87,79
050,51,735,"Virginia","Poquoson city",4,52,163,79,84
050,51,735,"Virginia","Poquoson city",4,53,152,73,79
050,51,735,"Virginia","Poquoson city",4,54,149,67,82
050,51,735,"Virginia","Poquoson city",4,55,159,72,87
050,51,735,"Virginia","Poquoson city",4,56,165,86,79
050,51,735,"Virginia","Poquoson city",4,57,183,98,85
050,51,735,"Virginia","Poquoson city",4,58,193,104,89
050,51,735,"Virginia","Poquoson city",4,59,203,109,94
050,51,735,"Virginia","Poquoson city",4,60,173,84,89
050,51,735,"Virginia","Poquoson city",4,61,167,82,85
050,51,735,"Virginia","Poquoson city",4,62,153,71,82
050,51,735,"Virginia","Poquoson city",4,63,160,69,91
050,51,735,"Virginia","Poquoson city",4,64,149,80,69
050,51,735,"Virginia","Poquoson city",4,65,159,80,79
050,51,735,"Virginia","Poquoson city",4,66,132,72,60
050,51,735,"Virginia","Poquoson city",4,67,137,68,69
050,51,735,"Virginia","Poquoson city",4,68,137,60,77
050,51,735,"Virginia","Poquoson city",4,69,128,62,66
050,51,735,"Virginia","Poquoson city",4,70,131,71,60
050,51,735,"Virginia","Poquoson city",4,71,129,66,63
050,51,735,"Virginia","Poquoson city",4,72,119,56,63
050,51,735,"Virginia","Poquoson city",4,73,116,50,66
050,51,735,"Virginia","Poquoson city",4,74,127,57,70
050,51,735,"Virginia","Poquoson city",4,75,151,70,81
050,51,735,"Virginia","Poquoson city",4,76,105,52,53
050,51,735,"Virginia","Poquoson city",4,77,104,54,50
050,51,735,"Virginia","Poquoson city",4,78,92,46,46
050,51,735,"Virginia","Poquoson city",4,79,98,47,51
050,51,735,"Virginia","Poquoson city",4,80,68,31,37
050,51,735,"Virginia","Poquoson city",4,81,59,26,33
050,51,735,"Virginia","Poquoson city",4,82,56,28,28
050,51,735,"Virginia","Poquoson city",4,83,57,22,35
050,51,735,"Virginia","Poquoson city",4,84,53,24,29
050,51,735,"Virginia","Poquoson city",4,85,284,115,169
050,51,735,"Virginia","Poquoson city",5,0,130,62,68
050,51,735,"Virginia","Poquoson city",5,1,128,72,56
050,51,735,"Virginia","Poquoson city",5,2,144,66,78
050,51,735,"Virginia","Poquoson city",5,3,116,65,51
050,51,735,"Virginia","Poquoson city",5,4,149,79,70
050,51,735,"Virginia","Poquoson city",5,5,125,58,67
050,51,735,"Virginia","Poquoson city",5,6,165,92,73
050,51,735,"Virginia","Poquoson city",5,7,151,82,69
050,51,735,"Virginia","Poquoson city",5,8,202,108,94
050,51,735,"Virginia","Poquoson city",5,9,167,80,87
050,51,735,"Virginia","Poquoson city",5,10,162,86,76
050,51,735,"Virginia","Poquoson city",5,11,186,93,93
050,51,735,"Virginia","Poquoson city",5,12,175,83,92
050,51,735,"Virginia","Poquoson city",5,13,166,84,82
050,51,735,"Virginia","Poquoson city",5,14,180,101,79
050,51,735,"Virginia","Poquoson city",5,15,183,99,84
050,51,735,"Virginia","Poquoson city",5,16,185,96,89
050,51,735,"Virginia","Poquoson city",5,17,186,93,93
050,51,735,"Virginia","Poquoson city",5,18,154,82,72
050,51,735,"Virginia","Poquoson city",5,19,116,60,56
050,51,735,"Virginia","Poquoson city",5,20,119,61,58
050,51,735,"Virginia","Poquoson city",5,21,113,55,58
050,51,735,"Virginia","Poquoson city",5,22,135,69,66
050,51,735,"Virginia","Poquoson city",5,23,119,64,55
050,51,735,"Virginia","Poquoson city",5,24,138,76,62
050,51,735,"Virginia","Poquoson city",5,25,114,61,53
050,51,735,"Virginia","Poquoson city",5,26,108,59,49
050,51,735,"Virginia","Poquoson city",5,27,97,53,44
050,51,735,"Virginia","Poquoson city",5,28,108,60,48
050,51,735,"Virginia","Poquoson city",5,29,124,59,65
050,51,735,"Virginia","Poquoson city",5,30,98,52,46
050,51,735,"Virginia","Poquoson city",5,31,124,63,61
050,51,735,"Virginia","Poquoson city",5,32,164,73,91
050,51,735,"Virginia","Poquoson city",5,33,137,62,75
050,51,735,"Virginia","Poquoson city",5,34,164,83,81
050,51,735,"Virginia","Poquoson city",5,35,178,93,85
050,51,735,"Virginia","Poquoson city",5,36,152,71,81
050,51,735,"Virginia","Poquoson city",5,37,170,77,93
050,51,735,"Virginia","Poquoson city",5,38,199,104,95
050,51,735,"Virginia","Poquoson city",5,39,189,100,89
050,51,735,"Virginia","Poquoson city",5,40,213,110,103
050,51,735,"Virginia","Poquoson city",5,41,174,94,80
050,51,735,"Virginia","Poquoson city",5,42,199,103,96
050,51,735,"Virginia","Poquoson city",5,43,189,103,86
050,51,735,"Virginia","Poquoson city",5,44,169,80,89
050,51,735,"Virginia","Poquoson city",5,45,167,96,71
050,51,735,"Virginia","Poquoson city",5,46,175,87,88
050,51,735,"Virginia","Poquoson city",5,47,155,76,79
050,51,735,"Virginia","Poquoson city",5,48,149,73,76
050,51,735,"Virginia","Poquoson city",5,49,159,83,76
050,51,735,"Virginia","Poquoson city",5,50,155,74,81
050,51,735,"Virginia","Poquoson city",5,51,176,95,81
050,51,735,"Virginia","Poquoson city",5,52,161,83,78
050,51,735,"Virginia","Poquoson city",5,53,161,80,81
050,51,735,"Virginia","Poquoson city",5,54,142,71,71
050,51,735,"Virginia","Poquoson city",5,55,147,70,77
050,51,735,"Virginia","Poquoson city",5,56,164,74,90
050,51,735,"Virginia","Poquoson city",5,57,158,87,71
050,51,735,"Virginia","Poquoson city",5,58,186,101,85
050,51,735,"Virginia","Poquoson city",5,59,195,104,91
050,51,735,"Virginia","Poquoson city",5,60,195,105,90
050,51,735,"Virginia","Poquoson city",5,61,171,85,86
050,51,735,"Virginia","Poquoson city",5,62,166,80,86
050,51,735,"Virginia","Poquoson city",5,63,156,73,83
050,51,735,"Virginia","Poquoson city",5,64,159,70,89
050,51,735,"Virginia","Poquoson city",5,65,142,74,68
050,51,735,"Virginia","Poquoson city",5,66,158,80,78
050,51,735,"Virginia","Poquoson city",5,67,127,72,55
050,51,735,"Virginia","Poquoson city",5,68,139,69,70
050,51,735,"Virginia","Poquoson city",5,69,131,60,71
050,51,735,"Virginia","Poquoson city",5,70,128,61,67
050,51,735,"Virginia","Poquoson city",5,71,133,74,59
050,51,735,"Virginia","Poquoson city",5,72,129,63,66
050,51,735,"Virginia","Poquoson city",5,73,111,52,59
050,51,735,"Virginia","Poquoson city",5,74,112,47,65
050,51,735,"Virginia","Poquoson city",5,75,123,55,68
050,51,735,"Virginia","Poquoson city",5,76,145,67,78
050,51,735,"Virginia","Poquoson city",5,77,104,49,55
050,51,735,"Virginia","Poquoson city",5,78,99,51,48
050,51,735,"Virginia","Poquoson city",5,79,90,46,44
050,51,735,"Virginia","Poquoson city",5,80,92,42,50
050,51,735,"Virginia","Poquoson city",5,81,58,25,33
050,51,735,"Virginia","Poquoson city",5,82,54,22,32
050,51,735,"Virginia","Poquoson city",5,83,56,28,28
050,51,735,"Virginia","Poquoson city",5,84,46,18,28
050,51,735,"Virginia","Poquoson city",5,85,297,122,175
050,51,740,"Virginia","Portsmouth city",1,0,1428,732,696
050,51,740,"Virginia","Portsmouth city",1,1,1426,750,676
050,51,740,"Virginia","Portsmouth city",1,2,1396,718,678
050,51,740,"Virginia","Portsmouth city",1,3,1430,730,700
050,51,740,"Virginia","Portsmouth city",1,4,1358,701,657
050,51,740,"Virginia","Portsmouth city",1,5,1350,684,666
050,51,740,"Virginia","Portsmouth city",1,6,1307,684,623
050,51,740,"Virginia","Portsmouth city",1,7,1229,637,592
050,51,740,"Virginia","Portsmouth city",1,8,1277,659,618
050,51,740,"Virginia","Portsmouth city",1,9,1257,641,616
050,51,740,"Virginia","Portsmouth city",1,10,1279,646,633
050,51,740,"Virginia","Portsmouth city",1,11,1224,606,618
050,51,740,"Virginia","Portsmouth city",1,12,1186,583,603
050,51,740,"Virginia","Portsmouth city",1,13,1165,605,560
050,51,740,"Virginia","Portsmouth city",1,14,1137,573,564
050,51,740,"Virginia","Portsmouth city",1,15,1108,564,544
050,51,740,"Virginia","Portsmouth city",1,16,1128,569,559
050,51,740,"Virginia","Portsmouth city",1,17,1164,570,594
050,51,740,"Virginia","Portsmouth city",1,18,1008,519,489
050,51,740,"Virginia","Portsmouth city",1,19,1030,570,460
050,51,740,"Virginia","Portsmouth city",1,20,1232,693,539
050,51,740,"Virginia","Portsmouth city",1,21,1335,749,586
050,51,740,"Virginia","Portsmouth city",1,22,1349,713,636
050,51,740,"Virginia","Portsmouth city",1,23,1434,752,682
050,51,740,"Virginia","Portsmouth city",1,24,1553,788,765
050,51,740,"Virginia","Portsmouth city",1,25,1573,807,766
050,51,740,"Virginia","Portsmouth city",1,26,1634,814,820
050,51,740,"Virginia","Portsmouth city",1,27,1702,847,855
050,51,740,"Virginia","Portsmouth city",1,28,1678,833,845
050,51,740,"Virginia","Portsmouth city",1,29,1720,852,868
050,51,740,"Virginia","Portsmouth city",1,30,1654,807,847
050,51,740,"Virginia","Portsmouth city",1,31,1632,817,815
050,51,740,"Virginia","Portsmouth city",1,32,1619,788,831
050,51,740,"Virginia","Portsmouth city",1,33,1548,754,794
050,51,740,"Virginia","Portsmouth city",1,34,1498,711,787
050,51,740,"Virginia","Portsmouth city",1,35,1391,655,736
050,51,740,"Virginia","Portsmouth city",1,36,1420,704,716
050,51,740,"Virginia","Portsmouth city",1,37,1425,700,725
050,51,740,"Virginia","Portsmouth city",1,38,1332,651,681
050,51,740,"Virginia","Portsmouth city",1,39,1274,604,670
050,51,740,"Virginia","Portsmouth city",1,40,1263,573,690
050,51,740,"Virginia","Portsmouth city",1,41,1148,562,586
050,51,740,"Virginia","Portsmouth city",1,42,1135,552,583
050,51,740,"Virginia","Portsmouth city",1,43,1084,534,550
050,51,740,"Virginia","Portsmouth city",1,44,1030,490,540
050,51,740,"Virginia","Portsmouth city",1,45,954,441,513
050,51,740,"Virginia","Portsmouth city",1,46,931,465,466
050,51,740,"Virginia","Portsmouth city",1,47,955,453,502
050,51,740,"Virginia","Portsmouth city",1,48,1044,501,543
050,51,740,"Virginia","Portsmouth city",1,49,1106,536,570
050,51,740,"Virginia","Portsmouth city",1,50,1095,508,587
050,51,740,"Virginia","Portsmouth city",1,51,1015,470,545
050,51,740,"Virginia","Portsmouth city",1,52,1095,477,618
050,51,740,"Virginia","Portsmouth city",1,53,1107,520,587
050,51,740,"Virginia","Portsmouth city",1,54,1103,506,597
050,51,740,"Virginia","Portsmouth city",1,55,1225,590,635
050,51,740,"Virginia","Portsmouth city",1,56,1231,573,658
050,51,740,"Virginia","Portsmouth city",1,57,1232,573,659
050,51,740,"Virginia","Portsmouth city",1,58,1307,616,691
050,51,740,"Virginia","Portsmouth city",1,59,1317,604,713
050,51,740,"Virginia","Portsmouth city",1,60,1274,562,712
050,51,740,"Virginia","Portsmouth city",1,61,1254,563,691
050,51,740,"Virginia","Portsmouth city",1,62,1233,567,666
050,51,740,"Virginia","Portsmouth city",1,63,1206,561,645
050,51,740,"Virginia","Portsmouth city",1,64,1164,528,636
050,51,740,"Virginia","Portsmouth city",1,65,1069,471,598
050,51,740,"Virginia","Portsmouth city",1,66,1041,459,582
050,51,740,"Virginia","Portsmouth city",1,67,1049,478,571
050,51,740,"Virginia","Portsmouth city",1,68,965,423,542
050,51,740,"Virginia","Portsmouth city",1,69,918,401,517
050,51,740,"Virginia","Portsmouth city",1,70,837,362,475
050,51,740,"Virginia","Portsmouth city",1,71,805,359,446
050,51,740,"Virginia","Portsmouth city",1,72,811,353,458
050,51,740,"Virginia","Portsmouth city",1,73,780,345,435
050,51,740,"Virginia","Portsmouth city",1,74,574,243,331
050,51,740,"Virginia","Portsmouth city",1,75,568,255,313
050,51,740,"Virginia","Portsmouth city",1,76,551,226,325
050,51,740,"Virginia","Portsmouth city",1,77,504,197,307
050,51,740,"Virginia","Portsmouth city",1,78,416,165,251
050,51,740,"Virginia","Portsmouth city",1,79,396,155,241
050,51,740,"Virginia","Portsmouth city",1,80,386,143,243
050,51,740,"Virginia","Portsmouth city",1,81,337,131,206
050,51,740,"Virginia","Portsmouth city",1,82,347,126,221
050,51,740,"Virginia","Portsmouth city",1,83,294,114,180
050,51,740,"Virginia","Portsmouth city",1,84,293,113,180
050,51,740,"Virginia","Portsmouth city",1,85,1573,527,1046
050,51,740,"Virginia","Portsmouth city",2,0,1362,700,662
050,51,740,"Virginia","Portsmouth city",2,1,1421,741,680
050,51,740,"Virginia","Portsmouth city",2,2,1408,728,680
050,51,740,"Virginia","Portsmouth city",2,3,1409,723,686
050,51,740,"Virginia","Portsmouth city",2,4,1365,701,664
050,51,740,"Virginia","Portsmouth city",2,5,1348,688,660
050,51,740,"Virginia","Portsmouth city",2,6,1311,680,631
050,51,740,"Virginia","Portsmouth city",2,7,1244,644,600
050,51,740,"Virginia","Portsmouth city",2,8,1254,650,604
050,51,740,"Virginia","Portsmouth city",2,9,1261,647,614
050,51,740,"Virginia","Portsmouth city",2,10,1267,642,625
050,51,740,"Virginia","Portsmouth city",2,11,1233,615,618
050,51,740,"Virginia","Portsmouth city",2,12,1198,591,607
050,51,740,"Virginia","Portsmouth city",2,13,1175,603,572
050,51,740,"Virginia","Portsmouth city",2,14,1139,578,561
050,51,740,"Virginia","Portsmouth city",2,15,1116,567,549
050,51,740,"Virginia","Portsmouth city",2,16,1130,570,560
050,51,740,"Virginia","Portsmouth city",2,17,1156,572,584
050,51,740,"Virginia","Portsmouth city",2,18,1032,531,501
050,51,740,"Virginia","Portsmouth city",2,19,1046,577,469
050,51,740,"Virginia","Portsmouth city",2,20,1244,697,547
050,51,740,"Virginia","Portsmouth city",2,21,1337,744,593
050,51,740,"Virginia","Portsmouth city",2,22,1366,727,639
050,51,740,"Virginia","Portsmouth city",2,23,1436,747,689
050,51,740,"Virginia","Portsmouth city",2,24,1525,779,746
050,51,740,"Virginia","Portsmouth city",2,25,1572,807,765
050,51,740,"Virginia","Portsmouth city",2,26,1614,807,807
050,51,740,"Virginia","Portsmouth city",2,27,1683,834,849
050,51,740,"Virginia","Portsmouth city",2,28,1693,841,852
050,51,740,"Virginia","Portsmouth city",2,29,1708,841,867
050,51,740,"Virginia","Portsmouth city",2,30,1674,818,856
050,51,740,"Virginia","Portsmouth city",2,31,1635,813,822
050,51,740,"Virginia","Portsmouth city",2,32,1613,789,824
050,51,740,"Virginia","Portsmouth city",2,33,1554,755,799
050,51,740,"Virginia","Portsmouth city",2,34,1496,714,782
050,51,740,"Virginia","Portsmouth city",2,35,1423,674,749
050,51,740,"Virginia","Portsmouth city",2,36,1405,691,714
050,51,740,"Virginia","Portsmouth city",2,37,1420,699,721
050,51,740,"Virginia","Portsmouth city",2,38,1360,665,695
050,51,740,"Virginia","Portsmouth city",2,39,1279,610,669
050,51,740,"Virginia","Portsmouth city",2,40,1264,580,684
050,51,740,"Virginia","Portsmouth city",2,41,1167,561,606
050,51,740,"Virginia","Portsmouth city",2,42,1124,548,576
050,51,740,"Virginia","Portsmouth city",2,43,1100,538,562
050,51,740,"Virginia","Portsmouth city",2,44,1030,495,535
050,51,740,"Virginia","Portsmouth city",2,45,978,456,522
050,51,740,"Virginia","Portsmouth city",2,46,933,457,476
050,51,740,"Virginia","Portsmouth city",2,47,944,450,494
050,51,740,"Virginia","Portsmouth city",2,48,1028,490,538
050,51,740,"Virginia","Portsmouth city",2,49,1099,526,573
050,51,740,"Virginia","Portsmouth city",2,50,1093,511,582
050,51,740,"Virginia","Portsmouth city",2,51,1031,475,556
050,51,740,"Virginia","Portsmouth city",2,52,1073,479,594
050,51,740,"Virginia","Portsmouth city",2,53,1095,502,593
050,51,740,"Virginia","Portsmouth city",2,54,1103,508,595
050,51,740,"Virginia","Portsmouth city",2,55,1199,571,628
050,51,740,"Virginia","Portsmouth city",2,56,1228,578,650
050,51,740,"Virginia","Portsmouth city",2,57,1238,579,659
050,51,740,"Virginia","Portsmouth city",2,58,1291,606,685
050,51,740,"Virginia","Portsmouth city",2,59,1312,604,708
050,51,740,"Virginia","Portsmouth city",2,60,1279,568,711
050,51,740,"Virginia","Portsmouth city",2,61,1250,557,693
050,51,740,"Virginia","Portsmouth city",2,62,1227,560,667
050,51,740,"Virginia","Portsmouth city",2,63,1224,566,658
050,51,740,"Virginia","Portsmouth city",2,64,1163,530,633
050,51,740,"Virginia","Portsmouth city",2,65,1083,478,605
050,51,740,"Virginia","Portsmouth city",2,66,1043,459,584
050,51,740,"Virginia","Portsmouth city",2,67,1035,470,565
050,51,740,"Virginia","Portsmouth city",2,68,973,431,542
050,51,740,"Virginia","Portsmouth city",2,69,935,407,528
050,51,740,"Virginia","Portsmouth city",2,70,847,364,483
050,51,740,"Virginia","Portsmouth city",2,71,804,355,449
050,51,740,"Virginia","Portsmouth city",2,72,796,347,449
050,51,740,"Virginia","Portsmouth city",2,73,809,359,450
050,51,740,"Virginia","Portsmouth city",2,74,584,253,331
050,51,740,"Virginia","Portsmouth city",2,75,563,250,313
050,51,740,"Virginia","Portsmouth city",2,76,541,230,311
050,51,740,"Virginia","Portsmouth city",2,77,520,206,314
050,51,740,"Virginia","Portsmouth city",2,78,427,169,258
050,51,740,"Virginia","Portsmouth city",2,79,393,153,240
050,51,740,"Virginia","Portsmouth city",2,80,385,144,241
050,51,740,"Virginia","Portsmouth city",2,81,343,134,209
050,51,740,"Virginia","Portsmouth city",2,82,341,125,216
050,51,740,"Virginia","Portsmouth city",2,83,301,117,184
050,51,740,"Virginia","Portsmouth city",2,84,287,112,175
050,51,740,"Virginia","Portsmouth city",2,85,1560,530,1030
050,51,740,"Virginia","Portsmouth city",3,0,1357,701,656
050,51,740,"Virginia","Portsmouth city",3,1,1404,770,634
050,51,740,"Virginia","Portsmouth city",3,2,1391,730,661
050,51,740,"Virginia","Portsmouth city",3,3,1359,719,640
050,51,740,"Virginia","Portsmouth city",3,4,1356,694,662
050,51,740,"Virginia","Portsmouth city",3,5,1287,638,649
050,51,740,"Virginia","Portsmouth city",3,6,1305,659,646
050,51,740,"Virginia","Portsmouth city",3,7,1254,635,619
050,51,740,"Virginia","Portsmouth city",3,8,1222,640,582
050,51,740,"Virginia","Portsmouth city",3,9,1206,630,576
050,51,740,"Virginia","Portsmouth city",3,10,1242,628,614
050,51,740,"Virginia","Portsmouth city",3,11,1246,634,612
050,51,740,"Virginia","Portsmouth city",3,12,1209,615,594
050,51,740,"Virginia","Portsmouth city",3,13,1235,596,639
050,51,740,"Virginia","Portsmouth city",3,14,1156,598,558
050,51,740,"Virginia","Portsmouth city",3,15,1170,596,574
050,51,740,"Virginia","Portsmouth city",3,16,1126,562,564
050,51,740,"Virginia","Portsmouth city",3,17,1106,570,536
050,51,740,"Virginia","Portsmouth city",3,18,1078,548,530
050,51,740,"Virginia","Portsmouth city",3,19,1027,564,463
050,51,740,"Virginia","Portsmouth city",3,20,1232,684,548
050,51,740,"Virginia","Portsmouth city",3,21,1359,737,622
050,51,740,"Virginia","Portsmouth city",3,22,1354,737,617
050,51,740,"Virginia","Portsmouth city",3,23,1432,752,680
050,51,740,"Virginia","Portsmouth city",3,24,1515,789,726
050,51,740,"Virginia","Portsmouth city",3,25,1560,806,754
050,51,740,"Virginia","Portsmouth city",3,26,1574,810,764
050,51,740,"Virginia","Portsmouth city",3,27,1611,794,817
050,51,740,"Virginia","Portsmouth city",3,28,1645,801,844
050,51,740,"Virginia","Portsmouth city",3,29,1693,849,844
050,51,740,"Virginia","Portsmouth city",3,30,1737,844,893
050,51,740,"Virginia","Portsmouth city",3,31,1691,836,855
050,51,740,"Virginia","Portsmouth city",3,32,1605,787,818
050,51,740,"Virginia","Portsmouth city",3,33,1599,767,832
050,51,740,"Virginia","Portsmouth city",3,34,1535,725,810
050,51,740,"Virginia","Portsmouth city",3,35,1477,714,763
050,51,740,"Virginia","Portsmouth city",3,36,1398,679,719
050,51,740,"Virginia","Portsmouth city",3,37,1404,677,727
050,51,740,"Virginia","Portsmouth city",3,38,1354,659,695
050,51,740,"Virginia","Portsmouth city",3,39,1358,664,694
050,51,740,"Virginia","Portsmouth city",3,40,1227,553,674
050,51,740,"Virginia","Portsmouth city",3,41,1240,569,671
050,51,740,"Virginia","Portsmouth city",3,42,1156,546,610
050,51,740,"Virginia","Portsmouth city",3,43,1079,534,545
050,51,740,"Virginia","Portsmouth city",3,44,1095,519,576
050,51,740,"Virginia","Portsmouth city",3,45,1020,492,528
050,51,740,"Virginia","Portsmouth city",3,46,969,433,536
050,51,740,"Virginia","Portsmouth city",3,47,923,448,475
050,51,740,"Virginia","Portsmouth city",3,48,963,456,507
050,51,740,"Virginia","Portsmouth city",3,49,1008,475,533
050,51,740,"Virginia","Portsmouth city",3,50,1065,516,549
050,51,740,"Virginia","Portsmouth city",3,51,1082,488,594
050,51,740,"Virginia","Portsmouth city",3,52,1037,476,561
050,51,740,"Virginia","Portsmouth city",3,53,1067,491,576
050,51,740,"Virginia","Portsmouth city",3,54,1101,508,593
050,51,740,"Virginia","Portsmouth city",3,55,1056,478,578
050,51,740,"Virginia","Portsmouth city",3,56,1159,556,603
050,51,740,"Virginia","Portsmouth city",3,57,1206,577,629
050,51,740,"Virginia","Portsmouth city",3,58,1219,558,661
050,51,740,"Virginia","Portsmouth city",3,59,1243,574,669
050,51,740,"Virginia","Portsmouth city",3,60,1277,584,693
050,51,740,"Virginia","Portsmouth city",3,61,1258,551,707
050,51,740,"Virginia","Portsmouth city",3,62,1246,542,704
050,51,740,"Virginia","Portsmouth city",3,63,1172,526,646
050,51,740,"Virginia","Portsmouth city",3,64,1158,531,627
050,51,740,"Virginia","Portsmouth city",3,65,1111,518,593
050,51,740,"Virginia","Portsmouth city",3,66,1046,453,593
050,51,740,"Virginia","Portsmouth city",3,67,1004,438,566
050,51,740,"Virginia","Portsmouth city",3,68,999,452,547
050,51,740,"Virginia","Portsmouth city",3,69,934,406,528
050,51,740,"Virginia","Portsmouth city",3,70,899,388,511
050,51,740,"Virginia","Portsmouth city",3,71,818,346,472
050,51,740,"Virginia","Portsmouth city",3,72,784,347,437
050,51,740,"Virginia","Portsmouth city",3,73,769,330,439
050,51,740,"Virginia","Portsmouth city",3,74,774,340,434
050,51,740,"Virginia","Portsmouth city",3,75,554,236,318
050,51,740,"Virginia","Portsmouth city",3,76,539,242,297
050,51,740,"Virginia","Portsmouth city",3,77,508,210,298
050,51,740,"Virginia","Portsmouth city",3,78,490,193,297
050,51,740,"Virginia","Portsmouth city",3,79,393,152,241
050,51,740,"Virginia","Portsmouth city",3,80,363,138,225
050,51,740,"Virginia","Portsmouth city",3,81,355,127,228
050,51,740,"Virginia","Portsmouth city",3,82,323,121,202
050,51,740,"Virginia","Portsmouth city",3,83,302,122,180
050,51,740,"Virginia","Portsmouth city",3,84,279,103,176
050,51,740,"Virginia","Portsmouth city",3,85,1513,514,999
050,51,740,"Virginia","Portsmouth city",4,0,1318,687,631
050,51,740,"Virginia","Portsmouth city",4,1,1304,686,618
050,51,740,"Virginia","Portsmouth city",4,2,1326,705,621
050,51,740,"Virginia","Portsmouth city",4,3,1367,717,650
050,51,740,"Virginia","Portsmouth city",4,4,1340,700,640
050,51,740,"Virginia","Portsmouth city",4,5,1300,648,652
050,51,740,"Virginia","Portsmouth city",4,6,1286,642,644
050,51,740,"Virginia","Portsmouth city",4,7,1254,622,632
050,51,740,"Virginia","Portsmouth city",4,8,1223,630,593
050,51,740,"Virginia","Portsmouth city",4,9,1228,627,601
050,51,740,"Virginia","Portsmouth city",4,10,1203,623,580
050,51,740,"Virginia","Portsmouth city",4,11,1224,617,607
050,51,740,"Virginia","Portsmouth city",4,12,1206,610,596
050,51,740,"Virginia","Portsmouth city",4,13,1208,629,579
050,51,740,"Virginia","Portsmouth city",4,14,1184,579,605
050,51,740,"Virginia","Portsmouth city",4,15,1161,603,558
050,51,740,"Virginia","Portsmouth city",4,16,1149,588,561
050,51,740,"Virginia","Portsmouth city",4,17,1141,576,565
050,51,740,"Virginia","Portsmouth city",4,18,1023,547,476
050,51,740,"Virginia","Portsmouth city",4,19,1041,575,466
050,51,740,"Virginia","Portsmouth city",4,20,1150,628,522
050,51,740,"Virginia","Portsmouth city",4,21,1321,722,599
050,51,740,"Virginia","Portsmouth city",4,22,1393,763,630
050,51,740,"Virginia","Portsmouth city",4,23,1444,757,687
050,51,740,"Virginia","Portsmouth city",4,24,1497,780,717
050,51,740,"Virginia","Portsmouth city",4,25,1557,794,763
050,51,740,"Virginia","Portsmouth city",4,26,1583,826,757
050,51,740,"Virginia","Portsmouth city",4,27,1560,773,787
050,51,740,"Virginia","Portsmouth city",4,28,1627,825,802
050,51,740,"Virginia","Portsmouth city",4,29,1647,819,828
050,51,740,"Virginia","Portsmouth city",4,30,1659,811,848
050,51,740,"Virginia","Portsmouth city",4,31,1739,883,856
050,51,740,"Virginia","Portsmouth city",4,32,1654,824,830
050,51,740,"Virginia","Portsmouth city",4,33,1517,737,780
050,51,740,"Virginia","Portsmouth city",4,34,1554,740,814
050,51,740,"Virginia","Portsmouth city",4,35,1461,689,772
050,51,740,"Virginia","Portsmouth city",4,36,1454,716,738
050,51,740,"Virginia","Portsmouth city",4,37,1348,646,702
050,51,740,"Virginia","Portsmouth city",4,38,1382,667,715
050,51,740,"Virginia","Portsmouth city",4,39,1338,665,673
050,51,740,"Virginia","Portsmouth city",4,40,1313,616,697
050,51,740,"Virginia","Portsmouth city",4,41,1208,554,654
050,51,740,"Virginia","Portsmouth city",4,42,1202,549,653
050,51,740,"Virginia","Portsmouth city",4,43,1133,514,619
050,51,740,"Virginia","Portsmouth city",4,44,1065,518,547
050,51,740,"Virginia","Portsmouth city",4,45,1045,481,564
050,51,740,"Virginia","Portsmouth city",4,46,1027,490,537
050,51,740,"Virginia","Portsmouth city",4,47,959,423,536
050,51,740,"Virginia","Portsmouth city",4,48,898,435,463
050,51,740,"Virginia","Portsmouth city",4,49,947,454,493
050,51,740,"Virginia","Portsmouth city",4,50,986,483,503
050,51,740,"Virginia","Portsmouth city",4,51,1035,492,543
050,51,740,"Virginia","Portsmouth city",4,52,1082,484,598
050,51,740,"Virginia","Portsmouth city",4,53,1030,471,559
050,51,740,"Virginia","Portsmouth city",4,54,1083,503,580
050,51,740,"Virginia","Portsmouth city",4,55,1077,500,577
050,51,740,"Virginia","Portsmouth city",4,56,1028,469,559
050,51,740,"Virginia","Portsmouth city",4,57,1149,544,605
050,51,740,"Virginia","Portsmouth city",4,58,1185,567,618
050,51,740,"Virginia","Portsmouth city",4,59,1209,547,662
050,51,740,"Virginia","Portsmouth city",4,60,1216,553,663
050,51,740,"Virginia","Portsmouth city",4,61,1232,562,670
050,51,740,"Virginia","Portsmouth city",4,62,1259,552,707
050,51,740,"Virginia","Portsmouth city",4,63,1189,512,677
050,51,740,"Virginia","Portsmouth city",4,64,1141,503,638
050,51,740,"Virginia","Portsmouth city",4,65,1135,523,612
050,51,740,"Virginia","Portsmouth city",4,66,1078,496,582
050,51,740,"Virginia","Portsmouth city",4,67,1004,427,577
050,51,740,"Virginia","Portsmouth city",4,68,949,411,538
050,51,740,"Virginia","Portsmouth city",4,69,961,434,527
050,51,740,"Virginia","Portsmouth city",4,70,888,380,508
050,51,740,"Virginia","Portsmouth city",4,71,874,376,498
050,51,740,"Virginia","Portsmouth city",4,72,795,330,465
050,51,740,"Virginia","Portsmouth city",4,73,756,327,429
050,51,740,"Virginia","Portsmouth city",4,74,745,313,432
050,51,740,"Virginia","Portsmouth city",4,75,738,321,417
050,51,740,"Virginia","Portsmouth city",4,76,530,227,303
050,51,740,"Virginia","Portsmouth city",4,77,499,216,283
050,51,740,"Virginia","Portsmouth city",4,78,456,187,269
050,51,740,"Virginia","Portsmouth city",4,79,461,179,282
050,51,740,"Virginia","Portsmouth city",4,80,357,139,218
050,51,740,"Virginia","Portsmouth city",4,81,331,125,206
050,51,740,"Virginia","Portsmouth city",4,82,325,110,215
050,51,740,"Virginia","Portsmouth city",4,83,277,105,172
050,51,740,"Virginia","Portsmouth city",4,84,278,106,172
050,51,740,"Virginia","Portsmouth city",4,85,1448,496,952
050,51,740,"Virginia","Portsmouth city",5,0,1311,685,626
050,51,740,"Virginia","Portsmouth city",5,1,1348,672,676
050,51,740,"Virginia","Portsmouth city",5,2,1264,650,614
050,51,740,"Virginia","Portsmouth city",5,3,1323,706,617
050,51,740,"Virginia","Portsmouth city",5,4,1320,696,624
050,51,740,"Virginia","Portsmouth city",5,5,1263,658,605
050,51,740,"Virginia","Portsmouth city",5,6,1286,671,615
050,51,740,"Virginia","Portsmouth city",5,7,1237,619,618
050,51,740,"Virginia","Portsmouth city",5,8,1258,613,645
050,51,740,"Virginia","Portsmouth city",5,9,1227,648,579
050,51,740,"Virginia","Portsmouth city",5,10,1178,616,562
050,51,740,"Virginia","Portsmouth city",5,11,1191,616,575
050,51,740,"Virginia","Portsmouth city",5,12,1214,620,594
050,51,740,"Virginia","Portsmouth city",5,13,1169,608,561
050,51,740,"Virginia","Portsmouth city",5,14,1194,613,581
050,51,740,"Virginia","Portsmouth city",5,15,1169,561,608
050,51,740,"Virginia","Portsmouth city",5,16,1101,570,531
050,51,740,"Virginia","Portsmouth city",5,17,1120,576,544
050,51,740,"Virginia","Portsmouth city",5,18,1065,548,517
050,51,740,"Virginia","Portsmouth city",5,19,1019,559,460
050,51,740,"Virginia","Portsmouth city",5,20,1184,662,522
050,51,740,"Virginia","Portsmouth city",5,21,1261,682,579
050,51,740,"Virginia","Portsmouth city",5,22,1337,696,641
050,51,740,"Virginia","Portsmouth city",5,23,1415,748,667
050,51,740,"Virginia","Portsmouth city",5,24,1570,800,770
050,51,740,"Virginia","Portsmouth city",5,25,1497,775,722
050,51,740,"Virginia","Portsmouth city",5,26,1540,782,758
050,51,740,"Virginia","Portsmouth city",5,27,1557,810,747
050,51,740,"Virginia","Portsmouth city",5,28,1605,809,796
050,51,740,"Virginia","Portsmouth city",5,29,1606,824,782
050,51,740,"Virginia","Portsmouth city",5,30,1682,841,841
050,51,740,"Virginia","Portsmouth city",5,31,1646,819,827
050,51,740,"Virginia","Portsmouth city",5,32,1741,872,869
050,51,740,"Virginia","Portsmouth city",5,33,1616,815,801
050,51,740,"Virginia","Portsmouth city",5,34,1499,735,764
050,51,740,"Virginia","Portsmouth city",5,35,1545,746,799
050,51,740,"Virginia","Portsmouth city",5,36,1449,686,763
050,51,740,"Virginia","Portsmouth city",5,37,1418,700,718
050,51,740,"Virginia","Portsmouth city",5,38,1335,650,685
050,51,740,"Virginia","Portsmouth city",5,39,1389,657,732
050,51,740,"Virginia","Portsmouth city",5,40,1297,631,666
050,51,740,"Virginia","Portsmouth city",5,41,1285,598,687
050,51,740,"Virginia","Portsmouth city",5,42,1183,544,639
050,51,740,"Virginia","Portsmouth city",5,43,1173,540,633
050,51,740,"Virginia","Portsmouth city",5,44,1120,522,598
050,51,740,"Virginia","Portsmouth city",5,45,1055,504,551
050,51,740,"Virginia","Portsmouth city",5,46,1039,497,542
050,51,740,"Virginia","Portsmouth city",5,47,1016,473,543
050,51,740,"Virginia","Portsmouth city",5,48,943,416,527
050,51,740,"Virginia","Portsmouth city",5,49,892,433,459
050,51,740,"Virginia","Portsmouth city",5,50,947,441,506
050,51,740,"Virginia","Portsmouth city",5,51,974,472,502
050,51,740,"Virginia","Portsmouth city",5,52,1012,487,525
050,51,740,"Virginia","Portsmouth city",5,53,1093,489,604
050,51,740,"Virginia","Portsmouth city",5,54,1023,466,557
050,51,740,"Virginia","Portsmouth city",5,55,1087,491,596
050,51,740,"Virginia","Portsmouth city",5,56,1070,494,576
050,51,740,"Virginia","Portsmouth city",5,57,1047,482,565
050,51,740,"Virginia","Portsmouth city",5,58,1135,534,601
050,51,740,"Virginia","Portsmouth city",5,59,1171,562,609
050,51,740,"Virginia","Portsmouth city",5,60,1193,542,651
050,51,740,"Virginia","Portsmouth city",5,61,1217,553,664
050,51,740,"Virginia","Portsmouth city",5,62,1219,550,669
050,51,740,"Virginia","Portsmouth city",5,63,1202,518,684
050,51,740,"Virginia","Portsmouth city",5,64,1156,494,662
050,51,740,"Virginia","Portsmouth city",5,65,1085,488,597
050,51,740,"Virginia","Portsmouth city",5,66,1103,497,606
050,51,740,"Virginia","Portsmouth city",5,67,1039,479,560
050,51,740,"Virginia","Portsmouth city",5,68,970,413,557
050,51,740,"Virginia","Portsmouth city",5,69,918,391,527
050,51,740,"Virginia","Portsmouth city",5,70,929,416,513
050,51,740,"Virginia","Portsmouth city",5,71,864,367,497
050,51,740,"Virginia","Portsmouth city",5,72,859,365,494
050,51,740,"Virginia","Portsmouth city",5,73,766,315,451
050,51,740,"Virginia","Portsmouth city",5,74,738,322,416
050,51,740,"Virginia","Portsmouth city",5,75,709,291,418
050,51,740,"Virginia","Portsmouth city",5,76,699,304,395
050,51,740,"Virginia","Portsmouth city",5,77,504,215,289
050,51,740,"Virginia","Portsmouth city",5,78,456,194,262
050,51,740,"Virginia","Portsmouth city",5,79,429,170,259
050,51,740,"Virginia","Portsmouth city",5,80,429,166,263
050,51,740,"Virginia","Portsmouth city",5,81,323,125,198
050,51,740,"Virginia","Portsmouth city",5,82,304,112,192
050,51,740,"Virginia","Portsmouth city",5,83,291,98,193
050,51,740,"Virginia","Portsmouth city",5,84,253,92,161
050,51,740,"Virginia","Portsmouth city",5,85,1427,496,931
050,51,750,"Virginia","Radford city",1,0,100,50,50
050,51,750,"Virginia","Radford city",1,1,92,42,50
050,51,750,"Virginia","Radford city",1,2,104,55,49
050,51,750,"Virginia","Radford city",1,3,99,61,38
050,51,750,"Virginia","Radford city",1,4,96,54,42
050,51,750,"Virginia","Radford city",1,5,99,55,44
050,51,750,"Virginia","Radford city",1,6,115,55,60
050,51,750,"Virginia","Radford city",1,7,111,52,59
050,51,750,"Virginia","Radford city",1,8,103,55,48
050,51,750,"Virginia","Radford city",1,9,108,51,57
050,51,750,"Virginia","Radford city",1,10,99,51,48
050,51,750,"Virginia","Radford city",1,11,111,50,61
050,51,750,"Virginia","Radford city",1,12,119,58,61
050,51,750,"Virginia","Radford city",1,13,115,61,54
050,51,750,"Virginia","Radford city",1,14,114,59,55
050,51,750,"Virginia","Radford city",1,15,116,60,56
050,51,750,"Virginia","Radford city",1,16,113,51,62
050,51,750,"Virginia","Radford city",1,17,118,60,58
050,51,750,"Virginia","Radford city",1,18,910,367,543
050,51,750,"Virginia","Radford city",1,19,1583,638,945
050,51,750,"Virginia","Radford city",1,20,1242,462,780
050,51,750,"Virginia","Radford city",1,21,1132,526,606
050,51,750,"Virginia","Radford city",1,22,729,378,351
050,51,750,"Virginia","Radford city",1,23,560,325,235
050,51,750,"Virginia","Radford city",1,24,356,164,192
050,51,750,"Virginia","Radford city",1,25,257,134,123
050,51,750,"Virginia","Radford city",1,26,218,112,106
050,51,750,"Virginia","Radford city",1,27,214,119,95
050,51,750,"Virginia","Radford city",1,28,208,107,101
050,51,750,"Virginia","Radford city",1,29,196,107,89
050,51,750,"Virginia","Radford city",1,30,194,103,91
050,51,750,"Virginia","Radford city",1,31,162,76,86
050,51,750,"Virginia","Radford city",1,32,183,95,88
050,51,750,"Virginia","Radford city",1,33,153,77,76
050,51,750,"Virginia","Radford city",1,34,142,73,69
050,51,750,"Virginia","Radford city",1,35,139,64,75
050,51,750,"Virginia","Radford city",1,36,149,76,73
050,51,750,"Virginia","Radford city",1,37,135,61,74
050,51,750,"Virginia","Radford city",1,38,126,66,60
050,51,750,"Virginia","Radford city",1,39,136,60,76
050,51,750,"Virginia","Radford city",1,40,134,58,76
050,51,750,"Virginia","Radford city",1,41,149,58,91
050,51,750,"Virginia","Radford city",1,42,141,67,74
050,51,750,"Virginia","Radford city",1,43,137,64,73
050,51,750,"Virginia","Radford city",1,44,149,74,75
050,51,750,"Virginia","Radford city",1,45,120,55,65
050,51,750,"Virginia","Radford city",1,46,116,62,54
050,51,750,"Virginia","Radford city",1,47,132,60,72
050,51,750,"Virginia","Radford city",1,48,150,84,66
050,51,750,"Virginia","Radford city",1,49,180,101,79
050,51,750,"Virginia","Radford city",1,50,162,83,79
050,51,750,"Virginia","Radford city",1,51,132,70,62
050,51,750,"Virginia","Radford city",1,52,120,72,48
050,51,750,"Virginia","Radford city",1,53,134,67,67
050,51,750,"Virginia","Radford city",1,54,148,66,82
050,51,750,"Virginia","Radford city",1,55,150,72,78
050,51,750,"Virginia","Radford city",1,56,154,67,87
050,51,750,"Virginia","Radford city",1,57,132,67,65
050,51,750,"Virginia","Radford city",1,58,150,75,75
050,51,750,"Virginia","Radford city",1,59,138,63,75
050,51,750,"Virginia","Radford city",1,60,132,61,71
050,51,750,"Virginia","Radford city",1,61,117,55,62
050,51,750,"Virginia","Radford city",1,62,141,79,62
050,51,750,"Virginia","Radford city",1,63,138,70,68
050,51,750,"Virginia","Radford city",1,64,137,60,77
050,51,750,"Virginia","Radford city",1,65,138,53,85
050,51,750,"Virginia","Radford city",1,66,141,64,77
050,51,750,"Virginia","Radford city",1,67,124,63,61
050,51,750,"Virginia","Radford city",1,68,100,47,53
050,51,750,"Virginia","Radford city",1,69,85,40,45
050,51,750,"Virginia","Radford city",1,70,81,33,48
050,51,750,"Virginia","Radford city",1,71,66,28,38
050,51,750,"Virginia","Radford city",1,72,67,36,31
050,51,750,"Virginia","Radford city",1,73,65,37,28
050,51,750,"Virginia","Radford city",1,74,50,25,25
050,51,750,"Virginia","Radford city",1,75,41,22,19
050,51,750,"Virginia","Radford city",1,76,48,21,27
050,51,750,"Virginia","Radford city",1,77,71,25,46
050,51,750,"Virginia","Radford city",1,78,52,20,32
050,51,750,"Virginia","Radford city",1,79,43,19,24
050,51,750,"Virginia","Radford city",1,80,37,16,21
050,51,750,"Virginia","Radford city",1,81,34,18,16
050,51,750,"Virginia","Radford city",1,82,40,19,21
050,51,750,"Virginia","Radford city",1,83,30,10,20
050,51,750,"Virginia","Radford city",1,84,28,8,20
050,51,750,"Virginia","Radford city",1,85,179,47,132
050,51,750,"Virginia","Radford city",2,0,116,57,59
050,51,750,"Virginia","Radford city",2,1,95,45,50
050,51,750,"Virginia","Radford city",2,2,101,54,47
050,51,750,"Virginia","Radford city",2,3,102,61,41
050,51,750,"Virginia","Radford city",2,4,99,56,43
050,51,750,"Virginia","Radford city",2,5,101,56,45
050,51,750,"Virginia","Radford city",2,6,113,56,57
050,51,750,"Virginia","Radford city",2,7,113,53,60
050,51,750,"Virginia","Radford city",2,8,105,54,51
050,51,750,"Virginia","Radford city",2,9,107,51,56
050,51,750,"Virginia","Radford city",2,10,100,50,50
050,51,750,"Virginia","Radford city",2,11,108,51,57
050,51,750,"Virginia","Radford city",2,12,117,56,61
050,51,750,"Virginia","Radford city",2,13,116,60,56
050,51,750,"Virginia","Radford city",2,14,114,60,54
050,51,750,"Virginia","Radford city",2,15,116,61,55
050,51,750,"Virginia","Radford city",2,16,114,53,61
050,51,750,"Virginia","Radford city",2,17,119,59,60
050,51,750,"Virginia","Radford city",2,18,908,366,542
050,51,750,"Virginia","Radford city",2,19,1583,636,947
050,51,750,"Virginia","Radford city",2,20,1273,475,798
050,51,750,"Virginia","Radford city",2,21,1155,537,618
050,51,750,"Virginia","Radford city",2,22,705,371,334
050,51,750,"Virginia","Radford city",2,23,564,328,236
050,51,750,"Virginia","Radford city",2,24,355,159,196
050,51,750,"Virginia","Radford city",2,25,256,135,121
050,51,750,"Virginia","Radford city",2,26,215,108,107
050,51,750,"Virginia","Radford city",2,27,207,110,97
050,51,750,"Virginia","Radford city",2,28,206,107,99
050,51,750,"Virginia","Radford city",2,29,199,107,92
050,51,750,"Virginia","Radford city",2,30,191,102,89
050,51,750,"Virginia","Radford city",2,31,166,80,86
050,51,750,"Virginia","Radford city",2,32,175,88,87
050,51,750,"Virginia","Radford city",2,33,158,82,76
050,51,750,"Virginia","Radford city",2,34,143,75,68
050,51,750,"Virginia","Radford city",2,35,140,68,72
050,51,750,"Virginia","Radford city",2,36,146,74,72
050,51,750,"Virginia","Radford city",2,37,136,62,74
050,51,750,"Virginia","Radford city",2,38,129,65,64
050,51,750,"Virginia","Radford city",2,39,135,61,74
050,51,750,"Virginia","Radford city",2,40,139,59,80
050,51,750,"Virginia","Radford city",2,41,145,57,88
050,51,750,"Virginia","Radford city",2,42,140,64,76
050,51,750,"Virginia","Radford city",2,43,138,65,73
050,51,750,"Virginia","Radford city",2,44,145,70,75
050,51,750,"Virginia","Radford city",2,45,128,59,69
050,51,750,"Virginia","Radford city",2,46,116,59,57
050,51,750,"Virginia","Radford city",2,47,127,60,67
050,51,750,"Virginia","Radford city",2,48,148,80,68
050,51,750,"Virginia","Radford city",2,49,172,97,75
050,51,750,"Virginia","Radford city",2,50,165,86,79
050,51,750,"Virginia","Radford city",2,51,137,73,64
050,51,750,"Virginia","Radford city",2,52,122,71,51
050,51,750,"Virginia","Radford city",2,53,130,68,62
050,51,750,"Virginia","Radford city",2,54,141,65,76
050,51,750,"Virginia","Radford city",2,55,148,68,80
050,51,750,"Virginia","Radford city",2,56,152,68,84
050,51,750,"Virginia","Radford city",2,57,139,68,71
050,51,750,"Virginia","Radford city",2,58,144,71,73
050,51,750,"Virginia","Radford city",2,59,140,64,76
050,51,750,"Virginia","Radford city",2,60,133,62,71
050,51,750,"Virginia","Radford city",2,61,121,56,65
050,51,750,"Virginia","Radford city",2,62,133,72,61
050,51,750,"Virginia","Radford city",2,63,138,71,67
050,51,750,"Virginia","Radford city",2,64,134,60,74
050,51,750,"Virginia","Radford city",2,65,138,54,84
050,51,750,"Virginia","Radford city",2,66,141,62,79
050,51,750,"Virginia","Radford city",2,67,129,64,65
050,51,750,"Virginia","Radford city",2,68,105,51,54
050,51,750,"Virginia","Radford city",2,69,90,43,47
050,51,750,"Virginia","Radford city",2,70,82,35,47
050,51,750,"Virginia","Radford city",2,71,71,29,42
050,51,750,"Virginia","Radford city",2,72,65,33,32
050,51,750,"Virginia","Radford city",2,73,66,37,29
050,51,750,"Virginia","Radford city",2,74,52,28,24
050,51,750,"Virginia","Radford city",2,75,42,22,20
050,51,750,"Virginia","Radford city",2,76,48,22,26
050,51,750,"Virginia","Radford city",2,77,66,24,42
050,51,750,"Virginia","Radford city",2,78,55,21,34
050,51,750,"Virginia","Radford city",2,79,45,20,25
050,51,750,"Virginia","Radford city",2,80,38,16,22
050,51,750,"Virginia","Radford city",2,81,34,17,17
050,51,750,"Virginia","Radford city",2,82,38,19,19
050,51,750,"Virginia","Radford city",2,83,33,11,22
050,51,750,"Virginia","Radford city",2,84,28,8,20
050,51,750,"Virginia","Radford city",2,85,177,43,134
050,51,750,"Virginia","Radford city",3,0,149,68,81
050,51,750,"Virginia","Radford city",3,1,125,61,64
050,51,750,"Virginia","Radford city",3,2,94,45,49
050,51,750,"Virginia","Radford city",3,3,98,50,48
050,51,750,"Virginia","Radford city",3,4,117,63,54
050,51,750,"Virginia","Radford city",3,5,98,53,45
050,51,750,"Virginia","Radford city",3,6,106,59,47
050,51,750,"Virginia","Radford city",3,7,118,55,63
050,51,750,"Virginia","Radford city",3,8,126,58,68
050,51,750,"Virginia","Radford city",3,9,105,51,54
050,51,750,"Virginia","Radford city",3,10,105,50,55
050,51,750,"Virginia","Radford city",3,11,104,54,50
050,51,750,"Virginia","Radford city",3,12,108,51,57
050,51,750,"Virginia","Radford city",3,13,123,55,68
050,51,750,"Virginia","Radford city",3,14,126,63,63
050,51,750,"Virginia","Radford city",3,15,114,56,58
050,51,750,"Virginia","Radford city",3,16,114,63,51
050,51,750,"Virginia","Radford city",3,17,126,60,66
050,51,750,"Virginia","Radford city",3,18,922,365,557
050,51,750,"Virginia","Radford city",3,19,1606,638,968
050,51,750,"Virginia","Radford city",3,20,1337,496,841
050,51,750,"Virginia","Radford city",3,21,1209,572,637
050,51,750,"Virginia","Radford city",3,22,689,375,314
050,51,750,"Virginia","Radford city",3,23,567,326,241
050,51,750,"Virginia","Radford city",3,24,366,171,195
050,51,750,"Virginia","Radford city",3,25,275,158,117
050,51,750,"Virginia","Radford city",3,26,236,123,113
050,51,750,"Virginia","Radford city",3,27,212,106,106
050,51,750,"Virginia","Radford city",3,28,209,111,98
050,51,750,"Virginia","Radford city",3,29,189,96,93
050,51,750,"Virginia","Radford city",3,30,188,104,84
050,51,750,"Virginia","Radford city",3,31,179,94,85
050,51,750,"Virginia","Radford city",3,32,185,93,92
050,51,750,"Virginia","Radford city",3,33,172,84,88
050,51,750,"Virginia","Radford city",3,34,141,69,72
050,51,750,"Virginia","Radford city",3,35,142,69,73
050,51,750,"Virginia","Radford city",3,36,158,80,78
050,51,750,"Virginia","Radford city",3,37,156,71,85
050,51,750,"Virginia","Radford city",3,38,130,65,65
050,51,750,"Virginia","Radford city",3,39,130,65,65
050,51,750,"Virginia","Radford city",3,40,132,61,71
050,51,750,"Virginia","Radford city",3,41,135,59,76
050,51,750,"Virginia","Radford city",3,42,147,66,81
050,51,750,"Virginia","Radford city",3,43,155,70,85
050,51,750,"Virginia","Radford city",3,44,140,63,77
050,51,750,"Virginia","Radford city",3,45,149,71,78
050,51,750,"Virginia","Radford city",3,46,136,61,75
050,51,750,"Virginia","Radford city",3,47,110,55,55
050,51,750,"Virginia","Radford city",3,48,136,65,71
050,51,750,"Virginia","Radford city",3,49,146,79,67
050,51,750,"Virginia","Radford city",3,50,169,98,71
050,51,750,"Virginia","Radford city",3,51,169,92,77
050,51,750,"Virginia","Radford city",3,52,134,66,68
050,51,750,"Virginia","Radford city",3,53,119,66,53
050,51,750,"Virginia","Radford city",3,54,142,74,68
050,51,750,"Virginia","Radford city",3,55,139,66,73
050,51,750,"Virginia","Radford city",3,56,151,71,80
050,51,750,"Virginia","Radford city",3,57,156,72,84
050,51,750,"Virginia","Radford city",3,58,147,72,75
050,51,750,"Virginia","Radford city",3,59,143,69,74
050,51,750,"Virginia","Radford city",3,60,136,63,73
050,51,750,"Virginia","Radford city",3,61,140,65,75
050,51,750,"Virginia","Radford city",3,62,114,56,58
050,51,750,"Virginia","Radford city",3,63,131,68,63
050,51,750,"Virginia","Radford city",3,64,125,66,59
050,51,750,"Virginia","Radford city",3,65,133,59,74
050,51,750,"Virginia","Radford city",3,66,133,54,79
050,51,750,"Virginia","Radford city",3,67,137,56,81
050,51,750,"Virginia","Radford city",3,68,124,61,63
050,51,750,"Virginia","Radford city",3,69,104,52,52
050,51,750,"Virginia","Radford city",3,70,85,38,47
050,51,750,"Virginia","Radford city",3,71,80,32,48
050,51,750,"Virginia","Radford city",3,72,68,28,40
050,51,750,"Virginia","Radford city",3,73,60,32,28
050,51,750,"Virginia","Radford city",3,74,70,42,28
050,51,750,"Virginia","Radford city",3,75,44,22,22
050,51,750,"Virginia","Radford city",3,76,39,19,20
050,51,750,"Virginia","Radford city",3,77,42,20,22
050,51,750,"Virginia","Radford city",3,78,61,22,39
050,51,750,"Virginia","Radford city",3,79,59,23,36
050,51,750,"Virginia","Radford city",3,80,43,16,27
050,51,750,"Virginia","Radford city",3,81,34,16,18
050,51,750,"Virginia","Radford city",3,82,30,15,15
050,51,750,"Virginia","Radford city",3,83,37,17,20
050,51,750,"Virginia","Radford city",3,84,27,10,17
050,51,750,"Virginia","Radford city",3,85,162,31,131
050,51,750,"Virginia","Radford city",4,0,140,70,70
050,51,750,"Virginia","Radford city",4,1,143,70,73
050,51,750,"Virginia","Radford city",4,2,129,70,59
050,51,750,"Virginia","Radford city",4,3,94,42,52
050,51,750,"Virginia","Radford city",4,4,102,50,52
050,51,750,"Virginia","Radford city",4,5,124,67,57
050,51,750,"Virginia","Radford city",4,6,101,57,44
050,51,750,"Virginia","Radford city",4,7,112,61,51
050,51,750,"Virginia","Radford city",4,8,111,54,57
050,51,750,"Virginia","Radford city",4,9,115,56,59
050,51,750,"Virginia","Radford city",4,10,112,51,61
050,51,750,"Virginia","Radford city",4,11,109,52,57
050,51,750,"Virginia","Radford city",4,12,102,57,45
050,51,750,"Virginia","Radford city",4,13,112,55,57
050,51,750,"Virginia","Radford city",4,14,122,57,65
050,51,750,"Virginia","Radford city",4,15,123,58,65
050,51,750,"Virginia","Radford city",4,16,102,52,50
050,51,750,"Virginia","Radford city",4,17,127,67,60
050,51,750,"Virginia","Radford city",4,18,920,364,556
050,51,750,"Virginia","Radford city",4,19,1594,632,962
050,51,750,"Virginia","Radford city",4,20,1341,511,830
050,51,750,"Virginia","Radford city",4,21,1293,602,691
050,51,750,"Virginia","Radford city",4,22,742,398,344
050,51,750,"Virginia","Radford city",4,23,573,334,239
050,51,750,"Virginia","Radford city",4,24,354,138,216
050,51,750,"Virginia","Radford city",4,25,277,140,137
050,51,750,"Virginia","Radford city",4,26,215,123,92
050,51,750,"Virginia","Radford city",4,27,204,98,106
050,51,750,"Virginia","Radford city",4,28,203,106,97
050,51,750,"Virginia","Radford city",4,29,201,104,97
050,51,750,"Virginia","Radford city",4,30,193,101,92
050,51,750,"Virginia","Radford city",4,31,181,103,78
050,51,750,"Virginia","Radford city",4,32,177,94,83
050,51,750,"Virginia","Radford city",4,33,174,88,86
050,51,750,"Virginia","Radford city",4,34,180,89,91
050,51,750,"Virginia","Radford city",4,35,144,71,73
050,51,750,"Virginia","Radford city",4,36,148,72,76
050,51,750,"Virginia","Radford city",4,37,144,66,78
050,51,750,"Virginia","Radford city",4,38,144,67,77
050,51,750,"Virginia","Radford city",4,39,141,73,68
050,51,750,"Virginia","Radford city",4,40,134,69,65
050,51,750,"Virginia","Radford city",4,41,142,65,77
050,51,750,"Virginia","Radford city",4,42,142,62,80
050,51,750,"Virginia","Radford city",4,43,139,62,77
050,51,750,"Virginia","Radford city",4,44,146,71,75
050,51,750,"Virginia","Radford city",4,45,150,65,85
050,51,750,"Virginia","Radford city",4,46,154,75,79
050,51,750,"Virginia","Radford city",4,47,134,63,71
050,51,750,"Virginia","Radford city",4,48,105,52,53
050,51,750,"Virginia","Radford city",4,49,133,64,69
050,51,750,"Virginia","Radford city",4,50,153,82,71
050,51,750,"Virginia","Radford city",4,51,164,95,69
050,51,750,"Virginia","Radford city",4,52,174,98,76
050,51,750,"Virginia","Radford city",4,53,129,64,65
050,51,750,"Virginia","Radford city",4,54,124,67,57
050,51,750,"Virginia","Radford city",4,55,143,73,70
050,51,750,"Virginia","Radford city",4,56,135,61,74
050,51,750,"Virginia","Radford city",4,57,149,75,74
050,51,750,"Virginia","Radford city",4,58,152,74,78
050,51,750,"Virginia","Radford city",4,59,137,69,68
050,51,750,"Virginia","Radford city",4,60,143,67,76
050,51,750,"Virginia","Radford city",4,61,139,67,72
050,51,750,"Virginia","Radford city",4,62,139,64,75
050,51,750,"Virginia","Radford city",4,63,112,57,55
050,51,750,"Virginia","Radford city",4,64,124,64,60
050,51,750,"Virginia","Radford city",4,65,119,61,58
050,51,750,"Virginia","Radford city",4,66,127,60,67
050,51,750,"Virginia","Radford city",4,67,127,51,76
050,51,750,"Virginia","Radford city",4,68,128,55,73
050,51,750,"Virginia","Radford city",4,69,118,59,59
050,51,750,"Virginia","Radford city",4,70,96,46,50
050,51,750,"Virginia","Radford city",4,71,82,35,47
050,51,750,"Virginia","Radford city",4,72,78,32,46
050,51,750,"Virginia","Radford city",4,73,59,23,36
050,51,750,"Virginia","Radford city",4,74,62,36,26
050,51,750,"Virginia","Radford city",4,75,64,35,29
050,51,750,"Virginia","Radford city",4,76,44,22,22
050,51,750,"Virginia","Radford city",4,77,37,18,19
050,51,750,"Virginia","Radford city",4,78,38,19,19
050,51,750,"Virginia","Radford city",4,79,64,23,41
050,51,750,"Virginia","Radford city",4,80,58,21,37
050,51,750,"Virginia","Radford city",4,81,37,17,20
050,51,750,"Virginia","Radford city",4,82,35,16,19
050,51,750,"Virginia","Radford city",4,83,31,13,18
050,51,750,"Virginia","Radford city",4,84,31,16,15
050,51,750,"Virginia","Radford city",4,85,165,30,135
050,51,750,"Virginia","Radford city",5,0,139,70,69
050,51,750,"Virginia","Radford city",5,1,158,70,88
050,51,750,"Virginia","Radford city",5,2,134,68,66
050,51,750,"Virginia","Radford city",5,3,125,61,64
050,51,750,"Virginia","Radford city",5,4,117,57,60
050,51,750,"Virginia","Radford city",5,5,118,60,58
050,51,750,"Virginia","Radford city",5,6,136,68,68
050,51,750,"Virginia","Radford city",5,7,87,49,38
050,51,750,"Virginia","Radford city",5,8,121,64,57
050,51,750,"Virginia","Radford city",5,9,116,60,56
050,51,750,"Virginia","Radford city",5,10,122,57,65
050,51,750,"Virginia","Radford city",5,11,118,56,62
050,51,750,"Virginia","Radford city",5,12,112,56,56
050,51,750,"Virginia","Radford city",5,13,108,58,50
050,51,750,"Virginia","Radford city",5,14,102,52,50
050,51,750,"Virginia","Radford city",5,15,129,58,71
050,51,750,"Virginia","Radford city",5,16,123,61,62
050,51,750,"Virginia","Radford city",5,17,109,57,52
050,51,750,"Virginia","Radford city",5,18,898,363,535
050,51,750,"Virginia","Radford city",5,19,1606,639,967
050,51,750,"Virginia","Radford city",5,20,1325,497,828
050,51,750,"Virginia","Radford city",5,21,1256,592,664
050,51,750,"Virginia","Radford city",5,22,784,409,375
050,51,750,"Virginia","Radford city",5,23,584,345,239
050,51,750,"Virginia","Radford city",5,24,366,156,210
050,51,750,"Virginia","Radford city",5,25,273,125,148
050,51,750,"Virginia","Radford city",5,26,240,118,122
050,51,750,"Virginia","Radford city",5,27,190,106,84
050,51,750,"Virginia","Radford city",5,28,195,97,98
050,51,750,"Virginia","Radford city",5,29,199,104,95
050,51,750,"Virginia","Radford city",5,30,218,112,106
050,51,750,"Virginia","Radford city",5,31,188,101,87
050,51,750,"Virginia","Radford city",5,32,171,92,79
050,51,750,"Virginia","Radford city",5,33,186,100,86
050,51,750,"Virginia","Radford city",5,34,192,98,94
050,51,750,"Virginia","Radford city",5,35,182,86,96
050,51,750,"Virginia","Radford city",5,36,150,77,73
050,51,750,"Virginia","Radford city",5,37,151,66,85
050,51,750,"Virginia","Radford city",5,38,155,77,78
050,51,750,"Virginia","Radford city",5,39,142,68,74
050,51,750,"Virginia","Radford city",5,40,141,73,68
050,51,750,"Virginia","Radford city",5,41,142,79,63
050,51,750,"Virginia","Radford city",5,42,145,61,84
050,51,750,"Virginia","Radford city",5,43,141,67,74
050,51,750,"Virginia","Radford city",5,44,143,67,76
050,51,750,"Virginia","Radford city",5,45,145,66,79
050,51,750,"Virginia","Radford city",5,46,138,64,74
050,51,750,"Virginia","Radford city",5,47,153,76,77
050,51,750,"Virginia","Radford city",5,48,136,63,73
050,51,750,"Virginia","Radford city",5,49,102,53,49
050,51,750,"Virginia","Radford city",5,50,135,69,66
050,51,750,"Virginia","Radford city",5,51,144,77,67
050,51,750,"Virginia","Radford city",5,52,162,93,69
050,51,750,"Virginia","Radford city",5,53,173,94,79
050,51,750,"Virginia","Radford city",5,54,129,65,64
050,51,750,"Virginia","Radford city",5,55,127,71,56
050,51,750,"Virginia","Radford city",5,56,139,68,71
050,51,750,"Virginia","Radford city",5,57,143,62,81
050,51,750,"Virginia","Radford city",5,58,154,72,82
050,51,750,"Virginia","Radford city",5,59,146,72,74
050,51,750,"Virginia","Radford city",5,60,135,66,69
050,51,750,"Virginia","Radford city",5,61,141,69,72
050,51,750,"Virginia","Radford city",5,62,138,66,72
050,51,750,"Virginia","Radford city",5,63,134,59,75
050,51,750,"Virginia","Radford city",5,64,105,52,53
050,51,750,"Virginia","Radford city",5,65,110,64,46
050,51,750,"Virginia","Radford city",5,66,121,59,62
050,51,750,"Virginia","Radford city",5,67,122,57,65
050,51,750,"Virginia","Radford city",5,68,125,48,77
050,51,750,"Virginia","Radford city",5,69,128,57,71
050,51,750,"Virginia","Radford city",5,70,103,51,52
050,51,750,"Virginia","Radford city",5,71,97,43,54
050,51,750,"Virginia","Radford city",5,72,86,38,48
050,51,750,"Virginia","Radford city",5,73,74,27,47
050,51,750,"Virginia","Radford city",5,74,64,29,35
050,51,750,"Virginia","Radford city",5,75,55,30,25
050,51,750,"Virginia","Radford city",5,76,67,35,32
050,51,750,"Virginia","Radford city",5,77,47,23,24
050,51,750,"Virginia","Radford city",5,78,34,18,16
050,51,750,"Virginia","Radford city",5,79,42,20,22
050,51,750,"Virginia","Radford city",5,80,64,22,42
050,51,750,"Virginia","Radford city",5,81,53,22,31
050,51,750,"Virginia","Radford city",5,82,37,18,19
050,51,750,"Virginia","Radford city",5,83,37,15,22
050,51,750,"Virginia","Radford city",5,84,26,12,14
050,51,750,"Virginia","Radford city",5,85,163,31,132
050,51,760,"Virginia","Richmond city",1,0,3038,1560,1478
050,51,760,"Virginia","Richmond city",1,1,2760,1436,1324
050,51,760,"Virginia","Richmond city",1,2,2570,1359,1211
050,51,760,"Virginia","Richmond city",1,3,2518,1279,1239
050,51,760,"Virginia","Richmond city",1,4,2441,1259,1182
050,51,760,"Virginia","Richmond city",1,5,2292,1149,1143
050,51,760,"Virginia","Richmond city",1,6,2196,1097,1099
050,51,760,"Virginia","Richmond city",1,7,2219,1132,1087
050,51,760,"Virginia","Richmond city",1,8,2236,1158,1078
050,51,760,"Virginia","Richmond city",1,9,2114,1081,1033
050,51,760,"Virginia","Richmond city",1,10,2112,1067,1045
050,51,760,"Virginia","Richmond city",1,11,2110,1060,1050
050,51,760,"Virginia","Richmond city",1,12,2173,1057,1116
050,51,760,"Virginia","Richmond city",1,13,2076,1055,1021
050,51,760,"Virginia","Richmond city",1,14,1921,976,945
050,51,760,"Virginia","Richmond city",1,15,1854,949,905
050,51,760,"Virginia","Richmond city",1,16,1821,902,919
050,51,760,"Virginia","Richmond city",1,17,1822,891,931
050,51,760,"Virginia","Richmond city",1,18,3648,1581,2067
050,51,760,"Virginia","Richmond city",1,19,4368,2020,2348
050,51,760,"Virginia","Richmond city",1,20,3370,1547,1823
050,51,760,"Virginia","Richmond city",1,21,3365,1527,1838
050,51,760,"Virginia","Richmond city",1,22,3361,1534,1827
050,51,760,"Virginia","Richmond city",1,23,3819,1775,2044
050,51,760,"Virginia","Richmond city",1,24,4421,2022,2399
050,51,760,"Virginia","Richmond city",1,25,4840,2296,2544
050,51,760,"Virginia","Richmond city",1,26,5181,2459,2722
050,51,760,"Virginia","Richmond city",1,27,5228,2454,2774
050,51,760,"Virginia","Richmond city",1,28,5362,2524,2838
050,51,760,"Virginia","Richmond city",1,29,5570,2647,2923
050,51,760,"Virginia","Richmond city",1,30,5230,2520,2710
050,51,760,"Virginia","Richmond city",1,31,4873,2368,2505
050,51,760,"Virginia","Richmond city",1,32,4767,2324,2443
050,51,760,"Virginia","Richmond city",1,33,4400,2146,2254
050,51,760,"Virginia","Richmond city",1,34,4102,2016,2086
050,51,760,"Virginia","Richmond city",1,35,3871,1982,1889
050,51,760,"Virginia","Richmond city",1,36,3521,1760,1761
050,51,760,"Virginia","Richmond city",1,37,3457,1744,1713
050,51,760,"Virginia","Richmond city",1,38,3130,1616,1514
050,51,760,"Virginia","Richmond city",1,39,2967,1546,1421
050,51,760,"Virginia","Richmond city",1,40,2821,1447,1374
050,51,760,"Virginia","Richmond city",1,41,2638,1350,1288
050,51,760,"Virginia","Richmond city",1,42,2356,1167,1189
050,51,760,"Virginia","Richmond city",1,43,2352,1212,1140
050,51,760,"Virginia","Richmond city",1,44,2167,1099,1068
050,51,760,"Virginia","Richmond city",1,45,2272,1109,1163
050,51,760,"Virginia","Richmond city",1,46,2127,1052,1075
050,51,760,"Virginia","Richmond city",1,47,2166,1050,1116
050,51,760,"Virginia","Richmond city",1,48,2269,1102,1167
050,51,760,"Virginia","Richmond city",1,49,2510,1261,1249
050,51,760,"Virginia","Richmond city",1,50,2497,1250,1247
050,51,760,"Virginia","Richmond city",1,51,2363,1142,1221
050,51,760,"Virginia","Richmond city",1,52,2402,1158,1244
050,51,760,"Virginia","Richmond city",1,53,2483,1185,1298
050,51,760,"Virginia","Richmond city",1,54,2549,1217,1332
050,51,760,"Virginia","Richmond city",1,55,2741,1279,1462
050,51,760,"Virginia","Richmond city",1,56,2716,1296,1420
050,51,760,"Virginia","Richmond city",1,57,2760,1323,1437
050,51,760,"Virginia","Richmond city",1,58,2754,1253,1501
050,51,760,"Virginia","Richmond city",1,59,2783,1236,1547
050,51,760,"Virginia","Richmond city",1,60,2862,1321,1541
050,51,760,"Virginia","Richmond city",1,61,2747,1270,1477
050,51,760,"Virginia","Richmond city",1,62,2740,1263,1477
050,51,760,"Virginia","Richmond city",1,63,2654,1223,1431
050,51,760,"Virginia","Richmond city",1,64,2598,1160,1438
050,51,760,"Virginia","Richmond city",1,65,2566,1164,1402
050,51,760,"Virginia","Richmond city",1,66,2406,1080,1326
050,51,760,"Virginia","Richmond city",1,67,2277,1054,1223
050,51,760,"Virginia","Richmond city",1,68,2172,1009,1163
050,51,760,"Virginia","Richmond city",1,69,2012,906,1106
050,51,760,"Virginia","Richmond city",1,70,1838,830,1008
050,51,760,"Virginia","Richmond city",1,71,1746,794,952
050,51,760,"Virginia","Richmond city",1,72,1645,748,897
050,51,760,"Virginia","Richmond city",1,73,1541,686,855
050,51,760,"Virginia","Richmond city",1,74,1092,480,612
050,51,760,"Virginia","Richmond city",1,75,1023,418,605
050,51,760,"Virginia","Richmond city",1,76,994,397,597
050,51,760,"Virginia","Richmond city",1,77,935,390,545
050,51,760,"Virginia","Richmond city",1,78,808,334,474
050,51,760,"Virginia","Richmond city",1,79,737,294,443
050,51,760,"Virginia","Richmond city",1,80,694,275,419
050,51,760,"Virginia","Richmond city",1,81,626,234,392
050,51,760,"Virginia","Richmond city",1,82,559,215,344
050,51,760,"Virginia","Richmond city",1,83,513,190,323
050,51,760,"Virginia","Richmond city",1,84,474,179,295
050,51,760,"Virginia","Richmond city",1,85,3439,1172,2267
050,51,760,"Virginia","Richmond city",2,0,3004,1557,1447
050,51,760,"Virginia","Richmond city",2,1,2788,1454,1334
050,51,760,"Virginia","Richmond city",2,2,2590,1367,1223
050,51,760,"Virginia","Richmond city",2,3,2493,1281,1212
050,51,760,"Virginia","Richmond city",2,4,2428,1247,1181
050,51,760,"Virginia","Richmond city",2,5,2303,1162,1141
050,51,760,"Virginia","Richmond city",2,6,2196,1100,1096
050,51,760,"Virginia","Richmond city",2,7,2199,1114,1085
050,51,760,"Virginia","Richmond city",2,8,2202,1136,1066
050,51,760,"Virginia","Richmond city",2,9,2120,1088,1032
050,51,760,"Virginia","Richmond city",2,10,2083,1055,1028
050,51,760,"Virginia","Richmond city",2,11,2080,1041,1039
050,51,760,"Virginia","Richmond city",2,12,2149,1051,1098
050,51,760,"Virginia","Richmond city",2,13,2084,1048,1036
050,51,760,"Virginia","Richmond city",2,14,1943,986,957
050,51,760,"Virginia","Richmond city",2,15,1851,944,907
050,51,760,"Virginia","Richmond city",2,16,1817,901,916
050,51,760,"Virginia","Richmond city",2,17,1826,887,939
050,51,760,"Virginia","Richmond city",2,18,3651,1575,2076
050,51,760,"Virginia","Richmond city",2,19,4354,2002,2352
050,51,760,"Virginia","Richmond city",2,20,3396,1560,1836
050,51,760,"Virginia","Richmond city",2,21,3393,1541,1852
050,51,760,"Virginia","Richmond city",2,22,3437,1567,1870
050,51,760,"Virginia","Richmond city",2,23,3793,1751,2042
050,51,760,"Virginia","Richmond city",2,24,4346,1993,2353
050,51,760,"Virginia","Richmond city",2,25,4809,2265,2544
050,51,760,"Virginia","Richmond city",2,26,5137,2435,2702
050,51,760,"Virginia","Richmond city",2,27,5228,2466,2762
050,51,760,"Virginia","Richmond city",2,28,5328,2513,2815
050,51,760,"Virginia","Richmond city",2,29,5484,2604,2880
050,51,760,"Virginia","Richmond city",2,30,5296,2532,2764
050,51,760,"Virginia","Richmond city",2,31,4915,2389,2526
050,51,760,"Virginia","Richmond city",2,32,4732,2305,2427
050,51,760,"Virginia","Richmond city",2,33,4434,2160,2274
050,51,760,"Virginia","Richmond city",2,34,4147,2043,2104
050,51,760,"Virginia","Richmond city",2,35,3912,1979,1933
050,51,760,"Virginia","Richmond city",2,36,3560,1786,1774
050,51,760,"Virginia","Richmond city",2,37,3457,1743,1714
050,51,760,"Virginia","Richmond city",2,38,3198,1644,1554
050,51,760,"Virginia","Richmond city",2,39,2975,1543,1432
050,51,760,"Virginia","Richmond city",2,40,2877,1480,1397
050,51,760,"Virginia","Richmond city",2,41,2665,1357,1308
050,51,760,"Virginia","Richmond city",2,42,2398,1192,1206
050,51,760,"Virginia","Richmond city",2,43,2358,1204,1154
050,51,760,"Virginia","Richmond city",2,44,2193,1114,1079
050,51,760,"Virginia","Richmond city",2,45,2265,1120,1145
050,51,760,"Virginia","Richmond city",2,46,2153,1059,1094
050,51,760,"Virginia","Richmond city",2,47,2151,1037,1114
050,51,760,"Virginia","Richmond city",2,48,2244,1085,1159
050,51,760,"Virginia","Richmond city",2,49,2473,1237,1236
050,51,760,"Virginia","Richmond city",2,50,2515,1265,1250
050,51,760,"Virginia","Richmond city",2,51,2376,1156,1220
050,51,760,"Virginia","Richmond city",2,52,2402,1158,1244
050,51,760,"Virginia","Richmond city",2,53,2462,1174,1288
050,51,760,"Virginia","Richmond city",2,54,2535,1210,1325
050,51,760,"Virginia","Richmond city",2,55,2694,1265,1429
050,51,760,"Virginia","Richmond city",2,56,2722,1289,1433
050,51,760,"Virginia","Richmond city",2,57,2754,1318,1436
050,51,760,"Virginia","Richmond city",2,58,2758,1267,1491
050,51,760,"Virginia","Richmond city",2,59,2777,1240,1537
050,51,760,"Virginia","Richmond city",2,60,2844,1305,1539
050,51,760,"Virginia","Richmond city",2,61,2773,1280,1493
050,51,760,"Virginia","Richmond city",2,62,2740,1264,1476
050,51,760,"Virginia","Richmond city",2,63,2704,1245,1459
050,51,760,"Virginia","Richmond city",2,64,2599,1167,1432
050,51,760,"Virginia","Richmond city",2,65,2549,1149,1400
050,51,760,"Virginia","Richmond city",2,66,2439,1095,1344
050,51,760,"Virginia","Richmond city",2,67,2290,1051,1239
050,51,760,"Virginia","Richmond city",2,68,2163,1000,1163
050,51,760,"Virginia","Richmond city",2,69,2047,929,1118
050,51,760,"Virginia","Richmond city",2,70,1862,839,1023
050,51,760,"Virginia","Richmond city",2,71,1759,799,960
050,51,760,"Virginia","Richmond city",2,72,1651,749,902
050,51,760,"Virginia","Richmond city",2,73,1616,724,892
050,51,760,"Virginia","Richmond city",2,74,1133,495,638
050,51,760,"Virginia","Richmond city",2,75,1040,434,606
050,51,760,"Virginia","Richmond city",2,76,982,394,588
050,51,760,"Virginia","Richmond city",2,77,947,393,554
050,51,760,"Virginia","Richmond city",2,78,813,334,479
050,51,760,"Virginia","Richmond city",2,79,749,303,446
050,51,760,"Virginia","Richmond city",2,80,698,276,422
050,51,760,"Virginia","Richmond city",2,81,626,242,384
050,51,760,"Virginia","Richmond city",2,82,570,216,354
050,51,760,"Virginia","Richmond city",2,83,512,189,323
050,51,760,"Virginia","Richmond city",2,84,482,181,301
050,51,760,"Virginia","Richmond city",2,85,3438,1172,2266
050,51,760,"Virginia","Richmond city",3,0,2866,1493,1373
050,51,760,"Virginia","Richmond city",3,1,2892,1465,1427
050,51,760,"Virginia","Richmond city",3,2,2597,1364,1233
050,51,760,"Virginia","Richmond city",3,3,2487,1298,1189
050,51,760,"Virginia","Richmond city",3,4,2407,1258,1149
050,51,760,"Virginia","Richmond city",3,5,2298,1161,1137
050,51,760,"Virginia","Richmond city",3,6,2265,1142,1123
050,51,760,"Virginia","Richmond city",3,7,2130,1063,1067
050,51,760,"Virginia","Richmond city",3,8,2163,1111,1052
050,51,760,"Virginia","Richmond city",3,9,2121,1093,1028
050,51,760,"Virginia","Richmond city",3,10,2044,1051,993
050,51,760,"Virginia","Richmond city",3,11,2003,1023,980
050,51,760,"Virginia","Richmond city",3,12,2041,1022,1019
050,51,760,"Virginia","Richmond city",3,13,2091,1040,1051
050,51,760,"Virginia","Richmond city",3,14,1989,997,992
050,51,760,"Virginia","Richmond city",3,15,1887,944,943
050,51,760,"Virginia","Richmond city",3,16,1807,916,891
050,51,760,"Virginia","Richmond city",3,17,1849,899,950
050,51,760,"Virginia","Richmond city",3,18,3643,1576,2067
050,51,760,"Virginia","Richmond city",3,19,4283,1932,2351
050,51,760,"Virginia","Richmond city",3,20,3327,1543,1784
050,51,760,"Virginia","Richmond city",3,21,3404,1573,1831
050,51,760,"Virginia","Richmond city",3,22,3414,1501,1913
050,51,760,"Virginia","Richmond city",3,23,3728,1653,2075
050,51,760,"Virginia","Richmond city",3,24,4176,1895,2281
050,51,760,"Virginia","Richmond city",3,25,4579,2110,2469
050,51,760,"Virginia","Richmond city",3,26,4978,2295,2683
050,51,760,"Virginia","Richmond city",3,27,5322,2541,2781
050,51,760,"Virginia","Richmond city",3,28,5186,2456,2730
050,51,760,"Virginia","Richmond city",3,29,5278,2465,2813
050,51,760,"Virginia","Richmond city",3,30,5323,2536,2787
050,51,760,"Virginia","Richmond city",3,31,5152,2469,2683
050,51,760,"Virginia","Richmond city",3,32,4815,2359,2456
050,51,760,"Virginia","Richmond city",3,33,4601,2251,2350
050,51,760,"Virginia","Richmond city",3,34,4330,2143,2187
050,51,760,"Virginia","Richmond city",3,35,4002,1973,2029
050,51,760,"Virginia","Richmond city",3,36,3761,1911,1850
050,51,760,"Virginia","Richmond city",3,37,3411,1716,1695
050,51,760,"Virginia","Richmond city",3,38,3366,1717,1649
050,51,760,"Virginia","Richmond city",3,39,3126,1603,1523
050,51,760,"Virginia","Richmond city",3,40,2847,1449,1398
050,51,760,"Virginia","Richmond city",3,41,2777,1408,1369
050,51,760,"Virginia","Richmond city",3,42,2565,1291,1274
050,51,760,"Virginia","Richmond city",3,43,2318,1147,1171
050,51,760,"Virginia","Richmond city",3,44,2317,1168,1149
050,51,760,"Virginia","Richmond city",3,45,2183,1123,1060
050,51,760,"Virginia","Richmond city",3,46,2206,1067,1139
050,51,760,"Virginia","Richmond city",3,47,2094,1008,1086
050,51,760,"Virginia","Richmond city",3,48,2111,1011,1100
050,51,760,"Virginia","Richmond city",3,49,2283,1116,1167
050,51,760,"Virginia","Richmond city",3,50,2447,1216,1231
050,51,760,"Virginia","Richmond city",3,51,2479,1236,1243
050,51,760,"Virginia","Richmond city",3,52,2360,1151,1209
050,51,760,"Virginia","Richmond city",3,53,2384,1171,1213
050,51,760,"Virginia","Richmond city",3,54,2416,1152,1264
050,51,760,"Virginia","Richmond city",3,55,2518,1206,1312
050,51,760,"Virginia","Richmond city",3,56,2645,1232,1413
050,51,760,"Virginia","Richmond city",3,57,2703,1280,1423
050,51,760,"Virginia","Richmond city",3,58,2685,1282,1403
050,51,760,"Virginia","Richmond city",3,59,2717,1224,1493
050,51,760,"Virginia","Richmond city",3,60,2751,1242,1509
050,51,760,"Virginia","Richmond city",3,61,2794,1257,1537
050,51,760,"Virginia","Richmond city",3,62,2749,1289,1460
050,51,760,"Virginia","Richmond city",3,63,2686,1218,1468
050,51,760,"Virginia","Richmond city",3,64,2678,1222,1456
050,51,760,"Virginia","Richmond city",3,65,2477,1129,1348
050,51,760,"Virginia","Richmond city",3,66,2460,1095,1365
050,51,760,"Virginia","Richmond city",3,67,2376,1070,1306
050,51,760,"Virginia","Richmond city",3,68,2200,992,1208
050,51,760,"Virginia","Richmond city",3,69,2087,960,1127
050,51,760,"Virginia","Richmond city",3,70,1988,890,1098
050,51,760,"Virginia","Richmond city",3,71,1835,825,1010
050,51,760,"Virginia","Richmond city",3,72,1729,780,949
050,51,760,"Virginia","Richmond city",3,73,1598,729,869
050,51,760,"Virginia","Richmond city",3,74,1564,697,867
050,51,760,"Virginia","Richmond city",3,75,1093,473,620
050,51,760,"Virginia","Richmond city",3,76,1008,419,589
050,51,760,"Virginia","Richmond city",3,77,936,368,568
050,51,760,"Virginia","Richmond city",3,78,903,369,534
050,51,760,"Virginia","Richmond city",3,79,760,308,452
050,51,760,"Virginia","Richmond city",3,80,691,273,418
050,51,760,"Virginia","Richmond city",3,81,668,261,407
050,51,760,"Virginia","Richmond city",3,82,588,222,366
050,51,760,"Virginia","Richmond city",3,83,517,191,326
050,51,760,"Virginia","Richmond city",3,84,472,180,292
050,51,760,"Virginia","Richmond city",3,85,3335,1159,2176
050,51,760,"Virginia","Richmond city",4,0,2959,1483,1476
050,51,760,"Virginia","Richmond city",4,1,2731,1379,1352
050,51,760,"Virginia","Richmond city",4,2,2797,1417,1380
050,51,760,"Virginia","Richmond city",4,3,2533,1334,1199
050,51,760,"Virginia","Richmond city",4,4,2437,1252,1185
050,51,760,"Virginia","Richmond city",4,5,2374,1225,1149
050,51,760,"Virginia","Richmond city",4,6,2223,1128,1095
050,51,760,"Virginia","Richmond city",4,7,2198,1122,1076
050,51,760,"Virginia","Richmond city",4,8,2058,1025,1033
050,51,760,"Virginia","Richmond city",4,9,2107,1087,1020
050,51,760,"Virginia","Richmond city",4,10,2035,1025,1010
050,51,760,"Virginia","Richmond city",4,11,1973,1009,964
050,51,760,"Virginia","Richmond city",4,12,1952,997,955
050,51,760,"Virginia","Richmond city",4,13,1982,1004,978
050,51,760,"Virginia","Richmond city",4,14,2047,1021,1026
050,51,760,"Virginia","Richmond city",4,15,1954,974,980
050,51,760,"Virginia","Richmond city",4,16,1852,927,925
050,51,760,"Virginia","Richmond city",4,17,1855,935,920
050,51,760,"Virginia","Richmond city",4,18,3598,1532,2066
050,51,760,"Virginia","Richmond city",4,19,4239,1919,2320
050,51,760,"Virginia","Richmond city",4,20,3279,1455,1824
050,51,760,"Virginia","Richmond city",4,21,3345,1545,1800
050,51,760,"Virginia","Richmond city",4,22,3449,1582,1867
050,51,760,"Virginia","Richmond city",4,23,3809,1651,2158
050,51,760,"Virginia","Richmond city",4,24,4280,1920,2360
050,51,760,"Virginia","Richmond city",4,25,4555,2023,2532
050,51,760,"Virginia","Richmond city",4,26,4777,2153,2624
050,51,760,"Virginia","Richmond city",4,27,5270,2488,2782
050,51,760,"Virginia","Richmond city",4,28,5315,2601,2714
050,51,760,"Virginia","Richmond city",4,29,5184,2483,2701
050,51,760,"Virginia","Richmond city",4,30,5225,2441,2784
050,51,760,"Virginia","Richmond city",4,31,5237,2505,2732
050,51,760,"Virginia","Richmond city",4,32,5039,2401,2638
050,51,760,"Virginia","Richmond city",4,33,4754,2328,2426
050,51,760,"Virginia","Richmond city",4,34,4454,2169,2285
050,51,760,"Virginia","Richmond city",4,35,4235,2098,2137
050,51,760,"Virginia","Richmond city",4,36,3803,1886,1917
050,51,760,"Virginia","Richmond city",4,37,3681,1859,1822
050,51,760,"Virginia","Richmond city",4,38,3268,1647,1621
050,51,760,"Virginia","Richmond city",4,39,3245,1646,1599
050,51,760,"Virginia","Richmond city",4,40,2980,1517,1463
050,51,760,"Virginia","Richmond city",4,41,2778,1380,1398
050,51,760,"Virginia","Richmond city",4,42,2687,1343,1344
050,51,760,"Virginia","Richmond city",4,43,2504,1252,1252
050,51,760,"Virginia","Richmond city",4,44,2313,1123,1190
050,51,760,"Virginia","Richmond city",4,45,2320,1159,1161
050,51,760,"Virginia","Richmond city",4,46,2134,1102,1032
050,51,760,"Virginia","Richmond city",4,47,2185,1050,1135
050,51,760,"Virginia","Richmond city",4,48,2052,987,1065
050,51,760,"Virginia","Richmond city",4,49,2081,999,1082
050,51,760,"Virginia","Richmond city",4,50,2256,1110,1146
050,51,760,"Virginia","Richmond city",4,51,2401,1183,1218
050,51,760,"Virginia","Richmond city",4,52,2465,1243,1222
050,51,760,"Virginia","Richmond city",4,53,2317,1105,1212
050,51,760,"Virginia","Richmond city",4,54,2382,1174,1208
050,51,760,"Virginia","Richmond city",4,55,2405,1161,1244
050,51,760,"Virginia","Richmond city",4,56,2435,1165,1270
050,51,760,"Virginia","Richmond city",4,57,2621,1212,1409
050,51,760,"Virginia","Richmond city",4,58,2698,1275,1423
050,51,760,"Virginia","Richmond city",4,59,2645,1254,1391
050,51,760,"Virginia","Richmond city",4,60,2676,1205,1471
050,51,760,"Virginia","Richmond city",4,61,2664,1162,1502
050,51,760,"Virginia","Richmond city",4,62,2767,1259,1508
050,51,760,"Virginia","Richmond city",4,63,2686,1236,1450
050,51,760,"Virginia","Richmond city",4,64,2615,1175,1440
050,51,760,"Virginia","Richmond city",4,65,2587,1186,1401
050,51,760,"Virginia","Richmond city",4,66,2433,1101,1332
050,51,760,"Virginia","Richmond city",4,67,2391,1047,1344
050,51,760,"Virginia","Richmond city",4,68,2305,1021,1284
050,51,760,"Virginia","Richmond city",4,69,2127,964,1163
050,51,760,"Virginia","Richmond city",4,70,2027,921,1106
050,51,760,"Virginia","Richmond city",4,71,1930,865,1065
050,51,760,"Virginia","Richmond city",4,72,1755,770,985
050,51,760,"Virginia","Richmond city",4,73,1663,750,913
050,51,760,"Virginia","Richmond city",4,74,1548,709,839
050,51,760,"Virginia","Richmond city",4,75,1496,661,835
050,51,760,"Virginia","Richmond city",4,76,1031,441,590
050,51,760,"Virginia","Richmond city",4,77,973,394,579
050,51,760,"Virginia","Richmond city",4,78,874,339,535
050,51,760,"Virginia","Richmond city",4,79,864,343,521
050,51,760,"Virginia","Richmond city",4,80,712,281,431
050,51,760,"Virginia","Richmond city",4,81,648,250,398
050,51,760,"Virginia","Richmond city",4,82,633,242,391
050,51,760,"Virginia","Richmond city",4,83,512,196,316
050,51,760,"Virginia","Richmond city",4,84,478,185,293
050,51,760,"Virginia","Richmond city",4,85,3205,1141,2064
050,51,760,"Virginia","Richmond city",5,0,2960,1487,1473
050,51,760,"Virginia","Richmond city",5,1,2784,1352,1432
050,51,760,"Virginia","Richmond city",5,2,2552,1268,1284
050,51,760,"Virginia","Richmond city",5,3,2642,1351,1291
050,51,760,"Virginia","Richmond city",5,4,2442,1262,1180
050,51,760,"Virginia","Richmond city",5,5,2392,1197,1195
050,51,760,"Virginia","Richmond city",5,6,2272,1141,1131
050,51,760,"Virginia","Richmond city",5,7,2170,1130,1040
050,51,760,"Virginia","Richmond city",5,8,2092,1052,1040
050,51,760,"Virginia","Richmond city",5,9,1962,965,997
050,51,760,"Virginia","Richmond city",5,10,2064,1033,1031
050,51,760,"Virginia","Richmond city",5,11,1959,967,992
050,51,760,"Virginia","Richmond city",5,12,1895,948,947
050,51,760,"Virginia","Richmond city",5,13,1937,986,951
050,51,760,"Virginia","Richmond city",5,14,1915,958,957
050,51,760,"Virginia","Richmond city",5,15,1934,969,965
050,51,760,"Virginia","Richmond city",5,16,1953,967,986
050,51,760,"Virginia","Richmond city",5,17,1884,926,958
050,51,760,"Virginia","Richmond city",5,18,3616,1581,2035
050,51,760,"Virginia","Richmond city",5,19,4241,1917,2324
050,51,760,"Virginia","Richmond city",5,20,3201,1443,1758
050,51,760,"Virginia","Richmond city",5,21,3285,1456,1829
050,51,760,"Virginia","Richmond city",5,22,3339,1459,1880
050,51,760,"Virginia","Richmond city",5,23,3728,1697,2031
050,51,760,"Virginia","Richmond city",5,24,4242,1853,2389
050,51,760,"Virginia","Richmond city",5,25,4546,2030,2516
050,51,760,"Virginia","Richmond city",5,26,4717,2116,2601
050,51,760,"Virginia","Richmond city",5,27,4872,2215,2657
050,51,760,"Virginia","Richmond city",5,28,5209,2447,2762
050,51,760,"Virginia","Richmond city",5,29,5253,2542,2711
050,51,760,"Virginia","Richmond city",5,30,5124,2462,2662
050,51,760,"Virginia","Richmond city",5,31,5171,2431,2740
050,51,760,"Virginia","Richmond city",5,32,5102,2399,2703
050,51,760,"Virginia","Richmond city",5,33,4996,2411,2585
050,51,760,"Virginia","Richmond city",5,34,4622,2266,2356
050,51,760,"Virginia","Richmond city",5,35,4406,2158,2248
050,51,760,"Virginia","Richmond city",5,36,4140,2058,2082
050,51,760,"Virginia","Richmond city",5,37,3758,1861,1897
050,51,760,"Virginia","Richmond city",5,38,3607,1830,1777
050,51,760,"Virginia","Richmond city",5,39,3189,1616,1573
050,51,760,"Virginia","Richmond city",5,40,3179,1611,1568
050,51,760,"Virginia","Richmond city",5,41,2922,1463,1459
050,51,760,"Virginia","Richmond city",5,42,2677,1325,1352
050,51,760,"Virginia","Richmond city",5,43,2670,1324,1346
050,51,760,"Virginia","Richmond city",5,44,2497,1269,1228
050,51,760,"Virginia","Richmond city",5,45,2258,1120,1138
050,51,760,"Virginia","Richmond city",5,46,2305,1145,1160
050,51,760,"Virginia","Richmond city",5,47,2084,1034,1050
050,51,760,"Virginia","Richmond city",5,48,2116,1013,1103
050,51,760,"Virginia","Richmond city",5,49,2027,969,1058
050,51,760,"Virginia","Richmond city",5,50,2094,1023,1071
050,51,760,"Virginia","Richmond city",5,51,2212,1074,1138
050,51,760,"Virginia","Richmond city",5,52,2392,1195,1197
050,51,760,"Virginia","Richmond city",5,53,2492,1258,1234
050,51,760,"Virginia","Richmond city",5,54,2263,1086,1177
050,51,760,"Virginia","Richmond city",5,55,2336,1141,1195
050,51,760,"Virginia","Richmond city",5,56,2384,1121,1263
050,51,760,"Virginia","Richmond city",5,57,2397,1136,1261
050,51,760,"Virginia","Richmond city",5,58,2589,1197,1392
050,51,760,"Virginia","Richmond city",5,59,2644,1233,1411
050,51,760,"Virginia","Richmond city",5,60,2643,1248,1395
050,51,760,"Virginia","Richmond city",5,61,2613,1174,1439
050,51,760,"Virginia","Richmond city",5,62,2663,1182,1481
050,51,760,"Virginia","Richmond city",5,63,2690,1210,1480
050,51,760,"Virginia","Richmond city",5,64,2634,1204,1430
050,51,760,"Virginia","Richmond city",5,65,2538,1135,1403
050,51,760,"Virginia","Richmond city",5,66,2566,1193,1373
050,51,760,"Virginia","Richmond city",5,67,2353,1076,1277
050,51,760,"Virginia","Richmond city",5,68,2325,1026,1299
050,51,760,"Virginia","Richmond city",5,69,2257,988,1269
050,51,760,"Virginia","Richmond city",5,70,2088,942,1146
050,51,760,"Virginia","Richmond city",5,71,1954,888,1066
050,51,760,"Virginia","Richmond city",5,72,1896,833,1063
050,51,760,"Virginia","Richmond city",5,73,1715,751,964
050,51,760,"Virginia","Richmond city",5,74,1622,730,892
050,51,760,"Virginia","Richmond city",5,75,1504,686,818
050,51,760,"Virginia","Richmond city",5,76,1456,638,818
050,51,760,"Virginia","Richmond city",5,77,993,417,576
050,51,760,"Virginia","Richmond city",5,78,927,369,558
050,51,760,"Virginia","Richmond city",5,79,820,309,511
050,51,760,"Virginia","Richmond city",5,80,819,326,493
050,51,760,"Virginia","Richmond city",5,81,679,261,418
050,51,760,"Virginia","Richmond city",5,82,607,229,378
050,51,760,"Virginia","Richmond city",5,83,566,220,346
050,51,760,"Virginia","Richmond city",5,84,488,191,297
050,51,760,"Virginia","Richmond city",5,85,3120,1136,1984
050,51,770,"Virginia","Roanoke city",1,0,1394,708,686
050,51,770,"Virginia","Roanoke city",1,1,1345,677,668
050,51,770,"Virginia","Roanoke city",1,2,1224,582,642
050,51,770,"Virginia","Roanoke city",1,3,1252,629,623
050,51,770,"Virginia","Roanoke city",1,4,1333,665,668
050,51,770,"Virginia","Roanoke city",1,5,1327,649,678
050,51,770,"Virginia","Roanoke city",1,6,1306,656,650
050,51,770,"Virginia","Roanoke city",1,7,1285,649,636
050,51,770,"Virginia","Roanoke city",1,8,1271,630,641
050,51,770,"Virginia","Roanoke city",1,9,1237,639,598
050,51,770,"Virginia","Roanoke city",1,10,1240,630,610
050,51,770,"Virginia","Roanoke city",1,11,1306,649,657
050,51,770,"Virginia","Roanoke city",1,12,1316,674,642
050,51,770,"Virginia","Roanoke city",1,13,1319,668,651
050,51,770,"Virginia","Roanoke city",1,14,1202,619,583
050,51,770,"Virginia","Roanoke city",1,15,1123,580,543
050,51,770,"Virginia","Roanoke city",1,16,1147,597,550
050,51,770,"Virginia","Roanoke city",1,17,1135,570,565
050,51,770,"Virginia","Roanoke city",1,18,1011,537,474
050,51,770,"Virginia","Roanoke city",1,19,938,502,436
050,51,770,"Virginia","Roanoke city",1,20,982,544,438
050,51,770,"Virginia","Roanoke city",1,21,1002,494,508
050,51,770,"Virginia","Roanoke city",1,22,1046,497,549
050,51,770,"Virginia","Roanoke city",1,23,1128,527,601
050,51,770,"Virginia","Roanoke city",1,24,1292,594,698
050,51,770,"Virginia","Roanoke city",1,25,1433,658,775
050,51,770,"Virginia","Roanoke city",1,26,1575,767,808
050,51,770,"Virginia","Roanoke city",1,27,1603,787,816
050,51,770,"Virginia","Roanoke city",1,28,1593,755,838
050,51,770,"Virginia","Roanoke city",1,29,1645,777,868
050,51,770,"Virginia","Roanoke city",1,30,1602,777,825
050,51,770,"Virginia","Roanoke city",1,31,1571,742,829
050,51,770,"Virginia","Roanoke city",1,32,1503,748,755
050,51,770,"Virginia","Roanoke city",1,33,1423,687,736
050,51,770,"Virginia","Roanoke city",1,34,1392,687,705
050,51,770,"Virginia","Roanoke city",1,35,1385,669,716
050,51,770,"Virginia","Roanoke city",1,36,1301,655,646
050,51,770,"Virginia","Roanoke city",1,37,1316,668,648
050,51,770,"Virginia","Roanoke city",1,38,1244,632,612
050,51,770,"Virginia","Roanoke city",1,39,1321,647,674
050,51,770,"Virginia","Roanoke city",1,40,1325,644,681
050,51,770,"Virginia","Roanoke city",1,41,1224,554,670
050,51,770,"Virginia","Roanoke city",1,42,1222,570,652
050,51,770,"Virginia","Roanoke city",1,43,1187,539,648
050,51,770,"Virginia","Roanoke city",1,44,1118,542,576
050,51,770,"Virginia","Roanoke city",1,45,1089,526,563
050,51,770,"Virginia","Roanoke city",1,46,1120,551,569
050,51,770,"Virginia","Roanoke city",1,47,1175,566,609
050,51,770,"Virginia","Roanoke city",1,48,1275,609,666
050,51,770,"Virginia","Roanoke city",1,49,1331,664,667
050,51,770,"Virginia","Roanoke city",1,50,1228,607,621
050,51,770,"Virginia","Roanoke city",1,51,1193,581,612
050,51,770,"Virginia","Roanoke city",1,52,1165,597,568
050,51,770,"Virginia","Roanoke city",1,53,1196,612,584
050,51,770,"Virginia","Roanoke city",1,54,1241,618,623
050,51,770,"Virginia","Roanoke city",1,55,1282,654,628
050,51,770,"Virginia","Roanoke city",1,56,1268,599,669
050,51,770,"Virginia","Roanoke city",1,57,1288,601,687
050,51,770,"Virginia","Roanoke city",1,58,1345,645,700
050,51,770,"Virginia","Roanoke city",1,59,1303,623,680
050,51,770,"Virginia","Roanoke city",1,60,1305,629,676
050,51,770,"Virginia","Roanoke city",1,61,1303,606,697
050,51,770,"Virginia","Roanoke city",1,62,1302,590,712
050,51,770,"Virginia","Roanoke city",1,63,1238,602,636
050,51,770,"Virginia","Roanoke city",1,64,1234,579,655
050,51,770,"Virginia","Roanoke city",1,65,1196,557,639
050,51,770,"Virginia","Roanoke city",1,66,1193,558,635
050,51,770,"Virginia","Roanoke city",1,67,1189,535,654
050,51,770,"Virginia","Roanoke city",1,68,1153,503,650
050,51,770,"Virginia","Roanoke city",1,69,1029,429,600
050,51,770,"Virginia","Roanoke city",1,70,1003,425,578
050,51,770,"Virginia","Roanoke city",1,71,994,427,567
050,51,770,"Virginia","Roanoke city",1,72,963,411,552
050,51,770,"Virginia","Roanoke city",1,73,967,432,535
050,51,770,"Virginia","Roanoke city",1,74,611,285,326
050,51,770,"Virginia","Roanoke city",1,75,611,262,349
050,51,770,"Virginia","Roanoke city",1,76,580,243,337
050,51,770,"Virginia","Roanoke city",1,77,599,246,353
050,51,770,"Virginia","Roanoke city",1,78,499,190,309
050,51,770,"Virginia","Roanoke city",1,79,409,161,248
050,51,770,"Virginia","Roanoke city",1,80,414,166,248
050,51,770,"Virginia","Roanoke city",1,81,398,141,257
050,51,770,"Virginia","Roanoke city",1,82,339,125,214
050,51,770,"Virginia","Roanoke city",1,83,311,110,201
050,51,770,"Virginia","Roanoke city",1,84,298,87,211
050,51,770,"Virginia","Roanoke city",1,85,2233,577,1656
050,51,770,"Virginia","Roanoke city",2,0,1371,687,684
050,51,770,"Virginia","Roanoke city",2,1,1348,678,670
050,51,770,"Virginia","Roanoke city",2,2,1247,607,640
050,51,770,"Virginia","Roanoke city",2,3,1236,614,622
050,51,770,"Virginia","Roanoke city",2,4,1310,654,656
050,51,770,"Virginia","Roanoke city",2,5,1324,651,673
050,51,770,"Virginia","Roanoke city",2,6,1304,653,651
050,51,770,"Virginia","Roanoke city",2,7,1282,647,635
050,51,770,"Virginia","Roanoke city",2,8,1267,631,636
050,51,770,"Virginia","Roanoke city",2,9,1238,637,601
050,51,770,"Virginia","Roanoke city",2,10,1233,630,603
050,51,770,"Virginia","Roanoke city",2,11,1271,637,634
050,51,770,"Virginia","Roanoke city",2,12,1319,673,646
050,51,770,"Virginia","Roanoke city",2,13,1314,668,646
050,51,770,"Virginia","Roanoke city",2,14,1219,625,594
050,51,770,"Virginia","Roanoke city",2,15,1136,590,546
050,51,770,"Virginia","Roanoke city",2,16,1144,593,551
050,51,770,"Virginia","Roanoke city",2,17,1135,572,563
050,51,770,"Virginia","Roanoke city",2,18,1009,532,477
050,51,770,"Virginia","Roanoke city",2,19,932,499,433
050,51,770,"Virginia","Roanoke city",2,20,1005,547,458
050,51,770,"Virginia","Roanoke city",2,21,1017,515,502
050,51,770,"Virginia","Roanoke city",2,22,1061,508,553
050,51,770,"Virginia","Roanoke city",2,23,1140,529,611
050,51,770,"Virginia","Roanoke city",2,24,1274,588,686
050,51,770,"Virginia","Roanoke city",2,25,1423,653,770
050,51,770,"Virginia","Roanoke city",2,26,1555,750,805
050,51,770,"Virginia","Roanoke city",2,27,1587,778,809
050,51,770,"Virginia","Roanoke city",2,28,1595,762,833
050,51,770,"Virginia","Roanoke city",2,29,1622,769,853
050,51,770,"Virginia","Roanoke city",2,30,1608,774,834
050,51,770,"Virginia","Roanoke city",2,31,1569,749,820
050,51,770,"Virginia","Roanoke city",2,32,1505,739,766
050,51,770,"Virginia","Roanoke city",2,33,1423,690,733
050,51,770,"Virginia","Roanoke city",2,34,1391,681,710
050,51,770,"Virginia","Roanoke city",2,35,1385,672,713
050,51,770,"Virginia","Roanoke city",2,36,1312,652,660
050,51,770,"Virginia","Roanoke city",2,37,1308,661,647
050,51,770,"Virginia","Roanoke city",2,38,1264,641,623
050,51,770,"Virginia","Roanoke city",2,39,1290,641,649
050,51,770,"Virginia","Roanoke city",2,40,1323,644,679
050,51,770,"Virginia","Roanoke city",2,41,1243,570,673
050,51,770,"Virginia","Roanoke city",2,42,1209,557,652
050,51,770,"Virginia","Roanoke city",2,43,1197,547,650
050,51,770,"Virginia","Roanoke city",2,44,1123,536,587
050,51,770,"Virginia","Roanoke city",2,45,1105,532,573
050,51,770,"Virginia","Roanoke city",2,46,1108,543,565
050,51,770,"Virginia","Roanoke city",2,47,1159,564,595
050,51,770,"Virginia","Roanoke city",2,48,1252,599,653
050,51,770,"Virginia","Roanoke city",2,49,1320,653,667
050,51,770,"Virginia","Roanoke city",2,50,1249,617,632
050,51,770,"Virginia","Roanoke city",2,51,1191,580,611
050,51,770,"Virginia","Roanoke city",2,52,1169,591,578
050,51,770,"Virginia","Roanoke city",2,53,1182,608,574
050,51,770,"Virginia","Roanoke city",2,54,1226,614,612
050,51,770,"Virginia","Roanoke city",2,55,1272,640,632
050,51,770,"Virginia","Roanoke city",2,56,1269,613,656
050,51,770,"Virginia","Roanoke city",2,57,1281,601,680
050,51,770,"Virginia","Roanoke city",2,58,1323,633,690
050,51,770,"Virginia","Roanoke city",2,59,1313,627,686
050,51,770,"Virginia","Roanoke city",2,60,1296,626,670
050,51,770,"Virginia","Roanoke city",2,61,1295,604,691
050,51,770,"Virginia","Roanoke city",2,62,1279,586,693
050,51,770,"Virginia","Roanoke city",2,63,1265,602,663
050,51,770,"Virginia","Roanoke city",2,64,1221,577,644
050,51,770,"Virginia","Roanoke city",2,65,1199,553,646
050,51,770,"Virginia","Roanoke city",2,66,1183,551,632
050,51,770,"Virginia","Roanoke city",2,67,1176,537,639
050,51,770,"Virginia","Roanoke city",2,68,1145,504,641
050,51,770,"Virginia","Roanoke city",2,69,1062,449,613
050,51,770,"Virginia","Roanoke city",2,70,996,417,579
050,51,770,"Virginia","Roanoke city",2,71,990,425,565
050,51,770,"Virginia","Roanoke city",2,72,952,407,545
050,51,770,"Virginia","Roanoke city",2,73,999,440,559
050,51,770,"Virginia","Roanoke city",2,74,652,299,353
050,51,770,"Virginia","Roanoke city",2,75,604,267,337
050,51,770,"Virginia","Roanoke city",2,76,575,241,334
050,51,770,"Virginia","Roanoke city",2,77,604,249,355
050,51,770,"Virginia","Roanoke city",2,78,512,199,313
050,51,770,"Virginia","Roanoke city",2,79,421,164,257
050,51,770,"Virginia","Roanoke city",2,80,412,164,248
050,51,770,"Virginia","Roanoke city",2,81,402,146,256
050,51,770,"Virginia","Roanoke city",2,82,341,121,220
050,51,770,"Virginia","Roanoke city",2,83,313,114,199
050,51,770,"Virginia","Roanoke city",2,84,293,86,207
050,51,770,"Virginia","Roanoke city",2,85,2217,564,1653
050,51,770,"Virginia","Roanoke city",3,0,1304,676,628
050,51,770,"Virginia","Roanoke city",3,1,1319,673,646
050,51,770,"Virginia","Roanoke city",3,2,1284,643,641
050,51,770,"Virginia","Roanoke city",3,3,1195,589,606
050,51,770,"Virginia","Roanoke city",3,4,1208,606,602
050,51,770,"Virginia","Roanoke city",3,5,1258,617,641
050,51,770,"Virginia","Roanoke city",3,6,1296,655,641
050,51,770,"Virginia","Roanoke city",3,7,1271,639,632
050,51,770,"Virginia","Roanoke city",3,8,1220,610,610
050,51,770,"Virginia","Roanoke city",3,9,1224,623,601
050,51,770,"Virginia","Roanoke city",3,10,1188,604,584
050,51,770,"Virginia","Roanoke city",3,11,1224,612,612
050,51,770,"Virginia","Roanoke city",3,12,1247,641,606
050,51,770,"Virginia","Roanoke city",3,13,1307,674,633
050,51,770,"Virginia","Roanoke city",3,14,1314,674,640
050,51,770,"Virginia","Roanoke city",3,15,1216,627,589
050,51,770,"Virginia","Roanoke city",3,16,1152,589,563
050,51,770,"Virginia","Roanoke city",3,17,1128,577,551
050,51,770,"Virginia","Roanoke city",3,18,1007,523,484
050,51,770,"Virginia","Roanoke city",3,19,880,463,417
050,51,770,"Virginia","Roanoke city",3,20,1008,538,470
050,51,770,"Virginia","Roanoke city",3,21,1060,575,485
050,51,770,"Virginia","Roanoke city",3,22,1110,534,576
050,51,770,"Virginia","Roanoke city",3,23,1144,506,638
050,51,770,"Virginia","Roanoke city",3,24,1221,548,673
050,51,770,"Virginia","Roanoke city",3,25,1352,631,721
050,51,770,"Virginia","Roanoke city",3,26,1483,716,767
050,51,770,"Virginia","Roanoke city",3,27,1578,770,808
050,51,770,"Virginia","Roanoke city",3,28,1538,766,772
050,51,770,"Virginia","Roanoke city",3,29,1593,783,810
050,51,770,"Virginia","Roanoke city",3,30,1584,750,834
050,51,770,"Virginia","Roanoke city",3,31,1558,745,813
050,51,770,"Virginia","Roanoke city",3,32,1501,720,781
050,51,770,"Virginia","Roanoke city",3,33,1471,743,728
050,51,770,"Virginia","Roanoke city",3,34,1380,683,697
050,51,770,"Virginia","Roanoke city",3,35,1338,654,684
050,51,770,"Virginia","Roanoke city",3,36,1308,632,676
050,51,770,"Virginia","Roanoke city",3,37,1295,651,644
050,51,770,"Virginia","Roanoke city",3,38,1285,652,633
050,51,770,"Virginia","Roanoke city",3,39,1241,624,617
050,51,770,"Virginia","Roanoke city",3,40,1264,640,624
050,51,770,"Virginia","Roanoke city",3,41,1272,597,675
050,51,770,"Virginia","Roanoke city",3,42,1216,557,659
050,51,770,"Virginia","Roanoke city",3,43,1159,529,630
050,51,770,"Virginia","Roanoke city",3,44,1189,549,640
050,51,770,"Virginia","Roanoke city",3,45,1078,508,570
050,51,770,"Virginia","Roanoke city",3,46,1080,523,557
050,51,770,"Virginia","Roanoke city",3,47,1083,531,552
050,51,770,"Virginia","Roanoke city",3,48,1143,553,590
050,51,770,"Virginia","Roanoke city",3,49,1218,574,644
050,51,770,"Virginia","Roanoke city",3,50,1269,625,644
050,51,770,"Virginia","Roanoke city",3,51,1223,605,618
050,51,770,"Virginia","Roanoke city",3,52,1171,557,614
050,51,770,"Virginia","Roanoke city",3,53,1143,578,565
050,51,770,"Virginia","Roanoke city",3,54,1154,598,556
050,51,770,"Virginia","Roanoke city",3,55,1197,606,591
050,51,770,"Virginia","Roanoke city",3,56,1253,630,623
050,51,770,"Virginia","Roanoke city",3,57,1218,575,643
050,51,770,"Virginia","Roanoke city",3,58,1255,581,674
050,51,770,"Virginia","Roanoke city",3,59,1285,609,676
050,51,770,"Virginia","Roanoke city",3,60,1275,611,664
050,51,770,"Virginia","Roanoke city",3,61,1264,600,664
050,51,770,"Virginia","Roanoke city",3,62,1249,584,665
050,51,770,"Virginia","Roanoke city",3,63,1259,582,677
050,51,770,"Virginia","Roanoke city",3,64,1231,589,642
050,51,770,"Virginia","Roanoke city",3,65,1173,550,623
050,51,770,"Virginia","Roanoke city",3,66,1163,537,626
050,51,770,"Virginia","Roanoke city",3,67,1142,529,613
050,51,770,"Virginia","Roanoke city",3,68,1135,518,617
050,51,770,"Virginia","Roanoke city",3,69,1100,487,613
050,51,770,"Virginia","Roanoke city",3,70,1016,421,595
050,51,770,"Virginia","Roanoke city",3,71,974,408,566
050,51,770,"Virginia","Roanoke city",3,72,962,412,550
050,51,770,"Virginia","Roanoke city",3,73,926,394,532
050,51,770,"Virginia","Roanoke city",3,74,949,406,543
050,51,770,"Virginia","Roanoke city",3,75,628,288,340
050,51,770,"Virginia","Roanoke city",3,76,560,242,318
050,51,770,"Virginia","Roanoke city",3,77,567,238,329
050,51,770,"Virginia","Roanoke city",3,78,584,233,351
050,51,770,"Virginia","Roanoke city",3,79,469,186,283
050,51,770,"Virginia","Roanoke city",3,80,403,158,245
050,51,770,"Virginia","Roanoke city",3,81,407,161,246
050,51,770,"Virginia","Roanoke city",3,82,346,122,224
050,51,770,"Virginia","Roanoke city",3,83,317,118,199
050,51,770,"Virginia","Roanoke city",3,84,283,98,185
050,51,770,"Virginia","Roanoke city",3,85,2158,519,1639
050,51,770,"Virginia","Roanoke city",4,0,1271,658,613
050,51,770,"Virginia","Roanoke city",4,1,1252,643,609
050,51,770,"Virginia","Roanoke city",4,2,1239,606,633
050,51,770,"Virginia","Roanoke city",4,3,1226,609,617
050,51,770,"Virginia","Roanoke city",4,4,1188,574,614
050,51,770,"Virginia","Roanoke city",4,5,1198,591,607
050,51,770,"Virginia","Roanoke city",4,6,1262,626,636
050,51,770,"Virginia","Roanoke city",4,7,1253,630,623
050,51,770,"Virginia","Roanoke city",4,8,1247,632,615
050,51,770,"Virginia","Roanoke city",4,9,1180,589,591
050,51,770,"Virginia","Roanoke city",4,10,1215,610,605
050,51,770,"Virginia","Roanoke city",4,11,1168,585,583
050,51,770,"Virginia","Roanoke city",4,12,1202,589,613
050,51,770,"Virginia","Roanoke city",4,13,1240,639,601
050,51,770,"Virginia","Roanoke city",4,14,1277,655,622
050,51,770,"Virginia","Roanoke city",4,15,1296,666,630
050,51,770,"Virginia","Roanoke city",4,16,1220,640,580
050,51,770,"Virginia","Roanoke city",4,17,1153,580,573
050,51,770,"Virginia","Roanoke city",4,18,973,524,449
050,51,770,"Virginia","Roanoke city",4,19,844,438,406
050,51,770,"Virginia","Roanoke city",4,20,927,475,452
050,51,770,"Virginia","Roanoke city",4,21,1050,559,491
050,51,770,"Virginia","Roanoke city",4,22,1119,579,540
050,51,770,"Virginia","Roanoke city",4,23,1164,535,629
050,51,770,"Virginia","Roanoke city",4,24,1260,562,698
050,51,770,"Virginia","Roanoke city",4,25,1285,600,685
050,51,770,"Virginia","Roanoke city",4,26,1357,647,710
050,51,770,"Virginia","Roanoke city",4,27,1444,680,764
050,51,770,"Virginia","Roanoke city",4,28,1513,751,762
050,51,770,"Virginia","Roanoke city",4,29,1538,789,749
050,51,770,"Virginia","Roanoke city",4,30,1542,760,782
050,51,770,"Virginia","Roanoke city",4,31,1548,736,812
050,51,770,"Virginia","Roanoke city",4,32,1538,745,793
050,51,770,"Virginia","Roanoke city",4,33,1447,692,755
050,51,770,"Virginia","Roanoke city",4,34,1500,773,727
050,51,770,"Virginia","Roanoke city",4,35,1341,665,676
050,51,770,"Virginia","Roanoke city",4,36,1321,657,664
050,51,770,"Virginia","Roanoke city",4,37,1283,611,672
050,51,770,"Virginia","Roanoke city",4,38,1259,625,634
050,51,770,"Virginia","Roanoke city",4,39,1297,673,624
050,51,770,"Virginia","Roanoke city",4,40,1199,593,606
050,51,770,"Virginia","Roanoke city",4,41,1234,616,618
050,51,770,"Virginia","Roanoke city",4,42,1230,576,654
050,51,770,"Virginia","Roanoke city",4,43,1191,553,638
050,51,770,"Virginia","Roanoke city",4,44,1165,533,632
050,51,770,"Virginia","Roanoke city",4,45,1195,552,643
050,51,770,"Virginia","Roanoke city",4,46,1081,512,569
050,51,770,"Virginia","Roanoke city",4,47,1041,488,553
050,51,770,"Virginia","Roanoke city",4,48,1075,520,555
050,51,770,"Virginia","Roanoke city",4,49,1126,548,578
050,51,770,"Virginia","Roanoke city",4,50,1185,554,631
050,51,770,"Virginia","Roanoke city",4,51,1248,607,641
050,51,770,"Virginia","Roanoke city",4,52,1210,584,626
050,51,770,"Virginia","Roanoke city",4,53,1143,548,595
050,51,770,"Virginia","Roanoke city",4,54,1116,567,549
050,51,770,"Virginia","Roanoke city",4,55,1136,585,551
050,51,770,"Virginia","Roanoke city",4,56,1166,585,581
050,51,770,"Virginia","Roanoke city",4,57,1213,611,602
050,51,770,"Virginia","Roanoke city",4,58,1218,573,645
050,51,770,"Virginia","Roanoke city",4,59,1231,564,667
050,51,770,"Virginia","Roanoke city",4,60,1240,573,667
050,51,770,"Virginia","Roanoke city",4,61,1249,590,659
050,51,770,"Virginia","Roanoke city",4,62,1247,591,656
050,51,770,"Virginia","Roanoke city",4,63,1212,565,647
050,51,770,"Virginia","Roanoke city",4,64,1212,563,649
050,51,770,"Virginia","Roanoke city",4,65,1167,556,611
050,51,770,"Virginia","Roanoke city",4,66,1154,533,621
050,51,770,"Virginia","Roanoke city",4,67,1118,517,601
050,51,770,"Virginia","Roanoke city",4,68,1099,510,589
050,51,770,"Virginia","Roanoke city",4,69,1092,502,590
050,51,770,"Virginia","Roanoke city",4,70,1052,454,598
050,51,770,"Virginia","Roanoke city",4,71,969,402,567
050,51,770,"Virginia","Roanoke city",4,72,938,389,549
050,51,770,"Virginia","Roanoke city",4,73,921,394,527
050,51,770,"Virginia","Roanoke city",4,74,895,362,533
050,51,770,"Virginia","Roanoke city",4,75,929,400,529
050,51,770,"Virginia","Roanoke city",4,76,580,258,322
050,51,770,"Virginia","Roanoke city",4,77,555,232,323
050,51,770,"Virginia","Roanoke city",4,78,536,213,323
050,51,770,"Virginia","Roanoke city",4,79,525,214,311
050,51,770,"Virginia","Roanoke city",4,80,445,175,270
050,51,770,"Virginia","Roanoke city",4,81,398,153,245
050,51,770,"Virginia","Roanoke city",4,82,352,134,218
050,51,770,"Virginia","Roanoke city",4,83,333,122,211
050,51,770,"Virginia","Roanoke city",4,84,288,95,193
050,51,770,"Virginia","Roanoke city",4,85,2111,500,1611
050,51,770,"Virginia","Roanoke city",5,0,1268,657,611
050,51,770,"Virginia","Roanoke city",5,1,1249,643,606
050,51,770,"Virginia","Roanoke city",5,2,1227,617,610
050,51,770,"Virginia","Roanoke city",5,3,1238,637,601
050,51,770,"Virginia","Roanoke city",5,4,1187,596,591
050,51,770,"Virginia","Roanoke city",5,5,1159,562,597
050,51,770,"Virginia","Roanoke city",5,6,1152,561,591
050,51,770,"Virginia","Roanoke city",5,7,1183,589,594
050,51,770,"Virginia","Roanoke city",5,8,1256,637,619
050,51,770,"Virginia","Roanoke city",5,9,1231,630,601
050,51,770,"Virginia","Roanoke city",5,10,1170,581,589
050,51,770,"Virginia","Roanoke city",5,11,1152,565,587
050,51,770,"Virginia","Roanoke city",5,12,1159,584,575
050,51,770,"Virginia","Roanoke city",5,13,1186,590,596
050,51,770,"Virginia","Roanoke city",5,14,1199,612,587
050,51,770,"Virginia","Roanoke city",5,15,1299,667,632
050,51,770,"Virginia","Roanoke city",5,16,1291,669,622
050,51,770,"Virginia","Roanoke city",5,17,1221,629,592
050,51,770,"Virginia","Roanoke city",5,18,990,518,472
050,51,770,"Virginia","Roanoke city",5,19,834,446,388
050,51,770,"Virginia","Roanoke city",5,20,929,472,457
050,51,770,"Virginia","Roanoke city",5,21,969,477,492
050,51,770,"Virginia","Roanoke city",5,22,1098,579,519
050,51,770,"Virginia","Roanoke city",5,23,1206,613,593
050,51,770,"Virginia","Roanoke city",5,24,1265,589,676
050,51,770,"Virginia","Roanoke city",5,25,1292,574,718
050,51,770,"Virginia","Roanoke city",5,26,1349,625,724
050,51,770,"Virginia","Roanoke city",5,27,1358,647,711
050,51,770,"Virginia","Roanoke city",5,28,1424,670,754
050,51,770,"Virginia","Roanoke city",5,29,1527,782,745
050,51,770,"Virginia","Roanoke city",5,30,1553,795,758
050,51,770,"Virginia","Roanoke city",5,31,1510,756,754
050,51,770,"Virginia","Roanoke city",5,32,1552,746,806
050,51,770,"Virginia","Roanoke city",5,33,1492,738,754
050,51,770,"Virginia","Roanoke city",5,34,1468,716,752
050,51,770,"Virginia","Roanoke city",5,35,1514,774,740
050,51,770,"Virginia","Roanoke city",5,36,1320,637,683
050,51,770,"Virginia","Roanoke city",5,37,1307,648,659
050,51,770,"Virginia","Roanoke city",5,38,1266,615,651
050,51,770,"Virginia","Roanoke city",5,39,1230,623,607
050,51,770,"Virginia","Roanoke city",5,40,1252,638,614
050,51,770,"Virginia","Roanoke city",5,41,1176,582,594
050,51,770,"Virginia","Roanoke city",5,42,1167,593,574
050,51,770,"Virginia","Roanoke city",5,43,1226,573,653
050,51,770,"Virginia","Roanoke city",5,44,1209,574,635
050,51,770,"Virginia","Roanoke city",5,45,1156,531,625
050,51,770,"Virginia","Roanoke city",5,46,1181,544,637
050,51,770,"Virginia","Roanoke city",5,47,1038,487,551
050,51,770,"Virginia","Roanoke city",5,48,1049,498,551
050,51,770,"Virginia","Roanoke city",5,49,1039,504,535
050,51,770,"Virginia","Roanoke city",5,50,1099,531,568
050,51,770,"Virginia","Roanoke city",5,51,1189,555,634
050,51,770,"Virginia","Roanoke city",5,52,1239,589,650
050,51,770,"Virginia","Roanoke city",5,53,1189,578,611
050,51,770,"Virginia","Roanoke city",5,54,1127,532,595
050,51,770,"Virginia","Roanoke city",5,55,1126,568,558
050,51,770,"Virginia","Roanoke city",5,56,1119,578,541
050,51,770,"Virginia","Roanoke city",5,57,1140,566,574
050,51,770,"Virginia","Roanoke city",5,58,1228,619,609
050,51,770,"Virginia","Roanoke city",5,59,1156,535,621
050,51,770,"Virginia","Roanoke city",5,60,1222,546,676
050,51,770,"Virginia","Roanoke city",5,61,1199,551,648
050,51,770,"Virginia","Roanoke city",5,62,1231,574,657
050,51,770,"Virginia","Roanoke city",5,63,1247,597,650
050,51,770,"Virginia","Roanoke city",5,64,1188,554,634
050,51,770,"Virginia","Roanoke city",5,65,1193,543,650
050,51,770,"Virginia","Roanoke city",5,66,1120,528,592
050,51,770,"Virginia","Roanoke city",5,67,1112,518,594
050,51,770,"Virginia","Roanoke city",5,68,1058,482,576
050,51,770,"Virginia","Roanoke city",5,69,1061,498,563
050,51,770,"Virginia","Roanoke city",5,70,1057,470,587
050,51,770,"Virginia","Roanoke city",5,71,1012,441,571
050,51,770,"Virginia","Roanoke city",5,72,930,384,546
050,51,770,"Virginia","Roanoke city",5,73,917,377,540
050,51,770,"Virginia","Roanoke city",5,74,880,371,509
050,51,770,"Virginia","Roanoke city",5,75,865,358,507
050,51,770,"Virginia","Roanoke city",5,76,874,371,503
050,51,770,"Virginia","Roanoke city",5,77,564,244,320
050,51,770,"Virginia","Roanoke city",5,78,526,215,311
050,51,770,"Virginia","Roanoke city",5,79,485,192,293
050,51,770,"Virginia","Roanoke city",5,80,505,206,299
050,51,770,"Virginia","Roanoke city",5,81,447,173,274
050,51,770,"Virginia","Roanoke city",5,82,345,126,219
050,51,770,"Virginia","Roanoke city",5,83,330,127,203
050,51,770,"Virginia","Roanoke city",5,84,308,100,208
050,51,770,"Virginia","Roanoke city",5,85,2110,486,1624
050,51,775,"Virginia","Salem city",1,0,216,110,106
050,51,775,"Virginia","Salem city",1,1,201,104,97
050,51,775,"Virginia","Salem city",1,2,219,108,111
050,51,775,"Virginia","Salem city",1,3,221,104,117
050,51,775,"Virginia","Salem city",1,4,256,134,122
050,51,775,"Virginia","Salem city",1,5,252,125,127
050,51,775,"Virginia","Salem city",1,6,258,139,119
050,51,775,"Virginia","Salem city",1,7,261,131,130
050,51,775,"Virginia","Salem city",1,8,273,135,138
050,51,775,"Virginia","Salem city",1,9,261,137,124
050,51,775,"Virginia","Salem city",1,10,277,150,127
050,51,775,"Virginia","Salem city",1,11,290,159,131
050,51,775,"Virginia","Salem city",1,12,288,156,132
050,51,775,"Virginia","Salem city",1,13,282,149,133
050,51,775,"Virginia","Salem city",1,14,308,167,141
050,51,775,"Virginia","Salem city",1,15,312,167,145
050,51,775,"Virginia","Salem city",1,16,316,160,156
050,51,775,"Virginia","Salem city",1,17,326,151,175
050,51,775,"Virginia","Salem city",1,18,518,227,291
050,51,775,"Virginia","Salem city",1,19,704,311,393
050,51,775,"Virginia","Salem city",1,20,623,270,353
050,51,775,"Virginia","Salem city",1,21,472,213,259
050,51,775,"Virginia","Salem city",1,22,375,198,177
050,51,775,"Virginia","Salem city",1,23,314,161,153
050,51,775,"Virginia","Salem city",1,24,280,144,136
050,51,775,"Virginia","Salem city",1,25,265,142,123
050,51,775,"Virginia","Salem city",1,26,273,151,122
050,51,775,"Virginia","Salem city",1,27,262,134,128
050,51,775,"Virginia","Salem city",1,28,306,151,155
050,51,775,"Virginia","Salem city",1,29,289,133,156
050,51,775,"Virginia","Salem city",1,30,307,141,166
050,51,775,"Virginia","Salem city",1,31,297,140,157
050,51,775,"Virginia","Salem city",1,32,287,148,139
050,51,775,"Virginia","Salem city",1,33,263,127,136
050,51,775,"Virginia","Salem city",1,34,294,153,141
050,51,775,"Virginia","Salem city",1,35,293,163,130
050,51,775,"Virginia","Salem city",1,36,299,158,141
050,51,775,"Virginia","Salem city",1,37,286,132,154
050,51,775,"Virginia","Salem city",1,38,316,153,163
050,51,775,"Virginia","Salem city",1,39,333,166,167
050,51,775,"Virginia","Salem city",1,40,285,147,138
050,51,775,"Virginia","Salem city",1,41,291,153,138
050,51,775,"Virginia","Salem city",1,42,269,132,137
050,51,775,"Virginia","Salem city",1,43,251,118,133
050,51,775,"Virginia","Salem city",1,44,247,114,133
050,51,775,"Virginia","Salem city",1,45,268,121,147
050,51,775,"Virginia","Salem city",1,46,274,140,134
050,51,775,"Virginia","Salem city",1,47,309,150,159
050,51,775,"Virginia","Salem city",1,48,328,154,174
050,51,775,"Virginia","Salem city",1,49,342,165,177
050,51,775,"Virginia","Salem city",1,50,346,170,176
050,51,775,"Virginia","Salem city",1,51,333,174,159
050,51,775,"Virginia","Salem city",1,52,314,155,159
050,51,775,"Virginia","Salem city",1,53,297,141,156
050,51,775,"Virginia","Salem city",1,54,319,155,164
050,51,775,"Virginia","Salem city",1,55,337,162,175
050,51,775,"Virginia","Salem city",1,56,353,174,179
050,51,775,"Virginia","Salem city",1,57,333,160,173
050,51,775,"Virginia","Salem city",1,58,333,154,179
050,51,775,"Virginia","Salem city",1,59,361,185,176
050,51,775,"Virginia","Salem city",1,60,358,178,180
050,51,775,"Virginia","Salem city",1,61,339,159,180
050,51,775,"Virginia","Salem city",1,62,369,176,193
050,51,775,"Virginia","Salem city",1,63,385,183,202
050,51,775,"Virginia","Salem city",1,64,359,162,197
050,51,775,"Virginia","Salem city",1,65,320,154,166
050,51,775,"Virginia","Salem city",1,66,300,126,174
050,51,775,"Virginia","Salem city",1,67,331,148,183
050,51,775,"Virginia","Salem city",1,68,326,158,168
050,51,775,"Virginia","Salem city",1,69,244,101,143
050,51,775,"Virginia","Salem city",1,70,268,124,144
050,51,775,"Virginia","Salem city",1,71,275,113,162
050,51,775,"Virginia","Salem city",1,72,292,129,163
050,51,775,"Virginia","Salem city",1,73,267,125,142
050,51,775,"Virginia","Salem city",1,74,192,78,114
050,51,775,"Virginia","Salem city",1,75,186,87,99
050,51,775,"Virginia","Salem city",1,76,194,79,115
050,51,775,"Virginia","Salem city",1,77,188,87,101
050,51,775,"Virginia","Salem city",1,78,170,69,101
050,51,775,"Virginia","Salem city",1,79,152,63,89
050,51,775,"Virginia","Salem city",1,80,131,60,71
050,51,775,"Virginia","Salem city",1,81,131,47,84
050,51,775,"Virginia","Salem city",1,82,122,52,70
050,51,775,"Virginia","Salem city",1,83,109,46,63
050,51,775,"Virginia","Salem city",1,84,88,39,49
050,51,775,"Virginia","Salem city",1,85,588,181,407
050,51,775,"Virginia","Salem city",2,0,248,131,117
050,51,775,"Virginia","Salem city",2,1,207,107,100
050,51,775,"Virginia","Salem city",2,2,215,105,110
050,51,775,"Virginia","Salem city",2,3,224,108,116
050,51,775,"Virginia","Salem city",2,4,252,130,122
050,51,775,"Virginia","Salem city",2,5,256,129,127
050,51,775,"Virginia","Salem city",2,6,257,135,122
050,51,775,"Virginia","Salem city",2,7,262,134,128
050,51,775,"Virginia","Salem city",2,8,270,135,135
050,51,775,"Virginia","Salem city",2,9,267,138,129
050,51,775,"Virginia","Salem city",2,10,274,147,127
050,51,775,"Virginia","Salem city",2,11,287,157,130
050,51,775,"Virginia","Salem city",2,12,293,158,135
050,51,775,"Virginia","Salem city",2,13,285,152,133
050,51,775,"Virginia","Salem city",2,14,307,166,141
050,51,775,"Virginia","Salem city",2,15,314,167,147
050,51,775,"Virginia","Salem city",2,16,315,160,155
050,51,775,"Virginia","Salem city",2,17,322,152,170
050,51,775,"Virginia","Salem city",2,18,518,225,293
050,51,775,"Virginia","Salem city",2,19,710,316,394
050,51,775,"Virginia","Salem city",2,20,628,271,357
050,51,775,"Virginia","Salem city",2,21,475,214,261
050,51,775,"Virginia","Salem city",2,22,373,193,180
050,51,775,"Virginia","Salem city",2,23,310,160,150
050,51,775,"Virginia","Salem city",2,24,288,147,141
050,51,775,"Virginia","Salem city",2,25,268,145,123
050,51,775,"Virginia","Salem city",2,26,269,148,121
050,51,775,"Virginia","Salem city",2,27,267,141,126
050,51,775,"Virginia","Salem city",2,28,289,141,148
050,51,775,"Virginia","Salem city",2,29,294,137,157
050,51,775,"Virginia","Salem city",2,30,304,138,166
050,51,775,"Virginia","Salem city",2,31,298,138,160
050,51,775,"Virginia","Salem city",2,32,285,143,142
050,51,775,"Virginia","Salem city",2,33,272,134,138
050,51,775,"Virginia","Salem city",2,34,287,146,141
050,51,775,"Virginia","Salem city",2,35,299,164,135
050,51,775,"Virginia","Salem city",2,36,294,156,138
050,51,775,"Virginia","Salem city",2,37,291,140,151
050,51,775,"Virginia","Salem city",2,38,310,149,161
050,51,775,"Virginia","Salem city",2,39,329,165,164
050,51,775,"Virginia","Salem city",2,40,298,151,147
050,51,775,"Virginia","Salem city",2,41,293,154,139
050,51,775,"Virginia","Salem city",2,42,274,137,137
050,51,775,"Virginia","Salem city",2,43,255,121,134
050,51,775,"Virginia","Salem city",2,44,246,113,133
050,51,775,"Virginia","Salem city",2,45,263,119,144
050,51,775,"Virginia","Salem city",2,46,273,136,137
050,51,775,"Virginia","Salem city",2,47,298,145,153
050,51,775,"Virginia","Salem city",2,48,325,154,171
050,51,775,"Virginia","Salem city",2,49,344,165,179
050,51,775,"Virginia","Salem city",2,50,343,169,174
050,51,775,"Virginia","Salem city",2,51,336,174,162
050,51,775,"Virginia","Salem city",2,52,318,158,160
050,51,775,"Virginia","Salem city",2,53,300,143,157
050,51,775,"Virginia","Salem city",2,54,317,155,162
050,51,775,"Virginia","Salem city",2,55,332,160,172
050,51,775,"Virginia","Salem city",2,56,352,173,179
050,51,775,"Virginia","Salem city",2,57,340,164,176
050,51,775,"Virginia","Salem city",2,58,333,157,176
050,51,775,"Virginia","Salem city",2,59,356,179,177
050,51,775,"Virginia","Salem city",2,60,357,179,178
050,51,775,"Virginia","Salem city",2,61,342,162,180
050,51,775,"Virginia","Salem city",2,62,364,176,188
050,51,775,"Virginia","Salem city",2,63,380,180,200
050,51,775,"Virginia","Salem city",2,64,359,164,195
050,51,775,"Virginia","Salem city",2,65,327,155,172
050,51,775,"Virginia","Salem city",2,66,301,131,170
050,51,775,"Virginia","Salem city",2,67,323,144,179
050,51,775,"Virginia","Salem city",2,68,325,156,169
050,51,775,"Virginia","Salem city",2,69,263,112,151
050,51,775,"Virginia","Salem city",2,70,259,117,142
050,51,775,"Virginia","Salem city",2,71,272,114,158
050,51,775,"Virginia","Salem city",2,72,283,124,159
050,51,775,"Virginia","Salem city",2,73,287,131,156
050,51,775,"Virginia","Salem city",2,74,196,82,114
050,51,775,"Virginia","Salem city",2,75,186,85,101
050,51,775,"Virginia","Salem city",2,76,192,81,111
050,51,775,"Virginia","Salem city",2,77,190,86,104
050,51,775,"Virginia","Salem city",2,78,169,71,98
050,51,775,"Virginia","Salem city",2,79,153,64,89
050,51,775,"Virginia","Salem city",2,80,133,60,73
050,51,775,"Virginia","Salem city",2,81,130,51,79
050,51,775,"Virginia","Salem city",2,82,122,50,72
050,51,775,"Virginia","Salem city",2,83,108,45,63
050,51,775,"Virginia","Salem city",2,84,92,41,51
050,51,775,"Virginia","Salem city",2,85,581,182,399
050,51,775,"Virginia","Salem city",3,0,287,162,125
050,51,775,"Virginia","Salem city",3,1,254,149,105
050,51,775,"Virginia","Salem city",3,2,227,113,114
050,51,775,"Virginia","Salem city",3,3,218,110,108
050,51,775,"Virginia","Salem city",3,4,230,121,109
050,51,775,"Virginia","Salem city",3,5,250,130,120
050,51,775,"Virginia","Salem city",3,6,270,138,132
050,51,775,"Virginia","Salem city",3,7,265,145,120
050,51,775,"Virginia","Salem city",3,8,270,139,131
050,51,775,"Virginia","Salem city",3,9,275,136,139
050,51,775,"Virginia","Salem city",3,10,272,146,126
050,51,775,"Virginia","Salem city",3,11,280,152,128
050,51,775,"Virginia","Salem city",3,12,281,150,131
050,51,775,"Virginia","Salem city",3,13,276,144,132
050,51,775,"Virginia","Salem city",3,14,283,161,122
050,51,775,"Virginia","Salem city",3,15,300,161,139
050,51,775,"Virginia","Salem city",3,16,315,171,144
050,51,775,"Virginia","Salem city",3,17,308,151,157
050,51,775,"Virginia","Salem city",3,18,516,220,296
050,51,775,"Virginia","Salem city",3,19,721,324,397
050,51,775,"Virginia","Salem city",3,20,620,273,347
050,51,775,"Virginia","Salem city",3,21,494,220,274
050,51,775,"Virginia","Salem city",3,22,353,183,170
050,51,775,"Virginia","Salem city",3,23,331,168,163
050,51,775,"Virginia","Salem city",3,24,294,153,141
050,51,775,"Virginia","Salem city",3,25,302,156,146
050,51,775,"Virginia","Salem city",3,26,264,146,118
050,51,775,"Virginia","Salem city",3,27,287,151,136
050,51,775,"Virginia","Salem city",3,28,253,115,138
050,51,775,"Virginia","Salem city",3,29,308,147,161
050,51,775,"Virginia","Salem city",3,30,288,131,157
050,51,775,"Virginia","Salem city",3,31,311,151,160
050,51,775,"Virginia","Salem city",3,32,292,128,164
050,51,775,"Virginia","Salem city",3,33,277,136,141
050,51,775,"Virginia","Salem city",3,34,284,145,139
050,51,775,"Virginia","Salem city",3,35,300,149,151
050,51,775,"Virginia","Salem city",3,36,292,165,127
050,51,775,"Virginia","Salem city",3,37,299,152,147
050,51,775,"Virginia","Salem city",3,38,291,145,146
050,51,775,"Virginia","Salem city",3,39,318,154,164
050,51,775,"Virginia","Salem city",3,40,326,164,162
050,51,775,"Virginia","Salem city",3,41,309,153,156
050,51,775,"Virginia","Salem city",3,42,299,156,143
050,51,775,"Virginia","Salem city",3,43,271,132,139
050,51,775,"Virginia","Salem city",3,44,260,119,141
050,51,775,"Virginia","Salem city",3,45,258,120,138
050,51,775,"Virginia","Salem city",3,46,249,123,126
050,51,775,"Virginia","Salem city",3,47,269,135,134
050,51,775,"Virginia","Salem city",3,48,290,142,148
050,51,775,"Virginia","Salem city",3,49,319,156,163
050,51,775,"Virginia","Salem city",3,50,345,158,187
050,51,775,"Virginia","Salem city",3,51,335,167,168
050,51,775,"Virginia","Salem city",3,52,319,164,155
050,51,775,"Virginia","Salem city",3,53,299,149,150
050,51,775,"Virginia","Salem city",3,54,299,144,155
050,51,775,"Virginia","Salem city",3,55,302,143,159
050,51,775,"Virginia","Salem city",3,56,339,159,180
050,51,775,"Virginia","Salem city",3,57,351,174,177
050,51,775,"Virginia","Salem city",3,58,341,165,176
050,51,775,"Virginia","Salem city",3,59,328,157,171
050,51,775,"Virginia","Salem city",3,60,356,179,177
050,51,775,"Virginia","Salem city",3,61,356,172,184
050,51,775,"Virginia","Salem city",3,62,353,174,179
050,51,775,"Virginia","Salem city",3,63,357,167,190
050,51,775,"Virginia","Salem city",3,64,380,176,204
050,51,775,"Virginia","Salem city",3,65,346,155,191
050,51,775,"Virginia","Salem city",3,66,321,148,173
050,51,775,"Virginia","Salem city",3,67,283,127,156
050,51,775,"Virginia","Salem city",3,68,322,153,169
050,51,775,"Virginia","Salem city",3,69,302,135,167
050,51,775,"Virginia","Salem city",3,70,252,106,146
050,51,775,"Virginia","Salem city",3,71,252,110,142
050,51,775,"Virginia","Salem city",3,72,258,110,148
050,51,775,"Virginia","Salem city",3,73,273,121,152
050,51,775,"Virginia","Salem city",3,74,277,122,155
050,51,775,"Virginia","Salem city",3,75,194,88,106
050,51,775,"Virginia","Salem city",3,76,182,80,102
050,51,775,"Virginia","Salem city",3,77,176,73,103
050,51,775,"Virginia","Salem city",3,78,175,76,99
050,51,775,"Virginia","Salem city",3,79,158,66,92
050,51,775,"Virginia","Salem city",3,80,153,65,88
050,51,775,"Virginia","Salem city",3,81,123,53,70
050,51,775,"Virginia","Salem city",3,82,118,44,74
050,51,775,"Virginia","Salem city",3,83,119,47,72
050,51,775,"Virginia","Salem city",3,84,95,41,54
050,51,775,"Virginia","Salem city",3,85,571,186,385
050,51,775,"Virginia","Salem city",4,0,329,170,159
050,51,775,"Virginia","Salem city",4,1,271,156,115
050,51,775,"Virginia","Salem city",4,2,266,154,112
050,51,775,"Virginia","Salem city",4,3,230,114,116
050,51,775,"Virginia","Salem city",4,4,234,114,120
050,51,775,"Virginia","Salem city",4,5,229,121,108
050,51,775,"Virginia","Salem city",4,6,239,114,125
050,51,775,"Virginia","Salem city",4,7,265,135,130
050,51,775,"Virginia","Salem city",4,8,269,142,127
050,51,775,"Virginia","Salem city",4,9,282,143,139
050,51,775,"Virginia","Salem city",4,10,294,148,146
050,51,775,"Virginia","Salem city",4,11,283,146,137
050,51,775,"Virginia","Salem city",4,12,297,158,139
050,51,775,"Virginia","Salem city",4,13,292,157,135
050,51,775,"Virginia","Salem city",4,14,288,150,138
050,51,775,"Virginia","Salem city",4,15,305,164,141
050,51,775,"Virginia","Salem city",4,16,305,168,137
050,51,775,"Virginia","Salem city",4,17,328,176,152
050,51,775,"Virginia","Salem city",4,18,491,217,274
050,51,775,"Virginia","Salem city",4,19,701,313,388
050,51,775,"Virginia","Salem city",4,20,616,266,350
050,51,775,"Virginia","Salem city",4,21,498,215,283
050,51,775,"Virginia","Salem city",4,22,386,189,197
050,51,775,"Virginia","Salem city",4,23,279,141,138
050,51,775,"Virginia","Salem city",4,24,281,150,131
050,51,775,"Virginia","Salem city",4,25,286,150,136
050,51,775,"Virginia","Salem city",4,26,294,151,143
050,51,775,"Virginia","Salem city",4,27,292,160,132
050,51,775,"Virginia","Salem city",4,28,306,152,154
050,51,775,"Virginia","Salem city",4,29,283,137,146
050,51,775,"Virginia","Salem city",4,30,306,138,168
050,51,775,"Virginia","Salem city",4,31,300,136,164
050,51,775,"Virginia","Salem city",4,32,322,145,177
050,51,775,"Virginia","Salem city",4,33,301,138,163
050,51,775,"Virginia","Salem city",4,34,290,141,149
050,51,775,"Virginia","Salem city",4,35,292,153,139
050,51,775,"Virginia","Salem city",4,36,301,156,145
050,51,775,"Virginia","Salem city",4,37,286,155,131
050,51,775,"Virginia","Salem city",4,38,295,149,146
050,51,775,"Virginia","Salem city",4,39,314,160,154
050,51,775,"Virginia","Salem city",4,40,304,146,158
050,51,775,"Virginia","Salem city",4,41,327,160,167
050,51,775,"Virginia","Salem city",4,42,319,155,164
050,51,775,"Virginia","Salem city",4,43,297,157,140
050,51,775,"Virginia","Salem city",4,44,279,133,146
050,51,775,"Virginia","Salem city",4,45,274,130,144
050,51,775,"Virginia","Salem city",4,46,270,128,142
050,51,775,"Virginia","Salem city",4,47,244,116,128
050,51,775,"Virginia","Salem city",4,48,272,137,135
050,51,775,"Virginia","Salem city",4,49,296,144,152
050,51,775,"Virginia","Salem city",4,50,315,152,163
050,51,775,"Virginia","Salem city",4,51,349,164,185
050,51,775,"Virginia","Salem city",4,52,350,170,180
050,51,775,"Virginia","Salem city",4,53,316,161,155
050,51,775,"Virginia","Salem city",4,54,309,152,157
050,51,775,"Virginia","Salem city",4,55,292,140,152
050,51,775,"Virginia","Salem city",4,56,290,131,159
050,51,775,"Virginia","Salem city",4,57,334,155,179
050,51,775,"Virginia","Salem city",4,58,350,177,173
050,51,775,"Virginia","Salem city",4,59,351,172,179
050,51,775,"Virginia","Salem city",4,60,321,148,173
050,51,775,"Virginia","Salem city",4,61,341,167,174
050,51,775,"Virginia","Salem city",4,62,371,182,189
050,51,775,"Virginia","Salem city",4,63,351,164,187
050,51,775,"Virginia","Salem city",4,64,364,172,192
050,51,775,"Virginia","Salem city",4,65,365,166,199
050,51,775,"Virginia","Salem city",4,66,344,148,196
050,51,775,"Virginia","Salem city",4,67,315,147,168
050,51,775,"Virginia","Salem city",4,68,291,139,152
050,51,775,"Virginia","Salem city",4,69,300,135,165
050,51,775,"Virginia","Salem city",4,70,308,133,175
050,51,775,"Virginia","Salem city",4,71,259,108,151
050,51,775,"Virginia","Salem city",4,72,242,103,139
050,51,775,"Virginia","Salem city",4,73,253,100,153
050,51,775,"Virginia","Salem city",4,74,270,120,150
050,51,775,"Virginia","Salem city",4,75,275,123,152
050,51,775,"Virginia","Salem city",4,76,190,83,107
050,51,775,"Virginia","Salem city",4,77,157,69,88
050,51,775,"Virginia","Salem city",4,78,161,65,96
050,51,775,"Virginia","Salem city",4,79,160,71,89
050,51,775,"Virginia","Salem city",4,80,153,66,87
050,51,775,"Virginia","Salem city",4,81,138,57,81
050,51,775,"Virginia","Salem city",4,82,103,44,59
050,51,775,"Virginia","Salem city",4,83,113,42,71
050,51,775,"Virginia","Salem city",4,84,107,48,59
050,51,775,"Virginia","Salem city",4,85,584,190,394
050,51,775,"Virginia","Salem city",5,0,323,166,157
050,51,775,"Virginia","Salem city",5,1,321,174,147
050,51,775,"Virginia","Salem city",5,2,253,148,105
050,51,775,"Virginia","Salem city",5,3,265,152,113
050,51,775,"Virginia","Salem city",5,4,226,122,104
050,51,775,"Virginia","Salem city",5,5,255,125,130
050,51,775,"Virginia","Salem city",5,6,246,128,118
050,51,775,"Virginia","Salem city",5,7,250,116,134
050,51,775,"Virginia","Salem city",5,8,266,135,131
050,51,775,"Virginia","Salem city",5,9,263,140,123
050,51,775,"Virginia","Salem city",5,10,269,135,134
050,51,775,"Virginia","Salem city",5,11,299,149,150
050,51,775,"Virginia","Salem city",5,12,280,147,133
050,51,775,"Virginia","Salem city",5,13,292,152,140
050,51,775,"Virginia","Salem city",5,14,300,164,136
050,51,775,"Virginia","Salem city",5,15,285,143,142
050,51,775,"Virginia","Salem city",5,16,295,153,142
050,51,775,"Virginia","Salem city",5,17,311,174,137
050,51,775,"Virginia","Salem city",5,18,514,242,272
050,51,775,"Virginia","Salem city",5,19,700,315,385
050,51,775,"Virginia","Salem city",5,20,602,260,342
050,51,775,"Virginia","Salem city",5,21,482,218,264
050,51,775,"Virginia","Salem city",5,22,400,187,213
050,51,775,"Virginia","Salem city",5,23,309,148,161
050,51,775,"Virginia","Salem city",5,24,248,129,119
050,51,775,"Virginia","Salem city",5,25,265,143,122
050,51,775,"Virginia","Salem city",5,26,287,144,143
050,51,775,"Virginia","Salem city",5,27,313,168,145
050,51,775,"Virginia","Salem city",5,28,271,141,130
050,51,775,"Virginia","Salem city",5,29,314,157,157
050,51,775,"Virginia","Salem city",5,30,284,137,147
050,51,775,"Virginia","Salem city",5,31,305,142,163
050,51,775,"Virginia","Salem city",5,32,298,131,167
050,51,775,"Virginia","Salem city",5,33,325,144,181
050,51,775,"Virginia","Salem city",5,34,310,141,169
050,51,775,"Virginia","Salem city",5,35,306,146,160
050,51,775,"Virginia","Salem city",5,36,288,142,146
050,51,775,"Virginia","Salem city",5,37,319,165,154
050,51,775,"Virginia","Salem city",5,38,287,158,129
050,51,775,"Virginia","Salem city",5,39,300,159,141
050,51,775,"Virginia","Salem city",5,40,302,157,145
050,51,775,"Virginia","Salem city",5,41,314,148,166
050,51,775,"Virginia","Salem city",5,42,324,156,168
050,51,775,"Virginia","Salem city",5,43,313,154,159
050,51,775,"Virginia","Salem city",5,44,286,154,132
050,51,775,"Virginia","Salem city",5,45,284,136,148
050,51,775,"Virginia","Salem city",5,46,281,133,148
050,51,775,"Virginia","Salem city",5,47,249,124,125
050,51,775,"Virginia","Salem city",5,48,235,111,124
050,51,775,"Virginia","Salem city",5,49,267,136,131
050,51,775,"Virginia","Salem city",5,50,296,141,155
050,51,775,"Virginia","Salem city",5,51,313,152,161
050,51,775,"Virginia","Salem city",5,52,352,169,183
050,51,775,"Virginia","Salem city",5,53,345,171,174
050,51,775,"Virginia","Salem city",5,54,314,156,158
050,51,775,"Virginia","Salem city",5,55,288,142,146
050,51,775,"Virginia","Salem city",5,56,285,135,150
050,51,775,"Virginia","Salem city",5,57,286,129,157
050,51,775,"Virginia","Salem city",5,58,318,145,173
050,51,775,"Virginia","Salem city",5,59,363,181,182
050,51,775,"Virginia","Salem city",5,60,331,161,170
050,51,775,"Virginia","Salem city",5,61,316,149,167
050,51,775,"Virginia","Salem city",5,62,332,167,165
050,51,775,"Virginia","Salem city",5,63,363,172,191
050,51,775,"Virginia","Salem city",5,64,347,160,187
050,51,775,"Virginia","Salem city",5,65,352,160,192
050,51,775,"Virginia","Salem city",5,66,355,155,200
050,51,775,"Virginia","Salem city",5,67,344,147,197
050,51,775,"Virginia","Salem city",5,68,311,153,158
050,51,775,"Virginia","Salem city",5,69,279,124,155
050,51,775,"Virginia","Salem city",5,70,289,127,162
050,51,775,"Virginia","Salem city",5,71,303,131,172
050,51,775,"Virginia","Salem city",5,72,249,105,144
050,51,775,"Virginia","Salem city",5,73,235,94,141
050,51,775,"Virginia","Salem city",5,74,247,100,147
050,51,775,"Virginia","Salem city",5,75,266,120,146
050,51,775,"Virginia","Salem city",5,76,270,115,155
050,51,775,"Virginia","Salem city",5,77,165,75,90
050,51,775,"Virginia","Salem city",5,78,145,62,83
050,51,775,"Virginia","Salem city",5,79,147,59,88
050,51,775,"Virginia","Salem city",5,80,149,72,77
050,51,775,"Virginia","Salem city",5,81,138,56,82
050,51,775,"Virginia","Salem city",5,82,126,49,77
050,51,775,"Virginia","Salem city",5,83,98,43,55
050,51,775,"Virginia","Salem city",5,84,99,40,59
050,51,775,"Virginia","Salem city",5,85,603,197,406
050,51,790,"Virginia","Staunton city",1,0,336,170,166
050,51,790,"Virginia","Staunton city",1,1,284,140,144
050,51,790,"Virginia","Staunton city",1,2,283,140,143
050,51,790,"Virginia","Staunton city",1,3,292,146,146
050,51,790,"Virginia","Staunton city",1,4,285,155,130
050,51,790,"Virginia","Staunton city",1,5,289,139,150
050,51,790,"Virginia","Staunton city",1,6,251,126,125
050,51,790,"Virginia","Staunton city",1,7,237,115,122
050,51,790,"Virginia","Staunton city",1,8,291,143,148
050,51,790,"Virginia","Staunton city",1,9,245,133,112
050,51,790,"Virginia","Staunton city",1,10,244,141,103
050,51,790,"Virginia","Staunton city",1,11,262,134,128
050,51,790,"Virginia","Staunton city",1,12,273,148,125
050,51,790,"Virginia","Staunton city",1,13,258,140,118
050,51,790,"Virginia","Staunton city",1,14,265,145,120
050,51,790,"Virginia","Staunton city",1,15,252,137,115
050,51,790,"Virginia","Staunton city",1,16,296,144,152
050,51,790,"Virginia","Staunton city",1,17,285,141,144
050,51,790,"Virginia","Staunton city",1,18,312,107,205
050,51,790,"Virginia","Staunton city",1,19,331,76,255
050,51,790,"Virginia","Staunton city",1,20,345,103,242
050,51,790,"Virginia","Staunton city",1,21,330,100,230
050,51,790,"Virginia","Staunton city",1,22,308,105,203
050,51,790,"Virginia","Staunton city",1,23,305,123,182
050,51,790,"Virginia","Staunton city",1,24,300,137,163
050,51,790,"Virginia","Staunton city",1,25,340,157,183
050,51,790,"Virginia","Staunton city",1,26,358,157,201
050,51,790,"Virginia","Staunton city",1,27,354,145,209
050,51,790,"Virginia","Staunton city",1,28,393,191,202
050,51,790,"Virginia","Staunton city",1,29,355,169,186
050,51,790,"Virginia","Staunton city",1,30,360,180,180
050,51,790,"Virginia","Staunton city",1,31,352,170,182
050,51,790,"Virginia","Staunton city",1,32,334,152,182
050,51,790,"Virginia","Staunton city",1,33,358,168,190
050,51,790,"Virginia","Staunton city",1,34,329,168,161
050,51,790,"Virginia","Staunton city",1,35,323,155,168
050,51,790,"Virginia","Staunton city",1,36,345,173,172
050,51,790,"Virginia","Staunton city",1,37,360,177,183
050,51,790,"Virginia","Staunton city",1,38,333,166,167
050,51,790,"Virginia","Staunton city",1,39,357,190,167
050,51,790,"Virginia","Staunton city",1,40,337,163,174
050,51,790,"Virginia","Staunton city",1,41,326,147,179
050,51,790,"Virginia","Staunton city",1,42,308,160,148
050,51,790,"Virginia","Staunton city",1,43,320,154,166
050,51,790,"Virginia","Staunton city",1,44,287,142,145
050,51,790,"Virginia","Staunton city",1,45,272,132,140
050,51,790,"Virginia","Staunton city",1,46,286,140,146
050,51,790,"Virginia","Staunton city",1,47,277,123,154
050,51,790,"Virginia","Staunton city",1,48,290,149,141
050,51,790,"Virginia","Staunton city",1,49,331,173,158
050,51,790,"Virginia","Staunton city",1,50,301,148,153
050,51,790,"Virginia","Staunton city",1,51,294,147,147
050,51,790,"Virginia","Staunton city",1,52,322,164,158
050,51,790,"Virginia","Staunton city",1,53,323,155,168
050,51,790,"Virginia","Staunton city",1,54,313,149,164
050,51,790,"Virginia","Staunton city",1,55,308,142,166
050,51,790,"Virginia","Staunton city",1,56,331,160,171
050,51,790,"Virginia","Staunton city",1,57,344,168,176
050,51,790,"Virginia","Staunton city",1,58,360,172,188
050,51,790,"Virginia","Staunton city",1,59,358,165,193
050,51,790,"Virginia","Staunton city",1,60,334,143,191
050,51,790,"Virginia","Staunton city",1,61,331,150,181
050,51,790,"Virginia","Staunton city",1,62,346,153,193
050,51,790,"Virginia","Staunton city",1,63,349,158,191
050,51,790,"Virginia","Staunton city",1,64,314,130,184
050,51,790,"Virginia","Staunton city",1,65,344,141,203
050,51,790,"Virginia","Staunton city",1,66,347,153,194
050,51,790,"Virginia","Staunton city",1,67,313,135,178
050,51,790,"Virginia","Staunton city",1,68,349,172,177
050,51,790,"Virginia","Staunton city",1,69,334,166,168
050,51,790,"Virginia","Staunton city",1,70,309,145,164
050,51,790,"Virginia","Staunton city",1,71,294,125,169
050,51,790,"Virginia","Staunton city",1,72,300,136,164
050,51,790,"Virginia","Staunton city",1,73,323,157,166
050,51,790,"Virginia","Staunton city",1,74,210,95,115
050,51,790,"Virginia","Staunton city",1,75,236,101,135
050,51,790,"Virginia","Staunton city",1,76,230,96,134
050,51,790,"Virginia","Staunton city",1,77,203,93,110
050,51,790,"Virginia","Staunton city",1,78,162,65,97
050,51,790,"Virginia","Staunton city",1,79,166,61,105
050,51,790,"Virginia","Staunton city",1,80,143,58,85
050,51,790,"Virginia","Staunton city",1,81,134,51,83
050,51,790,"Virginia","Staunton city",1,82,109,40,69
050,51,790,"Virginia","Staunton city",1,83,115,44,71
050,51,790,"Virginia","Staunton city",1,84,103,39,64
050,51,790,"Virginia","Staunton city",1,85,657,200,457
050,51,790,"Virginia","Staunton city",2,0,339,163,176
050,51,790,"Virginia","Staunton city",2,1,292,143,149
050,51,790,"Virginia","Staunton city",2,2,284,138,146
050,51,790,"Virginia","Staunton city",2,3,286,146,140
050,51,790,"Virginia","Staunton city",2,4,283,151,132
050,51,790,"Virginia","Staunton city",2,5,285,140,145
050,51,790,"Virginia","Staunton city",2,6,259,129,130
050,51,790,"Virginia","Staunton city",2,7,238,116,122
050,51,790,"Virginia","Staunton city",2,8,275,134,141
050,51,790,"Virginia","Staunton city",2,9,256,136,120
050,51,790,"Virginia","Staunton city",2,10,245,138,107
050,51,790,"Virginia","Staunton city",2,11,256,134,122
050,51,790,"Virginia","Staunton city",2,12,273,146,127
050,51,790,"Virginia","Staunton city",2,13,257,139,118
050,51,790,"Virginia","Staunton city",2,14,263,144,119
050,51,790,"Virginia","Staunton city",2,15,253,139,114
050,51,790,"Virginia","Staunton city",2,16,297,147,150
050,51,790,"Virginia","Staunton city",2,17,288,144,144
050,51,790,"Virginia","Staunton city",2,18,313,110,203
050,51,790,"Virginia","Staunton city",2,19,334,79,255
050,51,790,"Virginia","Staunton city",2,20,344,100,244
050,51,790,"Virginia","Staunton city",2,21,336,103,233
050,51,790,"Virginia","Staunton city",2,22,313,110,203
050,51,790,"Virginia","Staunton city",2,23,303,121,182
050,51,790,"Virginia","Staunton city",2,24,306,141,165
050,51,790,"Virginia","Staunton city",2,25,338,156,182
050,51,790,"Virginia","Staunton city",2,26,359,161,198
050,51,790,"Virginia","Staunton city",2,27,358,151,207
050,51,790,"Virginia","Staunton city",2,28,384,181,203
050,51,790,"Virginia","Staunton city",2,29,366,176,190
050,51,790,"Virginia","Staunton city",2,30,366,179,187
050,51,790,"Virginia","Staunton city",2,31,352,173,179
050,51,790,"Virginia","Staunton city",2,32,343,159,184
050,51,790,"Virginia","Staunton city",2,33,351,163,188
050,51,790,"Virginia","Staunton city",2,34,334,166,168
050,51,790,"Virginia","Staunton city",2,35,329,161,168
050,51,790,"Virginia","Staunton city",2,36,336,166,170
050,51,790,"Virginia","Staunton city",2,37,359,179,180
050,51,790,"Virginia","Staunton city",2,38,345,171,174
050,51,790,"Virginia","Staunton city",2,39,351,185,166
050,51,790,"Virginia","Staunton city",2,40,345,170,175
050,51,790,"Virginia","Staunton city",2,41,328,151,177
050,51,790,"Virginia","Staunton city",2,42,309,155,154
050,51,790,"Virginia","Staunton city",2,43,320,157,163
050,51,790,"Virginia","Staunton city",2,44,289,141,148
050,51,790,"Virginia","Staunton city",2,45,278,136,142
050,51,790,"Virginia","Staunton city",2,46,280,136,144
050,51,790,"Virginia","Staunton city",2,47,280,129,151
050,51,790,"Virginia","Staunton city",2,48,289,144,145
050,51,790,"Virginia","Staunton city",2,49,322,168,154
050,51,790,"Virginia","Staunton city",2,50,305,152,153
050,51,790,"Virginia","Staunton city",2,51,294,147,147
050,51,790,"Virginia","Staunton city",2,52,313,160,153
050,51,790,"Virginia","Staunton city",2,53,328,161,167
050,51,790,"Virginia","Staunton city",2,54,312,148,164
050,51,790,"Virginia","Staunton city",2,55,308,144,164
050,51,790,"Virginia","Staunton city",2,56,328,158,170
050,51,790,"Virginia","Staunton city",2,57,342,166,176
050,51,790,"Virginia","Staunton city",2,58,355,170,185
050,51,790,"Virginia","Staunton city",2,59,361,168,193
050,51,790,"Virginia","Staunton city",2,60,336,146,190
050,51,790,"Virginia","Staunton city",2,61,330,148,182
050,51,790,"Virginia","Staunton city",2,62,340,151,189
050,51,790,"Virginia","Staunton city",2,63,349,157,192
050,51,790,"Virginia","Staunton city",2,64,317,133,184
050,51,790,"Virginia","Staunton city",2,65,341,141,200
050,51,790,"Virginia","Staunton city",2,66,344,148,196
050,51,790,"Virginia","Staunton city",2,67,320,139,181
050,51,790,"Virginia","Staunton city",2,68,344,167,177
050,51,790,"Virginia","Staunton city",2,69,339,168,171
050,51,790,"Virginia","Staunton city",2,70,313,150,163
050,51,790,"Virginia","Staunton city",2,71,297,131,166
050,51,790,"Virginia","Staunton city",2,72,295,131,164
050,51,790,"Virginia","Staunton city",2,73,331,158,173
050,51,790,"Virginia","Staunton city",2,74,227,106,121
050,51,790,"Virginia","Staunton city",2,75,227,97,130
050,51,790,"Virginia","Staunton city",2,76,227,95,132
050,51,790,"Virginia","Staunton city",2,77,212,96,116
050,51,790,"Virginia","Staunton city",2,78,164,69,95
050,51,790,"Virginia","Staunton city",2,79,166,61,105
050,51,790,"Virginia","Staunton city",2,80,144,56,88
050,51,790,"Virginia","Staunton city",2,81,138,53,85
050,51,790,"Virginia","Staunton city",2,82,108,39,69
050,51,790,"Virginia","Staunton city",2,83,112,44,68
050,51,790,"Virginia","Staunton city",2,84,103,39,64
050,51,790,"Virginia","Staunton city",2,85,653,200,453
050,51,790,"Virginia","Staunton city",3,0,362,179,183
050,51,790,"Virginia","Staunton city",3,1,301,145,156
050,51,790,"Virginia","Staunton city",3,2,292,147,145
050,51,790,"Virginia","Staunton city",3,3,278,138,140
050,51,790,"Virginia","Staunton city",3,4,278,147,131
050,51,790,"Virginia","Staunton city",3,5,279,142,137
050,51,790,"Virginia","Staunton city",3,6,277,136,141
050,51,790,"Virginia","Staunton city",3,7,250,124,126
050,51,790,"Virginia","Staunton city",3,8,250,126,124
050,51,790,"Virginia","Staunton city",3,9,257,134,123
050,51,790,"Virginia","Staunton city",3,10,240,131,109
050,51,790,"Virginia","Staunton city",3,11,230,136,94
050,51,790,"Virginia","Staunton city",3,12,251,133,118
050,51,790,"Virginia","Staunton city",3,13,273,140,133
050,51,790,"Virginia","Staunton city",3,14,258,145,113
050,51,790,"Virginia","Staunton city",3,15,263,144,119
050,51,790,"Virginia","Staunton city",3,16,295,138,157
050,51,790,"Virginia","Staunton city",3,17,292,153,139
050,51,790,"Virginia","Staunton city",3,18,317,120,197
050,51,790,"Virginia","Staunton city",3,19,338,85,253
050,51,790,"Virginia","Staunton city",3,20,323,90,233
050,51,790,"Virginia","Staunton city",3,21,331,105,226
050,51,790,"Virginia","Staunton city",3,22,296,108,188
050,51,790,"Virginia","Staunton city",3,23,309,126,183
050,51,790,"Virginia","Staunton city",3,24,320,137,183
050,51,790,"Virginia","Staunton city",3,25,297,136,161
050,51,790,"Virginia","Staunton city",3,26,330,152,178
050,51,790,"Virginia","Staunton city",3,27,337,149,188
050,51,790,"Virginia","Staunton city",3,28,365,163,202
050,51,790,"Virginia","Staunton city",3,29,376,175,201
050,51,790,"Virginia","Staunton city",3,30,359,170,189
050,51,790,"Virginia","Staunton city",3,31,377,191,186
050,51,790,"Virginia","Staunton city",3,32,365,180,185
050,51,790,"Virginia","Staunton city",3,33,358,173,185
050,51,790,"Virginia","Staunton city",3,34,344,146,198
050,51,790,"Virginia","Staunton city",3,35,346,171,175
050,51,790,"Virginia","Staunton city",3,36,326,151,175
050,51,790,"Virginia","Staunton city",3,37,321,164,157
050,51,790,"Virginia","Staunton city",3,38,329,163,166
050,51,790,"Virginia","Staunton city",3,39,332,167,165
050,51,790,"Virginia","Staunton city",3,40,355,183,172
050,51,790,"Virginia","Staunton city",3,41,342,170,172
050,51,790,"Virginia","Staunton city",3,42,329,150,179
050,51,790,"Virginia","Staunton city",3,43,327,169,158
050,51,790,"Virginia","Staunton city",3,44,327,154,173
050,51,790,"Virginia","Staunton city",3,45,291,146,145
050,51,790,"Virginia","Staunton city",3,46,280,130,150
050,51,790,"Virginia","Staunton city",3,47,283,134,149
050,51,790,"Virginia","Staunton city",3,48,279,132,147
050,51,790,"Virginia","Staunton city",3,49,272,135,137
050,51,790,"Virginia","Staunton city",3,50,318,162,156
050,51,790,"Virginia","Staunton city",3,51,308,157,151
050,51,790,"Virginia","Staunton city",3,52,283,140,143
050,51,790,"Virginia","Staunton city",3,53,329,171,158
050,51,790,"Virginia","Staunton city",3,54,318,154,164
050,51,790,"Virginia","Staunton city",3,55,315,150,165
050,51,790,"Virginia","Staunton city",3,56,303,138,165
050,51,790,"Virginia","Staunton city",3,57,326,152,174
050,51,790,"Virginia","Staunton city",3,58,343,166,177
050,51,790,"Virginia","Staunton city",3,59,345,164,181
050,51,790,"Virginia","Staunton city",3,60,346,155,191
050,51,790,"Virginia","Staunton city",3,61,321,145,176
050,51,790,"Virginia","Staunton city",3,62,319,138,181
050,51,790,"Virginia","Staunton city",3,63,333,143,190
050,51,790,"Virginia","Staunton city",3,64,349,157,192
050,51,790,"Virginia","Staunton city",3,65,321,143,178
050,51,790,"Virginia","Staunton city",3,66,325,130,195
050,51,790,"Virginia","Staunton city",3,67,338,140,198
050,51,790,"Virginia","Staunton city",3,68,332,155,177
050,51,790,"Virginia","Staunton city",3,69,330,159,171
050,51,790,"Virginia","Staunton city",3,70,321,150,171
050,51,790,"Virginia","Staunton city",3,71,301,140,161
050,51,790,"Virginia","Staunton city",3,72,290,124,166
050,51,790,"Virginia","Staunton city",3,73,282,122,160
050,51,790,"Virginia","Staunton city",3,74,326,155,171
050,51,790,"Virginia","Staunton city",3,75,214,100,114
050,51,790,"Virginia","Staunton city",3,76,230,98,132
050,51,790,"Virginia","Staunton city",3,77,209,89,120
050,51,790,"Virginia","Staunton city",3,78,194,81,113
050,51,790,"Virginia","Staunton city",3,79,169,68,101
050,51,790,"Virginia","Staunton city",3,80,148,52,96
050,51,790,"Virginia","Staunton city",3,81,157,58,99
050,51,790,"Virginia","Staunton city",3,82,108,41,67
050,51,790,"Virginia","Staunton city",3,83,101,43,58
050,51,790,"Virginia","Staunton city",3,84,99,38,61
050,51,790,"Virginia","Staunton city",3,85,631,188,443
050,51,790,"Virginia","Staunton city",4,0,364,193,171
050,51,790,"Virginia","Staunton city",4,1,342,166,176
050,51,790,"Virginia","Staunton city",4,2,286,144,142
050,51,790,"Virginia","Staunton city",4,3,281,145,136
050,51,790,"Virginia","Staunton city",4,4,286,138,148
050,51,790,"Virginia","Staunton city",4,5,266,139,127
050,51,790,"Virginia","Staunton city",4,6,278,141,137
050,51,790,"Virginia","Staunton city",4,7,269,137,132
050,51,790,"Virginia","Staunton city",4,8,280,148,132
050,51,790,"Virginia","Staunton city",4,9,252,121,131
050,51,790,"Virginia","Staunton city",4,10,259,136,123
050,51,790,"Virginia","Staunton city",4,11,242,131,111
050,51,790,"Virginia","Staunton city",4,12,241,138,103
050,51,790,"Virginia","Staunton city",4,13,248,132,116
050,51,790,"Virginia","Staunton city",4,14,287,143,144
050,51,790,"Virginia","Staunton city",4,15,266,144,122
050,51,790,"Virginia","Staunton city",4,16,308,146,162
050,51,790,"Virginia","Staunton city",4,17,295,143,152
050,51,790,"Virginia","Staunton city",4,18,323,132,191
050,51,790,"Virginia","Staunton city",4,19,334,87,247
050,51,790,"Virginia","Staunton city",4,20,333,94,239
050,51,790,"Virginia","Staunton city",4,21,310,91,219
050,51,790,"Virginia","Staunton city",4,22,295,105,190
050,51,790,"Virginia","Staunton city",4,23,284,108,176
050,51,790,"Virginia","Staunton city",4,24,327,145,182
050,51,790,"Virginia","Staunton city",4,25,327,144,183
050,51,790,"Virginia","Staunton city",4,26,312,140,172
050,51,790,"Virginia","Staunton city",4,27,355,164,191
050,51,790,"Virginia","Staunton city",4,28,334,149,185
050,51,790,"Virginia","Staunton city",4,29,349,151,198
050,51,790,"Virginia","Staunton city",4,30,382,183,199
050,51,790,"Virginia","Staunton city",4,31,367,169,198
050,51,790,"Virginia","Staunton city",4,32,371,188,183
050,51,790,"Virginia","Staunton city",4,33,351,182,169
050,51,790,"Virginia","Staunton city",4,34,350,165,185
050,51,790,"Virginia","Staunton city",4,35,331,140,191
050,51,790,"Virginia","Staunton city",4,36,357,172,185
050,51,790,"Virginia","Staunton city",4,37,331,159,172
050,51,790,"Virginia","Staunton city",4,38,313,159,154
050,51,790,"Virginia","Staunton city",4,39,331,158,173
050,51,790,"Virginia","Staunton city",4,40,348,169,179
050,51,790,"Virginia","Staunton city",4,41,352,184,168
050,51,790,"Virginia","Staunton city",4,42,362,179,183
050,51,790,"Virginia","Staunton city",4,43,347,156,191
050,51,790,"Virginia","Staunton city",4,44,326,163,163
050,51,790,"Virginia","Staunton city",4,45,327,153,174
050,51,790,"Virginia","Staunton city",4,46,300,152,148
050,51,790,"Virginia","Staunton city",4,47,288,138,150
050,51,790,"Virginia","Staunton city",4,48,301,147,154
050,51,790,"Virginia","Staunton city",4,49,283,131,152
050,51,790,"Virginia","Staunton city",4,50,274,135,139
050,51,790,"Virginia","Staunton city",4,51,323,163,160
050,51,790,"Virginia","Staunton city",4,52,298,149,149
050,51,790,"Virginia","Staunton city",4,53,284,142,142
050,51,790,"Virginia","Staunton city",4,54,322,170,152
050,51,790,"Virginia","Staunton city",4,55,319,158,161
050,51,790,"Virginia","Staunton city",4,56,316,142,174
050,51,790,"Virginia","Staunton city",4,57,324,150,174
050,51,790,"Virginia","Staunton city",4,58,334,158,176
050,51,790,"Virginia","Staunton city",4,59,331,167,164
050,51,790,"Virginia","Staunton city",4,60,348,158,190
050,51,790,"Virginia","Staunton city",4,61,350,163,187
050,51,790,"Virginia","Staunton city",4,62,320,134,186
050,51,790,"Virginia","Staunton city",4,63,324,143,181
050,51,790,"Virginia","Staunton city",4,64,336,144,192
050,51,790,"Virginia","Staunton city",4,65,351,163,188
050,51,790,"Virginia","Staunton city",4,66,314,138,176
050,51,790,"Virginia","Staunton city",4,67,324,131,193
050,51,790,"Virginia","Staunton city",4,68,354,152,202
050,51,790,"Virginia","Staunton city",4,69,344,157,187
050,51,790,"Virginia","Staunton city",4,70,326,150,176
050,51,790,"Virginia","Staunton city",4,71,299,136,163
050,51,790,"Virginia","Staunton city",4,72,300,134,166
050,51,790,"Virginia","Staunton city",4,73,277,119,158
050,51,790,"Virginia","Staunton city",4,74,279,116,163
050,51,790,"Virginia","Staunton city",4,75,309,149,160
050,51,790,"Virginia","Staunton city",4,76,214,96,118
050,51,790,"Virginia","Staunton city",4,77,210,95,115
050,51,790,"Virginia","Staunton city",4,78,185,75,110
050,51,790,"Virginia","Staunton city",4,79,198,77,121
050,51,790,"Virginia","Staunton city",4,80,148,58,90
050,51,790,"Virginia","Staunton city",4,81,158,56,102
050,51,790,"Virginia","Staunton city",4,82,129,45,84
050,51,790,"Virginia","Staunton city",4,83,97,40,57
050,51,790,"Virginia","Staunton city",4,84,81,31,50
050,51,790,"Virginia","Staunton city",4,85,589,174,415
050,51,790,"Virginia","Staunton city",5,0,368,195,173
050,51,790,"Virginia","Staunton city",5,1,354,186,168
050,51,790,"Virginia","Staunton city",5,2,320,161,159
050,51,790,"Virginia","Staunton city",5,3,280,134,146
050,51,790,"Virginia","Staunton city",5,4,267,137,130
050,51,790,"Virginia","Staunton city",5,5,275,137,138
050,51,790,"Virginia","Staunton city",5,6,248,133,115
050,51,790,"Virginia","Staunton city",5,7,282,147,135
050,51,790,"Virginia","Staunton city",5,8,268,139,129
050,51,790,"Virginia","Staunton city",5,9,265,143,122
050,51,790,"Virginia","Staunton city",5,10,254,134,120
050,51,790,"Virginia","Staunton city",5,11,251,133,118
050,51,790,"Virginia","Staunton city",5,12,266,151,115
050,51,790,"Virginia","Staunton city",5,13,238,139,99
050,51,790,"Virginia","Staunton city",5,14,239,120,119
050,51,790,"Virginia","Staunton city",5,15,265,124,141
050,51,790,"Virginia","Staunton city",5,16,311,145,166
050,51,790,"Virginia","Staunton city",5,17,293,139,154
050,51,790,"Virginia","Staunton city",5,18,327,124,203
050,51,790,"Virginia","Staunton city",5,19,339,99,240
050,51,790,"Virginia","Staunton city",5,20,319,95,224
050,51,790,"Virginia","Staunton city",5,21,324,101,223
050,51,790,"Virginia","Staunton city",5,22,280,97,183
050,51,790,"Virginia","Staunton city",5,23,276,103,173
050,51,790,"Virginia","Staunton city",5,24,272,130,142
050,51,790,"Virginia","Staunton city",5,25,326,137,189
050,51,790,"Virginia","Staunton city",5,26,336,147,189
050,51,790,"Virginia","Staunton city",5,27,313,140,173
050,51,790,"Virginia","Staunton city",5,28,339,167,172
050,51,790,"Virginia","Staunton city",5,29,332,157,175
050,51,790,"Virginia","Staunton city",5,30,382,171,211
050,51,790,"Virginia","Staunton city",5,31,376,176,200
050,51,790,"Virginia","Staunton city",5,32,384,172,212
050,51,790,"Virginia","Staunton city",5,33,375,190,185
050,51,790,"Virginia","Staunton city",5,34,340,179,161
050,51,790,"Virginia","Staunton city",5,35,349,164,185
050,51,790,"Virginia","Staunton city",5,36,326,141,185
050,51,790,"Virginia","Staunton city",5,37,360,172,188
050,51,790,"Virginia","Staunton city",5,38,324,158,166
050,51,790,"Virginia","Staunton city",5,39,317,160,157
050,51,790,"Virginia","Staunton city",5,40,349,174,175
050,51,790,"Virginia","Staunton city",5,41,356,174,182
050,51,790,"Virginia","Staunton city",5,42,350,178,172
050,51,790,"Virginia","Staunton city",5,43,361,173,188
050,51,790,"Virginia","Staunton city",5,44,330,144,186
050,51,790,"Virginia","Staunton city",5,45,335,168,167
050,51,790,"Virginia","Staunton city",5,46,321,144,177
050,51,790,"Virginia","Staunton city",5,47,297,145,152
050,51,790,"Virginia","Staunton city",5,48,297,145,152
050,51,790,"Virginia","Staunton city",5,49,312,148,164
050,51,790,"Virginia","Staunton city",5,50,259,134,125
050,51,790,"Virginia","Staunton city",5,51,281,144,137
050,51,790,"Virginia","Staunton city",5,52,314,158,156
050,51,790,"Virginia","Staunton city",5,53,307,151,156
050,51,790,"Virginia","Staunton city",5,54,282,140,142
050,51,790,"Virginia","Staunton city",5,55,312,161,151
050,51,790,"Virginia","Staunton city",5,56,323,153,170
050,51,790,"Virginia","Staunton city",5,57,321,145,176
050,51,790,"Virginia","Staunton city",5,58,319,148,171
050,51,790,"Virginia","Staunton city",5,59,320,150,170
050,51,790,"Virginia","Staunton city",5,60,344,167,177
050,51,790,"Virginia","Staunton city",5,61,342,157,185
050,51,790,"Virginia","Staunton city",5,62,340,154,186
050,51,790,"Virginia","Staunton city",5,63,309,131,178
050,51,790,"Virginia","Staunton city",5,64,314,134,180
050,51,790,"Virginia","Staunton city",5,65,352,156,196
050,51,790,"Virginia","Staunton city",5,66,334,153,181
050,51,790,"Virginia","Staunton city",5,67,316,134,182
050,51,790,"Virginia","Staunton city",5,68,343,148,195
050,51,790,"Virginia","Staunton city",5,69,351,151,200
050,51,790,"Virginia","Staunton city",5,70,322,137,185
050,51,790,"Virginia","Staunton city",5,71,316,143,173
050,51,790,"Virginia","Staunton city",5,72,304,137,167
050,51,790,"Virginia","Staunton city",5,73,292,130,162
050,51,790,"Virginia","Staunton city",5,74,275,121,154
050,51,790,"Virginia","Staunton city",5,75,268,115,153
050,51,790,"Virginia","Staunton city",5,76,308,143,165
050,51,790,"Virginia","Staunton city",5,77,200,94,106
050,51,790,"Virginia","Staunton city",5,78,185,77,108
050,51,790,"Virginia","Staunton city",5,79,183,71,112
050,51,790,"Virginia","Staunton city",5,80,177,68,109
050,51,790,"Virginia","Staunton city",5,81,151,54,97
050,51,790,"Virginia","Staunton city",5,82,129,43,86
050,51,790,"Virginia","Staunton city",5,83,119,45,74
050,51,790,"Virginia","Staunton city",5,84,84,33,51
050,51,790,"Virginia","Staunton city",5,85,551,153,398
050,51,800,"Virginia","Suffolk city",1,0,1125,567,558
050,51,800,"Virginia","Suffolk city",1,1,1181,601,580
050,51,800,"Virginia","Suffolk city",1,2,1206,629,577
050,51,800,"Virginia","Suffolk city",1,3,1194,608,586
050,51,800,"Virginia","Suffolk city",1,4,1247,638,609
050,51,800,"Virginia","Suffolk city",1,5,1305,656,649
050,51,800,"Virginia","Suffolk city",1,6,1226,642,584
050,51,800,"Virginia","Suffolk city",1,7,1227,631,596
050,51,800,"Virginia","Suffolk city",1,8,1276,664,612
050,51,800,"Virginia","Suffolk city",1,9,1256,645,611
050,51,800,"Virginia","Suffolk city",1,10,1229,642,587
050,51,800,"Virginia","Suffolk city",1,11,1246,660,586
050,51,800,"Virginia","Suffolk city",1,12,1368,687,681
050,51,800,"Virginia","Suffolk city",1,13,1374,691,683
050,51,800,"Virginia","Suffolk city",1,14,1279,676,603
050,51,800,"Virginia","Suffolk city",1,15,1276,653,623
050,51,800,"Virginia","Suffolk city",1,16,1280,641,639
050,51,800,"Virginia","Suffolk city",1,17,1230,622,608
050,51,800,"Virginia","Suffolk city",1,18,1044,544,500
050,51,800,"Virginia","Suffolk city",1,19,953,494,459
050,51,800,"Virginia","Suffolk city",1,20,1011,534,477
050,51,800,"Virginia","Suffolk city",1,21,1016,517,499
050,51,800,"Virginia","Suffolk city",1,22,1059,547,512
050,51,800,"Virginia","Suffolk city",1,23,1116,594,522
050,51,800,"Virginia","Suffolk city",1,24,1101,567,534
050,51,800,"Virginia","Suffolk city",1,25,1169,599,570
050,51,800,"Virginia","Suffolk city",1,26,1196,599,597
050,51,800,"Virginia","Suffolk city",1,27,1190,560,630
050,51,800,"Virginia","Suffolk city",1,28,1211,578,633
050,51,800,"Virginia","Suffolk city",1,29,1279,624,655
050,51,800,"Virginia","Suffolk city",1,30,1338,658,680
050,51,800,"Virginia","Suffolk city",1,31,1362,664,698
050,51,800,"Virginia","Suffolk city",1,32,1392,693,699
050,51,800,"Virginia","Suffolk city",1,33,1354,645,709
050,51,800,"Virginia","Suffolk city",1,34,1335,674,661
050,51,800,"Virginia","Suffolk city",1,35,1303,629,674
050,51,800,"Virginia","Suffolk city",1,36,1328,630,698
050,51,800,"Virginia","Suffolk city",1,37,1323,678,645
050,51,800,"Virginia","Suffolk city",1,38,1386,718,668
050,51,800,"Virginia","Suffolk city",1,39,1335,671,664
050,51,800,"Virginia","Suffolk city",1,40,1287,620,667
050,51,800,"Virginia","Suffolk city",1,41,1219,577,642
050,51,800,"Virginia","Suffolk city",1,42,1164,557,607
050,51,800,"Virginia","Suffolk city",1,43,1068,509,559
050,51,800,"Virginia","Suffolk city",1,44,1028,501,527
050,51,800,"Virginia","Suffolk city",1,45,1105,529,576
050,51,800,"Virginia","Suffolk city",1,46,1160,579,581
050,51,800,"Virginia","Suffolk city",1,47,1215,589,626
050,51,800,"Virginia","Suffolk city",1,48,1269,623,646
050,51,800,"Virginia","Suffolk city",1,49,1333,653,680
050,51,800,"Virginia","Suffolk city",1,50,1273,579,694
050,51,800,"Virginia","Suffolk city",1,51,1190,552,638
050,51,800,"Virginia","Suffolk city",1,52,1248,574,674
050,51,800,"Virginia","Suffolk city",1,53,1270,586,684
050,51,800,"Virginia","Suffolk city",1,54,1304,630,674
050,51,800,"Virginia","Suffolk city",1,55,1398,680,718
050,51,800,"Virginia","Suffolk city",1,56,1435,693,742
050,51,800,"Virginia","Suffolk city",1,57,1436,691,745
050,51,800,"Virginia","Suffolk city",1,58,1415,718,697
050,51,800,"Virginia","Suffolk city",1,59,1333,665,668
050,51,800,"Virginia","Suffolk city",1,60,1278,624,654
050,51,800,"Virginia","Suffolk city",1,61,1266,623,643
050,51,800,"Virginia","Suffolk city",1,62,1185,605,580
050,51,800,"Virginia","Suffolk city",1,63,1144,554,590
050,51,800,"Virginia","Suffolk city",1,64,1123,516,607
050,51,800,"Virginia","Suffolk city",1,65,1084,509,575
050,51,800,"Virginia","Suffolk city",1,66,997,476,521
050,51,800,"Virginia","Suffolk city",1,67,909,446,463
050,51,800,"Virginia","Suffolk city",1,68,862,400,462
050,51,800,"Virginia","Suffolk city",1,69,796,374,422
050,51,800,"Virginia","Suffolk city",1,70,818,392,426
050,51,800,"Virginia","Suffolk city",1,71,797,363,434
050,51,800,"Virginia","Suffolk city",1,72,817,387,430
050,51,800,"Virginia","Suffolk city",1,73,789,376,413
050,51,800,"Virginia","Suffolk city",1,74,575,252,323
050,51,800,"Virginia","Suffolk city",1,75,566,246,320
050,51,800,"Virginia","Suffolk city",1,76,546,249,297
050,51,800,"Virginia","Suffolk city",1,77,547,237,310
050,51,800,"Virginia","Suffolk city",1,78,475,214,261
050,51,800,"Virginia","Suffolk city",1,79,398,163,235
050,51,800,"Virginia","Suffolk city",1,80,370,157,213
050,51,800,"Virginia","Suffolk city",1,81,342,137,205
050,51,800,"Virginia","Suffolk city",1,82,305,126,179
050,51,800,"Virginia","Suffolk city",1,83,271,105,166
050,51,800,"Virginia","Suffolk city",1,84,243,93,150
050,51,800,"Virginia","Suffolk city",1,85,1391,456,935
050,51,800,"Virginia","Suffolk city",2,0,1120,567,553
050,51,800,"Virginia","Suffolk city",2,1,1177,597,580
050,51,800,"Virginia","Suffolk city",2,2,1207,623,584
050,51,800,"Virginia","Suffolk city",2,3,1196,612,584
050,51,800,"Virginia","Suffolk city",2,4,1249,637,612
050,51,800,"Virginia","Suffolk city",2,5,1303,659,644
050,51,800,"Virginia","Suffolk city",2,6,1252,649,603
050,51,800,"Virginia","Suffolk city",2,7,1228,634,594
050,51,800,"Virginia","Suffolk city",2,8,1259,651,608
050,51,800,"Virginia","Suffolk city",2,9,1258,651,607
050,51,800,"Virginia","Suffolk city",2,10,1235,644,591
050,51,800,"Virginia","Suffolk city",2,11,1246,657,589
050,51,800,"Virginia","Suffolk city",2,12,1352,686,666
050,51,800,"Virginia","Suffolk city",2,13,1368,690,678
050,51,800,"Virginia","Suffolk city",2,14,1301,677,624
050,51,800,"Virginia","Suffolk city",2,15,1280,661,619
050,51,800,"Virginia","Suffolk city",2,16,1281,645,636
050,51,800,"Virginia","Suffolk city",2,17,1241,624,617
050,51,800,"Virginia","Suffolk city",2,18,1051,547,504
050,51,800,"Virginia","Suffolk city",2,19,950,493,457
050,51,800,"Virginia","Suffolk city",2,20,1027,540,487
050,51,800,"Virginia","Suffolk city",2,21,1030,530,500
050,51,800,"Virginia","Suffolk city",2,22,1076,554,522
050,51,800,"Virginia","Suffolk city",2,23,1128,594,534
050,51,800,"Virginia","Suffolk city",2,24,1116,578,538
050,51,800,"Virginia","Suffolk city",2,25,1172,605,567
050,51,800,"Virginia","Suffolk city",2,26,1197,599,598
050,51,800,"Virginia","Suffolk city",2,27,1200,577,623
050,51,800,"Virginia","Suffolk city",2,28,1220,580,640
050,51,800,"Virginia","Suffolk city",2,29,1282,626,656
050,51,800,"Virginia","Suffolk city",2,30,1348,656,692
050,51,800,"Virginia","Suffolk city",2,31,1365,666,699
050,51,800,"Virginia","Suffolk city",2,32,1391,688,703
050,51,800,"Virginia","Suffolk city",2,33,1369,658,711
050,51,800,"Virginia","Suffolk city",2,34,1347,671,676
050,51,800,"Virginia","Suffolk city",2,35,1331,647,684
050,51,800,"Virginia","Suffolk city",2,36,1317,627,690
050,51,800,"Virginia","Suffolk city",2,37,1340,679,661
050,51,800,"Virginia","Suffolk city",2,38,1389,719,670
050,51,800,"Virginia","Suffolk city",2,39,1345,681,664
050,51,800,"Virginia","Suffolk city",2,40,1300,634,666
050,51,800,"Virginia","Suffolk city",2,41,1226,580,646
050,51,800,"Virginia","Suffolk city",2,42,1172,560,612
050,51,800,"Virginia","Suffolk city",2,43,1100,526,574
050,51,800,"Virginia","Suffolk city",2,44,1031,499,532
050,51,800,"Virginia","Suffolk city",2,45,1096,525,571
050,51,800,"Virginia","Suffolk city",2,46,1141,563,578
050,51,800,"Virginia","Suffolk city",2,47,1204,586,618
050,51,800,"Virginia","Suffolk city",2,48,1256,612,644
050,51,800,"Virginia","Suffolk city",2,49,1321,650,671
050,51,800,"Virginia","Suffolk city",2,50,1291,600,691
050,51,800,"Virginia","Suffolk city",2,51,1205,558,647
050,51,800,"Virginia","Suffolk city",2,52,1237,569,668
050,51,800,"Virginia","Suffolk city",2,53,1264,586,678
050,51,800,"Virginia","Suffolk city",2,54,1295,619,676
050,51,800,"Virginia","Suffolk city",2,55,1382,670,712
050,51,800,"Virginia","Suffolk city",2,56,1429,692,737
050,51,800,"Virginia","Suffolk city",2,57,1440,693,747
050,51,800,"Virginia","Suffolk city",2,58,1420,710,710
050,51,800,"Virginia","Suffolk city",2,59,1356,678,678
050,51,800,"Virginia","Suffolk city",2,60,1290,635,655
050,51,800,"Virginia","Suffolk city",2,61,1269,625,644
050,51,800,"Virginia","Suffolk city",2,62,1204,606,598
050,51,800,"Virginia","Suffolk city",2,63,1156,565,591
050,51,800,"Virginia","Suffolk city",2,64,1119,520,599
050,51,800,"Virginia","Suffolk city",2,65,1089,512,577
050,51,800,"Virginia","Suffolk city",2,66,1014,481,533
050,51,800,"Virginia","Suffolk city",2,67,923,450,473
050,51,800,"Virginia","Suffolk city",2,68,865,407,458
050,51,800,"Virginia","Suffolk city",2,69,816,381,435
050,51,800,"Virginia","Suffolk city",2,70,811,387,424
050,51,800,"Virginia","Suffolk city",2,71,793,367,426
050,51,800,"Virginia","Suffolk city",2,72,797,376,421
050,51,800,"Virginia","Suffolk city",2,73,821,389,432
050,51,800,"Virginia","Suffolk city",2,74,589,265,324
050,51,800,"Virginia","Suffolk city",2,75,570,247,323
050,51,800,"Virginia","Suffolk city",2,76,546,244,302
050,51,800,"Virginia","Suffolk city",2,77,553,241,312
050,51,800,"Virginia","Suffolk city",2,78,486,218,268
050,51,800,"Virginia","Suffolk city",2,79,411,174,237
050,51,800,"Virginia","Suffolk city",2,80,375,159,216
050,51,800,"Virginia","Suffolk city",2,81,341,136,205
050,51,800,"Virginia","Suffolk city",2,82,313,128,185
050,51,800,"Virginia","Suffolk city",2,83,273,106,167
050,51,800,"Virginia","Suffolk city",2,84,240,91,149
050,51,800,"Virginia","Suffolk city",2,85,1376,456,920
050,51,800,"Virginia","Suffolk city",3,0,1139,577,562
050,51,800,"Virginia","Suffolk city",3,1,1158,562,596
050,51,800,"Virginia","Suffolk city",3,2,1249,642,607
050,51,800,"Virginia","Suffolk city",3,3,1263,642,621
050,51,800,"Virginia","Suffolk city",3,4,1242,630,612
050,51,800,"Virginia","Suffolk city",3,5,1271,654,617
050,51,800,"Virginia","Suffolk city",3,6,1287,655,632
050,51,800,"Virginia","Suffolk city",3,7,1278,664,614
050,51,800,"Virginia","Suffolk city",3,8,1231,626,605
050,51,800,"Virginia","Suffolk city",3,9,1241,651,590
050,51,800,"Virginia","Suffolk city",3,10,1259,655,604
050,51,800,"Virginia","Suffolk city",3,11,1257,630,627
050,51,800,"Virginia","Suffolk city",3,12,1279,673,606
050,51,800,"Virginia","Suffolk city",3,13,1347,690,657
050,51,800,"Virginia","Suffolk city",3,14,1387,710,677
050,51,800,"Virginia","Suffolk city",3,15,1308,671,637
050,51,800,"Virginia","Suffolk city",3,16,1267,657,610
050,51,800,"Virginia","Suffolk city",3,17,1266,617,649
050,51,800,"Virginia","Suffolk city",3,18,1092,578,514
050,51,800,"Virginia","Suffolk city",3,19,927,488,439
050,51,800,"Virginia","Suffolk city",3,20,1038,525,513
050,51,800,"Virginia","Suffolk city",3,21,1065,557,508
050,51,800,"Virginia","Suffolk city",3,22,1142,585,557
050,51,800,"Virginia","Suffolk city",3,23,1154,599,555
050,51,800,"Virginia","Suffolk city",3,24,1172,608,564
050,51,800,"Virginia","Suffolk city",3,25,1149,599,550
050,51,800,"Virginia","Suffolk city",3,26,1188,612,576
050,51,800,"Virginia","Suffolk city",3,27,1272,631,641
050,51,800,"Virginia","Suffolk city",3,28,1239,607,632
050,51,800,"Virginia","Suffolk city",3,29,1307,650,657
050,51,800,"Virginia","Suffolk city",3,30,1349,656,693
050,51,800,"Virginia","Suffolk city",3,31,1389,666,723
050,51,800,"Virginia","Suffolk city",3,32,1433,713,720
050,51,800,"Virginia","Suffolk city",3,33,1485,717,768
050,51,800,"Virginia","Suffolk city",3,34,1369,665,704
050,51,800,"Virginia","Suffolk city",3,35,1425,718,707
050,51,800,"Virginia","Suffolk city",3,36,1347,670,677
050,51,800,"Virginia","Suffolk city",3,37,1355,659,696
050,51,800,"Virginia","Suffolk city",3,38,1366,685,681
050,51,800,"Virginia","Suffolk city",3,39,1419,724,695
050,51,800,"Virginia","Suffolk city",3,40,1323,675,648
050,51,800,"Virginia","Suffolk city",3,41,1295,630,665
050,51,800,"Virginia","Suffolk city",3,42,1243,590,653
050,51,800,"Virginia","Suffolk city",3,43,1188,573,615
050,51,800,"Virginia","Suffolk city",3,44,1122,529,593
050,51,800,"Virginia","Suffolk city",3,45,1058,513,545
050,51,800,"Virginia","Suffolk city",3,46,1083,527,556
050,51,800,"Virginia","Suffolk city",3,47,1137,571,566
050,51,800,"Virginia","Suffolk city",3,48,1210,583,627
050,51,800,"Virginia","Suffolk city",3,49,1241,608,633
050,51,800,"Virginia","Suffolk city",3,50,1320,639,681
050,51,800,"Virginia","Suffolk city",3,51,1288,600,688
050,51,800,"Virginia","Suffolk city",3,52,1204,542,662
050,51,800,"Virginia","Suffolk city",3,53,1248,581,667
050,51,800,"Virginia","Suffolk city",3,54,1266,586,680
050,51,800,"Virginia","Suffolk city",3,55,1302,629,673
050,51,800,"Virginia","Suffolk city",3,56,1384,678,706
050,51,800,"Virginia","Suffolk city",3,57,1432,701,731
050,51,800,"Virginia","Suffolk city",3,58,1415,685,730
050,51,800,"Virginia","Suffolk city",3,59,1403,684,719
050,51,800,"Virginia","Suffolk city",3,60,1338,659,679
050,51,800,"Virginia","Suffolk city",3,61,1321,641,680
050,51,800,"Virginia","Suffolk city",3,62,1268,618,650
050,51,800,"Virginia","Suffolk city",3,63,1207,606,601
050,51,800,"Virginia","Suffolk city",3,64,1159,554,605
050,51,800,"Virginia","Suffolk city",3,65,1130,525,605
050,51,800,"Virginia","Suffolk city",3,66,1054,491,563
050,51,800,"Virginia","Suffolk city",3,67,991,463,528
050,51,800,"Virginia","Suffolk city",3,68,913,440,473
050,51,800,"Virginia","Suffolk city",3,69,848,399,449
050,51,800,"Virginia","Suffolk city",3,70,811,379,432
050,51,800,"Virginia","Suffolk city",3,71,793,369,424
050,51,800,"Virginia","Suffolk city",3,72,762,354,408
050,51,800,"Virginia","Suffolk city",3,73,765,357,408
050,51,800,"Virginia","Suffolk city",3,74,782,373,409
050,51,800,"Virginia","Suffolk city",3,75,573,248,325
050,51,800,"Virginia","Suffolk city",3,76,551,239,312
050,51,800,"Virginia","Suffolk city",3,77,515,230,285
050,51,800,"Virginia","Suffolk city",3,78,537,232,305
050,51,800,"Virginia","Suffolk city",3,79,463,199,264
050,51,800,"Virginia","Suffolk city",3,80,384,159,225
050,51,800,"Virginia","Suffolk city",3,81,359,151,208
050,51,800,"Virginia","Suffolk city",3,82,325,133,192
050,51,800,"Virginia","Suffolk city",3,83,295,107,188
050,51,800,"Virginia","Suffolk city",3,84,246,97,149
050,51,800,"Virginia","Suffolk city",3,85,1374,458,916
050,51,800,"Virginia","Suffolk city",4,0,1129,585,544
050,51,800,"Virginia","Suffolk city",4,1,1212,599,613
050,51,800,"Virginia","Suffolk city",4,2,1221,601,620
050,51,800,"Virginia","Suffolk city",4,3,1290,658,632
050,51,800,"Virginia","Suffolk city",4,4,1262,633,629
050,51,800,"Virginia","Suffolk city",4,5,1257,636,621
050,51,800,"Virginia","Suffolk city",4,6,1305,666,639
050,51,800,"Virginia","Suffolk city",4,7,1342,694,648
050,51,800,"Virginia","Suffolk city",4,8,1324,688,636
050,51,800,"Virginia","Suffolk city",4,9,1269,646,623
050,51,800,"Virginia","Suffolk city",4,10,1271,670,601
050,51,800,"Virginia","Suffolk city",4,11,1308,675,633
050,51,800,"Virginia","Suffolk city",4,12,1300,654,646
050,51,800,"Virginia","Suffolk city",4,13,1331,679,652
050,51,800,"Virginia","Suffolk city",4,14,1374,712,662
050,51,800,"Virginia","Suffolk city",4,15,1415,718,697
050,51,800,"Virginia","Suffolk city",4,16,1313,660,653
050,51,800,"Virginia","Suffolk city",4,17,1309,686,623
050,51,800,"Virginia","Suffolk city",4,18,1134,578,556
050,51,800,"Virginia","Suffolk city",4,19,928,499,429
050,51,800,"Virginia","Suffolk city",4,20,970,516,454
050,51,800,"Virginia","Suffolk city",4,21,1099,554,545
050,51,800,"Virginia","Suffolk city",4,22,1085,548,537
050,51,800,"Virginia","Suffolk city",4,23,1174,599,575
050,51,800,"Virginia","Suffolk city",4,24,1178,599,579
050,51,800,"Virginia","Suffolk city",4,25,1228,647,581
050,51,800,"Virginia","Suffolk city",4,26,1151,593,558
050,51,800,"Virginia","Suffolk city",4,27,1181,605,576
050,51,800,"Virginia","Suffolk city",4,28,1269,617,652
050,51,800,"Virginia","Suffolk city",4,29,1359,660,699
050,51,800,"Virginia","Suffolk city",4,30,1399,664,735
050,51,800,"Virginia","Suffolk city",4,31,1415,690,725
050,51,800,"Virginia","Suffolk city",4,32,1493,704,789
050,51,800,"Virginia","Suffolk city",4,33,1527,752,775
050,51,800,"Virginia","Suffolk city",4,34,1538,773,765
050,51,800,"Virginia","Suffolk city",4,35,1476,711,765
050,51,800,"Virginia","Suffolk city",4,36,1475,742,733
050,51,800,"Virginia","Suffolk city",4,37,1390,703,687
050,51,800,"Virginia","Suffolk city",4,38,1424,696,728
050,51,800,"Virginia","Suffolk city",4,39,1373,690,683
050,51,800,"Virginia","Suffolk city",4,40,1410,733,677
050,51,800,"Virginia","Suffolk city",4,41,1372,700,672
050,51,800,"Virginia","Suffolk city",4,42,1356,660,696
050,51,800,"Virginia","Suffolk city",4,43,1235,597,638
050,51,800,"Virginia","Suffolk city",4,44,1225,571,654
050,51,800,"Virginia","Suffolk city",4,45,1127,522,605
050,51,800,"Virginia","Suffolk city",4,46,1072,520,552
050,51,800,"Virginia","Suffolk city",4,47,1105,550,555
050,51,800,"Virginia","Suffolk city",4,48,1150,580,570
050,51,800,"Virginia","Suffolk city",4,49,1204,563,641
050,51,800,"Virginia","Suffolk city",4,50,1283,604,679
050,51,800,"Virginia","Suffolk city",4,51,1312,633,679
050,51,800,"Virginia","Suffolk city",4,52,1314,612,702
050,51,800,"Virginia","Suffolk city",4,53,1215,545,670
050,51,800,"Virginia","Suffolk city",4,54,1263,597,666
050,51,800,"Virginia","Suffolk city",4,55,1279,588,691
050,51,800,"Virginia","Suffolk city",4,56,1291,621,670
050,51,800,"Virginia","Suffolk city",4,57,1394,677,717
050,51,800,"Virginia","Suffolk city",4,58,1440,708,732
050,51,800,"Virginia","Suffolk city",4,59,1401,663,738
050,51,800,"Virginia","Suffolk city",4,60,1377,671,706
050,51,800,"Virginia","Suffolk city",4,61,1335,651,684
050,51,800,"Virginia","Suffolk city",4,62,1282,628,654
050,51,800,"Virginia","Suffolk city",4,63,1258,593,665
050,51,800,"Virginia","Suffolk city",4,64,1213,608,605
050,51,800,"Virginia","Suffolk city",4,65,1146,545,601
050,51,800,"Virginia","Suffolk city",4,66,1112,511,601
050,51,800,"Virginia","Suffolk city",4,67,1050,490,560
050,51,800,"Virginia","Suffolk city",4,68,1004,464,540
050,51,800,"Virginia","Suffolk city",4,69,899,442,457
050,51,800,"Virginia","Suffolk city",4,70,831,381,450
050,51,800,"Virginia","Suffolk city",4,71,784,365,419
050,51,800,"Virginia","Suffolk city",4,72,780,363,417
050,51,800,"Virginia","Suffolk city",4,73,731,331,400
050,51,800,"Virginia","Suffolk city",4,74,738,342,396
050,51,800,"Virginia","Suffolk city",4,75,768,356,412
050,51,800,"Virginia","Suffolk city",4,76,559,237,322
050,51,800,"Virginia","Suffolk city",4,77,525,222,303
050,51,800,"Virginia","Suffolk city",4,78,501,222,279
050,51,800,"Virginia","Suffolk city",4,79,502,209,293
050,51,800,"Virginia","Suffolk city",4,80,420,183,237
050,51,800,"Virginia","Suffolk city",4,81,358,143,215
050,51,800,"Virginia","Suffolk city",4,82,336,147,189
050,51,800,"Virginia","Suffolk city",4,83,297,112,185
050,51,800,"Virginia","Suffolk city",4,84,278,106,172
050,51,800,"Virginia","Suffolk city",4,85,1396,475,921
050,51,800,"Virginia","Suffolk city",5,0,1125,586,539
050,51,800,"Virginia","Suffolk city",5,1,1183,626,557
050,51,800,"Virginia","Suffolk city",5,2,1254,627,627
050,51,800,"Virginia","Suffolk city",5,3,1283,649,634
050,51,800,"Virginia","Suffolk city",5,4,1313,670,643
050,51,800,"Virginia","Suffolk city",5,5,1310,671,639
050,51,800,"Virginia","Suffolk city",5,6,1311,658,653
050,51,800,"Virginia","Suffolk city",5,7,1372,698,674
050,51,800,"Virginia","Suffolk city",5,8,1317,682,635
050,51,800,"Virginia","Suffolk city",5,9,1341,701,640
050,51,800,"Virginia","Suffolk city",5,10,1305,639,666
050,51,800,"Virginia","Suffolk city",5,11,1301,684,617
050,51,800,"Virginia","Suffolk city",5,12,1375,699,676
050,51,800,"Virginia","Suffolk city",5,13,1320,673,647
050,51,800,"Virginia","Suffolk city",5,14,1354,692,662
050,51,800,"Virginia","Suffolk city",5,15,1371,701,670
050,51,800,"Virginia","Suffolk city",5,16,1415,695,720
050,51,800,"Virginia","Suffolk city",5,17,1332,683,649
050,51,800,"Virginia","Suffolk city",5,18,1140,611,529
050,51,800,"Virginia","Suffolk city",5,19,954,488,466
050,51,800,"Virginia","Suffolk city",5,20,1051,568,483
050,51,800,"Virginia","Suffolk city",5,21,1037,543,494
050,51,800,"Virginia","Suffolk city",5,22,1170,564,606
050,51,800,"Virginia","Suffolk city",5,23,1246,629,617
050,51,800,"Virginia","Suffolk city",5,24,1201,596,605
050,51,800,"Virginia","Suffolk city",5,25,1216,628,588
050,51,800,"Virginia","Suffolk city",5,26,1245,647,598
050,51,800,"Virginia","Suffolk city",5,27,1218,621,597
050,51,800,"Virginia","Suffolk city",5,28,1243,635,608
050,51,800,"Virginia","Suffolk city",5,29,1351,664,687
050,51,800,"Virginia","Suffolk city",5,30,1426,675,751
050,51,800,"Virginia","Suffolk city",5,31,1453,664,789
050,51,800,"Virginia","Suffolk city",5,32,1437,722,715
050,51,800,"Virginia","Suffolk city",5,33,1604,747,857
050,51,800,"Virginia","Suffolk city",5,34,1575,762,813
050,51,800,"Virginia","Suffolk city",5,35,1627,811,816
050,51,800,"Virginia","Suffolk city",5,36,1521,731,790
050,51,800,"Virginia","Suffolk city",5,37,1513,769,744
050,51,800,"Virginia","Suffolk city",5,38,1434,720,714
050,51,800,"Virginia","Suffolk city",5,39,1460,715,745
050,51,800,"Virginia","Suffolk city",5,40,1378,693,685
050,51,800,"Virginia","Suffolk city",5,41,1407,720,687
050,51,800,"Virginia","Suffolk city",5,42,1388,696,692
050,51,800,"Virginia","Suffolk city",5,43,1348,661,687
050,51,800,"Virginia","Suffolk city",5,44,1262,610,652
050,51,800,"Virginia","Suffolk city",5,45,1241,573,668
050,51,800,"Virginia","Suffolk city",5,46,1132,517,615
050,51,800,"Virginia","Suffolk city",5,47,1098,534,564
050,51,800,"Virginia","Suffolk city",5,48,1133,557,576
050,51,800,"Virginia","Suffolk city",5,49,1175,568,607
050,51,800,"Virginia","Suffolk city",5,50,1207,561,646
050,51,800,"Virginia","Suffolk city",5,51,1305,616,689
050,51,800,"Virginia","Suffolk city",5,52,1337,620,717
050,51,800,"Virginia","Suffolk city",5,53,1331,629,702
050,51,800,"Virginia","Suffolk city",5,54,1216,553,663
050,51,800,"Virginia","Suffolk city",5,55,1272,605,667
050,51,800,"Virginia","Suffolk city",5,56,1269,596,673
050,51,800,"Virginia","Suffolk city",5,57,1298,619,679
050,51,800,"Virginia","Suffolk city",5,58,1412,687,725
050,51,800,"Virginia","Suffolk city",5,59,1418,706,712
050,51,800,"Virginia","Suffolk city",5,60,1394,660,734
050,51,800,"Virginia","Suffolk city",5,61,1373,670,703
050,51,800,"Virginia","Suffolk city",5,62,1298,633,665
050,51,800,"Virginia","Suffolk city",5,63,1297,628,669
050,51,800,"Virginia","Suffolk city",5,64,1267,593,674
050,51,800,"Virginia","Suffolk city",5,65,1203,592,611
050,51,800,"Virginia","Suffolk city",5,66,1130,529,601
050,51,800,"Virginia","Suffolk city",5,67,1099,499,600
050,51,800,"Virginia","Suffolk city",5,68,1058,492,566
050,51,800,"Virginia","Suffolk city",5,69,981,456,525
050,51,800,"Virginia","Suffolk city",5,70,887,429,458
050,51,800,"Virginia","Suffolk city",5,71,808,362,446
050,51,800,"Virginia","Suffolk city",5,72,783,363,420
050,51,800,"Virginia","Suffolk city",5,73,748,344,404
050,51,800,"Virginia","Suffolk city",5,74,727,319,408
050,51,800,"Virginia","Suffolk city",5,75,728,329,399
050,51,800,"Virginia","Suffolk city",5,76,755,347,408
050,51,800,"Virginia","Suffolk city",5,77,534,227,307
050,51,800,"Virginia","Suffolk city",5,78,513,216,297
050,51,800,"Virginia","Suffolk city",5,79,477,209,268
050,51,800,"Virginia","Suffolk city",5,80,472,201,271
050,51,800,"Virginia","Suffolk city",5,81,394,169,225
050,51,800,"Virginia","Suffolk city",5,82,343,139,204
050,51,800,"Virginia","Suffolk city",5,83,317,130,187
050,51,800,"Virginia","Suffolk city",5,84,289,114,175
050,51,800,"Virginia","Suffolk city",5,85,1453,497,956
050,51,810,"Virginia","Virginia Beach city",1,0,5516,2808,2708
050,51,810,"Virginia","Virginia Beach city",1,1,5492,2795,2697
050,51,810,"Virginia","Virginia Beach city",1,2,5634,2901,2733
050,51,810,"Virginia","Virginia Beach city",1,3,5735,2942,2793
050,51,810,"Virginia","Virginia Beach city",1,4,5756,2966,2790
050,51,810,"Virginia","Virginia Beach city",1,5,5800,3001,2799
050,51,810,"Virginia","Virginia Beach city",1,6,5702,2918,2784
050,51,810,"Virginia","Virginia Beach city",1,7,5641,2935,2706
050,51,810,"Virginia","Virginia Beach city",1,8,5720,2982,2738
050,51,810,"Virginia","Virginia Beach city",1,9,5719,3003,2716
050,51,810,"Virginia","Virginia Beach city",1,10,5733,2939,2794
050,51,810,"Virginia","Virginia Beach city",1,11,5762,2930,2832
050,51,810,"Virginia","Virginia Beach city",1,12,5939,3040,2899
050,51,810,"Virginia","Virginia Beach city",1,13,5892,3050,2842
050,51,810,"Virginia","Virginia Beach city",1,14,5816,2975,2841
050,51,810,"Virginia","Virginia Beach city",1,15,5743,2914,2829
050,51,810,"Virginia","Virginia Beach city",1,16,5716,2841,2875
050,51,810,"Virginia","Virginia Beach city",1,17,5515,2819,2696
050,51,810,"Virginia","Virginia Beach city",1,18,5030,2614,2416
050,51,810,"Virginia","Virginia Beach city",1,19,4847,2681,2166
050,51,810,"Virginia","Virginia Beach city",1,20,5286,2952,2334
050,51,810,"Virginia","Virginia Beach city",1,21,5528,2969,2559
050,51,810,"Virginia","Virginia Beach city",1,22,5798,3018,2780
050,51,810,"Virginia","Virginia Beach city",1,23,6215,3192,3023
050,51,810,"Virginia","Virginia Beach city",1,24,6557,3379,3178
050,51,810,"Virginia","Virginia Beach city",1,25,6856,3528,3328
050,51,810,"Virginia","Virginia Beach city",1,26,7368,3801,3567
050,51,810,"Virginia","Virginia Beach city",1,27,7546,3844,3702
050,51,810,"Virginia","Virginia Beach city",1,28,7419,3774,3645
050,51,810,"Virginia","Virginia Beach city",1,29,7564,3856,3708
050,51,810,"Virginia","Virginia Beach city",1,30,7498,3779,3719
050,51,810,"Virginia","Virginia Beach city",1,31,7428,3699,3729
050,51,810,"Virginia","Virginia Beach city",1,32,7468,3774,3694
050,51,810,"Virginia","Virginia Beach city",1,33,7358,3774,3584
050,51,810,"Virginia","Virginia Beach city",1,34,7288,3774,3514
050,51,810,"Virginia","Virginia Beach city",1,35,7126,3573,3553
050,51,810,"Virginia","Virginia Beach city",1,36,6978,3493,3485
050,51,810,"Virginia","Virginia Beach city",1,37,7012,3557,3455
050,51,810,"Virginia","Virginia Beach city",1,38,6781,3399,3382
050,51,810,"Virginia","Virginia Beach city",1,39,6581,3285,3296
050,51,810,"Virginia","Virginia Beach city",1,40,6276,3081,3195
050,51,810,"Virginia","Virginia Beach city",1,41,5943,2957,2986
050,51,810,"Virginia","Virginia Beach city",1,42,5780,2885,2895
050,51,810,"Virginia","Virginia Beach city",1,43,5625,2854,2771
050,51,810,"Virginia","Virginia Beach city",1,44,5276,2592,2684
050,51,810,"Virginia","Virginia Beach city",1,45,5170,2569,2601
050,51,810,"Virginia","Virginia Beach city",1,46,5193,2539,2654
050,51,810,"Virginia","Virginia Beach city",1,47,5259,2534,2725
050,51,810,"Virginia","Virginia Beach city",1,48,5502,2697,2805
050,51,810,"Virginia","Virginia Beach city",1,49,5727,2731,2996
050,51,810,"Virginia","Virginia Beach city",1,50,5651,2692,2959
050,51,810,"Virginia","Virginia Beach city",1,51,5526,2591,2935
050,51,810,"Virginia","Virginia Beach city",1,52,5450,2596,2854
050,51,810,"Virginia","Virginia Beach city",1,53,5566,2670,2896
050,51,810,"Virginia","Virginia Beach city",1,54,5695,2734,2961
050,51,810,"Virginia","Virginia Beach city",1,55,5936,2793,3143
050,51,810,"Virginia","Virginia Beach city",1,56,6198,2956,3242
050,51,810,"Virginia","Virginia Beach city",1,57,6114,2873,3241
050,51,810,"Virginia","Virginia Beach city",1,58,6251,2985,3266
050,51,810,"Virginia","Virginia Beach city",1,59,6118,2915,3203
050,51,810,"Virginia","Virginia Beach city",1,60,5828,2801,3027
050,51,810,"Virginia","Virginia Beach city",1,61,5691,2708,2983
050,51,810,"Virginia","Virginia Beach city",1,62,5527,2604,2923
050,51,810,"Virginia","Virginia Beach city",1,63,5284,2460,2824
050,51,810,"Virginia","Virginia Beach city",1,64,5103,2402,2701
050,51,810,"Virginia","Virginia Beach city",1,65,4913,2241,2672
050,51,810,"Virginia","Virginia Beach city",1,66,4684,2162,2522
050,51,810,"Virginia","Virginia Beach city",1,67,4532,2096,2436
050,51,810,"Virginia","Virginia Beach city",1,68,4332,1976,2356
050,51,810,"Virginia","Virginia Beach city",1,69,4044,1807,2237
050,51,810,"Virginia","Virginia Beach city",1,70,3901,1714,2187
050,51,810,"Virginia","Virginia Beach city",1,71,3914,1750,2164
050,51,810,"Virginia","Virginia Beach city",1,72,3876,1733,2143
050,51,810,"Virginia","Virginia Beach city",1,73,3791,1724,2067
050,51,810,"Virginia","Virginia Beach city",1,74,2722,1232,1490
050,51,810,"Virginia","Virginia Beach city",1,75,2682,1184,1498
050,51,810,"Virginia","Virginia Beach city",1,76,2644,1141,1503
050,51,810,"Virginia","Virginia Beach city",1,77,2558,1089,1469
050,51,810,"Virginia","Virginia Beach city",1,78,2161,897,1264
050,51,810,"Virginia","Virginia Beach city",1,79,1919,815,1104
050,51,810,"Virginia","Virginia Beach city",1,80,1780,763,1017
050,51,810,"Virginia","Virginia Beach city",1,81,1653,714,939
050,51,810,"Virginia","Virginia Beach city",1,82,1489,626,863
050,51,810,"Virginia","Virginia Beach city",1,83,1344,571,773
050,51,810,"Virginia","Virginia Beach city",1,84,1233,490,743
050,51,810,"Virginia","Virginia Beach city",1,85,7252,2530,4722
050,51,810,"Virginia","Virginia Beach city",2,0,5471,2781,2690
050,51,810,"Virginia","Virginia Beach city",2,1,5476,2790,2686
050,51,810,"Virginia","Virginia Beach city",2,2,5599,2874,2725
050,51,810,"Virginia","Virginia Beach city",2,3,5684,2912,2772
050,51,810,"Virginia","Virginia Beach city",2,4,5757,2967,2790
050,51,810,"Virginia","Virginia Beach city",2,5,5792,2990,2802
050,51,810,"Virginia","Virginia Beach city",2,6,5739,2942,2797
050,51,810,"Virginia","Virginia Beach city",2,7,5643,2926,2717
050,51,810,"Virginia","Virginia Beach city",2,8,5683,2967,2716
050,51,810,"Virginia","Virginia Beach city",2,9,5709,2989,2720
050,51,810,"Virginia","Virginia Beach city",2,10,5721,2946,2775
050,51,810,"Virginia","Virginia Beach city",2,11,5740,2918,2822
050,51,810,"Virginia","Virginia Beach city",2,12,5923,3024,2899
050,51,810,"Virginia","Virginia Beach city",2,13,5896,3041,2855
050,51,810,"Virginia","Virginia Beach city",2,14,5822,2988,2834
050,51,810,"Virginia","Virginia Beach city",2,15,5753,2918,2835
050,51,810,"Virginia","Virginia Beach city",2,16,5719,2862,2857
050,51,810,"Virginia","Virginia Beach city",2,17,5567,2827,2740
050,51,810,"Virginia","Virginia Beach city",2,18,5020,2608,2412
050,51,810,"Virginia","Virginia Beach city",2,19,4865,2688,2177
050,51,810,"Virginia","Virginia Beach city",2,20,5317,2949,2368
050,51,810,"Virginia","Virginia Beach city",2,21,5532,2981,2551
050,51,810,"Virginia","Virginia Beach city",2,22,5809,3027,2782
050,51,810,"Virginia","Virginia Beach city",2,23,6181,3169,3012
050,51,810,"Virginia","Virginia Beach city",2,24,6481,3335,3146
050,51,810,"Virginia","Virginia Beach city",2,25,6829,3516,3313
050,51,810,"Virginia","Virginia Beach city",2,26,7287,3756,3531
050,51,810,"Virginia","Virginia Beach city",2,27,7467,3804,3663
050,51,810,"Virginia","Virginia Beach city",2,28,7445,3795,3650
050,51,810,"Virginia","Virginia Beach city",2,29,7517,3826,3691
050,51,810,"Virginia","Virginia Beach city",2,30,7540,3803,3737
050,51,810,"Virginia","Virginia Beach city",2,31,7441,3718,3723
050,51,810,"Virginia","Virginia Beach city",2,32,7432,3737,3695
050,51,810,"Virginia","Virginia Beach city",2,33,7383,3785,3598
050,51,810,"Virginia","Virginia Beach city",2,34,7267,3748,3519
050,51,810,"Virginia","Virginia Beach city",2,35,7181,3628,3553
050,51,810,"Virginia","Virginia Beach city",2,36,6940,3473,3467
050,51,810,"Virginia","Virginia Beach city",2,37,7000,3537,3463
050,51,810,"Virginia","Virginia Beach city",2,38,6830,3426,3404
050,51,810,"Virginia","Virginia Beach city",2,39,6581,3278,3303
050,51,810,"Virginia","Virginia Beach city",2,40,6367,3130,3237
050,51,810,"Virginia","Virginia Beach city",2,41,6012,2985,3027
050,51,810,"Virginia","Virginia Beach city",2,42,5770,2879,2891
050,51,810,"Virginia","Virginia Beach city",2,43,5690,2874,2816
050,51,810,"Virginia","Virginia Beach city",2,44,5266,2603,2663
050,51,810,"Virginia","Virginia Beach city",2,45,5200,2573,2627
050,51,810,"Virginia","Virginia Beach city",2,46,5162,2540,2622
050,51,810,"Virginia","Virginia Beach city",2,47,5186,2496,2690
050,51,810,"Virginia","Virginia Beach city",2,48,5441,2655,2786
050,51,810,"Virginia","Virginia Beach city",2,49,5685,2728,2957
050,51,810,"Virginia","Virginia Beach city",2,50,5682,2712,2970
050,51,810,"Virginia","Virginia Beach city",2,51,5498,2580,2918
050,51,810,"Virginia","Virginia Beach city",2,52,5449,2580,2869
050,51,810,"Virginia","Virginia Beach city",2,53,5540,2657,2883
050,51,810,"Virginia","Virginia Beach city",2,54,5657,2719,2938
050,51,810,"Virginia","Virginia Beach city",2,55,5859,2765,3094
050,51,810,"Virginia","Virginia Beach city",2,56,6136,2918,3218
050,51,810,"Virginia","Virginia Beach city",2,57,6124,2881,3243
050,51,810,"Virginia","Virginia Beach city",2,58,6199,2948,3251
050,51,810,"Virginia","Virginia Beach city",2,59,6156,2936,3220
050,51,810,"Virginia","Virginia Beach city",2,60,5885,2822,3063
050,51,810,"Virginia","Virginia Beach city",2,61,5698,2717,2981
050,51,810,"Virginia","Virginia Beach city",2,62,5543,2616,2927
050,51,810,"Virginia","Virginia Beach city",2,63,5369,2509,2860
050,51,810,"Virginia","Virginia Beach city",2,64,5116,2399,2717
050,51,810,"Virginia","Virginia Beach city",2,65,4930,2263,2667
050,51,810,"Virginia","Virginia Beach city",2,66,4735,2178,2557
050,51,810,"Virginia","Virginia Beach city",2,67,4538,2095,2443
050,51,810,"Virginia","Virginia Beach city",2,68,4345,1982,2363
050,51,810,"Virginia","Virginia Beach city",2,69,4134,1851,2283
050,51,810,"Virginia","Virginia Beach city",2,70,3916,1725,2191
050,51,810,"Virginia","Virginia Beach city",2,71,3901,1733,2168
050,51,810,"Virginia","Virginia Beach city",2,72,3812,1696,2116
050,51,810,"Virginia","Virginia Beach city",2,73,3948,1784,2164
050,51,810,"Virginia","Virginia Beach city",2,74,2812,1271,1541
050,51,810,"Virginia","Virginia Beach city",2,75,2679,1187,1492
050,51,810,"Virginia","Virginia Beach city",2,76,2617,1134,1483
050,51,810,"Virginia","Virginia Beach city",2,77,2614,1110,1504
050,51,810,"Virginia","Virginia Beach city",2,78,2189,918,1271
050,51,810,"Virginia","Virginia Beach city",2,79,1941,819,1122
050,51,810,"Virginia","Virginia Beach city",2,80,1799,769,1030
050,51,810,"Virginia","Virginia Beach city",2,81,1652,708,944
050,51,810,"Virginia","Virginia Beach city",2,82,1509,630,879
050,51,810,"Virginia","Virginia Beach city",2,83,1354,575,779
050,51,810,"Virginia","Virginia Beach city",2,84,1229,502,727
050,51,810,"Virginia","Virginia Beach city",2,85,7301,2550,4751
050,51,810,"Virginia","Virginia Beach city",3,0,5259,2748,2511
050,51,810,"Virginia","Virginia Beach city",3,1,5348,2694,2654
050,51,810,"Virginia","Virginia Beach city",3,2,5407,2770,2637
050,51,810,"Virginia","Virginia Beach city",3,3,5590,2890,2700
050,51,810,"Virginia","Virginia Beach city",3,4,5649,2902,2747
050,51,810,"Virginia","Virginia Beach city",3,5,5800,2983,2817
050,51,810,"Virginia","Virginia Beach city",3,6,5710,2918,2792
050,51,810,"Virginia","Virginia Beach city",3,7,5710,2925,2785
050,51,810,"Virginia","Virginia Beach city",3,8,5572,2898,2674
050,51,810,"Virginia","Virginia Beach city",3,9,5621,2905,2716
050,51,810,"Virginia","Virginia Beach city",3,10,5667,2944,2723
050,51,810,"Virginia","Virginia Beach city",3,11,5686,2932,2754
050,51,810,"Virginia","Virginia Beach city",3,12,5717,2916,2801
050,51,810,"Virginia","Virginia Beach city",3,13,5874,3017,2857
050,51,810,"Virginia","Virginia Beach city",3,14,5803,2996,2807
050,51,810,"Virginia","Virginia Beach city",3,15,5774,2930,2844
050,51,810,"Virginia","Virginia Beach city",3,16,5717,2892,2825
050,51,810,"Virginia","Virginia Beach city",3,17,5676,2827,2849
050,51,810,"Virginia","Virginia Beach city",3,18,4985,2563,2422
050,51,810,"Virginia","Virginia Beach city",3,19,4689,2561,2128
050,51,810,"Virginia","Virginia Beach city",3,20,5295,2907,2388
050,51,810,"Virginia","Virginia Beach city",3,21,5648,3061,2587
050,51,810,"Virginia","Virginia Beach city",3,22,5804,3063,2741
050,51,810,"Virginia","Virginia Beach city",3,23,6159,3156,3003
050,51,810,"Virginia","Virginia Beach city",3,24,6303,3202,3101
050,51,810,"Virginia","Virginia Beach city",3,25,6720,3475,3245
050,51,810,"Virginia","Virginia Beach city",3,26,6916,3575,3341
050,51,810,"Virginia","Virginia Beach city",3,27,7255,3731,3524
050,51,810,"Virginia","Virginia Beach city",3,28,7361,3742,3619
050,51,810,"Virginia","Virginia Beach city",3,29,7342,3755,3587
050,51,810,"Virginia","Virginia Beach city",3,30,7408,3739,3669
050,51,810,"Virginia","Virginia Beach city",3,31,7334,3682,3652
050,51,810,"Virginia","Virginia Beach city",3,32,7324,3584,3740
050,51,810,"Virginia","Virginia Beach city",3,33,7294,3668,3626
050,51,810,"Virginia","Virginia Beach city",3,34,7240,3685,3555
050,51,810,"Virginia","Virginia Beach city",3,35,7143,3647,3496
050,51,810,"Virginia","Virginia Beach city",3,36,7081,3580,3501
050,51,810,"Virginia","Virginia Beach city",3,37,6884,3447,3437
050,51,810,"Virginia","Virginia Beach city",3,38,6882,3434,3448
050,51,810,"Virginia","Virginia Beach city",3,39,6655,3304,3351
050,51,810,"Virginia","Virginia Beach city",3,40,6520,3230,3290
050,51,810,"Virginia","Virginia Beach city",3,41,6280,3121,3159
050,51,810,"Virginia","Virginia Beach city",3,42,5895,2903,2992
050,51,810,"Virginia","Virginia Beach city",3,43,5720,2872,2848
050,51,810,"Virginia","Virginia Beach city",3,44,5538,2790,2748
050,51,810,"Virginia","Virginia Beach city",3,45,5221,2568,2653
050,51,810,"Virginia","Virginia Beach city",3,46,5164,2588,2576
050,51,810,"Virginia","Virginia Beach city",3,47,4977,2406,2571
050,51,810,"Virginia","Virginia Beach city",3,48,5140,2482,2658
050,51,810,"Virginia","Virginia Beach city",3,49,5346,2613,2733
050,51,810,"Virginia","Virginia Beach city",3,50,5662,2745,2917
050,51,810,"Virginia","Virginia Beach city",3,51,5571,2631,2940
050,51,810,"Virginia","Virginia Beach city",3,52,5432,2538,2894
050,51,810,"Virginia","Virginia Beach city",3,53,5428,2588,2840
050,51,810,"Virginia","Virginia Beach city",3,54,5479,2629,2850
050,51,810,"Virginia","Virginia Beach city",3,55,5523,2623,2900
050,51,810,"Virginia","Virginia Beach city",3,56,5852,2766,3086
050,51,810,"Virginia","Virginia Beach city",3,57,5998,2855,3143
050,51,810,"Virginia","Virginia Beach city",3,58,6048,2839,3209
050,51,810,"Virginia","Virginia Beach city",3,59,6110,2897,3213
050,51,810,"Virginia","Virginia Beach city",3,60,6094,2900,3194
050,51,810,"Virginia","Virginia Beach city",3,61,5791,2758,3033
050,51,810,"Virginia","Virginia Beach city",3,62,5614,2657,2957
050,51,810,"Virginia","Virginia Beach city",3,63,5456,2550,2906
050,51,810,"Virginia","Virginia Beach city",3,64,5308,2485,2823
050,51,810,"Virginia","Virginia Beach city",3,65,5037,2357,2680
050,51,810,"Virginia","Virginia Beach city",3,66,4859,2223,2636
050,51,810,"Virginia","Virginia Beach city",3,67,4671,2142,2529
050,51,810,"Virginia","Virginia Beach city",3,68,4421,2020,2401
050,51,810,"Virginia","Virginia Beach city",3,69,4242,1918,2324
050,51,810,"Virginia","Virginia Beach city",3,70,4064,1814,2250
050,51,810,"Virginia","Virginia Beach city",3,71,3850,1688,2162
050,51,810,"Virginia","Virginia Beach city",3,72,3829,1690,2139
050,51,810,"Virginia","Virginia Beach city",3,73,3729,1654,2075
050,51,810,"Virginia","Virginia Beach city",3,74,3855,1743,2112
050,51,810,"Virginia","Virginia Beach city",3,75,2716,1213,1503
050,51,810,"Virginia","Virginia Beach city",3,76,2583,1129,1454
050,51,810,"Virginia","Virginia Beach city",3,77,2511,1070,1441
050,51,810,"Virginia","Virginia Beach city",3,78,2513,1061,1452
050,51,810,"Virginia","Virginia Beach city",3,79,2070,857,1213
050,51,810,"Virginia","Virginia Beach city",3,80,1841,765,1076
050,51,810,"Virginia","Virginia Beach city",3,81,1705,721,984
050,51,810,"Virginia","Virginia Beach city",3,82,1569,655,914
050,51,810,"Virginia","Virginia Beach city",3,83,1402,586,816
050,51,810,"Virginia","Virginia Beach city",3,84,1264,526,738
050,51,810,"Virginia","Virginia Beach city",3,85,7369,2605,4764
050,51,810,"Virginia","Virginia Beach city",4,0,5337,2776,2561
050,51,810,"Virginia","Virginia Beach city",4,1,5234,2753,2481
050,51,810,"Virginia","Virginia Beach city",4,2,5138,2600,2538
050,51,810,"Virginia","Virginia Beach city",4,3,5315,2768,2547
050,51,810,"Virginia","Virginia Beach city",4,4,5526,2860,2666
050,51,810,"Virginia","Virginia Beach city",4,5,5520,2830,2690
050,51,810,"Virginia","Virginia Beach city",4,6,5720,2956,2764
050,51,810,"Virginia","Virginia Beach city",4,7,5697,2891,2806
050,51,810,"Virginia","Virginia Beach city",4,8,5637,2903,2734
050,51,810,"Virginia","Virginia Beach city",4,9,5529,2840,2689
050,51,810,"Virginia","Virginia Beach city",4,10,5519,2854,2665
050,51,810,"Virginia","Virginia Beach city",4,11,5530,2879,2651
050,51,810,"Virginia","Virginia Beach city",4,12,5545,2877,2668
050,51,810,"Virginia","Virginia Beach city",4,13,5598,2851,2747
050,51,810,"Virginia","Virginia Beach city",4,14,5818,2994,2824
050,51,810,"Virginia","Virginia Beach city",4,15,5733,2972,2761
050,51,810,"Virginia","Virginia Beach city",4,16,5713,2895,2818
050,51,810,"Virginia","Virginia Beach city",4,17,5631,2835,2796
050,51,810,"Virginia","Virginia Beach city",4,18,5025,2550,2475
050,51,810,"Virginia","Virginia Beach city",4,19,4523,2452,2071
050,51,810,"Virginia","Virginia Beach city",4,20,4988,2695,2293
050,51,810,"Virginia","Virginia Beach city",4,21,5628,2999,2629
050,51,810,"Virginia","Virginia Beach city",4,22,5745,3057,2688
050,51,810,"Virginia","Virginia Beach city",4,23,5984,3116,2868
050,51,810,"Virginia","Virginia Beach city",4,24,6208,3180,3028
050,51,810,"Virginia","Virginia Beach city",4,25,6387,3226,3161
050,51,810,"Virginia","Virginia Beach city",4,26,6652,3432,3220
050,51,810,"Virginia","Virginia Beach city",4,27,6840,3505,3335
050,51,810,"Virginia","Virginia Beach city",4,28,7067,3619,3448
050,51,810,"Virginia","Virginia Beach city",4,29,7138,3616,3522
050,51,810,"Virginia","Virginia Beach city",4,30,7116,3630,3486
050,51,810,"Virginia","Virginia Beach city",4,31,7267,3691,3576
050,51,810,"Virginia","Virginia Beach city",4,32,7328,3640,3688
050,51,810,"Virginia","Virginia Beach city",4,33,7185,3553,3632
050,51,810,"Virginia","Virginia Beach city",4,34,7103,3567,3536
050,51,810,"Virginia","Virginia Beach city",4,35,7101,3612,3489
050,51,810,"Virginia","Virginia Beach city",4,36,6958,3509,3449
050,51,810,"Virginia","Virginia Beach city",4,37,6979,3544,3435
050,51,810,"Virginia","Virginia Beach city",4,38,6703,3341,3362
050,51,810,"Virginia","Virginia Beach city",4,39,6746,3334,3412
050,51,810,"Virginia","Virginia Beach city",4,40,6493,3176,3317
050,51,810,"Virginia","Virginia Beach city",4,41,6459,3231,3228
050,51,810,"Virginia","Virginia Beach city",4,42,6159,3024,3135
050,51,810,"Virginia","Virginia Beach city",4,43,5808,2905,2903
050,51,810,"Virginia","Virginia Beach city",4,44,5573,2780,2793
050,51,810,"Virginia","Virginia Beach city",4,45,5545,2805,2740
050,51,810,"Virginia","Virginia Beach city",4,46,5162,2562,2600
050,51,810,"Virginia","Virginia Beach city",4,47,4999,2463,2536
050,51,810,"Virginia","Virginia Beach city",4,48,4923,2383,2540
050,51,810,"Virginia","Virginia Beach city",4,49,5058,2431,2627
050,51,810,"Virginia","Virginia Beach city",4,50,5256,2588,2668
050,51,810,"Virginia","Virginia Beach city",4,51,5546,2648,2898
050,51,810,"Virginia","Virginia Beach city",4,52,5424,2552,2872
050,51,810,"Virginia","Virginia Beach city",4,53,5419,2551,2868
050,51,810,"Virginia","Virginia Beach city",4,54,5348,2533,2815
050,51,810,"Virginia","Virginia Beach city",4,55,5375,2547,2828
050,51,810,"Virginia","Virginia Beach city",4,56,5467,2573,2894
050,51,810,"Virginia","Virginia Beach city",4,57,5746,2725,3021
050,51,810,"Virginia","Virginia Beach city",4,58,5946,2821,3125
050,51,810,"Virginia","Virginia Beach city",4,59,6007,2825,3182
050,51,810,"Virginia","Virginia Beach city",4,60,6010,2844,3166
050,51,810,"Virginia","Virginia Beach city",4,61,6011,2855,3156
050,51,810,"Virginia","Virginia Beach city",4,62,5677,2683,2994
050,51,810,"Virginia","Virginia Beach city",4,63,5489,2583,2906
050,51,810,"Virginia","Virginia Beach city",4,64,5368,2506,2862
050,51,810,"Virginia","Virginia Beach city",4,65,5224,2427,2797
050,51,810,"Virginia","Virginia Beach city",4,66,4968,2314,2654
050,51,810,"Virginia","Virginia Beach city",4,67,4789,2206,2583
050,51,810,"Virginia","Virginia Beach city",4,68,4566,2090,2476
050,51,810,"Virginia","Virginia Beach city",4,69,4357,1980,2377
050,51,810,"Virginia","Virginia Beach city",4,70,4152,1878,2274
050,51,810,"Virginia","Virginia Beach city",4,71,3981,1774,2207
050,51,810,"Virginia","Virginia Beach city",4,72,3770,1641,2129
050,51,810,"Virginia","Virginia Beach city",4,73,3733,1658,2075
050,51,810,"Virginia","Virginia Beach city",4,74,3677,1620,2057
050,51,810,"Virginia","Virginia Beach city",4,75,3726,1663,2063
050,51,810,"Virginia","Virginia Beach city",4,76,2623,1158,1465
050,51,810,"Virginia","Virginia Beach city",4,77,2490,1083,1407
050,51,810,"Virginia","Virginia Beach city",4,78,2452,1045,1407
050,51,810,"Virginia","Virginia Beach city",4,79,2433,1015,1418
050,51,810,"Virginia","Virginia Beach city",4,80,1989,805,1184
050,51,810,"Virginia","Virginia Beach city",4,81,1752,713,1039
050,51,810,"Virginia","Virginia Beach city",4,82,1577,649,928
050,51,810,"Virginia","Virginia Beach city",4,83,1460,609,851
050,51,810,"Virginia","Virginia Beach city",4,84,1297,524,773
050,51,810,"Virginia","Virginia Beach city",4,85,7374,2654,4720
050,51,810,"Virginia","Virginia Beach city",5,0,5309,2754,2555
050,51,810,"Virginia","Virginia Beach city",5,1,5194,2750,2444
050,51,810,"Virginia","Virginia Beach city",5,2,5108,2702,2406
050,51,810,"Virginia","Virginia Beach city",5,3,5028,2523,2505
050,51,810,"Virginia","Virginia Beach city",5,4,5304,2752,2552
050,51,810,"Virginia","Virginia Beach city",5,5,5436,2854,2582
050,51,810,"Virginia","Virginia Beach city",5,6,5432,2800,2632
050,51,810,"Virginia","Virginia Beach city",5,7,5662,2917,2745
050,51,810,"Virginia","Virginia Beach city",5,8,5579,2803,2776
050,51,810,"Virginia","Virginia Beach city",5,9,5597,2889,2708
050,51,810,"Virginia","Virginia Beach city",5,10,5497,2842,2655
050,51,810,"Virginia","Virginia Beach city",5,11,5497,2839,2658
050,51,810,"Virginia","Virginia Beach city",5,12,5514,2843,2671
050,51,810,"Virginia","Virginia Beach city",5,13,5574,2883,2691
050,51,810,"Virginia","Virginia Beach city",5,14,5524,2795,2729
050,51,810,"Virginia","Virginia Beach city",5,15,5799,2960,2839
050,51,810,"Virginia","Virginia Beach city",5,16,5656,2917,2739
050,51,810,"Virginia","Virginia Beach city",5,17,5723,2871,2852
050,51,810,"Virginia","Virginia Beach city",5,18,4945,2545,2400
050,51,810,"Virginia","Virginia Beach city",5,19,4604,2472,2132
050,51,810,"Virginia","Virginia Beach city",5,20,4935,2666,2269
050,51,810,"Virginia","Virginia Beach city",5,21,5448,2889,2559
050,51,810,"Virginia","Virginia Beach city",5,22,5894,3097,2797
050,51,810,"Virginia","Virginia Beach city",5,23,5906,3123,2783
050,51,810,"Virginia","Virginia Beach city",5,24,6114,3116,2998
050,51,810,"Virginia","Virginia Beach city",5,25,6260,3166,3094
050,51,810,"Virginia","Virginia Beach city",5,26,6340,3278,3062
050,51,810,"Virginia","Virginia Beach city",5,27,6549,3322,3227
050,51,810,"Virginia","Virginia Beach city",5,28,6752,3480,3272
050,51,810,"Virginia","Virginia Beach city",5,29,6884,3491,3393
050,51,810,"Virginia","Virginia Beach city",5,30,6919,3495,3424
050,51,810,"Virginia","Virginia Beach city",5,31,6916,3487,3429
050,51,810,"Virginia","Virginia Beach city",5,32,7120,3567,3553
050,51,810,"Virginia","Virginia Beach city",5,33,7341,3656,3685
050,51,810,"Virginia","Virginia Beach city",5,34,7044,3448,3596
050,51,810,"Virginia","Virginia Beach city",5,35,7012,3490,3522
050,51,810,"Virginia","Virginia Beach city",5,36,7001,3530,3471
050,51,810,"Virginia","Virginia Beach city",5,37,6840,3438,3402
050,51,810,"Virginia","Virginia Beach city",5,38,6854,3450,3404
050,51,810,"Virginia","Virginia Beach city",5,39,6550,3271,3279
050,51,810,"Virginia","Virginia Beach city",5,40,6684,3281,3403
050,51,810,"Virginia","Virginia Beach city",5,41,6445,3182,3263
050,51,810,"Virginia","Virginia Beach city",5,42,6327,3135,3192
050,51,810,"Virginia","Virginia Beach city",5,43,6158,3019,3139
050,51,810,"Virginia","Virginia Beach city",5,44,5640,2750,2890
050,51,810,"Virginia","Virginia Beach city",5,45,5537,2758,2779
050,51,810,"Virginia","Virginia Beach city",5,46,5561,2825,2736
050,51,810,"Virginia","Virginia Beach city",5,47,5073,2463,2610
050,51,810,"Virginia","Virginia Beach city",5,48,4967,2445,2522
050,51,810,"Virginia","Virginia Beach city",5,49,4900,2373,2527
050,51,810,"Virginia","Virginia Beach city",5,50,4976,2399,2577
050,51,810,"Virginia","Virginia Beach city",5,51,5211,2524,2687
050,51,810,"Virginia","Virginia Beach city",5,52,5469,2594,2875
050,51,810,"Virginia","Virginia Beach city",5,53,5419,2570,2849
050,51,810,"Virginia","Virginia Beach city",5,54,5388,2537,2851
050,51,810,"Virginia","Virginia Beach city",5,55,5272,2477,2795
050,51,810,"Virginia","Virginia Beach city",5,56,5326,2526,2800
050,51,810,"Virginia","Virginia Beach city",5,57,5366,2518,2848
050,51,810,"Virginia","Virginia Beach city",5,58,5670,2687,2983
050,51,810,"Virginia","Virginia Beach city",5,59,5878,2801,3077
050,51,810,"Virginia","Virginia Beach city",5,60,5954,2806,3148
050,51,810,"Virginia","Virginia Beach city",5,61,5951,2810,3141
050,51,810,"Virginia","Virginia Beach city",5,62,5871,2769,3102
050,51,810,"Virginia","Virginia Beach city",5,63,5575,2638,2937
050,51,810,"Virginia","Virginia Beach city",5,64,5459,2566,2893
050,51,810,"Virginia","Virginia Beach city",5,65,5288,2467,2821
050,51,810,"Virginia","Virginia Beach city",5,66,5175,2381,2794
050,51,810,"Virginia","Virginia Beach city",5,67,4936,2288,2648
050,51,810,"Virginia","Virginia Beach city",5,68,4715,2140,2575
050,51,810,"Virginia","Virginia Beach city",5,69,4506,2059,2447
050,51,810,"Virginia","Virginia Beach city",5,70,4283,1945,2338
050,51,810,"Virginia","Virginia Beach city",5,71,4096,1853,2243
050,51,810,"Virginia","Virginia Beach city",5,72,3871,1723,2148
050,51,810,"Virginia","Virginia Beach city",5,73,3677,1601,2076
050,51,810,"Virginia","Virginia Beach city",5,74,3666,1627,2039
050,51,810,"Virginia","Virginia Beach city",5,75,3569,1568,2001
050,51,810,"Virginia","Virginia Beach city",5,76,3628,1613,2015
050,51,810,"Virginia","Virginia Beach city",5,77,2514,1096,1418
050,51,810,"Virginia","Virginia Beach city",5,78,2432,1067,1365
050,51,810,"Virginia","Virginia Beach city",5,79,2351,988,1363
050,51,810,"Virginia","Virginia Beach city",5,80,2337,961,1376
050,51,810,"Virginia","Virginia Beach city",5,81,1897,760,1137
050,51,810,"Virginia","Virginia Beach city",5,82,1646,656,990
050,51,810,"Virginia","Virginia Beach city",5,83,1473,611,862
050,51,810,"Virginia","Virginia Beach city",5,84,1363,559,804
050,51,810,"Virginia","Virginia Beach city",5,85,7488,2731,4757
050,51,820,"Virginia","Waynesboro city",1,0,283,142,141
050,51,820,"Virginia","Waynesboro city",1,1,277,129,148
050,51,820,"Virginia","Waynesboro city",1,2,273,130,143
050,51,820,"Virginia","Waynesboro city",1,3,286,145,141
050,51,820,"Virginia","Waynesboro city",1,4,322,156,166
050,51,820,"Virginia","Waynesboro city",1,5,260,129,131
050,51,820,"Virginia","Waynesboro city",1,6,291,166,125
050,51,820,"Virginia","Waynesboro city",1,7,263,135,128
050,51,820,"Virginia","Waynesboro city",1,8,266,139,127
050,51,820,"Virginia","Waynesboro city",1,9,290,153,137
050,51,820,"Virginia","Waynesboro city",1,10,303,165,138
050,51,820,"Virginia","Waynesboro city",1,11,300,163,137
050,51,820,"Virginia","Waynesboro city",1,12,314,166,148
050,51,820,"Virginia","Waynesboro city",1,13,310,158,152
050,51,820,"Virginia","Waynesboro city",1,14,295,141,154
050,51,820,"Virginia","Waynesboro city",1,15,289,146,143
050,51,820,"Virginia","Waynesboro city",1,16,281,137,144
050,51,820,"Virginia","Waynesboro city",1,17,251,129,122
050,51,820,"Virginia","Waynesboro city",1,18,222,111,111
050,51,820,"Virginia","Waynesboro city",1,19,192,100,92
050,51,820,"Virginia","Waynesboro city",1,20,198,108,90
050,51,820,"Virginia","Waynesboro city",1,21,219,104,115
050,51,820,"Virginia","Waynesboro city",1,22,246,99,147
050,51,820,"Virginia","Waynesboro city",1,23,268,117,151
050,51,820,"Virginia","Waynesboro city",1,24,270,117,153
050,51,820,"Virginia","Waynesboro city",1,25,281,138,143
050,51,820,"Virginia","Waynesboro city",1,26,296,146,150
050,51,820,"Virginia","Waynesboro city",1,27,319,161,158
050,51,820,"Virginia","Waynesboro city",1,28,334,165,169
050,51,820,"Virginia","Waynesboro city",1,29,322,161,161
050,51,820,"Virginia","Waynesboro city",1,30,324,155,169
050,51,820,"Virginia","Waynesboro city",1,31,278,138,140
050,51,820,"Virginia","Waynesboro city",1,32,287,147,140
050,51,820,"Virginia","Waynesboro city",1,33,277,142,135
050,51,820,"Virginia","Waynesboro city",1,34,312,163,149
050,51,820,"Virginia","Waynesboro city",1,35,323,168,155
050,51,820,"Virginia","Waynesboro city",1,36,321,168,153
050,51,820,"Virginia","Waynesboro city",1,37,328,158,170
050,51,820,"Virginia","Waynesboro city",1,38,309,157,152
050,51,820,"Virginia","Waynesboro city",1,39,296,128,168
050,51,820,"Virginia","Waynesboro city",1,40,291,123,168
050,51,820,"Virginia","Waynesboro city",1,41,286,124,162
050,51,820,"Virginia","Waynesboro city",1,42,264,123,141
050,51,820,"Virginia","Waynesboro city",1,43,269,134,135
050,51,820,"Virginia","Waynesboro city",1,44,276,140,136
050,51,820,"Virginia","Waynesboro city",1,45,257,123,134
050,51,820,"Virginia","Waynesboro city",1,46,229,122,107
050,51,820,"Virginia","Waynesboro city",1,47,241,125,116
050,51,820,"Virginia","Waynesboro city",1,48,276,142,134
050,51,820,"Virginia","Waynesboro city",1,49,261,126,135
050,51,820,"Virginia","Waynesboro city",1,50,246,111,135
050,51,820,"Virginia","Waynesboro city",1,51,243,124,119
050,51,820,"Virginia","Waynesboro city",1,52,243,122,121
050,51,820,"Virginia","Waynesboro city",1,53,253,116,137
050,51,820,"Virginia","Waynesboro city",1,54,266,134,132
050,51,820,"Virginia","Waynesboro city",1,55,282,144,138
050,51,820,"Virginia","Waynesboro city",1,56,313,149,164
050,51,820,"Virginia","Waynesboro city",1,57,312,151,161
050,51,820,"Virginia","Waynesboro city",1,58,313,148,165
050,51,820,"Virginia","Waynesboro city",1,59,301,142,159
050,51,820,"Virginia","Waynesboro city",1,60,291,129,162
050,51,820,"Virginia","Waynesboro city",1,61,298,137,161
050,51,820,"Virginia","Waynesboro city",1,62,300,142,158
050,51,820,"Virginia","Waynesboro city",1,63,269,130,139
050,51,820,"Virginia","Waynesboro city",1,64,253,119,134
050,51,820,"Virginia","Waynesboro city",1,65,258,116,142
050,51,820,"Virginia","Waynesboro city",1,66,246,108,138
050,51,820,"Virginia","Waynesboro city",1,67,235,110,125
050,51,820,"Virginia","Waynesboro city",1,68,235,110,125
050,51,820,"Virginia","Waynesboro city",1,69,214,90,124
050,51,820,"Virginia","Waynesboro city",1,70,222,94,128
050,51,820,"Virginia","Waynesboro city",1,71,224,106,118
050,51,820,"Virginia","Waynesboro city",1,72,216,105,111
050,51,820,"Virginia","Waynesboro city",1,73,230,98,132
050,51,820,"Virginia","Waynesboro city",1,74,152,55,97
050,51,820,"Virginia","Waynesboro city",1,75,153,55,98
050,51,820,"Virginia","Waynesboro city",1,76,156,67,89
050,51,820,"Virginia","Waynesboro city",1,77,156,66,90
050,51,820,"Virginia","Waynesboro city",1,78,135,62,73
050,51,820,"Virginia","Waynesboro city",1,79,140,61,79
050,51,820,"Virginia","Waynesboro city",1,80,127,48,79
050,51,820,"Virginia","Waynesboro city",1,81,119,48,71
050,51,820,"Virginia","Waynesboro city",1,82,103,45,58
050,51,820,"Virginia","Waynesboro city",1,83,92,41,51
050,51,820,"Virginia","Waynesboro city",1,84,75,27,48
050,51,820,"Virginia","Waynesboro city",1,85,499,175,324
050,51,820,"Virginia","Waynesboro city",2,0,293,156,137
050,51,820,"Virginia","Waynesboro city",2,1,278,132,146
050,51,820,"Virginia","Waynesboro city",2,2,277,132,145
050,51,820,"Virginia","Waynesboro city",2,3,283,141,142
050,51,820,"Virginia","Waynesboro city",2,4,310,150,160
050,51,820,"Virginia","Waynesboro city",2,5,273,136,137
050,51,820,"Virginia","Waynesboro city",2,6,287,158,129
050,51,820,"Virginia","Waynesboro city",2,7,267,141,126
050,51,820,"Virginia","Waynesboro city",2,8,262,135,127
050,51,820,"Virginia","Waynesboro city",2,9,283,149,134
050,51,820,"Virginia","Waynesboro city",2,10,301,163,138
050,51,820,"Virginia","Waynesboro city",2,11,300,161,139
050,51,820,"Virginia","Waynesboro city",2,12,311,165,146
050,51,820,"Virginia","Waynesboro city",2,13,307,158,149
050,51,820,"Virginia","Waynesboro city",2,14,297,143,154
050,51,820,"Virginia","Waynesboro city",2,15,291,146,145
050,51,820,"Virginia","Waynesboro city",2,16,281,139,142
050,51,820,"Virginia","Waynesboro city",2,17,261,131,130
050,51,820,"Virginia","Waynesboro city",2,18,220,112,108
050,51,820,"Virginia","Waynesboro city",2,19,194,100,94
050,51,820,"Virginia","Waynesboro city",2,20,206,112,94
050,51,820,"Virginia","Waynesboro city",2,21,218,108,110
050,51,820,"Virginia","Waynesboro city",2,22,248,104,144
050,51,820,"Virginia","Waynesboro city",2,23,271,116,155
050,51,820,"Virginia","Waynesboro city",2,24,269,117,152
050,51,820,"Virginia","Waynesboro city",2,25,283,136,147
050,51,820,"Virginia","Waynesboro city",2,26,301,148,153
050,51,820,"Virginia","Waynesboro city",2,27,320,162,158
050,51,820,"Virginia","Waynesboro city",2,28,330,167,163
050,51,820,"Virginia","Waynesboro city",2,29,333,166,167
050,51,820,"Virginia","Waynesboro city",2,30,325,159,166
050,51,820,"Virginia","Waynesboro city",2,31,287,142,145
050,51,820,"Virginia","Waynesboro city",2,32,282,144,138
050,51,820,"Virginia","Waynesboro city",2,33,278,143,135
050,51,820,"Virginia","Waynesboro city",2,34,303,157,146
050,51,820,"Virginia","Waynesboro city",2,35,321,167,154
050,51,820,"Virginia","Waynesboro city",2,36,318,165,153
050,51,820,"Virginia","Waynesboro city",2,37,326,161,165
050,51,820,"Virginia","Waynesboro city",2,38,312,156,156
050,51,820,"Virginia","Waynesboro city",2,39,300,134,166
050,51,820,"Virginia","Waynesboro city",2,40,298,126,172
050,51,820,"Virginia","Waynesboro city",2,41,287,125,162
050,51,820,"Virginia","Waynesboro city",2,42,268,121,147
050,51,820,"Virginia","Waynesboro city",2,43,268,132,136
050,51,820,"Virginia","Waynesboro city",2,44,271,137,134
050,51,820,"Virginia","Waynesboro city",2,45,265,130,135
050,51,820,"Virginia","Waynesboro city",2,46,236,122,114
050,51,820,"Virginia","Waynesboro city",2,47,240,126,114
050,51,820,"Virginia","Waynesboro city",2,48,266,137,129
050,51,820,"Virginia","Waynesboro city",2,49,265,130,135
050,51,820,"Virginia","Waynesboro city",2,50,252,116,136
050,51,820,"Virginia","Waynesboro city",2,51,246,120,126
050,51,820,"Virginia","Waynesboro city",2,52,241,122,119
050,51,820,"Virginia","Waynesboro city",2,53,251,118,133
050,51,820,"Virginia","Waynesboro city",2,54,264,131,133
050,51,820,"Virginia","Waynesboro city",2,55,283,143,140
050,51,820,"Virginia","Waynesboro city",2,56,308,148,160
050,51,820,"Virginia","Waynesboro city",2,57,313,149,164
050,51,820,"Virginia","Waynesboro city",2,58,311,146,165
050,51,820,"Virginia","Waynesboro city",2,59,303,142,161
050,51,820,"Virginia","Waynesboro city",2,60,295,133,162
050,51,820,"Virginia","Waynesboro city",2,61,294,135,159
050,51,820,"Virginia","Waynesboro city",2,62,298,140,158
050,51,820,"Virginia","Waynesboro city",2,63,277,133,144
050,51,820,"Virginia","Waynesboro city",2,64,253,120,133
050,51,820,"Virginia","Waynesboro city",2,65,260,119,141
050,51,820,"Virginia","Waynesboro city",2,66,249,110,139
050,51,820,"Virginia","Waynesboro city",2,67,235,107,128
050,51,820,"Virginia","Waynesboro city",2,68,233,109,124
050,51,820,"Virginia","Waynesboro city",2,69,225,98,127
050,51,820,"Virginia","Waynesboro city",2,70,219,93,126
050,51,820,"Virginia","Waynesboro city",2,71,221,103,118
050,51,820,"Virginia","Waynesboro city",2,72,218,105,113
050,51,820,"Virginia","Waynesboro city",2,73,235,105,130
050,51,820,"Virginia","Waynesboro city",2,74,160,61,99
050,51,820,"Virginia","Waynesboro city",2,75,152,55,97
050,51,820,"Virginia","Waynesboro city",2,76,156,65,91
050,51,820,"Virginia","Waynesboro city",2,77,161,69,92
050,51,820,"Virginia","Waynesboro city",2,78,134,61,73
050,51,820,"Virginia","Waynesboro city",2,79,138,62,76
050,51,820,"Virginia","Waynesboro city",2,80,129,50,79
050,51,820,"Virginia","Waynesboro city",2,81,119,47,72
050,51,820,"Virginia","Waynesboro city",2,82,105,45,60
050,51,820,"Virginia","Waynesboro city",2,83,94,42,52
050,51,820,"Virginia","Waynesboro city",2,84,78,30,48
050,51,820,"Virginia","Waynesboro city",2,85,498,172,326
050,51,820,"Virginia","Waynesboro city",3,0,361,199,162
050,51,820,"Virginia","Waynesboro city",3,1,296,167,129
050,51,820,"Virginia","Waynesboro city",3,2,293,137,156
050,51,820,"Virginia","Waynesboro city",3,3,255,119,136
050,51,820,"Virginia","Waynesboro city",3,4,301,147,154
050,51,820,"Virginia","Waynesboro city",3,5,307,147,160
050,51,820,"Virginia","Waynesboro city",3,6,284,128,156
050,51,820,"Virginia","Waynesboro city",3,7,283,155,128
050,51,820,"Virginia","Waynesboro city",3,8,257,135,122
050,51,820,"Virginia","Waynesboro city",3,9,271,132,139
050,51,820,"Virginia","Waynesboro city",3,10,273,142,131
050,51,820,"Virginia","Waynesboro city",3,11,287,148,139
050,51,820,"Virginia","Waynesboro city",3,12,286,156,130
050,51,820,"Virginia","Waynesboro city",3,13,309,165,144
050,51,820,"Virginia","Waynesboro city",3,14,302,148,154
050,51,820,"Virginia","Waynesboro city",3,15,287,138,149
050,51,820,"Virginia","Waynesboro city",3,16,288,148,140
050,51,820,"Virginia","Waynesboro city",3,17,289,139,150
050,51,820,"Virginia","Waynesboro city",3,18,227,118,109
050,51,820,"Virginia","Waynesboro city",3,19,179,94,85
050,51,820,"Virginia","Waynesboro city",3,20,218,109,109
050,51,820,"Virginia","Waynesboro city",3,21,233,122,111
050,51,820,"Virginia","Waynesboro city",3,22,250,120,130
050,51,820,"Virginia","Waynesboro city",3,23,274,116,158
050,51,820,"Virginia","Waynesboro city",3,24,265,115,150
050,51,820,"Virginia","Waynesboro city",3,25,265,114,151
050,51,820,"Virginia","Waynesboro city",3,26,314,151,163
050,51,820,"Virginia","Waynesboro city",3,27,299,150,149
050,51,820,"Virginia","Waynesboro city",3,28,319,156,163
050,51,820,"Virginia","Waynesboro city",3,29,359,189,170
050,51,820,"Virginia","Waynesboro city",3,30,334,165,169
050,51,820,"Virginia","Waynesboro city",3,31,333,164,169
050,51,820,"Virginia","Waynesboro city",3,32,301,152,149
050,51,820,"Virginia","Waynesboro city",3,33,289,141,148
050,51,820,"Virginia","Waynesboro city",3,34,290,148,142
050,51,820,"Virginia","Waynesboro city",3,35,313,172,141
050,51,820,"Virginia","Waynesboro city",3,36,305,160,145
050,51,820,"Virginia","Waynesboro city",3,37,323,163,160
050,51,820,"Virginia","Waynesboro city",3,38,325,158,167
050,51,820,"Virginia","Waynesboro city",3,39,312,159,153
050,51,820,"Virginia","Waynesboro city",3,40,308,135,173
050,51,820,"Virginia","Waynesboro city",3,41,313,147,166
050,51,820,"Virginia","Waynesboro city",3,42,295,126,169
050,51,820,"Virginia","Waynesboro city",3,43,260,118,142
050,51,820,"Virginia","Waynesboro city",3,44,273,139,134
050,51,820,"Virginia","Waynesboro city",3,45,279,140,139
050,51,820,"Virginia","Waynesboro city",3,46,257,124,133
050,51,820,"Virginia","Waynesboro city",3,47,236,118,118
050,51,820,"Virginia","Waynesboro city",3,48,247,124,123
050,51,820,"Virginia","Waynesboro city",3,49,278,146,132
050,51,820,"Virginia","Waynesboro city",3,50,261,127,134
050,51,820,"Virginia","Waynesboro city",3,51,251,114,137
050,51,820,"Virginia","Waynesboro city",3,52,254,121,133
050,51,820,"Virginia","Waynesboro city",3,53,237,122,115
050,51,820,"Virginia","Waynesboro city",3,54,264,124,140
050,51,820,"Virginia","Waynesboro city",3,55,259,128,131
050,51,820,"Virginia","Waynesboro city",3,56,274,134,140
050,51,820,"Virginia","Waynesboro city",3,57,311,146,165
050,51,820,"Virginia","Waynesboro city",3,58,309,156,153
050,51,820,"Virginia","Waynesboro city",3,59,307,142,165
050,51,820,"Virginia","Waynesboro city",3,60,305,144,161
050,51,820,"Virginia","Waynesboro city",3,61,304,141,163
050,51,820,"Virginia","Waynesboro city",3,62,307,145,162
050,51,820,"Virginia","Waynesboro city",3,63,299,139,160
050,51,820,"Virginia","Waynesboro city",3,64,295,135,160
050,51,820,"Virginia","Waynesboro city",3,65,260,116,144
050,51,820,"Virginia","Waynesboro city",3,66,252,123,129
050,51,820,"Virginia","Waynesboro city",3,67,240,99,141
050,51,820,"Virginia","Waynesboro city",3,68,227,104,123
050,51,820,"Virginia","Waynesboro city",3,69,234,109,125
050,51,820,"Virginia","Waynesboro city",3,70,208,85,123
050,51,820,"Virginia","Waynesboro city",3,71,214,91,123
050,51,820,"Virginia","Waynesboro city",3,72,223,101,122
050,51,820,"Virginia","Waynesboro city",3,73,212,101,111
050,51,820,"Virginia","Waynesboro city",3,74,233,106,127
050,51,820,"Virginia","Waynesboro city",3,75,150,60,90
050,51,820,"Virginia","Waynesboro city",3,76,151,57,94
050,51,820,"Virginia","Waynesboro city",3,77,149,55,94
050,51,820,"Virginia","Waynesboro city",3,78,145,62,83
050,51,820,"Virginia","Waynesboro city",3,79,136,62,74
050,51,820,"Virginia","Waynesboro city",3,80,133,58,75
050,51,820,"Virginia","Waynesboro city",3,81,116,46,70
050,51,820,"Virginia","Waynesboro city",3,82,112,44,68
050,51,820,"Virginia","Waynesboro city",3,83,93,42,51
050,51,820,"Virginia","Waynesboro city",3,84,84,35,49
050,51,820,"Virginia","Waynesboro city",3,85,495,169,326
050,51,820,"Virginia","Waynesboro city",4,0,353,191,162
050,51,820,"Virginia","Waynesboro city",4,1,358,191,167
050,51,820,"Virginia","Waynesboro city",4,2,287,165,122
050,51,820,"Virginia","Waynesboro city",4,3,279,133,146
050,51,820,"Virginia","Waynesboro city",4,4,249,124,125
050,51,820,"Virginia","Waynesboro city",4,5,295,147,148
050,51,820,"Virginia","Waynesboro city",4,6,317,155,162
050,51,820,"Virginia","Waynesboro city",4,7,281,130,151
050,51,820,"Virginia","Waynesboro city",4,8,294,155,139
050,51,820,"Virginia","Waynesboro city",4,9,257,137,120
050,51,820,"Virginia","Waynesboro city",4,10,273,132,141
050,51,820,"Virginia","Waynesboro city",4,11,276,142,134
050,51,820,"Virginia","Waynesboro city",4,12,283,151,132
050,51,820,"Virginia","Waynesboro city",4,13,302,164,138
050,51,820,"Virginia","Waynesboro city",4,14,304,160,144
050,51,820,"Virginia","Waynesboro city",4,15,301,147,154
050,51,820,"Virginia","Waynesboro city",4,16,281,139,142
050,51,820,"Virginia","Waynesboro city",4,17,290,152,138
050,51,820,"Virginia","Waynesboro city",4,18,240,118,122
050,51,820,"Virginia","Waynesboro city",4,19,193,99,94
050,51,820,"Virginia","Waynesboro city",4,20,201,100,101
050,51,820,"Virginia","Waynesboro city",4,21,226,115,111
050,51,820,"Virginia","Waynesboro city",4,22,253,136,117
050,51,820,"Virginia","Waynesboro city",4,23,283,130,153
050,51,820,"Virginia","Waynesboro city",4,24,283,122,161
050,51,820,"Virginia","Waynesboro city",4,25,289,127,162
050,51,820,"Virginia","Waynesboro city",4,26,288,131,157
050,51,820,"Virginia","Waynesboro city",4,27,343,175,168
050,51,820,"Virginia","Waynesboro city",4,28,301,150,151
050,51,820,"Virginia","Waynesboro city",4,29,327,155,172
050,51,820,"Virginia","Waynesboro city",4,30,377,184,193
050,51,820,"Virginia","Waynesboro city",4,31,352,179,173
050,51,820,"Virginia","Waynesboro city",4,32,340,171,169
050,51,820,"Virginia","Waynesboro city",4,33,281,142,139
050,51,820,"Virginia","Waynesboro city",4,34,300,156,144
050,51,820,"Virginia","Waynesboro city",4,35,312,157,155
050,51,820,"Virginia","Waynesboro city",4,36,305,163,142
050,51,820,"Virginia","Waynesboro city",4,37,319,175,144
050,51,820,"Virginia","Waynesboro city",4,38,311,150,161
050,51,820,"Virginia","Waynesboro city",4,39,327,167,160
050,51,820,"Virginia","Waynesboro city",4,40,314,156,158
050,51,820,"Virginia","Waynesboro city",4,41,309,130,179
050,51,820,"Virginia","Waynesboro city",4,42,314,143,171
050,51,820,"Virginia","Waynesboro city",4,43,299,137,162
050,51,820,"Virginia","Waynesboro city",4,44,267,123,144
050,51,820,"Virginia","Waynesboro city",4,45,267,143,124
050,51,820,"Virginia","Waynesboro city",4,46,274,134,140
050,51,820,"Virginia","Waynesboro city",4,47,256,121,135
050,51,820,"Virginia","Waynesboro city",4,48,228,110,118
050,51,820,"Virginia","Waynesboro city",4,49,241,112,129
050,51,820,"Virginia","Waynesboro city",4,50,262,133,129
050,51,820,"Virginia","Waynesboro city",4,51,267,123,144
050,51,820,"Virginia","Waynesboro city",4,52,233,107,126
050,51,820,"Virginia","Waynesboro city",4,53,257,124,133
050,51,820,"Virginia","Waynesboro city",4,54,251,133,118
050,51,820,"Virginia","Waynesboro city",4,55,253,119,134
050,51,820,"Virginia","Waynesboro city",4,56,256,128,128
050,51,820,"Virginia","Waynesboro city",4,57,267,126,141
050,51,820,"Virginia","Waynesboro city",4,58,302,134,168
050,51,820,"Virginia","Waynesboro city",4,59,305,153,152
050,51,820,"Virginia","Waynesboro city",4,60,298,138,160
050,51,820,"Virginia","Waynesboro city",4,61,300,141,159
050,51,820,"Virginia","Waynesboro city",4,62,304,139,165
050,51,820,"Virginia","Waynesboro city",4,63,307,144,163
050,51,820,"Virginia","Waynesboro city",4,64,299,139,160
050,51,820,"Virginia","Waynesboro city",4,65,290,136,154
050,51,820,"Virginia","Waynesboro city",4,66,250,112,138
050,51,820,"Virginia","Waynesboro city",4,67,240,115,125
050,51,820,"Virginia","Waynesboro city",4,68,226,90,136
050,51,820,"Virginia","Waynesboro city",4,69,219,98,121
050,51,820,"Virginia","Waynesboro city",4,70,221,99,122
050,51,820,"Virginia","Waynesboro city",4,71,203,84,119
050,51,820,"Virginia","Waynesboro city",4,72,213,89,124
050,51,820,"Virginia","Waynesboro city",4,73,223,97,126
050,51,820,"Virginia","Waynesboro city",4,74,206,103,103
050,51,820,"Virginia","Waynesboro city",4,75,226,105,121
050,51,820,"Virginia","Waynesboro city",4,76,149,55,94
050,51,820,"Virginia","Waynesboro city",4,77,146,49,97
050,51,820,"Virginia","Waynesboro city",4,78,142,54,88
050,51,820,"Virginia","Waynesboro city",4,79,144,64,80
050,51,820,"Virginia","Waynesboro city",4,80,132,57,75
050,51,820,"Virginia","Waynesboro city",4,81,118,53,65
050,51,820,"Virginia","Waynesboro city",4,82,110,39,71
050,51,820,"Virginia","Waynesboro city",4,83,99,40,59
050,51,820,"Virginia","Waynesboro city",4,84,89,39,50
050,51,820,"Virginia","Waynesboro city",4,85,492,174,318
050,51,820,"Virginia","Waynesboro city",5,0,355,191,164
050,51,820,"Virginia","Waynesboro city",5,1,372,204,168
050,51,820,"Virginia","Waynesboro city",5,2,352,194,158
050,51,820,"Virginia","Waynesboro city",5,3,287,164,123
050,51,820,"Virginia","Waynesboro city",5,4,282,135,147
050,51,820,"Virginia","Waynesboro city",5,5,252,126,126
050,51,820,"Virginia","Waynesboro city",5,6,296,141,155
050,51,820,"Virginia","Waynesboro city",5,7,319,155,164
050,51,820,"Virginia","Waynesboro city",5,8,290,134,156
050,51,820,"Virginia","Waynesboro city",5,9,306,165,141
050,51,820,"Virginia","Waynesboro city",5,10,248,129,119
050,51,820,"Virginia","Waynesboro city",5,11,272,132,140
050,51,820,"Virginia","Waynesboro city",5,12,265,141,124
050,51,820,"Virginia","Waynesboro city",5,13,291,154,137
050,51,820,"Virginia","Waynesboro city",5,14,304,163,141
050,51,820,"Virginia","Waynesboro city",5,15,316,165,151
050,51,820,"Virginia","Waynesboro city",5,16,317,163,154
050,51,820,"Virginia","Waynesboro city",5,17,283,146,137
050,51,820,"Virginia","Waynesboro city",5,18,246,126,120
050,51,820,"Virginia","Waynesboro city",5,19,198,96,102
050,51,820,"Virginia","Waynesboro city",5,20,208,99,109
050,51,820,"Virginia","Waynesboro city",5,21,201,103,98
050,51,820,"Virginia","Waynesboro city",5,22,252,132,120
050,51,820,"Virginia","Waynesboro city",5,23,291,157,134
050,51,820,"Virginia","Waynesboro city",5,24,289,138,151
050,51,820,"Virginia","Waynesboro city",5,25,316,136,180
050,51,820,"Virginia","Waynesboro city",5,26,308,143,165
050,51,820,"Virginia","Waynesboro city",5,27,303,140,163
050,51,820,"Virginia","Waynesboro city",5,28,363,180,183
050,51,820,"Virginia","Waynesboro city",5,29,316,160,156
050,51,820,"Virginia","Waynesboro city",5,30,349,174,175
050,51,820,"Virginia","Waynesboro city",5,31,356,177,179
050,51,820,"Virginia","Waynesboro city",5,32,353,176,177
050,51,820,"Virginia","Waynesboro city",5,33,331,155,176
050,51,820,"Virginia","Waynesboro city",5,34,276,138,138
050,51,820,"Virginia","Waynesboro city",5,35,304,152,152
050,51,820,"Virginia","Waynesboro city",5,36,314,152,162
050,51,820,"Virginia","Waynesboro city",5,37,301,156,145
050,51,820,"Virginia","Waynesboro city",5,38,324,183,141
050,51,820,"Virginia","Waynesboro city",5,39,302,139,163
050,51,820,"Virginia","Waynesboro city",5,40,326,167,159
050,51,820,"Virginia","Waynesboro city",5,41,315,162,153
050,51,820,"Virginia","Waynesboro city",5,42,311,137,174
050,51,820,"Virginia","Waynesboro city",5,43,323,153,170
050,51,820,"Virginia","Waynesboro city",5,44,303,145,158
050,51,820,"Virginia","Waynesboro city",5,45,271,125,146
050,51,820,"Virginia","Waynesboro city",5,46,266,139,127
050,51,820,"Virginia","Waynesboro city",5,47,275,132,143
050,51,820,"Virginia","Waynesboro city",5,48,263,122,141
050,51,820,"Virginia","Waynesboro city",5,49,236,112,124
050,51,820,"Virginia","Waynesboro city",5,50,245,116,129
050,51,820,"Virginia","Waynesboro city",5,51,257,133,124
050,51,820,"Virginia","Waynesboro city",5,52,272,126,146
050,51,820,"Virginia","Waynesboro city",5,53,230,105,125
050,51,820,"Virginia","Waynesboro city",5,54,272,134,138
050,51,820,"Virginia","Waynesboro city",5,55,250,131,119
050,51,820,"Virginia","Waynesboro city",5,56,261,125,136
050,51,820,"Virginia","Waynesboro city",5,57,244,120,124
050,51,820,"Virginia","Waynesboro city",5,58,274,121,153
050,51,820,"Virginia","Waynesboro city",5,59,314,139,175
050,51,820,"Virginia","Waynesboro city",5,60,298,148,150
050,51,820,"Virginia","Waynesboro city",5,61,288,128,160
050,51,820,"Virginia","Waynesboro city",5,62,310,154,156
050,51,820,"Virginia","Waynesboro city",5,63,300,133,167
050,51,820,"Virginia","Waynesboro city",5,64,308,141,167
050,51,820,"Virginia","Waynesboro city",5,65,286,127,159
050,51,820,"Virginia","Waynesboro city",5,66,287,136,151
050,51,820,"Virginia","Waynesboro city",5,67,245,107,138
050,51,820,"Virginia","Waynesboro city",5,68,237,111,126
050,51,820,"Virginia","Waynesboro city",5,69,226,84,142
050,51,820,"Virginia","Waynesboro city",5,70,216,94,122
050,51,820,"Virginia","Waynesboro city",5,71,217,102,115
050,51,820,"Virginia","Waynesboro city",5,72,200,82,118
050,51,820,"Virginia","Waynesboro city",5,73,213,88,125
050,51,820,"Virginia","Waynesboro city",5,74,225,99,126
050,51,820,"Virginia","Waynesboro city",5,75,196,101,95
050,51,820,"Virginia","Waynesboro city",5,76,229,108,121
050,51,820,"Virginia","Waynesboro city",5,77,143,48,95
050,51,820,"Virginia","Waynesboro city",5,78,135,44,91
050,51,820,"Virginia","Waynesboro city",5,79,148,58,90
050,51,820,"Virginia","Waynesboro city",5,80,132,55,77
050,51,820,"Virginia","Waynesboro city",5,81,117,52,65
050,51,820,"Virginia","Waynesboro city",5,82,109,45,64
050,51,820,"Virginia","Waynesboro city",5,83,96,34,62
050,51,820,"Virginia","Waynesboro city",5,84,93,38,55
050,51,820,"Virginia","Waynesboro city",5,85,512,190,322
050,51,830,"Virginia","Williamsburg city",1,0,96,48,48
050,51,830,"Virginia","Williamsburg city",1,1,111,53,58
050,51,830,"Virginia","Williamsburg city",1,2,106,48,58
050,51,830,"Virginia","Williamsburg city",1,3,105,50,55
050,51,830,"Virginia","Williamsburg city",1,4,103,54,49
050,51,830,"Virginia","Williamsburg city",1,5,91,44,47
050,51,830,"Virginia","Williamsburg city",1,6,116,61,55
050,51,830,"Virginia","Williamsburg city",1,7,115,60,55
050,51,830,"Virginia","Williamsburg city",1,8,86,46,40
050,51,830,"Virginia","Williamsburg city",1,9,94,42,52
050,51,830,"Virginia","Williamsburg city",1,10,91,38,53
050,51,830,"Virginia","Williamsburg city",1,11,99,48,51
050,51,830,"Virginia","Williamsburg city",1,12,91,46,45
050,51,830,"Virginia","Williamsburg city",1,13,83,46,37
050,51,830,"Virginia","Williamsburg city",1,14,84,41,43
050,51,830,"Virginia","Williamsburg city",1,15,72,38,34
050,51,830,"Virginia","Williamsburg city",1,16,82,44,38
050,51,830,"Virginia","Williamsburg city",1,17,104,45,59
050,51,830,"Virginia","Williamsburg city",1,18,798,336,462
050,51,830,"Virginia","Williamsburg city",1,19,1579,719,860
050,51,830,"Virginia","Williamsburg city",1,20,1149,489,660
050,51,830,"Virginia","Williamsburg city",1,21,1069,454,615
050,51,830,"Virginia","Williamsburg city",1,22,674,294,380
050,51,830,"Virginia","Williamsburg city",1,23,264,132,132
050,51,830,"Virginia","Williamsburg city",1,24,214,96,118
050,51,830,"Virginia","Williamsburg city",1,25,213,99,114
050,51,830,"Virginia","Williamsburg city",1,26,164,87,77
050,51,830,"Virginia","Williamsburg city",1,27,173,86,87
050,51,830,"Virginia","Williamsburg city",1,28,145,71,74
050,51,830,"Virginia","Williamsburg city",1,29,156,72,84
050,51,830,"Virginia","Williamsburg city",1,30,169,79,90
050,51,830,"Virginia","Williamsburg city",1,31,170,89,81
050,51,830,"Virginia","Williamsburg city",1,32,155,75,80
050,51,830,"Virginia","Williamsburg city",1,33,167,82,85
050,51,830,"Virginia","Williamsburg city",1,34,160,77,83
050,51,830,"Virginia","Williamsburg city",1,35,145,83,62
050,51,830,"Virginia","Williamsburg city",1,36,120,60,60
050,51,830,"Virginia","Williamsburg city",1,37,130,59,71
050,51,830,"Virginia","Williamsburg city",1,38,124,63,61
050,51,830,"Virginia","Williamsburg city",1,39,112,54,58
050,51,830,"Virginia","Williamsburg city",1,40,118,58,60
050,51,830,"Virginia","Williamsburg city",1,41,110,55,55
050,51,830,"Virginia","Williamsburg city",1,42,92,40,52
050,51,830,"Virginia","Williamsburg city",1,43,115,59,56
050,51,830,"Virginia","Williamsburg city",1,44,94,43,51
050,51,830,"Virginia","Williamsburg city",1,45,93,40,53
050,51,830,"Virginia","Williamsburg city",1,46,92,50,42
050,51,830,"Virginia","Williamsburg city",1,47,90,50,40
050,51,830,"Virginia","Williamsburg city",1,48,99,57,42
050,51,830,"Virginia","Williamsburg city",1,49,98,48,50
050,51,830,"Virginia","Williamsburg city",1,50,102,48,54
050,51,830,"Virginia","Williamsburg city",1,51,119,46,73
050,51,830,"Virginia","Williamsburg city",1,52,127,56,71
050,51,830,"Virginia","Williamsburg city",1,53,127,55,72
050,51,830,"Virginia","Williamsburg city",1,54,108,48,60
050,51,830,"Virginia","Williamsburg city",1,55,115,48,67
050,51,830,"Virginia","Williamsburg city",1,56,148,71,77
050,51,830,"Virginia","Williamsburg city",1,57,140,68,72
050,51,830,"Virginia","Williamsburg city",1,58,168,87,81
050,51,830,"Virginia","Williamsburg city",1,59,165,81,84
050,51,830,"Virginia","Williamsburg city",1,60,158,74,84
050,51,830,"Virginia","Williamsburg city",1,61,160,68,92
050,51,830,"Virginia","Williamsburg city",1,62,161,73,88
050,51,830,"Virginia","Williamsburg city",1,63,155,77,78
050,51,830,"Virginia","Williamsburg city",1,64,136,61,75
050,51,830,"Virginia","Williamsburg city",1,65,149,74,75
050,51,830,"Virginia","Williamsburg city",1,66,165,81,84
050,51,830,"Virginia","Williamsburg city",1,67,165,77,88
050,51,830,"Virginia","Williamsburg city",1,68,130,56,74
050,51,830,"Virginia","Williamsburg city",1,69,133,58,75
050,51,830,"Virginia","Williamsburg city",1,70,147,64,83
050,51,830,"Virginia","Williamsburg city",1,71,154,70,84
050,51,830,"Virginia","Williamsburg city",1,72,147,66,81
050,51,830,"Virginia","Williamsburg city",1,73,133,69,64
050,51,830,"Virginia","Williamsburg city",1,74,111,56,55
050,51,830,"Virginia","Williamsburg city",1,75,121,56,65
050,51,830,"Virginia","Williamsburg city",1,76,113,51,62
050,51,830,"Virginia","Williamsburg city",1,77,99,44,55
050,51,830,"Virginia","Williamsburg city",1,78,85,38,47
050,51,830,"Virginia","Williamsburg city",1,79,78,37,41
050,51,830,"Virginia","Williamsburg city",1,80,73,35,38
050,51,830,"Virginia","Williamsburg city",1,81,78,36,42
050,51,830,"Virginia","Williamsburg city",1,82,69,29,40
050,51,830,"Virginia","Williamsburg city",1,83,65,29,36
050,51,830,"Virginia","Williamsburg city",1,84,54,25,29
050,51,830,"Virginia","Williamsburg city",1,85,275,96,179
050,51,830,"Virginia","Williamsburg city",2,0,90,48,42
050,51,830,"Virginia","Williamsburg city",2,1,111,53,58
050,51,830,"Virginia","Williamsburg city",2,2,106,47,59
050,51,830,"Virginia","Williamsburg city",2,3,104,49,55
050,51,830,"Virginia","Williamsburg city",2,4,102,51,51
050,51,830,"Virginia","Williamsburg city",2,5,94,48,46
050,51,830,"Virginia","Williamsburg city",2,6,111,58,53
050,51,830,"Virginia","Williamsburg city",2,7,116,61,55
050,51,830,"Virginia","Williamsburg city",2,8,93,50,43
050,51,830,"Virginia","Williamsburg city",2,9,93,42,51
050,51,830,"Virginia","Williamsburg city",2,10,94,41,53
050,51,830,"Virginia","Williamsburg city",2,11,98,46,52
050,51,830,"Virginia","Williamsburg city",2,12,92,46,46
050,51,830,"Virginia","Williamsburg city",2,13,86,47,39
050,51,830,"Virginia","Williamsburg city",2,14,83,43,40
050,51,830,"Virginia","Williamsburg city",2,15,74,38,36
050,51,830,"Virginia","Williamsburg city",2,16,80,43,37
050,51,830,"Virginia","Williamsburg city",2,17,102,45,57
050,51,830,"Virginia","Williamsburg city",2,18,794,334,460
050,51,830,"Virginia","Williamsburg city",2,19,1574,713,861
050,51,830,"Virginia","Williamsburg city",2,20,1159,494,665
050,51,830,"Virginia","Williamsburg city",2,21,1071,453,618
050,51,830,"Virginia","Williamsburg city",2,22,676,297,379
050,51,830,"Virginia","Williamsburg city",2,23,265,132,133
050,51,830,"Virginia","Williamsburg city",2,24,220,98,122
050,51,830,"Virginia","Williamsburg city",2,25,206,95,111
050,51,830,"Virginia","Williamsburg city",2,26,171,90,81
050,51,830,"Virginia","Williamsburg city",2,27,166,83,83
050,51,830,"Virginia","Williamsburg city",2,28,150,75,75
050,51,830,"Virginia","Williamsburg city",2,29,151,72,79
050,51,830,"Virginia","Williamsburg city",2,30,167,81,86
050,51,830,"Virginia","Williamsburg city",2,31,167,83,84
050,51,830,"Virginia","Williamsburg city",2,32,159,78,81
050,51,830,"Virginia","Williamsburg city",2,33,163,78,85
050,51,830,"Virginia","Williamsburg city",2,34,166,81,85
050,51,830,"Virginia","Williamsburg city",2,35,147,80,67
050,51,830,"Virginia","Williamsburg city",2,36,126,64,62
050,51,830,"Virginia","Williamsburg city",2,37,129,60,69
050,51,830,"Virginia","Williamsburg city",2,38,126,63,63
050,51,830,"Virginia","Williamsburg city",2,39,112,56,56
050,51,830,"Virginia","Williamsburg city",2,40,120,59,61
050,51,830,"Virginia","Williamsburg city",2,41,114,57,57
050,51,830,"Virginia","Williamsburg city",2,42,98,45,53
050,51,830,"Virginia","Williamsburg city",2,43,109,54,55
050,51,830,"Virginia","Williamsburg city",2,44,97,46,51
050,51,830,"Virginia","Williamsburg city",2,45,94,41,53
050,51,830,"Virginia","Williamsburg city",2,46,92,46,46
050,51,830,"Virginia","Williamsburg city",2,47,91,50,41
050,51,830,"Virginia","Williamsburg city",2,48,96,55,41
050,51,830,"Virginia","Williamsburg city",2,49,100,51,49
050,51,830,"Virginia","Williamsburg city",2,50,104,48,56
050,51,830,"Virginia","Williamsburg city",2,51,114,47,67
050,51,830,"Virginia","Williamsburg city",2,52,127,54,73
050,51,830,"Virginia","Williamsburg city",2,53,126,55,71
050,51,830,"Virginia","Williamsburg city",2,54,112,50,62
050,51,830,"Virginia","Williamsburg city",2,55,116,49,67
050,51,830,"Virginia","Williamsburg city",2,56,144,68,76
050,51,830,"Virginia","Williamsburg city",2,57,141,68,73
050,51,830,"Virginia","Williamsburg city",2,58,165,83,82
050,51,830,"Virginia","Williamsburg city",2,59,168,84,84
050,51,830,"Virginia","Williamsburg city",2,60,162,78,84
050,51,830,"Virginia","Williamsburg city",2,61,158,68,90
050,51,830,"Virginia","Williamsburg city",2,62,161,73,88
050,51,830,"Virginia","Williamsburg city",2,63,154,74,80
050,51,830,"Virginia","Williamsburg city",2,64,140,65,75
050,51,830,"Virginia","Williamsburg city",2,65,147,71,76
050,51,830,"Virginia","Williamsburg city",2,66,164,80,84
050,51,830,"Virginia","Williamsburg city",2,67,165,78,87
050,51,830,"Virginia","Williamsburg city",2,68,140,62,78
050,51,830,"Virginia","Williamsburg city",2,69,130,56,74
050,51,830,"Virginia","Williamsburg city",2,70,142,63,79
050,51,830,"Virginia","Williamsburg city",2,71,154,69,85
050,51,830,"Virginia","Williamsburg city",2,72,147,66,81
050,51,830,"Virginia","Williamsburg city",2,73,148,75,73
050,51,830,"Virginia","Williamsburg city",2,74,110,56,54
050,51,830,"Virginia","Williamsburg city",2,75,120,56,64
050,51,830,"Virginia","Williamsburg city",2,76,116,53,63
050,51,830,"Virginia","Williamsburg city",2,77,102,45,57
050,51,830,"Virginia","Williamsburg city",2,78,85,37,48
050,51,830,"Virginia","Williamsburg city",2,79,80,37,43
050,51,830,"Virginia","Williamsburg city",2,80,74,36,38
050,51,830,"Virginia","Williamsburg city",2,81,76,35,41
050,51,830,"Virginia","Williamsburg city",2,82,69,29,40
050,51,830,"Virginia","Williamsburg city",2,83,65,29,36
050,51,830,"Virginia","Williamsburg city",2,84,56,26,30
050,51,830,"Virginia","Williamsburg city",2,85,284,101,183
050,51,830,"Virginia","Williamsburg city",3,0,44,22,22
050,51,830,"Virginia","Williamsburg city",3,1,96,57,39
050,51,830,"Virginia","Williamsburg city",3,2,108,52,56
050,51,830,"Virginia","Williamsburg city",3,3,106,46,60
050,51,830,"Virginia","Williamsburg city",3,4,107,50,57
050,51,830,"Virginia","Williamsburg city",3,5,99,45,54
050,51,830,"Virginia","Williamsburg city",3,6,103,56,47
050,51,830,"Virginia","Williamsburg city",3,7,108,60,48
050,51,830,"Virginia","Williamsburg city",3,8,107,58,49
050,51,830,"Virginia","Williamsburg city",3,9,86,47,39
050,51,830,"Virginia","Williamsburg city",3,10,97,44,53
050,51,830,"Virginia","Williamsburg city",3,11,98,42,56
050,51,830,"Virginia","Williamsburg city",3,12,103,46,57
050,51,830,"Virginia","Williamsburg city",3,13,93,48,45
050,51,830,"Virginia","Williamsburg city",3,14,91,52,39
050,51,830,"Virginia","Williamsburg city",3,15,86,42,44
050,51,830,"Virginia","Williamsburg city",3,16,81,39,42
050,51,830,"Virginia","Williamsburg city",3,17,96,49,47
050,51,830,"Virginia","Williamsburg city",3,18,816,348,468
050,51,830,"Virginia","Williamsburg city",3,19,1590,733,857
050,51,830,"Virginia","Williamsburg city",3,20,1155,498,657
050,51,830,"Virginia","Williamsburg city",3,21,1090,458,632
050,51,830,"Virginia","Williamsburg city",3,22,670,298,372
050,51,830,"Virginia","Williamsburg city",3,23,257,131,126
050,51,830,"Virginia","Williamsburg city",3,24,220,103,117
050,51,830,"Virginia","Williamsburg city",3,25,234,106,128
050,51,830,"Virginia","Williamsburg city",3,26,176,89,87
050,51,830,"Virginia","Williamsburg city",3,27,160,74,86
050,51,830,"Virginia","Williamsburg city",3,28,151,71,80
050,51,830,"Virginia","Williamsburg city",3,29,134,72,62
050,51,830,"Virginia","Williamsburg city",3,30,169,88,81
050,51,830,"Virginia","Williamsburg city",3,31,160,78,82
050,51,830,"Virginia","Williamsburg city",3,32,155,80,75
050,51,830,"Virginia","Williamsburg city",3,33,166,84,82
050,51,830,"Virginia","Williamsburg city",3,34,153,81,72
050,51,830,"Virginia","Williamsburg city",3,35,143,68,75
050,51,830,"Virginia","Williamsburg city",3,36,153,82,71
050,51,830,"Virginia","Williamsburg city",3,37,137,67,70
050,51,830,"Virginia","Williamsburg city",3,38,125,57,68
050,51,830,"Virginia","Williamsburg city",3,39,120,63,57
050,51,830,"Virginia","Williamsburg city",3,40,109,58,51
050,51,830,"Virginia","Williamsburg city",3,41,119,60,59
050,51,830,"Virginia","Williamsburg city",3,42,116,61,55
050,51,830,"Virginia","Williamsburg city",3,43,94,44,50
050,51,830,"Virginia","Williamsburg city",3,44,109,51,58
050,51,830,"Virginia","Williamsburg city",3,45,98,46,52
050,51,830,"Virginia","Williamsburg city",3,46,92,37,55
050,51,830,"Virginia","Williamsburg city",3,47,106,52,54
050,51,830,"Virginia","Williamsburg city",3,48,102,57,45
050,51,830,"Virginia","Williamsburg city",3,49,107,57,50
050,51,830,"Virginia","Williamsburg city",3,50,100,43,57
050,51,830,"Virginia","Williamsburg city",3,51,116,52,64
050,51,830,"Virginia","Williamsburg city",3,52,111,47,64
050,51,830,"Virginia","Williamsburg city",3,53,136,58,78
050,51,830,"Virginia","Williamsburg city",3,54,121,53,68
050,51,830,"Virginia","Williamsburg city",3,55,118,56,62
050,51,830,"Virginia","Williamsburg city",3,56,119,51,68
050,51,830,"Virginia","Williamsburg city",3,57,150,71,79
050,51,830,"Virginia","Williamsburg city",3,58,146,69,77
050,51,830,"Virginia","Williamsburg city",3,59,170,85,85
050,51,830,"Virginia","Williamsburg city",3,60,175,89,86
050,51,830,"Virginia","Williamsburg city",3,61,152,72,80
050,51,830,"Virginia","Williamsburg city",3,62,155,73,82
050,51,830,"Virginia","Williamsburg city",3,63,157,62,95
050,51,830,"Virginia","Williamsburg city",3,64,161,76,85
050,51,830,"Virginia","Williamsburg city",3,65,134,65,69
050,51,830,"Virginia","Williamsburg city",3,66,137,69,68
050,51,830,"Virginia","Williamsburg city",3,67,159,76,83
050,51,830,"Virginia","Williamsburg city",3,68,162,72,90
050,51,830,"Virginia","Williamsburg city",3,69,134,64,70
050,51,830,"Virginia","Williamsburg city",3,70,127,56,71
050,51,830,"Virginia","Williamsburg city",3,71,146,60,86
050,51,830,"Virginia","Williamsburg city",3,72,151,64,87
050,51,830,"Virginia","Williamsburg city",3,73,142,67,75
050,51,830,"Virginia","Williamsburg city",3,74,155,79,76
050,51,830,"Virginia","Williamsburg city",3,75,108,51,57
050,51,830,"Virginia","Williamsburg city",3,76,118,58,60
050,51,830,"Virginia","Williamsburg city",3,77,112,49,63
050,51,830,"Virginia","Williamsburg city",3,78,99,43,56
050,51,830,"Virginia","Williamsburg city",3,79,85,38,47
050,51,830,"Virginia","Williamsburg city",3,80,85,37,48
050,51,830,"Virginia","Williamsburg city",3,81,76,35,41
050,51,830,"Virginia","Williamsburg city",3,82,77,35,42
050,51,830,"Virginia","Williamsburg city",3,83,67,29,38
050,51,830,"Virginia","Williamsburg city",3,84,57,25,32
050,51,830,"Virginia","Williamsburg city",3,85,296,104,192
050,51,830,"Virginia","Williamsburg city",4,0,59,33,26
050,51,830,"Virginia","Williamsburg city",4,1,60,27,33
050,51,830,"Virginia","Williamsburg city",4,2,103,64,39
050,51,830,"Virginia","Williamsburg city",4,3,120,56,64
050,51,830,"Virginia","Williamsburg city",4,4,101,45,56
050,51,830,"Virginia","Williamsburg city",4,5,112,55,57
050,51,830,"Virginia","Williamsburg city",4,6,97,45,52
050,51,830,"Virginia","Williamsburg city",4,7,110,62,48
050,51,830,"Virginia","Williamsburg city",4,8,114,63,51
050,51,830,"Virginia","Williamsburg city",4,9,107,57,50
050,51,830,"Virginia","Williamsburg city",4,10,90,49,41
050,51,830,"Virginia","Williamsburg city",4,11,99,45,54
050,51,830,"Virginia","Williamsburg city",4,12,102,47,55
050,51,830,"Virginia","Williamsburg city",4,13,107,56,51
050,51,830,"Virginia","Williamsburg city",4,14,97,52,45
050,51,830,"Virginia","Williamsburg city",4,15,80,41,39
050,51,830,"Virginia","Williamsburg city",4,16,93,45,48
050,51,830,"Virginia","Williamsburg city",4,17,105,44,61
050,51,830,"Virginia","Williamsburg city",4,18,791,335,456
050,51,830,"Virginia","Williamsburg city",4,19,1571,717,854
050,51,830,"Virginia","Williamsburg city",4,20,1162,508,654
050,51,830,"Virginia","Williamsburg city",4,21,1087,466,621
050,51,830,"Virginia","Williamsburg city",4,22,717,314,403
050,51,830,"Virginia","Williamsburg city",4,23,265,139,126
050,51,830,"Virginia","Williamsburg city",4,24,242,106,136
050,51,830,"Virginia","Williamsburg city",4,25,197,89,108
050,51,830,"Virginia","Williamsburg city",4,26,201,99,102
050,51,830,"Virginia","Williamsburg city",4,27,175,85,90
050,51,830,"Virginia","Williamsburg city",4,28,166,79,87
050,51,830,"Virginia","Williamsburg city",4,29,132,67,65
050,51,830,"Virginia","Williamsburg city",4,30,134,63,71
050,51,830,"Virginia","Williamsburg city",4,31,150,77,73
050,51,830,"Virginia","Williamsburg city",4,32,150,80,70
050,51,830,"Virginia","Williamsburg city",4,33,162,73,89
050,51,830,"Virginia","Williamsburg city",4,34,162,80,82
050,51,830,"Virginia","Williamsburg city",4,35,143,73,70
050,51,830,"Virginia","Williamsburg city",4,36,142,74,68
050,51,830,"Virginia","Williamsburg city",4,37,139,75,64
050,51,830,"Virginia","Williamsburg city",4,38,139,59,80
050,51,830,"Virginia","Williamsburg city",4,39,127,56,71
050,51,830,"Virginia","Williamsburg city",4,40,123,63,60
050,51,830,"Virginia","Williamsburg city",4,41,117,69,48
050,51,830,"Virginia","Williamsburg city",4,42,117,58,59
050,51,830,"Virginia","Williamsburg city",4,43,131,65,66
050,51,830,"Virginia","Williamsburg city",4,44,99,50,49
050,51,830,"Virginia","Williamsburg city",4,45,121,56,65
050,51,830,"Virginia","Williamsburg city",4,46,104,51,53
050,51,830,"Virginia","Williamsburg city",4,47,93,35,58
050,51,830,"Virginia","Williamsburg city",4,48,107,55,52
050,51,830,"Virginia","Williamsburg city",4,49,100,56,44
050,51,830,"Virginia","Williamsburg city",4,50,112,56,56
050,51,830,"Virginia","Williamsburg city",4,51,104,54,50
050,51,830,"Virginia","Williamsburg city",4,52,117,53,64
050,51,830,"Virginia","Williamsburg city",4,53,116,44,72
050,51,830,"Virginia","Williamsburg city",4,54,135,55,80
050,51,830,"Virginia","Williamsburg city",4,55,114,48,66
050,51,830,"Virginia","Williamsburg city",4,56,121,61,60
050,51,830,"Virginia","Williamsburg city",4,57,114,48,66
050,51,830,"Virginia","Williamsburg city",4,58,151,73,78
050,51,830,"Virginia","Williamsburg city",4,59,148,70,78
050,51,830,"Virginia","Williamsburg city",4,60,184,89,95
050,51,830,"Virginia","Williamsburg city",4,61,165,83,82
050,51,830,"Virginia","Williamsburg city",4,62,155,72,83
050,51,830,"Virginia","Williamsburg city",4,63,150,67,83
050,51,830,"Virginia","Williamsburg city",4,64,156,58,98
050,51,830,"Virginia","Williamsburg city",4,65,167,82,85
050,51,830,"Virginia","Williamsburg city",4,66,139,64,75
050,51,830,"Virginia","Williamsburg city",4,67,131,68,63
050,51,830,"Virginia","Williamsburg city",4,68,153,69,84
050,51,830,"Virginia","Williamsburg city",4,69,155,70,85
050,51,830,"Virginia","Williamsburg city",4,70,135,64,71
050,51,830,"Virginia","Williamsburg city",4,71,122,51,71
050,51,830,"Virginia","Williamsburg city",4,72,141,55,86
050,51,830,"Virginia","Williamsburg city",4,73,147,63,84
050,51,830,"Virginia","Williamsburg city",4,74,146,68,78
050,51,830,"Virginia","Williamsburg city",4,75,151,71,80
050,51,830,"Virginia","Williamsburg city",4,76,108,53,55
050,51,830,"Virginia","Williamsburg city",4,77,113,55,58
050,51,830,"Virginia","Williamsburg city",4,78,105,46,59
050,51,830,"Virginia","Williamsburg city",4,79,95,43,52
050,51,830,"Virginia","Williamsburg city",4,80,65,25,40
050,51,830,"Virginia","Williamsburg city",4,81,79,34,45
050,51,830,"Virginia","Williamsburg city",4,82,72,34,38
050,51,830,"Virginia","Williamsburg city",4,83,73,33,40
050,51,830,"Virginia","Williamsburg city",4,84,59,22,37
050,51,830,"Virginia","Williamsburg city",4,85,265,93,172
050,51,830,"Virginia","Williamsburg city",5,0,61,35,26
050,51,830,"Virginia","Williamsburg city",5,1,70,39,31
050,51,830,"Virginia","Williamsburg city",5,2,72,41,31
050,51,830,"Virginia","Williamsburg city",5,3,109,64,45
050,51,830,"Virginia","Williamsburg city",5,4,121,55,66
050,51,830,"Virginia","Williamsburg city",5,5,101,52,49
050,51,830,"Virginia","Williamsburg city",5,6,106,60,46
050,51,830,"Virginia","Williamsburg city",5,7,87,42,45
050,51,830,"Virginia","Williamsburg city",5,8,115,60,55
050,51,830,"Virginia","Williamsburg city",5,9,111,57,54
050,51,830,"Virginia","Williamsburg city",5,10,114,64,50
050,51,830,"Virginia","Williamsburg city",5,11,94,51,43
050,51,830,"Virginia","Williamsburg city",5,12,105,51,54
050,51,830,"Virginia","Williamsburg city",5,13,112,57,55
050,51,830,"Virginia","Williamsburg city",5,14,107,60,47
050,51,830,"Virginia","Williamsburg city",5,15,107,58,49
050,51,830,"Virginia","Williamsburg city",5,16,91,49,42
050,51,830,"Virginia","Williamsburg city",5,17,115,57,58
050,51,830,"Virginia","Williamsburg city",5,18,810,341,469
050,51,830,"Virginia","Williamsburg city",5,19,1584,722,862
050,51,830,"Virginia","Williamsburg city",5,20,1148,495,653
050,51,830,"Virginia","Williamsburg city",5,21,1062,462,600
050,51,830,"Virginia","Williamsburg city",5,22,692,320,372
050,51,830,"Virginia","Williamsburg city",5,23,290,140,150
050,51,830,"Virginia","Williamsburg city",5,24,254,119,135
050,51,830,"Virginia","Williamsburg city",5,25,220,94,126
050,51,830,"Virginia","Williamsburg city",5,26,185,94,91
050,51,830,"Virginia","Williamsburg city",5,27,190,82,108
050,51,830,"Virginia","Williamsburg city",5,28,167,79,88
050,51,830,"Virginia","Williamsburg city",5,29,152,77,75
050,51,830,"Virginia","Williamsburg city",5,30,136,76,60
050,51,830,"Virginia","Williamsburg city",5,31,123,57,66
050,51,830,"Virginia","Williamsburg city",5,32,159,73,86
050,51,830,"Virginia","Williamsburg city",5,33,134,74,60
050,51,830,"Virginia","Williamsburg city",5,34,156,71,85
050,51,830,"Virginia","Williamsburg city",5,35,170,75,95
050,51,830,"Virginia","Williamsburg city",5,36,131,66,65
050,51,830,"Virginia","Williamsburg city",5,37,144,71,73
050,51,830,"Virginia","Williamsburg city",5,38,143,78,65
050,51,830,"Virginia","Williamsburg city",5,39,151,69,82
050,51,830,"Virginia","Williamsburg city",5,40,120,62,58
050,51,830,"Virginia","Williamsburg city",5,41,113,60,53
050,51,830,"Virginia","Williamsburg city",5,42,129,72,57
050,51,830,"Virginia","Williamsburg city",5,43,122,60,62
050,51,830,"Virginia","Williamsburg city",5,44,126,61,65
050,51,830,"Virginia","Williamsburg city",5,45,111,58,53
050,51,830,"Virginia","Williamsburg city",5,46,112,51,61
050,51,830,"Virginia","Williamsburg city",5,47,102,54,48
050,51,830,"Virginia","Williamsburg city",5,48,104,40,64
050,51,830,"Virginia","Williamsburg city",5,49,108,53,55
050,51,830,"Virginia","Williamsburg city",5,50,109,60,49
050,51,830,"Virginia","Williamsburg city",5,51,129,68,61
050,51,830,"Virginia","Williamsburg city",5,52,112,60,52
050,51,830,"Virginia","Williamsburg city",5,53,115,54,61
050,51,830,"Virginia","Williamsburg city",5,54,121,48,73
050,51,830,"Virginia","Williamsburg city",5,55,142,62,80
050,51,830,"Virginia","Williamsburg city",5,56,128,56,72
050,51,830,"Virginia","Williamsburg city",5,57,120,49,71
050,51,830,"Virginia","Williamsburg city",5,58,120,54,66
050,51,830,"Virginia","Williamsburg city",5,59,154,70,84
050,51,830,"Virginia","Williamsburg city",5,60,151,70,81
050,51,830,"Virginia","Williamsburg city",5,61,166,80,86
050,51,830,"Virginia","Williamsburg city",5,62,177,88,89
050,51,830,"Virginia","Williamsburg city",5,63,150,72,78
050,51,830,"Virginia","Williamsburg city",5,64,141,65,76
050,51,830,"Virginia","Williamsburg city",5,65,163,65,98
050,51,830,"Virginia","Williamsburg city",5,66,170,85,85
050,51,830,"Virginia","Williamsburg city",5,67,134,60,74
050,51,830,"Virginia","Williamsburg city",5,68,135,65,70
050,51,830,"Virginia","Williamsburg city",5,69,153,70,83
050,51,830,"Virginia","Williamsburg city",5,70,164,73,91
050,51,830,"Virginia","Williamsburg city",5,71,133,62,71
050,51,830,"Virginia","Williamsburg city",5,72,118,51,67
050,51,830,"Virginia","Williamsburg city",5,73,132,56,76
050,51,830,"Virginia","Williamsburg city",5,74,144,60,84
050,51,830,"Virginia","Williamsburg city",5,75,137,66,71
050,51,830,"Virginia","Williamsburg city",5,76,150,75,75
050,51,830,"Virginia","Williamsburg city",5,77,104,49,55
050,51,830,"Virginia","Williamsburg city",5,78,107,51,56
050,51,830,"Virginia","Williamsburg city",5,79,93,40,53
050,51,830,"Virginia","Williamsburg city",5,80,80,34,46
050,51,830,"Virginia","Williamsburg city",5,81,69,23,46
050,51,830,"Virginia","Williamsburg city",5,82,75,32,43
050,51,830,"Virginia","Williamsburg city",5,83,70,33,37
050,51,830,"Virginia","Williamsburg city",5,84,69,29,40
050,51,830,"Virginia","Williamsburg city",5,85,266,94,172
050,51,840,"Virginia","Winchester city",1,0,356,181,175
050,51,840,"Virginia","Winchester city",1,1,342,173,169
050,51,840,"Virginia","Winchester city",1,2,348,172,176
050,51,840,"Virginia","Winchester city",1,3,359,183,176
050,51,840,"Virginia","Winchester city",1,4,371,194,177
050,51,840,"Virginia","Winchester city",1,5,332,163,169
050,51,840,"Virginia","Winchester city",1,6,337,188,149
050,51,840,"Virginia","Winchester city",1,7,354,190,164
050,51,840,"Virginia","Winchester city",1,8,343,169,174
050,51,840,"Virginia","Winchester city",1,9,353,184,169
050,51,840,"Virginia","Winchester city",1,10,345,177,168
050,51,840,"Virginia","Winchester city",1,11,342,176,166
050,51,840,"Virginia","Winchester city",1,12,361,196,165
050,51,840,"Virginia","Winchester city",1,13,403,212,191
050,51,840,"Virginia","Winchester city",1,14,379,200,179
050,51,840,"Virginia","Winchester city",1,15,367,198,169
050,51,840,"Virginia","Winchester city",1,16,337,175,162
050,51,840,"Virginia","Winchester city",1,17,347,193,154
050,51,840,"Virginia","Winchester city",1,18,497,242,255
050,51,840,"Virginia","Winchester city",1,19,597,276,321
050,51,840,"Virginia","Winchester city",1,20,452,239,213
050,51,840,"Virginia","Winchester city",1,21,347,179,168
050,51,840,"Virginia","Winchester city",1,22,355,191,164
050,51,840,"Virginia","Winchester city",1,23,359,183,176
050,51,840,"Virginia","Winchester city",1,24,414,204,210
050,51,840,"Virginia","Winchester city",1,25,428,202,226
050,51,840,"Virginia","Winchester city",1,26,430,213,217
050,51,840,"Virginia","Winchester city",1,27,418,218,200
050,51,840,"Virginia","Winchester city",1,28,410,217,193
050,51,840,"Virginia","Winchester city",1,29,424,211,213
050,51,840,"Virginia","Winchester city",1,30,417,212,205
050,51,840,"Virginia","Winchester city",1,31,370,176,194
050,51,840,"Virginia","Winchester city",1,32,353,188,165
050,51,840,"Virginia","Winchester city",1,33,355,185,170
050,51,840,"Virginia","Winchester city",1,34,372,186,186
050,51,840,"Virginia","Winchester city",1,35,348,179,169
050,51,840,"Virginia","Winchester city",1,36,329,168,161
050,51,840,"Virginia","Winchester city",1,37,357,195,162
050,51,840,"Virginia","Winchester city",1,38,338,174,164
050,51,840,"Virginia","Winchester city",1,39,360,189,171
050,51,840,"Virginia","Winchester city",1,40,373,194,179
050,51,840,"Virginia","Winchester city",1,41,338,164,174
050,51,840,"Virginia","Winchester city",1,42,330,161,169
050,51,840,"Virginia","Winchester city",1,43,309,157,152
050,51,840,"Virginia","Winchester city",1,44,300,154,146
050,51,840,"Virginia","Winchester city",1,45,300,159,141
050,51,840,"Virginia","Winchester city",1,46,280,138,142
050,51,840,"Virginia","Winchester city",1,47,314,152,162
050,51,840,"Virginia","Winchester city",1,48,353,161,192
050,51,840,"Virginia","Winchester city",1,49,359,169,190
050,51,840,"Virginia","Winchester city",1,50,329,136,193
050,51,840,"Virginia","Winchester city",1,51,323,151,172
050,51,840,"Virginia","Winchester city",1,52,324,173,151
050,51,840,"Virginia","Winchester city",1,53,371,197,174
050,51,840,"Virginia","Winchester city",1,54,355,161,194
050,51,840,"Virginia","Winchester city",1,55,353,185,168
050,51,840,"Virginia","Winchester city",1,56,343,165,178
050,51,840,"Virginia","Winchester city",1,57,390,191,199
050,51,840,"Virginia","Winchester city",1,58,360,178,182
050,51,840,"Virginia","Winchester city",1,59,355,190,165
050,51,840,"Virginia","Winchester city",1,60,319,167,152
050,51,840,"Virginia","Winchester city",1,61,329,151,178
050,51,840,"Virginia","Winchester city",1,62,364,172,192
050,51,840,"Virginia","Winchester city",1,63,347,172,175
050,51,840,"Virginia","Winchester city",1,64,301,140,161
050,51,840,"Virginia","Winchester city",1,65,310,141,169
050,51,840,"Virginia","Winchester city",1,66,317,142,175
050,51,840,"Virginia","Winchester city",1,67,292,151,141
050,51,840,"Virginia","Winchester city",1,68,294,136,158
050,51,840,"Virginia","Winchester city",1,69,272,130,142
050,51,840,"Virginia","Winchester city",1,70,278,124,154
050,51,840,"Virginia","Winchester city",1,71,255,112,143
050,51,840,"Virginia","Winchester city",1,72,265,127,138
050,51,840,"Virginia","Winchester city",1,73,259,126,133
050,51,840,"Virginia","Winchester city",1,74,194,95,99
050,51,840,"Virginia","Winchester city",1,75,193,85,108
050,51,840,"Virginia","Winchester city",1,76,191,85,106
050,51,840,"Virginia","Winchester city",1,77,181,74,107
050,51,840,"Virginia","Winchester city",1,78,144,52,92
050,51,840,"Virginia","Winchester city",1,79,126,51,75
050,51,840,"Virginia","Winchester city",1,80,98,42,56
050,51,840,"Virginia","Winchester city",1,81,106,41,65
050,51,840,"Virginia","Winchester city",1,82,122,54,68
050,51,840,"Virginia","Winchester city",1,83,86,34,52
050,51,840,"Virginia","Winchester city",1,84,92,38,54
050,51,840,"Virginia","Winchester city",1,85,524,198,326
050,51,840,"Virginia","Winchester city",2,0,342,173,169
050,51,840,"Virginia","Winchester city",2,1,342,173,169
050,51,840,"Virginia","Winchester city",2,2,346,171,175
050,51,840,"Virginia","Winchester city",2,3,355,179,176
050,51,840,"Virginia","Winchester city",2,4,366,187,179
050,51,840,"Virginia","Winchester city",2,5,336,168,168
050,51,840,"Virginia","Winchester city",2,6,333,181,152
050,51,840,"Virginia","Winchester city",2,7,343,186,157
050,51,840,"Virginia","Winchester city",2,8,342,172,170
050,51,840,"Virginia","Winchester city",2,9,345,177,168
050,51,840,"Virginia","Winchester city",2,10,343,177,166
050,51,840,"Virginia","Winchester city",2,11,337,173,164
050,51,840,"Virginia","Winchester city",2,12,359,192,167
050,51,840,"Virginia","Winchester city",2,13,393,210,183
050,51,840,"Virginia","Winchester city",2,14,378,200,178
050,51,840,"Virginia","Winchester city",2,15,365,196,169
050,51,840,"Virginia","Winchester city",2,16,346,183,163
050,51,840,"Virginia","Winchester city",2,17,347,187,160
050,51,840,"Virginia","Winchester city",2,18,498,247,251
050,51,840,"Virginia","Winchester city",2,19,603,279,324
050,51,840,"Virginia","Winchester city",2,20,455,237,218
050,51,840,"Virginia","Winchester city",2,21,350,183,167
050,51,840,"Virginia","Winchester city",2,22,351,188,163
050,51,840,"Virginia","Winchester city",2,23,357,186,171
050,51,840,"Virginia","Winchester city",2,24,398,197,201
050,51,840,"Virginia","Winchester city",2,25,421,204,217
050,51,840,"Virginia","Winchester city",2,26,424,210,214
050,51,840,"Virginia","Winchester city",2,27,413,215,198
050,51,840,"Virginia","Winchester city",2,28,409,215,194
050,51,840,"Virginia","Winchester city",2,29,421,215,206
050,51,840,"Virginia","Winchester city",2,30,418,210,208
050,51,840,"Virginia","Winchester city",2,31,373,183,190
050,51,840,"Virginia","Winchester city",2,32,352,182,170
050,51,840,"Virginia","Winchester city",2,33,352,183,169
050,51,840,"Virginia","Winchester city",2,34,364,183,181
050,51,840,"Virginia","Winchester city",2,35,351,180,171
050,51,840,"Virginia","Winchester city",2,36,328,169,159
050,51,840,"Virginia","Winchester city",2,37,346,185,161
050,51,840,"Virginia","Winchester city",2,38,346,182,164
050,51,840,"Virginia","Winchester city",2,39,351,183,168
050,51,840,"Virginia","Winchester city",2,40,364,187,177
050,51,840,"Virginia","Winchester city",2,41,344,168,176
050,51,840,"Virginia","Winchester city",2,42,327,161,166
050,51,840,"Virginia","Winchester city",2,43,314,156,158
050,51,840,"Virginia","Winchester city",2,44,300,154,146
050,51,840,"Virginia","Winchester city",2,45,303,161,142
050,51,840,"Virginia","Winchester city",2,46,284,143,141
050,51,840,"Virginia","Winchester city",2,47,305,147,158
050,51,840,"Virginia","Winchester city",2,48,343,158,185
050,51,840,"Virginia","Winchester city",2,49,359,168,191
050,51,840,"Virginia","Winchester city",2,50,337,144,193
050,51,840,"Virginia","Winchester city",2,51,323,147,176
050,51,840,"Virginia","Winchester city",2,52,322,168,154
050,51,840,"Virginia","Winchester city",2,53,356,189,167
050,51,840,"Virginia","Winchester city",2,54,354,168,186
050,51,840,"Virginia","Winchester city",2,55,353,180,173
050,51,840,"Virginia","Winchester city",2,56,344,169,175
050,51,840,"Virginia","Winchester city",2,57,375,182,193
050,51,840,"Virginia","Winchester city",2,58,364,182,182
050,51,840,"Virginia","Winchester city",2,59,361,191,170
050,51,840,"Virginia","Winchester city",2,60,329,173,156
050,51,840,"Virginia","Winchester city",2,61,324,152,172
050,51,840,"Virginia","Winchester city",2,62,351,165,186
050,51,840,"Virginia","Winchester city",2,63,352,170,182
050,51,840,"Virginia","Winchester city",2,64,307,147,160
050,51,840,"Virginia","Winchester city",2,65,307,140,167
050,51,840,"Virginia","Winchester city",2,66,313,140,173
050,51,840,"Virginia","Winchester city",2,67,296,146,150
050,51,840,"Virginia","Winchester city",2,68,293,141,152
050,51,840,"Virginia","Winchester city",2,69,280,133,147
050,51,840,"Virginia","Winchester city",2,70,277,126,151
050,51,840,"Virginia","Winchester city",2,71,259,114,145
050,51,840,"Virginia","Winchester city",2,72,256,122,134
050,51,840,"Virginia","Winchester city",2,73,271,132,139
050,51,840,"Virginia","Winchester city",2,74,192,93,99
050,51,840,"Virginia","Winchester city",2,75,192,85,107
050,51,840,"Virginia","Winchester city",2,76,190,83,107
050,51,840,"Virginia","Winchester city",2,77,185,75,110
050,51,840,"Virginia","Winchester city",2,78,148,54,94
050,51,840,"Virginia","Winchester city",2,79,132,53,79
050,51,840,"Virginia","Winchester city",2,80,103,43,60
050,51,840,"Virginia","Winchester city",2,81,99,38,61
050,51,840,"Virginia","Winchester city",2,82,118,52,66
050,51,840,"Virginia","Winchester city",2,83,93,37,56
050,51,840,"Virginia","Winchester city",2,84,88,36,52
050,51,840,"Virginia","Winchester city",2,85,527,201,326
050,51,840,"Virginia","Winchester city",3,0,339,180,159
050,51,840,"Virginia","Winchester city",3,1,345,171,174
050,51,840,"Virginia","Winchester city",3,2,351,185,166
050,51,840,"Virginia","Winchester city",3,3,342,162,180
050,51,840,"Virginia","Winchester city",3,4,343,177,166
050,51,840,"Virginia","Winchester city",3,5,384,197,187
050,51,840,"Virginia","Winchester city",3,6,326,164,162
050,51,840,"Virginia","Winchester city",3,7,335,185,150
050,51,840,"Virginia","Winchester city",3,8,317,169,148
050,51,840,"Virginia","Winchester city",3,9,360,188,172
050,51,840,"Virginia","Winchester city",3,10,337,162,175
050,51,840,"Virginia","Winchester city",3,11,342,167,175
050,51,840,"Virginia","Winchester city",3,12,356,188,168
050,51,840,"Virginia","Winchester city",3,13,370,196,174
050,51,840,"Virginia","Winchester city",3,14,383,200,183
050,51,840,"Virginia","Winchester city",3,15,372,195,177
050,51,840,"Virginia","Winchester city",3,16,374,198,176
050,51,840,"Virginia","Winchester city",3,17,359,195,164
050,51,840,"Virginia","Winchester city",3,18,516,268,248
050,51,840,"Virginia","Winchester city",3,19,608,288,320
050,51,840,"Virginia","Winchester city",3,20,448,222,226
050,51,840,"Virginia","Winchester city",3,21,366,185,181
050,51,840,"Virginia","Winchester city",3,22,369,195,174
050,51,840,"Virginia","Winchester city",3,23,367,195,172
050,51,840,"Virginia","Winchester city",3,24,384,183,201
050,51,840,"Virginia","Winchester city",3,25,412,201,211
050,51,840,"Virginia","Winchester city",3,26,435,215,220
050,51,840,"Virginia","Winchester city",3,27,417,229,188
050,51,840,"Virginia","Winchester city",3,28,394,199,195
050,51,840,"Virginia","Winchester city",3,29,391,193,198
050,51,840,"Virginia","Winchester city",3,30,390,197,193
050,51,840,"Virginia","Winchester city",3,31,402,197,205
050,51,840,"Virginia","Winchester city",3,32,372,198,174
050,51,840,"Virginia","Winchester city",3,33,360,185,175
050,51,840,"Virginia","Winchester city",3,34,355,186,169
050,51,840,"Virginia","Winchester city",3,35,350,172,178
050,51,840,"Virginia","Winchester city",3,36,335,170,165
050,51,840,"Virginia","Winchester city",3,37,334,169,165
050,51,840,"Virginia","Winchester city",3,38,339,185,154
050,51,840,"Virginia","Winchester city",3,39,328,175,153
050,51,840,"Virginia","Winchester city",3,40,346,175,171
050,51,840,"Virginia","Winchester city",3,41,356,181,175
050,51,840,"Virginia","Winchester city",3,42,342,173,169
050,51,840,"Virginia","Winchester city",3,43,319,162,157
050,51,840,"Virginia","Winchester city",3,44,325,156,169
050,51,840,"Virginia","Winchester city",3,45,300,150,150
050,51,840,"Virginia","Winchester city",3,46,294,160,134
050,51,840,"Virginia","Winchester city",3,47,301,149,152
050,51,840,"Virginia","Winchester city",3,48,302,149,153
050,51,840,"Virginia","Winchester city",3,49,351,158,193
050,51,840,"Virginia","Winchester city",3,50,338,160,178
050,51,840,"Virginia","Winchester city",3,51,333,141,192
050,51,840,"Virginia","Winchester city",3,52,324,153,171
050,51,840,"Virginia","Winchester city",3,53,322,165,157
050,51,840,"Virginia","Winchester city",3,54,339,173,166
050,51,840,"Virginia","Winchester city",3,55,347,163,184
050,51,840,"Virginia","Winchester city",3,56,360,185,175
050,51,840,"Virginia","Winchester city",3,57,350,170,180
050,51,840,"Virginia","Winchester city",3,58,380,187,193
050,51,840,"Virginia","Winchester city",3,59,365,193,172
050,51,840,"Virginia","Winchester city",3,60,369,191,178
050,51,840,"Virginia","Winchester city",3,61,331,169,162
050,51,840,"Virginia","Winchester city",3,62,321,158,163
050,51,840,"Virginia","Winchester city",3,63,335,146,189
050,51,840,"Virginia","Winchester city",3,64,345,168,177
050,51,840,"Virginia","Winchester city",3,65,303,144,159
050,51,840,"Virginia","Winchester city",3,66,300,130,170
050,51,840,"Virginia","Winchester city",3,67,312,133,179
050,51,840,"Virginia","Winchester city",3,68,290,140,150
050,51,840,"Virginia","Winchester city",3,69,287,132,155
050,51,840,"Virginia","Winchester city",3,70,285,140,145
050,51,840,"Virginia","Winchester city",3,71,260,114,146
050,51,840,"Virginia","Winchester city",3,72,256,111,145
050,51,840,"Virginia","Winchester city",3,73,250,121,129
050,51,840,"Virginia","Winchester city",3,74,260,130,130
050,51,840,"Virginia","Winchester city",3,75,185,84,101
050,51,840,"Virginia","Winchester city",3,76,185,82,103
050,51,840,"Virginia","Winchester city",3,77,177,78,99
050,51,840,"Virginia","Winchester city",3,78,181,73,108
050,51,840,"Virginia","Winchester city",3,79,140,52,88
050,51,840,"Virginia","Winchester city",3,80,130,51,79
050,51,840,"Virginia","Winchester city",3,81,92,37,55
050,51,840,"Virginia","Winchester city",3,82,91,32,59
050,51,840,"Virginia","Winchester city",3,83,105,45,60
050,51,840,"Virginia","Winchester city",3,84,85,35,50
050,51,840,"Virginia","Winchester city",3,85,516,195,321
050,51,840,"Virginia","Winchester city",4,0,337,178,159
050,51,840,"Virginia","Winchester city",4,1,339,178,161
050,51,840,"Virginia","Winchester city",4,2,327,165,162
050,51,840,"Virginia","Winchester city",4,3,350,175,175
050,51,840,"Virginia","Winchester city",4,4,338,160,178
050,51,840,"Virginia","Winchester city",4,5,344,172,172
050,51,840,"Virginia","Winchester city",4,6,359,181,178
050,51,840,"Virginia","Winchester city",4,7,317,162,155
050,51,840,"Virginia","Winchester city",4,8,318,180,138
050,51,840,"Virginia","Winchester city",4,9,320,179,141
050,51,840,"Virginia","Winchester city",4,10,366,201,165
050,51,840,"Virginia","Winchester city",4,11,335,159,176
050,51,840,"Virginia","Winchester city",4,12,324,171,153
050,51,840,"Virginia","Winchester city",4,13,344,184,160
050,51,840,"Virginia","Winchester city",4,14,371,199,172
050,51,840,"Virginia","Winchester city",4,15,386,208,178
050,51,840,"Virginia","Winchester city",4,16,363,195,168
050,51,840,"Virginia","Winchester city",4,17,381,204,177
050,51,840,"Virginia","Winchester city",4,18,503,269,234
050,51,840,"Virginia","Winchester city",4,19,623,304,319
050,51,840,"Virginia","Winchester city",4,20,464,229,235
050,51,840,"Virginia","Winchester city",4,21,359,172,187
050,51,840,"Virginia","Winchester city",4,22,366,184,182
050,51,840,"Virginia","Winchester city",4,23,393,203,190
050,51,840,"Virginia","Winchester city",4,24,389,213,176
050,51,840,"Virginia","Winchester city",4,25,357,169,188
050,51,840,"Virginia","Winchester city",4,26,395,189,206
050,51,840,"Virginia","Winchester city",4,27,417,206,211
050,51,840,"Virginia","Winchester city",4,28,412,219,193
050,51,840,"Virginia","Winchester city",4,29,405,203,202
050,51,840,"Virginia","Winchester city",4,30,391,193,198
050,51,840,"Virginia","Winchester city",4,31,379,193,186
050,51,840,"Virginia","Winchester city",4,32,381,194,187
050,51,840,"Virginia","Winchester city",4,33,358,186,172
050,51,840,"Virginia","Winchester city",4,34,321,167,154
050,51,840,"Virginia","Winchester city",4,35,333,170,163
050,51,840,"Virginia","Winchester city",4,36,344,165,179
050,51,840,"Virginia","Winchester city",4,37,337,171,166
050,51,840,"Virginia","Winchester city",4,38,326,162,164
050,51,840,"Virginia","Winchester city",4,39,342,188,154
050,51,840,"Virginia","Winchester city",4,40,311,166,145
050,51,840,"Virginia","Winchester city",4,41,328,164,164
050,51,840,"Virginia","Winchester city",4,42,360,185,175
050,51,840,"Virginia","Winchester city",4,43,353,179,174
050,51,840,"Virginia","Winchester city",4,44,311,159,152
050,51,840,"Virginia","Winchester city",4,45,322,162,160
050,51,840,"Virginia","Winchester city",4,46,294,140,154
050,51,840,"Virginia","Winchester city",4,47,296,156,140
050,51,840,"Virginia","Winchester city",4,48,310,158,152
050,51,840,"Virginia","Winchester city",4,49,302,154,148
050,51,840,"Virginia","Winchester city",4,50,335,160,175
050,51,840,"Virginia","Winchester city",4,51,367,181,186
050,51,840,"Virginia","Winchester city",4,52,328,143,185
050,51,840,"Virginia","Winchester city",4,53,307,140,167
050,51,840,"Virginia","Winchester city",4,54,310,153,157
050,51,840,"Virginia","Winchester city",4,55,348,183,165
050,51,840,"Virginia","Winchester city",4,56,354,164,190
050,51,840,"Virginia","Winchester city",4,57,358,186,172
050,51,840,"Virginia","Winchester city",4,58,337,160,177
050,51,840,"Virginia","Winchester city",4,59,370,189,181
050,51,840,"Virginia","Winchester city",4,60,357,189,168
050,51,840,"Virginia","Winchester city",4,61,364,188,176
050,51,840,"Virginia","Winchester city",4,62,322,166,156
050,51,840,"Virginia","Winchester city",4,63,306,144,162
050,51,840,"Virginia","Winchester city",4,64,330,149,181
050,51,840,"Virginia","Winchester city",4,65,336,160,176
050,51,840,"Virginia","Winchester city",4,66,299,138,161
050,51,840,"Virginia","Winchester city",4,67,286,120,166
050,51,840,"Virginia","Winchester city",4,68,291,121,170
050,51,840,"Virginia","Winchester city",4,69,280,130,150
050,51,840,"Virginia","Winchester city",4,70,274,129,145
050,51,840,"Virginia","Winchester city",4,71,268,129,139
050,51,840,"Virginia","Winchester city",4,72,260,111,149
050,51,840,"Virginia","Winchester city",4,73,254,106,148
050,51,840,"Virginia","Winchester city",4,74,238,113,125
050,51,840,"Virginia","Winchester city",4,75,255,120,135
050,51,840,"Virginia","Winchester city",4,76,184,82,102
050,51,840,"Virginia","Winchester city",4,77,180,82,98
050,51,840,"Virginia","Winchester city",4,78,169,73,96
050,51,840,"Virginia","Winchester city",4,79,181,72,109
050,51,840,"Virginia","Winchester city",4,80,142,55,87
050,51,840,"Virginia","Winchester city",4,81,119,46,73
050,51,840,"Virginia","Winchester city",4,82,78,30,48
050,51,840,"Virginia","Winchester city",4,83,78,23,55
050,51,840,"Virginia","Winchester city",4,84,102,43,59
050,51,840,"Virginia","Winchester city",4,85,493,179,314
050,51,840,"Virginia","Winchester city",5,0,332,174,158
050,51,840,"Virginia","Winchester city",5,1,326,161,165
050,51,840,"Virginia","Winchester city",5,2,353,184,169
050,51,840,"Virginia","Winchester city",5,3,335,161,174
050,51,840,"Virginia","Winchester city",5,4,357,181,176
050,51,840,"Virginia","Winchester city",5,5,317,156,161
050,51,840,"Virginia","Winchester city",5,6,326,165,161
050,51,840,"Virginia","Winchester city",5,7,363,184,179
050,51,840,"Virginia","Winchester city",5,8,324,170,154
050,51,840,"Virginia","Winchester city",5,9,313,177,136
050,51,840,"Virginia","Winchester city",5,10,324,177,147
050,51,840,"Virginia","Winchester city",5,11,356,186,170
050,51,840,"Virginia","Winchester city",5,12,337,161,176
050,51,840,"Virginia","Winchester city",5,13,335,173,162
050,51,840,"Virginia","Winchester city",5,14,345,177,168
050,51,840,"Virginia","Winchester city",5,15,392,206,186
050,51,840,"Virginia","Winchester city",5,16,368,194,174
050,51,840,"Virginia","Winchester city",5,17,368,199,169
050,51,840,"Virginia","Winchester city",5,18,523,275,248
050,51,840,"Virginia","Winchester city",5,19,616,301,315
050,51,840,"Virginia","Winchester city",5,20,488,252,236
050,51,840,"Virginia","Winchester city",5,21,391,193,198
050,51,840,"Virginia","Winchester city",5,22,355,176,179
050,51,840,"Virginia","Winchester city",5,23,377,190,187
050,51,840,"Virginia","Winchester city",5,24,394,199,195
050,51,840,"Virginia","Winchester city",5,25,370,190,180
050,51,840,"Virginia","Winchester city",5,26,361,165,196
050,51,840,"Virginia","Winchester city",5,27,385,194,191
050,51,840,"Virginia","Winchester city",5,28,410,203,207
050,51,840,"Virginia","Winchester city",5,29,386,190,196
050,51,840,"Virginia","Winchester city",5,30,368,192,176
050,51,840,"Virginia","Winchester city",5,31,358,193,165
050,51,840,"Virginia","Winchester city",5,32,375,194,181
050,51,840,"Virginia","Winchester city",5,33,355,177,178
050,51,840,"Virginia","Winchester city",5,34,352,178,174
050,51,840,"Virginia","Winchester city",5,35,315,164,151
050,51,840,"Virginia","Winchester city",5,36,319,170,149
050,51,840,"Virginia","Winchester city",5,37,349,172,177
050,51,840,"Virginia","Winchester city",5,38,326,164,162
050,51,840,"Virginia","Winchester city",5,39,315,156,159
050,51,840,"Virginia","Winchester city",5,40,341,187,154
050,51,840,"Virginia","Winchester city",5,41,304,162,142
050,51,840,"Virginia","Winchester city",5,42,322,169,153
050,51,840,"Virginia","Winchester city",5,43,352,182,170
050,51,840,"Virginia","Winchester city",5,44,344,176,168
050,51,840,"Virginia","Winchester city",5,45,305,163,142
050,51,840,"Virginia","Winchester city",5,46,325,161,164
050,51,840,"Virginia","Winchester city",5,47,312,149,163
050,51,840,"Virginia","Winchester city",5,48,281,139,142
050,51,840,"Virginia","Winchester city",5,49,297,151,146
050,51,840,"Virginia","Winchester city",5,50,290,146,144
050,51,840,"Virginia","Winchester city",5,51,343,166,177
050,51,840,"Virginia","Winchester city",5,52,374,186,188
050,51,840,"Virginia","Winchester city",5,53,321,139,182
050,51,840,"Virginia","Winchester city",5,54,291,121,170
050,51,840,"Virginia","Winchester city",5,55,304,151,153
050,51,840,"Virginia","Winchester city",5,56,321,171,150
050,51,840,"Virginia","Winchester city",5,57,348,160,188
050,51,840,"Virginia","Winchester city",5,58,349,186,163
050,51,840,"Virginia","Winchester city",5,59,338,167,171
050,51,840,"Virginia","Winchester city",5,60,357,172,185
050,51,840,"Virginia","Winchester city",5,61,354,185,169
050,51,840,"Virginia","Winchester city",5,62,354,182,172
050,51,840,"Virginia","Winchester city",5,63,323,163,160
050,51,840,"Virginia","Winchester city",5,64,299,142,157
050,51,840,"Virginia","Winchester city",5,65,303,131,172
050,51,840,"Virginia","Winchester city",5,66,320,148,172
050,51,840,"Virginia","Winchester city",5,67,278,126,152
050,51,840,"Virginia","Winchester city",5,68,274,114,160
050,51,840,"Virginia","Winchester city",5,69,293,121,172
050,51,840,"Virginia","Winchester city",5,70,279,133,146
050,51,840,"Virginia","Winchester city",5,71,266,130,136
050,51,840,"Virginia","Winchester city",5,72,263,128,135
050,51,840,"Virginia","Winchester city",5,73,252,105,147
050,51,840,"Virginia","Winchester city",5,74,237,101,136
050,51,840,"Virginia","Winchester city",5,75,223,102,121
050,51,840,"Virginia","Winchester city",5,76,247,115,132
050,51,840,"Virginia","Winchester city",5,77,171,76,95
050,51,840,"Virginia","Winchester city",5,78,166,74,92
050,51,840,"Virginia","Winchester city",5,79,164,69,95
050,51,840,"Virginia","Winchester city",5,80,179,73,106
050,51,840,"Virginia","Winchester city",5,81,131,47,84
050,51,840,"Virginia","Winchester city",5,82,113,40,73
050,51,840,"Virginia","Winchester city",5,83,75,27,48
050,51,840,"Virginia","Winchester city",5,84,74,21,53
050,51,840,"Virginia","Winchester city",5,85,501,186,315

