"SUMLEV","STATE","COUNTY","STNAME","CTYNAME","YEAR","AGE","TOT_POP","TOT_MALE","TOT_FEMALE"
050,53,001,"Washington","Adams County",1,0,380,197,183
050,53,001,"Washington","Adams County",1,1,374,204,170
050,53,001,"Washington","Adams County",1,2,364,194,170
050,53,001,"Washington","Adams County",1,3,402,183,219
050,53,001,"Washington","Adams County",1,4,376,186,190
050,53,001,"Washington","Adams County",1,5,386,189,197
050,53,001,"Washington","Adams County",1,6,399,200,199
050,53,001,"Washington","Adams County",1,7,427,225,202
050,53,001,"Washington","Adams County",1,8,421,214,207
050,53,001,"Washington","Adams County",1,9,462,237,225
050,53,001,"Washington","Adams County",1,10,460,245,215
050,53,001,"Washington","Adams County",1,11,448,241,207
050,53,001,"Washington","Adams County",1,12,452,234,218
050,53,001,"Washington","Adams County",1,13,433,226,207
050,53,001,"Washington","Adams County",1,14,417,213,204
050,53,001,"Washington","Adams County",1,15,383,201,182
050,53,001,"Washington","Adams County",1,16,365,200,165
050,53,001,"Washington","Adams County",1,17,380,201,179
050,53,001,"Washington","Adams County",1,18,340,180,160
050,53,001,"Washington","Adams County",1,19,306,165,141
050,53,001,"Washington","Adams County",1,20,301,162,139
050,53,001,"Washington","Adams County",1,21,307,156,151
050,53,001,"Washington","Adams County",1,22,289,154,135
050,53,001,"Washington","Adams County",1,23,282,158,124
050,53,001,"Washington","Adams County",1,24,260,142,118
050,53,001,"Washington","Adams County",1,25,277,150,127
050,53,001,"Washington","Adams County",1,26,259,139,120
050,53,001,"Washington","Adams County",1,27,245,126,119
050,53,001,"Washington","Adams County",1,28,277,137,140
050,53,001,"Washington","Adams County",1,29,238,120,118
050,53,001,"Washington","Adams County",1,30,235,122,113
050,53,001,"Washington","Adams County",1,31,238,122,116
050,53,001,"Washington","Adams County",1,32,250,133,117
050,53,001,"Washington","Adams County",1,33,271,154,117
050,53,001,"Washington","Adams County",1,34,245,134,111
050,53,001,"Washington","Adams County",1,35,233,126,107
050,53,001,"Washington","Adams County",1,36,210,106,104
050,53,001,"Washington","Adams County",1,37,223,115,108
050,53,001,"Washington","Adams County",1,38,244,120,124
050,53,001,"Washington","Adams County",1,39,235,112,123
050,53,001,"Washington","Adams County",1,40,217,117,100
050,53,001,"Washington","Adams County",1,41,230,111,119
050,53,001,"Washington","Adams County",1,42,220,107,113
050,53,001,"Washington","Adams County",1,43,243,131,112
050,53,001,"Washington","Adams County",1,44,222,112,110
050,53,001,"Washington","Adams County",1,45,212,102,110
050,53,001,"Washington","Adams County",1,46,208,112,96
050,53,001,"Washington","Adams County",1,47,192,102,90
050,53,001,"Washington","Adams County",1,48,194,96,98
050,53,001,"Washington","Adams County",1,49,208,103,105
050,53,001,"Washington","Adams County",1,50,199,109,90
050,53,001,"Washington","Adams County",1,51,209,107,102
050,53,001,"Washington","Adams County",1,52,202,108,94
050,53,001,"Washington","Adams County",1,53,210,118,92
050,53,001,"Washington","Adams County",1,54,186,96,90
050,53,001,"Washington","Adams County",1,55,199,102,97
050,53,001,"Washington","Adams County",1,56,209,113,96
050,53,001,"Washington","Adams County",1,57,208,114,94
050,53,001,"Washington","Adams County",1,58,201,93,108
050,53,001,"Washington","Adams County",1,59,195,82,113
050,53,001,"Washington","Adams County",1,60,199,94,105
050,53,001,"Washington","Adams County",1,61,197,100,97
050,53,001,"Washington","Adams County",1,62,198,101,97
050,53,001,"Washington","Adams County",1,63,202,101,101
050,53,001,"Washington","Adams County",1,64,194,97,97
050,53,001,"Washington","Adams County",1,65,176,82,94
050,53,001,"Washington","Adams County",1,66,174,87,87
050,53,001,"Washington","Adams County",1,67,174,91,83
050,53,001,"Washington","Adams County",1,68,178,90,88
050,53,001,"Washington","Adams County",1,69,150,74,76
050,53,001,"Washington","Adams County",1,70,133,60,73
050,53,001,"Washington","Adams County",1,71,111,53,58
050,53,001,"Washington","Adams County",1,72,136,70,66
050,53,001,"Washington","Adams County",1,73,128,66,62
050,53,001,"Washington","Adams County",1,74,88,43,45
050,53,001,"Washington","Adams County",1,75,99,51,48
050,53,001,"Washington","Adams County",1,76,94,48,46
050,53,001,"Washington","Adams County",1,77,76,37,39
050,53,001,"Washington","Adams County",1,78,61,31,30
050,53,001,"Washington","Adams County",1,79,68,33,35
050,53,001,"Washington","Adams County",1,80,68,35,33
050,53,001,"Washington","Adams County",1,81,59,27,32
050,53,001,"Washington","Adams County",1,82,46,16,30
050,53,001,"Washington","Adams County",1,83,47,21,26
050,53,001,"Washington","Adams County",1,84,44,20,24
050,53,001,"Washington","Adams County",1,85,251,111,140
050,53,001,"Washington","Adams County",2,0,367,187,180
050,53,001,"Washington","Adams County",2,1,377,203,174
050,53,001,"Washington","Adams County",2,2,367,195,172
050,53,001,"Washington","Adams County",2,3,387,181,206
050,53,001,"Washington","Adams County",2,4,381,184,197
050,53,001,"Washington","Adams County",2,5,385,190,195
050,53,001,"Washington","Adams County",2,6,398,198,200
050,53,001,"Washington","Adams County",2,7,416,217,199
050,53,001,"Washington","Adams County",2,8,420,215,205
050,53,001,"Washington","Adams County",2,9,454,234,220
050,53,001,"Washington","Adams County",2,10,462,243,219
050,53,001,"Washington","Adams County",2,11,444,239,205
050,53,001,"Washington","Adams County",2,12,450,236,214
050,53,001,"Washington","Adams County",2,13,433,227,206
050,53,001,"Washington","Adams County",2,14,417,214,203
050,53,001,"Washington","Adams County",2,15,390,203,187
050,53,001,"Washington","Adams County",2,16,370,201,169
050,53,001,"Washington","Adams County",2,17,376,200,176
050,53,001,"Washington","Adams County",2,18,340,180,160
050,53,001,"Washington","Adams County",2,19,307,165,142
050,53,001,"Washington","Adams County",2,20,304,163,141
050,53,001,"Washington","Adams County",2,21,305,156,149
050,53,001,"Washington","Adams County",2,22,299,158,141
050,53,001,"Washington","Adams County",2,23,280,155,125
050,53,001,"Washington","Adams County",2,24,263,144,119
050,53,001,"Washington","Adams County",2,25,274,149,125
050,53,001,"Washington","Adams County",2,26,263,143,120
050,53,001,"Washington","Adams County",2,27,247,127,120
050,53,001,"Washington","Adams County",2,28,269,134,135
050,53,001,"Washington","Adams County",2,29,244,121,123
050,53,001,"Washington","Adams County",2,30,237,122,115
050,53,001,"Washington","Adams County",2,31,240,124,116
050,53,001,"Washington","Adams County",2,32,247,129,118
050,53,001,"Washington","Adams County",2,33,266,150,116
050,53,001,"Washington","Adams County",2,34,254,142,112
050,53,001,"Washington","Adams County",2,35,233,127,106
050,53,001,"Washington","Adams County",2,36,213,109,104
050,53,001,"Washington","Adams County",2,37,221,113,108
050,53,001,"Washington","Adams County",2,38,242,122,120
050,53,001,"Washington","Adams County",2,39,234,114,120
050,53,001,"Washington","Adams County",2,40,225,117,108
050,53,001,"Washington","Adams County",2,41,224,111,113
050,53,001,"Washington","Adams County",2,42,221,107,114
050,53,001,"Washington","Adams County",2,43,237,125,112
050,53,001,"Washington","Adams County",2,44,225,116,109
050,53,001,"Washington","Adams County",2,45,216,106,110
050,53,001,"Washington","Adams County",2,46,209,110,99
050,53,001,"Washington","Adams County",2,47,193,103,90
050,53,001,"Washington","Adams County",2,48,191,95,96
050,53,001,"Washington","Adams County",2,49,204,101,103
050,53,001,"Washington","Adams County",2,50,197,106,91
050,53,001,"Washington","Adams County",2,51,203,105,98
050,53,001,"Washington","Adams County",2,52,202,107,95
050,53,001,"Washington","Adams County",2,53,207,114,93
050,53,001,"Washington","Adams County",2,54,192,102,90
050,53,001,"Washington","Adams County",2,55,194,99,95
050,53,001,"Washington","Adams County",2,56,207,110,97
050,53,001,"Washington","Adams County",2,57,206,112,94
050,53,001,"Washington","Adams County",2,58,201,97,104
050,53,001,"Washington","Adams County",2,59,195,84,111
050,53,001,"Washington","Adams County",2,60,201,93,108
050,53,001,"Washington","Adams County",2,61,199,99,100
050,53,001,"Washington","Adams County",2,62,199,100,99
050,53,001,"Washington","Adams County",2,63,201,101,100
050,53,001,"Washington","Adams County",2,64,191,95,96
050,53,001,"Washington","Adams County",2,65,180,85,95
050,53,001,"Washington","Adams County",2,66,175,86,89
050,53,001,"Washington","Adams County",2,67,172,90,82
050,53,001,"Washington","Adams County",2,68,175,89,86
050,53,001,"Washington","Adams County",2,69,156,77,79
050,53,001,"Washington","Adams County",2,70,135,62,73
050,53,001,"Washington","Adams County",2,71,118,55,63
050,53,001,"Washington","Adams County",2,72,130,66,64
050,53,001,"Washington","Adams County",2,73,134,69,65
050,53,001,"Washington","Adams County",2,74,90,44,46
050,53,001,"Washington","Adams County",2,75,95,48,47
050,53,001,"Washington","Adams County",2,76,94,48,46
050,53,001,"Washington","Adams County",2,77,83,41,42
050,53,001,"Washington","Adams County",2,78,63,31,32
050,53,001,"Washington","Adams County",2,79,66,32,34
050,53,001,"Washington","Adams County",2,80,67,34,33
050,53,001,"Washington","Adams County",2,81,61,29,32
050,53,001,"Washington","Adams County",2,82,51,19,32
050,53,001,"Washington","Adams County",2,83,47,21,26
050,53,001,"Washington","Adams County",2,84,42,18,24
050,53,001,"Washington","Adams County",2,85,257,115,142
050,53,001,"Washington","Adams County",3,0,368,173,195
050,53,001,"Washington","Adams County",3,1,370,185,185
050,53,001,"Washington","Adams County",3,2,367,191,176
050,53,001,"Washington","Adams County",3,3,361,204,157
050,53,001,"Washington","Adams County",3,4,376,183,193
050,53,001,"Washington","Adams County",3,5,382,192,190
050,53,001,"Washington","Adams County",3,6,394,197,197
050,53,001,"Washington","Adams County",3,7,407,199,208
050,53,001,"Washington","Adams County",3,8,410,211,199
050,53,001,"Washington","Adams County",3,9,414,209,205
050,53,001,"Washington","Adams County",3,10,469,244,225
050,53,001,"Washington","Adams County",3,11,457,243,214
050,53,001,"Washington","Adams County",3,12,452,243,209
050,53,001,"Washington","Adams County",3,13,445,228,217
050,53,001,"Washington","Adams County",3,14,427,225,202
050,53,001,"Washington","Adams County",3,15,421,216,205
050,53,001,"Washington","Adams County",3,16,401,209,192
050,53,001,"Washington","Adams County",3,17,366,202,164
050,53,001,"Washington","Adams County",3,18,355,197,158
050,53,001,"Washington","Adams County",3,19,317,178,139
050,53,001,"Washington","Adams County",3,20,306,161,145
050,53,001,"Washington","Adams County",3,21,298,162,136
050,53,001,"Washington","Adams County",3,22,308,161,147
050,53,001,"Washington","Adams County",3,23,289,151,138
050,53,001,"Washington","Adams County",3,24,270,147,123
050,53,001,"Washington","Adams County",3,25,252,133,119
050,53,001,"Washington","Adams County",3,26,265,144,121
050,53,001,"Washington","Adams County",3,27,241,134,107
050,53,001,"Washington","Adams County",3,28,249,125,124
050,53,001,"Washington","Adams County",3,29,261,128,133
050,53,001,"Washington","Adams County",3,30,242,127,115
050,53,001,"Washington","Adams County",3,31,243,131,112
050,53,001,"Washington","Adams County",3,32,244,117,127
050,53,001,"Washington","Adams County",3,33,245,124,121
050,53,001,"Washington","Adams County",3,34,267,148,119
050,53,001,"Washington","Adams County",3,35,248,138,110
050,53,001,"Washington","Adams County",3,36,229,127,102
050,53,001,"Washington","Adams County",3,37,219,116,103
050,53,001,"Washington","Adams County",3,38,230,120,110
050,53,001,"Washington","Adams County",3,39,243,123,120
050,53,001,"Washington","Adams County",3,40,225,109,116
050,53,001,"Washington","Adams County",3,41,217,109,108
050,53,001,"Washington","Adams County",3,42,217,108,109
050,53,001,"Washington","Adams County",3,43,213,102,111
050,53,001,"Washington","Adams County",3,44,240,126,114
050,53,001,"Washington","Adams County",3,45,227,122,105
050,53,001,"Washington","Adams County",3,46,210,105,105
050,53,001,"Washington","Adams County",3,47,194,99,95
050,53,001,"Washington","Adams County",3,48,187,97,90
050,53,001,"Washington","Adams County",3,49,182,87,95
050,53,001,"Washington","Adams County",3,50,206,103,103
050,53,001,"Washington","Adams County",3,51,193,109,84
050,53,001,"Washington","Adams County",3,52,206,106,100
050,53,001,"Washington","Adams County",3,53,198,106,92
050,53,001,"Washington","Adams County",3,54,203,108,95
050,53,001,"Washington","Adams County",3,55,187,101,86
050,53,001,"Washington","Adams County",3,56,200,101,99
050,53,001,"Washington","Adams County",3,57,212,112,100
050,53,001,"Washington","Adams County",3,58,201,105,96
050,53,001,"Washington","Adams County",3,59,194,93,101
050,53,001,"Washington","Adams County",3,60,189,84,105
050,53,001,"Washington","Adams County",3,61,202,95,107
050,53,001,"Washington","Adams County",3,62,197,98,99
050,53,001,"Washington","Adams County",3,63,197,98,99
050,53,001,"Washington","Adams County",3,64,195,97,98
050,53,001,"Washington","Adams County",3,65,185,94,91
050,53,001,"Washington","Adams County",3,66,174,82,92
050,53,001,"Washington","Adams County",3,67,169,83,86
050,53,001,"Washington","Adams County",3,68,164,83,81
050,53,001,"Washington","Adams County",3,69,165,85,80
050,53,001,"Washington","Adams County",3,70,154,75,79
050,53,001,"Washington","Adams County",3,71,131,60,71
050,53,001,"Washington","Adams County",3,72,115,51,64
050,53,001,"Washington","Adams County",3,73,130,66,64
050,53,001,"Washington","Adams County",3,74,127,66,61
050,53,001,"Washington","Adams County",3,75,86,43,43
050,53,001,"Washington","Adams County",3,76,93,48,45
050,53,001,"Washington","Adams County",3,77,90,47,43
050,53,001,"Washington","Adams County",3,78,79,36,43
050,53,001,"Washington","Adams County",3,79,61,28,33
050,53,001,"Washington","Adams County",3,80,61,29,32
050,53,001,"Washington","Adams County",3,81,62,30,32
050,53,001,"Washington","Adams County",3,82,59,28,31
050,53,001,"Washington","Adams County",3,83,47,18,29
050,53,001,"Washington","Adams County",3,84,36,16,20
050,53,001,"Washington","Adams County",3,85,259,114,145
050,53,001,"Washington","Adams County",4,0,350,173,177
050,53,001,"Washington","Adams County",4,1,381,184,197
050,53,001,"Washington","Adams County",4,2,359,187,172
050,53,001,"Washington","Adams County",4,3,392,200,192
050,53,001,"Washington","Adams County",4,4,350,199,151
050,53,001,"Washington","Adams County",4,5,400,195,205
050,53,001,"Washington","Adams County",4,6,382,193,189
050,53,001,"Washington","Adams County",4,7,392,197,195
050,53,001,"Washington","Adams County",4,8,415,200,215
050,53,001,"Washington","Adams County",4,9,412,215,197
050,53,001,"Washington","Adams County",4,10,430,215,215
050,53,001,"Washington","Adams County",4,11,476,243,233
050,53,001,"Washington","Adams County",4,12,461,246,215
050,53,001,"Washington","Adams County",4,13,448,238,210
050,53,001,"Washington","Adams County",4,14,426,220,206
050,53,001,"Washington","Adams County",4,15,429,219,210
050,53,001,"Washington","Adams County",4,16,420,218,202
050,53,001,"Washington","Adams County",4,17,402,212,190
050,53,001,"Washington","Adams County",4,18,357,196,161
050,53,001,"Washington","Adams County",4,19,326,179,147
050,53,001,"Washington","Adams County",4,20,321,171,150
050,53,001,"Washington","Adams County",4,21,285,148,137
050,53,001,"Washington","Adams County",4,22,293,153,140
050,53,001,"Washington","Adams County",4,23,287,147,140
050,53,001,"Washington","Adams County",4,24,292,151,141
050,53,001,"Washington","Adams County",4,25,280,148,132
050,53,001,"Washington","Adams County",4,26,269,140,129
050,53,001,"Washington","Adams County",4,27,267,146,121
050,53,001,"Washington","Adams County",4,28,229,129,100
050,53,001,"Washington","Adams County",4,29,251,133,118
050,53,001,"Washington","Adams County",4,30,266,126,140
050,53,001,"Washington","Adams County",4,31,248,122,126
050,53,001,"Washington","Adams County",4,32,250,138,112
050,53,001,"Washington","Adams County",4,33,243,118,125
050,53,001,"Washington","Adams County",4,34,259,133,126
050,53,001,"Washington","Adams County",4,35,278,155,123
050,53,001,"Washington","Adams County",4,36,244,138,106
050,53,001,"Washington","Adams County",4,37,230,128,102
050,53,001,"Washington","Adams County",4,38,229,122,107
050,53,001,"Washington","Adams County",4,39,224,117,107
050,53,001,"Washington","Adams County",4,40,251,128,123
050,53,001,"Washington","Adams County",4,41,241,117,124
050,53,001,"Washington","Adams County",4,42,223,112,111
050,53,001,"Washington","Adams County",4,43,219,111,108
050,53,001,"Washington","Adams County",4,44,223,111,112
050,53,001,"Washington","Adams County",4,45,237,111,126
050,53,001,"Washington","Adams County",4,46,228,116,112
050,53,001,"Washington","Adams County",4,47,214,110,104
050,53,001,"Washington","Adams County",4,48,189,96,93
050,53,001,"Washington","Adams County",4,49,187,93,94
050,53,001,"Washington","Adams County",4,50,179,92,87
050,53,001,"Washington","Adams County",4,51,204,102,102
050,53,001,"Washington","Adams County",4,52,197,112,85
050,53,001,"Washington","Adams County",4,53,198,104,94
050,53,001,"Washington","Adams County",4,54,193,102,91
050,53,001,"Washington","Adams County",4,55,206,107,99
050,53,001,"Washington","Adams County",4,56,188,100,88
050,53,001,"Washington","Adams County",4,57,197,99,98
050,53,001,"Washington","Adams County",4,58,206,106,100
050,53,001,"Washington","Adams County",4,59,206,107,99
050,53,001,"Washington","Adams County",4,60,196,95,101
050,53,001,"Washington","Adams County",4,61,183,81,102
050,53,001,"Washington","Adams County",4,62,191,88,103
050,53,001,"Washington","Adams County",4,63,189,93,96
050,53,001,"Washington","Adams County",4,64,189,94,95
050,53,001,"Washington","Adams County",4,65,195,99,96
050,53,001,"Washington","Adams County",4,66,184,94,90
050,53,001,"Washington","Adams County",4,67,166,77,89
050,53,001,"Washington","Adams County",4,68,155,75,80
050,53,001,"Washington","Adams County",4,69,145,71,74
050,53,001,"Washington","Adams County",4,70,171,83,88
050,53,001,"Washington","Adams County",4,71,145,73,72
050,53,001,"Washington","Adams County",4,72,127,56,71
050,53,001,"Washington","Adams County",4,73,114,52,62
050,53,001,"Washington","Adams County",4,74,119,60,59
050,53,001,"Washington","Adams County",4,75,125,63,62
050,53,001,"Washington","Adams County",4,76,84,41,43
050,53,001,"Washington","Adams County",4,77,90,47,43
050,53,001,"Washington","Adams County",4,78,84,40,44
050,53,001,"Washington","Adams County",4,79,72,31,41
050,53,001,"Washington","Adams County",4,80,58,26,32
050,53,001,"Washington","Adams County",4,81,55,24,31
050,53,001,"Washington","Adams County",4,82,63,29,34
050,53,001,"Washington","Adams County",4,83,59,29,30
050,53,001,"Washington","Adams County",4,84,40,15,25
050,53,001,"Washington","Adams County",4,85,260,113,147
050,53,001,"Washington","Adams County",5,0,349,173,176
050,53,001,"Washington","Adams County",5,1,344,166,178
050,53,001,"Washington","Adams County",5,2,381,180,201
050,53,001,"Washington","Adams County",5,3,351,173,178
050,53,001,"Washington","Adams County",5,4,384,193,191
050,53,001,"Washington","Adams County",5,5,347,199,148
050,53,001,"Washington","Adams County",5,6,400,188,212
050,53,001,"Washington","Adams County",5,7,368,171,197
050,53,001,"Washington","Adams County",5,8,384,197,187
050,53,001,"Washington","Adams County",5,9,410,199,211
050,53,001,"Washington","Adams County",5,10,407,209,198
050,53,001,"Washington","Adams County",5,11,429,214,215
050,53,001,"Washington","Adams County",5,12,461,236,225
050,53,001,"Washington","Adams County",5,13,449,246,203
050,53,001,"Washington","Adams County",5,14,441,232,209
050,53,001,"Washington","Adams County",5,15,429,220,209
050,53,001,"Washington","Adams County",5,16,420,214,206
050,53,001,"Washington","Adams County",5,17,425,219,206
050,53,001,"Washington","Adams County",5,18,379,199,180
050,53,001,"Washington","Adams County",5,19,321,176,145
050,53,001,"Washington","Adams County",5,20,335,182,153
050,53,001,"Washington","Adams County",5,21,317,165,152
050,53,001,"Washington","Adams County",5,22,286,148,138
050,53,001,"Washington","Adams County",5,23,284,151,133
050,53,001,"Washington","Adams County",5,24,286,155,131
050,53,001,"Washington","Adams County",5,25,278,140,138
050,53,001,"Washington","Adams County",5,26,255,136,119
050,53,001,"Washington","Adams County",5,27,252,128,124
050,53,001,"Washington","Adams County",5,28,270,147,123
050,53,001,"Washington","Adams County",5,29,237,129,108
050,53,001,"Washington","Adams County",5,30,242,131,111
050,53,001,"Washington","Adams County",5,31,258,124,134
050,53,001,"Washington","Adams County",5,32,250,127,123
050,53,001,"Washington","Adams County",5,33,250,129,121
050,53,001,"Washington","Adams County",5,34,244,123,121
050,53,001,"Washington","Adams County",5,35,245,131,114
050,53,001,"Washington","Adams County",5,36,285,154,131
050,53,001,"Washington","Adams County",5,37,245,137,108
050,53,001,"Washington","Adams County",5,38,230,129,101
050,53,001,"Washington","Adams County",5,39,222,119,103
050,53,001,"Washington","Adams County",5,40,220,114,106
050,53,001,"Washington","Adams County",5,41,252,126,126
050,53,001,"Washington","Adams County",5,42,239,115,124
050,53,001,"Washington","Adams County",5,43,215,108,107
050,53,001,"Washington","Adams County",5,44,216,107,109
050,53,001,"Washington","Adams County",5,45,227,109,118
050,53,001,"Washington","Adams County",5,46,235,114,121
050,53,001,"Washington","Adams County",5,47,226,112,114
050,53,001,"Washington","Adams County",5,48,210,103,107
050,53,001,"Washington","Adams County",5,49,193,100,93
050,53,001,"Washington","Adams County",5,50,184,91,93
050,53,001,"Washington","Adams County",5,51,175,89,86
050,53,001,"Washington","Adams County",5,52,213,110,103
050,53,001,"Washington","Adams County",5,53,191,110,81
050,53,001,"Washington","Adams County",5,54,199,103,96
050,53,001,"Washington","Adams County",5,55,188,99,89
050,53,001,"Washington","Adams County",5,56,203,104,99
050,53,001,"Washington","Adams County",5,57,184,98,86
050,53,001,"Washington","Adams County",5,58,191,97,94
050,53,001,"Washington","Adams County",5,59,210,108,102
050,53,001,"Washington","Adams County",5,60,203,106,97
050,53,001,"Washington","Adams County",5,61,190,94,96
050,53,001,"Washington","Adams County",5,62,183,81,102
050,53,001,"Washington","Adams County",5,63,187,84,103
050,53,001,"Washington","Adams County",5,64,189,93,96
050,53,001,"Washington","Adams County",5,65,181,92,89
050,53,001,"Washington","Adams County",5,66,186,94,92
050,53,001,"Washington","Adams County",5,67,170,85,85
050,53,001,"Washington","Adams County",5,68,161,74,87
050,53,001,"Washington","Adams County",5,69,148,71,77
050,53,001,"Washington","Adams County",5,70,145,71,74
050,53,001,"Washington","Adams County",5,71,168,83,85
050,53,001,"Washington","Adams County",5,72,138,66,72
050,53,001,"Washington","Adams County",5,73,129,57,72
050,53,001,"Washington","Adams County",5,74,106,47,59
050,53,001,"Washington","Adams County",5,75,116,58,58
050,53,001,"Washington","Adams County",5,76,119,62,57
050,53,001,"Washington","Adams County",5,77,79,38,41
050,53,001,"Washington","Adams County",5,78,86,42,44
050,53,001,"Washington","Adams County",5,79,79,36,43
050,53,001,"Washington","Adams County",5,80,64,26,38
050,53,001,"Washington","Adams County",5,81,51,20,31
050,53,001,"Washington","Adams County",5,82,55,23,32
050,53,001,"Washington","Adams County",5,83,58,28,30
050,53,001,"Washington","Adams County",5,84,48,22,26
050,53,001,"Washington","Adams County",5,85,260,108,152
050,53,003,"Washington","Asotin County",1,0,222,113,109
050,53,003,"Washington","Asotin County",1,1,226,116,110
050,53,003,"Washington","Asotin County",1,2,231,118,113
050,53,003,"Washington","Asotin County",1,3,209,119,90
050,53,003,"Washington","Asotin County",1,4,225,118,107
050,53,003,"Washington","Asotin County",1,5,244,130,114
050,53,003,"Washington","Asotin County",1,6,248,129,119
050,53,003,"Washington","Asotin County",1,7,271,145,126
050,53,003,"Washington","Asotin County",1,8,254,122,132
050,53,003,"Washington","Asotin County",1,9,239,118,121
050,53,003,"Washington","Asotin County",1,10,242,111,131
050,53,003,"Washington","Asotin County",1,11,256,123,133
050,53,003,"Washington","Asotin County",1,12,268,124,144
050,53,003,"Washington","Asotin County",1,13,274,146,128
050,53,003,"Washington","Asotin County",1,14,283,145,138
050,53,003,"Washington","Asotin County",1,15,276,135,141
050,53,003,"Washington","Asotin County",1,16,277,139,138
050,53,003,"Washington","Asotin County",1,17,263,129,134
050,53,003,"Washington","Asotin County",1,18,234,120,114
050,53,003,"Washington","Asotin County",1,19,200,102,98
050,53,003,"Washington","Asotin County",1,20,198,98,100
050,53,003,"Washington","Asotin County",1,21,199,107,92
050,53,003,"Washington","Asotin County",1,22,200,104,96
050,53,003,"Washington","Asotin County",1,23,217,110,107
050,53,003,"Washington","Asotin County",1,24,243,113,130
050,53,003,"Washington","Asotin County",1,25,235,116,119
050,53,003,"Washington","Asotin County",1,26,218,112,106
050,53,003,"Washington","Asotin County",1,27,253,125,128
050,53,003,"Washington","Asotin County",1,28,245,115,130
050,53,003,"Washington","Asotin County",1,29,258,125,133
050,53,003,"Washington","Asotin County",1,30,218,109,109
050,53,003,"Washington","Asotin County",1,31,213,112,101
050,53,003,"Washington","Asotin County",1,32,233,114,119
050,53,003,"Washington","Asotin County",1,33,235,120,115
050,53,003,"Washington","Asotin County",1,34,248,122,126
050,53,003,"Washington","Asotin County",1,35,264,132,132
050,53,003,"Washington","Asotin County",1,36,282,125,157
050,53,003,"Washington","Asotin County",1,37,277,131,146
050,53,003,"Washington","Asotin County",1,38,258,129,129
050,53,003,"Washington","Asotin County",1,39,265,140,125
050,53,003,"Washington","Asotin County",1,40,253,135,118
050,53,003,"Washington","Asotin County",1,41,234,119,115
050,53,003,"Washington","Asotin County",1,42,264,137,127
050,53,003,"Washington","Asotin County",1,43,239,113,126
050,53,003,"Washington","Asotin County",1,44,249,115,134
050,53,003,"Washington","Asotin County",1,45,241,129,112
050,53,003,"Washington","Asotin County",1,46,253,130,123
050,53,003,"Washington","Asotin County",1,47,216,105,111
050,53,003,"Washington","Asotin County",1,48,227,110,117
050,53,003,"Washington","Asotin County",1,49,275,132,143
050,53,003,"Washington","Asotin County",1,50,268,133,135
050,53,003,"Washington","Asotin County",1,51,280,140,140
050,53,003,"Washington","Asotin County",1,52,242,124,118
050,53,003,"Washington","Asotin County",1,53,251,118,133
050,53,003,"Washington","Asotin County",1,54,268,138,130
050,53,003,"Washington","Asotin County",1,55,294,151,143
050,53,003,"Washington","Asotin County",1,56,304,150,154
050,53,003,"Washington","Asotin County",1,57,331,170,161
050,53,003,"Washington","Asotin County",1,58,349,172,177
050,53,003,"Washington","Asotin County",1,59,368,172,196
050,53,003,"Washington","Asotin County",1,60,342,156,186
050,53,003,"Washington","Asotin County",1,61,363,163,200
050,53,003,"Washington","Asotin County",1,62,389,181,208
050,53,003,"Washington","Asotin County",1,63,373,171,202
050,53,003,"Washington","Asotin County",1,64,371,173,198
050,53,003,"Washington","Asotin County",1,65,377,189,188
050,53,003,"Washington","Asotin County",1,66,340,175,165
050,53,003,"Washington","Asotin County",1,67,339,175,164
050,53,003,"Washington","Asotin County",1,68,313,164,149
050,53,003,"Washington","Asotin County",1,69,302,156,146
050,53,003,"Washington","Asotin County",1,70,286,132,154
050,53,003,"Washington","Asotin County",1,71,275,125,150
050,53,003,"Washington","Asotin County",1,72,292,128,164
050,53,003,"Washington","Asotin County",1,73,294,137,157
050,53,003,"Washington","Asotin County",1,74,205,92,113
050,53,003,"Washington","Asotin County",1,75,212,102,110
050,53,003,"Washington","Asotin County",1,76,227,122,105
050,53,003,"Washington","Asotin County",1,77,246,119,127
050,53,003,"Washington","Asotin County",1,78,178,80,98
050,53,003,"Washington","Asotin County",1,79,179,80,99
050,53,003,"Washington","Asotin County",1,80,154,67,87
050,53,003,"Washington","Asotin County",1,81,142,73,69
050,53,003,"Washington","Asotin County",1,82,134,64,70
050,53,003,"Washington","Asotin County",1,83,119,58,61
050,53,003,"Washington","Asotin County",1,84,111,49,62
050,53,003,"Washington","Asotin County",1,85,616,271,345
050,53,003,"Washington","Asotin County",2,0,221,115,106
050,53,003,"Washington","Asotin County",2,1,224,115,109
050,53,003,"Washington","Asotin County",2,2,229,119,110
050,53,003,"Washington","Asotin County",2,3,213,119,94
050,53,003,"Washington","Asotin County",2,4,222,119,103
050,53,003,"Washington","Asotin County",2,5,236,125,111
050,53,003,"Washington","Asotin County",2,6,246,128,118
050,53,003,"Washington","Asotin County",2,7,265,141,124
050,53,003,"Washington","Asotin County",2,8,257,128,129
050,53,003,"Washington","Asotin County",2,9,245,120,125
050,53,003,"Washington","Asotin County",2,10,240,114,126
050,53,003,"Washington","Asotin County",2,11,253,120,133
050,53,003,"Washington","Asotin County",2,12,269,126,143
050,53,003,"Washington","Asotin County",2,13,273,140,133
050,53,003,"Washington","Asotin County",2,14,283,146,137
050,53,003,"Washington","Asotin County",2,15,278,136,142
050,53,003,"Washington","Asotin County",2,16,278,138,140
050,53,003,"Washington","Asotin County",2,17,267,130,137
050,53,003,"Washington","Asotin County",2,18,233,119,114
050,53,003,"Washington","Asotin County",2,19,198,102,96
050,53,003,"Washington","Asotin County",2,20,207,103,104
050,53,003,"Washington","Asotin County",2,21,200,104,96
050,53,003,"Washington","Asotin County",2,22,204,106,98
050,53,003,"Washington","Asotin County",2,23,216,109,107
050,53,003,"Washington","Asotin County",2,24,240,115,125
050,53,003,"Washington","Asotin County",2,25,240,115,125
050,53,003,"Washington","Asotin County",2,26,224,114,110
050,53,003,"Washington","Asotin County",2,27,242,120,122
050,53,003,"Washington","Asotin County",2,28,248,119,129
050,53,003,"Washington","Asotin County",2,29,253,121,132
050,53,003,"Washington","Asotin County",2,30,227,113,114
050,53,003,"Washington","Asotin County",2,31,213,109,104
050,53,003,"Washington","Asotin County",2,32,229,115,114
050,53,003,"Washington","Asotin County",2,33,234,117,117
050,53,003,"Washington","Asotin County",2,34,243,121,122
050,53,003,"Washington","Asotin County",2,35,262,130,132
050,53,003,"Washington","Asotin County",2,36,275,126,149
050,53,003,"Washington","Asotin County",2,37,279,129,150
050,53,003,"Washington","Asotin County",2,38,265,130,135
050,53,003,"Washington","Asotin County",2,39,261,135,126
050,53,003,"Washington","Asotin County",2,40,258,138,120
050,53,003,"Washington","Asotin County",2,41,240,124,116
050,53,003,"Washington","Asotin County",2,42,255,133,122
050,53,003,"Washington","Asotin County",2,43,250,121,129
050,53,003,"Washington","Asotin County",2,44,243,113,130
050,53,003,"Washington","Asotin County",2,45,243,126,117
050,53,003,"Washington","Asotin County",2,46,249,128,121
050,53,003,"Washington","Asotin County",2,47,224,109,115
050,53,003,"Washington","Asotin County",2,48,225,109,116
050,53,003,"Washington","Asotin County",2,49,263,127,136
050,53,003,"Washington","Asotin County",2,50,269,133,136
050,53,003,"Washington","Asotin County",2,51,272,136,136
050,53,003,"Washington","Asotin County",2,52,250,127,123
050,53,003,"Washington","Asotin County",2,53,251,121,130
050,53,003,"Washington","Asotin County",2,54,265,134,131
050,53,003,"Washington","Asotin County",2,55,289,148,141
050,53,003,"Washington","Asotin County",2,56,305,152,153
050,53,003,"Washington","Asotin County",2,57,330,168,162
050,53,003,"Washington","Asotin County",2,58,347,173,174
050,53,003,"Washington","Asotin County",2,59,368,173,195
050,53,003,"Washington","Asotin County",2,60,349,161,188
050,53,003,"Washington","Asotin County",2,61,359,164,195
050,53,003,"Washington","Asotin County",2,62,383,176,207
050,53,003,"Washington","Asotin County",2,63,381,176,205
050,53,003,"Washington","Asotin County",2,64,370,171,199
050,53,003,"Washington","Asotin County",2,65,377,185,192
050,53,003,"Washington","Asotin County",2,66,347,177,170
050,53,003,"Washington","Asotin County",2,67,338,174,164
050,53,003,"Washington","Asotin County",2,68,320,167,153
050,53,003,"Washington","Asotin County",2,69,304,156,148
050,53,003,"Washington","Asotin County",2,70,288,135,153
050,53,003,"Washington","Asotin County",2,71,277,126,151
050,53,003,"Washington","Asotin County",2,72,282,124,158
050,53,003,"Washington","Asotin County",2,73,310,142,168
050,53,003,"Washington","Asotin County",2,74,211,95,116
050,53,003,"Washington","Asotin County",2,75,210,100,110
050,53,003,"Washington","Asotin County",2,76,222,117,105
050,53,003,"Washington","Asotin County",2,77,249,122,127
050,53,003,"Washington","Asotin County",2,78,191,87,104
050,53,003,"Washington","Asotin County",2,79,176,78,98
050,53,003,"Washington","Asotin County",2,80,159,69,90
050,53,003,"Washington","Asotin County",2,81,143,70,73
050,53,003,"Washington","Asotin County",2,82,135,67,68
050,53,003,"Washington","Asotin County",2,83,119,57,62
050,53,003,"Washington","Asotin County",2,84,109,48,61
050,53,003,"Washington","Asotin County",2,85,627,278,349
050,53,003,"Washington","Asotin County",3,0,213,103,110
050,53,003,"Washington","Asotin County",3,1,228,111,117
050,53,003,"Washington","Asotin County",3,2,221,113,108
050,53,003,"Washington","Asotin County",3,3,250,132,118
050,53,003,"Washington","Asotin County",3,4,230,123,107
050,53,003,"Washington","Asotin County",3,5,226,125,101
050,53,003,"Washington","Asotin County",3,6,246,126,120
050,53,003,"Washington","Asotin County",3,7,254,133,121
050,53,003,"Washington","Asotin County",3,8,277,155,122
050,53,003,"Washington","Asotin County",3,9,264,136,128
050,53,003,"Washington","Asotin County",3,10,240,111,129
050,53,003,"Washington","Asotin County",3,11,225,100,125
050,53,003,"Washington","Asotin County",3,12,255,117,138
050,53,003,"Washington","Asotin County",3,13,265,129,136
050,53,003,"Washington","Asotin County",3,14,279,142,137
050,53,003,"Washington","Asotin County",3,15,284,148,136
050,53,003,"Washington","Asotin County",3,16,264,127,137
050,53,003,"Washington","Asotin County",3,17,282,143,139
050,53,003,"Washington","Asotin County",3,18,227,117,110
050,53,003,"Washington","Asotin County",3,19,188,94,94
050,53,003,"Washington","Asotin County",3,20,202,100,102
050,53,003,"Washington","Asotin County",3,21,199,98,101
050,53,003,"Washington","Asotin County",3,22,222,113,109
050,53,003,"Washington","Asotin County",3,23,224,115,109
050,53,003,"Washington","Asotin County",3,24,223,115,108
050,53,003,"Washington","Asotin County",3,25,239,113,126
050,53,003,"Washington","Asotin County",3,26,257,122,135
050,53,003,"Washington","Asotin County",3,27,231,129,102
050,53,003,"Washington","Asotin County",3,28,242,118,124
050,53,003,"Washington","Asotin County",3,29,253,122,131
050,53,003,"Washington","Asotin County",3,30,258,126,132
050,53,003,"Washington","Asotin County",3,31,240,116,124
050,53,003,"Washington","Asotin County",3,32,220,112,108
050,53,003,"Washington","Asotin County",3,33,232,125,107
050,53,003,"Washington","Asotin County",3,34,245,120,125
050,53,003,"Washington","Asotin County",3,35,248,125,123
050,53,003,"Washington","Asotin County",3,36,269,136,133
050,53,003,"Washington","Asotin County",3,37,275,124,151
050,53,003,"Washington","Asotin County",3,38,268,119,149
050,53,003,"Washington","Asotin County",3,39,278,144,134
050,53,003,"Washington","Asotin County",3,40,263,134,129
050,53,003,"Washington","Asotin County",3,41,255,134,121
050,53,003,"Washington","Asotin County",3,42,253,128,125
050,53,003,"Washington","Asotin County",3,43,250,127,123
050,53,003,"Washington","Asotin County",3,44,244,117,127
050,53,003,"Washington","Asotin County",3,45,252,115,137
050,53,003,"Washington","Asotin County",3,46,240,119,121
050,53,003,"Washington","Asotin County",3,47,245,127,118
050,53,003,"Washington","Asotin County",3,48,223,107,116
050,53,003,"Washington","Asotin County",3,49,222,113,109
050,53,003,"Washington","Asotin County",3,50,267,132,135
050,53,003,"Washington","Asotin County",3,51,277,132,145
050,53,003,"Washington","Asotin County",3,52,278,141,137
050,53,003,"Washington","Asotin County",3,53,260,130,130
050,53,003,"Washington","Asotin County",3,54,246,111,135
050,53,003,"Washington","Asotin County",3,55,255,125,130
050,53,003,"Washington","Asotin County",3,56,300,155,145
050,53,003,"Washington","Asotin County",3,57,304,149,155
050,53,003,"Washington","Asotin County",3,58,330,166,164
050,53,003,"Washington","Asotin County",3,59,350,169,181
050,53,003,"Washington","Asotin County",3,60,364,171,193
050,53,003,"Washington","Asotin County",3,61,359,167,192
050,53,003,"Washington","Asotin County",3,62,355,159,196
050,53,003,"Washington","Asotin County",3,63,376,176,200
050,53,003,"Washington","Asotin County",3,64,376,173,203
050,53,003,"Washington","Asotin County",3,65,368,169,199
050,53,003,"Washington","Asotin County",3,66,383,183,200
050,53,003,"Washington","Asotin County",3,67,345,178,167
050,53,003,"Washington","Asotin County",3,68,340,173,167
050,53,003,"Washington","Asotin County",3,69,319,167,152
050,53,003,"Washington","Asotin County",3,70,307,153,154
050,53,003,"Washington","Asotin County",3,71,287,136,151
050,53,003,"Washington","Asotin County",3,72,268,126,142
050,53,003,"Washington","Asotin County",3,73,289,129,160
050,53,003,"Washington","Asotin County",3,74,297,133,164
050,53,003,"Washington","Asotin County",3,75,199,86,113
050,53,003,"Washington","Asotin County",3,76,199,95,104
050,53,003,"Washington","Asotin County",3,77,221,117,104
050,53,003,"Washington","Asotin County",3,78,230,108,122
050,53,003,"Washington","Asotin County",3,79,179,79,100
050,53,003,"Washington","Asotin County",3,80,176,80,96
050,53,003,"Washington","Asotin County",3,81,155,66,89
050,53,003,"Washington","Asotin County",3,82,138,66,72
050,53,003,"Washington","Asotin County",3,83,128,61,67
050,53,003,"Washington","Asotin County",3,84,109,50,59
050,53,003,"Washington","Asotin County",3,85,645,286,359
050,53,003,"Washington","Asotin County",4,0,232,122,110
050,53,003,"Washington","Asotin County",4,1,218,112,106
050,53,003,"Washington","Asotin County",4,2,228,110,118
050,53,003,"Washington","Asotin County",4,3,221,115,106
050,53,003,"Washington","Asotin County",4,4,243,121,122
050,53,003,"Washington","Asotin County",4,5,225,119,106
050,53,003,"Washington","Asotin County",4,6,245,136,109
050,53,003,"Washington","Asotin County",4,7,251,133,118
050,53,003,"Washington","Asotin County",4,8,244,126,118
050,53,003,"Washington","Asotin County",4,9,267,148,119
050,53,003,"Washington","Asotin County",4,10,255,130,125
050,53,003,"Washington","Asotin County",4,11,235,107,128
050,53,003,"Washington","Asotin County",4,12,225,104,121
050,53,003,"Washington","Asotin County",4,13,256,118,138
050,53,003,"Washington","Asotin County",4,14,275,131,144
050,53,003,"Washington","Asotin County",4,15,281,150,131
050,53,003,"Washington","Asotin County",4,16,271,144,127
050,53,003,"Washington","Asotin County",4,17,274,132,142
050,53,003,"Washington","Asotin County",4,18,237,122,115
050,53,003,"Washington","Asotin County",4,19,181,90,91
050,53,003,"Washington","Asotin County",4,20,179,90,89
050,53,003,"Washington","Asotin County",4,21,196,92,104
050,53,003,"Washington","Asotin County",4,22,200,94,106
050,53,003,"Washington","Asotin County",4,23,233,112,121
050,53,003,"Washington","Asotin County",4,24,237,116,121
050,53,003,"Washington","Asotin County",4,25,239,128,111
050,53,003,"Washington","Asotin County",4,26,242,115,127
050,53,003,"Washington","Asotin County",4,27,248,118,130
050,53,003,"Washington","Asotin County",4,28,244,135,109
050,53,003,"Washington","Asotin County",4,29,264,135,129
050,53,003,"Washington","Asotin County",4,30,266,128,138
050,53,003,"Washington","Asotin County",4,31,282,131,151
050,53,003,"Washington","Asotin County",4,32,250,127,123
050,53,003,"Washington","Asotin County",4,33,212,110,102
050,53,003,"Washington","Asotin County",4,34,241,124,117
050,53,003,"Washington","Asotin County",4,35,236,110,126
050,53,003,"Washington","Asotin County",4,36,257,127,130
050,53,003,"Washington","Asotin County",4,37,254,125,129
050,53,003,"Washington","Asotin County",4,38,282,124,158
050,53,003,"Washington","Asotin County",4,39,270,118,152
050,53,003,"Washington","Asotin County",4,40,285,143,142
050,53,003,"Washington","Asotin County",4,41,266,132,134
050,53,003,"Washington","Asotin County",4,42,259,137,122
050,53,003,"Washington","Asotin County",4,43,250,123,127
050,53,003,"Washington","Asotin County",4,44,253,127,126
050,53,003,"Washington","Asotin County",4,45,250,125,125
050,53,003,"Washington","Asotin County",4,46,260,121,139
050,53,003,"Washington","Asotin County",4,47,245,119,126
050,53,003,"Washington","Asotin County",4,48,240,123,117
050,53,003,"Washington","Asotin County",4,49,231,109,122
050,53,003,"Washington","Asotin County",4,50,215,110,105
050,53,003,"Washington","Asotin County",4,51,269,131,138
050,53,003,"Washington","Asotin County",4,52,279,131,148
050,53,003,"Washington","Asotin County",4,53,269,133,136
050,53,003,"Washington","Asotin County",4,54,263,130,133
050,53,003,"Washington","Asotin County",4,55,242,108,134
050,53,003,"Washington","Asotin County",4,56,258,126,132
050,53,003,"Washington","Asotin County",4,57,307,161,146
050,53,003,"Washington","Asotin County",4,58,306,154,152
050,53,003,"Washington","Asotin County",4,59,334,169,165
050,53,003,"Washington","Asotin County",4,60,354,174,180
050,53,003,"Washington","Asotin County",4,61,360,162,198
050,53,003,"Washington","Asotin County",4,62,365,174,191
050,53,003,"Washington","Asotin County",4,63,359,163,196
050,53,003,"Washington","Asotin County",4,64,377,174,203
050,53,003,"Washington","Asotin County",4,65,378,169,209
050,53,003,"Washington","Asotin County",4,66,372,167,205
050,53,003,"Washington","Asotin County",4,67,375,178,197
050,53,003,"Washington","Asotin County",4,68,346,174,172
050,53,003,"Washington","Asotin County",4,69,338,170,168
050,53,003,"Washington","Asotin County",4,70,323,166,157
050,53,003,"Washington","Asotin County",4,71,304,151,153
050,53,003,"Washington","Asotin County",4,72,282,137,145
050,53,003,"Washington","Asotin County",4,73,265,126,139
050,53,003,"Washington","Asotin County",4,74,281,123,158
050,53,003,"Washington","Asotin County",4,75,288,128,160
050,53,003,"Washington","Asotin County",4,76,186,81,105
050,53,003,"Washington","Asotin County",4,77,193,91,102
050,53,003,"Washington","Asotin County",4,78,208,104,104
050,53,003,"Washington","Asotin County",4,79,218,99,119
050,53,003,"Washington","Asotin County",4,80,166,73,93
050,53,003,"Washington","Asotin County",4,81,165,73,92
050,53,003,"Washington","Asotin County",4,82,144,60,84
050,53,003,"Washington","Asotin County",4,83,135,62,73
050,53,003,"Washington","Asotin County",4,84,120,54,66
050,53,003,"Washington","Asotin County",4,85,657,296,361
050,53,003,"Washington","Asotin County",5,0,216,110,106
050,53,003,"Washington","Asotin County",5,1,244,128,116
050,53,003,"Washington","Asotin County",5,2,211,107,104
050,53,003,"Washington","Asotin County",5,3,223,111,112
050,53,003,"Washington","Asotin County",5,4,220,121,99
050,53,003,"Washington","Asotin County",5,5,235,125,110
050,53,003,"Washington","Asotin County",5,6,210,119,91
050,53,003,"Washington","Asotin County",5,7,236,133,103
050,53,003,"Washington","Asotin County",5,8,252,134,118
050,53,003,"Washington","Asotin County",5,9,254,132,122
050,53,003,"Washington","Asotin County",5,10,275,158,117
050,53,003,"Washington","Asotin County",5,11,252,125,127
050,53,003,"Washington","Asotin County",5,12,245,111,134
050,53,003,"Washington","Asotin County",5,13,229,111,118
050,53,003,"Washington","Asotin County",5,14,249,116,133
050,53,003,"Washington","Asotin County",5,15,272,127,145
050,53,003,"Washington","Asotin County",5,16,279,148,131
050,53,003,"Washington","Asotin County",5,17,265,142,123
050,53,003,"Washington","Asotin County",5,18,219,115,104
050,53,003,"Washington","Asotin County",5,19,195,101,94
050,53,003,"Washington","Asotin County",5,20,187,91,96
050,53,003,"Washington","Asotin County",5,21,196,101,95
050,53,003,"Washington","Asotin County",5,22,209,98,111
050,53,003,"Washington","Asotin County",5,23,209,95,114
050,53,003,"Washington","Asotin County",5,24,238,112,126
050,53,003,"Washington","Asotin County",5,25,238,115,123
050,53,003,"Washington","Asotin County",5,26,237,125,112
050,53,003,"Washington","Asotin County",5,27,242,116,126
050,53,003,"Washington","Asotin County",5,28,258,119,139
050,53,003,"Washington","Asotin County",5,29,235,133,102
050,53,003,"Washington","Asotin County",5,30,256,134,122
050,53,003,"Washington","Asotin County",5,31,265,126,139
050,53,003,"Washington","Asotin County",5,32,273,127,146
050,53,003,"Washington","Asotin County",5,33,245,114,131
050,53,003,"Washington","Asotin County",5,34,224,123,101
050,53,003,"Washington","Asotin County",5,35,249,126,123
050,53,003,"Washington","Asotin County",5,36,256,121,135
050,53,003,"Washington","Asotin County",5,37,263,129,134
050,53,003,"Washington","Asotin County",5,38,254,124,130
050,53,003,"Washington","Asotin County",5,39,285,130,155
050,53,003,"Washington","Asotin County",5,40,277,130,147
050,53,003,"Washington","Asotin County",5,41,286,145,141
050,53,003,"Washington","Asotin County",5,42,262,131,131
050,53,003,"Washington","Asotin County",5,43,258,135,123
050,53,003,"Washington","Asotin County",5,44,254,120,134
050,53,003,"Washington","Asotin County",5,45,249,125,124
050,53,003,"Washington","Asotin County",5,46,252,127,125
050,53,003,"Washington","Asotin County",5,47,265,123,142
050,53,003,"Washington","Asotin County",5,48,249,125,124
050,53,003,"Washington","Asotin County",5,49,238,117,121
050,53,003,"Washington","Asotin County",5,50,238,110,128
050,53,003,"Washington","Asotin County",5,51,219,117,102
050,53,003,"Washington","Asotin County",5,52,281,137,144
050,53,003,"Washington","Asotin County",5,53,281,133,148
050,53,003,"Washington","Asotin County",5,54,275,138,137
050,53,003,"Washington","Asotin County",5,55,271,132,139
050,53,003,"Washington","Asotin County",5,56,256,118,138
050,53,003,"Washington","Asotin County",5,57,260,130,130
050,53,003,"Washington","Asotin County",5,58,299,157,142
050,53,003,"Washington","Asotin County",5,59,308,147,161
050,53,003,"Washington","Asotin County",5,60,343,175,168
050,53,003,"Washington","Asotin County",5,61,348,166,182
050,53,003,"Washington","Asotin County",5,62,364,164,200
050,53,003,"Washington","Asotin County",5,63,364,176,188
050,53,003,"Washington","Asotin County",5,64,358,164,194
050,53,003,"Washington","Asotin County",5,65,371,174,197
050,53,003,"Washington","Asotin County",5,66,379,167,212
050,53,003,"Washington","Asotin County",5,67,359,160,199
050,53,003,"Washington","Asotin County",5,68,371,178,193
050,53,003,"Washington","Asotin County",5,69,352,174,178
050,53,003,"Washington","Asotin County",5,70,330,167,163
050,53,003,"Washington","Asotin County",5,71,318,162,156
050,53,003,"Washington","Asotin County",5,72,294,150,144
050,53,003,"Washington","Asotin County",5,73,284,140,144
050,53,003,"Washington","Asotin County",5,74,263,120,143
050,53,003,"Washington","Asotin County",5,75,273,117,156
050,53,003,"Washington","Asotin County",5,76,283,124,159
050,53,003,"Washington","Asotin County",5,77,185,82,103
050,53,003,"Washington","Asotin County",5,78,174,77,97
050,53,003,"Washington","Asotin County",5,79,200,98,102
050,53,003,"Washington","Asotin County",5,80,205,92,113
050,53,003,"Washington","Asotin County",5,81,152,65,87
050,53,003,"Washington","Asotin County",5,82,158,72,86
050,53,003,"Washington","Asotin County",5,83,139,55,84
050,53,003,"Washington","Asotin County",5,84,122,51,71
050,53,003,"Washington","Asotin County",5,85,682,309,373
050,53,005,"Washington","Benton County",1,0,2573,1314,1259
050,53,005,"Washington","Benton County",1,1,2608,1338,1270
050,53,005,"Washington","Benton County",1,2,2726,1391,1335
050,53,005,"Washington","Benton County",1,3,2903,1458,1445
050,53,005,"Washington","Benton County",1,4,3027,1553,1474
050,53,005,"Washington","Benton County",1,5,3137,1600,1537
050,53,005,"Washington","Benton County",1,6,3058,1602,1456
050,53,005,"Washington","Benton County",1,7,3066,1552,1514
050,53,005,"Washington","Benton County",1,8,3164,1612,1552
050,53,005,"Washington","Benton County",1,9,3215,1691,1524
050,53,005,"Washington","Benton County",1,10,3299,1741,1558
050,53,005,"Washington","Benton County",1,11,3397,1757,1640
050,53,005,"Washington","Benton County",1,12,3404,1761,1643
050,53,005,"Washington","Benton County",1,13,3379,1717,1662
050,53,005,"Washington","Benton County",1,14,3246,1690,1556
050,53,005,"Washington","Benton County",1,15,3134,1592,1542
050,53,005,"Washington","Benton County",1,16,3072,1604,1468
050,53,005,"Washington","Benton County",1,17,3058,1589,1469
050,53,005,"Washington","Benton County",1,18,2671,1416,1255
050,53,005,"Washington","Benton County",1,19,2234,1170,1064
050,53,005,"Washington","Benton County",1,20,2358,1250,1108
050,53,005,"Washington","Benton County",1,21,2398,1255,1143
050,53,005,"Washington","Benton County",1,22,2403,1269,1134
050,53,005,"Washington","Benton County",1,23,2443,1239,1204
050,53,005,"Washington","Benton County",1,24,2526,1277,1249
050,53,005,"Washington","Benton County",1,25,2612,1345,1267
050,53,005,"Washington","Benton County",1,26,2747,1373,1374
050,53,005,"Washington","Benton County",1,27,2742,1395,1347
050,53,005,"Washington","Benton County",1,28,2876,1424,1452
050,53,005,"Washington","Benton County",1,29,2924,1444,1480
050,53,005,"Washington","Benton County",1,30,2828,1431,1397
050,53,005,"Washington","Benton County",1,31,2710,1374,1336
050,53,005,"Washington","Benton County",1,32,2774,1387,1387
050,53,005,"Washington","Benton County",1,33,2818,1455,1363
050,53,005,"Washington","Benton County",1,34,2894,1451,1443
050,53,005,"Washington","Benton County",1,35,2931,1481,1450
050,53,005,"Washington","Benton County",1,36,2898,1497,1401
050,53,005,"Washington","Benton County",1,37,2887,1497,1390
050,53,005,"Washington","Benton County",1,38,2972,1523,1449
050,53,005,"Washington","Benton County",1,39,2898,1457,1441
050,53,005,"Washington","Benton County",1,40,2766,1392,1374
050,53,005,"Washington","Benton County",1,41,2550,1277,1273
050,53,005,"Washington","Benton County",1,42,2520,1304,1216
050,53,005,"Washington","Benton County",1,43,2484,1290,1194
050,53,005,"Washington","Benton County",1,44,2298,1184,1114
050,53,005,"Washington","Benton County",1,45,2282,1160,1122
050,53,005,"Washington","Benton County",1,46,2191,1118,1073
050,53,005,"Washington","Benton County",1,47,2212,1153,1059
050,53,005,"Washington","Benton County",1,48,2295,1181,1114
050,53,005,"Washington","Benton County",1,49,2482,1255,1227
050,53,005,"Washington","Benton County",1,50,2365,1190,1175
050,53,005,"Washington","Benton County",1,51,2355,1186,1169
050,53,005,"Washington","Benton County",1,52,2258,1119,1139
050,53,005,"Washington","Benton County",1,53,2259,1125,1134
050,53,005,"Washington","Benton County",1,54,2273,1137,1136
050,53,005,"Washington","Benton County",1,55,2389,1186,1203
050,53,005,"Washington","Benton County",1,56,2516,1250,1266
050,53,005,"Washington","Benton County",1,57,2495,1247,1248
050,53,005,"Washington","Benton County",1,58,2562,1261,1301
050,53,005,"Washington","Benton County",1,59,2601,1267,1334
050,53,005,"Washington","Benton County",1,60,2502,1244,1258
050,53,005,"Washington","Benton County",1,61,2504,1244,1260
050,53,005,"Washington","Benton County",1,62,2521,1248,1273
050,53,005,"Washington","Benton County",1,63,2426,1232,1194
050,53,005,"Washington","Benton County",1,64,2344,1152,1192
050,53,005,"Washington","Benton County",1,65,2369,1156,1213
050,53,005,"Washington","Benton County",1,66,2269,1094,1175
050,53,005,"Washington","Benton County",1,67,2193,1065,1128
050,53,005,"Washington","Benton County",1,68,2113,1068,1045
050,53,005,"Washington","Benton County",1,69,1906,961,945
050,53,005,"Washington","Benton County",1,70,1883,934,949
050,53,005,"Washington","Benton County",1,71,1824,884,940
050,53,005,"Washington","Benton County",1,72,1769,852,917
050,53,005,"Washington","Benton County",1,73,1761,866,895
050,53,005,"Washington","Benton County",1,74,1211,586,625
050,53,005,"Washington","Benton County",1,75,1208,575,633
050,53,005,"Washington","Benton County",1,76,1232,572,660
050,53,005,"Washington","Benton County",1,77,1202,574,628
050,53,005,"Washington","Benton County",1,78,990,463,527
050,53,005,"Washington","Benton County",1,79,931,433,498
050,53,005,"Washington","Benton County",1,80,816,389,427
050,53,005,"Washington","Benton County",1,81,748,343,405
050,53,005,"Washington","Benton County",1,82,706,310,396
050,53,005,"Washington","Benton County",1,83,599,270,329
050,53,005,"Washington","Benton County",1,84,534,230,304
050,53,005,"Washington","Benton County",1,85,3144,1125,2019
050,53,005,"Washington","Benton County",2,0,2570,1336,1234
050,53,005,"Washington","Benton County",2,1,2603,1338,1265
050,53,005,"Washington","Benton County",2,2,2707,1385,1322
050,53,005,"Washington","Benton County",2,3,2860,1444,1416
050,53,005,"Washington","Benton County",2,4,3017,1538,1479
050,53,005,"Washington","Benton County",2,5,3111,1588,1523
050,53,005,"Washington","Benton County",2,6,3087,1607,1480
050,53,005,"Washington","Benton County",2,7,3069,1565,1504
050,53,005,"Washington","Benton County",2,8,3141,1600,1541
050,53,005,"Washington","Benton County",2,9,3201,1674,1527
050,53,005,"Washington","Benton County",2,10,3287,1733,1554
050,53,005,"Washington","Benton County",2,11,3367,1749,1618
050,53,005,"Washington","Benton County",2,12,3420,1765,1655
050,53,005,"Washington","Benton County",2,13,3389,1728,1661
050,53,005,"Washington","Benton County",2,14,3274,1692,1582
050,53,005,"Washington","Benton County",2,15,3157,1616,1541
050,53,005,"Washington","Benton County",2,16,3089,1604,1485
050,53,005,"Washington","Benton County",2,17,3059,1599,1460
050,53,005,"Washington","Benton County",2,18,2662,1412,1250
050,53,005,"Washington","Benton County",2,19,2259,1186,1073
050,53,005,"Washington","Benton County",2,20,2382,1258,1124
050,53,005,"Washington","Benton County",2,21,2408,1264,1144
050,53,005,"Washington","Benton County",2,22,2428,1280,1148
050,53,005,"Washington","Benton County",2,23,2463,1256,1207
050,53,005,"Washington","Benton County",2,24,2519,1277,1242
050,53,005,"Washington","Benton County",2,25,2615,1341,1274
050,53,005,"Washington","Benton County",2,26,2730,1377,1353
050,53,005,"Washington","Benton County",2,27,2753,1398,1355
050,53,005,"Washington","Benton County",2,28,2874,1432,1442
050,53,005,"Washington","Benton County",2,29,2929,1449,1480
050,53,005,"Washington","Benton County",2,30,2870,1442,1428
050,53,005,"Washington","Benton County",2,31,2750,1394,1356
050,53,005,"Washington","Benton County",2,32,2776,1396,1380
050,53,005,"Washington","Benton County",2,33,2813,1441,1372
050,53,005,"Washington","Benton County",2,34,2891,1461,1430
050,53,005,"Washington","Benton County",2,35,2947,1490,1457
050,53,005,"Washington","Benton County",2,36,2894,1489,1405
050,53,005,"Washington","Benton County",2,37,2906,1506,1400
050,53,005,"Washington","Benton County",2,38,2970,1531,1439
050,53,005,"Washington","Benton County",2,39,2917,1472,1445
050,53,005,"Washington","Benton County",2,40,2820,1418,1402
050,53,005,"Washington","Benton County",2,41,2600,1306,1294
050,53,005,"Washington","Benton County",2,42,2527,1297,1230
050,53,005,"Washington","Benton County",2,43,2512,1303,1209
050,53,005,"Washington","Benton County",2,44,2323,1198,1125
050,53,005,"Washington","Benton County",2,45,2298,1173,1125
050,53,005,"Washington","Benton County",2,46,2212,1129,1083
050,53,005,"Washington","Benton County",2,47,2207,1144,1063
050,53,005,"Washington","Benton County",2,48,2275,1172,1103
050,53,005,"Washington","Benton County",2,49,2450,1249,1201
050,53,005,"Washington","Benton County",2,50,2406,1213,1193
050,53,005,"Washington","Benton County",2,51,2355,1185,1170
050,53,005,"Washington","Benton County",2,52,2273,1132,1141
050,53,005,"Washington","Benton County",2,53,2255,1119,1136
050,53,005,"Washington","Benton County",2,54,2261,1131,1130
050,53,005,"Washington","Benton County",2,55,2360,1175,1185
050,53,005,"Washington","Benton County",2,56,2498,1241,1257
050,53,005,"Washington","Benton County",2,57,2498,1248,1250
050,53,005,"Washington","Benton County",2,58,2539,1255,1284
050,53,005,"Washington","Benton County",2,59,2597,1268,1329
050,53,005,"Washington","Benton County",2,60,2525,1250,1275
050,53,005,"Washington","Benton County",2,61,2485,1228,1257
050,53,005,"Washington","Benton County",2,62,2513,1246,1267
050,53,005,"Washington","Benton County",2,63,2455,1238,1217
050,53,005,"Washington","Benton County",2,64,2352,1163,1189
050,53,005,"Washington","Benton County",2,65,2356,1151,1205
050,53,005,"Washington","Benton County",2,66,2289,1110,1179
050,53,005,"Washington","Benton County",2,67,2196,1061,1135
050,53,005,"Washington","Benton County",2,68,2116,1060,1056
050,53,005,"Washington","Benton County",2,69,1966,991,975
050,53,005,"Washington","Benton County",2,70,1867,933,934
050,53,005,"Washington","Benton County",2,71,1840,893,947
050,53,005,"Washington","Benton County",2,72,1749,841,908
050,53,005,"Washington","Benton County",2,73,1838,900,938
050,53,005,"Washington","Benton County",2,74,1250,610,640
050,53,005,"Washington","Benton County",2,75,1209,575,634
050,53,005,"Washington","Benton County",2,76,1211,564,647
050,53,005,"Washington","Benton County",2,77,1230,584,646
050,53,005,"Washington","Benton County",2,78,1007,475,532
050,53,005,"Washington","Benton County",2,79,935,436,499
050,53,005,"Washington","Benton County",2,80,838,400,438
050,53,005,"Washington","Benton County",2,81,748,346,402
050,53,005,"Washington","Benton County",2,82,720,321,399
050,53,005,"Washington","Benton County",2,83,613,277,336
050,53,005,"Washington","Benton County",2,84,543,236,307
050,53,005,"Washington","Benton County",2,85,3138,1127,2011
050,53,005,"Washington","Benton County",3,0,2477,1278,1199
050,53,005,"Washington","Benton County",3,1,2674,1399,1275
050,53,005,"Washington","Benton County",3,2,2700,1384,1316
050,53,005,"Washington","Benton County",3,3,2764,1401,1363
050,53,005,"Washington","Benton County",3,4,2971,1514,1457
050,53,005,"Washington","Benton County",3,5,3073,1560,1513
050,53,005,"Washington","Benton County",3,6,3191,1624,1567
050,53,005,"Washington","Benton County",3,7,3121,1634,1487
050,53,005,"Washington","Benton County",3,8,3085,1570,1515
050,53,005,"Washington","Benton County",3,9,3170,1605,1565
050,53,005,"Washington","Benton County",3,10,3260,1697,1563
050,53,005,"Washington","Benton County",3,11,3298,1727,1571
050,53,005,"Washington","Benton County",3,12,3364,1750,1614
050,53,005,"Washington","Benton County",3,13,3451,1783,1668
050,53,005,"Washington","Benton County",3,14,3395,1737,1658
050,53,005,"Washington","Benton County",3,15,3295,1696,1599
050,53,005,"Washington","Benton County",3,16,3151,1607,1544
050,53,005,"Washington","Benton County",3,17,3116,1618,1498
050,53,005,"Washington","Benton County",3,18,2700,1431,1269
050,53,005,"Washington","Benton County",3,19,2279,1212,1067
050,53,005,"Washington","Benton County",3,20,2439,1271,1168
050,53,005,"Washington","Benton County",3,21,2494,1284,1210
050,53,005,"Washington","Benton County",3,22,2494,1281,1213
050,53,005,"Washington","Benton County",3,23,2599,1359,1240
050,53,005,"Washington","Benton County",3,24,2572,1299,1273
050,53,005,"Washington","Benton County",3,25,2666,1369,1297
050,53,005,"Washington","Benton County",3,26,2652,1335,1317
050,53,005,"Washington","Benton County",3,27,2790,1406,1384
050,53,005,"Washington","Benton County",3,28,2846,1442,1404
050,53,005,"Washington","Benton County",3,29,2974,1510,1464
050,53,005,"Washington","Benton County",3,30,2994,1468,1526
050,53,005,"Washington","Benton County",3,31,2965,1486,1479
050,53,005,"Washington","Benton County",3,32,2862,1478,1384
050,53,005,"Washington","Benton County",3,33,2871,1443,1428
050,53,005,"Washington","Benton County",3,34,2895,1497,1398
050,53,005,"Washington","Benton County",3,35,2898,1471,1427
050,53,005,"Washington","Benton County",3,36,3002,1520,1482
050,53,005,"Washington","Benton County",3,37,2935,1509,1426
050,53,005,"Washington","Benton County",3,38,2992,1537,1455
050,53,005,"Washington","Benton County",3,39,2997,1529,1468
050,53,005,"Washington","Benton County",3,40,2941,1508,1433
050,53,005,"Washington","Benton County",3,41,2857,1440,1417
050,53,005,"Washington","Benton County",3,42,2601,1300,1301
050,53,005,"Washington","Benton County",3,43,2555,1298,1257
050,53,005,"Washington","Benton County",3,44,2531,1310,1221
050,53,005,"Washington","Benton County",3,45,2353,1215,1138
050,53,005,"Washington","Benton County",3,46,2310,1171,1139
050,53,005,"Washington","Benton County",3,47,2214,1126,1088
050,53,005,"Washington","Benton County",3,48,2244,1167,1077
050,53,005,"Washington","Benton County",3,49,2273,1171,1102
050,53,005,"Washington","Benton County",3,50,2461,1256,1205
050,53,005,"Washington","Benton County",3,51,2424,1233,1191
050,53,005,"Washington","Benton County",3,52,2358,1199,1159
050,53,005,"Washington","Benton County",3,53,2278,1144,1134
050,53,005,"Washington","Benton County",3,54,2278,1133,1145
050,53,005,"Washington","Benton County",3,55,2236,1124,1112
050,53,005,"Washington","Benton County",3,56,2378,1187,1191
050,53,005,"Washington","Benton County",3,57,2492,1232,1260
050,53,005,"Washington","Benton County",3,58,2501,1247,1254
050,53,005,"Washington","Benton County",3,59,2522,1252,1270
050,53,005,"Washington","Benton County",3,60,2585,1254,1331
050,53,005,"Washington","Benton County",3,61,2514,1232,1282
050,53,005,"Washington","Benton County",3,62,2489,1227,1262
050,53,005,"Washington","Benton County",3,63,2519,1245,1274
050,53,005,"Washington","Benton County",3,64,2435,1215,1220
050,53,005,"Washington","Benton County",3,65,2313,1135,1178
050,53,005,"Washington","Benton County",3,66,2338,1151,1187
050,53,005,"Washington","Benton County",3,67,2242,1087,1155
050,53,005,"Washington","Benton County",3,68,2180,1055,1125
050,53,005,"Washington","Benton County",3,69,2052,1025,1027
050,53,005,"Washington","Benton County",3,70,1957,975,982
050,53,005,"Washington","Benton County",3,71,1844,907,937
050,53,005,"Washington","Benton County",3,72,1807,869,938
050,53,005,"Washington","Benton County",3,73,1708,811,897
050,53,005,"Washington","Benton County",3,74,1783,868,915
050,53,005,"Washington","Benton County",3,75,1215,589,626
050,53,005,"Washington","Benton County",3,76,1184,547,637
050,53,005,"Washington","Benton County",3,77,1172,540,632
050,53,005,"Washington","Benton County",3,78,1190,560,630
050,53,005,"Washington","Benton County",3,79,989,457,532
050,53,005,"Washington","Benton County",3,80,900,427,473
050,53,005,"Washington","Benton County",3,81,796,371,425
050,53,005,"Washington","Benton County",3,82,729,320,409
050,53,005,"Washington","Benton County",3,83,670,305,365
050,53,005,"Washington","Benton County",3,84,583,261,322
050,53,005,"Washington","Benton County",3,85,3126,1158,1968
050,53,005,"Washington","Benton County",4,0,2555,1275,1280
050,53,005,"Washington","Benton County",4,1,2597,1348,1249
050,53,005,"Washington","Benton County",4,2,2729,1425,1304
050,53,005,"Washington","Benton County",4,3,2765,1414,1351
050,53,005,"Washington","Benton County",4,4,2871,1442,1429
050,53,005,"Washington","Benton County",4,5,3040,1557,1483
050,53,005,"Washington","Benton County",4,6,3151,1593,1558
050,53,005,"Washington","Benton County",4,7,3256,1674,1582
050,53,005,"Washington","Benton County",4,8,3161,1658,1503
050,53,005,"Washington","Benton County",4,9,3108,1578,1530
050,53,005,"Washington","Benton County",4,10,3187,1597,1590
050,53,005,"Washington","Benton County",4,11,3325,1743,1582
050,53,005,"Washington","Benton County",4,12,3294,1720,1574
050,53,005,"Washington","Benton County",4,13,3400,1771,1629
050,53,005,"Washington","Benton County",4,14,3438,1794,1644
050,53,005,"Washington","Benton County",4,15,3411,1742,1669
050,53,005,"Washington","Benton County",4,16,3317,1720,1597
050,53,005,"Washington","Benton County",4,17,3171,1630,1541
050,53,005,"Washington","Benton County",4,18,2743,1465,1278
050,53,005,"Washington","Benton County",4,19,2243,1181,1062
050,53,005,"Washington","Benton County",4,20,2382,1267,1115
050,53,005,"Washington","Benton County",4,21,2546,1324,1222
050,53,005,"Washington","Benton County",4,22,2638,1381,1257
050,53,005,"Washington","Benton County",4,23,2604,1337,1267
050,53,005,"Washington","Benton County",4,24,2677,1417,1260
050,53,005,"Washington","Benton County",4,25,2625,1336,1289
050,53,005,"Washington","Benton County",4,26,2727,1389,1338
050,53,005,"Washington","Benton County",4,27,2743,1413,1330
050,53,005,"Washington","Benton County",4,28,2887,1461,1426
050,53,005,"Washington","Benton County",4,29,2909,1470,1439
050,53,005,"Washington","Benton County",4,30,3036,1537,1499
050,53,005,"Washington","Benton County",4,31,3053,1487,1566
050,53,005,"Washington","Benton County",4,32,3027,1532,1495
050,53,005,"Washington","Benton County",4,33,2888,1513,1375
050,53,005,"Washington","Benton County",4,34,2967,1523,1444
050,53,005,"Washington","Benton County",4,35,2940,1536,1404
050,53,005,"Washington","Benton County",4,36,2981,1516,1465
050,53,005,"Washington","Benton County",4,37,3044,1548,1496
050,53,005,"Washington","Benton County",4,38,2925,1496,1429
050,53,005,"Washington","Benton County",4,39,2989,1554,1435
050,53,005,"Washington","Benton County",4,40,3007,1534,1473
050,53,005,"Washington","Benton County",4,41,2976,1538,1438
050,53,005,"Washington","Benton County",4,42,2866,1429,1437
050,53,005,"Washington","Benton County",4,43,2629,1323,1306
050,53,005,"Washington","Benton County",4,44,2545,1312,1233
050,53,005,"Washington","Benton County",4,45,2530,1320,1210
050,53,005,"Washington","Benton County",4,46,2378,1228,1150
050,53,005,"Washington","Benton County",4,47,2279,1153,1126
050,53,005,"Washington","Benton County",4,48,2184,1115,1069
050,53,005,"Washington","Benton County",4,49,2207,1137,1070
050,53,005,"Washington","Benton County",4,50,2246,1164,1082
050,53,005,"Washington","Benton County",4,51,2468,1253,1215
050,53,005,"Washington","Benton County",4,52,2460,1257,1203
050,53,005,"Washington","Benton County",4,53,2324,1176,1148
050,53,005,"Washington","Benton County",4,54,2254,1124,1130
050,53,005,"Washington","Benton County",4,55,2259,1121,1138
050,53,005,"Washington","Benton County",4,56,2202,1100,1102
050,53,005,"Washington","Benton County",4,57,2339,1169,1170
050,53,005,"Washington","Benton County",4,58,2483,1227,1256
050,53,005,"Washington","Benton County",4,59,2501,1256,1245
050,53,005,"Washington","Benton County",4,60,2513,1262,1251
050,53,005,"Washington","Benton County",4,61,2588,1234,1354
050,53,005,"Washington","Benton County",4,62,2511,1204,1307
050,53,005,"Washington","Benton County",4,63,2468,1218,1250
050,53,005,"Washington","Benton County",4,64,2490,1217,1273
050,53,005,"Washington","Benton County",4,65,2401,1183,1218
050,53,005,"Washington","Benton County",4,66,2271,1113,1158
050,53,005,"Washington","Benton County",4,67,2330,1135,1195
050,53,005,"Washington","Benton County",4,68,2205,1078,1127
050,53,005,"Washington","Benton County",4,69,2149,1023,1126
050,53,005,"Washington","Benton County",4,70,1991,982,1009
050,53,005,"Washington","Benton County",4,71,1904,932,972
050,53,005,"Washington","Benton County",4,72,1770,869,901
050,53,005,"Washington","Benton County",4,73,1772,849,923
050,53,005,"Washington","Benton County",4,74,1639,771,868
050,53,005,"Washington","Benton County",4,75,1752,841,911
050,53,005,"Washington","Benton County",4,76,1190,579,611
050,53,005,"Washington","Benton County",4,77,1132,531,601
050,53,005,"Washington","Benton County",4,78,1130,523,607
050,53,005,"Washington","Benton County",4,79,1167,532,635
050,53,005,"Washington","Benton County",4,80,934,434,500
050,53,005,"Washington","Benton County",4,81,835,389,446
050,53,005,"Washington","Benton County",4,82,770,355,415
050,53,005,"Washington","Benton County",4,83,675,302,373
050,53,005,"Washington","Benton County",4,84,622,281,341
050,53,005,"Washington","Benton County",4,85,3133,1192,1941
050,53,005,"Washington","Benton County",5,0,2479,1231,1248
050,53,005,"Washington","Benton County",5,1,2644,1324,1320
050,53,005,"Washington","Benton County",5,2,2670,1395,1275
050,53,005,"Washington","Benton County",5,3,2772,1430,1342
050,53,005,"Washington","Benton County",5,4,2809,1414,1395
050,53,005,"Washington","Benton County",5,5,2924,1495,1429
050,53,005,"Washington","Benton County",5,6,3081,1579,1502
050,53,005,"Washington","Benton County",5,7,3228,1638,1590
050,53,005,"Washington","Benton County",5,8,3270,1663,1607
050,53,005,"Washington","Benton County",5,9,3187,1679,1508
050,53,005,"Washington","Benton County",5,10,3162,1600,1562
050,53,005,"Washington","Benton County",5,11,3209,1628,1581
050,53,005,"Washington","Benton County",5,12,3332,1744,1588
050,53,005,"Washington","Benton County",5,13,3305,1717,1588
050,53,005,"Washington","Benton County",5,14,3440,1798,1642
050,53,005,"Washington","Benton County",5,15,3457,1800,1657
050,53,005,"Washington","Benton County",5,16,3413,1739,1674
050,53,005,"Washington","Benton County",5,17,3319,1727,1592
050,53,005,"Washington","Benton County",5,18,2774,1460,1314
050,53,005,"Washington","Benton County",5,19,2343,1233,1110
050,53,005,"Washington","Benton County",5,20,2422,1269,1153
050,53,005,"Washington","Benton County",5,21,2502,1308,1194
050,53,005,"Washington","Benton County",5,22,2663,1369,1294
050,53,005,"Washington","Benton County",5,23,2835,1486,1349
050,53,005,"Washington","Benton County",5,24,2713,1405,1308
050,53,005,"Washington","Benton County",5,25,2779,1467,1312
050,53,005,"Washington","Benton County",5,26,2720,1382,1338
050,53,005,"Washington","Benton County",5,27,2797,1444,1353
050,53,005,"Washington","Benton County",5,28,2853,1495,1358
050,53,005,"Washington","Benton County",5,29,3009,1533,1476
050,53,005,"Washington","Benton County",5,30,2988,1524,1464
050,53,005,"Washington","Benton County",5,31,3085,1578,1507
050,53,005,"Washington","Benton County",5,32,3135,1549,1586
050,53,005,"Washington","Benton County",5,33,3092,1551,1541
050,53,005,"Washington","Benton County",5,34,2926,1547,1379
050,53,005,"Washington","Benton County",5,35,2978,1529,1449
050,53,005,"Washington","Benton County",5,36,2959,1561,1398
050,53,005,"Washington","Benton County",5,37,2998,1534,1464
050,53,005,"Washington","Benton County",5,38,3028,1533,1495
050,53,005,"Washington","Benton County",5,39,2955,1524,1431
050,53,005,"Washington","Benton County",5,40,3002,1557,1445
050,53,005,"Washington","Benton County",5,41,3028,1536,1492
050,53,005,"Washington","Benton County",5,42,2982,1526,1456
050,53,005,"Washington","Benton County",5,43,2864,1422,1442
050,53,005,"Washington","Benton County",5,44,2637,1325,1312
050,53,005,"Washington","Benton County",5,45,2559,1324,1235
050,53,005,"Washington","Benton County",5,46,2530,1326,1204
050,53,005,"Washington","Benton County",5,47,2381,1235,1146
050,53,005,"Washington","Benton County",5,48,2287,1149,1138
050,53,005,"Washington","Benton County",5,49,2196,1130,1066
050,53,005,"Washington","Benton County",5,50,2217,1155,1062
050,53,005,"Washington","Benton County",5,51,2262,1162,1100
050,53,005,"Washington","Benton County",5,52,2442,1240,1202
050,53,005,"Washington","Benton County",5,53,2428,1233,1195
050,53,005,"Washington","Benton County",5,54,2303,1172,1131
050,53,005,"Washington","Benton County",5,55,2262,1121,1141
050,53,005,"Washington","Benton County",5,56,2254,1110,1144
050,53,005,"Washington","Benton County",5,57,2191,1103,1088
050,53,005,"Washington","Benton County",5,58,2330,1172,1158
050,53,005,"Washington","Benton County",5,59,2424,1205,1219
050,53,005,"Washington","Benton County",5,60,2483,1229,1254
050,53,005,"Washington","Benton County",5,61,2500,1240,1260
050,53,005,"Washington","Benton County",5,62,2577,1211,1366
050,53,005,"Washington","Benton County",5,63,2444,1174,1270
050,53,005,"Washington","Benton County",5,64,2447,1202,1245
050,53,005,"Washington","Benton County",5,65,2442,1171,1271
050,53,005,"Washington","Benton County",5,66,2369,1171,1198
050,53,005,"Washington","Benton County",5,67,2252,1101,1151
050,53,005,"Washington","Benton County",5,68,2294,1122,1172
050,53,005,"Washington","Benton County",5,69,2187,1056,1131
050,53,005,"Washington","Benton County",5,70,2128,1008,1120
050,53,005,"Washington","Benton County",5,71,1964,955,1009
050,53,005,"Washington","Benton County",5,72,1856,901,955
050,53,005,"Washington","Benton County",5,73,1763,857,906
050,53,005,"Washington","Benton County",5,74,1719,816,903
050,53,005,"Washington","Benton County",5,75,1592,739,853
050,53,005,"Washington","Benton County",5,76,1706,814,892
050,53,005,"Washington","Benton County",5,77,1134,551,583
050,53,005,"Washington","Benton County",5,78,1093,509,584
050,53,005,"Washington","Benton County",5,79,1093,499,594
050,53,005,"Washington","Benton County",5,80,1116,513,603
050,53,005,"Washington","Benton County",5,81,878,401,477
050,53,005,"Washington","Benton County",5,82,789,357,432
050,53,005,"Washington","Benton County",5,83,708,331,377
050,53,005,"Washington","Benton County",5,84,628,271,357
050,53,005,"Washington","Benton County",5,85,3223,1248,1975
050,53,007,"Washington","Chelan County",1,0,888,454,434
050,53,007,"Washington","Chelan County",1,1,898,456,442
050,53,007,"Washington","Chelan County",1,2,884,482,402
050,53,007,"Washington","Chelan County",1,3,967,507,460
050,53,007,"Washington","Chelan County",1,4,1002,554,448
050,53,007,"Washington","Chelan County",1,5,1036,537,499
050,53,007,"Washington","Chelan County",1,6,948,510,438
050,53,007,"Washington","Chelan County",1,7,1020,521,499
050,53,007,"Washington","Chelan County",1,8,1064,561,503
050,53,007,"Washington","Chelan County",1,9,1062,558,504
050,53,007,"Washington","Chelan County",1,10,1124,579,545
050,53,007,"Washington","Chelan County",1,11,1141,597,544
050,53,007,"Washington","Chelan County",1,12,1112,594,518
050,53,007,"Washington","Chelan County",1,13,1102,583,519
050,53,007,"Washington","Chelan County",1,14,1087,569,518
050,53,007,"Washington","Chelan County",1,15,1007,503,504
050,53,007,"Washington","Chelan County",1,16,1009,521,488
050,53,007,"Washington","Chelan County",1,17,1014,523,491
050,53,007,"Washington","Chelan County",1,18,956,505,451
050,53,007,"Washington","Chelan County",1,19,830,441,389
050,53,007,"Washington","Chelan County",1,20,842,439,403
050,53,007,"Washington","Chelan County",1,21,852,425,427
050,53,007,"Washington","Chelan County",1,22,868,440,428
050,53,007,"Washington","Chelan County",1,23,862,428,434
050,53,007,"Washington","Chelan County",1,24,891,456,435
050,53,007,"Washington","Chelan County",1,25,940,478,462
050,53,007,"Washington","Chelan County",1,26,883,453,430
050,53,007,"Washington","Chelan County",1,27,981,539,442
050,53,007,"Washington","Chelan County",1,28,1006,532,474
050,53,007,"Washington","Chelan County",1,29,1014,543,471
050,53,007,"Washington","Chelan County",1,30,1012,554,458
050,53,007,"Washington","Chelan County",1,31,944,497,447
050,53,007,"Washington","Chelan County",1,32,961,488,473
050,53,007,"Washington","Chelan County",1,33,987,499,488
050,53,007,"Washington","Chelan County",1,34,1011,522,489
050,53,007,"Washington","Chelan County",1,35,1011,515,496
050,53,007,"Washington","Chelan County",1,36,988,506,482
050,53,007,"Washington","Chelan County",1,37,1017,515,502
050,53,007,"Washington","Chelan County",1,38,983,485,498
050,53,007,"Washington","Chelan County",1,39,1029,525,504
050,53,007,"Washington","Chelan County",1,40,1022,524,498
050,53,007,"Washington","Chelan County",1,41,921,454,467
050,53,007,"Washington","Chelan County",1,42,921,441,480
050,53,007,"Washington","Chelan County",1,43,898,427,471
050,53,007,"Washington","Chelan County",1,44,847,408,439
050,53,007,"Washington","Chelan County",1,45,838,396,442
050,53,007,"Washington","Chelan County",1,46,804,404,400
050,53,007,"Washington","Chelan County",1,47,825,422,403
050,53,007,"Washington","Chelan County",1,48,846,433,413
050,53,007,"Washington","Chelan County",1,49,893,434,459
050,53,007,"Washington","Chelan County",1,50,878,442,436
050,53,007,"Washington","Chelan County",1,51,881,460,421
050,53,007,"Washington","Chelan County",1,52,897,470,427
050,53,007,"Washington","Chelan County",1,53,915,485,430
050,53,007,"Washington","Chelan County",1,54,898,462,436
050,53,007,"Washington","Chelan County",1,55,949,487,462
050,53,007,"Washington","Chelan County",1,56,1002,502,500
050,53,007,"Washington","Chelan County",1,57,1027,506,521
050,53,007,"Washington","Chelan County",1,58,1058,526,532
050,53,007,"Washington","Chelan County",1,59,1078,540,538
050,53,007,"Washington","Chelan County",1,60,1081,525,556
050,53,007,"Washington","Chelan County",1,61,1158,554,604
050,53,007,"Washington","Chelan County",1,62,1178,585,593
050,53,007,"Washington","Chelan County",1,63,1144,572,572
050,53,007,"Washington","Chelan County",1,64,1126,556,570
050,53,007,"Washington","Chelan County",1,65,1125,566,559
050,53,007,"Washington","Chelan County",1,66,1136,559,577
050,53,007,"Washington","Chelan County",1,67,1074,524,550
050,53,007,"Washington","Chelan County",1,68,1046,526,520
050,53,007,"Washington","Chelan County",1,69,918,471,447
050,53,007,"Washington","Chelan County",1,70,896,457,439
050,53,007,"Washington","Chelan County",1,71,880,418,462
050,53,007,"Washington","Chelan County",1,72,882,444,438
050,53,007,"Washington","Chelan County",1,73,881,428,453
050,53,007,"Washington","Chelan County",1,74,614,292,322
050,53,007,"Washington","Chelan County",1,75,565,287,278
050,53,007,"Washington","Chelan County",1,76,588,282,306
050,53,007,"Washington","Chelan County",1,77,559,271,288
050,53,007,"Washington","Chelan County",1,78,502,230,272
050,53,007,"Washington","Chelan County",1,79,415,195,220
050,53,007,"Washington","Chelan County",1,80,421,190,231
050,53,007,"Washington","Chelan County",1,81,386,179,207
050,53,007,"Washington","Chelan County",1,82,345,164,181
050,53,007,"Washington","Chelan County",1,83,336,160,176
050,53,007,"Washington","Chelan County",1,84,262,104,158
050,53,007,"Washington","Chelan County",1,85,1932,697,1235
050,53,007,"Washington","Chelan County",2,0,877,449,428
050,53,007,"Washington","Chelan County",2,1,893,456,437
050,53,007,"Washington","Chelan County",2,2,884,473,411
050,53,007,"Washington","Chelan County",2,3,947,502,445
050,53,007,"Washington","Chelan County",2,4,998,545,453
050,53,007,"Washington","Chelan County",2,5,1028,543,485
050,53,007,"Washington","Chelan County",2,6,970,517,453
050,53,007,"Washington","Chelan County",2,7,1004,521,483
050,53,007,"Washington","Chelan County",2,8,1054,554,500
050,53,007,"Washington","Chelan County",2,9,1065,559,506
050,53,007,"Washington","Chelan County",2,10,1110,573,537
050,53,007,"Washington","Chelan County",2,11,1137,591,546
050,53,007,"Washington","Chelan County",2,12,1126,594,532
050,53,007,"Washington","Chelan County",2,13,1107,588,519
050,53,007,"Washington","Chelan County",2,14,1094,574,520
050,53,007,"Washington","Chelan County",2,15,1029,522,507
050,53,007,"Washington","Chelan County",2,16,1017,518,499
050,53,007,"Washington","Chelan County",2,17,1016,525,491
050,53,007,"Washington","Chelan County",2,18,936,494,442
050,53,007,"Washington","Chelan County",2,19,833,443,390
050,53,007,"Washington","Chelan County",2,20,852,445,407
050,53,007,"Washington","Chelan County",2,21,858,429,429
050,53,007,"Washington","Chelan County",2,22,870,441,429
050,53,007,"Washington","Chelan County",2,23,866,432,434
050,53,007,"Washington","Chelan County",2,24,890,451,439
050,53,007,"Washington","Chelan County",2,25,926,474,452
050,53,007,"Washington","Chelan County",2,26,900,462,438
050,53,007,"Washington","Chelan County",2,27,972,532,440
050,53,007,"Washington","Chelan County",2,28,1000,532,468
050,53,007,"Washington","Chelan County",2,29,1008,539,469
050,53,007,"Washington","Chelan County",2,30,1022,557,465
050,53,007,"Washington","Chelan County",2,31,955,504,451
050,53,007,"Washington","Chelan County",2,32,969,500,469
050,53,007,"Washington","Chelan County",2,33,982,496,486
050,53,007,"Washington","Chelan County",2,34,1009,521,488
050,53,007,"Washington","Chelan County",2,35,1020,518,502
050,53,007,"Washington","Chelan County",2,36,996,507,489
050,53,007,"Washington","Chelan County",2,37,1008,510,498
050,53,007,"Washington","Chelan County",2,38,1002,499,503
050,53,007,"Washington","Chelan County",2,39,1016,515,501
050,53,007,"Washington","Chelan County",2,40,1036,529,507
050,53,007,"Washington","Chelan County",2,41,946,472,474
050,53,007,"Washington","Chelan County",2,42,916,444,472
050,53,007,"Washington","Chelan County",2,43,911,432,479
050,53,007,"Washington","Chelan County",2,44,849,407,442
050,53,007,"Washington","Chelan County",2,45,842,397,445
050,53,007,"Washington","Chelan County",2,46,809,399,410
050,53,007,"Washington","Chelan County",2,47,819,416,403
050,53,007,"Washington","Chelan County",2,48,841,428,413
050,53,007,"Washington","Chelan County",2,49,894,437,457
050,53,007,"Washington","Chelan County",2,50,883,444,439
050,53,007,"Washington","Chelan County",2,51,881,454,427
050,53,007,"Washington","Chelan County",2,52,891,465,426
050,53,007,"Washington","Chelan County",2,53,913,486,427
050,53,007,"Washington","Chelan County",2,54,901,468,433
050,53,007,"Washington","Chelan County",2,55,935,477,458
050,53,007,"Washington","Chelan County",2,56,989,500,489
050,53,007,"Washington","Chelan County",2,57,1022,504,518
050,53,007,"Washington","Chelan County",2,58,1049,517,532
050,53,007,"Washington","Chelan County",2,59,1081,545,536
050,53,007,"Washington","Chelan County",2,60,1087,534,553
050,53,007,"Washington","Chelan County",2,61,1143,550,593
050,53,007,"Washington","Chelan County",2,62,1167,575,592
050,53,007,"Washington","Chelan County",2,63,1161,581,580
050,53,007,"Washington","Chelan County",2,64,1123,555,568
050,53,007,"Washington","Chelan County",2,65,1128,566,562
050,53,007,"Washington","Chelan County",2,66,1139,562,577
050,53,007,"Washington","Chelan County",2,67,1085,530,555
050,53,007,"Washington","Chelan County",2,68,1043,519,524
050,53,007,"Washington","Chelan County",2,69,953,487,466
050,53,007,"Washington","Chelan County",2,70,898,458,440
050,53,007,"Washington","Chelan County",2,71,888,428,460
050,53,007,"Washington","Chelan County",2,72,870,433,437
050,53,007,"Washington","Chelan County",2,73,924,449,475
050,53,007,"Washington","Chelan County",2,74,636,304,332
050,53,007,"Washington","Chelan County",2,75,574,288,286
050,53,007,"Washington","Chelan County",2,76,571,275,296
050,53,007,"Washington","Chelan County",2,77,571,275,296
050,53,007,"Washington","Chelan County",2,78,502,231,271
050,53,007,"Washington","Chelan County",2,79,428,199,229
050,53,007,"Washington","Chelan County",2,80,423,190,233
050,53,007,"Washington","Chelan County",2,81,381,176,205
050,53,007,"Washington","Chelan County",2,82,352,166,186
050,53,007,"Washington","Chelan County",2,83,335,158,177
050,53,007,"Washington","Chelan County",2,84,267,112,155
050,53,007,"Washington","Chelan County",2,85,1935,696,1239
050,53,007,"Washington","Chelan County",3,0,788,419,369
050,53,007,"Washington","Chelan County",3,1,877,438,439
050,53,007,"Washington","Chelan County",3,2,925,475,450
050,53,007,"Washington","Chelan County",3,3,895,478,417
050,53,007,"Washington","Chelan County",3,4,927,494,433
050,53,007,"Washington","Chelan County",3,5,1017,550,467
050,53,007,"Washington","Chelan County",3,6,1032,550,482
050,53,007,"Washington","Chelan County",3,7,943,505,438
050,53,007,"Washington","Chelan County",3,8,1019,520,499
050,53,007,"Washington","Chelan County",3,9,1050,545,505
050,53,007,"Washington","Chelan County",3,10,1040,530,510
050,53,007,"Washington","Chelan County",3,11,1105,563,542
050,53,007,"Washington","Chelan County",3,12,1122,579,543
050,53,007,"Washington","Chelan County",3,13,1116,597,519
050,53,007,"Washington","Chelan County",3,14,1107,584,523
050,53,007,"Washington","Chelan County",3,15,1088,581,507
050,53,007,"Washington","Chelan County",3,16,1014,511,503
050,53,007,"Washington","Chelan County",3,17,1006,512,494
050,53,007,"Washington","Chelan County",3,18,901,473,428
050,53,007,"Washington","Chelan County",3,19,827,443,384
050,53,007,"Washington","Chelan County",3,20,870,470,400
050,53,007,"Washington","Chelan County",3,21,891,457,434
050,53,007,"Washington","Chelan County",3,22,891,454,437
050,53,007,"Washington","Chelan County",3,23,882,450,432
050,53,007,"Washington","Chelan County",3,24,884,431,453
050,53,007,"Washington","Chelan County",3,25,923,469,454
050,53,007,"Washington","Chelan County",3,26,940,483,457
050,53,007,"Washington","Chelan County",3,27,961,518,443
050,53,007,"Washington","Chelan County",3,28,979,522,457
050,53,007,"Washington","Chelan County",3,29,993,528,465
050,53,007,"Washington","Chelan County",3,30,1043,563,480
050,53,007,"Washington","Chelan County",3,31,1040,565,475
050,53,007,"Washington","Chelan County",3,32,981,527,454
050,53,007,"Washington","Chelan County",3,33,1002,507,495
050,53,007,"Washington","Chelan County",3,34,998,513,485
050,53,007,"Washington","Chelan County",3,35,1018,533,485
050,53,007,"Washington","Chelan County",3,36,1044,529,515
050,53,007,"Washington","Chelan County",3,37,1008,517,491
050,53,007,"Washington","Chelan County",3,38,1052,540,512
050,53,007,"Washington","Chelan County",3,39,988,485,503
050,53,007,"Washington","Chelan County",3,40,1033,517,516
050,53,007,"Washington","Chelan County",3,41,1047,527,520
050,53,007,"Washington","Chelan County",3,42,942,485,457
050,53,007,"Washington","Chelan County",3,43,935,451,484
050,53,007,"Washington","Chelan County",3,44,888,420,468
050,53,007,"Washington","Chelan County",3,45,861,410,451
050,53,007,"Washington","Chelan County",3,46,843,399,444
050,53,007,"Washington","Chelan County",3,47,811,394,417
050,53,007,"Washington","Chelan County",3,48,807,416,391
050,53,007,"Washington","Chelan County",3,49,840,419,421
050,53,007,"Washington","Chelan County",3,50,876,447,429
050,53,007,"Washington","Chelan County",3,51,893,438,455
050,53,007,"Washington","Chelan County",3,52,879,444,435
050,53,007,"Washington","Chelan County",3,53,931,495,436
050,53,007,"Washington","Chelan County",3,54,910,482,428
050,53,007,"Washington","Chelan County",3,55,877,445,432
050,53,007,"Washington","Chelan County",3,56,958,483,475
050,53,007,"Washington","Chelan County",3,57,989,501,488
050,53,007,"Washington","Chelan County",3,58,1050,501,549
050,53,007,"Washington","Chelan County",3,59,1063,513,550
050,53,007,"Washington","Chelan County",3,60,1104,555,549
050,53,007,"Washington","Chelan County",3,61,1106,549,557
050,53,007,"Washington","Chelan County",3,62,1169,562,607
050,53,007,"Washington","Chelan County",3,63,1181,580,601
050,53,007,"Washington","Chelan County",3,64,1176,596,580
050,53,007,"Washington","Chelan County",3,65,1138,572,566
050,53,007,"Washington","Chelan County",3,66,1138,569,569
050,53,007,"Washington","Chelan County",3,67,1116,546,570
050,53,007,"Washington","Chelan County",3,68,1086,535,551
050,53,007,"Washington","Chelan County",3,69,1026,508,518
050,53,007,"Washington","Chelan County",3,70,937,484,453
050,53,007,"Washington","Chelan County",3,71,885,453,432
050,53,007,"Washington","Chelan County",3,72,872,433,439
050,53,007,"Washington","Chelan County",3,73,832,402,430
050,53,007,"Washington","Chelan County",3,74,902,435,467
050,53,007,"Washington","Chelan County",3,75,616,297,319
050,53,007,"Washington","Chelan County",3,76,561,271,290
050,53,007,"Washington","Chelan County",3,77,541,265,276
050,53,007,"Washington","Chelan County",3,78,551,265,286
050,53,007,"Washington","Chelan County",3,79,481,222,259
050,53,007,"Washington","Chelan County",3,80,421,193,228
050,53,007,"Washington","Chelan County",3,81,370,169,201
050,53,007,"Washington","Chelan County",3,82,365,166,199
050,53,007,"Washington","Chelan County",3,83,355,163,192
050,53,007,"Washington","Chelan County",3,84,282,131,151
050,53,007,"Washington","Chelan County",3,85,1947,704,1243
050,53,007,"Washington","Chelan County",4,0,803,401,402
050,53,007,"Washington","Chelan County",4,1,811,421,390
050,53,007,"Washington","Chelan County",4,2,896,445,451
050,53,007,"Washington","Chelan County",4,3,955,480,475
050,53,007,"Washington","Chelan County",4,4,933,487,446
050,53,007,"Washington","Chelan County",4,5,930,488,442
050,53,007,"Washington","Chelan County",4,6,1021,551,470
050,53,007,"Washington","Chelan County",4,7,1040,555,485
050,53,007,"Washington","Chelan County",4,8,974,526,448
050,53,007,"Washington","Chelan County",4,9,1018,523,495
050,53,007,"Washington","Chelan County",4,10,1055,545,510
050,53,007,"Washington","Chelan County",4,11,1073,544,529
050,53,007,"Washington","Chelan County",4,12,1121,557,564
050,53,007,"Washington","Chelan County",4,13,1122,584,538
050,53,007,"Washington","Chelan County",4,14,1142,608,534
050,53,007,"Washington","Chelan County",4,15,1090,578,512
050,53,007,"Washington","Chelan County",4,16,1073,560,513
050,53,007,"Washington","Chelan County",4,17,1000,510,490
050,53,007,"Washington","Chelan County",4,18,897,473,424
050,53,007,"Washington","Chelan County",4,19,757,399,358
050,53,007,"Washington","Chelan County",4,20,848,445,403
050,53,007,"Washington","Chelan County",4,21,903,471,432
050,53,007,"Washington","Chelan County",4,22,898,464,434
050,53,007,"Washington","Chelan County",4,23,897,455,442
050,53,007,"Washington","Chelan County",4,24,892,460,432
050,53,007,"Washington","Chelan County",4,25,897,452,445
050,53,007,"Washington","Chelan County",4,26,915,472,443
050,53,007,"Washington","Chelan County",4,27,988,530,458
050,53,007,"Washington","Chelan County",4,28,959,499,460
050,53,007,"Washington","Chelan County",4,29,950,495,455
050,53,007,"Washington","Chelan County",4,30,1025,551,474
050,53,007,"Washington","Chelan County",4,31,1083,581,502
050,53,007,"Washington","Chelan County",4,32,1056,576,480
050,53,007,"Washington","Chelan County",4,33,971,504,467
050,53,007,"Washington","Chelan County",4,34,1057,551,506
050,53,007,"Washington","Chelan County",4,35,999,504,495
050,53,007,"Washington","Chelan County",4,36,1045,549,496
050,53,007,"Washington","Chelan County",4,37,1028,511,517
050,53,007,"Washington","Chelan County",4,38,1037,528,509
050,53,007,"Washington","Chelan County",4,39,1065,537,528
050,53,007,"Washington","Chelan County",4,40,1009,491,518
050,53,007,"Washington","Chelan County",4,41,1051,533,518
050,53,007,"Washington","Chelan County",4,42,1041,529,512
050,53,007,"Washington","Chelan County",4,43,970,487,483
050,53,007,"Washington","Chelan County",4,44,929,445,484
050,53,007,"Washington","Chelan County",4,45,898,432,466
050,53,007,"Washington","Chelan County",4,46,880,415,465
050,53,007,"Washington","Chelan County",4,47,850,405,445
050,53,007,"Washington","Chelan County",4,48,778,377,401
050,53,007,"Washington","Chelan County",4,49,814,410,404
050,53,007,"Washington","Chelan County",4,50,820,430,390
050,53,007,"Washington","Chelan County",4,51,893,456,437
050,53,007,"Washington","Chelan County",4,52,886,435,451
050,53,007,"Washington","Chelan County",4,53,876,443,433
050,53,007,"Washington","Chelan County",4,54,912,489,423
050,53,007,"Washington","Chelan County",4,55,898,477,421
050,53,007,"Washington","Chelan County",4,56,873,444,429
050,53,007,"Washington","Chelan County",4,57,969,476,493
050,53,007,"Washington","Chelan County",4,58,992,503,489
050,53,007,"Washington","Chelan County",4,59,1040,510,530
050,53,007,"Washington","Chelan County",4,60,1067,513,554
050,53,007,"Washington","Chelan County",4,61,1087,542,545
050,53,007,"Washington","Chelan County",4,62,1075,531,544
050,53,007,"Washington","Chelan County",4,63,1160,552,608
050,53,007,"Washington","Chelan County",4,64,1197,592,605
050,53,007,"Washington","Chelan County",4,65,1156,591,565
050,53,007,"Washington","Chelan County",4,66,1130,569,561
050,53,007,"Washington","Chelan County",4,67,1114,557,557
050,53,007,"Washington","Chelan County",4,68,1119,553,566
050,53,007,"Washington","Chelan County",4,69,1059,521,538
050,53,007,"Washington","Chelan County",4,70,1007,511,496
050,53,007,"Washington","Chelan County",4,71,903,466,437
050,53,007,"Washington","Chelan County",4,72,882,457,425
050,53,007,"Washington","Chelan County",4,73,833,412,421
050,53,007,"Washington","Chelan County",4,74,809,382,427
050,53,007,"Washington","Chelan County",4,75,885,423,462
050,53,007,"Washington","Chelan County",4,76,590,275,315
050,53,007,"Washington","Chelan County",4,77,541,266,275
050,53,007,"Washington","Chelan County",4,78,532,260,272
050,53,007,"Washington","Chelan County",4,79,521,241,280
050,53,007,"Washington","Chelan County",4,80,479,214,265
050,53,007,"Washington","Chelan County",4,81,366,182,184
050,53,007,"Washington","Chelan County",4,82,351,161,190
050,53,007,"Washington","Chelan County",4,83,353,155,198
050,53,007,"Washington","Chelan County",4,84,285,134,151
050,53,007,"Washington","Chelan County",4,85,1934,707,1227
050,53,007,"Washington","Chelan County",5,0,800,400,400
050,53,007,"Washington","Chelan County",5,1,787,390,397
050,53,007,"Washington","Chelan County",5,2,813,422,391
050,53,007,"Washington","Chelan County",5,3,918,442,476
050,53,007,"Washington","Chelan County",5,4,967,487,480
050,53,007,"Washington","Chelan County",5,5,919,487,432
050,53,007,"Washington","Chelan County",5,6,952,496,456
050,53,007,"Washington","Chelan County",5,7,1012,538,474
050,53,007,"Washington","Chelan County",5,8,1047,547,500
050,53,007,"Washington","Chelan County",5,9,983,522,461
050,53,007,"Washington","Chelan County",5,10,1009,520,489
050,53,007,"Washington","Chelan County",5,11,1081,557,524
050,53,007,"Washington","Chelan County",5,12,1076,543,533
050,53,007,"Washington","Chelan County",5,13,1124,555,569
050,53,007,"Washington","Chelan County",5,14,1135,588,547
050,53,007,"Washington","Chelan County",5,15,1114,600,514
050,53,007,"Washington","Chelan County",5,16,1074,568,506
050,53,007,"Washington","Chelan County",5,17,1080,565,515
050,53,007,"Washington","Chelan County",5,18,907,484,423
050,53,007,"Washington","Chelan County",5,19,761,400,361
050,53,007,"Washington","Chelan County",5,20,777,401,376
050,53,007,"Washington","Chelan County",5,21,874,441,433
050,53,007,"Washington","Chelan County",5,22,934,506,428
050,53,007,"Washington","Chelan County",5,23,883,434,449
050,53,007,"Washington","Chelan County",5,24,905,483,422
050,53,007,"Washington","Chelan County",5,25,911,486,425
050,53,007,"Washington","Chelan County",5,26,949,477,472
050,53,007,"Washington","Chelan County",5,27,991,535,456
050,53,007,"Washington","Chelan County",5,28,948,500,448
050,53,007,"Washington","Chelan County",5,29,942,507,435
050,53,007,"Washington","Chelan County",5,30,1012,552,460
050,53,007,"Washington","Chelan County",5,31,1037,548,489
050,53,007,"Washington","Chelan County",5,32,1114,602,512
050,53,007,"Washington","Chelan County",5,33,1029,539,490
050,53,007,"Washington","Chelan County",5,34,984,514,470
050,53,007,"Washington","Chelan County",5,35,1047,553,494
050,53,007,"Washington","Chelan County",5,36,1040,529,511
050,53,007,"Washington","Chelan County",5,37,1046,551,495
050,53,007,"Washington","Chelan County",5,38,1030,514,516
050,53,007,"Washington","Chelan County",5,39,1010,505,505
050,53,007,"Washington","Chelan County",5,40,1078,537,541
050,53,007,"Washington","Chelan County",5,41,1037,518,519
050,53,007,"Washington","Chelan County",5,42,1032,532,500
050,53,007,"Washington","Chelan County",5,43,1027,514,513
050,53,007,"Washington","Chelan County",5,44,955,486,469
050,53,007,"Washington","Chelan County",5,45,947,441,506
050,53,007,"Washington","Chelan County",5,46,894,426,468
050,53,007,"Washington","Chelan County",5,47,884,414,470
050,53,007,"Washington","Chelan County",5,48,825,401,424
050,53,007,"Washington","Chelan County",5,49,784,371,413
050,53,007,"Washington","Chelan County",5,50,807,422,385
050,53,007,"Washington","Chelan County",5,51,787,414,373
050,53,007,"Washington","Chelan County",5,52,889,451,438
050,53,007,"Washington","Chelan County",5,53,887,434,453
050,53,007,"Washington","Chelan County",5,54,875,439,436
050,53,007,"Washington","Chelan County",5,55,898,471,427
050,53,007,"Washington","Chelan County",5,56,914,490,424
050,53,007,"Washington","Chelan County",5,57,868,437,431
050,53,007,"Washington","Chelan County",5,58,971,484,487
050,53,007,"Washington","Chelan County",5,59,984,501,483
050,53,007,"Washington","Chelan County",5,60,1019,501,518
050,53,007,"Washington","Chelan County",5,61,1060,509,551
050,53,007,"Washington","Chelan County",5,62,1043,521,522
050,53,007,"Washington","Chelan County",5,63,1052,516,536
050,53,007,"Washington","Chelan County",5,64,1176,571,605
050,53,007,"Washington","Chelan County",5,65,1210,602,608
050,53,007,"Washington","Chelan County",5,66,1155,583,572
050,53,007,"Washington","Chelan County",5,67,1086,545,541
050,53,007,"Washington","Chelan County",5,68,1106,559,547
050,53,007,"Washington","Chelan County",5,69,1089,537,552
050,53,007,"Washington","Chelan County",5,70,1038,509,529
050,53,007,"Washington","Chelan County",5,71,965,484,481
050,53,007,"Washington","Chelan County",5,72,899,469,430
050,53,007,"Washington","Chelan County",5,73,846,428,418
050,53,007,"Washington","Chelan County",5,74,818,401,417
050,53,007,"Washington","Chelan County",5,75,779,369,410
050,53,007,"Washington","Chelan County",5,76,847,396,451
050,53,007,"Washington","Chelan County",5,77,569,266,303
050,53,007,"Washington","Chelan County",5,78,524,255,269
050,53,007,"Washington","Chelan County",5,79,498,236,262
050,53,007,"Washington","Chelan County",5,80,523,234,289
050,53,007,"Washington","Chelan County",5,81,432,205,227
050,53,007,"Washington","Chelan County",5,82,346,173,173
050,53,007,"Washington","Chelan County",5,83,341,152,189
050,53,007,"Washington","Chelan County",5,84,292,129,163
050,53,007,"Washington","Chelan County",5,85,1919,721,1198
050,53,009,"Washington","Clallam County",1,0,581,297,284
050,53,009,"Washington","Clallam County",1,1,575,285,290
050,53,009,"Washington","Clallam County",1,2,633,318,315
050,53,009,"Washington","Clallam County",1,3,676,368,308
050,53,009,"Washington","Clallam County",1,4,716,382,334
050,53,009,"Washington","Clallam County",1,5,724,393,331
050,53,009,"Washington","Clallam County",1,6,733,388,345
050,53,009,"Washington","Clallam County",1,7,728,380,348
050,53,009,"Washington","Clallam County",1,8,761,374,387
050,53,009,"Washington","Clallam County",1,9,763,384,379
050,53,009,"Washington","Clallam County",1,10,737,380,357
050,53,009,"Washington","Clallam County",1,11,756,393,363
050,53,009,"Washington","Clallam County",1,12,766,401,365
050,53,009,"Washington","Clallam County",1,13,749,388,361
050,53,009,"Washington","Clallam County",1,14,749,392,357
050,53,009,"Washington","Clallam County",1,15,721,355,366
050,53,009,"Washington","Clallam County",1,16,746,374,372
050,53,009,"Washington","Clallam County",1,17,722,360,362
050,53,009,"Washington","Clallam County",1,18,651,341,310
050,53,009,"Washington","Clallam County",1,19,561,322,239
050,53,009,"Washington","Clallam County",1,20,639,352,287
050,53,009,"Washington","Clallam County",1,21,665,376,289
050,53,009,"Washington","Clallam County",1,22,684,387,297
050,53,009,"Washington","Clallam County",1,23,719,396,323
050,53,009,"Washington","Clallam County",1,24,687,362,325
050,53,009,"Washington","Clallam County",1,25,669,345,324
050,53,009,"Washington","Clallam County",1,26,670,376,294
050,53,009,"Washington","Clallam County",1,27,728,410,318
050,53,009,"Washington","Clallam County",1,28,818,433,385
050,53,009,"Washington","Clallam County",1,29,858,448,410
050,53,009,"Washington","Clallam County",1,30,852,456,396
050,53,009,"Washington","Clallam County",1,31,835,422,413
050,53,009,"Washington","Clallam County",1,32,825,422,403
050,53,009,"Washington","Clallam County",1,33,838,443,395
050,53,009,"Washington","Clallam County",1,34,852,431,421
050,53,009,"Washington","Clallam County",1,35,896,464,432
050,53,009,"Washington","Clallam County",1,36,805,404,401
050,53,009,"Washington","Clallam County",1,37,824,416,408
050,53,009,"Washington","Clallam County",1,38,866,464,402
050,53,009,"Washington","Clallam County",1,39,886,448,438
050,53,009,"Washington","Clallam County",1,40,891,479,412
050,53,009,"Washington","Clallam County",1,41,809,421,388
050,53,009,"Washington","Clallam County",1,42,769,395,374
050,53,009,"Washington","Clallam County",1,43,744,386,358
050,53,009,"Washington","Clallam County",1,44,749,376,373
050,53,009,"Washington","Clallam County",1,45,680,330,350
050,53,009,"Washington","Clallam County",1,46,693,334,359
050,53,009,"Washington","Clallam County",1,47,703,342,361
050,53,009,"Washington","Clallam County",1,48,703,363,340
050,53,009,"Washington","Clallam County",1,49,787,392,395
050,53,009,"Washington","Clallam County",1,50,808,390,418
050,53,009,"Washington","Clallam County",1,51,799,390,409
050,53,009,"Washington","Clallam County",1,52,810,405,405
050,53,009,"Washington","Clallam County",1,53,789,384,405
050,53,009,"Washington","Clallam County",1,54,818,397,421
050,53,009,"Washington","Clallam County",1,55,889,424,465
050,53,009,"Washington","Clallam County",1,56,949,457,492
050,53,009,"Washington","Clallam County",1,57,1070,510,560
050,53,009,"Washington","Clallam County",1,58,1204,531,673
050,53,009,"Washington","Clallam County",1,59,1223,558,665
050,53,009,"Washington","Clallam County",1,60,1286,590,696
050,53,009,"Washington","Clallam County",1,61,1326,644,682
050,53,009,"Washington","Clallam County",1,62,1363,650,713
050,53,009,"Washington","Clallam County",1,63,1460,687,773
050,53,009,"Washington","Clallam County",1,64,1510,720,790
050,53,009,"Washington","Clallam County",1,65,1500,696,804
050,53,009,"Washington","Clallam County",1,66,1577,745,832
050,53,009,"Washington","Clallam County",1,67,1612,742,870
050,53,009,"Washington","Clallam County",1,68,1650,791,859
050,53,009,"Washington","Clallam County",1,69,1426,671,755
050,53,009,"Washington","Clallam County",1,70,1361,645,716
050,53,009,"Washington","Clallam County",1,71,1371,664,707
050,53,009,"Washington","Clallam County",1,72,1385,656,729
050,53,009,"Washington","Clallam County",1,73,1382,652,730
050,53,009,"Washington","Clallam County",1,74,931,424,507
050,53,009,"Washington","Clallam County",1,75,965,457,508
050,53,009,"Washington","Clallam County",1,76,994,486,508
050,53,009,"Washington","Clallam County",1,77,960,460,500
050,53,009,"Washington","Clallam County",1,78,828,400,428
050,53,009,"Washington","Clallam County",1,79,680,323,357
050,53,009,"Washington","Clallam County",1,80,636,313,323
050,53,009,"Washington","Clallam County",1,81,577,281,296
050,53,009,"Washington","Clallam County",1,82,485,243,242
050,53,009,"Washington","Clallam County",1,83,455,216,239
050,53,009,"Washington","Clallam County",1,84,410,199,211
050,53,009,"Washington","Clallam County",1,85,2485,1005,1480
050,53,009,"Washington","Clallam County",2,0,603,321,282
050,53,009,"Washington","Clallam County",2,1,577,287,290
050,53,009,"Washington","Clallam County",2,2,621,312,309
050,53,009,"Washington","Clallam County",2,3,668,358,310
050,53,009,"Washington","Clallam County",2,4,711,381,330
050,53,009,"Washington","Clallam County",2,5,727,393,334
050,53,009,"Washington","Clallam County",2,6,739,394,345
050,53,009,"Washington","Clallam County",2,7,731,383,348
050,53,009,"Washington","Clallam County",2,8,747,374,373
050,53,009,"Washington","Clallam County",2,9,763,384,379
050,53,009,"Washington","Clallam County",2,10,748,383,365
050,53,009,"Washington","Clallam County",2,11,750,388,362
050,53,009,"Washington","Clallam County",2,12,768,401,367
050,53,009,"Washington","Clallam County",2,13,751,391,360
050,53,009,"Washington","Clallam County",2,14,749,391,358
050,53,009,"Washington","Clallam County",2,15,729,364,365
050,53,009,"Washington","Clallam County",2,16,740,370,370
050,53,009,"Washington","Clallam County",2,17,730,363,367
050,53,009,"Washington","Clallam County",2,18,641,335,306
050,53,009,"Washington","Clallam County",2,19,566,318,248
050,53,009,"Washington","Clallam County",2,20,634,352,282
050,53,009,"Washington","Clallam County",2,21,665,374,291
050,53,009,"Washington","Clallam County",2,22,687,387,300
050,53,009,"Washington","Clallam County",2,23,723,401,322
050,53,009,"Washington","Clallam County",2,24,688,363,325
050,53,009,"Washington","Clallam County",2,25,676,349,327
050,53,009,"Washington","Clallam County",2,26,668,364,304
050,53,009,"Washington","Clallam County",2,27,719,406,313
050,53,009,"Washington","Clallam County",2,28,799,429,370
050,53,009,"Washington","Clallam County",2,29,844,443,401
050,53,009,"Washington","Clallam County",2,30,867,459,408
050,53,009,"Washington","Clallam County",2,31,837,429,408
050,53,009,"Washington","Clallam County",2,32,825,421,404
050,53,009,"Washington","Clallam County",2,33,837,437,400
050,53,009,"Washington","Clallam County",2,34,852,436,416
050,53,009,"Washington","Clallam County",2,35,893,459,434
050,53,009,"Washington","Clallam County",2,36,829,419,410
050,53,009,"Washington","Clallam County",2,37,823,415,408
050,53,009,"Washington","Clallam County",2,38,866,463,403
050,53,009,"Washington","Clallam County",2,39,881,453,428
050,53,009,"Washington","Clallam County",2,40,899,477,422
050,53,009,"Washington","Clallam County",2,41,827,432,395
050,53,009,"Washington","Clallam County",2,42,778,401,377
050,53,009,"Washington","Clallam County",2,43,758,391,367
050,53,009,"Washington","Clallam County",2,44,738,373,365
050,53,009,"Washington","Clallam County",2,45,700,341,359
050,53,009,"Washington","Clallam County",2,46,691,335,356
050,53,009,"Washington","Clallam County",2,47,697,338,359
050,53,009,"Washington","Clallam County",2,48,703,359,344
050,53,009,"Washington","Clallam County",2,49,768,385,383
050,53,009,"Washington","Clallam County",2,50,810,393,417
050,53,009,"Washington","Clallam County",2,51,803,394,409
050,53,009,"Washington","Clallam County",2,52,808,402,406
050,53,009,"Washington","Clallam County",2,53,797,392,405
050,53,009,"Washington","Clallam County",2,54,811,390,421
050,53,009,"Washington","Clallam County",2,55,875,418,457
050,53,009,"Washington","Clallam County",2,56,941,452,489
050,53,009,"Washington","Clallam County",2,57,1054,501,553
050,53,009,"Washington","Clallam County",2,58,1175,528,647
050,53,009,"Washington","Clallam County",2,59,1235,557,678
050,53,009,"Washington","Clallam County",2,60,1281,586,695
050,53,009,"Washington","Clallam County",2,61,1323,632,691
050,53,009,"Washington","Clallam County",2,62,1364,654,710
050,53,009,"Washington","Clallam County",2,63,1461,689,772
050,53,009,"Washington","Clallam County",2,64,1504,710,794
050,53,009,"Washington","Clallam County",2,65,1510,704,806
050,53,009,"Washington","Clallam County",2,66,1579,745,834
050,53,009,"Washington","Clallam County",2,67,1609,743,866
050,53,009,"Washington","Clallam County",2,68,1635,778,857
050,53,009,"Washington","Clallam County",2,69,1494,706,788
050,53,009,"Washington","Clallam County",2,70,1377,650,727
050,53,009,"Washington","Clallam County",2,71,1367,658,709
050,53,009,"Washington","Clallam County",2,72,1350,648,702
050,53,009,"Washington","Clallam County",2,73,1450,685,765
050,53,009,"Washington","Clallam County",2,74,971,446,525
050,53,009,"Washington","Clallam County",2,75,957,450,507
050,53,009,"Washington","Clallam County",2,76,973,473,500
050,53,009,"Washington","Clallam County",2,77,987,477,510
050,53,009,"Washington","Clallam County",2,78,841,405,436
050,53,009,"Washington","Clallam County",2,79,707,336,371
050,53,009,"Washington","Clallam County",2,80,637,309,328
050,53,009,"Washington","Clallam County",2,81,581,286,295
050,53,009,"Washington","Clallam County",2,82,500,252,248
050,53,009,"Washington","Clallam County",2,83,453,218,235
050,53,009,"Washington","Clallam County",2,84,414,201,213
050,53,009,"Washington","Clallam County",2,85,2502,1017,1485
050,53,009,"Washington","Clallam County",3,0,611,316,295
050,53,009,"Washington","Clallam County",3,1,591,309,282
050,53,009,"Washington","Clallam County",3,2,617,315,302
050,53,009,"Washington","Clallam County",3,3,655,337,318
050,53,009,"Washington","Clallam County",3,4,693,383,310
050,53,009,"Washington","Clallam County",3,5,720,381,339
050,53,009,"Washington","Clallam County",3,6,748,395,353
050,53,009,"Washington","Clallam County",3,7,743,392,351
050,53,009,"Washington","Clallam County",3,8,722,381,341
050,53,009,"Washington","Clallam County",3,9,753,367,386
050,53,009,"Washington","Clallam County",3,10,750,382,368
050,53,009,"Washington","Clallam County",3,11,747,380,367
050,53,009,"Washington","Clallam County",3,12,755,396,359
050,53,009,"Washington","Clallam County",3,13,789,408,381
050,53,009,"Washington","Clallam County",3,14,746,390,356
050,53,009,"Washington","Clallam County",3,15,748,381,367
050,53,009,"Washington","Clallam County",3,16,732,368,364
050,53,009,"Washington","Clallam County",3,17,742,375,367
050,53,009,"Washington","Clallam County",3,18,665,349,316
050,53,009,"Washington","Clallam County",3,19,542,281,261
050,53,009,"Washington","Clallam County",3,20,618,357,261
050,53,009,"Washington","Clallam County",3,21,672,375,297
050,53,009,"Washington","Clallam County",3,22,682,383,299
050,53,009,"Washington","Clallam County",3,23,765,427,338
050,53,009,"Washington","Clallam County",3,24,747,401,346
050,53,009,"Washington","Clallam County",3,25,743,397,346
050,53,009,"Washington","Clallam County",3,26,716,366,350
050,53,009,"Washington","Clallam County",3,27,745,409,336
050,53,009,"Washington","Clallam County",3,28,774,433,341
050,53,009,"Washington","Clallam County",3,29,818,424,394
050,53,009,"Washington","Clallam County",3,30,913,497,416
050,53,009,"Washington","Clallam County",3,31,889,460,429
050,53,009,"Washington","Clallam County",3,32,864,445,419
050,53,009,"Washington","Clallam County",3,33,847,433,414
050,53,009,"Washington","Clallam County",3,34,862,436,426
050,53,009,"Washington","Clallam County",3,35,883,455,428
050,53,009,"Washington","Clallam County",3,36,918,464,454
050,53,009,"Washington","Clallam County",3,37,846,422,424
050,53,009,"Washington","Clallam County",3,38,847,439,408
050,53,009,"Washington","Clallam County",3,39,880,461,419
050,53,009,"Washington","Clallam County",3,40,898,453,445
050,53,009,"Washington","Clallam County",3,41,910,482,428
050,53,009,"Washington","Clallam County",3,42,851,445,406
050,53,009,"Washington","Clallam County",3,43,765,392,373
050,53,009,"Washington","Clallam County",3,44,774,394,380
050,53,009,"Washington","Clallam County",3,45,748,389,359
050,53,009,"Washington","Clallam County",3,46,734,367,367
050,53,009,"Washington","Clallam County",3,47,687,333,354
050,53,009,"Washington","Clallam County",3,48,719,352,367
050,53,009,"Washington","Clallam County",3,49,710,352,358
050,53,009,"Washington","Clallam County",3,50,775,395,380
050,53,009,"Washington","Clallam County",3,51,825,396,429
050,53,009,"Washington","Clallam County",3,52,837,410,427
050,53,009,"Washington","Clallam County",3,53,802,401,401
050,53,009,"Washington","Clallam County",3,54,826,399,427
050,53,009,"Washington","Clallam County",3,55,822,399,423
050,53,009,"Washington","Clallam County",3,56,921,436,485
050,53,009,"Washington","Clallam County",3,57,980,483,497
050,53,009,"Washington","Clallam County",3,58,1076,516,560
050,53,009,"Washington","Clallam County",3,59,1198,539,659
050,53,009,"Washington","Clallam County",3,60,1301,583,718
050,53,009,"Washington","Clallam County",3,61,1332,617,715
050,53,009,"Washington","Clallam County",3,62,1358,654,704
050,53,009,"Washington","Clallam County",3,63,1407,667,740
050,53,009,"Washington","Clallam County",3,64,1505,719,786
050,53,009,"Washington","Clallam County",3,65,1548,725,823
050,53,009,"Washington","Clallam County",3,66,1522,710,812
050,53,009,"Washington","Clallam County",3,67,1609,753,856
050,53,009,"Washington","Clallam County",3,68,1628,758,870
050,53,009,"Washington","Clallam County",3,69,1618,771,847
050,53,009,"Washington","Clallam County",3,70,1477,687,790
050,53,009,"Washington","Clallam County",3,71,1360,639,721
050,53,009,"Washington","Clallam County",3,72,1358,653,705
050,53,009,"Washington","Clallam County",3,73,1322,639,683
050,53,009,"Washington","Clallam County",3,74,1426,674,752
050,53,009,"Washington","Clallam County",3,75,954,435,519
050,53,009,"Washington","Clallam County",3,76,927,441,486
050,53,009,"Washington","Clallam County",3,77,945,460,485
050,53,009,"Washington","Clallam County",3,78,934,461,473
050,53,009,"Washington","Clallam County",3,79,808,385,423
050,53,009,"Washington","Clallam County",3,80,681,323,358
050,53,009,"Washington","Clallam County",3,81,589,279,310
050,53,009,"Washington","Clallam County",3,82,526,255,271
050,53,009,"Washington","Clallam County",3,83,471,231,240
050,53,009,"Washington","Clallam County",3,84,403,195,208
050,53,009,"Washington","Clallam County",3,85,2501,1023,1478
050,53,009,"Washington","Clallam County",4,0,557,296,261
050,53,009,"Washington","Clallam County",4,1,617,327,290
050,53,009,"Washington","Clallam County",4,2,607,307,300
050,53,009,"Washington","Clallam County",4,3,594,313,281
050,53,009,"Washington","Clallam County",4,4,662,337,325
050,53,009,"Washington","Clallam County",4,5,673,364,309
050,53,009,"Washington","Clallam County",4,6,721,383,338
050,53,009,"Washington","Clallam County",4,7,720,379,341
050,53,009,"Washington","Clallam County",4,8,719,381,338
050,53,009,"Washington","Clallam County",4,9,708,380,328
050,53,009,"Washington","Clallam County",4,10,733,363,370
050,53,009,"Washington","Clallam County",4,11,757,397,360
050,53,009,"Washington","Clallam County",4,12,748,382,366
050,53,009,"Washington","Clallam County",4,13,739,385,354
050,53,009,"Washington","Clallam County",4,14,768,395,373
050,53,009,"Washington","Clallam County",4,15,735,393,342
050,53,009,"Washington","Clallam County",4,16,730,366,364
050,53,009,"Washington","Clallam County",4,17,731,366,365
050,53,009,"Washington","Clallam County",4,18,617,323,294
050,53,009,"Washington","Clallam County",4,19,542,278,264
050,53,009,"Washington","Clallam County",4,20,547,284,263
050,53,009,"Washington","Clallam County",4,21,600,337,263
050,53,009,"Washington","Clallam County",4,22,627,342,285
050,53,009,"Washington","Clallam County",4,23,694,380,314
050,53,009,"Washington","Clallam County",4,24,704,376,328
050,53,009,"Washington","Clallam County",4,25,720,378,342
050,53,009,"Washington","Clallam County",4,26,684,368,316
050,53,009,"Washington","Clallam County",4,27,686,361,325
050,53,009,"Washington","Clallam County",4,28,727,383,344
050,53,009,"Washington","Clallam County",4,29,729,390,339
050,53,009,"Washington","Clallam County",4,30,832,430,402
050,53,009,"Washington","Clallam County",4,31,881,447,434
050,53,009,"Washington","Clallam County",4,32,878,453,425
050,53,009,"Washington","Clallam County",4,33,848,431,417
050,53,009,"Washington","Clallam County",4,34,844,419,425
050,53,009,"Washington","Clallam County",4,35,861,439,422
050,53,009,"Washington","Clallam County",4,36,885,441,444
050,53,009,"Washington","Clallam County",4,37,913,461,452
050,53,009,"Washington","Clallam County",4,38,864,429,435
050,53,009,"Washington","Clallam County",4,39,823,430,393
050,53,009,"Washington","Clallam County",4,40,881,465,416
050,53,009,"Washington","Clallam County",4,41,868,429,439
050,53,009,"Washington","Clallam County",4,42,906,472,434
050,53,009,"Washington","Clallam County",4,43,837,428,409
050,53,009,"Washington","Clallam County",4,44,757,378,379
050,53,009,"Washington","Clallam County",4,45,761,383,378
050,53,009,"Washington","Clallam County",4,46,758,392,366
050,53,009,"Washington","Clallam County",4,47,703,343,360
050,53,009,"Washington","Clallam County",4,48,709,335,374
050,53,009,"Washington","Clallam County",4,49,736,355,381
050,53,009,"Washington","Clallam County",4,50,712,343,369
050,53,009,"Washington","Clallam County",4,51,791,404,387
050,53,009,"Washington","Clallam County",4,52,838,402,436
050,53,009,"Washington","Clallam County",4,53,848,413,435
050,53,009,"Washington","Clallam County",4,54,806,393,413
050,53,009,"Washington","Clallam County",4,55,847,411,436
050,53,009,"Washington","Clallam County",4,56,831,388,443
050,53,009,"Washington","Clallam County",4,57,954,446,508
050,53,009,"Washington","Clallam County",4,58,1002,472,530
050,53,009,"Washington","Clallam County",4,59,1105,531,574
050,53,009,"Washington","Clallam County",4,60,1259,569,690
050,53,009,"Washington","Clallam County",4,61,1329,587,742
050,53,009,"Washington","Clallam County",4,62,1396,650,746
050,53,009,"Washington","Clallam County",4,63,1406,666,740
050,53,009,"Washington","Clallam County",4,64,1444,679,765
050,53,009,"Washington","Clallam County",4,65,1528,735,793
050,53,009,"Washington","Clallam County",4,66,1550,731,819
050,53,009,"Washington","Clallam County",4,67,1548,712,836
050,53,009,"Washington","Clallam County",4,68,1598,746,852
050,53,009,"Washington","Clallam County",4,69,1625,767,858
050,53,009,"Washington","Clallam County",4,70,1632,776,856
050,53,009,"Washington","Clallam County",4,71,1466,690,776
050,53,009,"Washington","Clallam County",4,72,1316,627,689
050,53,009,"Washington","Clallam County",4,73,1343,633,710
050,53,009,"Washington","Clallam County",4,74,1288,620,668
050,53,009,"Washington","Clallam County",4,75,1377,650,727
050,53,009,"Washington","Clallam County",4,76,920,409,511
050,53,009,"Washington","Clallam County",4,77,902,423,479
050,53,009,"Washington","Clallam County",4,78,901,441,460
050,53,009,"Washington","Clallam County",4,79,895,443,452
050,53,009,"Washington","Clallam County",4,80,772,371,401
050,53,009,"Washington","Clallam County",4,81,631,294,337
050,53,009,"Washington","Clallam County",4,82,527,241,286
050,53,009,"Washington","Clallam County",4,83,502,234,268
050,53,009,"Washington","Clallam County",4,84,419,207,212
050,53,009,"Washington","Clallam County",4,85,2435,1006,1429
050,53,009,"Washington","Clallam County",5,0,549,292,257
050,53,009,"Washington","Clallam County",5,1,574,306,268
050,53,009,"Washington","Clallam County",5,2,615,319,296
050,53,009,"Washington","Clallam County",5,3,603,303,300
050,53,009,"Washington","Clallam County",5,4,595,308,287
050,53,009,"Washington","Clallam County",5,5,654,330,324
050,53,009,"Washington","Clallam County",5,6,681,368,313
050,53,009,"Washington","Clallam County",5,7,712,374,338
050,53,009,"Washington","Clallam County",5,8,726,382,344
050,53,009,"Washington","Clallam County",5,9,696,378,318
050,53,009,"Washington","Clallam County",5,10,705,383,322
050,53,009,"Washington","Clallam County",5,11,735,375,360
050,53,009,"Washington","Clallam County",5,12,766,406,360
050,53,009,"Washington","Clallam County",5,13,744,385,359
050,53,009,"Washington","Clallam County",5,14,735,387,348
050,53,009,"Washington","Clallam County",5,15,785,407,378
050,53,009,"Washington","Clallam County",5,16,720,385,335
050,53,009,"Washington","Clallam County",5,17,739,368,371
050,53,009,"Washington","Clallam County",5,18,619,327,292
050,53,009,"Washington","Clallam County",5,19,518,268,250
050,53,009,"Washington","Clallam County",5,20,575,300,275
050,53,009,"Washington","Clallam County",5,21,579,314,265
050,53,009,"Washington","Clallam County",5,22,608,333,275
050,53,009,"Washington","Clallam County",5,23,649,360,289
050,53,009,"Washington","Clallam County",5,24,699,391,308
050,53,009,"Washington","Clallam County",5,25,708,377,331
050,53,009,"Washington","Clallam County",5,26,711,363,348
050,53,009,"Washington","Clallam County",5,27,719,391,328
050,53,009,"Washington","Clallam County",5,28,680,350,330
050,53,009,"Washington","Clallam County",5,29,730,373,357
050,53,009,"Washington","Clallam County",5,30,746,404,342
050,53,009,"Washington","Clallam County",5,31,841,439,402
050,53,009,"Washington","Clallam County",5,32,883,456,427
050,53,009,"Washington","Clallam County",5,33,895,457,438
050,53,009,"Washington","Clallam County",5,34,846,436,410
050,53,009,"Washington","Clallam County",5,35,854,427,427
050,53,009,"Washington","Clallam County",5,36,864,442,422
050,53,009,"Washington","Clallam County",5,37,904,432,472
050,53,009,"Washington","Clallam County",5,38,941,490,451
050,53,009,"Washington","Clallam County",5,39,870,434,436
050,53,009,"Washington","Clallam County",5,40,834,431,403
050,53,009,"Washington","Clallam County",5,41,885,459,426
050,53,009,"Washington","Clallam County",5,42,873,432,441
050,53,009,"Washington","Clallam County",5,43,917,476,441
050,53,009,"Washington","Clallam County",5,44,838,430,408
050,53,009,"Washington","Clallam County",5,45,766,392,374
050,53,009,"Washington","Clallam County",5,46,778,398,380
050,53,009,"Washington","Clallam County",5,47,749,380,369
050,53,009,"Washington","Clallam County",5,48,720,351,369
050,53,009,"Washington","Clallam County",5,49,701,332,369
050,53,009,"Washington","Clallam County",5,50,747,351,396
050,53,009,"Washington","Clallam County",5,51,727,342,385
050,53,009,"Washington","Clallam County",5,52,789,404,385
050,53,009,"Washington","Clallam County",5,53,860,415,445
050,53,009,"Washington","Clallam County",5,54,850,406,444
050,53,009,"Washington","Clallam County",5,55,841,411,430
050,53,009,"Washington","Clallam County",5,56,853,408,445
050,53,009,"Washington","Clallam County",5,57,838,398,440
050,53,009,"Washington","Clallam County",5,58,978,457,521
050,53,009,"Washington","Clallam County",5,59,1033,498,535
050,53,009,"Washington","Clallam County",5,60,1129,531,598
050,53,009,"Washington","Clallam County",5,61,1304,582,722
050,53,009,"Washington","Clallam County",5,62,1362,610,752
050,53,009,"Washington","Clallam County",5,63,1423,670,753
050,53,009,"Washington","Clallam County",5,64,1445,686,759
050,53,009,"Washington","Clallam County",5,65,1458,677,781
050,53,009,"Washington","Clallam County",5,66,1534,737,797
050,53,009,"Washington","Clallam County",5,67,1562,733,829
050,53,009,"Washington","Clallam County",5,68,1548,713,835
050,53,009,"Washington","Clallam County",5,69,1596,743,853
050,53,009,"Washington","Clallam County",5,70,1617,763,854
050,53,009,"Washington","Clallam County",5,71,1632,773,859
050,53,009,"Washington","Clallam County",5,72,1439,682,757
050,53,009,"Washington","Clallam County",5,73,1281,615,666
050,53,009,"Washington","Clallam County",5,74,1303,620,683
050,53,009,"Washington","Clallam County",5,75,1245,601,644
050,53,009,"Washington","Clallam County",5,76,1324,621,703
050,53,009,"Washington","Clallam County",5,77,896,397,499
050,53,009,"Washington","Clallam County",5,78,863,411,452
050,53,009,"Washington","Clallam County",5,79,857,415,442
050,53,009,"Washington","Clallam County",5,80,842,420,422
050,53,009,"Washington","Clallam County",5,81,712,338,374
050,53,009,"Washington","Clallam County",5,82,564,268,296
050,53,009,"Washington","Clallam County",5,83,493,213,280
050,53,009,"Washington","Clallam County",5,84,445,213,232
050,53,009,"Washington","Clallam County",5,85,2392,1002,1390
050,53,011,"Washington","Clark County",1,0,5685,2912,2773
050,53,011,"Washington","Clark County",1,1,5787,2960,2827
050,53,011,"Washington","Clark County",1,2,5889,3030,2859
050,53,011,"Washington","Clark County",1,3,6081,3132,2949
050,53,011,"Washington","Clark County",1,4,6312,3250,3062
050,53,011,"Washington","Clark County",1,5,6446,3341,3105
050,53,011,"Washington","Clark County",1,6,6401,3305,3096
050,53,011,"Washington","Clark County",1,7,6542,3302,3240
050,53,011,"Washington","Clark County",1,8,6546,3339,3207
050,53,011,"Washington","Clark County",1,9,6641,3353,3288
050,53,011,"Washington","Clark County",1,10,6951,3534,3417
050,53,011,"Washington","Clark County",1,11,7221,3701,3520
050,53,011,"Washington","Clark County",1,12,7455,3788,3667
050,53,011,"Washington","Clark County",1,13,7405,3790,3615
050,53,011,"Washington","Clark County",1,14,7156,3637,3519
050,53,011,"Washington","Clark County",1,15,7037,3551,3486
050,53,011,"Washington","Clark County",1,16,7211,3659,3552
050,53,011,"Washington","Clark County",1,17,7094,3579,3515
050,53,011,"Washington","Clark County",1,18,6027,3148,2879
050,53,011,"Washington","Clark County",1,19,5127,2645,2482
050,53,011,"Washington","Clark County",1,20,5462,2836,2626
050,53,011,"Washington","Clark County",1,21,5602,2898,2704
050,53,011,"Washington","Clark County",1,22,5879,2963,2916
050,53,011,"Washington","Clark County",1,23,6163,3067,3096
050,53,011,"Washington","Clark County",1,24,6277,3200,3077
050,53,011,"Washington","Clark County",1,25,6383,3256,3127
050,53,011,"Washington","Clark County",1,26,6377,3259,3118
050,53,011,"Washington","Clark County",1,27,6600,3350,3250
050,53,011,"Washington","Clark County",1,28,6891,3483,3408
050,53,011,"Washington","Clark County",1,29,7044,3553,3491
050,53,011,"Washington","Clark County",1,30,7067,3599,3468
050,53,011,"Washington","Clark County",1,31,6877,3447,3430
050,53,011,"Washington","Clark County",1,32,6832,3443,3389
050,53,011,"Washington","Clark County",1,33,6624,3363,3261
050,53,011,"Washington","Clark County",1,34,6713,3323,3390
050,53,011,"Washington","Clark County",1,35,6717,3368,3349
050,53,011,"Washington","Clark County",1,36,6661,3345,3316
050,53,011,"Washington","Clark County",1,37,6867,3460,3407
050,53,011,"Washington","Clark County",1,38,6983,3438,3545
050,53,011,"Washington","Clark County",1,39,7095,3520,3575
050,53,011,"Washington","Clark County",1,40,7038,3489,3549
050,53,011,"Washington","Clark County",1,41,6822,3380,3442
050,53,011,"Washington","Clark County",1,42,6767,3308,3459
050,53,011,"Washington","Clark County",1,43,6607,3284,3323
050,53,011,"Washington","Clark County",1,44,6476,3235,3241
050,53,011,"Washington","Clark County",1,45,6477,3238,3239
050,53,011,"Washington","Clark County",1,46,6145,3073,3072
050,53,011,"Washington","Clark County",1,47,6218,3085,3133
050,53,011,"Washington","Clark County",1,48,6655,3376,3279
050,53,011,"Washington","Clark County",1,49,7145,3699,3446
050,53,011,"Washington","Clark County",1,50,6955,3548,3407
050,53,011,"Washington","Clark County",1,51,6457,3287,3170
050,53,011,"Washington","Clark County",1,52,6235,3167,3068
050,53,011,"Washington","Clark County",1,53,6158,3139,3019
050,53,011,"Washington","Clark County",1,54,6160,3075,3085
050,53,011,"Washington","Clark County",1,55,6467,3146,3321
050,53,011,"Washington","Clark County",1,56,6625,3222,3403
050,53,011,"Washington","Clark County",1,57,6540,3228,3312
050,53,011,"Washington","Clark County",1,58,6633,3295,3338
050,53,011,"Washington","Clark County",1,59,6618,3291,3327
050,53,011,"Washington","Clark County",1,60,6435,3231,3204
050,53,011,"Washington","Clark County",1,61,6318,3116,3202
050,53,011,"Washington","Clark County",1,62,6129,3022,3107
050,53,011,"Washington","Clark County",1,63,5972,2932,3040
050,53,011,"Washington","Clark County",1,64,5918,2875,3043
050,53,011,"Washington","Clark County",1,65,5913,2838,3075
050,53,011,"Washington","Clark County",1,66,5711,2706,3005
050,53,011,"Washington","Clark County",1,67,5566,2614,2952
050,53,011,"Washington","Clark County",1,68,5400,2532,2868
050,53,011,"Washington","Clark County",1,69,5073,2352,2721
050,53,011,"Washington","Clark County",1,70,4957,2371,2586
050,53,011,"Washington","Clark County",1,71,4759,2223,2536
050,53,011,"Washington","Clark County",1,72,4797,2237,2560
050,53,011,"Washington","Clark County",1,73,4740,2229,2511
050,53,011,"Washington","Clark County",1,74,3274,1502,1772
050,53,011,"Washington","Clark County",1,75,3228,1495,1733
050,53,011,"Washington","Clark County",1,76,3111,1434,1677
050,53,011,"Washington","Clark County",1,77,2922,1388,1534
050,53,011,"Washington","Clark County",1,78,2529,1199,1330
050,53,011,"Washington","Clark County",1,79,2253,1068,1185
050,53,011,"Washington","Clark County",1,80,1935,878,1057
050,53,011,"Washington","Clark County",1,81,1800,823,977
050,53,011,"Washington","Clark County",1,82,1569,716,853
050,53,011,"Washington","Clark County",1,83,1410,622,788
050,53,011,"Washington","Clark County",1,84,1248,515,733
050,53,011,"Washington","Clark County",1,85,7013,2573,4440
050,53,011,"Washington","Clark County",2,0,5641,2886,2755
050,53,011,"Washington","Clark County",2,1,5778,2958,2820
050,53,011,"Washington","Clark County",2,2,5892,3025,2867
050,53,011,"Washington","Clark County",2,3,6048,3115,2933
050,53,011,"Washington","Clark County",2,4,6308,3248,3060
050,53,011,"Washington","Clark County",2,5,6445,3332,3113
050,53,011,"Washington","Clark County",2,6,6450,3331,3119
050,53,011,"Washington","Clark County",2,7,6519,3313,3206
050,53,011,"Washington","Clark County",2,8,6543,3329,3214
050,53,011,"Washington","Clark County",2,9,6636,3359,3277
050,53,011,"Washington","Clark County",2,10,6897,3504,3393
050,53,011,"Washington","Clark County",2,11,7160,3657,3503
050,53,011,"Washington","Clark County",2,12,7459,3796,3663
050,53,011,"Washington","Clark County",2,13,7421,3797,3624
050,53,011,"Washington","Clark County",2,14,7221,3676,3545
050,53,011,"Washington","Clark County",2,15,7077,3574,3503
050,53,011,"Washington","Clark County",2,16,7180,3639,3541
050,53,011,"Washington","Clark County",2,17,7120,3596,3524
050,53,011,"Washington","Clark County",2,18,6035,3140,2895
050,53,011,"Washington","Clark County",2,19,5144,2656,2488
050,53,011,"Washington","Clark County",2,20,5512,2852,2660
050,53,011,"Washington","Clark County",2,21,5641,2914,2727
050,53,011,"Washington","Clark County",2,22,5912,2987,2925
050,53,011,"Washington","Clark County",2,23,6200,3093,3107
050,53,011,"Washington","Clark County",2,24,6324,3202,3122
050,53,011,"Washington","Clark County",2,25,6418,3269,3149
050,53,011,"Washington","Clark County",2,26,6437,3282,3155
050,53,011,"Washington","Clark County",2,27,6603,3361,3242
050,53,011,"Washington","Clark County",2,28,6880,3481,3399
050,53,011,"Washington","Clark County",2,29,7044,3558,3486
050,53,011,"Washington","Clark County",2,30,7147,3635,3512
050,53,011,"Washington","Clark County",2,31,6960,3507,3453
050,53,011,"Washington","Clark County",2,32,6878,3463,3415
050,53,011,"Washington","Clark County",2,33,6715,3402,3313
050,53,011,"Washington","Clark County",2,34,6723,3352,3371
050,53,011,"Washington","Clark County",2,35,6794,3400,3394
050,53,011,"Washington","Clark County",2,36,6671,3357,3314
050,53,011,"Washington","Clark County",2,37,6869,3460,3409
050,53,011,"Washington","Clark County",2,38,7013,3474,3539
050,53,011,"Washington","Clark County",2,39,7078,3504,3574
050,53,011,"Washington","Clark County",2,40,7121,3530,3591
050,53,011,"Washington","Clark County",2,41,6891,3411,3480
050,53,011,"Washington","Clark County",2,42,6775,3325,3450
050,53,011,"Washington","Clark County",2,43,6698,3316,3382
050,53,011,"Washington","Clark County",2,44,6469,3237,3232
050,53,011,"Washington","Clark County",2,45,6519,3259,3260
050,53,011,"Washington","Clark County",2,46,6219,3113,3106
050,53,011,"Washington","Clark County",2,47,6197,3082,3115
050,53,011,"Washington","Clark County",2,48,6549,3309,3240
050,53,011,"Washington","Clark County",2,49,7061,3638,3423
050,53,011,"Washington","Clark County",2,50,7016,3594,3422
050,53,011,"Washington","Clark County",2,51,6568,3344,3224
050,53,011,"Washington","Clark County",2,52,6286,3196,3090
050,53,011,"Washington","Clark County",2,53,6177,3154,3023
050,53,011,"Washington","Clark County",2,54,6143,3081,3062
050,53,011,"Washington","Clark County",2,55,6397,3128,3269
050,53,011,"Washington","Clark County",2,56,6610,3213,3397
050,53,011,"Washington","Clark County",2,57,6575,3234,3341
050,53,011,"Washington","Clark County",2,58,6605,3270,3335
050,53,011,"Washington","Clark County",2,59,6666,3313,3353
050,53,011,"Washington","Clark County",2,60,6472,3242,3230
050,53,011,"Washington","Clark County",2,61,6326,3131,3195
050,53,011,"Washington","Clark County",2,62,6173,3043,3130
050,53,011,"Washington","Clark County",2,63,6059,2974,3085
050,53,011,"Washington","Clark County",2,64,5899,2876,3023
050,53,011,"Washington","Clark County",2,65,5914,2842,3072
050,53,011,"Washington","Clark County",2,66,5776,2742,3034
050,53,011,"Washington","Clark County",2,67,5581,2622,2959
050,53,011,"Washington","Clark County",2,68,5405,2538,2867
050,53,011,"Washington","Clark County",2,69,5189,2414,2775
050,53,011,"Washington","Clark County",2,70,4957,2353,2604
050,53,011,"Washington","Clark County",2,71,4817,2255,2562
050,53,011,"Washington","Clark County",2,72,4702,2192,2510
050,53,011,"Washington","Clark County",2,73,4976,2335,2641
050,53,011,"Washington","Clark County",2,74,3393,1560,1833
050,53,011,"Washington","Clark County",2,75,3231,1497,1734
050,53,011,"Washington","Clark County",2,76,3107,1424,1683
050,53,011,"Washington","Clark County",2,77,3016,1422,1594
050,53,011,"Washington","Clark County",2,78,2558,1212,1346
050,53,011,"Washington","Clark County",2,79,2284,1079,1205
050,53,011,"Washington","Clark County",2,80,1997,911,1086
050,53,011,"Washington","Clark County",2,81,1811,829,982
050,53,011,"Washington","Clark County",2,82,1604,729,875
050,53,011,"Washington","Clark County",2,83,1428,635,793
050,53,011,"Washington","Clark County",2,84,1267,533,734
050,53,011,"Washington","Clark County",2,85,7061,2604,4457
050,53,011,"Washington","Clark County",3,0,5364,2711,2653
050,53,011,"Washington","Clark County",3,1,5781,2889,2892
050,53,011,"Washington","Clark County",3,2,5849,3005,2844
050,53,011,"Washington","Clark County",3,3,5992,3112,2880
050,53,011,"Washington","Clark County",3,4,6099,3146,2953
050,53,011,"Washington","Clark County",3,5,6348,3299,3049
050,53,011,"Washington","Clark County",3,6,6483,3352,3131
050,53,011,"Washington","Clark County",3,7,6479,3326,3153
050,53,011,"Washington","Clark County",3,8,6567,3340,3227
050,53,011,"Washington","Clark County",3,9,6518,3314,3204
050,53,011,"Washington","Clark County",3,10,6660,3354,3306
050,53,011,"Washington","Clark County",3,11,6911,3511,3400
050,53,011,"Washington","Clark County",3,12,7190,3673,3517
050,53,011,"Washington","Clark County",3,13,7506,3825,3681
050,53,011,"Washington","Clark County",3,14,7437,3814,3623
050,53,011,"Washington","Clark County",3,15,7258,3688,3570
050,53,011,"Washington","Clark County",3,16,7096,3566,3530
050,53,011,"Washington","Clark County",3,17,7158,3610,3548
050,53,011,"Washington","Clark County",3,18,6242,3253,2989
050,53,011,"Washington","Clark County",3,19,5122,2642,2480
050,53,011,"Washington","Clark County",3,20,5472,2787,2685
050,53,011,"Washington","Clark County",3,21,5867,3021,2846
050,53,011,"Washington","Clark County",3,22,6032,3081,2951
050,53,011,"Washington","Clark County",3,23,6271,3179,3092
050,53,011,"Washington","Clark County",3,24,6551,3290,3261
050,53,011,"Washington","Clark County",3,25,6590,3350,3240
050,53,011,"Washington","Clark County",3,26,6750,3428,3322
050,53,011,"Washington","Clark County",3,27,6695,3414,3281
050,53,011,"Washington","Clark County",3,28,6870,3451,3419
050,53,011,"Washington","Clark County",3,29,7045,3580,3465
050,53,011,"Washington","Clark County",3,30,7286,3719,3567
050,53,011,"Washington","Clark County",3,31,7363,3767,3596
050,53,011,"Washington","Clark County",3,32,7156,3591,3565
050,53,011,"Washington","Clark County",3,33,7127,3589,3538
050,53,011,"Washington","Clark County",3,34,6947,3508,3439
050,53,011,"Washington","Clark County",3,35,6908,3442,3466
050,53,011,"Washington","Clark County",3,36,6985,3506,3479
050,53,011,"Washington","Clark County",3,37,6801,3420,3381
050,53,011,"Washington","Clark County",3,38,7012,3562,3450
050,53,011,"Washington","Clark County",3,39,7195,3592,3603
050,53,011,"Washington","Clark County",3,40,7256,3579,3677
050,53,011,"Washington","Clark County",3,41,7146,3555,3591
050,53,011,"Washington","Clark County",3,42,6990,3447,3543
050,53,011,"Washington","Clark County",3,43,6859,3365,3494
050,53,011,"Washington","Clark County",3,44,6745,3351,3394
050,53,011,"Washington","Clark County",3,45,6494,3238,3256
050,53,011,"Washington","Clark County",3,46,6529,3251,3278
050,53,011,"Washington","Clark County",3,47,6318,3126,3192
050,53,011,"Washington","Clark County",3,48,6219,3090,3129
050,53,011,"Washington","Clark County",3,49,6541,3305,3236
050,53,011,"Washington","Clark County",3,50,7113,3631,3482
050,53,011,"Washington","Clark County",3,51,7002,3578,3424
050,53,011,"Washington","Clark County",3,52,6598,3355,3243
050,53,011,"Washington","Clark County",3,53,6278,3232,3046
050,53,011,"Washington","Clark County",3,54,6150,3132,3018
050,53,011,"Washington","Clark County",3,55,6189,3093,3096
050,53,011,"Washington","Clark County",3,56,6425,3163,3262
050,53,011,"Washington","Clark County",3,57,6622,3225,3397
050,53,011,"Washington","Clark County",3,58,6607,3251,3356
050,53,011,"Washington","Clark County",3,59,6625,3277,3348
050,53,011,"Washington","Clark County",3,60,6633,3291,3342
050,53,011,"Washington","Clark County",3,61,6443,3263,3180
050,53,011,"Washington","Clark County",3,62,6313,3101,3212
050,53,011,"Washington","Clark County",3,63,6127,3001,3126
050,53,011,"Washington","Clark County",3,64,6015,2934,3081
050,53,011,"Washington","Clark County",3,65,5921,2864,3057
050,53,011,"Washington","Clark County",3,66,5882,2813,3069
050,53,011,"Washington","Clark County",3,67,5732,2703,3029
050,53,011,"Washington","Clark County",3,68,5567,2610,2957
050,53,011,"Washington","Clark County",3,69,5387,2511,2876
050,53,011,"Washington","Clark County",3,70,5122,2364,2758
050,53,011,"Washington","Clark County",3,71,4893,2289,2604
050,53,011,"Washington","Clark County",3,72,4733,2194,2539
050,53,011,"Washington","Clark County",3,73,4679,2175,2504
050,53,011,"Washington","Clark County",3,74,4874,2268,2606
050,53,011,"Washington","Clark County",3,75,3310,1526,1784
050,53,011,"Washington","Clark County",3,76,3174,1451,1723
050,53,011,"Washington","Clark County",3,77,2997,1368,1629
050,53,011,"Washington","Clark County",3,78,2929,1378,1551
050,53,011,"Washington","Clark County",3,79,2446,1139,1307
050,53,011,"Washington","Clark County",3,80,2140,986,1154
050,53,011,"Washington","Clark County",3,81,1895,854,1041
050,53,011,"Washington","Clark County",3,82,1717,774,943
050,53,011,"Washington","Clark County",3,83,1530,675,855
050,53,011,"Washington","Clark County",3,84,1332,586,746
050,53,011,"Washington","Clark County",3,85,7103,2651,4452
050,53,011,"Washington","Clark County",4,0,5641,2871,2770
050,53,011,"Washington","Clark County",4,1,5419,2761,2658
050,53,011,"Washington","Clark County",4,2,5843,2923,2920
050,53,011,"Washington","Clark County",4,3,5890,3000,2890
050,53,011,"Washington","Clark County",4,4,5959,3068,2891
050,53,011,"Washington","Clark County",4,5,6144,3159,2985
050,53,011,"Washington","Clark County",4,6,6400,3278,3122
050,53,011,"Washington","Clark County",4,7,6503,3352,3151
050,53,011,"Washington","Clark County",4,8,6430,3283,3147
050,53,011,"Washington","Clark County",4,9,6591,3341,3250
050,53,011,"Washington","Clark County",4,10,6531,3335,3196
050,53,011,"Washington","Clark County",4,11,6669,3345,3324
050,53,011,"Washington","Clark County",4,12,6911,3540,3371
050,53,011,"Washington","Clark County",4,13,7156,3651,3505
050,53,011,"Washington","Clark County",4,14,7401,3752,3649
050,53,011,"Washington","Clark County",4,15,7418,3814,3604
050,53,011,"Washington","Clark County",4,16,7202,3623,3579
050,53,011,"Washington","Clark County",4,17,7070,3534,3536
050,53,011,"Washington","Clark County",4,18,6166,3211,2955
050,53,011,"Washington","Clark County",4,19,5044,2641,2403
050,53,011,"Washington","Clark County",4,20,5315,2741,2574
050,53,011,"Washington","Clark County",4,21,5687,2864,2823
050,53,011,"Washington","Clark County",4,22,6114,3104,3010
050,53,011,"Washington","Clark County",4,23,6342,3257,3085
050,53,011,"Washington","Clark County",4,24,6535,3354,3181
050,53,011,"Washington","Clark County",4,25,6698,3354,3344
050,53,011,"Washington","Clark County",4,26,6695,3379,3316
050,53,011,"Washington","Clark County",4,27,6908,3485,3423
050,53,011,"Washington","Clark County",4,28,6920,3484,3436
050,53,011,"Washington","Clark County",4,29,7098,3578,3520
050,53,011,"Washington","Clark County",4,30,7361,3761,3600
050,53,011,"Washington","Clark County",4,31,7554,3845,3709
050,53,011,"Washington","Clark County",4,32,7618,3874,3744
050,53,011,"Washington","Clark County",4,33,7468,3763,3705
050,53,011,"Washington","Clark County",4,34,7263,3635,3628
050,53,011,"Washington","Clark County",4,35,7033,3557,3476
050,53,011,"Washington","Clark County",4,36,7099,3538,3561
050,53,011,"Washington","Clark County",4,37,7127,3556,3571
050,53,011,"Washington","Clark County",4,38,6883,3489,3394
050,53,011,"Washington","Clark County",4,39,7111,3617,3494
050,53,011,"Washington","Clark County",4,40,7247,3632,3615
050,53,011,"Washington","Clark County",4,41,7281,3629,3652
050,53,011,"Washington","Clark County",4,42,7216,3621,3595
050,53,011,"Washington","Clark County",4,43,6998,3438,3560
050,53,011,"Washington","Clark County",4,44,6852,3363,3489
050,53,011,"Washington","Clark County",4,45,6712,3311,3401
050,53,011,"Washington","Clark County",4,46,6505,3238,3267
050,53,011,"Washington","Clark County",4,47,6553,3252,3301
050,53,011,"Washington","Clark County",4,48,6327,3129,3198
050,53,011,"Washington","Clark County",4,49,6253,3104,3149
050,53,011,"Washington","Clark County",4,50,6545,3301,3244
050,53,011,"Washington","Clark County",4,51,7053,3617,3436
050,53,011,"Washington","Clark County",4,52,7043,3601,3442
050,53,011,"Washington","Clark County",4,53,6613,3358,3255
050,53,011,"Washington","Clark County",4,54,6240,3169,3071
050,53,011,"Washington","Clark County",4,55,6091,3100,2991
050,53,011,"Washington","Clark County",4,56,6205,3099,3106
050,53,011,"Washington","Clark County",4,57,6424,3154,3270
050,53,011,"Washington","Clark County",4,58,6628,3215,3413
050,53,011,"Washington","Clark County",4,59,6651,3252,3399
050,53,011,"Washington","Clark County",4,60,6553,3236,3317
050,53,011,"Washington","Clark County",4,61,6602,3269,3333
050,53,011,"Washington","Clark County",4,62,6352,3198,3154
050,53,011,"Washington","Clark County",4,63,6293,3057,3236
050,53,011,"Washington","Clark County",4,64,6020,2936,3084
050,53,011,"Washington","Clark County",4,65,5940,2860,3080
050,53,011,"Washington","Clark County",4,66,5877,2826,3051
050,53,011,"Washington","Clark County",4,67,5757,2728,3029
050,53,011,"Washington","Clark County",4,68,5695,2708,2987
050,53,011,"Washington","Clark County",4,69,5499,2573,2926
050,53,011,"Washington","Clark County",4,70,5311,2460,2851
050,53,011,"Washington","Clark County",4,71,5070,2311,2759
050,53,011,"Washington","Clark County",4,72,4743,2177,2566
050,53,011,"Washington","Clark County",4,73,4690,2166,2524
050,53,011,"Washington","Clark County",4,74,4553,2113,2440
050,53,011,"Washington","Clark County",4,75,4766,2227,2539
050,53,011,"Washington","Clark County",4,76,3240,1470,1770
050,53,011,"Washington","Clark County",4,77,3078,1394,1684
050,53,011,"Washington","Clark County",4,78,2899,1308,1591
050,53,011,"Washington","Clark County",4,79,2813,1325,1488
050,53,011,"Washington","Clark County",4,80,2313,1061,1252
050,53,011,"Washington","Clark County",4,81,2021,913,1108
050,53,011,"Washington","Clark County",4,82,1788,797,991
050,53,011,"Washington","Clark County",4,83,1644,726,918
050,53,011,"Washington","Clark County",4,84,1393,605,788
050,53,011,"Washington","Clark County",4,85,7173,2695,4478
050,53,011,"Washington","Clark County",5,0,5510,2802,2708
050,53,011,"Washington","Clark County",5,1,5665,2864,2801
050,53,011,"Washington","Clark County",5,2,5492,2777,2715
050,53,011,"Washington","Clark County",5,3,5838,2929,2909
050,53,011,"Washington","Clark County",5,4,5906,3018,2888
050,53,011,"Washington","Clark County",5,5,5923,3042,2881
050,53,011,"Washington","Clark County",5,6,6173,3127,3046
050,53,011,"Washington","Clark County",5,7,6381,3233,3148
050,53,011,"Washington","Clark County",5,8,6553,3379,3174
050,53,011,"Washington","Clark County",5,9,6419,3288,3131
050,53,011,"Washington","Clark County",5,10,6662,3370,3292
050,53,011,"Washington","Clark County",5,11,6540,3314,3226
050,53,011,"Washington","Clark County",5,12,6675,3391,3284
050,53,011,"Washington","Clark County",5,13,6907,3518,3389
050,53,011,"Washington","Clark County",5,14,7158,3616,3542
050,53,011,"Washington","Clark County",5,15,7387,3743,3644
050,53,011,"Washington","Clark County",5,16,7405,3795,3610
050,53,011,"Washington","Clark County",5,17,7208,3611,3597
050,53,011,"Washington","Clark County",5,18,6082,3132,2950
050,53,011,"Washington","Clark County",5,19,5057,2634,2423
050,53,011,"Washington","Clark County",5,20,5379,2790,2589
050,53,011,"Washington","Clark County",5,21,5569,2833,2736
050,53,011,"Washington","Clark County",5,22,6055,3005,3050
050,53,011,"Washington","Clark County",5,23,6402,3247,3155
050,53,011,"Washington","Clark County",5,24,6611,3409,3202
050,53,011,"Washington","Clark County",5,25,6691,3443,3248
050,53,011,"Washington","Clark County",5,26,6841,3391,3450
050,53,011,"Washington","Clark County",5,27,6885,3481,3404
050,53,011,"Washington","Clark County",5,28,7150,3625,3525
050,53,011,"Washington","Clark County",5,29,7056,3558,3498
050,53,011,"Washington","Clark County",5,30,7328,3704,3624
050,53,011,"Washington","Clark County",5,31,7673,3926,3747
050,53,011,"Washington","Clark County",5,32,7747,3895,3852
050,53,011,"Washington","Clark County",5,33,7864,3999,3865
050,53,011,"Washington","Clark County",5,34,7555,3792,3763
050,53,011,"Washington","Clark County",5,35,7421,3748,3673
050,53,011,"Washington","Clark County",5,36,7265,3709,3556
050,53,011,"Washington","Clark County",5,37,7283,3622,3661
050,53,011,"Washington","Clark County",5,38,7195,3596,3599
050,53,011,"Washington","Clark County",5,39,7006,3556,3450
050,53,011,"Washington","Clark County",5,40,7266,3716,3550
050,53,011,"Washington","Clark County",5,41,7327,3678,3649
050,53,011,"Washington","Clark County",5,42,7297,3683,3614
050,53,011,"Washington","Clark County",5,43,7257,3630,3627
050,53,011,"Washington","Clark County",5,44,7011,3461,3550
050,53,011,"Washington","Clark County",5,45,6876,3376,3500
050,53,011,"Washington","Clark County",5,46,6710,3317,3393
050,53,011,"Washington","Clark County",5,47,6496,3242,3254
050,53,011,"Washington","Clark County",5,48,6548,3260,3288
050,53,011,"Washington","Clark County",5,49,6297,3096,3201
050,53,011,"Washington","Clark County",5,50,6259,3122,3137
050,53,011,"Washington","Clark County",5,51,6551,3309,3242
050,53,011,"Washington","Clark County",5,52,7099,3625,3474
050,53,011,"Washington","Clark County",5,53,7040,3623,3417
050,53,011,"Washington","Clark County",5,54,6556,3293,3263
050,53,011,"Washington","Clark County",5,55,6205,3140,3065
050,53,011,"Washington","Clark County",5,56,6087,3066,3021
050,53,011,"Washington","Clark County",5,57,6147,3060,3087
050,53,011,"Washington","Clark County",5,58,6397,3144,3253
050,53,011,"Washington","Clark County",5,59,6581,3187,3394
050,53,011,"Washington","Clark County",5,60,6594,3219,3375
050,53,011,"Washington","Clark County",5,61,6483,3209,3274
050,53,011,"Washington","Clark County",5,62,6556,3220,3336
050,53,011,"Washington","Clark County",5,63,6317,3142,3175
050,53,011,"Washington","Clark County",5,64,6227,3026,3201
050,53,011,"Washington","Clark County",5,65,5953,2880,3073
050,53,011,"Washington","Clark County",5,66,5865,2833,3032
050,53,011,"Washington","Clark County",5,67,5803,2771,3032
050,53,011,"Washington","Clark County",5,68,5692,2705,2987
050,53,011,"Washington","Clark County",5,69,5621,2667,2954
050,53,011,"Washington","Clark County",5,70,5405,2523,2882
050,53,011,"Washington","Clark County",5,71,5245,2399,2846
050,53,011,"Washington","Clark County",5,72,4930,2229,2701
050,53,011,"Washington","Clark County",5,73,4689,2143,2546
050,53,011,"Washington","Clark County",5,74,4570,2101,2469
050,53,011,"Washington","Clark County",5,75,4444,2075,2369
050,53,011,"Washington","Clark County",5,76,4649,2153,2496
050,53,011,"Washington","Clark County",5,77,3137,1409,1728
050,53,011,"Washington","Clark County",5,78,2972,1331,1641
050,53,011,"Washington","Clark County",5,79,2781,1251,1530
050,53,011,"Washington","Clark County",5,80,2691,1258,1433
050,53,011,"Washington","Clark County",5,81,2168,982,1186
050,53,011,"Washington","Clark County",5,82,1901,845,1056
050,53,011,"Washington","Clark County",5,83,1709,752,957
050,53,011,"Washington","Clark County",5,84,1509,660,849
050,53,011,"Washington","Clark County",5,85,7315,2784,4531
050,53,013,"Washington","Columbia County",1,0,30,14,16
050,53,013,"Washington","Columbia County",1,1,36,17,19
050,53,013,"Washington","Columbia County",1,2,33,18,15
050,53,013,"Washington","Columbia County",1,3,30,14,16
050,53,013,"Washington","Columbia County",1,4,46,23,23
050,53,013,"Washington","Columbia County",1,5,42,21,21
050,53,013,"Washington","Columbia County",1,6,43,20,23
050,53,013,"Washington","Columbia County",1,7,37,22,15
050,53,013,"Washington","Columbia County",1,8,33,17,16
050,53,013,"Washington","Columbia County",1,9,45,23,22
050,53,013,"Washington","Columbia County",1,10,34,20,14
050,53,013,"Washington","Columbia County",1,11,41,23,18
050,53,013,"Washington","Columbia County",1,12,44,25,19
050,53,013,"Washington","Columbia County",1,13,53,28,25
050,53,013,"Washington","Columbia County",1,14,45,25,20
050,53,013,"Washington","Columbia County",1,15,48,27,21
050,53,013,"Washington","Columbia County",1,16,45,24,21
050,53,013,"Washington","Columbia County",1,17,39,12,27
050,53,013,"Washington","Columbia County",1,18,37,16,21
050,53,013,"Washington","Columbia County",1,19,34,20,14
050,53,013,"Washington","Columbia County",1,20,24,14,10
050,53,013,"Washington","Columbia County",1,21,34,17,17
050,53,013,"Washington","Columbia County",1,22,33,17,16
050,53,013,"Washington","Columbia County",1,23,33,16,17
050,53,013,"Washington","Columbia County",1,24,34,15,19
050,53,013,"Washington","Columbia County",1,25,37,18,19
050,53,013,"Washington","Columbia County",1,26,39,14,25
050,53,013,"Washington","Columbia County",1,27,38,16,22
050,53,013,"Washington","Columbia County",1,28,38,13,25
050,53,013,"Washington","Columbia County",1,29,40,15,25
050,53,013,"Washington","Columbia County",1,30,41,17,24
050,53,013,"Washington","Columbia County",1,31,43,17,26
050,53,013,"Washington","Columbia County",1,32,36,13,23
050,53,013,"Washington","Columbia County",1,33,37,16,21
050,53,013,"Washington","Columbia County",1,34,39,16,23
050,53,013,"Washington","Columbia County",1,35,35,17,18
050,53,013,"Washington","Columbia County",1,36,37,19,18
050,53,013,"Washington","Columbia County",1,37,41,22,19
050,53,013,"Washington","Columbia County",1,38,47,25,22
050,53,013,"Washington","Columbia County",1,39,48,25,23
050,53,013,"Washington","Columbia County",1,40,44,24,20
050,53,013,"Washington","Columbia County",1,41,44,26,18
050,53,013,"Washington","Columbia County",1,42,46,28,18
050,53,013,"Washington","Columbia County",1,43,36,17,19
050,53,013,"Washington","Columbia County",1,44,41,22,19
050,53,013,"Washington","Columbia County",1,45,27,16,11
050,53,013,"Washington","Columbia County",1,46,28,10,18
050,53,013,"Washington","Columbia County",1,47,36,19,17
050,53,013,"Washington","Columbia County",1,48,35,18,17
050,53,013,"Washington","Columbia County",1,49,51,31,20
050,53,013,"Washington","Columbia County",1,50,48,25,23
050,53,013,"Washington","Columbia County",1,51,48,23,25
050,53,013,"Washington","Columbia County",1,52,48,22,26
050,53,013,"Washington","Columbia County",1,53,45,27,18
050,53,013,"Washington","Columbia County",1,54,48,25,23
050,53,013,"Washington","Columbia County",1,55,62,33,29
050,53,013,"Washington","Columbia County",1,56,70,34,36
050,53,013,"Washington","Columbia County",1,57,65,30,35
050,53,013,"Washington","Columbia County",1,58,65,30,35
050,53,013,"Washington","Columbia County",1,59,56,27,29
050,53,013,"Washington","Columbia County",1,60,62,33,29
050,53,013,"Washington","Columbia County",1,61,73,32,41
050,53,013,"Washington","Columbia County",1,62,65,29,36
050,53,013,"Washington","Columbia County",1,63,68,33,35
050,53,013,"Washington","Columbia County",1,64,62,33,29
050,53,013,"Washington","Columbia County",1,65,59,32,27
050,53,013,"Washington","Columbia County",1,66,62,25,37
050,53,013,"Washington","Columbia County",1,67,75,33,42
050,53,013,"Washington","Columbia County",1,68,73,36,37
050,53,013,"Washington","Columbia County",1,69,75,34,41
050,53,013,"Washington","Columbia County",1,70,70,31,39
050,53,013,"Washington","Columbia County",1,71,67,36,31
050,53,013,"Washington","Columbia County",1,72,59,33,26
050,53,013,"Washington","Columbia County",1,73,66,30,36
050,53,013,"Washington","Columbia County",1,74,42,21,21
050,53,013,"Washington","Columbia County",1,75,46,22,24
050,53,013,"Washington","Columbia County",1,76,41,21,20
050,53,013,"Washington","Columbia County",1,77,47,23,24
050,53,013,"Washington","Columbia County",1,78,38,16,22
050,53,013,"Washington","Columbia County",1,79,39,20,19
050,53,013,"Washington","Columbia County",1,80,35,18,17
050,53,013,"Washington","Columbia County",1,81,37,21,16
050,53,013,"Washington","Columbia County",1,82,32,17,15
050,53,013,"Washington","Columbia County",1,83,28,13,15
050,53,013,"Washington","Columbia County",1,84,19,13,6
050,53,013,"Washington","Columbia County",1,85,120,49,71
050,53,013,"Washington","Columbia County",2,0,27,13,14
050,53,013,"Washington","Columbia County",2,1,34,16,18
050,53,013,"Washington","Columbia County",2,2,33,17,16
050,53,013,"Washington","Columbia County",2,3,31,15,16
050,53,013,"Washington","Columbia County",2,4,43,21,22
050,53,013,"Washington","Columbia County",2,5,42,21,21
050,53,013,"Washington","Columbia County",2,6,44,21,23
050,53,013,"Washington","Columbia County",2,7,39,21,18
050,53,013,"Washington","Columbia County",2,8,35,18,17
050,53,013,"Washington","Columbia County",2,9,41,22,19
050,53,013,"Washington","Columbia County",2,10,36,20,16
050,53,013,"Washington","Columbia County",2,11,38,22,16
050,53,013,"Washington","Columbia County",2,12,44,25,19
050,53,013,"Washington","Columbia County",2,13,51,27,24
050,53,013,"Washington","Columbia County",2,14,47,26,21
050,53,013,"Washington","Columbia County",2,15,49,28,21
050,53,013,"Washington","Columbia County",2,16,45,24,21
050,53,013,"Washington","Columbia County",2,17,41,15,26
050,53,013,"Washington","Columbia County",2,18,35,14,21
050,53,013,"Washington","Columbia County",2,19,33,19,14
050,53,013,"Washington","Columbia County",2,20,27,16,11
050,53,013,"Washington","Columbia County",2,21,31,16,15
050,53,013,"Washington","Columbia County",2,22,34,17,17
050,53,013,"Washington","Columbia County",2,23,35,17,18
050,53,013,"Washington","Columbia County",2,24,34,15,19
050,53,013,"Washington","Columbia County",2,25,37,17,20
050,53,013,"Washington","Columbia County",2,26,38,15,23
050,53,013,"Washington","Columbia County",2,27,39,16,23
050,53,013,"Washington","Columbia County",2,28,42,16,26
050,53,013,"Washington","Columbia County",2,29,38,13,25
050,53,013,"Washington","Columbia County",2,30,41,16,25
050,53,013,"Washington","Columbia County",2,31,44,18,26
050,53,013,"Washington","Columbia County",2,32,36,13,23
050,53,013,"Washington","Columbia County",2,33,37,16,21
050,53,013,"Washington","Columbia County",2,34,39,17,22
050,53,013,"Washington","Columbia County",2,35,36,17,19
050,53,013,"Washington","Columbia County",2,36,35,17,18
050,53,013,"Washington","Columbia County",2,37,40,21,19
050,53,013,"Washington","Columbia County",2,38,47,25,22
050,53,013,"Washington","Columbia County",2,39,47,25,22
050,53,013,"Washington","Columbia County",2,40,46,25,21
050,53,013,"Washington","Columbia County",2,41,44,25,19
050,53,013,"Washington","Columbia County",2,42,45,27,18
050,53,013,"Washington","Columbia County",2,43,38,19,19
050,53,013,"Washington","Columbia County",2,44,40,21,19
050,53,013,"Washington","Columbia County",2,45,30,17,13
050,53,013,"Washington","Columbia County",2,46,29,13,16
050,53,013,"Washington","Columbia County",2,47,33,16,17
050,53,013,"Washington","Columbia County",2,48,37,19,18
050,53,013,"Washington","Columbia County",2,49,51,31,20
050,53,013,"Washington","Columbia County",2,50,46,24,22
050,53,013,"Washington","Columbia County",2,51,48,24,24
050,53,013,"Washington","Columbia County",2,52,48,23,25
050,53,013,"Washington","Columbia County",2,53,43,24,19
050,53,013,"Washington","Columbia County",2,54,49,26,23
050,53,013,"Washington","Columbia County",2,55,58,31,27
050,53,013,"Washington","Columbia County",2,56,68,34,34
050,53,013,"Washington","Columbia County",2,57,65,29,36
050,53,013,"Washington","Columbia County",2,58,67,31,36
050,53,013,"Washington","Columbia County",2,59,56,27,29
050,53,013,"Washington","Columbia County",2,60,61,32,29
050,53,013,"Washington","Columbia County",2,61,69,32,37
050,53,013,"Washington","Columbia County",2,62,67,29,38
050,53,013,"Washington","Columbia County",2,63,69,33,36
050,53,013,"Washington","Columbia County",2,64,64,33,31
050,53,013,"Washington","Columbia County",2,65,59,32,27
050,53,013,"Washington","Columbia County",2,66,61,27,34
050,53,013,"Washington","Columbia County",2,67,72,32,40
050,53,013,"Washington","Columbia County",2,68,74,36,38
050,53,013,"Washington","Columbia County",2,69,76,36,40
050,53,013,"Washington","Columbia County",2,70,71,32,39
050,53,013,"Washington","Columbia County",2,71,68,35,33
050,53,013,"Washington","Columbia County",2,72,62,34,28
050,53,013,"Washington","Columbia County",2,73,68,32,36
050,53,013,"Washington","Columbia County",2,74,44,21,23
050,53,013,"Washington","Columbia County",2,75,45,22,23
050,53,013,"Washington","Columbia County",2,76,43,22,21
050,53,013,"Washington","Columbia County",2,77,44,21,23
050,53,013,"Washington","Columbia County",2,78,37,17,20
050,53,013,"Washington","Columbia County",2,79,38,18,20
050,53,013,"Washington","Columbia County",2,80,36,19,17
050,53,013,"Washington","Columbia County",2,81,36,20,16
050,53,013,"Washington","Columbia County",2,82,29,14,15
050,53,013,"Washington","Columbia County",2,83,28,14,14
050,53,013,"Washington","Columbia County",2,84,20,12,8
050,53,013,"Washington","Columbia County",2,85,122,50,72
050,53,013,"Washington","Columbia County",3,0,37,22,15
050,53,013,"Washington","Columbia County",3,1,24,13,11
050,53,013,"Washington","Columbia County",3,2,35,15,20
050,53,013,"Washington","Columbia County",3,3,34,18,16
050,53,013,"Washington","Columbia County",3,4,35,15,20
050,53,013,"Washington","Columbia County",3,5,40,19,21
050,53,013,"Washington","Columbia County",3,6,39,21,18
050,53,013,"Washington","Columbia County",3,7,42,20,22
050,53,013,"Washington","Columbia County",3,8,44,27,17
050,53,013,"Washington","Columbia County",3,9,32,15,17
050,53,013,"Washington","Columbia County",3,10,39,21,18
050,53,013,"Washington","Columbia County",3,11,38,21,17
050,53,013,"Washington","Columbia County",3,12,43,24,19
050,53,013,"Washington","Columbia County",3,13,47,29,18
050,53,013,"Washington","Columbia County",3,14,55,27,28
050,53,013,"Washington","Columbia County",3,15,46,25,21
050,53,013,"Washington","Columbia County",3,16,52,32,20
050,53,013,"Washington","Columbia County",3,17,36,18,18
050,53,013,"Washington","Columbia County",3,18,39,16,23
050,53,013,"Washington","Columbia County",3,19,35,18,17
050,53,013,"Washington","Columbia County",3,20,28,18,10
050,53,013,"Washington","Columbia County",3,21,34,16,18
050,53,013,"Washington","Columbia County",3,22,38,17,21
050,53,013,"Washington","Columbia County",3,23,39,19,20
050,53,013,"Washington","Columbia County",3,24,36,19,17
050,53,013,"Washington","Columbia County",3,25,37,18,19
050,53,013,"Washington","Columbia County",3,26,40,18,22
050,53,013,"Washington","Columbia County",3,27,44,23,21
050,53,013,"Washington","Columbia County",3,28,48,19,29
050,53,013,"Washington","Columbia County",3,29,46,15,31
050,53,013,"Washington","Columbia County",3,30,41,17,24
050,53,013,"Washington","Columbia County",3,31,48,22,26
050,53,013,"Washington","Columbia County",3,32,43,16,27
050,53,013,"Washington","Columbia County",3,33,38,14,24
050,53,013,"Washington","Columbia County",3,34,35,13,22
050,53,013,"Washington","Columbia County",3,35,46,22,24
050,53,013,"Washington","Columbia County",3,36,34,14,20
050,53,013,"Washington","Columbia County",3,37,36,20,16
050,53,013,"Washington","Columbia County",3,38,42,21,21
050,53,013,"Washington","Columbia County",3,39,47,25,22
050,53,013,"Washington","Columbia County",3,40,50,25,25
050,53,013,"Washington","Columbia County",3,41,48,27,21
050,53,013,"Washington","Columbia County",3,42,45,25,20
050,53,013,"Washington","Columbia County",3,43,45,28,17
050,53,013,"Washington","Columbia County",3,44,40,20,20
050,53,013,"Washington","Columbia County",3,45,38,19,19
050,53,013,"Washington","Columbia County",3,46,34,21,13
050,53,013,"Washington","Columbia County",3,47,29,14,15
050,53,013,"Washington","Columbia County",3,48,35,17,18
050,53,013,"Washington","Columbia County",3,49,46,24,22
050,53,013,"Washington","Columbia County",3,50,46,26,20
050,53,013,"Washington","Columbia County",3,51,46,23,23
050,53,013,"Washington","Columbia County",3,52,48,24,24
050,53,013,"Washington","Columbia County",3,53,47,18,29
050,53,013,"Washington","Columbia County",3,54,42,24,18
050,53,013,"Washington","Columbia County",3,55,51,28,23
050,53,013,"Washington","Columbia County",3,56,54,29,25
050,53,013,"Washington","Columbia County",3,57,70,35,35
050,53,013,"Washington","Columbia County",3,58,61,28,33
050,53,013,"Washington","Columbia County",3,59,66,29,37
050,53,013,"Washington","Columbia County",3,60,54,25,29
050,53,013,"Washington","Columbia County",3,61,68,33,35
050,53,013,"Washington","Columbia County",3,62,70,31,39
050,53,013,"Washington","Columbia County",3,63,68,28,40
050,53,013,"Washington","Columbia County",3,64,75,36,39
050,53,013,"Washington","Columbia County",3,65,66,31,35
050,53,013,"Washington","Columbia County",3,66,58,33,25
050,53,013,"Washington","Columbia County",3,67,62,32,30
050,53,013,"Washington","Columbia County",3,68,74,32,42
050,53,013,"Washington","Columbia County",3,69,76,37,39
050,53,013,"Washington","Columbia County",3,70,74,33,41
050,53,013,"Washington","Columbia County",3,71,67,31,36
050,53,013,"Washington","Columbia County",3,72,70,35,35
050,53,013,"Washington","Columbia County",3,73,61,32,29
050,53,013,"Washington","Columbia County",3,74,60,28,32
050,53,013,"Washington","Columbia County",3,75,45,22,23
050,53,013,"Washington","Columbia County",3,76,42,21,21
050,53,013,"Washington","Columbia County",3,77,47,23,24
050,53,013,"Washington","Columbia County",3,78,38,18,20
050,53,013,"Washington","Columbia County",3,79,37,17,20
050,53,013,"Washington","Columbia County",3,80,34,17,17
050,53,013,"Washington","Columbia County",3,81,34,17,17
050,53,013,"Washington","Columbia County",3,82,36,18,18
050,53,013,"Washington","Columbia County",3,83,25,13,12
050,53,013,"Washington","Columbia County",3,84,26,13,13
050,53,013,"Washington","Columbia County",3,85,116,53,63
050,53,013,"Washington","Columbia County",4,0,33,18,15
050,53,013,"Washington","Columbia County",4,1,33,21,12
050,53,013,"Washington","Columbia County",4,2,26,15,11
050,53,013,"Washington","Columbia County",4,3,34,12,22
050,53,013,"Washington","Columbia County",4,4,41,23,18
050,53,013,"Washington","Columbia County",4,5,34,16,18
050,53,013,"Washington","Columbia County",4,6,39,19,20
050,53,013,"Washington","Columbia County",4,7,43,22,21
050,53,013,"Washington","Columbia County",4,8,41,18,23
050,53,013,"Washington","Columbia County",4,9,46,31,15
050,53,013,"Washington","Columbia County",4,10,32,16,16
050,53,013,"Washington","Columbia County",4,11,41,22,19
050,53,013,"Washington","Columbia County",4,12,40,23,17
050,53,013,"Washington","Columbia County",4,13,41,21,20
050,53,013,"Washington","Columbia County",4,14,47,30,17
050,53,013,"Washington","Columbia County",4,15,48,24,24
050,53,013,"Washington","Columbia County",4,16,47,24,23
050,53,013,"Washington","Columbia County",4,17,43,27,16
050,53,013,"Washington","Columbia County",4,18,36,18,18
050,53,013,"Washington","Columbia County",4,19,31,15,16
050,53,013,"Washington","Columbia County",4,20,29,17,12
050,53,013,"Washington","Columbia County",4,21,30,16,14
050,53,013,"Washington","Columbia County",4,22,33,18,15
050,53,013,"Washington","Columbia County",4,23,42,18,24
050,53,013,"Washington","Columbia County",4,24,39,20,19
050,53,013,"Washington","Columbia County",4,25,41,23,18
050,53,013,"Washington","Columbia County",4,26,36,19,17
050,53,013,"Washington","Columbia County",4,27,33,14,19
050,53,013,"Washington","Columbia County",4,28,47,26,21
050,53,013,"Washington","Columbia County",4,29,51,20,31
050,53,013,"Washington","Columbia County",4,30,46,17,29
050,53,013,"Washington","Columbia County",4,31,48,20,28
050,53,013,"Washington","Columbia County",4,32,46,20,26
050,53,013,"Washington","Columbia County",4,33,46,18,28
050,53,013,"Washington","Columbia County",4,34,41,17,24
050,53,013,"Washington","Columbia County",4,35,38,11,27
050,53,013,"Washington","Columbia County",4,36,47,22,25
050,53,013,"Washington","Columbia County",4,37,32,14,18
050,53,013,"Washington","Columbia County",4,38,38,21,17
050,53,013,"Washington","Columbia County",4,39,43,24,19
050,53,013,"Washington","Columbia County",4,40,43,23,20
050,53,013,"Washington","Columbia County",4,41,47,22,25
050,53,013,"Washington","Columbia County",4,42,48,28,20
050,53,013,"Washington","Columbia County",4,43,44,23,21
050,53,013,"Washington","Columbia County",4,44,44,27,17
050,53,013,"Washington","Columbia County",4,45,39,20,19
050,53,013,"Washington","Columbia County",4,46,36,17,19
050,53,013,"Washington","Columbia County",4,47,29,19,10
050,53,013,"Washington","Columbia County",4,48,31,15,16
050,53,013,"Washington","Columbia County",4,49,45,24,21
050,53,013,"Washington","Columbia County",4,50,45,21,24
050,53,013,"Washington","Columbia County",4,51,46,23,23
050,53,013,"Washington","Columbia County",4,52,46,23,23
050,53,013,"Washington","Columbia County",4,53,52,24,28
050,53,013,"Washington","Columbia County",4,54,49,18,31
050,53,013,"Washington","Columbia County",4,55,43,24,19
050,53,013,"Washington","Columbia County",4,56,61,33,28
050,53,013,"Washington","Columbia County",4,57,52,27,25
050,53,013,"Washington","Columbia County",4,58,71,37,34
050,53,013,"Washington","Columbia County",4,59,62,31,31
050,53,013,"Washington","Columbia County",4,60,71,31,40
050,53,013,"Washington","Columbia County",4,61,57,30,27
050,53,013,"Washington","Columbia County",4,62,73,31,42
050,53,013,"Washington","Columbia County",4,63,69,30,39
050,53,013,"Washington","Columbia County",4,64,71,30,41
050,53,013,"Washington","Columbia County",4,65,81,38,43
050,53,013,"Washington","Columbia County",4,66,67,32,35
050,53,013,"Washington","Columbia County",4,67,59,32,27
050,53,013,"Washington","Columbia County",4,68,65,35,30
050,53,013,"Washington","Columbia County",4,69,77,34,43
050,53,013,"Washington","Columbia County",4,70,78,35,43
050,53,013,"Washington","Columbia County",4,71,75,33,42
050,53,013,"Washington","Columbia County",4,72,63,29,34
050,53,013,"Washington","Columbia County",4,73,67,35,32
050,53,013,"Washington","Columbia County",4,74,61,32,29
050,53,013,"Washington","Columbia County",4,75,58,26,32
050,53,013,"Washington","Columbia County",4,76,39,20,19
050,53,013,"Washington","Columbia County",4,77,41,20,21
050,53,013,"Washington","Columbia County",4,78,35,18,17
050,53,013,"Washington","Columbia County",4,79,38,19,19
050,53,013,"Washington","Columbia County",4,80,36,15,21
050,53,013,"Washington","Columbia County",4,81,31,16,15
050,53,013,"Washington","Columbia County",4,82,27,13,14
050,53,013,"Washington","Columbia County",4,83,33,16,17
050,53,013,"Washington","Columbia County",4,84,27,14,13
050,53,013,"Washington","Columbia County",4,85,112,56,56
050,53,013,"Washington","Columbia County",5,0,34,18,16
050,53,013,"Washington","Columbia County",5,1,35,20,15
050,53,013,"Washington","Columbia County",5,2,41,24,17
050,53,013,"Washington","Columbia County",5,3,33,18,15
050,53,013,"Washington","Columbia County",5,4,36,11,25
050,53,013,"Washington","Columbia County",5,5,40,21,19
050,53,013,"Washington","Columbia County",5,6,34,14,20
050,53,013,"Washington","Columbia County",5,7,42,21,21
050,53,013,"Washington","Columbia County",5,8,47,23,24
050,53,013,"Washington","Columbia County",5,9,49,22,27
050,53,013,"Washington","Columbia County",5,10,43,27,16
050,53,013,"Washington","Columbia County",5,11,33,15,18
050,53,013,"Washington","Columbia County",5,12,39,20,19
050,53,013,"Washington","Columbia County",5,13,41,23,18
050,53,013,"Washington","Columbia County",5,14,42,24,18
050,53,013,"Washington","Columbia County",5,15,46,29,17
050,53,013,"Washington","Columbia County",5,16,50,24,26
050,53,013,"Washington","Columbia County",5,17,43,18,25
050,53,013,"Washington","Columbia County",5,18,39,25,14
050,53,013,"Washington","Columbia County",5,19,29,11,18
050,53,013,"Washington","Columbia County",5,20,31,14,17
050,53,013,"Washington","Columbia County",5,21,37,21,16
050,53,013,"Washington","Columbia County",5,22,26,10,16
050,53,013,"Washington","Columbia County",5,23,38,25,13
050,53,013,"Washington","Columbia County",5,24,40,15,25
050,53,013,"Washington","Columbia County",5,25,39,26,13
050,53,013,"Washington","Columbia County",5,26,43,24,19
050,53,013,"Washington","Columbia County",5,27,39,18,21
050,53,013,"Washington","Columbia County",5,28,39,17,22
050,53,013,"Washington","Columbia County",5,29,44,20,24
050,53,013,"Washington","Columbia County",5,30,50,19,31
050,53,013,"Washington","Columbia County",5,31,46,18,28
050,53,013,"Washington","Columbia County",5,32,47,18,29
050,53,013,"Washington","Columbia County",5,33,45,19,26
050,53,013,"Washington","Columbia County",5,34,48,19,29
050,53,013,"Washington","Columbia County",5,35,46,19,27
050,53,013,"Washington","Columbia County",5,36,41,14,27
050,53,013,"Washington","Columbia County",5,37,49,24,25
050,53,013,"Washington","Columbia County",5,38,32,14,18
050,53,013,"Washington","Columbia County",5,39,39,22,17
050,53,013,"Washington","Columbia County",5,40,43,24,19
050,53,013,"Washington","Columbia County",5,41,46,26,20
050,53,013,"Washington","Columbia County",5,42,53,25,28
050,53,013,"Washington","Columbia County",5,43,48,27,21
050,53,013,"Washington","Columbia County",5,44,45,23,22
050,53,013,"Washington","Columbia County",5,45,43,27,16
050,53,013,"Washington","Columbia County",5,46,43,20,23
050,53,013,"Washington","Columbia County",5,47,35,16,19
050,53,013,"Washington","Columbia County",5,48,33,22,11
050,53,013,"Washington","Columbia County",5,49,36,20,16
050,53,013,"Washington","Columbia County",5,50,43,23,20
050,53,013,"Washington","Columbia County",5,51,47,22,25
050,53,013,"Washington","Columbia County",5,52,41,21,20
050,53,013,"Washington","Columbia County",5,53,49,24,25
050,53,013,"Washington","Columbia County",5,54,54,24,30
050,53,013,"Washington","Columbia County",5,55,52,19,33
050,53,013,"Washington","Columbia County",5,56,40,22,18
050,53,013,"Washington","Columbia County",5,57,60,31,29
050,53,013,"Washington","Columbia County",5,58,50,25,25
050,53,013,"Washington","Columbia County",5,59,66,36,30
050,53,013,"Washington","Columbia County",5,60,61,30,31
050,53,013,"Washington","Columbia County",5,61,68,32,36
050,53,013,"Washington","Columbia County",5,62,62,29,33
050,53,013,"Washington","Columbia County",5,63,72,32,40
050,53,013,"Washington","Columbia County",5,64,68,31,37
050,53,013,"Washington","Columbia County",5,65,66,26,40
050,53,013,"Washington","Columbia County",5,66,80,37,43
050,53,013,"Washington","Columbia County",5,67,68,33,35
050,53,013,"Washington","Columbia County",5,68,57,30,27
050,53,013,"Washington","Columbia County",5,69,63,34,29
050,53,013,"Washington","Columbia County",5,70,71,31,40
050,53,013,"Washington","Columbia County",5,71,76,34,42
050,53,013,"Washington","Columbia County",5,72,71,32,39
050,53,013,"Washington","Columbia County",5,73,64,28,36
050,53,013,"Washington","Columbia County",5,74,68,35,33
050,53,013,"Washington","Columbia County",5,75,56,29,27
050,53,013,"Washington","Columbia County",5,76,58,28,30
050,53,013,"Washington","Columbia County",5,77,39,19,20
050,53,013,"Washington","Columbia County",5,78,37,16,21
050,53,013,"Washington","Columbia County",5,79,35,17,18
050,53,013,"Washington","Columbia County",5,80,37,19,18
050,53,013,"Washington","Columbia County",5,81,35,15,20
050,53,013,"Washington","Columbia County",5,82,23,11,12
050,53,013,"Washington","Columbia County",5,83,27,13,14
050,53,013,"Washington","Columbia County",5,84,34,17,17
050,53,013,"Washington","Columbia County",5,85,115,60,55
050,53,015,"Washington","Cowlitz County",1,0,1238,632,606
050,53,015,"Washington","Cowlitz County",1,1,1252,618,634
050,53,015,"Washington","Cowlitz County",1,2,1320,668,652
050,53,015,"Washington","Cowlitz County",1,3,1377,698,679
050,53,015,"Washington","Cowlitz County",1,4,1452,756,696
050,53,015,"Washington","Cowlitz County",1,5,1427,727,700
050,53,015,"Washington","Cowlitz County",1,6,1374,709,665
050,53,015,"Washington","Cowlitz County",1,7,1397,716,681
050,53,015,"Washington","Cowlitz County",1,8,1401,720,681
050,53,015,"Washington","Cowlitz County",1,9,1429,723,706
050,53,015,"Washington","Cowlitz County",1,10,1429,737,692
050,53,015,"Washington","Cowlitz County",1,11,1488,744,744
050,53,015,"Washington","Cowlitz County",1,12,1512,781,731
050,53,015,"Washington","Cowlitz County",1,13,1499,784,715
050,53,015,"Washington","Cowlitz County",1,14,1461,735,726
050,53,015,"Washington","Cowlitz County",1,15,1439,729,710
050,53,015,"Washington","Cowlitz County",1,16,1400,725,675
050,53,015,"Washington","Cowlitz County",1,17,1503,741,762
050,53,015,"Washington","Cowlitz County",1,18,1247,638,609
050,53,015,"Washington","Cowlitz County",1,19,1050,560,490
050,53,015,"Washington","Cowlitz County",1,20,1075,551,524
050,53,015,"Washington","Cowlitz County",1,21,1087,555,532
050,53,015,"Washington","Cowlitz County",1,22,1140,566,574
050,53,015,"Washington","Cowlitz County",1,23,1233,621,612
050,53,015,"Washington","Cowlitz County",1,24,1265,623,642
050,53,015,"Washington","Cowlitz County",1,25,1366,686,680
050,53,015,"Washington","Cowlitz County",1,26,1324,666,658
050,53,015,"Washington","Cowlitz County",1,27,1421,697,724
050,53,015,"Washington","Cowlitz County",1,28,1521,753,768
050,53,015,"Washington","Cowlitz County",1,29,1457,714,743
050,53,015,"Washington","Cowlitz County",1,30,1473,709,764
050,53,015,"Washington","Cowlitz County",1,31,1429,713,716
050,53,015,"Washington","Cowlitz County",1,32,1373,693,680
050,53,015,"Washington","Cowlitz County",1,33,1361,696,665
050,53,015,"Washington","Cowlitz County",1,34,1318,673,645
050,53,015,"Washington","Cowlitz County",1,35,1322,668,654
050,53,015,"Washington","Cowlitz County",1,36,1263,645,618
050,53,015,"Washington","Cowlitz County",1,37,1336,669,667
050,53,015,"Washington","Cowlitz County",1,38,1409,707,702
050,53,015,"Washington","Cowlitz County",1,39,1366,693,673
050,53,015,"Washington","Cowlitz County",1,40,1394,732,662
050,53,015,"Washington","Cowlitz County",1,41,1339,665,674
050,53,015,"Washington","Cowlitz County",1,42,1320,669,651
050,53,015,"Washington","Cowlitz County",1,43,1266,662,604
050,53,015,"Washington","Cowlitz County",1,44,1271,631,640
050,53,015,"Washington","Cowlitz County",1,45,1275,651,624
050,53,015,"Washington","Cowlitz County",1,46,1238,616,622
050,53,015,"Washington","Cowlitz County",1,47,1239,637,602
050,53,015,"Washington","Cowlitz County",1,48,1326,688,638
050,53,015,"Washington","Cowlitz County",1,49,1447,719,728
050,53,015,"Washington","Cowlitz County",1,50,1421,728,693
050,53,015,"Washington","Cowlitz County",1,51,1395,712,683
050,53,015,"Washington","Cowlitz County",1,52,1316,645,671
050,53,015,"Washington","Cowlitz County",1,53,1314,655,659
050,53,015,"Washington","Cowlitz County",1,54,1347,666,681
050,53,015,"Washington","Cowlitz County",1,55,1441,722,719
050,53,015,"Washington","Cowlitz County",1,56,1466,729,737
050,53,015,"Washington","Cowlitz County",1,57,1555,749,806
050,53,015,"Washington","Cowlitz County",1,58,1578,785,793
050,53,015,"Washington","Cowlitz County",1,59,1591,792,799
050,53,015,"Washington","Cowlitz County",1,60,1601,826,775
050,53,015,"Washington","Cowlitz County",1,61,1619,798,821
050,53,015,"Washington","Cowlitz County",1,62,1643,820,823
050,53,015,"Washington","Cowlitz County",1,63,1597,820,777
050,53,015,"Washington","Cowlitz County",1,64,1500,738,762
050,53,015,"Washington","Cowlitz County",1,65,1453,716,737
050,53,015,"Washington","Cowlitz County",1,66,1426,712,714
050,53,015,"Washington","Cowlitz County",1,67,1385,701,684
050,53,015,"Washington","Cowlitz County",1,68,1375,688,687
050,53,015,"Washington","Cowlitz County",1,69,1298,616,682
050,53,015,"Washington","Cowlitz County",1,70,1248,590,658
050,53,015,"Washington","Cowlitz County",1,71,1252,582,670
050,53,015,"Washington","Cowlitz County",1,72,1265,603,662
050,53,015,"Washington","Cowlitz County",1,73,1263,632,631
050,53,015,"Washington","Cowlitz County",1,74,875,425,450
050,53,015,"Washington","Cowlitz County",1,75,882,433,449
050,53,015,"Washington","Cowlitz County",1,76,865,410,455
050,53,015,"Washington","Cowlitz County",1,77,803,380,423
050,53,015,"Washington","Cowlitz County",1,78,712,346,366
050,53,015,"Washington","Cowlitz County",1,79,650,311,339
050,53,015,"Washington","Cowlitz County",1,80,595,289,306
050,53,015,"Washington","Cowlitz County",1,81,509,239,270
050,53,015,"Washington","Cowlitz County",1,82,451,212,239
050,53,015,"Washington","Cowlitz County",1,83,389,175,214
050,53,015,"Washington","Cowlitz County",1,84,337,153,184
050,53,015,"Washington","Cowlitz County",1,85,1962,774,1188
050,53,015,"Washington","Cowlitz County",2,0,1235,635,600
050,53,015,"Washington","Cowlitz County",2,1,1258,626,632
050,53,015,"Washington","Cowlitz County",2,2,1314,659,655
050,53,015,"Washington","Cowlitz County",2,3,1369,695,674
050,53,015,"Washington","Cowlitz County",2,4,1443,746,697
050,53,015,"Washington","Cowlitz County",2,5,1439,736,703
050,53,015,"Washington","Cowlitz County",2,6,1393,718,675
050,53,015,"Washington","Cowlitz County",2,7,1388,713,675
050,53,015,"Washington","Cowlitz County",2,8,1396,718,678
050,53,015,"Washington","Cowlitz County",2,9,1419,724,695
050,53,015,"Washington","Cowlitz County",2,10,1432,734,698
050,53,015,"Washington","Cowlitz County",2,11,1468,742,726
050,53,015,"Washington","Cowlitz County",2,12,1508,773,735
050,53,015,"Washington","Cowlitz County",2,13,1500,781,719
050,53,015,"Washington","Cowlitz County",2,14,1471,744,727
050,53,015,"Washington","Cowlitz County",2,15,1447,735,712
050,53,015,"Washington","Cowlitz County",2,16,1415,730,685
050,53,015,"Washington","Cowlitz County",2,17,1480,743,737
050,53,015,"Washington","Cowlitz County",2,18,1246,637,609
050,53,015,"Washington","Cowlitz County",2,19,1046,552,494
050,53,015,"Washington","Cowlitz County",2,20,1091,564,527
050,53,015,"Washington","Cowlitz County",2,21,1093,556,537
050,53,015,"Washington","Cowlitz County",2,22,1148,572,576
050,53,015,"Washington","Cowlitz County",2,23,1225,614,611
050,53,015,"Washington","Cowlitz County",2,24,1279,631,648
050,53,015,"Washington","Cowlitz County",2,25,1348,675,673
050,53,015,"Washington","Cowlitz County",2,26,1347,678,669
050,53,015,"Washington","Cowlitz County",2,27,1410,698,712
050,53,015,"Washington","Cowlitz County",2,28,1503,740,763
050,53,015,"Washington","Cowlitz County",2,29,1481,726,755
050,53,015,"Washington","Cowlitz County",2,30,1482,718,764
050,53,015,"Washington","Cowlitz County",2,31,1440,715,725
050,53,015,"Washington","Cowlitz County",2,32,1390,700,690
050,53,015,"Washington","Cowlitz County",2,33,1363,694,669
050,53,015,"Washington","Cowlitz County",2,34,1341,688,653
050,53,015,"Washington","Cowlitz County",2,35,1340,680,660
050,53,015,"Washington","Cowlitz County",2,36,1276,647,629
050,53,015,"Washington","Cowlitz County",2,37,1331,667,664
050,53,015,"Washington","Cowlitz County",2,38,1400,705,695
050,53,015,"Washington","Cowlitz County",2,39,1374,696,678
050,53,015,"Washington","Cowlitz County",2,40,1402,728,674
050,53,015,"Washington","Cowlitz County",2,41,1350,680,670
050,53,015,"Washington","Cowlitz County",2,42,1322,669,653
050,53,015,"Washington","Cowlitz County",2,43,1296,674,622
050,53,015,"Washington","Cowlitz County",2,44,1261,637,624
050,53,015,"Washington","Cowlitz County",2,45,1285,651,634
050,53,015,"Washington","Cowlitz County",2,46,1244,624,620
050,53,015,"Washington","Cowlitz County",2,47,1241,631,610
050,53,015,"Washington","Cowlitz County",2,48,1305,675,630
050,53,015,"Washington","Cowlitz County",2,49,1424,717,707
050,53,015,"Washington","Cowlitz County",2,50,1436,731,705
050,53,015,"Washington","Cowlitz County",2,51,1403,715,688
050,53,015,"Washington","Cowlitz County",2,52,1330,658,672
050,53,015,"Washington","Cowlitz County",2,53,1321,656,665
050,53,015,"Washington","Cowlitz County",2,54,1334,661,673
050,53,015,"Washington","Cowlitz County",2,55,1423,711,712
050,53,015,"Washington","Cowlitz County",2,56,1472,733,739
050,53,015,"Washington","Cowlitz County",2,57,1541,747,794
050,53,015,"Washington","Cowlitz County",2,58,1578,779,799
050,53,015,"Washington","Cowlitz County",2,59,1603,799,804
050,53,015,"Washington","Cowlitz County",2,60,1600,818,782
050,53,015,"Washington","Cowlitz County",2,61,1604,800,804
050,53,015,"Washington","Cowlitz County",2,62,1632,811,821
050,53,015,"Washington","Cowlitz County",2,63,1624,828,796
050,53,015,"Washington","Cowlitz County",2,64,1519,756,763
050,53,015,"Washington","Cowlitz County",2,65,1458,717,741
050,53,015,"Washington","Cowlitz County",2,66,1428,713,715
050,53,015,"Washington","Cowlitz County",2,67,1391,700,691
050,53,015,"Washington","Cowlitz County",2,68,1363,687,676
050,53,015,"Washington","Cowlitz County",2,69,1315,630,685
050,53,015,"Washington","Cowlitz County",2,70,1248,589,659
050,53,015,"Washington","Cowlitz County",2,71,1246,579,667
050,53,015,"Washington","Cowlitz County",2,72,1237,584,653
050,53,015,"Washington","Cowlitz County",2,73,1324,654,670
050,53,015,"Washington","Cowlitz County",2,74,907,445,462
050,53,015,"Washington","Cowlitz County",2,75,884,433,451
050,53,015,"Washington","Cowlitz County",2,76,856,410,446
050,53,015,"Washington","Cowlitz County",2,77,831,394,437
050,53,015,"Washington","Cowlitz County",2,78,709,342,367
050,53,015,"Washington","Cowlitz County",2,79,656,313,343
050,53,015,"Washington","Cowlitz County",2,80,601,289,312
050,53,015,"Washington","Cowlitz County",2,81,519,249,270
050,53,015,"Washington","Cowlitz County",2,82,464,218,246
050,53,015,"Washington","Cowlitz County",2,83,393,178,215
050,53,015,"Washington","Cowlitz County",2,84,344,158,186
050,53,015,"Washington","Cowlitz County",2,85,1961,773,1188
050,53,015,"Washington","Cowlitz County",3,0,1197,614,583
050,53,015,"Washington","Cowlitz County",3,1,1246,642,604
050,53,015,"Washington","Cowlitz County",3,2,1260,629,631
050,53,015,"Washington","Cowlitz County",3,3,1329,673,656
050,53,015,"Washington","Cowlitz County",3,4,1408,734,674
050,53,015,"Washington","Cowlitz County",3,5,1469,746,723
050,53,015,"Washington","Cowlitz County",3,6,1486,768,718
050,53,015,"Washington","Cowlitz County",3,7,1407,725,682
050,53,015,"Washington","Cowlitz County",3,8,1398,720,678
050,53,015,"Washington","Cowlitz County",3,9,1393,727,666
050,53,015,"Washington","Cowlitz County",3,10,1425,731,694
050,53,015,"Washington","Cowlitz County",3,11,1450,745,705
050,53,015,"Washington","Cowlitz County",3,12,1439,733,706
050,53,015,"Washington","Cowlitz County",3,13,1501,753,748
050,53,015,"Washington","Cowlitz County",3,14,1518,783,735
050,53,015,"Washington","Cowlitz County",3,15,1483,745,738
050,53,015,"Washington","Cowlitz County",3,16,1430,727,703
050,53,015,"Washington","Cowlitz County",3,17,1419,744,675
050,53,015,"Washington","Cowlitz County",3,18,1272,654,618
050,53,015,"Washington","Cowlitz County",3,19,1015,529,486
050,53,015,"Washington","Cowlitz County",3,20,1134,595,539
050,53,015,"Washington","Cowlitz County",3,21,1115,576,539
050,53,015,"Washington","Cowlitz County",3,22,1177,595,582
050,53,015,"Washington","Cowlitz County",3,23,1221,613,608
050,53,015,"Washington","Cowlitz County",3,24,1288,652,636
050,53,015,"Washington","Cowlitz County",3,25,1296,653,643
050,53,015,"Washington","Cowlitz County",3,26,1379,687,692
050,53,015,"Washington","Cowlitz County",3,27,1371,676,695
050,53,015,"Washington","Cowlitz County",3,28,1431,711,720
050,53,015,"Washington","Cowlitz County",3,29,1535,766,769
050,53,015,"Washington","Cowlitz County",3,30,1525,752,773
050,53,015,"Washington","Cowlitz County",3,31,1514,757,757
050,53,015,"Washington","Cowlitz County",3,32,1464,741,723
050,53,015,"Washington","Cowlitz County",3,33,1438,710,728
050,53,015,"Washington","Cowlitz County",3,34,1381,708,673
050,53,015,"Washington","Cowlitz County",3,35,1374,699,675
050,53,015,"Washington","Cowlitz County",3,36,1374,697,677
050,53,015,"Washington","Cowlitz County",3,37,1301,674,627
050,53,015,"Washington","Cowlitz County",3,38,1349,675,674
050,53,015,"Washington","Cowlitz County",3,39,1393,706,687
050,53,015,"Washington","Cowlitz County",3,40,1374,689,685
050,53,015,"Washington","Cowlitz County",3,41,1427,737,690
050,53,015,"Washington","Cowlitz County",3,42,1362,683,679
050,53,015,"Washington","Cowlitz County",3,43,1317,662,655
050,53,015,"Washington","Cowlitz County",3,44,1301,662,639
050,53,015,"Washington","Cowlitz County",3,45,1284,655,629
050,53,015,"Washington","Cowlitz County",3,46,1277,651,626
050,53,015,"Washington","Cowlitz County",3,47,1262,636,626
050,53,015,"Washington","Cowlitz County",3,48,1251,641,610
050,53,015,"Washington","Cowlitz County",3,49,1324,683,641
050,53,015,"Washington","Cowlitz County",3,50,1418,712,706
050,53,015,"Washington","Cowlitz County",3,51,1473,750,723
050,53,015,"Washington","Cowlitz County",3,52,1427,723,704
050,53,015,"Washington","Cowlitz County",3,53,1361,668,693
050,53,015,"Washington","Cowlitz County",3,54,1299,634,665
050,53,015,"Washington","Cowlitz County",3,55,1312,646,666
050,53,015,"Washington","Cowlitz County",3,56,1419,710,709
050,53,015,"Washington","Cowlitz County",3,57,1467,729,738
050,53,015,"Washington","Cowlitz County",3,58,1528,742,786
050,53,015,"Washington","Cowlitz County",3,59,1566,772,794
050,53,015,"Washington","Cowlitz County",3,60,1602,797,805
050,53,015,"Washington","Cowlitz County",3,61,1584,804,780
050,53,015,"Washington","Cowlitz County",3,62,1571,786,785
050,53,015,"Washington","Cowlitz County",3,63,1614,800,814
050,53,015,"Washington","Cowlitz County",3,64,1620,818,802
050,53,015,"Washington","Cowlitz County",3,65,1504,743,761
050,53,015,"Washington","Cowlitz County",3,66,1443,703,740
050,53,015,"Washington","Cowlitz County",3,67,1398,699,699
050,53,015,"Washington","Cowlitz County",3,68,1365,681,684
050,53,015,"Washington","Cowlitz County",3,69,1334,673,661
050,53,015,"Washington","Cowlitz County",3,70,1283,613,670
050,53,015,"Washington","Cowlitz County",3,71,1214,569,645
050,53,015,"Washington","Cowlitz County",3,72,1221,561,660
050,53,015,"Washington","Cowlitz County",3,73,1191,557,634
050,53,015,"Washington","Cowlitz County",3,74,1283,633,650
050,53,015,"Washington","Cowlitz County",3,75,867,422,445
050,53,015,"Washington","Cowlitz County",3,76,853,414,439
050,53,015,"Washington","Cowlitz County",3,77,830,391,439
050,53,015,"Washington","Cowlitz County",3,78,784,365,419
050,53,015,"Washington","Cowlitz County",3,79,670,317,353
050,53,015,"Washington","Cowlitz County",3,80,616,289,327
050,53,015,"Washington","Cowlitz County",3,81,559,266,293
050,53,015,"Washington","Cowlitz County",3,82,486,231,255
050,53,015,"Washington","Cowlitz County",3,83,427,194,233
050,53,015,"Washington","Cowlitz County",3,84,348,158,190
050,53,015,"Washington","Cowlitz County",3,85,1964,768,1196
050,53,015,"Washington","Cowlitz County",4,0,1217,607,610
050,53,015,"Washington","Cowlitz County",4,1,1208,621,587
050,53,015,"Washington","Cowlitz County",4,2,1252,664,588
050,53,015,"Washington","Cowlitz County",4,3,1277,645,632
050,53,015,"Washington","Cowlitz County",4,4,1353,690,663
050,53,015,"Washington","Cowlitz County",4,5,1408,729,679
050,53,015,"Washington","Cowlitz County",4,6,1462,727,735
050,53,015,"Washington","Cowlitz County",4,7,1471,769,702
050,53,015,"Washington","Cowlitz County",4,8,1404,726,678
050,53,015,"Washington","Cowlitz County",4,9,1401,707,694
050,53,015,"Washington","Cowlitz County",4,10,1379,706,673
050,53,015,"Washington","Cowlitz County",4,11,1426,734,692
050,53,015,"Washington","Cowlitz County",4,12,1463,744,719
050,53,015,"Washington","Cowlitz County",4,13,1436,723,713
050,53,015,"Washington","Cowlitz County",4,14,1509,761,748
050,53,015,"Washington","Cowlitz County",4,15,1552,813,739
050,53,015,"Washington","Cowlitz County",4,16,1463,730,733
050,53,015,"Washington","Cowlitz County",4,17,1444,750,694
050,53,015,"Washington","Cowlitz County",4,18,1210,643,567
050,53,015,"Washington","Cowlitz County",4,19,1017,509,508
050,53,015,"Washington","Cowlitz County",4,20,1058,546,512
050,53,015,"Washington","Cowlitz County",4,21,1155,601,554
050,53,015,"Washington","Cowlitz County",4,22,1158,597,561
050,53,015,"Washington","Cowlitz County",4,23,1231,632,599
050,53,015,"Washington","Cowlitz County",4,24,1264,635,629
050,53,015,"Washington","Cowlitz County",4,25,1306,661,645
050,53,015,"Washington","Cowlitz County",4,26,1340,662,678
050,53,015,"Washington","Cowlitz County",4,27,1413,715,698
050,53,015,"Washington","Cowlitz County",4,28,1368,668,700
050,53,015,"Washington","Cowlitz County",4,29,1473,753,720
050,53,015,"Washington","Cowlitz County",4,30,1526,773,753
050,53,015,"Washington","Cowlitz County",4,31,1560,771,789
050,53,015,"Washington","Cowlitz County",4,32,1492,735,757
050,53,015,"Washington","Cowlitz County",4,33,1521,762,759
050,53,015,"Washington","Cowlitz County",4,34,1449,720,729
050,53,015,"Washington","Cowlitz County",4,35,1415,708,707
050,53,015,"Washington","Cowlitz County",4,36,1407,725,682
050,53,015,"Washington","Cowlitz County",4,37,1406,716,690
050,53,015,"Washington","Cowlitz County",4,38,1317,678,639
050,53,015,"Washington","Cowlitz County",4,39,1392,704,688
050,53,015,"Washington","Cowlitz County",4,40,1420,735,685
050,53,015,"Washington","Cowlitz County",4,41,1378,680,698
050,53,015,"Washington","Cowlitz County",4,42,1438,741,697
050,53,015,"Washington","Cowlitz County",4,43,1395,701,694
050,53,015,"Washington","Cowlitz County",4,44,1324,669,655
050,53,015,"Washington","Cowlitz County",4,45,1314,662,652
050,53,015,"Washington","Cowlitz County",4,46,1281,647,634
050,53,015,"Washington","Cowlitz County",4,47,1289,648,641
050,53,015,"Washington","Cowlitz County",4,48,1264,622,642
050,53,015,"Washington","Cowlitz County",4,49,1276,656,620
050,53,015,"Washington","Cowlitz County",4,50,1340,685,655
050,53,015,"Washington","Cowlitz County",4,51,1452,735,717
050,53,015,"Washington","Cowlitz County",4,52,1446,740,706
050,53,015,"Washington","Cowlitz County",4,53,1442,729,713
050,53,015,"Washington","Cowlitz County",4,54,1356,676,680
050,53,015,"Washington","Cowlitz County",4,55,1282,626,656
050,53,015,"Washington","Cowlitz County",4,56,1314,640,674
050,53,015,"Washington","Cowlitz County",4,57,1408,696,712
050,53,015,"Washington","Cowlitz County",4,58,1484,737,747
050,53,015,"Washington","Cowlitz County",4,59,1533,744,789
050,53,015,"Washington","Cowlitz County",4,60,1555,765,790
050,53,015,"Washington","Cowlitz County",4,61,1578,786,792
050,53,015,"Washington","Cowlitz County",4,62,1565,807,758
050,53,015,"Washington","Cowlitz County",4,63,1557,778,779
050,53,015,"Washington","Cowlitz County",4,64,1579,777,802
050,53,015,"Washington","Cowlitz County",4,65,1570,801,769
050,53,015,"Washington","Cowlitz County",4,66,1493,734,759
050,53,015,"Washington","Cowlitz County",4,67,1413,682,731
050,53,015,"Washington","Cowlitz County",4,68,1396,691,705
050,53,015,"Washington","Cowlitz County",4,69,1330,658,672
050,53,015,"Washington","Cowlitz County",4,70,1295,650,645
050,53,015,"Washington","Cowlitz County",4,71,1236,583,653
050,53,015,"Washington","Cowlitz County",4,72,1171,541,630
050,53,015,"Washington","Cowlitz County",4,73,1186,535,651
050,53,015,"Washington","Cowlitz County",4,74,1170,541,629
050,53,015,"Washington","Cowlitz County",4,75,1210,589,621
050,53,015,"Washington","Cowlitz County",4,76,841,400,441
050,53,015,"Washington","Cowlitz County",4,77,820,396,424
050,53,015,"Washington","Cowlitz County",4,78,788,368,420
050,53,015,"Washington","Cowlitz County",4,79,733,336,397
050,53,015,"Washington","Cowlitz County",4,80,633,287,346
050,53,015,"Washington","Cowlitz County",4,81,586,273,313
050,53,015,"Washington","Cowlitz County",4,82,525,246,279
050,53,015,"Washington","Cowlitz County",4,83,448,211,237
050,53,015,"Washington","Cowlitz County",4,84,390,177,213
050,53,015,"Washington","Cowlitz County",4,85,1957,769,1188
050,53,015,"Washington","Cowlitz County",5,0,1204,599,605
050,53,015,"Washington","Cowlitz County",5,1,1232,600,632
050,53,015,"Washington","Cowlitz County",5,2,1234,619,615
050,53,015,"Washington","Cowlitz County",5,3,1300,680,620
050,53,015,"Washington","Cowlitz County",5,4,1299,656,643
050,53,015,"Washington","Cowlitz County",5,5,1372,709,663
050,53,015,"Washington","Cowlitz County",5,6,1419,735,684
050,53,015,"Washington","Cowlitz County",5,7,1483,748,735
050,53,015,"Washington","Cowlitz County",5,8,1470,761,709
050,53,015,"Washington","Cowlitz County",5,9,1436,750,686
050,53,015,"Washington","Cowlitz County",5,10,1409,726,683
050,53,015,"Washington","Cowlitz County",5,11,1393,715,678
050,53,015,"Washington","Cowlitz County",5,12,1454,743,711
050,53,015,"Washington","Cowlitz County",5,13,1438,729,709
050,53,015,"Washington","Cowlitz County",5,14,1456,746,710
050,53,015,"Washington","Cowlitz County",5,15,1525,762,763
050,53,015,"Washington","Cowlitz County",5,16,1539,814,725
050,53,015,"Washington","Cowlitz County",5,17,1479,751,728
050,53,015,"Washington","Cowlitz County",5,18,1230,641,589
050,53,015,"Washington","Cowlitz County",5,19,961,516,445
050,53,015,"Washington","Cowlitz County",5,20,1059,521,538
050,53,015,"Washington","Cowlitz County",5,21,1088,553,535
050,53,015,"Washington","Cowlitz County",5,22,1212,634,578
050,53,015,"Washington","Cowlitz County",5,23,1239,639,600
050,53,015,"Washington","Cowlitz County",5,24,1285,663,622
050,53,015,"Washington","Cowlitz County",5,25,1291,652,639
050,53,015,"Washington","Cowlitz County",5,26,1335,680,655
050,53,015,"Washington","Cowlitz County",5,27,1383,681,702
050,53,015,"Washington","Cowlitz County",5,28,1492,739,753
050,53,015,"Washington","Cowlitz County",5,29,1394,698,696
050,53,015,"Washington","Cowlitz County",5,30,1509,762,747
050,53,015,"Washington","Cowlitz County",5,31,1562,783,779
050,53,015,"Washington","Cowlitz County",5,32,1566,801,765
050,53,015,"Washington","Cowlitz County",5,33,1517,756,761
050,53,015,"Washington","Cowlitz County",5,34,1562,792,770
050,53,015,"Washington","Cowlitz County",5,35,1493,741,752
050,53,015,"Washington","Cowlitz County",5,36,1447,713,734
050,53,015,"Washington","Cowlitz County",5,37,1415,738,677
050,53,015,"Washington","Cowlitz County",5,38,1412,708,704
050,53,015,"Washington","Cowlitz County",5,39,1351,680,671
050,53,015,"Washington","Cowlitz County",5,40,1388,698,690
050,53,015,"Washington","Cowlitz County",5,41,1402,726,676
050,53,015,"Washington","Cowlitz County",5,42,1394,688,706
050,53,015,"Washington","Cowlitz County",5,43,1455,748,707
050,53,015,"Washington","Cowlitz County",5,44,1401,711,690
050,53,015,"Washington","Cowlitz County",5,45,1340,673,667
050,53,015,"Washington","Cowlitz County",5,46,1319,665,654
050,53,015,"Washington","Cowlitz County",5,47,1308,659,649
050,53,015,"Washington","Cowlitz County",5,48,1300,648,652
050,53,015,"Washington","Cowlitz County",5,49,1247,622,625
050,53,015,"Washington","Cowlitz County",5,50,1287,660,627
050,53,015,"Washington","Cowlitz County",5,51,1353,696,657
050,53,015,"Washington","Cowlitz County",5,52,1443,730,713
050,53,015,"Washington","Cowlitz County",5,53,1467,752,715
050,53,015,"Washington","Cowlitz County",5,54,1425,717,708
050,53,015,"Washington","Cowlitz County",5,55,1349,663,686
050,53,015,"Washington","Cowlitz County",5,56,1299,638,661
050,53,015,"Washington","Cowlitz County",5,57,1315,631,684
050,53,015,"Washington","Cowlitz County",5,58,1421,702,719
050,53,015,"Washington","Cowlitz County",5,59,1480,726,754
050,53,015,"Washington","Cowlitz County",5,60,1533,741,792
050,53,015,"Washington","Cowlitz County",5,61,1533,755,778
050,53,015,"Washington","Cowlitz County",5,62,1574,781,793
050,53,015,"Washington","Cowlitz County",5,63,1566,813,753
050,53,015,"Washington","Cowlitz County",5,64,1538,769,769
050,53,015,"Washington","Cowlitz County",5,65,1565,770,795
050,53,015,"Washington","Cowlitz County",5,66,1568,795,773
050,53,015,"Washington","Cowlitz County",5,67,1467,730,737
050,53,015,"Washington","Cowlitz County",5,68,1405,670,735
050,53,015,"Washington","Cowlitz County",5,69,1362,669,693
050,53,015,"Washington","Cowlitz County",5,70,1293,646,647
050,53,015,"Washington","Cowlitz County",5,71,1277,639,638
050,53,015,"Washington","Cowlitz County",5,72,1195,560,635
050,53,015,"Washington","Cowlitz County",5,73,1142,526,616
050,53,015,"Washington","Cowlitz County",5,74,1147,514,633
050,53,015,"Washington","Cowlitz County",5,75,1105,504,601
050,53,015,"Washington","Cowlitz County",5,76,1162,557,605
050,53,015,"Washington","Cowlitz County",5,77,810,380,430
050,53,015,"Washington","Cowlitz County",5,78,781,377,404
050,53,015,"Washington","Cowlitz County",5,79,759,346,413
050,53,015,"Washington","Cowlitz County",5,80,689,307,382
050,53,015,"Washington","Cowlitz County",5,81,604,271,333
050,53,015,"Washington","Cowlitz County",5,82,557,262,295
050,53,015,"Washington","Cowlitz County",5,83,486,223,263
050,53,015,"Washington","Cowlitz County",5,84,402,198,204
050,53,015,"Washington","Cowlitz County",5,85,2006,796,1210
050,53,017,"Washington","Douglas County",1,0,496,258,238
050,53,017,"Washington","Douglas County",1,1,519,277,242
050,53,017,"Washington","Douglas County",1,2,560,278,282
050,53,017,"Washington","Douglas County",1,3,567,285,282
050,53,017,"Washington","Douglas County",1,4,573,287,286
050,53,017,"Washington","Douglas County",1,5,588,302,286
050,53,017,"Washington","Douglas County",1,6,580,314,266
050,53,017,"Washington","Douglas County",1,7,578,288,290
050,53,017,"Washington","Douglas County",1,8,616,305,311
050,53,017,"Washington","Douglas County",1,9,664,341,323
050,53,017,"Washington","Douglas County",1,10,667,354,313
050,53,017,"Washington","Douglas County",1,11,684,343,341
050,53,017,"Washington","Douglas County",1,12,744,396,348
050,53,017,"Washington","Douglas County",1,13,660,348,312
050,53,017,"Washington","Douglas County",1,14,643,323,320
050,53,017,"Washington","Douglas County",1,15,633,321,312
050,53,017,"Washington","Douglas County",1,16,629,309,320
050,53,017,"Washington","Douglas County",1,17,659,344,315
050,53,017,"Washington","Douglas County",1,18,578,323,255
050,53,017,"Washington","Douglas County",1,19,495,287,208
050,53,017,"Washington","Douglas County",1,20,491,264,227
050,53,017,"Washington","Douglas County",1,21,511,278,233
050,53,017,"Washington","Douglas County",1,22,493,264,229
050,53,017,"Washington","Douglas County",1,23,488,284,204
050,53,017,"Washington","Douglas County",1,24,499,274,225
050,53,017,"Washington","Douglas County",1,25,491,250,241
050,53,017,"Washington","Douglas County",1,26,517,272,245
050,53,017,"Washington","Douglas County",1,27,579,310,269
050,53,017,"Washington","Douglas County",1,28,514,290,224
050,53,017,"Washington","Douglas County",1,29,553,304,249
050,53,017,"Washington","Douglas County",1,30,549,294,255
050,53,017,"Washington","Douglas County",1,31,514,274,240
050,53,017,"Washington","Douglas County",1,32,542,299,243
050,53,017,"Washington","Douglas County",1,33,530,290,240
050,53,017,"Washington","Douglas County",1,34,587,314,273
050,53,017,"Washington","Douglas County",1,35,563,297,266
050,53,017,"Washington","Douglas County",1,36,576,306,270
050,53,017,"Washington","Douglas County",1,37,535,288,247
050,53,017,"Washington","Douglas County",1,38,572,308,264
050,53,017,"Washington","Douglas County",1,39,543,292,251
050,53,017,"Washington","Douglas County",1,40,522,264,258
050,53,017,"Washington","Douglas County",1,41,515,289,226
050,53,017,"Washington","Douglas County",1,42,493,249,244
050,53,017,"Washington","Douglas County",1,43,485,254,231
050,53,017,"Washington","Douglas County",1,44,496,254,242
050,53,017,"Washington","Douglas County",1,45,483,255,228
050,53,017,"Washington","Douglas County",1,46,511,269,242
050,53,017,"Washington","Douglas County",1,47,491,249,242
050,53,017,"Washington","Douglas County",1,48,481,236,245
050,53,017,"Washington","Douglas County",1,49,511,263,248
050,53,017,"Washington","Douglas County",1,50,503,286,217
050,53,017,"Washington","Douglas County",1,51,477,248,229
050,53,017,"Washington","Douglas County",1,52,460,245,215
050,53,017,"Washington","Douglas County",1,53,454,231,223
050,53,017,"Washington","Douglas County",1,54,460,223,237
050,53,017,"Washington","Douglas County",1,55,491,242,249
050,53,017,"Washington","Douglas County",1,56,530,269,261
050,53,017,"Washington","Douglas County",1,57,523,275,248
050,53,017,"Washington","Douglas County",1,58,573,298,275
050,53,017,"Washington","Douglas County",1,59,554,265,289
050,53,017,"Washington","Douglas County",1,60,542,290,252
050,53,017,"Washington","Douglas County",1,61,502,255,247
050,53,017,"Washington","Douglas County",1,62,525,258,267
050,53,017,"Washington","Douglas County",1,63,557,276,281
050,53,017,"Washington","Douglas County",1,64,531,270,261
050,53,017,"Washington","Douglas County",1,65,537,267,270
050,53,017,"Washington","Douglas County",1,66,505,259,246
050,53,017,"Washington","Douglas County",1,67,487,229,258
050,53,017,"Washington","Douglas County",1,68,477,233,244
050,53,017,"Washington","Douglas County",1,69,456,209,247
050,53,017,"Washington","Douglas County",1,70,433,197,236
050,53,017,"Washington","Douglas County",1,71,430,210,220
050,53,017,"Washington","Douglas County",1,72,431,202,229
050,53,017,"Washington","Douglas County",1,73,421,215,206
050,53,017,"Washington","Douglas County",1,74,290,127,163
050,53,017,"Washington","Douglas County",1,75,296,126,170
050,53,017,"Washington","Douglas County",1,76,310,142,168
050,53,017,"Washington","Douglas County",1,77,291,157,134
050,53,017,"Washington","Douglas County",1,78,247,139,108
050,53,017,"Washington","Douglas County",1,79,247,117,130
050,53,017,"Washington","Douglas County",1,80,210,109,101
050,53,017,"Washington","Douglas County",1,81,187,105,82
050,53,017,"Washington","Douglas County",1,82,157,84,73
050,53,017,"Washington","Douglas County",1,83,143,62,81
050,53,017,"Washington","Douglas County",1,84,159,72,87
050,53,017,"Washington","Douglas County",1,85,769,289,480
050,53,017,"Washington","Douglas County",2,0,514,272,242
050,53,017,"Washington","Douglas County",2,1,517,274,243
050,53,017,"Washington","Douglas County",2,2,552,279,273
050,53,017,"Washington","Douglas County",2,3,566,284,282
050,53,017,"Washington","Douglas County",2,4,576,288,288
050,53,017,"Washington","Douglas County",2,5,589,301,288
050,53,017,"Washington","Douglas County",2,6,589,311,278
050,53,017,"Washington","Douglas County",2,7,575,291,284
050,53,017,"Washington","Douglas County",2,8,607,302,305
050,53,017,"Washington","Douglas County",2,9,652,333,319
050,53,017,"Washington","Douglas County",2,10,661,346,315
050,53,017,"Washington","Douglas County",2,11,673,343,330
050,53,017,"Washington","Douglas County",2,12,730,386,344
050,53,017,"Washington","Douglas County",2,13,675,357,318
050,53,017,"Washington","Douglas County",2,14,644,326,318
050,53,017,"Washington","Douglas County",2,15,634,320,314
050,53,017,"Washington","Douglas County",2,16,628,312,316
050,53,017,"Washington","Douglas County",2,17,652,338,314
050,53,017,"Washington","Douglas County",2,18,573,316,257
050,53,017,"Washington","Douglas County",2,19,498,285,213
050,53,017,"Washington","Douglas County",2,20,497,271,226
050,53,017,"Washington","Douglas County",2,21,509,277,232
050,53,017,"Washington","Douglas County",2,22,499,268,231
050,53,017,"Washington","Douglas County",2,23,495,284,211
050,53,017,"Washington","Douglas County",2,24,498,277,221
050,53,017,"Washington","Douglas County",2,25,489,252,237
050,53,017,"Washington","Douglas County",2,26,518,271,247
050,53,017,"Washington","Douglas County",2,27,569,307,262
050,53,017,"Washington","Douglas County",2,28,529,292,237
050,53,017,"Washington","Douglas County",2,29,540,298,242
050,53,017,"Washington","Douglas County",2,30,553,299,254
050,53,017,"Washington","Douglas County",2,31,527,278,249
050,53,017,"Washington","Douglas County",2,32,535,295,240
050,53,017,"Washington","Douglas County",2,33,538,293,245
050,53,017,"Washington","Douglas County",2,34,583,315,268
050,53,017,"Washington","Douglas County",2,35,568,299,269
050,53,017,"Washington","Douglas County",2,36,573,307,266
050,53,017,"Washington","Douglas County",2,37,544,290,254
050,53,017,"Washington","Douglas County",2,38,561,301,260
050,53,017,"Washington","Douglas County",2,39,548,294,254
050,53,017,"Washington","Douglas County",2,40,536,275,261
050,53,017,"Washington","Douglas County",2,41,532,296,236
050,53,017,"Washington","Douglas County",2,42,486,246,240
050,53,017,"Washington","Douglas County",2,43,490,253,237
050,53,017,"Washington","Douglas County",2,44,491,255,236
050,53,017,"Washington","Douglas County",2,45,487,255,232
050,53,017,"Washington","Douglas County",2,46,506,269,237
050,53,017,"Washington","Douglas County",2,47,492,252,240
050,53,017,"Washington","Douglas County",2,48,483,241,242
050,53,017,"Washington","Douglas County",2,49,501,256,245
050,53,017,"Washington","Douglas County",2,50,513,287,226
050,53,017,"Washington","Douglas County",2,51,476,251,225
050,53,017,"Washington","Douglas County",2,52,470,250,220
050,53,017,"Washington","Douglas County",2,53,450,229,221
050,53,017,"Washington","Douglas County",2,54,457,224,233
050,53,017,"Washington","Douglas County",2,55,487,240,247
050,53,017,"Washington","Douglas County",2,56,526,264,262
050,53,017,"Washington","Douglas County",2,57,527,273,254
050,53,017,"Washington","Douglas County",2,58,559,290,269
050,53,017,"Washington","Douglas County",2,59,565,278,287
050,53,017,"Washington","Douglas County",2,60,548,286,262
050,53,017,"Washington","Douglas County",2,61,513,263,250
050,53,017,"Washington","Douglas County",2,62,524,259,265
050,53,017,"Washington","Douglas County",2,63,555,274,281
050,53,017,"Washington","Douglas County",2,64,534,270,264
050,53,017,"Washington","Douglas County",2,65,537,269,268
050,53,017,"Washington","Douglas County",2,66,512,260,252
050,53,017,"Washington","Douglas County",2,67,488,234,254
050,53,017,"Washington","Douglas County",2,68,472,229,243
050,53,017,"Washington","Douglas County",2,69,466,218,248
050,53,017,"Washington","Douglas County",2,70,438,201,237
050,53,017,"Washington","Douglas County",2,71,430,207,223
050,53,017,"Washington","Douglas County",2,72,425,202,223
050,53,017,"Washington","Douglas County",2,73,439,217,222
050,53,017,"Washington","Douglas County",2,74,298,136,162
050,53,017,"Washington","Douglas County",2,75,295,127,168
050,53,017,"Washington","Douglas County",2,76,303,137,166
050,53,017,"Washington","Douglas County",2,77,303,157,146
050,53,017,"Washington","Douglas County",2,78,252,140,112
050,53,017,"Washington","Douglas County",2,79,244,120,124
050,53,017,"Washington","Douglas County",2,80,217,111,106
050,53,017,"Washington","Douglas County",2,81,190,105,85
050,53,017,"Washington","Douglas County",2,82,163,88,75
050,53,017,"Washington","Douglas County",2,83,143,64,79
050,53,017,"Washington","Douglas County",2,84,154,67,87
050,53,017,"Washington","Douglas County",2,85,774,291,483
050,53,017,"Washington","Douglas County",3,0,473,231,242
050,53,017,"Washington","Douglas County",3,1,545,292,253
050,53,017,"Washington","Douglas County",3,2,507,266,241
050,53,017,"Washington","Douglas County",3,3,567,283,284
050,53,017,"Washington","Douglas County",3,4,582,297,285
050,53,017,"Washington","Douglas County",3,5,585,294,291
050,53,017,"Washington","Douglas County",3,6,594,299,295
050,53,017,"Washington","Douglas County",3,7,582,311,271
050,53,017,"Washington","Douglas County",3,8,571,300,271
050,53,017,"Washington","Douglas County",3,9,599,300,299
050,53,017,"Washington","Douglas County",3,10,665,337,328
050,53,017,"Washington","Douglas County",3,11,666,369,297
050,53,017,"Washington","Douglas County",3,12,679,348,331
050,53,017,"Washington","Douglas County",3,13,731,384,347
050,53,017,"Washington","Douglas County",3,14,688,365,323
050,53,017,"Washington","Douglas County",3,15,653,325,328
050,53,017,"Washington","Douglas County",3,16,665,339,326
050,53,017,"Washington","Douglas County",3,17,640,328,312
050,53,017,"Washington","Douglas County",3,18,585,311,274
050,53,017,"Washington","Douglas County",3,19,501,276,225
050,53,017,"Washington","Douglas County",3,20,517,283,234
050,53,017,"Washington","Douglas County",3,21,518,280,238
050,53,017,"Washington","Douglas County",3,22,513,269,244
050,53,017,"Washington","Douglas County",3,23,512,280,232
050,53,017,"Washington","Douglas County",3,24,492,289,203
050,53,017,"Washington","Douglas County",3,25,489,272,217
050,53,017,"Washington","Douglas County",3,26,500,250,250
050,53,017,"Washington","Douglas County",3,27,583,324,259
050,53,017,"Washington","Douglas County",3,28,572,300,272
050,53,017,"Washington","Douglas County",3,29,555,298,257
050,53,017,"Washington","Douglas County",3,30,558,297,261
050,53,017,"Washington","Douglas County",3,31,580,295,285
050,53,017,"Washington","Douglas County",3,32,555,304,251
050,53,017,"Washington","Douglas County",3,33,552,298,254
050,53,017,"Washington","Douglas County",3,34,577,318,259
050,53,017,"Washington","Douglas County",3,35,558,290,268
050,53,017,"Washington","Douglas County",3,36,603,319,284
050,53,017,"Washington","Douglas County",3,37,555,294,261
050,53,017,"Washington","Douglas County",3,38,544,286,258
050,53,017,"Washington","Douglas County",3,39,576,320,256
050,53,017,"Washington","Douglas County",3,40,558,306,252
050,53,017,"Washington","Douglas County",3,41,602,338,264
050,53,017,"Washington","Douglas County",3,42,495,257,238
050,53,017,"Washington","Douglas County",3,43,467,233,234
050,53,017,"Washington","Douglas County",3,44,522,274,248
050,53,017,"Washington","Douglas County",3,45,494,254,240
050,53,017,"Washington","Douglas County",3,46,514,282,232
050,53,017,"Washington","Douglas County",3,47,526,285,241
050,53,017,"Washington","Douglas County",3,48,519,260,259
050,53,017,"Washington","Douglas County",3,49,472,233,239
050,53,017,"Washington","Douglas County",3,50,542,284,258
050,53,017,"Washington","Douglas County",3,51,495,268,227
050,53,017,"Washington","Douglas County",3,52,505,282,223
050,53,017,"Washington","Douglas County",3,53,476,233,243
050,53,017,"Washington","Douglas County",3,54,474,239,235
050,53,017,"Washington","Douglas County",3,55,480,235,245
050,53,017,"Washington","Douglas County",3,56,488,245,243
050,53,017,"Washington","Douglas County",3,57,536,268,268
050,53,017,"Washington","Douglas County",3,58,510,263,247
050,53,017,"Washington","Douglas County",3,59,568,294,274
050,53,017,"Washington","Douglas County",3,60,573,278,295
050,53,017,"Washington","Douglas County",3,61,560,286,274
050,53,017,"Washington","Douglas County",3,62,503,262,241
050,53,017,"Washington","Douglas County",3,63,546,273,273
050,53,017,"Washington","Douglas County",3,64,564,285,279
050,53,017,"Washington","Douglas County",3,65,545,270,275
050,53,017,"Washington","Douglas County",3,66,531,268,263
050,53,017,"Washington","Douglas County",3,67,510,256,254
050,53,017,"Washington","Douglas County",3,68,483,232,251
050,53,017,"Washington","Douglas County",3,69,468,229,239
050,53,017,"Washington","Douglas County",3,70,468,215,253
050,53,017,"Washington","Douglas County",3,71,434,197,237
050,53,017,"Washington","Douglas County",3,72,431,207,224
050,53,017,"Washington","Douglas County",3,73,416,198,218
050,53,017,"Washington","Douglas County",3,74,430,216,214
050,53,017,"Washington","Douglas County",3,75,304,137,167
050,53,017,"Washington","Douglas County",3,76,284,123,161
050,53,017,"Washington","Douglas County",3,77,293,133,160
050,53,017,"Washington","Douglas County",3,78,293,154,139
050,53,017,"Washington","Douglas County",3,79,246,135,111
050,53,017,"Washington","Douglas County",3,80,236,117,119
050,53,017,"Washington","Douglas County",3,81,201,102,99
050,53,017,"Washington","Douglas County",3,82,183,98,85
050,53,017,"Washington","Douglas County",3,83,157,87,70
050,53,017,"Washington","Douglas County",3,84,138,63,75
050,53,017,"Washington","Douglas County",3,85,810,309,501
050,53,017,"Washington","Douglas County",4,0,522,268,254
050,53,017,"Washington","Douglas County",4,1,482,244,238
050,53,017,"Washington","Douglas County",4,2,562,299,263
050,53,017,"Washington","Douglas County",4,3,505,269,236
050,53,017,"Washington","Douglas County",4,4,546,283,263
050,53,017,"Washington","Douglas County",4,5,586,301,285
050,53,017,"Washington","Douglas County",4,6,583,297,286
050,53,017,"Washington","Douglas County",4,7,563,284,279
050,53,017,"Washington","Douglas County",4,8,588,323,265
050,53,017,"Washington","Douglas County",4,9,564,297,267
050,53,017,"Washington","Douglas County",4,10,597,293,304
050,53,017,"Washington","Douglas County",4,11,652,322,330
050,53,017,"Washington","Douglas County",4,12,648,356,292
050,53,017,"Washington","Douglas County",4,13,673,344,329
050,53,017,"Washington","Douglas County",4,14,703,364,339
050,53,017,"Washington","Douglas County",4,15,665,345,320
050,53,017,"Washington","Douglas County",4,16,645,331,314
050,53,017,"Washington","Douglas County",4,17,671,345,326
050,53,017,"Washington","Douglas County",4,18,571,299,272
050,53,017,"Washington","Douglas County",4,19,499,267,232
050,53,017,"Washington","Douglas County",4,20,499,280,219
050,53,017,"Washington","Douglas County",4,21,524,293,231
050,53,017,"Washington","Douglas County",4,22,521,264,257
050,53,017,"Washington","Douglas County",4,23,546,295,251
050,53,017,"Washington","Douglas County",4,24,562,324,238
050,53,017,"Washington","Douglas County",4,25,496,285,211
050,53,017,"Washington","Douglas County",4,26,520,297,223
050,53,017,"Washington","Douglas County",4,27,565,295,270
050,53,017,"Washington","Douglas County",4,28,568,315,253
050,53,017,"Washington","Douglas County",4,29,608,318,290
050,53,017,"Washington","Douglas County",4,30,562,307,255
050,53,017,"Washington","Douglas County",4,31,587,308,279
050,53,017,"Washington","Douglas County",4,32,593,315,278
050,53,017,"Washington","Douglas County",4,33,592,330,262
050,53,017,"Washington","Douglas County",4,34,565,317,248
050,53,017,"Washington","Douglas County",4,35,572,305,267
050,53,017,"Washington","Douglas County",4,36,554,298,256
050,53,017,"Washington","Douglas County",4,37,590,311,279
050,53,017,"Washington","Douglas County",4,38,549,281,268
050,53,017,"Washington","Douglas County",4,39,550,290,260
050,53,017,"Washington","Douglas County",4,40,554,308,246
050,53,017,"Washington","Douglas County",4,41,621,373,248
050,53,017,"Washington","Douglas County",4,42,545,287,258
050,53,017,"Washington","Douglas County",4,43,485,248,237
050,53,017,"Washington","Douglas County",4,44,474,240,234
050,53,017,"Washington","Douglas County",4,45,490,245,245
050,53,017,"Washington","Douglas County",4,46,503,256,247
050,53,017,"Washington","Douglas County",4,47,514,281,233
050,53,017,"Washington","Douglas County",4,48,537,286,251
050,53,017,"Washington","Douglas County",4,49,500,243,257
050,53,017,"Washington","Douglas County",4,50,519,270,249
050,53,017,"Washington","Douglas County",4,51,504,259,245
050,53,017,"Washington","Douglas County",4,52,517,286,231
050,53,017,"Washington","Douglas County",4,53,505,278,227
050,53,017,"Washington","Douglas County",4,54,486,244,242
050,53,017,"Washington","Douglas County",4,55,475,238,237
050,53,017,"Washington","Douglas County",4,56,494,241,253
050,53,017,"Washington","Douglas County",4,57,494,248,246
050,53,017,"Washington","Douglas County",4,58,526,245,281
050,53,017,"Washington","Douglas County",4,59,513,258,255
050,53,017,"Washington","Douglas County",4,60,583,302,281
050,53,017,"Washington","Douglas County",4,61,585,296,289
050,53,017,"Washington","Douglas County",4,62,565,287,278
050,53,017,"Washington","Douglas County",4,63,511,269,242
050,53,017,"Washington","Douglas County",4,64,566,279,287
050,53,017,"Washington","Douglas County",4,65,576,280,296
050,53,017,"Washington","Douglas County",4,66,541,274,267
050,53,017,"Washington","Douglas County",4,67,533,270,263
050,53,017,"Washington","Douglas County",4,68,509,251,258
050,53,017,"Washington","Douglas County",4,69,486,239,247
050,53,017,"Washington","Douglas County",4,70,472,227,245
050,53,017,"Washington","Douglas County",4,71,460,217,243
050,53,017,"Washington","Douglas County",4,72,439,201,238
050,53,017,"Washington","Douglas County",4,73,424,200,224
050,53,017,"Washington","Douglas County",4,74,408,194,214
050,53,017,"Washington","Douglas County",4,75,426,208,218
050,53,017,"Washington","Douglas County",4,76,304,139,165
050,53,017,"Washington","Douglas County",4,77,270,111,159
050,53,017,"Washington","Douglas County",4,78,279,130,149
050,53,017,"Washington","Douglas County",4,79,276,141,135
050,53,017,"Washington","Douglas County",4,80,239,134,105
050,53,017,"Washington","Douglas County",4,81,231,111,120
050,53,017,"Washington","Douglas County",4,82,185,95,90
050,53,017,"Washington","Douglas County",4,83,178,97,81
050,53,017,"Washington","Douglas County",4,84,152,76,76
050,53,017,"Washington","Douglas County",4,85,821,316,505
050,53,017,"Washington","Douglas County",5,0,512,262,250
050,53,017,"Washington","Douglas County",5,1,526,269,257
050,53,017,"Washington","Douglas County",5,2,493,249,244
050,53,017,"Washington","Douglas County",5,3,561,321,240
050,53,017,"Washington","Douglas County",5,4,513,269,244
050,53,017,"Washington","Douglas County",5,5,553,282,271
050,53,017,"Washington","Douglas County",5,6,563,292,271
050,53,017,"Washington","Douglas County",5,7,567,288,279
050,53,017,"Washington","Douglas County",5,8,571,294,277
050,53,017,"Washington","Douglas County",5,9,611,338,273
050,53,017,"Washington","Douglas County",5,10,560,299,261
050,53,017,"Washington","Douglas County",5,11,603,300,303
050,53,017,"Washington","Douglas County",5,12,651,318,333
050,53,017,"Washington","Douglas County",5,13,664,375,289
050,53,017,"Washington","Douglas County",5,14,676,349,327
050,53,017,"Washington","Douglas County",5,15,727,384,343
050,53,017,"Washington","Douglas County",5,16,685,354,331
050,53,017,"Washington","Douglas County",5,17,672,344,328
050,53,017,"Washington","Douglas County",5,18,586,309,277
050,53,017,"Washington","Douglas County",5,19,515,273,242
050,53,017,"Washington","Douglas County",5,20,507,265,242
050,53,017,"Washington","Douglas County",5,21,530,299,231
050,53,017,"Washington","Douglas County",5,22,518,288,230
050,53,017,"Washington","Douglas County",5,23,585,320,265
050,53,017,"Washington","Douglas County",5,24,571,311,260
050,53,017,"Washington","Douglas County",5,25,542,300,242
050,53,017,"Washington","Douglas County",5,26,470,274,196
050,53,017,"Washington","Douglas County",5,27,564,322,242
050,53,017,"Washington","Douglas County",5,28,595,296,299
050,53,017,"Washington","Douglas County",5,29,591,325,266
050,53,017,"Washington","Douglas County",5,30,605,306,299
050,53,017,"Washington","Douglas County",5,31,584,307,277
050,53,017,"Washington","Douglas County",5,32,599,329,270
050,53,017,"Washington","Douglas County",5,33,639,353,286
050,53,017,"Washington","Douglas County",5,34,629,361,268
050,53,017,"Washington","Douglas County",5,35,552,300,252
050,53,017,"Washington","Douglas County",5,36,578,303,275
050,53,017,"Washington","Douglas County",5,37,558,295,263
050,53,017,"Washington","Douglas County",5,38,601,312,289
050,53,017,"Washington","Douglas County",5,39,564,300,264
050,53,017,"Washington","Douglas County",5,40,549,279,270
050,53,017,"Washington","Douglas County",5,41,616,360,256
050,53,017,"Washington","Douglas County",5,42,558,305,253
050,53,017,"Washington","Douglas County",5,43,555,301,254
050,53,017,"Washington","Douglas County",5,44,503,255,248
050,53,017,"Washington","Douglas County",5,45,459,234,225
050,53,017,"Washington","Douglas County",5,46,500,252,248
050,53,017,"Washington","Douglas County",5,47,523,271,252
050,53,017,"Washington","Douglas County",5,48,530,284,246
050,53,017,"Washington","Douglas County",5,49,522,278,244
050,53,017,"Washington","Douglas County",5,50,530,270,260
050,53,017,"Washington","Douglas County",5,51,495,242,253
050,53,017,"Washington","Douglas County",5,52,525,273,252
050,53,017,"Washington","Douglas County",5,53,508,275,233
050,53,017,"Washington","Douglas County",5,54,502,278,224
050,53,017,"Washington","Douglas County",5,55,499,259,240
050,53,017,"Washington","Douglas County",5,56,483,240,243
050,53,017,"Washington","Douglas County",5,57,496,247,249
050,53,017,"Washington","Douglas County",5,58,487,237,250
050,53,017,"Washington","Douglas County",5,59,525,245,280
050,53,017,"Washington","Douglas County",5,60,518,261,257
050,53,017,"Washington","Douglas County",5,61,564,288,276
050,53,017,"Washington","Douglas County",5,62,595,294,301
050,53,017,"Washington","Douglas County",5,63,564,290,274
050,53,017,"Washington","Douglas County",5,64,506,266,240
050,53,017,"Washington","Douglas County",5,65,572,282,290
050,53,017,"Washington","Douglas County",5,66,562,277,285
050,53,017,"Washington","Douglas County",5,67,539,271,268
050,53,017,"Washington","Douglas County",5,68,529,264,265
050,53,017,"Washington","Douglas County",5,69,505,251,254
050,53,017,"Washington","Douglas County",5,70,488,238,250
050,53,017,"Washington","Douglas County",5,71,471,222,249
050,53,017,"Washington","Douglas County",5,72,445,216,229
050,53,017,"Washington","Douglas County",5,73,430,195,235
050,53,017,"Washington","Douglas County",5,74,406,195,211
050,53,017,"Washington","Douglas County",5,75,407,193,214
050,53,017,"Washington","Douglas County",5,76,423,209,214
050,53,017,"Washington","Douglas County",5,77,292,132,160
050,53,017,"Washington","Douglas County",5,78,269,109,160
050,53,017,"Washington","Douglas County",5,79,268,118,150
050,53,017,"Washington","Douglas County",5,80,266,136,130
050,53,017,"Washington","Douglas County",5,81,228,130,98
050,53,017,"Washington","Douglas County",5,82,209,101,108
050,53,017,"Washington","Douglas County",5,83,175,88,87
050,53,017,"Washington","Douglas County",5,84,178,91,87
050,53,017,"Washington","Douglas County",5,85,833,338,495
050,53,019,"Washington","Ferry County",1,0,58,29,29
050,53,019,"Washington","Ferry County",1,1,58,31,27
050,53,019,"Washington","Ferry County",1,2,58,35,23
050,53,019,"Washington","Ferry County",1,3,61,32,29
050,53,019,"Washington","Ferry County",1,4,63,34,29
050,53,019,"Washington","Ferry County",1,5,70,38,32
050,53,019,"Washington","Ferry County",1,6,70,35,35
050,53,019,"Washington","Ferry County",1,7,70,31,39
050,53,019,"Washington","Ferry County",1,8,74,37,37
050,53,019,"Washington","Ferry County",1,9,61,31,30
050,53,019,"Washington","Ferry County",1,10,72,35,37
050,53,019,"Washington","Ferry County",1,11,59,30,29
050,53,019,"Washington","Ferry County",1,12,57,27,30
050,53,019,"Washington","Ferry County",1,13,78,41,37
050,53,019,"Washington","Ferry County",1,14,68,36,32
050,53,019,"Washington","Ferry County",1,15,57,34,23
050,53,019,"Washington","Ferry County",1,16,71,43,28
050,53,019,"Washington","Ferry County",1,17,70,39,31
050,53,019,"Washington","Ferry County",1,18,72,43,29
050,53,019,"Washington","Ferry County",1,19,58,38,20
050,53,019,"Washington","Ferry County",1,20,63,37,26
050,53,019,"Washington","Ferry County",1,21,61,35,26
050,53,019,"Washington","Ferry County",1,22,58,29,29
050,53,019,"Washington","Ferry County",1,23,53,26,27
050,53,019,"Washington","Ferry County",1,24,51,31,20
050,53,019,"Washington","Ferry County",1,25,50,25,25
050,53,019,"Washington","Ferry County",1,26,47,21,26
050,53,019,"Washington","Ferry County",1,27,62,29,33
050,53,019,"Washington","Ferry County",1,28,65,32,33
050,53,019,"Washington","Ferry County",1,29,60,33,27
050,53,019,"Washington","Ferry County",1,30,65,36,29
050,53,019,"Washington","Ferry County",1,31,61,33,28
050,53,019,"Washington","Ferry County",1,32,54,21,33
050,53,019,"Washington","Ferry County",1,33,63,28,35
050,53,019,"Washington","Ferry County",1,34,63,35,28
050,53,019,"Washington","Ferry County",1,35,70,34,36
050,53,019,"Washington","Ferry County",1,36,78,41,37
050,53,019,"Washington","Ferry County",1,37,62,35,27
050,53,019,"Washington","Ferry County",1,38,56,29,27
050,53,019,"Washington","Ferry County",1,39,70,24,46
050,53,019,"Washington","Ferry County",1,40,73,38,35
050,53,019,"Washington","Ferry County",1,41,82,42,40
050,53,019,"Washington","Ferry County",1,42,83,38,45
050,53,019,"Washington","Ferry County",1,43,78,39,39
050,53,019,"Washington","Ferry County",1,44,86,51,35
050,53,019,"Washington","Ferry County",1,45,85,46,39
050,53,019,"Washington","Ferry County",1,46,71,45,26
050,53,019,"Washington","Ferry County",1,47,82,47,35
050,53,019,"Washington","Ferry County",1,48,86,37,49
050,53,019,"Washington","Ferry County",1,49,76,37,39
050,53,019,"Washington","Ferry County",1,50,101,49,52
050,53,019,"Washington","Ferry County",1,51,94,38,56
050,53,019,"Washington","Ferry County",1,52,84,35,49
050,53,019,"Washington","Ferry County",1,53,88,42,46
050,53,019,"Washington","Ferry County",1,54,86,35,51
050,53,019,"Washington","Ferry County",1,55,95,46,49
050,53,019,"Washington","Ferry County",1,56,115,55,60
050,53,019,"Washington","Ferry County",1,57,125,65,60
050,53,019,"Washington","Ferry County",1,58,135,58,77
050,53,019,"Washington","Ferry County",1,59,116,59,57
050,53,019,"Washington","Ferry County",1,60,123,65,58
050,53,019,"Washington","Ferry County",1,61,136,71,65
050,53,019,"Washington","Ferry County",1,62,138,67,71
050,53,019,"Washington","Ferry County",1,63,130,61,69
050,53,019,"Washington","Ferry County",1,64,162,77,85
050,53,019,"Washington","Ferry County",1,65,146,77,69
050,53,019,"Washington","Ferry County",1,66,145,76,69
050,53,019,"Washington","Ferry County",1,67,161,80,81
050,53,019,"Washington","Ferry County",1,68,189,95,94
050,53,019,"Washington","Ferry County",1,69,159,84,75
050,53,019,"Washington","Ferry County",1,70,143,76,67
050,53,019,"Washington","Ferry County",1,71,149,86,63
050,53,019,"Washington","Ferry County",1,72,130,73,57
050,53,019,"Washington","Ferry County",1,73,114,64,50
050,53,019,"Washington","Ferry County",1,74,76,41,35
050,53,019,"Washington","Ferry County",1,75,75,38,37
050,53,019,"Washington","Ferry County",1,76,80,38,42
050,53,019,"Washington","Ferry County",1,77,77,42,35
050,53,019,"Washington","Ferry County",1,78,74,43,31
050,53,019,"Washington","Ferry County",1,79,56,28,28
050,53,019,"Washington","Ferry County",1,80,57,35,22
050,53,019,"Washington","Ferry County",1,81,48,23,25
050,53,019,"Washington","Ferry County",1,82,40,19,21
050,53,019,"Washington","Ferry County",1,83,37,20,17
050,53,019,"Washington","Ferry County",1,84,28,11,17
050,53,019,"Washington","Ferry County",1,85,149,58,91
050,53,019,"Washington","Ferry County",2,0,59,30,29
050,53,019,"Washington","Ferry County",2,1,59,31,28
050,53,019,"Washington","Ferry County",2,2,58,33,25
050,53,019,"Washington","Ferry County",2,3,62,33,29
050,53,019,"Washington","Ferry County",2,4,63,34,29
050,53,019,"Washington","Ferry County",2,5,68,37,31
050,53,019,"Washington","Ferry County",2,6,70,37,33
050,53,019,"Washington","Ferry County",2,7,71,32,39
050,53,019,"Washington","Ferry County",2,8,73,35,38
050,53,019,"Washington","Ferry County",2,9,62,31,31
050,53,019,"Washington","Ferry County",2,10,70,35,35
050,53,019,"Washington","Ferry County",2,11,60,30,30
050,53,019,"Washington","Ferry County",2,12,60,29,31
050,53,019,"Washington","Ferry County",2,13,72,37,35
050,53,019,"Washington","Ferry County",2,14,70,37,33
050,53,019,"Washington","Ferry County",2,15,59,34,25
050,53,019,"Washington","Ferry County",2,16,68,41,27
050,53,019,"Washington","Ferry County",2,17,71,41,30
050,53,019,"Washington","Ferry County",2,18,70,42,28
050,53,019,"Washington","Ferry County",2,19,58,37,21
050,53,019,"Washington","Ferry County",2,20,63,37,26
050,53,019,"Washington","Ferry County",2,21,60,34,26
050,53,019,"Washington","Ferry County",2,22,60,31,29
050,53,019,"Washington","Ferry County",2,23,53,27,26
050,53,019,"Washington","Ferry County",2,24,51,30,21
050,53,019,"Washington","Ferry County",2,25,50,26,24
050,53,019,"Washington","Ferry County",2,26,49,23,26
050,53,019,"Washington","Ferry County",2,27,58,27,31
050,53,019,"Washington","Ferry County",2,28,64,32,32
050,53,019,"Washington","Ferry County",2,29,61,33,28
050,53,019,"Washington","Ferry County",2,30,65,36,29
050,53,019,"Washington","Ferry County",2,31,64,34,30
050,53,019,"Washington","Ferry County",2,32,56,23,33
050,53,019,"Washington","Ferry County",2,33,62,28,34
050,53,019,"Washington","Ferry County",2,34,65,35,30
050,53,019,"Washington","Ferry County",2,35,69,34,35
050,53,019,"Washington","Ferry County",2,36,75,38,37
050,53,019,"Washington","Ferry County",2,37,64,35,29
050,53,019,"Washington","Ferry County",2,38,60,32,28
050,53,019,"Washington","Ferry County",2,39,66,25,41
050,53,019,"Washington","Ferry County",2,40,73,35,38
050,53,019,"Washington","Ferry County",2,41,79,39,40
050,53,019,"Washington","Ferry County",2,42,83,38,45
050,53,019,"Washington","Ferry County",2,43,81,40,41
050,53,019,"Washington","Ferry County",2,44,84,48,36
050,53,019,"Washington","Ferry County",2,45,88,49,39
050,53,019,"Washington","Ferry County",2,46,73,45,28
050,53,019,"Washington","Ferry County",2,47,79,46,33
050,53,019,"Washington","Ferry County",2,48,83,38,45
050,53,019,"Washington","Ferry County",2,49,79,36,43
050,53,019,"Washington","Ferry County",2,50,96,46,50
050,53,019,"Washington","Ferry County",2,51,97,42,55
050,53,019,"Washington","Ferry County",2,52,86,35,51
050,53,019,"Washington","Ferry County",2,53,87,39,48
050,53,019,"Washington","Ferry County",2,54,88,38,50
050,53,019,"Washington","Ferry County",2,55,94,45,49
050,53,019,"Washington","Ferry County",2,56,111,53,58
050,53,019,"Washington","Ferry County",2,57,123,62,61
050,53,019,"Washington","Ferry County",2,58,135,61,74
050,53,019,"Washington","Ferry County",2,59,122,59,63
050,53,019,"Washington","Ferry County",2,60,123,64,59
050,53,019,"Washington","Ferry County",2,61,132,70,62
050,53,019,"Washington","Ferry County",2,62,136,68,68
050,53,019,"Washington","Ferry County",2,63,136,64,72
050,53,019,"Washington","Ferry County",2,64,154,72,82
050,53,019,"Washington","Ferry County",2,65,152,79,73
050,53,019,"Washington","Ferry County",2,66,148,78,70
050,53,019,"Washington","Ferry County",2,67,157,79,78
050,53,019,"Washington","Ferry County",2,68,182,92,90
050,53,019,"Washington","Ferry County",2,69,164,86,78
050,53,019,"Washington","Ferry County",2,70,146,78,68
050,53,019,"Washington","Ferry County",2,71,147,83,64
050,53,019,"Washington","Ferry County",2,72,132,75,57
050,53,019,"Washington","Ferry County",2,73,124,70,54
050,53,019,"Washington","Ferry County",2,74,80,43,37
050,53,019,"Washington","Ferry County",2,75,74,38,36
050,53,019,"Washington","Ferry County",2,76,77,37,40
050,53,019,"Washington","Ferry County",2,77,79,42,37
050,53,019,"Washington","Ferry County",2,78,72,41,31
050,53,019,"Washington","Ferry County",2,79,59,31,28
050,53,019,"Washington","Ferry County",2,80,56,32,24
050,53,019,"Washington","Ferry County",2,81,50,26,24
050,53,019,"Washington","Ferry County",2,82,44,21,23
050,53,019,"Washington","Ferry County",2,83,36,18,18
050,53,019,"Washington","Ferry County",2,84,30,13,17
050,53,019,"Washington","Ferry County",2,85,149,58,91
050,53,019,"Washington","Ferry County",3,0,64,37,27
050,53,019,"Washington","Ferry County",3,1,57,30,27
050,53,019,"Washington","Ferry County",3,2,50,30,20
050,53,019,"Washington","Ferry County",3,3,59,32,27
050,53,019,"Washington","Ferry County",3,4,61,37,24
050,53,019,"Washington","Ferry County",3,5,64,31,33
050,53,019,"Washington","Ferry County",3,6,66,34,32
050,53,019,"Washington","Ferry County",3,7,73,35,38
050,53,019,"Washington","Ferry County",3,8,73,40,33
050,53,019,"Washington","Ferry County",3,9,80,40,40
050,53,019,"Washington","Ferry County",3,10,56,28,28
050,53,019,"Washington","Ferry County",3,11,75,40,35
050,53,019,"Washington","Ferry County",3,12,66,33,33
050,53,019,"Washington","Ferry County",3,13,63,33,30
050,53,019,"Washington","Ferry County",3,14,78,40,38
050,53,019,"Washington","Ferry County",3,15,68,35,33
050,53,019,"Washington","Ferry County",3,16,68,41,27
050,53,019,"Washington","Ferry County",3,17,69,43,26
050,53,019,"Washington","Ferry County",3,18,66,42,24
050,53,019,"Washington","Ferry County",3,19,58,34,24
050,53,019,"Washington","Ferry County",3,20,61,41,20
050,53,019,"Washington","Ferry County",3,21,63,37,26
050,53,019,"Washington","Ferry County",3,22,53,29,24
050,53,019,"Washington","Ferry County",3,23,58,32,26
050,53,019,"Washington","Ferry County",3,24,50,20,30
050,53,019,"Washington","Ferry County",3,25,45,28,17
050,53,019,"Washington","Ferry County",3,26,56,28,28
050,53,019,"Washington","Ferry County",3,27,48,22,26
050,53,019,"Washington","Ferry County",3,28,59,26,33
050,53,019,"Washington","Ferry County",3,29,67,35,32
050,53,019,"Washington","Ferry County",3,30,65,33,32
050,53,019,"Washington","Ferry County",3,31,65,36,29
050,53,019,"Washington","Ferry County",3,32,71,34,37
050,53,019,"Washington","Ferry County",3,33,57,23,34
050,53,019,"Washington","Ferry County",3,34,61,26,35
050,53,019,"Washington","Ferry County",3,35,77,40,37
050,53,019,"Washington","Ferry County",3,36,73,38,35
050,53,019,"Washington","Ferry County",3,37,75,36,39
050,53,019,"Washington","Ferry County",3,38,69,38,31
050,53,019,"Washington","Ferry County",3,39,62,31,31
050,53,019,"Washington","Ferry County",3,40,71,31,40
050,53,019,"Washington","Ferry County",3,41,70,34,36
050,53,019,"Washington","Ferry County",3,42,93,46,47
050,53,019,"Washington","Ferry County",3,43,82,40,42
050,53,019,"Washington","Ferry County",3,44,87,40,47
050,53,019,"Washington","Ferry County",3,45,90,48,42
050,53,019,"Washington","Ferry County",3,46,88,50,38
050,53,019,"Washington","Ferry County",3,47,79,46,33
050,53,019,"Washington","Ferry County",3,48,81,45,36
050,53,019,"Washington","Ferry County",3,49,89,43,46
050,53,019,"Washington","Ferry County",3,50,84,35,49
050,53,019,"Washington","Ferry County",3,51,101,48,53
050,53,019,"Washington","Ferry County",3,52,99,42,57
050,53,019,"Washington","Ferry County",3,53,88,37,51
050,53,019,"Washington","Ferry County",3,54,86,44,42
050,53,019,"Washington","Ferry County",3,55,89,42,47
050,53,019,"Washington","Ferry County",3,56,94,45,49
050,53,019,"Washington","Ferry County",3,57,116,52,64
050,53,019,"Washington","Ferry County",3,58,127,63,64
050,53,019,"Washington","Ferry County",3,59,127,59,68
050,53,019,"Washington","Ferry County",3,60,126,58,68
050,53,019,"Washington","Ferry County",3,61,115,63,52
050,53,019,"Washington","Ferry County",3,62,132,73,59
050,53,019,"Washington","Ferry County",3,63,143,71,72
050,53,019,"Washington","Ferry County",3,64,144,68,76
050,53,019,"Washington","Ferry County",3,65,157,73,84
050,53,019,"Washington","Ferry County",3,66,149,73,76
050,53,019,"Washington","Ferry County",3,67,153,79,74
050,53,019,"Washington","Ferry County",3,68,153,77,76
050,53,019,"Washington","Ferry County",3,69,182,91,91
050,53,019,"Washington","Ferry County",3,70,163,83,80
050,53,019,"Washington","Ferry County",3,71,144,75,69
050,53,019,"Washington","Ferry County",3,72,147,83,64
050,53,019,"Washington","Ferry County",3,73,128,70,58
050,53,019,"Washington","Ferry County",3,74,120,68,52
050,53,019,"Washington","Ferry County",3,75,76,41,35
050,53,019,"Washington","Ferry County",3,76,76,37,39
050,53,019,"Washington","Ferry County",3,77,72,35,37
050,53,019,"Washington","Ferry County",3,78,76,40,36
050,53,019,"Washington","Ferry County",3,79,71,40,31
050,53,019,"Washington","Ferry County",3,80,52,28,24
050,53,019,"Washington","Ferry County",3,81,45,26,19
050,53,019,"Washington","Ferry County",3,82,49,25,24
050,53,019,"Washington","Ferry County",3,83,40,18,22
050,53,019,"Washington","Ferry County",3,84,33,17,16
050,53,019,"Washington","Ferry County",3,85,154,62,92
050,53,019,"Washington","Ferry County",4,0,68,38,30
050,53,019,"Washington","Ferry County",4,1,57,34,23
050,53,019,"Washington","Ferry County",4,2,64,34,30
050,53,019,"Washington","Ferry County",4,3,57,31,26
050,53,019,"Washington","Ferry County",4,4,64,31,33
050,53,019,"Washington","Ferry County",4,5,65,37,28
050,53,019,"Washington","Ferry County",4,6,70,35,35
050,53,019,"Washington","Ferry County",4,7,68,37,31
050,53,019,"Washington","Ferry County",4,8,84,40,44
050,53,019,"Washington","Ferry County",4,9,82,41,41
050,53,019,"Washington","Ferry County",4,10,81,40,41
050,53,019,"Washington","Ferry County",4,11,60,30,30
050,53,019,"Washington","Ferry County",4,12,77,42,35
050,53,019,"Washington","Ferry County",4,13,63,33,30
050,53,019,"Washington","Ferry County",4,14,72,35,37
050,53,019,"Washington","Ferry County",4,15,83,43,40
050,53,019,"Washington","Ferry County",4,16,75,37,38
050,53,019,"Washington","Ferry County",4,17,69,44,25
050,53,019,"Washington","Ferry County",4,18,68,46,22
050,53,019,"Washington","Ferry County",4,19,55,36,19
050,53,019,"Washington","Ferry County",4,20,56,31,25
050,53,019,"Washington","Ferry County",4,21,65,35,30
050,53,019,"Washington","Ferry County",4,22,56,32,24
050,53,019,"Washington","Ferry County",4,23,51,28,23
050,53,019,"Washington","Ferry County",4,24,61,34,27
050,53,019,"Washington","Ferry County",4,25,51,22,29
050,53,019,"Washington","Ferry County",4,26,55,29,26
050,53,019,"Washington","Ferry County",4,27,57,28,29
050,53,019,"Washington","Ferry County",4,28,53,28,25
050,53,019,"Washington","Ferry County",4,29,63,30,33
050,53,019,"Washington","Ferry County",4,30,66,32,34
050,53,019,"Washington","Ferry County",4,31,61,30,31
050,53,019,"Washington","Ferry County",4,32,80,44,36
050,53,019,"Washington","Ferry County",4,33,68,30,38
050,53,019,"Washington","Ferry County",4,34,63,26,37
050,53,019,"Washington","Ferry County",4,35,68,30,38
050,53,019,"Washington","Ferry County",4,36,87,45,42
050,53,019,"Washington","Ferry County",4,37,77,40,37
050,53,019,"Washington","Ferry County",4,38,82,39,43
050,53,019,"Washington","Ferry County",4,39,82,48,34
050,53,019,"Washington","Ferry County",4,40,70,34,36
050,53,019,"Washington","Ferry County",4,41,71,31,40
050,53,019,"Washington","Ferry County",4,42,79,41,38
050,53,019,"Washington","Ferry County",4,43,95,48,47
050,53,019,"Washington","Ferry County",4,44,91,46,45
050,53,019,"Washington","Ferry County",4,45,89,42,47
050,53,019,"Washington","Ferry County",4,46,93,50,43
050,53,019,"Washington","Ferry County",4,47,91,50,41
050,53,019,"Washington","Ferry County",4,48,85,46,39
050,53,019,"Washington","Ferry County",4,49,84,47,37
050,53,019,"Washington","Ferry County",4,50,97,50,47
050,53,019,"Washington","Ferry County",4,51,90,40,50
050,53,019,"Washington","Ferry County",4,52,102,48,54
050,53,019,"Washington","Ferry County",4,53,102,44,58
050,53,019,"Washington","Ferry County",4,54,94,41,53
050,53,019,"Washington","Ferry County",4,55,93,46,47
050,53,019,"Washington","Ferry County",4,56,87,39,48
050,53,019,"Washington","Ferry County",4,57,103,49,54
050,53,019,"Washington","Ferry County",4,58,116,54,62
050,53,019,"Washington","Ferry County",4,59,127,60,67
050,53,019,"Washington","Ferry County",4,60,129,55,74
050,53,019,"Washington","Ferry County",4,61,133,63,70
050,53,019,"Washington","Ferry County",4,62,118,65,53
050,53,019,"Washington","Ferry County",4,63,141,82,59
050,53,019,"Washington","Ferry County",4,64,144,68,76
050,53,019,"Washington","Ferry County",4,65,150,71,79
050,53,019,"Washington","Ferry County",4,66,147,71,76
050,53,019,"Washington","Ferry County",4,67,153,74,79
050,53,019,"Washington","Ferry County",4,68,155,77,78
050,53,019,"Washington","Ferry County",4,69,144,73,71
050,53,019,"Washington","Ferry County",4,70,172,83,89
050,53,019,"Washington","Ferry County",4,71,155,80,75
050,53,019,"Washington","Ferry County",4,72,135,71,64
050,53,019,"Washington","Ferry County",4,73,141,81,60
050,53,019,"Washington","Ferry County",4,74,124,68,56
050,53,019,"Washington","Ferry County",4,75,116,69,47
050,53,019,"Washington","Ferry County",4,76,71,38,33
050,53,019,"Washington","Ferry County",4,77,74,36,38
050,53,019,"Washington","Ferry County",4,78,67,32,35
050,53,019,"Washington","Ferry County",4,79,76,38,38
050,53,019,"Washington","Ferry County",4,80,59,32,27
050,53,019,"Washington","Ferry County",4,81,51,27,24
050,53,019,"Washington","Ferry County",4,82,42,23,19
050,53,019,"Washington","Ferry County",4,83,45,22,23
050,53,019,"Washington","Ferry County",4,84,32,13,19
050,53,019,"Washington","Ferry County",4,85,151,55,96
050,53,019,"Washington","Ferry County",5,0,63,35,28
050,53,019,"Washington","Ferry County",5,1,63,35,28
050,53,019,"Washington","Ferry County",5,2,63,40,23
050,53,019,"Washington","Ferry County",5,3,68,37,31
050,53,019,"Washington","Ferry County",5,4,54,28,26
050,53,019,"Washington","Ferry County",5,5,66,33,33
050,53,019,"Washington","Ferry County",5,6,77,42,35
050,53,019,"Washington","Ferry County",5,7,69,37,32
050,53,019,"Washington","Ferry County",5,8,70,36,34
050,53,019,"Washington","Ferry County",5,9,85,39,46
050,53,019,"Washington","Ferry County",5,10,76,38,38
050,53,019,"Washington","Ferry County",5,11,81,40,41
050,53,019,"Washington","Ferry County",5,12,58,28,30
050,53,019,"Washington","Ferry County",5,13,76,43,33
050,53,019,"Washington","Ferry County",5,14,68,36,32
050,53,019,"Washington","Ferry County",5,15,73,35,38
050,53,019,"Washington","Ferry County",5,16,84,45,39
050,53,019,"Washington","Ferry County",5,17,86,46,40
050,53,019,"Washington","Ferry County",5,18,69,44,25
050,53,019,"Washington","Ferry County",5,19,61,43,18
050,53,019,"Washington","Ferry County",5,20,53,37,16
050,53,019,"Washington","Ferry County",5,21,59,35,24
050,53,019,"Washington","Ferry County",5,22,67,35,32
050,53,019,"Washington","Ferry County",5,23,61,28,33
050,53,019,"Washington","Ferry County",5,24,49,29,20
050,53,019,"Washington","Ferry County",5,25,60,33,27
050,53,019,"Washington","Ferry County",5,26,50,21,29
050,53,019,"Washington","Ferry County",5,27,53,31,22
050,53,019,"Washington","Ferry County",5,28,61,33,28
050,53,019,"Washington","Ferry County",5,29,53,28,25
050,53,019,"Washington","Ferry County",5,30,76,33,43
050,53,019,"Washington","Ferry County",5,31,75,41,34
050,53,019,"Washington","Ferry County",5,32,63,30,33
050,53,019,"Washington","Ferry County",5,33,75,45,30
050,53,019,"Washington","Ferry County",5,34,65,26,39
050,53,019,"Washington","Ferry County",5,35,68,30,38
050,53,019,"Washington","Ferry County",5,36,68,29,39
050,53,019,"Washington","Ferry County",5,37,91,47,44
050,53,019,"Washington","Ferry County",5,38,75,40,35
050,53,019,"Washington","Ferry County",5,39,85,41,44
050,53,019,"Washington","Ferry County",5,40,88,52,36
050,53,019,"Washington","Ferry County",5,41,74,36,38
050,53,019,"Washington","Ferry County",5,42,72,35,37
050,53,019,"Washington","Ferry County",5,43,78,37,41
050,53,019,"Washington","Ferry County",5,44,101,52,49
050,53,019,"Washington","Ferry County",5,45,90,51,39
050,53,019,"Washington","Ferry County",5,46,86,38,48
050,53,019,"Washington","Ferry County",5,47,93,48,45
050,53,019,"Washington","Ferry County",5,48,99,55,44
050,53,019,"Washington","Ferry County",5,49,90,50,40
050,53,019,"Washington","Ferry County",5,50,81,46,35
050,53,019,"Washington","Ferry County",5,51,97,51,46
050,53,019,"Washington","Ferry County",5,52,93,41,52
050,53,019,"Washington","Ferry County",5,53,108,52,56
050,53,019,"Washington","Ferry County",5,54,104,44,60
050,53,019,"Washington","Ferry County",5,55,93,42,51
050,53,019,"Washington","Ferry County",5,56,98,48,50
050,53,019,"Washington","Ferry County",5,57,80,36,44
050,53,019,"Washington","Ferry County",5,58,99,46,53
050,53,019,"Washington","Ferry County",5,59,116,52,64
050,53,019,"Washington","Ferry County",5,60,129,62,67
050,53,019,"Washington","Ferry County",5,61,126,55,71
050,53,019,"Washington","Ferry County",5,62,132,63,69
050,53,019,"Washington","Ferry County",5,63,118,62,56
050,53,019,"Washington","Ferry County",5,64,140,81,59
050,53,019,"Washington","Ferry County",5,65,147,70,77
050,53,019,"Washington","Ferry County",5,66,154,71,83
050,53,019,"Washington","Ferry County",5,67,134,64,70
050,53,019,"Washington","Ferry County",5,68,150,77,73
050,53,019,"Washington","Ferry County",5,69,152,77,75
050,53,019,"Washington","Ferry County",5,70,145,71,74
050,53,019,"Washington","Ferry County",5,71,167,79,88
050,53,019,"Washington","Ferry County",5,72,150,80,70
050,53,019,"Washington","Ferry County",5,73,122,66,56
050,53,019,"Washington","Ferry County",5,74,136,79,57
050,53,019,"Washington","Ferry County",5,75,116,64,52
050,53,019,"Washington","Ferry County",5,76,115,67,48
050,53,019,"Washington","Ferry County",5,77,67,37,30
050,53,019,"Washington","Ferry County",5,78,73,34,39
050,53,019,"Washington","Ferry County",5,79,62,30,32
050,53,019,"Washington","Ferry County",5,80,65,34,31
050,53,019,"Washington","Ferry County",5,81,58,30,28
050,53,019,"Washington","Ferry County",5,82,51,26,25
050,53,019,"Washington","Ferry County",5,83,37,22,15
050,53,019,"Washington","Ferry County",5,84,36,16,20
050,53,019,"Washington","Ferry County",5,85,158,55,103
050,53,021,"Washington","Franklin County",1,0,1481,755,726
050,53,021,"Washington","Franklin County",1,1,1515,763,752
050,53,021,"Washington","Franklin County",1,2,1656,860,796
050,53,021,"Washington","Franklin County",1,3,1725,880,845
050,53,021,"Washington","Franklin County",1,4,1773,912,861
050,53,021,"Washington","Franklin County",1,5,1737,857,880
050,53,021,"Washington","Franklin County",1,6,1686,801,885
050,53,021,"Washington","Franklin County",1,7,1732,862,870
050,53,021,"Washington","Franklin County",1,8,1756,863,893
050,53,021,"Washington","Franklin County",1,9,1762,869,893
050,53,021,"Washington","Franklin County",1,10,1813,913,900
050,53,021,"Washington","Franklin County",1,11,1845,919,926
050,53,021,"Washington","Franklin County",1,12,1869,918,951
050,53,021,"Washington","Franklin County",1,13,1832,935,897
050,53,021,"Washington","Franklin County",1,14,1766,909,857
050,53,021,"Washington","Franklin County",1,15,1780,881,899
050,53,021,"Washington","Franklin County",1,16,1707,840,867
050,53,021,"Washington","Franklin County",1,17,1669,831,838
050,53,021,"Washington","Franklin County",1,18,1540,790,750
050,53,021,"Washington","Franklin County",1,19,1350,706,644
050,53,021,"Washington","Franklin County",1,20,1360,706,654
050,53,021,"Washington","Franklin County",1,21,1331,694,637
050,53,021,"Washington","Franklin County",1,22,1278,669,609
050,53,021,"Washington","Franklin County",1,23,1353,730,623
050,53,021,"Washington","Franklin County",1,24,1298,676,622
050,53,021,"Washington","Franklin County",1,25,1304,690,614
050,53,021,"Washington","Franklin County",1,26,1346,712,634
050,53,021,"Washington","Franklin County",1,27,1426,779,647
050,53,021,"Washington","Franklin County",1,28,1470,776,694
050,53,021,"Washington","Franklin County",1,29,1468,775,693
050,53,021,"Washington","Franklin County",1,30,1473,819,654
050,53,021,"Washington","Franklin County",1,31,1410,766,644
050,53,021,"Washington","Franklin County",1,32,1424,745,679
050,53,021,"Washington","Franklin County",1,33,1447,774,673
050,53,021,"Washington","Franklin County",1,34,1454,754,700
050,53,021,"Washington","Franklin County",1,35,1487,803,684
050,53,021,"Washington","Franklin County",1,36,1472,808,664
050,53,021,"Washington","Franklin County",1,37,1436,763,673
050,53,021,"Washington","Franklin County",1,38,1426,779,647
050,53,021,"Washington","Franklin County",1,39,1432,795,637
050,53,021,"Washington","Franklin County",1,40,1355,734,621
050,53,021,"Washington","Franklin County",1,41,1344,757,587
050,53,021,"Washington","Franklin County",1,42,1224,650,574
050,53,021,"Washington","Franklin County",1,43,1256,662,594
050,53,021,"Washington","Franklin County",1,44,1253,660,593
050,53,021,"Washington","Franklin County",1,45,1138,602,536
050,53,021,"Washington","Franklin County",1,46,1106,581,525
050,53,021,"Washington","Franklin County",1,47,1088,570,518
050,53,021,"Washington","Franklin County",1,48,1093,590,503
050,53,021,"Washington","Franklin County",1,49,1081,568,513
050,53,021,"Washington","Franklin County",1,50,1009,556,453
050,53,021,"Washington","Franklin County",1,51,1046,583,463
050,53,021,"Washington","Franklin County",1,52,993,540,453
050,53,021,"Washington","Franklin County",1,53,942,497,445
050,53,021,"Washington","Franklin County",1,54,913,506,407
050,53,021,"Washington","Franklin County",1,55,909,463,446
050,53,021,"Washington","Franklin County",1,56,939,471,468
050,53,021,"Washington","Franklin County",1,57,885,462,423
050,53,021,"Washington","Franklin County",1,58,877,454,423
050,53,021,"Washington","Franklin County",1,59,812,408,404
050,53,021,"Washington","Franklin County",1,60,830,439,391
050,53,021,"Washington","Franklin County",1,61,818,432,386
050,53,021,"Washington","Franklin County",1,62,810,435,375
050,53,021,"Washington","Franklin County",1,63,796,402,394
050,53,021,"Washington","Franklin County",1,64,763,378,385
050,53,021,"Washington","Franklin County",1,65,802,411,391
050,53,021,"Washington","Franklin County",1,66,795,426,369
050,53,021,"Washington","Franklin County",1,67,704,372,332
050,53,021,"Washington","Franklin County",1,68,653,325,328
050,53,021,"Washington","Franklin County",1,69,617,308,309
050,53,021,"Washington","Franklin County",1,70,566,281,285
050,53,021,"Washington","Franklin County",1,71,517,255,262
050,53,021,"Washington","Franklin County",1,72,551,281,270
050,53,021,"Washington","Franklin County",1,73,525,240,285
050,53,021,"Washington","Franklin County",1,74,384,183,201
050,53,021,"Washington","Franklin County",1,75,360,166,194
050,53,021,"Washington","Franklin County",1,76,343,155,188
050,53,021,"Washington","Franklin County",1,77,338,165,173
050,53,021,"Washington","Franklin County",1,78,290,126,164
050,53,021,"Washington","Franklin County",1,79,241,118,123
050,53,021,"Washington","Franklin County",1,80,204,95,109
050,53,021,"Washington","Franklin County",1,81,218,93,125
050,53,021,"Washington","Franklin County",1,82,188,92,96
050,53,021,"Washington","Franklin County",1,83,190,77,113
050,53,021,"Washington","Franklin County",1,84,138,52,86
050,53,021,"Washington","Franklin County",1,85,755,286,469
050,53,021,"Washington","Franklin County",2,0,1494,770,724
050,53,021,"Washington","Franklin County",2,1,1518,767,751
050,53,021,"Washington","Franklin County",2,2,1629,840,789
050,53,021,"Washington","Franklin County",2,3,1711,879,832
050,53,021,"Washington","Franklin County",2,4,1768,909,859
050,53,021,"Washington","Franklin County",2,5,1750,873,877
050,53,021,"Washington","Franklin County",2,6,1706,819,887
050,53,021,"Washington","Franklin County",2,7,1720,845,875
050,53,021,"Washington","Franklin County",2,8,1743,857,886
050,53,021,"Washington","Franklin County",2,9,1758,864,894
050,53,021,"Washington","Franklin County",2,10,1806,907,899
050,53,021,"Washington","Franklin County",2,11,1826,915,911
050,53,021,"Washington","Franklin County",2,12,1870,926,944
050,53,021,"Washington","Franklin County",2,13,1839,930,909
050,53,021,"Washington","Franklin County",2,14,1788,921,867
050,53,021,"Washington","Franklin County",2,15,1786,896,890
050,53,021,"Washington","Franklin County",2,16,1726,849,877
050,53,021,"Washington","Franklin County",2,17,1678,830,848
050,53,021,"Washington","Franklin County",2,18,1532,783,749
050,53,021,"Washington","Franklin County",2,19,1372,709,663
050,53,021,"Washington","Franklin County",2,20,1390,726,664
050,53,021,"Washington","Franklin County",2,21,1334,696,638
050,53,021,"Washington","Franklin County",2,22,1314,687,627
050,53,021,"Washington","Franklin County",2,23,1352,724,628
050,53,021,"Washington","Franklin County",2,24,1317,690,627
050,53,021,"Washington","Franklin County",2,25,1324,698,626
050,53,021,"Washington","Franklin County",2,26,1355,718,637
050,53,021,"Washington","Franklin County",2,27,1415,770,645
050,53,021,"Washington","Franklin County",2,28,1465,780,685
050,53,021,"Washington","Franklin County",2,29,1472,775,697
050,53,021,"Washington","Franklin County",2,30,1489,822,667
050,53,021,"Washington","Franklin County",2,31,1412,767,645
050,53,021,"Washington","Franklin County",2,32,1416,747,669
050,53,021,"Washington","Franklin County",2,33,1442,769,673
050,53,021,"Washington","Franklin County",2,34,1453,761,692
050,53,021,"Washington","Franklin County",2,35,1477,787,690
050,53,021,"Washington","Franklin County",2,36,1474,802,672
050,53,021,"Washington","Franklin County",2,37,1445,772,673
050,53,021,"Washington","Franklin County",2,38,1437,778,659
050,53,021,"Washington","Franklin County",2,39,1434,797,637
050,53,021,"Washington","Franklin County",2,40,1370,744,626
050,53,021,"Washington","Franklin County",2,41,1360,765,595
050,53,021,"Washington","Franklin County",2,42,1234,660,574
050,53,021,"Washington","Franklin County",2,43,1260,665,595
050,53,021,"Washington","Franklin County",2,44,1237,649,588
050,53,021,"Washington","Franklin County",2,45,1168,617,551
050,53,021,"Washington","Franklin County",2,46,1114,585,529
050,53,021,"Washington","Franklin County",2,47,1094,576,518
050,53,021,"Washington","Franklin County",2,48,1093,585,508
050,53,021,"Washington","Franklin County",2,49,1093,580,513
050,53,021,"Washington","Franklin County",2,50,1022,558,464
050,53,021,"Washington","Franklin County",2,51,1049,586,463
050,53,021,"Washington","Franklin County",2,52,1005,548,457
050,53,021,"Washington","Franklin County",2,53,947,501,446
050,53,021,"Washington","Franklin County",2,54,927,509,418
050,53,021,"Washington","Franklin County",2,55,912,471,441
050,53,021,"Washington","Franklin County",2,56,937,474,463
050,53,021,"Washington","Franklin County",2,57,896,465,431
050,53,021,"Washington","Franklin County",2,58,876,455,421
050,53,021,"Washington","Franklin County",2,59,828,419,409
050,53,021,"Washington","Franklin County",2,60,831,433,398
050,53,021,"Washington","Franklin County",2,61,818,435,383
050,53,021,"Washington","Franklin County",2,62,804,427,377
050,53,021,"Washington","Franklin County",2,63,801,411,390
050,53,021,"Washington","Franklin County",2,64,760,377,383
050,53,021,"Washington","Franklin County",2,65,790,400,390
050,53,021,"Washington","Franklin County",2,66,794,420,374
050,53,021,"Washington","Franklin County",2,67,727,385,342
050,53,021,"Washington","Franklin County",2,68,658,331,327
050,53,021,"Washington","Franklin County",2,69,629,314,315
050,53,021,"Washington","Franklin County",2,70,577,286,291
050,53,021,"Washington","Franklin County",2,71,531,260,271
050,53,021,"Washington","Franklin County",2,72,531,271,260
050,53,021,"Washington","Franklin County",2,73,548,255,293
050,53,021,"Washington","Franklin County",2,74,395,186,209
050,53,021,"Washington","Franklin County",2,75,362,168,194
050,53,021,"Washington","Franklin County",2,76,342,154,188
050,53,021,"Washington","Franklin County",2,77,345,166,179
050,53,021,"Washington","Franklin County",2,78,293,131,162
050,53,021,"Washington","Franklin County",2,79,252,119,133
050,53,021,"Washington","Franklin County",2,80,210,100,110
050,53,021,"Washington","Franklin County",2,81,215,92,123
050,53,021,"Washington","Franklin County",2,82,194,91,103
050,53,021,"Washington","Franklin County",2,83,189,77,112
050,53,021,"Washington","Franklin County",2,84,140,53,87
050,53,021,"Washington","Franklin County",2,85,755,287,468
050,53,021,"Washington","Franklin County",3,0,1413,701,712
050,53,021,"Washington","Franklin County",3,1,1507,776,731
050,53,021,"Washington","Franklin County",3,2,1517,764,753
050,53,021,"Washington","Franklin County",3,3,1641,847,794
050,53,021,"Washington","Franklin County",3,4,1735,885,850
050,53,021,"Washington","Franklin County",3,5,1766,904,862
050,53,021,"Washington","Franklin County",3,6,1748,877,871
050,53,021,"Washington","Franklin County",3,7,1710,835,875
050,53,021,"Washington","Franklin County",3,8,1718,852,866
050,53,021,"Washington","Franklin County",3,9,1745,871,874
050,53,021,"Washington","Franklin County",3,10,1744,861,883
050,53,021,"Washington","Franklin County",3,11,1812,910,902
050,53,021,"Washington","Franklin County",3,12,1846,938,908
050,53,021,"Washington","Franklin County",3,13,1869,897,972
050,53,021,"Washington","Franklin County",3,14,1857,948,909
050,53,021,"Washington","Franklin County",3,15,1815,935,880
050,53,021,"Washington","Franklin County",3,16,1769,889,880
050,53,021,"Washington","Franklin County",3,17,1714,838,876
050,53,021,"Washington","Franklin County",3,18,1578,787,791
050,53,021,"Washington","Franklin County",3,19,1397,703,694
050,53,021,"Washington","Franklin County",3,20,1455,749,706
050,53,021,"Washington","Franklin County",3,21,1408,754,654
050,53,021,"Washington","Franklin County",3,22,1356,723,633
050,53,021,"Washington","Franklin County",3,23,1356,738,618
050,53,021,"Washington","Franklin County",3,24,1363,718,645
050,53,021,"Washington","Franklin County",3,25,1339,702,637
050,53,021,"Washington","Franklin County",3,26,1391,726,665
050,53,021,"Washington","Franklin County",3,27,1378,728,650
050,53,021,"Washington","Franklin County",3,28,1405,746,659
050,53,021,"Washington","Franklin County",3,29,1495,781,714
050,53,021,"Washington","Franklin County",3,30,1516,811,705
050,53,021,"Washington","Franklin County",3,31,1471,793,678
050,53,021,"Washington","Franklin County",3,32,1386,737,649
050,53,021,"Washington","Franklin County",3,33,1432,766,666
050,53,021,"Washington","Franklin County",3,34,1444,762,682
050,53,021,"Washington","Franklin County",3,35,1444,744,700
050,53,021,"Washington","Franklin County",3,36,1490,799,691
050,53,021,"Washington","Franklin County",3,37,1431,785,646
050,53,021,"Washington","Franklin County",3,38,1457,792,665
050,53,021,"Washington","Franklin County",3,39,1464,830,634
050,53,021,"Washington","Franklin County",3,40,1388,742,646
050,53,021,"Washington","Franklin County",3,41,1401,791,610
050,53,021,"Washington","Franklin County",3,42,1309,717,592
050,53,021,"Washington","Franklin County",3,43,1261,684,577
050,53,021,"Washington","Franklin County",3,44,1248,660,588
050,53,021,"Washington","Franklin County",3,45,1226,643,583
050,53,021,"Washington","Franklin County",3,46,1151,606,545
050,53,021,"Washington","Franklin County",3,47,1118,583,535
050,53,021,"Washington","Franklin County",3,48,1064,547,517
050,53,021,"Washington","Franklin County",3,49,1115,595,520
050,53,021,"Washington","Franklin County",3,50,1055,548,507
050,53,021,"Washington","Franklin County",3,51,1042,575,467
050,53,021,"Washington","Franklin County",3,52,1027,572,455
050,53,021,"Washington","Franklin County",3,53,977,521,456
050,53,021,"Washington","Franklin County",3,54,973,516,457
050,53,021,"Washington","Franklin County",3,55,908,481,427
050,53,021,"Washington","Franklin County",3,56,931,500,431
050,53,021,"Washington","Franklin County",3,57,906,460,446
050,53,021,"Washington","Franklin County",3,58,866,449,417
050,53,021,"Washington","Franklin County",3,59,877,450,427
050,53,021,"Washington","Franklin County",3,60,829,423,406
050,53,021,"Washington","Franklin County",3,61,837,435,402
050,53,021,"Washington","Franklin County",3,62,805,419,386
050,53,021,"Washington","Franklin County",3,63,792,429,363
050,53,021,"Washington","Franklin County",3,64,800,399,401
050,53,021,"Washington","Franklin County",3,65,752,370,382
050,53,021,"Washington","Franklin County",3,66,762,387,375
050,53,021,"Washington","Franklin County",3,67,793,416,377
050,53,021,"Washington","Franklin County",3,68,712,370,342
050,53,021,"Washington","Franklin County",3,69,634,322,312
050,53,021,"Washington","Franklin County",3,70,622,311,311
050,53,021,"Washington","Franklin County",3,71,563,275,288
050,53,021,"Washington","Franklin County",3,72,510,255,255
050,53,021,"Washington","Franklin County",3,73,496,249,247
050,53,021,"Washington","Franklin County",3,74,538,249,289
050,53,021,"Washington","Franklin County",3,75,380,176,204
050,53,021,"Washington","Franklin County",3,76,353,165,188
050,53,021,"Washington","Franklin County",3,77,335,152,183
050,53,021,"Washington","Franklin County",3,78,324,154,170
050,53,021,"Washington","Franklin County",3,79,286,130,156
050,53,021,"Washington","Franklin County",3,80,221,105,116
050,53,021,"Washington","Franklin County",3,81,211,94,117
050,53,021,"Washington","Franklin County",3,82,191,91,100
050,53,021,"Washington","Franklin County",3,83,193,81,112
050,53,021,"Washington","Franklin County",3,84,161,69,92
050,53,021,"Washington","Franklin County",3,85,777,286,491
050,53,021,"Washington","Franklin County",4,0,1465,731,734
050,53,021,"Washington","Franklin County",4,1,1423,672,751
050,53,021,"Washington","Franklin County",4,2,1543,785,758
050,53,021,"Washington","Franklin County",4,3,1544,786,758
050,53,021,"Washington","Franklin County",4,4,1629,840,789
050,53,021,"Washington","Franklin County",4,5,1740,868,872
050,53,021,"Washington","Franklin County",4,6,1760,890,870
050,53,021,"Washington","Franklin County",4,7,1724,868,856
050,53,021,"Washington","Franklin County",4,8,1703,840,863
050,53,021,"Washington","Franklin County",4,9,1708,837,871
050,53,021,"Washington","Franklin County",4,10,1740,873,867
050,53,021,"Washington","Franklin County",4,11,1718,851,867
050,53,021,"Washington","Franklin County",4,12,1819,908,911
050,53,021,"Washington","Franklin County",4,13,1821,913,908
050,53,021,"Washington","Franklin County",4,14,1873,902,971
050,53,021,"Washington","Franklin County",4,15,1854,935,919
050,53,021,"Washington","Franklin County",4,16,1794,910,884
050,53,021,"Washington","Franklin County",4,17,1753,885,868
050,53,021,"Washington","Franklin County",4,18,1623,801,822
050,53,021,"Washington","Franklin County",4,19,1493,737,756
050,53,021,"Washington","Franklin County",4,20,1469,743,726
050,53,021,"Washington","Franklin County",4,21,1427,732,695
050,53,021,"Washington","Franklin County",4,22,1444,785,659
050,53,021,"Washington","Franklin County",4,23,1418,769,649
050,53,021,"Washington","Franklin County",4,24,1383,749,634
050,53,021,"Washington","Franklin County",4,25,1428,738,690
050,53,021,"Washington","Franklin County",4,26,1378,728,650
050,53,021,"Washington","Franklin County",4,27,1397,721,676
050,53,021,"Washington","Franklin County",4,28,1372,710,662
050,53,021,"Washington","Franklin County",4,29,1435,776,659
050,53,021,"Washington","Franklin County",4,30,1516,815,701
050,53,021,"Washington","Franklin County",4,31,1509,801,708
050,53,021,"Washington","Franklin County",4,32,1426,766,660
050,53,021,"Washington","Franklin County",4,33,1372,723,649
050,53,021,"Washington","Franklin County",4,34,1354,710,644
050,53,021,"Washington","Franklin County",4,35,1426,738,688
050,53,021,"Washington","Franklin County",4,36,1435,734,701
050,53,021,"Washington","Franklin County",4,37,1430,763,667
050,53,021,"Washington","Franklin County",4,38,1426,782,644
050,53,021,"Washington","Franklin County",4,39,1456,800,656
050,53,021,"Washington","Franklin County",4,40,1396,769,627
050,53,021,"Washington","Franklin County",4,41,1392,758,634
050,53,021,"Washington","Franklin County",4,42,1344,729,615
050,53,021,"Washington","Franklin County",4,43,1305,718,587
050,53,021,"Washington","Franklin County",4,44,1252,670,582
050,53,021,"Washington","Franklin County",4,45,1249,640,609
050,53,021,"Washington","Franklin County",4,46,1219,627,592
050,53,021,"Washington","Franklin County",4,47,1150,603,547
050,53,021,"Washington","Franklin County",4,48,1110,564,546
050,53,021,"Washington","Franklin County",4,49,1083,565,518
050,53,021,"Washington","Franklin County",4,50,1087,568,519
050,53,021,"Washington","Franklin County",4,51,1093,578,515
050,53,021,"Washington","Franklin County",4,52,988,538,450
050,53,021,"Washington","Franklin County",4,53,995,546,449
050,53,021,"Washington","Franklin County",4,54,980,527,453
050,53,021,"Washington","Franklin County",4,55,924,480,444
050,53,021,"Washington","Franklin County",4,56,918,486,432
050,53,021,"Washington","Franklin County",4,57,901,475,426
050,53,021,"Washington","Franklin County",4,58,883,441,442
050,53,021,"Washington","Franklin County",4,59,880,455,425
050,53,021,"Washington","Franklin County",4,60,860,429,431
050,53,021,"Washington","Franklin County",4,61,807,410,397
050,53,021,"Washington","Franklin County",4,62,819,413,406
050,53,021,"Washington","Franklin County",4,63,799,409,390
050,53,021,"Washington","Franklin County",4,64,775,409,366
050,53,021,"Washington","Franklin County",4,65,772,387,385
050,53,021,"Washington","Franklin County",4,66,728,361,367
050,53,021,"Washington","Franklin County",4,67,753,386,367
050,53,021,"Washington","Franklin County",4,68,763,385,378
050,53,021,"Washington","Franklin County",4,69,691,360,331
050,53,021,"Washington","Franklin County",4,70,635,327,308
050,53,021,"Washington","Franklin County",4,71,616,304,312
050,53,021,"Washington","Franklin County",4,72,545,275,270
050,53,021,"Washington","Franklin County",4,73,489,244,245
050,53,021,"Washington","Franklin County",4,74,481,242,239
050,53,021,"Washington","Franklin County",4,75,504,225,279
050,53,021,"Washington","Franklin County",4,76,371,170,201
050,53,021,"Washington","Franklin County",4,77,340,155,185
050,53,021,"Washington","Franklin County",4,78,319,139,180
050,53,021,"Washington","Franklin County",4,79,318,153,165
050,53,021,"Washington","Franklin County",4,80,257,118,139
050,53,021,"Washington","Franklin County",4,81,224,98,126
050,53,021,"Washington","Franklin County",4,82,189,88,101
050,53,021,"Washington","Franklin County",4,83,193,81,112
050,53,021,"Washington","Franklin County",4,84,170,76,94
050,53,021,"Washington","Franklin County",4,85,787,295,492
050,53,021,"Washington","Franklin County",5,0,1430,713,717
050,53,021,"Washington","Franklin County",5,1,1474,752,722
050,53,021,"Washington","Franklin County",5,2,1446,674,772
050,53,021,"Washington","Franklin County",5,3,1518,761,757
050,53,021,"Washington","Franklin County",5,4,1547,783,764
050,53,021,"Washington","Franklin County",5,5,1655,848,807
050,53,021,"Washington","Franklin County",5,6,1738,876,862
050,53,021,"Washington","Franklin County",5,7,1742,893,849
050,53,021,"Washington","Franklin County",5,8,1727,898,829
050,53,021,"Washington","Franklin County",5,9,1701,830,871
050,53,021,"Washington","Franklin County",5,10,1666,832,834
050,53,021,"Washington","Franklin County",5,11,1730,856,874
050,53,021,"Washington","Franklin County",5,12,1743,866,877
050,53,021,"Washington","Franklin County",5,13,1804,910,894
050,53,021,"Washington","Franklin County",5,14,1824,924,900
050,53,021,"Washington","Franklin County",5,15,1864,902,962
050,53,021,"Washington","Franklin County",5,16,1821,919,902
050,53,021,"Washington","Franklin County",5,17,1740,877,863
050,53,021,"Washington","Franklin County",5,18,1612,829,783
050,53,021,"Washington","Franklin County",5,19,1506,727,779
050,53,021,"Washington","Franklin County",5,20,1542,779,763
050,53,021,"Washington","Franklin County",5,21,1469,743,726
050,53,021,"Washington","Franklin County",5,22,1495,775,720
050,53,021,"Washington","Franklin County",5,23,1468,800,668
050,53,021,"Washington","Franklin County",5,24,1420,770,650
050,53,021,"Washington","Franklin County",5,25,1405,750,655
050,53,021,"Washington","Franklin County",5,26,1440,762,678
050,53,021,"Washington","Franklin County",5,27,1357,705,652
050,53,021,"Washington","Franklin County",5,28,1408,712,696
050,53,021,"Washington","Franklin County",5,29,1366,705,661
050,53,021,"Washington","Franklin County",5,30,1475,804,671
050,53,021,"Washington","Franklin County",5,31,1495,781,714
050,53,021,"Washington","Franklin County",5,32,1492,780,712
050,53,021,"Washington","Franklin County",5,33,1439,787,652
050,53,021,"Washington","Franklin County",5,34,1372,728,644
050,53,021,"Washington","Franklin County",5,35,1287,670,617
050,53,021,"Washington","Franklin County",5,36,1441,745,696
050,53,021,"Washington","Franklin County",5,37,1399,727,672
050,53,021,"Washington","Franklin County",5,38,1408,752,656
050,53,021,"Washington","Franklin County",5,39,1431,805,626
050,53,021,"Washington","Franklin County",5,40,1413,754,659
050,53,021,"Washington","Franklin County",5,41,1402,793,609
050,53,021,"Washington","Franklin County",5,42,1315,695,620
050,53,021,"Washington","Franklin County",5,43,1347,738,609
050,53,021,"Washington","Franklin County",5,44,1291,708,583
050,53,021,"Washington","Franklin County",5,45,1231,658,573
050,53,021,"Washington","Franklin County",5,46,1249,637,612
050,53,021,"Washington","Franklin County",5,47,1196,617,579
050,53,021,"Washington","Franklin County",5,48,1151,598,553
050,53,021,"Washington","Franklin County",5,49,1118,574,544
050,53,021,"Washington","Franklin County",5,50,1059,540,519
050,53,021,"Washington","Franklin County",5,51,1121,599,522
050,53,021,"Washington","Franklin County",5,52,1061,554,507
050,53,021,"Washington","Franklin County",5,53,966,522,444
050,53,021,"Washington","Franklin County",5,54,999,548,451
050,53,021,"Washington","Franklin County",5,55,940,500,440
050,53,021,"Washington","Franklin County",5,56,927,486,441
050,53,021,"Washington","Franklin County",5,57,913,482,431
050,53,021,"Washington","Franklin County",5,58,872,451,421
050,53,021,"Washington","Franklin County",5,59,885,435,450
050,53,021,"Washington","Franklin County",5,60,898,467,431
050,53,021,"Washington","Franklin County",5,61,855,431,424
050,53,021,"Washington","Franklin County",5,62,809,403,406
050,53,021,"Washington","Franklin County",5,63,815,419,396
050,53,021,"Washington","Franklin County",5,64,791,408,383
050,53,021,"Washington","Franklin County",5,65,768,410,358
050,53,021,"Washington","Franklin County",5,66,755,378,377
050,53,021,"Washington","Franklin County",5,67,724,366,358
050,53,021,"Washington","Franklin County",5,68,737,376,361
050,53,021,"Washington","Franklin County",5,69,746,383,363
050,53,021,"Washington","Franklin County",5,70,682,360,322
050,53,021,"Washington","Franklin County",5,71,615,312,303
050,53,021,"Washington","Franklin County",5,72,588,305,283
050,53,021,"Washington","Franklin County",5,73,525,266,259
050,53,021,"Washington","Franklin County",5,74,477,242,235
050,53,021,"Washington","Franklin County",5,75,463,229,234
050,53,021,"Washington","Franklin County",5,76,499,226,273
050,53,021,"Washington","Franklin County",5,77,360,162,198
050,53,021,"Washington","Franklin County",5,78,318,141,177
050,53,021,"Washington","Franklin County",5,79,322,140,182
050,53,021,"Washington","Franklin County",5,80,295,142,153
050,53,021,"Washington","Franklin County",5,81,261,114,147
050,53,021,"Washington","Franklin County",5,82,208,97,111
050,53,021,"Washington","Franklin County",5,83,187,76,111
050,53,021,"Washington","Franklin County",5,84,173,76,97
050,53,021,"Washington","Franklin County",5,85,810,319,491
050,53,023,"Washington","Garfield County",1,0,20,10,10
050,53,023,"Washington","Garfield County",1,1,23,12,11
050,53,023,"Washington","Garfield County",1,2,23,11,12
050,53,023,"Washington","Garfield County",1,3,38,19,19
050,53,023,"Washington","Garfield County",1,4,36,20,16
050,53,023,"Washington","Garfield County",1,5,35,16,19
050,53,023,"Washington","Garfield County",1,6,20,7,13
050,53,023,"Washington","Garfield County",1,7,22,11,11
050,53,023,"Washington","Garfield County",1,8,31,14,17
050,53,023,"Washington","Garfield County",1,9,22,9,13
050,53,023,"Washington","Garfield County",1,10,22,12,10
050,53,023,"Washington","Garfield County",1,11,28,15,13
050,53,023,"Washington","Garfield County",1,12,25,11,14
050,53,023,"Washington","Garfield County",1,13,25,15,10
050,53,023,"Washington","Garfield County",1,14,22,15,7
050,53,023,"Washington","Garfield County",1,15,27,18,9
050,53,023,"Washington","Garfield County",1,16,23,12,11
050,53,023,"Washington","Garfield County",1,17,27,14,13
050,53,023,"Washington","Garfield County",1,18,20,7,13
050,53,023,"Washington","Garfield County",1,19,19,11,8
050,53,023,"Washington","Garfield County",1,20,17,11,6
050,53,023,"Washington","Garfield County",1,21,16,10,6
050,53,023,"Washington","Garfield County",1,22,20,9,11
050,53,023,"Washington","Garfield County",1,23,22,10,12
050,53,023,"Washington","Garfield County",1,24,18,9,9
050,53,023,"Washington","Garfield County",1,25,22,10,12
050,53,023,"Washington","Garfield County",1,26,19,11,8
050,53,023,"Washington","Garfield County",1,27,13,7,6
050,53,023,"Washington","Garfield County",1,28,24,15,9
050,53,023,"Washington","Garfield County",1,29,21,9,12
050,53,023,"Washington","Garfield County",1,30,18,8,10
050,53,023,"Washington","Garfield County",1,31,19,6,13
050,53,023,"Washington","Garfield County",1,32,27,13,14
050,53,023,"Washington","Garfield County",1,33,25,16,9
050,53,023,"Washington","Garfield County",1,34,18,10,8
050,53,023,"Washington","Garfield County",1,35,22,13,9
050,53,023,"Washington","Garfield County",1,36,21,12,9
050,53,023,"Washington","Garfield County",1,37,21,12,9
050,53,023,"Washington","Garfield County",1,38,25,10,15
050,53,023,"Washington","Garfield County",1,39,20,9,11
050,53,023,"Washington","Garfield County",1,40,31,17,14
050,53,023,"Washington","Garfield County",1,41,32,18,14
050,53,023,"Washington","Garfield County",1,42,29,11,18
050,53,023,"Washington","Garfield County",1,43,28,9,19
050,53,023,"Washington","Garfield County",1,44,31,9,22
050,53,023,"Washington","Garfield County",1,45,40,14,26
050,53,023,"Washington","Garfield County",1,46,32,14,18
050,53,023,"Washington","Garfield County",1,47,24,11,13
050,53,023,"Washington","Garfield County",1,48,21,12,9
050,53,023,"Washington","Garfield County",1,49,26,12,14
050,53,023,"Washington","Garfield County",1,50,21,9,12
050,53,023,"Washington","Garfield County",1,51,16,8,8
050,53,023,"Washington","Garfield County",1,52,20,9,11
050,53,023,"Washington","Garfield County",1,53,19,8,11
050,53,023,"Washington","Garfield County",1,54,23,10,13
050,53,023,"Washington","Garfield County",1,55,25,11,14
050,53,023,"Washington","Garfield County",1,56,31,16,15
050,53,023,"Washington","Garfield County",1,57,28,13,15
050,53,023,"Washington","Garfield County",1,58,40,20,20
050,53,023,"Washington","Garfield County",1,59,36,19,17
050,53,023,"Washington","Garfield County",1,60,36,19,17
050,53,023,"Washington","Garfield County",1,61,42,22,20
050,53,023,"Washington","Garfield County",1,62,40,22,18
050,53,023,"Washington","Garfield County",1,63,47,23,24
050,53,023,"Washington","Garfield County",1,64,44,24,20
050,53,023,"Washington","Garfield County",1,65,46,19,27
050,53,023,"Washington","Garfield County",1,66,43,24,19
050,53,023,"Washington","Garfield County",1,67,44,27,17
050,53,023,"Washington","Garfield County",1,68,45,19,26
050,53,023,"Washington","Garfield County",1,69,37,17,20
050,53,023,"Washington","Garfield County",1,70,35,19,16
050,53,023,"Washington","Garfield County",1,71,39,17,22
050,53,023,"Washington","Garfield County",1,72,30,15,15
050,53,023,"Washington","Garfield County",1,73,30,14,16
050,53,023,"Washington","Garfield County",1,74,27,15,12
050,53,023,"Washington","Garfield County",1,75,27,17,10
050,53,023,"Washington","Garfield County",1,76,21,13,8
050,53,023,"Washington","Garfield County",1,77,18,12,6
050,53,023,"Washington","Garfield County",1,78,19,12,7
050,53,023,"Washington","Garfield County",1,79,12,5,7
050,53,023,"Washington","Garfield County",1,80,12,4,8
050,53,023,"Washington","Garfield County",1,81,11,3,8
050,53,023,"Washington","Garfield County",1,82,17,6,11
050,53,023,"Washington","Garfield County",1,83,11,5,6
050,53,023,"Washington","Garfield County",1,84,10,2,8
050,53,023,"Washington","Garfield County",1,85,72,30,42
050,53,023,"Washington","Garfield County",2,0,21,12,9
050,53,023,"Washington","Garfield County",2,1,20,10,10
050,53,023,"Washington","Garfield County",2,2,23,11,12
050,53,023,"Washington","Garfield County",2,3,34,17,17
050,53,023,"Washington","Garfield County",2,4,37,20,17
050,53,023,"Washington","Garfield County",2,5,34,17,17
050,53,023,"Washington","Garfield County",2,6,24,9,15
050,53,023,"Washington","Garfield County",2,7,21,10,11
050,53,023,"Washington","Garfield County",2,8,28,13,15
050,53,023,"Washington","Garfield County",2,9,25,10,15
050,53,023,"Washington","Garfield County",2,10,21,11,10
050,53,023,"Washington","Garfield County",2,11,26,14,12
050,53,023,"Washington","Garfield County",2,12,27,13,14
050,53,023,"Washington","Garfield County",2,13,26,15,11
050,53,023,"Washington","Garfield County",2,14,23,15,8
050,53,023,"Washington","Garfield County",2,15,27,18,9
050,53,023,"Washington","Garfield County",2,16,23,13,10
050,53,023,"Washington","Garfield County",2,17,27,14,13
050,53,023,"Washington","Garfield County",2,18,20,8,12
050,53,023,"Washington","Garfield County",2,19,20,10,10
050,53,023,"Washington","Garfield County",2,20,19,12,7
050,53,023,"Washington","Garfield County",2,21,17,10,7
050,53,023,"Washington","Garfield County",2,22,19,9,10
050,53,023,"Washington","Garfield County",2,23,22,10,12
050,53,023,"Washington","Garfield County",2,24,18,9,9
050,53,023,"Washington","Garfield County",2,25,22,10,12
050,53,023,"Washington","Garfield County",2,26,20,11,9
050,53,023,"Washington","Garfield County",2,27,13,7,6
050,53,023,"Washington","Garfield County",2,28,22,13,9
050,53,023,"Washington","Garfield County",2,29,21,11,10
050,53,023,"Washington","Garfield County",2,30,20,9,11
050,53,023,"Washington","Garfield County",2,31,19,6,13
050,53,023,"Washington","Garfield County",2,32,25,11,14
050,53,023,"Washington","Garfield County",2,33,26,16,10
050,53,023,"Washington","Garfield County",2,34,20,12,8
050,53,023,"Washington","Garfield County",2,35,21,12,9
050,53,023,"Washington","Garfield County",2,36,21,13,8
050,53,023,"Washington","Garfield County",2,37,21,12,9
050,53,023,"Washington","Garfield County",2,38,25,11,14
050,53,023,"Washington","Garfield County",2,39,21,9,12
050,53,023,"Washington","Garfield County",2,40,30,16,14
050,53,023,"Washington","Garfield County",2,41,31,17,14
050,53,023,"Washington","Garfield County",2,42,29,12,17
050,53,023,"Washington","Garfield County",2,43,30,10,20
050,53,023,"Washington","Garfield County",2,44,30,9,21
050,53,023,"Washington","Garfield County",2,45,38,13,25
050,53,023,"Washington","Garfield County",2,46,33,13,20
050,53,023,"Washington","Garfield County",2,47,26,12,14
050,53,023,"Washington","Garfield County",2,48,21,11,10
050,53,023,"Washington","Garfield County",2,49,25,12,13
050,53,023,"Washington","Garfield County",2,50,21,9,12
050,53,023,"Washington","Garfield County",2,51,17,8,9
050,53,023,"Washington","Garfield County",2,52,20,9,11
050,53,023,"Washington","Garfield County",2,53,18,8,10
050,53,023,"Washington","Garfield County",2,54,21,9,12
050,53,023,"Washington","Garfield County",2,55,24,11,13
050,53,023,"Washington","Garfield County",2,56,30,15,15
050,53,023,"Washington","Garfield County",2,57,29,14,15
050,53,023,"Washington","Garfield County",2,58,38,19,19
050,53,023,"Washington","Garfield County",2,59,37,19,18
050,53,023,"Washington","Garfield County",2,60,36,19,17
050,53,023,"Washington","Garfield County",2,61,42,22,20
050,53,023,"Washington","Garfield County",2,62,40,22,18
050,53,023,"Washington","Garfield County",2,63,47,23,24
050,53,023,"Washington","Garfield County",2,64,44,24,20
050,53,023,"Washington","Garfield County",2,65,46,21,25
050,53,023,"Washington","Garfield County",2,66,46,24,22
050,53,023,"Washington","Garfield County",2,67,43,26,17
050,53,023,"Washington","Garfield County",2,68,45,21,24
050,53,023,"Washington","Garfield County",2,69,40,18,22
050,53,023,"Washington","Garfield County",2,70,35,18,17
050,53,023,"Washington","Garfield County",2,71,39,18,21
050,53,023,"Washington","Garfield County",2,72,31,15,16
050,53,023,"Washington","Garfield County",2,73,32,16,16
050,53,023,"Washington","Garfield County",2,74,26,14,12
050,53,023,"Washington","Garfield County",2,75,27,17,10
050,53,023,"Washington","Garfield County",2,76,22,13,9
050,53,023,"Washington","Garfield County",2,77,20,13,7
050,53,023,"Washington","Garfield County",2,78,19,12,7
050,53,023,"Washington","Garfield County",2,79,14,7,7
050,53,023,"Washington","Garfield County",2,80,11,4,7
050,53,023,"Washington","Garfield County",2,81,10,2,8
050,53,023,"Washington","Garfield County",2,82,17,6,11
050,53,023,"Washington","Garfield County",2,83,11,5,6
050,53,023,"Washington","Garfield County",2,84,11,3,8
050,53,023,"Washington","Garfield County",2,85,73,30,43
050,53,023,"Washington","Garfield County",3,0,22,15,7
050,53,023,"Washington","Garfield County",3,1,25,14,11
050,53,023,"Washington","Garfield County",3,2,19,10,9
050,53,023,"Washington","Garfield County",3,3,25,12,13
050,53,023,"Washington","Garfield County",3,4,31,14,17
050,53,023,"Washington","Garfield County",3,5,39,22,17
050,53,023,"Washington","Garfield County",3,6,37,17,20
050,53,023,"Washington","Garfield County",3,7,27,12,15
050,53,023,"Washington","Garfield County",3,8,23,10,13
050,53,023,"Washington","Garfield County",3,9,29,13,16
050,53,023,"Washington","Garfield County",3,10,27,10,17
050,53,023,"Washington","Garfield County",3,11,25,12,13
050,53,023,"Washington","Garfield County",3,12,28,16,12
050,53,023,"Washington","Garfield County",3,13,29,14,15
050,53,023,"Washington","Garfield County",3,14,26,16,10
050,53,023,"Washington","Garfield County",3,15,30,18,12
050,53,023,"Washington","Garfield County",3,16,30,21,9
050,53,023,"Washington","Garfield County",3,17,27,16,11
050,53,023,"Washington","Garfield County",3,18,22,12,10
050,53,023,"Washington","Garfield County",3,19,15,6,9
050,53,023,"Washington","Garfield County",3,20,23,11,12
050,53,023,"Washington","Garfield County",3,21,16,9,7
050,53,023,"Washington","Garfield County",3,22,15,9,6
050,53,023,"Washington","Garfield County",3,23,15,6,9
050,53,023,"Washington","Garfield County",3,24,26,12,14
050,53,023,"Washington","Garfield County",3,25,23,11,12
050,53,023,"Washington","Garfield County",3,26,24,11,13
050,53,023,"Washington","Garfield County",3,27,20,9,11
050,53,023,"Washington","Garfield County",3,28,9,7,2
050,53,023,"Washington","Garfield County",3,29,22,12,10
050,53,023,"Washington","Garfield County",3,30,23,11,12
050,53,023,"Washington","Garfield County",3,31,18,7,11
050,53,023,"Washington","Garfield County",3,32,24,10,14
050,53,023,"Washington","Garfield County",3,33,23,9,14
050,53,023,"Washington","Garfield County",3,34,28,19,9
050,53,023,"Washington","Garfield County",3,35,22,13,9
050,53,023,"Washington","Garfield County",3,36,17,9,8
050,53,023,"Washington","Garfield County",3,37,23,14,9
050,53,023,"Washington","Garfield County",3,38,23,11,12
050,53,023,"Washington","Garfield County",3,39,25,11,14
050,53,023,"Washington","Garfield County",3,40,25,12,13
050,53,023,"Washington","Garfield County",3,41,35,16,19
050,53,023,"Washington","Garfield County",3,42,35,18,17
050,53,023,"Washington","Garfield County",3,43,30,13,17
050,53,023,"Washington","Garfield County",3,44,31,11,20
050,53,023,"Washington","Garfield County",3,45,33,9,24
050,53,023,"Washington","Garfield County",3,46,41,13,28
050,53,023,"Washington","Garfield County",3,47,34,14,20
050,53,023,"Washington","Garfield County",3,48,27,12,15
050,53,023,"Washington","Garfield County",3,49,24,13,11
050,53,023,"Washington","Garfield County",3,50,25,12,13
050,53,023,"Washington","Garfield County",3,51,20,9,11
050,53,023,"Washington","Garfield County",3,52,18,8,10
050,53,023,"Washington","Garfield County",3,53,21,11,10
050,53,023,"Washington","Garfield County",3,54,17,6,11
050,53,023,"Washington","Garfield County",3,55,24,12,12
050,53,023,"Washington","Garfield County",3,56,26,13,13
050,53,023,"Washington","Garfield County",3,57,33,18,15
050,53,023,"Washington","Garfield County",3,58,28,14,14
050,53,023,"Washington","Garfield County",3,59,37,19,18
050,53,023,"Washington","Garfield County",3,60,39,21,18
050,53,023,"Washington","Garfield County",3,61,36,19,17
050,53,023,"Washington","Garfield County",3,62,40,22,18
050,53,023,"Washington","Garfield County",3,63,40,21,19
050,53,023,"Washington","Garfield County",3,64,45,21,24
050,53,023,"Washington","Garfield County",3,65,44,24,20
050,53,023,"Washington","Garfield County",3,66,41,18,23
050,53,023,"Washington","Garfield County",3,67,46,24,22
050,53,023,"Washington","Garfield County",3,68,40,23,17
050,53,023,"Washington","Garfield County",3,69,43,20,23
050,53,023,"Washington","Garfield County",3,70,40,18,22
050,53,023,"Washington","Garfield County",3,71,35,19,16
050,53,023,"Washington","Garfield County",3,72,37,17,20
050,53,023,"Washington","Garfield County",3,73,30,15,15
050,53,023,"Washington","Garfield County",3,74,30,15,15
050,53,023,"Washington","Garfield County",3,75,25,13,12
050,53,023,"Washington","Garfield County",3,76,27,17,10
050,53,023,"Washington","Garfield County",3,77,21,12,9
050,53,023,"Washington","Garfield County",3,78,21,14,7
050,53,023,"Washington","Garfield County",3,79,19,12,7
050,53,023,"Washington","Garfield County",3,80,11,5,6
050,53,023,"Washington","Garfield County",3,81,11,4,7
050,53,023,"Washington","Garfield County",3,82,11,2,9
050,53,023,"Washington","Garfield County",3,83,12,6,6
050,53,023,"Washington","Garfield County",3,84,15,8,7
050,53,023,"Washington","Garfield County",3,85,66,27,39
050,53,023,"Washington","Garfield County",4,0,28,21,7
050,53,023,"Washington","Garfield County",4,1,26,19,7
050,53,023,"Washington","Garfield County",4,2,24,13,11
050,53,023,"Washington","Garfield County",4,3,25,16,9
050,53,023,"Washington","Garfield County",4,4,23,13,10
050,53,023,"Washington","Garfield County",4,5,30,13,17
050,53,023,"Washington","Garfield County",4,6,39,23,16
050,53,023,"Washington","Garfield County",4,7,36,16,20
050,53,023,"Washington","Garfield County",4,8,26,11,15
050,53,023,"Washington","Garfield County",4,9,24,12,12
050,53,023,"Washington","Garfield County",4,10,35,17,18
050,53,023,"Washington","Garfield County",4,11,28,11,17
050,53,023,"Washington","Garfield County",4,12,25,11,14
050,53,023,"Washington","Garfield County",4,13,30,16,14
050,53,023,"Washington","Garfield County",4,14,25,12,13
050,53,023,"Washington","Garfield County",4,15,29,15,14
050,53,023,"Washington","Garfield County",4,16,31,19,12
050,53,023,"Washington","Garfield County",4,17,31,19,12
050,53,023,"Washington","Garfield County",4,18,23,14,9
050,53,023,"Washington","Garfield County",4,19,18,10,8
050,53,023,"Washington","Garfield County",4,20,18,7,11
050,53,023,"Washington","Garfield County",4,21,28,13,15
050,53,023,"Washington","Garfield County",4,22,19,13,6
050,53,023,"Washington","Garfield County",4,23,16,10,6
050,53,023,"Washington","Garfield County",4,24,20,8,12
050,53,023,"Washington","Garfield County",4,25,25,11,14
050,53,023,"Washington","Garfield County",4,26,19,7,12
050,53,023,"Washington","Garfield County",4,27,24,10,14
050,53,023,"Washington","Garfield County",4,28,20,10,10
050,53,023,"Washington","Garfield County",4,29,8,5,3
050,53,023,"Washington","Garfield County",4,30,25,15,10
050,53,023,"Washington","Garfield County",4,31,28,13,15
050,53,023,"Washington","Garfield County",4,32,14,4,10
050,53,023,"Washington","Garfield County",4,33,24,10,14
050,53,023,"Washington","Garfield County",4,34,31,12,19
050,53,023,"Washington","Garfield County",4,35,27,19,8
050,53,023,"Washington","Garfield County",4,36,25,16,9
050,53,023,"Washington","Garfield County",4,37,13,7,6
050,53,023,"Washington","Garfield County",4,38,20,12,8
050,53,023,"Washington","Garfield County",4,39,21,11,10
050,53,023,"Washington","Garfield County",4,40,27,12,15
050,53,023,"Washington","Garfield County",4,41,28,12,16
050,53,023,"Washington","Garfield County",4,42,33,13,20
050,53,023,"Washington","Garfield County",4,43,34,18,16
050,53,023,"Washington","Garfield County",4,44,34,17,17
050,53,023,"Washington","Garfield County",4,45,31,10,21
050,53,023,"Washington","Garfield County",4,46,34,10,24
050,53,023,"Washington","Garfield County",4,47,42,14,28
050,53,023,"Washington","Garfield County",4,48,32,14,18
050,53,023,"Washington","Garfield County",4,49,26,12,14
050,53,023,"Washington","Garfield County",4,50,20,9,11
050,53,023,"Washington","Garfield County",4,51,27,13,14
050,53,023,"Washington","Garfield County",4,52,20,9,11
050,53,023,"Washington","Garfield County",4,53,18,9,9
050,53,023,"Washington","Garfield County",4,54,23,12,11
050,53,023,"Washington","Garfield County",4,55,18,6,12
050,53,023,"Washington","Garfield County",4,56,24,12,12
050,53,023,"Washington","Garfield County",4,57,27,13,14
050,53,023,"Washington","Garfield County",4,58,36,21,15
050,53,023,"Washington","Garfield County",4,59,31,17,14
050,53,023,"Washington","Garfield County",4,60,38,20,18
050,53,023,"Washington","Garfield County",4,61,37,20,17
050,53,023,"Washington","Garfield County",4,62,31,19,12
050,53,023,"Washington","Garfield County",4,63,39,22,17
050,53,023,"Washington","Garfield County",4,64,36,17,19
050,53,023,"Washington","Garfield County",4,65,46,22,24
050,53,023,"Washington","Garfield County",4,66,44,23,21
050,53,023,"Washington","Garfield County",4,67,37,17,20
050,53,023,"Washington","Garfield County",4,68,42,24,18
050,53,023,"Washington","Garfield County",4,69,39,23,16
050,53,023,"Washington","Garfield County",4,70,42,19,23
050,53,023,"Washington","Garfield County",4,71,40,18,22
050,53,023,"Washington","Garfield County",4,72,31,16,15
050,53,023,"Washington","Garfield County",4,73,34,15,19
050,53,023,"Washington","Garfield County",4,74,28,13,15
050,53,023,"Washington","Garfield County",4,75,26,15,11
050,53,023,"Washington","Garfield County",4,76,23,12,11
050,53,023,"Washington","Garfield County",4,77,28,17,11
050,53,023,"Washington","Garfield County",4,78,21,11,10
050,53,023,"Washington","Garfield County",4,79,21,13,8
050,53,023,"Washington","Garfield County",4,80,18,11,7
050,53,023,"Washington","Garfield County",4,81,10,3,7
050,53,023,"Washington","Garfield County",4,82,10,4,6
050,53,023,"Washington","Garfield County",4,83,7,2,5
050,53,023,"Washington","Garfield County",4,84,13,6,7
050,53,023,"Washington","Garfield County",4,85,70,33,37
050,53,023,"Washington","Garfield County",5,0,26,20,6
050,53,023,"Washington","Garfield County",5,1,25,21,4
050,53,023,"Washington","Garfield County",5,2,28,20,8
050,53,023,"Washington","Garfield County",5,3,23,12,11
050,53,023,"Washington","Garfield County",5,4,26,16,10
050,53,023,"Washington","Garfield County",5,5,22,12,10
050,53,023,"Washington","Garfield County",5,6,29,13,16
050,53,023,"Washington","Garfield County",5,7,39,23,16
050,53,023,"Washington","Garfield County",5,8,37,16,21
050,53,023,"Washington","Garfield County",5,9,26,11,15
050,53,023,"Washington","Garfield County",5,10,24,11,13
050,53,023,"Washington","Garfield County",5,11,33,17,16
050,53,023,"Washington","Garfield County",5,12,29,11,18
050,53,023,"Washington","Garfield County",5,13,25,11,14
050,53,023,"Washington","Garfield County",5,14,28,14,14
050,53,023,"Washington","Garfield County",5,15,22,9,13
050,53,023,"Washington","Garfield County",5,16,27,13,14
050,53,023,"Washington","Garfield County",5,17,29,19,10
050,53,023,"Washington","Garfield County",5,18,28,18,10
050,53,023,"Washington","Garfield County",5,19,21,14,7
050,53,023,"Washington","Garfield County",5,20,17,9,8
050,53,023,"Washington","Garfield County",5,21,18,8,10
050,53,023,"Washington","Garfield County",5,22,27,13,14
050,53,023,"Washington","Garfield County",5,23,22,14,8
050,53,023,"Washington","Garfield County",5,24,17,11,6
050,53,023,"Washington","Garfield County",5,25,17,6,11
050,53,023,"Washington","Garfield County",5,26,26,12,14
050,53,023,"Washington","Garfield County",5,27,22,7,15
050,53,023,"Washington","Garfield County",5,28,23,10,13
050,53,023,"Washington","Garfield County",5,29,27,14,13
050,53,023,"Washington","Garfield County",5,30,10,7,3
050,53,023,"Washington","Garfield County",5,31,25,14,11
050,53,023,"Washington","Garfield County",5,32,29,13,16
050,53,023,"Washington","Garfield County",5,33,14,5,9
050,53,023,"Washington","Garfield County",5,34,23,10,13
050,53,023,"Washington","Garfield County",5,35,31,12,19
050,53,023,"Washington","Garfield County",5,36,28,20,8
050,53,023,"Washington","Garfield County",5,37,24,15,9
050,53,023,"Washington","Garfield County",5,38,20,10,10
050,53,023,"Washington","Garfield County",5,39,19,12,7
050,53,023,"Washington","Garfield County",5,40,20,11,9
050,53,023,"Washington","Garfield County",5,41,27,11,16
050,53,023,"Washington","Garfield County",5,42,28,12,16
050,53,023,"Washington","Garfield County",5,43,35,13,22
050,53,023,"Washington","Garfield County",5,44,33,18,15
050,53,023,"Washington","Garfield County",5,45,28,15,13
050,53,023,"Washington","Garfield County",5,46,31,10,21
050,53,023,"Washington","Garfield County",5,47,33,9,24
050,53,023,"Washington","Garfield County",5,48,41,13,28
050,53,023,"Washington","Garfield County",5,49,31,14,17
050,53,023,"Washington","Garfield County",5,50,24,11,13
050,53,023,"Washington","Garfield County",5,51,20,9,11
050,53,023,"Washington","Garfield County",5,52,27,13,14
050,53,023,"Washington","Garfield County",5,53,19,9,10
050,53,023,"Washington","Garfield County",5,54,20,9,11
050,53,023,"Washington","Garfield County",5,55,23,12,11
050,53,023,"Washington","Garfield County",5,56,18,6,12
050,53,023,"Washington","Garfield County",5,57,26,12,14
050,53,023,"Washington","Garfield County",5,58,31,15,16
050,53,023,"Washington","Garfield County",5,59,36,21,15
050,53,023,"Washington","Garfield County",5,60,31,17,14
050,53,023,"Washington","Garfield County",5,61,43,21,22
050,53,023,"Washington","Garfield County",5,62,35,20,15
050,53,023,"Washington","Garfield County",5,63,34,20,14
050,53,023,"Washington","Garfield County",5,64,41,24,17
050,53,023,"Washington","Garfield County",5,65,37,17,20
050,53,023,"Washington","Garfield County",5,66,43,21,22
050,53,023,"Washington","Garfield County",5,67,44,24,20
050,53,023,"Washington","Garfield County",5,68,41,19,22
050,53,023,"Washington","Garfield County",5,69,39,22,17
050,53,023,"Washington","Garfield County",5,70,40,23,17
050,53,023,"Washington","Garfield County",5,71,43,21,22
050,53,023,"Washington","Garfield County",5,72,41,18,23
050,53,023,"Washington","Garfield County",5,73,30,16,14
050,53,023,"Washington","Garfield County",5,74,33,14,19
050,53,023,"Washington","Garfield County",5,75,27,13,14
050,53,023,"Washington","Garfield County",5,76,26,15,11
050,53,023,"Washington","Garfield County",5,77,23,12,11
050,53,023,"Washington","Garfield County",5,78,28,17,11
050,53,023,"Washington","Garfield County",5,79,19,10,9
050,53,023,"Washington","Garfield County",5,80,20,13,7
050,53,023,"Washington","Garfield County",5,81,16,9,7
050,53,023,"Washington","Garfield County",5,82,10,3,7
050,53,023,"Washington","Garfield County",5,83,6,4,2
050,53,023,"Washington","Garfield County",5,84,8,2,6
050,53,023,"Washington","Garfield County",5,85,68,35,33
050,53,025,"Washington","Grant County",1,0,1437,744,693
050,53,025,"Washington","Grant County",1,1,1439,770,669
050,53,025,"Washington","Grant County",1,2,1483,755,728
050,53,025,"Washington","Grant County",1,3,1511,778,733
050,53,025,"Washington","Grant County",1,4,1567,807,760
050,53,025,"Washington","Grant County",1,5,1532,761,771
050,53,025,"Washington","Grant County",1,6,1547,768,779
050,53,025,"Washington","Grant County",1,7,1625,828,797
050,53,025,"Washington","Grant County",1,8,1651,807,844
050,53,025,"Washington","Grant County",1,9,1719,856,863
050,53,025,"Washington","Grant County",1,10,1694,863,831
050,53,025,"Washington","Grant County",1,11,1783,928,855
050,53,025,"Washington","Grant County",1,12,1807,922,885
050,53,025,"Washington","Grant County",1,13,1752,893,859
050,53,025,"Washington","Grant County",1,14,1683,870,813
050,53,025,"Washington","Grant County",1,15,1662,843,819
050,53,025,"Washington","Grant County",1,16,1624,832,792
050,53,025,"Washington","Grant County",1,17,1617,834,783
050,53,025,"Washington","Grant County",1,18,1471,782,689
050,53,025,"Washington","Grant County",1,19,1418,766,652
050,53,025,"Washington","Grant County",1,20,1379,718,661
050,53,025,"Washington","Grant County",1,21,1340,667,673
050,53,025,"Washington","Grant County",1,22,1297,695,602
050,53,025,"Washington","Grant County",1,23,1294,703,591
050,53,025,"Washington","Grant County",1,24,1306,697,609
050,53,025,"Washington","Grant County",1,25,1377,759,618
050,53,025,"Washington","Grant County",1,26,1349,703,646
050,53,025,"Washington","Grant County",1,27,1384,703,681
050,53,025,"Washington","Grant County",1,28,1429,741,688
050,53,025,"Washington","Grant County",1,29,1433,750,683
050,53,025,"Washington","Grant County",1,30,1372,724,648
050,53,025,"Washington","Grant County",1,31,1317,660,657
050,53,025,"Washington","Grant County",1,32,1237,654,583
050,53,025,"Washington","Grant County",1,33,1214,648,566
050,53,025,"Washington","Grant County",1,34,1276,680,596
050,53,025,"Washington","Grant County",1,35,1204,629,575
050,53,025,"Washington","Grant County",1,36,1162,621,541
050,53,025,"Washington","Grant County",1,37,1210,671,539
050,53,025,"Washington","Grant County",1,38,1229,663,566
050,53,025,"Washington","Grant County",1,39,1214,646,568
050,53,025,"Washington","Grant County",1,40,1248,639,609
050,53,025,"Washington","Grant County",1,41,1142,586,556
050,53,025,"Washington","Grant County",1,42,1102,517,585
050,53,025,"Washington","Grant County",1,43,1113,544,569
050,53,025,"Washington","Grant County",1,44,1106,544,562
050,53,025,"Washington","Grant County",1,45,1120,584,536
050,53,025,"Washington","Grant County",1,46,1068,506,562
050,53,025,"Washington","Grant County",1,47,1056,525,531
050,53,025,"Washington","Grant County",1,48,1079,547,532
050,53,025,"Washington","Grant County",1,49,1154,579,575
050,53,025,"Washington","Grant County",1,50,1094,582,512
050,53,025,"Washington","Grant County",1,51,1055,560,495
050,53,025,"Washington","Grant County",1,52,1032,544,488
050,53,025,"Washington","Grant County",1,53,956,506,450
050,53,025,"Washington","Grant County",1,54,998,516,482
050,53,025,"Washington","Grant County",1,55,1063,538,525
050,53,025,"Washington","Grant County",1,56,1109,574,535
050,53,025,"Washington","Grant County",1,57,1140,620,520
050,53,025,"Washington","Grant County",1,58,1140,601,539
050,53,025,"Washington","Grant County",1,59,1130,581,549
050,53,025,"Washington","Grant County",1,60,1128,552,576
050,53,025,"Washington","Grant County",1,61,1073,546,527
050,53,025,"Washington","Grant County",1,62,1110,577,533
050,53,025,"Washington","Grant County",1,63,1046,548,498
050,53,025,"Washington","Grant County",1,64,1052,532,520
050,53,025,"Washington","Grant County",1,65,984,512,472
050,53,025,"Washington","Grant County",1,66,944,463,481
050,53,025,"Washington","Grant County",1,67,911,470,441
050,53,025,"Washington","Grant County",1,68,897,470,427
050,53,025,"Washington","Grant County",1,69,863,426,437
050,53,025,"Washington","Grant County",1,70,806,399,407
050,53,025,"Washington","Grant County",1,71,768,363,405
050,53,025,"Washington","Grant County",1,72,824,408,416
050,53,025,"Washington","Grant County",1,73,788,403,385
050,53,025,"Washington","Grant County",1,74,573,283,290
050,53,025,"Washington","Grant County",1,75,611,314,297
050,53,025,"Washington","Grant County",1,76,547,278,269
050,53,025,"Washington","Grant County",1,77,496,231,265
050,53,025,"Washington","Grant County",1,78,474,222,252
050,53,025,"Washington","Grant County",1,79,401,192,209
050,53,025,"Washington","Grant County",1,80,336,149,187
050,53,025,"Washington","Grant County",1,81,320,156,164
050,53,025,"Washington","Grant County",1,82,287,130,157
050,53,025,"Washington","Grant County",1,83,250,105,145
050,53,025,"Washington","Grant County",1,84,214,100,114
050,53,025,"Washington","Grant County",1,85,1472,575,897
050,53,025,"Washington","Grant County",2,0,1438,738,700
050,53,025,"Washington","Grant County",2,1,1438,761,677
050,53,025,"Washington","Grant County",2,2,1479,761,718
050,53,025,"Washington","Grant County",2,3,1509,776,733
050,53,025,"Washington","Grant County",2,4,1552,799,753
050,53,025,"Washington","Grant County",2,5,1539,770,769
050,53,025,"Washington","Grant County",2,6,1545,770,775
050,53,025,"Washington","Grant County",2,7,1607,811,796
050,53,025,"Washington","Grant County",2,8,1642,810,832
050,53,025,"Washington","Grant County",2,9,1699,844,855
050,53,025,"Washington","Grant County",2,10,1704,866,838
050,53,025,"Washington","Grant County",2,11,1759,909,850
050,53,025,"Washington","Grant County",2,12,1809,924,885
050,53,025,"Washington","Grant County",2,13,1766,899,867
050,53,025,"Washington","Grant County",2,14,1701,876,825
050,53,025,"Washington","Grant County",2,15,1674,851,823
050,53,025,"Washington","Grant County",2,16,1635,842,793
050,53,025,"Washington","Grant County",2,17,1634,841,793
050,53,025,"Washington","Grant County",2,18,1473,784,689
050,53,025,"Washington","Grant County",2,19,1419,767,652
050,53,025,"Washington","Grant County",2,20,1399,729,670
050,53,025,"Washington","Grant County",2,21,1333,665,668
050,53,025,"Washington","Grant County",2,22,1319,703,616
050,53,025,"Washington","Grant County",2,23,1282,689,593
050,53,025,"Washington","Grant County",2,24,1302,699,603
050,53,025,"Washington","Grant County",2,25,1369,754,615
050,53,025,"Washington","Grant County",2,26,1348,707,641
050,53,025,"Washington","Grant County",2,27,1371,701,670
050,53,025,"Washington","Grant County",2,28,1426,740,686
050,53,025,"Washington","Grant County",2,29,1437,753,684
050,53,025,"Washington","Grant County",2,30,1403,735,668
050,53,025,"Washington","Grant County",2,31,1324,671,653
050,53,025,"Washington","Grant County",2,32,1255,653,602
050,53,025,"Washington","Grant County",2,33,1222,648,574
050,53,025,"Washington","Grant County",2,34,1264,673,591
050,53,025,"Washington","Grant County",2,35,1229,647,582
050,53,025,"Washington","Grant County",2,36,1173,620,553
050,53,025,"Washington","Grant County",2,37,1204,658,546
050,53,025,"Washington","Grant County",2,38,1235,674,561
050,53,025,"Washington","Grant County",2,39,1214,645,569
050,53,025,"Washington","Grant County",2,40,1254,653,601
050,53,025,"Washington","Grant County",2,41,1168,597,571
050,53,025,"Washington","Grant County",2,42,1102,531,571
050,53,025,"Washington","Grant County",2,43,1121,542,579
050,53,025,"Washington","Grant County",2,44,1106,544,562
050,53,025,"Washington","Grant County",2,45,1124,577,547
050,53,025,"Washington","Grant County",2,46,1079,524,555
050,53,025,"Washington","Grant County",2,47,1054,516,538
050,53,025,"Washington","Grant County",2,48,1079,544,535
050,53,025,"Washington","Grant County",2,49,1150,579,571
050,53,025,"Washington","Grant County",2,50,1101,573,528
050,53,025,"Washington","Grant County",2,51,1069,573,496
050,53,025,"Washington","Grant County",2,52,1036,545,491
050,53,025,"Washington","Grant County",2,53,978,518,460
050,53,025,"Washington","Grant County",2,54,985,514,471
050,53,025,"Washington","Grant County",2,55,1050,533,517
050,53,025,"Washington","Grant County",2,56,1108,572,536
050,53,025,"Washington","Grant County",2,57,1143,613,530
050,53,025,"Washington","Grant County",2,58,1139,610,529
050,53,025,"Washington","Grant County",2,59,1134,583,551
050,53,025,"Washington","Grant County",2,60,1129,559,570
050,53,025,"Washington","Grant County",2,61,1082,547,535
050,53,025,"Washington","Grant County",2,62,1095,565,530
050,53,025,"Washington","Grant County",2,63,1074,560,514
050,53,025,"Washington","Grant County",2,64,1043,530,513
050,53,025,"Washington","Grant County",2,65,999,515,484
050,53,025,"Washington","Grant County",2,66,954,476,478
050,53,025,"Washington","Grant County",2,67,913,467,446
050,53,025,"Washington","Grant County",2,68,894,465,429
050,53,025,"Washington","Grant County",2,69,878,442,436
050,53,025,"Washington","Grant County",2,70,820,405,415
050,53,025,"Washington","Grant County",2,71,778,373,405
050,53,025,"Washington","Grant County",2,72,799,392,407
050,53,025,"Washington","Grant County",2,73,827,422,405
050,53,025,"Washington","Grant County",2,74,589,294,295
050,53,025,"Washington","Grant County",2,75,593,302,291
050,53,025,"Washington","Grant County",2,76,548,277,271
050,53,025,"Washington","Grant County",2,77,518,247,271
050,53,025,"Washington","Grant County",2,78,471,218,253
050,53,025,"Washington","Grant County",2,79,411,196,215
050,53,025,"Washington","Grant County",2,80,346,154,192
050,53,025,"Washington","Grant County",2,81,320,153,167
050,53,025,"Washington","Grant County",2,82,295,134,161
050,53,025,"Washington","Grant County",2,83,250,106,144
050,53,025,"Washington","Grant County",2,84,219,99,120
050,53,025,"Washington","Grant County",2,85,1485,573,912
050,53,025,"Washington","Grant County",3,0,1355,668,687
050,53,025,"Washington","Grant County",3,1,1454,724,730
050,53,025,"Washington","Grant County",3,2,1467,770,697
050,53,025,"Washington","Grant County",3,3,1467,755,712
050,53,025,"Washington","Grant County",3,4,1485,760,725
050,53,025,"Washington","Grant County",3,5,1577,795,782
050,53,025,"Washington","Grant County",3,6,1528,775,753
050,53,025,"Washington","Grant County",3,7,1549,781,768
050,53,025,"Washington","Grant County",3,8,1618,812,806
050,53,025,"Washington","Grant County",3,9,1654,821,833
050,53,025,"Washington","Grant County",3,10,1679,832,847
050,53,025,"Washington","Grant County",3,11,1707,858,849
050,53,025,"Washington","Grant County",3,12,1733,882,851
050,53,025,"Washington","Grant County",3,13,1802,928,874
050,53,025,"Washington","Grant County",3,14,1772,906,866
050,53,025,"Washington","Grant County",3,15,1708,872,836
050,53,025,"Washington","Grant County",3,16,1676,880,796
050,53,025,"Washington","Grant County",3,17,1717,880,837
050,53,025,"Washington","Grant County",3,18,1504,802,702
050,53,025,"Washington","Grant County",3,19,1411,768,643
050,53,025,"Washington","Grant County",3,20,1411,732,679
050,53,025,"Washington","Grant County",3,21,1344,671,673
050,53,025,"Washington","Grant County",3,22,1372,722,650
050,53,025,"Washington","Grant County",3,23,1318,679,639
050,53,025,"Washington","Grant County",3,24,1304,706,598
050,53,025,"Washington","Grant County",3,25,1307,701,606
050,53,025,"Washington","Grant County",3,26,1333,718,615
050,53,025,"Washington","Grant County",3,27,1375,724,651
050,53,025,"Washington","Grant County",3,28,1384,715,669
050,53,025,"Washington","Grant County",3,29,1421,732,689
050,53,025,"Washington","Grant County",3,30,1484,791,693
050,53,025,"Washington","Grant County",3,31,1443,742,701
050,53,025,"Washington","Grant County",3,32,1316,667,649
050,53,025,"Washington","Grant County",3,33,1287,672,615
050,53,025,"Washington","Grant County",3,34,1249,671,578
050,53,025,"Washington","Grant County",3,35,1293,686,607
050,53,025,"Washington","Grant County",3,36,1217,647,570
050,53,025,"Washington","Grant County",3,37,1183,622,561
050,53,025,"Washington","Grant County",3,38,1209,668,541
050,53,025,"Washington","Grant County",3,39,1218,664,554
050,53,025,"Washington","Grant County",3,40,1212,652,560
050,53,025,"Washington","Grant County",3,41,1297,676,621
050,53,025,"Washington","Grant County",3,42,1152,584,568
050,53,025,"Washington","Grant County",3,43,1110,540,570
050,53,025,"Washington","Grant County",3,44,1124,548,576
050,53,025,"Washington","Grant County",3,45,1110,545,565
050,53,025,"Washington","Grant County",3,46,1123,568,555
050,53,025,"Washington","Grant County",3,47,1082,526,556
050,53,025,"Washington","Grant County",3,48,1062,525,537
050,53,025,"Washington","Grant County",3,49,1107,563,544
050,53,025,"Washington","Grant County",3,50,1125,557,568
050,53,025,"Washington","Grant County",3,51,1109,589,520
050,53,025,"Washington","Grant County",3,52,1074,572,502
050,53,025,"Washington","Grant County",3,53,1053,549,504
050,53,025,"Washington","Grant County",3,54,988,518,470
050,53,025,"Washington","Grant County",3,55,998,510,488
050,53,025,"Washington","Grant County",3,56,1080,554,526
050,53,025,"Washington","Grant County",3,57,1122,579,543
050,53,025,"Washington","Grant County",3,58,1128,613,515
050,53,025,"Washington","Grant County",3,59,1129,591,538
050,53,025,"Washington","Grant County",3,60,1152,587,565
050,53,025,"Washington","Grant County",3,61,1133,553,580
050,53,025,"Washington","Grant County",3,62,1074,541,533
050,53,025,"Washington","Grant County",3,63,1103,568,535
050,53,025,"Washington","Grant County",3,64,1074,549,525
050,53,025,"Washington","Grant County",3,65,1008,512,496
050,53,025,"Washington","Grant County",3,66,994,515,479
050,53,025,"Washington","Grant County",3,67,954,486,468
050,53,025,"Washington","Grant County",3,68,892,455,437
050,53,025,"Washington","Grant County",3,69,881,460,421
050,53,025,"Washington","Grant County",3,70,879,438,441
050,53,025,"Washington","Grant County",3,71,805,394,411
050,53,025,"Washington","Grant County",3,72,776,372,404
050,53,025,"Washington","Grant County",3,73,770,379,391
050,53,025,"Washington","Grant County",3,74,819,416,403
050,53,025,"Washington","Grant County",3,75,555,273,282
050,53,025,"Washington","Grant County",3,76,567,288,279
050,53,025,"Washington","Grant County",3,77,532,259,273
050,53,025,"Washington","Grant County",3,78,505,230,275
050,53,025,"Washington","Grant County",3,79,452,219,233
050,53,025,"Washington","Grant County",3,80,393,189,204
050,53,025,"Washington","Grant County",3,81,330,153,177
050,53,025,"Washington","Grant County",3,82,299,145,154
050,53,025,"Washington","Grant County",3,83,266,120,146
050,53,025,"Washington","Grant County",3,84,227,96,131
050,53,025,"Washington","Grant County",3,85,1471,561,910
050,53,025,"Washington","Grant County",4,0,1390,706,684
050,53,025,"Washington","Grant County",4,1,1379,675,704
050,53,025,"Washington","Grant County",4,2,1474,723,751
050,53,025,"Washington","Grant County",4,3,1473,777,696
050,53,025,"Washington","Grant County",4,4,1462,763,699
050,53,025,"Washington","Grant County",4,5,1459,741,718
050,53,025,"Washington","Grant County",4,6,1592,805,787
050,53,025,"Washington","Grant County",4,7,1562,794,768
050,53,025,"Washington","Grant County",4,8,1562,779,783
050,53,025,"Washington","Grant County",4,9,1612,803,809
050,53,025,"Washington","Grant County",4,10,1636,811,825
050,53,025,"Washington","Grant County",4,11,1681,848,833
050,53,025,"Washington","Grant County",4,12,1728,862,866
050,53,025,"Washington","Grant County",4,13,1733,876,857
050,53,025,"Washington","Grant County",4,14,1828,936,892
050,53,025,"Washington","Grant County",4,15,1772,894,878
050,53,025,"Washington","Grant County",4,16,1752,909,843
050,53,025,"Washington","Grant County",4,17,1768,919,849
050,53,025,"Washington","Grant County",4,18,1573,820,753
050,53,025,"Washington","Grant County",4,19,1424,774,650
050,53,025,"Washington","Grant County",4,20,1380,737,643
050,53,025,"Washington","Grant County",4,21,1404,690,714
050,53,025,"Washington","Grant County",4,22,1380,724,656
050,53,025,"Washington","Grant County",4,23,1370,695,675
050,53,025,"Washington","Grant County",4,24,1376,712,664
050,53,025,"Washington","Grant County",4,25,1336,737,599
050,53,025,"Washington","Grant County",4,26,1275,677,598
050,53,025,"Washington","Grant County",4,27,1370,735,635
050,53,025,"Washington","Grant County",4,28,1392,715,677
050,53,025,"Washington","Grant County",4,29,1434,775,659
050,53,025,"Washington","Grant County",4,30,1483,799,684
050,53,025,"Washington","Grant County",4,31,1489,790,699
050,53,025,"Washington","Grant County",4,32,1486,762,724
050,53,025,"Washington","Grant County",4,33,1352,697,655
050,53,025,"Washington","Grant County",4,34,1294,681,613
050,53,025,"Washington","Grant County",4,35,1254,680,574
050,53,025,"Washington","Grant County",4,36,1310,693,617
050,53,025,"Washington","Grant County",4,37,1246,657,589
050,53,025,"Washington","Grant County",4,38,1196,624,572
050,53,025,"Washington","Grant County",4,39,1209,663,546
050,53,025,"Washington","Grant County",4,40,1247,676,571
050,53,025,"Washington","Grant County",4,41,1222,649,573
050,53,025,"Washington","Grant County",4,42,1283,666,617
050,53,025,"Washington","Grant County",4,43,1173,608,565
050,53,025,"Washington","Grant County",4,44,1116,548,568
050,53,025,"Washington","Grant County",4,45,1129,561,568
050,53,025,"Washington","Grant County",4,46,1114,542,572
050,53,025,"Washington","Grant County",4,47,1115,558,557
050,53,025,"Washington","Grant County",4,48,1073,528,545
050,53,025,"Washington","Grant County",4,49,1091,537,554
050,53,025,"Washington","Grant County",4,50,1099,544,555
050,53,025,"Washington","Grant County",4,51,1127,576,551
050,53,025,"Washington","Grant County",4,52,1089,578,511
050,53,025,"Washington","Grant County",4,53,1076,578,498
050,53,025,"Washington","Grant County",4,54,1058,542,516
050,53,025,"Washington","Grant County",4,55,982,511,471
050,53,025,"Washington","Grant County",4,56,988,509,479
050,53,025,"Washington","Grant County",4,57,1075,559,516
050,53,025,"Washington","Grant County",4,58,1116,593,523
050,53,025,"Washington","Grant County",4,59,1125,591,534
050,53,025,"Washington","Grant County",4,60,1119,588,531
050,53,025,"Washington","Grant County",4,61,1122,571,551
050,53,025,"Washington","Grant County",4,62,1112,544,568
050,53,025,"Washington","Grant County",4,63,1067,524,543
050,53,025,"Washington","Grant County",4,64,1106,569,537
050,53,025,"Washington","Grant County",4,65,1043,543,500
050,53,025,"Washington","Grant County",4,66,1009,508,501
050,53,025,"Washington","Grant County",4,67,992,516,476
050,53,025,"Washington","Grant County",4,68,934,461,473
050,53,025,"Washington","Grant County",4,69,871,445,426
050,53,025,"Washington","Grant County",4,70,881,457,424
050,53,025,"Washington","Grant County",4,71,855,417,438
050,53,025,"Washington","Grant County",4,72,790,381,409
050,53,025,"Washington","Grant County",4,73,759,363,396
050,53,025,"Washington","Grant County",4,74,771,384,387
050,53,025,"Washington","Grant County",4,75,776,387,389
050,53,025,"Washington","Grant County",4,76,534,257,277
050,53,025,"Washington","Grant County",4,77,546,277,269
050,53,025,"Washington","Grant County",4,78,528,249,279
050,53,025,"Washington","Grant County",4,79,481,221,260
050,53,025,"Washington","Grant County",4,80,429,206,223
050,53,025,"Washington","Grant County",4,81,366,177,189
050,53,025,"Washington","Grant County",4,82,309,143,166
050,53,025,"Washington","Grant County",4,83,266,127,139
050,53,025,"Washington","Grant County",4,84,246,108,138
050,53,025,"Washington","Grant County",4,85,1474,549,925
050,53,025,"Washington","Grant County",5,0,1351,689,662
050,53,025,"Washington","Grant County",5,1,1420,703,717
050,53,025,"Washington","Grant County",5,2,1394,685,709
050,53,025,"Washington","Grant County",5,3,1488,742,746
050,53,025,"Washington","Grant County",5,4,1441,774,667
050,53,025,"Washington","Grant County",5,5,1467,769,698
050,53,025,"Washington","Grant County",5,6,1468,743,725
050,53,025,"Washington","Grant County",5,7,1595,812,783
050,53,025,"Washington","Grant County",5,8,1574,800,774
050,53,025,"Washington","Grant County",5,9,1542,775,767
050,53,025,"Washington","Grant County",5,10,1616,804,812
050,53,025,"Washington","Grant County",5,11,1628,809,819
050,53,025,"Washington","Grant County",5,12,1689,842,847
050,53,025,"Washington","Grant County",5,13,1730,863,867
050,53,025,"Washington","Grant County",5,14,1747,885,862
050,53,025,"Washington","Grant County",5,15,1845,935,910
050,53,025,"Washington","Grant County",5,16,1776,922,854
050,53,025,"Washington","Grant County",5,17,1826,954,872
050,53,025,"Washington","Grant County",5,18,1626,856,770
050,53,025,"Washington","Grant County",5,19,1482,801,681
050,53,025,"Washington","Grant County",5,20,1413,737,676
050,53,025,"Washington","Grant County",5,21,1389,717,672
050,53,025,"Washington","Grant County",5,22,1467,755,712
050,53,025,"Washington","Grant County",5,23,1406,725,681
050,53,025,"Washington","Grant County",5,24,1372,712,660
050,53,025,"Washington","Grant County",5,25,1420,750,670
050,53,025,"Washington","Grant County",5,26,1312,709,603
050,53,025,"Washington","Grant County",5,27,1327,711,616
050,53,025,"Washington","Grant County",5,28,1381,735,646
050,53,025,"Washington","Grant County",5,29,1385,731,654
050,53,025,"Washington","Grant County",5,30,1456,778,678
050,53,025,"Washington","Grant County",5,31,1459,782,677
050,53,025,"Washington","Grant County",5,32,1481,772,709
050,53,025,"Washington","Grant County",5,33,1521,792,729
050,53,025,"Washington","Grant County",5,34,1362,699,663
050,53,025,"Washington","Grant County",5,35,1316,691,625
050,53,025,"Washington","Grant County",5,36,1257,670,587
050,53,025,"Washington","Grant County",5,37,1317,699,618
050,53,025,"Washington","Grant County",5,38,1275,679,596
050,53,025,"Washington","Grant County",5,39,1184,607,577
050,53,025,"Washington","Grant County",5,40,1245,695,550
050,53,025,"Washington","Grant County",5,41,1278,690,588
050,53,025,"Washington","Grant County",5,42,1229,655,574
050,53,025,"Washington","Grant County",5,43,1285,666,619
050,53,025,"Washington","Grant County",5,44,1167,590,577
050,53,025,"Washington","Grant County",5,45,1113,553,560
050,53,025,"Washington","Grant County",5,46,1144,553,591
050,53,025,"Washington","Grant County",5,47,1092,526,566
050,53,025,"Washington","Grant County",5,48,1126,577,549
050,53,025,"Washington","Grant County",5,49,1097,541,556
050,53,025,"Washington","Grant County",5,50,1069,516,553
050,53,025,"Washington","Grant County",5,51,1091,549,542
050,53,025,"Washington","Grant County",5,52,1144,586,558
050,53,025,"Washington","Grant County",5,53,1107,581,526
050,53,025,"Washington","Grant County",5,54,1080,577,503
050,53,025,"Washington","Grant County",5,55,1057,528,529
050,53,025,"Washington","Grant County",5,56,990,512,478
050,53,025,"Washington","Grant County",5,57,1014,521,493
050,53,025,"Washington","Grant County",5,58,1080,576,504
050,53,025,"Washington","Grant County",5,59,1120,590,530
050,53,025,"Washington","Grant County",5,60,1122,586,536
050,53,025,"Washington","Grant County",5,61,1121,596,525
050,53,025,"Washington","Grant County",5,62,1114,567,547
050,53,025,"Washington","Grant County",5,63,1117,532,585
050,53,025,"Washington","Grant County",5,64,1085,535,550
050,53,025,"Washington","Grant County",5,65,1121,577,544
050,53,025,"Washington","Grant County",5,66,1034,536,498
050,53,025,"Washington","Grant County",5,67,1014,510,504
050,53,025,"Washington","Grant County",5,68,968,496,472
050,53,025,"Washington","Grant County",5,69,908,443,465
050,53,025,"Washington","Grant County",5,70,849,429,420
050,53,025,"Washington","Grant County",5,71,849,439,410
050,53,025,"Washington","Grant County",5,72,843,408,435
050,53,025,"Washington","Grant County",5,73,769,365,404
050,53,025,"Washington","Grant County",5,74,756,363,393
050,53,025,"Washington","Grant County",5,75,727,361,366
050,53,025,"Washington","Grant County",5,76,754,373,381
050,53,025,"Washington","Grant County",5,77,517,247,270
050,53,025,"Washington","Grant County",5,78,522,254,268
050,53,025,"Washington","Grant County",5,79,494,238,256
050,53,025,"Washington","Grant County",5,80,456,208,248
050,53,025,"Washington","Grant County",5,81,401,194,207
050,53,025,"Washington","Grant County",5,82,356,171,185
050,53,025,"Washington","Grant County",5,83,284,129,155
050,53,025,"Washington","Grant County",5,84,249,119,130
050,53,025,"Washington","Grant County",5,85,1515,554,961
050,53,027,"Washington","Grays Harbor County",1,0,729,373,356
050,53,027,"Washington","Grays Harbor County",1,1,747,382,365
050,53,027,"Washington","Grays Harbor County",1,2,759,387,372
050,53,027,"Washington","Grays Harbor County",1,3,789,393,396
050,53,027,"Washington","Grays Harbor County",1,4,844,410,434
050,53,027,"Washington","Grays Harbor County",1,5,832,417,415
050,53,027,"Washington","Grays Harbor County",1,6,832,420,412
050,53,027,"Washington","Grays Harbor County",1,7,842,442,400
050,53,027,"Washington","Grays Harbor County",1,8,867,464,403
050,53,027,"Washington","Grays Harbor County",1,9,910,464,446
050,53,027,"Washington","Grays Harbor County",1,10,922,480,442
050,53,027,"Washington","Grays Harbor County",1,11,925,465,460
050,53,027,"Washington","Grays Harbor County",1,12,972,473,499
050,53,027,"Washington","Grays Harbor County",1,13,905,442,463
050,53,027,"Washington","Grays Harbor County",1,14,909,478,431
050,53,027,"Washington","Grays Harbor County",1,15,890,463,427
050,53,027,"Washington","Grays Harbor County",1,16,866,433,433
050,53,027,"Washington","Grays Harbor County",1,17,882,446,436
050,53,027,"Washington","Grays Harbor County",1,18,746,375,371
050,53,027,"Washington","Grays Harbor County",1,19,614,333,281
050,53,027,"Washington","Grays Harbor County",1,20,716,408,308
050,53,027,"Washington","Grays Harbor County",1,21,763,435,328
050,53,027,"Washington","Grays Harbor County",1,22,747,415,332
050,53,027,"Washington","Grays Harbor County",1,23,790,430,360
050,53,027,"Washington","Grays Harbor County",1,24,793,439,354
050,53,027,"Washington","Grays Harbor County",1,25,769,432,337
050,53,027,"Washington","Grays Harbor County",1,26,803,432,371
050,53,027,"Washington","Grays Harbor County",1,27,828,451,377
050,53,027,"Washington","Grays Harbor County",1,28,921,516,405
050,53,027,"Washington","Grays Harbor County",1,29,954,532,422
050,53,027,"Washington","Grays Harbor County",1,30,977,529,448
050,53,027,"Washington","Grays Harbor County",1,31,889,481,408
050,53,027,"Washington","Grays Harbor County",1,32,876,459,417
050,53,027,"Washington","Grays Harbor County",1,33,901,476,425
050,53,027,"Washington","Grays Harbor County",1,34,920,502,418
050,53,027,"Washington","Grays Harbor County",1,35,878,486,392
050,53,027,"Washington","Grays Harbor County",1,36,860,468,392
050,53,027,"Washington","Grays Harbor County",1,37,918,486,432
050,53,027,"Washington","Grays Harbor County",1,38,903,491,412
050,53,027,"Washington","Grays Harbor County",1,39,888,458,430
050,53,027,"Washington","Grays Harbor County",1,40,951,497,454
050,53,027,"Washington","Grays Harbor County",1,41,935,500,435
050,53,027,"Washington","Grays Harbor County",1,42,886,455,431
050,53,027,"Washington","Grays Harbor County",1,43,841,479,362
050,53,027,"Washington","Grays Harbor County",1,44,856,474,382
050,53,027,"Washington","Grays Harbor County",1,45,863,484,379
050,53,027,"Washington","Grays Harbor County",1,46,799,454,345
050,53,027,"Washington","Grays Harbor County",1,47,820,447,373
050,53,027,"Washington","Grays Harbor County",1,48,880,468,412
050,53,027,"Washington","Grays Harbor County",1,49,967,507,460
050,53,027,"Washington","Grays Harbor County",1,50,903,467,436
050,53,027,"Washington","Grays Harbor County",1,51,935,495,440
050,53,027,"Washington","Grays Harbor County",1,52,910,495,415
050,53,027,"Washington","Grays Harbor County",1,53,928,481,447
050,53,027,"Washington","Grays Harbor County",1,54,951,488,463
050,53,027,"Washington","Grays Harbor County",1,55,1008,517,491
050,53,027,"Washington","Grays Harbor County",1,56,1017,496,521
050,53,027,"Washington","Grays Harbor County",1,57,1085,533,552
050,53,027,"Washington","Grays Harbor County",1,58,1124,575,549
050,53,027,"Washington","Grays Harbor County",1,59,1184,580,604
050,53,027,"Washington","Grays Harbor County",1,60,1177,584,593
050,53,027,"Washington","Grays Harbor County",1,61,1170,569,601
050,53,027,"Washington","Grays Harbor County",1,62,1233,591,642
050,53,027,"Washington","Grays Harbor County",1,63,1287,664,623
050,53,027,"Washington","Grays Harbor County",1,64,1246,588,658
050,53,027,"Washington","Grays Harbor County",1,65,1258,614,644
050,53,027,"Washington","Grays Harbor County",1,66,1273,619,654
050,53,027,"Washington","Grays Harbor County",1,67,1231,583,648
050,53,027,"Washington","Grays Harbor County",1,68,1166,579,587
050,53,027,"Washington","Grays Harbor County",1,69,1082,556,526
050,53,027,"Washington","Grays Harbor County",1,70,1058,534,524
050,53,027,"Washington","Grays Harbor County",1,71,1049,514,535
050,53,027,"Washington","Grays Harbor County",1,72,1031,502,529
050,53,027,"Washington","Grays Harbor County",1,73,972,476,496
050,53,027,"Washington","Grays Harbor County",1,74,673,327,346
050,53,027,"Washington","Grays Harbor County",1,75,669,343,326
050,53,027,"Washington","Grays Harbor County",1,76,649,321,328
050,53,027,"Washington","Grays Harbor County",1,77,620,305,315
050,53,027,"Washington","Grays Harbor County",1,78,529,280,249
050,53,027,"Washington","Grays Harbor County",1,79,460,235,225
050,53,027,"Washington","Grays Harbor County",1,80,398,199,199
050,53,027,"Washington","Grays Harbor County",1,81,376,182,194
050,53,027,"Washington","Grays Harbor County",1,82,339,150,189
050,53,027,"Washington","Grays Harbor County",1,83,322,149,173
050,53,027,"Washington","Grays Harbor County",1,84,242,94,148
050,53,027,"Washington","Grays Harbor County",1,85,1405,582,823
050,53,027,"Washington","Grays Harbor County",2,0,729,379,350
050,53,027,"Washington","Grays Harbor County",2,1,748,383,365
050,53,027,"Washington","Grays Harbor County",2,2,759,387,372
050,53,027,"Washington","Grays Harbor County",2,3,783,391,392
050,53,027,"Washington","Grays Harbor County",2,4,836,410,426
050,53,027,"Washington","Grays Harbor County",2,5,841,419,422
050,53,027,"Washington","Grays Harbor County",2,6,834,422,412
050,53,027,"Washington","Grays Harbor County",2,7,837,437,400
050,53,027,"Washington","Grays Harbor County",2,8,858,456,402
050,53,027,"Washington","Grays Harbor County",2,9,902,466,436
050,53,027,"Washington","Grays Harbor County",2,10,918,476,442
050,53,027,"Washington","Grays Harbor County",2,11,923,467,456
050,53,027,"Washington","Grays Harbor County",2,12,967,474,493
050,53,027,"Washington","Grays Harbor County",2,13,922,453,469
050,53,027,"Washington","Grays Harbor County",2,14,910,469,441
050,53,027,"Washington","Grays Harbor County",2,15,895,467,428
050,53,027,"Washington","Grays Harbor County",2,16,869,440,429
050,53,027,"Washington","Grays Harbor County",2,17,884,447,437
050,53,027,"Washington","Grays Harbor County",2,18,749,379,370
050,53,027,"Washington","Grays Harbor County",2,19,626,338,288
050,53,027,"Washington","Grays Harbor County",2,20,713,404,309
050,53,027,"Washington","Grays Harbor County",2,21,758,432,326
050,53,027,"Washington","Grays Harbor County",2,22,755,419,336
050,53,027,"Washington","Grays Harbor County",2,23,793,433,360
050,53,027,"Washington","Grays Harbor County",2,24,787,434,353
050,53,027,"Washington","Grays Harbor County",2,25,783,440,343
050,53,027,"Washington","Grays Harbor County",2,26,796,429,367
050,53,027,"Washington","Grays Harbor County",2,27,825,452,373
050,53,027,"Washington","Grays Harbor County",2,28,908,508,400
050,53,027,"Washington","Grays Harbor County",2,29,950,524,426
050,53,027,"Washington","Grays Harbor County",2,30,991,541,450
050,53,027,"Washington","Grays Harbor County",2,31,904,488,416
050,53,027,"Washington","Grays Harbor County",2,32,883,465,418
050,53,027,"Washington","Grays Harbor County",2,33,898,473,425
050,53,027,"Washington","Grays Harbor County",2,34,923,500,423
050,53,027,"Washington","Grays Harbor County",2,35,894,493,401
050,53,027,"Washington","Grays Harbor County",2,36,855,462,393
050,53,027,"Washington","Grays Harbor County",2,37,907,480,427
050,53,027,"Washington","Grays Harbor County",2,38,921,501,420
050,53,027,"Washington","Grays Harbor County",2,39,891,461,430
050,53,027,"Washington","Grays Harbor County",2,40,946,494,452
050,53,027,"Washington","Grays Harbor County",2,41,946,506,440
050,53,027,"Washington","Grays Harbor County",2,42,896,465,431
050,53,027,"Washington","Grays Harbor County",2,43,864,478,386
050,53,027,"Washington","Grays Harbor County",2,44,857,479,378
050,53,027,"Washington","Grays Harbor County",2,45,871,491,380
050,53,027,"Washington","Grays Harbor County",2,46,813,458,355
050,53,027,"Washington","Grays Harbor County",2,47,811,444,367
050,53,027,"Washington","Grays Harbor County",2,48,868,465,403
050,53,027,"Washington","Grays Harbor County",2,49,952,500,452
050,53,027,"Washington","Grays Harbor County",2,50,926,478,448
050,53,027,"Washington","Grays Harbor County",2,51,932,490,442
050,53,027,"Washington","Grays Harbor County",2,52,912,494,418
050,53,027,"Washington","Grays Harbor County",2,53,932,486,446
050,53,027,"Washington","Grays Harbor County",2,54,943,485,458
050,53,027,"Washington","Grays Harbor County",2,55,999,512,487
050,53,027,"Washington","Grays Harbor County",2,56,1021,501,520
050,53,027,"Washington","Grays Harbor County",2,57,1076,526,550
050,53,027,"Washington","Grays Harbor County",2,58,1123,570,553
050,53,027,"Washington","Grays Harbor County",2,59,1172,580,592
050,53,027,"Washington","Grays Harbor County",2,60,1178,582,596
050,53,027,"Washington","Grays Harbor County",2,61,1158,561,597
050,53,027,"Washington","Grays Harbor County",2,62,1219,587,632
050,53,027,"Washington","Grays Harbor County",2,63,1293,655,638
050,53,027,"Washington","Grays Harbor County",2,64,1252,603,649
050,53,027,"Washington","Grays Harbor County",2,65,1254,608,646
050,53,027,"Washington","Grays Harbor County",2,66,1280,620,660
050,53,027,"Washington","Grays Harbor County",2,67,1239,592,647
050,53,027,"Washington","Grays Harbor County",2,68,1175,576,599
050,53,027,"Washington","Grays Harbor County",2,69,1116,567,549
050,53,027,"Washington","Grays Harbor County",2,70,1063,538,525
050,53,027,"Washington","Grays Harbor County",2,71,1055,520,535
050,53,027,"Washington","Grays Harbor County",2,72,1017,499,518
050,53,027,"Washington","Grays Harbor County",2,73,1034,510,524
050,53,027,"Washington","Grays Harbor County",2,74,703,342,361
050,53,027,"Washington","Grays Harbor County",2,75,668,338,330
050,53,027,"Washington","Grays Harbor County",2,76,643,320,323
050,53,027,"Washington","Grays Harbor County",2,77,636,314,322
050,53,027,"Washington","Grays Harbor County",2,78,527,267,260
050,53,027,"Washington","Grays Harbor County",2,79,467,240,227
050,53,027,"Washington","Grays Harbor County",2,80,401,199,202
050,53,027,"Washington","Grays Harbor County",2,81,372,183,189
050,53,027,"Washington","Grays Harbor County",2,82,344,155,189
050,53,027,"Washington","Grays Harbor County",2,83,317,144,173
050,53,027,"Washington","Grays Harbor County",2,84,250,99,151
050,53,027,"Washington","Grays Harbor County",2,85,1409,581,828
050,53,027,"Washington","Grays Harbor County",3,0,679,345,334
050,53,027,"Washington","Grays Harbor County",3,1,754,373,381
050,53,027,"Washington","Grays Harbor County",3,2,762,380,382
050,53,027,"Washington","Grays Harbor County",3,3,777,397,380
050,53,027,"Washington","Grays Harbor County",3,4,808,405,403
050,53,027,"Washington","Grays Harbor County",3,5,855,423,432
050,53,027,"Washington","Grays Harbor County",3,6,867,430,437
050,53,027,"Washington","Grays Harbor County",3,7,844,431,413
050,53,027,"Washington","Grays Harbor County",3,8,852,447,405
050,53,027,"Washington","Grays Harbor County",3,9,889,464,425
050,53,027,"Washington","Grays Harbor County",3,10,921,480,441
050,53,027,"Washington","Grays Harbor County",3,11,918,470,448
050,53,027,"Washington","Grays Harbor County",3,12,924,464,460
050,53,027,"Washington","Grays Harbor County",3,13,959,482,477
050,53,027,"Washington","Grays Harbor County",3,14,927,462,465
050,53,027,"Washington","Grays Harbor County",3,15,935,481,454
050,53,027,"Washington","Grays Harbor County",3,16,896,471,425
050,53,027,"Washington","Grays Harbor County",3,17,880,443,437
050,53,027,"Washington","Grays Harbor County",3,18,783,409,374
050,53,027,"Washington","Grays Harbor County",3,19,619,320,299
050,53,027,"Washington","Grays Harbor County",3,20,666,365,301
050,53,027,"Washington","Grays Harbor County",3,21,737,407,330
050,53,027,"Washington","Grays Harbor County",3,22,783,423,360
050,53,027,"Washington","Grays Harbor County",3,23,819,473,346
050,53,027,"Washington","Grays Harbor County",3,24,791,425,366
050,53,027,"Washington","Grays Harbor County",3,25,796,445,351
050,53,027,"Washington","Grays Harbor County",3,26,781,425,356
050,53,027,"Washington","Grays Harbor County",3,27,817,446,371
050,53,027,"Washington","Grays Harbor County",3,28,849,466,383
050,53,027,"Washington","Grays Harbor County",3,29,903,490,413
050,53,027,"Washington","Grays Harbor County",3,30,1001,568,433
050,53,027,"Washington","Grays Harbor County",3,31,964,530,434
050,53,027,"Washington","Grays Harbor County",3,32,941,498,443
050,53,027,"Washington","Grays Harbor County",3,33,901,468,433
050,53,027,"Washington","Grays Harbor County",3,34,941,487,454
050,53,027,"Washington","Grays Harbor County",3,35,955,521,434
050,53,027,"Washington","Grays Harbor County",3,36,922,498,424
050,53,027,"Washington","Grays Harbor County",3,37,875,471,404
050,53,027,"Washington","Grays Harbor County",3,38,971,533,438
050,53,027,"Washington","Grays Harbor County",3,39,904,474,430
050,53,027,"Washington","Grays Harbor County",3,40,897,457,440
050,53,027,"Washington","Grays Harbor County",3,41,967,508,459
050,53,027,"Washington","Grays Harbor County",3,42,928,484,444
050,53,027,"Washington","Grays Harbor County",3,43,914,470,444
050,53,027,"Washington","Grays Harbor County",3,44,883,486,397
050,53,027,"Washington","Grays Harbor County",3,45,868,494,374
050,53,027,"Washington","Grays Harbor County",3,46,866,484,382
050,53,027,"Washington","Grays Harbor County",3,47,792,437,355
050,53,027,"Washington","Grays Harbor County",3,48,811,433,378
050,53,027,"Washington","Grays Harbor County",3,49,876,469,407
050,53,027,"Washington","Grays Harbor County",3,50,969,512,457
050,53,027,"Washington","Grays Harbor County",3,51,950,488,462
050,53,027,"Washington","Grays Harbor County",3,52,948,503,445
050,53,027,"Washington","Grays Harbor County",3,53,923,497,426
050,53,027,"Washington","Grays Harbor County",3,54,914,466,448
050,53,027,"Washington","Grays Harbor County",3,55,989,514,475
050,53,027,"Washington","Grays Harbor County",3,56,1014,512,502
050,53,027,"Washington","Grays Harbor County",3,57,1071,518,553
050,53,027,"Washington","Grays Harbor County",3,58,1125,566,559
050,53,027,"Washington","Grays Harbor County",3,59,1145,603,542
050,53,027,"Washington","Grays Harbor County",3,60,1219,598,621
050,53,027,"Washington","Grays Harbor County",3,61,1188,586,602
050,53,027,"Washington","Grays Harbor County",3,62,1205,584,621
050,53,027,"Washington","Grays Harbor County",3,63,1264,608,656
050,53,027,"Washington","Grays Harbor County",3,64,1302,645,657
050,53,027,"Washington","Grays Harbor County",3,65,1254,609,645
050,53,027,"Washington","Grays Harbor County",3,66,1292,628,664
050,53,027,"Washington","Grays Harbor County",3,67,1283,620,663
050,53,027,"Washington","Grays Harbor County",3,68,1208,574,634
050,53,027,"Washington","Grays Harbor County",3,69,1179,575,604
050,53,027,"Washington","Grays Harbor County",3,70,1107,569,538
050,53,027,"Washington","Grays Harbor County",3,71,1027,521,506
050,53,027,"Washington","Grays Harbor County",3,72,1046,518,528
050,53,027,"Washington","Grays Harbor County",3,73,985,469,516
050,53,027,"Washington","Grays Harbor County",3,74,1003,490,513
050,53,027,"Washington","Grays Harbor County",3,75,703,341,362
050,53,027,"Washington","Grays Harbor County",3,76,644,326,318
050,53,027,"Washington","Grays Harbor County",3,77,630,313,317
050,53,027,"Washington","Grays Harbor County",3,78,595,283,312
050,53,027,"Washington","Grays Harbor County",3,79,499,240,259
050,53,027,"Washington","Grays Harbor County",3,80,433,223,210
050,53,027,"Washington","Grays Harbor County",3,81,376,185,191
050,53,027,"Washington","Grays Harbor County",3,82,338,169,169
050,53,027,"Washington","Grays Harbor County",3,83,325,152,173
050,53,027,"Washington","Grays Harbor County",3,84,299,131,168
050,53,027,"Washington","Grays Harbor County",3,85,1418,574,844
050,53,027,"Washington","Grays Harbor County",4,0,682,327,355
050,53,027,"Washington","Grays Harbor County",4,1,688,350,338
050,53,027,"Washington","Grays Harbor County",4,2,770,385,385
050,53,027,"Washington","Grays Harbor County",4,3,746,370,376
050,53,027,"Washington","Grays Harbor County",4,4,767,392,375
050,53,027,"Washington","Grays Harbor County",4,5,816,404,412
050,53,027,"Washington","Grays Harbor County",4,6,847,411,436
050,53,027,"Washington","Grays Harbor County",4,7,857,433,424
050,53,027,"Washington","Grays Harbor County",4,8,849,430,419
050,53,027,"Washington","Grays Harbor County",4,9,869,450,419
050,53,027,"Washington","Grays Harbor County",4,10,895,464,431
050,53,027,"Washington","Grays Harbor County",4,11,920,473,447
050,53,027,"Washington","Grays Harbor County",4,12,932,480,452
050,53,027,"Washington","Grays Harbor County",4,13,941,480,461
050,53,027,"Washington","Grays Harbor County",4,14,942,468,474
050,53,027,"Washington","Grays Harbor County",4,15,956,473,483
050,53,027,"Washington","Grays Harbor County",4,16,934,474,460
050,53,027,"Washington","Grays Harbor County",4,17,906,490,416
050,53,027,"Washington","Grays Harbor County",4,18,762,380,382
050,53,027,"Washington","Grays Harbor County",4,19,636,355,281
050,53,027,"Washington","Grays Harbor County",4,20,674,350,324
050,53,027,"Washington","Grays Harbor County",4,21,685,380,305
050,53,027,"Washington","Grays Harbor County",4,22,740,411,329
050,53,027,"Washington","Grays Harbor County",4,23,844,463,381
050,53,027,"Washington","Grays Harbor County",4,24,825,470,355
050,53,027,"Washington","Grays Harbor County",4,25,818,450,368
050,53,027,"Washington","Grays Harbor County",4,26,810,446,364
050,53,027,"Washington","Grays Harbor County",4,27,821,450,371
050,53,027,"Washington","Grays Harbor County",4,28,850,466,384
050,53,027,"Washington","Grays Harbor County",4,29,832,449,383
050,53,027,"Washington","Grays Harbor County",4,30,960,534,426
050,53,027,"Washington","Grays Harbor County",4,31,974,540,434
050,53,027,"Washington","Grays Harbor County",4,32,946,508,438
050,53,027,"Washington","Grays Harbor County",4,33,953,494,459
050,53,027,"Washington","Grays Harbor County",4,34,947,493,454
050,53,027,"Washington","Grays Harbor County",4,35,947,500,447
050,53,027,"Washington","Grays Harbor County",4,36,960,512,448
050,53,027,"Washington","Grays Harbor County",4,37,933,505,428
050,53,027,"Washington","Grays Harbor County",4,38,938,524,414
050,53,027,"Washington","Grays Harbor County",4,39,951,508,443
050,53,027,"Washington","Grays Harbor County",4,40,902,482,420
050,53,027,"Washington","Grays Harbor County",4,41,917,481,436
050,53,027,"Washington","Grays Harbor County",4,42,956,484,472
050,53,027,"Washington","Grays Harbor County",4,43,941,485,456
050,53,027,"Washington","Grays Harbor County",4,44,935,487,448
050,53,027,"Washington","Grays Harbor County",4,45,901,499,402
050,53,027,"Washington","Grays Harbor County",4,46,846,465,381
050,53,027,"Washington","Grays Harbor County",4,47,858,474,384
050,53,027,"Washington","Grays Harbor County",4,48,810,444,366
050,53,027,"Washington","Grays Harbor County",4,49,823,429,394
050,53,027,"Washington","Grays Harbor County",4,50,871,463,408
050,53,027,"Washington","Grays Harbor County",4,51,977,524,453
050,53,027,"Washington","Grays Harbor County",4,52,951,491,460
050,53,027,"Washington","Grays Harbor County",4,53,952,497,455
050,53,027,"Washington","Grays Harbor County",4,54,917,478,439
050,53,027,"Washington","Grays Harbor County",4,55,934,481,453
050,53,027,"Washington","Grays Harbor County",4,56,1000,517,483
050,53,027,"Washington","Grays Harbor County",4,57,1015,498,517
050,53,027,"Washington","Grays Harbor County",4,58,1054,518,536
050,53,027,"Washington","Grays Harbor County",4,59,1119,558,561
050,53,027,"Washington","Grays Harbor County",4,60,1155,589,566
050,53,027,"Washington","Grays Harbor County",4,61,1193,585,608
050,53,027,"Washington","Grays Harbor County",4,62,1196,589,607
050,53,027,"Washington","Grays Harbor County",4,63,1235,604,631
050,53,027,"Washington","Grays Harbor County",4,64,1283,611,672
050,53,027,"Washington","Grays Harbor County",4,65,1269,619,650
050,53,027,"Washington","Grays Harbor County",4,66,1257,609,648
050,53,027,"Washington","Grays Harbor County",4,67,1279,623,656
050,53,027,"Washington","Grays Harbor County",4,68,1279,611,668
050,53,027,"Washington","Grays Harbor County",4,69,1212,578,634
050,53,027,"Washington","Grays Harbor County",4,70,1162,567,595
050,53,027,"Washington","Grays Harbor County",4,71,1084,554,530
050,53,027,"Washington","Grays Harbor County",4,72,1000,506,494
050,53,027,"Washington","Grays Harbor County",4,73,999,499,500
050,53,027,"Washington","Grays Harbor County",4,74,947,442,505
050,53,027,"Washington","Grays Harbor County",4,75,968,470,498
050,53,027,"Washington","Grays Harbor County",4,76,674,324,350
050,53,027,"Washington","Grays Harbor County",4,77,617,315,302
050,53,027,"Washington","Grays Harbor County",4,78,579,278,301
050,53,027,"Washington","Grays Harbor County",4,79,567,259,308
050,53,027,"Washington","Grays Harbor County",4,80,462,221,241
050,53,027,"Washington","Grays Harbor County",4,81,411,205,206
050,53,027,"Washington","Grays Harbor County",4,82,349,172,177
050,53,027,"Washington","Grays Harbor County",4,83,299,156,143
050,53,027,"Washington","Grays Harbor County",4,84,286,132,154
050,53,027,"Washington","Grays Harbor County",4,85,1477,611,866
050,53,027,"Washington","Grays Harbor County",5,0,672,327,345
050,53,027,"Washington","Grays Harbor County",5,1,713,344,369
050,53,027,"Washington","Grays Harbor County",5,2,705,354,351
050,53,027,"Washington","Grays Harbor County",5,3,764,375,389
050,53,027,"Washington","Grays Harbor County",5,4,755,388,367
050,53,027,"Washington","Grays Harbor County",5,5,797,401,396
050,53,027,"Washington","Grays Harbor County",5,6,801,395,406
050,53,027,"Washington","Grays Harbor County",5,7,869,429,440
050,53,027,"Washington","Grays Harbor County",5,8,883,445,438
050,53,027,"Washington","Grays Harbor County",5,9,868,451,417
050,53,027,"Washington","Grays Harbor County",5,10,876,449,427
050,53,027,"Washington","Grays Harbor County",5,11,900,466,434
050,53,027,"Washington","Grays Harbor County",5,12,924,470,454
050,53,027,"Washington","Grays Harbor County",5,13,940,484,456
050,53,027,"Washington","Grays Harbor County",5,14,929,480,449
050,53,027,"Washington","Grays Harbor County",5,15,944,464,480
050,53,027,"Washington","Grays Harbor County",5,16,960,466,494
050,53,027,"Washington","Grays Harbor County",5,17,920,467,453
050,53,027,"Washington","Grays Harbor County",5,18,784,432,352
050,53,027,"Washington","Grays Harbor County",5,19,635,332,303
050,53,027,"Washington","Grays Harbor County",5,20,708,400,308
050,53,027,"Washington","Grays Harbor County",5,21,697,366,331
050,53,027,"Washington","Grays Harbor County",5,22,694,378,316
050,53,027,"Washington","Grays Harbor County",5,23,805,451,354
050,53,027,"Washington","Grays Harbor County",5,24,836,462,374
050,53,027,"Washington","Grays Harbor County",5,25,847,484,363
050,53,027,"Washington","Grays Harbor County",5,26,843,456,387
050,53,027,"Washington","Grays Harbor County",5,27,830,457,373
050,53,027,"Washington","Grays Harbor County",5,28,832,458,374
050,53,027,"Washington","Grays Harbor County",5,29,864,470,394
050,53,027,"Washington","Grays Harbor County",5,30,872,480,392
050,53,027,"Washington","Grays Harbor County",5,31,971,544,427
050,53,027,"Washington","Grays Harbor County",5,32,988,543,445
050,53,027,"Washington","Grays Harbor County",5,33,982,523,459
050,53,027,"Washington","Grays Harbor County",5,34,1004,516,488
050,53,027,"Washington","Grays Harbor County",5,35,949,491,458
050,53,027,"Washington","Grays Harbor County",5,36,955,497,458
050,53,027,"Washington","Grays Harbor County",5,37,973,519,454
050,53,027,"Washington","Grays Harbor County",5,38,985,549,436
050,53,027,"Washington","Grays Harbor County",5,39,908,498,410
050,53,027,"Washington","Grays Harbor County",5,40,945,514,431
050,53,027,"Washington","Grays Harbor County",5,41,921,500,421
050,53,027,"Washington","Grays Harbor County",5,42,892,453,439
050,53,027,"Washington","Grays Harbor County",5,43,967,485,482
050,53,027,"Washington","Grays Harbor County",5,44,962,496,466
050,53,027,"Washington","Grays Harbor County",5,45,948,505,443
050,53,027,"Washington","Grays Harbor County",5,46,892,484,408
050,53,027,"Washington","Grays Harbor County",5,47,833,451,382
050,53,027,"Washington","Grays Harbor County",5,48,878,484,394
050,53,027,"Washington","Grays Harbor County",5,49,813,440,373
050,53,027,"Washington","Grays Harbor County",5,50,831,426,405
050,53,027,"Washington","Grays Harbor County",5,51,885,471,414
050,53,027,"Washington","Grays Harbor County",5,52,993,534,459
050,53,027,"Washington","Grays Harbor County",5,53,956,484,472
050,53,027,"Washington","Grays Harbor County",5,54,941,491,450
050,53,027,"Washington","Grays Harbor County",5,55,934,480,454
050,53,027,"Washington","Grays Harbor County",5,56,918,459,459
050,53,027,"Washington","Grays Harbor County",5,57,977,502,475
050,53,027,"Washington","Grays Harbor County",5,58,991,485,506
050,53,027,"Washington","Grays Harbor County",5,59,1084,526,558
050,53,027,"Washington","Grays Harbor County",5,60,1128,568,560
050,53,027,"Washington","Grays Harbor County",5,61,1158,567,591
050,53,027,"Washington","Grays Harbor County",5,62,1201,592,609
050,53,027,"Washington","Grays Harbor County",5,63,1225,608,617
050,53,027,"Washington","Grays Harbor County",5,64,1226,586,640
050,53,027,"Washington","Grays Harbor County",5,65,1269,596,673
050,53,027,"Washington","Grays Harbor County",5,66,1267,621,646
050,53,027,"Washington","Grays Harbor County",5,67,1251,603,648
050,53,027,"Washington","Grays Harbor County",5,68,1251,604,647
050,53,027,"Washington","Grays Harbor County",5,69,1277,615,662
050,53,027,"Washington","Grays Harbor County",5,70,1167,554,613
050,53,027,"Washington","Grays Harbor County",5,71,1126,547,579
050,53,027,"Washington","Grays Harbor County",5,72,1049,530,519
050,53,027,"Washington","Grays Harbor County",5,73,970,492,478
050,53,027,"Washington","Grays Harbor County",5,74,967,473,494
050,53,027,"Washington","Grays Harbor County",5,75,899,418,481
050,53,027,"Washington","Grays Harbor County",5,76,918,445,473
050,53,027,"Washington","Grays Harbor County",5,77,651,319,332
050,53,027,"Washington","Grays Harbor County",5,78,575,288,287
050,53,027,"Washington","Grays Harbor County",5,79,540,253,287
050,53,027,"Washington","Grays Harbor County",5,80,531,241,290
050,53,027,"Washington","Grays Harbor County",5,81,429,204,225
050,53,027,"Washington","Grays Harbor County",5,82,378,186,192
050,53,027,"Washington","Grays Harbor County",5,83,307,154,153
050,53,027,"Washington","Grays Harbor County",5,84,267,134,133
050,53,027,"Washington","Grays Harbor County",5,85,1520,645,875
050,53,029,"Washington","Island County",1,0,895,456,439
050,53,029,"Washington","Island County",1,1,884,448,436
050,53,029,"Washington","Island County",1,2,891,450,441
050,53,029,"Washington","Island County",1,3,1007,514,493
050,53,029,"Washington","Island County",1,4,984,469,515
050,53,029,"Washington","Island County",1,5,967,498,469
050,53,029,"Washington","Island County",1,6,928,497,431
050,53,029,"Washington","Island County",1,7,914,477,437
050,53,029,"Washington","Island County",1,8,898,464,434
050,53,029,"Washington","Island County",1,9,888,448,440
050,53,029,"Washington","Island County",1,10,861,447,414
050,53,029,"Washington","Island County",1,11,837,425,412
050,53,029,"Washington","Island County",1,12,866,431,435
050,53,029,"Washington","Island County",1,13,852,430,422
050,53,029,"Washington","Island County",1,14,798,408,390
050,53,029,"Washington","Island County",1,15,789,387,402
050,53,029,"Washington","Island County",1,16,769,381,388
050,53,029,"Washington","Island County",1,17,812,408,404
050,53,029,"Washington","Island County",1,18,717,391,326
050,53,029,"Washington","Island County",1,19,785,468,317
050,53,029,"Washington","Island County",1,20,1003,605,398
050,53,029,"Washington","Island County",1,21,1071,621,450
050,53,029,"Washington","Island County",1,22,1184,672,512
050,53,029,"Washington","Island County",1,23,1200,675,525
050,53,029,"Washington","Island County",1,24,1144,624,520
050,53,029,"Washington","Island County",1,25,1234,659,575
050,53,029,"Washington","Island County",1,26,1295,697,598
050,53,029,"Washington","Island County",1,27,1271,690,581
050,53,029,"Washington","Island County",1,28,1267,701,566
050,53,029,"Washington","Island County",1,29,1242,681,561
050,53,029,"Washington","Island County",1,30,1213,675,538
050,53,029,"Washington","Island County",1,31,1112,590,522
050,53,029,"Washington","Island County",1,32,1162,614,548
050,53,029,"Washington","Island County",1,33,1152,617,535
050,53,029,"Washington","Island County",1,34,1153,604,549
050,53,029,"Washington","Island County",1,35,1092,571,521
050,53,029,"Washington","Island County",1,36,1065,562,503
050,53,029,"Washington","Island County",1,37,1080,558,522
050,53,029,"Washington","Island County",1,38,1035,533,502
050,53,029,"Washington","Island County",1,39,1014,538,476
050,53,029,"Washington","Island County",1,40,910,479,431
050,53,029,"Washington","Island County",1,41,893,470,423
050,53,029,"Washington","Island County",1,42,828,412,416
050,53,029,"Washington","Island County",1,43,758,376,382
050,53,029,"Washington","Island County",1,44,775,365,410
050,53,029,"Washington","Island County",1,45,779,403,376
050,53,029,"Washington","Island County",1,46,733,375,358
050,53,029,"Washington","Island County",1,47,741,376,365
050,53,029,"Washington","Island County",1,48,797,393,404
050,53,029,"Washington","Island County",1,49,883,424,459
050,53,029,"Washington","Island County",1,50,869,426,443
050,53,029,"Washington","Island County",1,51,899,443,456
050,53,029,"Washington","Island County",1,52,865,421,444
050,53,029,"Washington","Island County",1,53,878,428,450
050,53,029,"Washington","Island County",1,54,924,430,494
050,53,029,"Washington","Island County",1,55,1032,481,551
050,53,029,"Washington","Island County",1,56,1128,544,584
050,53,029,"Washington","Island County",1,57,1148,576,572
050,53,029,"Washington","Island County",1,58,1160,541,619
050,53,029,"Washington","Island County",1,59,1168,548,620
050,53,029,"Washington","Island County",1,60,1195,573,622
050,53,029,"Washington","Island County",1,61,1258,586,672
050,53,029,"Washington","Island County",1,62,1318,607,711
050,53,029,"Washington","Island County",1,63,1381,602,779
050,53,029,"Washington","Island County",1,64,1362,628,734
050,53,029,"Washington","Island County",1,65,1414,662,752
050,53,029,"Washington","Island County",1,66,1462,671,791
050,53,029,"Washington","Island County",1,67,1547,708,839
050,53,029,"Washington","Island County",1,68,1460,686,774
050,53,029,"Washington","Island County",1,69,1336,623,713
050,53,029,"Washington","Island County",1,70,1317,636,681
050,53,029,"Washington","Island County",1,71,1332,636,696
050,53,029,"Washington","Island County",1,72,1369,683,686
050,53,029,"Washington","Island County",1,73,1365,681,684
050,53,029,"Washington","Island County",1,74,991,487,504
050,53,029,"Washington","Island County",1,75,936,444,492
050,53,029,"Washington","Island County",1,76,944,450,494
050,53,029,"Washington","Island County",1,77,880,421,459
050,53,029,"Washington","Island County",1,78,731,352,379
050,53,029,"Washington","Island County",1,79,635,300,335
050,53,029,"Washington","Island County",1,80,560,262,298
050,53,029,"Washington","Island County",1,81,540,270,270
050,53,029,"Washington","Island County",1,82,460,227,233
050,53,029,"Washington","Island County",1,83,355,162,193
050,53,029,"Washington","Island County",1,84,327,160,167
050,53,029,"Washington","Island County",1,85,1877,792,1085
050,53,029,"Washington","Island County",2,0,851,416,435
050,53,029,"Washington","Island County",2,1,883,446,437
050,53,029,"Washington","Island County",2,2,894,455,439
050,53,029,"Washington","Island County",2,3,969,494,475
050,53,029,"Washington","Island County",2,4,987,477,510
050,53,029,"Washington","Island County",2,5,964,489,475
050,53,029,"Washington","Island County",2,6,935,497,438
050,53,029,"Washington","Island County",2,7,914,479,435
050,53,029,"Washington","Island County",2,8,901,464,437
050,53,029,"Washington","Island County",2,9,887,453,434
050,53,029,"Washington","Island County",2,10,866,447,419
050,53,029,"Washington","Island County",2,11,842,431,411
050,53,029,"Washington","Island County",2,12,861,430,431
050,53,029,"Washington","Island County",2,13,854,430,424
050,53,029,"Washington","Island County",2,14,812,414,398
050,53,029,"Washington","Island County",2,15,787,388,399
050,53,029,"Washington","Island County",2,16,775,382,393
050,53,029,"Washington","Island County",2,17,807,403,404
050,53,029,"Washington","Island County",2,18,720,392,328
050,53,029,"Washington","Island County",2,19,788,472,316
050,53,029,"Washington","Island County",2,20,1013,609,404
050,53,029,"Washington","Island County",2,21,1064,622,442
050,53,029,"Washington","Island County",2,22,1174,665,509
050,53,029,"Washington","Island County",2,23,1191,668,523
050,53,029,"Washington","Island County",2,24,1163,637,526
050,53,029,"Washington","Island County",2,25,1216,650,566
050,53,029,"Washington","Island County",2,26,1285,688,597
050,53,029,"Washington","Island County",2,27,1275,687,588
050,53,029,"Washington","Island County",2,28,1257,693,564
050,53,029,"Washington","Island County",2,29,1246,685,561
050,53,029,"Washington","Island County",2,30,1216,675,541
050,53,029,"Washington","Island County",2,31,1131,612,519
050,53,029,"Washington","Island County",2,32,1144,608,536
050,53,029,"Washington","Island County",2,33,1154,610,544
050,53,029,"Washington","Island County",2,34,1149,605,544
050,53,029,"Washington","Island County",2,35,1114,584,530
050,53,029,"Washington","Island County",2,36,1072,565,507
050,53,029,"Washington","Island County",2,37,1080,560,520
050,53,029,"Washington","Island County",2,38,1045,540,505
050,53,029,"Washington","Island County",2,39,1011,534,477
050,53,029,"Washington","Island County",2,40,942,496,446
050,53,029,"Washington","Island County",2,41,893,468,425
050,53,029,"Washington","Island County",2,42,836,422,414
050,53,029,"Washington","Island County",2,43,780,387,393
050,53,029,"Washington","Island County",2,44,767,369,398
050,53,029,"Washington","Island County",2,45,785,397,388
050,53,029,"Washington","Island County",2,46,742,382,360
050,53,029,"Washington","Island County",2,47,739,376,363
050,53,029,"Washington","Island County",2,48,785,388,397
050,53,029,"Washington","Island County",2,49,869,421,448
050,53,029,"Washington","Island County",2,50,880,428,452
050,53,029,"Washington","Island County",2,51,892,438,454
050,53,029,"Washington","Island County",2,52,869,423,446
050,53,029,"Washington","Island County",2,53,877,428,449
050,53,029,"Washington","Island County",2,54,917,430,487
050,53,029,"Washington","Island County",2,55,1012,470,542
050,53,029,"Washington","Island County",2,56,1106,529,577
050,53,029,"Washington","Island County",2,57,1151,572,579
050,53,029,"Washington","Island County",2,58,1163,552,611
050,53,029,"Washington","Island County",2,59,1181,556,625
050,53,029,"Washington","Island County",2,60,1193,569,624
050,53,029,"Washington","Island County",2,61,1241,584,657
050,53,029,"Washington","Island County",2,62,1313,605,708
050,53,029,"Washington","Island County",2,63,1382,610,772
050,53,029,"Washington","Island County",2,64,1368,622,746
050,53,029,"Washington","Island County",2,65,1407,655,752
050,53,029,"Washington","Island County",2,66,1459,675,784
050,53,029,"Washington","Island County",2,67,1525,698,827
050,53,029,"Washington","Island County",2,68,1473,688,785
050,53,029,"Washington","Island County",2,69,1378,646,732
050,53,029,"Washington","Island County",2,70,1319,632,687
050,53,029,"Washington","Island County",2,71,1333,637,696
050,53,029,"Washington","Island County",2,72,1338,663,675
050,53,029,"Washington","Island County",2,73,1431,709,722
050,53,029,"Washington","Island County",2,74,1005,494,511
050,53,029,"Washington","Island County",2,75,954,457,497
050,53,029,"Washington","Island County",2,76,929,442,487
050,53,029,"Washington","Island County",2,77,914,437,477
050,53,029,"Washington","Island County",2,78,747,360,387
050,53,029,"Washington","Island County",2,79,648,306,342
050,53,029,"Washington","Island County",2,80,569,268,301
050,53,029,"Washington","Island County",2,81,531,264,267
050,53,029,"Washington","Island County",2,82,474,234,240
050,53,029,"Washington","Island County",2,83,370,169,201
050,53,029,"Washington","Island County",2,84,327,156,171
050,53,029,"Washington","Island County",2,85,1887,800,1087
050,53,029,"Washington","Island County",3,0,763,395,368
050,53,029,"Washington","Island County",3,1,873,418,455
050,53,029,"Washington","Island County",3,2,863,449,414
050,53,029,"Washington","Island County",3,3,908,486,422
050,53,029,"Washington","Island County",3,4,989,518,471
050,53,029,"Washington","Island County",3,5,961,473,488
050,53,029,"Washington","Island County",3,6,944,495,449
050,53,029,"Washington","Island County",3,7,933,480,453
050,53,029,"Washington","Island County",3,8,889,464,425
050,53,029,"Washington","Island County",3,9,881,449,432
050,53,029,"Washington","Island County",3,10,851,430,421
050,53,029,"Washington","Island County",3,11,850,437,413
050,53,029,"Washington","Island County",3,12,826,432,394
050,53,029,"Washington","Island County",3,13,852,434,418
050,53,029,"Washington","Island County",3,14,804,416,388
050,53,029,"Washington","Island County",3,15,796,401,395
050,53,029,"Washington","Island County",3,16,776,376,400
050,53,029,"Washington","Island County",3,17,763,367,396
050,53,029,"Washington","Island County",3,18,705,374,331
050,53,029,"Washington","Island County",3,19,740,443,297
050,53,029,"Washington","Island County",3,20,1019,616,403
050,53,029,"Washington","Island County",3,21,1074,647,427
050,53,029,"Washington","Island County",3,22,1142,657,485
050,53,029,"Washington","Island County",3,23,1152,629,523
050,53,029,"Washington","Island County",3,24,1164,636,528
050,53,029,"Washington","Island County",3,25,1152,629,523
050,53,029,"Washington","Island County",3,26,1220,657,563
050,53,029,"Washington","Island County",3,27,1258,678,580
050,53,029,"Washington","Island County",3,28,1292,706,586
050,53,029,"Washington","Island County",3,29,1255,680,575
050,53,029,"Washington","Island County",3,30,1218,675,543
050,53,029,"Washington","Island County",3,31,1222,665,557
050,53,029,"Washington","Island County",3,32,1130,587,543
050,53,029,"Washington","Island County",3,33,1133,590,543
050,53,029,"Washington","Island County",3,34,1149,612,537
050,53,029,"Washington","Island County",3,35,1176,616,560
050,53,029,"Washington","Island County",3,36,1100,589,511
050,53,029,"Washington","Island County",3,37,1092,588,504
050,53,029,"Washington","Island County",3,38,1056,537,519
050,53,029,"Washington","Island County",3,39,1054,552,502
050,53,029,"Washington","Island County",3,40,1014,536,478
050,53,029,"Washington","Island County",3,41,973,503,470
050,53,029,"Washington","Island County",3,42,886,463,423
050,53,029,"Washington","Island County",3,43,848,428,420
050,53,029,"Washington","Island County",3,44,768,374,394
050,53,029,"Washington","Island County",3,45,785,382,403
050,53,029,"Washington","Island County",3,46,775,380,395
050,53,029,"Washington","Island County",3,47,759,396,363
050,53,029,"Washington","Island County",3,48,739,366,373
050,53,029,"Washington","Island County",3,49,782,387,395
050,53,029,"Washington","Island County",3,50,866,420,446
050,53,029,"Washington","Island County",3,51,897,433,464
050,53,029,"Washington","Island County",3,52,897,440,457
050,53,029,"Washington","Island County",3,53,873,436,437
050,53,029,"Washington","Island County",3,54,882,431,451
050,53,029,"Washington","Island County",3,55,916,421,495
050,53,029,"Washington","Island County",3,56,1049,486,563
050,53,029,"Washington","Island County",3,57,1140,547,593
050,53,029,"Washington","Island County",3,58,1189,593,596
050,53,029,"Washington","Island County",3,59,1182,563,619
050,53,029,"Washington","Island County",3,60,1200,551,649
050,53,029,"Washington","Island County",3,61,1259,599,660
050,53,029,"Washington","Island County",3,62,1297,611,686
050,53,029,"Washington","Island County",3,63,1352,624,728
050,53,029,"Washington","Island County",3,64,1399,622,777
050,53,029,"Washington","Island County",3,65,1402,644,758
050,53,029,"Washington","Island County",3,66,1434,663,771
050,53,029,"Washington","Island County",3,67,1470,681,789
050,53,029,"Washington","Island County",3,68,1554,712,842
050,53,029,"Washington","Island County",3,69,1459,681,778
050,53,029,"Washington","Island County",3,70,1381,645,736
050,53,029,"Washington","Island County",3,71,1297,616,681
050,53,029,"Washington","Island County",3,72,1324,639,685
050,53,029,"Washington","Island County",3,73,1336,647,689
050,53,029,"Washington","Island County",3,74,1410,696,714
050,53,029,"Washington","Island County",3,75,989,484,505
050,53,029,"Washington","Island County",3,76,918,434,484
050,53,029,"Washington","Island County",3,77,893,429,464
050,53,029,"Washington","Island County",3,78,872,408,464
050,53,029,"Washington","Island County",3,79,709,344,365
050,53,029,"Washington","Island County",3,80,610,284,326
050,53,029,"Washington","Island County",3,81,541,257,284
050,53,029,"Washington","Island County",3,82,506,249,257
050,53,029,"Washington","Island County",3,83,439,212,227
050,53,029,"Washington","Island County",3,84,354,165,189
050,53,029,"Washington","Island County",3,85,1916,830,1086
050,53,029,"Washington","Island County",4,0,766,399,367
050,53,029,"Washington","Island County",4,1,756,404,352
050,53,029,"Washington","Island County",4,2,835,427,408
050,53,029,"Washington","Island County",4,3,871,445,426
050,53,029,"Washington","Island County",4,4,854,469,385
050,53,029,"Washington","Island County",4,5,947,507,440
050,53,029,"Washington","Island County",4,6,900,450,450
050,53,029,"Washington","Island County",4,7,893,467,426
050,53,029,"Washington","Island County",4,8,893,469,424
050,53,029,"Washington","Island County",4,9,851,453,398
050,53,029,"Washington","Island County",4,10,874,438,436
050,53,029,"Washington","Island County",4,11,816,405,411
050,53,029,"Washington","Island County",4,12,807,425,382
050,53,029,"Washington","Island County",4,13,804,417,387
050,53,029,"Washington","Island County",4,14,812,409,403
050,53,029,"Washington","Island County",4,15,786,417,369
050,53,029,"Washington","Island County",4,16,773,394,379
050,53,029,"Washington","Island County",4,17,783,379,404
050,53,029,"Washington","Island County",4,18,660,345,315
050,53,029,"Washington","Island County",4,19,743,433,310
050,53,029,"Washington","Island County",4,20,931,561,370
050,53,029,"Washington","Island County",4,21,1042,641,401
050,53,029,"Washington","Island County",4,22,1101,660,441
050,53,029,"Washington","Island County",4,23,1111,645,466
050,53,029,"Washington","Island County",4,24,1110,601,509
050,53,029,"Washington","Island County",4,25,1142,623,519
050,53,029,"Washington","Island County",4,26,1132,624,508
050,53,029,"Washington","Island County",4,27,1180,617,563
050,53,029,"Washington","Island County",4,28,1240,689,551
050,53,029,"Washington","Island County",4,29,1205,628,577
050,53,029,"Washington","Island County",4,30,1167,637,530
050,53,029,"Washington","Island County",4,31,1142,624,518
050,53,029,"Washington","Island County",4,32,1142,617,525
050,53,029,"Washington","Island County",4,33,1063,545,518
050,53,029,"Washington","Island County",4,34,1090,566,524
050,53,029,"Washington","Island County",4,35,1134,594,540
050,53,029,"Washington","Island County",4,36,1186,625,561
050,53,029,"Washington","Island County",4,37,1077,584,493
050,53,029,"Washington","Island County",4,38,1057,576,481
050,53,029,"Washington","Island County",4,39,1053,548,505
050,53,029,"Washington","Island County",4,40,1053,553,500
050,53,029,"Washington","Island County",4,41,993,515,478
050,53,029,"Washington","Island County",4,42,961,491,470
050,53,029,"Washington","Island County",4,43,866,444,422
050,53,029,"Washington","Island County",4,44,842,433,409
050,53,029,"Washington","Island County",4,45,751,372,379
050,53,029,"Washington","Island County",4,46,772,372,400
050,53,029,"Washington","Island County",4,47,774,383,391
050,53,029,"Washington","Island County",4,48,753,377,376
050,53,029,"Washington","Island County",4,49,756,371,385
050,53,029,"Washington","Island County",4,50,786,385,401
050,53,029,"Washington","Island County",4,51,876,428,448
050,53,029,"Washington","Island County",4,52,897,435,462
050,53,029,"Washington","Island County",4,53,922,456,466
050,53,029,"Washington","Island County",4,54,879,437,442
050,53,029,"Washington","Island County",4,55,905,433,472
050,53,029,"Washington","Island County",4,56,921,423,498
050,53,029,"Washington","Island County",4,57,1048,490,558
050,53,029,"Washington","Island County",4,58,1160,562,598
050,53,029,"Washington","Island County",4,59,1208,592,616
050,53,029,"Washington","Island County",4,60,1201,570,631
050,53,029,"Washington","Island County",4,61,1216,542,674
050,53,029,"Washington","Island County",4,62,1297,616,681
050,53,029,"Washington","Island County",4,63,1300,611,689
050,53,029,"Washington","Island County",4,64,1352,626,726
050,53,029,"Washington","Island County",4,65,1388,632,756
050,53,029,"Washington","Island County",4,66,1406,645,761
050,53,029,"Washington","Island County",4,67,1447,661,786
050,53,029,"Washington","Island County",4,68,1511,697,814
050,53,029,"Washington","Island County",4,69,1561,721,840
050,53,029,"Washington","Island County",4,70,1431,667,764
050,53,029,"Washington","Island County",4,71,1377,637,740
050,53,029,"Washington","Island County",4,72,1269,595,674
050,53,029,"Washington","Island County",4,73,1291,625,666
050,53,029,"Washington","Island County",4,74,1309,632,677
050,53,029,"Washington","Island County",4,75,1376,679,697
050,53,029,"Washington","Island County",4,76,955,463,492
050,53,029,"Washington","Island County",4,77,885,424,461
050,53,029,"Washington","Island County",4,78,866,409,457
050,53,029,"Washington","Island County",4,79,832,390,442
050,53,029,"Washington","Island County",4,80,671,329,342
050,53,029,"Washington","Island County",4,81,579,269,310
050,53,029,"Washington","Island County",4,82,491,229,262
050,53,029,"Washington","Island County",4,83,476,237,239
050,53,029,"Washington","Island County",4,84,389,191,198
050,53,029,"Washington","Island County",4,85,1954,845,1109
050,53,029,"Washington","Island County",5,0,746,390,356
050,53,029,"Washington","Island County",5,1,765,399,366
050,53,029,"Washington","Island County",5,2,735,400,335
050,53,029,"Washington","Island County",5,3,829,418,411
050,53,029,"Washington","Island County",5,4,822,428,394
050,53,029,"Washington","Island County",5,5,822,459,363
050,53,029,"Washington","Island County",5,6,906,475,431
050,53,029,"Washington","Island County",5,7,867,448,419
050,53,029,"Washington","Island County",5,8,922,473,449
050,53,029,"Washington","Island County",5,9,860,442,418
050,53,029,"Washington","Island County",5,10,853,450,403
050,53,029,"Washington","Island County",5,11,829,417,412
050,53,029,"Washington","Island County",5,12,814,402,412
050,53,029,"Washington","Island County",5,13,769,405,364
050,53,029,"Washington","Island County",5,14,772,384,388
050,53,029,"Washington","Island County",5,15,802,403,399
050,53,029,"Washington","Island County",5,16,773,409,364
050,53,029,"Washington","Island County",5,17,767,396,371
050,53,029,"Washington","Island County",5,18,679,355,324
050,53,029,"Washington","Island County",5,19,706,419,287
050,53,029,"Washington","Island County",5,20,983,594,389
050,53,029,"Washington","Island County",5,21,966,579,387
050,53,029,"Washington","Island County",5,22,1099,660,439
050,53,029,"Washington","Island County",5,23,1054,627,427
050,53,029,"Washington","Island County",5,24,1068,591,477
050,53,029,"Washington","Island County",5,25,1055,565,490
050,53,029,"Washington","Island County",5,26,1120,612,508
050,53,029,"Washington","Island County",5,27,1119,623,496
050,53,029,"Washington","Island County",5,28,1156,600,556
050,53,029,"Washington","Island County",5,29,1178,646,532
050,53,029,"Washington","Island County",5,30,1177,611,566
050,53,029,"Washington","Island County",5,31,1137,606,531
050,53,029,"Washington","Island County",5,32,1109,610,499
050,53,029,"Washington","Island County",5,33,1135,610,525
050,53,029,"Washington","Island County",5,34,1030,532,498
050,53,029,"Washington","Island County",5,35,1099,573,526
050,53,029,"Washington","Island County",5,36,1147,607,540
050,53,029,"Washington","Island County",5,37,1204,646,558
050,53,029,"Washington","Island County",5,38,1065,578,487
050,53,029,"Washington","Island County",5,39,1024,549,475
050,53,029,"Washington","Island County",5,40,1030,524,506
050,53,029,"Washington","Island County",5,41,1031,540,491
050,53,029,"Washington","Island County",5,42,991,516,475
050,53,029,"Washington","Island County",5,43,957,482,475
050,53,029,"Washington","Island County",5,44,860,434,426
050,53,029,"Washington","Island County",5,45,832,431,401
050,53,029,"Washington","Island County",5,46,750,373,377
050,53,029,"Washington","Island County",5,47,771,370,401
050,53,029,"Washington","Island County",5,48,765,388,377
050,53,029,"Washington","Island County",5,49,767,377,390
050,53,029,"Washington","Island County",5,50,760,382,378
050,53,029,"Washington","Island County",5,51,784,396,388
050,53,029,"Washington","Island County",5,52,864,420,444
050,53,029,"Washington","Island County",5,53,901,432,469
050,53,029,"Washington","Island County",5,54,921,450,471
050,53,029,"Washington","Island County",5,55,900,446,454
050,53,029,"Washington","Island County",5,56,922,441,481
050,53,029,"Washington","Island County",5,57,930,431,499
050,53,029,"Washington","Island County",5,58,1057,496,561
050,53,029,"Washington","Island County",5,59,1139,542,597
050,53,029,"Washington","Island County",5,60,1232,605,627
050,53,029,"Washington","Island County",5,61,1218,566,652
050,53,029,"Washington","Island County",5,62,1237,552,685
050,53,029,"Washington","Island County",5,63,1344,620,724
050,53,029,"Washington","Island County",5,64,1333,623,710
050,53,029,"Washington","Island County",5,65,1385,638,747
050,53,029,"Washington","Island County",5,66,1402,633,769
050,53,029,"Washington","Island County",5,67,1414,646,768
050,53,029,"Washington","Island County",5,68,1434,657,777
050,53,029,"Washington","Island County",5,69,1504,692,812
050,53,029,"Washington","Island County",5,70,1543,712,831
050,53,029,"Washington","Island County",5,71,1408,657,751
050,53,029,"Washington","Island County",5,72,1352,624,728
050,53,029,"Washington","Island County",5,73,1232,575,657
050,53,029,"Washington","Island County",5,74,1247,606,641
050,53,029,"Washington","Island County",5,75,1282,612,670
050,53,029,"Washington","Island County",5,76,1336,653,683
050,53,029,"Washington","Island County",5,77,926,446,480
050,53,029,"Washington","Island County",5,78,856,408,448
050,53,029,"Washington","Island County",5,79,826,391,435
050,53,029,"Washington","Island County",5,80,780,368,412
050,53,029,"Washington","Island County",5,81,615,305,310
050,53,029,"Washington","Island County",5,82,536,246,290
050,53,029,"Washington","Island County",5,83,472,222,250
050,53,029,"Washington","Island County",5,84,430,216,214
050,53,029,"Washington","Island County",5,85,2028,893,1135
050,53,031,"Washington","Jefferson County",1,0,197,103,94
050,53,031,"Washington","Jefferson County",1,1,191,103,88
050,53,031,"Washington","Jefferson County",1,2,175,92,83
050,53,031,"Washington","Jefferson County",1,3,221,128,93
050,53,031,"Washington","Jefferson County",1,4,205,116,89
050,53,031,"Washington","Jefferson County",1,5,203,96,107
050,53,031,"Washington","Jefferson County",1,6,212,113,99
050,53,031,"Washington","Jefferson County",1,7,206,109,97
050,53,031,"Washington","Jefferson County",1,8,221,112,109
050,53,031,"Washington","Jefferson County",1,9,237,114,123
050,53,031,"Washington","Jefferson County",1,10,222,106,116
050,53,031,"Washington","Jefferson County",1,11,231,116,115
050,53,031,"Washington","Jefferson County",1,12,247,127,120
050,53,031,"Washington","Jefferson County",1,13,235,123,112
050,53,031,"Washington","Jefferson County",1,14,232,121,111
050,53,031,"Washington","Jefferson County",1,15,249,134,115
050,53,031,"Washington","Jefferson County",1,16,249,128,121
050,53,031,"Washington","Jefferson County",1,17,226,113,113
050,53,031,"Washington","Jefferson County",1,18,221,122,99
050,53,031,"Washington","Jefferson County",1,19,191,101,90
050,53,031,"Washington","Jefferson County",1,20,184,96,88
050,53,031,"Washington","Jefferson County",1,21,194,104,90
050,53,031,"Washington","Jefferson County",1,22,229,121,108
050,53,031,"Washington","Jefferson County",1,23,213,119,94
050,53,031,"Washington","Jefferson County",1,24,226,123,103
050,53,031,"Washington","Jefferson County",1,25,219,113,106
050,53,031,"Washington","Jefferson County",1,26,240,133,107
050,53,031,"Washington","Jefferson County",1,27,254,132,122
050,53,031,"Washington","Jefferson County",1,28,254,137,117
050,53,031,"Washington","Jefferson County",1,29,266,135,131
050,53,031,"Washington","Jefferson County",1,30,291,159,132
050,53,031,"Washington","Jefferson County",1,31,295,153,142
050,53,031,"Washington","Jefferson County",1,32,311,171,140
050,53,031,"Washington","Jefferson County",1,33,282,150,132
050,53,031,"Washington","Jefferson County",1,34,291,146,145
050,53,031,"Washington","Jefferson County",1,35,292,145,147
050,53,031,"Washington","Jefferson County",1,36,323,170,153
050,53,031,"Washington","Jefferson County",1,37,317,162,155
050,53,031,"Washington","Jefferson County",1,38,346,177,169
050,53,031,"Washington","Jefferson County",1,39,319,164,155
050,53,031,"Washington","Jefferson County",1,40,304,158,146
050,53,031,"Washington","Jefferson County",1,41,316,173,143
050,53,031,"Washington","Jefferson County",1,42,287,140,147
050,53,031,"Washington","Jefferson County",1,43,285,144,141
050,53,031,"Washington","Jefferson County",1,44,265,134,131
050,53,031,"Washington","Jefferson County",1,45,258,133,125
050,53,031,"Washington","Jefferson County",1,46,279,151,128
050,53,031,"Washington","Jefferson County",1,47,295,159,136
050,53,031,"Washington","Jefferson County",1,48,324,169,155
050,53,031,"Washington","Jefferson County",1,49,358,179,179
050,53,031,"Washington","Jefferson County",1,50,359,175,184
050,53,031,"Washington","Jefferson County",1,51,364,185,179
050,53,031,"Washington","Jefferson County",1,52,346,188,158
050,53,031,"Washington","Jefferson County",1,53,327,160,167
050,53,031,"Washington","Jefferson County",1,54,380,184,196
050,53,031,"Washington","Jefferson County",1,55,418,193,225
050,53,031,"Washington","Jefferson County",1,56,442,195,247
050,53,031,"Washington","Jefferson County",1,57,471,216,255
050,53,031,"Washington","Jefferson County",1,58,553,249,304
050,53,031,"Washington","Jefferson County",1,59,576,256,320
050,53,031,"Washington","Jefferson County",1,60,625,283,342
050,53,031,"Washington","Jefferson County",1,61,641,281,360
050,53,031,"Washington","Jefferson County",1,62,717,328,389
050,53,031,"Washington","Jefferson County",1,63,745,321,424
050,53,031,"Washington","Jefferson County",1,64,781,347,434
050,53,031,"Washington","Jefferson County",1,65,806,363,443
050,53,031,"Washington","Jefferson County",1,66,835,387,448
050,53,031,"Washington","Jefferson County",1,67,871,421,450
050,53,031,"Washington","Jefferson County",1,68,846,416,430
050,53,031,"Washington","Jefferson County",1,69,795,391,404
050,53,031,"Washington","Jefferson County",1,70,820,383,437
050,53,031,"Washington","Jefferson County",1,71,785,382,403
050,53,031,"Washington","Jefferson County",1,72,812,392,420
050,53,031,"Washington","Jefferson County",1,73,809,389,420
050,53,031,"Washington","Jefferson County",1,74,587,288,299
050,53,031,"Washington","Jefferson County",1,75,588,292,296
050,53,031,"Washington","Jefferson County",1,76,548,276,272
050,53,031,"Washington","Jefferson County",1,77,517,270,247
050,53,031,"Washington","Jefferson County",1,78,421,212,209
050,53,031,"Washington","Jefferson County",1,79,355,185,170
050,53,031,"Washington","Jefferson County",1,80,314,155,159
050,53,031,"Washington","Jefferson County",1,81,257,135,122
050,53,031,"Washington","Jefferson County",1,82,226,124,102
050,53,031,"Washington","Jefferson County",1,83,202,110,92
050,53,031,"Washington","Jefferson County",1,84,180,89,91
050,53,031,"Washington","Jefferson County",1,85,964,430,534
050,53,031,"Washington","Jefferson County",2,0,180,96,84
050,53,031,"Washington","Jefferson County",2,1,191,102,89
050,53,031,"Washington","Jefferson County",2,2,181,95,86
050,53,031,"Washington","Jefferson County",2,3,211,120,91
050,53,031,"Washington","Jefferson County",2,4,210,120,90
050,53,031,"Washington","Jefferson County",2,5,202,101,101
050,53,031,"Washington","Jefferson County",2,6,213,111,102
050,53,031,"Washington","Jefferson County",2,7,206,108,98
050,53,031,"Washington","Jefferson County",2,8,219,111,108
050,53,031,"Washington","Jefferson County",2,9,234,114,120
050,53,031,"Washington","Jefferson County",2,10,229,110,119
050,53,031,"Washington","Jefferson County",2,11,228,113,115
050,53,031,"Washington","Jefferson County",2,12,244,126,118
050,53,031,"Washington","Jefferson County",2,13,236,123,113
050,53,031,"Washington","Jefferson County",2,14,237,124,113
050,53,031,"Washington","Jefferson County",2,15,247,133,114
050,53,031,"Washington","Jefferson County",2,16,248,130,118
050,53,031,"Washington","Jefferson County",2,17,232,117,115
050,53,031,"Washington","Jefferson County",2,18,212,116,96
050,53,031,"Washington","Jefferson County",2,19,192,104,88
050,53,031,"Washington","Jefferson County",2,20,187,97,90
050,53,031,"Washington","Jefferson County",2,21,196,104,92
050,53,031,"Washington","Jefferson County",2,22,227,122,105
050,53,031,"Washington","Jefferson County",2,23,214,116,98
050,53,031,"Washington","Jefferson County",2,24,227,125,102
050,53,031,"Washington","Jefferson County",2,25,221,116,105
050,53,031,"Washington","Jefferson County",2,26,233,127,106
050,53,031,"Washington","Jefferson County",2,27,252,133,119
050,53,031,"Washington","Jefferson County",2,28,255,137,118
050,53,031,"Washington","Jefferson County",2,29,266,135,131
050,53,031,"Washington","Jefferson County",2,30,286,153,133
050,53,031,"Washington","Jefferson County",2,31,295,154,141
050,53,031,"Washington","Jefferson County",2,32,308,166,142
050,53,031,"Washington","Jefferson County",2,33,293,157,136
050,53,031,"Washington","Jefferson County",2,34,286,143,143
050,53,031,"Washington","Jefferson County",2,35,295,148,147
050,53,031,"Washington","Jefferson County",2,36,318,166,152
050,53,031,"Washington","Jefferson County",2,37,325,166,159
050,53,031,"Washington","Jefferson County",2,38,346,178,168
050,53,031,"Washington","Jefferson County",2,39,327,168,159
050,53,031,"Washington","Jefferson County",2,40,316,166,150
050,53,031,"Washington","Jefferson County",2,41,313,169,144
050,53,031,"Washington","Jefferson County",2,42,293,147,146
050,53,031,"Washington","Jefferson County",2,43,292,146,146
050,53,031,"Washington","Jefferson County",2,44,266,133,133
050,53,031,"Washington","Jefferson County",2,45,260,135,125
050,53,031,"Washington","Jefferson County",2,46,276,149,127
050,53,031,"Washington","Jefferson County",2,47,290,157,133
050,53,031,"Washington","Jefferson County",2,48,319,168,151
050,53,031,"Washington","Jefferson County",2,49,354,177,177
050,53,031,"Washington","Jefferson County",2,50,361,178,183
050,53,031,"Washington","Jefferson County",2,51,364,183,181
050,53,031,"Washington","Jefferson County",2,52,351,188,163
050,53,031,"Washington","Jefferson County",2,53,330,163,167
050,53,031,"Washington","Jefferson County",2,54,366,179,187
050,53,031,"Washington","Jefferson County",2,55,413,193,220
050,53,031,"Washington","Jefferson County",2,56,443,197,246
050,53,031,"Washington","Jefferson County",2,57,475,216,259
050,53,031,"Washington","Jefferson County",2,58,535,240,295
050,53,031,"Washington","Jefferson County",2,59,579,257,322
050,53,031,"Washington","Jefferson County",2,60,619,280,339
050,53,031,"Washington","Jefferson County",2,61,641,284,357
050,53,031,"Washington","Jefferson County",2,62,702,317,385
050,53,031,"Washington","Jefferson County",2,63,753,329,424
050,53,031,"Washington","Jefferson County",2,64,772,337,435
050,53,031,"Washington","Jefferson County",2,65,807,362,445
050,53,031,"Washington","Jefferson County",2,66,839,388,451
050,53,031,"Washington","Jefferson County",2,67,863,413,450
050,53,031,"Washington","Jefferson County",2,68,851,415,436
050,53,031,"Washington","Jefferson County",2,69,821,404,417
050,53,031,"Washington","Jefferson County",2,70,811,381,430
050,53,031,"Washington","Jefferson County",2,71,797,382,415
050,53,031,"Washington","Jefferson County",2,72,785,377,408
050,53,031,"Washington","Jefferson County",2,73,850,411,439
050,53,031,"Washington","Jefferson County",2,74,597,293,304
050,53,031,"Washington","Jefferson County",2,75,589,290,299
050,53,031,"Washington","Jefferson County",2,76,549,275,274
050,53,031,"Washington","Jefferson County",2,77,536,277,259
050,53,031,"Washington","Jefferson County",2,78,431,221,210
050,53,031,"Washington","Jefferson County",2,79,364,187,177
050,53,031,"Washington","Jefferson County",2,80,321,162,159
050,53,031,"Washington","Jefferson County",2,81,265,136,129
050,53,031,"Washington","Jefferson County",2,82,232,126,106
050,53,031,"Washington","Jefferson County",2,83,203,110,93
050,53,031,"Washington","Jefferson County",2,84,183,92,91
050,53,031,"Washington","Jefferson County",2,85,975,434,541
050,53,031,"Washington","Jefferson County",3,0,139,72,67
050,53,031,"Washington","Jefferson County",3,1,202,94,108
050,53,031,"Washington","Jefferson County",3,2,191,105,86
050,53,031,"Washington","Jefferson County",3,3,190,99,91
050,53,031,"Washington","Jefferson County",3,4,211,118,93
050,53,031,"Washington","Jefferson County",3,5,205,115,90
050,53,031,"Washington","Jefferson County",3,6,210,101,109
050,53,031,"Washington","Jefferson County",3,7,222,115,107
050,53,031,"Washington","Jefferson County",3,8,205,111,94
050,53,031,"Washington","Jefferson County",3,9,230,125,105
050,53,031,"Washington","Jefferson County",3,10,238,116,122
050,53,031,"Washington","Jefferson County",3,11,241,114,127
050,53,031,"Washington","Jefferson County",3,12,230,112,118
050,53,031,"Washington","Jefferson County",3,13,236,127,109
050,53,031,"Washington","Jefferson County",3,14,239,127,112
050,53,031,"Washington","Jefferson County",3,15,229,113,116
050,53,031,"Washington","Jefferson County",3,16,260,137,123
050,53,031,"Washington","Jefferson County",3,17,244,129,115
050,53,031,"Washington","Jefferson County",3,18,207,106,101
050,53,031,"Washington","Jefferson County",3,19,188,104,84
050,53,031,"Washington","Jefferson County",3,20,183,95,88
050,53,031,"Washington","Jefferson County",3,21,201,106,95
050,53,031,"Washington","Jefferson County",3,22,224,112,112
050,53,031,"Washington","Jefferson County",3,23,212,111,101
050,53,031,"Washington","Jefferson County",3,24,223,121,102
050,53,031,"Washington","Jefferson County",3,25,212,108,104
050,53,031,"Washington","Jefferson County",3,26,222,112,110
050,53,031,"Washington","Jefferson County",3,27,234,117,117
050,53,031,"Washington","Jefferson County",3,28,265,134,131
050,53,031,"Washington","Jefferson County",3,29,253,134,119
050,53,031,"Washington","Jefferson County",3,30,287,152,135
050,53,031,"Washington","Jefferson County",3,31,310,160,150
050,53,031,"Washington","Jefferson County",3,32,301,154,147
050,53,031,"Washington","Jefferson County",3,33,325,173,152
050,53,031,"Washington","Jefferson County",3,34,289,154,135
050,53,031,"Washington","Jefferson County",3,35,311,154,157
050,53,031,"Washington","Jefferson County",3,36,314,157,157
050,53,031,"Washington","Jefferson County",3,37,322,160,162
050,53,031,"Washington","Jefferson County",3,38,344,183,161
050,53,031,"Washington","Jefferson County",3,39,358,181,177
050,53,031,"Washington","Jefferson County",3,40,342,177,165
050,53,031,"Washington","Jefferson County",3,41,336,166,170
050,53,031,"Washington","Jefferson County",3,42,314,164,150
050,53,031,"Washington","Jefferson County",3,43,310,158,152
050,53,031,"Washington","Jefferson County",3,44,295,140,155
050,53,031,"Washington","Jefferson County",3,45,281,134,147
050,53,031,"Washington","Jefferson County",3,46,267,137,130
050,53,031,"Washington","Jefferson County",3,47,274,151,123
050,53,031,"Washington","Jefferson County",3,48,300,157,143
050,53,031,"Washington","Jefferson County",3,49,322,163,159
050,53,031,"Washington","Jefferson County",3,50,369,187,182
050,53,031,"Washington","Jefferson County",3,51,375,188,187
050,53,031,"Washington","Jefferson County",3,52,386,190,196
050,53,031,"Washington","Jefferson County",3,53,360,189,171
050,53,031,"Washington","Jefferson County",3,54,342,176,166
050,53,031,"Washington","Jefferson County",3,55,405,193,212
050,53,031,"Washington","Jefferson County",3,56,443,215,228
050,53,031,"Washington","Jefferson County",3,57,458,200,258
050,53,031,"Washington","Jefferson County",3,58,507,228,279
050,53,031,"Washington","Jefferson County",3,59,537,238,299
050,53,031,"Washington","Jefferson County",3,60,608,276,332
050,53,031,"Washington","Jefferson County",3,61,634,277,357
050,53,031,"Washington","Jefferson County",3,62,681,294,387
050,53,031,"Washington","Jefferson County",3,63,738,335,403
050,53,031,"Washington","Jefferson County",3,64,768,336,432
050,53,031,"Washington","Jefferson County",3,65,804,348,456
050,53,031,"Washington","Jefferson County",3,66,831,384,447
050,53,031,"Washington","Jefferson County",3,67,844,388,456
050,53,031,"Washington","Jefferson County",3,68,876,417,459
050,53,031,"Washington","Jefferson County",3,69,835,409,426
050,53,031,"Washington","Jefferson County",3,70,821,405,416
050,53,031,"Washington","Jefferson County",3,71,813,388,425
050,53,031,"Washington","Jefferson County",3,72,798,375,423
050,53,031,"Washington","Jefferson County",3,73,779,369,410
050,53,031,"Washington","Jefferson County",3,74,846,413,433
050,53,031,"Washington","Jefferson County",3,75,585,286,299
050,53,031,"Washington","Jefferson County",3,76,575,285,290
050,53,031,"Washington","Jefferson County",3,77,533,270,263
050,53,031,"Washington","Jefferson County",3,78,517,269,248
050,53,031,"Washington","Jefferson County",3,79,415,218,197
050,53,031,"Washington","Jefferson County",3,80,349,178,171
050,53,031,"Washington","Jefferson County",3,81,291,144,147
050,53,031,"Washington","Jefferson County",3,82,253,129,124
050,53,031,"Washington","Jefferson County",3,83,215,119,96
050,53,031,"Washington","Jefferson County",3,84,190,104,86
050,53,031,"Washington","Jefferson County",3,85,1024,459,565
050,53,031,"Washington","Jefferson County",4,0,163,85,78
050,53,031,"Washington","Jefferson County",4,1,134,65,69
050,53,031,"Washington","Jefferson County",4,2,192,78,114
050,53,031,"Washington","Jefferson County",4,3,200,105,95
050,53,031,"Washington","Jefferson County",4,4,197,107,90
050,53,031,"Washington","Jefferson County",4,5,220,127,93
050,53,031,"Washington","Jefferson County",4,6,207,119,88
050,53,031,"Washington","Jefferson County",4,7,203,99,104
050,53,031,"Washington","Jefferson County",4,8,232,120,112
050,53,031,"Washington","Jefferson County",4,9,209,107,102
050,53,031,"Washington","Jefferson County",4,10,226,127,99
050,53,031,"Washington","Jefferson County",4,11,233,113,120
050,53,031,"Washington","Jefferson County",4,12,242,118,124
050,53,031,"Washington","Jefferson County",4,13,219,106,113
050,53,031,"Washington","Jefferson County",4,14,240,130,110
050,53,031,"Washington","Jefferson County",4,15,239,127,112
050,53,031,"Washington","Jefferson County",4,16,223,118,105
050,53,031,"Washington","Jefferson County",4,17,260,137,123
050,53,031,"Washington","Jefferson County",4,18,211,116,95
050,53,031,"Washington","Jefferson County",4,19,167,84,83
050,53,031,"Washington","Jefferson County",4,20,173,91,82
050,53,031,"Washington","Jefferson County",4,21,180,90,90
050,53,031,"Washington","Jefferson County",4,22,218,119,99
050,53,031,"Washington","Jefferson County",4,23,198,90,108
050,53,031,"Washington","Jefferson County",4,24,218,108,110
050,53,031,"Washington","Jefferson County",4,25,204,98,106
050,53,031,"Washington","Jefferson County",4,26,210,99,111
050,53,031,"Washington","Jefferson County",4,27,217,103,114
050,53,031,"Washington","Jefferson County",4,28,238,118,120
050,53,031,"Washington","Jefferson County",4,29,271,134,137
050,53,031,"Washington","Jefferson County",4,30,271,147,124
050,53,031,"Washington","Jefferson County",4,31,292,157,135
050,53,031,"Washington","Jefferson County",4,32,316,163,153
050,53,031,"Washington","Jefferson County",4,33,306,161,145
050,53,031,"Washington","Jefferson County",4,34,313,167,146
050,53,031,"Washington","Jefferson County",4,35,291,159,132
050,53,031,"Washington","Jefferson County",4,36,309,154,155
050,53,031,"Washington","Jefferson County",4,37,317,153,164
050,53,031,"Washington","Jefferson County",4,38,340,165,175
050,53,031,"Washington","Jefferson County",4,39,363,189,174
050,53,031,"Washington","Jefferson County",4,40,360,186,174
050,53,031,"Washington","Jefferson County",4,41,353,182,171
050,53,031,"Washington","Jefferson County",4,42,318,161,157
050,53,031,"Washington","Jefferson County",4,43,324,174,150
050,53,031,"Washington","Jefferson County",4,44,317,167,150
050,53,031,"Washington","Jefferson County",4,45,295,134,161
050,53,031,"Washington","Jefferson County",4,46,277,132,145
050,53,031,"Washington","Jefferson County",4,47,277,141,136
050,53,031,"Washington","Jefferson County",4,48,291,157,134
050,53,031,"Washington","Jefferson County",4,49,306,157,149
050,53,031,"Washington","Jefferson County",4,50,317,167,150
050,53,031,"Washington","Jefferson County",4,51,373,181,192
050,53,031,"Washington","Jefferson County",4,52,375,197,178
050,53,031,"Washington","Jefferson County",4,53,368,171,197
050,53,031,"Washington","Jefferson County",4,54,363,188,175
050,53,031,"Washington","Jefferson County",4,55,362,181,181
050,53,031,"Washington","Jefferson County",4,56,414,197,217
050,53,031,"Washington","Jefferson County",4,57,465,222,243
050,53,031,"Washington","Jefferson County",4,58,453,198,255
050,53,031,"Washington","Jefferson County",4,59,523,228,295
050,53,031,"Washington","Jefferson County",4,60,563,250,313
050,53,031,"Washington","Jefferson County",4,61,609,267,342
050,53,031,"Washington","Jefferson County",4,62,628,272,356
050,53,031,"Washington","Jefferson County",4,63,702,296,406
050,53,031,"Washington","Jefferson County",4,64,789,362,427
050,53,031,"Washington","Jefferson County",4,65,798,332,466
050,53,031,"Washington","Jefferson County",4,66,839,373,466
050,53,031,"Washington","Jefferson County",4,67,845,388,457
050,53,031,"Washington","Jefferson County",4,68,843,384,459
050,53,031,"Washington","Jefferson County",4,69,879,423,456
050,53,031,"Washington","Jefferson County",4,70,839,407,432
050,53,031,"Washington","Jefferson County",4,71,829,407,422
050,53,031,"Washington","Jefferson County",4,72,807,387,420
050,53,031,"Washington","Jefferson County",4,73,802,377,425
050,53,031,"Washington","Jefferson County",4,74,758,360,398
050,53,031,"Washington","Jefferson County",4,75,817,400,417
050,53,031,"Washington","Jefferson County",4,76,555,268,287
050,53,031,"Washington","Jefferson County",4,77,557,280,277
050,53,031,"Washington","Jefferson County",4,78,512,250,262
050,53,031,"Washington","Jefferson County",4,79,506,259,247
050,53,031,"Washington","Jefferson County",4,80,401,208,193
050,53,031,"Washington","Jefferson County",4,81,333,174,159
050,53,031,"Washington","Jefferson County",4,82,288,148,140
050,53,031,"Washington","Jefferson County",4,83,243,124,119
050,53,031,"Washington","Jefferson County",4,84,199,111,88
050,53,031,"Washington","Jefferson County",4,85,1036,480,556
050,53,031,"Washington","Jefferson County",5,0,163,85,78
050,53,031,"Washington","Jefferson County",5,1,163,87,76
050,53,031,"Washington","Jefferson County",5,2,149,68,81
050,53,031,"Washington","Jefferson County",5,3,202,82,120
050,53,031,"Washington","Jefferson County",5,4,198,103,95
050,53,031,"Washington","Jefferson County",5,5,196,105,91
050,53,031,"Washington","Jefferson County",5,6,211,121,90
050,53,031,"Washington","Jefferson County",5,7,202,117,85
050,53,031,"Washington","Jefferson County",5,8,201,95,106
050,53,031,"Washington","Jefferson County",5,9,227,121,106
050,53,031,"Washington","Jefferson County",5,10,208,109,99
050,53,031,"Washington","Jefferson County",5,11,215,119,96
050,53,031,"Washington","Jefferson County",5,12,220,110,110
050,53,031,"Washington","Jefferson County",5,13,231,120,111
050,53,031,"Washington","Jefferson County",5,14,216,104,112
050,53,031,"Washington","Jefferson County",5,15,230,125,105
050,53,031,"Washington","Jefferson County",5,16,245,132,113
050,53,031,"Washington","Jefferson County",5,17,224,118,106
050,53,031,"Washington","Jefferson County",5,18,219,123,96
050,53,031,"Washington","Jefferson County",5,19,181,98,83
050,53,031,"Washington","Jefferson County",5,20,168,84,84
050,53,031,"Washington","Jefferson County",5,21,198,112,86
050,53,031,"Washington","Jefferson County",5,22,203,111,92
050,53,031,"Washington","Jefferson County",5,23,230,111,119
050,53,031,"Washington","Jefferson County",5,24,206,101,105
050,53,031,"Washington","Jefferson County",5,25,214,97,117
050,53,031,"Washington","Jefferson County",5,26,213,100,113
050,53,031,"Washington","Jefferson County",5,27,203,100,103
050,53,031,"Washington","Jefferson County",5,28,216,112,104
050,53,031,"Washington","Jefferson County",5,29,229,113,116
050,53,031,"Washington","Jefferson County",5,30,284,143,141
050,53,031,"Washington","Jefferson County",5,31,293,153,140
050,53,031,"Washington","Jefferson County",5,32,297,155,142
050,53,031,"Washington","Jefferson County",5,33,319,167,152
050,53,031,"Washington","Jefferson County",5,34,312,157,155
050,53,031,"Washington","Jefferson County",5,35,326,176,150
050,53,031,"Washington","Jefferson County",5,36,324,168,156
050,53,031,"Washington","Jefferson County",5,37,305,149,156
050,53,031,"Washington","Jefferson County",5,38,339,160,179
050,53,031,"Washington","Jefferson County",5,39,332,161,171
050,53,031,"Washington","Jefferson County",5,40,359,190,169
050,53,031,"Washington","Jefferson County",5,41,358,185,173
050,53,031,"Washington","Jefferson County",5,42,341,166,175
050,53,031,"Washington","Jefferson County",5,43,337,178,159
050,53,031,"Washington","Jefferson County",5,44,314,167,147
050,53,031,"Washington","Jefferson County",5,45,314,163,151
050,53,031,"Washington","Jefferson County",5,46,290,133,157
050,53,031,"Washington","Jefferson County",5,47,280,130,150
050,53,031,"Washington","Jefferson County",5,48,284,147,137
050,53,031,"Washington","Jefferson County",5,49,293,156,137
050,53,031,"Washington","Jefferson County",5,50,314,164,150
050,53,031,"Washington","Jefferson County",5,51,326,168,158
050,53,031,"Washington","Jefferson County",5,52,391,195,196
050,53,031,"Washington","Jefferson County",5,53,374,183,191
050,53,031,"Washington","Jefferson County",5,54,386,178,208
050,53,031,"Washington","Jefferson County",5,55,363,187,176
050,53,031,"Washington","Jefferson County",5,56,377,184,193
050,53,031,"Washington","Jefferson County",5,57,448,216,232
050,53,031,"Washington","Jefferson County",5,58,473,222,251
050,53,031,"Washington","Jefferson County",5,59,481,208,273
050,53,031,"Washington","Jefferson County",5,60,543,240,303
050,53,031,"Washington","Jefferson County",5,61,585,257,328
050,53,031,"Washington","Jefferson County",5,62,633,286,347
050,53,031,"Washington","Jefferson County",5,63,635,287,348
050,53,031,"Washington","Jefferson County",5,64,715,301,414
050,53,031,"Washington","Jefferson County",5,65,803,368,435
050,53,031,"Washington","Jefferson County",5,66,818,339,479
050,53,031,"Washington","Jefferson County",5,67,842,382,460
050,53,031,"Washington","Jefferson County",5,68,863,400,463
050,53,031,"Washington","Jefferson County",5,69,855,388,467
050,53,031,"Washington","Jefferson County",5,70,878,421,457
050,53,031,"Washington","Jefferson County",5,71,849,406,443
050,53,031,"Washington","Jefferson County",5,72,817,405,412
050,53,031,"Washington","Jefferson County",5,73,798,383,415
050,53,031,"Washington","Jefferson County",5,74,791,377,414
050,53,031,"Washington","Jefferson County",5,75,736,344,392
050,53,031,"Washington","Jefferson County",5,76,793,382,411
050,53,031,"Washington","Jefferson County",5,77,546,262,284
050,53,031,"Washington","Jefferson County",5,78,542,268,274
050,53,031,"Washington","Jefferson County",5,79,496,245,251
050,53,031,"Washington","Jefferson County",5,80,487,248,239
050,53,031,"Washington","Jefferson County",5,81,377,196,181
050,53,031,"Washington","Jefferson County",5,82,322,168,154
050,53,031,"Washington","Jefferson County",5,83,274,142,132
050,53,031,"Washington","Jefferson County",5,84,232,120,112
050,53,031,"Washington","Jefferson County",5,85,1069,504,565
050,53,033,"Washington","King County",1,0,24654,12607,12047
050,53,033,"Washington","King County",1,1,24570,12549,12021
050,53,033,"Washington","King County",1,2,24845,12711,12134
050,53,033,"Washington","King County",1,3,25732,13307,12425
050,53,033,"Washington","King County",1,4,25747,13175,12572
050,53,033,"Washington","King County",1,5,25640,13128,12512
050,53,033,"Washington","King County",1,6,25642,13081,12561
050,53,033,"Washington","King County",1,7,25695,13092,12603
050,53,033,"Washington","King County",1,8,25314,12813,12501
050,53,033,"Washington","King County",1,9,25489,12924,12565
050,53,033,"Washington","King County",1,10,26116,13271,12845
050,53,033,"Washington","King County",1,11,26437,13522,12915
050,53,033,"Washington","King County",1,12,26602,13678,12924
050,53,033,"Washington","King County",1,13,25910,13292,12618
050,53,033,"Washington","King County",1,14,25051,12806,12245
050,53,033,"Washington","King County",1,15,24733,12647,12086
050,53,033,"Washington","King County",1,16,24808,12658,12150
050,53,033,"Washington","King County",1,17,24521,12408,12113
050,53,033,"Washington","King County",1,18,24597,12311,12286
050,53,033,"Washington","King County",1,19,25336,12443,12893
050,53,033,"Washington","King County",1,20,23794,12022,11772
050,53,033,"Washington","King County",1,21,23131,11761,11370
050,53,033,"Washington","King County",1,22,24939,12715,12224
050,53,033,"Washington","King County",1,23,29032,14958,14074
050,53,033,"Washington","King County",1,24,32465,16873,15592
050,53,033,"Washington","King County",1,25,35570,18428,17142
050,53,033,"Washington","King County",1,26,38211,19791,18420
050,53,033,"Washington","King County",1,27,40342,20974,19368
050,53,033,"Washington","King County",1,28,42797,22424,20373
050,53,033,"Washington","King County",1,29,44795,23549,21246
050,53,033,"Washington","King County",1,30,45235,23882,21353
050,53,033,"Washington","King County",1,31,44239,23279,20960
050,53,033,"Washington","King County",1,32,42364,22386,19978
050,53,033,"Washington","King County",1,33,41282,21581,19701
050,53,033,"Washington","King County",1,34,41139,21603,19536
050,53,033,"Washington","King County",1,35,40281,21310,18971
050,53,033,"Washington","King County",1,36,39217,20614,18603
050,53,033,"Washington","King County",1,37,38720,20214,18506
050,53,033,"Washington","King County",1,38,37696,19629,18067
050,53,033,"Washington","King County",1,39,36162,18906,17256
050,53,033,"Washington","King County",1,40,34849,17947,16902
050,53,033,"Washington","King County",1,41,33081,17159,15922
050,53,033,"Washington","King County",1,42,31989,16517,15472
050,53,033,"Washington","King County",1,43,31279,16218,15061
050,53,033,"Washington","King County",1,44,30431,15648,14783
050,53,033,"Washington","King County",1,45,30211,15556,14655
050,53,033,"Washington","King County",1,46,29137,14864,14273
050,53,033,"Washington","King County",1,47,29468,15028,14440
050,53,033,"Washington","King County",1,48,30492,15650,14842
050,53,033,"Washington","King County",1,49,32058,16600,15458
050,53,033,"Washington","King County",1,50,31194,16195,14999
050,53,033,"Washington","King County",1,51,30233,15743,14490
050,53,033,"Washington","King County",1,52,28309,14523,13786
050,53,033,"Washington","King County",1,53,27331,13993,13338
050,53,033,"Washington","King County",1,54,26860,13768,13092
050,53,033,"Washington","King County",1,55,27674,14098,13576
050,53,033,"Washington","King County",1,56,28003,14282,13721
050,53,033,"Washington","King County",1,57,27946,14263,13683
050,53,033,"Washington","King County",1,58,27604,14191,13413
050,53,033,"Washington","King County",1,59,26942,13679,13263
050,53,033,"Washington","King County",1,60,26383,13338,13045
050,53,033,"Washington","King County",1,61,25730,12929,12801
050,53,033,"Washington","King County",1,62,25422,12670,12752
050,53,033,"Washington","King County",1,63,24572,12233,12339
050,53,033,"Washington","King County",1,64,23723,11655,12068
050,53,033,"Washington","King County",1,65,22938,11235,11703
050,53,033,"Washington","King County",1,66,21703,10482,11221
050,53,033,"Washington","King County",1,67,20614,9934,10680
050,53,033,"Washington","King County",1,68,19777,9387,10390
050,53,033,"Washington","King County",1,69,18280,8601,9679
050,53,033,"Washington","King County",1,70,17618,8200,9418
050,53,033,"Washington","King County",1,71,17040,7988,9052
050,53,033,"Washington","King County",1,72,16711,7745,8966
050,53,033,"Washington","King County",1,73,16417,7572,8845
050,53,033,"Washington","King County",1,74,12037,5499,6538
050,53,033,"Washington","King County",1,75,11795,5366,6429
050,53,033,"Washington","King County",1,76,11316,5144,6172
050,53,033,"Washington","King County",1,77,10678,4864,5814
050,53,033,"Washington","King County",1,78,8943,4043,4900
050,53,033,"Washington","King County",1,79,7888,3533,4355
050,53,033,"Washington","King County",1,80,7158,3132,4026
050,53,033,"Washington","King County",1,81,6722,2775,3947
050,53,033,"Washington","King County",1,82,6356,2697,3659
050,53,033,"Washington","King County",1,83,5682,2386,3296
050,53,033,"Washington","King County",1,84,5160,2161,2999
050,53,033,"Washington","King County",1,85,35093,12438,22655
050,53,033,"Washington","King County",2,0,24476,12556,11920
050,53,033,"Washington","King County",2,1,24471,12491,11980
050,53,033,"Washington","King County",2,2,24737,12646,12091
050,53,033,"Washington","King County",2,3,25442,13114,12328
050,53,033,"Washington","King County",2,4,25746,13205,12541
050,53,033,"Washington","King County",2,5,25677,13145,12532
050,53,033,"Washington","King County",2,6,25662,13102,12560
050,53,033,"Washington","King County",2,7,25620,13067,12553
050,53,033,"Washington","King County",2,8,25298,12826,12472
050,53,033,"Washington","King County",2,9,25381,12871,12510
050,53,033,"Washington","King County",2,10,25929,13160,12769
050,53,033,"Washington","King County",2,11,26214,13372,12842
050,53,033,"Washington","King County",2,12,26660,13692,12968
050,53,033,"Washington","King County",2,13,26006,13350,12656
050,53,033,"Washington","King County",2,14,25236,12919,12317
050,53,033,"Washington","King County",2,15,24810,12678,12132
050,53,033,"Washington","King County",2,16,24802,12651,12151
050,53,033,"Washington","King County",2,17,24605,12478,12127
050,53,033,"Washington","King County",2,18,24496,12247,12249
050,53,033,"Washington","King County",2,19,25336,12437,12899
050,53,033,"Washington","King County",2,20,24059,12151,11908
050,53,033,"Washington","King County",2,21,23266,11833,11433
050,53,033,"Washington","King County",2,22,25216,12846,12370
050,53,033,"Washington","King County",2,23,28922,14872,14050
050,53,033,"Washington","King County",2,24,32356,16815,15541
050,53,033,"Washington","King County",2,25,35471,18454,17017
050,53,033,"Washington","King County",2,26,38212,19824,18388
050,53,033,"Washington","King County",2,27,40192,20934,19258
050,53,033,"Washington","King County",2,28,42563,22305,20258
050,53,033,"Washington","King County",2,29,44601,23434,21167
050,53,033,"Washington","King County",2,30,45562,24037,21525
050,53,033,"Washington","King County",2,31,44546,23479,21067
050,53,033,"Washington","King County",2,32,42828,22612,20216
050,53,033,"Washington","King County",2,33,41548,21800,19748
050,53,033,"Washington","King County",2,34,41202,21658,19544
050,53,033,"Washington","King County",2,35,40710,21522,19188
050,53,033,"Washington","King County",2,36,39242,20658,18584
050,53,033,"Washington","King County",2,37,38888,20327,18561
050,53,033,"Washington","King County",2,38,38072,19833,18239
050,53,033,"Washington","King County",2,39,36381,18993,17388
050,53,033,"Washington","King County",2,40,35349,18293,17056
050,53,033,"Washington","King County",2,41,33425,17295,16130
050,53,033,"Washington","King County",2,42,32086,16601,15485
050,53,033,"Washington","King County",2,43,31574,16345,15229
050,53,033,"Washington","King County",2,44,30385,15668,14717
050,53,033,"Washington","King County",2,45,30356,15637,14719
050,53,033,"Washington","King County",2,46,29259,14940,14319
050,53,033,"Washington","King County",2,47,29306,14958,14348
050,53,033,"Washington","King County",2,48,30216,15480,14736
050,53,033,"Washington","King County",2,49,31711,16405,15306
050,53,033,"Washington","King County",2,50,31437,16308,15129
050,53,033,"Washington","King County",2,51,30288,15755,14533
050,53,033,"Washington","King County",2,52,28692,14772,13920
050,53,033,"Washington","King County",2,53,27470,14071,13399
050,53,033,"Washington","King County",2,54,26841,13736,13105
050,53,033,"Washington","King County",2,55,27388,13971,13417
050,53,033,"Washington","King County",2,56,27879,14221,13658
050,53,033,"Washington","King County",2,57,27902,14234,13668
050,53,033,"Washington","King County",2,58,27519,14113,13406
050,53,033,"Washington","King County",2,59,27006,13747,13259
050,53,033,"Washington","King County",2,60,26403,13359,13044
050,53,033,"Washington","King County",2,61,25628,12898,12730
050,53,033,"Washington","King County",2,62,25321,12642,12679
050,53,033,"Washington","King County",2,63,24780,12325,12455
050,53,033,"Washington","King County",2,64,23656,11657,11999
050,53,033,"Washington","King County",2,65,22917,11200,11717
050,53,033,"Washington","King County",2,66,21885,10599,11286
050,53,033,"Washington","King County",2,67,20623,9918,10705
050,53,033,"Washington","King County",2,68,19755,9399,10356
050,53,033,"Washington","King County",2,69,18584,8738,9846
050,53,033,"Washington","King County",2,70,17669,8251,9418
050,53,033,"Washington","King County",2,71,17042,7959,9083
050,53,033,"Washington","King County",2,72,16447,7632,8815
050,53,033,"Washington","King County",2,73,17065,7884,9181
050,53,033,"Washington","King County",2,74,12298,5614,6684
050,53,033,"Washington","King County",2,75,11827,5372,6455
050,53,033,"Washington","King County",2,76,11287,5139,6148
050,53,033,"Washington","King County",2,77,10949,4981,5968
050,53,033,"Washington","King County",2,78,9173,4143,5030
050,53,033,"Washington","King County",2,79,8024,3590,4434
050,53,033,"Washington","King County",2,80,7262,3181,4081
050,53,033,"Washington","King County",2,81,6733,2812,3921
050,53,033,"Washington","King County",2,82,6377,2681,3696
050,53,033,"Washington","King County",2,83,5742,2415,3327
050,53,033,"Washington","King County",2,84,5214,2181,3033
050,53,033,"Washington","King County",2,85,35091,12481,22610
050,53,033,"Washington","King County",3,0,23352,11804,11548
050,53,033,"Washington","King County",3,1,23816,12268,11548
050,53,033,"Washington","King County",3,2,23811,12188,11623
050,53,033,"Washington","King County",3,3,24148,12384,11764
050,53,033,"Washington","King County",3,4,24831,12809,12022
050,53,033,"Washington","King County",3,5,25145,12900,12245
050,53,033,"Washington","King County",3,6,25125,12880,12245
050,53,033,"Washington","King County",3,7,25210,12891,12319
050,53,033,"Washington","King County",3,8,25161,12866,12295
050,53,033,"Washington","King County",3,9,24854,12566,12288
050,53,033,"Washington","King County",3,10,24960,12692,12268
050,53,033,"Washington","King County",3,11,25505,12957,12548
050,53,033,"Washington","King County",3,12,25854,13178,12676
050,53,033,"Washington","King County",3,13,26209,13485,12724
050,53,033,"Washington","King County",3,14,25702,13159,12543
050,53,033,"Washington","King County",3,15,24909,12737,12172
050,53,033,"Washington","King County",3,16,24587,12570,12017
050,53,033,"Washington","King County",3,17,24601,12591,12010
050,53,033,"Washington","King County",3,18,23369,11794,11575
050,53,033,"Washington","King County",3,19,22094,11014,11080
050,53,033,"Washington","King County",3,20,22254,11241,11013
050,53,033,"Washington","King County",3,21,22444,11326,11118
050,53,033,"Washington","King County",3,22,23948,12094,11854
050,53,033,"Washington","King County",3,23,28119,14346,13773
050,53,033,"Washington","King County",3,24,31103,16058,15045
050,53,033,"Washington","King County",3,25,34099,17866,16233
050,53,033,"Washington","King County",3,26,36710,19215,17495
050,53,033,"Washington","King County",3,27,39134,20404,18730
050,53,033,"Washington","King County",3,28,40680,21321,19359
050,53,033,"Washington","King County",3,29,42850,22601,20249
050,53,033,"Washington","King County",3,30,44341,23311,21030
050,53,033,"Washington","King County",3,31,45118,23787,21331
050,53,033,"Washington","King County",3,32,43787,23167,20620
050,53,033,"Washington","King County",3,33,41874,22095,19779
050,53,033,"Washington","King County",3,34,40650,21461,19189
050,53,033,"Washington","King County",3,35,40323,21197,19126
050,53,033,"Washington","King County",3,36,39884,21052,18832
050,53,033,"Washington","King County",3,37,38324,20095,18229
050,53,033,"Washington","King County",3,38,37953,19844,18109
050,53,033,"Washington","King County",3,39,37241,19321,17920
050,53,033,"Washington","King County",3,40,35711,18654,17057
050,53,033,"Washington","King County",3,41,34580,17897,16683
050,53,033,"Washington","King County",3,42,32733,16950,15783
050,53,033,"Washington","King County",3,43,31288,16232,15056
050,53,033,"Washington","King County",3,44,30918,15953,14965
050,53,033,"Washington","King County",3,45,29851,15473,14378
050,53,033,"Washington","King County",3,46,29802,15275,14527
050,53,033,"Washington","King County",3,47,28908,14793,14115
050,53,033,"Washington","King County",3,48,28799,14722,14077
050,53,033,"Washington","King County",3,49,29638,15173,14465
050,53,033,"Washington","King County",3,50,31163,16145,15018
050,53,033,"Washington","King County",3,51,30889,16028,14861
050,53,033,"Washington","King County",3,52,29727,15459,14268
050,53,033,"Washington","King County",3,53,28127,14463,13664
050,53,033,"Washington","King County",3,54,26848,13670,13178
050,53,033,"Washington","King County",3,55,26297,13460,12837
050,53,033,"Washington","King County",3,56,26703,13617,13086
050,53,033,"Washington","King County",3,57,27156,13858,13298
050,53,033,"Washington","King County",3,58,27035,13803,13232
050,53,033,"Washington","King County",3,59,26773,13694,13079
050,53,033,"Washington","King County",3,60,26318,13332,12986
050,53,033,"Washington","King County",3,61,25546,12925,12621
050,53,033,"Washington","King County",3,62,24741,12415,12326
050,53,033,"Washington","King County",3,63,24387,12155,12232
050,53,033,"Washington","King County",3,64,23870,11839,12031
050,53,033,"Washington","King County",3,65,22853,11179,11674
050,53,033,"Washington","King County",3,66,22192,10849,11343
050,53,033,"Washington","King County",3,67,21135,10140,10995
050,53,033,"Washington","King County",3,68,20000,9564,10436
050,53,033,"Washington","King County",3,69,19217,9104,10113
050,53,033,"Washington","King County",3,70,18077,8461,9616
050,53,033,"Washington","King County",3,71,17202,8003,9199
050,53,033,"Washington","King County",3,72,16555,7713,8842
050,53,033,"Washington","King County",3,73,15988,7362,8626
050,53,033,"Washington","King County",3,74,16509,7592,8917
050,53,033,"Washington","King County",3,75,11910,5368,6542
050,53,033,"Washington","King County",3,76,11460,5163,6297
050,53,033,"Washington","King County",3,77,10901,4920,5981
050,53,033,"Washington","King County",3,78,10528,4747,5781
050,53,033,"Washington","King County",3,79,8835,3958,4877
050,53,033,"Washington","King County",3,80,7660,3401,4259
050,53,033,"Washington","King County",3,81,6950,2978,3972
050,53,033,"Washington","King County",3,82,6385,2644,3741
050,53,033,"Washington","King County",3,83,6048,2504,3544
050,53,033,"Washington","King County",3,84,5396,2250,3146
050,53,033,"Washington","King County",3,85,35292,12675,22617
050,53,033,"Washington","King County",4,0,23570,11959,11611
050,53,033,"Washington","King County",4,1,22955,11596,11359
050,53,033,"Washington","King County",4,2,23338,12028,11310
050,53,033,"Washington","King County",4,3,23427,12052,11375
050,53,033,"Washington","King County",4,4,23802,12221,11581
050,53,033,"Washington","King County",4,5,24585,12712,11873
050,53,033,"Washington","King County",4,6,24749,12725,12024
050,53,033,"Washington","King County",4,7,24752,12724,12028
050,53,033,"Washington","King County",4,8,24742,12742,12000
050,53,033,"Washington","King County",4,9,24718,12618,12100
050,53,033,"Washington","King County",4,10,24443,12399,12044
050,53,033,"Washington","King County",4,11,24500,12464,12036
050,53,033,"Washington","King County",4,12,25170,12770,12400
050,53,033,"Washington","King County",4,13,25528,13030,12498
050,53,033,"Washington","King County",4,14,25863,13298,12565
050,53,033,"Washington","King County",4,15,25415,13014,12401
050,53,033,"Washington","King County",4,16,24744,12636,12108
050,53,033,"Washington","King County",4,17,24614,12616,11998
050,53,033,"Washington","King County",4,18,24702,12421,12281
050,53,033,"Washington","King County",4,19,24584,12015,12569
050,53,033,"Washington","King County",4,20,23282,11708,11574
050,53,033,"Washington","King County",4,21,23245,11699,11546
050,53,033,"Washington","King County",4,22,25294,12798,12496
050,53,033,"Washington","King County",4,23,28603,14479,14124
050,53,033,"Washington","King County",4,24,32090,16531,15559
050,53,033,"Washington","King County",4,25,34477,17905,16572
050,53,033,"Washington","King County",4,26,36848,19272,17576
050,53,033,"Washington","King County",4,27,39605,20727,18878
050,53,033,"Washington","King County",4,28,41133,21437,19696
050,53,033,"Washington","King County",4,29,42115,22038,20077
050,53,033,"Washington","King County",4,30,43685,23210,20475
050,53,033,"Washington","King County",4,31,44758,23636,21122
050,53,033,"Washington","King County",4,32,45058,23776,21282
050,53,033,"Washington","King County",4,33,43817,23242,20575
050,53,033,"Washington","King County",4,34,41532,22155,19377
050,53,033,"Washington","King County",4,35,40314,21302,19012
050,53,033,"Washington","King County",4,36,39651,20782,18869
050,53,033,"Washington","King County",4,37,39198,20629,18569
050,53,033,"Washington","King County",4,38,37724,19814,17910
050,53,033,"Washington","King County",4,39,37213,19433,17780
050,53,033,"Washington","King County",4,40,36690,19025,17665
050,53,033,"Washington","King County",4,41,35097,18284,16813
050,53,033,"Washington","King County",4,42,33869,17526,16343
050,53,033,"Washington","King County",4,43,32132,16687,15445
050,53,033,"Washington","King County",4,44,30694,15920,14774
050,53,033,"Washington","King County",4,45,30418,15642,14776
050,53,033,"Washington","King County",4,46,29241,15104,14137
050,53,033,"Washington","King County",4,47,29334,15045,14289
050,53,033,"Washington","King County",4,48,28355,14495,13860
050,53,033,"Washington","King County",4,49,28307,14417,13890
050,53,033,"Washington","King County",4,50,29132,14942,14190
050,53,033,"Washington","King County",4,51,30551,15854,14697
050,53,033,"Washington","King County",4,52,30346,15731,14615
050,53,033,"Washington","King County",4,53,29130,15158,13972
050,53,033,"Washington","King County",4,54,27461,14065,13396
050,53,033,"Washington","King County",4,55,26277,13374,12903
050,53,033,"Washington","King County",4,56,25751,13136,12615
050,53,033,"Washington","King County",4,57,26242,13368,12874
050,53,033,"Washington","King County",4,58,26350,13418,12932
050,53,033,"Washington","King County",4,59,26319,13409,12910
050,53,033,"Washington","King County",4,60,26141,13343,12798
050,53,033,"Washington","King County",4,61,25531,12859,12672
050,53,033,"Washington","King County",4,62,24751,12489,12262
050,53,033,"Washington","King County",4,63,23862,11931,11931
050,53,033,"Washington","King County",4,64,23720,11761,11959
050,53,033,"Washington","King County",4,65,23094,11370,11724
050,53,033,"Washington","King County",4,66,22173,10872,11301
050,53,033,"Washington","King County",4,67,21352,10356,10996
050,53,033,"Washington","King County",4,68,20417,9755,10662
050,53,033,"Washington","King County",4,69,19377,9210,10167
050,53,033,"Washington","King County",4,70,18620,8756,9864
050,53,033,"Washington","King County",4,71,17591,8150,9441
050,53,033,"Washington","King County",4,72,16690,7755,8935
050,53,033,"Washington","King County",4,73,16117,7435,8682
050,53,033,"Washington","King County",4,74,15528,7104,8424
050,53,033,"Washington","King County",4,75,15952,7249,8703
050,53,033,"Washington","King County",4,76,11498,5164,6334
050,53,033,"Washington","King County",4,77,11074,4929,6145
050,53,033,"Washington","King County",4,78,10553,4673,5880
050,53,033,"Washington","King County",4,79,10098,4513,5585
050,53,033,"Washington","King County",4,80,8464,3751,4713
050,53,033,"Washington","King County",4,81,7330,3198,4132
050,53,033,"Washington","King County",4,82,6606,2795,3811
050,53,033,"Washington","King County",4,83,6073,2468,3605
050,53,033,"Washington","King County",4,84,5684,2321,3363
050,53,033,"Washington","King County",4,85,35476,12853,22623
050,53,033,"Washington","King County",5,0,23140,11760,11380
050,53,033,"Washington","King County",5,1,22978,11625,11353
050,53,033,"Washington","King County",5,2,22358,11280,11078
050,53,033,"Washington","King County",5,3,22945,11894,11051
050,53,033,"Washington","King County",5,4,23018,11882,11136
050,53,033,"Washington","King County",5,5,23523,12076,11447
050,53,033,"Washington","King County",5,6,24262,12532,11730
050,53,033,"Washington","King County",5,7,24327,12505,11822
050,53,033,"Washington","King County",5,8,24484,12618,11866
050,53,033,"Washington","King County",5,9,24434,12585,11849
050,53,033,"Washington","King County",5,10,24569,12543,12026
050,53,033,"Washington","King County",5,11,24203,12226,11977
050,53,033,"Washington","King County",5,12,24382,12416,11966
050,53,033,"Washington","King County",5,13,24940,12641,12299
050,53,033,"Washington","King County",5,14,25383,12947,12436
050,53,033,"Washington","King County",5,15,25752,13241,12511
050,53,033,"Washington","King County",5,16,25325,12910,12415
050,53,033,"Washington","King County",5,17,24828,12727,12101
050,53,033,"Washington","King County",5,18,24737,12458,12279
050,53,033,"Washington","King County",5,19,24926,12260,12666
050,53,033,"Washington","King County",5,20,23545,11822,11723
050,53,033,"Washington","King County",5,21,22820,11536,11284
050,53,033,"Washington","King County",5,22,25331,12814,12517
050,53,033,"Washington","King County",5,23,29729,15119,14610
050,53,033,"Washington","King County",5,24,32166,16478,15688
050,53,033,"Washington","King County",5,25,34980,18188,16792
050,53,033,"Washington","King County",5,26,36931,19224,17707
050,53,033,"Washington","King County",5,27,38901,20372,18529
050,53,033,"Washington","King County",5,28,40886,21511,19375
050,53,033,"Washington","King County",5,29,42206,22003,20203
050,53,033,"Washington","King County",5,30,42537,22327,20210
050,53,033,"Washington","King County",5,31,43724,23247,20477
050,53,033,"Washington","King County",5,32,44633,23588,21045
050,53,033,"Washington","King County",5,33,44810,23724,21086
050,53,033,"Washington","King County",5,34,43432,23086,20346
050,53,033,"Washington","King County",5,35,41066,21932,19134
050,53,033,"Washington","King County",5,36,39706,21025,18681
050,53,033,"Washington","King County",5,37,38970,20404,18566
050,53,033,"Washington","King County",5,38,38309,20139,18170
050,53,033,"Washington","King County",5,39,37087,19416,17671
050,53,033,"Washington","King County",5,40,36745,19211,17534
050,53,033,"Washington","King County",5,41,36057,18633,17424
050,53,033,"Washington","King County",5,42,34425,17910,16515
050,53,033,"Washington","King County",5,43,33357,17277,16080
050,53,033,"Washington","King County",5,44,31694,16468,15226
050,53,033,"Washington","King County",5,45,30246,15689,14557
050,53,033,"Washington","King County",5,46,29831,15233,14598
050,53,033,"Washington","King County",5,47,28838,14902,13936
050,53,033,"Washington","King County",5,48,28886,14801,14085
050,53,033,"Washington","King County",5,49,28039,14321,13718
050,53,033,"Washington","King County",5,50,28006,14225,13781
050,53,033,"Washington","King County",5,51,28648,14660,13988
050,53,033,"Washington","King County",5,52,30081,15555,14526
050,53,033,"Washington","King County",5,53,29844,15491,14353
050,53,033,"Washington","King County",5,54,28464,14758,13706
050,53,033,"Washington","King County",5,55,26941,13857,13084
050,53,033,"Washington","King County",5,56,25805,13114,12691
050,53,033,"Washington","King County",5,57,25323,12893,12430
050,53,033,"Washington","King County",5,58,25640,13044,12596
050,53,033,"Washington","King County",5,59,25734,13113,12621
050,53,033,"Washington","King County",5,60,25773,13082,12691
050,53,033,"Washington","King County",5,61,25432,12942,12490
050,53,033,"Washington","King County",5,62,24860,12469,12391
050,53,033,"Washington","King County",5,63,24022,12015,12007
050,53,033,"Washington","King County",5,64,23152,11561,11591
050,53,033,"Washington","King County",5,65,22984,11310,11674
050,53,033,"Washington","King County",5,66,22459,11036,11423
050,53,033,"Washington","King County",5,67,21560,10487,11073
050,53,033,"Washington","King County",5,68,20814,10055,10759
050,53,033,"Washington","King County",5,69,19924,9472,10452
050,53,033,"Washington","King County",5,70,18877,8935,9942
050,53,033,"Washington","King County",5,71,18235,8532,9703
050,53,033,"Washington","King County",5,72,17061,7871,9190
050,53,033,"Washington","King County",5,73,16235,7481,8754
050,53,033,"Washington","King County",5,74,15698,7214,8484
050,53,033,"Washington","King County",5,75,15113,6853,8260
050,53,033,"Washington","King County",5,76,15523,7020,8503
050,53,033,"Washington","King County",5,77,11125,4947,6178
050,53,033,"Washington","King County",5,78,10685,4718,5967
050,53,033,"Washington","King County",5,79,10170,4479,5691
050,53,033,"Washington","King County",5,80,9676,4289,5387
050,53,033,"Washington","King County",5,81,8134,3552,4582
050,53,033,"Washington","King County",5,82,6967,2999,3968
050,53,033,"Washington","King County",5,83,6249,2592,3657
050,53,033,"Washington","King County",5,84,5707,2269,3438
050,53,033,"Washington","King County",5,85,36058,13182,22876
050,53,035,"Washington","Kitsap County",1,0,3010,1541,1469
050,53,035,"Washington","Kitsap County",1,1,2989,1530,1459
050,53,035,"Washington","Kitsap County",1,2,2976,1546,1430
050,53,035,"Washington","Kitsap County",1,3,3138,1624,1514
050,53,035,"Washington","Kitsap County",1,4,3215,1710,1505
050,53,035,"Washington","Kitsap County",1,5,3189,1630,1559
050,53,035,"Washington","Kitsap County",1,6,3139,1596,1543
050,53,035,"Washington","Kitsap County",1,7,3112,1575,1537
050,53,035,"Washington","Kitsap County",1,8,3182,1637,1545
050,53,035,"Washington","Kitsap County",1,9,3128,1588,1540
050,53,035,"Washington","Kitsap County",1,10,3127,1580,1547
050,53,035,"Washington","Kitsap County",1,11,3182,1635,1547
050,53,035,"Washington","Kitsap County",1,12,3296,1721,1575
050,53,035,"Washington","Kitsap County",1,13,3234,1632,1602
050,53,035,"Washington","Kitsap County",1,14,3126,1607,1519
050,53,035,"Washington","Kitsap County",1,15,3117,1591,1526
050,53,035,"Washington","Kitsap County",1,16,3160,1591,1569
050,53,035,"Washington","Kitsap County",1,17,3081,1530,1551
050,53,035,"Washington","Kitsap County",1,18,2714,1417,1297
050,53,035,"Washington","Kitsap County",1,19,2783,1601,1182
050,53,035,"Washington","Kitsap County",1,20,3418,2114,1304
050,53,035,"Washington","Kitsap County",1,21,3919,2517,1402
050,53,035,"Washington","Kitsap County",1,22,3945,2423,1522
050,53,035,"Washington","Kitsap County",1,23,4011,2333,1678
050,53,035,"Washington","Kitsap County",1,24,4092,2393,1699
050,53,035,"Washington","Kitsap County",1,25,4111,2348,1763
050,53,035,"Washington","Kitsap County",1,26,4029,2266,1763
050,53,035,"Washington","Kitsap County",1,27,4146,2297,1849
050,53,035,"Washington","Kitsap County",1,28,4222,2255,1967
050,53,035,"Washington","Kitsap County",1,29,4182,2241,1941
050,53,035,"Washington","Kitsap County",1,30,4099,2167,1932
050,53,035,"Washington","Kitsap County",1,31,3967,2103,1864
050,53,035,"Washington","Kitsap County",1,32,3894,2067,1827
050,53,035,"Washington","Kitsap County",1,33,3891,2069,1822
050,53,035,"Washington","Kitsap County",1,34,3916,2086,1830
050,53,035,"Washington","Kitsap County",1,35,3808,2039,1769
050,53,035,"Washington","Kitsap County",1,36,3775,2019,1756
050,53,035,"Washington","Kitsap County",1,37,3763,1977,1786
050,53,035,"Washington","Kitsap County",1,38,3829,2026,1803
050,53,035,"Washington","Kitsap County",1,39,3646,1898,1748
050,53,035,"Washington","Kitsap County",1,40,3402,1736,1666
050,53,035,"Washington","Kitsap County",1,41,3276,1680,1596
050,53,035,"Washington","Kitsap County",1,42,3256,1658,1598
050,53,035,"Washington","Kitsap County",1,43,3025,1534,1491
050,53,035,"Washington","Kitsap County",1,44,2943,1483,1460
050,53,035,"Washington","Kitsap County",1,45,2911,1500,1411
050,53,035,"Washington","Kitsap County",1,46,2771,1471,1300
050,53,035,"Washington","Kitsap County",1,47,2765,1413,1352
050,53,035,"Washington","Kitsap County",1,48,3065,1532,1533
050,53,035,"Washington","Kitsap County",1,49,3344,1717,1627
050,53,035,"Washington","Kitsap County",1,50,3365,1703,1662
050,53,035,"Washington","Kitsap County",1,51,3247,1610,1637
050,53,035,"Washington","Kitsap County",1,52,3121,1511,1610
050,53,035,"Washington","Kitsap County",1,53,3237,1614,1623
050,53,035,"Washington","Kitsap County",1,54,3255,1628,1627
050,53,035,"Washington","Kitsap County",1,55,3509,1766,1743
050,53,035,"Washington","Kitsap County",1,56,3673,1859,1814
050,53,035,"Washington","Kitsap County",1,57,3828,1889,1939
050,53,035,"Washington","Kitsap County",1,58,3894,1905,1989
050,53,035,"Washington","Kitsap County",1,59,3893,1906,1987
050,53,035,"Washington","Kitsap County",1,60,3756,1849,1907
050,53,035,"Washington","Kitsap County",1,61,3799,1850,1949
050,53,035,"Washington","Kitsap County",1,62,3778,1841,1937
050,53,035,"Washington","Kitsap County",1,63,3740,1831,1909
050,53,035,"Washington","Kitsap County",1,64,3735,1802,1933
050,53,035,"Washington","Kitsap County",1,65,3673,1765,1908
050,53,035,"Washington","Kitsap County",1,66,3621,1718,1903
050,53,035,"Washington","Kitsap County",1,67,3497,1693,1804
050,53,035,"Washington","Kitsap County",1,68,3405,1641,1764
050,53,035,"Washington","Kitsap County",1,69,3180,1545,1635
050,53,035,"Washington","Kitsap County",1,70,3101,1493,1608
050,53,035,"Washington","Kitsap County",1,71,3029,1418,1611
050,53,035,"Washington","Kitsap County",1,72,3044,1410,1634
050,53,035,"Washington","Kitsap County",1,73,3079,1471,1608
050,53,035,"Washington","Kitsap County",1,74,2174,1029,1145
050,53,035,"Washington","Kitsap County",1,75,2115,1014,1101
050,53,035,"Washington","Kitsap County",1,76,2046,989,1057
050,53,035,"Washington","Kitsap County",1,77,1965,931,1034
050,53,035,"Washington","Kitsap County",1,78,1581,762,819
050,53,035,"Washington","Kitsap County",1,79,1401,664,737
050,53,035,"Washington","Kitsap County",1,80,1230,592,638
050,53,035,"Washington","Kitsap County",1,81,1069,522,547
050,53,035,"Washington","Kitsap County",1,82,967,444,523
050,53,035,"Washington","Kitsap County",1,83,855,366,489
050,53,035,"Washington","Kitsap County",1,84,818,358,460
050,53,035,"Washington","Kitsap County",1,85,4613,1687,2926
050,53,035,"Washington","Kitsap County",2,0,2921,1496,1425
050,53,035,"Washington","Kitsap County",2,1,2976,1521,1455
050,53,035,"Washington","Kitsap County",2,2,2970,1538,1432
050,53,035,"Washington","Kitsap County",2,3,3082,1600,1482
050,53,035,"Washington","Kitsap County",2,4,3200,1686,1514
050,53,035,"Washington","Kitsap County",2,5,3191,1641,1550
050,53,035,"Washington","Kitsap County",2,6,3156,1607,1549
050,53,035,"Washington","Kitsap County",2,7,3118,1582,1536
050,53,035,"Washington","Kitsap County",2,8,3153,1619,1534
050,53,035,"Washington","Kitsap County",2,9,3131,1599,1532
050,53,035,"Washington","Kitsap County",2,10,3126,1579,1547
050,53,035,"Washington","Kitsap County",2,11,3155,1616,1539
050,53,035,"Washington","Kitsap County",2,12,3287,1709,1578
050,53,035,"Washington","Kitsap County",2,13,3242,1651,1591
050,53,035,"Washington","Kitsap County",2,14,3142,1607,1535
050,53,035,"Washington","Kitsap County",2,15,3115,1593,1522
050,53,035,"Washington","Kitsap County",2,16,3146,1586,1560
050,53,035,"Washington","Kitsap County",2,17,3087,1533,1554
050,53,035,"Washington","Kitsap County",2,18,2716,1411,1305
050,53,035,"Washington","Kitsap County",2,19,2800,1610,1190
050,53,035,"Washington","Kitsap County",2,20,3440,2119,1321
050,53,035,"Washington","Kitsap County",2,21,3883,2483,1400
050,53,035,"Washington","Kitsap County",2,22,3930,2425,1505
050,53,035,"Washington","Kitsap County",2,23,3978,2325,1653
050,53,035,"Washington","Kitsap County",2,24,4052,2362,1690
050,53,035,"Washington","Kitsap County",2,25,4077,2323,1754
050,53,035,"Washington","Kitsap County",2,26,4013,2260,1753
050,53,035,"Washington","Kitsap County",2,27,4106,2276,1830
050,53,035,"Washington","Kitsap County",2,28,4177,2252,1925
050,53,035,"Washington","Kitsap County",2,29,4193,2241,1952
050,53,035,"Washington","Kitsap County",2,30,4149,2195,1954
050,53,035,"Washington","Kitsap County",2,31,3996,2112,1884
050,53,035,"Washington","Kitsap County",2,32,3906,2072,1834
050,53,035,"Washington","Kitsap County",2,33,3882,2061,1821
050,53,035,"Washington","Kitsap County",2,34,3921,2089,1832
050,53,035,"Washington","Kitsap County",2,35,3858,2064,1794
050,53,035,"Washington","Kitsap County",2,36,3761,2010,1751
050,53,035,"Washington","Kitsap County",2,37,3792,2001,1791
050,53,035,"Washington","Kitsap County",2,38,3828,2018,1810
050,53,035,"Washington","Kitsap County",2,39,3672,1918,1754
050,53,035,"Washington","Kitsap County",2,40,3473,1775,1698
050,53,035,"Washington","Kitsap County",2,41,3309,1695,1614
050,53,035,"Washington","Kitsap County",2,42,3240,1657,1583
050,53,035,"Washington","Kitsap County",2,43,3096,1570,1526
050,53,035,"Washington","Kitsap County",2,44,2943,1489,1454
050,53,035,"Washington","Kitsap County",2,45,2946,1511,1435
050,53,035,"Washington","Kitsap County",2,46,2794,1474,1320
050,53,035,"Washington","Kitsap County",2,47,2759,1419,1340
050,53,035,"Washington","Kitsap County",2,48,2992,1504,1488
050,53,035,"Washington","Kitsap County",2,49,3294,1684,1610
050,53,035,"Washington","Kitsap County",2,50,3368,1716,1652
050,53,035,"Washington","Kitsap County",2,51,3261,1623,1638
050,53,035,"Washington","Kitsap County",2,52,3150,1536,1614
050,53,035,"Washington","Kitsap County",2,53,3211,1591,1620
050,53,035,"Washington","Kitsap County",2,54,3244,1624,1620
050,53,035,"Washington","Kitsap County",2,55,3443,1727,1716
050,53,035,"Washington","Kitsap County",2,56,3636,1832,1804
050,53,035,"Washington","Kitsap County",2,57,3805,1889,1916
050,53,035,"Washington","Kitsap County",2,58,3874,1897,1977
050,53,035,"Washington","Kitsap County",2,59,3903,1908,1995
050,53,035,"Washington","Kitsap County",2,60,3784,1855,1929
050,53,035,"Washington","Kitsap County",2,61,3772,1839,1933
050,53,035,"Washington","Kitsap County",2,62,3774,1837,1937
050,53,035,"Washington","Kitsap County",2,63,3777,1847,1930
050,53,035,"Washington","Kitsap County",2,64,3709,1799,1910
050,53,035,"Washington","Kitsap County",2,65,3688,1770,1918
050,53,035,"Washington","Kitsap County",2,66,3639,1725,1914
050,53,035,"Washington","Kitsap County",2,67,3505,1686,1819
050,53,035,"Washington","Kitsap County",2,68,3407,1640,1767
050,53,035,"Washington","Kitsap County",2,69,3251,1580,1671
050,53,035,"Washington","Kitsap County",2,70,3105,1500,1605
050,53,035,"Washington","Kitsap County",2,71,3043,1438,1605
050,53,035,"Washington","Kitsap County",2,72,2972,1372,1600
050,53,035,"Washington","Kitsap County",2,73,3208,1522,1686
050,53,035,"Washington","Kitsap County",2,74,2240,1060,1180
050,53,035,"Washington","Kitsap County",2,75,2124,1012,1112
050,53,035,"Washington","Kitsap County",2,76,2031,976,1055
050,53,035,"Washington","Kitsap County",2,77,1998,948,1050
050,53,035,"Washington","Kitsap County",2,78,1630,779,851
050,53,035,"Washington","Kitsap County",2,79,1420,678,742
050,53,035,"Washington","Kitsap County",2,80,1261,602,659
050,53,035,"Washington","Kitsap County",2,81,1087,527,560
050,53,035,"Washington","Kitsap County",2,82,984,460,524
050,53,035,"Washington","Kitsap County",2,83,869,380,489
050,53,035,"Washington","Kitsap County",2,84,811,349,462
050,53,035,"Washington","Kitsap County",2,85,4665,1718,2947
050,53,035,"Washington","Kitsap County",3,0,2736,1402,1334
050,53,035,"Washington","Kitsap County",3,1,2868,1485,1383
050,53,035,"Washington","Kitsap County",3,2,2856,1462,1394
050,53,035,"Washington","Kitsap County",3,3,2905,1499,1406
050,53,035,"Washington","Kitsap County",3,4,3008,1564,1444
050,53,035,"Washington","Kitsap County",3,5,3124,1665,1459
050,53,035,"Washington","Kitsap County",3,6,3097,1615,1482
050,53,035,"Washington","Kitsap County",3,7,3046,1543,1503
050,53,035,"Washington","Kitsap County",3,8,3088,1545,1543
050,53,035,"Washington","Kitsap County",3,9,3117,1596,1521
050,53,035,"Washington","Kitsap County",3,10,3061,1559,1502
050,53,035,"Washington","Kitsap County",3,11,3054,1521,1533
050,53,035,"Washington","Kitsap County",3,12,3137,1603,1534
050,53,035,"Washington","Kitsap County",3,13,3267,1676,1591
050,53,035,"Washington","Kitsap County",3,14,3206,1620,1586
050,53,035,"Washington","Kitsap County",3,15,3086,1561,1525
050,53,035,"Washington","Kitsap County",3,16,3126,1607,1519
050,53,035,"Washington","Kitsap County",3,17,3107,1556,1551
050,53,035,"Washington","Kitsap County",3,18,2793,1443,1350
050,53,035,"Washington","Kitsap County",3,19,2880,1675,1205
050,53,035,"Washington","Kitsap County",3,20,3596,2268,1328
050,53,035,"Washington","Kitsap County",3,21,4093,2654,1439
050,53,035,"Washington","Kitsap County",3,22,3883,2459,1424
050,53,035,"Washington","Kitsap County",3,23,3920,2343,1577
050,53,035,"Washington","Kitsap County",3,24,3983,2355,1628
050,53,035,"Washington","Kitsap County",3,25,3974,2294,1680
050,53,035,"Washington","Kitsap County",3,26,3949,2215,1734
050,53,035,"Washington","Kitsap County",3,27,3948,2232,1716
050,53,035,"Washington","Kitsap County",3,28,4007,2223,1784
050,53,035,"Washington","Kitsap County",3,29,4174,2254,1920
050,53,035,"Washington","Kitsap County",3,30,4151,2204,1947
050,53,035,"Washington","Kitsap County",3,31,4076,2164,1912
050,53,035,"Washington","Kitsap County",3,32,3948,2086,1862
050,53,035,"Washington","Kitsap County",3,33,3889,2032,1857
050,53,035,"Washington","Kitsap County",3,34,3907,2084,1823
050,53,035,"Washington","Kitsap County",3,35,3959,2097,1862
050,53,035,"Washington","Kitsap County",3,36,3851,2071,1780
050,53,035,"Washington","Kitsap County",3,37,3835,2061,1774
050,53,035,"Washington","Kitsap County",3,38,3781,1980,1801
050,53,035,"Washington","Kitsap County",3,39,3840,2007,1833
050,53,035,"Washington","Kitsap County",3,40,3688,1925,1763
050,53,035,"Washington","Kitsap County",3,41,3486,1779,1707
050,53,035,"Washington","Kitsap County",3,42,3290,1671,1619
050,53,035,"Washington","Kitsap County",3,43,3251,1673,1578
050,53,035,"Washington","Kitsap County",3,44,3145,1590,1555
050,53,035,"Washington","Kitsap County",3,45,2955,1505,1450
050,53,035,"Washington","Kitsap County",3,46,2940,1516,1424
050,53,035,"Washington","Kitsap County",3,47,2791,1445,1346
050,53,035,"Washington","Kitsap County",3,48,2753,1399,1354
050,53,035,"Washington","Kitsap County",3,49,3010,1527,1483
050,53,035,"Washington","Kitsap County",3,50,3304,1681,1623
050,53,035,"Washington","Kitsap County",3,51,3368,1703,1665
050,53,035,"Washington","Kitsap County",3,52,3213,1611,1602
050,53,035,"Washington","Kitsap County",3,53,3151,1532,1619
050,53,035,"Washington","Kitsap County",3,54,3210,1609,1601
050,53,035,"Washington","Kitsap County",3,55,3257,1624,1633
050,53,035,"Washington","Kitsap County",3,56,3366,1678,1688
050,53,035,"Washington","Kitsap County",3,57,3648,1831,1817
050,53,035,"Washington","Kitsap County",3,58,3805,1880,1925
050,53,035,"Washington","Kitsap County",3,59,3890,1902,1988
050,53,035,"Washington","Kitsap County",3,60,3870,1887,1983
050,53,035,"Washington","Kitsap County",3,61,3763,1844,1919
050,53,035,"Washington","Kitsap County",3,62,3753,1832,1921
050,53,035,"Washington","Kitsap County",3,63,3732,1822,1910
050,53,035,"Washington","Kitsap County",3,64,3748,1826,1922
050,53,035,"Washington","Kitsap County",3,65,3698,1780,1918
050,53,035,"Washington","Kitsap County",3,66,3643,1738,1905
050,53,035,"Washington","Kitsap County",3,67,3593,1703,1890
050,53,035,"Washington","Kitsap County",3,68,3481,1664,1817
050,53,035,"Washington","Kitsap County",3,69,3353,1610,1743
050,53,035,"Washington","Kitsap County",3,70,3208,1546,1662
050,53,035,"Washington","Kitsap County",3,71,3066,1478,1588
050,53,035,"Washington","Kitsap County",3,72,2975,1394,1581
050,53,035,"Washington","Kitsap County",3,73,2934,1357,1577
050,53,035,"Washington","Kitsap County",3,74,3126,1472,1654
050,53,035,"Washington","Kitsap County",3,75,2201,1045,1156
050,53,035,"Washington","Kitsap County",3,76,2057,970,1087
050,53,035,"Washington","Kitsap County",3,77,1996,953,1043
050,53,035,"Washington","Kitsap County",3,78,1926,915,1011
050,53,035,"Washington","Kitsap County",3,79,1570,747,823
050,53,035,"Washington","Kitsap County",3,80,1353,635,718
050,53,035,"Washington","Kitsap County",3,81,1205,556,649
050,53,035,"Washington","Kitsap County",3,82,1028,494,534
050,53,035,"Washington","Kitsap County",3,83,933,421,512
050,53,035,"Washington","Kitsap County",3,84,803,336,467
050,53,035,"Washington","Kitsap County",3,85,4727,1772,2955
050,53,035,"Washington","Kitsap County",4,0,2811,1448,1363
050,53,035,"Washington","Kitsap County",4,1,2795,1434,1361
050,53,035,"Washington","Kitsap County",4,2,2928,1543,1385
050,53,035,"Washington","Kitsap County",4,3,2897,1502,1395
050,53,035,"Washington","Kitsap County",4,4,2922,1515,1407
050,53,035,"Washington","Kitsap County",4,5,3073,1602,1471
050,53,035,"Washington","Kitsap County",4,6,3137,1675,1462
050,53,035,"Washington","Kitsap County",4,7,3089,1591,1498
050,53,035,"Washington","Kitsap County",4,8,3066,1543,1523
050,53,035,"Washington","Kitsap County",4,9,3076,1541,1535
050,53,035,"Washington","Kitsap County",4,10,3055,1554,1501
050,53,035,"Washington","Kitsap County",4,11,3012,1539,1473
050,53,035,"Washington","Kitsap County",4,12,3044,1522,1522
050,53,035,"Washington","Kitsap County",4,13,3108,1599,1509
050,53,035,"Washington","Kitsap County",4,14,3211,1656,1555
050,53,035,"Washington","Kitsap County",4,15,3175,1603,1572
050,53,035,"Washington","Kitsap County",4,16,3071,1569,1502
050,53,035,"Washington","Kitsap County",4,17,3033,1533,1500
050,53,035,"Washington","Kitsap County",4,18,2760,1453,1307
050,53,035,"Washington","Kitsap County",4,19,2820,1647,1173
050,53,035,"Washington","Kitsap County",4,20,3530,2185,1345
050,53,035,"Washington","Kitsap County",4,21,4187,2663,1524
050,53,035,"Washington","Kitsap County",4,22,4042,2531,1511
050,53,035,"Washington","Kitsap County",4,23,3822,2310,1512
050,53,035,"Washington","Kitsap County",4,24,3903,2347,1556
050,53,035,"Washington","Kitsap County",4,25,3932,2231,1701
050,53,035,"Washington","Kitsap County",4,26,3863,2169,1694
050,53,035,"Washington","Kitsap County",4,27,3900,2172,1728
050,53,035,"Washington","Kitsap County",4,28,3823,2116,1707
050,53,035,"Washington","Kitsap County",4,29,3960,2198,1762
050,53,035,"Washington","Kitsap County",4,30,4155,2194,1961
050,53,035,"Washington","Kitsap County",4,31,4188,2223,1965
050,53,035,"Washington","Kitsap County",4,32,4140,2194,1946
050,53,035,"Washington","Kitsap County",4,33,4041,2089,1952
050,53,035,"Washington","Kitsap County",4,34,3951,2065,1886
050,53,035,"Washington","Kitsap County",4,35,3937,2089,1848
050,53,035,"Washington","Kitsap County",4,36,4045,2135,1910
050,53,035,"Washington","Kitsap County",4,37,3899,2078,1821
050,53,035,"Washington","Kitsap County",4,38,3883,2090,1793
050,53,035,"Washington","Kitsap County",4,39,3815,1991,1824
050,53,035,"Washington","Kitsap County",4,40,3787,1953,1834
050,53,035,"Washington","Kitsap County",4,41,3689,1929,1760
050,53,035,"Washington","Kitsap County",4,42,3490,1773,1717
050,53,035,"Washington","Kitsap County",4,43,3334,1703,1631
050,53,035,"Washington","Kitsap County",4,44,3233,1660,1573
050,53,035,"Washington","Kitsap County",4,45,3161,1602,1559
050,53,035,"Washington","Kitsap County",4,46,2939,1540,1399
050,53,035,"Washington","Kitsap County",4,47,2927,1512,1415
050,53,035,"Washington","Kitsap County",4,48,2747,1410,1337
050,53,035,"Washington","Kitsap County",4,49,2757,1412,1345
050,53,035,"Washington","Kitsap County",4,50,2985,1529,1456
050,53,035,"Washington","Kitsap County",4,51,3261,1633,1628
050,53,035,"Washington","Kitsap County",4,52,3358,1692,1666
050,53,035,"Washington","Kitsap County",4,53,3188,1578,1610
050,53,035,"Washington","Kitsap County",4,54,3146,1526,1620
050,53,035,"Washington","Kitsap County",4,55,3170,1583,1587
050,53,035,"Washington","Kitsap County",4,56,3231,1605,1626
050,53,035,"Washington","Kitsap County",4,57,3391,1696,1695
050,53,035,"Washington","Kitsap County",4,58,3583,1791,1792
050,53,035,"Washington","Kitsap County",4,59,3796,1892,1904
050,53,035,"Washington","Kitsap County",4,60,3814,1843,1971
050,53,035,"Washington","Kitsap County",4,61,3827,1862,1965
050,53,035,"Washington","Kitsap County",4,62,3762,1847,1915
050,53,035,"Washington","Kitsap County",4,63,3738,1816,1922
050,53,035,"Washington","Kitsap County",4,64,3694,1801,1893
050,53,035,"Washington","Kitsap County",4,65,3698,1795,1903
050,53,035,"Washington","Kitsap County",4,66,3665,1742,1923
050,53,035,"Washington","Kitsap County",4,67,3620,1727,1893
050,53,035,"Washington","Kitsap County",4,68,3558,1671,1887
050,53,035,"Washington","Kitsap County",4,69,3444,1648,1796
050,53,035,"Washington","Kitsap County",4,70,3292,1567,1725
050,53,035,"Washington","Kitsap County",4,71,3188,1523,1665
050,53,035,"Washington","Kitsap County",4,72,3000,1425,1575
050,53,035,"Washington","Kitsap County",4,73,2949,1391,1558
050,53,035,"Washington","Kitsap County",4,74,2851,1313,1538
050,53,035,"Washington","Kitsap County",4,75,3058,1424,1634
050,53,035,"Washington","Kitsap County",4,76,2126,993,1133
050,53,035,"Washington","Kitsap County",4,77,1983,927,1056
050,53,035,"Washington","Kitsap County",4,78,1920,915,1005
050,53,035,"Washington","Kitsap County",4,79,1850,882,968
050,53,035,"Washington","Kitsap County",4,80,1488,705,783
050,53,035,"Washington","Kitsap County",4,81,1289,594,695
050,53,035,"Washington","Kitsap County",4,82,1117,515,602
050,53,035,"Washington","Kitsap County",4,83,990,466,524
050,53,035,"Washington","Kitsap County",4,84,868,382,486
050,53,035,"Washington","Kitsap County",4,85,4752,1799,2953
050,53,035,"Washington","Kitsap County",5,0,2795,1442,1353
050,53,035,"Washington","Kitsap County",5,1,2736,1417,1319
050,53,035,"Washington","Kitsap County",5,2,2773,1455,1318
050,53,035,"Washington","Kitsap County",5,3,2887,1527,1360
050,53,035,"Washington","Kitsap County",5,4,2834,1470,1364
050,53,035,"Washington","Kitsap County",5,5,2945,1524,1421
050,53,035,"Washington","Kitsap County",5,6,3047,1594,1453
050,53,035,"Washington","Kitsap County",5,7,3125,1655,1470
050,53,035,"Washington","Kitsap County",5,8,3045,1564,1481
050,53,035,"Washington","Kitsap County",5,9,3009,1515,1494
050,53,035,"Washington","Kitsap County",5,10,3020,1531,1489
050,53,035,"Washington","Kitsap County",5,11,2998,1506,1492
050,53,035,"Washington","Kitsap County",5,12,2942,1515,1427
050,53,035,"Washington","Kitsap County",5,13,3017,1504,1513
050,53,035,"Washington","Kitsap County",5,14,3055,1569,1486
050,53,035,"Washington","Kitsap County",5,15,3177,1652,1525
050,53,035,"Washington","Kitsap County",5,16,3156,1608,1548
050,53,035,"Washington","Kitsap County",5,17,3027,1547,1480
050,53,035,"Washington","Kitsap County",5,18,2683,1422,1261
050,53,035,"Washington","Kitsap County",5,19,2832,1667,1165
050,53,035,"Washington","Kitsap County",5,20,3489,2196,1293
050,53,035,"Washington","Kitsap County",5,21,4021,2520,1501
050,53,035,"Washington","Kitsap County",5,22,3989,2456,1533
050,53,035,"Washington","Kitsap County",5,23,3831,2321,1510
050,53,035,"Washington","Kitsap County",5,24,3761,2278,1483
050,53,035,"Washington","Kitsap County",5,25,3717,2130,1587
050,53,035,"Washington","Kitsap County",5,26,3808,2088,1720
050,53,035,"Washington","Kitsap County",5,27,3796,2090,1706
050,53,035,"Washington","Kitsap County",5,28,3714,2044,1670
050,53,035,"Washington","Kitsap County",5,29,3774,2074,1700
050,53,035,"Washington","Kitsap County",5,30,3978,2224,1754
050,53,035,"Washington","Kitsap County",5,31,4159,2205,1954
050,53,035,"Washington","Kitsap County",5,32,4190,2191,1999
050,53,035,"Washington","Kitsap County",5,33,4157,2203,1954
050,53,035,"Washington","Kitsap County",5,34,4127,2151,1976
050,53,035,"Washington","Kitsap County",5,35,3974,2054,1920
050,53,035,"Washington","Kitsap County",5,36,3945,2077,1868
050,53,035,"Washington","Kitsap County",5,37,4073,2153,1920
050,53,035,"Washington","Kitsap County",5,38,3834,2057,1777
050,53,035,"Washington","Kitsap County",5,39,3816,2027,1789
050,53,035,"Washington","Kitsap County",5,40,3760,1933,1827
050,53,035,"Washington","Kitsap County",5,41,3816,1972,1844
050,53,035,"Washington","Kitsap County",5,42,3660,1929,1731
050,53,035,"Washington","Kitsap County",5,43,3464,1764,1700
050,53,035,"Washington","Kitsap County",5,44,3303,1655,1648
050,53,035,"Washington","Kitsap County",5,45,3261,1664,1597
050,53,035,"Washington","Kitsap County",5,46,3132,1610,1522
050,53,035,"Washington","Kitsap County",5,47,2969,1547,1422
050,53,035,"Washington","Kitsap County",5,48,2943,1512,1431
050,53,035,"Washington","Kitsap County",5,49,2744,1407,1337
050,53,035,"Washington","Kitsap County",5,50,2775,1428,1347
050,53,035,"Washington","Kitsap County",5,51,2948,1503,1445
050,53,035,"Washington","Kitsap County",5,52,3232,1627,1605
050,53,035,"Washington","Kitsap County",5,53,3379,1684,1695
050,53,035,"Washington","Kitsap County",5,54,3197,1592,1605
050,53,035,"Washington","Kitsap County",5,55,3164,1526,1638
050,53,035,"Washington","Kitsap County",5,56,3181,1596,1585
050,53,035,"Washington","Kitsap County",5,57,3271,1631,1640
050,53,035,"Washington","Kitsap County",5,58,3382,1686,1696
050,53,035,"Washington","Kitsap County",5,59,3568,1786,1782
050,53,035,"Washington","Kitsap County",5,60,3799,1889,1910
050,53,035,"Washington","Kitsap County",5,61,3768,1819,1949
050,53,035,"Washington","Kitsap County",5,62,3821,1856,1965
050,53,035,"Washington","Kitsap County",5,63,3768,1842,1926
050,53,035,"Washington","Kitsap County",5,64,3700,1777,1923
050,53,035,"Washington","Kitsap County",5,65,3672,1770,1902
050,53,035,"Washington","Kitsap County",5,66,3660,1768,1892
050,53,035,"Washington","Kitsap County",5,67,3612,1710,1902
050,53,035,"Washington","Kitsap County",5,68,3579,1704,1875
050,53,035,"Washington","Kitsap County",5,69,3538,1663,1875
050,53,035,"Washington","Kitsap County",5,70,3393,1619,1774
050,53,035,"Washington","Kitsap County",5,71,3251,1553,1698
050,53,035,"Washington","Kitsap County",5,72,3135,1490,1645
050,53,035,"Washington","Kitsap County",5,73,2965,1410,1555
050,53,035,"Washington","Kitsap County",5,74,2853,1335,1518
050,53,035,"Washington","Kitsap County",5,75,2791,1280,1511
050,53,035,"Washington","Kitsap County",5,76,2957,1356,1601
050,53,035,"Washington","Kitsap County",5,77,2046,951,1095
050,53,035,"Washington","Kitsap County",5,78,1923,888,1035
050,53,035,"Washington","Kitsap County",5,79,1832,874,958
050,53,035,"Washington","Kitsap County",5,80,1750,824,926
050,53,035,"Washington","Kitsap County",5,81,1414,658,756
050,53,035,"Washington","Kitsap County",5,82,1222,556,666
050,53,035,"Washington","Kitsap County",5,83,1073,492,581
050,53,035,"Washington","Kitsap County",5,84,921,422,499
050,53,035,"Washington","Kitsap County",5,85,4810,1871,2939
050,53,037,"Washington","Kittitas County",1,0,383,196,187
050,53,037,"Washington","Kittitas County",1,1,388,205,183
050,53,037,"Washington","Kittitas County",1,2,409,223,186
050,53,037,"Washington","Kittitas County",1,3,427,209,218
050,53,037,"Washington","Kittitas County",1,4,441,228,213
050,53,037,"Washington","Kittitas County",1,5,448,232,216
050,53,037,"Washington","Kittitas County",1,6,395,205,190
050,53,037,"Washington","Kittitas County",1,7,443,222,221
050,53,037,"Washington","Kittitas County",1,8,453,232,221
050,53,037,"Washington","Kittitas County",1,9,454,248,206
050,53,037,"Washington","Kittitas County",1,10,457,239,218
050,53,037,"Washington","Kittitas County",1,11,475,234,241
050,53,037,"Washington","Kittitas County",1,12,478,236,242
050,53,037,"Washington","Kittitas County",1,13,456,227,229
050,53,037,"Washington","Kittitas County",1,14,411,202,209
050,53,037,"Washington","Kittitas County",1,15,449,223,226
050,53,037,"Washington","Kittitas County",1,16,461,227,234
050,53,037,"Washington","Kittitas County",1,17,431,220,211
050,53,037,"Washington","Kittitas County",1,18,590,266,324
050,53,037,"Washington","Kittitas County",1,19,907,436,471
050,53,037,"Washington","Kittitas County",1,20,1366,675,691
050,53,037,"Washington","Kittitas County",1,21,1594,727,867
050,53,037,"Washington","Kittitas County",1,22,1609,832,777
050,53,037,"Washington","Kittitas County",1,23,1223,617,606
050,53,037,"Washington","Kittitas County",1,24,845,464,381
050,53,037,"Washington","Kittitas County",1,25,702,399,303
050,53,037,"Washington","Kittitas County",1,26,630,367,263
050,53,037,"Washington","Kittitas County",1,27,583,313,270
050,53,037,"Washington","Kittitas County",1,28,562,298,264
050,53,037,"Washington","Kittitas County",1,29,559,292,267
050,53,037,"Washington","Kittitas County",1,30,562,307,255
050,53,037,"Washington","Kittitas County",1,31,576,326,250
050,53,037,"Washington","Kittitas County",1,32,509,275,234
050,53,037,"Washington","Kittitas County",1,33,481,246,235
050,53,037,"Washington","Kittitas County",1,34,491,236,255
050,53,037,"Washington","Kittitas County",1,35,505,269,236
050,53,037,"Washington","Kittitas County",1,36,494,253,241
050,53,037,"Washington","Kittitas County",1,37,536,287,249
050,53,037,"Washington","Kittitas County",1,38,495,237,258
050,53,037,"Washington","Kittitas County",1,39,527,273,254
050,53,037,"Washington","Kittitas County",1,40,455,229,226
050,53,037,"Washington","Kittitas County",1,41,455,238,217
050,53,037,"Washington","Kittitas County",1,42,498,250,248
050,53,037,"Washington","Kittitas County",1,43,471,243,228
050,53,037,"Washington","Kittitas County",1,44,415,231,184
050,53,037,"Washington","Kittitas County",1,45,428,242,186
050,53,037,"Washington","Kittitas County",1,46,418,216,202
050,53,037,"Washington","Kittitas County",1,47,429,219,210
050,53,037,"Washington","Kittitas County",1,48,476,258,218
050,53,037,"Washington","Kittitas County",1,49,496,258,238
050,53,037,"Washington","Kittitas County",1,50,490,247,243
050,53,037,"Washington","Kittitas County",1,51,471,248,223
050,53,037,"Washington","Kittitas County",1,52,446,232,214
050,53,037,"Washington","Kittitas County",1,53,446,216,230
050,53,037,"Washington","Kittitas County",1,54,480,237,243
050,53,037,"Washington","Kittitas County",1,55,519,257,262
050,53,037,"Washington","Kittitas County",1,56,506,243,263
050,53,037,"Washington","Kittitas County",1,57,547,275,272
050,53,037,"Washington","Kittitas County",1,58,584,289,295
050,53,037,"Washington","Kittitas County",1,59,576,290,286
050,53,037,"Washington","Kittitas County",1,60,618,290,328
050,53,037,"Washington","Kittitas County",1,61,628,295,333
050,53,037,"Washington","Kittitas County",1,62,590,284,306
050,53,037,"Washington","Kittitas County",1,63,581,297,284
050,53,037,"Washington","Kittitas County",1,64,574,296,278
050,53,037,"Washington","Kittitas County",1,65,571,291,280
050,53,037,"Washington","Kittitas County",1,66,564,284,280
050,53,037,"Washington","Kittitas County",1,67,545,285,260
050,53,037,"Washington","Kittitas County",1,68,515,277,238
050,53,037,"Washington","Kittitas County",1,69,486,237,249
050,53,037,"Washington","Kittitas County",1,70,451,229,222
050,53,037,"Washington","Kittitas County",1,71,426,212,214
050,53,037,"Washington","Kittitas County",1,72,436,219,217
050,53,037,"Washington","Kittitas County",1,73,425,215,210
050,53,037,"Washington","Kittitas County",1,74,303,158,145
050,53,037,"Washington","Kittitas County",1,75,297,150,147
050,53,037,"Washington","Kittitas County",1,76,281,144,137
050,53,037,"Washington","Kittitas County",1,77,280,138,142
050,53,037,"Washington","Kittitas County",1,78,234,118,116
050,53,037,"Washington","Kittitas County",1,79,222,115,107
050,53,037,"Washington","Kittitas County",1,80,203,97,106
050,53,037,"Washington","Kittitas County",1,81,189,95,94
050,53,037,"Washington","Kittitas County",1,82,175,92,83
050,53,037,"Washington","Kittitas County",1,83,132,70,62
050,53,037,"Washington","Kittitas County",1,84,105,56,49
050,53,037,"Washington","Kittitas County",1,85,668,272,396
050,53,037,"Washington","Kittitas County",2,0,385,189,196
050,53,037,"Washington","Kittitas County",2,1,395,210,185
050,53,037,"Washington","Kittitas County",2,2,410,223,187
050,53,037,"Washington","Kittitas County",2,3,425,215,210
050,53,037,"Washington","Kittitas County",2,4,443,227,216
050,53,037,"Washington","Kittitas County",2,5,447,232,215
050,53,037,"Washington","Kittitas County",2,6,410,212,198
050,53,037,"Washington","Kittitas County",2,7,435,220,215
050,53,037,"Washington","Kittitas County",2,8,452,231,221
050,53,037,"Washington","Kittitas County",2,9,457,245,212
050,53,037,"Washington","Kittitas County",2,10,458,241,217
050,53,037,"Washington","Kittitas County",2,11,471,235,236
050,53,037,"Washington","Kittitas County",2,12,481,236,245
050,53,037,"Washington","Kittitas County",2,13,462,229,233
050,53,037,"Washington","Kittitas County",2,14,424,209,215
050,53,037,"Washington","Kittitas County",2,15,442,220,222
050,53,037,"Washington","Kittitas County",2,16,458,224,234
050,53,037,"Washington","Kittitas County",2,17,443,224,219
050,53,037,"Washington","Kittitas County",2,18,601,274,327
050,53,037,"Washington","Kittitas County",2,19,933,445,488
050,53,037,"Washington","Kittitas County",2,20,1378,682,696
050,53,037,"Washington","Kittitas County",2,21,1587,719,868
050,53,037,"Washington","Kittitas County",2,22,1595,830,765
050,53,037,"Washington","Kittitas County",2,23,1225,613,612
050,53,037,"Washington","Kittitas County",2,24,855,472,383
050,53,037,"Washington","Kittitas County",2,25,710,403,307
050,53,037,"Washington","Kittitas County",2,26,626,365,261
050,53,037,"Washington","Kittitas County",2,27,577,316,261
050,53,037,"Washington","Kittitas County",2,28,566,299,267
050,53,037,"Washington","Kittitas County",2,29,558,289,269
050,53,037,"Washington","Kittitas County",2,30,575,311,264
050,53,037,"Washington","Kittitas County",2,31,576,323,253
050,53,037,"Washington","Kittitas County",2,32,526,286,240
050,53,037,"Washington","Kittitas County",2,33,493,254,239
050,53,037,"Washington","Kittitas County",2,34,495,242,253
050,53,037,"Washington","Kittitas County",2,35,510,263,247
050,53,037,"Washington","Kittitas County",2,36,501,261,240
050,53,037,"Washington","Kittitas County",2,37,533,282,251
050,53,037,"Washington","Kittitas County",2,38,515,255,260
050,53,037,"Washington","Kittitas County",2,39,518,265,253
050,53,037,"Washington","Kittitas County",2,40,476,243,233
050,53,037,"Washington","Kittitas County",2,41,461,237,224
050,53,037,"Washington","Kittitas County",2,42,492,248,244
050,53,037,"Washington","Kittitas County",2,43,483,249,234
050,53,037,"Washington","Kittitas County",2,44,427,236,191
050,53,037,"Washington","Kittitas County",2,45,430,241,189
050,53,037,"Washington","Kittitas County",2,46,416,220,196
050,53,037,"Washington","Kittitas County",2,47,425,218,207
050,53,037,"Washington","Kittitas County",2,48,466,251,215
050,53,037,"Washington","Kittitas County",2,49,497,260,237
050,53,037,"Washington","Kittitas County",2,50,493,251,242
050,53,037,"Washington","Kittitas County",2,51,475,247,228
050,53,037,"Washington","Kittitas County",2,52,453,236,217
050,53,037,"Washington","Kittitas County",2,53,449,221,228
050,53,037,"Washington","Kittitas County",2,54,472,232,240
050,53,037,"Washington","Kittitas County",2,55,513,253,260
050,53,037,"Washington","Kittitas County",2,56,513,250,263
050,53,037,"Washington","Kittitas County",2,57,536,266,270
050,53,037,"Washington","Kittitas County",2,58,575,285,290
050,53,037,"Washington","Kittitas County",2,59,582,291,291
050,53,037,"Washington","Kittitas County",2,60,609,289,320
050,53,037,"Washington","Kittitas County",2,61,629,295,334
050,53,037,"Washington","Kittitas County",2,62,602,288,314
050,53,037,"Washington","Kittitas County",2,63,595,300,295
050,53,037,"Washington","Kittitas County",2,64,576,296,280
050,53,037,"Washington","Kittitas County",2,65,573,294,279
050,53,037,"Washington","Kittitas County",2,66,569,287,282
050,53,037,"Washington","Kittitas County",2,67,550,285,265
050,53,037,"Washington","Kittitas County",2,68,521,278,243
050,53,037,"Washington","Kittitas County",2,69,496,250,246
050,53,037,"Washington","Kittitas County",2,70,459,232,227
050,53,037,"Washington","Kittitas County",2,71,431,216,215
050,53,037,"Washington","Kittitas County",2,72,425,213,212
050,53,037,"Washington","Kittitas County",2,73,448,226,222
050,53,037,"Washington","Kittitas County",2,74,311,160,151
050,53,037,"Washington","Kittitas County",2,75,299,152,147
050,53,037,"Washington","Kittitas County",2,76,281,143,138
050,53,037,"Washington","Kittitas County",2,77,287,143,144
050,53,037,"Washington","Kittitas County",2,78,240,121,119
050,53,037,"Washington","Kittitas County",2,79,220,112,108
050,53,037,"Washington","Kittitas County",2,80,210,103,107
050,53,037,"Washington","Kittitas County",2,81,190,95,95
050,53,037,"Washington","Kittitas County",2,82,177,91,86
050,53,037,"Washington","Kittitas County",2,83,139,72,67
050,53,037,"Washington","Kittitas County",2,84,109,57,52
050,53,037,"Washington","Kittitas County",2,85,668,278,390
050,53,037,"Washington","Kittitas County",3,0,358,169,189
050,53,037,"Washington","Kittitas County",3,1,411,207,204
050,53,037,"Washington","Kittitas County",3,2,402,217,185
050,53,037,"Washington","Kittitas County",3,3,401,206,195
050,53,037,"Washington","Kittitas County",3,4,422,215,207
050,53,037,"Washington","Kittitas County",3,5,441,218,223
050,53,037,"Washington","Kittitas County",3,6,449,225,224
050,53,037,"Washington","Kittitas County",3,7,400,210,190
050,53,037,"Washington","Kittitas County",3,8,450,230,220
050,53,037,"Washington","Kittitas County",3,9,451,228,223
050,53,037,"Washington","Kittitas County",3,10,478,261,217
050,53,037,"Washington","Kittitas County",3,11,470,255,215
050,53,037,"Washington","Kittitas County",3,12,479,245,234
050,53,037,"Washington","Kittitas County",3,13,502,245,257
050,53,037,"Washington","Kittitas County",3,14,457,228,229
050,53,037,"Washington","Kittitas County",3,15,423,206,217
050,53,037,"Washington","Kittitas County",3,16,451,219,232
050,53,037,"Washington","Kittitas County",3,17,466,232,234
050,53,037,"Washington","Kittitas County",3,18,416,217,199
050,53,037,"Washington","Kittitas County",3,19,531,249,282
050,53,037,"Washington","Kittitas County",3,20,1251,602,649
050,53,037,"Washington","Kittitas County",3,21,1541,678,863
050,53,037,"Washington","Kittitas County",3,22,1581,818,763
050,53,037,"Washington","Kittitas County",3,23,1202,607,595
050,53,037,"Washington","Kittitas County",3,24,825,449,376
050,53,037,"Washington","Kittitas County",3,25,711,393,318
050,53,037,"Washington","Kittitas County",3,26,601,342,259
050,53,037,"Washington","Kittitas County",3,27,560,310,250
050,53,037,"Washington","Kittitas County",3,28,570,316,254
050,53,037,"Washington","Kittitas County",3,29,551,292,259
050,53,037,"Washington","Kittitas County",3,30,562,292,270
050,53,037,"Washington","Kittitas County",3,31,562,304,258
050,53,037,"Washington","Kittitas County",3,32,583,317,266
050,53,037,"Washington","Kittitas County",3,33,514,259,255
050,53,037,"Washington","Kittitas County",3,34,508,265,243
050,53,037,"Washington","Kittitas County",3,35,515,260,255
050,53,037,"Washington","Kittitas County",3,36,546,275,271
050,53,037,"Washington","Kittitas County",3,37,538,277,261
050,53,037,"Washington","Kittitas County",3,38,548,291,257
050,53,037,"Washington","Kittitas County",3,39,532,263,269
050,53,037,"Washington","Kittitas County",3,40,542,272,270
050,53,037,"Washington","Kittitas County",3,41,494,256,238
050,53,037,"Washington","Kittitas County",3,42,484,250,234
050,53,037,"Washington","Kittitas County",3,43,507,256,251
050,53,037,"Washington","Kittitas County",3,44,502,259,243
050,53,037,"Washington","Kittitas County",3,45,442,242,200
050,53,037,"Washington","Kittitas County",3,46,453,254,199
050,53,037,"Washington","Kittitas County",3,47,424,221,203
050,53,037,"Washington","Kittitas County",3,48,452,231,221
050,53,037,"Washington","Kittitas County",3,49,454,235,219
050,53,037,"Washington","Kittitas County",3,50,511,269,242
050,53,037,"Washington","Kittitas County",3,51,494,254,240
050,53,037,"Washington","Kittitas County",3,52,495,254,241
050,53,037,"Washington","Kittitas County",3,53,486,258,228
050,53,037,"Washington","Kittitas County",3,54,461,221,240
050,53,037,"Washington","Kittitas County",3,55,487,243,244
050,53,037,"Washington","Kittitas County",3,56,518,251,267
050,53,037,"Washington","Kittitas County",3,57,525,254,271
050,53,037,"Washington","Kittitas County",3,58,560,280,280
050,53,037,"Washington","Kittitas County",3,59,603,293,310
050,53,037,"Washington","Kittitas County",3,60,615,300,315
050,53,037,"Washington","Kittitas County",3,61,621,294,327
050,53,037,"Washington","Kittitas County",3,62,644,307,337
050,53,037,"Washington","Kittitas County",3,63,629,304,325
050,53,037,"Washington","Kittitas County",3,64,621,308,313
050,53,037,"Washington","Kittitas County",3,65,594,296,298
050,53,037,"Washington","Kittitas County",3,66,583,293,290
050,53,037,"Washington","Kittitas County",3,67,573,289,284
050,53,037,"Washington","Kittitas County",3,68,543,282,261
050,53,037,"Washington","Kittitas County",3,69,530,280,250
050,53,037,"Washington","Kittitas County",3,70,489,250,239
050,53,037,"Washington","Kittitas County",3,71,449,227,222
050,53,037,"Washington","Kittitas County",3,72,419,215,204
050,53,037,"Washington","Kittitas County",3,73,423,211,212
050,53,037,"Washington","Kittitas County",3,74,434,222,212
050,53,037,"Washington","Kittitas County",3,75,307,162,145
050,53,037,"Washington","Kittitas County",3,76,288,145,143
050,53,037,"Washington","Kittitas County",3,77,273,137,136
050,53,037,"Washington","Kittitas County",3,78,276,139,137
050,53,037,"Washington","Kittitas County",3,79,226,111,115
050,53,037,"Washington","Kittitas County",3,80,208,109,99
050,53,037,"Washington","Kittitas County",3,81,205,98,107
050,53,037,"Washington","Kittitas County",3,82,171,86,85
050,53,037,"Washington","Kittitas County",3,83,166,86,80
050,53,037,"Washington","Kittitas County",3,84,128,63,65
050,53,037,"Washington","Kittitas County",3,85,677,292,385
050,53,037,"Washington","Kittitas County",4,0,399,195,204
050,53,037,"Washington","Kittitas County",4,1,356,172,184
050,53,037,"Washington","Kittitas County",4,2,392,192,200
050,53,037,"Washington","Kittitas County",4,3,400,214,186
050,53,037,"Washington","Kittitas County",4,4,401,196,205
050,53,037,"Washington","Kittitas County",4,5,444,230,214
050,53,037,"Washington","Kittitas County",4,6,447,221,226
050,53,037,"Washington","Kittitas County",4,7,454,229,225
050,53,037,"Washington","Kittitas County",4,8,421,205,216
050,53,037,"Washington","Kittitas County",4,9,443,225,218
050,53,037,"Washington","Kittitas County",4,10,439,218,221
050,53,037,"Washington","Kittitas County",4,11,483,264,219
050,53,037,"Washington","Kittitas County",4,12,498,270,228
050,53,037,"Washington","Kittitas County",4,13,480,250,230
050,53,037,"Washington","Kittitas County",4,14,492,241,251
050,53,037,"Washington","Kittitas County",4,15,454,227,227
050,53,037,"Washington","Kittitas County",4,16,429,207,222
050,53,037,"Washington","Kittitas County",4,17,439,214,225
050,53,037,"Washington","Kittitas County",4,18,418,218,200
050,53,037,"Washington","Kittitas County",4,19,553,265,288
050,53,037,"Washington","Kittitas County",4,20,1236,609,627
050,53,037,"Washington","Kittitas County",4,21,1603,697,906
050,53,037,"Washington","Kittitas County",4,22,1609,833,776
050,53,037,"Washington","Kittitas County",4,23,1224,600,624
050,53,037,"Washington","Kittitas County",4,24,812,449,363
050,53,037,"Washington","Kittitas County",4,25,706,389,317
050,53,037,"Washington","Kittitas County",4,26,603,316,287
050,53,037,"Washington","Kittitas County",4,27,506,278,228
050,53,037,"Washington","Kittitas County",4,28,544,297,247
050,53,037,"Washington","Kittitas County",4,29,580,323,257
050,53,037,"Washington","Kittitas County",4,30,548,282,266
050,53,037,"Washington","Kittitas County",4,31,549,277,272
050,53,037,"Washington","Kittitas County",4,32,556,295,261
050,53,037,"Washington","Kittitas County",4,33,582,314,268
050,53,037,"Washington","Kittitas County",4,34,525,269,256
050,53,037,"Washington","Kittitas County",4,35,521,266,255
050,53,037,"Washington","Kittitas County",4,36,530,266,264
050,53,037,"Washington","Kittitas County",4,37,558,288,270
050,53,037,"Washington","Kittitas County",4,38,528,263,265
050,53,037,"Washington","Kittitas County",4,39,557,298,259
050,53,037,"Washington","Kittitas County",4,40,547,272,275
050,53,037,"Washington","Kittitas County",4,41,531,266,265
050,53,037,"Washington","Kittitas County",4,42,499,256,243
050,53,037,"Washington","Kittitas County",4,43,503,268,235
050,53,037,"Washington","Kittitas County",4,44,499,248,251
050,53,037,"Washington","Kittitas County",4,45,507,258,249
050,53,037,"Washington","Kittitas County",4,46,445,241,204
050,53,037,"Washington","Kittitas County",4,47,441,244,197
050,53,037,"Washington","Kittitas County",4,48,443,236,207
050,53,037,"Washington","Kittitas County",4,49,464,238,226
050,53,037,"Washington","Kittitas County",4,50,456,232,224
050,53,037,"Washington","Kittitas County",4,51,524,275,249
050,53,037,"Washington","Kittitas County",4,52,487,244,243
050,53,037,"Washington","Kittitas County",4,53,501,259,242
050,53,037,"Washington","Kittitas County",4,54,503,268,235
050,53,037,"Washington","Kittitas County",4,55,487,229,258
050,53,037,"Washington","Kittitas County",4,56,498,254,244
050,53,037,"Washington","Kittitas County",4,57,542,264,278
050,53,037,"Washington","Kittitas County",4,58,548,270,278
050,53,037,"Washington","Kittitas County",4,59,569,289,280
050,53,037,"Washington","Kittitas County",4,60,593,285,308
050,53,037,"Washington","Kittitas County",4,61,635,316,319
050,53,037,"Washington","Kittitas County",4,62,633,297,336
050,53,037,"Washington","Kittitas County",4,63,635,309,326
050,53,037,"Washington","Kittitas County",4,64,618,291,327
050,53,037,"Washington","Kittitas County",4,65,639,316,323
050,53,037,"Washington","Kittitas County",4,66,584,286,298
050,53,037,"Washington","Kittitas County",4,67,569,289,280
050,53,037,"Washington","Kittitas County",4,68,562,279,283
050,53,037,"Washington","Kittitas County",4,69,536,270,266
050,53,037,"Washington","Kittitas County",4,70,521,278,243
050,53,037,"Washington","Kittitas County",4,71,485,246,239
050,53,037,"Washington","Kittitas County",4,72,442,223,219
050,53,037,"Washington","Kittitas County",4,73,407,208,199
050,53,037,"Washington","Kittitas County",4,74,405,198,207
050,53,037,"Washington","Kittitas County",4,75,435,224,211
050,53,037,"Washington","Kittitas County",4,76,289,154,135
050,53,037,"Washington","Kittitas County",4,77,283,141,142
050,53,037,"Washington","Kittitas County",4,78,263,139,124
050,53,037,"Washington","Kittitas County",4,79,262,126,136
050,53,037,"Washington","Kittitas County",4,80,215,106,109
050,53,037,"Washington","Kittitas County",4,81,200,100,100
050,53,037,"Washington","Kittitas County",4,82,190,85,105
050,53,037,"Washington","Kittitas County",4,83,152,80,72
050,53,037,"Washington","Kittitas County",4,84,160,80,80
050,53,037,"Washington","Kittitas County",4,85,696,309,387
050,53,037,"Washington","Kittitas County",5,0,393,192,201
050,53,037,"Washington","Kittitas County",5,1,418,210,208
050,53,037,"Washington","Kittitas County",5,2,359,171,188
050,53,037,"Washington","Kittitas County",5,3,408,198,210
050,53,037,"Washington","Kittitas County",5,4,418,224,194
050,53,037,"Washington","Kittitas County",5,5,407,197,210
050,53,037,"Washington","Kittitas County",5,6,442,226,216
050,53,037,"Washington","Kittitas County",5,7,442,214,228
050,53,037,"Washington","Kittitas County",5,8,465,235,230
050,53,037,"Washington","Kittitas County",5,9,400,196,204
050,53,037,"Washington","Kittitas County",5,10,458,232,226
050,53,037,"Washington","Kittitas County",5,11,448,221,227
050,53,037,"Washington","Kittitas County",5,12,491,262,229
050,53,037,"Washington","Kittitas County",5,13,499,268,231
050,53,037,"Washington","Kittitas County",5,14,484,246,238
050,53,037,"Washington","Kittitas County",5,15,486,244,242
050,53,037,"Washington","Kittitas County",5,16,452,230,222
050,53,037,"Washington","Kittitas County",5,17,433,210,223
050,53,037,"Washington","Kittitas County",5,18,397,210,187
050,53,037,"Washington","Kittitas County",5,19,520,258,262
050,53,037,"Washington","Kittitas County",5,20,1225,598,627
050,53,037,"Washington","Kittitas County",5,21,1529,669,860
050,53,037,"Washington","Kittitas County",5,22,1664,831,833
050,53,037,"Washington","Kittitas County",5,23,1247,622,625
050,53,037,"Washington","Kittitas County",5,24,896,501,395
050,53,037,"Washington","Kittitas County",5,25,685,386,299
050,53,037,"Washington","Kittitas County",5,26,617,335,282
050,53,037,"Washington","Kittitas County",5,27,540,272,268
050,53,037,"Washington","Kittitas County",5,28,508,269,239
050,53,037,"Washington","Kittitas County",5,29,540,298,242
050,53,037,"Washington","Kittitas County",5,30,586,332,254
050,53,037,"Washington","Kittitas County",5,31,544,284,260
050,53,037,"Washington","Kittitas County",5,32,540,277,263
050,53,037,"Washington","Kittitas County",5,33,552,287,265
050,53,037,"Washington","Kittitas County",5,34,597,326,271
050,53,037,"Washington","Kittitas County",5,35,522,262,260
050,53,037,"Washington","Kittitas County",5,36,516,260,256
050,53,037,"Washington","Kittitas County",5,37,537,268,269
050,53,037,"Washington","Kittitas County",5,38,549,283,266
050,53,037,"Washington","Kittitas County",5,39,531,266,265
050,53,037,"Washington","Kittitas County",5,40,570,295,275
050,53,037,"Washington","Kittitas County",5,41,548,273,275
050,53,037,"Washington","Kittitas County",5,42,554,285,269
050,53,037,"Washington","Kittitas County",5,43,489,256,233
050,53,037,"Washington","Kittitas County",5,44,495,261,234
050,53,037,"Washington","Kittitas County",5,45,497,243,254
050,53,037,"Washington","Kittitas County",5,46,503,254,249
050,53,037,"Washington","Kittitas County",5,47,449,236,213
050,53,037,"Washington","Kittitas County",5,48,443,242,201
050,53,037,"Washington","Kittitas County",5,49,436,236,200
050,53,037,"Washington","Kittitas County",5,50,470,238,232
050,53,037,"Washington","Kittitas County",5,51,471,243,228
050,53,037,"Washington","Kittitas County",5,52,531,281,250
050,53,037,"Washington","Kittitas County",5,53,488,250,238
050,53,037,"Washington","Kittitas County",5,54,497,257,240
050,53,037,"Washington","Kittitas County",5,55,511,269,242
050,53,037,"Washington","Kittitas County",5,56,483,233,250
050,53,037,"Washington","Kittitas County",5,57,505,263,242
050,53,037,"Washington","Kittitas County",5,58,533,251,282
050,53,037,"Washington","Kittitas County",5,59,566,281,285
050,53,037,"Washington","Kittitas County",5,60,570,294,276
050,53,037,"Washington","Kittitas County",5,61,607,292,315
050,53,037,"Washington","Kittitas County",5,62,644,321,323
050,53,037,"Washington","Kittitas County",5,63,642,310,332
050,53,037,"Washington","Kittitas County",5,64,619,299,320
050,53,037,"Washington","Kittitas County",5,65,612,280,332
050,53,037,"Washington","Kittitas County",5,66,635,319,316
050,53,037,"Washington","Kittitas County",5,67,577,278,299
050,53,037,"Washington","Kittitas County",5,68,566,291,275
050,53,037,"Washington","Kittitas County",5,69,567,274,293
050,53,037,"Washington","Kittitas County",5,70,541,274,267
050,53,037,"Washington","Kittitas County",5,71,507,270,237
050,53,037,"Washington","Kittitas County",5,72,470,238,232
050,53,037,"Washington","Kittitas County",5,73,433,216,217
050,53,037,"Washington","Kittitas County",5,74,382,197,185
050,53,037,"Washington","Kittitas County",5,75,405,199,206
050,53,037,"Washington","Kittitas County",5,76,418,212,206
050,53,037,"Washington","Kittitas County",5,77,284,152,132
050,53,037,"Washington","Kittitas County",5,78,275,134,141
050,53,037,"Washington","Kittitas County",5,79,255,133,122
050,53,037,"Washington","Kittitas County",5,80,249,124,125
050,53,037,"Washington","Kittitas County",5,81,207,101,106
050,53,037,"Washington","Kittitas County",5,82,193,93,100
050,53,037,"Washington","Kittitas County",5,83,171,80,91
050,53,037,"Washington","Kittitas County",5,84,143,72,71
050,53,037,"Washington","Kittitas County",5,85,752,350,402
050,53,039,"Washington","Klickitat County",1,0,208,108,100
050,53,039,"Washington","Klickitat County",1,1,208,107,101
050,53,039,"Washington","Klickitat County",1,2,232,114,118
050,53,039,"Washington","Klickitat County",1,3,224,122,102
050,53,039,"Washington","Klickitat County",1,4,218,111,107
050,53,039,"Washington","Klickitat County",1,5,231,116,115
050,53,039,"Washington","Klickitat County",1,6,247,133,114
050,53,039,"Washington","Klickitat County",1,7,244,124,120
050,53,039,"Washington","Klickitat County",1,8,237,131,106
050,53,039,"Washington","Klickitat County",1,9,232,123,109
050,53,039,"Washington","Klickitat County",1,10,249,135,114
050,53,039,"Washington","Klickitat County",1,11,261,134,127
050,53,039,"Washington","Klickitat County",1,12,257,124,133
050,53,039,"Washington","Klickitat County",1,13,282,152,130
050,53,039,"Washington","Klickitat County",1,14,276,149,127
050,53,039,"Washington","Klickitat County",1,15,250,134,116
050,53,039,"Washington","Klickitat County",1,16,253,123,130
050,53,039,"Washington","Klickitat County",1,17,260,133,127
050,53,039,"Washington","Klickitat County",1,18,222,112,110
050,53,039,"Washington","Klickitat County",1,19,195,106,89
050,53,039,"Washington","Klickitat County",1,20,183,98,85
050,53,039,"Washington","Klickitat County",1,21,188,98,90
050,53,039,"Washington","Klickitat County",1,22,194,107,87
050,53,039,"Washington","Klickitat County",1,23,189,104,85
050,53,039,"Washington","Klickitat County",1,24,216,104,112
050,53,039,"Washington","Klickitat County",1,25,237,130,107
050,53,039,"Washington","Klickitat County",1,26,226,110,116
050,53,039,"Washington","Klickitat County",1,27,201,110,91
050,53,039,"Washington","Klickitat County",1,28,257,139,118
050,53,039,"Washington","Klickitat County",1,29,231,119,112
050,53,039,"Washington","Klickitat County",1,30,253,133,120
050,53,039,"Washington","Klickitat County",1,31,264,134,130
050,53,039,"Washington","Klickitat County",1,32,252,141,111
050,53,039,"Washington","Klickitat County",1,33,239,118,121
050,53,039,"Washington","Klickitat County",1,34,276,120,156
050,53,039,"Washington","Klickitat County",1,35,260,125,135
050,53,039,"Washington","Klickitat County",1,36,268,134,134
050,53,039,"Washington","Klickitat County",1,37,244,131,113
050,53,039,"Washington","Klickitat County",1,38,285,152,133
050,53,039,"Washington","Klickitat County",1,39,291,146,145
050,53,039,"Washington","Klickitat County",1,40,294,169,125
050,53,039,"Washington","Klickitat County",1,41,260,137,123
050,53,039,"Washington","Klickitat County",1,42,277,149,128
050,53,039,"Washington","Klickitat County",1,43,270,147,123
050,53,039,"Washington","Klickitat County",1,44,258,118,140
050,53,039,"Washington","Klickitat County",1,45,272,134,138
050,53,039,"Washington","Klickitat County",1,46,289,130,159
050,53,039,"Washington","Klickitat County",1,47,282,137,145
050,53,039,"Washington","Klickitat County",1,48,284,150,134
050,53,039,"Washington","Klickitat County",1,49,303,168,135
050,53,039,"Washington","Klickitat County",1,50,279,143,136
050,53,039,"Washington","Klickitat County",1,51,275,156,119
050,53,039,"Washington","Klickitat County",1,52,275,146,129
050,53,039,"Washington","Klickitat County",1,53,271,154,117
050,53,039,"Washington","Klickitat County",1,54,288,150,138
050,53,039,"Washington","Klickitat County",1,55,318,151,167
050,53,039,"Washington","Klickitat County",1,56,326,170,156
050,53,039,"Washington","Klickitat County",1,57,321,166,155
050,53,039,"Washington","Klickitat County",1,58,350,164,186
050,53,039,"Washington","Klickitat County",1,59,330,157,173
050,53,039,"Washington","Klickitat County",1,60,371,174,197
050,53,039,"Washington","Klickitat County",1,61,368,178,190
050,53,039,"Washington","Klickitat County",1,62,388,192,196
050,53,039,"Washington","Klickitat County",1,63,404,201,203
050,53,039,"Washington","Klickitat County",1,64,399,206,193
050,53,039,"Washington","Klickitat County",1,65,387,188,199
050,53,039,"Washington","Klickitat County",1,66,404,190,214
050,53,039,"Washington","Klickitat County",1,67,395,200,195
050,53,039,"Washington","Klickitat County",1,68,390,197,193
050,53,039,"Washington","Klickitat County",1,69,339,170,169
050,53,039,"Washington","Klickitat County",1,70,334,173,161
050,53,039,"Washington","Klickitat County",1,71,340,173,167
050,53,039,"Washington","Klickitat County",1,72,318,174,144
050,53,039,"Washington","Klickitat County",1,73,321,169,152
050,53,039,"Washington","Klickitat County",1,74,212,110,102
050,53,039,"Washington","Klickitat County",1,75,223,114,109
050,53,039,"Washington","Klickitat County",1,76,221,111,110
050,53,039,"Washington","Klickitat County",1,77,206,99,107
050,53,039,"Washington","Klickitat County",1,78,174,91,83
050,53,039,"Washington","Klickitat County",1,79,164,89,75
050,53,039,"Washington","Klickitat County",1,80,142,80,62
050,53,039,"Washington","Klickitat County",1,81,121,67,54
050,53,039,"Washington","Klickitat County",1,82,122,62,60
050,53,039,"Washington","Klickitat County",1,83,96,45,51
050,53,039,"Washington","Klickitat County",1,84,91,42,49
050,53,039,"Washington","Klickitat County",1,85,438,152,286
050,53,039,"Washington","Klickitat County",2,0,215,112,103
050,53,039,"Washington","Klickitat County",2,1,210,108,102
050,53,039,"Washington","Klickitat County",2,2,223,109,114
050,53,039,"Washington","Klickitat County",2,3,227,121,106
050,53,039,"Washington","Klickitat County",2,4,219,114,105
050,53,039,"Washington","Klickitat County",2,5,227,115,112
050,53,039,"Washington","Klickitat County",2,6,246,131,115
050,53,039,"Washington","Klickitat County",2,7,247,125,122
050,53,039,"Washington","Klickitat County",2,8,240,130,110
050,53,039,"Washington","Klickitat County",2,9,233,124,109
050,53,039,"Washington","Klickitat County",2,10,245,132,113
050,53,039,"Washington","Klickitat County",2,11,263,137,126
050,53,039,"Washington","Klickitat County",2,12,260,127,133
050,53,039,"Washington","Klickitat County",2,13,274,144,130
050,53,039,"Washington","Klickitat County",2,14,278,150,128
050,53,039,"Washington","Klickitat County",2,15,255,136,119
050,53,039,"Washington","Klickitat County",2,16,253,127,126
050,53,039,"Washington","Klickitat County",2,17,258,129,129
050,53,039,"Washington","Klickitat County",2,18,222,113,109
050,53,039,"Washington","Klickitat County",2,19,193,103,90
050,53,039,"Washington","Klickitat County",2,20,189,101,88
050,53,039,"Washington","Klickitat County",2,21,189,99,90
050,53,039,"Washington","Klickitat County",2,22,195,106,89
050,53,039,"Washington","Klickitat County",2,23,191,106,85
050,53,039,"Washington","Klickitat County",2,24,213,102,111
050,53,039,"Washington","Klickitat County",2,25,237,130,107
050,53,039,"Washington","Klickitat County",2,26,225,112,113
050,53,039,"Washington","Klickitat County",2,27,205,108,97
050,53,039,"Washington","Klickitat County",2,28,246,133,113
050,53,039,"Washington","Klickitat County",2,29,238,124,114
050,53,039,"Washington","Klickitat County",2,30,252,131,121
050,53,039,"Washington","Klickitat County",2,31,262,133,129
050,53,039,"Washington","Klickitat County",2,32,255,139,116
050,53,039,"Washington","Klickitat County",2,33,244,125,119
050,53,039,"Washington","Klickitat County",2,34,271,119,152
050,53,039,"Washington","Klickitat County",2,35,265,125,140
050,53,039,"Washington","Klickitat County",2,36,263,127,136
050,53,039,"Washington","Klickitat County",2,37,255,135,120
050,53,039,"Washington","Klickitat County",2,38,279,148,131
050,53,039,"Washington","Klickitat County",2,39,287,145,142
050,53,039,"Washington","Klickitat County",2,40,298,169,129
050,53,039,"Washington","Klickitat County",2,41,269,144,125
050,53,039,"Washington","Klickitat County",2,42,271,147,124
050,53,039,"Washington","Klickitat County",2,43,271,147,124
050,53,039,"Washington","Klickitat County",2,44,258,123,135
050,53,039,"Washington","Klickitat County",2,45,272,132,140
050,53,039,"Washington","Klickitat County",2,46,287,130,157
050,53,039,"Washington","Klickitat County",2,47,284,137,147
050,53,039,"Washington","Klickitat County",2,48,283,147,136
050,53,039,"Washington","Klickitat County",2,49,301,164,137
050,53,039,"Washington","Klickitat County",2,50,289,151,138
050,53,039,"Washington","Klickitat County",2,51,276,155,121
050,53,039,"Washington","Klickitat County",2,52,277,147,130
050,53,039,"Washington","Klickitat County",2,53,275,155,120
050,53,039,"Washington","Klickitat County",2,54,283,150,133
050,53,039,"Washington","Klickitat County",2,55,317,154,163
050,53,039,"Washington","Klickitat County",2,56,325,169,156
050,53,039,"Washington","Klickitat County",2,57,322,168,154
050,53,039,"Washington","Klickitat County",2,58,345,166,179
050,53,039,"Washington","Klickitat County",2,59,337,160,177
050,53,039,"Washington","Klickitat County",2,60,368,174,194
050,53,039,"Washington","Klickitat County",2,61,372,177,195
050,53,039,"Washington","Klickitat County",2,62,388,191,197
050,53,039,"Washington","Klickitat County",2,63,408,203,205
050,53,039,"Washington","Klickitat County",2,64,400,202,198
050,53,039,"Washington","Klickitat County",2,65,388,191,197
050,53,039,"Washington","Klickitat County",2,66,400,190,210
050,53,039,"Washington","Klickitat County",2,67,396,197,199
050,53,039,"Washington","Klickitat County",2,68,387,195,192
050,53,039,"Washington","Klickitat County",2,69,358,180,178
050,53,039,"Washington","Klickitat County",2,70,333,172,161
050,53,039,"Washington","Klickitat County",2,71,341,173,168
050,53,039,"Washington","Klickitat County",2,72,314,169,145
050,53,039,"Washington","Klickitat County",2,73,335,177,158
050,53,039,"Washington","Klickitat County",2,74,219,113,106
050,53,039,"Washington","Klickitat County",2,75,222,114,108
050,53,039,"Washington","Klickitat County",2,76,218,109,109
050,53,039,"Washington","Klickitat County",2,77,215,106,109
050,53,039,"Washington","Klickitat County",2,78,177,90,87
050,53,039,"Washington","Klickitat County",2,79,159,87,72
050,53,039,"Washington","Klickitat County",2,80,147,82,65
050,53,039,"Washington","Klickitat County",2,81,124,69,55
050,53,039,"Washington","Klickitat County",2,82,121,61,60
050,53,039,"Washington","Klickitat County",2,83,101,48,53
050,53,039,"Washington","Klickitat County",2,84,88,41,47
050,53,039,"Washington","Klickitat County",2,85,446,155,291
050,53,039,"Washington","Klickitat County",3,0,193,106,87
050,53,039,"Washington","Klickitat County",3,1,225,128,97
050,53,039,"Washington","Klickitat County",3,2,195,94,101
050,53,039,"Washington","Klickitat County",3,3,226,116,110
050,53,039,"Washington","Klickitat County",3,4,243,128,115
050,53,039,"Washington","Klickitat County",3,5,221,115,106
050,53,039,"Washington","Klickitat County",3,6,238,125,113
050,53,039,"Washington","Klickitat County",3,7,246,121,125
050,53,039,"Washington","Klickitat County",3,8,242,128,114
050,53,039,"Washington","Klickitat County",3,9,227,119,108
050,53,039,"Washington","Klickitat County",3,10,243,132,111
050,53,039,"Washington","Klickitat County",3,11,262,145,117
050,53,039,"Washington","Klickitat County",3,12,257,136,121
050,53,039,"Washington","Klickitat County",3,13,262,130,132
050,53,039,"Washington","Klickitat County",3,14,285,143,142
050,53,039,"Washington","Klickitat County",3,15,275,149,126
050,53,039,"Washington","Klickitat County",3,16,264,142,122
050,53,039,"Washington","Klickitat County",3,17,245,127,118
050,53,039,"Washington","Klickitat County",3,18,232,127,105
050,53,039,"Washington","Klickitat County",3,19,184,94,90
050,53,039,"Washington","Klickitat County",3,20,196,110,86
050,53,039,"Washington","Klickitat County",3,21,195,108,87
050,53,039,"Washington","Klickitat County",3,22,215,116,99
050,53,039,"Washington","Klickitat County",3,23,193,105,88
050,53,039,"Washington","Klickitat County",3,24,212,94,118
050,53,039,"Washington","Klickitat County",3,25,237,121,116
050,53,039,"Washington","Klickitat County",3,26,233,124,109
050,53,039,"Washington","Klickitat County",3,27,209,113,96
050,53,039,"Washington","Klickitat County",3,28,220,112,108
050,53,039,"Washington","Klickitat County",3,29,253,146,107
050,53,039,"Washington","Klickitat County",3,30,254,134,120
050,53,039,"Washington","Klickitat County",3,31,261,123,138
050,53,039,"Washington","Klickitat County",3,32,259,135,124
050,53,039,"Washington","Klickitat County",3,33,269,151,118
050,53,039,"Washington","Klickitat County",3,34,271,137,134
050,53,039,"Washington","Klickitat County",3,35,286,130,156
050,53,039,"Washington","Klickitat County",3,36,266,124,142
050,53,039,"Washington","Klickitat County",3,37,269,140,129
050,53,039,"Washington","Klickitat County",3,38,265,141,124
050,53,039,"Washington","Klickitat County",3,39,288,141,147
050,53,039,"Washington","Klickitat County",3,40,310,168,142
050,53,039,"Washington","Klickitat County",3,41,295,158,137
050,53,039,"Washington","Klickitat County",3,42,288,152,136
050,53,039,"Washington","Klickitat County",3,43,273,146,127
050,53,039,"Washington","Klickitat County",3,44,274,149,125
050,53,039,"Washington","Klickitat County",3,45,268,132,136
050,53,039,"Washington","Klickitat County",3,46,291,132,159
050,53,039,"Washington","Klickitat County",3,47,291,140,151
050,53,039,"Washington","Klickitat County",3,48,271,137,134
050,53,039,"Washington","Klickitat County",3,49,287,147,140
050,53,039,"Washington","Klickitat County",3,50,285,147,138
050,53,039,"Washington","Klickitat County",3,51,296,159,137
050,53,039,"Washington","Klickitat County",3,52,282,148,134
050,53,039,"Washington","Klickitat County",3,53,288,162,126
050,53,039,"Washington","Klickitat County",3,54,274,147,127
050,53,039,"Washington","Klickitat County",3,55,306,156,150
050,53,039,"Washington","Klickitat County",3,56,313,157,156
050,53,039,"Washington","Klickitat County",3,57,318,166,152
050,53,039,"Washington","Klickitat County",3,58,331,170,161
050,53,039,"Washington","Klickitat County",3,59,355,173,182
050,53,039,"Washington","Klickitat County",3,60,354,172,182
050,53,039,"Washington","Klickitat County",3,61,371,169,202
050,53,039,"Washington","Klickitat County",3,62,382,184,198
050,53,039,"Washington","Klickitat County",3,63,405,197,208
050,53,039,"Washington","Klickitat County",3,64,420,213,207
050,53,039,"Washington","Klickitat County",3,65,398,202,196
050,53,039,"Washington","Klickitat County",3,66,392,191,201
050,53,039,"Washington","Klickitat County",3,67,409,197,212
050,53,039,"Washington","Klickitat County",3,68,395,198,197
050,53,039,"Washington","Klickitat County",3,69,390,196,194
050,53,039,"Washington","Klickitat County",3,70,350,181,169
050,53,039,"Washington","Klickitat County",3,71,330,175,155
050,53,039,"Washington","Klickitat County",3,72,328,167,161
050,53,039,"Washington","Klickitat County",3,73,305,166,139
050,53,039,"Washington","Klickitat County",3,74,330,172,158
050,53,039,"Washington","Klickitat County",3,75,211,108,103
050,53,039,"Washington","Klickitat County",3,76,216,109,107
050,53,039,"Washington","Klickitat County",3,77,207,105,102
050,53,039,"Washington","Klickitat County",3,78,207,100,107
050,53,039,"Washington","Klickitat County",3,79,162,80,82
050,53,039,"Washington","Klickitat County",3,80,158,87,71
050,53,039,"Washington","Klickitat County",3,81,140,76,64
050,53,039,"Washington","Klickitat County",3,82,114,64,50
050,53,039,"Washington","Klickitat County",3,83,121,58,63
050,53,039,"Washington","Klickitat County",3,84,93,45,48
050,53,039,"Washington","Klickitat County",3,85,467,173,294
050,53,039,"Washington","Klickitat County",4,0,208,107,101
050,53,039,"Washington","Klickitat County",4,1,205,122,83
050,53,039,"Washington","Klickitat County",4,2,223,126,97
050,53,039,"Washington","Klickitat County",4,3,210,112,98
050,53,039,"Washington","Klickitat County",4,4,213,107,106
050,53,039,"Washington","Klickitat County",4,5,225,117,108
050,53,039,"Washington","Klickitat County",4,6,244,138,106
050,53,039,"Washington","Klickitat County",4,7,238,121,117
050,53,039,"Washington","Klickitat County",4,8,246,122,124
050,53,039,"Washington","Klickitat County",4,9,230,122,108
050,53,039,"Washington","Klickitat County",4,10,237,136,101
050,53,039,"Washington","Klickitat County",4,11,255,138,117
050,53,039,"Washington","Klickitat County",4,12,255,138,117
050,53,039,"Washington","Klickitat County",4,13,249,131,118
050,53,039,"Washington","Klickitat County",4,14,278,139,139
050,53,039,"Washington","Klickitat County",4,15,261,134,127
050,53,039,"Washington","Klickitat County",4,16,264,137,127
050,53,039,"Washington","Klickitat County",4,17,259,131,128
050,53,039,"Washington","Klickitat County",4,18,217,124,93
050,53,039,"Washington","Klickitat County",4,19,175,99,76
050,53,039,"Washington","Klickitat County",4,20,186,93,93
050,53,039,"Washington","Klickitat County",4,21,193,106,87
050,53,039,"Washington","Klickitat County",4,22,206,121,85
050,53,039,"Washington","Klickitat County",4,23,213,132,81
050,53,039,"Washington","Klickitat County",4,24,227,110,117
050,53,039,"Washington","Klickitat County",4,25,228,125,103
050,53,039,"Washington","Klickitat County",4,26,245,122,123
050,53,039,"Washington","Klickitat County",4,27,228,133,95
050,53,039,"Washington","Klickitat County",4,28,240,130,110
050,53,039,"Washington","Klickitat County",4,29,234,117,117
050,53,039,"Washington","Klickitat County",4,30,251,141,110
050,53,039,"Washington","Klickitat County",4,31,277,131,146
050,53,039,"Washington","Klickitat County",4,32,288,148,140
050,53,039,"Washington","Klickitat County",4,33,262,138,124
050,53,039,"Washington","Klickitat County",4,34,296,161,135
050,53,039,"Washington","Klickitat County",4,35,270,143,127
050,53,039,"Washington","Klickitat County",4,36,297,139,158
050,53,039,"Washington","Klickitat County",4,37,267,138,129
050,53,039,"Washington","Klickitat County",4,38,282,151,131
050,53,039,"Washington","Klickitat County",4,39,286,154,132
050,53,039,"Washington","Klickitat County",4,40,303,161,142
050,53,039,"Washington","Klickitat County",4,41,303,154,149
050,53,039,"Washington","Klickitat County",4,42,304,169,135
050,53,039,"Washington","Klickitat County",4,43,279,144,135
050,53,039,"Washington","Klickitat County",4,44,279,141,138
050,53,039,"Washington","Klickitat County",4,45,285,161,124
050,53,039,"Washington","Klickitat County",4,46,283,126,157
050,53,039,"Washington","Klickitat County",4,47,297,143,154
050,53,039,"Washington","Klickitat County",4,48,285,142,143
050,53,039,"Washington","Klickitat County",4,49,261,128,133
050,53,039,"Washington","Klickitat County",4,50,286,145,141
050,53,039,"Washington","Klickitat County",4,51,285,154,131
050,53,039,"Washington","Klickitat County",4,52,297,150,147
050,53,039,"Washington","Klickitat County",4,53,287,160,127
050,53,039,"Washington","Klickitat County",4,54,295,157,138
050,53,039,"Washington","Klickitat County",4,55,281,142,139
050,53,039,"Washington","Klickitat County",4,56,295,160,135
050,53,039,"Washington","Klickitat County",4,57,308,160,148
050,53,039,"Washington","Klickitat County",4,58,330,168,162
050,53,039,"Washington","Klickitat County",4,59,324,169,155
050,53,039,"Washington","Klickitat County",4,60,369,184,185
050,53,039,"Washington","Klickitat County",4,61,363,177,186
050,53,039,"Washington","Klickitat County",4,62,379,171,208
050,53,039,"Washington","Klickitat County",4,63,385,195,190
050,53,039,"Washington","Klickitat County",4,64,402,189,213
050,53,039,"Washington","Klickitat County",4,65,429,223,206
050,53,039,"Washington","Klickitat County",4,66,391,199,192
050,53,039,"Washington","Klickitat County",4,67,384,185,199
050,53,039,"Washington","Klickitat County",4,68,395,190,205
050,53,039,"Washington","Klickitat County",4,69,382,191,191
050,53,039,"Washington","Klickitat County",4,70,378,190,188
050,53,039,"Washington","Klickitat County",4,71,349,178,171
050,53,039,"Washington","Klickitat County",4,72,315,168,147
050,53,039,"Washington","Klickitat County",4,73,323,165,158
050,53,039,"Washington","Klickitat County",4,74,293,158,135
050,53,039,"Washington","Klickitat County",4,75,316,168,148
050,53,039,"Washington","Klickitat County",4,76,199,100,99
050,53,039,"Washington","Klickitat County",4,77,210,104,106
050,53,039,"Washington","Klickitat County",4,78,196,99,97
050,53,039,"Washington","Klickitat County",4,79,191,91,100
050,53,039,"Washington","Klickitat County",4,80,153,77,76
050,53,039,"Washington","Klickitat County",4,81,146,79,67
050,53,039,"Washington","Klickitat County",4,82,128,69,59
050,53,039,"Washington","Klickitat County",4,83,111,57,54
050,53,039,"Washington","Klickitat County",4,84,102,47,55
050,53,039,"Washington","Klickitat County",4,85,479,188,291
050,53,039,"Washington","Klickitat County",5,0,185,96,89
050,53,039,"Washington","Klickitat County",5,1,207,113,94
050,53,039,"Washington","Klickitat County",5,2,204,116,88
050,53,039,"Washington","Klickitat County",5,3,223,129,94
050,53,039,"Washington","Klickitat County",5,4,202,102,100
050,53,039,"Washington","Klickitat County",5,5,218,110,108
050,53,039,"Washington","Klickitat County",5,6,241,135,106
050,53,039,"Washington","Klickitat County",5,7,252,137,115
050,53,039,"Washington","Klickitat County",5,8,239,125,114
050,53,039,"Washington","Klickitat County",5,9,244,120,124
050,53,039,"Washington","Klickitat County",5,10,234,125,109
050,53,039,"Washington","Klickitat County",5,11,249,147,102
050,53,039,"Washington","Klickitat County",5,12,256,135,121
050,53,039,"Washington","Klickitat County",5,13,252,140,112
050,53,039,"Washington","Klickitat County",5,14,258,135,123
050,53,039,"Washington","Klickitat County",5,15,272,137,135
050,53,039,"Washington","Klickitat County",5,16,271,136,135
050,53,039,"Washington","Klickitat County",5,17,265,138,127
050,53,039,"Washington","Klickitat County",5,18,226,122,104
050,53,039,"Washington","Klickitat County",5,19,186,109,77
050,53,039,"Washington","Klickitat County",5,20,187,102,85
050,53,039,"Washington","Klickitat County",5,21,180,94,86
050,53,039,"Washington","Klickitat County",5,22,227,122,105
050,53,039,"Washington","Klickitat County",5,23,208,132,76
050,53,039,"Washington","Klickitat County",5,24,221,118,103
050,53,039,"Washington","Klickitat County",5,25,249,137,112
050,53,039,"Washington","Klickitat County",5,26,243,131,112
050,53,039,"Washington","Klickitat County",5,27,231,120,111
050,53,039,"Washington","Klickitat County",5,28,228,131,97
050,53,039,"Washington","Klickitat County",5,29,221,111,110
050,53,039,"Washington","Klickitat County",5,30,250,121,129
050,53,039,"Washington","Klickitat County",5,31,272,147,125
050,53,039,"Washington","Klickitat County",5,32,293,146,147
050,53,039,"Washington","Klickitat County",5,33,307,159,148
050,53,039,"Washington","Klickitat County",5,34,280,145,135
050,53,039,"Washington","Klickitat County",5,35,299,163,136
050,53,039,"Washington","Klickitat County",5,36,287,150,137
050,53,039,"Washington","Klickitat County",5,37,310,151,159
050,53,039,"Washington","Klickitat County",5,38,290,150,140
050,53,039,"Washington","Klickitat County",5,39,301,158,143
050,53,039,"Washington","Klickitat County",5,40,299,169,130
050,53,039,"Washington","Klickitat County",5,41,300,149,151
050,53,039,"Washington","Klickitat County",5,42,301,156,145
050,53,039,"Washington","Klickitat County",5,43,308,166,142
050,53,039,"Washington","Klickitat County",5,44,285,144,141
050,53,039,"Washington","Klickitat County",5,45,292,155,137
050,53,039,"Washington","Klickitat County",5,46,300,161,139
050,53,039,"Washington","Klickitat County",5,47,290,138,152
050,53,039,"Washington","Klickitat County",5,48,288,139,149
050,53,039,"Washington","Klickitat County",5,49,281,142,139
050,53,039,"Washington","Klickitat County",5,50,262,123,139
050,53,039,"Washington","Klickitat County",5,51,278,144,134
050,53,039,"Washington","Klickitat County",5,52,276,143,133
050,53,039,"Washington","Klickitat County",5,53,306,165,141
050,53,039,"Washington","Klickitat County",5,54,287,149,138
050,53,039,"Washington","Klickitat County",5,55,316,167,149
050,53,039,"Washington","Klickitat County",5,56,277,149,128
050,53,039,"Washington","Klickitat County",5,57,301,160,141
050,53,039,"Washington","Klickitat County",5,58,322,168,154
050,53,039,"Washington","Klickitat County",5,59,335,176,159
050,53,039,"Washington","Klickitat County",5,60,327,167,160
050,53,039,"Washington","Klickitat County",5,61,373,184,189
050,53,039,"Washington","Klickitat County",5,62,365,177,188
050,53,039,"Washington","Klickitat County",5,63,392,182,210
050,53,039,"Washington","Klickitat County",5,64,399,198,201
050,53,039,"Washington","Klickitat County",5,65,390,180,210
050,53,039,"Washington","Klickitat County",5,66,438,229,209
050,53,039,"Washington","Klickitat County",5,67,392,203,189
050,53,039,"Washington","Klickitat County",5,68,378,181,197
050,53,039,"Washington","Klickitat County",5,69,386,184,202
050,53,039,"Washington","Klickitat County",5,70,395,203,192
050,53,039,"Washington","Klickitat County",5,71,366,182,184
050,53,039,"Washington","Klickitat County",5,72,344,177,167
050,53,039,"Washington","Klickitat County",5,73,306,162,144
050,53,039,"Washington","Klickitat County",5,74,319,160,159
050,53,039,"Washington","Klickitat County",5,75,290,156,134
050,53,039,"Washington","Klickitat County",5,76,308,165,143
050,53,039,"Washington","Klickitat County",5,77,191,93,98
050,53,039,"Washington","Klickitat County",5,78,198,101,97
050,53,039,"Washington","Klickitat County",5,79,178,88,90
050,53,039,"Washington","Klickitat County",5,80,185,88,97
050,53,039,"Washington","Klickitat County",5,81,146,71,75
050,53,039,"Washington","Klickitat County",5,82,138,73,65
050,53,039,"Washington","Klickitat County",5,83,121,61,60
050,53,039,"Washington","Klickitat County",5,84,94,50,44
050,53,039,"Washington","Klickitat County",5,85,498,204,294
050,53,041,"Washington","Lewis County",1,0,897,459,438
050,53,041,"Washington","Lewis County",1,1,920,478,442
050,53,041,"Washington","Lewis County",1,2,954,504,450
050,53,041,"Washington","Lewis County",1,3,1045,549,496
050,53,041,"Washington","Lewis County",1,4,1007,529,478
050,53,041,"Washington","Lewis County",1,5,985,512,473
050,53,041,"Washington","Lewis County",1,6,975,513,462
050,53,041,"Washington","Lewis County",1,7,969,504,465
050,53,041,"Washington","Lewis County",1,8,986,503,483
050,53,041,"Washington","Lewis County",1,9,988,516,472
050,53,041,"Washington","Lewis County",1,10,1034,542,492
050,53,041,"Washington","Lewis County",1,11,1011,506,505
050,53,041,"Washington","Lewis County",1,12,1027,523,504
050,53,041,"Washington","Lewis County",1,13,1039,533,506
050,53,041,"Washington","Lewis County",1,14,1032,535,497
050,53,041,"Washington","Lewis County",1,15,979,506,473
050,53,041,"Washington","Lewis County",1,16,1012,521,491
050,53,041,"Washington","Lewis County",1,17,985,522,463
050,53,041,"Washington","Lewis County",1,18,896,491,405
050,53,041,"Washington","Lewis County",1,19,733,398,335
050,53,041,"Washington","Lewis County",1,20,790,416,374
050,53,041,"Washington","Lewis County",1,21,805,434,371
050,53,041,"Washington","Lewis County",1,22,823,414,409
050,53,041,"Washington","Lewis County",1,23,840,414,426
050,53,041,"Washington","Lewis County",1,24,896,453,443
050,53,041,"Washington","Lewis County",1,25,893,456,437
050,53,041,"Washington","Lewis County",1,26,944,494,450
050,53,041,"Washington","Lewis County",1,27,988,532,456
050,53,041,"Washington","Lewis County",1,28,1032,510,522
050,53,041,"Washington","Lewis County",1,29,1023,519,504
050,53,041,"Washington","Lewis County",1,30,1052,540,512
050,53,041,"Washington","Lewis County",1,31,1049,538,511
050,53,041,"Washington","Lewis County",1,32,989,504,485
050,53,041,"Washington","Lewis County",1,33,997,514,483
050,53,041,"Washington","Lewis County",1,34,1009,508,501
050,53,041,"Washington","Lewis County",1,35,982,474,508
050,53,041,"Washington","Lewis County",1,36,988,504,484
050,53,041,"Washington","Lewis County",1,37,1018,532,486
050,53,041,"Washington","Lewis County",1,38,997,512,485
050,53,041,"Washington","Lewis County",1,39,1018,514,504
050,53,041,"Washington","Lewis County",1,40,1016,521,495
050,53,041,"Washington","Lewis County",1,41,981,503,478
050,53,041,"Washington","Lewis County",1,42,940,482,458
050,53,041,"Washington","Lewis County",1,43,946,467,479
050,53,041,"Washington","Lewis County",1,44,922,472,450
050,53,041,"Washington","Lewis County",1,45,865,446,419
050,53,041,"Washington","Lewis County",1,46,861,453,408
050,53,041,"Washington","Lewis County",1,47,915,461,454
050,53,041,"Washington","Lewis County",1,48,986,496,490
050,53,041,"Washington","Lewis County",1,49,1032,509,523
050,53,041,"Washington","Lewis County",1,50,1002,509,493
050,53,041,"Washington","Lewis County",1,51,968,472,496
050,53,041,"Washington","Lewis County",1,52,918,471,447
050,53,041,"Washington","Lewis County",1,53,969,488,481
050,53,041,"Washington","Lewis County",1,54,983,512,471
050,53,041,"Washington","Lewis County",1,55,1039,539,500
050,53,041,"Washington","Lewis County",1,56,1115,554,561
050,53,041,"Washington","Lewis County",1,57,1161,535,626
050,53,041,"Washington","Lewis County",1,58,1225,587,638
050,53,041,"Washington","Lewis County",1,59,1257,600,657
050,53,041,"Washington","Lewis County",1,60,1254,604,650
050,53,041,"Washington","Lewis County",1,61,1222,613,609
050,53,041,"Washington","Lewis County",1,62,1245,640,605
050,53,041,"Washington","Lewis County",1,63,1231,591,640
050,53,041,"Washington","Lewis County",1,64,1215,578,637
050,53,041,"Washington","Lewis County",1,65,1230,598,632
050,53,041,"Washington","Lewis County",1,66,1187,588,599
050,53,041,"Washington","Lewis County",1,67,1150,579,571
050,53,041,"Washington","Lewis County",1,68,1161,578,583
050,53,041,"Washington","Lewis County",1,69,1101,539,562
050,53,041,"Washington","Lewis County",1,70,1032,494,538
050,53,041,"Washington","Lewis County",1,71,1005,510,495
050,53,041,"Washington","Lewis County",1,72,1001,504,497
050,53,041,"Washington","Lewis County",1,73,1028,543,485
050,53,041,"Washington","Lewis County",1,74,699,354,345
050,53,041,"Washington","Lewis County",1,75,696,354,342
050,53,041,"Washington","Lewis County",1,76,716,365,351
050,53,041,"Washington","Lewis County",1,77,698,337,361
050,53,041,"Washington","Lewis County",1,78,604,287,317
050,53,041,"Washington","Lewis County",1,79,511,241,270
050,53,041,"Washington","Lewis County",1,80,453,216,237
050,53,041,"Washington","Lewis County",1,81,431,206,225
050,53,041,"Washington","Lewis County",1,82,386,177,209
050,53,041,"Washington","Lewis County",1,83,335,162,173
050,53,041,"Washington","Lewis County",1,84,300,144,156
050,53,041,"Washington","Lewis County",1,85,1544,588,956
050,53,041,"Washington","Lewis County",2,0,903,463,440
050,53,041,"Washington","Lewis County",2,1,917,473,444
050,53,041,"Washington","Lewis County",2,2,956,503,453
050,53,041,"Washington","Lewis County",2,3,1023,537,486
050,53,041,"Washington","Lewis County",2,4,1024,537,487
050,53,041,"Washington","Lewis County",2,5,999,522,477
050,53,041,"Washington","Lewis County",2,6,987,517,470
050,53,041,"Washington","Lewis County",2,7,975,511,464
050,53,041,"Washington","Lewis County",2,8,988,508,480
050,53,041,"Washington","Lewis County",2,9,997,519,478
050,53,041,"Washington","Lewis County",2,10,1031,537,494
050,53,041,"Washington","Lewis County",2,11,1019,515,504
050,53,041,"Washington","Lewis County",2,12,1036,524,512
050,53,041,"Washington","Lewis County",2,13,1042,530,512
050,53,041,"Washington","Lewis County",2,14,1032,531,501
050,53,041,"Washington","Lewis County",2,15,996,515,481
050,53,041,"Washington","Lewis County",2,16,1010,524,486
050,53,041,"Washington","Lewis County",2,17,997,528,469
050,53,041,"Washington","Lewis County",2,18,878,483,395
050,53,041,"Washington","Lewis County",2,19,734,398,336
050,53,041,"Washington","Lewis County",2,20,792,420,372
050,53,041,"Washington","Lewis County",2,21,810,431,379
050,53,041,"Washington","Lewis County",2,22,831,423,408
050,53,041,"Washington","Lewis County",2,23,849,422,427
050,53,041,"Washington","Lewis County",2,24,887,447,440
050,53,041,"Washington","Lewis County",2,25,907,464,443
050,53,041,"Washington","Lewis County",2,26,938,490,448
050,53,041,"Washington","Lewis County",2,27,987,529,458
050,53,041,"Washington","Lewis County",2,28,1029,520,509
050,53,041,"Washington","Lewis County",2,29,1032,520,512
050,53,041,"Washington","Lewis County",2,30,1058,543,515
050,53,041,"Washington","Lewis County",2,31,1059,544,515
050,53,041,"Washington","Lewis County",2,32,1015,517,498
050,53,041,"Washington","Lewis County",2,33,1005,517,488
050,53,041,"Washington","Lewis County",2,34,1015,513,502
050,53,041,"Washington","Lewis County",2,35,1003,488,515
050,53,041,"Washington","Lewis County",2,36,990,498,492
050,53,041,"Washington","Lewis County",2,37,1025,530,495
050,53,041,"Washington","Lewis County",2,38,1016,523,493
050,53,041,"Washington","Lewis County",2,39,1024,523,501
050,53,041,"Washington","Lewis County",2,40,1032,530,502
050,53,041,"Washington","Lewis County",2,41,992,509,483
050,53,041,"Washington","Lewis County",2,42,942,483,459
050,53,041,"Washington","Lewis County",2,43,962,479,483
050,53,041,"Washington","Lewis County",2,44,923,466,457
050,53,041,"Washington","Lewis County",2,45,886,458,428
050,53,041,"Washington","Lewis County",2,46,868,458,410
050,53,041,"Washington","Lewis County",2,47,903,459,444
050,53,041,"Washington","Lewis County",2,48,972,487,485
050,53,041,"Washington","Lewis County",2,49,1026,509,517
050,53,041,"Washington","Lewis County",2,50,1012,511,501
050,53,041,"Washington","Lewis County",2,51,975,483,492
050,53,041,"Washington","Lewis County",2,52,933,475,458
050,53,041,"Washington","Lewis County",2,53,962,489,473
050,53,041,"Washington","Lewis County",2,54,982,507,475
050,53,041,"Washington","Lewis County",2,55,1031,535,496
050,53,041,"Washington","Lewis County",2,56,1105,557,548
050,53,041,"Washington","Lewis County",2,57,1157,544,613
050,53,041,"Washington","Lewis County",2,58,1218,578,640
050,53,041,"Washington","Lewis County",2,59,1259,602,657
050,53,041,"Washington","Lewis County",2,60,1255,603,652
050,53,041,"Washington","Lewis County",2,61,1233,613,620
050,53,041,"Washington","Lewis County",2,62,1236,629,607
050,53,041,"Washington","Lewis County",2,63,1242,608,634
050,53,041,"Washington","Lewis County",2,64,1212,578,634
050,53,041,"Washington","Lewis County",2,65,1229,595,634
050,53,041,"Washington","Lewis County",2,66,1199,591,608
050,53,041,"Washington","Lewis County",2,67,1161,581,580
050,53,041,"Washington","Lewis County",2,68,1153,574,579
050,53,041,"Washington","Lewis County",2,69,1124,551,573
050,53,041,"Washington","Lewis County",2,70,1048,503,545
050,53,041,"Washington","Lewis County",2,71,1012,507,505
050,53,041,"Washington","Lewis County",2,72,978,493,485
050,53,041,"Washington","Lewis County",2,73,1068,559,509
050,53,041,"Washington","Lewis County",2,74,724,373,351
050,53,041,"Washington","Lewis County",2,75,693,353,340
050,53,041,"Washington","Lewis County",2,76,699,357,342
050,53,041,"Washington","Lewis County",2,77,716,350,366
050,53,041,"Washington","Lewis County",2,78,608,292,316
050,53,041,"Washington","Lewis County",2,79,522,243,279
050,53,041,"Washington","Lewis County",2,80,461,218,243
050,53,041,"Washington","Lewis County",2,81,428,206,222
050,53,041,"Washington","Lewis County",2,82,394,180,214
050,53,041,"Washington","Lewis County",2,83,343,163,180
050,53,041,"Washington","Lewis County",2,84,294,142,152
050,53,041,"Washington","Lewis County",2,85,1565,601,964
050,53,041,"Washington","Lewis County",3,0,876,465,411
050,53,041,"Washington","Lewis County",3,1,961,501,460
050,53,041,"Washington","Lewis County",3,2,949,482,467
050,53,041,"Washington","Lewis County",3,3,1001,527,474
050,53,041,"Washington","Lewis County",3,4,1059,549,510
050,53,041,"Washington","Lewis County",3,5,1041,541,500
050,53,041,"Washington","Lewis County",3,6,1030,541,489
050,53,041,"Washington","Lewis County",3,7,1016,543,473
050,53,041,"Washington","Lewis County",3,8,1067,555,512
050,53,041,"Washington","Lewis County",3,9,1017,513,504
050,53,041,"Washington","Lewis County",3,10,1040,526,514
050,53,041,"Washington","Lewis County",3,11,1029,544,485
050,53,041,"Washington","Lewis County",3,12,1048,530,518
050,53,041,"Washington","Lewis County",3,13,1083,554,529
050,53,041,"Washington","Lewis County",3,14,1075,545,530
050,53,041,"Washington","Lewis County",3,15,1056,552,504
050,53,041,"Washington","Lewis County",3,16,1014,534,480
050,53,041,"Washington","Lewis County",3,17,1056,556,500
050,53,041,"Washington","Lewis County",3,18,904,493,411
050,53,041,"Washington","Lewis County",3,19,722,384,338
050,53,041,"Washington","Lewis County",3,20,817,429,388
050,53,041,"Washington","Lewis County",3,21,849,451,398
050,53,041,"Washington","Lewis County",3,22,874,464,410
050,53,041,"Washington","Lewis County",3,23,905,461,444
050,53,041,"Washington","Lewis County",3,24,874,434,440
050,53,041,"Washington","Lewis County",3,25,940,472,468
050,53,041,"Washington","Lewis County",3,26,956,476,480
050,53,041,"Washington","Lewis County",3,27,1022,547,475
050,53,041,"Washington","Lewis County",3,28,997,522,475
050,53,041,"Washington","Lewis County",3,29,1064,564,500
050,53,041,"Washington","Lewis County",3,30,1074,530,544
050,53,041,"Washington","Lewis County",3,31,1138,590,548
050,53,041,"Washington","Lewis County",3,32,1071,548,523
050,53,041,"Washington","Lewis County",3,33,1064,532,532
050,53,041,"Washington","Lewis County",3,34,1040,530,510
050,53,041,"Washington","Lewis County",3,35,1078,538,540
050,53,041,"Washington","Lewis County",3,36,1039,518,521
050,53,041,"Washington","Lewis County",3,37,1059,538,521
050,53,041,"Washington","Lewis County",3,38,1043,545,498
050,53,041,"Washington","Lewis County",3,39,1072,549,523
050,53,041,"Washington","Lewis County",3,40,1072,548,524
050,53,041,"Washington","Lewis County",3,41,1082,553,529
050,53,041,"Washington","Lewis County",3,42,1029,533,496
050,53,041,"Washington","Lewis County",3,43,997,513,484
050,53,041,"Washington","Lewis County",3,44,979,491,488
050,53,041,"Washington","Lewis County",3,45,949,486,463
050,53,041,"Washington","Lewis County",3,46,927,476,451
050,53,041,"Washington","Lewis County",3,47,876,454,422
050,53,041,"Washington","Lewis County",3,48,938,475,463
050,53,041,"Washington","Lewis County",3,49,993,490,503
050,53,041,"Washington","Lewis County",3,50,1052,522,530
050,53,041,"Washington","Lewis County",3,51,1014,516,498
050,53,041,"Washington","Lewis County",3,52,980,487,493
050,53,041,"Washington","Lewis County",3,53,957,489,468
050,53,041,"Washington","Lewis County",3,54,982,484,498
050,53,041,"Washington","Lewis County",3,55,998,515,483
050,53,041,"Washington","Lewis County",3,56,1067,547,520
050,53,041,"Washington","Lewis County",3,57,1112,556,556
050,53,041,"Washington","Lewis County",3,58,1157,549,608
050,53,041,"Washington","Lewis County",3,59,1229,581,648
050,53,041,"Washington","Lewis County",3,60,1273,615,658
050,53,041,"Washington","Lewis County",3,61,1254,598,656
050,53,041,"Washington","Lewis County",3,62,1242,616,626
050,53,041,"Washington","Lewis County",3,63,1242,628,614
050,53,041,"Washington","Lewis County",3,64,1245,608,637
050,53,041,"Washington","Lewis County",3,65,1225,577,648
050,53,041,"Washington","Lewis County",3,66,1249,605,644
050,53,041,"Washington","Lewis County",3,67,1193,585,608
050,53,041,"Washington","Lewis County",3,68,1143,563,580
050,53,041,"Washington","Lewis County",3,69,1133,564,569
050,53,041,"Washington","Lewis County",3,70,1111,550,561
050,53,041,"Washington","Lewis County",3,71,1033,493,540
050,53,041,"Washington","Lewis County",3,72,980,495,485
050,53,041,"Washington","Lewis County",3,73,941,474,467
050,53,041,"Washington","Lewis County",3,74,1033,539,494
050,53,041,"Washington","Lewis County",3,75,704,362,342
050,53,041,"Washington","Lewis County",3,76,647,332,315
050,53,041,"Washington","Lewis County",3,77,668,328,340
050,53,041,"Washington","Lewis County",3,78,684,343,341
050,53,041,"Washington","Lewis County",3,79,581,271,310
050,53,041,"Washington","Lewis County",3,80,500,230,270
050,53,041,"Washington","Lewis County",3,81,436,211,225
050,53,041,"Washington","Lewis County",3,82,403,182,221
050,53,041,"Washington","Lewis County",3,83,364,161,203
050,53,041,"Washington","Lewis County",3,84,306,147,159
050,53,041,"Washington","Lewis County",3,85,1569,626,943
050,53,041,"Washington","Lewis County",4,0,926,487,439
050,53,041,"Washington","Lewis County",4,1,894,479,415
050,53,041,"Washington","Lewis County",4,2,977,493,484
050,53,041,"Washington","Lewis County",4,3,970,499,471
050,53,041,"Washington","Lewis County",4,4,996,528,468
050,53,041,"Washington","Lewis County",4,5,1048,568,480
050,53,041,"Washington","Lewis County",4,6,1067,546,521
050,53,041,"Washington","Lewis County",4,7,1053,549,504
050,53,041,"Washington","Lewis County",4,8,1055,561,494
050,53,041,"Washington","Lewis County",4,9,1061,556,505
050,53,041,"Washington","Lewis County",4,10,1032,523,509
050,53,041,"Washington","Lewis County",4,11,1035,526,509
050,53,041,"Washington","Lewis County",4,12,1021,541,480
050,53,041,"Washington","Lewis County",4,13,1064,535,529
050,53,041,"Washington","Lewis County",4,14,1095,557,538
050,53,041,"Washington","Lewis County",4,15,1057,542,515
050,53,041,"Washington","Lewis County",4,16,1081,575,506
050,53,041,"Washington","Lewis County",4,17,1040,546,494
050,53,041,"Washington","Lewis County",4,18,916,495,421
050,53,041,"Washington","Lewis County",4,19,696,368,328
050,53,041,"Washington","Lewis County",4,20,771,396,375
050,53,041,"Washington","Lewis County",4,21,843,446,397
050,53,041,"Washington","Lewis County",4,22,884,462,422
050,53,041,"Washington","Lewis County",4,23,900,491,409
050,53,041,"Washington","Lewis County",4,24,901,465,436
050,53,041,"Washington","Lewis County",4,25,930,471,459
050,53,041,"Washington","Lewis County",4,26,981,489,492
050,53,041,"Washington","Lewis County",4,27,980,496,484
050,53,041,"Washington","Lewis County",4,28,1021,555,466
050,53,041,"Washington","Lewis County",4,29,1007,526,481
050,53,041,"Washington","Lewis County",4,30,1125,585,540
050,53,041,"Washington","Lewis County",4,31,1112,559,553
050,53,041,"Washington","Lewis County",4,32,1169,590,579
050,53,041,"Washington","Lewis County",4,33,1086,558,528
050,53,041,"Washington","Lewis County",4,34,1091,547,544
050,53,041,"Washington","Lewis County",4,35,1074,549,525
050,53,041,"Washington","Lewis County",4,36,1126,562,564
050,53,041,"Washington","Lewis County",4,37,1064,534,530
050,53,041,"Washington","Lewis County",4,38,1084,555,529
050,53,041,"Washington","Lewis County",4,39,1082,567,515
050,53,041,"Washington","Lewis County",4,40,1079,542,537
050,53,041,"Washington","Lewis County",4,41,1081,558,523
050,53,041,"Washington","Lewis County",4,42,1079,541,538
050,53,041,"Washington","Lewis County",4,43,1052,555,497
050,53,041,"Washington","Lewis County",4,44,1004,507,497
050,53,041,"Washington","Lewis County",4,45,991,503,488
050,53,041,"Washington","Lewis County",4,46,988,509,479
050,53,041,"Washington","Lewis County",4,47,943,486,457
050,53,041,"Washington","Lewis County",4,48,885,467,418
050,53,041,"Washington","Lewis County",4,49,909,459,450
050,53,041,"Washington","Lewis County",4,50,982,486,496
050,53,041,"Washington","Lewis County",4,51,1067,524,543
050,53,041,"Washington","Lewis County",4,52,1022,524,498
050,53,041,"Washington","Lewis County",4,53,997,501,496
050,53,041,"Washington","Lewis County",4,54,964,489,475
050,53,041,"Washington","Lewis County",4,55,1004,495,509
050,53,041,"Washington","Lewis County",4,56,1017,514,503
050,53,041,"Washington","Lewis County",4,57,1079,552,527
050,53,041,"Washington","Lewis County",4,58,1132,565,567
050,53,041,"Washington","Lewis County",4,59,1160,558,602
050,53,041,"Washington","Lewis County",4,60,1246,605,641
050,53,041,"Washington","Lewis County",4,61,1289,622,667
050,53,041,"Washington","Lewis County",4,62,1250,597,653
050,53,041,"Washington","Lewis County",4,63,1233,609,624
050,53,041,"Washington","Lewis County",4,64,1229,624,605
050,53,041,"Washington","Lewis County",4,65,1268,618,650
050,53,041,"Washington","Lewis County",4,66,1229,568,661
050,53,041,"Washington","Lewis County",4,67,1259,625,634
050,53,041,"Washington","Lewis County",4,68,1177,580,597
050,53,041,"Washington","Lewis County",4,69,1113,551,562
050,53,041,"Washington","Lewis County",4,70,1118,550,568
050,53,041,"Washington","Lewis County",4,71,1109,552,557
050,53,041,"Washington","Lewis County",4,72,1020,487,533
050,53,041,"Washington","Lewis County",4,73,942,467,475
050,53,041,"Washington","Lewis County",4,74,889,436,453
050,53,041,"Washington","Lewis County",4,75,1007,521,486
050,53,041,"Washington","Lewis County",4,76,680,353,327
050,53,041,"Washington","Lewis County",4,77,621,312,309
050,53,041,"Washington","Lewis County",4,78,634,313,321
050,53,041,"Washington","Lewis County",4,79,641,315,326
050,53,041,"Washington","Lewis County",4,80,549,250,299
050,53,041,"Washington","Lewis County",4,81,458,216,242
050,53,041,"Washington","Lewis County",4,82,397,190,207
050,53,041,"Washington","Lewis County",4,83,369,166,203
050,53,041,"Washington","Lewis County",4,84,320,140,180
050,53,041,"Washington","Lewis County",4,85,1560,637,923
050,53,041,"Washington","Lewis County",5,0,912,483,429
050,53,041,"Washington","Lewis County",5,1,951,509,442
050,53,041,"Washington","Lewis County",5,2,921,498,423
050,53,041,"Washington","Lewis County",5,3,1000,516,484
050,53,041,"Washington","Lewis County",5,4,999,516,483
050,53,041,"Washington","Lewis County",5,5,1029,545,484
050,53,041,"Washington","Lewis County",5,6,1057,576,481
050,53,041,"Washington","Lewis County",5,7,1104,567,537
050,53,041,"Washington","Lewis County",5,8,1046,559,487
050,53,041,"Washington","Lewis County",5,9,1067,565,502
050,53,041,"Washington","Lewis County",5,10,1058,541,517
050,53,041,"Washington","Lewis County",5,11,1023,523,500
050,53,041,"Washington","Lewis County",5,12,1046,541,505
050,53,041,"Washington","Lewis County",5,13,1022,533,489
050,53,041,"Washington","Lewis County",5,14,1052,543,509
050,53,041,"Washington","Lewis County",5,15,1115,570,545
050,53,041,"Washington","Lewis County",5,16,1077,556,521
050,53,041,"Washington","Lewis County",5,17,1098,599,499
050,53,041,"Washington","Lewis County",5,18,894,485,409
050,53,041,"Washington","Lewis County",5,19,722,391,331
050,53,041,"Washington","Lewis County",5,20,768,390,378
050,53,041,"Washington","Lewis County",5,21,816,412,404
050,53,041,"Washington","Lewis County",5,22,900,471,429
050,53,041,"Washington","Lewis County",5,23,940,493,447
050,53,041,"Washington","Lewis County",5,24,945,518,427
050,53,041,"Washington","Lewis County",5,25,940,495,445
050,53,041,"Washington","Lewis County",5,26,943,471,472
050,53,041,"Washington","Lewis County",5,27,1006,511,495
050,53,041,"Washington","Lewis County",5,28,1029,511,518
050,53,041,"Washington","Lewis County",5,29,1045,564,481
050,53,041,"Washington","Lewis County",5,30,1034,546,488
050,53,041,"Washington","Lewis County",5,31,1138,600,538
050,53,041,"Washington","Lewis County",5,32,1109,547,562
050,53,041,"Washington","Lewis County",5,33,1190,608,582
050,53,041,"Washington","Lewis County",5,34,1086,557,529
050,53,041,"Washington","Lewis County",5,35,1090,537,553
050,53,041,"Washington","Lewis County",5,36,1088,564,524
050,53,041,"Washington","Lewis County",5,37,1152,577,575
050,53,041,"Washington","Lewis County",5,38,1075,531,544
050,53,041,"Washington","Lewis County",5,39,1094,571,523
050,53,041,"Washington","Lewis County",5,40,1100,570,530
050,53,041,"Washington","Lewis County",5,41,1081,554,527
050,53,041,"Washington","Lewis County",5,42,1085,542,543
050,53,041,"Washington","Lewis County",5,43,1089,545,544
050,53,041,"Washington","Lewis County",5,44,1061,556,505
050,53,041,"Washington","Lewis County",5,45,1021,525,496
050,53,041,"Washington","Lewis County",5,46,1034,533,501
050,53,041,"Washington","Lewis County",5,47,977,494,483
050,53,041,"Washington","Lewis County",5,48,951,480,471
050,53,041,"Washington","Lewis County",5,49,894,458,436
050,53,041,"Washington","Lewis County",5,50,907,465,442
050,53,041,"Washington","Lewis County",5,51,986,489,497
050,53,041,"Washington","Lewis County",5,52,1058,523,535
050,53,041,"Washington","Lewis County",5,53,1026,519,507
050,53,041,"Washington","Lewis County",5,54,1023,507,516
050,53,041,"Washington","Lewis County",5,55,980,499,481
050,53,041,"Washington","Lewis County",5,56,1023,501,522
050,53,041,"Washington","Lewis County",5,57,1039,522,517
050,53,041,"Washington","Lewis County",5,58,1103,556,547
050,53,041,"Washington","Lewis County",5,59,1149,576,573
050,53,041,"Washington","Lewis County",5,60,1186,565,621
050,53,041,"Washington","Lewis County",5,61,1243,600,643
050,53,041,"Washington","Lewis County",5,62,1310,641,669
050,53,041,"Washington","Lewis County",5,63,1261,611,650
050,53,041,"Washington","Lewis County",5,64,1238,612,626
050,53,041,"Washington","Lewis County",5,65,1235,620,615
050,53,041,"Washington","Lewis County",5,66,1251,604,647
050,53,041,"Washington","Lewis County",5,67,1211,553,658
050,53,041,"Washington","Lewis County",5,68,1240,612,628
050,53,041,"Washington","Lewis County",5,69,1154,560,594
050,53,041,"Washington","Lewis County",5,70,1094,532,562
050,53,041,"Washington","Lewis County",5,71,1099,536,563
050,53,041,"Washington","Lewis County",5,72,1068,535,533
050,53,041,"Washington","Lewis County",5,73,985,460,525
050,53,041,"Washington","Lewis County",5,74,899,450,449
050,53,041,"Washington","Lewis County",5,75,874,426,448
050,53,041,"Washington","Lewis County",5,76,974,502,472
050,53,041,"Washington","Lewis County",5,77,651,335,316
050,53,041,"Washington","Lewis County",5,78,585,293,292
050,53,041,"Washington","Lewis County",5,79,586,284,302
050,53,041,"Washington","Lewis County",5,80,610,302,308
050,53,041,"Washington","Lewis County",5,81,507,234,273
050,53,041,"Washington","Lewis County",5,82,433,199,234
050,53,041,"Washington","Lewis County",5,83,381,180,201
050,53,041,"Washington","Lewis County",5,84,330,150,180
050,53,041,"Washington","Lewis County",5,85,1581,644,937
050,53,043,"Washington","Lincoln County",1,0,100,51,49
050,53,043,"Washington","Lincoln County",1,1,110,58,52
050,53,043,"Washington","Lincoln County",1,2,116,59,57
050,53,043,"Washington","Lincoln County",1,3,120,66,54
050,53,043,"Washington","Lincoln County",1,4,134,70,64
050,53,043,"Washington","Lincoln County",1,5,117,63,54
050,53,043,"Washington","Lincoln County",1,6,134,77,57
050,53,043,"Washington","Lincoln County",1,7,126,63,63
050,53,043,"Washington","Lincoln County",1,8,121,58,63
050,53,043,"Washington","Lincoln County",1,9,123,60,63
050,53,043,"Washington","Lincoln County",1,10,131,71,60
050,53,043,"Washington","Lincoln County",1,11,133,68,65
050,53,043,"Washington","Lincoln County",1,12,154,90,64
050,53,043,"Washington","Lincoln County",1,13,151,82,69
050,53,043,"Washington","Lincoln County",1,14,150,81,69
050,53,043,"Washington","Lincoln County",1,15,161,68,93
050,53,043,"Washington","Lincoln County",1,16,148,73,75
050,53,043,"Washington","Lincoln County",1,17,149,76,73
050,53,043,"Washington","Lincoln County",1,18,124,65,59
050,53,043,"Washington","Lincoln County",1,19,101,52,49
050,53,043,"Washington","Lincoln County",1,20,96,52,44
050,53,043,"Washington","Lincoln County",1,21,95,50,45
050,53,043,"Washington","Lincoln County",1,22,100,52,48
050,53,043,"Washington","Lincoln County",1,23,102,47,55
050,53,043,"Washington","Lincoln County",1,24,81,40,41
050,53,043,"Washington","Lincoln County",1,25,91,54,37
050,53,043,"Washington","Lincoln County",1,26,98,55,43
050,53,043,"Washington","Lincoln County",1,27,93,52,41
050,53,043,"Washington","Lincoln County",1,28,83,40,43
050,53,043,"Washington","Lincoln County",1,29,77,39,38
050,53,043,"Washington","Lincoln County",1,30,91,49,42
050,53,043,"Washington","Lincoln County",1,31,103,51,52
050,53,043,"Washington","Lincoln County",1,32,106,53,53
050,53,043,"Washington","Lincoln County",1,33,94,46,48
050,53,043,"Washington","Lincoln County",1,34,106,53,53
050,53,043,"Washington","Lincoln County",1,35,107,51,56
050,53,043,"Washington","Lincoln County",1,36,113,50,63
050,53,043,"Washington","Lincoln County",1,37,122,65,57
050,53,043,"Washington","Lincoln County",1,38,127,63,64
050,53,043,"Washington","Lincoln County",1,39,127,72,55
050,53,043,"Washington","Lincoln County",1,40,112,60,52
050,53,043,"Washington","Lincoln County",1,41,114,58,56
050,53,043,"Washington","Lincoln County",1,42,126,64,62
050,53,043,"Washington","Lincoln County",1,43,108,51,57
050,53,043,"Washington","Lincoln County",1,44,128,66,62
050,53,043,"Washington","Lincoln County",1,45,111,52,59
050,53,043,"Washington","Lincoln County",1,46,102,50,52
050,53,043,"Washington","Lincoln County",1,47,96,49,47
050,53,043,"Washington","Lincoln County",1,48,111,54,57
050,53,043,"Washington","Lincoln County",1,49,126,60,66
050,53,043,"Washington","Lincoln County",1,50,133,61,72
050,53,043,"Washington","Lincoln County",1,51,130,72,58
050,53,043,"Washington","Lincoln County",1,52,100,53,47
050,53,043,"Washington","Lincoln County",1,53,124,67,57
050,53,043,"Washington","Lincoln County",1,54,122,70,52
050,53,043,"Washington","Lincoln County",1,55,137,74,63
050,53,043,"Washington","Lincoln County",1,56,143,69,74
050,53,043,"Washington","Lincoln County",1,57,138,64,74
050,53,043,"Washington","Lincoln County",1,58,164,80,84
050,53,043,"Washington","Lincoln County",1,59,180,93,87
050,53,043,"Washington","Lincoln County",1,60,181,94,87
050,53,043,"Washington","Lincoln County",1,61,207,97,110
050,53,043,"Washington","Lincoln County",1,62,214,108,106
050,53,043,"Washington","Lincoln County",1,63,180,93,87
050,53,043,"Washington","Lincoln County",1,64,180,98,82
050,53,043,"Washington","Lincoln County",1,65,197,96,101
050,53,043,"Washington","Lincoln County",1,66,192,99,93
050,53,043,"Washington","Lincoln County",1,67,197,104,93
050,53,043,"Washington","Lincoln County",1,68,183,92,91
050,53,043,"Washington","Lincoln County",1,69,157,80,77
050,53,043,"Washington","Lincoln County",1,70,162,83,79
050,53,043,"Washington","Lincoln County",1,71,152,79,73
050,53,043,"Washington","Lincoln County",1,72,164,81,83
050,53,043,"Washington","Lincoln County",1,73,171,87,84
050,53,043,"Washington","Lincoln County",1,74,127,65,62
050,53,043,"Washington","Lincoln County",1,75,113,54,59
050,53,043,"Washington","Lincoln County",1,76,104,53,51
050,53,043,"Washington","Lincoln County",1,77,96,56,40
050,53,043,"Washington","Lincoln County",1,78,82,51,31
050,53,043,"Washington","Lincoln County",1,79,86,44,42
050,53,043,"Washington","Lincoln County",1,80,72,33,39
050,53,043,"Washington","Lincoln County",1,81,71,36,35
050,53,043,"Washington","Lincoln County",1,82,66,34,32
050,53,043,"Washington","Lincoln County",1,83,54,23,31
050,53,043,"Washington","Lincoln County",1,84,51,30,21
050,53,043,"Washington","Lincoln County",1,85,299,127,172
050,53,043,"Washington","Lincoln County",2,0,110,52,58
050,53,043,"Washington","Lincoln County",2,1,108,56,52
050,53,043,"Washington","Lincoln County",2,2,114,57,57
050,53,043,"Washington","Lincoln County",2,3,121,65,56
050,53,043,"Washington","Lincoln County",2,4,131,69,62
050,53,043,"Washington","Lincoln County",2,5,124,66,58
050,53,043,"Washington","Lincoln County",2,6,131,74,57
050,53,043,"Washington","Lincoln County",2,7,129,68,61
050,53,043,"Washington","Lincoln County",2,8,121,59,62
050,53,043,"Washington","Lincoln County",2,9,123,60,63
050,53,043,"Washington","Lincoln County",2,10,130,69,61
050,53,043,"Washington","Lincoln County",2,11,133,69,64
050,53,043,"Washington","Lincoln County",2,12,152,86,66
050,53,043,"Washington","Lincoln County",2,13,152,84,68
050,53,043,"Washington","Lincoln County",2,14,151,81,70
050,53,043,"Washington","Lincoln County",2,15,158,70,88
050,53,043,"Washington","Lincoln County",2,16,150,72,78
050,53,043,"Washington","Lincoln County",2,17,147,75,72
050,53,043,"Washington","Lincoln County",2,18,124,65,59
050,53,043,"Washington","Lincoln County",2,19,100,52,48
050,53,043,"Washington","Lincoln County",2,20,103,54,49
050,53,043,"Washington","Lincoln County",2,21,95,50,45
050,53,043,"Washington","Lincoln County",2,22,102,52,50
050,53,043,"Washington","Lincoln County",2,23,103,48,55
050,53,043,"Washington","Lincoln County",2,24,85,43,42
050,53,043,"Washington","Lincoln County",2,25,90,51,39
050,53,043,"Washington","Lincoln County",2,26,94,54,40
050,53,043,"Washington","Lincoln County",2,27,94,52,42
050,53,043,"Washington","Lincoln County",2,28,86,43,43
050,53,043,"Washington","Lincoln County",2,29,78,39,39
050,53,043,"Washington","Lincoln County",2,30,88,47,41
050,53,043,"Washington","Lincoln County",2,31,102,50,52
050,53,043,"Washington","Lincoln County",2,32,107,54,53
050,53,043,"Washington","Lincoln County",2,33,100,49,51
050,53,043,"Washington","Lincoln County",2,34,107,53,54
050,53,043,"Washington","Lincoln County",2,35,111,53,58
050,53,043,"Washington","Lincoln County",2,36,112,51,61
050,53,043,"Washington","Lincoln County",2,37,122,63,59
050,53,043,"Washington","Lincoln County",2,38,127,64,63
050,53,043,"Washington","Lincoln County",2,39,126,68,58
050,53,043,"Washington","Lincoln County",2,40,116,63,53
050,53,043,"Washington","Lincoln County",2,41,114,60,54
050,53,043,"Washington","Lincoln County",2,42,122,62,60
050,53,043,"Washington","Lincoln County",2,43,115,55,60
050,53,043,"Washington","Lincoln County",2,44,122,62,60
050,53,043,"Washington","Lincoln County",2,45,117,56,61
050,53,043,"Washington","Lincoln County",2,46,105,52,53
050,53,043,"Washington","Lincoln County",2,47,97,48,49
050,53,043,"Washington","Lincoln County",2,48,106,52,54
050,53,043,"Washington","Lincoln County",2,49,122,59,63
050,53,043,"Washington","Lincoln County",2,50,132,62,70
050,53,043,"Washington","Lincoln County",2,51,129,67,62
050,53,043,"Washington","Lincoln County",2,52,107,57,50
050,53,043,"Washington","Lincoln County",2,53,119,64,55
050,53,043,"Washington","Lincoln County",2,54,122,69,53
050,53,043,"Washington","Lincoln County",2,55,134,74,60
050,53,043,"Washington","Lincoln County",2,56,142,71,71
050,53,043,"Washington","Lincoln County",2,57,140,66,74
050,53,043,"Washington","Lincoln County",2,58,156,76,80
050,53,043,"Washington","Lincoln County",2,59,179,92,87
050,53,043,"Washington","Lincoln County",2,60,184,95,89
050,53,043,"Washington","Lincoln County",2,61,202,97,105
050,53,043,"Washington","Lincoln County",2,62,212,105,107
050,53,043,"Washington","Lincoln County",2,63,193,99,94
050,53,043,"Washington","Lincoln County",2,64,181,96,85
050,53,043,"Washington","Lincoln County",2,65,192,96,96
050,53,043,"Washington","Lincoln County",2,66,195,99,96
050,53,043,"Washington","Lincoln County",2,67,196,104,92
050,53,043,"Washington","Lincoln County",2,68,184,93,91
050,53,043,"Washington","Lincoln County",2,69,163,83,80
050,53,043,"Washington","Lincoln County",2,70,162,83,79
050,53,043,"Washington","Lincoln County",2,71,156,81,75
050,53,043,"Washington","Lincoln County",2,72,159,80,79
050,53,043,"Washington","Lincoln County",2,73,177,90,87
050,53,043,"Washington","Lincoln County",2,74,129,66,63
050,53,043,"Washington","Lincoln County",2,75,119,58,61
050,53,043,"Washington","Lincoln County",2,76,103,51,52
050,53,043,"Washington","Lincoln County",2,77,99,56,43
050,53,043,"Washington","Lincoln County",2,78,81,51,30
050,53,043,"Washington","Lincoln County",2,79,85,45,40
050,53,043,"Washington","Lincoln County",2,80,74,34,40
050,53,043,"Washington","Lincoln County",2,81,72,36,36
050,53,043,"Washington","Lincoln County",2,82,65,33,32
050,53,043,"Washington","Lincoln County",2,83,56,25,31
050,53,043,"Washington","Lincoln County",2,84,48,26,22
050,53,043,"Washington","Lincoln County",2,85,304,130,174
050,53,043,"Washington","Lincoln County",3,0,109,57,52
050,53,043,"Washington","Lincoln County",3,1,122,68,54
050,53,043,"Washington","Lincoln County",3,2,118,60,58
050,53,043,"Washington","Lincoln County",3,3,118,54,64
050,53,043,"Washington","Lincoln County",3,4,129,73,56
050,53,043,"Washington","Lincoln County",3,5,138,71,67
050,53,043,"Washington","Lincoln County",3,6,129,68,61
050,53,043,"Washington","Lincoln County",3,7,136,81,55
050,53,043,"Washington","Lincoln County",3,8,144,74,70
050,53,043,"Washington","Lincoln County",3,9,115,57,58
050,53,043,"Washington","Lincoln County",3,10,134,69,65
050,53,043,"Washington","Lincoln County",3,11,146,78,68
050,53,043,"Washington","Lincoln County",3,12,135,71,64
050,53,043,"Washington","Lincoln County",3,13,160,88,72
050,53,043,"Washington","Lincoln County",3,14,161,91,70
050,53,043,"Washington","Lincoln County",3,15,159,87,72
050,53,043,"Washington","Lincoln County",3,16,161,75,86
050,53,043,"Washington","Lincoln County",3,17,153,73,80
050,53,043,"Washington","Lincoln County",3,18,126,70,56
050,53,043,"Washington","Lincoln County",3,19,97,52,45
050,53,043,"Washington","Lincoln County",3,20,114,58,56
050,53,043,"Washington","Lincoln County",3,21,105,57,48
050,53,043,"Washington","Lincoln County",3,22,98,51,47
050,53,043,"Washington","Lincoln County",3,23,110,53,57
050,53,043,"Washington","Lincoln County",3,24,103,52,51
050,53,043,"Washington","Lincoln County",3,25,90,47,43
050,53,043,"Washington","Lincoln County",3,26,103,58,45
050,53,043,"Washington","Lincoln County",3,27,98,53,45
050,53,043,"Washington","Lincoln County",3,28,101,54,47
050,53,043,"Washington","Lincoln County",3,29,99,53,46
050,53,043,"Washington","Lincoln County",3,30,80,35,45
050,53,043,"Washington","Lincoln County",3,31,95,52,43
050,53,043,"Washington","Lincoln County",3,32,118,59,59
050,53,043,"Washington","Lincoln County",3,33,109,56,53
050,53,043,"Washington","Lincoln County",3,34,105,53,52
050,53,043,"Washington","Lincoln County",3,35,119,57,62
050,53,043,"Washington","Lincoln County",3,36,120,60,60
050,53,043,"Washington","Lincoln County",3,37,115,52,63
050,53,043,"Washington","Lincoln County",3,38,136,68,68
050,53,043,"Washington","Lincoln County",3,39,123,64,59
050,53,043,"Washington","Lincoln County",3,40,139,69,70
050,53,043,"Washington","Lincoln County",3,41,122,65,57
050,53,043,"Washington","Lincoln County",3,42,123,65,58
050,53,043,"Washington","Lincoln County",3,43,118,59,59
050,53,043,"Washington","Lincoln County",3,44,125,61,64
050,53,043,"Washington","Lincoln County",3,45,125,65,60
050,53,043,"Washington","Lincoln County",3,46,125,62,63
050,53,043,"Washington","Lincoln County",3,47,107,55,52
050,53,043,"Washington","Lincoln County",3,48,95,47,48
050,53,043,"Washington","Lincoln County",3,49,113,58,55
050,53,043,"Washington","Lincoln County",3,50,122,59,63
050,53,043,"Washington","Lincoln County",3,51,134,65,69
050,53,043,"Washington","Lincoln County",3,52,128,70,58
050,53,043,"Washington","Lincoln County",3,53,117,63,54
050,53,043,"Washington","Lincoln County",3,54,123,62,61
050,53,043,"Washington","Lincoln County",3,55,129,69,60
050,53,043,"Washington","Lincoln County",3,56,126,72,54
050,53,043,"Washington","Lincoln County",3,57,150,72,78
050,53,043,"Washington","Lincoln County",3,58,152,73,79
050,53,043,"Washington","Lincoln County",3,59,164,83,81
050,53,043,"Washington","Lincoln County",3,60,193,102,91
050,53,043,"Washington","Lincoln County",3,61,195,99,96
050,53,043,"Washington","Lincoln County",3,62,212,105,107
050,53,043,"Washington","Lincoln County",3,63,216,108,108
050,53,043,"Washington","Lincoln County",3,64,192,99,93
050,53,043,"Washington","Lincoln County",3,65,188,103,85
050,53,043,"Washington","Lincoln County",3,66,194,97,97
050,53,043,"Washington","Lincoln County",3,67,201,101,100
050,53,043,"Washington","Lincoln County",3,68,194,100,94
050,53,043,"Washington","Lincoln County",3,69,181,92,89
050,53,043,"Washington","Lincoln County",3,70,165,85,80
050,53,043,"Washington","Lincoln County",3,71,157,82,75
050,53,043,"Washington","Lincoln County",3,72,151,78,73
050,53,043,"Washington","Lincoln County",3,73,157,79,78
050,53,043,"Washington","Lincoln County",3,74,175,89,86
050,53,043,"Washington","Lincoln County",3,75,126,65,61
050,53,043,"Washington","Lincoln County",3,76,116,59,57
050,53,043,"Washington","Lincoln County",3,77,100,50,50
050,53,043,"Washington","Lincoln County",3,78,95,53,42
050,53,043,"Washington","Lincoln County",3,79,75,46,29
050,53,043,"Washington","Lincoln County",3,80,82,44,38
050,53,043,"Washington","Lincoln County",3,81,67,27,40
050,53,043,"Washington","Lincoln County",3,82,66,33,33
050,53,043,"Washington","Lincoln County",3,83,62,30,32
050,53,043,"Washington","Lincoln County",3,84,51,24,27
050,53,043,"Washington","Lincoln County",3,85,305,133,172
050,53,043,"Washington","Lincoln County",4,0,102,61,41
050,53,043,"Washington","Lincoln County",4,1,110,61,49
050,53,043,"Washington","Lincoln County",4,2,117,63,54
050,53,043,"Washington","Lincoln County",4,3,126,64,62
050,53,043,"Washington","Lincoln County",4,4,120,55,65
050,53,043,"Washington","Lincoln County",4,5,141,81,60
050,53,043,"Washington","Lincoln County",4,6,148,85,63
050,53,043,"Washington","Lincoln County",4,7,132,68,64
050,53,043,"Washington","Lincoln County",4,8,143,81,62
050,53,043,"Washington","Lincoln County",4,9,146,72,74
050,53,043,"Washington","Lincoln County",4,10,128,67,61
050,53,043,"Washington","Lincoln County",4,11,138,75,63
050,53,043,"Washington","Lincoln County",4,12,154,81,73
050,53,043,"Washington","Lincoln County",4,13,136,75,61
050,53,043,"Washington","Lincoln County",4,14,170,92,78
050,53,043,"Washington","Lincoln County",4,15,174,101,73
050,53,043,"Washington","Lincoln County",4,16,163,91,72
050,53,043,"Washington","Lincoln County",4,17,170,82,88
050,53,043,"Washington","Lincoln County",4,18,134,71,63
050,53,043,"Washington","Lincoln County",4,19,89,56,33
050,53,043,"Washington","Lincoln County",4,20,106,56,50
050,53,043,"Washington","Lincoln County",4,21,110,54,56
050,53,043,"Washington","Lincoln County",4,22,116,59,57
050,53,043,"Washington","Lincoln County",4,23,105,58,47
050,53,043,"Washington","Lincoln County",4,24,117,55,62
050,53,043,"Washington","Lincoln County",4,25,106,48,58
050,53,043,"Washington","Lincoln County",4,26,98,46,52
050,53,043,"Washington","Lincoln County",4,27,104,56,48
050,53,043,"Washington","Lincoln County",4,28,105,61,44
050,53,043,"Washington","Lincoln County",4,29,102,55,47
050,53,043,"Washington","Lincoln County",4,30,108,58,50
050,53,043,"Washington","Lincoln County",4,31,94,49,45
050,53,043,"Washington","Lincoln County",4,32,107,63,44
050,53,043,"Washington","Lincoln County",4,33,110,55,55
050,53,043,"Washington","Lincoln County",4,34,113,51,62
050,53,043,"Washington","Lincoln County",4,35,108,53,55
050,53,043,"Washington","Lincoln County",4,36,132,67,65
050,53,043,"Washington","Lincoln County",4,37,132,69,63
050,53,043,"Washington","Lincoln County",4,38,115,50,65
050,53,043,"Washington","Lincoln County",4,39,137,74,63
050,53,043,"Washington","Lincoln County",4,40,130,68,62
050,53,043,"Washington","Lincoln County",4,41,142,70,72
050,53,043,"Washington","Lincoln County",4,42,129,68,61
050,53,043,"Washington","Lincoln County",4,43,131,70,61
050,53,043,"Washington","Lincoln County",4,44,131,71,60
050,53,043,"Washington","Lincoln County",4,45,125,58,67
050,53,043,"Washington","Lincoln County",4,46,130,69,61
050,53,043,"Washington","Lincoln County",4,47,124,63,61
050,53,043,"Washington","Lincoln County",4,48,107,54,53
050,53,043,"Washington","Lincoln County",4,49,99,48,51
050,53,043,"Washington","Lincoln County",4,50,113,57,56
050,53,043,"Washington","Lincoln County",4,51,127,60,67
050,53,043,"Washington","Lincoln County",4,52,139,65,74
050,53,043,"Washington","Lincoln County",4,53,127,68,59
050,53,043,"Washington","Lincoln County",4,54,128,68,60
050,53,043,"Washington","Lincoln County",4,55,128,64,64
050,53,043,"Washington","Lincoln County",4,56,134,71,63
050,53,043,"Washington","Lincoln County",4,57,136,79,57
050,53,043,"Washington","Lincoln County",4,58,156,80,76
050,53,043,"Washington","Lincoln County",4,59,163,77,86
050,53,043,"Washington","Lincoln County",4,60,176,87,89
050,53,043,"Washington","Lincoln County",4,61,196,103,93
050,53,043,"Washington","Lincoln County",4,62,215,110,105
050,53,043,"Washington","Lincoln County",4,63,219,107,112
050,53,043,"Washington","Lincoln County",4,64,214,109,105
050,53,043,"Washington","Lincoln County",4,65,203,105,98
050,53,043,"Washington","Lincoln County",4,66,202,108,94
050,53,043,"Washington","Lincoln County",4,67,194,96,98
050,53,043,"Washington","Lincoln County",4,68,197,102,95
050,53,043,"Washington","Lincoln County",4,69,198,103,95
050,53,043,"Washington","Lincoln County",4,70,172,86,86
050,53,043,"Washington","Lincoln County",4,71,161,85,76
050,53,043,"Washington","Lincoln County",4,72,148,78,70
050,53,043,"Washington","Lincoln County",4,73,156,81,75
050,53,043,"Washington","Lincoln County",4,74,160,86,74
050,53,043,"Washington","Lincoln County",4,75,174,87,87
050,53,043,"Washington","Lincoln County",4,76,121,64,57
050,53,043,"Washington","Lincoln County",4,77,113,58,55
050,53,043,"Washington","Lincoln County",4,78,94,49,45
050,53,043,"Washington","Lincoln County",4,79,88,49,39
050,53,043,"Washington","Lincoln County",4,80,70,42,28
050,53,043,"Washington","Lincoln County",4,81,82,43,39
050,53,043,"Washington","Lincoln County",4,82,60,25,35
050,53,043,"Washington","Lincoln County",4,83,62,32,30
050,53,043,"Washington","Lincoln County",4,84,53,26,27
050,53,043,"Washington","Lincoln County",4,85,320,136,184
050,53,043,"Washington","Lincoln County",5,0,98,59,39
050,53,043,"Washington","Lincoln County",5,1,91,39,52
050,53,043,"Washington","Lincoln County",5,2,115,58,57
050,53,043,"Washington","Lincoln County",5,3,122,64,58
050,53,043,"Washington","Lincoln County",5,4,134,66,68
050,53,043,"Washington","Lincoln County",5,5,129,63,66
050,53,043,"Washington","Lincoln County",5,6,140,88,52
050,53,043,"Washington","Lincoln County",5,7,151,85,66
050,53,043,"Washington","Lincoln County",5,8,139,72,67
050,53,043,"Washington","Lincoln County",5,9,140,77,63
050,53,043,"Washington","Lincoln County",5,10,150,79,71
050,53,043,"Washington","Lincoln County",5,11,127,62,65
050,53,043,"Washington","Lincoln County",5,12,142,77,65
050,53,043,"Washington","Lincoln County",5,13,151,79,72
050,53,043,"Washington","Lincoln County",5,14,148,78,70
050,53,043,"Washington","Lincoln County",5,15,170,91,79
050,53,043,"Washington","Lincoln County",5,16,170,98,72
050,53,043,"Washington","Lincoln County",5,17,168,92,76
050,53,043,"Washington","Lincoln County",5,18,151,77,74
050,53,043,"Washington","Lincoln County",5,19,108,57,51
050,53,043,"Washington","Lincoln County",5,20,93,57,36
050,53,043,"Washington","Lincoln County",5,21,113,63,50
050,53,043,"Washington","Lincoln County",5,22,112,58,54
050,53,043,"Washington","Lincoln County",5,23,119,61,58
050,53,043,"Washington","Lincoln County",5,24,99,56,43
050,53,043,"Washington","Lincoln County",5,25,114,59,55
050,53,043,"Washington","Lincoln County",5,26,115,51,64
050,53,043,"Washington","Lincoln County",5,27,103,49,54
050,53,043,"Washington","Lincoln County",5,28,117,64,53
050,53,043,"Washington","Lincoln County",5,29,114,63,51
050,53,043,"Washington","Lincoln County",5,30,97,55,42
050,53,043,"Washington","Lincoln County",5,31,111,62,49
050,53,043,"Washington","Lincoln County",5,32,105,55,50
050,53,043,"Washington","Lincoln County",5,33,107,58,49
050,53,043,"Washington","Lincoln County",5,34,117,61,56
050,53,043,"Washington","Lincoln County",5,35,113,52,61
050,53,043,"Washington","Lincoln County",5,36,114,57,57
050,53,043,"Washington","Lincoln County",5,37,131,61,70
050,53,043,"Washington","Lincoln County",5,38,131,69,62
050,53,043,"Washington","Lincoln County",5,39,114,47,67
050,53,043,"Washington","Lincoln County",5,40,137,76,61
050,53,043,"Washington","Lincoln County",5,41,138,69,69
050,53,043,"Washington","Lincoln County",5,42,141,73,68
050,53,043,"Washington","Lincoln County",5,43,134,72,62
050,53,043,"Washington","Lincoln County",5,44,131,70,61
050,53,043,"Washington","Lincoln County",5,45,135,71,64
050,53,043,"Washington","Lincoln County",5,46,133,65,68
050,53,043,"Washington","Lincoln County",5,47,144,78,66
050,53,043,"Washington","Lincoln County",5,48,121,66,55
050,53,043,"Washington","Lincoln County",5,49,113,55,58
050,53,043,"Washington","Lincoln County",5,50,105,51,54
050,53,043,"Washington","Lincoln County",5,51,115,59,56
050,53,043,"Washington","Lincoln County",5,52,131,60,71
050,53,043,"Washington","Lincoln County",5,53,141,63,78
050,53,043,"Washington","Lincoln County",5,54,126,68,58
050,53,043,"Washington","Lincoln County",5,55,135,71,64
050,53,043,"Washington","Lincoln County",5,56,128,65,63
050,53,043,"Washington","Lincoln County",5,57,138,76,62
050,53,043,"Washington","Lincoln County",5,58,139,79,60
050,53,043,"Washington","Lincoln County",5,59,160,85,75
050,53,043,"Washington","Lincoln County",5,60,164,75,89
050,53,043,"Washington","Lincoln County",5,61,180,86,94
050,53,043,"Washington","Lincoln County",5,62,197,103,94
050,53,043,"Washington","Lincoln County",5,63,212,108,104
050,53,043,"Washington","Lincoln County",5,64,219,112,107
050,53,043,"Washington","Lincoln County",5,65,214,111,103
050,53,043,"Washington","Lincoln County",5,66,212,109,103
050,53,043,"Washington","Lincoln County",5,67,210,110,100
050,53,043,"Washington","Lincoln County",5,68,187,93,94
050,53,043,"Washington","Lincoln County",5,69,186,97,89
050,53,043,"Washington","Lincoln County",5,70,194,100,94
050,53,043,"Washington","Lincoln County",5,71,159,78,81
050,53,043,"Washington","Lincoln County",5,72,156,84,72
050,53,043,"Washington","Lincoln County",5,73,146,81,65
050,53,043,"Washington","Lincoln County",5,74,151,81,70
050,53,043,"Washington","Lincoln County",5,75,151,78,73
050,53,043,"Washington","Lincoln County",5,76,172,88,84
050,53,043,"Washington","Lincoln County",5,77,113,57,56
050,53,043,"Washington","Lincoln County",5,78,106,55,51
050,53,043,"Washington","Lincoln County",5,79,94,47,47
050,53,043,"Washington","Lincoln County",5,80,81,44,37
050,53,043,"Washington","Lincoln County",5,81,73,43,30
050,53,043,"Washington","Lincoln County",5,82,77,40,37
050,53,043,"Washington","Lincoln County",5,83,58,24,34
050,53,043,"Washington","Lincoln County",5,84,57,29,28
050,53,043,"Washington","Lincoln County",5,85,341,148,193
050,53,045,"Washington","Mason County",1,0,624,318,306
050,53,045,"Washington","Mason County",1,1,675,350,325
050,53,045,"Washington","Mason County",1,2,703,374,329
050,53,045,"Washington","Mason County",1,3,698,360,338
050,53,045,"Washington","Mason County",1,4,724,375,349
050,53,045,"Washington","Mason County",1,5,732,385,347
050,53,045,"Washington","Mason County",1,6,719,377,342
050,53,045,"Washington","Mason County",1,7,764,408,356
050,53,045,"Washington","Mason County",1,8,710,354,356
050,53,045,"Washington","Mason County",1,9,682,364,318
050,53,045,"Washington","Mason County",1,10,762,402,360
050,53,045,"Washington","Mason County",1,11,737,374,363
050,53,045,"Washington","Mason County",1,12,733,394,339
050,53,045,"Washington","Mason County",1,13,779,417,362
050,53,045,"Washington","Mason County",1,14,769,411,358
050,53,045,"Washington","Mason County",1,15,777,388,389
050,53,045,"Washington","Mason County",1,16,742,372,370
050,53,045,"Washington","Mason County",1,17,705,383,322
050,53,045,"Washington","Mason County",1,18,627,350,277
050,53,045,"Washington","Mason County",1,19,555,338,217
050,53,045,"Washington","Mason County",1,20,563,338,225
050,53,045,"Washington","Mason County",1,21,620,351,269
050,53,045,"Washington","Mason County",1,22,659,362,297
050,53,045,"Washington","Mason County",1,23,752,415,337
050,53,045,"Washington","Mason County",1,24,683,393,290
050,53,045,"Washington","Mason County",1,25,758,459,299
050,53,045,"Washington","Mason County",1,26,772,448,324
050,53,045,"Washington","Mason County",1,27,793,459,334
050,53,045,"Washington","Mason County",1,28,820,468,352
050,53,045,"Washington","Mason County",1,29,879,474,405
050,53,045,"Washington","Mason County",1,30,852,473,379
050,53,045,"Washington","Mason County",1,31,765,412,353
050,53,045,"Washington","Mason County",1,32,787,442,345
050,53,045,"Washington","Mason County",1,33,724,390,334
050,53,045,"Washington","Mason County",1,34,753,409,344
050,53,045,"Washington","Mason County",1,35,748,409,339
050,53,045,"Washington","Mason County",1,36,803,425,378
050,53,045,"Washington","Mason County",1,37,808,430,378
050,53,045,"Washington","Mason County",1,38,756,405,351
050,53,045,"Washington","Mason County",1,39,826,452,374
050,53,045,"Washington","Mason County",1,40,770,416,354
050,53,045,"Washington","Mason County",1,41,734,395,339
050,53,045,"Washington","Mason County",1,42,719,394,325
050,53,045,"Washington","Mason County",1,43,686,372,314
050,53,045,"Washington","Mason County",1,44,680,397,283
050,53,045,"Washington","Mason County",1,45,688,387,301
050,53,045,"Washington","Mason County",1,46,659,358,301
050,53,045,"Washington","Mason County",1,47,682,355,327
050,53,045,"Washington","Mason County",1,48,705,374,331
050,53,045,"Washington","Mason County",1,49,789,406,383
050,53,045,"Washington","Mason County",1,50,751,372,379
050,53,045,"Washington","Mason County",1,51,786,406,380
050,53,045,"Washington","Mason County",1,52,713,372,341
050,53,045,"Washington","Mason County",1,53,711,362,349
050,53,045,"Washington","Mason County",1,54,793,416,377
050,53,045,"Washington","Mason County",1,55,862,426,436
050,53,045,"Washington","Mason County",1,56,921,463,458
050,53,045,"Washington","Mason County",1,57,944,465,479
050,53,045,"Washington","Mason County",1,58,1003,488,515
050,53,045,"Washington","Mason County",1,59,1076,518,558
050,53,045,"Washington","Mason County",1,60,1056,530,526
050,53,045,"Washington","Mason County",1,61,1050,544,506
050,53,045,"Washington","Mason County",1,62,1126,562,564
050,53,045,"Washington","Mason County",1,63,1125,558,567
050,53,045,"Washington","Mason County",1,64,1167,589,578
050,53,045,"Washington","Mason County",1,65,1132,572,560
050,53,045,"Washington","Mason County",1,66,1145,570,575
050,53,045,"Washington","Mason County",1,67,1057,529,528
050,53,045,"Washington","Mason County",1,68,1030,511,519
050,53,045,"Washington","Mason County",1,69,977,481,496
050,53,045,"Washington","Mason County",1,70,948,466,482
050,53,045,"Washington","Mason County",1,71,925,447,478
050,53,045,"Washington","Mason County",1,72,911,435,476
050,53,045,"Washington","Mason County",1,73,912,477,435
050,53,045,"Washington","Mason County",1,74,605,307,298
050,53,045,"Washington","Mason County",1,75,612,298,314
050,53,045,"Washington","Mason County",1,76,621,316,305
050,53,045,"Washington","Mason County",1,77,591,276,315
050,53,045,"Washington","Mason County",1,78,474,246,228
050,53,045,"Washington","Mason County",1,79,406,196,210
050,53,045,"Washington","Mason County",1,80,395,203,192
050,53,045,"Washington","Mason County",1,81,365,188,177
050,53,045,"Washington","Mason County",1,82,338,166,172
050,53,045,"Washington","Mason County",1,83,297,141,156
050,53,045,"Washington","Mason County",1,84,255,119,136
050,53,045,"Washington","Mason County",1,85,1193,479,714
050,53,045,"Washington","Mason County",2,0,636,327,309
050,53,045,"Washington","Mason County",2,1,669,345,324
050,53,045,"Washington","Mason County",2,2,696,365,331
050,53,045,"Washington","Mason County",2,3,698,361,337
050,53,045,"Washington","Mason County",2,4,726,376,350
050,53,045,"Washington","Mason County",2,5,733,385,348
050,53,045,"Washington","Mason County",2,6,726,382,344
050,53,045,"Washington","Mason County",2,7,746,399,347
050,53,045,"Washington","Mason County",2,8,725,368,357
050,53,045,"Washington","Mason County",2,9,697,367,330
050,53,045,"Washington","Mason County",2,10,748,396,352
050,53,045,"Washington","Mason County",2,11,738,379,359
050,53,045,"Washington","Mason County",2,12,742,394,348
050,53,045,"Washington","Mason County",2,13,770,414,356
050,53,045,"Washington","Mason County",2,14,776,415,361
050,53,045,"Washington","Mason County",2,15,775,393,382
050,53,045,"Washington","Mason County",2,16,753,378,375
050,53,045,"Washington","Mason County",2,17,716,382,334
050,53,045,"Washington","Mason County",2,18,625,351,274
050,53,045,"Washington","Mason County",2,19,553,334,219
050,53,045,"Washington","Mason County",2,20,578,351,227
050,53,045,"Washington","Mason County",2,21,617,356,261
050,53,045,"Washington","Mason County",2,22,661,367,294
050,53,045,"Washington","Mason County",2,23,749,418,331
050,53,045,"Washington","Mason County",2,24,702,398,304
050,53,045,"Washington","Mason County",2,25,754,452,302
050,53,045,"Washington","Mason County",2,26,780,457,323
050,53,045,"Washington","Mason County",2,27,793,458,335
050,53,045,"Washington","Mason County",2,28,823,469,354
050,53,045,"Washington","Mason County",2,29,869,474,395
050,53,045,"Washington","Mason County",2,30,864,473,391
050,53,045,"Washington","Mason County",2,31,787,427,360
050,53,045,"Washington","Mason County",2,32,797,444,353
050,53,045,"Washington","Mason County",2,33,739,401,338
050,53,045,"Washington","Mason County",2,34,754,409,345
050,53,045,"Washington","Mason County",2,35,764,414,350
050,53,045,"Washington","Mason County",2,36,799,428,371
050,53,045,"Washington","Mason County",2,37,809,427,382
050,53,045,"Washington","Mason County",2,38,776,414,362
050,53,045,"Washington","Mason County",2,39,813,443,370
050,53,045,"Washington","Mason County",2,40,792,428,364
050,53,045,"Washington","Mason County",2,41,742,398,344
050,53,045,"Washington","Mason County",2,42,726,396,330
050,53,045,"Washington","Mason County",2,43,707,387,320
050,53,045,"Washington","Mason County",2,44,687,394,293
050,53,045,"Washington","Mason County",2,45,692,390,302
050,53,045,"Washington","Mason County",2,46,668,366,302
050,53,045,"Washington","Mason County",2,47,676,355,321
050,53,045,"Washington","Mason County",2,48,698,369,329
050,53,045,"Washington","Mason County",2,49,774,401,373
050,53,045,"Washington","Mason County",2,50,769,382,387
050,53,045,"Washington","Mason County",2,51,780,400,380
050,53,045,"Washington","Mason County",2,52,730,378,352
050,53,045,"Washington","Mason County",2,53,715,364,351
050,53,045,"Washington","Mason County",2,54,778,406,372
050,53,045,"Washington","Mason County",2,55,851,424,427
050,53,045,"Washington","Mason County",2,56,915,456,459
050,53,045,"Washington","Mason County",2,57,944,468,476
050,53,045,"Washington","Mason County",2,58,1001,488,513
050,53,045,"Washington","Mason County",2,59,1069,514,555
050,53,045,"Washington","Mason County",2,60,1065,531,534
050,53,045,"Washington","Mason County",2,61,1052,543,509
050,53,045,"Washington","Mason County",2,62,1111,559,552
050,53,045,"Washington","Mason County",2,63,1148,567,581
050,53,045,"Washington","Mason County",2,64,1154,581,573
050,53,045,"Washington","Mason County",2,65,1145,582,563
050,53,045,"Washington","Mason County",2,66,1144,568,576
050,53,045,"Washington","Mason County",2,67,1074,537,537
050,53,045,"Washington","Mason County",2,68,1028,513,515
050,53,045,"Washington","Mason County",2,69,993,490,503
050,53,045,"Washington","Mason County",2,70,944,466,478
050,53,045,"Washington","Mason County",2,71,932,452,480
050,53,045,"Washington","Mason County",2,72,897,429,468
050,53,045,"Washington","Mason County",2,73,957,490,467
050,53,045,"Washington","Mason County",2,74,636,324,312
050,53,045,"Washington","Mason County",2,75,609,300,309
050,53,045,"Washington","Mason County",2,76,606,307,299
050,53,045,"Washington","Mason County",2,77,609,290,319
050,53,045,"Washington","Mason County",2,78,481,241,240
050,53,045,"Washington","Mason County",2,79,410,200,210
050,53,045,"Washington","Mason County",2,80,389,197,192
050,53,045,"Washington","Mason County",2,81,363,188,175
050,53,045,"Washington","Mason County",2,82,341,167,174
050,53,045,"Washington","Mason County",2,83,300,144,156
050,53,045,"Washington","Mason County",2,84,261,123,138
050,53,045,"Washington","Mason County",2,85,1195,474,721
050,53,045,"Washington","Mason County",3,0,611,320,291
050,53,045,"Washington","Mason County",3,1,674,354,320
050,53,045,"Washington","Mason County",3,2,672,344,328
050,53,045,"Washington","Mason County",3,3,742,391,351
050,53,045,"Washington","Mason County",3,4,730,381,349
050,53,045,"Washington","Mason County",3,5,746,387,359
050,53,045,"Washington","Mason County",3,6,737,374,363
050,53,045,"Washington","Mason County",3,7,739,385,354
050,53,045,"Washington","Mason County",3,8,757,410,347
050,53,045,"Washington","Mason County",3,9,727,372,355
050,53,045,"Washington","Mason County",3,10,705,371,334
050,53,045,"Washington","Mason County",3,11,761,394,367
050,53,045,"Washington","Mason County",3,12,747,377,370
050,53,045,"Washington","Mason County",3,13,761,396,365
050,53,045,"Washington","Mason County",3,14,790,415,375
050,53,045,"Washington","Mason County",3,15,773,414,359
050,53,045,"Washington","Mason County",3,16,797,415,382
050,53,045,"Washington","Mason County",3,17,762,386,376
050,53,045,"Washington","Mason County",3,18,635,353,282
050,53,045,"Washington","Mason County",3,19,531,309,222
050,53,045,"Washington","Mason County",3,20,584,355,229
050,53,045,"Washington","Mason County",3,21,579,351,228
050,53,045,"Washington","Mason County",3,22,649,359,290
050,53,045,"Washington","Mason County",3,23,711,392,319
050,53,045,"Washington","Mason County",3,24,760,396,364
050,53,045,"Washington","Mason County",3,25,719,409,310
050,53,045,"Washington","Mason County",3,26,794,463,331
050,53,045,"Washington","Mason County",3,27,793,462,331
050,53,045,"Washington","Mason County",3,28,822,473,349
050,53,045,"Washington","Mason County",3,29,831,468,363
050,53,045,"Washington","Mason County",3,30,873,453,420
050,53,045,"Washington","Mason County",3,31,849,446,403
050,53,045,"Washington","Mason County",3,32,818,444,374
050,53,045,"Washington","Mason County",3,33,800,442,358
050,53,045,"Washington","Mason County",3,34,795,423,372
050,53,045,"Washington","Mason County",3,35,788,432,356
050,53,045,"Washington","Mason County",3,36,782,423,359
050,53,045,"Washington","Mason County",3,37,805,424,381
050,53,045,"Washington","Mason County",3,38,829,439,390
050,53,045,"Washington","Mason County",3,39,828,446,382
050,53,045,"Washington","Mason County",3,40,822,442,380
050,53,045,"Washington","Mason County",3,41,790,419,371
050,53,045,"Washington","Mason County",3,42,756,403,353
050,53,045,"Washington","Mason County",3,43,753,420,333
050,53,045,"Washington","Mason County",3,44,725,390,335
050,53,045,"Washington","Mason County",3,45,678,378,300
050,53,045,"Washington","Mason County",3,46,716,393,323
050,53,045,"Washington","Mason County",3,47,675,366,309
050,53,045,"Washington","Mason County",3,48,687,354,333
050,53,045,"Washington","Mason County",3,49,727,387,340
050,53,045,"Washington","Mason County",3,50,790,402,388
050,53,045,"Washington","Mason County",3,51,775,386,389
050,53,045,"Washington","Mason County",3,52,795,411,384
050,53,045,"Washington","Mason County",3,53,742,381,361
050,53,045,"Washington","Mason County",3,54,758,392,366
050,53,045,"Washington","Mason County",3,55,773,387,386
050,53,045,"Washington","Mason County",3,56,870,438,432
050,53,045,"Washington","Mason County",3,57,947,450,497
050,53,045,"Washington","Mason County",3,58,985,497,488
050,53,045,"Washington","Mason County",3,59,1026,490,536
050,53,045,"Washington","Mason County",3,60,1118,525,593
050,53,045,"Washington","Mason County",3,61,1124,568,556
050,53,045,"Washington","Mason County",3,62,1049,539,510
050,53,045,"Washington","Mason County",3,63,1150,578,572
050,53,045,"Washington","Mason County",3,64,1181,584,597
050,53,045,"Washington","Mason County",3,65,1198,602,596
050,53,045,"Washington","Mason County",3,66,1147,570,577
050,53,045,"Washington","Mason County",3,67,1146,573,573
050,53,045,"Washington","Mason County",3,68,1098,557,541
050,53,045,"Washington","Mason County",3,69,1033,511,522
050,53,045,"Washington","Mason County",3,70,979,482,497
050,53,045,"Washington","Mason County",3,71,927,455,472
050,53,045,"Washington","Mason County",3,72,916,441,475
050,53,045,"Washington","Mason County",3,73,882,425,457
050,53,045,"Washington","Mason County",3,74,925,467,458
050,53,045,"Washington","Mason County",3,75,606,309,297
050,53,045,"Washington","Mason County",3,76,573,282,291
050,53,045,"Washington","Mason County",3,77,580,294,286
050,53,045,"Washington","Mason County",3,78,587,288,299
050,53,045,"Washington","Mason County",3,79,461,227,234
050,53,045,"Washington","Mason County",3,80,404,200,204
050,53,045,"Washington","Mason County",3,81,356,177,179
050,53,045,"Washington","Mason County",3,82,339,176,163
050,53,045,"Washington","Mason County",3,83,319,157,162
050,53,045,"Washington","Mason County",3,84,278,133,145
050,53,045,"Washington","Mason County",3,85,1274,510,764
050,53,045,"Washington","Mason County",4,0,627,310,317
050,53,045,"Washington","Mason County",4,1,660,352,308
050,53,045,"Washington","Mason County",4,2,739,398,341
050,53,045,"Washington","Mason County",4,3,700,353,347
050,53,045,"Washington","Mason County",4,4,749,384,365
050,53,045,"Washington","Mason County",4,5,738,382,356
050,53,045,"Washington","Mason County",4,6,764,389,375
050,53,045,"Washington","Mason County",4,7,740,374,366
050,53,045,"Washington","Mason County",4,8,714,377,337
050,53,045,"Washington","Mason County",4,9,769,418,351
050,53,045,"Washington","Mason County",4,10,745,378,367
050,53,045,"Washington","Mason County",4,11,712,373,339
050,53,045,"Washington","Mason County",4,12,764,400,364
050,53,045,"Washington","Mason County",4,13,775,382,393
050,53,045,"Washington","Mason County",4,14,770,400,370
050,53,045,"Washington","Mason County",4,15,797,415,382
050,53,045,"Washington","Mason County",4,16,761,403,358
050,53,045,"Washington","Mason County",4,17,792,407,385
050,53,045,"Washington","Mason County",4,18,671,360,311
050,53,045,"Washington","Mason County",4,19,541,307,234
050,53,045,"Washington","Mason County",4,20,547,322,225
050,53,045,"Washington","Mason County",4,21,626,386,240
050,53,045,"Washington","Mason County",4,22,625,364,261
050,53,045,"Washington","Mason County",4,23,697,395,302
050,53,045,"Washington","Mason County",4,24,695,355,340
050,53,045,"Washington","Mason County",4,25,783,426,357
050,53,045,"Washington","Mason County",4,26,744,415,329
050,53,045,"Washington","Mason County",4,27,819,472,347
050,53,045,"Washington","Mason County",4,28,831,487,344
050,53,045,"Washington","Mason County",4,29,840,473,367
050,53,045,"Washington","Mason County",4,30,886,485,401
050,53,045,"Washington","Mason County",4,31,880,448,432
050,53,045,"Washington","Mason County",4,32,899,482,417
050,53,045,"Washington","Mason County",4,33,830,459,371
050,53,045,"Washington","Mason County",4,34,839,462,377
050,53,045,"Washington","Mason County",4,35,821,432,389
050,53,045,"Washington","Mason County",4,36,834,454,380
050,53,045,"Washington","Mason County",4,37,783,416,367
050,53,045,"Washington","Mason County",4,38,825,442,383
050,53,045,"Washington","Mason County",4,39,843,453,390
050,53,045,"Washington","Mason County",4,40,839,442,397
050,53,045,"Washington","Mason County",4,41,808,421,387
050,53,045,"Washington","Mason County",4,42,793,431,362
050,53,045,"Washington","Mason County",4,43,770,405,365
050,53,045,"Washington","Mason County",4,44,766,424,342
050,53,045,"Washington","Mason County",4,45,744,389,355
050,53,045,"Washington","Mason County",4,46,695,383,312
050,53,045,"Washington","Mason County",4,47,746,402,344
050,53,045,"Washington","Mason County",4,48,674,354,320
050,53,045,"Washington","Mason County",4,49,702,371,331
050,53,045,"Washington","Mason County",4,50,748,401,347
050,53,045,"Washington","Mason County",4,51,837,427,410
050,53,045,"Washington","Mason County",4,52,802,399,403
050,53,045,"Washington","Mason County",4,53,813,414,399
050,53,045,"Washington","Mason County",4,54,787,415,372
050,53,045,"Washington","Mason County",4,55,742,368,374
050,53,045,"Washington","Mason County",4,56,784,400,384
050,53,045,"Washington","Mason County",4,57,877,433,444
050,53,045,"Washington","Mason County",4,58,962,461,501
050,53,045,"Washington","Mason County",4,59,990,501,489
050,53,045,"Washington","Mason County",4,60,1042,489,553
050,53,045,"Washington","Mason County",4,61,1138,553,585
050,53,045,"Washington","Mason County",4,62,1152,567,585
050,53,045,"Washington","Mason County",4,63,1056,536,520
050,53,045,"Washington","Mason County",4,64,1140,573,567
050,53,045,"Washington","Mason County",4,65,1187,588,599
050,53,045,"Washington","Mason County",4,66,1212,599,613
050,53,045,"Washington","Mason County",4,67,1153,585,568
050,53,045,"Washington","Mason County",4,68,1130,572,558
050,53,045,"Washington","Mason County",4,69,1092,544,548
050,53,045,"Washington","Mason County",4,70,1018,513,505
050,53,045,"Washington","Mason County",4,71,960,480,480
050,53,045,"Washington","Mason County",4,72,915,454,461
050,53,045,"Washington","Mason County",4,73,886,426,460
050,53,045,"Washington","Mason County",4,74,847,412,435
050,53,045,"Washington","Mason County",4,75,892,448,444
050,53,045,"Washington","Mason County",4,76,595,298,297
050,53,045,"Washington","Mason County",4,77,551,268,283
050,53,045,"Washington","Mason County",4,78,552,284,268
050,53,045,"Washington","Mason County",4,79,549,260,289
050,53,045,"Washington","Mason County",4,80,435,213,222
050,53,045,"Washington","Mason County",4,81,377,185,192
050,53,045,"Washington","Mason County",4,82,316,153,163
050,53,045,"Washington","Mason County",4,83,311,165,146
050,53,045,"Washington","Mason County",4,84,291,138,153
050,53,045,"Washington","Mason County",4,85,1320,546,774
050,53,045,"Washington","Mason County",5,0,619,303,316
050,53,045,"Washington","Mason County",5,1,662,348,314
050,53,045,"Washington","Mason County",5,2,677,373,304
050,53,045,"Washington","Mason County",5,3,722,393,329
050,53,045,"Washington","Mason County",5,4,707,347,360
050,53,045,"Washington","Mason County",5,5,752,399,353
050,53,045,"Washington","Mason County",5,6,733,377,356
050,53,045,"Washington","Mason County",5,7,747,391,356
050,53,045,"Washington","Mason County",5,8,735,377,358
050,53,045,"Washington","Mason County",5,9,725,369,356
050,53,045,"Washington","Mason County",5,10,763,412,351
050,53,045,"Washington","Mason County",5,11,769,403,366
050,53,045,"Washington","Mason County",5,12,696,364,332
050,53,045,"Washington","Mason County",5,13,768,393,375
050,53,045,"Washington","Mason County",5,14,779,383,396
050,53,045,"Washington","Mason County",5,15,762,396,366
050,53,045,"Washington","Mason County",5,16,798,404,394
050,53,045,"Washington","Mason County",5,17,761,401,360
050,53,045,"Washington","Mason County",5,18,700,373,327
050,53,045,"Washington","Mason County",5,19,564,318,246
050,53,045,"Washington","Mason County",5,20,580,332,248
050,53,045,"Washington","Mason County",5,21,572,336,236
050,53,045,"Washington","Mason County",5,22,666,393,273
050,53,045,"Washington","Mason County",5,23,671,394,277
050,53,045,"Washington","Mason County",5,24,669,363,306
050,53,045,"Washington","Mason County",5,25,720,376,344
050,53,045,"Washington","Mason County",5,26,779,422,357
050,53,045,"Washington","Mason County",5,27,742,424,318
050,53,045,"Washington","Mason County",5,28,828,473,355
050,53,045,"Washington","Mason County",5,29,816,482,334
050,53,045,"Washington","Mason County",5,30,858,467,391
050,53,045,"Washington","Mason County",5,31,848,454,394
050,53,045,"Washington","Mason County",5,32,913,474,439
050,53,045,"Washington","Mason County",5,33,894,477,417
050,53,045,"Washington","Mason County",5,34,840,458,382
050,53,045,"Washington","Mason County",5,35,828,458,370
050,53,045,"Washington","Mason County",5,36,854,457,397
050,53,045,"Washington","Mason County",5,37,831,450,381
050,53,045,"Washington","Mason County",5,38,790,420,370
050,53,045,"Washington","Mason County",5,39,852,455,397
050,53,045,"Washington","Mason County",5,40,847,451,396
050,53,045,"Washington","Mason County",5,41,806,411,395
050,53,045,"Washington","Mason County",5,42,813,438,375
050,53,045,"Washington","Mason County",5,43,798,423,375
050,53,045,"Washington","Mason County",5,44,782,414,368
050,53,045,"Washington","Mason County",5,45,780,424,356
050,53,045,"Washington","Mason County",5,46,750,384,366
050,53,045,"Washington","Mason County",5,47,680,358,322
050,53,045,"Washington","Mason County",5,48,757,402,355
050,53,045,"Washington","Mason County",5,49,681,362,319
050,53,045,"Washington","Mason County",5,50,719,368,351
050,53,045,"Washington","Mason County",5,51,750,399,351
050,53,045,"Washington","Mason County",5,52,855,431,424
050,53,045,"Washington","Mason County",5,53,822,396,426
050,53,045,"Washington","Mason County",5,54,826,422,404
050,53,045,"Washington","Mason County",5,55,792,399,393
050,53,045,"Washington","Mason County",5,56,765,385,380
050,53,045,"Washington","Mason County",5,57,799,393,406
050,53,045,"Washington","Mason County",5,58,884,441,443
050,53,045,"Washington","Mason County",5,59,946,459,487
050,53,045,"Washington","Mason County",5,60,1014,516,498
050,53,045,"Washington","Mason County",5,61,1060,502,558
050,53,045,"Washington","Mason County",5,62,1133,538,595
050,53,045,"Washington","Mason County",5,63,1175,569,606
050,53,045,"Washington","Mason County",5,64,1065,535,530
050,53,045,"Washington","Mason County",5,65,1139,585,554
050,53,045,"Washington","Mason County",5,66,1176,573,603
050,53,045,"Washington","Mason County",5,67,1234,618,616
050,53,045,"Washington","Mason County",5,68,1141,586,555
050,53,045,"Washington","Mason County",5,69,1127,568,559
050,53,045,"Washington","Mason County",5,70,1068,534,534
050,53,045,"Washington","Mason County",5,71,996,492,504
050,53,045,"Washington","Mason County",5,72,924,457,467
050,53,045,"Washington","Mason County",5,73,890,441,449
050,53,045,"Washington","Mason County",5,74,857,410,447
050,53,045,"Washington","Mason County",5,75,821,395,426
050,53,045,"Washington","Mason County",5,76,871,438,433
050,53,045,"Washington","Mason County",5,77,577,283,294
050,53,045,"Washington","Mason County",5,78,534,269,265
050,53,045,"Washington","Mason County",5,79,529,265,264
050,53,045,"Washington","Mason County",5,80,523,246,277
050,53,045,"Washington","Mason County",5,81,408,203,205
050,53,045,"Washington","Mason County",5,82,337,161,176
050,53,045,"Washington","Mason County",5,83,286,138,148
050,53,045,"Washington","Mason County",5,84,285,146,139
050,53,045,"Washington","Mason County",5,85,1377,582,795
050,53,047,"Washington","Okanogan County",1,0,444,232,212
050,53,047,"Washington","Okanogan County",1,1,460,247,213
050,53,047,"Washington","Okanogan County",1,2,479,261,218
050,53,047,"Washington","Okanogan County",1,3,523,262,261
050,53,047,"Washington","Okanogan County",1,4,489,239,250
050,53,047,"Washington","Okanogan County",1,5,483,233,250
050,53,047,"Washington","Okanogan County",1,6,529,266,263
050,53,047,"Washington","Okanogan County",1,7,532,306,226
050,53,047,"Washington","Okanogan County",1,8,579,301,278
050,53,047,"Washington","Okanogan County",1,9,582,300,282
050,53,047,"Washington","Okanogan County",1,10,558,292,266
050,53,047,"Washington","Okanogan County",1,11,559,304,255
050,53,047,"Washington","Okanogan County",1,12,580,301,279
050,53,047,"Washington","Okanogan County",1,13,605,303,302
050,53,047,"Washington","Okanogan County",1,14,543,271,272
050,53,047,"Washington","Okanogan County",1,15,549,291,258
050,53,047,"Washington","Okanogan County",1,16,495,251,244
050,53,047,"Washington","Okanogan County",1,17,515,290,225
050,53,047,"Washington","Okanogan County",1,18,461,242,219
050,53,047,"Washington","Okanogan County",1,19,391,208,183
050,53,047,"Washington","Okanogan County",1,20,416,228,188
050,53,047,"Washington","Okanogan County",1,21,362,204,158
050,53,047,"Washington","Okanogan County",1,22,376,196,180
050,53,047,"Washington","Okanogan County",1,23,384,217,167
050,53,047,"Washington","Okanogan County",1,24,398,207,191
050,53,047,"Washington","Okanogan County",1,25,402,194,208
050,53,047,"Washington","Okanogan County",1,26,457,209,248
050,53,047,"Washington","Okanogan County",1,27,490,226,264
050,53,047,"Washington","Okanogan County",1,28,469,228,241
050,53,047,"Washington","Okanogan County",1,29,478,244,234
050,53,047,"Washington","Okanogan County",1,30,470,251,219
050,53,047,"Washington","Okanogan County",1,31,435,228,207
050,53,047,"Washington","Okanogan County",1,32,465,239,226
050,53,047,"Washington","Okanogan County",1,33,501,247,254
050,53,047,"Washington","Okanogan County",1,34,490,243,247
050,53,047,"Washington","Okanogan County",1,35,449,220,229
050,53,047,"Washington","Okanogan County",1,36,449,234,215
050,53,047,"Washington","Okanogan County",1,37,471,251,220
050,53,047,"Washington","Okanogan County",1,38,489,248,241
050,53,047,"Washington","Okanogan County",1,39,506,275,231
050,53,047,"Washington","Okanogan County",1,40,514,259,255
050,53,047,"Washington","Okanogan County",1,41,492,255,237
050,53,047,"Washington","Okanogan County",1,42,484,261,223
050,53,047,"Washington","Okanogan County",1,43,471,257,214
050,53,047,"Washington","Okanogan County",1,44,447,224,223
050,53,047,"Washington","Okanogan County",1,45,445,224,221
050,53,047,"Washington","Okanogan County",1,46,431,223,208
050,53,047,"Washington","Okanogan County",1,47,462,246,216
050,53,047,"Washington","Okanogan County",1,48,507,261,246
050,53,047,"Washington","Okanogan County",1,49,524,276,248
050,53,047,"Washington","Okanogan County",1,50,503,262,241
050,53,047,"Washington","Okanogan County",1,51,485,254,231
050,53,047,"Washington","Okanogan County",1,52,434,227,207
050,53,047,"Washington","Okanogan County",1,53,441,228,213
050,53,047,"Washington","Okanogan County",1,54,478,236,242
050,53,047,"Washington","Okanogan County",1,55,465,228,237
050,53,047,"Washington","Okanogan County",1,56,525,251,274
050,53,047,"Washington","Okanogan County",1,57,567,287,280
050,53,047,"Washington","Okanogan County",1,58,590,295,295
050,53,047,"Washington","Okanogan County",1,59,607,293,314
050,53,047,"Washington","Okanogan County",1,60,639,301,338
050,53,047,"Washington","Okanogan County",1,61,616,305,311
050,53,047,"Washington","Okanogan County",1,62,678,330,348
050,53,047,"Washington","Okanogan County",1,63,704,343,361
050,53,047,"Washington","Okanogan County",1,64,691,332,359
050,53,047,"Washington","Okanogan County",1,65,714,361,353
050,53,047,"Washington","Okanogan County",1,66,702,356,346
050,53,047,"Washington","Okanogan County",1,67,673,342,331
050,53,047,"Washington","Okanogan County",1,68,628,321,307
050,53,047,"Washington","Okanogan County",1,69,595,295,300
050,53,047,"Washington","Okanogan County",1,70,588,291,297
050,53,047,"Washington","Okanogan County",1,71,591,298,293
050,53,047,"Washington","Okanogan County",1,72,597,316,281
050,53,047,"Washington","Okanogan County",1,73,567,298,269
050,53,047,"Washington","Okanogan County",1,74,382,202,180
050,53,047,"Washington","Okanogan County",1,75,376,197,179
050,53,047,"Washington","Okanogan County",1,76,365,189,176
050,53,047,"Washington","Okanogan County",1,77,363,195,168
050,53,047,"Washington","Okanogan County",1,78,293,154,139
050,53,047,"Washington","Okanogan County",1,79,245,126,119
050,53,047,"Washington","Okanogan County",1,80,232,134,98
050,53,047,"Washington","Okanogan County",1,81,201,105,96
050,53,047,"Washington","Okanogan County",1,82,198,99,99
050,53,047,"Washington","Okanogan County",1,83,176,86,90
050,53,047,"Washington","Okanogan County",1,84,152,68,84
050,53,047,"Washington","Okanogan County",1,85,939,349,590
050,53,047,"Washington","Okanogan County",2,0,433,231,202
050,53,047,"Washington","Okanogan County",2,1,460,246,214
050,53,047,"Washington","Okanogan County",2,2,474,257,217
050,53,047,"Washington","Okanogan County",2,3,509,258,251
050,53,047,"Washington","Okanogan County",2,4,491,242,249
050,53,047,"Washington","Okanogan County",2,5,485,232,253
050,53,047,"Washington","Okanogan County",2,6,514,257,257
050,53,047,"Washington","Okanogan County",2,7,531,296,235
050,53,047,"Washington","Okanogan County",2,8,561,294,267
050,53,047,"Washington","Okanogan County",2,9,582,300,282
050,53,047,"Washington","Okanogan County",2,10,562,290,272
050,53,047,"Washington","Okanogan County",2,11,558,301,257
050,53,047,"Washington","Okanogan County",2,12,577,302,275
050,53,047,"Washington","Okanogan County",2,13,598,301,297
050,53,047,"Washington","Okanogan County",2,14,556,276,280
050,53,047,"Washington","Okanogan County",2,15,546,285,261
050,53,047,"Washington","Okanogan County",2,16,506,261,245
050,53,047,"Washington","Okanogan County",2,17,513,286,227
050,53,047,"Washington","Okanogan County",2,18,450,239,211
050,53,047,"Washington","Okanogan County",2,19,393,211,182
050,53,047,"Washington","Okanogan County",2,20,420,226,194
050,53,047,"Washington","Okanogan County",2,21,369,207,162
050,53,047,"Washington","Okanogan County",2,22,375,198,177
050,53,047,"Washington","Okanogan County",2,23,392,221,171
050,53,047,"Washington","Okanogan County",2,24,395,207,188
050,53,047,"Washington","Okanogan County",2,25,402,196,206
050,53,047,"Washington","Okanogan County",2,26,450,208,242
050,53,047,"Washington","Okanogan County",2,27,477,219,258
050,53,047,"Washington","Okanogan County",2,28,471,230,241
050,53,047,"Washington","Okanogan County",2,29,481,242,239
050,53,047,"Washington","Okanogan County",2,30,482,256,226
050,53,047,"Washington","Okanogan County",2,31,441,229,212
050,53,047,"Washington","Okanogan County",2,32,467,241,226
050,53,047,"Washington","Okanogan County",2,33,491,242,249
050,53,047,"Washington","Okanogan County",2,34,495,248,247
050,53,047,"Washington","Okanogan County",2,35,459,226,233
050,53,047,"Washington","Okanogan County",2,36,449,231,218
050,53,047,"Washington","Okanogan County",2,37,468,248,220
050,53,047,"Washington","Okanogan County",2,38,489,250,239
050,53,047,"Washington","Okanogan County",2,39,505,272,233
050,53,047,"Washington","Okanogan County",2,40,518,262,256
050,53,047,"Washington","Okanogan County",2,41,498,259,239
050,53,047,"Washington","Okanogan County",2,42,480,256,224
050,53,047,"Washington","Okanogan County",2,43,483,263,220
050,53,047,"Washington","Okanogan County",2,44,445,226,219
050,53,047,"Washington","Okanogan County",2,45,452,229,223
050,53,047,"Washington","Okanogan County",2,46,436,222,214
050,53,047,"Washington","Okanogan County",2,47,455,241,214
050,53,047,"Washington","Okanogan County",2,48,498,256,242
050,53,047,"Washington","Okanogan County",2,49,525,276,249
050,53,047,"Washington","Okanogan County",2,50,511,265,246
050,53,047,"Washington","Okanogan County",2,51,486,256,230
050,53,047,"Washington","Okanogan County",2,52,449,237,212
050,53,047,"Washington","Okanogan County",2,53,434,223,211
050,53,047,"Washington","Okanogan County",2,54,470,232,238
050,53,047,"Washington","Okanogan County",2,55,472,232,240
050,53,047,"Washington","Okanogan County",2,56,517,248,269
050,53,047,"Washington","Okanogan County",2,57,564,283,281
050,53,047,"Washington","Okanogan County",2,58,588,297,291
050,53,047,"Washington","Okanogan County",2,59,607,294,313
050,53,047,"Washington","Okanogan County",2,60,632,303,329
050,53,047,"Washington","Okanogan County",2,61,625,307,318
050,53,047,"Washington","Okanogan County",2,62,660,324,336
050,53,047,"Washington","Okanogan County",2,63,706,344,362
050,53,047,"Washington","Okanogan County",2,64,688,330,358
050,53,047,"Washington","Okanogan County",2,65,711,356,355
050,53,047,"Washington","Okanogan County",2,66,707,357,350
050,53,047,"Washington","Okanogan County",2,67,675,343,332
050,53,047,"Washington","Okanogan County",2,68,628,321,307
050,53,047,"Washington","Okanogan County",2,69,609,304,305
050,53,047,"Washington","Okanogan County",2,70,585,290,295
050,53,047,"Washington","Okanogan County",2,71,584,290,294
050,53,047,"Washington","Okanogan County",2,72,585,306,279
050,53,047,"Washington","Okanogan County",2,73,603,318,285
050,53,047,"Washington","Okanogan County",2,74,399,211,188
050,53,047,"Washington","Okanogan County",2,75,382,203,179
050,53,047,"Washington","Okanogan County",2,76,359,186,173
050,53,047,"Washington","Okanogan County",2,77,369,195,174
050,53,047,"Washington","Okanogan County",2,78,301,158,143
050,53,047,"Washington","Okanogan County",2,79,253,130,123
050,53,047,"Washington","Okanogan County",2,80,231,129,102
050,53,047,"Washington","Okanogan County",2,81,202,108,94
050,53,047,"Washington","Okanogan County",2,82,191,95,96
050,53,047,"Washington","Okanogan County",2,83,177,86,91
050,53,047,"Washington","Okanogan County",2,84,159,72,87
050,53,047,"Washington","Okanogan County",2,85,953,357,596
050,53,047,"Washington","Okanogan County",3,0,458,236,222
050,53,047,"Washington","Okanogan County",3,1,435,227,208
050,53,047,"Washington","Okanogan County",3,2,465,248,217
050,53,047,"Washington","Okanogan County",3,3,486,248,238
050,53,047,"Washington","Okanogan County",3,4,534,275,259
050,53,047,"Washington","Okanogan County",3,5,496,242,254
050,53,047,"Washington","Okanogan County",3,6,500,238,262
050,53,047,"Washington","Okanogan County",3,7,537,275,262
050,53,047,"Washington","Okanogan County",3,8,548,294,254
050,53,047,"Washington","Okanogan County",3,9,570,302,268
050,53,047,"Washington","Okanogan County",3,10,572,291,281
050,53,047,"Washington","Okanogan County",3,11,563,301,262
050,53,047,"Washington","Okanogan County",3,12,568,296,272
050,53,047,"Washington","Okanogan County",3,13,588,298,290
050,53,047,"Washington","Okanogan County",3,14,600,301,299
050,53,047,"Washington","Okanogan County",3,15,550,276,274
050,53,047,"Washington","Okanogan County",3,16,551,289,262
050,53,047,"Washington","Okanogan County",3,17,520,283,237
050,53,047,"Washington","Okanogan County",3,18,442,240,202
050,53,047,"Washington","Okanogan County",3,19,380,206,174
050,53,047,"Washington","Okanogan County",3,20,435,230,205
050,53,047,"Washington","Okanogan County",3,21,388,203,185
050,53,047,"Washington","Okanogan County",3,22,393,221,172
050,53,047,"Washington","Okanogan County",3,23,424,234,190
050,53,047,"Washington","Okanogan County",3,24,402,217,185
050,53,047,"Washington","Okanogan County",3,25,394,207,187
050,53,047,"Washington","Okanogan County",3,26,418,197,221
050,53,047,"Washington","Okanogan County",3,27,475,217,258
050,53,047,"Washington","Okanogan County",3,28,464,230,234
050,53,047,"Washington","Okanogan County",3,29,505,256,249
050,53,047,"Washington","Okanogan County",3,30,514,281,233
050,53,047,"Washington","Okanogan County",3,31,480,236,244
050,53,047,"Washington","Okanogan County",3,32,468,254,214
050,53,047,"Washington","Okanogan County",3,33,497,250,247
050,53,047,"Washington","Okanogan County",3,34,516,262,254
050,53,047,"Washington","Okanogan County",3,35,511,251,260
050,53,047,"Washington","Okanogan County",3,36,483,237,246
050,53,047,"Washington","Okanogan County",3,37,458,238,220
050,53,047,"Washington","Okanogan County",3,38,491,260,231
050,53,047,"Washington","Okanogan County",3,39,513,282,231
050,53,047,"Washington","Okanogan County",3,40,535,270,265
050,53,047,"Washington","Okanogan County",3,41,531,282,249
050,53,047,"Washington","Okanogan County",3,42,484,254,230
050,53,047,"Washington","Okanogan County",3,43,505,266,239
050,53,047,"Washington","Okanogan County",3,44,485,256,229
050,53,047,"Washington","Okanogan County",3,45,451,235,216
050,53,047,"Washington","Okanogan County",3,46,457,227,230
050,53,047,"Washington","Okanogan County",3,47,446,230,216
050,53,047,"Washington","Okanogan County",3,48,446,233,213
050,53,047,"Washington","Okanogan County",3,49,494,259,235
050,53,047,"Washington","Okanogan County",3,50,530,276,254
050,53,047,"Washington","Okanogan County",3,51,510,266,244
050,53,047,"Washington","Okanogan County",3,52,513,273,240
050,53,047,"Washington","Okanogan County",3,53,440,220,220
050,53,047,"Washington","Okanogan County",3,54,447,226,221
050,53,047,"Washington","Okanogan County",3,55,465,231,234
050,53,047,"Washington","Okanogan County",3,56,482,238,244
050,53,047,"Washington","Okanogan County",3,57,514,255,259
050,53,047,"Washington","Okanogan County",3,58,584,300,284
050,53,047,"Washington","Okanogan County",3,59,583,278,305
050,53,047,"Washington","Okanogan County",3,60,607,296,311
050,53,047,"Washington","Okanogan County",3,61,639,307,332
050,53,047,"Washington","Okanogan County",3,62,638,313,325
050,53,047,"Washington","Okanogan County",3,63,683,338,345
050,53,047,"Washington","Okanogan County",3,64,710,338,372
050,53,047,"Washington","Okanogan County",3,65,688,326,362
050,53,047,"Washington","Okanogan County",3,66,729,371,358
050,53,047,"Washington","Okanogan County",3,67,717,367,350
050,53,047,"Washington","Okanogan County",3,68,659,336,323
050,53,047,"Washington","Okanogan County",3,69,631,323,308
050,53,047,"Washington","Okanogan County",3,70,596,303,293
050,53,047,"Washington","Okanogan County",3,71,577,285,292
050,53,047,"Washington","Okanogan County",3,72,579,290,289
050,53,047,"Washington","Okanogan County",3,73,571,296,275
050,53,047,"Washington","Okanogan County",3,74,577,303,274
050,53,047,"Washington","Okanogan County",3,75,393,212,181
050,53,047,"Washington","Okanogan County",3,76,353,184,169
050,53,047,"Washington","Okanogan County",3,77,333,174,159
050,53,047,"Washington","Okanogan County",3,78,361,183,178
050,53,047,"Washington","Okanogan County",3,79,293,152,141
050,53,047,"Washington","Okanogan County",3,80,240,125,115
050,53,047,"Washington","Okanogan County",3,81,199,113,86
050,53,047,"Washington","Okanogan County",3,82,184,99,85
050,53,047,"Washington","Okanogan County",3,83,184,89,95
050,53,047,"Washington","Okanogan County",3,84,158,70,88
050,53,047,"Washington","Okanogan County",3,85,979,365,614
050,53,047,"Washington","Okanogan County",4,0,463,233,230
050,53,047,"Washington","Okanogan County",4,1,481,245,236
050,53,047,"Washington","Okanogan County",4,2,443,230,213
050,53,047,"Washington","Okanogan County",4,3,490,255,235
050,53,047,"Washington","Okanogan County",4,4,503,283,220
050,53,047,"Washington","Okanogan County",4,5,542,286,256
050,53,047,"Washington","Okanogan County",4,6,491,236,255
050,53,047,"Washington","Okanogan County",4,7,502,250,252
050,53,047,"Washington","Okanogan County",4,8,532,267,265
050,53,047,"Washington","Okanogan County",4,9,569,309,260
050,53,047,"Washington","Okanogan County",4,10,560,300,260
050,53,047,"Washington","Okanogan County",4,11,581,296,285
050,53,047,"Washington","Okanogan County",4,12,549,288,261
050,53,047,"Washington","Okanogan County",4,13,578,302,276
050,53,047,"Washington","Okanogan County",4,14,585,297,288
050,53,047,"Washington","Okanogan County",4,15,610,315,295
050,53,047,"Washington","Okanogan County",4,16,565,278,287
050,53,047,"Washington","Okanogan County",4,17,570,309,261
050,53,047,"Washington","Okanogan County",4,18,451,238,213
050,53,047,"Washington","Okanogan County",4,19,369,212,157
050,53,047,"Washington","Okanogan County",4,20,412,222,190
050,53,047,"Washington","Okanogan County",4,21,429,236,193
050,53,047,"Washington","Okanogan County",4,22,441,254,187
050,53,047,"Washington","Okanogan County",4,23,445,263,182
050,53,047,"Washington","Okanogan County",4,24,446,248,198
050,53,047,"Washington","Okanogan County",4,25,424,236,188
050,53,047,"Washington","Okanogan County",4,26,446,250,196
050,53,047,"Washington","Okanogan County",4,27,442,220,222
050,53,047,"Washington","Okanogan County",4,28,466,218,248
050,53,047,"Washington","Okanogan County",4,29,509,257,252
050,53,047,"Washington","Okanogan County",4,30,585,299,286
050,53,047,"Washington","Okanogan County",4,31,521,286,235
050,53,047,"Washington","Okanogan County",4,32,512,259,253
050,53,047,"Washington","Okanogan County",4,33,479,250,229
050,53,047,"Washington","Okanogan County",4,34,493,257,236
050,53,047,"Washington","Okanogan County",4,35,520,257,263
050,53,047,"Washington","Okanogan County",4,36,547,271,276
050,53,047,"Washington","Okanogan County",4,37,498,254,244
050,53,047,"Washington","Okanogan County",4,38,488,256,232
050,53,047,"Washington","Okanogan County",4,39,525,295,230
050,53,047,"Washington","Okanogan County",4,40,521,272,249
050,53,047,"Washington","Okanogan County",4,41,541,282,259
050,53,047,"Washington","Okanogan County",4,42,535,287,248
050,53,047,"Washington","Okanogan County",4,43,496,265,231
050,53,047,"Washington","Okanogan County",4,44,502,261,241
050,53,047,"Washington","Okanogan County",4,45,508,280,228
050,53,047,"Washington","Okanogan County",4,46,448,229,219
050,53,047,"Washington","Okanogan County",4,47,452,228,224
050,53,047,"Washington","Okanogan County",4,48,465,239,226
050,53,047,"Washington","Okanogan County",4,49,480,270,210
050,53,047,"Washington","Okanogan County",4,50,496,244,252
050,53,047,"Washington","Okanogan County",4,51,522,280,242
050,53,047,"Washington","Okanogan County",4,52,541,285,256
050,53,047,"Washington","Okanogan County",4,53,505,260,245
050,53,047,"Washington","Okanogan County",4,54,469,232,237
050,53,047,"Washington","Okanogan County",4,55,447,233,214
050,53,047,"Washington","Okanogan County",4,56,475,237,238
050,53,047,"Washington","Okanogan County",4,57,499,251,248
050,53,047,"Washington","Okanogan County",4,58,531,267,264
050,53,047,"Washington","Okanogan County",4,59,585,288,297
050,53,047,"Washington","Okanogan County",4,60,584,278,306
050,53,047,"Washington","Okanogan County",4,61,618,302,316
050,53,047,"Washington","Okanogan County",4,62,648,307,341
050,53,047,"Washington","Okanogan County",4,63,656,334,322
050,53,047,"Washington","Okanogan County",4,64,679,331,348
050,53,047,"Washington","Okanogan County",4,65,720,343,377
050,53,047,"Washington","Okanogan County",4,66,683,328,355
050,53,047,"Washington","Okanogan County",4,67,724,369,355
050,53,047,"Washington","Okanogan County",4,68,687,353,334
050,53,047,"Washington","Okanogan County",4,69,655,333,322
050,53,047,"Washington","Okanogan County",4,70,621,315,306
050,53,047,"Washington","Okanogan County",4,71,579,293,286
050,53,047,"Washington","Okanogan County",4,72,559,277,282
050,53,047,"Washington","Okanogan County",4,73,550,275,275
050,53,047,"Washington","Okanogan County",4,74,557,288,269
050,53,047,"Washington","Okanogan County",4,75,562,296,266
050,53,047,"Washington","Okanogan County",4,76,354,190,164
050,53,047,"Washington","Okanogan County",4,77,323,171,152
050,53,047,"Washington","Okanogan County",4,78,315,158,157
050,53,047,"Washington","Okanogan County",4,79,333,164,169
050,53,047,"Washington","Okanogan County",4,80,271,141,130
050,53,047,"Washington","Okanogan County",4,81,215,114,101
050,53,047,"Washington","Okanogan County",4,82,170,100,70
050,53,047,"Washington","Okanogan County",4,83,169,87,82
050,53,047,"Washington","Okanogan County",4,84,163,74,89
050,53,047,"Washington","Okanogan County",4,85,985,370,615
050,53,047,"Washington","Okanogan County",5,0,422,207,215
050,53,047,"Washington","Okanogan County",5,1,466,247,219
050,53,047,"Washington","Okanogan County",5,2,476,246,230
050,53,047,"Washington","Okanogan County",5,3,472,243,229
050,53,047,"Washington","Okanogan County",5,4,489,263,226
050,53,047,"Washington","Okanogan County",5,5,495,271,224
050,53,047,"Washington","Okanogan County",5,6,540,296,244
050,53,047,"Washington","Okanogan County",5,7,505,247,258
050,53,047,"Washington","Okanogan County",5,8,484,229,255
050,53,047,"Washington","Okanogan County",5,9,537,283,254
050,53,047,"Washington","Okanogan County",5,10,567,309,258
050,53,047,"Washington","Okanogan County",5,11,564,300,264
050,53,047,"Washington","Okanogan County",5,12,585,301,284
050,53,047,"Washington","Okanogan County",5,13,568,285,283
050,53,047,"Washington","Okanogan County",5,14,562,289,273
050,53,047,"Washington","Okanogan County",5,15,580,299,281
050,53,047,"Washington","Okanogan County",5,16,616,320,296
050,53,047,"Washington","Okanogan County",5,17,579,298,281
050,53,047,"Washington","Okanogan County",5,18,483,259,224
050,53,047,"Washington","Okanogan County",5,19,381,213,168
050,53,047,"Washington","Okanogan County",5,20,424,232,192
050,53,047,"Washington","Okanogan County",5,21,368,204,164
050,53,047,"Washington","Okanogan County",5,22,445,245,200
050,53,047,"Washington","Okanogan County",5,23,448,257,191
050,53,047,"Washington","Okanogan County",5,24,459,266,193
050,53,047,"Washington","Okanogan County",5,25,448,249,199
050,53,047,"Washington","Okanogan County",5,26,416,237,179
050,53,047,"Washington","Okanogan County",5,27,446,241,205
050,53,047,"Washington","Okanogan County",5,28,423,218,205
050,53,047,"Washington","Okanogan County",5,29,487,225,262
050,53,047,"Washington","Okanogan County",5,30,550,293,257
050,53,047,"Washington","Okanogan County",5,31,599,287,312
050,53,047,"Washington","Okanogan County",5,32,547,298,249
050,53,047,"Washington","Okanogan County",5,33,532,259,273
050,53,047,"Washington","Okanogan County",5,34,506,279,227
050,53,047,"Washington","Okanogan County",5,35,494,244,250
050,53,047,"Washington","Okanogan County",5,36,551,290,261
050,53,047,"Washington","Okanogan County",5,37,567,283,284
050,53,047,"Washington","Okanogan County",5,38,517,264,253
050,53,047,"Washington","Okanogan County",5,39,515,289,226
050,53,047,"Washington","Okanogan County",5,40,531,282,249
050,53,047,"Washington","Okanogan County",5,41,526,287,239
050,53,047,"Washington","Okanogan County",5,42,534,281,253
050,53,047,"Washington","Okanogan County",5,43,532,291,241
050,53,047,"Washington","Okanogan County",5,44,486,253,233
050,53,047,"Washington","Okanogan County",5,45,502,274,228
050,53,047,"Washington","Okanogan County",5,46,523,288,235
050,53,047,"Washington","Okanogan County",5,47,452,232,220
050,53,047,"Washington","Okanogan County",5,48,455,233,222
050,53,047,"Washington","Okanogan County",5,49,487,266,221
050,53,047,"Washington","Okanogan County",5,50,490,264,226
050,53,047,"Washington","Okanogan County",5,51,492,248,244
050,53,047,"Washington","Okanogan County",5,52,535,294,241
050,53,047,"Washington","Okanogan County",5,53,524,268,256
050,53,047,"Washington","Okanogan County",5,54,528,267,261
050,53,047,"Washington","Okanogan County",5,55,471,241,230
050,53,047,"Washington","Okanogan County",5,56,461,235,226
050,53,047,"Washington","Okanogan County",5,57,490,253,237
050,53,047,"Washington","Okanogan County",5,58,495,252,243
050,53,047,"Washington","Okanogan County",5,59,528,253,275
050,53,047,"Washington","Okanogan County",5,60,585,293,292
050,53,047,"Washington","Okanogan County",5,61,590,281,309
050,53,047,"Washington","Okanogan County",5,62,624,304,320
050,53,047,"Washington","Okanogan County",5,63,690,334,356
050,53,047,"Washington","Okanogan County",5,64,648,320,328
050,53,047,"Washington","Okanogan County",5,65,686,335,351
050,53,047,"Washington","Okanogan County",5,66,737,349,388
050,53,047,"Washington","Okanogan County",5,67,683,326,357
050,53,047,"Washington","Okanogan County",5,68,697,359,338
050,53,047,"Washington","Okanogan County",5,69,694,354,340
050,53,047,"Washington","Okanogan County",5,70,632,318,314
050,53,047,"Washington","Okanogan County",5,71,613,311,302
050,53,047,"Washington","Okanogan County",5,72,558,285,273
050,53,047,"Washington","Okanogan County",5,73,554,282,272
050,53,047,"Washington","Okanogan County",5,74,533,262,271
050,53,047,"Washington","Okanogan County",5,75,542,285,257
050,53,047,"Washington","Okanogan County",5,76,507,266,241
050,53,047,"Washington","Okanogan County",5,77,326,178,148
050,53,047,"Washington","Okanogan County",5,78,306,154,152
050,53,047,"Washington","Okanogan County",5,79,302,148,154
050,53,047,"Washington","Okanogan County",5,80,317,154,163
050,53,047,"Washington","Okanogan County",5,81,240,126,114
050,53,047,"Washington","Okanogan County",5,82,190,105,85
050,53,047,"Washington","Okanogan County",5,83,160,91,69
050,53,047,"Washington","Okanogan County",5,84,146,70,76
050,53,047,"Washington","Okanogan County",5,85,997,377,620
050,53,049,"Washington","Pacific County",1,0,168,86,82
050,53,049,"Washington","Pacific County",1,1,152,71,81
050,53,049,"Washington","Pacific County",1,2,162,82,80
050,53,049,"Washington","Pacific County",1,3,205,104,101
050,53,049,"Washington","Pacific County",1,4,187,103,84
050,53,049,"Washington","Pacific County",1,5,196,112,84
050,53,049,"Washington","Pacific County",1,6,176,81,95
050,53,049,"Washington","Pacific County",1,7,182,86,96
050,53,049,"Washington","Pacific County",1,8,213,110,103
050,53,049,"Washington","Pacific County",1,9,207,117,90
050,53,049,"Washington","Pacific County",1,10,202,108,94
050,53,049,"Washington","Pacific County",1,11,199,99,100
050,53,049,"Washington","Pacific County",1,12,229,106,123
050,53,049,"Washington","Pacific County",1,13,205,114,91
050,53,049,"Washington","Pacific County",1,14,227,105,122
050,53,049,"Washington","Pacific County",1,15,228,109,119
050,53,049,"Washington","Pacific County",1,16,224,121,103
050,53,049,"Washington","Pacific County",1,17,228,137,91
050,53,049,"Washington","Pacific County",1,18,198,107,91
050,53,049,"Washington","Pacific County",1,19,152,82,70
050,53,049,"Washington","Pacific County",1,20,160,84,76
050,53,049,"Washington","Pacific County",1,21,147,80,67
050,53,049,"Washington","Pacific County",1,22,174,95,79
050,53,049,"Washington","Pacific County",1,23,191,101,90
050,53,049,"Washington","Pacific County",1,24,184,97,87
050,53,049,"Washington","Pacific County",1,25,180,92,88
050,53,049,"Washington","Pacific County",1,26,206,110,96
050,53,049,"Washington","Pacific County",1,27,216,125,91
050,53,049,"Washington","Pacific County",1,28,219,110,109
050,53,049,"Washington","Pacific County",1,29,222,109,113
050,53,049,"Washington","Pacific County",1,30,228,108,120
050,53,049,"Washington","Pacific County",1,31,198,95,103
050,53,049,"Washington","Pacific County",1,32,211,102,109
050,53,049,"Washington","Pacific County",1,33,214,102,112
050,53,049,"Washington","Pacific County",1,34,230,117,113
050,53,049,"Washington","Pacific County",1,35,236,115,121
050,53,049,"Washington","Pacific County",1,36,230,111,119
050,53,049,"Washington","Pacific County",1,37,268,129,139
050,53,049,"Washington","Pacific County",1,38,255,146,109
050,53,049,"Washington","Pacific County",1,39,237,134,103
050,53,049,"Washington","Pacific County",1,40,229,132,97
050,53,049,"Washington","Pacific County",1,41,232,133,99
050,53,049,"Washington","Pacific County",1,42,213,107,106
050,53,049,"Washington","Pacific County",1,43,206,93,113
050,53,049,"Washington","Pacific County",1,44,217,107,110
050,53,049,"Washington","Pacific County",1,45,208,105,103
050,53,049,"Washington","Pacific County",1,46,214,108,106
050,53,049,"Washington","Pacific County",1,47,215,108,107
050,53,049,"Washington","Pacific County",1,48,238,115,123
050,53,049,"Washington","Pacific County",1,49,280,126,154
050,53,049,"Washington","Pacific County",1,50,266,131,135
050,53,049,"Washington","Pacific County",1,51,243,133,110
050,53,049,"Washington","Pacific County",1,52,288,138,150
050,53,049,"Washington","Pacific County",1,53,287,145,142
050,53,049,"Washington","Pacific County",1,54,281,149,132
050,53,049,"Washington","Pacific County",1,55,296,142,154
050,53,049,"Washington","Pacific County",1,56,316,148,168
050,53,049,"Washington","Pacific County",1,57,365,177,188
050,53,049,"Washington","Pacific County",1,58,371,182,189
050,53,049,"Washington","Pacific County",1,59,380,181,199
050,53,049,"Washington","Pacific County",1,60,401,198,203
050,53,049,"Washington","Pacific County",1,61,415,193,222
050,53,049,"Washington","Pacific County",1,62,474,234,240
050,53,049,"Washington","Pacific County",1,63,499,237,262
050,53,049,"Washington","Pacific County",1,64,520,264,256
050,53,049,"Washington","Pacific County",1,65,559,260,299
050,53,049,"Washington","Pacific County",1,66,562,280,282
050,53,049,"Washington","Pacific County",1,67,545,271,274
050,53,049,"Washington","Pacific County",1,68,550,258,292
050,53,049,"Washington","Pacific County",1,69,469,213,256
050,53,049,"Washington","Pacific County",1,70,441,220,221
050,53,049,"Washington","Pacific County",1,71,455,215,240
050,53,049,"Washington","Pacific County",1,72,465,231,234
050,53,049,"Washington","Pacific County",1,73,462,229,233
050,53,049,"Washington","Pacific County",1,74,311,146,165
050,53,049,"Washington","Pacific County",1,75,302,143,159
050,53,049,"Washington","Pacific County",1,76,285,139,146
050,53,049,"Washington","Pacific County",1,77,284,138,146
050,53,049,"Washington","Pacific County",1,78,257,122,135
050,53,049,"Washington","Pacific County",1,79,221,101,120
050,53,049,"Washington","Pacific County",1,80,163,77,86
050,53,049,"Washington","Pacific County",1,81,170,77,93
050,53,049,"Washington","Pacific County",1,82,188,107,81
050,53,049,"Washington","Pacific County",1,83,153,85,68
050,53,049,"Washington","Pacific County",1,84,119,71,48
050,53,049,"Washington","Pacific County",1,85,607,270,337
050,53,049,"Washington","Pacific County",2,0,175,90,85
050,53,049,"Washington","Pacific County",2,1,155,75,80
050,53,049,"Washington","Pacific County",2,2,163,83,80
050,53,049,"Washington","Pacific County",2,3,191,99,92
050,53,049,"Washington","Pacific County",2,4,193,103,90
050,53,049,"Washington","Pacific County",2,5,190,108,82
050,53,049,"Washington","Pacific County",2,6,177,86,91
050,53,049,"Washington","Pacific County",2,7,183,85,98
050,53,049,"Washington","Pacific County",2,8,210,106,104
050,53,049,"Washington","Pacific County",2,9,209,115,94
050,53,049,"Washington","Pacific County",2,10,206,111,95
050,53,049,"Washington","Pacific County",2,11,201,102,99
050,53,049,"Washington","Pacific County",2,12,224,105,119
050,53,049,"Washington","Pacific County",2,13,211,111,100
050,53,049,"Washington","Pacific County",2,14,222,106,116
050,53,049,"Washington","Pacific County",2,15,234,112,122
050,53,049,"Washington","Pacific County",2,16,226,121,105
050,53,049,"Washington","Pacific County",2,17,233,137,96
050,53,049,"Washington","Pacific County",2,18,193,105,88
050,53,049,"Washington","Pacific County",2,19,154,83,71
050,53,049,"Washington","Pacific County",2,20,162,85,77
050,53,049,"Washington","Pacific County",2,21,152,81,71
050,53,049,"Washington","Pacific County",2,22,173,96,77
050,53,049,"Washington","Pacific County",2,23,187,99,88
050,53,049,"Washington","Pacific County",2,24,181,94,87
050,53,049,"Washington","Pacific County",2,25,179,92,87
050,53,049,"Washington","Pacific County",2,26,202,108,94
050,53,049,"Washington","Pacific County",2,27,213,121,92
050,53,049,"Washington","Pacific County",2,28,219,113,106
050,53,049,"Washington","Pacific County",2,29,220,109,111
050,53,049,"Washington","Pacific County",2,30,225,109,116
050,53,049,"Washington","Pacific County",2,31,206,99,107
050,53,049,"Washington","Pacific County",2,32,210,100,110
050,53,049,"Washington","Pacific County",2,33,215,103,112
050,53,049,"Washington","Pacific County",2,34,229,116,113
050,53,049,"Washington","Pacific County",2,35,240,117,123
050,53,049,"Washington","Pacific County",2,36,232,112,120
050,53,049,"Washington","Pacific County",2,37,259,127,132
050,53,049,"Washington","Pacific County",2,38,261,143,118
050,53,049,"Washington","Pacific County",2,39,242,136,106
050,53,049,"Washington","Pacific County",2,40,235,135,100
050,53,049,"Washington","Pacific County",2,41,232,132,100
050,53,049,"Washington","Pacific County",2,42,220,114,106
050,53,049,"Washington","Pacific County",2,43,212,98,114
050,53,049,"Washington","Pacific County",2,44,213,103,110
050,53,049,"Washington","Pacific County",2,45,214,108,106
050,53,049,"Washington","Pacific County",2,46,214,107,107
050,53,049,"Washington","Pacific County",2,47,217,107,110
050,53,049,"Washington","Pacific County",2,48,237,115,122
050,53,049,"Washington","Pacific County",2,49,276,126,150
050,53,049,"Washington","Pacific County",2,50,269,129,140
050,53,049,"Washington","Pacific County",2,51,254,135,119
050,53,049,"Washington","Pacific County",2,52,278,136,142
050,53,049,"Washington","Pacific County",2,53,289,145,144
050,53,049,"Washington","Pacific County",2,54,283,149,134
050,53,049,"Washington","Pacific County",2,55,295,143,152
050,53,049,"Washington","Pacific County",2,56,315,148,167
050,53,049,"Washington","Pacific County",2,57,359,171,188
050,53,049,"Washington","Pacific County",2,58,377,184,193
050,53,049,"Washington","Pacific County",2,59,387,185,202
050,53,049,"Washington","Pacific County",2,60,404,197,207
050,53,049,"Washington","Pacific County",2,61,419,199,220
050,53,049,"Washington","Pacific County",2,62,465,227,238
050,53,049,"Washington","Pacific County",2,63,499,241,258
050,53,049,"Washington","Pacific County",2,64,516,257,259
050,53,049,"Washington","Pacific County",2,65,553,264,289
050,53,049,"Washington","Pacific County",2,66,565,276,289
050,53,049,"Washington","Pacific County",2,67,558,277,281
050,53,049,"Washington","Pacific County",2,68,546,259,287
050,53,049,"Washington","Pacific County",2,69,495,227,268
050,53,049,"Washington","Pacific County",2,70,450,220,230
050,53,049,"Washington","Pacific County",2,71,452,218,234
050,53,049,"Washington","Pacific County",2,72,457,226,231
050,53,049,"Washington","Pacific County",2,73,479,236,243
050,53,049,"Washington","Pacific County",2,74,324,154,170
050,53,049,"Washington","Pacific County",2,75,307,144,163
050,53,049,"Washington","Pacific County",2,76,286,137,149
050,53,049,"Washington","Pacific County",2,77,290,143,147
050,53,049,"Washington","Pacific County",2,78,257,121,136
050,53,049,"Washington","Pacific County",2,79,229,106,123
050,53,049,"Washington","Pacific County",2,80,175,81,94
050,53,049,"Washington","Pacific County",2,81,164,75,89
050,53,049,"Washington","Pacific County",2,82,182,100,82
050,53,049,"Washington","Pacific County",2,83,154,86,68
050,53,049,"Washington","Pacific County",2,84,123,71,52
050,53,049,"Washington","Pacific County",2,85,613,278,335
050,53,049,"Washington","Pacific County",3,0,171,85,86
050,53,049,"Washington","Pacific County",3,1,171,89,82
050,53,049,"Washington","Pacific County",3,2,153,76,77
050,53,049,"Washington","Pacific County",3,3,159,87,72
050,53,049,"Washington","Pacific County",3,4,187,86,101
050,53,049,"Washington","Pacific County",3,5,195,108,87
050,53,049,"Washington","Pacific County",3,6,197,111,86
050,53,049,"Washington","Pacific County",3,7,184,90,94
050,53,049,"Washington","Pacific County",3,8,196,90,106
050,53,049,"Washington","Pacific County",3,9,212,104,108
050,53,049,"Washington","Pacific County",3,10,208,113,95
050,53,049,"Washington","Pacific County",3,11,221,117,104
050,53,049,"Washington","Pacific County",3,12,206,105,101
050,53,049,"Washington","Pacific County",3,13,221,102,119
050,53,049,"Washington","Pacific County",3,14,225,120,105
050,53,049,"Washington","Pacific County",3,15,228,114,114
050,53,049,"Washington","Pacific County",3,16,253,128,125
050,53,049,"Washington","Pacific County",3,17,232,128,104
050,53,049,"Washington","Pacific County",3,18,191,103,88
050,53,049,"Washington","Pacific County",3,19,151,84,67
050,53,049,"Washington","Pacific County",3,20,163,92,71
050,53,049,"Washington","Pacific County",3,21,169,89,80
050,53,049,"Washington","Pacific County",3,22,165,91,74
050,53,049,"Washington","Pacific County",3,23,167,93,74
050,53,049,"Washington","Pacific County",3,24,187,97,90
050,53,049,"Washington","Pacific County",3,25,188,99,89
050,53,049,"Washington","Pacific County",3,26,192,100,92
050,53,049,"Washington","Pacific County",3,27,207,111,96
050,53,049,"Washington","Pacific County",3,28,209,114,95
050,53,049,"Washington","Pacific County",3,29,219,110,109
050,53,049,"Washington","Pacific County",3,30,229,109,120
050,53,049,"Washington","Pacific County",3,31,228,107,121
050,53,049,"Washington","Pacific County",3,32,212,99,113
050,53,049,"Washington","Pacific County",3,33,237,116,121
050,53,049,"Washington","Pacific County",3,34,218,102,116
050,53,049,"Washington","Pacific County",3,35,234,113,121
050,53,049,"Washington","Pacific County",3,36,262,125,137
050,53,049,"Washington","Pacific County",3,37,249,117,132
050,53,049,"Washington","Pacific County",3,38,268,132,136
050,53,049,"Washington","Pacific County",3,39,274,159,115
050,53,049,"Washington","Pacific County",3,40,252,136,116
050,53,049,"Washington","Pacific County",3,41,242,134,108
050,53,049,"Washington","Pacific County",3,42,251,141,110
050,53,049,"Washington","Pacific County",3,43,239,128,111
050,53,049,"Washington","Pacific County",3,44,236,113,123
050,53,049,"Washington","Pacific County",3,45,216,107,109
050,53,049,"Washington","Pacific County",3,46,231,114,117
050,53,049,"Washington","Pacific County",3,47,230,115,115
050,53,049,"Washington","Pacific County",3,48,233,116,117
050,53,049,"Washington","Pacific County",3,49,253,123,130
050,53,049,"Washington","Pacific County",3,50,297,135,162
050,53,049,"Washington","Pacific County",3,51,280,131,149
050,53,049,"Washington","Pacific County",3,52,260,136,124
050,53,049,"Washington","Pacific County",3,53,291,146,145
050,53,049,"Washington","Pacific County",3,54,309,159,150
050,53,049,"Washington","Pacific County",3,55,286,149,137
050,53,049,"Washington","Pacific County",3,56,314,153,161
050,53,049,"Washington","Pacific County",3,57,332,157,175
050,53,049,"Washington","Pacific County",3,58,362,179,183
050,53,049,"Washington","Pacific County",3,59,408,195,213
050,53,049,"Washington","Pacific County",3,60,394,193,201
050,53,049,"Washington","Pacific County",3,61,430,204,226
050,53,049,"Washington","Pacific County",3,62,437,207,230
050,53,049,"Washington","Pacific County",3,63,495,247,248
050,53,049,"Washington","Pacific County",3,64,520,245,275
050,53,049,"Washington","Pacific County",3,65,526,267,259
050,53,049,"Washington","Pacific County",3,66,557,260,297
050,53,049,"Washington","Pacific County",3,67,583,285,298
050,53,049,"Washington","Pacific County",3,68,577,287,290
050,53,049,"Washington","Pacific County",3,69,541,254,287
050,53,049,"Washington","Pacific County",3,70,505,238,267
050,53,049,"Washington","Pacific County",3,71,435,210,225
050,53,049,"Washington","Pacific County",3,72,445,212,233
050,53,049,"Washington","Pacific County",3,73,463,233,230
050,53,049,"Washington","Pacific County",3,74,466,231,235
050,53,049,"Washington","Pacific County",3,75,317,153,164
050,53,049,"Washington","Pacific County",3,76,289,135,154
050,53,049,"Washington","Pacific County",3,77,276,131,145
050,53,049,"Washington","Pacific County",3,78,268,131,137
050,53,049,"Washington","Pacific County",3,79,243,118,125
050,53,049,"Washington","Pacific County",3,80,216,97,119
050,53,049,"Washington","Pacific County",3,81,160,73,87
050,53,049,"Washington","Pacific County",3,82,160,73,87
050,53,049,"Washington","Pacific County",3,83,171,95,76
050,53,049,"Washington","Pacific County",3,84,132,75,57
050,53,049,"Washington","Pacific County",3,85,627,297,330
050,53,049,"Washington","Pacific County",4,0,169,90,79
050,53,049,"Washington","Pacific County",4,1,156,77,79
050,53,049,"Washington","Pacific County",4,2,183,103,80
050,53,049,"Washington","Pacific County",4,3,149,72,77
050,53,049,"Washington","Pacific County",4,4,157,87,70
050,53,049,"Washington","Pacific County",4,5,195,92,103
050,53,049,"Washington","Pacific County",4,6,196,109,87
050,53,049,"Washington","Pacific County",4,7,198,114,84
050,53,049,"Washington","Pacific County",4,8,190,94,96
050,53,049,"Washington","Pacific County",4,9,192,93,99
050,53,049,"Washington","Pacific County",4,10,221,115,106
050,53,049,"Washington","Pacific County",4,11,210,110,100
050,53,049,"Washington","Pacific County",4,12,208,109,99
050,53,049,"Washington","Pacific County",4,13,203,102,101
050,53,049,"Washington","Pacific County",4,14,231,109,122
050,53,049,"Washington","Pacific County",4,15,235,131,104
050,53,049,"Washington","Pacific County",4,16,230,118,112
050,53,049,"Washington","Pacific County",4,17,258,132,126
050,53,049,"Washington","Pacific County",4,18,191,98,93
050,53,049,"Washington","Pacific County",4,19,159,87,72
050,53,049,"Washington","Pacific County",4,20,160,91,69
050,53,049,"Washington","Pacific County",4,21,166,90,76
050,53,049,"Washington","Pacific County",4,22,172,92,80
050,53,049,"Washington","Pacific County",4,23,155,88,67
050,53,049,"Washington","Pacific County",4,24,170,95,75
050,53,049,"Washington","Pacific County",4,25,182,97,85
050,53,049,"Washington","Pacific County",4,26,188,95,93
050,53,049,"Washington","Pacific County",4,27,186,101,85
050,53,049,"Washington","Pacific County",4,28,228,119,109
050,53,049,"Washington","Pacific County",4,29,213,119,94
050,53,049,"Washington","Pacific County",4,30,227,110,117
050,53,049,"Washington","Pacific County",4,31,229,103,126
050,53,049,"Washington","Pacific County",4,32,233,103,130
050,53,049,"Washington","Pacific County",4,33,220,101,119
050,53,049,"Washington","Pacific County",4,34,241,113,128
050,53,049,"Washington","Pacific County",4,35,222,110,112
050,53,049,"Washington","Pacific County",4,36,250,123,127
050,53,049,"Washington","Pacific County",4,37,269,127,142
050,53,049,"Washington","Pacific County",4,38,230,106,124
050,53,049,"Washington","Pacific County",4,39,278,134,144
050,53,049,"Washington","Pacific County",4,40,281,158,123
050,53,049,"Washington","Pacific County",4,41,271,139,132
050,53,049,"Washington","Pacific County",4,42,252,145,107
050,53,049,"Washington","Pacific County",4,43,259,145,114
050,53,049,"Washington","Pacific County",4,44,241,120,121
050,53,049,"Washington","Pacific County",4,45,234,121,113
050,53,049,"Washington","Pacific County",4,46,223,108,115
050,53,049,"Washington","Pacific County",4,47,230,118,112
050,53,049,"Washington","Pacific County",4,48,244,126,118
050,53,049,"Washington","Pacific County",4,49,245,119,126
050,53,049,"Washington","Pacific County",4,50,255,120,135
050,53,049,"Washington","Pacific County",4,51,308,140,168
050,53,049,"Washington","Pacific County",4,52,291,137,154
050,53,049,"Washington","Pacific County",4,53,272,139,133
050,53,049,"Washington","Pacific County",4,54,300,145,155
050,53,049,"Washington","Pacific County",4,55,326,161,165
050,53,049,"Washington","Pacific County",4,56,295,157,138
050,53,049,"Washington","Pacific County",4,57,331,162,169
050,53,049,"Washington","Pacific County",4,58,354,167,187
050,53,049,"Washington","Pacific County",4,59,395,192,203
050,53,049,"Washington","Pacific County",4,60,412,211,201
050,53,049,"Washington","Pacific County",4,61,399,187,212
050,53,049,"Washington","Pacific County",4,62,434,206,228
050,53,049,"Washington","Pacific County",4,63,460,214,246
050,53,049,"Washington","Pacific County",4,64,494,250,244
050,53,049,"Washington","Pacific County",4,65,544,250,294
050,53,049,"Washington","Pacific County",4,66,525,266,259
050,53,049,"Washington","Pacific County",4,67,565,263,302
050,53,049,"Washington","Pacific County",4,68,585,284,301
050,53,049,"Washington","Pacific County",4,69,552,279,273
050,53,049,"Washington","Pacific County",4,70,534,255,279
050,53,049,"Washington","Pacific County",4,71,493,231,262
050,53,049,"Washington","Pacific County",4,72,447,213,234
050,53,049,"Washington","Pacific County",4,73,449,220,229
050,53,049,"Washington","Pacific County",4,74,441,219,222
050,53,049,"Washington","Pacific County",4,75,444,220,224
050,53,049,"Washington","Pacific County",4,76,295,138,157
050,53,049,"Washington","Pacific County",4,77,273,130,143
050,53,049,"Washington","Pacific County",4,78,261,124,137
050,53,049,"Washington","Pacific County",4,79,245,127,118
050,53,049,"Washington","Pacific County",4,80,218,105,113
050,53,049,"Washington","Pacific County",4,81,202,90,112
050,53,049,"Washington","Pacific County",4,82,152,71,81
050,53,049,"Washington","Pacific County",4,83,155,70,85
050,53,049,"Washington","Pacific County",4,84,156,88,68
050,53,049,"Washington","Pacific County",4,85,603,305,298
050,53,049,"Washington","Pacific County",5,0,155,78,77
050,53,049,"Washington","Pacific County",5,1,164,90,74
050,53,049,"Washington","Pacific County",5,2,161,75,86
050,53,049,"Washington","Pacific County",5,3,194,112,82
050,53,049,"Washington","Pacific County",5,4,145,66,79
050,53,049,"Washington","Pacific County",5,5,160,90,70
050,53,049,"Washington","Pacific County",5,6,190,90,100
050,53,049,"Washington","Pacific County",5,7,196,107,89
050,53,049,"Washington","Pacific County",5,8,207,114,93
050,53,049,"Washington","Pacific County",5,9,183,89,94
050,53,049,"Washington","Pacific County",5,10,199,93,106
050,53,049,"Washington","Pacific County",5,11,221,115,106
050,53,049,"Washington","Pacific County",5,12,206,103,103
050,53,049,"Washington","Pacific County",5,13,218,112,106
050,53,049,"Washington","Pacific County",5,14,207,105,102
050,53,049,"Washington","Pacific County",5,15,239,115,124
050,53,049,"Washington","Pacific County",5,16,242,134,108
050,53,049,"Washington","Pacific County",5,17,236,127,109
050,53,049,"Washington","Pacific County",5,18,217,109,108
050,53,049,"Washington","Pacific County",5,19,154,88,66
050,53,049,"Washington","Pacific County",5,20,159,90,69
050,53,049,"Washington","Pacific County",5,21,161,90,71
050,53,049,"Washington","Pacific County",5,22,184,102,82
050,53,049,"Washington","Pacific County",5,23,178,98,80
050,53,049,"Washington","Pacific County",5,24,150,83,67
050,53,049,"Washington","Pacific County",5,25,164,85,79
050,53,049,"Washington","Pacific County",5,26,179,93,86
050,53,049,"Washington","Pacific County",5,27,181,96,85
050,53,049,"Washington","Pacific County",5,28,209,110,99
050,53,049,"Washington","Pacific County",5,29,215,109,106
050,53,049,"Washington","Pacific County",5,30,213,110,103
050,53,049,"Washington","Pacific County",5,31,209,105,104
050,53,049,"Washington","Pacific County",5,32,226,102,124
050,53,049,"Washington","Pacific County",5,33,250,110,140
050,53,049,"Washington","Pacific County",5,34,242,112,130
050,53,049,"Washington","Pacific County",5,35,251,109,142
050,53,049,"Washington","Pacific County",5,36,240,119,121
050,53,049,"Washington","Pacific County",5,37,260,129,131
050,53,049,"Washington","Pacific County",5,38,277,134,143
050,53,049,"Washington","Pacific County",5,39,246,117,129
050,53,049,"Washington","Pacific County",5,40,281,130,151
050,53,049,"Washington","Pacific County",5,41,290,156,134
050,53,049,"Washington","Pacific County",5,42,286,145,141
050,53,049,"Washington","Pacific County",5,43,264,156,108
050,53,049,"Washington","Pacific County",5,44,272,147,125
050,53,049,"Washington","Pacific County",5,45,250,130,120
050,53,049,"Washington","Pacific County",5,46,238,121,117
050,53,049,"Washington","Pacific County",5,47,239,114,125
050,53,049,"Washington","Pacific County",5,48,248,130,118
050,53,049,"Washington","Pacific County",5,49,249,130,119
050,53,049,"Washington","Pacific County",5,50,233,110,123
050,53,049,"Washington","Pacific County",5,51,257,127,130
050,53,049,"Washington","Pacific County",5,52,304,134,170
050,53,049,"Washington","Pacific County",5,53,298,140,158
050,53,049,"Washington","Pacific County",5,54,268,143,125
050,53,049,"Washington","Pacific County",5,55,309,147,162
050,53,049,"Washington","Pacific County",5,56,319,161,158
050,53,049,"Washington","Pacific County",5,57,317,172,145
050,53,049,"Washington","Pacific County",5,58,330,160,170
050,53,049,"Washington","Pacific County",5,59,371,173,198
050,53,049,"Washington","Pacific County",5,60,405,192,213
050,53,049,"Washington","Pacific County",5,61,410,210,200
050,53,049,"Washington","Pacific County",5,62,400,196,204
050,53,049,"Washington","Pacific County",5,63,450,219,231
050,53,049,"Washington","Pacific County",5,64,460,215,245
050,53,049,"Washington","Pacific County",5,65,501,245,256
050,53,049,"Washington","Pacific County",5,66,550,248,302
050,53,049,"Washington","Pacific County",5,67,539,268,271
050,53,049,"Washington","Pacific County",5,68,579,273,306
050,53,049,"Washington","Pacific County",5,69,574,273,301
050,53,049,"Washington","Pacific County",5,70,552,286,266
050,53,049,"Washington","Pacific County",5,71,540,255,285
050,53,049,"Washington","Pacific County",5,72,506,239,267
050,53,049,"Washington","Pacific County",5,73,439,211,228
050,53,049,"Washington","Pacific County",5,74,435,209,226
050,53,049,"Washington","Pacific County",5,75,413,208,205
050,53,049,"Washington","Pacific County",5,76,417,201,216
050,53,049,"Washington","Pacific County",5,77,283,133,150
050,53,049,"Washington","Pacific County",5,78,260,125,135
050,53,049,"Washington","Pacific County",5,79,245,120,125
050,53,049,"Washington","Pacific County",5,80,221,114,107
050,53,049,"Washington","Pacific County",5,81,208,96,112
050,53,049,"Washington","Pacific County",5,82,185,81,104
050,53,049,"Washington","Pacific County",5,83,144,68,76
050,53,049,"Washington","Pacific County",5,84,133,61,72
050,53,049,"Washington","Pacific County",5,85,640,340,300
050,53,051,"Washington","Pend Oreille County",1,0,114,58,56
050,53,051,"Washington","Pend Oreille County",1,1,121,67,54
050,53,051,"Washington","Pend Oreille County",1,2,125,55,70
050,53,051,"Washington","Pend Oreille County",1,3,143,73,70
050,53,051,"Washington","Pend Oreille County",1,4,138,72,66
050,53,051,"Washington","Pend Oreille County",1,5,142,74,68
050,53,051,"Washington","Pend Oreille County",1,6,129,68,61
050,53,051,"Washington","Pend Oreille County",1,7,126,59,67
050,53,051,"Washington","Pend Oreille County",1,8,130,68,62
050,53,051,"Washington","Pend Oreille County",1,9,156,87,69
050,53,051,"Washington","Pend Oreille County",1,10,156,83,73
050,53,051,"Washington","Pend Oreille County",1,11,151,78,73
050,53,051,"Washington","Pend Oreille County",1,12,168,91,77
050,53,051,"Washington","Pend Oreille County",1,13,157,77,80
050,53,051,"Washington","Pend Oreille County",1,14,164,85,79
050,53,051,"Washington","Pend Oreille County",1,15,152,83,69
050,53,051,"Washington","Pend Oreille County",1,16,154,87,67
050,53,051,"Washington","Pend Oreille County",1,17,163,82,81
050,53,051,"Washington","Pend Oreille County",1,18,136,80,56
050,53,051,"Washington","Pend Oreille County",1,19,117,65,52
050,53,051,"Washington","Pend Oreille County",1,20,108,55,53
050,53,051,"Washington","Pend Oreille County",1,21,111,54,57
050,53,051,"Washington","Pend Oreille County",1,22,97,52,45
050,53,051,"Washington","Pend Oreille County",1,23,115,66,49
050,53,051,"Washington","Pend Oreille County",1,24,110,56,54
050,53,051,"Washington","Pend Oreille County",1,25,109,54,55
050,53,051,"Washington","Pend Oreille County",1,26,103,53,50
050,53,051,"Washington","Pend Oreille County",1,27,106,56,50
050,53,051,"Washington","Pend Oreille County",1,28,119,74,45
050,53,051,"Washington","Pend Oreille County",1,29,132,76,56
050,53,051,"Washington","Pend Oreille County",1,30,121,63,58
050,53,051,"Washington","Pend Oreille County",1,31,131,62,69
050,53,051,"Washington","Pend Oreille County",1,32,121,64,57
050,53,051,"Washington","Pend Oreille County",1,33,121,62,59
050,53,051,"Washington","Pend Oreille County",1,34,130,61,69
050,53,051,"Washington","Pend Oreille County",1,35,131,64,67
050,53,051,"Washington","Pend Oreille County",1,36,114,54,60
050,53,051,"Washington","Pend Oreille County",1,37,127,60,67
050,53,051,"Washington","Pend Oreille County",1,38,144,71,73
050,53,051,"Washington","Pend Oreille County",1,39,143,78,65
050,53,051,"Washington","Pend Oreille County",1,40,126,60,66
050,53,051,"Washington","Pend Oreille County",1,41,131,63,68
050,53,051,"Washington","Pend Oreille County",1,42,142,76,66
050,53,051,"Washington","Pend Oreille County",1,43,133,64,69
050,53,051,"Washington","Pend Oreille County",1,44,136,69,67
050,53,051,"Washington","Pend Oreille County",1,45,128,68,60
050,53,051,"Washington","Pend Oreille County",1,46,129,64,65
050,53,051,"Washington","Pend Oreille County",1,47,131,66,65
050,53,051,"Washington","Pend Oreille County",1,48,141,76,65
050,53,051,"Washington","Pend Oreille County",1,49,163,88,75
050,53,051,"Washington","Pend Oreille County",1,50,169,94,75
050,53,051,"Washington","Pend Oreille County",1,51,170,100,70
050,53,051,"Washington","Pend Oreille County",1,52,156,91,65
050,53,051,"Washington","Pend Oreille County",1,53,151,85,66
050,53,051,"Washington","Pend Oreille County",1,54,168,85,83
050,53,051,"Washington","Pend Oreille County",1,55,217,110,107
050,53,051,"Washington","Pend Oreille County",1,56,217,117,100
050,53,051,"Washington","Pend Oreille County",1,57,231,118,113
050,53,051,"Washington","Pend Oreille County",1,58,228,108,120
050,53,051,"Washington","Pend Oreille County",1,59,240,105,135
050,53,051,"Washington","Pend Oreille County",1,60,238,125,113
050,53,051,"Washington","Pend Oreille County",1,61,237,129,108
050,53,051,"Washington","Pend Oreille County",1,62,245,113,132
050,53,051,"Washington","Pend Oreille County",1,63,272,135,137
050,53,051,"Washington","Pend Oreille County",1,64,264,124,140
050,53,051,"Washington","Pend Oreille County",1,65,275,139,136
050,53,051,"Washington","Pend Oreille County",1,66,284,148,136
050,53,051,"Washington","Pend Oreille County",1,67,279,150,129
050,53,051,"Washington","Pend Oreille County",1,68,248,128,120
050,53,051,"Washington","Pend Oreille County",1,69,211,118,93
050,53,051,"Washington","Pend Oreille County",1,70,225,116,109
050,53,051,"Washington","Pend Oreille County",1,71,236,118,118
050,53,051,"Washington","Pend Oreille County",1,72,231,130,101
050,53,051,"Washington","Pend Oreille County",1,73,220,126,94
050,53,051,"Washington","Pend Oreille County",1,74,141,79,62
050,53,051,"Washington","Pend Oreille County",1,75,141,70,71
050,53,051,"Washington","Pend Oreille County",1,76,163,83,80
050,53,051,"Washington","Pend Oreille County",1,77,140,67,73
050,53,051,"Washington","Pend Oreille County",1,78,118,63,55
050,53,051,"Washington","Pend Oreille County",1,79,95,45,50
050,53,051,"Washington","Pend Oreille County",1,80,75,37,38
050,53,051,"Washington","Pend Oreille County",1,81,76,39,37
050,53,051,"Washington","Pend Oreille County",1,82,45,26,19
050,53,051,"Washington","Pend Oreille County",1,83,61,27,34
050,53,051,"Washington","Pend Oreille County",1,84,58,29,29
050,53,051,"Washington","Pend Oreille County",1,85,280,107,173
050,53,051,"Washington","Pend Oreille County",2,0,113,61,52
050,53,051,"Washington","Pend Oreille County",2,1,122,68,54
050,53,051,"Washington","Pend Oreille County",2,2,128,59,69
050,53,051,"Washington","Pend Oreille County",2,3,142,72,70
050,53,051,"Washington","Pend Oreille County",2,4,143,74,69
050,53,051,"Washington","Pend Oreille County",2,5,144,74,70
050,53,051,"Washington","Pend Oreille County",2,6,135,70,65
050,53,051,"Washington","Pend Oreille County",2,7,128,62,66
050,53,051,"Washington","Pend Oreille County",2,8,129,66,63
050,53,051,"Washington","Pend Oreille County",2,9,152,85,67
050,53,051,"Washington","Pend Oreille County",2,10,159,86,73
050,53,051,"Washington","Pend Oreille County",2,11,154,80,74
050,53,051,"Washington","Pend Oreille County",2,12,166,89,77
050,53,051,"Washington","Pend Oreille County",2,13,162,82,80
050,53,051,"Washington","Pend Oreille County",2,14,165,84,81
050,53,051,"Washington","Pend Oreille County",2,15,155,84,71
050,53,051,"Washington","Pend Oreille County",2,16,153,85,68
050,53,051,"Washington","Pend Oreille County",2,17,160,83,77
050,53,051,"Washington","Pend Oreille County",2,18,136,77,59
050,53,051,"Washington","Pend Oreille County",2,19,116,65,51
050,53,051,"Washington","Pend Oreille County",2,20,114,59,55
050,53,051,"Washington","Pend Oreille County",2,21,110,54,56
050,53,051,"Washington","Pend Oreille County",2,22,103,54,49
050,53,051,"Washington","Pend Oreille County",2,23,113,63,50
050,53,051,"Washington","Pend Oreille County",2,24,109,59,50
050,53,051,"Washington","Pend Oreille County",2,25,111,55,56
050,53,051,"Washington","Pend Oreille County",2,26,107,54,53
050,53,051,"Washington","Pend Oreille County",2,27,107,58,49
050,53,051,"Washington","Pend Oreille County",2,28,120,73,47
050,53,051,"Washington","Pend Oreille County",2,29,132,78,54
050,53,051,"Washington","Pend Oreille County",2,30,127,67,60
050,53,051,"Washington","Pend Oreille County",2,31,126,62,64
050,53,051,"Washington","Pend Oreille County",2,32,126,65,61
050,53,051,"Washington","Pend Oreille County",2,33,123,63,60
050,53,051,"Washington","Pend Oreille County",2,34,129,62,67
050,53,051,"Washington","Pend Oreille County",2,35,133,65,68
050,53,051,"Washington","Pend Oreille County",2,36,121,58,63
050,53,051,"Washington","Pend Oreille County",2,37,128,61,67
050,53,051,"Washington","Pend Oreille County",2,38,146,71,75
050,53,051,"Washington","Pend Oreille County",2,39,147,78,69
050,53,051,"Washington","Pend Oreille County",2,40,134,66,68
050,53,051,"Washington","Pend Oreille County",2,41,129,62,67
050,53,051,"Washington","Pend Oreille County",2,42,138,73,65
050,53,051,"Washington","Pend Oreille County",2,43,138,68,70
050,53,051,"Washington","Pend Oreille County",2,44,130,66,64
050,53,051,"Washington","Pend Oreille County",2,45,133,69,64
050,53,051,"Washington","Pend Oreille County",2,46,129,66,63
050,53,051,"Washington","Pend Oreille County",2,47,130,65,65
050,53,051,"Washington","Pend Oreille County",2,48,143,75,68
050,53,051,"Washington","Pend Oreille County",2,49,161,88,73
050,53,051,"Washington","Pend Oreille County",2,50,170,93,77
050,53,051,"Washington","Pend Oreille County",2,51,171,98,73
050,53,051,"Washington","Pend Oreille County",2,52,161,95,66
050,53,051,"Washington","Pend Oreille County",2,53,151,84,67
050,53,051,"Washington","Pend Oreille County",2,54,165,86,79
050,53,051,"Washington","Pend Oreille County",2,55,207,106,101
050,53,051,"Washington","Pend Oreille County",2,56,221,118,103
050,53,051,"Washington","Pend Oreille County",2,57,228,118,110
050,53,051,"Washington","Pend Oreille County",2,58,231,112,119
050,53,051,"Washington","Pend Oreille County",2,59,241,106,135
050,53,051,"Washington","Pend Oreille County",2,60,240,121,119
050,53,051,"Washington","Pend Oreille County",2,61,236,127,109
050,53,051,"Washington","Pend Oreille County",2,62,243,117,126
050,53,051,"Washington","Pend Oreille County",2,63,270,130,140
050,53,051,"Washington","Pend Oreille County",2,64,268,127,141
050,53,051,"Washington","Pend Oreille County",2,65,275,136,139
050,53,051,"Washington","Pend Oreille County",2,66,286,148,138
050,53,051,"Washington","Pend Oreille County",2,67,280,149,131
050,53,051,"Washington","Pend Oreille County",2,68,252,131,121
050,53,051,"Washington","Pend Oreille County",2,69,221,121,100
050,53,051,"Washington","Pend Oreille County",2,70,221,116,105
050,53,051,"Washington","Pend Oreille County",2,71,234,118,116
050,53,051,"Washington","Pend Oreille County",2,72,226,123,103
050,53,051,"Washington","Pend Oreille County",2,73,233,133,100
050,53,051,"Washington","Pend Oreille County",2,74,147,82,65
050,53,051,"Washington","Pend Oreille County",2,75,142,72,70
050,53,051,"Washington","Pend Oreille County",2,76,156,79,77
050,53,051,"Washington","Pend Oreille County",2,77,149,73,76
050,53,051,"Washington","Pend Oreille County",2,78,118,63,55
050,53,051,"Washington","Pend Oreille County",2,79,100,48,52
050,53,051,"Washington","Pend Oreille County",2,80,76,38,38
050,53,051,"Washington","Pend Oreille County",2,81,74,37,37
050,53,051,"Washington","Pend Oreille County",2,82,51,28,23
050,53,051,"Washington","Pend Oreille County",2,83,59,28,31
050,53,051,"Washington","Pend Oreille County",2,84,57,27,30
050,53,051,"Washington","Pend Oreille County",2,85,283,108,175
050,53,051,"Washington","Pend Oreille County",3,0,103,57,46
050,53,051,"Washington","Pend Oreille County",3,1,137,63,74
050,53,051,"Washington","Pend Oreille County",3,2,139,78,61
050,53,051,"Washington","Pend Oreille County",3,3,135,60,75
050,53,051,"Washington","Pend Oreille County",3,4,144,77,67
050,53,051,"Washington","Pend Oreille County",3,5,146,81,65
050,53,051,"Washington","Pend Oreille County",3,6,150,70,80
050,53,051,"Washington","Pend Oreille County",3,7,151,81,70
050,53,051,"Washington","Pend Oreille County",3,8,141,74,67
050,53,051,"Washington","Pend Oreille County",3,9,129,69,60
050,53,051,"Washington","Pend Oreille County",3,10,165,96,69
050,53,051,"Washington","Pend Oreille County",3,11,168,91,77
050,53,051,"Washington","Pend Oreille County",3,12,159,81,78
050,53,051,"Washington","Pend Oreille County",3,13,174,95,79
050,53,051,"Washington","Pend Oreille County",3,14,165,86,79
050,53,051,"Washington","Pend Oreille County",3,15,165,82,83
050,53,051,"Washington","Pend Oreille County",3,16,169,93,76
050,53,051,"Washington","Pend Oreille County",3,17,151,82,69
050,53,051,"Washington","Pend Oreille County",3,18,135,72,63
050,53,051,"Washington","Pend Oreille County",3,19,100,64,36
050,53,051,"Washington","Pend Oreille County",3,20,115,62,53
050,53,051,"Washington","Pend Oreille County",3,21,117,59,58
050,53,051,"Washington","Pend Oreille County",3,22,106,47,59
050,53,051,"Washington","Pend Oreille County",3,23,126,65,61
050,53,051,"Washington","Pend Oreille County",3,24,127,72,55
050,53,051,"Washington","Pend Oreille County",3,25,133,69,64
050,53,051,"Washington","Pend Oreille County",3,26,120,61,59
050,53,051,"Washington","Pend Oreille County",3,27,112,56,56
050,53,051,"Washington","Pend Oreille County",3,28,105,62,43
050,53,051,"Washington","Pend Oreille County",3,29,139,80,59
050,53,051,"Washington","Pend Oreille County",3,30,132,70,62
050,53,051,"Washington","Pend Oreille County",3,31,136,66,70
050,53,051,"Washington","Pend Oreille County",3,32,152,66,86
050,53,051,"Washington","Pend Oreille County",3,33,121,62,59
050,53,051,"Washington","Pend Oreille County",3,34,139,71,68
050,53,051,"Washington","Pend Oreille County",3,35,137,68,69
050,53,051,"Washington","Pend Oreille County",3,36,139,72,67
050,53,051,"Washington","Pend Oreille County",3,37,135,67,68
050,53,051,"Washington","Pend Oreille County",3,38,133,65,68
050,53,051,"Washington","Pend Oreille County",3,39,152,74,78
050,53,051,"Washington","Pend Oreille County",3,40,158,82,76
050,53,051,"Washington","Pend Oreille County",3,41,144,66,78
050,53,051,"Washington","Pend Oreille County",3,42,135,62,73
050,53,051,"Washington","Pend Oreille County",3,43,134,71,63
050,53,051,"Washington","Pend Oreille County",3,44,144,77,67
050,53,051,"Washington","Pend Oreille County",3,45,126,63,63
050,53,051,"Washington","Pend Oreille County",3,46,147,69,78
050,53,051,"Washington","Pend Oreille County",3,47,128,65,63
050,53,051,"Washington","Pend Oreille County",3,48,134,70,64
050,53,051,"Washington","Pend Oreille County",3,49,151,78,73
050,53,051,"Washington","Pend Oreille County",3,50,161,89,72
050,53,051,"Washington","Pend Oreille County",3,51,173,98,75
050,53,051,"Washington","Pend Oreille County",3,52,176,103,73
050,53,051,"Washington","Pend Oreille County",3,53,167,99,68
050,53,051,"Washington","Pend Oreille County",3,54,168,88,80
050,53,051,"Washington","Pend Oreille County",3,55,177,89,88
050,53,051,"Washington","Pend Oreille County",3,56,206,106,100
050,53,051,"Washington","Pend Oreille County",3,57,236,126,110
050,53,051,"Washington","Pend Oreille County",3,58,236,119,117
050,53,051,"Washington","Pend Oreille County",3,59,242,120,122
050,53,051,"Washington","Pend Oreille County",3,60,255,112,143
050,53,051,"Washington","Pend Oreille County",3,61,241,121,120
050,53,051,"Washington","Pend Oreille County",3,62,241,128,113
050,53,051,"Washington","Pend Oreille County",3,63,261,125,136
050,53,051,"Washington","Pend Oreille County",3,64,279,132,147
050,53,051,"Washington","Pend Oreille County",3,65,276,125,151
050,53,051,"Washington","Pend Oreille County",3,66,278,142,136
050,53,051,"Washington","Pend Oreille County",3,67,292,147,145
050,53,051,"Washington","Pend Oreille County",3,68,269,140,129
050,53,051,"Washington","Pend Oreille County",3,69,249,128,121
050,53,051,"Washington","Pend Oreille County",3,70,208,111,97
050,53,051,"Washington","Pend Oreille County",3,71,218,114,104
050,53,051,"Washington","Pend Oreille County",3,72,230,117,113
050,53,051,"Washington","Pend Oreille County",3,73,222,117,105
050,53,051,"Washington","Pend Oreille County",3,74,215,121,94
050,53,051,"Washington","Pend Oreille County",3,75,155,83,72
050,53,051,"Washington","Pend Oreille County",3,76,134,70,64
050,53,051,"Washington","Pend Oreille County",3,77,141,73,68
050,53,051,"Washington","Pend Oreille County",3,78,142,73,69
050,53,051,"Washington","Pend Oreille County",3,79,115,60,55
050,53,051,"Washington","Pend Oreille County",3,80,94,49,45
050,53,051,"Washington","Pend Oreille County",3,81,72,34,38
050,53,051,"Washington","Pend Oreille County",3,82,59,26,33
050,53,051,"Washington","Pend Oreille County",3,83,53,29,24
050,53,051,"Washington","Pend Oreille County",3,84,60,27,33
050,53,051,"Washington","Pend Oreille County",3,85,287,108,179
050,53,051,"Washington","Pend Oreille County",4,0,121,63,58
050,53,051,"Washington","Pend Oreille County",4,1,96,46,50
050,53,051,"Washington","Pend Oreille County",4,2,140,63,77
050,53,051,"Washington","Pend Oreille County",4,3,141,84,57
050,53,051,"Washington","Pend Oreille County",4,4,142,62,80
050,53,051,"Washington","Pend Oreille County",4,5,157,85,72
050,53,051,"Washington","Pend Oreille County",4,6,140,77,63
050,53,051,"Washington","Pend Oreille County",4,7,159,74,85
050,53,051,"Washington","Pend Oreille County",4,8,166,84,82
050,53,051,"Washington","Pend Oreille County",4,9,153,81,72
050,53,051,"Washington","Pend Oreille County",4,10,141,71,70
050,53,051,"Washington","Pend Oreille County",4,11,167,94,73
050,53,051,"Washington","Pend Oreille County",4,12,182,97,85
050,53,051,"Washington","Pend Oreille County",4,13,165,84,81
050,53,051,"Washington","Pend Oreille County",4,14,183,99,84
050,53,051,"Washington","Pend Oreille County",4,15,177,92,85
050,53,051,"Washington","Pend Oreille County",4,16,180,89,91
050,53,051,"Washington","Pend Oreille County",4,17,172,102,70
050,53,051,"Washington","Pend Oreille County",4,18,143,79,64
050,53,051,"Washington","Pend Oreille County",4,19,109,62,47
050,53,051,"Washington","Pend Oreille County",4,20,97,62,35
050,53,051,"Washington","Pend Oreille County",4,21,109,57,52
050,53,051,"Washington","Pend Oreille County",4,22,107,51,56
050,53,051,"Washington","Pend Oreille County",4,23,115,53,62
050,53,051,"Washington","Pend Oreille County",4,24,112,62,50
050,53,051,"Washington","Pend Oreille County",4,25,135,74,61
050,53,051,"Washington","Pend Oreille County",4,26,124,68,56
050,53,051,"Washington","Pend Oreille County",4,27,116,58,58
050,53,051,"Washington","Pend Oreille County",4,28,122,59,63
050,53,051,"Washington","Pend Oreille County",4,29,122,72,50
050,53,051,"Washington","Pend Oreille County",4,30,140,77,63
050,53,051,"Washington","Pend Oreille County",4,31,136,64,72
050,53,051,"Washington","Pend Oreille County",4,32,144,69,75
050,53,051,"Washington","Pend Oreille County",4,33,153,68,85
050,53,051,"Washington","Pend Oreille County",4,34,126,68,58
050,53,051,"Washington","Pend Oreille County",4,35,152,75,77
050,53,051,"Washington","Pend Oreille County",4,36,140,68,72
050,53,051,"Washington","Pend Oreille County",4,37,147,76,71
050,53,051,"Washington","Pend Oreille County",4,38,142,73,69
050,53,051,"Washington","Pend Oreille County",4,39,146,70,76
050,53,051,"Washington","Pend Oreille County",4,40,159,79,80
050,53,051,"Washington","Pend Oreille County",4,41,168,87,81
050,53,051,"Washington","Pend Oreille County",4,42,152,63,89
050,53,051,"Washington","Pend Oreille County",4,43,132,60,72
050,53,051,"Washington","Pend Oreille County",4,44,139,74,65
050,53,051,"Washington","Pend Oreille County",4,45,152,75,77
050,53,051,"Washington","Pend Oreille County",4,46,129,63,66
050,53,051,"Washington","Pend Oreille County",4,47,146,74,72
050,53,051,"Washington","Pend Oreille County",4,48,128,63,65
050,53,051,"Washington","Pend Oreille County",4,49,145,76,69
050,53,051,"Washington","Pend Oreille County",4,50,169,87,82
050,53,051,"Washington","Pend Oreille County",4,51,175,96,79
050,53,051,"Washington","Pend Oreille County",4,52,180,104,76
050,53,051,"Washington","Pend Oreille County",4,53,180,103,77
050,53,051,"Washington","Pend Oreille County",4,54,174,100,74
050,53,051,"Washington","Pend Oreille County",4,55,169,94,75
050,53,051,"Washington","Pend Oreille County",4,56,183,95,88
050,53,051,"Washington","Pend Oreille County",4,57,204,105,99
050,53,051,"Washington","Pend Oreille County",4,58,245,132,113
050,53,051,"Washington","Pend Oreille County",4,59,245,123,122
050,53,051,"Washington","Pend Oreille County",4,60,258,129,129
050,53,051,"Washington","Pend Oreille County",4,61,248,116,132
050,53,051,"Washington","Pend Oreille County",4,62,256,127,129
050,53,051,"Washington","Pend Oreille County",4,63,235,117,118
050,53,051,"Washington","Pend Oreille County",4,64,277,130,147
050,53,051,"Washington","Pend Oreille County",4,65,276,130,146
050,53,051,"Washington","Pend Oreille County",4,66,268,127,141
050,53,051,"Washington","Pend Oreille County",4,67,265,133,132
050,53,051,"Washington","Pend Oreille County",4,68,282,141,141
050,53,051,"Washington","Pend Oreille County",4,69,273,143,130
050,53,051,"Washington","Pend Oreille County",4,70,249,126,123
050,53,051,"Washington","Pend Oreille County",4,71,204,108,96
050,53,051,"Washington","Pend Oreille County",4,72,221,118,103
050,53,051,"Washington","Pend Oreille County",4,73,223,111,112
050,53,051,"Washington","Pend Oreille County",4,74,210,111,99
050,53,051,"Washington","Pend Oreille County",4,75,217,120,97
050,53,051,"Washington","Pend Oreille County",4,76,146,82,64
050,53,051,"Washington","Pend Oreille County",4,77,124,63,61
050,53,051,"Washington","Pend Oreille County",4,78,133,68,65
050,53,051,"Washington","Pend Oreille County",4,79,127,62,65
050,53,051,"Washington","Pend Oreille County",4,80,112,60,52
050,53,051,"Washington","Pend Oreille County",4,81,86,44,42
050,53,051,"Washington","Pend Oreille County",4,82,57,30,27
050,53,051,"Washington","Pend Oreille County",4,83,56,25,31
050,53,051,"Washington","Pend Oreille County",4,84,53,26,27
050,53,051,"Washington","Pend Oreille County",4,85,289,113,176
050,53,051,"Washington","Pend Oreille County",5,0,114,61,53
050,53,051,"Washington","Pend Oreille County",5,1,114,52,62
050,53,051,"Washington","Pend Oreille County",5,2,124,63,61
050,53,051,"Washington","Pend Oreille County",5,3,150,69,81
050,53,051,"Washington","Pend Oreille County",5,4,152,91,61
050,53,051,"Washington","Pend Oreille County",5,5,159,74,85
050,53,051,"Washington","Pend Oreille County",5,6,160,84,76
050,53,051,"Washington","Pend Oreille County",5,7,162,93,69
050,53,051,"Washington","Pend Oreille County",5,8,172,79,93
050,53,051,"Washington","Pend Oreille County",5,9,179,90,89
050,53,051,"Washington","Pend Oreille County",5,10,159,83,76
050,53,051,"Washington","Pend Oreille County",5,11,148,78,70
050,53,051,"Washington","Pend Oreille County",5,12,183,108,75
050,53,051,"Washington","Pend Oreille County",5,13,171,91,80
050,53,051,"Washington","Pend Oreille County",5,14,166,83,83
050,53,051,"Washington","Pend Oreille County",5,15,189,103,86
050,53,051,"Washington","Pend Oreille County",5,16,176,91,85
050,53,051,"Washington","Pend Oreille County",5,17,169,80,89
050,53,051,"Washington","Pend Oreille County",5,18,147,89,58
050,53,051,"Washington","Pend Oreille County",5,19,107,61,46
050,53,051,"Washington","Pend Oreille County",5,20,117,63,54
050,53,051,"Washington","Pend Oreille County",5,21,99,64,35
050,53,051,"Washington","Pend Oreille County",5,22,105,55,50
050,53,051,"Washington","Pend Oreille County",5,23,112,52,60
050,53,051,"Washington","Pend Oreille County",5,24,116,52,64
050,53,051,"Washington","Pend Oreille County",5,25,122,63,59
050,53,051,"Washington","Pend Oreille County",5,26,123,68,55
050,53,051,"Washington","Pend Oreille County",5,27,139,76,63
050,53,051,"Washington","Pend Oreille County",5,28,126,61,65
050,53,051,"Washington","Pend Oreille County",5,29,131,60,71
050,53,051,"Washington","Pend Oreille County",5,30,119,65,54
050,53,051,"Washington","Pend Oreille County",5,31,142,75,67
050,53,051,"Washington","Pend Oreille County",5,32,156,77,79
050,53,051,"Washington","Pend Oreille County",5,33,157,74,83
050,53,051,"Washington","Pend Oreille County",5,34,170,75,95
050,53,051,"Washington","Pend Oreille County",5,35,137,78,59
050,53,051,"Washington","Pend Oreille County",5,36,163,84,79
050,53,051,"Washington","Pend Oreille County",5,37,150,75,75
050,53,051,"Washington","Pend Oreille County",5,38,148,73,75
050,53,051,"Washington","Pend Oreille County",5,39,152,78,74
050,53,051,"Washington","Pend Oreille County",5,40,149,69,80
050,53,051,"Washington","Pend Oreille County",5,41,154,71,83
050,53,051,"Washington","Pend Oreille County",5,42,163,85,78
050,53,051,"Washington","Pend Oreille County",5,43,151,67,84
050,53,051,"Washington","Pend Oreille County",5,44,139,64,75
050,53,051,"Washington","Pend Oreille County",5,45,146,80,66
050,53,051,"Washington","Pend Oreille County",5,46,153,75,78
050,53,051,"Washington","Pend Oreille County",5,47,136,65,71
050,53,051,"Washington","Pend Oreille County",5,48,154,79,75
050,53,051,"Washington","Pend Oreille County",5,49,139,66,73
050,53,051,"Washington","Pend Oreille County",5,50,145,76,69
050,53,051,"Washington","Pend Oreille County",5,51,169,85,84
050,53,051,"Washington","Pend Oreille County",5,52,182,101,81
050,53,051,"Washington","Pend Oreille County",5,53,181,103,78
050,53,051,"Washington","Pend Oreille County",5,54,191,107,84
050,53,051,"Washington","Pend Oreille County",5,55,176,97,79
050,53,051,"Washington","Pend Oreille County",5,56,180,97,83
050,53,051,"Washington","Pend Oreille County",5,57,191,93,98
050,53,051,"Washington","Pend Oreille County",5,58,206,109,97
050,53,051,"Washington","Pend Oreille County",5,59,262,137,125
050,53,051,"Washington","Pend Oreille County",5,60,247,129,118
050,53,051,"Washington","Pend Oreille County",5,61,264,127,137
050,53,051,"Washington","Pend Oreille County",5,62,266,121,145
050,53,051,"Washington","Pend Oreille County",5,63,259,124,135
050,53,051,"Washington","Pend Oreille County",5,64,232,115,117
050,53,051,"Washington","Pend Oreille County",5,65,279,132,147
050,53,051,"Washington","Pend Oreille County",5,66,278,131,147
050,53,051,"Washington","Pend Oreille County",5,67,258,122,136
050,53,051,"Washington","Pend Oreille County",5,68,263,131,132
050,53,051,"Washington","Pend Oreille County",5,69,274,139,135
050,53,051,"Washington","Pend Oreille County",5,70,267,138,129
050,53,051,"Washington","Pend Oreille County",5,71,241,124,117
050,53,051,"Washington","Pend Oreille County",5,72,204,107,97
050,53,051,"Washington","Pend Oreille County",5,73,215,115,100
050,53,051,"Washington","Pend Oreille County",5,74,208,104,104
050,53,051,"Washington","Pend Oreille County",5,75,205,105,100
050,53,051,"Washington","Pend Oreille County",5,76,208,117,91
050,53,051,"Washington","Pend Oreille County",5,77,129,73,56
050,53,051,"Washington","Pend Oreille County",5,78,115,58,57
050,53,051,"Washington","Pend Oreille County",5,79,123,61,62
050,53,051,"Washington","Pend Oreille County",5,80,118,59,59
050,53,051,"Washington","Pend Oreille County",5,81,106,56,50
050,53,051,"Washington","Pend Oreille County",5,82,65,36,29
050,53,051,"Washington","Pend Oreille County",5,83,53,29,24
050,53,051,"Washington","Pend Oreille County",5,84,54,21,33
050,53,051,"Washington","Pend Oreille County",5,85,278,113,165
050,53,053,"Washington","Pierce County",1,0,11216,5726,5490
050,53,053,"Washington","Pierce County",1,1,11210,5698,5512
050,53,053,"Washington","Pierce County",1,2,11708,6100,5608
050,53,053,"Washington","Pierce County",1,3,12170,6211,5959
050,53,053,"Washington","Pierce County",1,4,12555,6512,6043
050,53,053,"Washington","Pierce County",1,5,12629,6471,6158
050,53,053,"Washington","Pierce County",1,6,12389,6407,5982
050,53,053,"Washington","Pierce County",1,7,12090,6196,5894
050,53,053,"Washington","Pierce County",1,8,12177,6306,5871
050,53,053,"Washington","Pierce County",1,9,12167,6226,5941
050,53,053,"Washington","Pierce County",1,10,12326,6199,6127
050,53,053,"Washington","Pierce County",1,11,12462,6380,6082
050,53,053,"Washington","Pierce County",1,12,12553,6460,6093
050,53,053,"Washington","Pierce County",1,13,12446,6383,6063
050,53,053,"Washington","Pierce County",1,14,11884,6153,5731
050,53,053,"Washington","Pierce County",1,15,11617,5974,5643
050,53,053,"Washington","Pierce County",1,16,11583,5893,5690
050,53,053,"Washington","Pierce County",1,17,11205,5715,5490
050,53,053,"Washington","Pierce County",1,18,10591,5473,5118
050,53,053,"Washington","Pierce County",1,19,10541,5627,4914
050,53,053,"Washington","Pierce County",1,20,11434,6397,5037
050,53,053,"Washington","Pierce County",1,21,11729,6546,5183
050,53,053,"Washington","Pierce County",1,22,12168,6773,5395
050,53,053,"Washington","Pierce County",1,23,12542,6755,5787
050,53,053,"Washington","Pierce County",1,24,13251,7135,6116
050,53,053,"Washington","Pierce County",1,25,13632,7246,6386
050,53,053,"Washington","Pierce County",1,26,13984,7424,6560
050,53,053,"Washington","Pierce County",1,27,14245,7416,6829
050,53,053,"Washington","Pierce County",1,28,14814,7670,7144
050,53,053,"Washington","Pierce County",1,29,15189,7814,7375
050,53,053,"Washington","Pierce County",1,30,14799,7533,7266
050,53,053,"Washington","Pierce County",1,31,14314,7284,7030
050,53,053,"Washington","Pierce County",1,32,14100,7100,7000
050,53,053,"Washington","Pierce County",1,33,13903,7009,6894
050,53,053,"Washington","Pierce County",1,34,14001,7054,6947
050,53,053,"Washington","Pierce County",1,35,13946,7067,6879
050,53,053,"Washington","Pierce County",1,36,13903,7058,6845
050,53,053,"Washington","Pierce County",1,37,13849,6994,6855
050,53,053,"Washington","Pierce County",1,38,13672,6809,6863
050,53,053,"Washington","Pierce County",1,39,13300,6573,6727
050,53,053,"Washington","Pierce County",1,40,12896,6469,6427
050,53,053,"Washington","Pierce County",1,41,12318,6216,6102
050,53,053,"Washington","Pierce County",1,42,11790,5958,5832
050,53,053,"Washington","Pierce County",1,43,11146,5573,5573
050,53,053,"Washington","Pierce County",1,44,10885,5492,5393
050,53,053,"Washington","Pierce County",1,45,10796,5399,5397
050,53,053,"Washington","Pierce County",1,46,10470,5292,5178
050,53,053,"Washington","Pierce County",1,47,10468,5266,5202
050,53,053,"Washington","Pierce County",1,48,11186,5662,5524
050,53,053,"Washington","Pierce County",1,49,12044,6133,5911
050,53,053,"Washington","Pierce County",1,50,11740,5920,5820
050,53,053,"Washington","Pierce County",1,51,11302,5650,5652
050,53,053,"Washington","Pierce County",1,52,10748,5407,5341
050,53,053,"Washington","Pierce County",1,53,10910,5386,5524
050,53,053,"Washington","Pierce County",1,54,11088,5516,5572
050,53,053,"Washington","Pierce County",1,55,11390,5724,5666
050,53,053,"Washington","Pierce County",1,56,11604,5909,5695
050,53,053,"Washington","Pierce County",1,57,11654,5837,5817
050,53,053,"Washington","Pierce County",1,58,11791,5881,5910
050,53,053,"Washington","Pierce County",1,59,11752,5831,5921
050,53,053,"Washington","Pierce County",1,60,11512,5648,5864
050,53,053,"Washington","Pierce County",1,61,11285,5502,5783
050,53,053,"Washington","Pierce County",1,62,11096,5464,5632
050,53,053,"Washington","Pierce County",1,63,10683,5295,5388
050,53,053,"Washington","Pierce County",1,64,10379,4995,5384
050,53,053,"Washington","Pierce County",1,65,9896,4681,5215
050,53,053,"Washington","Pierce County",1,66,9506,4526,4980
050,53,053,"Washington","Pierce County",1,67,8975,4222,4753
050,53,053,"Washington","Pierce County",1,68,8439,3974,4465
050,53,053,"Washington","Pierce County",1,69,7951,3683,4268
050,53,053,"Washington","Pierce County",1,70,7672,3624,4048
050,53,053,"Washington","Pierce County",1,71,7413,3566,3847
050,53,053,"Washington","Pierce County",1,72,7311,3380,3931
050,53,053,"Washington","Pierce County",1,73,7296,3422,3874
050,53,053,"Washington","Pierce County",1,74,5075,2315,2760
050,53,053,"Washington","Pierce County",1,75,5037,2314,2723
050,53,053,"Washington","Pierce County",1,76,5038,2281,2757
050,53,053,"Washington","Pierce County",1,77,4748,2116,2632
050,53,053,"Washington","Pierce County",1,78,4018,1795,2223
050,53,053,"Washington","Pierce County",1,79,3542,1574,1968
050,53,053,"Washington","Pierce County",1,80,3164,1386,1778
050,53,053,"Washington","Pierce County",1,81,2905,1219,1686
050,53,053,"Washington","Pierce County",1,82,2615,1104,1511
050,53,053,"Washington","Pierce County",1,83,2365,945,1420
050,53,053,"Washington","Pierce County",1,84,2200,887,1313
050,53,053,"Washington","Pierce County",1,85,12754,4563,8191
050,53,053,"Washington","Pierce County",2,0,11216,5713,5503
050,53,053,"Washington","Pierce County",2,1,11214,5713,5501
050,53,053,"Washington","Pierce County",2,2,11628,6024,5604
050,53,053,"Washington","Pierce County",2,3,12036,6182,5854
050,53,053,"Washington","Pierce County",2,4,12499,6475,6024
050,53,053,"Washington","Pierce County",2,5,12625,6510,6115
050,53,053,"Washington","Pierce County",2,6,12453,6430,6023
050,53,053,"Washington","Pierce County",2,7,12167,6256,5911
050,53,053,"Washington","Pierce County",2,8,12135,6266,5869
050,53,053,"Washington","Pierce County",2,9,12158,6239,5919
050,53,053,"Washington","Pierce County",2,10,12298,6212,6086
050,53,053,"Washington","Pierce County",2,11,12367,6303,6064
050,53,053,"Washington","Pierce County",2,12,12593,6462,6131
050,53,053,"Washington","Pierce County",2,13,12479,6406,6073
050,53,053,"Washington","Pierce County",2,14,12029,6221,5808
050,53,053,"Washington","Pierce County",2,15,11703,6023,5680
050,53,053,"Washington","Pierce County",2,16,11621,5925,5696
050,53,053,"Washington","Pierce County",2,17,11309,5766,5543
050,53,053,"Washington","Pierce County",2,18,10592,5475,5117
050,53,053,"Washington","Pierce County",2,19,10550,5634,4916
050,53,053,"Washington","Pierce County",2,20,11567,6450,5117
050,53,053,"Washington","Pierce County",2,21,11742,6539,5203
050,53,053,"Washington","Pierce County",2,22,12230,6790,5440
050,53,053,"Washington","Pierce County",2,23,12591,6797,5794
050,53,053,"Washington","Pierce County",2,24,13164,7073,6091
050,53,053,"Washington","Pierce County",2,25,13601,7250,6351
050,53,053,"Washington","Pierce County",2,26,13983,7415,6568
050,53,053,"Washington","Pierce County",2,27,14180,7408,6772
050,53,053,"Washington","Pierce County",2,28,14742,7639,7103
050,53,053,"Washington","Pierce County",2,29,15106,7772,7334
050,53,053,"Washington","Pierce County",2,30,15002,7663,7339
050,53,053,"Washington","Pierce County",2,31,14428,7347,7081
050,53,053,"Washington","Pierce County",2,32,14154,7160,6994
050,53,053,"Washington","Pierce County",2,33,13973,7045,6928
050,53,053,"Washington","Pierce County",2,34,14010,7060,6950
050,53,053,"Washington","Pierce County",2,35,14065,7126,6939
050,53,053,"Washington","Pierce County",2,36,13846,7027,6819
050,53,053,"Washington","Pierce County",2,37,13909,7039,6870
050,53,053,"Washington","Pierce County",2,38,13786,6880,6906
050,53,053,"Washington","Pierce County",2,39,13362,6621,6741
050,53,053,"Washington","Pierce County",2,40,13113,6548,6565
050,53,053,"Washington","Pierce County",2,41,12432,6258,6174
050,53,053,"Washington","Pierce County",2,42,11879,6010,5869
050,53,053,"Washington","Pierce County",2,43,11357,5693,5664
050,53,053,"Washington","Pierce County",2,44,10870,5466,5404
050,53,053,"Washington","Pierce County",2,45,10867,5441,5426
050,53,053,"Washington","Pierce County",2,46,10517,5298,5219
050,53,053,"Washington","Pierce County",2,47,10449,5262,5187
050,53,053,"Washington","Pierce County",2,48,10992,5553,5439
050,53,053,"Washington","Pierce County",2,49,11883,6058,5825
050,53,053,"Washington","Pierce County",2,50,11833,5972,5861
050,53,053,"Washington","Pierce County",2,51,11351,5690,5661
050,53,053,"Washington","Pierce County",2,52,10863,5468,5395
050,53,053,"Washington","Pierce County",2,53,10851,5372,5479
050,53,053,"Washington","Pierce County",2,54,11010,5467,5543
050,53,053,"Washington","Pierce County",2,55,11308,5666,5642
050,53,053,"Washington","Pierce County",2,56,11571,5871,5700
050,53,053,"Washington","Pierce County",2,57,11639,5856,5783
050,53,053,"Washington","Pierce County",2,58,11720,5847,5873
050,53,053,"Washington","Pierce County",2,59,11762,5836,5926
050,53,053,"Washington","Pierce County",2,60,11529,5662,5867
050,53,053,"Washington","Pierce County",2,61,11277,5505,5772
050,53,053,"Washington","Pierce County",2,62,11105,5449,5656
050,53,053,"Washington","Pierce County",2,63,10835,5365,5470
050,53,053,"Washington","Pierce County",2,64,10369,5022,5347
050,53,053,"Washington","Pierce County",2,65,9985,4739,5246
050,53,053,"Washington","Pierce County",2,66,9570,4543,5027
050,53,053,"Washington","Pierce County",2,67,9033,4258,4775
050,53,053,"Washington","Pierce County",2,68,8509,4000,4509
050,53,053,"Washington","Pierce County",2,69,8068,3747,4321
050,53,053,"Washington","Pierce County",2,70,7706,3622,4084
050,53,053,"Washington","Pierce County",2,71,7439,3552,3887
050,53,053,"Washington","Pierce County",2,72,7198,3344,3854
050,53,053,"Washington","Pierce County",2,73,7599,3555,4044
050,53,053,"Washington","Pierce County",2,74,5257,2415,2842
050,53,053,"Washington","Pierce County",2,75,5018,2304,2714
050,53,053,"Washington","Pierce County",2,76,4956,2243,2713
050,53,053,"Washington","Pierce County",2,77,4883,2184,2699
050,53,053,"Washington","Pierce County",2,78,4100,1824,2276
050,53,053,"Washington","Pierce County",2,79,3616,1601,2015
050,53,053,"Washington","Pierce County",2,80,3223,1415,1808
050,53,053,"Washington","Pierce County",2,81,2909,1234,1675
050,53,053,"Washington","Pierce County",2,82,2662,1115,1547
050,53,053,"Washington","Pierce County",2,83,2380,967,1413
050,53,053,"Washington","Pierce County",2,84,2186,880,1306
050,53,053,"Washington","Pierce County",2,85,12797,4593,8204
050,53,053,"Washington","Pierce County",3,0,10955,5571,5384
050,53,053,"Washington","Pierce County",3,1,11029,5686,5343
050,53,053,"Washington","Pierce County",3,2,11140,5689,5451
050,53,053,"Washington","Pierce County",3,3,11631,6051,5580
050,53,053,"Washington","Pierce County",3,4,12077,6247,5830
050,53,053,"Washington","Pierce County",3,5,12489,6447,6042
050,53,053,"Washington","Pierce County",3,6,12621,6493,6128
050,53,053,"Washington","Pierce County",3,7,12465,6428,6037
050,53,053,"Washington","Pierce County",3,8,12199,6256,5943
050,53,053,"Washington","Pierce County",3,9,12093,6251,5842
050,53,053,"Washington","Pierce County",3,10,12079,6164,5915
050,53,053,"Washington","Pierce County",3,11,12233,6172,6061
050,53,053,"Washington","Pierce County",3,12,12362,6287,6075
050,53,053,"Washington","Pierce County",3,13,12583,6476,6107
050,53,053,"Washington","Pierce County",3,14,12427,6378,6049
050,53,053,"Washington","Pierce County",3,15,11964,6199,5765
050,53,053,"Washington","Pierce County",3,16,11579,5939,5640
050,53,053,"Washington","Pierce County",3,17,11496,5856,5640
050,53,053,"Washington","Pierce County",3,18,10454,5460,4994
050,53,053,"Washington","Pierce County",3,19,9932,5338,4594
050,53,053,"Washington","Pierce County",3,20,11387,6403,4984
050,53,053,"Washington","Pierce County",3,21,11733,6480,5253
050,53,053,"Washington","Pierce County",3,22,12146,6704,5442
050,53,053,"Washington","Pierce County",3,23,12404,6752,5652
050,53,053,"Washington","Pierce County",3,24,13043,7003,6040
050,53,053,"Washington","Pierce County",3,25,13300,7164,6136
050,53,053,"Washington","Pierce County",3,26,13676,7168,6508
050,53,053,"Washington","Pierce County",3,27,13915,7312,6603
050,53,053,"Washington","Pierce County",3,28,14146,7387,6759
050,53,053,"Washington","Pierce County",3,29,14822,7617,7205
050,53,053,"Washington","Pierce County",3,30,15357,7908,7449
050,53,053,"Washington","Pierce County",3,31,15182,7784,7398
050,53,053,"Washington","Pierce County",3,32,14532,7336,7196
050,53,053,"Washington","Pierce County",3,33,14273,7198,7075
050,53,053,"Washington","Pierce County",3,34,14046,7074,6972
050,53,053,"Washington","Pierce County",3,35,14335,7229,7106
050,53,053,"Washington","Pierce County",3,36,14129,7159,6970
050,53,053,"Washington","Pierce County",3,37,13921,7103,6818
050,53,053,"Washington","Pierce County",3,38,14045,7124,6921
050,53,053,"Washington","Pierce County",3,39,13805,6908,6897
050,53,053,"Washington","Pierce County",3,40,13377,6617,6760
050,53,053,"Washington","Pierce County",3,41,13070,6496,6574
050,53,053,"Washington","Pierce County",3,42,12507,6336,6171
050,53,053,"Washington","Pierce County",3,43,11809,5958,5851
050,53,053,"Washington","Pierce County",3,44,11338,5667,5671
050,53,053,"Washington","Pierce County",3,45,10805,5405,5400
050,53,053,"Washington","Pierce County",3,46,10794,5460,5334
050,53,053,"Washington","Pierce County",3,47,10492,5314,5178
050,53,053,"Washington","Pierce County",3,48,10398,5228,5170
050,53,053,"Washington","Pierce County",3,49,10944,5545,5399
050,53,053,"Washington","Pierce County",3,50,11815,5980,5835
050,53,053,"Washington","Pierce County",3,51,11738,5919,5819
050,53,053,"Washington","Pierce County",3,52,11321,5663,5658
050,53,053,"Washington","Pierce County",3,53,10733,5369,5364
050,53,053,"Washington","Pierce County",3,54,10755,5296,5459
050,53,053,"Washington","Pierce County",3,55,10874,5400,5474
050,53,053,"Washington","Pierce County",3,56,11163,5592,5571
050,53,053,"Washington","Pierce County",3,57,11450,5788,5662
050,53,053,"Washington","Pierce County",3,58,11446,5706,5740
050,53,053,"Washington","Pierce County",3,59,11533,5739,5794
050,53,053,"Washington","Pierce County",3,60,11588,5737,5851
050,53,053,"Washington","Pierce County",3,61,11286,5512,5774
050,53,053,"Washington","Pierce County",3,62,11013,5337,5676
050,53,053,"Washington","Pierce County",3,63,10883,5322,5561
050,53,053,"Washington","Pierce County",3,64,10633,5251,5382
050,53,053,"Washington","Pierce County",3,65,10127,4904,5223
050,53,053,"Washington","Pierce County",3,66,9782,4603,5179
050,53,053,"Washington","Pierce County",3,67,9380,4450,4930
050,53,053,"Washington","Pierce County",3,68,8850,4134,4716
050,53,053,"Washington","Pierce County",3,69,8311,3870,4441
050,53,053,"Washington","Pierce County",3,70,7845,3658,4187
050,53,053,"Washington","Pierce County",3,71,7531,3528,4003
050,53,053,"Washington","Pierce County",3,72,7207,3409,3798
050,53,053,"Washington","Pierce County",3,73,7004,3246,3758
050,53,053,"Washington","Pierce County",3,74,7399,3434,3965
050,53,053,"Washington","Pierce County",3,75,5127,2344,2783
050,53,053,"Washington","Pierce County",3,76,4841,2196,2645
050,53,053,"Washington","Pierce County",3,77,4781,2143,2638
050,53,053,"Washington","Pierce County",3,78,4700,2094,2606
050,53,053,"Washington","Pierce County",3,79,3890,1728,2162
050,53,053,"Washington","Pierce County",3,80,3472,1517,1955
050,53,053,"Washington","Pierce County",3,81,3050,1333,1717
050,53,053,"Washington","Pierce County",3,82,2733,1156,1577
050,53,053,"Washington","Pierce County",3,83,2522,1043,1479
050,53,053,"Washington","Pierce County",3,84,2203,882,1321
050,53,053,"Washington","Pierce County",3,85,12877,4625,8252
050,53,053,"Washington","Pierce County",4,0,10968,5577,5391
050,53,053,"Washington","Pierce County",4,1,10798,5534,5264
050,53,053,"Washington","Pierce County",4,2,11078,5708,5370
050,53,053,"Washington","Pierce County",4,3,11178,5655,5523
050,53,053,"Washington","Pierce County",4,4,11538,6017,5521
050,53,053,"Washington","Pierce County",4,5,12042,6168,5874
050,53,053,"Washington","Pierce County",4,6,12328,6395,5933
050,53,053,"Washington","Pierce County",4,7,12547,6454,6093
050,53,053,"Washington","Pierce County",4,8,12387,6389,5998
050,53,053,"Washington","Pierce County",4,9,12064,6159,5905
050,53,053,"Washington","Pierce County",4,10,12001,6160,5841
050,53,053,"Washington","Pierce County",4,11,12021,6144,5877
050,53,053,"Washington","Pierce County",4,12,12098,6088,6010
050,53,053,"Washington","Pierce County",4,13,12246,6249,5997
050,53,053,"Washington","Pierce County",4,14,12462,6385,6077
050,53,053,"Washington","Pierce County",4,15,12315,6335,5980
050,53,053,"Washington","Pierce County",4,16,11886,6146,5740
050,53,053,"Washington","Pierce County",4,17,11497,5907,5590
050,53,053,"Washington","Pierce County",4,18,10605,5481,5124
050,53,053,"Washington","Pierce County",4,19,9901,5351,4550
050,53,053,"Washington","Pierce County",4,20,10801,6012,4789
050,53,053,"Washington","Pierce County",4,21,11521,6383,5138
050,53,053,"Washington","Pierce County",4,22,12074,6561,5513
050,53,053,"Washington","Pierce County",4,23,12301,6602,5699
050,53,053,"Washington","Pierce County",4,24,12561,6783,5778
050,53,053,"Washington","Pierce County",4,25,13026,6979,6047
050,53,053,"Washington","Pierce County",4,26,13379,7157,6222
050,53,053,"Washington","Pierce County",4,27,13279,6860,6419
050,53,053,"Washington","Pierce County",4,28,13903,7243,6660
050,53,053,"Washington","Pierce County",4,29,14272,7422,6850
050,53,053,"Washington","Pierce County",4,30,14989,7693,7296
050,53,053,"Washington","Pierce County",4,31,15405,7906,7499
050,53,053,"Washington","Pierce County",4,32,15295,7801,7494
050,53,053,"Washington","Pierce County",4,33,14561,7352,7209
050,53,053,"Washington","Pierce County",4,34,14440,7290,7150
050,53,053,"Washington","Pierce County",4,35,14089,7134,6955
050,53,053,"Washington","Pierce County",4,36,14395,7234,7161
050,53,053,"Washington","Pierce County",4,37,14113,7136,6977
050,53,053,"Washington","Pierce County",4,38,13900,7051,6849
050,53,053,"Washington","Pierce County",4,39,14030,7120,6910
050,53,053,"Washington","Pierce County",4,40,13829,6906,6923
050,53,053,"Washington","Pierce County",4,41,13256,6552,6704
050,53,053,"Washington","Pierce County",4,42,13087,6511,6576
050,53,053,"Washington","Pierce County",4,43,12348,6277,6071
050,53,053,"Washington","Pierce County",4,44,11686,5850,5836
050,53,053,"Washington","Pierce County",4,45,11177,5588,5589
050,53,053,"Washington","Pierce County",4,46,10706,5331,5375
050,53,053,"Washington","Pierce County",4,47,10793,5436,5357
050,53,053,"Washington","Pierce County",4,48,10375,5213,5162
050,53,053,"Washington","Pierce County",4,49,10308,5184,5124
050,53,053,"Washington","Pierce County",4,50,10923,5491,5432
050,53,053,"Washington","Pierce County",4,51,11613,5871,5742
050,53,053,"Washington","Pierce County",4,52,11616,5834,5782
050,53,053,"Washington","Pierce County",4,53,11114,5538,5576
050,53,053,"Washington","Pierce County",4,54,10563,5267,5296
050,53,053,"Washington","Pierce County",4,55,10597,5211,5386
050,53,053,"Washington","Pierce County",4,56,10726,5325,5401
050,53,053,"Washington","Pierce County",4,57,10984,5497,5487
050,53,053,"Washington","Pierce County",4,58,11176,5655,5521
050,53,053,"Washington","Pierce County",4,59,11140,5496,5644
050,53,053,"Washington","Pierce County",4,60,11265,5563,5702
050,53,053,"Washington","Pierce County",4,61,11291,5615,5676
050,53,053,"Washington","Pierce County",4,62,11033,5399,5634
050,53,053,"Washington","Pierce County",4,63,10746,5187,5559
050,53,053,"Washington","Pierce County",4,64,10564,5132,5432
050,53,053,"Washington","Pierce County",4,65,10395,5094,5301
050,53,053,"Washington","Pierce County",4,66,9804,4688,5116
050,53,053,"Washington","Pierce County",4,67,9470,4420,5050
050,53,053,"Washington","Pierce County",4,68,9131,4300,4831
050,53,053,"Washington","Pierce County",4,69,8553,3979,4574
050,53,053,"Washington","Pierce County",4,70,8058,3757,4301
050,53,053,"Washington","Pierce County",4,71,7616,3524,4092
050,53,053,"Washington","Pierce County",4,72,7315,3359,3956
050,53,053,"Washington","Pierce County",4,73,6992,3297,3695
050,53,053,"Washington","Pierce County",4,74,6708,3080,3628
050,53,053,"Washington","Pierce County",4,75,7165,3314,3851
050,53,053,"Washington","Pierce County",4,76,4931,2230,2701
050,53,053,"Washington","Pierce County",4,77,4644,2100,2544
050,53,053,"Washington","Pierce County",4,78,4595,2039,2556
050,53,053,"Washington","Pierce County",4,79,4470,1989,2481
050,53,053,"Washington","Pierce County",4,80,3664,1600,2064
050,53,053,"Washington","Pierce County",4,81,3275,1433,1842
050,53,053,"Washington","Pierce County",4,82,2860,1238,1622
050,53,053,"Washington","Pierce County",4,83,2548,1064,1484
050,53,053,"Washington","Pierce County",4,84,2301,934,1367
050,53,053,"Washington","Pierce County",4,85,12774,4616,8158
050,53,053,"Washington","Pierce County",5,0,10828,5508,5320
050,53,053,"Washington","Pierce County",5,1,10977,5551,5426
050,53,053,"Washington","Pierce County",5,2,10891,5604,5287
050,53,053,"Washington","Pierce County",5,3,11173,5779,5394
050,53,053,"Washington","Pierce County",5,4,11067,5611,5456
050,53,053,"Washington","Pierce County",5,5,11469,5981,5488
050,53,053,"Washington","Pierce County",5,6,12004,6148,5856
050,53,053,"Washington","Pierce County",5,7,12396,6435,5961
050,53,053,"Washington","Pierce County",5,8,12497,6431,6066
050,53,053,"Washington","Pierce County",5,9,12305,6323,5982
050,53,053,"Washington","Pierce County",5,10,11953,6077,5876
050,53,053,"Washington","Pierce County",5,11,11944,6189,5755
050,53,053,"Washington","Pierce County",5,12,11852,6028,5824
050,53,053,"Washington","Pierce County",5,13,12005,6091,5914
050,53,053,"Washington","Pierce County",5,14,12156,6218,5938
050,53,053,"Washington","Pierce County",5,15,12301,6260,6041
050,53,053,"Washington","Pierce County",5,16,12256,6311,5945
050,53,053,"Washington","Pierce County",5,17,11809,6085,5724
050,53,053,"Washington","Pierce County",5,18,10549,5522,5027
050,53,053,"Washington","Pierce County",5,19,10009,5325,4684
050,53,053,"Washington","Pierce County",5,20,10700,5998,4702
050,53,053,"Washington","Pierce County",5,21,11141,6126,5015
050,53,053,"Washington","Pierce County",5,22,11942,6545,5397
050,53,053,"Washington","Pierce County",5,23,12286,6569,5717
050,53,053,"Washington","Pierce County",5,24,12390,6654,5736
050,53,053,"Washington","Pierce County",5,25,12799,6909,5890
050,53,053,"Washington","Pierce County",5,26,13191,7030,6161
050,53,053,"Washington","Pierce County",5,27,13321,7007,6314
050,53,053,"Washington","Pierce County",5,28,13438,6914,6524
050,53,053,"Washington","Pierce County",5,29,13974,7186,6788
050,53,053,"Washington","Pierce County",5,30,14393,7410,6983
050,53,053,"Washington","Pierce County",5,31,15261,7814,7447
050,53,053,"Washington","Pierce County",5,32,15387,7884,7503
050,53,053,"Washington","Pierce County",5,33,15331,7783,7548
050,53,053,"Washington","Pierce County",5,34,14528,7347,7181
050,53,053,"Washington","Pierce County",5,35,14551,7356,7195
050,53,053,"Washington","Pierce County",5,36,14167,7145,7022
050,53,053,"Washington","Pierce County",5,37,14463,7262,7201
050,53,053,"Washington","Pierce County",5,38,14225,7236,6989
050,53,053,"Washington","Pierce County",5,39,13853,7050,6803
050,53,053,"Washington","Pierce County",5,40,13996,7087,6909
050,53,053,"Washington","Pierce County",5,41,13748,6817,6931
050,53,053,"Washington","Pierce County",5,42,13327,6568,6759
050,53,053,"Washington","Pierce County",5,43,13090,6537,6553
050,53,053,"Washington","Pierce County",5,44,12324,6244,6080
050,53,053,"Washington","Pierce County",5,45,11597,5800,5797
050,53,053,"Washington","Pierce County",5,46,11046,5482,5564
050,53,053,"Washington","Pierce County",5,47,10663,5313,5350
050,53,053,"Washington","Pierce County",5,48,10584,5287,5297
050,53,053,"Washington","Pierce County",5,49,10360,5220,5140
050,53,053,"Washington","Pierce County",5,50,10258,5163,5095
050,53,053,"Washington","Pierce County",5,51,10828,5446,5382
050,53,053,"Washington","Pierce County",5,52,11560,5882,5678
050,53,053,"Washington","Pierce County",5,53,11514,5761,5753
050,53,053,"Washington","Pierce County",5,54,11022,5514,5508
050,53,053,"Washington","Pierce County",5,55,10444,5207,5237
050,53,053,"Washington","Pierce County",5,56,10427,5147,5280
050,53,053,"Washington","Pierce County",5,57,10572,5261,5311
050,53,053,"Washington","Pierce County",5,58,10739,5365,5374
050,53,053,"Washington","Pierce County",5,59,10989,5495,5494
050,53,053,"Washington","Pierce County",5,60,11011,5422,5589
050,53,053,"Washington","Pierce County",5,61,11122,5480,5642
050,53,053,"Washington","Pierce County",5,62,11065,5501,5564
050,53,053,"Washington","Pierce County",5,63,10781,5299,5482
050,53,053,"Washington","Pierce County",5,64,10468,5035,5433
050,53,053,"Washington","Pierce County",5,65,10280,4980,5300
050,53,053,"Washington","Pierce County",5,66,10139,4944,5195
050,53,053,"Washington","Pierce County",5,67,9584,4556,5028
050,53,053,"Washington","Pierce County",5,68,9254,4286,4968
050,53,053,"Washington","Pierce County",5,69,8890,4146,4744
050,53,053,"Washington","Pierce County",5,70,8310,3848,4462
050,53,053,"Washington","Pierce County",5,71,7921,3683,4238
050,53,053,"Washington","Pierce County",5,72,7418,3373,4045
050,53,053,"Washington","Pierce County",5,73,7127,3286,3841
050,53,053,"Washington","Pierce County",5,74,6746,3168,3578
050,53,053,"Washington","Pierce County",5,75,6509,2978,3531
050,53,053,"Washington","Pierce County",5,76,6920,3180,3740
050,53,053,"Washington","Pierce County",5,77,4761,2151,2610
050,53,053,"Washington","Pierce County",5,78,4484,2008,2476
050,53,053,"Washington","Pierce County",5,79,4386,1940,2446
050,53,053,"Washington","Pierce County",5,80,4262,1873,2389
050,53,053,"Washington","Pierce County",5,81,3476,1518,1958
050,53,053,"Washington","Pierce County",5,82,3071,1346,1725
050,53,053,"Washington","Pierce County",5,83,2680,1138,1542
050,53,053,"Washington","Pierce County",5,84,2349,973,1376
050,53,053,"Washington","Pierce County",5,85,12812,4665,8147
050,53,055,"Washington","San Juan County",1,0,99,51,48
050,53,055,"Washington","San Juan County",1,1,98,47,51
050,53,055,"Washington","San Juan County",1,2,91,45,46
050,53,055,"Washington","San Juan County",1,3,107,50,57
050,53,055,"Washington","San Juan County",1,4,118,62,56
050,53,055,"Washington","San Juan County",1,5,115,62,53
050,53,055,"Washington","San Juan County",1,6,119,57,62
050,53,055,"Washington","San Juan County",1,7,113,59,54
050,53,055,"Washington","San Juan County",1,8,123,66,57
050,53,055,"Washington","San Juan County",1,9,128,64,64
050,53,055,"Washington","San Juan County",1,10,141,67,74
050,53,055,"Washington","San Juan County",1,11,147,77,70
050,53,055,"Washington","San Juan County",1,12,151,76,75
050,53,055,"Washington","San Juan County",1,13,147,74,73
050,53,055,"Washington","San Juan County",1,14,169,80,89
050,53,055,"Washington","San Juan County",1,15,153,69,84
050,53,055,"Washington","San Juan County",1,16,134,57,77
050,53,055,"Washington","San Juan County",1,17,154,75,79
050,53,055,"Washington","San Juan County",1,18,142,81,61
050,53,055,"Washington","San Juan County",1,19,107,58,49
050,53,055,"Washington","San Juan County",1,20,103,55,48
050,53,055,"Washington","San Juan County",1,21,117,64,53
050,53,055,"Washington","San Juan County",1,22,143,75,68
050,53,055,"Washington","San Juan County",1,23,141,66,75
050,53,055,"Washington","San Juan County",1,24,144,76,68
050,53,055,"Washington","San Juan County",1,25,130,70,60
050,53,055,"Washington","San Juan County",1,26,141,71,70
050,53,055,"Washington","San Juan County",1,27,127,64,63
050,53,055,"Washington","San Juan County",1,28,139,66,73
050,53,055,"Washington","San Juan County",1,29,159,79,80
050,53,055,"Washington","San Juan County",1,30,147,77,70
050,53,055,"Washington","San Juan County",1,31,141,68,73
050,53,055,"Washington","San Juan County",1,32,161,76,85
050,53,055,"Washington","San Juan County",1,33,162,72,90
050,53,055,"Washington","San Juan County",1,34,185,91,94
050,53,055,"Washington","San Juan County",1,35,170,87,83
050,53,055,"Washington","San Juan County",1,36,159,78,81
050,53,055,"Washington","San Juan County",1,37,165,88,77
050,53,055,"Washington","San Juan County",1,38,170,79,91
050,53,055,"Washington","San Juan County",1,39,193,90,103
050,53,055,"Washington","San Juan County",1,40,207,110,97
050,53,055,"Washington","San Juan County",1,41,184,86,98
050,53,055,"Washington","San Juan County",1,42,175,80,95
050,53,055,"Washington","San Juan County",1,43,183,85,98
050,53,055,"Washington","San Juan County",1,44,193,102,91
050,53,055,"Washington","San Juan County",1,45,183,95,88
050,53,055,"Washington","San Juan County",1,46,150,76,74
050,53,055,"Washington","San Juan County",1,47,165,78,87
050,53,055,"Washington","San Juan County",1,48,189,87,102
050,53,055,"Washington","San Juan County",1,49,196,97,99
050,53,055,"Washington","San Juan County",1,50,221,109,112
050,53,055,"Washington","San Juan County",1,51,195,102,93
050,53,055,"Washington","San Juan County",1,52,228,115,113
050,53,055,"Washington","San Juan County",1,53,212,101,111
050,53,055,"Washington","San Juan County",1,54,232,101,131
050,53,055,"Washington","San Juan County",1,55,210,102,108
050,53,055,"Washington","San Juan County",1,56,250,127,123
050,53,055,"Washington","San Juan County",1,57,288,146,142
050,53,055,"Washington","San Juan County",1,58,292,144,148
050,53,055,"Washington","San Juan County",1,59,333,171,162
050,53,055,"Washington","San Juan County",1,60,331,155,176
050,53,055,"Washington","San Juan County",1,61,347,154,193
050,53,055,"Washington","San Juan County",1,62,371,164,207
050,53,055,"Washington","San Juan County",1,63,396,185,211
050,53,055,"Washington","San Juan County",1,64,378,174,204
050,53,055,"Washington","San Juan County",1,65,393,188,205
050,53,055,"Washington","San Juan County",1,66,428,196,232
050,53,055,"Washington","San Juan County",1,67,432,207,225
050,53,055,"Washington","San Juan County",1,68,412,203,209
050,53,055,"Washington","San Juan County",1,69,395,189,206
050,53,055,"Washington","San Juan County",1,70,371,181,190
050,53,055,"Washington","San Juan County",1,71,374,185,189
050,53,055,"Washington","San Juan County",1,72,406,204,202
050,53,055,"Washington","San Juan County",1,73,418,204,214
050,53,055,"Washington","San Juan County",1,74,286,137,149
050,53,055,"Washington","San Juan County",1,75,273,147,126
050,53,055,"Washington","San Juan County",1,76,257,140,117
050,53,055,"Washington","San Juan County",1,77,231,120,111
050,53,055,"Washington","San Juan County",1,78,218,113,105
050,53,055,"Washington","San Juan County",1,79,174,88,86
050,53,055,"Washington","San Juan County",1,80,140,70,70
050,53,055,"Washington","San Juan County",1,81,131,66,65
050,53,055,"Washington","San Juan County",1,82,126,61,65
050,53,055,"Washington","San Juan County",1,83,115,64,51
050,53,055,"Washington","San Juan County",1,84,98,48,50
050,53,055,"Washington","San Juan County",1,85,446,192,254
050,53,055,"Washington","San Juan County",2,0,99,53,46
050,53,055,"Washington","San Juan County",2,1,97,47,50
050,53,055,"Washington","San Juan County",2,2,92,45,47
050,53,055,"Washington","San Juan County",2,3,105,51,54
050,53,055,"Washington","San Juan County",2,4,116,59,57
050,53,055,"Washington","San Juan County",2,5,115,61,54
050,53,055,"Washington","San Juan County",2,6,118,58,60
050,53,055,"Washington","San Juan County",2,7,115,59,56
050,53,055,"Washington","San Juan County",2,8,117,62,55
050,53,055,"Washington","San Juan County",2,9,127,65,62
050,53,055,"Washington","San Juan County",2,10,137,66,71
050,53,055,"Washington","San Juan County",2,11,146,76,70
050,53,055,"Washington","San Juan County",2,12,152,77,75
050,53,055,"Washington","San Juan County",2,13,150,76,74
050,53,055,"Washington","San Juan County",2,14,164,79,85
050,53,055,"Washington","San Juan County",2,15,156,72,84
050,53,055,"Washington","San Juan County",2,16,138,60,78
050,53,055,"Washington","San Juan County",2,17,151,71,80
050,53,055,"Washington","San Juan County",2,18,139,76,63
050,53,055,"Washington","San Juan County",2,19,108,59,49
050,53,055,"Washington","San Juan County",2,20,105,56,49
050,53,055,"Washington","San Juan County",2,21,115,63,52
050,53,055,"Washington","San Juan County",2,22,139,72,67
050,53,055,"Washington","San Juan County",2,23,140,66,74
050,53,055,"Washington","San Juan County",2,24,142,72,70
050,53,055,"Washington","San Juan County",2,25,131,71,60
050,53,055,"Washington","San Juan County",2,26,139,73,66
050,53,055,"Washington","San Juan County",2,27,132,67,65
050,53,055,"Washington","San Juan County",2,28,140,68,72
050,53,055,"Washington","San Juan County",2,29,159,79,80
050,53,055,"Washington","San Juan County",2,30,150,78,72
050,53,055,"Washington","San Juan County",2,31,143,70,73
050,53,055,"Washington","San Juan County",2,32,157,75,82
050,53,055,"Washington","San Juan County",2,33,161,71,90
050,53,055,"Washington","San Juan County",2,34,180,87,93
050,53,055,"Washington","San Juan County",2,35,177,88,89
050,53,055,"Washington","San Juan County",2,36,160,81,79
050,53,055,"Washington","San Juan County",2,37,166,87,79
050,53,055,"Washington","San Juan County",2,38,171,83,88
050,53,055,"Washington","San Juan County",2,39,186,87,99
050,53,055,"Washington","San Juan County",2,40,207,107,100
050,53,055,"Washington","San Juan County",2,41,189,90,99
050,53,055,"Washington","San Juan County",2,42,177,82,95
050,53,055,"Washington","San Juan County",2,43,181,84,97
050,53,055,"Washington","San Juan County",2,44,191,97,94
050,53,055,"Washington","San Juan County",2,45,188,98,90
050,53,055,"Washington","San Juan County",2,46,158,79,79
050,53,055,"Washington","San Juan County",2,47,162,78,84
050,53,055,"Washington","San Juan County",2,48,184,85,99
050,53,055,"Washington","San Juan County",2,49,196,96,100
050,53,055,"Washington","San Juan County",2,50,217,108,109
050,53,055,"Washington","San Juan County",2,51,200,102,98
050,53,055,"Washington","San Juan County",2,52,221,113,108
050,53,055,"Washington","San Juan County",2,53,219,106,113
050,53,055,"Washington","San Juan County",2,54,227,99,128
050,53,055,"Washington","San Juan County",2,55,216,103,113
050,53,055,"Washington","San Juan County",2,56,240,122,118
050,53,055,"Washington","San Juan County",2,57,283,143,140
050,53,055,"Washington","San Juan County",2,58,293,145,148
050,53,055,"Washington","San Juan County",2,59,328,168,160
050,53,055,"Washington","San Juan County",2,60,333,158,175
050,53,055,"Washington","San Juan County",2,61,345,154,191
050,53,055,"Washington","San Juan County",2,62,369,163,206
050,53,055,"Washington","San Juan County",2,63,399,184,215
050,53,055,"Washington","San Juan County",2,64,383,178,205
050,53,055,"Washington","San Juan County",2,65,391,185,206
050,53,055,"Washington","San Juan County",2,66,421,194,227
050,53,055,"Washington","San Juan County",2,67,432,204,228
050,53,055,"Washington","San Juan County",2,68,413,202,211
050,53,055,"Washington","San Juan County",2,69,400,193,207
050,53,055,"Washington","San Juan County",2,70,375,182,193
050,53,055,"Washington","San Juan County",2,71,375,186,189
050,53,055,"Washington","San Juan County",2,72,394,196,198
050,53,055,"Washington","San Juan County",2,73,439,215,224
050,53,055,"Washington","San Juan County",2,74,298,144,154
050,53,055,"Washington","San Juan County",2,75,278,146,132
050,53,055,"Washington","San Juan County",2,76,259,141,118
050,53,055,"Washington","San Juan County",2,77,242,127,115
050,53,055,"Washington","San Juan County",2,78,216,111,105
050,53,055,"Washington","San Juan County",2,79,181,93,88
050,53,055,"Washington","San Juan County",2,80,148,74,74
050,53,055,"Washington","San Juan County",2,81,132,66,66
050,53,055,"Washington","San Juan County",2,82,127,62,65
050,53,055,"Washington","San Juan County",2,83,114,63,51
050,53,055,"Washington","San Juan County",2,84,100,51,49
050,53,055,"Washington","San Juan County",2,85,450,195,255
050,53,055,"Washington","San Juan County",3,0,117,57,60
050,53,055,"Washington","San Juan County",3,1,104,56,48
050,53,055,"Washington","San Juan County",3,2,106,47,59
050,53,055,"Washington","San Juan County",3,3,102,54,48
050,53,055,"Washington","San Juan County",3,4,110,51,59
050,53,055,"Washington","San Juan County",3,5,123,62,61
050,53,055,"Washington","San Juan County",3,6,119,57,62
050,53,055,"Washington","San Juan County",3,7,129,68,61
050,53,055,"Washington","San Juan County",3,8,121,60,61
050,53,055,"Washington","San Juan County",3,9,129,71,58
050,53,055,"Washington","San Juan County",3,10,140,74,66
050,53,055,"Washington","San Juan County",3,11,148,67,81
050,53,055,"Washington","San Juan County",3,12,150,78,72
050,53,055,"Washington","San Juan County",3,13,153,77,76
050,53,055,"Washington","San Juan County",3,14,155,82,73
050,53,055,"Washington","San Juan County",3,15,165,80,85
050,53,055,"Washington","San Juan County",3,16,155,68,87
050,53,055,"Washington","San Juan County",3,17,145,63,82
050,53,055,"Washington","San Juan County",3,18,131,64,67
050,53,055,"Washington","San Juan County",3,19,112,62,50
050,53,055,"Washington","San Juan County",3,20,114,62,52
050,53,055,"Washington","San Juan County",3,21,119,72,47
050,53,055,"Washington","San Juan County",3,22,131,74,57
050,53,055,"Washington","San Juan County",3,23,153,75,78
050,53,055,"Washington","San Juan County",3,24,134,65,69
050,53,055,"Washington","San Juan County",3,25,161,82,79
050,53,055,"Washington","San Juan County",3,26,136,70,66
050,53,055,"Washington","San Juan County",3,27,151,71,80
050,53,055,"Washington","San Juan County",3,28,145,74,71
050,53,055,"Washington","San Juan County",3,29,162,81,81
050,53,055,"Washington","San Juan County",3,30,175,92,83
050,53,055,"Washington","San Juan County",3,31,176,95,81
050,53,055,"Washington","San Juan County",3,32,161,76,85
050,53,055,"Washington","San Juan County",3,33,172,82,90
050,53,055,"Washington","San Juan County",3,34,169,77,92
050,53,055,"Washington","San Juan County",3,35,204,103,101
050,53,055,"Washington","San Juan County",3,36,199,96,103
050,53,055,"Washington","San Juan County",3,37,183,89,94
050,53,055,"Washington","San Juan County",3,38,180,94,86
050,53,055,"Washington","San Juan County",3,39,180,89,91
050,53,055,"Washington","San Juan County",3,40,202,99,103
050,53,055,"Washington","San Juan County",3,41,223,117,106
050,53,055,"Washington","San Juan County",3,42,203,94,109
050,53,055,"Washington","San Juan County",3,43,194,87,107
050,53,055,"Washington","San Juan County",3,44,195,96,99
050,53,055,"Washington","San Juan County",3,45,197,99,98
050,53,055,"Washington","San Juan County",3,46,199,106,93
050,53,055,"Washington","San Juan County",3,47,171,88,83
050,53,055,"Washington","San Juan County",3,48,186,93,93
050,53,055,"Washington","San Juan County",3,49,200,93,107
050,53,055,"Washington","San Juan County",3,50,209,104,105
050,53,055,"Washington","San Juan County",3,51,226,112,114
050,53,055,"Washington","San Juan County",3,52,217,111,106
050,53,055,"Washington","San Juan County",3,53,247,131,116
050,53,055,"Washington","San Juan County",3,54,232,109,123
050,53,055,"Washington","San Juan County",3,55,237,103,134
050,53,055,"Washington","San Juan County",3,56,231,113,118
050,53,055,"Washington","San Juan County",3,57,254,127,127
050,53,055,"Washington","San Juan County",3,58,294,146,148
050,53,055,"Washington","San Juan County",3,59,302,145,157
050,53,055,"Washington","San Juan County",3,60,336,169,167
050,53,055,"Washington","San Juan County",3,61,354,164,190
050,53,055,"Washington","San Juan County",3,62,376,176,200
050,53,055,"Washington","San Juan County",3,63,388,170,218
050,53,055,"Washington","San Juan County",3,64,417,186,231
050,53,055,"Washington","San Juan County",3,65,394,191,203
050,53,055,"Washington","San Juan County",3,66,387,183,204
050,53,055,"Washington","San Juan County",3,67,444,200,244
050,53,055,"Washington","San Juan County",3,68,435,207,228
050,53,055,"Washington","San Juan County",3,69,414,204,210
050,53,055,"Washington","San Juan County",3,70,409,197,212
050,53,055,"Washington","San Juan County",3,71,380,188,192
050,53,055,"Washington","San Juan County",3,72,376,184,192
050,53,055,"Washington","San Juan County",3,73,388,194,194
050,53,055,"Washington","San Juan County",3,74,440,218,222
050,53,055,"Washington","San Juan County",3,75,290,139,151
050,53,055,"Washington","San Juan County",3,76,277,140,137
050,53,055,"Washington","San Juan County",3,77,253,139,114
050,53,055,"Washington","San Juan County",3,78,251,135,116
050,53,055,"Washington","San Juan County",3,79,200,106,94
050,53,055,"Washington","San Juan County",3,80,184,95,89
050,53,055,"Washington","San Juan County",3,81,144,71,73
050,53,055,"Washington","San Juan County",3,82,129,62,67
050,53,055,"Washington","San Juan County",3,83,119,60,59
050,53,055,"Washington","San Juan County",3,84,106,58,48
050,53,055,"Washington","San Juan County",3,85,489,217,272
050,53,055,"Washington","San Juan County",4,0,105,58,47
050,53,055,"Washington","San Juan County",4,1,129,57,72
050,53,055,"Washington","San Juan County",4,2,118,61,57
050,53,055,"Washington","San Juan County",4,3,103,49,54
050,53,055,"Washington","San Juan County",4,4,110,56,54
050,53,055,"Washington","San Juan County",4,5,112,54,58
050,53,055,"Washington","San Juan County",4,6,130,60,70
050,53,055,"Washington","San Juan County",4,7,124,56,68
050,53,055,"Washington","San Juan County",4,8,133,69,64
050,53,055,"Washington","San Juan County",4,9,124,61,63
050,53,055,"Washington","San Juan County",4,10,122,70,52
050,53,055,"Washington","San Juan County",4,11,138,75,63
050,53,055,"Washington","San Juan County",4,12,155,74,81
050,53,055,"Washington","San Juan County",4,13,158,79,79
050,53,055,"Washington","San Juan County",4,14,153,78,75
050,53,055,"Washington","San Juan County",4,15,156,80,76
050,53,055,"Washington","San Juan County",4,16,163,79,84
050,53,055,"Washington","San Juan County",4,17,154,70,84
050,53,055,"Washington","San Juan County",4,18,122,57,65
050,53,055,"Washington","San Juan County",4,19,98,47,51
050,53,055,"Washington","San Juan County",4,20,112,64,48
050,53,055,"Washington","San Juan County",4,21,121,59,62
050,53,055,"Washington","San Juan County",4,22,123,69,54
050,53,055,"Washington","San Juan County",4,23,140,73,67
050,53,055,"Washington","San Juan County",4,24,158,76,82
050,53,055,"Washington","San Juan County",4,25,133,63,70
050,53,055,"Washington","San Juan County",4,26,157,87,70
050,53,055,"Washington","San Juan County",4,27,137,70,67
050,53,055,"Washington","San Juan County",4,28,144,75,69
050,53,055,"Washington","San Juan County",4,29,151,75,76
050,53,055,"Washington","San Juan County",4,30,151,77,74
050,53,055,"Washington","San Juan County",4,31,166,79,87
050,53,055,"Washington","San Juan County",4,32,195,106,89
050,53,055,"Washington","San Juan County",4,33,173,83,90
050,53,055,"Washington","San Juan County",4,34,171,78,93
050,53,055,"Washington","San Juan County",4,35,182,82,100
050,53,055,"Washington","San Juan County",4,36,207,107,100
050,53,055,"Washington","San Juan County",4,37,192,94,98
050,53,055,"Washington","San Juan County",4,38,195,93,102
050,53,055,"Washington","San Juan County",4,39,202,110,92
050,53,055,"Washington","San Juan County",4,40,179,87,92
050,53,055,"Washington","San Juan County",4,41,212,110,102
050,53,055,"Washington","San Juan County",4,42,235,121,114
050,53,055,"Washington","San Juan County",4,43,207,93,114
050,53,055,"Washington","San Juan County",4,44,208,88,120
050,53,055,"Washington","San Juan County",4,45,199,96,103
050,53,055,"Washington","San Juan County",4,46,206,101,105
050,53,055,"Washington","San Juan County",4,47,198,103,95
050,53,055,"Washington","San Juan County",4,48,177,94,83
050,53,055,"Washington","San Juan County",4,49,191,93,98
050,53,055,"Washington","San Juan County",4,50,206,98,108
050,53,055,"Washington","San Juan County",4,51,210,107,103
050,53,055,"Washington","San Juan County",4,52,235,116,119
050,53,055,"Washington","San Juan County",4,53,219,116,103
050,53,055,"Washington","San Juan County",4,54,242,124,118
050,53,055,"Washington","San Juan County",4,55,237,111,126
050,53,055,"Washington","San Juan County",4,56,251,114,137
050,53,055,"Washington","San Juan County",4,57,240,116,124
050,53,055,"Washington","San Juan County",4,58,250,131,119
050,53,055,"Washington","San Juan County",4,59,295,145,150
050,53,055,"Washington","San Juan County",4,60,309,147,162
050,53,055,"Washington","San Juan County",4,61,326,173,153
050,53,055,"Washington","San Juan County",4,62,359,164,195
050,53,055,"Washington","San Juan County",4,63,376,180,196
050,53,055,"Washington","San Juan County",4,64,384,163,221
050,53,055,"Washington","San Juan County",4,65,412,180,232
050,53,055,"Washington","San Juan County",4,66,402,200,202
050,53,055,"Washington","San Juan County",4,67,394,182,212
050,53,055,"Washington","San Juan County",4,68,442,206,236
050,53,055,"Washington","San Juan County",4,69,429,208,221
050,53,055,"Washington","San Juan County",4,70,400,193,207
050,53,055,"Washington","San Juan County",4,71,397,194,203
050,53,055,"Washington","San Juan County",4,72,376,182,194
050,53,055,"Washington","San Juan County",4,73,368,181,187
050,53,055,"Washington","San Juan County",4,74,380,189,191
050,53,055,"Washington","San Juan County",4,75,418,210,208
050,53,055,"Washington","San Juan County",4,76,281,135,146
050,53,055,"Washington","San Juan County",4,77,260,133,127
050,53,055,"Washington","San Juan County",4,78,249,135,114
050,53,055,"Washington","San Juan County",4,79,238,132,106
050,53,055,"Washington","San Juan County",4,80,192,100,92
050,53,055,"Washington","San Juan County",4,81,174,90,84
050,53,055,"Washington","San Juan County",4,82,135,64,71
050,53,055,"Washington","San Juan County",4,83,125,61,64
050,53,055,"Washington","San Juan County",4,84,103,51,52
050,53,055,"Washington","San Juan County",4,85,529,238,291
050,53,055,"Washington","San Juan County",5,0,103,57,46
050,53,055,"Washington","San Juan County",5,1,110,58,52
050,53,055,"Washington","San Juan County",5,2,120,55,65
050,53,055,"Washington","San Juan County",5,3,115,61,54
050,53,055,"Washington","San Juan County",5,4,106,51,55
050,53,055,"Washington","San Juan County",5,5,106,49,57
050,53,055,"Washington","San Juan County",5,6,107,54,53
050,53,055,"Washington","San Juan County",5,7,128,62,66
050,53,055,"Washington","San Juan County",5,8,127,59,68
050,53,055,"Washington","San Juan County",5,9,128,65,63
050,53,055,"Washington","San Juan County",5,10,117,58,59
050,53,055,"Washington","San Juan County",5,11,116,65,51
050,53,055,"Washington","San Juan County",5,12,131,69,62
050,53,055,"Washington","San Juan County",5,13,156,75,81
050,53,055,"Washington","San Juan County",5,14,158,81,77
050,53,055,"Washington","San Juan County",5,15,159,81,78
050,53,055,"Washington","San Juan County",5,16,149,75,74
050,53,055,"Washington","San Juan County",5,17,163,77,86
050,53,055,"Washington","San Juan County",5,18,132,62,70
050,53,055,"Washington","San Juan County",5,19,105,51,54
050,53,055,"Washington","San Juan County",5,20,102,43,59
050,53,055,"Washington","San Juan County",5,21,114,62,52
050,53,055,"Washington","San Juan County",5,22,138,69,69
050,53,055,"Washington","San Juan County",5,23,123,58,65
050,53,055,"Washington","San Juan County",5,24,130,64,66
050,53,055,"Washington","San Juan County",5,25,152,78,74
050,53,055,"Washington","San Juan County",5,26,137,69,68
050,53,055,"Washington","San Juan County",5,27,151,77,74
050,53,055,"Washington","San Juan County",5,28,143,76,67
050,53,055,"Washington","San Juan County",5,29,150,66,84
050,53,055,"Washington","San Juan County",5,30,143,82,61
050,53,055,"Washington","San Juan County",5,31,165,85,80
050,53,055,"Washington","San Juan County",5,32,168,78,90
050,53,055,"Washington","San Juan County",5,33,190,99,91
050,53,055,"Washington","San Juan County",5,34,171,86,85
050,53,055,"Washington","San Juan County",5,35,194,86,108
050,53,055,"Washington","San Juan County",5,36,177,79,98
050,53,055,"Washington","San Juan County",5,37,207,111,96
050,53,055,"Washington","San Juan County",5,38,196,97,99
050,53,055,"Washington","San Juan County",5,39,205,100,105
050,53,055,"Washington","San Juan County",5,40,201,108,93
050,53,055,"Washington","San Juan County",5,41,189,91,98
050,53,055,"Washington","San Juan County",5,42,212,106,106
050,53,055,"Washington","San Juan County",5,43,229,112,117
050,53,055,"Washington","San Juan County",5,44,211,97,114
050,53,055,"Washington","San Juan County",5,45,204,87,117
050,53,055,"Washington","San Juan County",5,46,202,97,105
050,53,055,"Washington","San Juan County",5,47,201,98,103
050,53,055,"Washington","San Juan County",5,48,206,104,102
050,53,055,"Washington","San Juan County",5,49,176,96,80
050,53,055,"Washington","San Juan County",5,50,189,96,93
050,53,055,"Washington","San Juan County",5,51,193,92,101
050,53,055,"Washington","San Juan County",5,52,220,117,103
050,53,055,"Washington","San Juan County",5,53,250,124,126
050,53,055,"Washington","San Juan County",5,54,216,108,108
050,53,055,"Washington","San Juan County",5,55,248,126,122
050,53,055,"Washington","San Juan County",5,56,231,114,117
050,53,055,"Washington","San Juan County",5,57,267,118,149
050,53,055,"Washington","San Juan County",5,58,239,118,121
050,53,055,"Washington","San Juan County",5,59,261,138,123
050,53,055,"Washington","San Juan County",5,60,298,146,152
050,53,055,"Washington","San Juan County",5,61,314,145,169
050,53,055,"Washington","San Juan County",5,62,323,173,150
050,53,055,"Washington","San Juan County",5,63,363,165,198
050,53,055,"Washington","San Juan County",5,64,381,176,205
050,53,055,"Washington","San Juan County",5,65,389,165,224
050,53,055,"Washington","San Juan County",5,66,411,184,227
050,53,055,"Washington","San Juan County",5,67,398,198,200
050,53,055,"Washington","San Juan County",5,68,381,177,204
050,53,055,"Washington","San Juan County",5,69,435,200,235
050,53,055,"Washington","San Juan County",5,70,416,204,212
050,53,055,"Washington","San Juan County",5,71,396,188,208
050,53,055,"Washington","San Juan County",5,72,393,194,199
050,53,055,"Washington","San Juan County",5,73,374,180,194
050,53,055,"Washington","San Juan County",5,74,351,176,175
050,53,055,"Washington","San Juan County",5,75,374,184,190
050,53,055,"Washington","San Juan County",5,76,399,196,203
050,53,055,"Washington","San Juan County",5,77,270,134,136
050,53,055,"Washington","San Juan County",5,78,252,129,123
050,53,055,"Washington","San Juan County",5,79,238,130,108
050,53,055,"Washington","San Juan County",5,80,230,125,105
050,53,055,"Washington","San Juan County",5,81,181,95,86
050,53,055,"Washington","San Juan County",5,82,162,84,78
050,53,055,"Washington","San Juan County",5,83,128,63,65
050,53,055,"Washington","San Juan County",5,84,117,55,62
050,53,055,"Washington","San Juan County",5,85,555,254,301
050,53,057,"Washington","Skagit County",1,0,1371,698,673
050,53,057,"Washington","Skagit County",1,1,1372,683,689
050,53,057,"Washington","Skagit County",1,2,1436,725,711
050,53,057,"Washington","Skagit County",1,3,1552,836,716
050,53,057,"Washington","Skagit County",1,4,1557,819,738
050,53,057,"Washington","Skagit County",1,5,1564,832,732
050,53,057,"Washington","Skagit County",1,6,1587,813,774
050,53,057,"Washington","Skagit County",1,7,1526,784,742
050,53,057,"Washington","Skagit County",1,8,1555,805,750
050,53,057,"Washington","Skagit County",1,9,1553,792,761
050,53,057,"Washington","Skagit County",1,10,1589,794,795
050,53,057,"Washington","Skagit County",1,11,1659,828,831
050,53,057,"Washington","Skagit County",1,12,1686,875,811
050,53,057,"Washington","Skagit County",1,13,1650,858,792
050,53,057,"Washington","Skagit County",1,14,1568,812,756
050,53,057,"Washington","Skagit County",1,15,1606,801,805
050,53,057,"Washington","Skagit County",1,16,1549,778,771
050,53,057,"Washington","Skagit County",1,17,1539,784,755
050,53,057,"Washington","Skagit County",1,18,1428,772,656
050,53,057,"Washington","Skagit County",1,19,1241,658,583
050,53,057,"Washington","Skagit County",1,20,1282,654,628
050,53,057,"Washington","Skagit County",1,21,1308,680,628
050,53,057,"Washington","Skagit County",1,22,1326,654,672
050,53,057,"Washington","Skagit County",1,23,1410,704,706
050,53,057,"Washington","Skagit County",1,24,1433,725,708
050,53,057,"Washington","Skagit County",1,25,1537,780,757
050,53,057,"Washington","Skagit County",1,26,1649,827,822
050,53,057,"Washington","Skagit County",1,27,1665,850,815
050,53,057,"Washington","Skagit County",1,28,1690,856,834
050,53,057,"Washington","Skagit County",1,29,1704,871,833
050,53,057,"Washington","Skagit County",1,30,1645,832,813
050,53,057,"Washington","Skagit County",1,31,1582,830,752
050,53,057,"Washington","Skagit County",1,32,1627,858,769
050,53,057,"Washington","Skagit County",1,33,1563,811,752
050,53,057,"Washington","Skagit County",1,34,1639,826,813
050,53,057,"Washington","Skagit County",1,35,1682,834,848
050,53,057,"Washington","Skagit County",1,36,1712,877,835
050,53,057,"Washington","Skagit County",1,37,1735,876,859
050,53,057,"Washington","Skagit County",1,38,1690,876,814
050,53,057,"Washington","Skagit County",1,39,1677,894,783
050,53,057,"Washington","Skagit County",1,40,1571,807,764
050,53,057,"Washington","Skagit County",1,41,1516,776,740
050,53,057,"Washington","Skagit County",1,42,1518,763,755
050,53,057,"Washington","Skagit County",1,43,1471,739,732
050,53,057,"Washington","Skagit County",1,44,1399,709,690
050,53,057,"Washington","Skagit County",1,45,1360,677,683
050,53,057,"Washington","Skagit County",1,46,1380,706,674
050,53,057,"Washington","Skagit County",1,47,1332,667,665
050,53,057,"Washington","Skagit County",1,48,1444,705,739
050,53,057,"Washington","Skagit County",1,49,1572,800,772
050,53,057,"Washington","Skagit County",1,50,1547,789,758
050,53,057,"Washington","Skagit County",1,51,1442,705,737
050,53,057,"Washington","Skagit County",1,52,1412,703,709
050,53,057,"Washington","Skagit County",1,53,1485,738,747
050,53,057,"Washington","Skagit County",1,54,1443,744,699
050,53,057,"Washington","Skagit County",1,55,1554,762,792
050,53,057,"Washington","Skagit County",1,56,1655,819,836
050,53,057,"Washington","Skagit County",1,57,1708,823,885
050,53,057,"Washington","Skagit County",1,58,1790,857,933
050,53,057,"Washington","Skagit County",1,59,1841,909,932
050,53,057,"Washington","Skagit County",1,60,1847,915,932
050,53,057,"Washington","Skagit County",1,61,1832,872,960
050,53,057,"Washington","Skagit County",1,62,1856,880,976
050,53,057,"Washington","Skagit County",1,63,1828,862,966
050,53,057,"Washington","Skagit County",1,64,1858,892,966
050,53,057,"Washington","Skagit County",1,65,1902,904,998
050,53,057,"Washington","Skagit County",1,66,1903,917,986
050,53,057,"Washington","Skagit County",1,67,1839,866,973
050,53,057,"Washington","Skagit County",1,68,1812,864,948
050,53,057,"Washington","Skagit County",1,69,1698,815,883
050,53,057,"Washington","Skagit County",1,70,1654,793,861
050,53,057,"Washington","Skagit County",1,71,1622,778,844
050,53,057,"Washington","Skagit County",1,72,1605,772,833
050,53,057,"Washington","Skagit County",1,73,1661,804,857
050,53,057,"Washington","Skagit County",1,74,1195,555,640
050,53,057,"Washington","Skagit County",1,75,1196,562,634
050,53,057,"Washington","Skagit County",1,76,1159,550,609
050,53,057,"Washington","Skagit County",1,77,1116,508,608
050,53,057,"Washington","Skagit County",1,78,888,423,465
050,53,057,"Washington","Skagit County",1,79,763,373,390
050,53,057,"Washington","Skagit County",1,80,722,338,384
050,53,057,"Washington","Skagit County",1,81,669,330,339
050,53,057,"Washington","Skagit County",1,82,627,288,339
050,53,057,"Washington","Skagit County",1,83,520,226,294
050,53,057,"Washington","Skagit County",1,84,471,218,253
050,53,057,"Washington","Skagit County",1,85,2697,1109,1588
050,53,057,"Washington","Skagit County",2,0,1368,692,676
050,53,057,"Washington","Skagit County",2,1,1370,682,688
050,53,057,"Washington","Skagit County",2,2,1428,721,707
050,53,057,"Washington","Skagit County",2,3,1524,811,713
050,53,057,"Washington","Skagit County",2,4,1566,829,737
050,53,057,"Washington","Skagit County",2,5,1567,831,736
050,53,057,"Washington","Skagit County",2,6,1590,822,768
050,53,057,"Washington","Skagit County",2,7,1541,792,749
050,53,057,"Washington","Skagit County",2,8,1547,801,746
050,53,057,"Washington","Skagit County",2,9,1553,797,756
050,53,057,"Washington","Skagit County",2,10,1578,795,783
050,53,057,"Washington","Skagit County",2,11,1630,814,816
050,53,057,"Washington","Skagit County",2,12,1688,869,819
050,53,057,"Washington","Skagit County",2,13,1656,860,796
050,53,057,"Washington","Skagit County",2,14,1592,826,766
050,53,057,"Washington","Skagit County",2,15,1605,809,796
050,53,057,"Washington","Skagit County",2,16,1565,786,779
050,53,057,"Washington","Skagit County",2,17,1549,786,763
050,53,057,"Washington","Skagit County",2,18,1403,752,651
050,53,057,"Washington","Skagit County",2,19,1248,668,580
050,53,057,"Washington","Skagit County",2,20,1301,667,634
050,53,057,"Washington","Skagit County",2,21,1307,677,630
050,53,057,"Washington","Skagit County",2,22,1338,668,670
050,53,057,"Washington","Skagit County",2,23,1412,703,709
050,53,057,"Washington","Skagit County",2,24,1438,729,709
050,53,057,"Washington","Skagit County",2,25,1536,782,754
050,53,057,"Washington","Skagit County",2,26,1635,826,809
050,53,057,"Washington","Skagit County",2,27,1670,849,821
050,53,057,"Washington","Skagit County",2,28,1699,858,841
050,53,057,"Washington","Skagit County",2,29,1703,867,836
050,53,057,"Washington","Skagit County",2,30,1681,851,830
050,53,057,"Washington","Skagit County",2,31,1600,835,765
050,53,057,"Washington","Skagit County",2,32,1610,842,768
050,53,057,"Washington","Skagit County",2,33,1585,825,760
050,53,057,"Washington","Skagit County",2,34,1632,830,802
050,53,057,"Washington","Skagit County",2,35,1689,843,846
050,53,057,"Washington","Skagit County",2,36,1703,865,838
050,53,057,"Washington","Skagit County",2,37,1737,880,857
050,53,057,"Washington","Skagit County",2,38,1719,888,831
050,53,057,"Washington","Skagit County",2,39,1672,884,788
050,53,057,"Washington","Skagit County",2,40,1611,834,777
050,53,057,"Washington","Skagit County",2,41,1530,784,746
050,53,057,"Washington","Skagit County",2,42,1513,763,750
050,53,057,"Washington","Skagit County",2,43,1494,752,742
050,53,057,"Washington","Skagit County",2,44,1414,714,700
050,53,057,"Washington","Skagit County",2,45,1385,691,694
050,53,057,"Washington","Skagit County",2,46,1371,696,675
050,53,057,"Washington","Skagit County",2,47,1341,677,664
050,53,057,"Washington","Skagit County",2,48,1422,701,721
050,53,057,"Washington","Skagit County",2,49,1555,784,771
050,53,057,"Washington","Skagit County",2,50,1562,792,770
050,53,057,"Washington","Skagit County",2,51,1466,723,743
050,53,057,"Washington","Skagit County",2,52,1426,708,718
050,53,057,"Washington","Skagit County",2,53,1468,730,738
050,53,057,"Washington","Skagit County",2,54,1455,744,711
050,53,057,"Washington","Skagit County",2,55,1530,759,771
050,53,057,"Washington","Skagit County",2,56,1641,812,829
050,53,057,"Washington","Skagit County",2,57,1696,823,873
050,53,057,"Washington","Skagit County",2,58,1773,852,921
050,53,057,"Washington","Skagit County",2,59,1838,901,937
050,53,057,"Washington","Skagit County",2,60,1846,915,931
050,53,057,"Washington","Skagit County",2,61,1837,883,954
050,53,057,"Washington","Skagit County",2,62,1844,876,968
050,53,057,"Washington","Skagit County",2,63,1856,876,980
050,53,057,"Washington","Skagit County",2,64,1845,878,967
050,53,057,"Washington","Skagit County",2,65,1896,902,994
050,53,057,"Washington","Skagit County",2,66,1905,912,993
050,53,057,"Washington","Skagit County",2,67,1856,880,976
050,53,057,"Washington","Skagit County",2,68,1807,856,951
050,53,057,"Washington","Skagit County",2,69,1738,833,905
050,53,057,"Washington","Skagit County",2,70,1661,797,864
050,53,057,"Washington","Skagit County",2,71,1632,784,848
050,53,057,"Washington","Skagit County",2,72,1586,762,824
050,53,057,"Washington","Skagit County",2,73,1717,833,884
050,53,057,"Washington","Skagit County",2,74,1227,575,652
050,53,057,"Washington","Skagit County",2,75,1193,555,638
050,53,057,"Washington","Skagit County",2,76,1148,544,604
050,53,057,"Washington","Skagit County",2,77,1151,531,620
050,53,057,"Washington","Skagit County",2,78,914,429,485
050,53,057,"Washington","Skagit County",2,79,785,382,403
050,53,057,"Washington","Skagit County",2,80,722,345,377
050,53,057,"Washington","Skagit County",2,81,668,325,343
050,53,057,"Washington","Skagit County",2,82,634,297,337
050,53,057,"Washington","Skagit County",2,83,539,238,301
050,53,057,"Washington","Skagit County",2,84,473,215,258
050,53,057,"Washington","Skagit County",2,85,2696,1108,1588
050,53,057,"Washington","Skagit County",3,0,1382,689,693
050,53,057,"Washington","Skagit County",3,1,1372,705,667
050,53,057,"Washington","Skagit County",3,2,1373,702,671
050,53,057,"Washington","Skagit County",3,3,1447,736,711
050,53,057,"Washington","Skagit County",3,4,1513,780,733
050,53,057,"Washington","Skagit County",3,5,1551,830,721
050,53,057,"Washington","Skagit County",3,6,1541,825,716
050,53,057,"Washington","Skagit County",3,7,1579,808,771
050,53,057,"Washington","Skagit County",3,8,1560,811,749
050,53,057,"Washington","Skagit County",3,9,1537,793,744
050,53,057,"Washington","Skagit County",3,10,1551,787,764
050,53,057,"Washington","Skagit County",3,11,1581,788,793
050,53,057,"Washington","Skagit County",3,12,1607,794,813
050,53,057,"Washington","Skagit County",3,13,1667,856,811
050,53,057,"Washington","Skagit County",3,14,1648,846,802
050,53,057,"Washington","Skagit County",3,15,1587,832,755
050,53,057,"Washington","Skagit County",3,16,1614,813,801
050,53,057,"Washington","Skagit County",3,17,1573,786,787
050,53,057,"Washington","Skagit County",3,18,1395,729,666
050,53,057,"Washington","Skagit County",3,19,1204,658,546
050,53,057,"Washington","Skagit County",3,20,1290,676,614
050,53,057,"Washington","Skagit County",3,21,1324,666,658
050,53,057,"Washington","Skagit County",3,22,1349,695,654
050,53,057,"Washington","Skagit County",3,23,1409,702,707
050,53,057,"Washington","Skagit County",3,24,1415,706,709
050,53,057,"Washington","Skagit County",3,25,1508,779,729
050,53,057,"Washington","Skagit County",3,26,1589,825,764
050,53,057,"Washington","Skagit County",3,27,1676,865,811
050,53,057,"Washington","Skagit County",3,28,1651,826,825
050,53,057,"Washington","Skagit County",3,29,1669,861,808
050,53,057,"Washington","Skagit County",3,30,1749,894,855
050,53,057,"Washington","Skagit County",3,31,1724,879,845
050,53,057,"Washington","Skagit County",3,32,1605,832,773
050,53,057,"Washington","Skagit County",3,33,1655,855,800
050,53,057,"Washington","Skagit County",3,34,1637,868,769
050,53,057,"Washington","Skagit County",3,35,1667,837,830
050,53,057,"Washington","Skagit County",3,36,1710,860,850
050,53,057,"Washington","Skagit County",3,37,1678,859,819
050,53,057,"Washington","Skagit County",3,38,1770,899,871
050,53,057,"Washington","Skagit County",3,39,1729,896,833
050,53,057,"Washington","Skagit County",3,40,1678,864,814
050,53,057,"Washington","Skagit County",3,41,1626,852,774
050,53,057,"Washington","Skagit County",3,42,1549,791,758
050,53,057,"Washington","Skagit County",3,43,1528,779,749
050,53,057,"Washington","Skagit County",3,44,1510,767,743
050,53,057,"Washington","Skagit County",3,45,1434,735,699
050,53,057,"Washington","Skagit County",3,46,1393,700,693
050,53,057,"Washington","Skagit County",3,47,1382,697,685
050,53,057,"Washington","Skagit County",3,48,1376,695,681
050,53,057,"Washington","Skagit County",3,49,1458,711,747
050,53,057,"Washington","Skagit County",3,50,1567,792,775
050,53,057,"Washington","Skagit County",3,51,1541,789,752
050,53,057,"Washington","Skagit County",3,52,1498,744,754
050,53,057,"Washington","Skagit County",3,53,1437,715,722
050,53,057,"Washington","Skagit County",3,54,1495,746,749
050,53,057,"Washington","Skagit County",3,55,1484,760,724
050,53,057,"Washington","Skagit County",3,56,1572,781,791
050,53,057,"Washington","Skagit County",3,57,1674,826,848
050,53,057,"Washington","Skagit County",3,58,1701,824,877
050,53,057,"Washington","Skagit County",3,59,1810,869,941
050,53,057,"Washington","Skagit County",3,60,1860,917,943
050,53,057,"Washington","Skagit County",3,61,1859,906,953
050,53,057,"Washington","Skagit County",3,62,1858,893,965
050,53,057,"Washington","Skagit County",3,63,1880,883,997
050,53,057,"Washington","Skagit County",3,64,1877,890,987
050,53,057,"Washington","Skagit County",3,65,1870,876,994
050,53,057,"Washington","Skagit County",3,66,1903,889,1014
050,53,057,"Washington","Skagit County",3,67,1913,916,997
050,53,057,"Washington","Skagit County",3,68,1860,887,973
050,53,057,"Washington","Skagit County",3,69,1792,853,939
050,53,057,"Washington","Skagit County",3,70,1725,827,898
050,53,057,"Washington","Skagit County",3,71,1633,779,854
050,53,057,"Washington","Skagit County",3,72,1642,778,864
050,53,057,"Washington","Skagit County",3,73,1559,750,809
050,53,057,"Washington","Skagit County",3,74,1685,807,878
050,53,057,"Washington","Skagit County",3,75,1187,552,635
050,53,057,"Washington","Skagit County",3,76,1164,553,611
050,53,057,"Washington","Skagit County",3,77,1123,532,591
050,53,057,"Washington","Skagit County",3,78,1096,503,593
050,53,057,"Washington","Skagit County",3,79,884,414,470
050,53,057,"Washington","Skagit County",3,80,751,365,386
050,53,057,"Washington","Skagit County",3,81,679,324,355
050,53,057,"Washington","Skagit County",3,82,628,301,327
050,53,057,"Washington","Skagit County",3,83,603,283,320
050,53,057,"Washington","Skagit County",3,84,506,218,288
050,53,057,"Washington","Skagit County",3,85,2669,1122,1547
050,53,057,"Washington","Skagit County",4,0,1403,711,692
050,53,057,"Washington","Skagit County",4,1,1352,679,673
050,53,057,"Washington","Skagit County",4,2,1359,705,654
050,53,057,"Washington","Skagit County",4,3,1361,697,664
050,53,057,"Washington","Skagit County",4,4,1430,708,722
050,53,057,"Washington","Skagit County",4,5,1512,785,727
050,53,057,"Washington","Skagit County",4,6,1535,816,719
050,53,057,"Washington","Skagit County",4,7,1535,812,723
050,53,057,"Washington","Skagit County",4,8,1554,791,763
050,53,057,"Washington","Skagit County",4,9,1544,816,728
050,53,057,"Washington","Skagit County",4,10,1523,790,733
050,53,057,"Washington","Skagit County",4,11,1567,790,777
050,53,057,"Washington","Skagit County",4,12,1580,790,790
050,53,057,"Washington","Skagit County",4,13,1618,802,816
050,53,057,"Washington","Skagit County",4,14,1700,863,837
050,53,057,"Washington","Skagit County",4,15,1635,838,797
050,53,057,"Washington","Skagit County",4,16,1583,832,751
050,53,057,"Washington","Skagit County",4,17,1640,816,824
050,53,057,"Washington","Skagit County",4,18,1407,729,678
050,53,057,"Washington","Skagit County",4,19,1200,644,556
050,53,057,"Washington","Skagit County",4,20,1238,659,579
050,53,057,"Washington","Skagit County",4,21,1277,685,592
050,53,057,"Washington","Skagit County",4,22,1317,656,661
050,53,057,"Washington","Skagit County",4,23,1392,720,672
050,53,057,"Washington","Skagit County",4,24,1419,716,703
050,53,057,"Washington","Skagit County",4,25,1405,711,694
050,53,057,"Washington","Skagit County",4,26,1538,799,739
050,53,057,"Washington","Skagit County",4,27,1597,833,764
050,53,057,"Washington","Skagit County",4,28,1658,854,804
050,53,057,"Washington","Skagit County",4,29,1662,833,829
050,53,057,"Washington","Skagit County",4,30,1713,889,824
050,53,057,"Washington","Skagit County",4,31,1747,890,857
050,53,057,"Washington","Skagit County",4,32,1713,867,846
050,53,057,"Washington","Skagit County",4,33,1627,844,783
050,53,057,"Washington","Skagit County",4,34,1686,870,816
050,53,057,"Washington","Skagit County",4,35,1670,891,779
050,53,057,"Washington","Skagit County",4,36,1653,837,816
050,53,057,"Washington","Skagit County",4,37,1729,862,867
050,53,057,"Washington","Skagit County",4,38,1696,877,819
050,53,057,"Washington","Skagit County",4,39,1760,895,865
050,53,057,"Washington","Skagit County",4,40,1765,890,875
050,53,057,"Washington","Skagit County",4,41,1686,856,830
050,53,057,"Washington","Skagit County",4,42,1626,859,767
050,53,057,"Washington","Skagit County",4,43,1548,775,773
050,53,057,"Washington","Skagit County",4,44,1530,782,748
050,53,057,"Washington","Skagit County",4,45,1530,774,756
050,53,057,"Washington","Skagit County",4,46,1432,728,704
050,53,057,"Washington","Skagit County",4,47,1386,697,689
050,53,057,"Washington","Skagit County",4,48,1399,703,696
050,53,057,"Washington","Skagit County",4,49,1373,693,680
050,53,057,"Washington","Skagit County",4,50,1473,724,749
050,53,057,"Washington","Skagit County",4,51,1556,775,781
050,53,057,"Washington","Skagit County",4,52,1573,800,773
050,53,057,"Washington","Skagit County",4,53,1488,733,755
050,53,057,"Washington","Skagit County",4,54,1458,708,750
050,53,057,"Washington","Skagit County",4,55,1494,751,743
050,53,057,"Washington","Skagit County",4,56,1500,767,733
050,53,057,"Washington","Skagit County",4,57,1566,779,787
050,53,057,"Washington","Skagit County",4,58,1688,840,848
050,53,057,"Washington","Skagit County",4,59,1725,836,889
050,53,057,"Washington","Skagit County",4,60,1810,872,938
050,53,057,"Washington","Skagit County",4,61,1873,915,958
050,53,057,"Washington","Skagit County",4,62,1866,893,973
050,53,057,"Washington","Skagit County",4,63,1846,896,950
050,53,057,"Washington","Skagit County",4,64,1887,884,1003
050,53,057,"Washington","Skagit County",4,65,1895,898,997
050,53,057,"Washington","Skagit County",4,66,1879,880,999
050,53,057,"Washington","Skagit County",4,67,1911,895,1016
050,53,057,"Washington","Skagit County",4,68,1871,895,976
050,53,057,"Washington","Skagit County",4,69,1862,878,984
050,53,057,"Washington","Skagit County",4,70,1772,847,925
050,53,057,"Washington","Skagit County",4,71,1710,812,898
050,53,057,"Washington","Skagit County",4,72,1610,761,849
050,53,057,"Washington","Skagit County",4,73,1602,762,840
050,53,057,"Washington","Skagit County",4,74,1518,720,798
050,53,057,"Washington","Skagit County",4,75,1649,787,862
050,53,057,"Washington","Skagit County",4,76,1161,532,629
050,53,057,"Washington","Skagit County",4,77,1123,535,588
050,53,057,"Washington","Skagit County",4,78,1054,499,555
050,53,057,"Washington","Skagit County",4,79,1060,486,574
050,53,057,"Washington","Skagit County",4,80,857,400,457
050,53,057,"Washington","Skagit County",4,81,715,342,373
050,53,057,"Washington","Skagit County",4,82,643,300,343
050,53,057,"Washington","Skagit County",4,83,587,280,307
050,53,057,"Washington","Skagit County",4,84,555,255,300
050,53,057,"Washington","Skagit County",4,85,2675,1130,1545
050,53,057,"Washington","Skagit County",5,0,1384,698,686
050,53,057,"Washington","Skagit County",5,1,1374,684,690
050,53,057,"Washington","Skagit County",5,2,1355,682,673
050,53,057,"Washington","Skagit County",5,3,1372,690,682
050,53,057,"Washington","Skagit County",5,4,1366,680,686
050,53,057,"Washington","Skagit County",5,5,1398,715,683
050,53,057,"Washington","Skagit County",5,6,1503,781,722
050,53,057,"Washington","Skagit County",5,7,1514,798,716
050,53,057,"Washington","Skagit County",5,8,1532,808,724
050,53,057,"Washington","Skagit County",5,9,1517,784,733
050,53,057,"Washington","Skagit County",5,10,1515,783,732
050,53,057,"Washington","Skagit County",5,11,1535,799,736
050,53,057,"Washington","Skagit County",5,12,1546,782,764
050,53,057,"Washington","Skagit County",5,13,1580,784,796
050,53,057,"Washington","Skagit County",5,14,1596,792,804
050,53,057,"Washington","Skagit County",5,15,1700,865,835
050,53,057,"Washington","Skagit County",5,16,1629,844,785
050,53,057,"Washington","Skagit County",5,17,1598,830,768
050,53,057,"Washington","Skagit County",5,18,1463,733,730
050,53,057,"Washington","Skagit County",5,19,1192,624,568
050,53,057,"Washington","Skagit County",5,20,1254,649,605
050,53,057,"Washington","Skagit County",5,21,1254,671,583
050,53,057,"Washington","Skagit County",5,22,1307,689,618
050,53,057,"Washington","Skagit County",5,23,1373,682,691
050,53,057,"Washington","Skagit County",5,24,1405,734,671
050,53,057,"Washington","Skagit County",5,25,1444,724,720
050,53,057,"Washington","Skagit County",5,26,1429,720,709
050,53,057,"Washington","Skagit County",5,27,1552,800,752
050,53,057,"Washington","Skagit County",5,28,1587,814,773
050,53,057,"Washington","Skagit County",5,29,1629,823,806
050,53,057,"Washington","Skagit County",5,30,1660,807,853
050,53,057,"Washington","Skagit County",5,31,1707,915,792
050,53,057,"Washington","Skagit County",5,32,1737,883,854
050,53,057,"Washington","Skagit County",5,33,1729,876,853
050,53,057,"Washington","Skagit County",5,34,1643,845,798
050,53,057,"Washington","Skagit County",5,35,1728,886,842
050,53,057,"Washington","Skagit County",5,36,1682,895,787
050,53,057,"Washington","Skagit County",5,37,1666,846,820
050,53,057,"Washington","Skagit County",5,38,1719,862,857
050,53,057,"Washington","Skagit County",5,39,1692,869,823
050,53,057,"Washington","Skagit County",5,40,1738,894,844
050,53,057,"Washington","Skagit County",5,41,1761,895,866
050,53,057,"Washington","Skagit County",5,42,1701,859,842
050,53,057,"Washington","Skagit County",5,43,1638,850,788
050,53,057,"Washington","Skagit County",5,44,1527,774,753
050,53,057,"Washington","Skagit County",5,45,1548,799,749
050,53,057,"Washington","Skagit County",5,46,1529,767,762
050,53,057,"Washington","Skagit County",5,47,1446,737,709
050,53,057,"Washington","Skagit County",5,48,1406,697,709
050,53,057,"Washington","Skagit County",5,49,1392,697,695
050,53,057,"Washington","Skagit County",5,50,1366,688,678
050,53,057,"Washington","Skagit County",5,51,1452,713,739
050,53,057,"Washington","Skagit County",5,52,1579,786,793
050,53,057,"Washington","Skagit County",5,53,1545,782,763
050,53,057,"Washington","Skagit County",5,54,1502,736,766
050,53,057,"Washington","Skagit County",5,55,1452,693,759
050,53,057,"Washington","Skagit County",5,56,1496,749,747
050,53,057,"Washington","Skagit County",5,57,1514,784,730
050,53,057,"Washington","Skagit County",5,58,1556,766,790
050,53,057,"Washington","Skagit County",5,59,1715,841,874
050,53,057,"Washington","Skagit County",5,60,1733,839,894
050,53,057,"Washington","Skagit County",5,61,1795,869,926
050,53,057,"Washington","Skagit County",5,62,1880,905,975
050,53,057,"Washington","Skagit County",5,63,1866,888,978
050,53,057,"Washington","Skagit County",5,64,1823,882,941
050,53,057,"Washington","Skagit County",5,65,1877,883,994
050,53,057,"Washington","Skagit County",5,66,1906,902,1004
050,53,057,"Washington","Skagit County",5,67,1898,893,1005
050,53,057,"Washington","Skagit County",5,68,1909,894,1015
050,53,057,"Washington","Skagit County",5,69,1856,880,976
050,53,057,"Washington","Skagit County",5,70,1849,875,974
050,53,057,"Washington","Skagit County",5,71,1750,834,916
050,53,057,"Washington","Skagit County",5,72,1712,809,903
050,53,057,"Washington","Skagit County",5,73,1573,751,822
050,53,057,"Washington","Skagit County",5,74,1581,749,832
050,53,057,"Washington","Skagit County",5,75,1469,696,773
050,53,057,"Washington","Skagit County",5,76,1592,757,835
050,53,057,"Washington","Skagit County",5,77,1112,507,605
050,53,057,"Washington","Skagit County",5,78,1070,503,567
050,53,057,"Washington","Skagit County",5,79,1024,483,541
050,53,057,"Washington","Skagit County",5,80,1024,471,553
050,53,057,"Washington","Skagit County",5,81,812,376,436
050,53,057,"Washington","Skagit County",5,82,680,315,365
050,53,057,"Washington","Skagit County",5,83,609,278,331
050,53,057,"Washington","Skagit County",5,84,533,250,283
050,53,057,"Washington","Skagit County",5,85,2755,1183,1572
050,53,059,"Washington","Skamania County",1,0,83,43,40
050,53,059,"Washington","Skamania County",1,1,87,44,43
050,53,059,"Washington","Skamania County",1,2,92,48,44
050,53,059,"Washington","Skamania County",1,3,99,57,42
050,53,059,"Washington","Skamania County",1,4,116,55,61
050,53,059,"Washington","Skamania County",1,5,106,46,60
050,53,059,"Washington","Skamania County",1,6,117,60,57
050,53,059,"Washington","Skamania County",1,7,120,61,59
050,53,059,"Washington","Skamania County",1,8,126,63,63
050,53,059,"Washington","Skamania County",1,9,115,57,58
050,53,059,"Washington","Skamania County",1,10,130,59,71
050,53,059,"Washington","Skamania County",1,11,127,70,57
050,53,059,"Washington","Skamania County",1,12,149,80,69
050,53,059,"Washington","Skamania County",1,13,139,75,64
050,53,059,"Washington","Skamania County",1,14,125,61,64
050,53,059,"Washington","Skamania County",1,15,119,60,59
050,53,059,"Washington","Skamania County",1,16,116,72,44
050,53,059,"Washington","Skamania County",1,17,143,80,63
050,53,059,"Washington","Skamania County",1,18,121,65,56
050,53,059,"Washington","Skamania County",1,19,106,55,51
050,53,059,"Washington","Skamania County",1,20,108,56,52
050,53,059,"Washington","Skamania County",1,21,105,60,45
050,53,059,"Washington","Skamania County",1,22,90,48,42
050,53,059,"Washington","Skamania County",1,23,96,52,44
050,53,059,"Washington","Skamania County",1,24,104,52,52
050,53,059,"Washington","Skamania County",1,25,103,56,47
050,53,059,"Washington","Skamania County",1,26,117,62,55
050,53,059,"Washington","Skamania County",1,27,121,58,63
050,53,059,"Washington","Skamania County",1,28,124,67,57
050,53,059,"Washington","Skamania County",1,29,112,57,55
050,53,059,"Washington","Skamania County",1,30,133,66,67
050,53,059,"Washington","Skamania County",1,31,124,67,57
050,53,059,"Washington","Skamania County",1,32,121,62,59
050,53,059,"Washington","Skamania County",1,33,146,70,76
050,53,059,"Washington","Skamania County",1,34,139,71,68
050,53,059,"Washington","Skamania County",1,35,136,70,66
050,53,059,"Washington","Skamania County",1,36,134,63,71
050,53,059,"Washington","Skamania County",1,37,139,71,68
050,53,059,"Washington","Skamania County",1,38,147,73,74
050,53,059,"Washington","Skamania County",1,39,153,76,77
050,53,059,"Washington","Skamania County",1,40,159,86,73
050,53,059,"Washington","Skamania County",1,41,147,67,80
050,53,059,"Washington","Skamania County",1,42,161,84,77
050,53,059,"Washington","Skamania County",1,43,153,72,81
050,53,059,"Washington","Skamania County",1,44,142,74,68
050,53,059,"Washington","Skamania County",1,45,139,78,61
050,53,059,"Washington","Skamania County",1,46,152,81,71
050,53,059,"Washington","Skamania County",1,47,151,73,78
050,53,059,"Washington","Skamania County",1,48,141,74,67
050,53,059,"Washington","Skamania County",1,49,185,86,99
050,53,059,"Washington","Skamania County",1,50,169,94,75
050,53,059,"Washington","Skamania County",1,51,169,86,83
050,53,059,"Washington","Skamania County",1,52,156,77,79
050,53,059,"Washington","Skamania County",1,53,155,79,76
050,53,059,"Washington","Skamania County",1,54,179,88,91
050,53,059,"Washington","Skamania County",1,55,178,91,87
050,53,059,"Washington","Skamania County",1,56,211,108,103
050,53,059,"Washington","Skamania County",1,57,214,121,93
050,53,059,"Washington","Skamania County",1,58,222,123,99
050,53,059,"Washington","Skamania County",1,59,223,122,101
050,53,059,"Washington","Skamania County",1,60,224,109,115
050,53,059,"Washington","Skamania County",1,61,212,99,113
050,53,059,"Washington","Skamania County",1,62,204,99,105
050,53,059,"Washington","Skamania County",1,63,224,107,117
050,53,059,"Washington","Skamania County",1,64,234,115,119
050,53,059,"Washington","Skamania County",1,65,237,116,121
050,53,059,"Washington","Skamania County",1,66,235,122,113
050,53,059,"Washington","Skamania County",1,67,191,104,87
050,53,059,"Washington","Skamania County",1,68,197,109,88
050,53,059,"Washington","Skamania County",1,69,160,81,79
050,53,059,"Washington","Skamania County",1,70,162,87,75
050,53,059,"Washington","Skamania County",1,71,158,83,75
050,53,059,"Washington","Skamania County",1,72,173,84,89
050,53,059,"Washington","Skamania County",1,73,139,84,55
050,53,059,"Washington","Skamania County",1,74,99,59,40
050,53,059,"Washington","Skamania County",1,75,119,70,49
050,53,059,"Washington","Skamania County",1,76,101,49,52
050,53,059,"Washington","Skamania County",1,77,96,44,52
050,53,059,"Washington","Skamania County",1,78,85,39,46
050,53,059,"Washington","Skamania County",1,79,69,37,32
050,53,059,"Washington","Skamania County",1,80,54,26,28
050,53,059,"Washington","Skamania County",1,81,49,28,21
050,53,059,"Washington","Skamania County",1,82,45,21,24
050,53,059,"Washington","Skamania County",1,83,40,20,20
050,53,059,"Washington","Skamania County",1,84,45,24,21
050,53,059,"Washington","Skamania County",1,85,287,118,169
050,53,059,"Washington","Skamania County",2,0,88,48,40
050,53,059,"Washington","Skamania County",2,1,85,44,41
050,53,059,"Washington","Skamania County",2,2,90,47,43
050,53,059,"Washington","Skamania County",2,3,96,54,42
050,53,059,"Washington","Skamania County",2,4,114,56,58
050,53,059,"Washington","Skamania County",2,5,108,47,61
050,53,059,"Washington","Skamania County",2,6,114,56,58
050,53,059,"Washington","Skamania County",2,7,119,61,58
050,53,059,"Washington","Skamania County",2,8,125,63,62
050,53,059,"Washington","Skamania County",2,9,117,57,60
050,53,059,"Washington","Skamania County",2,10,127,58,69
050,53,059,"Washington","Skamania County",2,11,127,68,59
050,53,059,"Washington","Skamania County",2,12,145,79,66
050,53,059,"Washington","Skamania County",2,13,140,76,64
050,53,059,"Washington","Skamania County",2,14,126,62,64
050,53,059,"Washington","Skamania County",2,15,119,61,58
050,53,059,"Washington","Skamania County",2,16,115,68,47
050,53,059,"Washington","Skamania County",2,17,136,78,58
050,53,059,"Washington","Skamania County",2,18,120,65,55
050,53,059,"Washington","Skamania County",2,19,103,53,50
050,53,059,"Washington","Skamania County",2,20,108,56,52
050,53,059,"Washington","Skamania County",2,21,103,57,46
050,53,059,"Washington","Skamania County",2,22,92,51,41
050,53,059,"Washington","Skamania County",2,23,96,52,44
050,53,059,"Washington","Skamania County",2,24,103,52,51
050,53,059,"Washington","Skamania County",2,25,102,54,48
050,53,059,"Washington","Skamania County",2,26,114,61,53
050,53,059,"Washington","Skamania County",2,27,119,59,60
050,53,059,"Washington","Skamania County",2,28,122,64,58
050,53,059,"Washington","Skamania County",2,29,119,61,58
050,53,059,"Washington","Skamania County",2,30,131,65,66
050,53,059,"Washington","Skamania County",2,31,124,67,57
050,53,059,"Washington","Skamania County",2,32,121,64,57
050,53,059,"Washington","Skamania County",2,33,142,70,72
050,53,059,"Washington","Skamania County",2,34,141,71,70
050,53,059,"Washington","Skamania County",2,35,137,70,67
050,53,059,"Washington","Skamania County",2,36,134,65,69
050,53,059,"Washington","Skamania County",2,37,138,69,69
050,53,059,"Washington","Skamania County",2,38,145,72,73
050,53,059,"Washington","Skamania County",2,39,153,76,77
050,53,059,"Washington","Skamania County",2,40,160,84,76
050,53,059,"Washington","Skamania County",2,41,149,71,78
050,53,059,"Washington","Skamania County",2,42,158,80,78
050,53,059,"Washington","Skamania County",2,43,156,76,80
050,53,059,"Washington","Skamania County",2,44,140,71,69
050,53,059,"Washington","Skamania County",2,45,144,79,65
050,53,059,"Washington","Skamania County",2,46,149,79,70
050,53,059,"Washington","Skamania County",2,47,151,74,77
050,53,059,"Washington","Skamania County",2,48,144,74,70
050,53,059,"Washington","Skamania County",2,49,175,83,92
050,53,059,"Washington","Skamania County",2,50,176,92,84
050,53,059,"Washington","Skamania County",2,51,168,89,79
050,53,059,"Washington","Skamania County",2,52,159,79,80
050,53,059,"Washington","Skamania County",2,53,155,78,77
050,53,059,"Washington","Skamania County",2,54,173,86,87
050,53,059,"Washington","Skamania County",2,55,177,91,86
050,53,059,"Washington","Skamania County",2,56,204,105,99
050,53,059,"Washington","Skamania County",2,57,213,119,94
050,53,059,"Washington","Skamania County",2,58,219,122,97
050,53,059,"Washington","Skamania County",2,59,225,122,103
050,53,059,"Washington","Skamania County",2,60,227,115,112
050,53,059,"Washington","Skamania County",2,61,214,101,113
050,53,059,"Washington","Skamania County",2,62,206,98,108
050,53,059,"Washington","Skamania County",2,63,219,105,114
050,53,059,"Washington","Skamania County",2,64,229,112,117
050,53,059,"Washington","Skamania County",2,65,237,116,121
050,53,059,"Washington","Skamania County",2,66,240,122,118
050,53,059,"Washington","Skamania County",2,67,203,109,94
050,53,059,"Washington","Skamania County",2,68,195,107,88
050,53,059,"Washington","Skamania County",2,69,170,88,82
050,53,059,"Washington","Skamania County",2,70,163,85,78
050,53,059,"Washington","Skamania County",2,71,159,83,76
050,53,059,"Washington","Skamania County",2,72,166,82,84
050,53,059,"Washington","Skamania County",2,73,156,89,67
050,53,059,"Washington","Skamania County",2,74,103,61,42
050,53,059,"Washington","Skamania County",2,75,114,67,47
050,53,059,"Washington","Skamania County",2,76,104,54,50
050,53,059,"Washington","Skamania County",2,77,99,46,53
050,53,059,"Washington","Skamania County",2,78,86,40,46
050,53,059,"Washington","Skamania County",2,79,71,37,34
050,53,059,"Washington","Skamania County",2,80,58,28,30
050,53,059,"Washington","Skamania County",2,81,49,27,22
050,53,059,"Washington","Skamania County",2,82,45,22,23
050,53,059,"Washington","Skamania County",2,83,40,19,21
050,53,059,"Washington","Skamania County",2,84,42,23,19
050,53,059,"Washington","Skamania County",2,85,293,123,170
050,53,059,"Washington","Skamania County",3,0,94,49,45
050,53,059,"Washington","Skamania County",3,1,93,43,50
050,53,059,"Washington","Skamania County",3,2,91,52,39
050,53,059,"Washington","Skamania County",3,3,84,40,44
050,53,059,"Washington","Skamania County",3,4,97,54,43
050,53,059,"Washington","Skamania County",3,5,115,58,57
050,53,059,"Washington","Skamania County",3,6,108,45,63
050,53,059,"Washington","Skamania County",3,7,117,57,60
050,53,059,"Washington","Skamania County",3,8,121,64,57
050,53,059,"Washington","Skamania County",3,9,121,60,61
050,53,059,"Washington","Skamania County",3,10,118,57,61
050,53,059,"Washington","Skamania County",3,11,132,63,69
050,53,059,"Washington","Skamania County",3,12,128,69,59
050,53,059,"Washington","Skamania County",3,13,144,83,61
050,53,059,"Washington","Skamania County",3,14,138,76,62
050,53,059,"Washington","Skamania County",3,15,117,60,57
050,53,059,"Washington","Skamania County",3,16,122,65,57
050,53,059,"Washington","Skamania County",3,17,130,74,56
050,53,059,"Washington","Skamania County",3,18,130,75,55
050,53,059,"Washington","Skamania County",3,19,107,59,48
050,53,059,"Washington","Skamania County",3,20,115,60,55
050,53,059,"Washington","Skamania County",3,21,112,57,55
050,53,059,"Washington","Skamania County",3,22,105,61,44
050,53,059,"Washington","Skamania County",3,23,93,49,44
050,53,059,"Washington","Skamania County",3,24,94,48,46
050,53,059,"Washington","Skamania County",3,25,108,56,52
050,53,059,"Washington","Skamania County",3,26,101,56,45
050,53,059,"Washington","Skamania County",3,27,112,62,50
050,53,059,"Washington","Skamania County",3,28,127,68,59
050,53,059,"Washington","Skamania County",3,29,124,71,53
050,53,059,"Washington","Skamania County",3,30,130,67,63
050,53,059,"Washington","Skamania County",3,31,152,81,71
050,53,059,"Washington","Skamania County",3,32,131,69,62
050,53,059,"Washington","Skamania County",3,33,129,71,58
050,53,059,"Washington","Skamania County",3,34,142,73,69
050,53,059,"Washington","Skamania County",3,35,145,69,76
050,53,059,"Washington","Skamania County",3,36,151,75,76
050,53,059,"Washington","Skamania County",3,37,143,69,74
050,53,059,"Washington","Skamania County",3,38,129,62,67
050,53,059,"Washington","Skamania County",3,39,142,71,71
050,53,059,"Washington","Skamania County",3,40,153,81,72
050,53,059,"Washington","Skamania County",3,41,168,83,85
050,53,059,"Washington","Skamania County",3,42,152,78,74
050,53,059,"Washington","Skamania County",3,43,172,86,86
050,53,059,"Washington","Skamania County",3,44,153,74,79
050,53,059,"Washington","Skamania County",3,45,149,78,71
050,53,059,"Washington","Skamania County",3,46,150,85,65
050,53,059,"Washington","Skamania County",3,47,146,78,68
050,53,059,"Washington","Skamania County",3,48,157,74,83
050,53,059,"Washington","Skamania County",3,49,141,74,67
050,53,059,"Washington","Skamania County",3,50,172,80,92
050,53,059,"Washington","Skamania County",3,51,186,102,84
050,53,059,"Washington","Skamania County",3,52,169,86,83
050,53,059,"Washington","Skamania County",3,53,163,81,82
050,53,059,"Washington","Skamania County",3,54,162,83,79
050,53,059,"Washington","Skamania County",3,55,177,90,87
050,53,059,"Washington","Skamania County",3,56,166,81,85
050,53,059,"Washington","Skamania County",3,57,202,102,100
050,53,059,"Washington","Skamania County",3,58,210,117,93
050,53,059,"Washington","Skamania County",3,59,224,127,97
050,53,059,"Washington","Skamania County",3,60,228,124,104
050,53,059,"Washington","Skamania County",3,61,217,108,109
050,53,059,"Washington","Skamania County",3,62,214,99,115
050,53,059,"Washington","Skamania County",3,63,213,102,111
050,53,059,"Washington","Skamania County",3,64,221,110,111
050,53,059,"Washington","Skamania County",3,65,223,110,113
050,53,059,"Washington","Skamania County",3,66,243,121,122
050,53,059,"Washington","Skamania County",3,67,235,122,113
050,53,059,"Washington","Skamania County",3,68,205,105,100
050,53,059,"Washington","Skamania County",3,69,194,106,88
050,53,059,"Washington","Skamania County",3,70,171,89,82
050,53,059,"Washington","Skamania County",3,71,161,88,73
050,53,059,"Washington","Skamania County",3,72,159,85,74
050,53,059,"Washington","Skamania County",3,73,164,84,80
050,53,059,"Washington","Skamania County",3,74,152,83,69
050,53,059,"Washington","Skamania County",3,75,97,57,40
050,53,059,"Washington","Skamania County",3,76,112,67,45
050,53,059,"Washington","Skamania County",3,77,101,54,47
050,53,059,"Washington","Skamania County",3,78,95,45,50
050,53,059,"Washington","Skamania County",3,79,81,38,43
050,53,059,"Washington","Skamania County",3,80,70,36,34
050,53,059,"Washington","Skamania County",3,81,59,28,31
050,53,059,"Washington","Skamania County",3,82,43,23,20
050,53,059,"Washington","Skamania County",3,83,41,20,21
050,53,059,"Washington","Skamania County",3,84,40,20,20
050,53,059,"Washington","Skamania County",3,85,306,129,177
050,53,059,"Washington","Skamania County",4,0,94,45,49
050,53,059,"Washington","Skamania County",4,1,101,50,51
050,53,059,"Washington","Skamania County",4,2,93,42,51
050,53,059,"Washington","Skamania County",4,3,94,51,43
050,53,059,"Washington","Skamania County",4,4,96,46,50
050,53,059,"Washington","Skamania County",4,5,108,59,49
050,53,059,"Washington","Skamania County",4,6,114,57,57
050,53,059,"Washington","Skamania County",4,7,113,48,65
050,53,059,"Washington","Skamania County",4,8,120,61,59
050,53,059,"Washington","Skamania County",4,9,118,62,56
050,53,059,"Washington","Skamania County",4,10,132,63,69
050,53,059,"Washington","Skamania County",4,11,122,60,62
050,53,059,"Washington","Skamania County",4,12,141,71,70
050,53,059,"Washington","Skamania County",4,13,125,69,56
050,53,059,"Washington","Skamania County",4,14,139,76,63
050,53,059,"Washington","Skamania County",4,15,144,76,68
050,53,059,"Washington","Skamania County",4,16,124,66,58
050,53,059,"Washington","Skamania County",4,17,128,64,64
050,53,059,"Washington","Skamania County",4,18,108,62,46
050,53,059,"Washington","Skamania County",4,19,98,58,40
050,53,059,"Washington","Skamania County",4,20,106,58,48
050,53,059,"Washington","Skamania County",4,21,106,55,51
050,53,059,"Washington","Skamania County",4,22,122,64,58
050,53,059,"Washington","Skamania County",4,23,119,65,54
050,53,059,"Washington","Skamania County",4,24,91,45,46
050,53,059,"Washington","Skamania County",4,25,97,52,45
050,53,059,"Washington","Skamania County",4,26,108,57,51
050,53,059,"Washington","Skamania County",4,27,101,56,45
050,53,059,"Washington","Skamania County",4,28,119,63,56
050,53,059,"Washington","Skamania County",4,29,133,67,66
050,53,059,"Washington","Skamania County",4,30,111,60,51
050,53,059,"Washington","Skamania County",4,31,135,71,64
050,53,059,"Washington","Skamania County",4,32,153,78,75
050,53,059,"Washington","Skamania County",4,33,137,68,69
050,53,059,"Washington","Skamania County",4,34,141,82,59
050,53,059,"Washington","Skamania County",4,35,138,68,70
050,53,059,"Washington","Skamania County",4,36,155,74,81
050,53,059,"Washington","Skamania County",4,37,153,81,72
050,53,059,"Washington","Skamania County",4,38,147,64,83
050,53,059,"Washington","Skamania County",4,39,139,64,75
050,53,059,"Washington","Skamania County",4,40,162,84,78
050,53,059,"Washington","Skamania County",4,41,156,85,71
050,53,059,"Washington","Skamania County",4,42,162,79,83
050,53,059,"Washington","Skamania County",4,43,164,84,80
050,53,059,"Washington","Skamania County",4,44,181,89,92
050,53,059,"Washington","Skamania County",4,45,168,79,89
050,53,059,"Washington","Skamania County",4,46,154,81,73
050,53,059,"Washington","Skamania County",4,47,150,84,66
050,53,059,"Washington","Skamania County",4,48,153,80,73
050,53,059,"Washington","Skamania County",4,49,163,83,80
050,53,059,"Washington","Skamania County",4,50,138,70,68
050,53,059,"Washington","Skamania County",4,51,171,79,92
050,53,059,"Washington","Skamania County",4,52,190,104,86
050,53,059,"Washington","Skamania County",4,53,168,90,78
050,53,059,"Washington","Skamania County",4,54,178,83,95
050,53,059,"Washington","Skamania County",4,55,176,93,83
050,53,059,"Washington","Skamania County",4,56,177,90,87
050,53,059,"Washington","Skamania County",4,57,163,79,84
050,53,059,"Washington","Skamania County",4,58,204,104,100
050,53,059,"Washington","Skamania County",4,59,217,118,99
050,53,059,"Washington","Skamania County",4,60,232,133,99
050,53,059,"Washington","Skamania County",4,61,237,130,107
050,53,059,"Washington","Skamania County",4,62,216,103,113
050,53,059,"Washington","Skamania County",4,63,218,106,112
050,53,059,"Washington","Skamania County",4,64,221,104,117
050,53,059,"Washington","Skamania County",4,65,219,109,110
050,53,059,"Washington","Skamania County",4,66,227,107,120
050,53,059,"Washington","Skamania County",4,67,246,122,124
050,53,059,"Washington","Skamania County",4,68,236,121,115
050,53,059,"Washington","Skamania County",4,69,207,108,99
050,53,059,"Washington","Skamania County",4,70,190,107,83
050,53,059,"Washington","Skamania County",4,71,159,86,73
050,53,059,"Washington","Skamania County",4,72,160,87,73
050,53,059,"Washington","Skamania County",4,73,155,80,75
050,53,059,"Washington","Skamania County",4,74,165,82,83
050,53,059,"Washington","Skamania County",4,75,153,83,70
050,53,059,"Washington","Skamania County",4,76,96,55,41
050,53,059,"Washington","Skamania County",4,77,114,69,45
050,53,059,"Washington","Skamania County",4,78,96,50,46
050,53,059,"Washington","Skamania County",4,79,100,48,52
050,53,059,"Washington","Skamania County",4,80,81,37,44
050,53,059,"Washington","Skamania County",4,81,72,37,35
050,53,059,"Washington","Skamania County",4,82,51,25,26
050,53,059,"Washington","Skamania County",4,83,42,22,20
050,53,059,"Washington","Skamania County",4,84,42,20,22
050,53,059,"Washington","Skamania County",4,85,302,130,172
050,53,059,"Washington","Skamania County",5,0,88,44,44
050,53,059,"Washington","Skamania County",5,1,97,52,45
050,53,059,"Washington","Skamania County",5,2,94,47,47
050,53,059,"Washington","Skamania County",5,3,95,43,52
050,53,059,"Washington","Skamania County",5,4,96,54,42
050,53,059,"Washington","Skamania County",5,5,97,42,55
050,53,059,"Washington","Skamania County",5,6,115,64,51
050,53,059,"Washington","Skamania County",5,7,113,55,58
050,53,059,"Washington","Skamania County",5,8,118,52,66
050,53,059,"Washington","Skamania County",5,9,127,67,60
050,53,059,"Washington","Skamania County",5,10,124,72,52
050,53,059,"Washington","Skamania County",5,11,139,66,73
050,53,059,"Washington","Skamania County",5,12,115,56,59
050,53,059,"Washington","Skamania County",5,13,141,70,71
050,53,059,"Washington","Skamania County",5,14,126,69,57
050,53,059,"Washington","Skamania County",5,15,150,79,71
050,53,059,"Washington","Skamania County",5,16,147,79,68
050,53,059,"Washington","Skamania County",5,17,123,64,59
050,53,059,"Washington","Skamania County",5,18,116,61,55
050,53,059,"Washington","Skamania County",5,19,86,45,41
050,53,059,"Washington","Skamania County",5,20,103,60,43
050,53,059,"Washington","Skamania County",5,21,106,54,52
050,53,059,"Washington","Skamania County",5,22,112,55,57
050,53,059,"Washington","Skamania County",5,23,133,64,69
050,53,059,"Washington","Skamania County",5,24,113,61,52
050,53,059,"Washington","Skamania County",5,25,103,53,50
050,53,059,"Washington","Skamania County",5,26,103,57,46
050,53,059,"Washington","Skamania County",5,27,113,61,52
050,53,059,"Washington","Skamania County",5,28,111,54,57
050,53,059,"Washington","Skamania County",5,29,125,66,59
050,53,059,"Washington","Skamania County",5,30,137,72,65
050,53,059,"Washington","Skamania County",5,31,125,63,62
050,53,059,"Washington","Skamania County",5,32,134,73,61
050,53,059,"Washington","Skamania County",5,33,159,76,83
050,53,059,"Washington","Skamania County",5,34,151,80,71
050,53,059,"Washington","Skamania County",5,35,145,79,66
050,53,059,"Washington","Skamania County",5,36,148,71,77
050,53,059,"Washington","Skamania County",5,37,173,86,87
050,53,059,"Washington","Skamania County",5,38,155,85,70
050,53,059,"Washington","Skamania County",5,39,155,73,82
050,53,059,"Washington","Skamania County",5,40,156,74,82
050,53,059,"Washington","Skamania County",5,41,161,87,74
050,53,059,"Washington","Skamania County",5,42,163,89,74
050,53,059,"Washington","Skamania County",5,43,161,77,84
050,53,059,"Washington","Skamania County",5,44,167,88,79
050,53,059,"Washington","Skamania County",5,45,180,86,94
050,53,059,"Washington","Skamania County",5,46,166,76,90
050,53,059,"Washington","Skamania County",5,47,156,84,72
050,53,059,"Washington","Skamania County",5,48,165,91,74
050,53,059,"Washington","Skamania County",5,49,156,79,77
050,53,059,"Washington","Skamania County",5,50,167,86,81
050,53,059,"Washington","Skamania County",5,51,146,75,71
050,53,059,"Washington","Skamania County",5,52,172,79,93
050,53,059,"Washington","Skamania County",5,53,187,98,89
050,53,059,"Washington","Skamania County",5,54,183,99,84
050,53,059,"Washington","Skamania County",5,55,175,81,94
050,53,059,"Washington","Skamania County",5,56,167,89,78
050,53,059,"Washington","Skamania County",5,57,174,90,84
050,53,059,"Washington","Skamania County",5,58,163,79,84
050,53,059,"Washington","Skamania County",5,59,205,100,105
050,53,059,"Washington","Skamania County",5,60,217,121,96
050,53,059,"Washington","Skamania County",5,61,228,134,94
050,53,059,"Washington","Skamania County",5,62,226,123,103
050,53,059,"Washington","Skamania County",5,63,220,110,110
050,53,059,"Washington","Skamania County",5,64,210,100,110
050,53,059,"Washington","Skamania County",5,65,223,106,117
050,53,059,"Washington","Skamania County",5,66,223,111,112
050,53,059,"Washington","Skamania County",5,67,226,104,122
050,53,059,"Washington","Skamania County",5,68,252,123,129
050,53,059,"Washington","Skamania County",5,69,230,121,109
050,53,059,"Washington","Skamania County",5,70,201,106,95
050,53,059,"Washington","Skamania County",5,71,189,104,85
050,53,059,"Washington","Skamania County",5,72,158,84,74
050,53,059,"Washington","Skamania County",5,73,155,87,68
050,53,059,"Washington","Skamania County",5,74,147,77,70
050,53,059,"Washington","Skamania County",5,75,166,82,84
050,53,059,"Washington","Skamania County",5,76,148,79,69
050,53,059,"Washington","Skamania County",5,77,98,58,40
050,53,059,"Washington","Skamania County",5,78,107,65,42
050,53,059,"Washington","Skamania County",5,79,94,49,45
050,53,059,"Washington","Skamania County",5,80,103,51,52
050,53,059,"Washington","Skamania County",5,81,83,39,44
050,53,059,"Washington","Skamania County",5,82,66,35,31
050,53,059,"Washington","Skamania County",5,83,49,24,25
050,53,059,"Washington","Skamania County",5,84,38,21,17
050,53,059,"Washington","Skamania County",5,85,302,131,171
050,53,061,"Washington","Snohomish County",1,0,9807,5015,4792
050,53,061,"Washington","Snohomish County",1,1,9951,5049,4902
050,53,061,"Washington","Snohomish County",1,2,10303,5246,5057
050,53,061,"Washington","Snohomish County",1,3,10625,5416,5209
050,53,061,"Washington","Snohomish County",1,4,10816,5594,5222
050,53,061,"Washington","Snohomish County",1,5,10703,5476,5227
050,53,061,"Washington","Snohomish County",1,6,10376,5341,5035
050,53,061,"Washington","Snohomish County",1,7,10383,5340,5043
050,53,061,"Washington","Snohomish County",1,8,10133,5208,4925
050,53,061,"Washington","Snohomish County",1,9,10222,5272,4950
050,53,061,"Washington","Snohomish County",1,10,10600,5495,5105
050,53,061,"Washington","Snohomish County",1,11,10931,5699,5232
050,53,061,"Washington","Snohomish County",1,12,11141,5667,5474
050,53,061,"Washington","Snohomish County",1,13,10775,5539,5236
050,53,061,"Washington","Snohomish County",1,14,10415,5394,5021
050,53,061,"Washington","Snohomish County",1,15,10341,5382,4959
050,53,061,"Washington","Snohomish County",1,16,10546,5372,5174
050,53,061,"Washington","Snohomish County",1,17,10272,5194,5078
050,53,061,"Washington","Snohomish County",1,18,8762,4563,4199
050,53,061,"Washington","Snohomish County",1,19,7577,3994,3583
050,53,061,"Washington","Snohomish County",1,20,8028,4162,3866
050,53,061,"Washington","Snohomish County",1,21,8373,4316,4057
050,53,061,"Washington","Snohomish County",1,22,8814,4493,4321
050,53,061,"Washington","Snohomish County",1,23,9443,4827,4616
050,53,061,"Washington","Snohomish County",1,24,9910,5126,4784
050,53,061,"Washington","Snohomish County",1,25,10307,5347,4960
050,53,061,"Washington","Snohomish County",1,26,10751,5468,5283
050,53,061,"Washington","Snohomish County",1,27,11325,5790,5535
050,53,061,"Washington","Snohomish County",1,28,11916,6102,5814
050,53,061,"Washington","Snohomish County",1,29,12614,6452,6162
050,53,061,"Washington","Snohomish County",1,30,12963,6567,6396
050,53,061,"Washington","Snohomish County",1,31,12979,6538,6441
050,53,061,"Washington","Snohomish County",1,32,12778,6487,6291
050,53,061,"Washington","Snohomish County",1,33,12910,6669,6241
050,53,061,"Washington","Snohomish County",1,34,13414,6905,6509
050,53,061,"Washington","Snohomish County",1,35,13458,6864,6594
050,53,061,"Washington","Snohomish County",1,36,13419,6909,6510
050,53,061,"Washington","Snohomish County",1,37,13378,6920,6458
050,53,061,"Washington","Snohomish County",1,38,13236,6840,6396
050,53,061,"Washington","Snohomish County",1,39,12974,6825,6149
050,53,061,"Washington","Snohomish County",1,40,12338,6464,5874
050,53,061,"Washington","Snohomish County",1,41,11638,6048,5590
050,53,061,"Washington","Snohomish County",1,42,11442,5901,5541
050,53,061,"Washington","Snohomish County",1,43,10954,5656,5298
050,53,061,"Washington","Snohomish County",1,44,10581,5446,5135
050,53,061,"Washington","Snohomish County",1,45,10531,5412,5119
050,53,061,"Washington","Snohomish County",1,46,10234,5301,4933
050,53,061,"Washington","Snohomish County",1,47,10258,5195,5063
050,53,061,"Washington","Snohomish County",1,48,10967,5650,5317
050,53,061,"Washington","Snohomish County",1,49,11835,6094,5741
050,53,061,"Washington","Snohomish County",1,50,11590,5952,5638
050,53,061,"Washington","Snohomish County",1,51,11142,5788,5354
050,53,061,"Washington","Snohomish County",1,52,10659,5554,5105
050,53,061,"Washington","Snohomish County",1,53,10671,5462,5209
050,53,061,"Washington","Snohomish County",1,54,10682,5419,5263
050,53,061,"Washington","Snohomish County",1,55,11173,5687,5486
050,53,061,"Washington","Snohomish County",1,56,11599,5901,5698
050,53,061,"Washington","Snohomish County",1,57,11836,6042,5794
050,53,061,"Washington","Snohomish County",1,58,11674,5960,5714
050,53,061,"Washington","Snohomish County",1,59,11366,5737,5629
050,53,061,"Washington","Snohomish County",1,60,11017,5503,5514
050,53,061,"Washington","Snohomish County",1,61,10973,5507,5466
050,53,061,"Washington","Snohomish County",1,62,10811,5406,5405
050,53,061,"Washington","Snohomish County",1,63,10124,5071,5053
050,53,061,"Washington","Snohomish County",1,64,9826,4856,4970
050,53,061,"Washington","Snohomish County",1,65,9500,4647,4853
050,53,061,"Washington","Snohomish County",1,66,8855,4286,4569
050,53,061,"Washington","Snohomish County",1,67,8618,4155,4463
050,53,061,"Washington","Snohomish County",1,68,7951,3740,4211
050,53,061,"Washington","Snohomish County",1,69,7067,3268,3799
050,53,061,"Washington","Snohomish County",1,70,6864,3249,3615
050,53,061,"Washington","Snohomish County",1,71,6642,3100,3542
050,53,061,"Washington","Snohomish County",1,72,6564,3010,3554
050,53,061,"Washington","Snohomish County",1,73,6475,3038,3437
050,53,061,"Washington","Snohomish County",1,74,4498,2065,2433
050,53,061,"Washington","Snohomish County",1,75,4414,2013,2401
050,53,061,"Washington","Snohomish County",1,76,4209,1921,2288
050,53,061,"Washington","Snohomish County",1,77,3944,1824,2120
050,53,061,"Washington","Snohomish County",1,78,3335,1535,1800
050,53,061,"Washington","Snohomish County",1,79,2999,1316,1683
050,53,061,"Washington","Snohomish County",1,80,2706,1177,1529
050,53,061,"Washington","Snohomish County",1,81,2539,1119,1420
050,53,061,"Washington","Snohomish County",1,82,2261,957,1304
050,53,061,"Washington","Snohomish County",1,83,2030,806,1224
050,53,061,"Washington","Snohomish County",1,84,1819,729,1090
050,53,061,"Washington","Snohomish County",1,85,11073,3915,7158
050,53,061,"Washington","Snohomish County",2,0,9790,5005,4785
050,53,061,"Washington","Snohomish County",2,1,9928,5043,4885
050,53,061,"Washington","Snohomish County",2,2,10253,5221,5032
050,53,061,"Washington","Snohomish County",2,3,10519,5363,5156
050,53,061,"Washington","Snohomish County",2,4,10795,5565,5230
050,53,061,"Washington","Snohomish County",2,5,10746,5512,5234
050,53,061,"Washington","Snohomish County",2,6,10475,5394,5081
050,53,061,"Washington","Snohomish County",2,7,10371,5342,5029
050,53,061,"Washington","Snohomish County",2,8,10163,5217,4946
050,53,061,"Washington","Snohomish County",2,9,10201,5257,4944
050,53,061,"Washington","Snohomish County",2,10,10526,5445,5081
050,53,061,"Washington","Snohomish County",2,11,10812,5626,5186
050,53,061,"Washington","Snohomish County",2,12,11131,5699,5432
050,53,061,"Washington","Snohomish County",2,13,10847,5565,5282
050,53,061,"Washington","Snohomish County",2,14,10502,5432,5070
050,53,061,"Washington","Snohomish County",2,15,10380,5388,4992
050,53,061,"Washington","Snohomish County",2,16,10525,5394,5131
050,53,061,"Washington","Snohomish County",2,17,10362,5247,5115
050,53,061,"Washington","Snohomish County",2,18,8766,4558,4208
050,53,061,"Washington","Snohomish County",2,19,7592,3992,3600
050,53,061,"Washington","Snohomish County",2,20,8128,4220,3908
050,53,061,"Washington","Snohomish County",2,21,8406,4345,4061
050,53,061,"Washington","Snohomish County",2,22,8832,4507,4325
050,53,061,"Washington","Snohomish County",2,23,9448,4823,4625
050,53,061,"Washington","Snohomish County",2,24,9867,5092,4775
050,53,061,"Washington","Snohomish County",2,25,10286,5333,4953
050,53,061,"Washington","Snohomish County",2,26,10743,5498,5245
050,53,061,"Washington","Snohomish County",2,27,11232,5744,5488
050,53,061,"Washington","Snohomish County",2,28,11865,6086,5779
050,53,061,"Washington","Snohomish County",2,29,12550,6423,6127
050,53,061,"Washington","Snohomish County",2,30,13050,6622,6428
050,53,061,"Washington","Snohomish County",2,31,13013,6561,6452
050,53,061,"Washington","Snohomish County",2,32,12871,6530,6341
050,53,061,"Washington","Snohomish County",2,33,12949,6675,6274
050,53,061,"Washington","Snohomish County",2,34,13373,6892,6481
050,53,061,"Washington","Snohomish County",2,35,13578,6947,6631
050,53,061,"Washington","Snohomish County",2,36,13398,6881,6517
050,53,061,"Washington","Snohomish County",2,37,13433,6943,6490
050,53,061,"Washington","Snohomish County",2,38,13344,6909,6435
050,53,061,"Washington","Snohomish County",2,39,13006,6821,6185
050,53,061,"Washington","Snohomish County",2,40,12605,6616,5989
050,53,061,"Washington","Snohomish County",2,41,11804,6147,5657
050,53,061,"Washington","Snohomish County",2,42,11464,5931,5533
050,53,061,"Washington","Snohomish County",2,43,11121,5740,5381
050,53,061,"Washington","Snohomish County",2,44,10590,5455,5135
050,53,061,"Washington","Snohomish County",2,45,10597,5450,5147
050,53,061,"Washington","Snohomish County",2,46,10282,5313,4969
050,53,061,"Washington","Snohomish County",2,47,10222,5202,5020
050,53,061,"Washington","Snohomish County",2,48,10791,5539,5252
050,53,061,"Washington","Snohomish County",2,49,11656,6006,5650
050,53,061,"Washington","Snohomish County",2,50,11649,5986,5663
050,53,061,"Washington","Snohomish County",2,51,11211,5808,5403
050,53,061,"Washington","Snohomish County",2,52,10758,5594,5164
050,53,061,"Washington","Snohomish County",2,53,10642,5462,5180
050,53,061,"Washington","Snohomish County",2,54,10633,5411,5222
050,53,061,"Washington","Snohomish County",2,55,11025,5607,5418
050,53,061,"Washington","Snohomish County",2,56,11506,5854,5652
050,53,061,"Washington","Snohomish County",2,57,11770,5999,5771
050,53,061,"Washington","Snohomish County",2,58,11690,5967,5723
050,53,061,"Washington","Snohomish County",2,59,11452,5792,5660
050,53,061,"Washington","Snohomish County",2,60,11063,5527,5536
050,53,061,"Washington","Snohomish County",2,61,10910,5470,5440
050,53,061,"Washington","Snohomish County",2,62,10803,5411,5392
050,53,061,"Washington","Snohomish County",2,63,10338,5177,5161
050,53,061,"Washington","Snohomish County",2,64,9795,4857,4938
050,53,061,"Washington","Snohomish County",2,65,9522,4662,4860
050,53,061,"Washington","Snohomish County",2,66,8987,4361,4626
050,53,061,"Washington","Snohomish County",2,67,8607,4154,4453
050,53,061,"Washington","Snohomish County",2,68,8036,3808,4228
050,53,061,"Washington","Snohomish County",2,69,7284,3382,3902
050,53,061,"Washington","Snohomish County",2,70,6876,3233,3643
050,53,061,"Washington","Snohomish County",2,71,6667,3115,3552
050,53,061,"Washington","Snohomish County",2,72,6465,2983,3482
050,53,061,"Washington","Snohomish County",2,73,6763,3155,3608
050,53,061,"Washington","Snohomish County",2,74,4662,2150,2512
050,53,061,"Washington","Snohomish County",2,75,4422,2021,2401
050,53,061,"Washington","Snohomish County",2,76,4194,1905,2289
050,53,061,"Washington","Snohomish County",2,77,4042,1858,2184
050,53,061,"Washington","Snohomish County",2,78,3391,1557,1834
050,53,061,"Washington","Snohomish County",2,79,3035,1344,1691
050,53,061,"Washington","Snohomish County",2,80,2746,1199,1547
050,53,061,"Washington","Snohomish County",2,81,2537,1115,1422
050,53,061,"Washington","Snohomish County",2,82,2305,981,1324
050,53,061,"Washington","Snohomish County",2,83,2040,817,1223
050,53,061,"Washington","Snohomish County",2,84,1846,740,1106
050,53,061,"Washington","Snohomish County",2,85,11073,3919,7154
050,53,061,"Washington","Snohomish County",3,0,9432,4891,4541
050,53,061,"Washington","Snohomish County",3,1,10010,5112,4898
050,53,061,"Washington","Snohomish County",3,2,10063,5072,4991
050,53,061,"Washington","Snohomish County",3,3,10371,5301,5070
050,53,061,"Washington","Snohomish County",3,4,10545,5356,5189
050,53,061,"Washington","Snohomish County",3,5,10848,5566,5282
050,53,061,"Washington","Snohomish County",3,6,10704,5457,5247
050,53,061,"Washington","Snohomish County",3,7,10338,5346,4992
050,53,061,"Washington","Snohomish County",3,8,10360,5314,5046
050,53,061,"Washington","Snohomish County",3,9,10128,5207,4921
050,53,061,"Washington","Snohomish County",3,10,10167,5219,4948
050,53,061,"Washington","Snohomish County",3,11,10440,5381,5059
050,53,061,"Washington","Snohomish County",3,12,10660,5530,5130
050,53,061,"Washington","Snohomish County",3,13,10974,5595,5379
050,53,061,"Washington","Snohomish County",3,14,10856,5589,5267
050,53,061,"Washington","Snohomish County",3,15,10504,5428,5076
050,53,061,"Washington","Snohomish County",3,16,10387,5377,5010
050,53,061,"Washington","Snohomish County",3,17,10482,5363,5119
050,53,061,"Washington","Snohomish County",3,18,8960,4662,4298
050,53,061,"Washington","Snohomish County",3,19,7472,3896,3576
050,53,061,"Washington","Snohomish County",3,20,8113,4251,3862
050,53,061,"Washington","Snohomish County",3,21,8550,4449,4101
050,53,061,"Washington","Snohomish County",3,22,8819,4504,4315
050,53,061,"Washington","Snohomish County",3,23,9462,4842,4620
050,53,061,"Washington","Snohomish County",3,24,9709,4968,4741
050,53,061,"Washington","Snohomish County",3,25,10157,5234,4923
050,53,061,"Washington","Snohomish County",3,26,10474,5399,5075
050,53,061,"Washington","Snohomish County",3,27,11052,5582,5470
050,53,061,"Washington","Snohomish County",3,28,11653,5915,5738
050,53,061,"Washington","Snohomish County",3,29,12361,6280,6081
050,53,061,"Washington","Snohomish County",3,30,13202,6672,6530
050,53,061,"Washington","Snohomish County",3,31,13653,6890,6763
050,53,061,"Washington","Snohomish County",3,32,13706,6974,6732
050,53,061,"Washington","Snohomish County",3,33,13457,6828,6629
050,53,061,"Washington","Snohomish County",3,34,13492,6950,6542
050,53,061,"Washington","Snohomish County",3,35,13722,7117,6605
050,53,061,"Washington","Snohomish County",3,36,13755,7065,6690
050,53,061,"Washington","Snohomish County",3,37,13705,7079,6626
050,53,061,"Washington","Snohomish County",3,38,13661,7096,6565
050,53,061,"Washington","Snohomish County",3,39,13360,6898,6462
050,53,061,"Washington","Snohomish County",3,40,13118,6874,6244
050,53,061,"Washington","Snohomish County",3,41,12592,6624,5968
050,53,061,"Washington","Snohomish County",3,42,11842,6167,5675
050,53,061,"Washington","Snohomish County",3,43,11407,5876,5531
050,53,061,"Washington","Snohomish County",3,44,11127,5773,5354
050,53,061,"Washington","Snohomish County",3,45,10521,5413,5108
050,53,061,"Washington","Snohomish County",3,46,10594,5451,5143
050,53,061,"Washington","Snohomish County",3,47,10194,5255,4939
050,53,061,"Washington","Snohomish County",3,48,10127,5159,4968
050,53,061,"Washington","Snohomish County",3,49,10767,5494,5273
050,53,061,"Washington","Snohomish County",3,50,11549,5944,5605
050,53,061,"Washington","Snohomish County",3,51,11529,5947,5582
050,53,061,"Washington","Snohomish County",3,52,11086,5735,5351
050,53,061,"Washington","Snohomish County",3,53,10611,5491,5120
050,53,061,"Washington","Snohomish County",3,54,10430,5373,5057
050,53,061,"Washington","Snohomish County",3,55,10379,5283,5096
050,53,061,"Washington","Snohomish County",3,56,10826,5496,5330
050,53,061,"Washington","Snohomish County",3,57,11301,5701,5600
050,53,061,"Washington","Snohomish County",3,58,11511,5861,5650
050,53,061,"Washington","Snohomish County",3,59,11453,5841,5612
050,53,061,"Washington","Snohomish County",3,60,11135,5622,5513
050,53,061,"Washington","Snohomish County",3,61,10771,5375,5396
050,53,061,"Washington","Snohomish County",3,62,10642,5288,5354
050,53,061,"Washington","Snohomish County",3,63,10486,5248,5238
050,53,061,"Washington","Snohomish County",3,64,10056,5005,5051
050,53,061,"Washington","Snohomish County",3,65,9562,4728,4834
050,53,061,"Washington","Snohomish County",3,66,9214,4484,4730
050,53,061,"Washington","Snohomish County",3,67,8793,4234,4559
050,53,061,"Washington","Snohomish County",3,68,8354,3991,4363
050,53,061,"Washington","Snohomish County",3,69,7851,3703,4148
050,53,061,"Washington","Snohomish County",3,70,7099,3265,3834
050,53,061,"Washington","Snohomish County",3,71,6725,3145,3580
050,53,061,"Washington","Snohomish County",3,72,6561,3025,3536
050,53,061,"Washington","Snohomish County",3,73,6282,2888,3394
050,53,061,"Washington","Snohomish County",3,74,6588,3046,3542
050,53,061,"Washington","Snohomish County",3,75,4534,2088,2446
050,53,061,"Washington","Snohomish County",3,76,4305,1946,2359
050,53,061,"Washington","Snohomish County",3,77,4013,1816,2197
050,53,061,"Washington","Snohomish County",3,78,3887,1764,2123
050,53,061,"Washington","Snohomish County",3,79,3309,1507,1802
050,53,061,"Washington","Snohomish County",3,80,2921,1285,1636
050,53,061,"Washington","Snohomish County",3,81,2601,1124,1477
050,53,061,"Washington","Snohomish County",3,82,2453,1073,1380
050,53,061,"Washington","Snohomish County",3,83,2128,872,1256
050,53,061,"Washington","Snohomish County",3,84,1955,790,1165
050,53,061,"Washington","Snohomish County",3,85,11144,3936,7208
050,53,061,"Washington","Snohomish County",4,0,9781,5077,4704
050,53,061,"Washington","Snohomish County",4,1,9627,4963,4664
050,53,061,"Washington","Snohomish County",4,2,10267,5254,5013
050,53,061,"Washington","Snohomish County",4,3,10168,5131,5037
050,53,061,"Washington","Snohomish County",4,4,10338,5321,5017
050,53,061,"Washington","Snohomish County",4,5,10512,5333,5179
050,53,061,"Washington","Snohomish County",4,6,10825,5532,5293
050,53,061,"Washington","Snohomish County",4,7,10536,5393,5143
050,53,061,"Washington","Snohomish County",4,8,10355,5378,4977
050,53,061,"Washington","Snohomish County",4,9,10374,5320,5054
050,53,061,"Washington","Snohomish County",4,10,10022,5140,4882
050,53,061,"Washington","Snohomish County",4,11,10091,5168,4923
050,53,061,"Washington","Snohomish County",4,12,10397,5341,5056
050,53,061,"Washington","Snohomish County",4,13,10516,5450,5066
050,53,061,"Washington","Snohomish County",4,14,10869,5580,5289
050,53,061,"Washington","Snohomish County",4,15,10689,5481,5208
050,53,061,"Washington","Snohomish County",4,16,10415,5397,5018
050,53,061,"Washington","Snohomish County",4,17,10342,5396,4946
050,53,061,"Washington","Snohomish County",4,18,8929,4699,4230
050,53,061,"Washington","Snohomish County",4,19,7414,3856,3558
050,53,061,"Washington","Snohomish County",4,20,7827,4059,3768
050,53,061,"Washington","Snohomish County",4,21,8423,4402,4021
050,53,061,"Washington","Snohomish County",4,22,8928,4597,4331
050,53,061,"Washington","Snohomish County",4,23,9257,4788,4469
050,53,061,"Washington","Snohomish County",4,24,9680,4997,4683
050,53,061,"Washington","Snohomish County",4,25,9928,5072,4856
050,53,061,"Washington","Snohomish County",4,26,10407,5332,5075
050,53,061,"Washington","Snohomish County",4,27,10778,5487,5291
050,53,061,"Washington","Snohomish County",4,28,11572,5844,5728
050,53,061,"Washington","Snohomish County",4,29,12345,6310,6035
050,53,061,"Washington","Snohomish County",4,30,13123,6562,6561
050,53,061,"Washington","Snohomish County",4,31,13921,7060,6861
050,53,061,"Washington","Snohomish County",4,32,14495,7332,7163
050,53,061,"Washington","Snohomish County",4,33,14183,7190,6993
050,53,061,"Washington","Snohomish County",4,34,13956,7060,6896
050,53,061,"Washington","Snohomish County",4,35,13914,7222,6692
050,53,061,"Washington","Snohomish County",4,36,14058,7297,6761
050,53,061,"Washington","Snohomish County",4,37,14062,7273,6789
050,53,061,"Washington","Snohomish County",4,38,13858,7183,6675
050,53,061,"Washington","Snohomish County",4,39,13731,7108,6623
050,53,061,"Washington","Snohomish County",4,40,13388,6910,6478
050,53,061,"Washington","Snohomish County",4,41,13155,6924,6231
050,53,061,"Washington","Snohomish County",4,42,12534,6585,5949
050,53,061,"Washington","Snohomish County",4,43,11806,6127,5679
050,53,061,"Washington","Snohomish County",4,44,11254,5790,5464
050,53,061,"Washington","Snohomish County",4,45,10914,5635,5279
050,53,061,"Washington","Snohomish County",4,46,10444,5375,5069
050,53,061,"Washington","Snohomish County",4,47,10415,5318,5097
050,53,061,"Washington","Snohomish County",4,48,10065,5159,4906
050,53,061,"Washington","Snohomish County",4,49,10030,5115,4915
050,53,061,"Washington","Snohomish County",4,50,10589,5383,5206
050,53,061,"Washington","Snohomish County",4,51,11313,5821,5492
050,53,061,"Washington","Snohomish County",4,52,11282,5798,5484
050,53,061,"Washington","Snohomish County",4,53,10873,5615,5258
050,53,061,"Washington","Snohomish County",4,54,10373,5374,4999
050,53,061,"Washington","Snohomish County",4,55,10220,5250,4970
050,53,061,"Washington","Snohomish County",4,56,10170,5172,4998
050,53,061,"Washington","Snohomish County",4,57,10613,5359,5254
050,53,061,"Washington","Snohomish County",4,58,11086,5560,5526
050,53,061,"Washington","Snohomish County",4,59,11248,5701,5547
050,53,061,"Washington","Snohomish County",4,60,11151,5648,5503
050,53,061,"Washington","Snohomish County",4,61,10902,5497,5405
050,53,061,"Washington","Snohomish County",4,62,10410,5185,5225
050,53,061,"Washington","Snohomish County",4,63,10441,5126,5315
050,53,061,"Washington","Snohomish County",4,64,10158,5051,5107
050,53,061,"Washington","Snohomish County",4,65,9757,4804,4953
050,53,061,"Washington","Snohomish County",4,66,9222,4517,4705
050,53,061,"Washington","Snohomish County",4,67,8937,4306,4631
050,53,061,"Washington","Snohomish County",4,68,8541,4076,4465
050,53,061,"Washington","Snohomish County",4,69,8171,3848,4323
050,53,061,"Washington","Snohomish County",4,70,7641,3601,4040
050,53,061,"Washington","Snohomish County",4,71,6943,3167,3776
050,53,061,"Washington","Snohomish County",4,72,6612,3056,3556
050,53,061,"Washington","Snohomish County",4,73,6357,2918,3439
050,53,061,"Washington","Snohomish County",4,74,6093,2779,3314
050,53,061,"Washington","Snohomish County",4,75,6392,2939,3453
050,53,061,"Washington","Snohomish County",4,76,4379,1999,2380
050,53,061,"Washington","Snohomish County",4,77,4137,1840,2297
050,53,061,"Washington","Snohomish County",4,78,3832,1727,2105
050,53,061,"Washington","Snohomish County",4,79,3751,1687,2064
050,53,061,"Washington","Snohomish County",4,80,3169,1441,1728
050,53,061,"Washington","Snohomish County",4,81,2781,1206,1575
050,53,061,"Washington","Snohomish County",4,82,2435,1052,1383
050,53,061,"Washington","Snohomish County",4,83,2255,944,1311
050,53,061,"Washington","Snohomish County",4,84,2022,823,1199
050,53,061,"Washington","Snohomish County",4,85,11278,4060,7218
050,53,061,"Washington","Snohomish County",5,0,9694,5036,4658
050,53,061,"Washington","Snohomish County",5,1,9808,5106,4702
050,53,061,"Washington","Snohomish County",5,2,9690,4959,4731
050,53,061,"Washington","Snohomish County",5,3,10184,5172,5012
050,53,061,"Washington","Snohomish County",5,4,10103,5112,4991
050,53,061,"Washington","Snohomish County",5,5,10257,5250,5007
050,53,061,"Washington","Snohomish County",5,6,10358,5231,5127
050,53,061,"Washington","Snohomish County",5,7,10640,5452,5188
050,53,061,"Washington","Snohomish County",5,8,10467,5353,5114
050,53,061,"Washington","Snohomish County",5,9,10219,5316,4903
050,53,061,"Washington","Snohomish County",5,10,10307,5282,5025
050,53,061,"Washington","Snohomish County",5,11,9939,5101,4838
050,53,061,"Washington","Snohomish County",5,12,9990,5098,4892
050,53,061,"Washington","Snohomish County",5,13,10307,5304,5003
050,53,061,"Washington","Snohomish County",5,14,10457,5425,5032
050,53,061,"Washington","Snohomish County",5,15,10744,5499,5245
050,53,061,"Washington","Snohomish County",5,16,10707,5482,5225
050,53,061,"Washington","Snohomish County",5,17,10475,5428,5047
050,53,061,"Washington","Snohomish County",5,18,8824,4722,4102
050,53,061,"Washington","Snohomish County",5,19,7528,3982,3546
050,53,061,"Washington","Snohomish County",5,20,7977,4126,3851
050,53,061,"Washington","Snohomish County",5,21,8190,4222,3968
050,53,061,"Washington","Snohomish County",5,22,8891,4568,4323
050,53,061,"Washington","Snohomish County",5,23,9473,4932,4541
050,53,061,"Washington","Snohomish County",5,24,9673,5043,4630
050,53,061,"Washington","Snohomish County",5,25,10001,5230,4771
050,53,061,"Washington","Snohomish County",5,26,10245,5275,4970
050,53,061,"Washington","Snohomish County",5,27,10908,5543,5365
050,53,061,"Washington","Snohomish County",5,28,11373,5764,5609
050,53,061,"Washington","Snohomish County",5,29,12248,6188,6060
050,53,061,"Washington","Snohomish County",5,30,13010,6628,6382
050,53,061,"Washington","Snohomish County",5,31,13789,6959,6830
050,53,061,"Washington","Snohomish County",5,32,14490,7406,7084
050,53,061,"Washington","Snohomish County",5,33,15017,7666,7351
050,53,061,"Washington","Snohomish County",5,34,14516,7368,7148
050,53,061,"Washington","Snohomish County",5,35,14161,7235,6926
050,53,061,"Washington","Snohomish County",5,36,14014,7294,6720
050,53,061,"Washington","Snohomish County",5,37,14185,7394,6791
050,53,061,"Washington","Snohomish County",5,38,14171,7344,6827
050,53,061,"Washington","Snohomish County",5,39,13925,7280,6645
050,53,061,"Washington","Snohomish County",5,40,13781,7125,6656
050,53,061,"Washington","Snohomish County",5,41,13353,6920,6433
050,53,061,"Washington","Snohomish County",5,42,13114,6941,6173
050,53,061,"Washington","Snohomish County",5,43,12459,6535,5924
050,53,061,"Washington","Snohomish County",5,44,11715,6068,5647
050,53,061,"Washington","Snohomish County",5,45,11101,5699,5402
050,53,061,"Washington","Snohomish County",5,46,10843,5615,5228
050,53,061,"Washington","Snohomish County",5,47,10302,5288,5014
050,53,061,"Washington","Snohomish County",5,48,10318,5271,5047
050,53,061,"Washington","Snohomish County",5,49,9991,5102,4889
050,53,061,"Washington","Snohomish County",5,50,9864,5052,4812
050,53,061,"Washington","Snohomish County",5,51,10445,5311,5134
050,53,061,"Washington","Snohomish County",5,52,11194,5796,5398
050,53,061,"Washington","Snohomish County",5,53,11104,5700,5404
050,53,061,"Washington","Snohomish County",5,54,10682,5500,5182
050,53,061,"Washington","Snohomish County",5,55,10239,5291,4948
050,53,061,"Washington","Snohomish County",5,56,10003,5127,4876
050,53,061,"Washington","Snohomish County",5,57,9944,5040,4904
050,53,061,"Washington","Snohomish County",5,58,10406,5242,5164
050,53,061,"Washington","Snohomish County",5,59,10832,5410,5422
050,53,061,"Washington","Snohomish County",5,60,11008,5568,5440
050,53,061,"Washington","Snohomish County",5,61,10946,5545,5401
050,53,061,"Washington","Snohomish County",5,62,10607,5341,5266
050,53,061,"Washington","Snohomish County",5,63,10219,5076,5143
050,53,061,"Washington","Snohomish County",5,64,10129,4945,5184
050,53,061,"Washington","Snohomish County",5,65,9860,4900,4960
050,53,061,"Washington","Snohomish County",5,66,9450,4639,4811
050,53,061,"Washington","Snohomish County",5,67,9004,4397,4607
050,53,061,"Washington","Snohomish County",5,68,8756,4183,4573
050,53,061,"Washington","Snohomish County",5,69,8333,3936,4397
050,53,061,"Washington","Snohomish County",5,70,7970,3744,4226
050,53,061,"Washington","Snohomish County",5,71,7464,3513,3951
050,53,061,"Washington","Snohomish County",5,72,6811,3080,3731
050,53,061,"Washington","Snohomish County",5,73,6408,2965,3443
050,53,061,"Washington","Snohomish County",5,74,6203,2806,3397
050,53,061,"Washington","Snohomish County",5,75,5907,2672,3235
050,53,061,"Washington","Snohomish County",5,76,6160,2802,3358
050,53,061,"Washington","Snohomish County",5,77,4189,1905,2284
050,53,061,"Washington","Snohomish County",5,78,3970,1757,2213
050,53,061,"Washington","Snohomish County",5,79,3713,1653,2060
050,53,061,"Washington","Snohomish County",5,80,3592,1616,1976
050,53,061,"Washington","Snohomish County",5,81,3013,1363,1650
050,53,061,"Washington","Snohomish County",5,82,2616,1131,1485
050,53,061,"Washington","Snohomish County",5,83,2231,930,1301
050,53,061,"Washington","Snohomish County",5,84,2118,898,1220
050,53,061,"Washington","Snohomish County",5,85,11439,4152,7287
050,53,063,"Washington","Spokane County",1,0,5926,3033,2893
050,53,063,"Washington","Spokane County",1,1,5979,2978,3001
050,53,063,"Washington","Spokane County",1,2,6230,3173,3057
050,53,063,"Washington","Spokane County",1,3,6565,3321,3244
050,53,063,"Washington","Spokane County",1,4,6561,3375,3186
050,53,063,"Washington","Spokane County",1,5,6562,3403,3159
050,53,063,"Washington","Spokane County",1,6,6617,3435,3182
050,53,063,"Washington","Spokane County",1,7,6735,3477,3258
050,53,063,"Washington","Spokane County",1,8,6582,3421,3161
050,53,063,"Washington","Spokane County",1,9,6559,3370,3189
050,53,063,"Washington","Spokane County",1,10,6730,3392,3338
050,53,063,"Washington","Spokane County",1,11,6887,3576,3311
050,53,063,"Washington","Spokane County",1,12,7124,3698,3426
050,53,063,"Washington","Spokane County",1,13,7090,3693,3397
050,53,063,"Washington","Spokane County",1,14,6747,3430,3317
050,53,063,"Washington","Spokane County",1,15,6636,3386,3250
050,53,063,"Washington","Spokane County",1,16,6732,3465,3267
050,53,063,"Washington","Spokane County",1,17,6672,3448,3224
050,53,063,"Washington","Spokane County",1,18,6664,3424,3240
050,53,063,"Washington","Spokane County",1,19,7246,3715,3531
050,53,063,"Washington","Spokane County",1,20,6935,3593,3342
050,53,063,"Washington","Spokane County",1,21,6692,3511,3181
050,53,063,"Washington","Spokane County",1,22,6860,3521,3339
050,53,063,"Washington","Spokane County",1,23,7173,3661,3512
050,53,063,"Washington","Spokane County",1,24,7380,3705,3675
050,53,063,"Washington","Spokane County",1,25,7605,3897,3708
050,53,063,"Washington","Spokane County",1,26,7910,3978,3932
050,53,063,"Washington","Spokane County",1,27,7960,4131,3829
050,53,063,"Washington","Spokane County",1,28,8383,4367,4016
050,53,063,"Washington","Spokane County",1,29,8530,4435,4095
050,53,063,"Washington","Spokane County",1,30,8500,4413,4087
050,53,063,"Washington","Spokane County",1,31,8375,4323,4052
050,53,063,"Washington","Spokane County",1,32,7961,3991,3970
050,53,063,"Washington","Spokane County",1,33,7727,3930,3797
050,53,063,"Washington","Spokane County",1,34,7805,3973,3832
050,53,063,"Washington","Spokane County",1,35,7542,3829,3713
050,53,063,"Washington","Spokane County",1,36,7407,3782,3625
050,53,063,"Washington","Spokane County",1,37,7526,3829,3697
050,53,063,"Washington","Spokane County",1,38,7414,3886,3528
050,53,063,"Washington","Spokane County",1,39,7339,3793,3546
050,53,063,"Washington","Spokane County",1,40,7011,3604,3407
050,53,063,"Washington","Spokane County",1,41,6710,3417,3293
050,53,063,"Washington","Spokane County",1,42,6452,3225,3227
050,53,063,"Washington","Spokane County",1,43,6234,3150,3084
050,53,063,"Washington","Spokane County",1,44,6012,3047,2965
050,53,063,"Washington","Spokane County",1,45,6005,3021,2984
050,53,063,"Washington","Spokane County",1,46,6030,3073,2957
050,53,063,"Washington","Spokane County",1,47,6013,3039,2974
050,53,063,"Washington","Spokane County",1,48,6375,3293,3082
050,53,063,"Washington","Spokane County",1,49,6992,3609,3383
050,53,063,"Washington","Spokane County",1,50,6696,3349,3347
050,53,063,"Washington","Spokane County",1,51,6403,3237,3166
050,53,063,"Washington","Spokane County",1,52,6017,3034,2983
050,53,063,"Washington","Spokane County",1,53,6148,3054,3094
050,53,063,"Washington","Spokane County",1,54,6237,3094,3143
050,53,063,"Washington","Spokane County",1,55,6591,3239,3352
050,53,063,"Washington","Spokane County",1,56,6891,3364,3527
050,53,063,"Washington","Spokane County",1,57,7077,3445,3632
050,53,063,"Washington","Spokane County",1,58,7212,3529,3683
050,53,063,"Washington","Spokane County",1,59,7145,3520,3625
050,53,063,"Washington","Spokane County",1,60,6940,3450,3490
050,53,063,"Washington","Spokane County",1,61,6855,3344,3511
050,53,063,"Washington","Spokane County",1,62,7086,3441,3645
050,53,063,"Washington","Spokane County",1,63,6817,3266,3551
050,53,063,"Washington","Spokane County",1,64,6619,3171,3448
050,53,063,"Washington","Spokane County",1,65,6491,3082,3409
050,53,063,"Washington","Spokane County",1,66,6423,3101,3322
050,53,063,"Washington","Spokane County",1,67,6264,3007,3257
050,53,063,"Washington","Spokane County",1,68,6009,2899,3110
050,53,063,"Washington","Spokane County",1,69,5483,2589,2894
050,53,063,"Washington","Spokane County",1,70,5359,2521,2838
050,53,063,"Washington","Spokane County",1,71,5184,2430,2754
050,53,063,"Washington","Spokane County",1,72,5060,2431,2629
050,53,063,"Washington","Spokane County",1,73,5053,2468,2585
050,53,063,"Washington","Spokane County",1,74,3446,1634,1812
050,53,063,"Washington","Spokane County",1,75,3417,1564,1853
050,53,063,"Washington","Spokane County",1,76,3392,1556,1836
050,53,063,"Washington","Spokane County",1,77,3264,1519,1745
050,53,063,"Washington","Spokane County",1,78,2743,1254,1489
050,53,063,"Washington","Spokane County",1,79,2435,1121,1314
050,53,063,"Washington","Spokane County",1,80,2165,992,1173
050,53,063,"Washington","Spokane County",1,81,2066,909,1157
050,53,063,"Washington","Spokane County",1,82,1885,807,1078
050,53,063,"Washington","Spokane County",1,83,1689,729,960
050,53,063,"Washington","Spokane County",1,84,1589,659,930
050,53,063,"Washington","Spokane County",1,85,9487,3382,6105
050,53,063,"Washington","Spokane County",2,0,5990,3039,2951
050,53,063,"Washington","Spokane County",2,1,5969,2982,2987
050,53,063,"Washington","Spokane County",2,2,6197,3138,3059
050,53,063,"Washington","Spokane County",2,3,6464,3272,3192
050,53,063,"Washington","Spokane County",2,4,6596,3383,3213
050,53,063,"Washington","Spokane County",2,5,6587,3413,3174
050,53,063,"Washington","Spokane County",2,6,6633,3443,3190
050,53,063,"Washington","Spokane County",2,7,6709,3471,3238
050,53,063,"Washington","Spokane County",2,8,6615,3436,3179
050,53,063,"Washington","Spokane County",2,9,6574,3392,3182
050,53,063,"Washington","Spokane County",2,10,6703,3396,3307
050,53,063,"Washington","Spokane County",2,11,6841,3526,3315
050,53,063,"Washington","Spokane County",2,12,7111,3691,3420
050,53,063,"Washington","Spokane County",2,13,7105,3692,3413
050,53,063,"Washington","Spokane County",2,14,6834,3496,3338
050,53,063,"Washington","Spokane County",2,15,6688,3408,3280
050,53,063,"Washington","Spokane County",2,16,6726,3453,3273
050,53,063,"Washington","Spokane County",2,17,6718,3473,3245
050,53,063,"Washington","Spokane County",2,18,6697,3436,3261
050,53,063,"Washington","Spokane County",2,19,7270,3729,3541
050,53,063,"Washington","Spokane County",2,20,7021,3642,3379
050,53,063,"Washington","Spokane County",2,21,6706,3510,3196
050,53,063,"Washington","Spokane County",2,22,6874,3525,3349
050,53,063,"Washington","Spokane County",2,23,7171,3663,3508
050,53,063,"Washington","Spokane County",2,24,7387,3724,3663
050,53,063,"Washington","Spokane County",2,25,7607,3872,3735
050,53,063,"Washington","Spokane County",2,26,7863,3982,3881
050,53,063,"Washington","Spokane County",2,27,7966,4109,3857
050,53,063,"Washington","Spokane County",2,28,8291,4317,3974
050,53,063,"Washington","Spokane County",2,29,8517,4424,4093
050,53,063,"Washington","Spokane County",2,30,8593,4455,4138
050,53,063,"Washington","Spokane County",2,31,8409,4345,4064
050,53,063,"Washington","Spokane County",2,32,8061,4064,3997
050,53,063,"Washington","Spokane County",2,33,7818,3970,3848
050,53,063,"Washington","Spokane County",2,34,7807,3973,3834
050,53,063,"Washington","Spokane County",2,35,7657,3891,3766
050,53,063,"Washington","Spokane County",2,36,7423,3789,3634
050,53,063,"Washington","Spokane County",2,37,7527,3832,3695
050,53,063,"Washington","Spokane County",2,38,7497,3905,3592
050,53,063,"Washington","Spokane County",2,39,7368,3828,3540
050,53,063,"Washington","Spokane County",2,40,7161,3683,3478
050,53,063,"Washington","Spokane County",2,41,6787,3461,3326
050,53,063,"Washington","Spokane County",2,42,6480,3252,3228
050,53,063,"Washington","Spokane County",2,43,6335,3190,3145
050,53,063,"Washington","Spokane County",2,44,6020,3050,2970
050,53,063,"Washington","Spokane County",2,45,6057,3043,3014
050,53,063,"Washington","Spokane County",2,46,6020,3067,2953
050,53,063,"Washington","Spokane County",2,47,6013,3046,2967
050,53,063,"Washington","Spokane County",2,48,6287,3229,3058
050,53,063,"Washington","Spokane County",2,49,6887,3559,3328
050,53,063,"Washington","Spokane County",2,50,6803,3419,3384
050,53,063,"Washington","Spokane County",2,51,6452,3258,3194
050,53,063,"Washington","Spokane County",2,52,6098,3075,3023
050,53,063,"Washington","Spokane County",2,53,6140,3059,3081
050,53,063,"Washington","Spokane County",2,54,6196,3071,3125
050,53,063,"Washington","Spokane County",2,55,6518,3211,3307
050,53,063,"Washington","Spokane County",2,56,6842,3334,3508
050,53,063,"Washington","Spokane County",2,57,7047,3435,3612
050,53,063,"Washington","Spokane County",2,58,7163,3494,3669
050,53,063,"Washington","Spokane County",2,59,7191,3544,3647
050,53,063,"Washington","Spokane County",2,60,6971,3454,3517
050,53,063,"Washington","Spokane County",2,61,6859,3355,3504
050,53,063,"Washington","Spokane County",2,62,7020,3409,3611
050,53,063,"Washington","Spokane County",2,63,6930,3328,3602
050,53,063,"Washington","Spokane County",2,64,6617,3167,3450
050,53,063,"Washington","Spokane County",2,65,6506,3100,3406
050,53,063,"Washington","Spokane County",2,66,6444,3096,3348
050,53,063,"Washington","Spokane County",2,67,6266,3011,3255
050,53,063,"Washington","Spokane County",2,68,6016,2896,3120
050,53,063,"Washington","Spokane County",2,69,5638,2672,2966
050,53,063,"Washington","Spokane County",2,70,5351,2520,2831
050,53,063,"Washington","Spokane County",2,71,5216,2443,2773
050,53,063,"Washington","Spokane County",2,72,4980,2375,2605
050,53,063,"Washington","Spokane County",2,73,5285,2574,2711
050,53,063,"Washington","Spokane County",2,74,3590,1710,1880
050,53,063,"Washington","Spokane County",2,75,3426,1576,1850
050,53,063,"Washington","Spokane County",2,76,3341,1529,1812
050,53,063,"Washington","Spokane County",2,77,3348,1544,1804
050,53,063,"Washington","Spokane County",2,78,2795,1288,1507
050,53,063,"Washington","Spokane County",2,79,2478,1134,1344
050,53,063,"Washington","Spokane County",2,80,2211,1016,1195
050,53,063,"Washington","Spokane County",2,81,2051,902,1149
050,53,063,"Washington","Spokane County",2,82,1912,824,1088
050,53,063,"Washington","Spokane County",2,83,1710,734,976
050,53,063,"Washington","Spokane County",2,84,1592,666,926
050,53,063,"Washington","Spokane County",2,85,9535,3405,6130
050,53,063,"Washington","Spokane County",3,0,5791,2980,2811
050,53,063,"Washington","Spokane County",3,1,6015,3070,2945
050,53,063,"Washington","Spokane County",3,2,6047,3029,3018
050,53,063,"Washington","Spokane County",3,3,6271,3184,3087
050,53,063,"Washington","Spokane County",3,4,6469,3286,3183
050,53,063,"Washington","Spokane County",3,5,6645,3380,3265
050,53,063,"Washington","Spokane County",3,6,6697,3424,3273
050,53,063,"Washington","Spokane County",3,7,6659,3449,3210
050,53,063,"Washington","Spokane County",3,8,6792,3508,3284
050,53,063,"Washington","Spokane County",3,9,6653,3454,3199
050,53,063,"Washington","Spokane County",3,10,6562,3375,3187
050,53,063,"Washington","Spokane County",3,11,6758,3428,3330
050,53,063,"Washington","Spokane County",3,12,6834,3521,3313
050,53,063,"Washington","Spokane County",3,13,7138,3694,3444
050,53,063,"Washington","Spokane County",3,14,7121,3671,3450
050,53,063,"Washington","Spokane County",3,15,6904,3539,3365
050,53,063,"Washington","Spokane County",3,16,6725,3414,3311
050,53,063,"Washington","Spokane County",3,17,6781,3480,3301
050,53,063,"Washington","Spokane County",3,18,6537,3371,3166
050,53,063,"Washington","Spokane County",3,19,6611,3437,3174
050,53,063,"Washington","Spokane County",3,20,6704,3511,3193
050,53,063,"Washington","Spokane County",3,21,6719,3492,3227
050,53,063,"Washington","Spokane County",3,22,6901,3553,3348
050,53,063,"Washington","Spokane County",3,23,7229,3700,3529
050,53,063,"Washington","Spokane County",3,24,7442,3833,3609
050,53,063,"Washington","Spokane County",3,25,7661,3888,3773
050,53,063,"Washington","Spokane County",3,26,7745,3967,3778
050,53,063,"Washington","Spokane County",3,27,8065,4080,3985
050,53,063,"Washington","Spokane County",3,28,8023,4150,3873
050,53,063,"Washington","Spokane County",3,29,8415,4385,4030
050,53,063,"Washington","Spokane County",3,30,8586,4459,4127
050,53,063,"Washington","Spokane County",3,31,8718,4491,4227
050,53,063,"Washington","Spokane County",3,32,8418,4367,4051
050,53,063,"Washington","Spokane County",3,33,8165,4140,4025
050,53,063,"Washington","Spokane County",3,34,7853,3982,3871
050,53,063,"Washington","Spokane County",3,35,7881,4014,3867
050,53,063,"Washington","Spokane County",3,36,7781,3955,3826
050,53,063,"Washington","Spokane County",3,37,7489,3779,3710
050,53,063,"Washington","Spokane County",3,38,7652,3900,3752
050,53,063,"Washington","Spokane County",3,39,7602,3956,3646
050,53,063,"Washington","Spokane County",3,40,7402,3850,3552
050,53,063,"Washington","Spokane County",3,41,7208,3726,3482
050,53,063,"Washington","Spokane County",3,42,6801,3432,3369
050,53,063,"Washington","Spokane County",3,43,6518,3273,3245
050,53,063,"Washington","Spokane County",3,44,6343,3230,3113
050,53,063,"Washington","Spokane County",3,45,6050,3050,3000
050,53,063,"Washington","Spokane County",3,46,6088,3101,2987
050,53,063,"Washington","Spokane County",3,47,6091,3099,2992
050,53,063,"Washington","Spokane County",3,48,6037,3010,3027
050,53,063,"Washington","Spokane County",3,49,6302,3230,3072
050,53,063,"Washington","Spokane County",3,50,6872,3531,3341
050,53,063,"Washington","Spokane County",3,51,6755,3404,3351
050,53,063,"Washington","Spokane County",3,52,6507,3255,3252
050,53,063,"Washington","Spokane County",3,53,6154,3084,3070
050,53,063,"Washington","Spokane County",3,54,6108,3047,3061
050,53,063,"Washington","Spokane County",3,55,6214,3074,3140
050,53,063,"Washington","Spokane County",3,56,6527,3205,3322
050,53,063,"Washington","Spokane County",3,57,6835,3330,3505
050,53,063,"Washington","Spokane County",3,58,7096,3446,3650
050,53,063,"Washington","Spokane County",3,59,7131,3463,3668
050,53,063,"Washington","Spokane County",3,60,7185,3526,3659
050,53,063,"Washington","Spokane County",3,61,7001,3464,3537
050,53,063,"Washington","Spokane County",3,62,6830,3344,3486
050,53,063,"Washington","Spokane County",3,63,6950,3344,3606
050,53,063,"Washington","Spokane County",3,64,6854,3279,3575
050,53,063,"Washington","Spokane County",3,65,6569,3141,3428
050,53,063,"Washington","Spokane County",3,66,6474,3065,3409
050,53,063,"Washington","Spokane County",3,67,6368,3049,3319
050,53,063,"Washington","Spokane County",3,68,6174,2941,3233
050,53,063,"Washington","Spokane County",3,69,5927,2853,3074
050,53,063,"Washington","Spokane County",3,70,5535,2623,2912
050,53,063,"Washington","Spokane County",3,71,5270,2470,2800
050,53,063,"Washington","Spokane County",3,72,5110,2383,2727
050,53,063,"Washington","Spokane County",3,73,4908,2339,2569
050,53,063,"Washington","Spokane County",3,74,5129,2481,2648
050,53,063,"Washington","Spokane County",3,75,3462,1624,1838
050,53,063,"Washington","Spokane County",3,76,3308,1506,1802
050,53,063,"Washington","Spokane County",3,77,3247,1475,1772
050,53,063,"Washington","Spokane County",3,78,3220,1482,1738
050,53,063,"Washington","Spokane County",3,79,2660,1202,1458
050,53,063,"Washington","Spokane County",3,80,2361,1085,1276
050,53,063,"Washington","Spokane County",3,81,2116,952,1164
050,53,063,"Washington","Spokane County",3,82,1891,828,1063
050,53,063,"Washington","Spokane County",3,83,1784,769,1015
050,53,063,"Washington","Spokane County",3,84,1576,659,917
050,53,063,"Washington","Spokane County",3,85,9503,3424,6079
050,53,063,"Washington","Spokane County",4,0,5875,3023,2852
050,53,063,"Washington","Spokane County",4,1,5919,3029,2890
050,53,063,"Washington","Spokane County",4,2,6147,3142,3005
050,53,063,"Washington","Spokane County",4,3,6132,3048,3084
050,53,063,"Washington","Spokane County",4,4,6287,3200,3087
050,53,063,"Washington","Spokane County",4,5,6521,3314,3207
050,53,063,"Washington","Spokane County",4,6,6649,3390,3259
050,53,063,"Washington","Spokane County",4,7,6700,3463,3237
050,53,063,"Washington","Spokane County",4,8,6701,3458,3243
050,53,063,"Washington","Spokane County",4,9,6787,3499,3288
050,53,063,"Washington","Spokane County",4,10,6671,3469,3202
050,53,063,"Washington","Spokane County",4,11,6573,3402,3171
050,53,063,"Washington","Spokane County",4,12,6742,3451,3291
050,53,063,"Washington","Spokane County",4,13,6890,3519,3371
050,53,063,"Washington","Spokane County",4,14,7138,3698,3440
050,53,063,"Washington","Spokane County",4,15,7153,3693,3460
050,53,063,"Washington","Spokane County",4,16,6924,3530,3394
050,53,063,"Washington","Spokane County",4,17,6754,3408,3346
050,53,063,"Washington","Spokane County",4,18,6653,3413,3240
050,53,063,"Washington","Spokane County",4,19,6801,3484,3317
050,53,063,"Washington","Spokane County",4,20,6745,3520,3225
050,53,063,"Washington","Spokane County",4,21,6748,3519,3229
050,53,063,"Washington","Spokane County",4,22,7071,3593,3478
050,53,063,"Washington","Spokane County",4,23,7318,3739,3579
050,53,063,"Washington","Spokane County",4,24,7529,3881,3648
050,53,063,"Washington","Spokane County",4,25,7595,3953,3642
050,53,063,"Washington","Spokane County",4,26,7776,3984,3792
050,53,063,"Washington","Spokane County",4,27,7847,3987,3860
050,53,063,"Washington","Spokane County",4,28,8110,4111,3999
050,53,063,"Washington","Spokane County",4,29,8026,4094,3932
050,53,063,"Washington","Spokane County",4,30,8457,4412,4045
050,53,063,"Washington","Spokane County",4,31,8650,4450,4200
050,53,063,"Washington","Spokane County",4,32,8670,4500,4170
050,53,063,"Washington","Spokane County",4,33,8411,4381,4030
050,53,063,"Washington","Spokane County",4,34,8258,4201,4057
050,53,063,"Washington","Spokane County",4,35,7871,3971,3900
050,53,063,"Washington","Spokane County",4,36,7915,4038,3877
050,53,063,"Washington","Spokane County",4,37,7841,3970,3871
050,53,063,"Washington","Spokane County",4,38,7602,3815,3787
050,53,063,"Washington","Spokane County",4,39,7726,3953,3773
050,53,063,"Washington","Spokane County",4,40,7694,4010,3684
050,53,063,"Washington","Spokane County",4,41,7427,3873,3554
050,53,063,"Washington","Spokane County",4,42,7161,3653,3508
050,53,063,"Washington","Spokane County",4,43,6783,3429,3354
050,53,063,"Washington","Spokane County",4,44,6529,3280,3249
050,53,063,"Washington","Spokane County",4,45,6341,3219,3122
050,53,063,"Washington","Spokane County",4,46,6074,3108,2966
050,53,063,"Washington","Spokane County",4,47,6104,3117,2987
050,53,063,"Washington","Spokane County",4,48,6087,3074,3013
050,53,063,"Washington","Spokane County",4,49,6051,3027,3024
050,53,063,"Washington","Spokane County",4,50,6307,3209,3098
050,53,063,"Washington","Spokane County",4,51,6888,3532,3356
050,53,063,"Washington","Spokane County",4,52,6725,3372,3353
050,53,063,"Washington","Spokane County",4,53,6575,3256,3319
050,53,063,"Washington","Spokane County",4,54,6114,3055,3059
050,53,063,"Washington","Spokane County",4,55,6106,3057,3049
050,53,063,"Washington","Spokane County",4,56,6202,3007,3195
050,53,063,"Washington","Spokane County",4,57,6463,3188,3275
050,53,063,"Washington","Spokane County",4,58,6815,3313,3502
050,53,063,"Washington","Spokane County",4,59,7004,3399,3605
050,53,063,"Washington","Spokane County",4,60,7077,3402,3675
050,53,063,"Washington","Spokane County",4,61,7126,3456,3670
050,53,063,"Washington","Spokane County",4,62,6922,3450,3472
050,53,063,"Washington","Spokane County",4,63,6780,3303,3477
050,53,063,"Washington","Spokane County",4,64,6872,3309,3563
050,53,063,"Washington","Spokane County",4,65,6748,3216,3532
050,53,063,"Washington","Spokane County",4,66,6450,3089,3361
050,53,063,"Washington","Spokane County",4,67,6372,3010,3362
050,53,063,"Washington","Spokane County",4,68,6272,2959,3313
050,53,063,"Washington","Spokane County",4,69,6061,2860,3201
050,53,063,"Washington","Spokane County",4,70,5768,2789,2979
050,53,063,"Washington","Spokane County",4,71,5387,2543,2844
050,53,063,"Washington","Spokane County",4,72,5124,2372,2752
050,53,063,"Washington","Spokane County",4,73,5003,2324,2679
050,53,063,"Washington","Spokane County",4,74,4727,2226,2501
050,53,063,"Washington","Spokane County",4,75,4962,2364,2598
050,53,063,"Washington","Spokane County",4,76,3370,1559,1811
050,53,063,"Washington","Spokane County",4,77,3209,1458,1751
050,53,063,"Washington","Spokane County",4,78,3122,1402,1720
050,53,063,"Washington","Spokane County",4,79,3088,1401,1687
050,53,063,"Washington","Spokane County",4,80,2525,1146,1379
050,53,063,"Washington","Spokane County",4,81,2260,1035,1225
050,53,063,"Washington","Spokane County",4,82,1988,882,1106
050,53,063,"Washington","Spokane County",4,83,1752,761,991
050,53,063,"Washington","Spokane County",4,84,1659,704,955
050,53,063,"Washington","Spokane County",4,85,9483,3440,6043
050,53,063,"Washington","Spokane County",5,0,5702,2936,2766
050,53,063,"Washington","Spokane County",5,1,5955,3073,2882
050,53,063,"Washington","Spokane County",5,2,5950,3053,2897
050,53,063,"Washington","Spokane County",5,3,6096,3153,2943
050,53,063,"Washington","Spokane County",5,4,6159,3074,3085
050,53,063,"Washington","Spokane County",5,5,6252,3190,3062
050,53,063,"Washington","Spokane County",5,6,6553,3305,3248
050,53,063,"Washington","Spokane County",5,7,6655,3391,3264
050,53,063,"Washington","Spokane County",5,8,6718,3463,3255
050,53,063,"Washington","Spokane County",5,9,6717,3466,3251
050,53,063,"Washington","Spokane County",5,10,6769,3483,3286
050,53,063,"Washington","Spokane County",5,11,6659,3482,3177
050,53,063,"Washington","Spokane County",5,12,6552,3403,3149
050,53,063,"Washington","Spokane County",5,13,6773,3454,3319
050,53,063,"Washington","Spokane County",5,14,6868,3522,3346
050,53,063,"Washington","Spokane County",5,15,7172,3699,3473
050,53,063,"Washington","Spokane County",5,16,7122,3654,3468
050,53,063,"Washington","Spokane County",5,17,6920,3512,3408
050,53,063,"Washington","Spokane County",5,18,6559,3310,3249
050,53,063,"Washington","Spokane County",5,19,6812,3493,3319
050,53,063,"Washington","Spokane County",5,20,6674,3487,3187
050,53,063,"Washington","Spokane County",5,21,6697,3510,3187
050,53,063,"Washington","Spokane County",5,22,6922,3514,3408
050,53,063,"Washington","Spokane County",5,23,7398,3812,3586
050,53,063,"Washington","Spokane County",5,24,7526,3818,3708
050,53,063,"Washington","Spokane County",5,25,7670,3950,3720
050,53,063,"Washington","Spokane County",5,26,7594,3953,3641
050,53,063,"Washington","Spokane County",5,27,7844,4041,3803
050,53,063,"Washington","Spokane County",5,28,7804,3965,3839
050,53,063,"Washington","Spokane County",5,29,8192,4118,4074
050,53,063,"Washington","Spokane County",5,30,8076,4142,3934
050,53,063,"Washington","Spokane County",5,31,8403,4386,4017
050,53,063,"Washington","Spokane County",5,32,8624,4462,4162
050,53,063,"Washington","Spokane County",5,33,8697,4532,4165
050,53,063,"Washington","Spokane County",5,34,8417,4363,4054
050,53,063,"Washington","Spokane County",5,35,8189,4155,4034
050,53,063,"Washington","Spokane County",5,36,7895,3985,3910
050,53,063,"Washington","Spokane County",5,37,7928,4012,3916
050,53,063,"Washington","Spokane County",5,38,7859,3985,3874
050,53,063,"Washington","Spokane County",5,39,7651,3854,3797
050,53,063,"Washington","Spokane County",5,40,7771,3962,3809
050,53,063,"Washington","Spokane County",5,41,7647,3996,3651
050,53,063,"Washington","Spokane County",5,42,7413,3839,3574
050,53,063,"Washington","Spokane County",5,43,7159,3654,3505
050,53,063,"Washington","Spokane County",5,44,6745,3418,3327
050,53,063,"Washington","Spokane County",5,45,6521,3258,3263
050,53,063,"Washington","Spokane County",5,46,6332,3250,3082
050,53,063,"Washington","Spokane County",5,47,6090,3112,2978
050,53,063,"Washington","Spokane County",5,48,6070,3080,2990
050,53,063,"Washington","Spokane County",5,49,6018,3037,2981
050,53,063,"Washington","Spokane County",5,50,6047,3013,3034
050,53,063,"Washington","Spokane County",5,51,6234,3192,3042
050,53,063,"Washington","Spokane County",5,52,6890,3516,3374
050,53,063,"Washington","Spokane County",5,53,6751,3367,3384
050,53,063,"Washington","Spokane County",5,54,6493,3221,3272
050,53,063,"Washington","Spokane County",5,55,6125,3081,3044
050,53,063,"Washington","Spokane County",5,56,6127,3045,3082
050,53,063,"Washington","Spokane County",5,57,6152,2987,3165
050,53,063,"Washington","Spokane County",5,58,6398,3141,3257
050,53,063,"Washington","Spokane County",5,59,6737,3282,3455
050,53,063,"Washington","Spokane County",5,60,6904,3324,3580
050,53,063,"Washington","Spokane County",5,61,7019,3354,3665
050,53,063,"Washington","Spokane County",5,62,7062,3448,3614
050,53,063,"Washington","Spokane County",5,63,6842,3391,3451
050,53,063,"Washington","Spokane County",5,64,6705,3243,3462
050,53,063,"Washington","Spokane County",5,65,6738,3224,3514
050,53,063,"Washington","Spokane County",5,66,6656,3175,3481
050,53,063,"Washington","Spokane County",5,67,6368,3036,3332
050,53,063,"Washington","Spokane County",5,68,6264,2937,3327
050,53,063,"Washington","Spokane County",5,69,6164,2903,3261
050,53,063,"Washington","Spokane County",5,70,5955,2820,3135
050,53,063,"Washington","Spokane County",5,71,5626,2704,2922
050,53,063,"Washington","Spokane County",5,72,5219,2422,2797
050,53,063,"Washington","Spokane County",5,73,5062,2332,2730
050,53,063,"Washington","Spokane County",5,74,4826,2215,2611
050,53,063,"Washington","Spokane County",5,75,4557,2144,2413
050,53,063,"Washington","Spokane County",5,76,4831,2284,2547
050,53,063,"Washington","Spokane County",5,77,3248,1506,1742
050,53,063,"Washington","Spokane County",5,78,3081,1400,1681
050,53,063,"Washington","Spokane County",5,79,3030,1338,1692
050,53,063,"Washington","Spokane County",5,80,2940,1336,1604
050,53,063,"Washington","Spokane County",5,81,2426,1076,1350
050,53,063,"Washington","Spokane County",5,82,2119,962,1157
050,53,063,"Washington","Spokane County",5,83,1845,822,1023
050,53,063,"Washington","Spokane County",5,84,1622,695,927
050,53,063,"Washington","Spokane County",5,85,9603,3521,6082
050,53,065,"Washington","Stevens County",1,0,407,211,196
050,53,065,"Washington","Stevens County",1,1,429,219,210
050,53,065,"Washington","Stevens County",1,2,460,243,217
050,53,065,"Washington","Stevens County",1,3,469,243,226
050,53,065,"Washington","Stevens County",1,4,525,267,258
050,53,065,"Washington","Stevens County",1,5,527,262,265
050,53,065,"Washington","Stevens County",1,6,550,305,245
050,53,065,"Washington","Stevens County",1,7,552,309,243
050,53,065,"Washington","Stevens County",1,8,542,280,262
050,53,065,"Washington","Stevens County",1,9,568,303,265
050,53,065,"Washington","Stevens County",1,10,558,277,281
050,53,065,"Washington","Stevens County",1,11,604,299,305
050,53,065,"Washington","Stevens County",1,12,624,304,320
050,53,065,"Washington","Stevens County",1,13,618,318,300
050,53,065,"Washington","Stevens County",1,14,627,320,307
050,53,065,"Washington","Stevens County",1,15,650,329,321
050,53,065,"Washington","Stevens County",1,16,613,310,303
050,53,065,"Washington","Stevens County",1,17,586,292,294
050,53,065,"Washington","Stevens County",1,18,503,263,240
050,53,065,"Washington","Stevens County",1,19,385,213,172
050,53,065,"Washington","Stevens County",1,20,403,206,197
050,53,065,"Washington","Stevens County",1,21,398,211,187
050,53,065,"Washington","Stevens County",1,22,407,201,206
050,53,065,"Washington","Stevens County",1,23,395,206,189
050,53,065,"Washington","Stevens County",1,24,410,220,190
050,53,065,"Washington","Stevens County",1,25,423,218,205
050,53,065,"Washington","Stevens County",1,26,463,243,220
050,53,065,"Washington","Stevens County",1,27,476,232,244
050,53,065,"Washington","Stevens County",1,28,424,211,213
050,53,065,"Washington","Stevens County",1,29,454,235,219
050,53,065,"Washington","Stevens County",1,30,446,228,218
050,53,065,"Washington","Stevens County",1,31,424,214,210
050,53,065,"Washington","Stevens County",1,32,400,201,199
050,53,065,"Washington","Stevens County",1,33,441,226,215
050,53,065,"Washington","Stevens County",1,34,474,249,225
050,53,065,"Washington","Stevens County",1,35,465,227,238
050,53,065,"Washington","Stevens County",1,36,505,243,262
050,53,065,"Washington","Stevens County",1,37,510,272,238
050,53,065,"Washington","Stevens County",1,38,493,260,233
050,53,065,"Washington","Stevens County",1,39,472,240,232
050,53,065,"Washington","Stevens County",1,40,510,253,257
050,53,065,"Washington","Stevens County",1,41,534,254,280
050,53,065,"Washington","Stevens County",1,42,530,249,281
050,53,065,"Washington","Stevens County",1,43,491,233,258
050,53,065,"Washington","Stevens County",1,44,471,222,249
050,53,065,"Washington","Stevens County",1,45,508,251,257
050,53,065,"Washington","Stevens County",1,46,455,236,219
050,53,065,"Washington","Stevens County",1,47,483,254,229
050,53,065,"Washington","Stevens County",1,48,515,260,255
050,53,065,"Washington","Stevens County",1,49,598,316,282
050,53,065,"Washington","Stevens County",1,50,587,287,300
050,53,065,"Washington","Stevens County",1,51,564,275,289
050,53,065,"Washington","Stevens County",1,52,542,253,289
050,53,065,"Washington","Stevens County",1,53,533,260,273
050,53,065,"Washington","Stevens County",1,54,562,281,281
050,53,065,"Washington","Stevens County",1,55,614,312,302
050,53,065,"Washington","Stevens County",1,56,658,318,340
050,53,065,"Washington","Stevens County",1,57,710,355,355
050,53,065,"Washington","Stevens County",1,58,719,346,373
050,53,065,"Washington","Stevens County",1,59,752,369,383
050,53,065,"Washington","Stevens County",1,60,816,420,396
050,53,065,"Washington","Stevens County",1,61,848,410,438
050,53,065,"Washington","Stevens County",1,62,886,424,462
050,53,065,"Washington","Stevens County",1,63,834,414,420
050,53,065,"Washington","Stevens County",1,64,870,428,442
050,53,065,"Washington","Stevens County",1,65,829,406,423
050,53,065,"Washington","Stevens County",1,66,798,396,402
050,53,065,"Washington","Stevens County",1,67,805,412,393
050,53,065,"Washington","Stevens County",1,68,800,391,409
050,53,065,"Washington","Stevens County",1,69,735,369,366
050,53,065,"Washington","Stevens County",1,70,740,385,355
050,53,065,"Washington","Stevens County",1,71,693,365,328
050,53,065,"Washington","Stevens County",1,72,654,330,324
050,53,065,"Washington","Stevens County",1,73,622,336,286
050,53,065,"Washington","Stevens County",1,74,450,221,229
050,53,065,"Washington","Stevens County",1,75,456,241,215
050,53,065,"Washington","Stevens County",1,76,439,237,202
050,53,065,"Washington","Stevens County",1,77,419,204,215
050,53,065,"Washington","Stevens County",1,78,378,184,194
050,53,065,"Washington","Stevens County",1,79,322,154,168
050,53,065,"Washington","Stevens County",1,80,291,154,137
050,53,065,"Washington","Stevens County",1,81,244,111,133
050,53,065,"Washington","Stevens County",1,82,249,119,130
050,53,065,"Washington","Stevens County",1,83,189,102,87
050,53,065,"Washington","Stevens County",1,84,171,90,81
050,53,065,"Washington","Stevens County",1,85,896,359,537
050,53,065,"Washington","Stevens County",2,0,398,202,196
050,53,065,"Washington","Stevens County",2,1,427,220,207
050,53,065,"Washington","Stevens County",2,2,450,236,214
050,53,065,"Washington","Stevens County",2,3,472,247,225
050,53,065,"Washington","Stevens County",2,4,517,264,253
050,53,065,"Washington","Stevens County",2,5,530,266,264
050,53,065,"Washington","Stevens County",2,6,552,300,252
050,53,065,"Washington","Stevens County",2,7,552,308,244
050,53,065,"Washington","Stevens County",2,8,550,289,261
050,53,065,"Washington","Stevens County",2,9,561,296,265
050,53,065,"Washington","Stevens County",2,10,565,284,281
050,53,065,"Washington","Stevens County",2,11,595,296,299
050,53,065,"Washington","Stevens County",2,12,625,307,318
050,53,065,"Washington","Stevens County",2,13,626,320,306
050,53,065,"Washington","Stevens County",2,14,631,322,309
050,53,065,"Washington","Stevens County",2,15,647,329,318
050,53,065,"Washington","Stevens County",2,16,627,318,309
050,53,065,"Washington","Stevens County",2,17,592,298,294
050,53,065,"Washington","Stevens County",2,18,492,257,235
050,53,065,"Washington","Stevens County",2,19,389,211,178
050,53,065,"Washington","Stevens County",2,20,403,211,192
050,53,065,"Washington","Stevens County",2,21,398,208,190
050,53,065,"Washington","Stevens County",2,22,409,207,202
050,53,065,"Washington","Stevens County",2,23,403,209,194
050,53,065,"Washington","Stevens County",2,24,409,218,191
050,53,065,"Washington","Stevens County",2,25,420,220,200
050,53,065,"Washington","Stevens County",2,26,453,236,217
050,53,065,"Washington","Stevens County",2,27,475,234,241
050,53,065,"Washington","Stevens County",2,28,446,222,224
050,53,065,"Washington","Stevens County",2,29,451,232,219
050,53,065,"Washington","Stevens County",2,30,449,230,219
050,53,065,"Washington","Stevens County",2,31,426,217,209
050,53,065,"Washington","Stevens County",2,32,412,208,204
050,53,065,"Washington","Stevens County",2,33,436,224,212
050,53,065,"Washington","Stevens County",2,34,471,247,224
050,53,065,"Washington","Stevens County",2,35,479,239,240
050,53,065,"Washington","Stevens County",2,36,501,244,257
050,53,065,"Washington","Stevens County",2,37,515,267,248
050,53,065,"Washington","Stevens County",2,38,503,267,236
050,53,065,"Washington","Stevens County",2,39,480,246,234
050,53,065,"Washington","Stevens County",2,40,509,254,255
050,53,065,"Washington","Stevens County",2,41,529,254,275
050,53,065,"Washington","Stevens County",2,42,534,252,282
050,53,065,"Washington","Stevens County",2,43,508,241,267
050,53,065,"Washington","Stevens County",2,44,473,224,249
050,53,065,"Washington","Stevens County",2,45,498,241,257
050,53,065,"Washington","Stevens County",2,46,471,241,230
050,53,065,"Washington","Stevens County",2,47,474,249,225
050,53,065,"Washington","Stevens County",2,48,507,261,246
050,53,065,"Washington","Stevens County",2,49,586,307,279
050,53,065,"Washington","Stevens County",2,50,592,297,295
050,53,065,"Washington","Stevens County",2,51,569,278,291
050,53,065,"Washington","Stevens County",2,52,543,260,283
050,53,065,"Washington","Stevens County",2,53,536,257,279
050,53,065,"Washington","Stevens County",2,54,554,276,278
050,53,065,"Washington","Stevens County",2,55,603,304,299
050,53,065,"Washington","Stevens County",2,56,653,322,331
050,53,065,"Washington","Stevens County",2,57,699,346,353
050,53,065,"Washington","Stevens County",2,58,721,350,371
050,53,065,"Washington","Stevens County",2,59,752,368,384
050,53,065,"Washington","Stevens County",2,60,799,408,391
050,53,065,"Washington","Stevens County",2,61,842,412,430
050,53,065,"Washington","Stevens County",2,62,880,421,459
050,53,065,"Washington","Stevens County",2,63,854,421,433
050,53,065,"Washington","Stevens County",2,64,857,422,435
050,53,065,"Washington","Stevens County",2,65,839,412,427
050,53,065,"Washington","Stevens County",2,66,808,401,407
050,53,065,"Washington","Stevens County",2,67,803,407,396
050,53,065,"Washington","Stevens County",2,68,793,394,399
050,53,065,"Washington","Stevens County",2,69,758,379,379
050,53,065,"Washington","Stevens County",2,70,735,379,356
050,53,065,"Washington","Stevens County",2,71,703,370,333
050,53,065,"Washington","Stevens County",2,72,646,330,316
050,53,065,"Washington","Stevens County",2,73,655,345,310
050,53,065,"Washington","Stevens County",2,74,463,234,229
050,53,065,"Washington","Stevens County",2,75,450,233,217
050,53,065,"Washington","Stevens County",2,76,437,233,204
050,53,065,"Washington","Stevens County",2,77,434,217,217
050,53,065,"Washington","Stevens County",2,78,377,182,195
050,53,065,"Washington","Stevens County",2,79,331,159,172
050,53,065,"Washington","Stevens County",2,80,299,155,144
050,53,065,"Washington","Stevens County",2,81,251,121,130
050,53,065,"Washington","Stevens County",2,82,249,117,132
050,53,065,"Washington","Stevens County",2,83,198,103,95
050,53,065,"Washington","Stevens County",2,84,175,92,83
050,53,065,"Washington","Stevens County",2,85,907,371,536
050,53,065,"Washington","Stevens County",3,0,440,229,211
050,53,065,"Washington","Stevens County",3,1,402,206,196
050,53,065,"Washington","Stevens County",3,2,453,234,219
050,53,065,"Washington","Stevens County",3,3,466,234,232
050,53,065,"Washington","Stevens County",3,4,495,257,238
050,53,065,"Washington","Stevens County",3,5,545,282,263
050,53,065,"Washington","Stevens County",3,6,548,284,264
050,53,065,"Washington","Stevens County",3,7,584,312,272
050,53,065,"Washington","Stevens County",3,8,579,318,261
050,53,065,"Washington","Stevens County",3,9,582,305,277
050,53,065,"Washington","Stevens County",3,10,586,314,272
050,53,065,"Washington","Stevens County",3,11,588,294,294
050,53,065,"Washington","Stevens County",3,12,609,311,298
050,53,065,"Washington","Stevens County",3,13,638,312,326
050,53,065,"Washington","Stevens County",3,14,658,338,320
050,53,065,"Washington","Stevens County",3,15,654,336,318
050,53,065,"Washington","Stevens County",3,16,646,331,315
050,53,065,"Washington","Stevens County",3,17,644,334,310
050,53,065,"Washington","Stevens County",3,18,512,266,246
050,53,065,"Washington","Stevens County",3,19,356,172,184
050,53,065,"Washington","Stevens County",3,20,402,209,193
050,53,065,"Washington","Stevens County",3,21,422,215,207
050,53,065,"Washington","Stevens County",3,22,404,208,196
050,53,065,"Washington","Stevens County",3,23,437,222,215
050,53,065,"Washington","Stevens County",3,24,425,220,205
050,53,065,"Washington","Stevens County",3,25,413,218,195
050,53,065,"Washington","Stevens County",3,26,416,224,192
050,53,065,"Washington","Stevens County",3,27,475,238,237
050,53,065,"Washington","Stevens County",3,28,494,241,253
050,53,065,"Washington","Stevens County",3,29,455,227,228
050,53,065,"Washington","Stevens County",3,30,474,253,221
050,53,065,"Washington","Stevens County",3,31,474,237,237
050,53,065,"Washington","Stevens County",3,32,461,232,229
050,53,065,"Washington","Stevens County",3,33,459,234,225
050,53,065,"Washington","Stevens County",3,34,469,241,228
050,53,065,"Washington","Stevens County",3,35,491,267,224
050,53,065,"Washington","Stevens County",3,36,497,246,251
050,53,065,"Washington","Stevens County",3,37,543,265,278
050,53,065,"Washington","Stevens County",3,38,533,279,254
050,53,065,"Washington","Stevens County",3,39,524,277,247
050,53,065,"Washington","Stevens County",3,40,505,245,260
050,53,065,"Washington","Stevens County",3,41,515,255,260
050,53,065,"Washington","Stevens County",3,42,542,268,274
050,53,065,"Washington","Stevens County",3,43,560,265,295
050,53,065,"Washington","Stevens County",3,44,530,252,278
050,53,065,"Washington","Stevens County",3,45,489,229,260
050,53,065,"Washington","Stevens County",3,46,513,253,260
050,53,065,"Washington","Stevens County",3,47,474,250,224
050,53,065,"Washington","Stevens County",3,48,471,248,223
050,53,065,"Washington","Stevens County",3,49,513,267,246
050,53,065,"Washington","Stevens County",3,50,605,310,295
050,53,065,"Washington","Stevens County",3,51,602,303,299
050,53,065,"Washington","Stevens County",3,52,579,287,292
050,53,065,"Washington","Stevens County",3,53,553,265,288
050,53,065,"Washington","Stevens County",3,54,565,268,297
050,53,065,"Washington","Stevens County",3,55,583,290,293
050,53,065,"Washington","Stevens County",3,56,614,314,300
050,53,065,"Washington","Stevens County",3,57,699,345,354
050,53,065,"Washington","Stevens County",3,58,724,357,367
050,53,065,"Washington","Stevens County",3,59,739,363,376
050,53,065,"Washington","Stevens County",3,60,750,363,387
050,53,065,"Washington","Stevens County",3,61,813,410,403
050,53,065,"Washington","Stevens County",3,62,855,415,440
050,53,065,"Washington","Stevens County",3,63,885,429,456
050,53,065,"Washington","Stevens County",3,64,856,416,440
050,53,065,"Washington","Stevens County",3,65,862,435,427
050,53,065,"Washington","Stevens County",3,66,853,427,426
050,53,065,"Washington","Stevens County",3,67,807,400,407
050,53,065,"Washington","Stevens County",3,68,818,414,404
050,53,065,"Washington","Stevens County",3,69,800,397,403
050,53,065,"Washington","Stevens County",3,70,756,368,388
050,53,065,"Washington","Stevens County",3,71,724,373,351
050,53,065,"Washington","Stevens County",3,72,692,351,341
050,53,065,"Washington","Stevens County",3,73,622,323,299
050,53,065,"Washington","Stevens County",3,74,654,343,311
050,53,065,"Washington","Stevens County",3,75,455,227,228
050,53,065,"Washington","Stevens County",3,76,439,226,213
050,53,065,"Washington","Stevens County",3,77,409,213,196
050,53,065,"Washington","Stevens County",3,78,412,207,205
050,53,065,"Washington","Stevens County",3,79,353,170,183
050,53,065,"Washington","Stevens County",3,80,306,146,160
050,53,065,"Washington","Stevens County",3,81,283,143,140
050,53,065,"Washington","Stevens County",3,82,242,110,132
050,53,065,"Washington","Stevens County",3,83,221,108,113
050,53,065,"Washington","Stevens County",3,84,178,91,87
050,53,065,"Washington","Stevens County",3,85,946,395,551
050,53,065,"Washington","Stevens County",4,0,452,233,219
050,53,065,"Washington","Stevens County",4,1,445,227,218
050,53,065,"Washington","Stevens County",4,2,419,226,193
050,53,065,"Washington","Stevens County",4,3,463,254,209
050,53,065,"Washington","Stevens County",4,4,497,257,240
050,53,065,"Washington","Stevens County",4,5,502,263,239
050,53,065,"Washington","Stevens County",4,6,569,301,268
050,53,065,"Washington","Stevens County",4,7,553,282,271
050,53,065,"Washington","Stevens County",4,8,585,311,274
050,53,065,"Washington","Stevens County",4,9,605,328,277
050,53,065,"Washington","Stevens County",4,10,582,301,281
050,53,065,"Washington","Stevens County",4,11,603,319,284
050,53,065,"Washington","Stevens County",4,12,593,300,293
050,53,065,"Washington","Stevens County",4,13,634,330,304
050,53,065,"Washington","Stevens County",4,14,658,321,337
050,53,065,"Washington","Stevens County",4,15,675,354,321
050,53,065,"Washington","Stevens County",4,16,652,334,318
050,53,065,"Washington","Stevens County",4,17,656,341,315
050,53,065,"Washington","Stevens County",4,18,535,283,252
050,53,065,"Washington","Stevens County",4,19,379,194,185
050,53,065,"Washington","Stevens County",4,20,369,178,191
050,53,065,"Washington","Stevens County",4,21,410,214,196
050,53,065,"Washington","Stevens County",4,22,449,236,213
050,53,065,"Washington","Stevens County",4,23,423,228,195
050,53,065,"Washington","Stevens County",4,24,450,208,242
050,53,065,"Washington","Stevens County",4,25,424,219,205
050,53,065,"Washington","Stevens County",4,26,415,217,198
050,53,065,"Washington","Stevens County",4,27,431,216,215
050,53,065,"Washington","Stevens County",4,28,466,245,221
050,53,065,"Washington","Stevens County",4,29,523,249,274
050,53,065,"Washington","Stevens County",4,30,486,246,240
050,53,065,"Washington","Stevens County",4,31,495,268,227
050,53,065,"Washington","Stevens County",4,32,492,239,253
050,53,065,"Washington","Stevens County",4,33,490,248,242
050,53,065,"Washington","Stevens County",4,34,473,246,227
050,53,065,"Washington","Stevens County",4,35,493,254,239
050,53,065,"Washington","Stevens County",4,36,526,290,236
050,53,065,"Washington","Stevens County",4,37,498,244,254
050,53,065,"Washington","Stevens County",4,38,563,279,284
050,53,065,"Washington","Stevens County",4,39,555,277,278
050,53,065,"Washington","Stevens County",4,40,543,280,263
050,53,065,"Washington","Stevens County",4,41,525,263,262
050,53,065,"Washington","Stevens County",4,42,539,278,261
050,53,065,"Washington","Stevens County",4,43,564,285,279
050,53,065,"Washington","Stevens County",4,44,561,271,290
050,53,065,"Washington","Stevens County",4,45,536,255,281
050,53,065,"Washington","Stevens County",4,46,498,238,260
050,53,065,"Washington","Stevens County",4,47,515,256,259
050,53,065,"Washington","Stevens County",4,48,498,261,237
050,53,065,"Washington","Stevens County",4,49,479,256,223
050,53,065,"Washington","Stevens County",4,50,515,266,249
050,53,065,"Washington","Stevens County",4,51,632,322,310
050,53,065,"Washington","Stevens County",4,52,618,311,307
050,53,065,"Washington","Stevens County",4,53,601,298,303
050,53,065,"Washington","Stevens County",4,54,560,274,286
050,53,065,"Washington","Stevens County",4,55,577,279,298
050,53,065,"Washington","Stevens County",4,56,598,292,306
050,53,065,"Washington","Stevens County",4,57,635,326,309
050,53,065,"Washington","Stevens County",4,58,705,345,360
050,53,065,"Washington","Stevens County",4,59,731,361,370
050,53,065,"Washington","Stevens County",4,60,742,364,378
050,53,065,"Washington","Stevens County",4,61,771,370,401
050,53,065,"Washington","Stevens County",4,62,819,421,398
050,53,065,"Washington","Stevens County",4,63,858,422,436
050,53,065,"Washington","Stevens County",4,64,890,430,460
050,53,065,"Washington","Stevens County",4,65,867,428,439
050,53,065,"Washington","Stevens County",4,66,869,432,437
050,53,065,"Washington","Stevens County",4,67,858,424,434
050,53,065,"Washington","Stevens County",4,68,815,396,419
050,53,065,"Washington","Stevens County",4,69,818,418,400
050,53,065,"Washington","Stevens County",4,70,788,384,404
050,53,065,"Washington","Stevens County",4,71,750,367,383
050,53,065,"Washington","Stevens County",4,72,712,360,352
050,53,065,"Washington","Stevens County",4,73,665,342,323
050,53,065,"Washington","Stevens County",4,74,618,324,294
050,53,065,"Washington","Stevens County",4,75,635,327,308
050,53,065,"Washington","Stevens County",4,76,436,212,224
050,53,065,"Washington","Stevens County",4,77,403,205,198
050,53,065,"Washington","Stevens County",4,78,395,208,187
050,53,065,"Washington","Stevens County",4,79,378,192,186
050,53,065,"Washington","Stevens County",4,80,340,162,178
050,53,065,"Washington","Stevens County",4,81,283,128,155
050,53,065,"Washington","Stevens County",4,82,260,131,129
050,53,065,"Washington","Stevens County",4,83,215,101,114
050,53,065,"Washington","Stevens County",4,84,204,97,107
050,53,065,"Washington","Stevens County",4,85,976,423,553
050,53,065,"Washington","Stevens County",5,0,437,222,215
050,53,065,"Washington","Stevens County",5,1,495,259,236
050,53,065,"Washington","Stevens County",5,2,445,232,213
050,53,065,"Washington","Stevens County",5,3,447,235,212
050,53,065,"Washington","Stevens County",5,4,475,256,219
050,53,065,"Washington","Stevens County",5,5,506,263,243
050,53,065,"Washington","Stevens County",5,6,515,272,243
050,53,065,"Washington","Stevens County",5,7,587,307,280
050,53,065,"Washington","Stevens County",5,8,571,293,278
050,53,065,"Washington","Stevens County",5,9,611,318,293
050,53,065,"Washington","Stevens County",5,10,628,336,292
050,53,065,"Washington","Stevens County",5,11,608,312,296
050,53,065,"Washington","Stevens County",5,12,616,327,289
050,53,065,"Washington","Stevens County",5,13,594,307,287
050,53,065,"Washington","Stevens County",5,14,629,322,307
050,53,065,"Washington","Stevens County",5,15,665,315,350
050,53,065,"Washington","Stevens County",5,16,680,360,320
050,53,065,"Washington","Stevens County",5,17,642,328,314
050,53,065,"Washington","Stevens County",5,18,526,286,240
050,53,065,"Washington","Stevens County",5,19,401,220,181
050,53,065,"Washington","Stevens County",5,20,405,209,196
050,53,065,"Washington","Stevens County",5,21,386,180,206
050,53,065,"Washington","Stevens County",5,22,449,234,215
050,53,065,"Washington","Stevens County",5,23,436,236,200
050,53,065,"Washington","Stevens County",5,24,419,218,201
050,53,065,"Washington","Stevens County",5,25,435,218,217
050,53,065,"Washington","Stevens County",5,26,446,227,219
050,53,065,"Washington","Stevens County",5,27,420,220,200
050,53,065,"Washington","Stevens County",5,28,450,237,213
050,53,065,"Washington","Stevens County",5,29,485,256,229
050,53,065,"Washington","Stevens County",5,30,545,245,300
050,53,065,"Washington","Stevens County",5,31,507,253,254
050,53,065,"Washington","Stevens County",5,32,517,269,248
050,53,065,"Washington","Stevens County",5,33,514,248,266
050,53,065,"Washington","Stevens County",5,34,500,251,249
050,53,065,"Washington","Stevens County",5,35,502,259,243
050,53,065,"Washington","Stevens County",5,36,501,261,240
050,53,065,"Washington","Stevens County",5,37,535,291,244
050,53,065,"Washington","Stevens County",5,38,524,258,266
050,53,065,"Washington","Stevens County",5,39,582,281,301
050,53,065,"Washington","Stevens County",5,40,576,287,289
050,53,065,"Washington","Stevens County",5,41,560,296,264
050,53,065,"Washington","Stevens County",5,42,549,271,278
050,53,065,"Washington","Stevens County",5,43,538,276,262
050,53,065,"Washington","Stevens County",5,44,570,282,288
050,53,065,"Washington","Stevens County",5,45,570,268,302
050,53,065,"Washington","Stevens County",5,46,555,264,291
050,53,065,"Washington","Stevens County",5,47,510,242,268
050,53,065,"Washington","Stevens County",5,48,514,259,255
050,53,065,"Washington","Stevens County",5,49,508,271,237
050,53,065,"Washington","Stevens County",5,50,503,264,239
050,53,065,"Washington","Stevens County",5,51,527,268,259
050,53,065,"Washington","Stevens County",5,52,632,326,306
050,53,065,"Washington","Stevens County",5,53,617,306,311
050,53,065,"Washington","Stevens County",5,54,623,302,321
050,53,065,"Washington","Stevens County",5,55,584,281,303
050,53,065,"Washington","Stevens County",5,56,604,295,309
050,53,065,"Washington","Stevens County",5,57,627,308,319
050,53,065,"Washington","Stevens County",5,58,641,336,305
050,53,065,"Washington","Stevens County",5,59,725,353,372
050,53,065,"Washington","Stevens County",5,60,753,375,378
050,53,065,"Washington","Stevens County",5,61,762,383,379
050,53,065,"Washington","Stevens County",5,62,788,374,414
050,53,065,"Washington","Stevens County",5,63,825,421,404
050,53,065,"Washington","Stevens County",5,64,873,429,444
050,53,065,"Washington","Stevens County",5,65,893,436,457
050,53,065,"Washington","Stevens County",5,66,867,429,438
050,53,065,"Washington","Stevens County",5,67,852,415,437
050,53,065,"Washington","Stevens County",5,68,857,422,435
050,53,065,"Washington","Stevens County",5,69,808,386,422
050,53,065,"Washington","Stevens County",5,70,801,406,395
050,53,065,"Washington","Stevens County",5,71,776,375,401
050,53,065,"Washington","Stevens County",5,72,736,357,379
050,53,065,"Washington","Stevens County",5,73,683,360,323
050,53,065,"Washington","Stevens County",5,74,648,330,318
050,53,065,"Washington","Stevens County",5,75,602,315,287
050,53,065,"Washington","Stevens County",5,76,609,311,298
050,53,065,"Washington","Stevens County",5,77,418,207,211
050,53,065,"Washington","Stevens County",5,78,391,200,191
050,53,065,"Washington","Stevens County",5,79,362,196,166
050,53,065,"Washington","Stevens County",5,80,355,179,176
050,53,065,"Washington","Stevens County",5,81,308,141,167
050,53,065,"Washington","Stevens County",5,82,269,117,152
050,53,065,"Washington","Stevens County",5,83,232,118,114
050,53,065,"Washington","Stevens County",5,84,194,87,107
050,53,065,"Washington","Stevens County",5,85,1006,452,554
050,53,067,"Washington","Thurston County",1,0,3081,1580,1501
050,53,067,"Washington","Thurston County",1,1,3204,1635,1569
050,53,067,"Washington","Thurston County",1,2,3262,1696,1566
050,53,067,"Washington","Thurston County",1,3,3449,1812,1637
050,53,067,"Washington","Thurston County",1,4,3689,1912,1777
050,53,067,"Washington","Thurston County",1,5,3611,1846,1765
050,53,067,"Washington","Thurston County",1,6,3568,1829,1739
050,53,067,"Washington","Thurston County",1,7,3611,1840,1771
050,53,067,"Washington","Thurston County",1,8,3612,1862,1750
050,53,067,"Washington","Thurston County",1,9,3489,1850,1639
050,53,067,"Washington","Thurston County",1,10,3562,1883,1679
050,53,067,"Washington","Thurston County",1,11,3698,1914,1784
050,53,067,"Washington","Thurston County",1,12,3688,1908,1780
050,53,067,"Washington","Thurston County",1,13,3631,1865,1766
050,53,067,"Washington","Thurston County",1,14,3534,1817,1717
050,53,067,"Washington","Thurston County",1,15,3493,1764,1729
050,53,067,"Washington","Thurston County",1,16,3560,1821,1739
050,53,067,"Washington","Thurston County",1,17,3484,1752,1732
050,53,067,"Washington","Thurston County",1,18,3149,1598,1551
050,53,067,"Washington","Thurston County",1,19,2884,1484,1400
050,53,067,"Washington","Thurston County",1,20,3028,1533,1495
050,53,067,"Washington","Thurston County",1,21,3227,1637,1590
050,53,067,"Washington","Thurston County",1,22,3392,1686,1706
050,53,067,"Washington","Thurston County",1,23,3627,1781,1846
050,53,067,"Washington","Thurston County",1,24,3735,1907,1828
050,53,067,"Washington","Thurston County",1,25,3871,1982,1889
050,53,067,"Washington","Thurston County",1,26,4023,2057,1966
050,53,067,"Washington","Thurston County",1,27,4103,2123,1980
050,53,067,"Washington","Thurston County",1,28,4401,2243,2158
050,53,067,"Washington","Thurston County",1,29,4528,2335,2193
050,53,067,"Washington","Thurston County",1,30,4378,2230,2148
050,53,067,"Washington","Thurston County",1,31,4291,2172,2119
050,53,067,"Washington","Thurston County",1,32,4232,2120,2112
050,53,067,"Washington","Thurston County",1,33,4285,2111,2174
050,53,067,"Washington","Thurston County",1,34,4293,2124,2169
050,53,067,"Washington","Thurston County",1,35,4268,2119,2149
050,53,067,"Washington","Thurston County",1,36,4407,2215,2192
050,53,067,"Washington","Thurston County",1,37,4392,2169,2223
050,53,067,"Washington","Thurston County",1,38,4434,2186,2248
050,53,067,"Washington","Thurston County",1,39,4338,2167,2171
050,53,067,"Washington","Thurston County",1,40,4185,2137,2048
050,53,067,"Washington","Thurston County",1,41,3953,1976,1977
050,53,067,"Washington","Thurston County",1,42,3915,1936,1979
050,53,067,"Washington","Thurston County",1,43,3736,1830,1906
050,53,067,"Washington","Thurston County",1,44,3606,1797,1809
050,53,067,"Washington","Thurston County",1,45,3529,1756,1773
050,53,067,"Washington","Thurston County",1,46,3370,1696,1674
050,53,067,"Washington","Thurston County",1,47,3326,1639,1687
050,53,067,"Washington","Thurston County",1,48,3537,1783,1754
050,53,067,"Washington","Thurston County",1,49,3873,1955,1918
050,53,067,"Washington","Thurston County",1,50,3702,1843,1859
050,53,067,"Washington","Thurston County",1,51,3579,1762,1817
050,53,067,"Washington","Thurston County",1,52,3426,1683,1743
050,53,067,"Washington","Thurston County",1,53,3421,1703,1718
050,53,067,"Washington","Thurston County",1,54,3451,1714,1737
050,53,067,"Washington","Thurston County",1,55,3624,1727,1897
050,53,067,"Washington","Thurston County",1,56,3686,1750,1936
050,53,067,"Washington","Thurston County",1,57,3719,1782,1937
050,53,067,"Washington","Thurston County",1,58,3738,1769,1969
050,53,067,"Washington","Thurston County",1,59,3838,1851,1987
050,53,067,"Washington","Thurston County",1,60,3843,1831,2012
050,53,067,"Washington","Thurston County",1,61,3776,1774,2002
050,53,067,"Washington","Thurston County",1,62,3792,1817,1975
050,53,067,"Washington","Thurston County",1,63,3758,1787,1971
050,53,067,"Washington","Thurston County",1,64,3724,1730,1994
050,53,067,"Washington","Thurston County",1,65,3719,1716,2003
050,53,067,"Washington","Thurston County",1,66,3692,1642,2050
050,53,067,"Washington","Thurston County",1,67,3701,1682,2019
050,53,067,"Washington","Thurston County",1,68,3515,1636,1879
050,53,067,"Washington","Thurston County",1,69,3353,1540,1813
050,53,067,"Washington","Thurston County",1,70,3275,1488,1787
050,53,067,"Washington","Thurston County",1,71,3117,1433,1684
050,53,067,"Washington","Thurston County",1,72,3150,1481,1669
050,53,067,"Washington","Thurston County",1,73,3060,1472,1588
050,53,067,"Washington","Thurston County",1,74,2093,998,1095
050,53,067,"Washington","Thurston County",1,75,2125,988,1137
050,53,067,"Washington","Thurston County",1,76,2080,937,1143
050,53,067,"Washington","Thurston County",1,77,1973,877,1096
050,53,067,"Washington","Thurston County",1,78,1620,749,871
050,53,067,"Washington","Thurston County",1,79,1376,644,732
050,53,067,"Washington","Thurston County",1,80,1221,543,678
050,53,067,"Washington","Thurston County",1,81,1164,530,634
050,53,067,"Washington","Thurston County",1,82,1092,464,628
050,53,067,"Washington","Thurston County",1,83,944,426,518
050,53,067,"Washington","Thurston County",1,84,855,386,469
050,53,067,"Washington","Thurston County",1,85,5048,1779,3269
050,53,067,"Washington","Thurston County",2,0,3125,1609,1516
050,53,067,"Washington","Thurston County",2,1,3196,1631,1565
050,53,067,"Washington","Thurston County",2,2,3282,1700,1582
050,53,067,"Washington","Thurston County",2,3,3434,1799,1635
050,53,067,"Washington","Thurston County",2,4,3661,1900,1761
050,53,067,"Washington","Thurston County",2,5,3659,1874,1785
050,53,067,"Washington","Thurston County",2,6,3597,1845,1752
050,53,067,"Washington","Thurston County",2,7,3606,1839,1767
050,53,067,"Washington","Thurston County",2,8,3608,1856,1752
050,53,067,"Washington","Thurston County",2,9,3519,1857,1662
050,53,067,"Washington","Thurston County",2,10,3555,1881,1674
050,53,067,"Washington","Thurston County",2,11,3657,1904,1753
050,53,067,"Washington","Thurston County",2,12,3695,1914,1781
050,53,067,"Washington","Thurston County",2,13,3648,1879,1769
050,53,067,"Washington","Thurston County",2,14,3563,1833,1730
050,53,067,"Washington","Thurston County",2,15,3511,1784,1727
050,53,067,"Washington","Thurston County",2,16,3551,1810,1741
050,53,067,"Washington","Thurston County",2,17,3498,1769,1729
050,53,067,"Washington","Thurston County",2,18,3157,1597,1560
050,53,067,"Washington","Thurston County",2,19,2892,1483,1409
050,53,067,"Washington","Thurston County",2,20,3088,1562,1526
050,53,067,"Washington","Thurston County",2,21,3201,1619,1582
050,53,067,"Washington","Thurston County",2,22,3423,1706,1717
050,53,067,"Washington","Thurston County",2,23,3635,1791,1844
050,53,067,"Washington","Thurston County",2,24,3731,1893,1838
050,53,067,"Washington","Thurston County",2,25,3892,1995,1897
050,53,067,"Washington","Thurston County",2,26,4019,2058,1961
050,53,067,"Washington","Thurston County",2,27,4117,2124,1993
050,53,067,"Washington","Thurston County",2,28,4384,2251,2133
050,53,067,"Washington","Thurston County",2,29,4523,2319,2204
050,53,067,"Washington","Thurston County",2,30,4458,2269,2189
050,53,067,"Washington","Thurston County",2,31,4314,2187,2127
050,53,067,"Washington","Thurston County",2,32,4253,2133,2120
050,53,067,"Washington","Thurston County",2,33,4298,2123,2175
050,53,067,"Washington","Thurston County",2,34,4312,2139,2173
050,53,067,"Washington","Thurston County",2,35,4326,2151,2175
050,53,067,"Washington","Thurston County",2,36,4365,2185,2180
050,53,067,"Washington","Thurston County",2,37,4418,2186,2232
050,53,067,"Washington","Thurston County",2,38,4442,2192,2250
050,53,067,"Washington","Thurston County",2,39,4366,2178,2188
050,53,067,"Washington","Thurston County",2,40,4261,2161,2100
050,53,067,"Washington","Thurston County",2,41,4002,2008,1994
050,53,067,"Washington","Thurston County",2,42,3900,1936,1964
050,53,067,"Washington","Thurston County",2,43,3799,1863,1936
050,53,067,"Washington","Thurston County",2,44,3612,1789,1823
050,53,067,"Washington","Thurston County",2,45,3575,1783,1792
050,53,067,"Washington","Thurston County",2,46,3407,1706,1701
050,53,067,"Washington","Thurston County",2,47,3329,1651,1678
050,53,067,"Washington","Thurston County",2,48,3486,1750,1736
050,53,067,"Washington","Thurston County",2,49,3804,1917,1887
050,53,067,"Washington","Thurston County",2,50,3750,1873,1877
050,53,067,"Washington","Thurston County",2,51,3600,1777,1823
050,53,067,"Washington","Thurston County",2,52,3465,1701,1764
050,53,067,"Washington","Thurston County",2,53,3424,1695,1729
050,53,067,"Washington","Thurston County",2,54,3431,1704,1727
050,53,067,"Washington","Thurston County",2,55,3593,1727,1866
050,53,067,"Washington","Thurston County",2,56,3685,1749,1936
050,53,067,"Washington","Thurston County",2,57,3726,1780,1946
050,53,067,"Washington","Thurston County",2,58,3735,1769,1966
050,53,067,"Washington","Thurston County",2,59,3835,1841,1994
050,53,067,"Washington","Thurston County",2,60,3835,1834,2001
050,53,067,"Washington","Thurston County",2,61,3783,1778,2005
050,53,067,"Washington","Thurston County",2,62,3795,1808,1987
050,53,067,"Washington","Thurston County",2,63,3794,1813,1981
050,53,067,"Washington","Thurston County",2,64,3707,1734,1973
050,53,067,"Washington","Thurston County",2,65,3719,1712,2007
050,53,067,"Washington","Thurston County",2,66,3703,1658,2045
050,53,067,"Washington","Thurston County",2,67,3685,1664,2021
050,53,067,"Washington","Thurston County",2,68,3549,1645,1904
050,53,067,"Washington","Thurston County",2,69,3397,1564,1833
050,53,067,"Washington","Thurston County",2,70,3286,1492,1794
050,53,067,"Washington","Thurston County",2,71,3157,1442,1715
050,53,067,"Washington","Thurston County",2,72,3082,1444,1638
050,53,067,"Washington","Thurston County",2,73,3219,1542,1677
050,53,067,"Washington","Thurston County",2,74,2182,1038,1144
050,53,067,"Washington","Thurston County",2,75,2115,987,1128
050,53,067,"Washington","Thurston County",2,76,2063,937,1126
050,53,067,"Washington","Thurston County",2,77,2031,904,1127
050,53,067,"Washington","Thurston County",2,78,1670,766,904
050,53,067,"Washington","Thurston County",2,79,1409,650,759
050,53,067,"Washington","Thurston County",2,80,1245,553,692
050,53,067,"Washington","Thurston County",2,81,1156,519,637
050,53,067,"Washington","Thurston County",2,82,1102,473,629
050,53,067,"Washington","Thurston County",2,83,960,426,534
050,53,067,"Washington","Thurston County",2,84,860,386,474
050,53,067,"Washington","Thurston County",2,85,5096,1808,3288
050,53,067,"Washington","Thurston County",3,0,3046,1533,1513
050,53,067,"Washington","Thurston County",3,1,3244,1709,1535
050,53,067,"Washington","Thurston County",3,2,3216,1661,1555
050,53,067,"Washington","Thurston County",3,3,3280,1676,1604
050,53,067,"Washington","Thurston County",3,4,3457,1806,1651
050,53,067,"Washington","Thurston County",3,5,3658,1887,1771
050,53,067,"Washington","Thurston County",3,6,3682,1890,1792
050,53,067,"Washington","Thurston County",3,7,3627,1869,1758
050,53,067,"Washington","Thurston County",3,8,3587,1825,1762
050,53,067,"Washington","Thurston County",3,9,3632,1898,1734
050,53,067,"Washington","Thurston County",3,10,3507,1830,1677
050,53,067,"Washington","Thurston County",3,11,3620,1890,1730
050,53,067,"Washington","Thurston County",3,12,3695,1931,1764
050,53,067,"Washington","Thurston County",3,13,3688,1921,1767
050,53,067,"Washington","Thurston County",3,14,3648,1869,1779
050,53,067,"Washington","Thurston County",3,15,3564,1827,1737
050,53,067,"Washington","Thurston County",3,16,3499,1776,1723
050,53,067,"Washington","Thurston County",3,17,3548,1794,1754
050,53,067,"Washington","Thurston County",3,18,3119,1588,1531
050,53,067,"Washington","Thurston County",3,19,2650,1371,1279
050,53,067,"Washington","Thurston County",3,20,2923,1482,1441
050,53,067,"Washington","Thurston County",3,21,3086,1547,1539
050,53,067,"Washington","Thurston County",3,22,3438,1748,1690
050,53,067,"Washington","Thurston County",3,23,3647,1843,1804
050,53,067,"Washington","Thurston County",3,24,3711,1866,1845
050,53,067,"Washington","Thurston County",3,25,3990,2050,1940
050,53,067,"Washington","Thurston County",3,26,4004,2036,1968
050,53,067,"Washington","Thurston County",3,27,4138,2139,1999
050,53,067,"Washington","Thurston County",3,28,4258,2176,2082
050,53,067,"Washington","Thurston County",3,29,4397,2257,2140
050,53,067,"Washington","Thurston County",3,30,4613,2348,2265
050,53,067,"Washington","Thurston County",3,31,4486,2269,2217
050,53,067,"Washington","Thurston County",3,32,4427,2264,2163
050,53,067,"Washington","Thurston County",3,33,4323,2170,2153
050,53,067,"Washington","Thurston County",3,34,4393,2197,2196
050,53,067,"Washington","Thurston County",3,35,4335,2184,2151
050,53,067,"Washington","Thurston County",3,36,4419,2193,2226
050,53,067,"Washington","Thurston County",3,37,4394,2189,2205
050,53,067,"Washington","Thurston County",3,38,4441,2213,2228
050,53,067,"Washington","Thurston County",3,39,4526,2261,2265
050,53,067,"Washington","Thurston County",3,40,4424,2205,2219
050,53,067,"Washington","Thurston County",3,41,4256,2142,2114
050,53,067,"Washington","Thurston County",3,42,3993,2006,1987
050,53,067,"Washington","Thurston County",3,43,3901,1929,1972
050,53,067,"Washington","Thurston County",3,44,3812,1878,1934
050,53,067,"Washington","Thurston County",3,45,3623,1789,1834
050,53,067,"Washington","Thurston County",3,46,3533,1742,1791
050,53,067,"Washington","Thurston County",3,47,3393,1712,1681
050,53,067,"Washington","Thurston County",3,48,3330,1657,1673
050,53,067,"Washington","Thurston County",3,49,3495,1733,1762
050,53,067,"Washington","Thurston County",3,50,3827,1932,1895
050,53,067,"Washington","Thurston County",3,51,3737,1856,1881
050,53,067,"Washington","Thurston County",3,52,3632,1804,1828
050,53,067,"Washington","Thurston County",3,53,3443,1703,1740
050,53,067,"Washington","Thurston County",3,54,3404,1695,1709
050,53,067,"Washington","Thurston County",3,55,3417,1702,1715
050,53,067,"Washington","Thurston County",3,56,3551,1686,1865
050,53,067,"Washington","Thurston County",3,57,3633,1736,1897
050,53,067,"Washington","Thurston County",3,58,3703,1752,1951
050,53,067,"Washington","Thurston County",3,59,3714,1749,1965
050,53,067,"Washington","Thurston County",3,60,3795,1815,1980
050,53,067,"Washington","Thurston County",3,61,3803,1791,2012
050,53,067,"Washington","Thurston County",3,62,3772,1750,2022
050,53,067,"Washington","Thurston County",3,63,3738,1796,1942
050,53,067,"Washington","Thurston County",3,64,3757,1806,1951
050,53,067,"Washington","Thurston County",3,65,3665,1690,1975
050,53,067,"Washington","Thurston County",3,66,3671,1675,1996
050,53,067,"Washington","Thurston County",3,67,3683,1643,2040
050,53,067,"Washington","Thurston County",3,68,3665,1661,2004
050,53,067,"Washington","Thurston County",3,69,3485,1606,1879
050,53,067,"Washington","Thurston County",3,70,3361,1545,1816
050,53,067,"Washington","Thurston County",3,71,3260,1472,1788
050,53,067,"Washington","Thurston County",3,72,3125,1427,1698
050,53,067,"Washington","Thurston County",3,73,3024,1406,1618
050,53,067,"Washington","Thurston County",3,74,3139,1485,1654
050,53,067,"Washington","Thurston County",3,75,2144,1002,1142
050,53,067,"Washington","Thurston County",3,76,2042,951,1091
050,53,067,"Washington","Thurston County",3,77,2012,910,1102
050,53,067,"Washington","Thurston County",3,78,1978,865,1113
050,53,067,"Washington","Thurston County",3,79,1604,726,878
050,53,067,"Washington","Thurston County",3,80,1327,593,734
050,53,067,"Washington","Thurston County",3,81,1201,526,675
050,53,067,"Washington","Thurston County",3,82,1091,488,603
050,53,067,"Washington","Thurston County",3,83,1032,435,597
050,53,067,"Washington","Thurston County",3,84,891,380,511
050,53,067,"Washington","Thurston County",3,85,5194,1862,3332
050,53,067,"Washington","Thurston County",4,0,3051,1556,1495
050,53,067,"Washington","Thurston County",4,1,3059,1548,1511
050,53,067,"Washington","Thurston County",4,2,3171,1670,1501
050,53,067,"Washington","Thurston County",4,3,3244,1686,1558
050,53,067,"Washington","Thurston County",4,4,3275,1683,1592
050,53,067,"Washington","Thurston County",4,5,3479,1813,1666
050,53,067,"Washington","Thurston County",4,6,3654,1879,1775
050,53,067,"Washington","Thurston County",4,7,3641,1860,1781
050,53,067,"Washington","Thurston County",4,8,3579,1842,1737
050,53,067,"Washington","Thurston County",4,9,3517,1841,1676
050,53,067,"Washington","Thurston County",4,10,3637,1865,1772
050,53,067,"Washington","Thurston County",4,11,3519,1839,1680
050,53,067,"Washington","Thurston County",4,12,3611,1884,1727
050,53,067,"Washington","Thurston County",4,13,3646,1906,1740
050,53,067,"Washington","Thurston County",4,14,3617,1888,1729
050,53,067,"Washington","Thurston County",4,15,3631,1836,1795
050,53,067,"Washington","Thurston County",4,16,3536,1812,1724
050,53,067,"Washington","Thurston County",4,17,3516,1792,1724
050,53,067,"Washington","Thurston County",4,18,3200,1614,1586
050,53,067,"Washington","Thurston County",4,19,2707,1395,1312
050,53,067,"Washington","Thurston County",4,20,2837,1453,1384
050,53,067,"Washington","Thurston County",4,21,3023,1521,1502
050,53,067,"Washington","Thurston County",4,22,3300,1657,1643
050,53,067,"Washington","Thurston County",4,23,3630,1820,1810
050,53,067,"Washington","Thurston County",4,24,3771,1934,1837
050,53,067,"Washington","Thurston County",4,25,3814,1950,1864
050,53,067,"Washington","Thurston County",4,26,3978,2017,1961
050,53,067,"Washington","Thurston County",4,27,4136,2091,2045
050,53,067,"Washington","Thurston County",4,28,4191,2081,2110
050,53,067,"Washington","Thurston County",4,29,4322,2200,2122
050,53,067,"Washington","Thurston County",4,30,4427,2281,2146
050,53,067,"Washington","Thurston County",4,31,4669,2378,2291
050,53,067,"Washington","Thurston County",4,32,4451,2253,2198
050,53,067,"Washington","Thurston County",4,33,4544,2324,2220
050,53,067,"Washington","Thurston County",4,34,4354,2175,2179
050,53,067,"Washington","Thurston County",4,35,4512,2270,2242
050,53,067,"Washington","Thurston County",4,36,4379,2187,2192
050,53,067,"Washington","Thurston County",4,37,4443,2213,2230
050,53,067,"Washington","Thurston County",4,38,4384,2225,2159
050,53,067,"Washington","Thurston County",4,39,4454,2206,2248
050,53,067,"Washington","Thurston County",4,40,4520,2289,2231
050,53,067,"Washington","Thurston County",4,41,4409,2170,2239
050,53,067,"Washington","Thurston County",4,42,4211,2128,2083
050,53,067,"Washington","Thurston County",4,43,3995,2001,1994
050,53,067,"Washington","Thurston County",4,44,3873,1927,1946
050,53,067,"Washington","Thurston County",4,45,3784,1873,1911
050,53,067,"Washington","Thurston County",4,46,3598,1791,1807
050,53,067,"Washington","Thurston County",4,47,3506,1720,1786
050,53,067,"Washington","Thurston County",4,48,3339,1687,1652
050,53,067,"Washington","Thurston County",4,49,3260,1620,1640
050,53,067,"Washington","Thurston County",4,50,3486,1712,1774
050,53,067,"Washington","Thurston County",4,51,3767,1887,1880
050,53,067,"Washington","Thurston County",4,52,3774,1897,1877
050,53,067,"Washington","Thurston County",4,53,3616,1793,1823
050,53,067,"Washington","Thurston County",4,54,3370,1671,1699
050,53,067,"Washington","Thurston County",4,55,3382,1677,1705
050,53,067,"Washington","Thurston County",4,56,3372,1664,1708
050,53,067,"Washington","Thurston County",4,57,3520,1670,1850
050,53,067,"Washington","Thurston County",4,58,3530,1657,1873
050,53,067,"Washington","Thurston County",4,59,3697,1753,1944
050,53,067,"Washington","Thurston County",4,60,3664,1731,1933
050,53,067,"Washington","Thurston County",4,61,3745,1778,1967
050,53,067,"Washington","Thurston County",4,62,3700,1731,1969
050,53,067,"Washington","Thurston County",4,63,3716,1713,2003
050,53,067,"Washington","Thurston County",4,64,3689,1784,1905
050,53,067,"Washington","Thurston County",4,65,3712,1773,1939
050,53,067,"Washington","Thurston County",4,66,3634,1662,1972
050,53,067,"Washington","Thurston County",4,67,3639,1660,1979
050,53,067,"Washington","Thurston County",4,68,3676,1630,2046
050,53,067,"Washington","Thurston County",4,69,3599,1622,1977
050,53,067,"Washington","Thurston County",4,70,3441,1592,1849
050,53,067,"Washington","Thurston County",4,71,3312,1503,1809
050,53,067,"Washington","Thurston County",4,72,3193,1435,1758
050,53,067,"Washington","Thurston County",4,73,3050,1375,1675
050,53,067,"Washington","Thurston County",4,74,2930,1346,1584
050,53,067,"Washington","Thurston County",4,75,3064,1418,1646
050,53,067,"Washington","Thurston County",4,76,2063,957,1106
050,53,067,"Washington","Thurston County",4,77,1980,928,1052
050,53,067,"Washington","Thurston County",4,78,1905,851,1054
050,53,067,"Washington","Thurston County",4,79,1916,829,1087
050,53,067,"Washington","Thurston County",4,80,1530,677,853
050,53,067,"Washington","Thurston County",4,81,1257,551,706
050,53,067,"Washington","Thurston County",4,82,1121,493,628
050,53,067,"Washington","Thurston County",4,83,1024,454,570
050,53,067,"Washington","Thurston County",4,84,936,392,544
050,53,067,"Washington","Thurston County",4,85,5225,1846,3379
050,53,067,"Washington","Thurston County",5,0,3012,1533,1479
050,53,067,"Washington","Thurston County",5,1,3003,1509,1494
050,53,067,"Washington","Thurston County",5,2,2990,1511,1479
050,53,067,"Washington","Thurston County",5,3,3101,1628,1473
050,53,067,"Washington","Thurston County",5,4,3235,1674,1561
050,53,067,"Washington","Thurston County",5,5,3269,1687,1582
050,53,067,"Washington","Thurston County",5,6,3477,1801,1676
050,53,067,"Washington","Thurston County",5,7,3591,1869,1722
050,53,067,"Washington","Thurston County",5,8,3641,1838,1803
050,53,067,"Washington","Thurston County",5,9,3524,1809,1715
050,53,067,"Washington","Thurston County",5,10,3520,1824,1696
050,53,067,"Washington","Thurston County",5,11,3622,1852,1770
050,53,067,"Washington","Thurston County",5,12,3517,1843,1674
050,53,067,"Washington","Thurston County",5,13,3591,1883,1708
050,53,067,"Washington","Thurston County",5,14,3619,1869,1750
050,53,067,"Washington","Thurston County",5,15,3587,1862,1725
050,53,067,"Washington","Thurston County",5,16,3600,1827,1773
050,53,067,"Washington","Thurston County",5,17,3535,1808,1727
050,53,067,"Washington","Thurston County",5,18,3149,1630,1519
050,53,067,"Washington","Thurston County",5,19,2751,1414,1337
050,53,067,"Washington","Thurston County",5,20,2871,1457,1414
050,53,067,"Washington","Thurston County",5,21,2887,1456,1431
050,53,067,"Washington","Thurston County",5,22,3182,1598,1584
050,53,067,"Washington","Thurston County",5,23,3521,1778,1743
050,53,067,"Washington","Thurston County",5,24,3727,1847,1880
050,53,067,"Washington","Thurston County",5,25,3844,1971,1873
050,53,067,"Washington","Thurston County",5,26,3805,1936,1869
050,53,067,"Washington","Thurston County",5,27,4048,2059,1989
050,53,067,"Washington","Thurston County",5,28,4184,2121,2063
050,53,067,"Washington","Thurston County",5,29,4187,2102,2085
050,53,067,"Washington","Thurston County",5,30,4352,2232,2120
050,53,067,"Washington","Thurston County",5,31,4505,2271,2234
050,53,067,"Washington","Thurston County",5,32,4647,2358,2289
050,53,067,"Washington","Thurston County",5,33,4469,2248,2221
050,53,067,"Washington","Thurston County",5,34,4577,2354,2223
050,53,067,"Washington","Thurston County",5,35,4440,2219,2221
050,53,067,"Washington","Thurston County",5,36,4597,2339,2258
050,53,067,"Washington","Thurston County",5,37,4376,2166,2210
050,53,067,"Washington","Thurston County",5,38,4416,2201,2215
050,53,067,"Washington","Thurston County",5,39,4402,2209,2193
050,53,067,"Washington","Thurston County",5,40,4510,2241,2269
050,53,067,"Washington","Thurston County",5,41,4515,2273,2242
050,53,067,"Washington","Thurston County",5,42,4376,2152,2224
050,53,067,"Washington","Thurston County",5,43,4231,2134,2097
050,53,067,"Washington","Thurston County",5,44,3967,1976,1991
050,53,067,"Washington","Thurston County",5,45,3836,1919,1917
050,53,067,"Washington","Thurston County",5,46,3805,1874,1931
050,53,067,"Washington","Thurston County",5,47,3561,1777,1784
050,53,067,"Washington","Thurston County",5,48,3526,1749,1777
050,53,067,"Washington","Thurston County",5,49,3278,1645,1633
050,53,067,"Washington","Thurston County",5,50,3248,1596,1652
050,53,067,"Washington","Thurston County",5,51,3452,1706,1746
050,53,067,"Washington","Thurston County",5,52,3802,1903,1899
050,53,067,"Washington","Thurston County",5,53,3727,1889,1838
050,53,067,"Washington","Thurston County",5,54,3579,1766,1813
050,53,067,"Washington","Thurston County",5,55,3347,1667,1680
050,53,067,"Washington","Thurston County",5,56,3343,1655,1688
050,53,067,"Washington","Thurston County",5,57,3355,1642,1713
050,53,067,"Washington","Thurston County",5,58,3524,1669,1855
050,53,067,"Washington","Thurston County",5,59,3545,1658,1887
050,53,067,"Washington","Thurston County",5,60,3669,1743,1926
050,53,067,"Washington","Thurston County",5,61,3620,1704,1916
050,53,067,"Washington","Thurston County",5,62,3723,1753,1970
050,53,067,"Washington","Thurston County",5,63,3664,1706,1958
050,53,067,"Washington","Thurston County",5,64,3644,1674,1970
050,53,067,"Washington","Thurston County",5,65,3684,1763,1921
050,53,067,"Washington","Thurston County",5,66,3666,1742,1924
050,53,067,"Washington","Thurston County",5,67,3589,1629,1960
050,53,067,"Washington","Thurston County",5,68,3614,1649,1965
050,53,067,"Washington","Thurston County",5,69,3613,1586,2027
050,53,067,"Washington","Thurston County",5,70,3578,1621,1957
050,53,067,"Washington","Thurston County",5,71,3401,1585,1816
050,53,067,"Washington","Thurston County",5,72,3268,1477,1791
050,53,067,"Washington","Thurston County",5,73,3115,1393,1722
050,53,067,"Washington","Thurston County",5,74,2963,1335,1628
050,53,067,"Washington","Thurston County",5,75,2864,1294,1570
050,53,067,"Washington","Thurston County",5,76,2965,1359,1606
050,53,067,"Washington","Thurston County",5,77,1990,915,1075
050,53,067,"Washington","Thurston County",5,78,1896,882,1014
050,53,067,"Washington","Thurston County",5,79,1817,803,1014
050,53,067,"Washington","Thurston County",5,80,1814,763,1051
050,53,067,"Washington","Thurston County",5,81,1464,645,819
050,53,067,"Washington","Thurston County",5,82,1190,505,685
050,53,067,"Washington","Thurston County",5,83,1044,459,585
050,53,067,"Washington","Thurston County",5,84,924,402,522
050,53,067,"Washington","Thurston County",5,85,5326,1893,3433
050,53,069,"Washington","Wahkiakum County",1,0,29,14,15
050,53,069,"Washington","Wahkiakum County",1,1,30,12,18
050,53,069,"Washington","Wahkiakum County",1,2,34,13,21
050,53,069,"Washington","Wahkiakum County",1,3,21,13,8
050,53,069,"Washington","Wahkiakum County",1,4,32,13,19
050,53,069,"Washington","Wahkiakum County",1,5,34,20,14
050,53,069,"Washington","Wahkiakum County",1,6,39,25,14
050,53,069,"Washington","Wahkiakum County",1,7,46,21,25
050,53,069,"Washington","Wahkiakum County",1,8,44,27,17
050,53,069,"Washington","Wahkiakum County",1,9,38,18,20
050,53,069,"Washington","Wahkiakum County",1,10,46,25,21
050,53,069,"Washington","Wahkiakum County",1,11,43,21,22
050,53,069,"Washington","Wahkiakum County",1,12,41,21,20
050,53,069,"Washington","Wahkiakum County",1,13,43,20,23
050,53,069,"Washington","Wahkiakum County",1,14,60,31,29
050,53,069,"Washington","Wahkiakum County",1,15,54,25,29
050,53,069,"Washington","Wahkiakum County",1,16,48,24,24
050,53,069,"Washington","Wahkiakum County",1,17,51,27,24
050,53,069,"Washington","Wahkiakum County",1,18,50,30,20
050,53,069,"Washington","Wahkiakum County",1,19,33,20,13
050,53,069,"Washington","Wahkiakum County",1,20,35,14,21
050,53,069,"Washington","Wahkiakum County",1,21,41,19,22
050,53,069,"Washington","Wahkiakum County",1,22,31,16,15
050,53,069,"Washington","Wahkiakum County",1,23,37,15,22
050,53,069,"Washington","Wahkiakum County",1,24,29,14,15
050,53,069,"Washington","Wahkiakum County",1,25,34,21,13
050,53,069,"Washington","Wahkiakum County",1,26,41,20,21
050,53,069,"Washington","Wahkiakum County",1,27,30,14,16
050,53,069,"Washington","Wahkiakum County",1,28,29,12,17
050,53,069,"Washington","Wahkiakum County",1,29,30,19,11
050,53,069,"Washington","Wahkiakum County",1,30,42,23,19
050,53,069,"Washington","Wahkiakum County",1,31,39,18,21
050,53,069,"Washington","Wahkiakum County",1,32,30,17,13
050,53,069,"Washington","Wahkiakum County",1,33,29,16,13
050,53,069,"Washington","Wahkiakum County",1,34,39,19,20
050,53,069,"Washington","Wahkiakum County",1,35,40,17,23
050,53,069,"Washington","Wahkiakum County",1,36,43,22,21
050,53,069,"Washington","Wahkiakum County",1,37,44,23,21
050,53,069,"Washington","Wahkiakum County",1,38,29,16,13
050,53,069,"Washington","Wahkiakum County",1,39,45,24,21
050,53,069,"Washington","Wahkiakum County",1,40,41,16,25
050,53,069,"Washington","Wahkiakum County",1,41,39,22,17
050,53,069,"Washington","Wahkiakum County",1,42,38,22,16
050,53,069,"Washington","Wahkiakum County",1,43,37,17,20
050,53,069,"Washington","Wahkiakum County",1,44,37,17,20
050,53,069,"Washington","Wahkiakum County",1,45,42,23,19
050,53,069,"Washington","Wahkiakum County",1,46,35,16,19
050,53,069,"Washington","Wahkiakum County",1,47,40,26,14
050,53,069,"Washington","Wahkiakum County",1,48,43,21,22
050,53,069,"Washington","Wahkiakum County",1,49,48,23,25
050,53,069,"Washington","Wahkiakum County",1,50,52,24,28
050,53,069,"Washington","Wahkiakum County",1,51,48,27,21
050,53,069,"Washington","Wahkiakum County",1,52,51,27,24
050,53,069,"Washington","Wahkiakum County",1,53,42,24,18
050,53,069,"Washington","Wahkiakum County",1,54,62,31,31
050,53,069,"Washington","Wahkiakum County",1,55,78,37,41
050,53,069,"Washington","Wahkiakum County",1,56,76,41,35
050,53,069,"Washington","Wahkiakum County",1,57,57,30,27
050,53,069,"Washington","Wahkiakum County",1,58,84,43,41
050,53,069,"Washington","Wahkiakum County",1,59,69,32,37
050,53,069,"Washington","Wahkiakum County",1,60,73,36,37
050,53,069,"Washington","Wahkiakum County",1,61,81,40,41
050,53,069,"Washington","Wahkiakum County",1,62,81,39,42
050,53,069,"Washington","Wahkiakum County",1,63,77,44,33
050,53,069,"Washington","Wahkiakum County",1,64,83,37,46
050,53,069,"Washington","Wahkiakum County",1,65,109,45,64
050,53,069,"Washington","Wahkiakum County",1,66,102,53,49
050,53,069,"Washington","Wahkiakum County",1,67,86,50,36
050,53,069,"Washington","Wahkiakum County",1,68,91,50,41
050,53,069,"Washington","Wahkiakum County",1,69,101,57,44
050,53,069,"Washington","Wahkiakum County",1,70,93,47,46
050,53,069,"Washington","Wahkiakum County",1,71,95,42,53
050,53,069,"Washington","Wahkiakum County",1,72,96,44,52
050,53,069,"Washington","Wahkiakum County",1,73,92,49,43
050,53,069,"Washington","Wahkiakum County",1,74,61,31,30
050,53,069,"Washington","Wahkiakum County",1,75,59,33,26
050,53,069,"Washington","Wahkiakum County",1,76,70,34,36
050,53,069,"Washington","Wahkiakum County",1,77,62,31,31
050,53,069,"Washington","Wahkiakum County",1,78,53,32,21
050,53,069,"Washington","Wahkiakum County",1,79,43,28,15
050,53,069,"Washington","Wahkiakum County",1,80,38,20,18
050,53,069,"Washington","Wahkiakum County",1,81,25,11,14
050,53,069,"Washington","Wahkiakum County",1,82,32,12,20
050,53,069,"Washington","Wahkiakum County",1,83,26,12,14
050,53,069,"Washington","Wahkiakum County",1,84,22,13,9
050,53,069,"Washington","Wahkiakum County",1,85,121,58,63
050,53,069,"Washington","Wahkiakum County",2,0,31,16,15
050,53,069,"Washington","Wahkiakum County",2,1,31,13,18
050,53,069,"Washington","Wahkiakum County",2,2,32,13,19
050,53,069,"Washington","Wahkiakum County",2,3,24,13,11
050,53,069,"Washington","Wahkiakum County",2,4,29,13,16
050,53,069,"Washington","Wahkiakum County",2,5,33,19,14
050,53,069,"Washington","Wahkiakum County",2,6,39,24,15
050,53,069,"Washington","Wahkiakum County",2,7,45,23,22
050,53,069,"Washington","Wahkiakum County",2,8,43,25,18
050,53,069,"Washington","Wahkiakum County",2,9,41,20,21
050,53,069,"Washington","Wahkiakum County",2,10,46,25,21
050,53,069,"Washington","Wahkiakum County",2,11,44,21,23
050,53,069,"Washington","Wahkiakum County",2,12,43,21,22
050,53,069,"Washington","Wahkiakum County",2,13,43,20,23
050,53,069,"Washington","Wahkiakum County",2,14,57,30,27
050,53,069,"Washington","Wahkiakum County",2,15,54,25,29
050,53,069,"Washington","Wahkiakum County",2,16,50,24,26
050,53,069,"Washington","Wahkiakum County",2,17,51,27,24
050,53,069,"Washington","Wahkiakum County",2,18,46,27,19
050,53,069,"Washington","Wahkiakum County",2,19,34,21,13
050,53,069,"Washington","Wahkiakum County",2,20,36,16,20
050,53,069,"Washington","Wahkiakum County",2,21,38,17,21
050,53,069,"Washington","Wahkiakum County",2,22,34,17,17
050,53,069,"Washington","Wahkiakum County",2,23,35,14,21
050,53,069,"Washington","Wahkiakum County",2,24,30,14,16
050,53,069,"Washington","Wahkiakum County",2,25,35,20,15
050,53,069,"Washington","Wahkiakum County",2,26,39,20,19
050,53,069,"Washington","Wahkiakum County",2,27,31,15,16
050,53,069,"Washington","Wahkiakum County",2,28,31,15,16
050,53,069,"Washington","Wahkiakum County",2,29,30,17,13
050,53,069,"Washington","Wahkiakum County",2,30,42,23,19
050,53,069,"Washington","Wahkiakum County",2,31,39,19,20
050,53,069,"Washington","Wahkiakum County",2,32,34,18,16
050,53,069,"Washington","Wahkiakum County",2,33,30,17,13
050,53,069,"Washington","Wahkiakum County",2,34,36,18,18
050,53,069,"Washington","Wahkiakum County",2,35,40,17,23
050,53,069,"Washington","Wahkiakum County",2,36,41,20,21
050,53,069,"Washington","Wahkiakum County",2,37,45,24,21
050,53,069,"Washington","Wahkiakum County",2,38,34,18,16
050,53,069,"Washington","Wahkiakum County",2,39,43,23,20
050,53,069,"Washington","Wahkiakum County",2,40,44,20,24
050,53,069,"Washington","Wahkiakum County",2,41,40,21,19
050,53,069,"Washington","Wahkiakum County",2,42,38,22,16
050,53,069,"Washington","Wahkiakum County",2,43,38,18,20
050,53,069,"Washington","Wahkiakum County",2,44,36,17,19
050,53,069,"Washington","Wahkiakum County",2,45,41,22,19
050,53,069,"Washington","Wahkiakum County",2,46,37,19,18
050,53,069,"Washington","Wahkiakum County",2,47,39,24,15
050,53,069,"Washington","Wahkiakum County",2,48,43,22,21
050,53,069,"Washington","Wahkiakum County",2,49,47,22,25
050,53,069,"Washington","Wahkiakum County",2,50,51,23,28
050,53,069,"Washington","Wahkiakum County",2,51,49,26,23
050,53,069,"Washington","Wahkiakum County",2,52,51,28,23
050,53,069,"Washington","Wahkiakum County",2,53,45,25,20
050,53,069,"Washington","Wahkiakum County",2,54,57,28,29
050,53,069,"Washington","Wahkiakum County",2,55,75,36,39
050,53,069,"Washington","Wahkiakum County",2,56,79,41,38
050,53,069,"Washington","Wahkiakum County",2,57,63,33,30
050,53,069,"Washington","Wahkiakum County",2,58,76,39,37
050,53,069,"Washington","Wahkiakum County",2,59,72,35,37
050,53,069,"Washington","Wahkiakum County",2,60,74,36,38
050,53,069,"Washington","Wahkiakum County",2,61,78,37,41
050,53,069,"Washington","Wahkiakum County",2,62,83,40,43
050,53,069,"Washington","Wahkiakum County",2,63,81,45,36
050,53,069,"Washington","Wahkiakum County",2,64,83,39,44
050,53,069,"Washington","Wahkiakum County",2,65,105,44,61
050,53,069,"Washington","Wahkiakum County",2,66,103,50,53
050,53,069,"Washington","Wahkiakum County",2,67,90,51,39
050,53,069,"Washington","Wahkiakum County",2,68,90,50,40
050,53,069,"Washington","Wahkiakum County",2,69,100,55,45
050,53,069,"Washington","Wahkiakum County",2,70,96,50,46
050,53,069,"Washington","Wahkiakum County",2,71,94,43,51
050,53,069,"Washington","Wahkiakum County",2,72,93,43,50
050,53,069,"Washington","Wahkiakum County",2,73,97,50,47
050,53,069,"Washington","Wahkiakum County",2,74,64,33,31
050,53,069,"Washington","Wahkiakum County",2,75,60,33,27
050,53,069,"Washington","Wahkiakum County",2,76,66,33,33
050,53,069,"Washington","Wahkiakum County",2,77,65,33,32
050,53,069,"Washington","Wahkiakum County",2,78,54,31,23
050,53,069,"Washington","Wahkiakum County",2,79,44,28,16
050,53,069,"Washington","Wahkiakum County",2,80,39,22,17
050,53,069,"Washington","Wahkiakum County",2,81,27,12,15
050,53,069,"Washington","Wahkiakum County",2,82,29,11,18
050,53,069,"Washington","Wahkiakum County",2,83,27,12,15
050,53,069,"Washington","Wahkiakum County",2,84,23,13,10
050,53,069,"Washington","Wahkiakum County",2,85,123,58,65
050,53,069,"Washington","Wahkiakum County",3,0,23,14,9
050,53,069,"Washington","Wahkiakum County",3,1,38,18,20
050,53,069,"Washington","Wahkiakum County",3,2,35,14,21
050,53,069,"Washington","Wahkiakum County",3,3,33,14,19
050,53,069,"Washington","Wahkiakum County",3,4,23,10,13
050,53,069,"Washington","Wahkiakum County",3,5,31,13,18
050,53,069,"Washington","Wahkiakum County",3,6,34,18,16
050,53,069,"Washington","Wahkiakum County",3,7,42,27,15
050,53,069,"Washington","Wahkiakum County",3,8,49,23,26
050,53,069,"Washington","Wahkiakum County",3,9,40,21,19
050,53,069,"Washington","Wahkiakum County",3,10,39,19,20
050,53,069,"Washington","Wahkiakum County",3,11,47,26,21
050,53,069,"Washington","Wahkiakum County",3,12,47,21,26
050,53,069,"Washington","Wahkiakum County",3,13,43,22,21
050,53,069,"Washington","Wahkiakum County",3,14,44,21,23
050,53,069,"Washington","Wahkiakum County",3,15,56,31,25
050,53,069,"Washington","Wahkiakum County",3,16,55,26,29
050,53,069,"Washington","Wahkiakum County",3,17,50,24,26
050,53,069,"Washington","Wahkiakum County",3,18,48,25,23
050,53,069,"Washington","Wahkiakum County",3,19,38,21,17
050,53,069,"Washington","Wahkiakum County",3,20,42,25,17
050,53,069,"Washington","Wahkiakum County",3,21,37,15,22
050,53,069,"Washington","Wahkiakum County",3,22,41,20,21
050,53,069,"Washington","Wahkiakum County",3,23,30,18,12
050,53,069,"Washington","Wahkiakum County",3,24,41,16,25
050,53,069,"Washington","Wahkiakum County",3,25,37,18,19
050,53,069,"Washington","Wahkiakum County",3,26,33,22,11
050,53,069,"Washington","Wahkiakum County",3,27,35,16,19
050,53,069,"Washington","Wahkiakum County",3,28,39,22,17
050,53,069,"Washington","Wahkiakum County",3,29,38,21,17
050,53,069,"Washington","Wahkiakum County",3,30,31,18,13
050,53,069,"Washington","Wahkiakum County",3,31,40,20,20
050,53,069,"Washington","Wahkiakum County",3,32,47,26,21
050,53,069,"Washington","Wahkiakum County",3,33,35,17,18
050,53,069,"Washington","Wahkiakum County",3,34,37,23,14
050,53,069,"Washington","Wahkiakum County",3,35,36,16,20
050,53,069,"Washington","Wahkiakum County",3,36,47,23,24
050,53,069,"Washington","Wahkiakum County",3,37,42,19,23
050,53,069,"Washington","Wahkiakum County",3,38,47,26,21
050,53,069,"Washington","Wahkiakum County",3,39,33,19,14
050,53,069,"Washington","Wahkiakum County",3,40,45,26,19
050,53,069,"Washington","Wahkiakum County",3,41,44,20,24
050,53,069,"Washington","Wahkiakum County",3,42,38,18,20
050,53,069,"Washington","Wahkiakum County",3,43,37,20,17
050,53,069,"Washington","Wahkiakum County",3,44,45,21,24
050,53,069,"Washington","Wahkiakum County",3,45,42,21,21
050,53,069,"Washington","Wahkiakum County",3,46,42,23,19
050,53,069,"Washington","Wahkiakum County",3,47,40,22,18
050,53,069,"Washington","Wahkiakum County",3,48,44,25,19
050,53,069,"Washington","Wahkiakum County",3,49,46,22,24
050,53,069,"Washington","Wahkiakum County",3,50,53,26,27
050,53,069,"Washington","Wahkiakum County",3,51,51,21,30
050,53,069,"Washington","Wahkiakum County",3,52,51,28,23
050,53,069,"Washington","Wahkiakum County",3,53,48,27,21
050,53,069,"Washington","Wahkiakum County",3,54,47,24,23
050,53,069,"Washington","Wahkiakum County",3,55,63,30,33
050,53,069,"Washington","Wahkiakum County",3,56,79,38,41
050,53,069,"Washington","Wahkiakum County",3,57,84,43,41
050,53,069,"Washington","Wahkiakum County",3,58,65,35,30
050,53,069,"Washington","Wahkiakum County",3,59,78,38,40
050,53,069,"Washington","Wahkiakum County",3,60,80,40,40
050,53,069,"Washington","Wahkiakum County",3,61,75,41,34
050,53,069,"Washington","Wahkiakum County",3,62,90,43,47
050,53,069,"Washington","Wahkiakum County",3,63,89,45,44
050,53,069,"Washington","Wahkiakum County",3,64,90,48,42
050,53,069,"Washington","Wahkiakum County",3,65,91,42,49
050,53,069,"Washington","Wahkiakum County",3,66,110,50,60
050,53,069,"Washington","Wahkiakum County",3,67,98,49,49
050,53,069,"Washington","Wahkiakum County",3,68,92,53,39
050,53,069,"Washington","Wahkiakum County",3,69,90,51,39
050,53,069,"Washington","Wahkiakum County",3,70,99,54,45
050,53,069,"Washington","Wahkiakum County",3,71,99,50,49
050,53,069,"Washington","Wahkiakum County",3,72,92,41,51
050,53,069,"Washington","Wahkiakum County",3,73,88,38,50
050,53,069,"Washington","Wahkiakum County",3,74,95,49,46
050,53,069,"Washington","Wahkiakum County",3,75,62,32,30
050,53,069,"Washington","Wahkiakum County",3,76,59,32,27
050,53,069,"Washington","Wahkiakum County",3,77,62,30,32
050,53,069,"Washington","Wahkiakum County",3,78,66,34,32
050,53,069,"Washington","Wahkiakum County",3,79,55,32,23
050,53,069,"Washington","Wahkiakum County",3,80,42,27,15
050,53,069,"Washington","Wahkiakum County",3,81,39,21,18
050,53,069,"Washington","Wahkiakum County",3,82,22,11,11
050,53,069,"Washington","Wahkiakum County",3,83,28,11,17
050,53,069,"Washington","Wahkiakum County",3,84,20,9,11
050,53,069,"Washington","Wahkiakum County",3,85,128,65,63
050,53,069,"Washington","Wahkiakum County",4,0,30,16,14
050,53,069,"Washington","Wahkiakum County",4,1,27,15,12
050,53,069,"Washington","Wahkiakum County",4,2,42,22,20
050,53,069,"Washington","Wahkiakum County",4,3,39,16,23
050,53,069,"Washington","Wahkiakum County",4,4,33,12,21
050,53,069,"Washington","Wahkiakum County",4,5,30,17,13
050,53,069,"Washington","Wahkiakum County",4,6,33,15,18
050,53,069,"Washington","Wahkiakum County",4,7,42,22,20
050,53,069,"Washington","Wahkiakum County",4,8,45,26,19
050,53,069,"Washington","Wahkiakum County",4,9,48,24,24
050,53,069,"Washington","Wahkiakum County",4,10,46,26,20
050,53,069,"Washington","Wahkiakum County",4,11,43,21,22
050,53,069,"Washington","Wahkiakum County",4,12,51,26,25
050,53,069,"Washington","Wahkiakum County",4,13,41,15,26
050,53,069,"Washington","Wahkiakum County",4,14,46,23,23
050,53,069,"Washington","Wahkiakum County",4,15,45,18,27
050,53,069,"Washington","Wahkiakum County",4,16,58,31,27
050,53,069,"Washington","Wahkiakum County",4,17,54,27,27
050,53,069,"Washington","Wahkiakum County",4,18,43,22,21
050,53,069,"Washington","Wahkiakum County",4,19,36,20,16
050,53,069,"Washington","Wahkiakum County",4,20,38,20,18
050,53,069,"Washington","Wahkiakum County",4,21,40,24,16
050,53,069,"Washington","Wahkiakum County",4,22,36,18,18
050,53,069,"Washington","Wahkiakum County",4,23,40,19,21
050,53,069,"Washington","Wahkiakum County",4,24,29,19,10
050,53,069,"Washington","Wahkiakum County",4,25,33,12,21
050,53,069,"Washington","Wahkiakum County",4,26,38,15,23
050,53,069,"Washington","Wahkiakum County",4,27,40,25,15
050,53,069,"Washington","Wahkiakum County",4,28,36,18,18
050,53,069,"Washington","Wahkiakum County",4,29,43,24,19
050,53,069,"Washington","Wahkiakum County",4,30,43,22,21
050,53,069,"Washington","Wahkiakum County",4,31,39,21,18
050,53,069,"Washington","Wahkiakum County",4,32,49,23,26
050,53,069,"Washington","Wahkiakum County",4,33,47,26,21
050,53,069,"Washington","Wahkiakum County",4,34,44,23,21
050,53,069,"Washington","Wahkiakum County",4,35,35,22,13
050,53,069,"Washington","Wahkiakum County",4,36,38,15,23
050,53,069,"Washington","Wahkiakum County",4,37,44,20,24
050,53,069,"Washington","Wahkiakum County",4,38,49,28,21
050,53,069,"Washington","Wahkiakum County",4,39,54,27,27
050,53,069,"Washington","Wahkiakum County",4,40,36,22,14
050,53,069,"Washington","Wahkiakum County",4,41,42,20,22
050,53,069,"Washington","Wahkiakum County",4,42,44,21,23
050,53,069,"Washington","Wahkiakum County",4,43,44,25,19
050,53,069,"Washington","Wahkiakum County",4,44,39,20,19
050,53,069,"Washington","Wahkiakum County",4,45,51,26,25
050,53,069,"Washington","Wahkiakum County",4,46,43,21,22
050,53,069,"Washington","Wahkiakum County",4,47,46,25,21
050,53,069,"Washington","Wahkiakum County",4,48,41,22,19
050,53,069,"Washington","Wahkiakum County",4,49,45,25,20
050,53,069,"Washington","Wahkiakum County",4,50,51,26,25
050,53,069,"Washington","Wahkiakum County",4,51,59,31,28
050,53,069,"Washington","Wahkiakum County",4,52,53,23,30
050,53,069,"Washington","Wahkiakum County",4,53,52,29,23
050,53,069,"Washington","Wahkiakum County",4,54,47,25,22
050,53,069,"Washington","Wahkiakum County",4,55,48,25,23
050,53,069,"Washington","Wahkiakum County",4,56,61,27,34
050,53,069,"Washington","Wahkiakum County",4,57,80,38,42
050,53,069,"Washington","Wahkiakum County",4,58,84,42,42
050,53,069,"Washington","Wahkiakum County",4,59,64,35,29
050,53,069,"Washington","Wahkiakum County",4,60,81,41,40
050,53,069,"Washington","Wahkiakum County",4,61,83,40,43
050,53,069,"Washington","Wahkiakum County",4,62,75,41,34
050,53,069,"Washington","Wahkiakum County",4,63,96,48,48
050,53,069,"Washington","Wahkiakum County",4,64,94,50,44
050,53,069,"Washington","Wahkiakum County",4,65,87,45,42
050,53,069,"Washington","Wahkiakum County",4,66,94,44,50
050,53,069,"Washington","Wahkiakum County",4,67,110,48,62
050,53,069,"Washington","Wahkiakum County",4,68,100,49,51
050,53,069,"Washington","Wahkiakum County",4,69,92,54,38
050,53,069,"Washington","Wahkiakum County",4,70,89,48,41
050,53,069,"Washington","Wahkiakum County",4,71,103,57,46
050,53,069,"Washington","Wahkiakum County",4,72,101,51,50
050,53,069,"Washington","Wahkiakum County",4,73,93,41,52
050,53,069,"Washington","Wahkiakum County",4,74,85,38,47
050,53,069,"Washington","Wahkiakum County",4,75,91,47,44
050,53,069,"Washington","Wahkiakum County",4,76,59,29,30
050,53,069,"Washington","Wahkiakum County",4,77,59,32,27
050,53,069,"Washington","Wahkiakum County",4,78,63,31,32
050,53,069,"Washington","Wahkiakum County",4,79,60,30,30
050,53,069,"Washington","Wahkiakum County",4,80,55,32,23
050,53,069,"Washington","Wahkiakum County",4,81,41,25,16
050,53,069,"Washington","Wahkiakum County",4,82,34,20,14
050,53,069,"Washington","Wahkiakum County",4,83,20,9,11
050,53,069,"Washington","Wahkiakum County",4,84,23,8,15
050,53,069,"Washington","Wahkiakum County",4,85,123,63,60
050,53,069,"Washington","Wahkiakum County",5,0,31,16,15
050,53,069,"Washington","Wahkiakum County",5,1,23,11,12
050,53,069,"Washington","Wahkiakum County",5,2,30,15,15
050,53,069,"Washington","Wahkiakum County",5,3,40,18,22
050,53,069,"Washington","Wahkiakum County",5,4,51,17,34
050,53,069,"Washington","Wahkiakum County",5,5,36,16,20
050,53,069,"Washington","Wahkiakum County",5,6,39,21,18
050,53,069,"Washington","Wahkiakum County",5,7,38,20,18
050,53,069,"Washington","Wahkiakum County",5,8,42,21,21
050,53,069,"Washington","Wahkiakum County",5,9,46,26,20
050,53,069,"Washington","Wahkiakum County",5,10,54,28,26
050,53,069,"Washington","Wahkiakum County",5,11,46,25,21
050,53,069,"Washington","Wahkiakum County",5,12,46,22,24
050,53,069,"Washington","Wahkiakum County",5,13,49,26,23
050,53,069,"Washington","Wahkiakum County",5,14,42,16,26
050,53,069,"Washington","Wahkiakum County",5,15,53,26,27
050,53,069,"Washington","Wahkiakum County",5,16,51,22,29
050,53,069,"Washington","Wahkiakum County",5,17,61,33,28
050,53,069,"Washington","Wahkiakum County",5,18,47,26,21
050,53,069,"Washington","Wahkiakum County",5,19,35,19,16
050,53,069,"Washington","Wahkiakum County",5,20,34,20,14
050,53,069,"Washington","Wahkiakum County",5,21,36,20,16
050,53,069,"Washington","Wahkiakum County",5,22,37,22,15
050,53,069,"Washington","Wahkiakum County",5,23,38,17,21
050,53,069,"Washington","Wahkiakum County",5,24,40,18,22
050,53,069,"Washington","Wahkiakum County",5,25,34,23,11
050,53,069,"Washington","Wahkiakum County",5,26,27,9,18
050,53,069,"Washington","Wahkiakum County",5,27,42,18,24
050,53,069,"Washington","Wahkiakum County",5,28,39,24,15
050,53,069,"Washington","Wahkiakum County",5,29,41,19,22
050,53,069,"Washington","Wahkiakum County",5,30,45,30,15
050,53,069,"Washington","Wahkiakum County",5,31,48,24,24
050,53,069,"Washington","Wahkiakum County",5,32,43,25,18
050,53,069,"Washington","Wahkiakum County",5,33,54,23,31
050,53,069,"Washington","Wahkiakum County",5,34,45,23,22
050,53,069,"Washington","Wahkiakum County",5,35,43,22,21
050,53,069,"Washington","Wahkiakum County",5,36,38,24,14
050,53,069,"Washington","Wahkiakum County",5,37,35,15,20
050,53,069,"Washington","Wahkiakum County",5,38,43,21,22
050,53,069,"Washington","Wahkiakum County",5,39,50,29,21
050,53,069,"Washington","Wahkiakum County",5,40,55,28,27
050,53,069,"Washington","Wahkiakum County",5,41,38,21,17
050,53,069,"Washington","Wahkiakum County",5,42,47,22,25
050,53,069,"Washington","Wahkiakum County",5,43,50,26,24
050,53,069,"Washington","Wahkiakum County",5,44,46,28,18
050,53,069,"Washington","Wahkiakum County",5,45,45,23,22
050,53,069,"Washington","Wahkiakum County",5,46,49,24,25
050,53,069,"Washington","Wahkiakum County",5,47,43,22,21
050,53,069,"Washington","Wahkiakum County",5,48,45,24,21
050,53,069,"Washington","Wahkiakum County",5,49,41,21,20
050,53,069,"Washington","Wahkiakum County",5,50,48,28,20
050,53,069,"Washington","Wahkiakum County",5,51,51,28,23
050,53,069,"Washington","Wahkiakum County",5,52,59,28,31
050,53,069,"Washington","Wahkiakum County",5,53,52,26,26
050,53,069,"Washington","Wahkiakum County",5,54,49,29,20
050,53,069,"Washington","Wahkiakum County",5,55,52,29,23
050,53,069,"Washington","Wahkiakum County",5,56,48,22,26
050,53,069,"Washington","Wahkiakum County",5,57,68,32,36
050,53,069,"Washington","Wahkiakum County",5,58,78,35,43
050,53,069,"Washington","Wahkiakum County",5,59,86,42,44
050,53,069,"Washington","Wahkiakum County",5,60,67,35,32
050,53,069,"Washington","Wahkiakum County",5,61,75,37,38
050,53,069,"Washington","Wahkiakum County",5,62,88,41,47
050,53,069,"Washington","Wahkiakum County",5,63,77,41,36
050,53,069,"Washington","Wahkiakum County",5,64,101,51,50
050,53,069,"Washington","Wahkiakum County",5,65,94,52,42
050,53,069,"Washington","Wahkiakum County",5,66,84,42,42
050,53,069,"Washington","Wahkiakum County",5,67,98,45,53
050,53,069,"Washington","Wahkiakum County",5,68,110,48,62
050,53,069,"Washington","Wahkiakum County",5,69,100,51,49
050,53,069,"Washington","Wahkiakum County",5,70,90,50,40
050,53,069,"Washington","Wahkiakum County",5,71,88,45,43
050,53,069,"Washington","Wahkiakum County",5,72,104,57,47
050,53,069,"Washington","Wahkiakum County",5,73,105,53,52
050,53,069,"Washington","Wahkiakum County",5,74,88,39,49
050,53,069,"Washington","Wahkiakum County",5,75,84,36,48
050,53,069,"Washington","Wahkiakum County",5,76,89,44,45
050,53,069,"Washington","Wahkiakum County",5,77,59,31,28
050,53,069,"Washington","Wahkiakum County",5,78,58,33,25
050,53,069,"Washington","Wahkiakum County",5,79,61,30,31
050,53,069,"Washington","Wahkiakum County",5,80,58,28,30
050,53,069,"Washington","Wahkiakum County",5,81,53,30,23
050,53,069,"Washington","Wahkiakum County",5,82,40,26,14
050,53,069,"Washington","Wahkiakum County",5,83,32,18,14
050,53,069,"Washington","Wahkiakum County",5,84,17,6,11
050,53,069,"Washington","Wahkiakum County",5,85,123,67,56
050,53,071,"Washington","Walla Walla County",1,0,615,310,305
050,53,071,"Washington","Walla Walla County",1,1,640,300,340
050,53,071,"Washington","Walla Walla County",1,2,651,317,334
050,53,071,"Washington","Walla Walla County",1,3,689,340,349
050,53,071,"Washington","Walla Walla County",1,4,708,340,368
050,53,071,"Washington","Walla Walla County",1,5,729,366,363
050,53,071,"Washington","Walla Walla County",1,6,738,393,345
050,53,071,"Washington","Walla Walla County",1,7,701,361,340
050,53,071,"Washington","Walla Walla County",1,8,763,402,361
050,53,071,"Washington","Walla Walla County",1,9,747,386,361
050,53,071,"Washington","Walla Walla County",1,10,744,385,359
050,53,071,"Washington","Walla Walla County",1,11,773,406,367
050,53,071,"Washington","Walla Walla County",1,12,803,408,395
050,53,071,"Washington","Walla Walla County",1,13,782,399,383
050,53,071,"Washington","Walla Walla County",1,14,781,414,367
050,53,071,"Washington","Walla Walla County",1,15,780,418,362
050,53,071,"Washington","Walla Walla County",1,16,805,415,390
050,53,071,"Washington","Walla Walla County",1,17,755,380,375
050,53,071,"Washington","Walla Walla County",1,18,1061,529,532
050,53,071,"Washington","Walla Walla County",1,19,1607,777,830
050,53,071,"Washington","Walla Walla County",1,20,1450,743,707
050,53,071,"Washington","Walla Walla County",1,21,1238,680,558
050,53,071,"Washington","Walla Walla County",1,22,1104,597,507
050,53,071,"Washington","Walla Walla County",1,23,929,529,400
050,53,071,"Washington","Walla Walla County",1,24,784,429,355
050,53,071,"Washington","Walla Walla County",1,25,762,422,340
050,53,071,"Washington","Walla Walla County",1,26,802,447,355
050,53,071,"Washington","Walla Walla County",1,27,755,421,334
050,53,071,"Washington","Walla Walla County",1,28,830,476,354
050,53,071,"Washington","Walla Walla County",1,29,803,463,340
050,53,071,"Washington","Walla Walla County",1,30,775,423,352
050,53,071,"Washington","Walla Walla County",1,31,796,437,359
050,53,071,"Washington","Walla Walla County",1,32,793,422,371
050,53,071,"Washington","Walla Walla County",1,33,754,417,337
050,53,071,"Washington","Walla Walla County",1,34,781,411,370
050,53,071,"Washington","Walla Walla County",1,35,743,421,322
050,53,071,"Washington","Walla Walla County",1,36,777,423,354
050,53,071,"Washington","Walla Walla County",1,37,809,428,381
050,53,071,"Washington","Walla Walla County",1,38,776,433,343
050,53,071,"Washington","Walla Walla County",1,39,747,406,341
050,53,071,"Washington","Walla Walla County",1,40,745,417,328
050,53,071,"Washington","Walla Walla County",1,41,699,380,319
050,53,071,"Washington","Walla Walla County",1,42,658,336,322
050,53,071,"Washington","Walla Walla County",1,43,672,353,319
050,53,071,"Washington","Walla Walla County",1,44,650,349,301
050,53,071,"Washington","Walla Walla County",1,45,666,354,312
050,53,071,"Washington","Walla Walla County",1,46,663,340,323
050,53,071,"Washington","Walla Walla County",1,47,649,340,309
050,53,071,"Washington","Walla Walla County",1,48,667,362,305
050,53,071,"Washington","Walla Walla County",1,49,682,360,322
050,53,071,"Washington","Walla Walla County",1,50,676,362,314
050,53,071,"Washington","Walla Walla County",1,51,691,376,315
050,53,071,"Washington","Walla Walla County",1,52,686,361,325
050,53,071,"Washington","Walla Walla County",1,53,675,343,332
050,53,071,"Washington","Walla Walla County",1,54,693,342,351
050,53,071,"Washington","Walla Walla County",1,55,745,370,375
050,53,071,"Washington","Walla Walla County",1,56,728,372,356
050,53,071,"Washington","Walla Walla County",1,57,770,384,386
050,53,071,"Washington","Walla Walla County",1,58,751,383,368
050,53,071,"Washington","Walla Walla County",1,59,756,382,374
050,53,071,"Washington","Walla Walla County",1,60,736,349,387
050,53,071,"Washington","Walla Walla County",1,61,765,378,387
050,53,071,"Washington","Walla Walla County",1,62,774,392,382
050,53,071,"Washington","Walla Walla County",1,63,809,378,431
050,53,071,"Washington","Walla Walla County",1,64,783,379,404
050,53,071,"Washington","Walla Walla County",1,65,772,368,404
050,53,071,"Washington","Walla Walla County",1,66,756,356,400
050,53,071,"Washington","Walla Walla County",1,67,756,387,369
050,53,071,"Washington","Walla Walla County",1,68,721,352,369
050,53,071,"Washington","Walla Walla County",1,69,636,310,326
050,53,071,"Washington","Walla Walla County",1,70,659,311,348
050,53,071,"Washington","Walla Walla County",1,71,620,299,321
050,53,071,"Washington","Walla Walla County",1,72,630,305,325
050,53,071,"Washington","Walla Walla County",1,73,619,302,317
050,53,071,"Washington","Walla Walla County",1,74,472,224,248
050,53,071,"Washington","Walla Walla County",1,75,450,210,240
050,53,071,"Washington","Walla Walla County",1,76,457,222,235
050,53,071,"Washington","Walla Walla County",1,77,453,221,232
050,53,071,"Washington","Walla Walla County",1,78,374,171,203
050,53,071,"Washington","Walla Walla County",1,79,329,141,188
050,53,071,"Washington","Walla Walla County",1,80,299,116,183
050,53,071,"Washington","Walla Walla County",1,81,280,110,170
050,53,071,"Washington","Walla Walla County",1,82,267,123,144
050,53,071,"Washington","Walla Walla County",1,83,242,109,133
050,53,071,"Washington","Walla Walla County",1,84,245,101,144
050,53,071,"Washington","Walla Walla County",1,85,1679,575,1104
050,53,071,"Washington","Walla Walla County",2,0,600,297,303
050,53,071,"Washington","Walla Walla County",2,1,636,303,333
050,53,071,"Washington","Walla Walla County",2,2,652,312,340
050,53,071,"Washington","Walla Walla County",2,3,678,332,346
050,53,071,"Washington","Walla Walla County",2,4,708,342,366
050,53,071,"Washington","Walla Walla County",2,5,729,362,367
050,53,071,"Washington","Walla Walla County",2,6,737,389,348
050,53,071,"Washington","Walla Walla County",2,7,712,372,340
050,53,071,"Washington","Walla Walla County",2,8,747,393,354
050,53,071,"Washington","Walla Walla County",2,9,752,393,359
050,53,071,"Washington","Walla Walla County",2,10,745,387,358
050,53,071,"Washington","Walla Walla County",2,11,763,398,365
050,53,071,"Washington","Walla Walla County",2,12,806,414,392
050,53,071,"Washington","Walla Walla County",2,13,787,401,386
050,53,071,"Washington","Walla Walla County",2,14,782,412,370
050,53,071,"Washington","Walla Walla County",2,15,782,418,364
050,53,071,"Washington","Walla Walla County",2,16,804,420,384
050,53,071,"Washington","Walla Walla County",2,17,767,388,379
050,53,071,"Washington","Walla Walla County",2,18,1045,516,529
050,53,071,"Washington","Walla Walla County",2,19,1599,776,823
050,53,071,"Washington","Walla Walla County",2,20,1465,754,711
050,53,071,"Washington","Walla Walla County",2,21,1232,677,555
050,53,071,"Washington","Walla Walla County",2,22,1105,594,511
050,53,071,"Washington","Walla Walla County",2,23,922,529,393
050,53,071,"Washington","Walla Walla County",2,24,793,440,353
050,53,071,"Washington","Walla Walla County",2,25,758,418,340
050,53,071,"Washington","Walla Walla County",2,26,802,446,356
050,53,071,"Washington","Walla Walla County",2,27,757,420,337
050,53,071,"Washington","Walla Walla County",2,28,817,470,347
050,53,071,"Washington","Walla Walla County",2,29,803,461,342
050,53,071,"Washington","Walla Walla County",2,30,776,425,351
050,53,071,"Washington","Walla Walla County",2,31,793,436,357
050,53,071,"Washington","Walla Walla County",2,32,789,418,371
050,53,071,"Washington","Walla Walla County",2,33,768,422,346
050,53,071,"Washington","Walla Walla County",2,34,770,410,360
050,53,071,"Washington","Walla Walla County",2,35,763,426,337
050,53,071,"Washington","Walla Walla County",2,36,762,418,344
050,53,071,"Washington","Walla Walla County",2,37,808,430,378
050,53,071,"Washington","Walla Walla County",2,38,787,433,354
050,53,071,"Washington","Walla Walla County",2,39,746,405,341
050,53,071,"Washington","Walla Walla County",2,40,753,421,332
050,53,071,"Washington","Walla Walla County",2,41,706,385,321
050,53,071,"Washington","Walla Walla County",2,42,662,344,318
050,53,071,"Washington","Walla Walla County",2,43,673,352,321
050,53,071,"Washington","Walla Walla County",2,44,654,349,305
050,53,071,"Washington","Walla Walla County",2,45,667,356,311
050,53,071,"Washington","Walla Walla County",2,46,664,342,322
050,53,071,"Washington","Walla Walla County",2,47,644,335,309
050,53,071,"Washington","Walla Walla County",2,48,663,358,305
050,53,071,"Washington","Walla Walla County",2,49,675,355,320
050,53,071,"Washington","Walla Walla County",2,50,675,359,316
050,53,071,"Washington","Walla Walla County",2,51,689,375,314
050,53,071,"Washington","Walla Walla County",2,52,682,360,322
050,53,071,"Washington","Walla Walla County",2,53,676,347,329
050,53,071,"Washington","Walla Walla County",2,54,687,342,345
050,53,071,"Washington","Walla Walla County",2,55,731,359,372
050,53,071,"Washington","Walla Walla County",2,56,738,375,363
050,53,071,"Washington","Walla Walla County",2,57,759,381,378
050,53,071,"Washington","Walla Walla County",2,58,744,376,368
050,53,071,"Washington","Walla Walla County",2,59,755,382,373
050,53,071,"Washington","Walla Walla County",2,60,738,355,383
050,53,071,"Washington","Walla Walla County",2,61,755,372,383
050,53,071,"Washington","Walla Walla County",2,62,773,388,385
050,53,071,"Washington","Walla Walla County",2,63,803,382,421
050,53,071,"Washington","Walla Walla County",2,64,787,372,415
050,53,071,"Washington","Walla Walla County",2,65,778,372,406
050,53,071,"Washington","Walla Walla County",2,66,765,364,401
050,53,071,"Washington","Walla Walla County",2,67,756,379,377
050,53,071,"Washington","Walla Walla County",2,68,722,357,365
050,53,071,"Washington","Walla Walla County",2,69,660,322,338
050,53,071,"Washington","Walla Walla County",2,70,648,305,343
050,53,071,"Washington","Walla Walla County",2,71,633,304,329
050,53,071,"Washington","Walla Walla County",2,72,616,298,318
050,53,071,"Washington","Walla Walla County",2,73,654,318,336
050,53,071,"Washington","Walla Walla County",2,74,476,226,250
050,53,071,"Washington","Walla Walla County",2,75,456,213,243
050,53,071,"Washington","Walla Walla County",2,76,450,216,234
050,53,071,"Washington","Walla Walla County",2,77,460,223,237
050,53,071,"Washington","Walla Walla County",2,78,386,178,208
050,53,071,"Washington","Walla Walla County",2,79,331,144,187
050,53,071,"Washington","Walla Walla County",2,80,306,122,184
050,53,071,"Washington","Walla Walla County",2,81,282,112,170
050,53,071,"Washington","Walla Walla County",2,82,275,123,152
050,53,071,"Washington","Walla Walla County",2,83,245,111,134
050,53,071,"Washington","Walla Walla County",2,84,245,100,145
050,53,071,"Washington","Walla Walla County",2,85,1679,578,1101
050,53,071,"Washington","Walla Walla County",3,0,597,306,291
050,53,071,"Washington","Walla Walla County",3,1,614,310,304
050,53,071,"Washington","Walla Walla County",3,2,623,310,313
050,53,071,"Washington","Walla Walla County",3,3,661,319,342
050,53,071,"Washington","Walla Walla County",3,4,679,333,346
050,53,071,"Washington","Walla Walla County",3,5,727,356,371
050,53,071,"Washington","Walla Walla County",3,6,732,356,376
050,53,071,"Washington","Walla Walla County",3,7,749,390,359
050,53,071,"Washington","Walla Walla County",3,8,741,388,353
050,53,071,"Washington","Walla Walla County",3,9,743,385,358
050,53,071,"Washington","Walla Walla County",3,10,751,390,361
050,53,071,"Washington","Walla Walla County",3,11,747,388,359
050,53,071,"Washington","Walla Walla County",3,12,763,405,358
050,53,071,"Washington","Walla Walla County",3,13,811,420,391
050,53,071,"Washington","Walla Walla County",3,14,787,405,382
050,53,071,"Washington","Walla Walla County",3,15,786,411,375
050,53,071,"Washington","Walla Walla County",3,16,779,422,357
050,53,071,"Washington","Walla Walla County",3,17,803,419,384
050,53,071,"Washington","Walla Walla County",3,18,958,459,499
050,53,071,"Washington","Walla Walla County",3,19,1388,687,701
050,53,071,"Washington","Walla Walla County",3,20,1329,687,642
050,53,071,"Washington","Walla Walla County",3,21,1199,643,556
050,53,071,"Washington","Walla Walla County",3,22,1077,561,516
050,53,071,"Washington","Walla Walla County",3,23,932,533,399
050,53,071,"Washington","Walla Walla County",3,24,799,459,340
050,53,071,"Washington","Walla Walla County",3,25,734,412,322
050,53,071,"Washington","Walla Walla County",3,26,761,423,338
050,53,071,"Washington","Walla Walla County",3,27,738,394,344
050,53,071,"Washington","Walla Walla County",3,28,798,446,352
050,53,071,"Washington","Walla Walla County",3,29,813,453,360
050,53,071,"Washington","Walla Walla County",3,30,756,417,339
050,53,071,"Washington","Walla Walla County",3,31,767,425,342
050,53,071,"Washington","Walla Walla County",3,32,763,401,362
050,53,071,"Washington","Walla Walla County",3,33,805,444,361
050,53,071,"Washington","Walla Walla County",3,34,747,396,351
050,53,071,"Washington","Walla Walla County",3,35,770,420,350
050,53,071,"Washington","Walla Walla County",3,36,760,418,342
050,53,071,"Washington","Walla Walla County",3,37,769,421,348
050,53,071,"Washington","Walla Walla County",3,38,817,436,381
050,53,071,"Washington","Walla Walla County",3,39,794,432,362
050,53,071,"Washington","Walla Walla County",3,40,760,420,340
050,53,071,"Washington","Walla Walla County",3,41,744,399,345
050,53,071,"Washington","Walla Walla County",3,42,698,385,313
050,53,071,"Washington","Walla Walla County",3,43,660,346,314
050,53,071,"Washington","Walla Walla County",3,44,688,358,330
050,53,071,"Washington","Walla Walla County",3,45,660,358,302
050,53,071,"Washington","Walla Walla County",3,46,661,344,317
050,53,071,"Washington","Walla Walla County",3,47,651,334,317
050,53,071,"Washington","Walla Walla County",3,48,658,353,305
050,53,071,"Washington","Walla Walla County",3,49,643,337,306
050,53,071,"Washington","Walla Walla County",3,50,680,355,325
050,53,071,"Washington","Walla Walla County",3,51,683,365,318
050,53,071,"Washington","Walla Walla County",3,52,682,366,316
050,53,071,"Washington","Walla Walla County",3,53,670,352,318
050,53,071,"Washington","Walla Walla County",3,54,648,336,312
050,53,071,"Washington","Walla Walla County",3,55,672,324,348
050,53,071,"Washington","Walla Walla County",3,56,760,384,376
050,53,071,"Washington","Walla Walla County",3,57,756,385,371
050,53,071,"Washington","Walla Walla County",3,58,736,364,372
050,53,071,"Washington","Walla Walla County",3,59,741,374,367
050,53,071,"Washington","Walla Walla County",3,60,766,385,381
050,53,071,"Washington","Walla Walla County",3,61,743,362,381
050,53,071,"Washington","Walla Walla County",3,62,752,366,386
050,53,071,"Washington","Walla Walla County",3,63,771,384,387
050,53,071,"Washington","Walla Walla County",3,64,798,369,429
050,53,071,"Washington","Walla Walla County",3,65,772,368,404
050,53,071,"Washington","Walla Walla County",3,66,766,362,404
050,53,071,"Washington","Walla Walla County",3,67,762,356,406
050,53,071,"Washington","Walla Walla County",3,68,747,371,376
050,53,071,"Washington","Walla Walla County",3,69,709,349,360
050,53,071,"Washington","Walla Walla County",3,70,654,312,342
050,53,071,"Washington","Walla Walla County",3,71,640,299,341
050,53,071,"Washington","Walla Walla County",3,72,629,302,327
050,53,071,"Washington","Walla Walla County",3,73,612,293,319
050,53,071,"Washington","Walla Walla County",3,74,640,314,326
050,53,071,"Washington","Walla Walla County",3,75,462,220,242
050,53,071,"Washington","Walla Walla County",3,76,462,206,256
050,53,071,"Washington","Walla Walla County",3,77,436,199,237
050,53,071,"Washington","Walla Walla County",3,78,437,203,234
050,53,071,"Washington","Walla Walla County",3,79,364,167,197
050,53,071,"Washington","Walla Walla County",3,80,325,144,181
050,53,071,"Washington","Walla Walla County",3,81,302,123,179
050,53,071,"Washington","Walla Walla County",3,82,285,116,169
050,53,071,"Washington","Walla Walla County",3,83,263,116,147
050,53,071,"Washington","Walla Walla County",3,84,235,92,143
050,53,071,"Washington","Walla Walla County",3,85,1661,589,1072
050,53,071,"Washington","Walla Walla County",4,0,553,296,257
050,53,071,"Washington","Walla Walla County",4,1,608,322,286
050,53,071,"Washington","Walla Walla County",4,2,608,314,294
050,53,071,"Washington","Walla Walla County",4,3,627,316,311
050,53,071,"Washington","Walla Walla County",4,4,666,306,360
050,53,071,"Washington","Walla Walla County",4,5,691,336,355
050,53,071,"Washington","Walla Walla County",4,6,727,359,368
050,53,071,"Washington","Walla Walla County",4,7,717,349,368
050,53,071,"Washington","Walla Walla County",4,8,751,370,381
050,53,071,"Washington","Walla Walla County",4,9,721,375,346
050,53,071,"Washington","Walla Walla County",4,10,739,380,359
050,53,071,"Washington","Walla Walla County",4,11,730,378,352
050,53,071,"Washington","Walla Walla County",4,12,762,392,370
050,53,071,"Washington","Walla Walla County",4,13,777,416,361
050,53,071,"Washington","Walla Walla County",4,14,815,427,388
050,53,071,"Washington","Walla Walla County",4,15,791,403,388
050,53,071,"Washington","Walla Walla County",4,16,793,422,371
050,53,071,"Washington","Walla Walla County",4,17,771,410,361
050,53,071,"Washington","Walla Walla County",4,18,983,471,512
050,53,071,"Washington","Walla Walla County",4,19,1380,671,709
050,53,071,"Washington","Walla Walla County",4,20,1309,681,628
050,53,071,"Washington","Walla Walla County",4,21,1193,653,540
050,53,071,"Washington","Walla Walla County",4,22,1083,551,532
050,53,071,"Washington","Walla Walla County",4,23,918,503,415
050,53,071,"Washington","Walla Walla County",4,24,807,467,340
050,53,071,"Washington","Walla Walla County",4,25,729,412,317
050,53,071,"Washington","Walla Walla County",4,26,752,427,325
050,53,071,"Washington","Walla Walla County",4,27,720,393,327
050,53,071,"Washington","Walla Walla County",4,28,752,399,353
050,53,071,"Washington","Walla Walla County",4,29,780,429,351
050,53,071,"Washington","Walla Walla County",4,30,765,407,358
050,53,071,"Washington","Walla Walla County",4,31,794,443,351
050,53,071,"Washington","Walla Walla County",4,32,746,397,349
050,53,071,"Washington","Walla Walla County",4,33,748,403,345
050,53,071,"Washington","Walla Walla County",4,34,763,400,363
050,53,071,"Washington","Walla Walla County",4,35,747,411,336
050,53,071,"Washington","Walla Walla County",4,36,757,414,343
050,53,071,"Washington","Walla Walla County",4,37,767,422,345
050,53,071,"Washington","Walla Walla County",4,38,766,426,340
050,53,071,"Washington","Walla Walla County",4,39,798,421,377
050,53,071,"Washington","Walla Walla County",4,40,788,429,359
050,53,071,"Washington","Walla Walla County",4,41,743,393,350
050,53,071,"Washington","Walla Walla County",4,42,735,392,343
050,53,071,"Washington","Walla Walla County",4,43,689,374,315
050,53,071,"Washington","Walla Walla County",4,44,667,349,318
050,53,071,"Washington","Walla Walla County",4,45,679,354,325
050,53,071,"Washington","Walla Walla County",4,46,654,347,307
050,53,071,"Washington","Walla Walla County",4,47,642,327,315
050,53,071,"Washington","Walla Walla County",4,48,643,333,310
050,53,071,"Washington","Walla Walla County",4,49,622,327,295
050,53,071,"Washington","Walla Walla County",4,50,637,330,307
050,53,071,"Washington","Walla Walla County",4,51,700,367,333
050,53,071,"Washington","Walla Walla County",4,52,678,354,324
050,53,071,"Washington","Walla Walla County",4,53,677,362,315
050,53,071,"Washington","Walla Walla County",4,54,660,343,317
050,53,071,"Washington","Walla Walla County",4,55,639,317,322
050,53,071,"Washington","Walla Walla County",4,56,671,339,332
050,53,071,"Washington","Walla Walla County",4,57,760,392,368
050,53,071,"Washington","Walla Walla County",4,58,726,368,358
050,53,071,"Washington","Walla Walla County",4,59,741,368,373
050,53,071,"Washington","Walla Walla County",4,60,722,360,362
050,53,071,"Washington","Walla Walla County",4,61,753,381,372
050,53,071,"Washington","Walla Walla County",4,62,756,368,388
050,53,071,"Washington","Walla Walla County",4,63,752,362,390
050,53,071,"Washington","Walla Walla County",4,64,759,363,396
050,53,071,"Washington","Walla Walla County",4,65,787,364,423
050,53,071,"Washington","Walla Walla County",4,66,759,364,395
050,53,071,"Washington","Walla Walla County",4,67,764,351,413
050,53,071,"Washington","Walla Walla County",4,68,733,341,392
050,53,071,"Washington","Walla Walla County",4,69,729,366,363
050,53,071,"Washington","Walla Walla County",4,70,697,336,361
050,53,071,"Washington","Walla Walla County",4,71,648,310,338
050,53,071,"Washington","Walla Walla County",4,72,627,286,341
050,53,071,"Washington","Walla Walla County",4,73,608,291,317
050,53,071,"Washington","Walla Walla County",4,74,604,289,315
050,53,071,"Washington","Walla Walla County",4,75,615,306,309
050,53,071,"Washington","Walla Walla County",4,76,461,216,245
050,53,071,"Washington","Walla Walla County",4,77,453,198,255
050,53,071,"Washington","Walla Walla County",4,78,420,189,231
050,53,071,"Washington","Walla Walla County",4,79,413,189,224
050,53,071,"Washington","Walla Walla County",4,80,358,162,196
050,53,071,"Washington","Walla Walla County",4,81,310,138,172
050,53,071,"Washington","Walla Walla County",4,82,299,128,171
050,53,071,"Washington","Walla Walla County",4,83,268,109,159
050,53,071,"Washington","Walla Walla County",4,84,258,100,158
050,53,071,"Washington","Walla Walla County",4,85,1645,592,1053
050,53,071,"Washington","Walla Walla County",5,0,545,290,255
050,53,071,"Washington","Walla Walla County",5,1,547,292,255
050,53,071,"Washington","Walla Walla County",5,2,616,315,301
050,53,071,"Washington","Walla Walla County",5,3,608,307,301
050,53,071,"Washington","Walla Walla County",5,4,626,308,318
050,53,071,"Washington","Walla Walla County",5,5,658,293,365
050,53,071,"Washington","Walla Walla County",5,6,700,338,362
050,53,071,"Washington","Walla Walla County",5,7,725,354,371
050,53,071,"Washington","Walla Walla County",5,8,709,352,357
050,53,071,"Washington","Walla Walla County",5,9,741,375,366
050,53,071,"Washington","Walla Walla County",5,10,726,382,344
050,53,071,"Washington","Walla Walla County",5,11,741,387,354
050,53,071,"Washington","Walla Walla County",5,12,728,383,345
050,53,071,"Washington","Walla Walla County",5,13,770,393,377
050,53,071,"Washington","Walla Walla County",5,14,791,421,370
050,53,071,"Washington","Walla Walla County",5,15,797,413,384
050,53,071,"Washington","Walla Walla County",5,16,785,406,379
050,53,071,"Washington","Walla Walla County",5,17,789,417,372
050,53,071,"Washington","Walla Walla County",5,18,927,456,471
050,53,071,"Washington","Walla Walla County",5,19,1389,671,718
050,53,071,"Washington","Walla Walla County",5,20,1299,670,629
050,53,071,"Washington","Walla Walla County",5,21,1155,633,522
050,53,071,"Washington","Walla Walla County",5,22,1105,573,532
050,53,071,"Washington","Walla Walla County",5,23,922,496,426
050,53,071,"Washington","Walla Walla County",5,24,810,454,356
050,53,071,"Washington","Walla Walla County",5,25,753,450,303
050,53,071,"Washington","Walla Walla County",5,26,735,418,317
050,53,071,"Washington","Walla Walla County",5,27,722,408,314
050,53,071,"Washington","Walla Walla County",5,28,725,401,324
050,53,071,"Washington","Walla Walla County",5,29,749,390,359
050,53,071,"Washington","Walla Walla County",5,30,762,413,349
050,53,071,"Washington","Walla Walla County",5,31,783,431,352
050,53,071,"Washington","Walla Walla County",5,32,815,448,367
050,53,071,"Washington","Walla Walla County",5,33,755,394,361
050,53,071,"Washington","Walla Walla County",5,34,748,400,348
050,53,071,"Washington","Walla Walla County",5,35,780,417,363
050,53,071,"Washington","Walla Walla County",5,36,741,407,334
050,53,071,"Washington","Walla Walla County",5,37,756,406,350
050,53,071,"Washington","Walla Walla County",5,38,772,426,346
050,53,071,"Washington","Walla Walla County",5,39,767,413,354
050,53,071,"Washington","Walla Walla County",5,40,814,447,367
050,53,071,"Washington","Walla Walla County",5,41,768,399,369
050,53,071,"Washington","Walla Walla County",5,42,747,396,351
050,53,071,"Washington","Walla Walla County",5,43,724,392,332
050,53,071,"Washington","Walla Walla County",5,44,693,378,315
050,53,071,"Washington","Walla Walla County",5,45,669,348,321
050,53,071,"Washington","Walla Walla County",5,46,667,341,326
050,53,071,"Washington","Walla Walla County",5,47,613,323,290
050,53,071,"Washington","Walla Walla County",5,48,634,337,297
050,53,071,"Washington","Walla Walla County",5,49,626,299,327
050,53,071,"Washington","Walla Walla County",5,50,629,340,289
050,53,071,"Washington","Walla Walla County",5,51,658,351,307
050,53,071,"Washington","Walla Walla County",5,52,698,360,338
050,53,071,"Washington","Walla Walla County",5,53,678,354,324
050,53,071,"Washington","Walla Walla County",5,54,672,355,317
050,53,071,"Washington","Walla Walla County",5,55,640,329,311
050,53,071,"Washington","Walla Walla County",5,56,649,324,325
050,53,071,"Washington","Walla Walla County",5,57,660,338,322
050,53,071,"Washington","Walla Walla County",5,58,737,373,364
050,53,071,"Washington","Walla Walla County",5,59,714,360,354
050,53,071,"Washington","Walla Walla County",5,60,724,358,366
050,53,071,"Washington","Walla Walla County",5,61,725,368,357
050,53,071,"Washington","Walla Walla County",5,62,745,373,372
050,53,071,"Washington","Walla Walla County",5,63,742,365,377
050,53,071,"Washington","Walla Walla County",5,64,716,339,377
050,53,071,"Washington","Walla Walla County",5,65,738,343,395
050,53,071,"Washington","Walla Walla County",5,66,769,361,408
050,53,071,"Washington","Walla Walla County",5,67,751,361,390
050,53,071,"Washington","Walla Walla County",5,68,753,346,407
050,53,071,"Washington","Walla Walla County",5,69,730,345,385
050,53,071,"Washington","Walla Walla County",5,70,710,356,354
050,53,071,"Washington","Walla Walla County",5,71,684,329,355
050,53,071,"Washington","Walla Walla County",5,72,640,301,339
050,53,071,"Washington","Walla Walla County",5,73,617,278,339
050,53,071,"Washington","Walla Walla County",5,74,589,286,303
050,53,071,"Washington","Walla Walla County",5,75,583,277,306
050,53,071,"Washington","Walla Walla County",5,76,605,299,306
050,53,071,"Washington","Walla Walla County",5,77,442,205,237
050,53,071,"Washington","Walla Walla County",5,78,446,195,251
050,53,071,"Washington","Walla Walla County",5,79,394,176,218
050,53,071,"Washington","Walla Walla County",5,80,406,183,223
050,53,071,"Washington","Walla Walla County",5,81,337,147,190
050,53,071,"Washington","Walla Walla County",5,82,306,139,167
050,53,071,"Washington","Walla Walla County",5,83,277,115,162
050,53,071,"Washington","Walla Walla County",5,84,252,90,162
050,53,071,"Washington","Walla Walla County",5,85,1625,590,1035
050,53,073,"Washington","Whatcom County",1,0,2043,1037,1006
050,53,073,"Washington","Whatcom County",1,1,2064,1045,1019
050,53,073,"Washington","Whatcom County",1,2,2262,1157,1105
050,53,073,"Washington","Whatcom County",1,3,2377,1234,1143
050,53,073,"Washington","Whatcom County",1,4,2461,1278,1183
050,53,073,"Washington","Whatcom County",1,5,2506,1289,1217
050,53,073,"Washington","Whatcom County",1,6,2461,1282,1179
050,53,073,"Washington","Whatcom County",1,7,2487,1288,1199
050,53,073,"Washington","Whatcom County",1,8,2457,1275,1182
050,53,073,"Washington","Whatcom County",1,9,2431,1289,1142
050,53,073,"Washington","Whatcom County",1,10,2556,1332,1224
050,53,073,"Washington","Whatcom County",1,11,2579,1318,1261
050,53,073,"Washington","Whatcom County",1,12,2606,1326,1280
050,53,073,"Washington","Whatcom County",1,13,2507,1275,1232
050,53,073,"Washington","Whatcom County",1,14,2553,1342,1211
050,53,073,"Washington","Whatcom County",1,15,2517,1333,1184
050,53,073,"Washington","Whatcom County",1,16,2480,1264,1216
050,53,073,"Washington","Whatcom County",1,17,2482,1265,1217
050,53,073,"Washington","Whatcom County",1,18,3206,1556,1650
050,53,073,"Washington","Whatcom County",1,19,4358,2061,2297
050,53,073,"Washington","Whatcom County",1,20,4868,2374,2494
050,53,073,"Washington","Whatcom County",1,21,5086,2416,2670
050,53,073,"Washington","Whatcom County",1,22,5047,2432,2615
050,53,073,"Washington","Whatcom County",1,23,4201,2084,2117
050,53,073,"Washington","Whatcom County",1,24,3704,1954,1750
050,53,073,"Washington","Whatcom County",1,25,3344,1733,1611
050,53,073,"Washington","Whatcom County",1,26,3198,1652,1546
050,53,073,"Washington","Whatcom County",1,27,3232,1683,1549
050,53,073,"Washington","Whatcom County",1,28,3267,1690,1577
050,53,073,"Washington","Whatcom County",1,29,3336,1729,1607
050,53,073,"Washington","Whatcom County",1,30,3200,1682,1518
050,53,073,"Washington","Whatcom County",1,31,2889,1532,1357
050,53,073,"Washington","Whatcom County",1,32,2786,1423,1363
050,53,073,"Washington","Whatcom County",1,33,2750,1395,1355
050,53,073,"Washington","Whatcom County",1,34,2812,1428,1384
050,53,073,"Washington","Whatcom County",1,35,2976,1498,1478
050,53,073,"Washington","Whatcom County",1,36,2945,1470,1475
050,53,073,"Washington","Whatcom County",1,37,3009,1527,1482
050,53,073,"Washington","Whatcom County",1,38,3060,1525,1535
050,53,073,"Washington","Whatcom County",1,39,2987,1498,1489
050,53,073,"Washington","Whatcom County",1,40,2919,1484,1435
050,53,073,"Washington","Whatcom County",1,41,2799,1408,1391
050,53,073,"Washington","Whatcom County",1,42,2694,1353,1341
050,53,073,"Washington","Whatcom County",1,43,2590,1323,1267
050,53,073,"Washington","Whatcom County",1,44,2519,1274,1245
050,53,073,"Washington","Whatcom County",1,45,2420,1224,1196
050,53,073,"Washington","Whatcom County",1,46,2379,1195,1184
050,53,073,"Washington","Whatcom County",1,47,2408,1227,1181
050,53,073,"Washington","Whatcom County",1,48,2578,1325,1253
050,53,073,"Washington","Whatcom County",1,49,2739,1399,1340
050,53,073,"Washington","Whatcom County",1,50,2707,1368,1339
050,53,073,"Washington","Whatcom County",1,51,2652,1322,1330
050,53,073,"Washington","Whatcom County",1,52,2499,1247,1252
050,53,073,"Washington","Whatcom County",1,53,2419,1201,1218
050,53,073,"Washington","Whatcom County",1,54,2455,1212,1243
050,53,073,"Washington","Whatcom County",1,55,2582,1292,1290
050,53,073,"Washington","Whatcom County",1,56,2685,1301,1384
050,53,073,"Washington","Whatcom County",1,57,2698,1296,1402
050,53,073,"Washington","Whatcom County",1,58,2774,1351,1423
050,53,073,"Washington","Whatcom County",1,59,2860,1407,1453
050,53,073,"Washington","Whatcom County",1,60,2801,1382,1419
050,53,073,"Washington","Whatcom County",1,61,2712,1312,1400
050,53,073,"Washington","Whatcom County",1,62,2847,1348,1499
050,53,073,"Washington","Whatcom County",1,63,2883,1391,1492
050,53,073,"Washington","Whatcom County",1,64,2803,1371,1432
050,53,073,"Washington","Whatcom County",1,65,2812,1333,1479
050,53,073,"Washington","Whatcom County",1,66,2867,1334,1533
050,53,073,"Washington","Whatcom County",1,67,2774,1308,1466
050,53,073,"Washington","Whatcom County",1,68,2756,1286,1470
050,53,073,"Washington","Whatcom County",1,69,2588,1203,1385
050,53,073,"Washington","Whatcom County",1,70,2473,1213,1260
050,53,073,"Washington","Whatcom County",1,71,2445,1206,1239
050,53,073,"Washington","Whatcom County",1,72,2453,1175,1278
050,53,073,"Washington","Whatcom County",1,73,2391,1091,1300
050,53,073,"Washington","Whatcom County",1,74,1660,780,880
050,53,073,"Washington","Whatcom County",1,75,1689,804,885
050,53,073,"Washington","Whatcom County",1,76,1591,754,837
050,53,073,"Washington","Whatcom County",1,77,1510,729,781
050,53,073,"Washington","Whatcom County",1,78,1263,605,658
050,53,073,"Washington","Whatcom County",1,79,1078,522,556
050,53,073,"Washington","Whatcom County",1,80,976,457,519
050,53,073,"Washington","Whatcom County",1,81,914,415,499
050,53,073,"Washington","Whatcom County",1,82,829,386,443
050,53,073,"Washington","Whatcom County",1,83,721,326,395
050,53,073,"Washington","Whatcom County",1,84,678,307,371
050,53,073,"Washington","Whatcom County",1,85,3872,1464,2408
050,53,073,"Washington","Whatcom County",2,0,2066,1055,1011
050,53,073,"Washington","Whatcom County",2,1,2066,1050,1016
050,53,073,"Washington","Whatcom County",2,2,2227,1135,1092
050,53,073,"Washington","Whatcom County",2,3,2342,1211,1131
050,53,073,"Washington","Whatcom County",2,4,2447,1267,1180
050,53,073,"Washington","Whatcom County",2,5,2499,1286,1213
050,53,073,"Washington","Whatcom County",2,6,2478,1288,1190
050,53,073,"Washington","Whatcom County",2,7,2481,1286,1195
050,53,073,"Washington","Whatcom County",2,8,2456,1275,1181
050,53,073,"Washington","Whatcom County",2,9,2441,1288,1153
050,53,073,"Washington","Whatcom County",2,10,2522,1321,1201
050,53,073,"Washington","Whatcom County",2,11,2572,1321,1251
050,53,073,"Washington","Whatcom County",2,12,2610,1325,1285
050,53,073,"Washington","Whatcom County",2,13,2531,1285,1246
050,53,073,"Washington","Whatcom County",2,14,2541,1327,1214
050,53,073,"Washington","Whatcom County",2,15,2540,1338,1202
050,53,073,"Washington","Whatcom County",2,16,2488,1277,1211
050,53,073,"Washington","Whatcom County",2,17,2485,1264,1221
050,53,073,"Washington","Whatcom County",2,18,3231,1560,1671
050,53,073,"Washington","Whatcom County",2,19,4373,2068,2305
050,53,073,"Washington","Whatcom County",2,20,4897,2385,2512
050,53,073,"Washington","Whatcom County",2,21,5046,2393,2653
050,53,073,"Washington","Whatcom County",2,22,5026,2427,2599
050,53,073,"Washington","Whatcom County",2,23,4180,2090,2090
050,53,073,"Washington","Whatcom County",2,24,3702,1931,1771
050,53,073,"Washington","Whatcom County",2,25,3352,1731,1621
050,53,073,"Washington","Whatcom County",2,26,3206,1655,1551
050,53,073,"Washington","Whatcom County",2,27,3184,1657,1527
050,53,073,"Washington","Whatcom County",2,28,3263,1696,1567
050,53,073,"Washington","Whatcom County",2,29,3327,1731,1596
050,53,073,"Washington","Whatcom County",2,30,3250,1704,1546
050,53,073,"Washington","Whatcom County",2,31,2962,1567,1395
050,53,073,"Washington","Whatcom County",2,32,2823,1455,1368
050,53,073,"Washington","Whatcom County",2,33,2769,1410,1359
050,53,073,"Washington","Whatcom County",2,34,2810,1430,1380
050,53,073,"Washington","Whatcom County",2,35,2959,1487,1472
050,53,073,"Washington","Whatcom County",2,36,2941,1472,1469
050,53,073,"Washington","Whatcom County",2,37,3011,1525,1486
050,53,073,"Washington","Whatcom County",2,38,3070,1535,1535
050,53,073,"Washington","Whatcom County",2,39,3007,1504,1503
050,53,073,"Washington","Whatcom County",2,40,2968,1502,1466
050,53,073,"Washington","Whatcom County",2,41,2822,1423,1399
050,53,073,"Washington","Whatcom County",2,42,2713,1364,1349
050,53,073,"Washington","Whatcom County",2,43,2639,1344,1295
050,53,073,"Washington","Whatcom County",2,44,2516,1275,1241
050,53,073,"Washington","Whatcom County",2,45,2470,1251,1219
050,53,073,"Washington","Whatcom County",2,46,2381,1196,1185
050,53,073,"Washington","Whatcom County",2,47,2400,1218,1182
050,53,073,"Washington","Whatcom County",2,48,2531,1302,1229
050,53,073,"Washington","Whatcom County",2,49,2710,1382,1328
050,53,073,"Washington","Whatcom County",2,50,2723,1380,1343
050,53,073,"Washington","Whatcom County",2,51,2650,1327,1323
050,53,073,"Washington","Whatcom County",2,52,2526,1259,1267
050,53,073,"Washington","Whatcom County",2,53,2435,1211,1224
050,53,073,"Washington","Whatcom County",2,54,2439,1205,1234
050,53,073,"Washington","Whatcom County",2,55,2554,1274,1280
050,53,073,"Washington","Whatcom County",2,56,2666,1300,1366
050,53,073,"Washington","Whatcom County",2,57,2706,1303,1403
050,53,073,"Washington","Whatcom County",2,58,2763,1338,1425
050,53,073,"Washington","Whatcom County",2,59,2857,1405,1452
050,53,073,"Washington","Whatcom County",2,60,2820,1390,1430
050,53,073,"Washington","Whatcom County",2,61,2733,1324,1409
050,53,073,"Washington","Whatcom County",2,62,2824,1344,1480
050,53,073,"Washington","Whatcom County",2,63,2897,1392,1505
050,53,073,"Washington","Whatcom County",2,64,2811,1367,1444
050,53,073,"Washington","Whatcom County",2,65,2808,1338,1470
050,53,073,"Washington","Whatcom County",2,66,2863,1341,1522
050,53,073,"Washington","Whatcom County",2,67,2791,1312,1479
050,53,073,"Washington","Whatcom County",2,68,2744,1283,1461
050,53,073,"Washington","Whatcom County",2,69,2648,1234,1414
050,53,073,"Washington","Whatcom County",2,70,2498,1210,1288
050,53,073,"Washington","Whatcom County",2,71,2448,1202,1246
050,53,073,"Washington","Whatcom County",2,72,2407,1161,1246
050,53,073,"Washington","Whatcom County",2,73,2515,1165,1350
050,53,073,"Washington","Whatcom County",2,74,1720,795,925
050,53,073,"Washington","Whatcom County",2,75,1679,795,884
050,53,073,"Washington","Whatcom County",2,76,1598,757,841
050,53,073,"Washington","Whatcom County",2,77,1566,753,813
050,53,073,"Washington","Whatcom County",2,78,1289,614,675
050,53,073,"Washington","Whatcom County",2,79,1096,527,569
050,53,073,"Washington","Whatcom County",2,80,1000,470,530
050,53,073,"Washington","Whatcom County",2,81,913,413,500
050,53,073,"Washington","Whatcom County",2,82,847,392,455
050,53,073,"Washington","Whatcom County",2,83,729,330,399
050,53,073,"Washington","Whatcom County",2,84,673,308,365
050,53,073,"Washington","Whatcom County",2,85,3882,1477,2405
050,53,073,"Washington","Whatcom County",3,0,1980,987,993
050,53,073,"Washington","Whatcom County",3,1,2053,1048,1005
050,53,073,"Washington","Whatcom County",3,2,2066,1033,1033
050,53,073,"Washington","Whatcom County",3,3,2239,1144,1095
050,53,073,"Washington","Whatcom County",3,4,2326,1216,1110
050,53,073,"Washington","Whatcom County",3,5,2475,1281,1194
050,53,073,"Washington","Whatcom County",3,6,2443,1260,1183
050,53,073,"Washington","Whatcom County",3,7,2469,1272,1197
050,53,073,"Washington","Whatcom County",3,8,2467,1287,1180
050,53,073,"Washington","Whatcom County",3,9,2447,1270,1177
050,53,073,"Washington","Whatcom County",3,10,2441,1284,1157
050,53,073,"Washington","Whatcom County",3,11,2557,1354,1203
050,53,073,"Washington","Whatcom County",3,12,2565,1317,1248
050,53,073,"Washington","Whatcom County",3,13,2585,1303,1282
050,53,073,"Washington","Whatcom County",3,14,2546,1296,1250
050,53,073,"Washington","Whatcom County",3,15,2590,1355,1235
050,53,073,"Washington","Whatcom County",3,16,2512,1302,1210
050,53,073,"Washington","Whatcom County",3,17,2504,1290,1214
050,53,073,"Washington","Whatcom County",3,18,2563,1302,1261
050,53,073,"Washington","Whatcom County",3,19,3166,1512,1654
050,53,073,"Washington","Whatcom County",3,20,4454,2200,2254
050,53,073,"Washington","Whatcom County",3,21,4932,2311,2621
050,53,073,"Washington","Whatcom County",3,22,4976,2424,2552
050,53,073,"Washington","Whatcom County",3,23,4118,2103,2015
050,53,073,"Washington","Whatcom County",3,24,3662,1859,1803
050,53,073,"Washington","Whatcom County",3,25,3383,1717,1666
050,53,073,"Washington","Whatcom County",3,26,3179,1650,1529
050,53,073,"Washington","Whatcom County",3,27,3092,1591,1501
050,53,073,"Washington","Whatcom County",3,28,3169,1648,1521
050,53,073,"Washington","Whatcom County",3,29,3325,1723,1602
050,53,073,"Washington","Whatcom County",3,30,3358,1766,1592
050,53,073,"Washington","Whatcom County",3,31,3269,1699,1570
050,53,073,"Washington","Whatcom County",3,32,3021,1590,1431
050,53,073,"Washington","Whatcom County",3,33,2870,1477,1393
050,53,073,"Washington","Whatcom County",3,34,2786,1411,1375
050,53,073,"Washington","Whatcom County",3,35,2847,1460,1387
050,53,073,"Washington","Whatcom County",3,36,3012,1518,1494
050,53,073,"Washington","Whatcom County",3,37,2991,1484,1507
050,53,073,"Washington","Whatcom County",3,38,3069,1561,1508
050,53,073,"Washington","Whatcom County",3,39,3087,1558,1529
050,53,073,"Washington","Whatcom County",3,40,3054,1531,1523
050,53,073,"Washington","Whatcom County",3,41,2963,1499,1464
050,53,073,"Washington","Whatcom County",3,42,2830,1423,1407
050,53,073,"Washington","Whatcom County",3,43,2775,1389,1386
050,53,073,"Washington","Whatcom County",3,44,2664,1348,1316
050,53,073,"Washington","Whatcom County",3,45,2585,1326,1259
050,53,073,"Washington","Whatcom County",3,46,2460,1238,1222
050,53,073,"Washington","Whatcom County",3,47,2399,1202,1197
050,53,073,"Washington","Whatcom County",3,48,2382,1205,1177
050,53,073,"Washington","Whatcom County",3,49,2521,1295,1226
050,53,073,"Washington","Whatcom County",3,50,2730,1379,1351
050,53,073,"Washington","Whatcom County",3,51,2742,1390,1352
050,53,073,"Washington","Whatcom County",3,52,2656,1325,1331
050,53,073,"Washington","Whatcom County",3,53,2517,1250,1267
050,53,073,"Washington","Whatcom County",3,54,2429,1201,1228
050,53,073,"Washington","Whatcom County",3,55,2436,1196,1240
050,53,073,"Washington","Whatcom County",3,56,2532,1261,1271
050,53,073,"Washington","Whatcom County",3,57,2677,1305,1372
050,53,073,"Washington","Whatcom County",3,58,2712,1294,1418
050,53,073,"Washington","Whatcom County",3,59,2770,1335,1435
050,53,073,"Washington","Whatcom County",3,60,2855,1410,1445
050,53,073,"Washington","Whatcom County",3,61,2791,1364,1427
050,53,073,"Washington","Whatcom County",3,62,2745,1332,1413
050,53,073,"Washington","Whatcom County",3,63,2852,1339,1513
050,53,073,"Washington","Whatcom County",3,64,2933,1392,1541
050,53,073,"Washington","Whatcom County",3,65,2815,1355,1460
050,53,073,"Washington","Whatcom County",3,66,2804,1343,1461
050,53,073,"Washington","Whatcom County",3,67,2814,1318,1496
050,53,073,"Washington","Whatcom County",3,68,2768,1310,1458
050,53,073,"Washington","Whatcom County",3,69,2723,1259,1464
050,53,073,"Washington","Whatcom County",3,70,2624,1227,1397
050,53,073,"Washington","Whatcom County",3,71,2479,1192,1287
050,53,073,"Washington","Whatcom County",3,72,2384,1181,1203
050,53,073,"Washington","Whatcom County",3,73,2379,1142,1237
050,53,073,"Washington","Whatcom County",3,74,2482,1147,1335
050,53,073,"Washington","Whatcom County",3,75,1665,771,894
050,53,073,"Washington","Whatcom County",3,76,1638,772,866
050,53,073,"Washington","Whatcom County",3,77,1539,728,811
050,53,073,"Washington","Whatcom County",3,78,1513,714,799
050,53,073,"Washington","Whatcom County",3,79,1216,586,630
050,53,073,"Washington","Whatcom County",3,80,1079,510,569
050,53,073,"Washington","Whatcom County",3,81,937,434,503
050,53,073,"Washington","Whatcom County",3,82,864,388,476
050,53,073,"Washington","Whatcom County",3,83,820,370,450
050,53,073,"Washington","Whatcom County",3,84,685,313,372
050,53,073,"Washington","Whatcom County",3,85,3869,1507,2362
050,53,073,"Washington","Whatcom County",4,0,1995,1033,962
050,53,073,"Washington","Whatcom County",4,1,2003,994,1009
050,53,073,"Washington","Whatcom County",4,2,2084,1068,1016
050,53,073,"Washington","Whatcom County",4,3,2046,1029,1017
050,53,073,"Washington","Whatcom County",4,4,2237,1137,1100
050,53,073,"Washington","Whatcom County",4,5,2308,1187,1121
050,53,073,"Washington","Whatcom County",4,6,2490,1293,1197
050,53,073,"Washington","Whatcom County",4,7,2420,1255,1165
050,53,073,"Washington","Whatcom County",4,8,2435,1250,1185
050,53,073,"Washington","Whatcom County",4,9,2458,1287,1171
050,53,073,"Washington","Whatcom County",4,10,2440,1260,1180
050,53,073,"Washington","Whatcom County",4,11,2475,1314,1161
050,53,073,"Washington","Whatcom County",4,12,2551,1330,1221
050,53,073,"Washington","Whatcom County",4,13,2549,1306,1243
050,53,073,"Washington","Whatcom County",4,14,2536,1274,1262
050,53,073,"Washington","Whatcom County",4,15,2580,1319,1261
050,53,073,"Washington","Whatcom County",4,16,2569,1328,1241
050,53,073,"Washington","Whatcom County",4,17,2512,1299,1213
050,53,073,"Washington","Whatcom County",4,18,3265,1565,1700
050,53,073,"Washington","Whatcom County",4,19,4287,2010,2277
050,53,073,"Washington","Whatcom County",4,20,4802,2316,2486
050,53,073,"Washington","Whatcom County",4,21,5050,2370,2680
050,53,073,"Washington","Whatcom County",4,22,5133,2450,2683
050,53,073,"Washington","Whatcom County",4,23,4294,2200,2094
050,53,073,"Washington","Whatcom County",4,24,3744,1914,1830
050,53,073,"Washington","Whatcom County",4,25,3237,1592,1645
050,53,073,"Washington","Whatcom County",4,26,3198,1632,1566
050,53,073,"Washington","Whatcom County",4,27,3080,1611,1469
050,53,073,"Washington","Whatcom County",4,28,3105,1629,1476
050,53,073,"Washington","Whatcom County",4,29,3217,1688,1529
050,53,073,"Washington","Whatcom County",4,30,3309,1703,1606
050,53,073,"Washington","Whatcom County",4,31,3371,1748,1623
050,53,073,"Washington","Whatcom County",4,32,3295,1694,1601
050,53,073,"Washington","Whatcom County",4,33,3106,1622,1484
050,53,073,"Washington","Whatcom County",4,34,2933,1511,1422
050,53,073,"Washington","Whatcom County",4,35,2859,1459,1400
050,53,073,"Washington","Whatcom County",4,36,2862,1459,1403
050,53,073,"Washington","Whatcom County",4,37,3054,1554,1500
050,53,073,"Washington","Whatcom County",4,38,3024,1499,1525
050,53,073,"Washington","Whatcom County",4,39,3082,1570,1512
050,53,073,"Washington","Whatcom County",4,40,3086,1556,1530
050,53,073,"Washington","Whatcom County",4,41,2997,1489,1508
050,53,073,"Washington","Whatcom County",4,42,3011,1505,1506
050,53,073,"Washington","Whatcom County",4,43,2851,1438,1413
050,53,073,"Washington","Whatcom County",4,44,2769,1390,1379
050,53,073,"Washington","Whatcom County",4,45,2734,1409,1325
050,53,073,"Washington","Whatcom County",4,46,2548,1302,1246
050,53,073,"Washington","Whatcom County",4,47,2463,1231,1232
050,53,073,"Washington","Whatcom County",4,48,2368,1188,1180
050,53,073,"Washington","Whatcom County",4,49,2358,1189,1169
050,53,073,"Washington","Whatcom County",4,50,2517,1286,1231
050,53,073,"Washington","Whatcom County",4,51,2734,1374,1360
050,53,073,"Washington","Whatcom County",4,52,2709,1370,1339
050,53,073,"Washington","Whatcom County",4,53,2644,1318,1326
050,53,073,"Washington","Whatcom County",4,54,2519,1242,1277
050,53,073,"Washington","Whatcom County",4,55,2425,1207,1218
050,53,073,"Washington","Whatcom County",4,56,2415,1178,1237
050,53,073,"Washington","Whatcom County",4,57,2529,1263,1266
050,53,073,"Washington","Whatcom County",4,58,2682,1292,1390
050,53,073,"Washington","Whatcom County",4,59,2701,1278,1423
050,53,073,"Washington","Whatcom County",4,60,2798,1362,1436
050,53,073,"Washington","Whatcom County",4,61,2839,1389,1450
050,53,073,"Washington","Whatcom County",4,62,2841,1399,1442
050,53,073,"Washington","Whatcom County",4,63,2755,1329,1426
050,53,073,"Washington","Whatcom County",4,64,2837,1333,1504
050,53,073,"Washington","Whatcom County",4,65,2913,1385,1528
050,53,073,"Washington","Whatcom County",4,66,2795,1341,1454
050,53,073,"Washington","Whatcom County",4,67,2741,1296,1445
050,53,073,"Washington","Whatcom County",4,68,2801,1299,1502
050,53,073,"Washington","Whatcom County",4,69,2747,1300,1447
050,53,073,"Washington","Whatcom County",4,70,2696,1248,1448
050,53,073,"Washington","Whatcom County",4,71,2599,1219,1380
050,53,073,"Washington","Whatcom County",4,72,2431,1163,1268
050,53,073,"Washington","Whatcom County",4,73,2356,1165,1191
050,53,073,"Washington","Whatcom County",4,74,2335,1119,1216
050,53,073,"Washington","Whatcom County",4,75,2414,1117,1297
050,53,073,"Washington","Whatcom County",4,76,1621,738,883
050,53,073,"Washington","Whatcom County",4,77,1586,745,841
050,53,073,"Washington","Whatcom County",4,78,1499,698,801
050,53,073,"Washington","Whatcom County",4,79,1449,690,759
050,53,073,"Washington","Whatcom County",4,80,1177,558,619
050,53,073,"Washington","Whatcom County",4,81,1017,476,541
050,53,073,"Washington","Whatcom County",4,82,871,406,465
050,53,073,"Washington","Whatcom County",4,83,826,358,468
050,53,073,"Washington","Whatcom County",4,84,762,354,408
050,53,073,"Washington","Whatcom County",4,85,3837,1535,2302
050,53,073,"Washington","Whatcom County",5,0,1958,1017,941
050,53,073,"Washington","Whatcom County",5,1,2006,1030,976
050,53,073,"Washington","Whatcom County",5,2,2050,1006,1044
050,53,073,"Washington","Whatcom County",5,3,2061,1062,999
050,53,073,"Washington","Whatcom County",5,4,2066,1042,1024
050,53,073,"Washington","Whatcom County",5,5,2252,1126,1126
050,53,073,"Washington","Whatcom County",5,6,2293,1182,1111
050,53,073,"Washington","Whatcom County",5,7,2502,1321,1181
050,53,073,"Washington","Whatcom County",5,8,2413,1265,1148
050,53,073,"Washington","Whatcom County",5,9,2417,1243,1174
050,53,073,"Washington","Whatcom County",5,10,2459,1285,1174
050,53,073,"Washington","Whatcom County",5,11,2467,1287,1180
050,53,073,"Washington","Whatcom County",5,12,2469,1298,1171
050,53,073,"Washington","Whatcom County",5,13,2559,1337,1222
050,53,073,"Washington","Whatcom County",5,14,2518,1287,1231
050,53,073,"Washington","Whatcom County",5,15,2572,1297,1275
050,53,073,"Washington","Whatcom County",5,16,2521,1271,1250
050,53,073,"Washington","Whatcom County",5,17,2552,1327,1225
050,53,073,"Washington","Whatcom County",5,18,3199,1554,1645
050,53,073,"Washington","Whatcom County",5,19,4302,2019,2283
050,53,073,"Washington","Whatcom County",5,20,4797,2323,2474
050,53,073,"Washington","Whatcom County",5,21,4984,2335,2649
050,53,073,"Washington","Whatcom County",5,22,5059,2408,2651
050,53,073,"Washington","Whatcom County",5,23,4213,2100,2113
050,53,073,"Washington","Whatcom County",5,24,3840,2002,1838
050,53,073,"Washington","Whatcom County",5,25,3417,1737,1680
050,53,073,"Washington","Whatcom County",5,26,3092,1521,1571
050,53,073,"Washington","Whatcom County",5,27,3088,1609,1479
050,53,073,"Washington","Whatcom County",5,28,3080,1633,1447
050,53,073,"Washington","Whatcom County",5,29,3143,1688,1455
050,53,073,"Washington","Whatcom County",5,30,3291,1726,1565
050,53,073,"Washington","Whatcom County",5,31,3329,1675,1654
050,53,073,"Washington","Whatcom County",5,32,3374,1736,1638
050,53,073,"Washington","Whatcom County",5,33,3340,1713,1627
050,53,073,"Washington","Whatcom County",5,34,3153,1643,1510
050,53,073,"Washington","Whatcom County",5,35,3033,1557,1476
050,53,073,"Washington","Whatcom County",5,36,2895,1471,1424
050,53,073,"Washington","Whatcom County",5,37,2919,1487,1432
050,53,073,"Washington","Whatcom County",5,38,3092,1562,1530
050,53,073,"Washington","Whatcom County",5,39,3026,1506,1520
050,53,073,"Washington","Whatcom County",5,40,3140,1589,1551
050,53,073,"Washington","Whatcom County",5,41,3060,1549,1511
050,53,073,"Washington","Whatcom County",5,42,3078,1537,1541
050,53,073,"Washington","Whatcom County",5,43,3050,1531,1519
050,53,073,"Washington","Whatcom County",5,44,2849,1445,1404
050,53,073,"Washington","Whatcom County",5,45,2769,1412,1357
050,53,073,"Washington","Whatcom County",5,46,2713,1383,1330
050,53,073,"Washington","Whatcom County",5,47,2574,1317,1257
050,53,073,"Washington","Whatcom County",5,48,2449,1227,1222
050,53,073,"Washington","Whatcom County",5,49,2375,1184,1191
050,53,073,"Washington","Whatcom County",5,50,2376,1193,1183
050,53,073,"Washington","Whatcom County",5,51,2503,1267,1236
050,53,073,"Washington","Whatcom County",5,52,2724,1358,1366
050,53,073,"Washington","Whatcom County",5,53,2706,1366,1340
050,53,073,"Washington","Whatcom County",5,54,2676,1328,1348
050,53,073,"Washington","Whatcom County",5,55,2509,1232,1277
050,53,073,"Washington","Whatcom County",5,56,2390,1189,1201
050,53,073,"Washington","Whatcom County",5,57,2394,1170,1224
050,53,073,"Washington","Whatcom County",5,58,2547,1253,1294
050,53,073,"Washington","Whatcom County",5,59,2669,1274,1395
050,53,073,"Washington","Whatcom County",5,60,2725,1300,1425
050,53,073,"Washington","Whatcom County",5,61,2768,1325,1443
050,53,073,"Washington","Whatcom County",5,62,2858,1392,1466
050,53,073,"Washington","Whatcom County",5,63,2820,1379,1441
050,53,073,"Washington","Whatcom County",5,64,2753,1313,1440
050,53,073,"Washington","Whatcom County",5,65,2807,1306,1501
050,53,073,"Washington","Whatcom County",5,66,2886,1367,1519
050,53,073,"Washington","Whatcom County",5,67,2746,1322,1424
050,53,073,"Washington","Whatcom County",5,68,2718,1279,1439
050,53,073,"Washington","Whatcom County",5,69,2773,1282,1491
050,53,073,"Washington","Whatcom County",5,70,2729,1298,1431
050,53,073,"Washington","Whatcom County",5,71,2653,1219,1434
050,53,073,"Washington","Whatcom County",5,72,2525,1179,1346
050,53,073,"Washington","Whatcom County",5,73,2404,1146,1258
050,53,073,"Washington","Whatcom County",5,74,2307,1129,1178
050,53,073,"Washington","Whatcom County",5,75,2283,1084,1199
050,53,073,"Washington","Whatcom County",5,76,2321,1053,1268
050,53,073,"Washington","Whatcom County",5,77,1561,714,847
050,53,073,"Washington","Whatcom County",5,78,1537,719,818
050,53,073,"Washington","Whatcom County",5,79,1448,672,776
050,53,073,"Washington","Whatcom County",5,80,1398,661,737
050,53,073,"Washington","Whatcom County",5,81,1105,522,583
050,53,073,"Washington","Whatcom County",5,82,949,452,497
050,53,073,"Washington","Whatcom County",5,83,832,377,455
050,53,073,"Washington","Whatcom County",5,84,767,342,425
050,53,073,"Washington","Whatcom County",5,85,3894,1604,2290
050,53,075,"Washington","Whitman County",1,0,352,181,171
050,53,075,"Washington","Whitman County",1,1,373,187,186
050,53,075,"Washington","Whitman County",1,2,383,207,176
050,53,075,"Washington","Whitman County",1,3,390,197,193
050,53,075,"Washington","Whitman County",1,4,415,208,207
050,53,075,"Washington","Whitman County",1,5,441,220,221
050,53,075,"Washington","Whitman County",1,6,412,203,209
050,53,075,"Washington","Whitman County",1,7,437,234,203
050,53,075,"Washington","Whitman County",1,8,393,206,187
050,53,075,"Washington","Whitman County",1,9,394,214,180
050,53,075,"Washington","Whitman County",1,10,372,193,179
050,53,075,"Washington","Whitman County",1,11,397,213,184
050,53,075,"Washington","Whitman County",1,12,428,222,206
050,53,075,"Washington","Whitman County",1,13,412,209,203
050,53,075,"Washington","Whitman County",1,14,405,216,189
050,53,075,"Washington","Whitman County",1,15,422,226,196
050,53,075,"Washington","Whitman County",1,16,435,241,194
050,53,075,"Washington","Whitman County",1,17,448,224,224
050,53,075,"Washington","Whitman County",1,18,1732,803,929
050,53,075,"Washington","Whitman County",1,19,3193,1510,1683
050,53,075,"Washington","Whitman County",1,20,2969,1347,1622
050,53,075,"Washington","Whitman County",1,21,2770,1394,1376
050,53,075,"Washington","Whitman County",1,22,2557,1343,1214
050,53,075,"Washington","Whitman County",1,23,1827,1093,734
050,53,075,"Washington","Whitman County",1,24,1275,697,578
050,53,075,"Washington","Whitman County",1,25,969,504,465
050,53,075,"Washington","Whitman County",1,26,761,425,336
050,53,075,"Washington","Whitman County",1,27,713,359,354
050,53,075,"Washington","Whitman County",1,28,732,385,347
050,53,075,"Washington","Whitman County",1,29,704,399,305
050,53,075,"Washington","Whitman County",1,30,715,438,277
050,53,075,"Washington","Whitman County",1,31,608,335,273
050,53,075,"Washington","Whitman County",1,32,549,308,241
050,53,075,"Washington","Whitman County",1,33,516,273,243
050,53,075,"Washington","Whitman County",1,34,499,271,228
050,53,075,"Washington","Whitman County",1,35,472,262,210
050,53,075,"Washington","Whitman County",1,36,496,264,232
050,53,075,"Washington","Whitman County",1,37,480,247,233
050,53,075,"Washington","Whitman County",1,38,482,259,223
050,53,075,"Washington","Whitman County",1,39,467,244,223
050,53,075,"Washington","Whitman County",1,40,445,227,218
050,53,075,"Washington","Whitman County",1,41,402,199,203
050,53,075,"Washington","Whitman County",1,42,434,224,210
050,53,075,"Washington","Whitman County",1,43,433,216,217
050,53,075,"Washington","Whitman County",1,44,399,196,203
050,53,075,"Washington","Whitman County",1,45,393,203,190
050,53,075,"Washington","Whitman County",1,46,339,173,166
050,53,075,"Washington","Whitman County",1,47,346,173,173
050,53,075,"Washington","Whitman County",1,48,362,181,181
050,53,075,"Washington","Whitman County",1,49,392,202,190
050,53,075,"Washington","Whitman County",1,50,391,206,185
050,53,075,"Washington","Whitman County",1,51,370,188,182
050,53,075,"Washington","Whitman County",1,52,340,161,179
050,53,075,"Washington","Whitman County",1,53,348,173,175
050,53,075,"Washington","Whitman County",1,54,350,171,179
050,53,075,"Washington","Whitman County",1,55,377,181,196
050,53,075,"Washington","Whitman County",1,56,391,197,194
050,53,075,"Washington","Whitman County",1,57,414,210,204
050,53,075,"Washington","Whitman County",1,58,422,206,216
050,53,075,"Washington","Whitman County",1,59,447,227,220
050,53,075,"Washington","Whitman County",1,60,463,238,225
050,53,075,"Washington","Whitman County",1,61,453,240,213
050,53,075,"Washington","Whitman County",1,62,420,206,214
050,53,075,"Washington","Whitman County",1,63,414,198,216
050,53,075,"Washington","Whitman County",1,64,418,207,211
050,53,075,"Washington","Whitman County",1,65,382,195,187
050,53,075,"Washington","Whitman County",1,66,359,185,174
050,53,075,"Washington","Whitman County",1,67,355,190,165
050,53,075,"Washington","Whitman County",1,68,323,170,153
050,53,075,"Washington","Whitman County",1,69,315,163,152
050,53,075,"Washington","Whitman County",1,70,322,161,161
050,53,075,"Washington","Whitman County",1,71,272,132,140
050,53,075,"Washington","Whitman County",1,72,262,128,134
050,53,075,"Washington","Whitman County",1,73,267,122,145
050,53,075,"Washington","Whitman County",1,74,201,92,109
050,53,075,"Washington","Whitman County",1,75,218,108,110
050,53,075,"Washington","Whitman County",1,76,219,103,116
050,53,075,"Washington","Whitman County",1,77,187,77,110
050,53,075,"Washington","Whitman County",1,78,175,76,99
050,53,075,"Washington","Whitman County",1,79,156,73,83
050,53,075,"Washington","Whitman County",1,80,121,60,61
050,53,075,"Washington","Whitman County",1,81,126,58,68
050,53,075,"Washington","Whitman County",1,82,117,54,63
050,53,075,"Washington","Whitman County",1,83,119,56,63
050,53,075,"Washington","Whitman County",1,84,98,43,55
050,53,075,"Washington","Whitman County",1,85,618,238,380
050,53,075,"Washington","Whitman County",2,0,372,193,179
050,53,075,"Washington","Whitman County",2,1,367,186,181
050,53,075,"Washington","Whitman County",2,2,377,202,175
050,53,075,"Washington","Whitman County",2,3,386,198,188
050,53,075,"Washington","Whitman County",2,4,410,205,205
050,53,075,"Washington","Whitman County",2,5,433,215,218
050,53,075,"Washington","Whitman County",2,6,417,207,210
050,53,075,"Washington","Whitman County",2,7,427,223,204
050,53,075,"Washington","Whitman County",2,8,399,211,188
050,53,075,"Washington","Whitman County",2,9,391,210,181
050,53,075,"Washington","Whitman County",2,10,375,196,179
050,53,075,"Washington","Whitman County",2,11,395,212,183
050,53,075,"Washington","Whitman County",2,12,425,223,202
050,53,075,"Washington","Whitman County",2,13,413,210,203
050,53,075,"Washington","Whitman County",2,14,404,211,193
050,53,075,"Washington","Whitman County",2,15,417,225,192
050,53,075,"Washington","Whitman County",2,16,435,239,196
050,53,075,"Washington","Whitman County",2,17,452,232,220
050,53,075,"Washington","Whitman County",2,18,1735,802,933
050,53,075,"Washington","Whitman County",2,19,3186,1500,1686
050,53,075,"Washington","Whitman County",2,20,2992,1360,1632
050,53,075,"Washington","Whitman County",2,21,2747,1377,1370
050,53,075,"Washington","Whitman County",2,22,2522,1331,1191
050,53,075,"Washington","Whitman County",2,23,1800,1076,724
050,53,075,"Washington","Whitman County",2,24,1256,683,573
050,53,075,"Washington","Whitman County",2,25,955,495,460
050,53,075,"Washington","Whitman County",2,26,763,424,339
050,53,075,"Washington","Whitman County",2,27,689,353,336
050,53,075,"Washington","Whitman County",2,28,713,373,340
050,53,075,"Washington","Whitman County",2,29,689,381,308
050,53,075,"Washington","Whitman County",2,30,700,419,281
050,53,075,"Washington","Whitman County",2,31,627,359,268
050,53,075,"Washington","Whitman County",2,32,552,305,247
050,53,075,"Washington","Whitman County",2,33,514,275,239
050,53,075,"Washington","Whitman County",2,34,498,270,228
050,53,075,"Washington","Whitman County",2,35,477,265,212
050,53,075,"Washington","Whitman County",2,36,479,256,223
050,53,075,"Washington","Whitman County",2,37,481,250,231
050,53,075,"Washington","Whitman County",2,38,477,252,225
050,53,075,"Washington","Whitman County",2,39,464,243,221
050,53,075,"Washington","Whitman County",2,40,450,231,219
050,53,075,"Washington","Whitman County",2,41,407,202,205
050,53,075,"Washington","Whitman County",2,42,420,214,206
050,53,075,"Washington","Whitman County",2,43,434,219,215
050,53,075,"Washington","Whitman County",2,44,400,197,203
050,53,075,"Washington","Whitman County",2,45,395,201,194
050,53,075,"Washington","Whitman County",2,46,351,178,173
050,53,075,"Washington","Whitman County",2,47,343,172,171
050,53,075,"Washington","Whitman County",2,48,354,176,178
050,53,075,"Washington","Whitman County",2,49,385,197,188
050,53,075,"Washington","Whitman County",2,50,389,205,184
050,53,075,"Washington","Whitman County",2,51,369,190,179
050,53,075,"Washington","Whitman County",2,52,346,167,179
050,53,075,"Washington","Whitman County",2,53,346,169,177
050,53,075,"Washington","Whitman County",2,54,350,171,179
050,53,075,"Washington","Whitman County",2,55,368,178,190
050,53,075,"Washington","Whitman County",2,56,388,192,196
050,53,075,"Washington","Whitman County",2,57,408,207,201
050,53,075,"Washington","Whitman County",2,58,420,207,213
050,53,075,"Washington","Whitman County",2,59,442,222,220
050,53,075,"Washington","Whitman County",2,60,458,235,223
050,53,075,"Washington","Whitman County",2,61,454,240,214
050,53,075,"Washington","Whitman County",2,62,426,214,212
050,53,075,"Washington","Whitman County",2,63,419,203,216
050,53,075,"Washington","Whitman County",2,64,409,199,210
050,53,075,"Washington","Whitman County",2,65,392,200,192
050,53,075,"Washington","Whitman County",2,66,362,185,177
050,53,075,"Washington","Whitman County",2,67,353,185,168
050,53,075,"Washington","Whitman County",2,68,326,173,153
050,53,075,"Washington","Whitman County",2,69,319,166,153
050,53,075,"Washington","Whitman County",2,70,319,159,160
050,53,075,"Washington","Whitman County",2,71,284,141,143
050,53,075,"Washington","Whitman County",2,72,259,127,132
050,53,075,"Washington","Whitman County",2,73,277,127,150
050,53,075,"Washington","Whitman County",2,74,205,93,112
050,53,075,"Washington","Whitman County",2,75,214,104,110
050,53,075,"Washington","Whitman County",2,76,216,104,112
050,53,075,"Washington","Whitman County",2,77,199,85,114
050,53,075,"Washington","Whitman County",2,78,177,76,101
050,53,075,"Washington","Whitman County",2,79,156,73,83
050,53,075,"Washington","Whitman County",2,80,127,63,64
050,53,075,"Washington","Whitman County",2,81,123,57,66
050,53,075,"Washington","Whitman County",2,82,118,56,62
050,53,075,"Washington","Whitman County",2,83,117,55,62
050,53,075,"Washington","Whitman County",2,84,101,44,57
050,53,075,"Washington","Whitman County",2,85,621,240,381
050,53,075,"Washington","Whitman County",3,0,368,174,194
050,53,075,"Washington","Whitman County",3,1,357,173,184
050,53,075,"Washington","Whitman County",3,2,387,200,187
050,53,075,"Washington","Whitman County",3,3,390,206,184
050,53,075,"Washington","Whitman County",3,4,389,203,186
050,53,075,"Washington","Whitman County",3,5,438,217,221
050,53,075,"Washington","Whitman County",3,6,443,223,220
050,53,075,"Washington","Whitman County",3,7,418,209,209
050,53,075,"Washington","Whitman County",3,8,411,213,198
050,53,075,"Washington","Whitman County",3,9,417,216,201
050,53,075,"Washington","Whitman County",3,10,415,214,201
050,53,075,"Washington","Whitman County",3,11,376,204,172
050,53,075,"Washington","Whitman County",3,12,395,206,189
050,53,075,"Washington","Whitman County",3,13,433,228,205
050,53,075,"Washington","Whitman County",3,14,420,211,209
050,53,075,"Washington","Whitman County",3,15,415,218,197
050,53,075,"Washington","Whitman County",3,16,445,240,205
050,53,075,"Washington","Whitman County",3,17,445,244,201
050,53,075,"Washington","Whitman County",3,18,744,373,371
050,53,075,"Washington","Whitman County",3,19,1257,567,690
050,53,075,"Washington","Whitman County",3,20,2019,863,1156
050,53,075,"Washington","Whitman County",3,21,2321,1158,1163
050,53,075,"Washington","Whitman County",3,22,2302,1222,1080
050,53,075,"Washington","Whitman County",3,23,1661,1012,649
050,53,075,"Washington","Whitman County",3,24,1128,619,509
050,53,075,"Washington","Whitman County",3,25,917,447,470
050,53,075,"Washington","Whitman County",3,26,791,424,367
050,53,075,"Washington","Whitman County",3,27,642,350,292
050,53,075,"Washington","Whitman County",3,28,679,373,306
050,53,075,"Washington","Whitman County",3,29,638,325,313
050,53,075,"Washington","Whitman County",3,30,664,360,304
050,53,075,"Washington","Whitman County",3,31,682,386,296
050,53,075,"Washington","Whitman County",3,32,591,349,242
050,53,075,"Washington","Whitman County",3,33,549,299,250
050,53,075,"Washington","Whitman County",3,34,500,262,238
050,53,075,"Washington","Whitman County",3,35,518,273,245
050,53,075,"Washington","Whitman County",3,36,479,257,222
050,53,075,"Washington","Whitman County",3,37,498,270,228
050,53,075,"Washington","Whitman County",3,38,485,252,233
050,53,075,"Washington","Whitman County",3,39,479,260,219
050,53,075,"Washington","Whitman County",3,40,485,250,235
050,53,075,"Washington","Whitman County",3,41,441,226,215
050,53,075,"Washington","Whitman County",3,42,398,198,200
050,53,075,"Washington","Whitman County",3,43,433,222,211
050,53,075,"Washington","Whitman County",3,44,438,225,213
050,53,075,"Washington","Whitman County",3,45,405,198,207
050,53,075,"Washington","Whitman County",3,46,388,203,185
050,53,075,"Washington","Whitman County",3,47,343,173,170
050,53,075,"Washington","Whitman County",3,48,332,160,172
050,53,075,"Washington","Whitman County",3,49,351,172,179
050,53,075,"Washington","Whitman County",3,50,385,199,186
050,53,075,"Washington","Whitman County",3,51,389,207,182
050,53,075,"Washington","Whitman County",3,52,362,184,178
050,53,075,"Washington","Whitman County",3,53,349,176,173
050,53,075,"Washington","Whitman County",3,54,344,162,182
050,53,075,"Washington","Whitman County",3,55,352,171,181
050,53,075,"Washington","Whitman County",3,56,384,181,203
050,53,075,"Washington","Whitman County",3,57,376,191,185
050,53,075,"Washington","Whitman County",3,58,412,214,198
050,53,075,"Washington","Whitman County",3,59,427,203,224
050,53,075,"Washington","Whitman County",3,60,446,218,228
050,53,075,"Washington","Whitman County",3,61,445,232,213
050,53,075,"Washington","Whitman County",3,62,444,239,205
050,53,075,"Washington","Whitman County",3,63,416,214,202
050,53,075,"Washington","Whitman County",3,64,401,199,202
050,53,075,"Washington","Whitman County",3,65,414,210,204
050,53,075,"Washington","Whitman County",3,66,392,195,197
050,53,075,"Washington","Whitman County",3,67,355,180,175
050,53,075,"Washington","Whitman County",3,68,345,179,166
050,53,075,"Washington","Whitman County",3,69,312,165,147
050,53,075,"Washington","Whitman County",3,70,313,158,155
050,53,075,"Washington","Whitman County",3,71,297,145,152
050,53,075,"Washington","Whitman County",3,72,282,147,135
050,53,075,"Washington","Whitman County",3,73,242,121,121
050,53,075,"Washington","Whitman County",3,74,274,119,155
050,53,075,"Washington","Whitman County",3,75,191,87,104
050,53,075,"Washington","Whitman County",3,76,209,104,105
050,53,075,"Washington","Whitman County",3,77,196,92,104
050,53,075,"Washington","Whitman County",3,78,193,79,114
050,53,075,"Washington","Whitman County",3,79,165,73,92
050,53,075,"Washington","Whitman County",3,80,140,70,70
050,53,075,"Washington","Whitman County",3,81,113,50,63
050,53,075,"Washington","Whitman County",3,82,113,55,58
050,53,075,"Washington","Whitman County",3,83,113,56,57
050,53,075,"Washington","Whitman County",3,84,109,45,64
050,53,075,"Washington","Whitman County",3,85,604,237,367
050,53,075,"Washington","Whitman County",4,0,400,204,196
050,53,075,"Washington","Whitman County",4,1,378,197,181
050,53,075,"Washington","Whitman County",4,2,381,186,195
050,53,075,"Washington","Whitman County",4,3,401,204,197
050,53,075,"Washington","Whitman County",4,4,404,209,195
050,53,075,"Washington","Whitman County",4,5,393,209,184
050,53,075,"Washington","Whitman County",4,6,452,237,215
050,53,075,"Washington","Whitman County",4,7,449,228,221
050,53,075,"Washington","Whitman County",4,8,421,209,212
050,53,075,"Washington","Whitman County",4,9,404,208,196
050,53,075,"Washington","Whitman County",4,10,428,219,209
050,53,075,"Washington","Whitman County",4,11,414,214,200
050,53,075,"Washington","Whitman County",4,12,369,198,171
050,53,075,"Washington","Whitman County",4,13,390,200,190
050,53,075,"Washington","Whitman County",4,14,435,227,208
050,53,075,"Washington","Whitman County",4,15,431,213,218
050,53,075,"Washington","Whitman County",4,16,414,213,201
050,53,075,"Washington","Whitman County",4,17,444,238,206
050,53,075,"Washington","Whitman County",4,18,1526,724,802
050,53,075,"Washington","Whitman County",4,19,2772,1300,1472
050,53,075,"Washington","Whitman County",4,20,2844,1269,1575
050,53,075,"Washington","Whitman County",4,21,2775,1365,1410
050,53,075,"Washington","Whitman County",4,22,2543,1357,1186
050,53,075,"Washington","Whitman County",4,23,1745,1079,666
050,53,075,"Washington","Whitman County",4,24,1187,645,542
050,53,075,"Washington","Whitman County",4,25,912,442,470
050,53,075,"Washington","Whitman County",4,26,787,412,375
050,53,075,"Washington","Whitman County",4,27,666,357,309
050,53,075,"Washington","Whitman County",4,28,632,373,259
050,53,075,"Washington","Whitman County",4,29,667,350,317
050,53,075,"Washington","Whitman County",4,30,621,331,290
050,53,075,"Washington","Whitman County",4,31,645,347,298
050,53,075,"Washington","Whitman County",4,32,706,399,307
050,53,075,"Washington","Whitman County",4,33,602,341,261
050,53,075,"Washington","Whitman County",4,34,550,293,257
050,53,075,"Washington","Whitman County",4,35,519,269,250
050,53,075,"Washington","Whitman County",4,36,501,270,231
050,53,075,"Washington","Whitman County",4,37,487,257,230
050,53,075,"Washington","Whitman County",4,38,500,266,234
050,53,075,"Washington","Whitman County",4,39,465,237,228
050,53,075,"Washington","Whitman County",4,40,477,257,220
050,53,075,"Washington","Whitman County",4,41,468,241,227
050,53,075,"Washington","Whitman County",4,42,436,227,209
050,53,075,"Washington","Whitman County",4,43,413,208,205
050,53,075,"Washington","Whitman County",4,44,438,231,207
050,53,075,"Washington","Whitman County",4,45,443,226,217
050,53,075,"Washington","Whitman County",4,46,414,200,214
050,53,075,"Washington","Whitman County",4,47,374,188,186
050,53,075,"Washington","Whitman County",4,48,343,168,175
050,53,075,"Washington","Whitman County",4,49,315,144,171
050,53,075,"Washington","Whitman County",4,50,351,175,176
050,53,075,"Washington","Whitman County",4,51,373,198,175
050,53,075,"Washington","Whitman County",4,52,385,195,190
050,53,075,"Washington","Whitman County",4,53,360,185,175
050,53,075,"Washington","Whitman County",4,54,351,175,176
050,53,075,"Washington","Whitman County",4,55,343,164,179
050,53,075,"Washington","Whitman County",4,56,365,177,188
050,53,075,"Washington","Whitman County",4,57,373,175,198
050,53,075,"Washington","Whitman County",4,58,378,191,187
050,53,075,"Washington","Whitman County",4,59,411,208,203
050,53,075,"Washington","Whitman County",4,60,422,207,215
050,53,075,"Washington","Whitman County",4,61,439,215,224
050,53,075,"Washington","Whitman County",4,62,441,232,209
050,53,075,"Washington","Whitman County",4,63,455,249,206
050,53,075,"Washington","Whitman County",4,64,399,201,198
050,53,075,"Washington","Whitman County",4,65,404,199,205
050,53,075,"Washington","Whitman County",4,66,405,204,201
050,53,075,"Washington","Whitman County",4,67,391,186,205
050,53,075,"Washington","Whitman County",4,68,358,183,175
050,53,075,"Washington","Whitman County",4,69,339,173,166
050,53,075,"Washington","Whitman County",4,70,308,162,146
050,53,075,"Washington","Whitman County",4,71,294,148,146
050,53,075,"Washington","Whitman County",4,72,293,148,145
050,53,075,"Washington","Whitman County",4,73,273,145,128
050,53,075,"Washington","Whitman County",4,74,249,123,126
050,53,075,"Washington","Whitman County",4,75,262,111,151
050,53,075,"Washington","Whitman County",4,76,194,96,98
050,53,075,"Washington","Whitman County",4,77,186,90,96
050,53,075,"Washington","Whitman County",4,78,197,87,110
050,53,075,"Washington","Whitman County",4,79,191,78,113
050,53,075,"Washington","Whitman County",4,80,159,80,79
050,53,075,"Washington","Whitman County",4,81,134,61,73
050,53,075,"Washington","Whitman County",4,82,100,46,54
050,53,075,"Washington","Whitman County",4,83,108,56,52
050,53,075,"Washington","Whitman County",4,84,100,41,59
050,53,075,"Washington","Whitman County",4,85,607,241,366
050,53,075,"Washington","Whitman County",5,0,392,203,189
050,53,075,"Washington","Whitman County",5,1,404,210,194
050,53,075,"Washington","Whitman County",5,2,380,194,186
050,53,075,"Washington","Whitman County",5,3,368,181,187
050,53,075,"Washington","Whitman County",5,4,414,196,218
050,53,075,"Washington","Whitman County",5,5,422,227,195
050,53,075,"Washington","Whitman County",5,6,398,214,184
050,53,075,"Washington","Whitman County",5,7,472,254,218
050,53,075,"Washington","Whitman County",5,8,458,241,217
050,53,075,"Washington","Whitman County",5,9,429,212,217
050,53,075,"Washington","Whitman County",5,10,409,212,197
050,53,075,"Washington","Whitman County",5,11,431,227,204
050,53,075,"Washington","Whitman County",5,12,430,218,212
050,53,075,"Washington","Whitman County",5,13,394,209,185
050,53,075,"Washington","Whitman County",5,14,400,205,195
050,53,075,"Washington","Whitman County",5,15,461,243,218
050,53,075,"Washington","Whitman County",5,16,450,223,227
050,53,075,"Washington","Whitman County",5,17,437,228,209
050,53,075,"Washington","Whitman County",5,18,1535,730,805
050,53,075,"Washington","Whitman County",5,19,2757,1306,1451
050,53,075,"Washington","Whitman County",5,20,2786,1243,1543
050,53,075,"Washington","Whitman County",5,21,2703,1333,1370
050,53,075,"Washington","Whitman County",5,22,2602,1360,1242
050,53,075,"Washington","Whitman County",5,23,1798,1101,697
050,53,075,"Washington","Whitman County",5,24,1244,682,562
050,53,075,"Washington","Whitman County",5,25,982,479,503
050,53,075,"Washington","Whitman County",5,26,733,362,371
050,53,075,"Washington","Whitman County",5,27,715,383,332
050,53,075,"Washington","Whitman County",5,28,662,360,302
050,53,075,"Washington","Whitman County",5,29,603,352,251
050,53,075,"Washington","Whitman County",5,30,642,333,309
050,53,075,"Washington","Whitman County",5,31,610,315,295
050,53,075,"Washington","Whitman County",5,32,643,343,300
050,53,075,"Washington","Whitman County",5,33,682,381,301
050,53,075,"Washington","Whitman County",5,34,587,332,255
050,53,075,"Washington","Whitman County",5,35,547,271,276
050,53,075,"Washington","Whitman County",5,36,513,265,248
050,53,075,"Washington","Whitman County",5,37,521,280,241
050,53,075,"Washington","Whitman County",5,38,504,264,240
050,53,075,"Washington","Whitman County",5,39,499,266,233
050,53,075,"Washington","Whitman County",5,40,476,244,232
050,53,075,"Washington","Whitman County",5,41,479,257,222
050,53,075,"Washington","Whitman County",5,42,471,243,228
050,53,075,"Washington","Whitman County",5,43,439,226,213
050,53,075,"Washington","Whitman County",5,44,421,218,203
050,53,075,"Washington","Whitman County",5,45,435,232,203
050,53,075,"Washington","Whitman County",5,46,429,219,210
050,53,075,"Washington","Whitman County",5,47,404,196,208
050,53,075,"Washington","Whitman County",5,48,361,180,181
050,53,075,"Washington","Whitman County",5,49,358,177,181
050,53,075,"Washington","Whitman County",5,50,316,143,173
050,53,075,"Washington","Whitman County",5,51,351,170,181
050,53,075,"Washington","Whitman County",5,52,369,191,178
050,53,075,"Washington","Whitman County",5,53,388,200,188
050,53,075,"Washington","Whitman County",5,54,373,193,180
050,53,075,"Washington","Whitman County",5,55,333,165,168
050,53,075,"Washington","Whitman County",5,56,324,152,172
050,53,075,"Washington","Whitman County",5,57,364,179,185
050,53,075,"Washington","Whitman County",5,58,366,171,195
050,53,075,"Washington","Whitman County",5,59,370,184,186
050,53,075,"Washington","Whitman County",5,60,407,209,198
050,53,075,"Washington","Whitman County",5,61,426,208,218
050,53,075,"Washington","Whitman County",5,62,431,211,220
050,53,075,"Washington","Whitman County",5,63,424,230,194
050,53,075,"Washington","Whitman County",5,64,447,236,211
050,53,075,"Washington","Whitman County",5,65,396,195,201
050,53,075,"Washington","Whitman County",5,66,392,196,196
050,53,075,"Washington","Whitman County",5,67,396,193,203
050,53,075,"Washington","Whitman County",5,68,387,187,200
050,53,075,"Washington","Whitman County",5,69,341,172,169
050,53,075,"Washington","Whitman County",5,70,333,170,163
050,53,075,"Washington","Whitman County",5,71,286,151,135
050,53,075,"Washington","Whitman County",5,72,290,145,145
050,53,075,"Washington","Whitman County",5,73,283,147,136
050,53,075,"Washington","Whitman County",5,74,268,137,131
050,53,075,"Washington","Whitman County",5,75,243,116,127
050,53,075,"Washington","Whitman County",5,76,244,107,137
050,53,075,"Washington","Whitman County",5,77,179,85,94
050,53,075,"Washington","Whitman County",5,78,183,83,100
050,53,075,"Washington","Whitman County",5,79,183,83,100
050,53,075,"Washington","Whitman County",5,80,175,77,98
050,53,075,"Washington","Whitman County",5,81,150,69,81
050,53,075,"Washington","Whitman County",5,82,121,56,65
050,53,075,"Washington","Whitman County",5,83,95,46,49
050,53,075,"Washington","Whitman County",5,84,98,43,55
050,53,075,"Washington","Whitman County",5,85,590,247,343
050,53,077,"Washington","Yakima County",1,0,3613,1850,1763
050,53,077,"Washington","Yakima County",1,1,3694,1880,1814
050,53,077,"Washington","Yakima County",1,2,3930,1975,1955
050,53,077,"Washington","Yakima County",1,3,4130,2030,2100
050,53,077,"Washington","Yakima County",1,4,4331,2180,2151
050,53,077,"Washington","Yakima County",1,5,4281,2216,2065
050,53,077,"Washington","Yakima County",1,6,4274,2192,2082
050,53,077,"Washington","Yakima County",1,7,4209,2130,2079
050,53,077,"Washington","Yakima County",1,8,4222,2154,2068
050,53,077,"Washington","Yakima County",1,9,4430,2272,2158
050,53,077,"Washington","Yakima County",1,10,4476,2326,2150
050,53,077,"Washington","Yakima County",1,11,4457,2240,2217
050,53,077,"Washington","Yakima County",1,12,4653,2410,2243
050,53,077,"Washington","Yakima County",1,13,4583,2381,2202
050,53,077,"Washington","Yakima County",1,14,4381,2234,2147
050,53,077,"Washington","Yakima County",1,15,4201,2141,2060
050,53,077,"Washington","Yakima County",1,16,4244,2148,2096
050,53,077,"Washington","Yakima County",1,17,4130,2091,2039
050,53,077,"Washington","Yakima County",1,18,3744,1938,1806
050,53,077,"Washington","Yakima County",1,19,3426,1788,1638
050,53,077,"Washington","Yakima County",1,20,3462,1803,1659
050,53,077,"Washington","Yakima County",1,21,3383,1709,1674
050,53,077,"Washington","Yakima County",1,22,3388,1699,1689
050,53,077,"Washington","Yakima County",1,23,3368,1720,1648
050,53,077,"Washington","Yakima County",1,24,3365,1702,1663
050,53,077,"Washington","Yakima County",1,25,3356,1686,1670
050,53,077,"Washington","Yakima County",1,26,3605,1811,1794
050,53,077,"Washington","Yakima County",1,27,3643,1798,1845
050,53,077,"Washington","Yakima County",1,28,3643,1806,1837
050,53,077,"Washington","Yakima County",1,29,3603,1837,1766
050,53,077,"Washington","Yakima County",1,30,3455,1769,1686
050,53,077,"Washington","Yakima County",1,31,3328,1662,1666
050,53,077,"Washington","Yakima County",1,32,3205,1606,1599
050,53,077,"Washington","Yakima County",1,33,3269,1662,1607
050,53,077,"Washington","Yakima County",1,34,3205,1610,1595
050,53,077,"Washington","Yakima County",1,35,3144,1566,1578
050,53,077,"Washington","Yakima County",1,36,3104,1573,1531
050,53,077,"Washington","Yakima County",1,37,3135,1520,1615
050,53,077,"Washington","Yakima County",1,38,3151,1605,1546
050,53,077,"Washington","Yakima County",1,39,3209,1653,1556
050,53,077,"Washington","Yakima County",1,40,3154,1620,1534
050,53,077,"Washington","Yakima County",1,41,2990,1511,1479
050,53,077,"Washington","Yakima County",1,42,3041,1530,1511
050,53,077,"Washington","Yakima County",1,43,2932,1464,1468
050,53,077,"Washington","Yakima County",1,44,2776,1402,1374
050,53,077,"Washington","Yakima County",1,45,2786,1402,1384
050,53,077,"Washington","Yakima County",1,46,2716,1385,1331
050,53,077,"Washington","Yakima County",1,47,2771,1383,1388
050,53,077,"Washington","Yakima County",1,48,2843,1409,1434
050,53,077,"Washington","Yakima County",1,49,3002,1540,1462
050,53,077,"Washington","Yakima County",1,50,2861,1456,1405
050,53,077,"Washington","Yakima County",1,51,2749,1390,1359
050,53,077,"Washington","Yakima County",1,52,2752,1394,1358
050,53,077,"Washington","Yakima County",1,53,2658,1348,1310
050,53,077,"Washington","Yakima County",1,54,2657,1362,1295
050,53,077,"Washington","Yakima County",1,55,2832,1446,1386
050,53,077,"Washington","Yakima County",1,56,2863,1449,1414
050,53,077,"Washington","Yakima County",1,57,2930,1449,1481
050,53,077,"Washington","Yakima County",1,58,2920,1487,1433
050,53,077,"Washington","Yakima County",1,59,2849,1440,1409
050,53,077,"Washington","Yakima County",1,60,2793,1447,1346
050,53,077,"Washington","Yakima County",1,61,2734,1417,1317
050,53,077,"Washington","Yakima County",1,62,2726,1386,1340
050,53,077,"Washington","Yakima County",1,63,2629,1304,1325
050,53,077,"Washington","Yakima County",1,64,2571,1240,1331
050,53,077,"Washington","Yakima County",1,65,2461,1207,1254
050,53,077,"Washington","Yakima County",1,66,2389,1162,1227
050,53,077,"Washington","Yakima County",1,67,2414,1118,1296
050,53,077,"Washington","Yakima County",1,68,2260,1064,1196
050,53,077,"Washington","Yakima County",1,69,2191,1066,1125
050,53,077,"Washington","Yakima County",1,70,2131,1046,1085
050,53,077,"Washington","Yakima County",1,71,2032,976,1056
050,53,077,"Washington","Yakima County",1,72,2014,967,1047
050,53,077,"Washington","Yakima County",1,73,1964,972,992
050,53,077,"Washington","Yakima County",1,74,1426,693,733
050,53,077,"Washington","Yakima County",1,75,1477,721,756
050,53,077,"Washington","Yakima County",1,76,1416,670,746
050,53,077,"Washington","Yakima County",1,77,1359,648,711
050,53,077,"Washington","Yakima County",1,78,1137,538,599
050,53,077,"Washington","Yakima County",1,79,1064,493,571
050,53,077,"Washington","Yakima County",1,80,949,429,520
050,53,077,"Washington","Yakima County",1,81,883,392,491
050,53,077,"Washington","Yakima County",1,82,838,377,461
050,53,077,"Washington","Yakima County",1,83,721,317,404
050,53,077,"Washington","Yakima County",1,84,651,278,373
050,53,077,"Washington","Yakima County",1,85,3996,1510,2486
050,53,077,"Washington","Yakima County",2,0,3649,1871,1778
050,53,077,"Washington","Yakima County",2,1,3681,1871,1810
050,53,077,"Washington","Yakima County",2,2,3877,1957,1920
050,53,077,"Washington","Yakima County",2,3,4073,2012,2061
050,53,077,"Washington","Yakima County",2,4,4279,2145,2134
050,53,077,"Washington","Yakima County",2,5,4291,2207,2084
050,53,077,"Washington","Yakima County",2,6,4275,2202,2073
050,53,077,"Washington","Yakima County",2,7,4212,2138,2074
050,53,077,"Washington","Yakima County",2,8,4206,2138,2068
050,53,077,"Washington","Yakima County",2,9,4374,2242,2132
050,53,077,"Washington","Yakima County",2,10,4462,2310,2152
050,53,077,"Washington","Yakima County",2,11,4443,2251,2192
050,53,077,"Washington","Yakima County",2,12,4620,2376,2244
050,53,077,"Washington","Yakima County",2,13,4590,2384,2206
050,53,077,"Washington","Yakima County",2,14,4419,2268,2151
050,53,077,"Washington","Yakima County",2,15,4242,2161,2081
050,53,077,"Washington","Yakima County",2,16,4239,2147,2092
050,53,077,"Washington","Yakima County",2,17,4144,2098,2046
050,53,077,"Washington","Yakima County",2,18,3746,1934,1812
050,53,077,"Washington","Yakima County",2,19,3429,1783,1646
050,53,077,"Washington","Yakima County",2,20,3488,1819,1669
050,53,077,"Washington","Yakima County",2,21,3387,1715,1672
050,53,077,"Washington","Yakima County",2,22,3401,1707,1694
050,53,077,"Washington","Yakima County",2,23,3389,1721,1668
050,53,077,"Washington","Yakima County",2,24,3357,1705,1652
050,53,077,"Washington","Yakima County",2,25,3363,1694,1669
050,53,077,"Washington","Yakima County",2,26,3541,1776,1765
050,53,077,"Washington","Yakima County",2,27,3627,1799,1828
050,53,077,"Washington","Yakima County",2,28,3647,1807,1840
050,53,077,"Washington","Yakima County",2,29,3615,1829,1786
050,53,077,"Washington","Yakima County",2,30,3515,1801,1714
050,53,077,"Washington","Yakima County",2,31,3339,1671,1668
050,53,077,"Washington","Yakima County",2,32,3229,1615,1614
050,53,077,"Washington","Yakima County",2,33,3256,1653,1603
050,53,077,"Washington","Yakima County",2,34,3210,1616,1594
050,53,077,"Washington","Yakima County",2,35,3170,1583,1587
050,53,077,"Washington","Yakima County",2,36,3101,1568,1533
050,53,077,"Washington","Yakima County",2,37,3129,1533,1596
050,53,077,"Washington","Yakima County",2,38,3158,1594,1564
050,53,077,"Washington","Yakima County",2,39,3168,1626,1542
050,53,077,"Washington","Yakima County",2,40,3195,1644,1551
050,53,077,"Washington","Yakima County",2,41,3013,1523,1490
050,53,077,"Washington","Yakima County",2,42,3012,1522,1490
050,53,077,"Washington","Yakima County",2,43,2963,1482,1481
050,53,077,"Washington","Yakima County",2,44,2796,1408,1388
050,53,077,"Washington","Yakima County",2,45,2791,1408,1383
050,53,077,"Washington","Yakima County",2,46,2713,1382,1331
050,53,077,"Washington","Yakima County",2,47,2750,1380,1370
050,53,077,"Washington","Yakima County",2,48,2816,1395,1421
050,53,077,"Washington","Yakima County",2,49,2970,1513,1457
050,53,077,"Washington","Yakima County",2,50,2881,1472,1409
050,53,077,"Washington","Yakima County",2,51,2756,1395,1361
050,53,077,"Washington","Yakima County",2,52,2746,1389,1357
050,53,077,"Washington","Yakima County",2,53,2667,1347,1320
050,53,077,"Washington","Yakima County",2,54,2649,1358,1291
050,53,077,"Washington","Yakima County",2,55,2789,1426,1363
050,53,077,"Washington","Yakima County",2,56,2863,1454,1409
050,53,077,"Washington","Yakima County",2,57,2906,1440,1466
050,53,077,"Washington","Yakima County",2,58,2912,1469,1443
050,53,077,"Washington","Yakima County",2,59,2863,1445,1418
050,53,077,"Washington","Yakima County",2,60,2801,1442,1359
050,53,077,"Washington","Yakima County",2,61,2732,1413,1319
050,53,077,"Washington","Yakima County",2,62,2713,1385,1328
050,53,077,"Washington","Yakima County",2,63,2658,1325,1333
050,53,077,"Washington","Yakima County",2,64,2563,1243,1320
050,53,077,"Washington","Yakima County",2,65,2479,1212,1267
050,53,077,"Washington","Yakima County",2,66,2388,1159,1229
050,53,077,"Washington","Yakima County",2,67,2396,1123,1273
050,53,077,"Washington","Yakima County",2,68,2269,1066,1203
050,53,077,"Washington","Yakima County",2,69,2210,1064,1146
050,53,077,"Washington","Yakima County",2,70,2126,1041,1085
050,53,077,"Washington","Yakima County",2,71,2039,981,1058
050,53,077,"Washington","Yakima County",2,72,1972,947,1025
050,53,077,"Washington","Yakima County",2,73,2043,1001,1042
050,53,077,"Washington","Yakima County",2,74,1469,718,751
050,53,077,"Washington","Yakima County",2,75,1448,705,743
050,53,077,"Washington","Yakima County",2,76,1401,664,737
050,53,077,"Washington","Yakima County",2,77,1395,662,733
050,53,077,"Washington","Yakima County",2,78,1150,544,606
050,53,077,"Washington","Yakima County",2,79,1059,487,572
050,53,077,"Washington","Yakima County",2,80,959,434,525
050,53,077,"Washington","Yakima County",2,81,874,387,487
050,53,077,"Washington","Yakima County",2,82,827,367,460
050,53,077,"Washington","Yakima County",2,83,729,323,406
050,53,077,"Washington","Yakima County",2,84,655,281,374
050,53,077,"Washington","Yakima County",2,85,3986,1504,2482
050,53,077,"Washington","Yakima County",3,0,3360,1755,1605
050,53,077,"Washington","Yakima County",3,1,3631,1875,1756
050,53,077,"Washington","Yakima County",3,2,3706,1889,1817
050,53,077,"Washington","Yakima County",3,3,3907,1986,1921
050,53,077,"Washington","Yakima County",3,4,4023,1967,2056
050,53,077,"Washington","Yakima County",3,5,4285,2140,2145
050,53,077,"Washington","Yakima County",3,6,4289,2206,2083
050,53,077,"Washington","Yakima County",3,7,4284,2203,2081
050,53,077,"Washington","Yakima County",3,8,4179,2128,2051
050,53,077,"Washington","Yakima County",3,9,4215,2165,2050
050,53,077,"Washington","Yakima County",3,10,4355,2243,2112
050,53,077,"Washington","Yakima County",3,11,4462,2314,2148
050,53,077,"Washington","Yakima County",3,12,4430,2233,2197
050,53,077,"Washington","Yakima County",3,13,4640,2390,2250
050,53,077,"Washington","Yakima County",3,14,4553,2371,2182
050,53,077,"Washington","Yakima County",3,15,4398,2264,2134
050,53,077,"Washington","Yakima County",3,16,4217,2145,2072
050,53,077,"Washington","Yakima County",3,17,4230,2165,2065
050,53,077,"Washington","Yakima County",3,18,3831,1968,1863
050,53,077,"Washington","Yakima County",3,19,3441,1786,1655
050,53,077,"Washington","Yakima County",3,20,3546,1855,1691
050,53,077,"Washington","Yakima County",3,21,3401,1759,1642
050,53,077,"Washington","Yakima County",3,22,3500,1754,1746
050,53,077,"Washington","Yakima County",3,23,3475,1734,1741
050,53,077,"Washington","Yakima County",3,24,3436,1772,1664
050,53,077,"Washington","Yakima County",3,25,3389,1721,1668
050,53,077,"Washington","Yakima County",3,26,3352,1671,1681
050,53,077,"Washington","Yakima County",3,27,3591,1798,1793
050,53,077,"Washington","Yakima County",3,28,3601,1785,1816
050,53,077,"Washington","Yakima County",3,29,3650,1813,1837
050,53,077,"Washington","Yakima County",3,30,3626,1854,1772
050,53,077,"Washington","Yakima County",3,31,3458,1775,1683
050,53,077,"Washington","Yakima County",3,32,3323,1657,1666
050,53,077,"Washington","Yakima County",3,33,3272,1628,1644
050,53,077,"Washington","Yakima County",3,34,3203,1629,1574
050,53,077,"Washington","Yakima County",3,35,3211,1610,1601
050,53,077,"Washington","Yakima County",3,36,3147,1581,1566
050,53,077,"Washington","Yakima County",3,37,3056,1544,1512
050,53,077,"Washington","Yakima County",3,38,3125,1553,1572
050,53,077,"Washington","Yakima County",3,39,3109,1562,1547
050,53,077,"Washington","Yakima County",3,40,3146,1604,1542
050,53,077,"Washington","Yakima County",3,41,3165,1616,1549
050,53,077,"Washington","Yakima County",3,42,3014,1542,1472
050,53,077,"Washington","Yakima County",3,43,2966,1486,1480
050,53,077,"Washington","Yakima County",3,44,2933,1453,1480
050,53,077,"Washington","Yakima County",3,45,2786,1399,1387
050,53,077,"Washington","Yakima County",3,46,2767,1400,1367
050,53,077,"Washington","Yakima County",3,47,2689,1371,1318
050,53,077,"Washington","Yakima County",3,48,2710,1357,1353
050,53,077,"Washington","Yakima County",3,49,2758,1374,1384
050,53,077,"Washington","Yakima County",3,50,2911,1474,1437
050,53,077,"Washington","Yakima County",3,51,2836,1451,1385
050,53,077,"Washington","Yakima County",3,52,2740,1390,1350
050,53,077,"Washington","Yakima County",3,53,2688,1347,1341
050,53,077,"Washington","Yakima County",3,54,2629,1321,1308
050,53,077,"Washington","Yakima County",3,55,2654,1366,1288
050,53,077,"Washington","Yakima County",3,56,2733,1389,1344
050,53,077,"Washington","Yakima County",3,57,2827,1435,1392
050,53,077,"Washington","Yakima County",3,58,2865,1418,1447
050,53,077,"Washington","Yakima County",3,59,2892,1458,1434
050,53,077,"Washington","Yakima County",3,60,2823,1416,1407
050,53,077,"Washington","Yakima County",3,61,2755,1429,1326
050,53,077,"Washington","Yakima County",3,62,2692,1382,1310
050,53,077,"Washington","Yakima County",3,63,2640,1334,1306
050,53,077,"Washington","Yakima County",3,64,2637,1324,1313
050,53,077,"Washington","Yakima County",3,65,2518,1222,1296
050,53,077,"Washington","Yakima County",3,66,2410,1166,1244
050,53,077,"Washington","Yakima County",3,67,2310,1105,1205
050,53,077,"Washington","Yakima County",3,68,2341,1104,1237
050,53,077,"Washington","Yakima County",3,69,2230,1038,1192
050,53,077,"Washington","Yakima County",3,70,2152,1035,1117
050,53,077,"Washington","Yakima County",3,71,2077,998,1079
050,53,077,"Washington","Yakima County",3,72,1965,937,1028
050,53,077,"Washington","Yakima County",3,73,1901,908,993
050,53,077,"Washington","Yakima County",3,74,1997,974,1023
050,53,077,"Washington","Yakima County",3,75,1386,662,724
050,53,077,"Washington","Yakima County",3,76,1401,685,716
050,53,077,"Washington","Yakima County",3,77,1341,628,713
050,53,077,"Washington","Yakima County",3,78,1343,632,711
050,53,077,"Washington","Yakima County",3,79,1095,515,580
050,53,077,"Washington","Yakima County",3,80,1007,463,544
050,53,077,"Washington","Yakima County",3,81,891,394,497
050,53,077,"Washington","Yakima County",3,82,825,359,466
050,53,077,"Washington","Yakima County",3,83,766,342,424
050,53,077,"Washington","Yakima County",3,84,664,278,386
050,53,077,"Washington","Yakima County",3,85,3936,1499,2437
050,53,077,"Washington","Yakima County",4,0,3462,1747,1715
050,53,077,"Washington","Yakima County",4,1,3433,1775,1658
050,53,077,"Washington","Yakima County",4,2,3730,1922,1808
050,53,077,"Washington","Yakima County",4,3,3736,1881,1855
050,53,077,"Washington","Yakima County",4,4,3944,2017,1927
050,53,077,"Washington","Yakima County",4,5,4044,1975,2069
050,53,077,"Washington","Yakima County",4,6,4278,2150,2128
050,53,077,"Washington","Yakima County",4,7,4258,2176,2082
050,53,077,"Washington","Yakima County",4,8,4249,2192,2057
050,53,077,"Washington","Yakima County",4,9,4199,2129,2070
050,53,077,"Washington","Yakima County",4,10,4173,2147,2026
050,53,077,"Washington","Yakima County",4,11,4377,2243,2134
050,53,077,"Washington","Yakima County",4,12,4466,2313,2153
050,53,077,"Washington","Yakima County",4,13,4434,2240,2194
050,53,077,"Washington","Yakima County",4,14,4592,2359,2233
050,53,077,"Washington","Yakima County",4,15,4521,2365,2156
050,53,077,"Washington","Yakima County",4,16,4394,2273,2121
050,53,077,"Washington","Yakima County",4,17,4234,2155,2079
050,53,077,"Washington","Yakima County",4,18,3926,2017,1909
050,53,077,"Washington","Yakima County",4,19,3492,1820,1672
050,53,077,"Washington","Yakima County",4,20,3497,1826,1671
050,53,077,"Washington","Yakima County",4,21,3495,1816,1679
050,53,077,"Washington","Yakima County",4,22,3459,1779,1680
050,53,077,"Washington","Yakima County",4,23,3559,1769,1790
050,53,077,"Washington","Yakima County",4,24,3490,1776,1714
050,53,077,"Washington","Yakima County",4,25,3423,1772,1651
050,53,077,"Washington","Yakima County",4,26,3429,1718,1711
050,53,077,"Washington","Yakima County",4,27,3352,1705,1647
050,53,077,"Washington","Yakima County",4,28,3600,1818,1782
050,53,077,"Washington","Yakima County",4,29,3651,1819,1832
050,53,077,"Washington","Yakima County",4,30,3667,1862,1805
050,53,077,"Washington","Yakima County",4,31,3581,1835,1746
050,53,077,"Washington","Yakima County",4,32,3472,1757,1715
050,53,077,"Washington","Yakima County",4,33,3361,1666,1695
050,53,077,"Washington","Yakima County",4,34,3289,1643,1646
050,53,077,"Washington","Yakima County",4,35,3236,1637,1599
050,53,077,"Washington","Yakima County",4,36,3216,1632,1584
050,53,077,"Washington","Yakima County",4,37,3152,1602,1550
050,53,077,"Washington","Yakima County",4,38,3045,1556,1489
050,53,077,"Washington","Yakima County",4,39,3121,1558,1563
050,53,077,"Washington","Yakima County",4,40,3099,1553,1546
050,53,077,"Washington","Yakima County",4,41,3144,1585,1559
050,53,077,"Washington","Yakima County",4,42,3122,1596,1526
050,53,077,"Washington","Yakima County",4,43,2956,1493,1463
050,53,077,"Washington","Yakima County",4,44,2940,1466,1474
050,53,077,"Washington","Yakima County",4,45,2908,1459,1449
050,53,077,"Washington","Yakima County",4,46,2736,1367,1369
050,53,077,"Washington","Yakima County",4,47,2744,1387,1357
050,53,077,"Washington","Yakima County",4,48,2623,1333,1290
050,53,077,"Washington","Yakima County",4,49,2678,1358,1320
050,53,077,"Washington","Yakima County",4,50,2721,1343,1378
050,53,077,"Washington","Yakima County",4,51,2893,1479,1414
050,53,077,"Washington","Yakima County",4,52,2802,1439,1363
050,53,077,"Washington","Yakima County",4,53,2678,1369,1309
050,53,077,"Washington","Yakima County",4,54,2634,1321,1313
050,53,077,"Washington","Yakima County",4,55,2626,1328,1298
050,53,077,"Washington","Yakima County",4,56,2657,1363,1294
050,53,077,"Washington","Yakima County",4,57,2718,1359,1359
050,53,077,"Washington","Yakima County",4,58,2769,1400,1369
050,53,077,"Washington","Yakima County",4,59,2817,1388,1429
050,53,077,"Washington","Yakima County",4,60,2861,1438,1423
050,53,077,"Washington","Yakima County",4,61,2765,1390,1375
050,53,077,"Washington","Yakima County",4,62,2716,1410,1306
050,53,077,"Washington","Yakima County",4,63,2623,1342,1281
050,53,077,"Washington","Yakima County",4,64,2599,1311,1288
050,53,077,"Washington","Yakima County",4,65,2555,1287,1268
050,53,077,"Washington","Yakima County",4,66,2457,1184,1273
050,53,077,"Washington","Yakima County",4,67,2341,1125,1216
050,53,077,"Washington","Yakima County",4,68,2244,1077,1167
050,53,077,"Washington","Yakima County",4,69,2291,1082,1209
050,53,077,"Washington","Yakima County",4,70,2159,995,1164
050,53,077,"Washington","Yakima County",4,71,2080,985,1095
050,53,077,"Washington","Yakima County",4,72,1996,959,1037
050,53,077,"Washington","Yakima County",4,73,1900,892,1008
050,53,077,"Washington","Yakima County",4,74,1845,880,965
050,53,077,"Washington","Yakima County",4,75,1891,905,986
050,53,077,"Washington","Yakima County",4,76,1331,636,695
050,53,077,"Washington","Yakima County",4,77,1356,656,700
050,53,077,"Washington","Yakima County",4,78,1270,588,682
050,53,077,"Washington","Yakima County",4,79,1275,586,689
050,53,077,"Washington","Yakima County",4,80,1033,474,559
050,53,077,"Washington","Yakima County",4,81,936,426,510
050,53,077,"Washington","Yakima County",4,82,839,358,481
050,53,077,"Washington","Yakima County",4,83,766,332,434
050,53,077,"Washington","Yakima County",4,84,706,309,397
050,53,077,"Washington","Yakima County",4,85,3882,1472,2410
050,53,077,"Washington","Yakima County",5,0,3345,1690,1655
050,53,077,"Washington","Yakima County",5,1,3507,1757,1750
050,53,077,"Washington","Yakima County",5,2,3485,1817,1668
050,53,077,"Washington","Yakima County",5,3,3723,1924,1799
050,53,077,"Washington","Yakima County",5,4,3739,1881,1858
050,53,077,"Washington","Yakima County",5,5,3958,2002,1956
050,53,077,"Washington","Yakima County",5,6,4050,1976,2074
050,53,077,"Washington","Yakima County",5,7,4262,2142,2120
050,53,077,"Washington","Yakima County",5,8,4237,2156,2081
050,53,077,"Washington","Yakima County",5,9,4245,2203,2042
050,53,077,"Washington","Yakima County",5,10,4178,2125,2053
050,53,077,"Washington","Yakima County",5,11,4162,2141,2021
050,53,077,"Washington","Yakima County",5,12,4359,2229,2130
050,53,077,"Washington","Yakima County",5,13,4465,2309,2156
050,53,077,"Washington","Yakima County",5,14,4359,2214,2145
050,53,077,"Washington","Yakima County",5,15,4534,2317,2217
050,53,077,"Washington","Yakima County",5,16,4520,2365,2155
050,53,077,"Washington","Yakima County",5,17,4355,2242,2113
050,53,077,"Washington","Yakima County",5,18,3923,2001,1922
050,53,077,"Washington","Yakima County",5,19,3597,1873,1724
050,53,077,"Washington","Yakima County",5,20,3564,1862,1702
050,53,077,"Washington","Yakima County",5,21,3464,1776,1688
050,53,077,"Washington","Yakima County",5,22,3518,1804,1714
050,53,077,"Washington","Yakima County",5,23,3553,1807,1746
050,53,077,"Washington","Yakima County",5,24,3556,1786,1770
050,53,077,"Washington","Yakima County",5,25,3453,1751,1702
050,53,077,"Washington","Yakima County",5,26,3364,1722,1642
050,53,077,"Washington","Yakima County",5,27,3405,1725,1680
050,53,077,"Washington","Yakima County",5,28,3344,1682,1662
050,53,077,"Washington","Yakima County",5,29,3576,1795,1781
050,53,077,"Washington","Yakima County",5,30,3638,1834,1804
050,53,077,"Washington","Yakima County",5,31,3644,1829,1815
050,53,077,"Washington","Yakima County",5,32,3560,1807,1753
050,53,077,"Washington","Yakima County",5,33,3467,1762,1705
050,53,077,"Washington","Yakima County",5,34,3308,1634,1674
050,53,077,"Washington","Yakima County",5,35,3262,1639,1623
050,53,077,"Washington","Yakima County",5,36,3223,1657,1566
050,53,077,"Washington","Yakima County",5,37,3246,1649,1597
050,53,077,"Washington","Yakima County",5,38,3150,1614,1536
050,53,077,"Washington","Yakima County",5,39,3005,1538,1467
050,53,077,"Washington","Yakima County",5,40,3116,1561,1555
050,53,077,"Washington","Yakima County",5,41,3062,1526,1536
050,53,077,"Washington","Yakima County",5,42,3137,1601,1536
050,53,077,"Washington","Yakima County",5,43,3079,1567,1512
050,53,077,"Washington","Yakima County",5,44,2935,1481,1454
050,53,077,"Washington","Yakima County",5,45,2917,1457,1460
050,53,077,"Washington","Yakima County",5,46,2870,1451,1419
050,53,077,"Washington","Yakima County",5,47,2711,1351,1360
050,53,077,"Washington","Yakima County",5,48,2692,1357,1335
050,53,077,"Washington","Yakima County",5,49,2597,1328,1269
050,53,077,"Washington","Yakima County",5,50,2646,1316,1330
050,53,077,"Washington","Yakima County",5,51,2683,1318,1365
050,53,077,"Washington","Yakima County",5,52,2889,1474,1415
050,53,077,"Washington","Yakima County",5,53,2751,1406,1345
050,53,077,"Washington","Yakima County",5,54,2668,1372,1296
050,53,077,"Washington","Yakima County",5,55,2624,1322,1302
050,53,077,"Washington","Yakima County",5,56,2591,1304,1287
050,53,077,"Washington","Yakima County",5,57,2616,1335,1281
050,53,077,"Washington","Yakima County",5,58,2678,1346,1332
050,53,077,"Washington","Yakima County",5,59,2736,1386,1350
050,53,077,"Washington","Yakima County",5,60,2747,1341,1406
050,53,077,"Washington","Yakima County",5,61,2796,1410,1386
050,53,077,"Washington","Yakima County",5,62,2733,1374,1359
050,53,077,"Washington","Yakima County",5,63,2652,1374,1278
050,53,077,"Washington","Yakima County",5,64,2609,1330,1279
050,53,077,"Washington","Yakima County",5,65,2528,1291,1237
050,53,077,"Washington","Yakima County",5,66,2487,1240,1247
050,53,077,"Washington","Yakima County",5,67,2404,1146,1258
050,53,077,"Washington","Yakima County",5,68,2296,1105,1191
050,53,077,"Washington","Yakima County",5,69,2202,1058,1144
050,53,077,"Washington","Yakima County",5,70,2222,1052,1170
050,53,077,"Washington","Yakima County",5,71,2104,965,1139
050,53,077,"Washington","Yakima County",5,72,2012,946,1066
050,53,077,"Washington","Yakima County",5,73,1942,917,1025
050,53,077,"Washington","Yakima County",5,74,1865,871,994
050,53,077,"Washington","Yakima County",5,75,1752,824,928
050,53,077,"Washington","Yakima County",5,76,1813,864,949
050,53,077,"Washington","Yakima County",5,77,1273,603,670
050,53,077,"Washington","Yakima County",5,78,1303,631,672
050,53,077,"Washington","Yakima County",5,79,1218,555,663
050,53,077,"Washington","Yakima County",5,80,1193,538,655
050,53,077,"Washington","Yakima County",5,81,977,447,530
050,53,077,"Washington","Yakima County",5,82,888,397,491
050,53,077,"Washington","Yakima County",5,83,759,329,430
050,53,077,"Washington","Yakima County",5,84,700,296,404
050,53,077,"Washington","Yakima County",5,85,3867,1474,2393

